TGTGCCAGCAGCGGCCGGACAGTTTGGTTTAGTAACACTGAAGCTTTCTTT	CASSGRTVWFSNTEAFF	TRBV5-4	TRBJ1-1
TGTGCCAGCAGTTTAAGGGACAGGGGTTCTGGGACCCAGTACTTC	CASSLRDRGSGTQYF	TRBV28	TRBJ2-5
TGTGCCAGCAGTGAACCGGGACTCCCAGATACGCAGTATTTT	CASSEPGLPDTQYF	TRBV6-1	TRBJ2-3
TGCGCCAGCAGTTATGGGGGGGACAAGCCAAGGAGCTCCTACGAGCAGTACTTC	CASSYGGDKPRSSYEQYF	TRBV5-1	TRBJ2-7
TGCAGCGTTGCGCACCAGGACAGGGGGCGGGTACAATACCAAGAGACCCAGTACTTC	CSVAHQDRGRVQYQETQYF	TRBV29-1	TRBJ2-5
TGTGCCTGGAGTGTAAAAGGACGGGACGGGGAGTATGAAGCTTTCTTT	CAWSVKGRDGEYEAFF	TRBV30	TRBJ1-1
TGTGCCAGCAGCCTGACGGGGGCTAAGCGGAACACTGAAGCTTTCTTT	CASSLTGAKRNTEAFF	TRBV14	TRBJ1-1
TGCGCCAGCAGCAATCTGCGGATTCCCTACAATGAGCAGTTCTTC	CASSNLRIPYNEQFF	TRBV5-1	TRBJ2-1
TGTGCCAGCAGCGTAGACGCCCTACCCAGTGATGACACCGGGGAGCTGTTTTTT	CASSVDALPSDDTGELFF	TRBV9	TRBJ2-2
TGTGCCAGCAGCCAAGGAAAACGACCACAGGGGGTAGGTAGAAAGAACTATGGCTACACCTTC	CASSQGKRPQGVGRKNYGYTF	TRBV14	TRBJ1-2
TGTGCCAGCAGCTTGGCGGACAGGTACACAGATACGCAGTATTTT	CASSLADRYTDTQYF	TRBV7-9	TRBJ2-3
TGTGCCAGCAGCGAAGTCTCTTTAACCCGAGCTTTCTTT	CASSEVSLTRAFF	TRBV7-2	TRBJ1-1
TGTGCCAGCAGCCAAGCTGACGGTTCGATACCTTTGAACACTGAAGCTTTCTTT	CASSQADGSIPLNTEAFF	TRBV3-1	TRBJ1-1
TGCAGTGCCCCCAGGGGCACTGAAGCTTTCTTT	CSAPRGTEAFF	TRBV20-1	TRBJ1-1
TGTGCCAGCAGCTTGCCTTTAACGGCCTACAGGGGGAATTTAGAGACCCAGTACTTC	CASSLPLTAYRGNLETQYF	TRBV5-5	TRBJ2-5
TGTGCCACGGGCGGCGATGATGATAATGAAAAACTGTTTTTT	CATGGDDDNEKLFF	TRBV6-4	TRBJ1-4
TGTGCCAGCAGTTTAGATCAGCTGGCCACCTTC	CASSLDQLATF	TRBV28	TRBJ1-2
TGCGCCAGCAGCCACGTGGGGTTCAACAATGAGCAGTTCTTC	CASSHVGFNNEQFF	TRBV4-1	TRBJ2-1
TGCGCCAGCAGCCAAGCAGGCAAGCCACCAAAGTTGGCTTTCTTT	CASSQAGKPPKLAFF	TRBV4-1	TRBJ1-1
TGTGCCAGCAGCCGATTTCGTCGTCGGGACATGGACAACACCGGGGAGCTGTTTTTT	CASSRFRRRDMDNTGELFF	TRBV14	TRBJ2-2
TGTGCCAGCAGCTTAGAGCCCCCGGCGAGCTATGGCTACACCTTC	CASSLEPPASYGYTF	TRBV11-2	TRBJ1-2
TGTGCCAGCACCGGGACTAGCGGGAGGGGGGACACTGAAGCTTTCTTT	CASTGTSGRGDTEAFF	TRBV9	TRBJ1-1
TGTGCCAGCAGCCGACAGGTCGATATATTGGGAAACACCATATATTTT	CASSRQVDILGNTIYF	TRBV6-4	TRBJ1-3
TGTGCCGGCACAGTTTACGAGCAGTACTTC	CAGTVYEQYF	TRBV24-1	TRBJ2-7
TGTGCCAGCAGCCGGGACAGGGGGAACTATGGCTACACCTTC	CASSRDRGNYGYTF	TRBV27	TRBJ1-2
TGTGCCAGCAGTTTCCCAATGTCCAGACCCCAGTACTTC	CASSFPMSRPQYF	TRBV27	TRBJ2-5
TGCGCCAGCAGCAGGGGTATTCAGGGGCGCCTGGCTGGGGCCAACGTCCTGACTTTC	CASSRGIQGRLAGANVLTF	TRBV5-1	TRBJ2-6
TGCAGTGCTAGCCACCAGGGCTACGAGCAGTACTTC	CSASHQGYEQYF	TRBV20-1	TRBJ2-7
TGTGCCAGCAGTTTATCGCAAATTCCGAAGCGCGGGTGGTTATACGAGCAGTACTTC	CASSLSQIPKRGWLYEQYF	TRBV27	TRBJ2-7
TGTGCCAGCAGCGTACTTAGCGGCCCGGGCACAGATACGCAGTATTTT	CASSVLSGPGTDTQYF	TRBV9	TRBJ2-3
TGCGCCAGCAGTCGGGAAAGGACTAGCGGGAGGAACACAGATACGCAGTATTTT	CASSRERTSGRNTDTQYF	TRBV10-1	TRBJ2-3
TGCAGTGCTACTAGGGGCGGAAACACCATATATTTT	CSATRGGNTIYF	TRBV20-1	TRBJ1-3
TGTGCCAGCAGCTTATTAATGGGGGCCCAGGGCGGGGAGCTGTTTTTT	CASSLLMGAQGGELFF	TRBV14	TRBJ2-2
TGTGCCAGCAGCTGTTCGGCGACACCTTTTAAGGACAGGTATGGCTACACCTTC	CASSCSATPFKDRYGYTF	TRBV5-4	TRBJ1-2
TGTGCCAGCAGTATGGGGGGGCCTCATGAGCAGTTCTTC	CASSMGGPHEQFF	TRBV27	TRBJ2-1
TGTGCCAGCAGTTACTCATCAGGGGAGTTCGGGGAGCTGTTTTTT	CASSYSSGEFGELFF	TRBV6-2	TRBJ2-2
TGTGCCAGCAGCTTAGACGAGGACAATGAGCAGTTCTTC	CASSLDEDNEQFF	TRBV7-4	TRBJ2-1
TGCAGTGCTCTCGGGGGATCGCCCCAGCATTTT	CSALGGSPQHF	TRBV20-1	TRBJ1-5
TGTGCCAGCAGCAACCCTATGAAGGCAATGGACGAGCAGTACTTC	CASSNPMKAMDEQYF	TRBV14	TRBJ2-7
TGTGCCTGGGGGTCTACTTTTTTGCAGTACTTC	CAWGSTFLQYF	TRBV30	TRBJ2-7
TGTGCCAGCAGCCGCCACAAAGACAGCCGCAATCAGCCCCAGCATTTT	CASSRHKDSRNQPQHF	TRBV11-2	TRBJ1-5
TGTGCCAGCAGTGACTCTGTTGAAGGAAGGGGGGACAGGGAAAAACCGGCCAAAAACATTCAGTACTTC	CASSDSVEGRGDREKPAKNIQYF	TRBV6-4	TRBJ2-4
TGTGCCAGCAGCTTAGAAGGGGGGCCCCCTGTCGAGCAGTACTTC	CASSLEGGPPVEQYF	TRBV7-6	TRBJ2-7
TGTGCCAGCAGCGGGGCGGCTTTGCACTACGAGCAGTACTTC	CASSGAALHYEQYF	TRBV28	TRBJ2-7
TGTGCCAGTAGTATAAGTAGTAAGTACGAGCAGTACTTC	CASSISSKYEQYF	TRBV19	TRBJ2-7
TGTGCCAGCAGTTACCAATTGGGACAGAGTCGCCAGGGGGGATTGAACACTGAAGCTTTCTTT	CASSYQLGQSRQGGLNTEAFF	TRBV6-2	TRBJ1-1
TGTGCCAGCAGTTACTTCGCCGGGAGGGGGGCTCATGAGACCCAGTACTTC	CASSYFAGRGAHETQYF	TRBV6-6	TRBJ2-5
TGTGCCAGCAGCGGCCCCCTTGGGGGGGCAGATACGCAGTATTTT	CASSGPLGGADTQYF	TRBV7-9	TRBJ2-3
TGTGCCATCAGTGAGACTGGGACAGCGACGATCATTAGCAATCAGCCCCAGCATTTT	CAISETGTATIISNQPQHF	TRBV10-3	TRBJ1-5
TGTGCCAGCAGCAATGGGGGGCCTAAGTTGTATGGCTACACCTTC	CASSNGGPKLYGYTF	TRBV13	TRBJ1-2
TGTGCCAGCAGCTTAACTCCTTGGGGGCGCCTGGGGACCTACGAGCAGTACTTC	CASSLTPWGRLGTYEQYF	TRBV11-2	TRBJ2-7
TGCGCCAGCAGCTCCCCGCCCGGCAAGTCGGGGTCTGGAAACACCATATATTTT	CASSSPPGKSGSGNTIYF	TRBV5-1	TRBJ1-3
TGCGCCAGCAGGGGCCTGATAAGGGACAAGTCGCCTAACTATGGCTACACCTTC	CASRGLIRDKSPNYGYTF	TRBV10-1	TRBJ1-2
TGCGCCAGCAGCTTGGAGAGAGACAATGAGCAGTTCTTC	CASSLERDNEQFF	TRBV5-1	TRBJ2-1
TGTGCCAGGGGGGAGGTCGTCTGGGAGACCCAGTACTTC	CARGEVVWETQYF	TRBV13	TRBJ2-5
TGCGCCAGCAGCTTGGTGGCAGGGTGGGACAGGGGTCCGTATAATTCACCCCTCCACTTT	CASSLVAGWDRGPYNSPLHF	TRBV5-1	TRBJ1-6
TGTGCCCACTTCAGGGCGCGGCAGAGGGAAGCTTTCTTT	CAHFRARQREAFF	TRBV19	TRBJ1-1
TGTGCCAGCAGTTCCAGGGGGGGTAGACAAGAGACCCAGTACTTC	CASSSRGGRQETQYF	TRBV6-9	TRBJ2-5
TGCGCCAGCAGCCAAGATGGCCGAATCCAGATTAAAGAGACCCAGTACTTC	CASSQDGRIQIKETQYF	TRBV4-1	TRBJ2-5
TGTGCCAGCACCTATTCGGCCAATTGTCCTAACTATGGCTACACCTTC	CASTYSANCPNYGYTF	TRBV25-1	TRBJ1-2
TGTGCCAGCAGCTTTTTATTGACTAGCGGGTTGGCCTCTGGGGCCAACGTCCTGACTTTC	CASSFLLTSGLASGANVLTF	TRBV11-2	TRBJ2-6
TGTGCCAGCAGCTTGCGCAGCATTTTCCTCCACTTT	CASSLRSIFLHF	TRBV5-5	TRBJ1-6
TGCGCCAGCAGTGAGTCTTGCTCCTACGAGCAGTACTTC	CASSESCSYEQYF	TRBV10-1	TRBJ2-7
TGTGGGGAGAATGAGCAGTTCTTC	CGENEQFF	TRBV27	TRBJ2-1
TGTGCCAGCAGCTGGTATCGGGCCCCCGACACTGAAGCTTTCTTT	CASSWYRAPDTEAFF	TRBV7-2	TRBJ1-1
TGCGCCAGCAGCCAAGAGGTAGGGGGTGACAATCAGCCCCAGCATTTT	CASSQEVGGDNQPQHF	TRBV4-1	TRBJ1-5
TGTGCCAGCAGCTTAGCCAGGGGTATTTCCTACGAGCAGTACTTC	CASSLARGISYEQYF	TRBV7-8	TRBJ2-7
TGCGCCAGCCAGGGGGGCGTCACAGATACGCAGTATTTT	CASQGGVTDTQYF	TRBV10-1	TRBJ2-3
TGCGCCAGCAGTACAGGGCTAAATGGCTACACCTTC	CASSTGLNGYTF	TRBV5-1	TRBJ1-2
TGTGCCAGCTACAGGACACGGGAGACCCAGTACTTC	CASYRTRETQYF	TRBV12-3	TRBJ2-5
TGTGCCAGCAGTCCGGGAGGGGGCACAGATACGCAGTATTTT	CASSPGGGTDTQYF	TRBV12-3	TRBJ2-3
TGTGCCAGACCGGACGAGGAGACCCAGTACTTC	CARPDEETQYF	TRBV27	TRBJ2-5
TGCGCCAGTCAGGGGGATCCCTACGAGCAGTACTTC	CASQGDPYEQYF	TRBV10-1	TRBJ2-7
TGCAGCGTTTCCGGGCGGGACTACGAGCAGTACTTC	CSVSGRDYEQYF	TRBV29-1	TRBJ2-7
TGTGCCAGCAGCTTAGGAAGCGGGAGAGGGAGCCAGCTCGAGCAGTACTTC	CASSLGSGRGSQLEQYF	TRBV11-3	TRBJ2-7
TGTGCCAGCAGCCTGACCAGGGCATGGTGGGCAACTGAAGCTTTCTTT	CASSLTRAWWATEAFF	TRBV5-6	TRBJ1-1
TGCAGTGCCCAAACCATTCTTAATGAAAAACTGTTTTTT	CSAQTILNEKLFF	TRBV20-1	TRBJ1-4
TGTGCCTGGATAACCGGGCCTGGCTACACCTTC	CAWITGPGYTF	TRBV30	TRBJ1-2
TGTGCCAGCAGCTTGCGGTGGACAGGGCATCATTCACCCCTCCACTTT	CASSLRWTGHHSPLHF	TRBV7-8	TRBJ1-6
TGTGCCACCAGGGCCCCTGACAGTAGGAATCTCGCCTCTGGAAACACCATATATTTT	CATRAPDSRNLASGNTIYF	TRBV24-1	TRBJ1-3
TGTGCCTGGAGTGTACCCGACCGCTCACTAGCGGGAGCAGAATACGAGCAGTACTTC	CAWSVPDRSLAGAEYEQYF	TRBV30	TRBJ2-7
TGTGCCAGCAGCGTAACCGGGACTAGCGGGATCGGTTCCGGGGAGCTGTTTTTT	CASSVTGTSGIGSGELFF	TRBV11-2	TRBJ2-2
TGTGCCAGCAGCTTAGGCGGGCGCAGCAGCCCCTACGAGCAGTACTTC	CASSLGGRSSPYEQYF	TRBV7-9	TRBJ2-7
TGTGCCATCAGTGAAGTACCGGACGAGCAGTACTTC	CAISEVPDEQYF	TRBV10-3	TRBJ2-7
TGTGCCAGCAGCGAGGGCGGAGGCCGCAATCAGCCCCAGCATTTT	CASSEGGGRNQPQHF	TRBV11-3	TRBJ1-5
TGCGCCAGCAGCTTGGCGACAGGGTCGGAGGCCGGGGCCTACGAGCAGTACTTC	CASSLATGSEAGAYEQYF	TRBV5-1	TRBJ2-7
TGCGCCAGCAGCGCTCTCTGTTGCAGATCTGGAAACACCATATATTTT	CASSALCCRSGNTIYF	TRBV5-1	TRBJ1-3
TGTGCCAGCAGCTTAGTCCGGGGGTTCTCCTACGAGCAGTACTTC	CASSLVRGFSYEQYF	TRBV7-2	TRBJ2-7
TGTGCCAGCAGCCAAGATATCTCTAGCGGATCCTACGAGCAGTACTTC	CASSQDISSGSYEQYF	TRBV14	TRBJ2-7
TGTGCCAGCAAGAATAGCCAGGACCCTGGGGCCAACGTCCTGACTTTC	CASKNSQDPGANVLTF	TRBV6-5	TRBJ2-6
TGTGCCAGCAGCCAAGCCGAAAGGACCGGGGAGCTGTTTTTT	CASSQAERTGELFF	TRBV4-2	TRBJ2-2
TGTGCCACAAACGACCAGGCAATATATTTT	CATNDQAIYF	TRBV6-3	TRBJ1-3
TGTGCCAGCAGTAAGGCCCCCGGACTAGCGGGCCACGAGCAGTACTTC	CASSKAPGLAGHEQYF	TRBV28	TRBJ2-7
TGTGCCAGCAGCGAAGCTCTCGCGGGACTACCGACACCCCCTAGATACAATGAGCAGTTCTTC	CASSEALAGLPTPPRYNEQFF	TRBV9	TRBJ2-1
TGTGCCAGCAGCCCCAGAAGAGCTCCGACAGGCCCCTCTGGAAACACCATATATTTT	CASSPRRAPTGPSGNTIYF	TRBV5-5	TRBJ1-3
TGCAGTGCTAGGAAACGGTGTTCGGGGGAGGAATATCAGCCCCAGCATTTT	CSARKRCSGEEYQPQHF	TRBV20-1	TRBJ1-5
TGCGCCAGCAGCAAATCTGTGGGGAGGGCTTGGGGCTCCTACGAGCAGTACTTC	CASSKSVGRAWGSYEQYF	TRBV4-3	TRBJ2-7
TGTGCCAGCAGCTACTGCGGCAGTACGCAGTATTTT	CASSYCGSTQYF	TRBV11-3	TRBJ2-3
TGTGCCTGGAGTGTCGGCCTCGGGGACAGGGACGTATTTCAGCCCCAGCATTTT	CAWSVGLGDRDVFQPQHF	TRBV30	TRBJ1-5
TGCAGTGCTCAAGGGACAGGGAGAAGGAGAGGCTACGAGCAGTACTTC	CSAQGTGRRRGYEQYF	TRBV20-1	TRBJ2-7
TGCGCCAGCAGCCAAGAACGGAACTGGGCTTGGACCAAAAACATTCAGTACTTC	CASSQERNWAWTKNIQYF	TRBV4-1	TRBJ2-4
TGCGCCAGCAGCCAAGAGTGGATCCCGGGACTAGCGGGCGGCACAGATACGCAGTATTTT	CASSQEWIPGLAGGTDTQYF	TRBV4-3	TRBJ2-3
TGTGCCAGCAGCTCCCCGTGGGCTACGTATGGCTACACCTTC	CASSSPWATYGYTF	TRBV7-2	TRBJ1-2
TGCAGCGAGGCTCAGCAGTACTTC	CSEAQQYF	TRBV29-1	TRBJ2-7
TGTGCCAGCAAACTGACAGGCTCTGGGGCCAACGTCCTGACTTTC	CASKLTGSGANVLTF	TRBV12-4	TRBJ2-6
TGTGCCAGCAGCTTACCCGAGGGTTACTTC	CASSLPEGYF	TRBV7-3	TRBJ2-4
TGCGCCAGCAGCTGGGACAGGGGATATCAGCCCCAGCATTTT	CASSWDRGYQPQHF	TRBV5-1	TRBJ1-5
TGTGCCAGCAGCCAGGGGGTAAATGAGCAGTTCTTC	CASSQGVNEQFF	TRBV4-2	TRBJ2-1
TGCAGTGCTAGACTCTCGCCAGACACTGAAGCTTTCTTT	CSARLSPDTEAFF	TRBV20-1	TRBJ1-1
TGTGCCAGCAGCTTAGCTTCCGACAGAGGGGAGCTGTTTTTT	CASSLASDRGELFF	TRBV7-9	TRBJ2-2
TGTGCCAGTAGTATAGTTCATGAGAAGTACGAGCAGTACTTC	CASSIVHEKYEQYF	TRBV19	TRBJ2-7
TGTGCCTGGAGTAATCCGGAATTTAATGAAAAACTGTTTTTT	CAWSNPEFNEKLFF	TRBV30	TRBJ1-4
TGTGCCAGCAGTGGGGACTCTGGAAACACCATATATTTT	CASSGDSGNTIYF	TRBV2	TRBJ1-3
TGTGCTAGTGGGAAAAGGGGGGACAAAAACTATGGCTACACCTTC	CASGKRGDKNYGYTF	TRBV12-5	TRBJ1-2
TGCGCCAGCAGCCCCCCAAAGGGGGCAGATATGCACAATCAGCCCCAGCATTTT	CASSPPKGADMHNQPQHF	TRBV5-1	TRBJ1-5
TGCGCCAGCAGACTTAGGACTAGCTTCAACAATGAGCAGTTCTTC	CASRLRTSFNNEQFF	TRBV10-1	TRBJ2-1
TGCAGTGCTAGAGATCCTGGACGTTTCTATAATTCACCCCTCCACTTT	CSARDPGRFYNSPLHF	TRBV20-1	TRBJ1-6
TGCAGTGCTAGAGATGACAGGACGAGGCGTTACCCCCCTGAAGCTTTCTTT	CSARDDRTRRYPPEAFF	TRBV20-1	TRBJ1-1
TGTGCCAGCTCTAGACAGGGCCCGAAGGACTACGAGCAGTACTTC	CASSRQGPKDYEQYF	TRBV28	TRBJ2-7
TGTGCCAGCAGCCTGTGGTGGGGTGAAGCTTTCTTT	CASSLWWGEAFF	TRBV7-4	TRBJ1-1
TGTGCCAGCAGTGTGAGGGACAGGGGGAACTCTGGAAACACCATATATTTT	CASSVRDRGNSGNTIYF	TRBV25-1	TRBJ1-3
TGCGCCAGCCTCCCGGCGCTCACTGAAGCTTTCTTT	CASLPALTEAFF	TRBV4-3	TRBJ1-1
TGCAGTCAGGATACGGGCTACGAGCAGTACTTC	CSQDTGYEQYF	TRBV20-1	TRBJ2-7
TGCAGCGTTGACCTAAAATCCCGGTTCGCTGAGACCCAGTACTTC	CSVDLKSRFAETQYF	TRBV29-1	TRBJ2-5
TGCGCCAGCAGCTTGAAGGGACTAGCGGGGTCGAGAGATACGCAGTATTTT	CASSLKGLAGSRDTQYF	TRBV5-1	TRBJ2-3
TGTGCCAGCTCACTTAACTGGGGGGGGGATCGGGGGGATGAGCAGTTCTTC	CASSLNWGGDRGDEQFF	TRBV18	TRBJ2-1
TGTGCCAGCAGCACTGCGGAGCGAGCTAACTATGGCTACACCTTC	CASSTAERANYGYTF	TRBV13	TRBJ1-2
TGCAGTGCTAGCGTAGGACAGGCCAATCAGTATGGCTACACCTTC	CSASVGQANQYGYTF	TRBV20-1	TRBJ1-2
TGCGCCAGCAGGCAGGGGCACGCAGATACGCAGTATTTT	CASRQGHADTQYF	TRBV4-1	TRBJ2-3
TGTGCCAGCAGCGGGAGTGAGGGGACCGGCTATGGCTACACCTTC	CASSGSEGTGYGYTF	TRBV11-2	TRBJ1-2
TGTGCCTGGAGTGTAACAAACTTACAGGGTCACTATGGCTACACCTTC	CAWSVTNLQGHYGYTF	TRBV30	TRBJ1-2
TGTGCCAGCACGACGCCGAACACCGGGGAGCTGTTTTTT	CASTTPNTGELFF	TRBV7-3	TRBJ2-2
TGTGCCAGCATTTATCAGCATCTCTATGGCTACACCTTC	CASIYQHLYGYTF	TRBV2	TRBJ1-2
TGTGCCAGCAGCTCGGGGATGGGGGCCGAAGAGCAGCCCCAGCATTTT	CASSSGMGAEEQPQHF	TRBV11-2	TRBJ1-5
TGTGCCAGCAGCTTATCGGGGAATGGCTACACCTTC	CASSLSGNGYTF	TRBV7-7	TRBJ1-2
TGCAGTGCTAGAGTCGGTCCGAGCTACGAGCAGTACTTC	CSARVGPSYEQYF	TRBV20-1	TRBJ2-7
TGTGCCAGCAGCAGTCCACGGACTAGCGGGCCCTACGAGCAGTACTTC	CASSSPRTSGPYEQYF	TRBV7-6	TRBJ2-7
TGCAGTACCCACCGGGACAGGGGCTATGGCTACACCTTC	CSTHRDRGYGYTF	TRBV20-1	TRBJ1-2
TGTGCCAGCACAATGCGGGAGGTAGTCGAGACCCAGTACTTC	CASTMREVVETQYF	TRBV28	TRBJ2-5
TGCGCCAGCAGCTTGGAACCCGGGCAGCGAGACGAGCAGTACTTC	CASSLEPGQRDEQYF	TRBV5-1	TRBJ2-7
TGCGCCAGCAGTGATGCCCACCTGGCAGGGGGCCGGAACACTGAAGCTTTCTTT	CASSDAHLAGGRNTEAFF	TRBV10-1	TRBJ1-1
TGTGCCAGCAAGATTGGCGATTCAGATACGCAGTATTTT	CASKIGDSDTQYF	TRBV6-1	TRBJ2-3
TGTGCCAGCAGCCCCTTAACGTATAGCAATCAGCCCCAGCATTTT	CASSPLTYSNQPQHF	TRBV13	TRBJ1-5
TGTGCCAGCAGTCCAGGGACTGGTTCCGAGCAGTACTTC	CASSPGTGSEQYF	TRBV28	TRBJ2-7
TGTGCCAGCGGACAGGCCTCTGAAGCTTTCTTT	CASGQASEAFF	TRBV9	TRBJ1-1
TGTGCCAGCAGTGGTGATATAAATCAGCCCCAGCATTTT	CASSGDINQPQHF	TRBV2	TRBJ1-5
TGCGCCAGCAGCAACAAATCCTCGAGGGGAATCTCCTCTGGAAACACCATATATTTT	CASSNKSSRGISSGNTIYF	TRBV5-1	TRBJ1-3
TGTGCCCGGGACAGGGTGAAAGTTTACACTGAAGCTTTCTTT	CARDRVKVYTEAFF	TRBV28	TRBJ1-1
TGCAGTGCTCACGAGCGGGACCCTCATGAGCAGTTCTTC	CSAHERDPHEQFF	TRBV20-1	TRBJ2-1
TGTGCCATCAGGACAGGGGGCGAAGGGGGCGAGCAGTACTTC	CAIRTGGEGGEQYF	TRBV10-3	TRBJ2-7
TGCAGCGAACAGGGGCGCTATGGCTACACCTTC	CSEQGRYGYTF	TRBV20-1	TRBJ1-2
TGTGCCAGGTCCCTCCAACGACAGGGGGACCTTTGCAATCAGCCCCAGCATTTT	CARSLQRQGDLCNQPQHF	TRBV6-5	TRBJ1-5
TGTGCCATCAGAAGGGGCGATAACGAGCAGTACTTC	CAIRRGDNEQYF	TRBV10-3	TRBJ2-7
TGCGCCAGCAGCTTGGAGAATGTACAGGGTAGCAATCAGCCCCAGCATTTT	CASSLENVQGSNQPQHF	TRBV5-1	TRBJ1-5
TGTGCCAGCAGCTTGGCCCGCGGCTACTACAATGAGCAGTTCTTC	CASSLARGYYNEQFF	TRBV5-4	TRBJ2-1
TGTGCCAGCAGCTTACCCCTTAGGCTCACTAGCGGGAGGGCAGGCTCCTACGAGCAGTACTTC	CASSLPLRLTSGRAGSYEQYF	TRBV7-3	TRBJ2-7
TGCGCCAGCAGCCGGGCTAGGGGTTCACCCCTCCACTTT	CASSRARGSPLHF	TRBV4-1	TRBJ1-6
TGTGCCAGCAGCCAAGGCGGTCTCGTTGGGGGACTAGCGGGAGCGGACCTTATCACAGATACGCAGTATTTT	CASSQGGLVGGLAGADLITDTQYF	TRBV3-1	TRBJ2-3
TGCGCCAGCAGCCAAGTGAGCAGGGTTGTGGGGCCGGAGGTCGACCTGGCTGGGGCCAACGTCCTGACTTTC	CASSQVSRVVGPEVDLAGANVLTF	TRBV4-3	TRBJ2-6
TGCAGTGCCCGGGACAGCCATACCGGGGAGCTGTTTTTT	CSARDSHTGELFF	TRBV20-1	TRBJ2-2
TGTGCCAGCACCCACCCCAGGAAGCCTGAAAAACTGTTTTTT	CASTHPRKPEKLFF	TRBV14	TRBJ1-4
TGTGCCAGCTCTAGGGTGAGTGGGGAGACCCAGTACTTC	CASSRVSGETQYF	TRBV6-2	TRBJ2-5
TGTGCCAGCAGCGGTAGAACGCCCCCTGAAGCTTTCTTT	CASSGRTPPEAFF	TRBV13	TRBJ1-1
TGTGCCAGCAGCGTACTAGCGGGAGAATACGAGCAGTACTTC	CASSVLAGEYEQYF	TRBV9	TRBJ2-7
TGCGCCAGCAGTTCTGGAACCGGGACCGGGGAGCTGTTTTTT	CASSSGTGTGELFF	TRBV10-1	TRBJ2-2
TGTGCCAGCAGTTTCTCTCCCTACTACGAGCAGTACTTC	CASSFSPYYEQYF	TRBV7-9	TRBJ2-7
TGTGCCAGCAGCGTAGGGACAGGAAAACTGTTTTTT	CASSVGTGKLFF	TRBV9	TRBJ1-4
TGTGCCACCAGCAGAGACGAAAAGCGGGATTCCTACGAGCAGTACTTC	CATSRDEKRDSYEQYF	TRBV15	TRBJ2-7
TGCGCCAGCAGTGAGCTGACAGGTTCACCCCTCCACTTT	CASSELTGSPLHF	TRBV10-1	TRBJ1-6
TGTGCCAGCTCACCAGCGAGGTGCGAGGGGGGGAATGAGCAGTTCTTC	CASSPARCEGGNEQFF	TRBV18	TRBJ2-1
TGTGCCAGCAGCTGCGGCTGCCACAGGGCCGAAGCTTTCTTT	CASSCGCHRAEAFF	TRBV13	TRBJ1-1
TGCGCCAGCAGCTTGGAACCGTTTCCGCCGTGTTGGACAGATTTGAACACTGAAGCTTTCTTT	CASSLEPFPPCWTDLNTEAFF	TRBV5-1	TRBJ1-1
TGCGCCAGCAGCTTGGCAGGGGGACTAGCGGAAAGAAAAGACAATGAGCAGTTCTTC	CASSLAGGLAERKDNEQFF	TRBV5-1	TRBJ2-1
TGTGCCAGCAGTTTATCTCGCCAGGGACAGGCTACTGAAGCTTTCTTT	CASSLSRQGQATEAFF	TRBV27	TRBJ1-1
TGTGCCAGCAGCGGGCGAAAGGGAAACATTCAGTACTTC	CASSGRKGNIQYF	TRBV9	TRBJ2-4
TGTGCCAGCAGTAGGCGGACCTCCTACGAGCAGTACTTC	CASSRRTSYEQYF	TRBV6-1	TRBJ2-7
TGTGCCTGGAGTAACGGACAGGGTCGTCGAACTACTGGCTACACCTTC	CAWSNGQGRRTTGYTF	TRBV30	TRBJ1-2
TGTGCCAGCAGCTTGGGGCCAACTCGGGGATGCTCCTACAATGAGCAGTTCTTC	CASSLGPTRGCSYNEQFF	TRBV5-5	TRBJ2-1
TGTGCCACCAGAGGGACTGAGAATTCACCCCTCCACTTT	CATRGTENSPLHF	TRBV24-1	TRBJ1-6
TGTGCCAGTACATGTTATAGGCCCCGTTTGGTAGCCAAAAACATTCAGTACTTC	CASTCYRPRLVAKNIQYF	TRBV19	TRBJ2-4
TGTGCCAGCAGCTATCCGACAGGGGTCCCGAACACTGAAGCTTTCTTT	CASSYPTGVPNTEAFF	TRBV7-8	TRBJ1-1
TGTGCCACCGAAAATCTAGCGGGGGGCTCCTACAATGAGCAGTTCTTC	CATENLAGGSYNEQFF	TRBV24-1	TRBJ2-1
TGTGCCAGCAGCTCCCGACCATACACAGATACGCAGTATTTT	CASSSRPYTDTQYF	TRBV6-2	TRBJ2-3
TGTGCCAGCAGTCCCCGTCCGGGACAGGGGAAACACGAGCAGTACTTC	CASSPRPGQGKHEQYF	TRBV6-1	TRBJ2-7
TGTGCCAGCAGCGGAGGGCTAACCCTATGGAATCAGCCCCAGCATTTT	CASSGGLTLWNQPQHF	TRBV7-9	TRBJ1-5
TGTGCCAGCAGTTTTAACAGGGGCTGGAGCTCTGGGGCCAACGTCCTGACTTTC	CASSFNRGWSSGANVLTF	TRBV27	TRBJ2-6
TGTGCCAGTAGTATTAGGTTGGAGGGGTTACCCTCTGGAAACACCATATATTTT	CASSIRLEGLPSGNTIYF	TRBV19	TRBJ1-3
TGCGCCAGCAGCCCCATTGCCGGAAGATACGAGCAGTACTTC	CASSPIAGRYEQYF	TRBV5-1	TRBJ2-7
TGCAGTGCACAGGGTTCCTACGAGCAGTACTTC	CSAQGSYEQYF	TRBV20-1	TRBJ2-7
TGTGCCTGGGCCCTGGCAAGCACAGATACGCAGTATTTT	CAWALASTDTQYF	TRBV30	TRBJ2-3
TGTGCCAGCAGCTGGAGCTATCGAGGGGCGACGAGAAACACCATATATTTT	CASSWSYRGATRNTIYF	TRBV13	TRBJ1-3
TGTGCCAGCAGTGAACACCACTCCAAAGGGGACAAATATGAGCAGTTCTTC	CASSEHHSKGDKYEQFF	TRBV2	TRBJ2-1
TGTGCCAGCAGCTTGGGGACTCTGATTTCGATGAGGACGGAAGAGACCCAGTACTTC	CASSLGTLISMRTEETQYF	TRBV5-4	TRBJ2-5
TGTGCCACCCCCGGGGGAACCCTAGCTTTCTTT	CATPGGTLAFF	TRBV28	TRBJ1-1
TGTGCCAGCAGCGTCAGGGGGAACGAGCAGTACTTC	CASSVRGNEQYF	TRBV9	TRBJ2-7
TGTGCCAGCAGCTTAGCCAGTTATCGGACAGGGTCGACGGGCTACACCTTC	CASSLASYRTGSTGYTF	TRBV11-2	TRBJ1-2
TGTGCCAGCAGCCAAGAGAGTCGACAAAGGGGGGGTGGTCCTTGCACAGATACGCAGTATTTT	CASSQESRQRGGGPCTDTQYF	TRBV4-2	TRBJ2-3
TGTGCCAGCTCACCAGGAGGCCCCGGGACAGGGTCTGGGAGCTCCTACAATGAGCAGTTCTTC	CASSPGGPGTGSGSSYNEQFF	TRBV18	TRBJ2-1
TGTGCCACCAGTGATTTGTCGTTAACTAGCGGGAGGGCGACTGAAGCTTTCTTT	CATSDLSLTSGRATEAFF	TRBV24-1	TRBJ1-1
TGCGCCAGCACTGAAATCTACGAGCAGTACTTC	CASTEIYEQYF	TRBV10-1	TRBJ2-7
TGTGCCAGCAGCCAGGGCTCGGGGACGGAAGCTTTCTTT	CASSQGSGTEAFF	TRBV3-1	TRBJ1-1
TGTGCCAGCAGCAGAATTCGGGGGGGCCGGCCCAAAAACATTCAGTACTTC	CASSRIRGGRPKNIQYF	TRBV7-3	TRBJ2-4
TGTGCCAGCAGTGAACAGACCCCCTACAATGAGCAGTTCTTC	CASSEQTPYNEQFF	TRBV25-1	TRBJ2-1
TGTGCCATCAGTGAGGTTGGACGTGAAGCTTTCTTT	CAISEVGREAFF	TRBV10-3	TRBJ1-1
TGCAGTGCTAGTTCGAGGGCACAGGGGAGCAATCAGCCCCAGCATTTT	CSASSRAQGSNQPQHF	TRBV20-1	TRBJ1-5
TGTGCCAGCAGTTCTATTGAGGACGTCTCCTACGAGCAGTACTTC	CASSSIEDVSYEQYF	TRBV7-9	TRBJ2-7
TGTGCCAGCAGTTTTCAGCCCCTCCTCGAGTCTTCACGACGGTCCTACGAGCAGTACTTC	CASSFQPLLESSRRSYEQYF	TRBV12-3	TRBJ2-7
TGCGCCAAGGAAGGGGGTGAGCAGTTCTTC	CAKEGGEQFF	TRBV10-1	TRBJ2-1
TGTGCCAGCAGTCTCAGGGGGGGTGGGAACACTGAAGCTTTCTTT	CASSLRGGGNTEAFF	TRBV9	TRBJ1-1
TGCACAGGGTTGGTCTCCTACGAGCAGTACTTC	CTGLVSYEQYF	TRBV20-1	TRBJ2-7
TGTGCCAGCAGCTTGGCCAAGTTAACTAGCGGGAGGGCGGAAACAGATACGCAGTATTTT	CASSLAKLTSGRAETDTQYF	TRBV5-6	TRBJ2-3
TGTGCCAGCAGTTCTCAGGGGGCGCCTAACTATGGCTACACCTTC	CASSSQGAPNYGYTF	TRBV12-4	TRBJ1-2
TGTGCCAGTAGTATACTGAGTTCGCCAAGCCAAGTGAGGAACACTGAAGCTTTCTTT	CASSILSSPSQVRNTEAFF	TRBV19	TRBJ1-1
TGTGCCAGCAGGCCATTTTTAGCGGGCGGGGGGCAGACCCAGTACTTC	CASRPFLAGGGQTQYF	TRBV6-4	TRBJ2-5
TGTGCCAGCAGCTCCCAGGTATTTACCTACACTGAAGCTTTCTTT	CASSSQVFTYTEAFF	TRBV7-3	TRBJ1-1
TGCGCCAGCAGCTTTACGGGGGGTAGTAACACTGAAGCTTTCTTT	CASSFTGGSNTEAFF	TRBV5-1	TRBJ1-1
TGTGCCAGCAGCTTAGAAGAGGGCCAGGAACTTACTACAGATACGCAGTATTTT	CASSLEEGQELTTDTQYF	TRBV11-2	TRBJ2-3
TGTGCCAGCAGCTTAGTGGACCATACAGGGACAGGAGTCCAGTCCTACGAGCAGTACTTC	CASSLVDHTGTGVQSYEQYF	TRBV7-2	TRBJ2-7
TGTGCCAGCAGCCATCCAGACAGAGGGGGGGGACTGAATCAGCCCCAGCATTTT	CASSHPDRGGGLNQPQHF	TRBV9	TRBJ1-5
TGTGCCACCAGTGATTCATTTGGGGGACGGGACAGAACAGATACGCAGTATTTT	CATSDSFGGRDRTDTQYF	TRBV24-1	TRBJ2-3
TGCGCCAGCAGCTTGCTGGGACAGGGGGGCTACACCTTC	CASSLLGQGGYTF	TRBV4-1	TRBJ1-2
TGTGCCAGCAGCAACGCATTCGTGGGCGAGGGGAAAGGGTCAACTGAAGCTTTCTTT	CASSNAFVGEGKGSTEAFF	TRBV7-3	TRBJ1-1
TGTGCCAGCAGCCGTCGGACAGGGAATCAGCCCCAGCATTTT	CASSRRTGNQPQHF	TRBV13	TRBJ1-5
TGTGCCAGCAGACAGGGGGCCAATGGCTCCTACGAGCAGTACTTC	CASRQGANGSYEQYF	TRBV7-3	TRBJ2-7
TGTGCCATCAGTTCCCCTGGGACAGGGAGTGGAAAATCAGCCAATCAGCCCCAGCATTTT	CAISSPGTGSGKSANQPQHF	TRBV10-3	TRBJ1-5
TGTGCCAGCAGTTTTAGTTCCGGACAGGGGTGCTCTGGAAACACCATATATTTT	CASSFSSGQGCSGNTIYF	TRBV27	TRBJ1-3
TGCGCCAGCAGCTTGCCCGGGGAGCCCTACAATGAGCAGTTCTTC	CASSLPGEPYNEQFF	TRBV5-1	TRBJ2-1
TGTGTCAAACTAGCGGGAGAAGGACTGAGAAACACCATATATTTT	CVKLAGEGLRNTIYF	TRBV9	TRBJ1-3
TGCAGTGCTAGAGTCCCCCGGCACGAATACGAGCAGTACTTC	CSARVPRHEYEQYF	TRBV20-1	TRBJ2-7
TGTGCAGGGGGGGTGAAGGATAGCAATCAGCCCCAGCATTTT	CAGGVKDSNQPQHF	TRBV6-2	TRBJ1-5
TGTGCCAGCAGAGAACTGGAAGGCGAGCAGTACTTC	CASRELEGEQYF	TRBV6-1	TRBJ2-7
TGTGCCAGCAGACCCCAGACTAGCGGGCGGAGCAATGAGCAGTTCTTC	CASRPQTSGRSNEQFF	TRBV5-6	TRBJ2-1
TGCAGCGTTGAGGGGGGGCCGAGGGCCTACGAGCAGTACTTC	CSVEGGPRAYEQYF	TRBV29-1	TRBJ2-7
TGTGCCAGCAGCGGCCCCAGAGGGGTAAACACCATATATTTT	CASSGPRGVNTIYF	TRBV13	TRBJ1-3
TGCGCCAGCAGCTTCCGAGGGGGGGATGTCAATGAGCAGTTCTTC	CASSFRGGDVNEQFF	TRBV5-1	TRBJ2-1
TGTGCCAGCAGAGGCCTAAGGGATTCGGTCTACGAGCAGTACTTC	CASRGLRDSVYEQYF	TRBV6-5	TRBJ2-7
TGTGCCAGCAGTTCGGGGTATGCCGACAGGCGGGTCCACACCGCCGGGGAGCTGTTTTTT	CASSSGYADRRVHTAGELFF	TRBV28	TRBJ2-2
TGTGCCACAAACAGGGAGCAGTTCTTC	CATNREQFF	TRBV6-4	TRBJ2-1
TGTGCCAGCAGTTTTCCCGAGCGGGATGGGCAGCAGTATTTT	CASSFPERDGQQYF	TRBV27	TRBJ2-3
TGCGCCAGCAGCCATCTACAGGGGCACCTGTACAATGAGCAGTTCTTC	CASSHLQGHLYNEQFF	TRBV4-1	TRBJ2-1
TGTGCCAGCAGCTCCGGCTTCCGAGGTCAGACCCAGTACTTC	CASSSGFRGQTQYF	TRBV7-4	TRBJ2-5
TGCGAGGGCAATGAGCAGTTCTTC	CEGNEQFF	TRBV29-1	TRBJ2-1
TGCAGCGTTGGGGTTCAGGGTACAACTAATGAAAAACTGTTTTTT	CSVGVQGTTNEKLFF	TRBV29-1	TRBJ1-4
TGTGCCAGCAGCCCGTACGGACAGGCTACTGAAGCTTTCTTT	CASSPYGQATEAFF	TRBV13	TRBJ1-1
TGTGCCAGCCCGCCCCAGGCCTACGAGCAGTACTTC	CASPPQAYEQYF	TRBV9	TRBJ2-7
TGTGCCAGCAGGGAATGTGGTCATTGGCCCGGGACGCCCTACGAGCAGTACTTC	CASRECGHWPGTPYEQYF	TRBV6-5	TRBJ2-7
TGTGCGCCGGGACAGGGTAATGAAAAACTGTTTTTT	CAPGQGNEKLFF	TRBV9	TRBJ1-4
TGTGCCAGCAGCTCCAGGCCTGGGGGCCGGTCCTCCTACGAGCAGTACTTC	CASSSRPGGRSSYEQYF	TRBV11-2	TRBJ2-7
TGTGCCAGCAGCTTAGATCTGGAACGTAGCGGGCAGTGCCAAGAGACCCAGTACTTC	CASSLDLERSGQCQETQYF	TRBV7-2	TRBJ2-5
TGTGCCAGCTCACCCCTTGGGGGTCAAGGAGGGACGAATCAGACCCAGTACTTC	CASSPLGGQGGTNQTQYF	TRBV18	TRBJ2-5
TGCAGTGCTAGGGGGGACCCGGGACAGGGGGCCGAATCCCCCTATAATTCACCCCTCCACTTT	CSARGDPGQGAESPYNSPLHF	TRBV20-1	TRBJ1-6
TGCAGTGCTAGAGATGCTCGAGGGCATGAGCAGTTCTTC	CSARDARGHEQFF	TRBV20-1	TRBJ2-1
TGTGCCAGCAGCGCACGAACAGGGGGACGGTTCGGCAATCAGCCCCAGCATTTT	CASSARTGGRFGNQPQHF	TRBV9	TRBJ1-5
TGCGCCAGCAGAGGGGGGCTAGCCAAAAACATTCAGTACTTC	CASRGGLAKNIQYF	TRBV10-1	TRBJ2-4
TGCAGCGTTTGGGTACAAGGGTGTCGTGCAACTAATGAAAAACTGTTTTTT	CSVWVQGCRATNEKLFF	TRBV29-1	TRBJ1-4
TGTGCTGGACAGGGCATCCCGTCCTACGAGCAGTACTTC	CAGQGIPSYEQYF	TRBV5-6	TRBJ2-7
TGTGCCAGCAGCCACAACCTAGCGGGTTGCTACGAGCAGTACTTC	CASSHNLAGCYEQYF	TRBV3-1	TRBJ2-7
TGTGCCAGCAGTCCGACCCAGGACACCTACGAGCAGTACTTC	CASSPTQDTYEQYF	TRBV3-1	TRBJ2-7
TGTGCCAGCAGTCAAAACAGGTCGCTAGCGGGGCATGAGCAGTTCTTC	CASSQNRSLAGHEQFF	TRBV27	TRBJ2-1
TGTGCCAGCAGTGAAGGAGGCAGGGAGGGAGGGGTTATGAACACTGAAGCTTTCTTT	CASSEGGREGGVMNTEAFF	TRBV28	TRBJ1-1
TGTGCCAGCAGTTACAAAGAGGGGGCGCGGAAGGATGAGCAGTTCTTC	CASSYKEGARKDEQFF	TRBV6-6	TRBJ2-1
TGTGCCAGCAGTAGAGACAGGGCCCGCTACGAGCAGTACTTC	CASSRDRARYEQYF	TRBV6-1	TRBJ2-7
TGTGCTAGCAGCTTAGCAGGGACAGGGGATAGCCCCAACACTGAAGCTTTCTTT	CASSLAGTGDSPNTEAFF	TRBV7-7	TRBJ1-1
TGTGCCAGCGATTCGTTACCATACGAGCAGTACTTC	CASDSLPYEQYF	TRBV27	TRBJ2-7
TGTGCCAGCAGCTCGGGGTTAGGCTCTGGAAACACCATATATTTT	CASSSGLGSGNTIYF	TRBV11-3	TRBJ1-3
TGTGCCAGAACCGGCGGCTACAATGAGCAGTTCTTC	CARTGGYNEQFF	TRBV5-5	TRBJ2-1
TGCGCCAGCAGCCAAGCCAGAAGGGCAGATTTTTTGGCGAACACTGAAGCTTTCTTT	CASSQARRADFLANTEAFF	TRBV4-1	TRBJ1-1
TGTGCCAGCAGCCAAGACGACAGGGATACTGAAGCTTTCTTT	CASSQDDRDTEAFF	TRBV3-1	TRBJ1-1
TGTGCCACCAGTATGGCGCTCTATGAGCAGTTCTTC	CATSMALYEQFF	TRBV24-1	TRBJ2-1
TGTGCCCAGGAAGGGACTAGCGGGGGACCGTCCTACGAGCAGTACTTC	CAQEGTSGGPSYEQYF	TRBV10-3	TRBJ2-7
TGCAGTGCTAGGGGGCGGCGGGAGTTAGTGACCTACGAGCAGTACTTC	CSARGRRELVTYEQYF	TRBV20-1	TRBJ2-7
TGCAGTGCTAGCGACTCTTTCAGAACTTACCACGAGCAGTACTTC	CSASDSFRTYHEQYF	TRBV20-1	TRBJ2-7
TGTGCCAGCAGCTTTGCACAGTCGGCAGATACGCAGTATTTT	CASSFAQSADTQYF	TRBV7-7	TRBJ2-3
TGTGCCAGCAGCGCGGGGGAATACACAGATACGCAGTATTTT	CASSAGEYTDTQYF	TRBV13	TRBJ2-3
TGTGCCAGCAGTGCAAACACAGGGCTAGGGCACTATGGCTACACCTTC	CASSANTGLGHYGYTF	TRBV6-6	TRBJ1-2
TGTGCCAGCAGCTTGGTCCCGACCCGAAAACTGTTTTTT	CASSLVPTRKLFF	TRBV7-3	TRBJ1-4
TGCAGTGCTAGGTTCGCAGGGTATGGCTACACCTTC	CSARFAGYGYTF	TRBV20-1	TRBJ1-2
TGCAGTGCGGAGTACAGGGACAGGGGTGGCTACACCTTC	CSAEYRDRGGYTF	TRBV20-1	TRBJ1-2
TGTGCCACCAGTGATTACGCAGGGATTGGGACGCACAACACTGAAGCTTTCTTT	CATSDYAGIGTHNTEAFF	TRBV24-1	TRBJ1-1
TGTGCCAGCAGTTGTTGGAGGAGACAGAGCAATCAGCCCCAGCATTTT	CASSCWRRQSNQPQHF	TRBV27	TRBJ1-5
TGTGCCAGCAGTGACGATGGGGGCGATGGGAACTATGGCTACACCTTC	CASSDDGGDGNYGYTF	TRBV25-1	TRBJ1-2
TGTGCCAGCAGGGGAATATCTAACTATGGCTACACCTTC	CASRGISNYGYTF	TRBV25-1	TRBJ1-2
TGTGCCAGCAAGTCTCGAACCCCTTTTGAGCAGTTCTTC	CASKSRTPFEQFF	TRBV25-1	TRBJ2-1
TGTGCCAGCAGCTTAAGCCGGGACCGTGGGGGCGAGACCCAGTACTTC	CASSLSRDRGGETQYF	TRBV7-6	TRBJ2-5
TGCGCCAGCAGCCCATTGTTAGAAGACAGGGAAGGAGACGAGCAGTACTTC	CASSPLLEDREGDEQYF	TRBV4-3	TRBJ2-7
TGTGCCAGCAGCCGGGCCCCCGACAGGGGGAATGTTGAAGCTTTCTTT	CASSRAPDRGNVEAFF	TRBV4-2	TRBJ1-1
TGTGCCAGCAACTGGAGGGGGGTGAACACTGAAGCTTTCTTT	CASNWRGVNTEAFF	TRBV7-7	TRBJ1-1
TGTGCCAGCAATAGGGACAACTATGGCTACACCTTC	CASNRDNYGYTF	TRBV7-2	TRBJ1-2
TGCAGTGCTAGAGATCGCAAGGCCGAGACAGGACCCATCCACGAGCAGTACTTC	CSARDRKAETGPIHEQYF	TRBV20-1	TRBJ2-7
TGCGCTTCCGGACAATGGGAGGCCAGCTCTGGAAACACCATATATTTT	CASGQWEASSGNTIYF	TRBV10-2	TRBJ1-3
TGCAGCGGAGGGGGGCTCCTCATAGAGACCCAGTACTTC	CSGGGLLIETQYF	TRBV29-1	TRBJ2-5
TGTGCCAGCAGTTTATCGCTTTTACAGGGTTGCAATCAGCCCCAGCATTTT	CASSLSLLQGCNQPQHF	TRBV27	TRBJ1-5
TGCTTGCAGTACTTC	CLQYF	TRBV20-1	TRBJ2-5
TGTGGGCTATATAGCAATCAGCCCCAGCATTTT	CGLYSNQPQHF	TRBV11-3	TRBJ1-5
TGTGCCAGCAGCTTCGGAAACCGGAGGGGACTCTCTGGGGCCAACGTCCTGACTTTC	CASSFGNRRGLSGANVLTF	TRBV9	TRBJ2-6
TGCAGCGTTTCTAATAGATATAAGACTAACACCATATATTTT	CSVSNRYKTNTIYF	TRBV29-1	TRBJ1-3
TGTGCCAGCAGTACCGGAGGAAAGTCCTATAATTCACCCCTCCACTTT	CASSTGGKSYNSPLHF	TRBV6-4	TRBJ1-6
TGCAGTGCTAGAGCAAGTGGACCGCACTATGGCTACACCTTC	CSARASGPHYGYTF	TRBV20-1	TRBJ1-2
TGTGCCACCCGGTCGGCGGTGAACACTGAAGCTTTCTTT	CATRSAVNTEAFF	TRBV24-1	TRBJ1-1
TGTGCCAGCAGTTCCCGGGACAGGGCCTCTGCAGCTTTCTTT	CASSSRDRASAAFF	TRBV27	TRBJ1-1
TGTGCCAGCAGCGCGCGGGATTCGAGCTACGAGCAGTACTTC	CASSARDSSYEQYF	TRBV9	TRBJ2-7
TGTGCCAGCAGTGCAGCGACAGAGATGGCAACCCAGTACTTC	CASSAATEMATQYF	TRBV12-3	TRBJ2-5
TGTGCCAGCAGCGGCAGGACAGGGGGAACTGACATTCAGTACTTC	CASSGRTGGTDIQYF	TRBV9	TRBJ2-4
TGTGCCAGCAGCGCGGGACAGGGACAAGAGACCCAGTACTTC	CASSAGQGQETQYF	TRBV7-3	TRBJ2-5
TGTGCCAGCAGCGTTGGGACCGGGGGGTATAATTCACCCCTCCACTTT	CASSVGTGGYNSPLHF	TRBV7-9	TRBJ1-6
TGCGCCAGCAGCTTGGTTTACATCCCTGGACAGGGTGTCCAAGAGACCCAGTACTTC	CASSLVYIPGQGVQETQYF	TRBV5-1	TRBJ2-5
TGTGCCACCAGCAGGGGGCAGGGGACCCAGTACTTC	CATSRGQGTQYF	TRBV15	TRBJ2-5
TGTGCTAGCAGCTTAGCACAGCGACTTGTTTGGTTGCAAGAGACCCAGTACTTC	CASSLAQRLVWLQETQYF	TRBV7-7	TRBJ2-5
TGCGCCAGCAGCTTGACCAGCGGTTATTACGAGCAGTACTTC	CASSLTSGYYEQYF	TRBV5-1	TRBJ2-7
TGCGCCAGCAGCTTGGACGACAGGGGCCCCTACGAGCAGTACTTC	CASSLDDRGPYEQYF	TRBV5-1	TRBJ2-7
TGCAGTGCTAGAGGGGGCATCAACACTGAAGCTTTCTTT	CSARGGINTEAFF	TRBV20-1	TRBJ1-1
TGTGCCAGCATCCGGACAGGGGACCCTAACAATGAGCAGTTCTTC	CASIRTGDPNNEQFF	TRBV6-1	TRBJ2-1
TGTGCCAGCAGTGAAGTTCGGGACAGGAACACTGAAGCTTTCTTT	CASSEVRDRNTEAFF	TRBV6-1	TRBJ1-1
TGTGCCAGCAGCTTAGGCCTCCAGGCGAGCTCCTACGAGCAGTACTTC	CASSLGLQASSYEQYF	TRBV11-3	TRBJ2-7
TGTGCCAGCAGCTTAACGGGGTTGGTCGGCGGCAAAAACATTCAGTACTTC	CASSLTGLVGGKNIQYF	TRBV7-2	TRBJ2-4
TGTGCCAGCAGCCCCGGGATGGCCCGGACAGACGATGACGAGCAGTACTTC	CASSPGMARTDDDEQYF	TRBV3-1	TRBJ2-7
TGTGCCAGCAGTATGTGGGAACCCCCACAGTATCAGCCCCAGCATTTT	CASSMWEPPQYQPQHF	TRBV27	TRBJ1-5
TGTGCCAGCAGCCCCCGGACAGGGGACGAGCAGTACTTC	CASSPRTGDEQYF	TRBV7-8	TRBJ2-7
TGTGCTAGTGGTCAGGACTACAATGAGCAGTTCTTC	CASGQDYNEQFF	TRBV12-5	TRBJ2-1
TGCGCCAGCATAACGGACAGTAGTGACACCGGGGAGCTGTTTTTT	CASITDSSDTGELFF	TRBV5-1	TRBJ2-2
TGTGCCAGCAGAAGCCAACCTGGGCCCTACAATCAGCCCCAGCATTTT	CASRSQPGPYNQPQHF	TRBV6-1	TRBJ1-5
TGTGCCAGCAGTTACTCGCCCACGGGACAGTTACGAGGCTACACCTTC	CASSYSPTGQLRGYTF	TRBV6-8	TRBJ1-2
TGTGCCAGTAGTATACACACGAGGGTCCGGGCTAGCACAGATACGCAGTATTTT	CASSIHTRVRASTDTQYF	TRBV19	TRBJ2-3
TGTGCCACCAGTGAACATAAGGGAGCCCAGCATTTT	CATSEHKGAQHF	TRBV24-1	TRBJ1-5
TGTGCCAGCAGCGGCTCGAGGTTCACCTACGAGCAGTACTTC	CASSGSRFTYEQYF	TRBV7-3	TRBJ2-7
TGTGCCAGCAGCACCGAGGGCGCGGGTGATGAGCAGTTCTTC	CASSTEGAGDEQFF	TRBV3-1	TRBJ2-1
TGTGCCACCAGTGATAACCGCCGGGACAGTGTATTTCGAGAATTTTACGAGCAGTACTTC	CATSDNRRDSVFREFYEQYF	TRBV24-1	TRBJ2-7
TGCGCCAGCAGCCAAGAGTTCGGGGGACAGGGGGGAAATGAGCAGTTCTTC	CASSQEFGGQGGNEQFF	TRBV4-1	TRBJ2-1
TGTGCCAGTAGAAGTCCAGGGAGCTATAATTCACCCCTCCACTTT	CASRSPGSYNSPLHF	TRBV19	TRBJ1-6
TGTGCCAGCAGCGACACTAGCGGGAGGGGCACAGATACGCAGTATTTT	CASSDTSGRGTDTQYF	TRBV9	TRBJ2-3
TGTGCCAGGAACCACCGGGGACCCGACACTGAAGCTTTCTTT	CARNHRGPDTEAFF	TRBV2	TRBJ1-1
TGTGCCAGCAGTTACTCGAGGGGGTCCTATGGCTACACCTTC	CASSYSRGSYGYTF	TRBV6-5	TRBJ1-2
TGTGCCAGCAGTGACTCGATTCGGGACAGGGGCGAGGCGACCTACGAGCAGTACTTC	CASSDSIRDRGEATYEQYF	TRBV6-4	TRBJ2-7
TGTGCCAGCAGTGGAGGTAGCAGGGAGGCGCCACAGCCCCAGCATTTT	CASSGGSREAPQPQHF	TRBV12-4	TRBJ1-5
TGTGCCAAAAGGAAAAAGGGGGGGGAGGGTGGCTACACCTTC	CAKRKKGGEGGYTF	TRBV13	TRBJ1-2
TGTGCCAGCAGTTTTCGCGACAGCCAAGGGAGGTTGAACACTGAAGCTTTCTTT	CASSFRDSQGRLNTEAFF	TRBV6-5	TRBJ1-1
TGTGCCAGCAGCCCAGCAGCCCGACAGGGGCATGGCTACACCTTC	CASSPAARQGHGYTF	TRBV7-3	TRBJ1-2
TGTGCCACGCCGGTATCCTACGAGCAGTACTTC	CATPVSYEQYF	TRBV7-9	TRBJ2-7
TGTGCCAGCAGTTTGGGCACTAGCGGGTACAATGAGCAGTTCTTC	CASSLGTSGYNEQFF	TRBV27	TRBJ2-1
TGCGCCAGCAGCCAAGGGCCCCGCCACTCTGCGAATGAAAAACTGTTTTTT	CASSQGPRHSANEKLFF	TRBV4-1	TRBJ1-4
TGTGCCAGCAGCAGGGACGGACCGACAAATGAAAAACTGTTTTTT	CASSRDGPTNEKLFF	TRBV13	TRBJ1-4
TGTGCCAGCAGTTACGCCGCCGGGACAGCCCGGAAACTCCCTAGAGGGTATAATTCACCCCTCCACTTT	CASSYAAGTARKLPRGYNSPLHF	TRBV6-3	TRBJ1-6
TGTGCCAGCAGAACCTCCACTAGCGGGCGTTATGATGAGCAGTTCTTC	CASRTSTSGRYDEQFF	TRBV7-6	TRBJ2-1
TGCGCCAGCAGTGAGCCCCCGCCGCAGGGGGCGGCAGGCGGCTACACCTTC	CASSEPPPQGAAGGYTF	TRBV10-1	TRBJ1-2
TGCAGTGCTAGTCGCGGGACAGGGACCTACGAGCAGTACTTC	CSASRGTGTYEQYF	TRBV20-1	TRBJ2-7
TGCGCCAGCACCCTCCACCCATTGGGGGACAGGGGACCCGTTGCTTTCTTT	CASTLHPLGDRGPVAFF	TRBV5-1	TRBJ1-1
TGCAGCGTTGAAGATACGGAGGAGAACAATGAGCAGTTCTTC	CSVEDTEENNEQFF	TRBV29-1	TRBJ2-1
TGTGCCAGCAGCTTAATACGGGAGGGTCATAAATATAATTCACCCCTCCACTTT	CASSLIREGHKYNSPLHF	TRBV11-2	TRBJ1-6
TGTGCCAGCAGCTTATCCTACAGGGAGGGTAGCAATCAGCCCCAGCATTTT	CASSLSYREGSNQPQHF	TRBV9	TRBJ1-5
TGTGCCAGCAGGAGGGTCGACCAGACAGATACGCAGTATTTT	CASRRVDQTDTQYF	TRBV6-5	TRBJ2-3
TGTGCCTGGAGCCAGACCCCAGGGCCGGAGCAGTTCTTC	CAWSQTPGPEQFF	TRBV30	TRBJ2-1
TGTGCCGTAAAGGGGGCTCCTGGAAACACCATATATTTT	CAVKGAPGNTIYF	TRBV6-1	TRBJ1-3
TGCGCCAGCAGCTCGGCCCTAATCTATCAGAATGAAGCTTTCTTT	CASSSALIYQNEAFF	TRBV5-1	TRBJ1-1
TGTGCCAGCAGAAGGACCGAGCAGTACTTC	CASRRTEQYF	TRBV6-1	TRBJ2-7
TGTGCCAGCAGTTACAAGGGGGTCCACAATGAGCAGTTCTTC	CASSYKGVHNEQFF	TRBV6-5	TRBJ2-1
TGTGCCAGTAGTATGGGGGGGGAAAGGGAGGCCAATGGCTACACCTTC	CASSMGGEREANGYTF	TRBV19	TRBJ1-2
TGTGCCAGCAGCTTAGGAAGTAACCCCGGACATCCAGAAGCTTTCTTT	CASSLGSNPGHPEAFF	TRBV7-2	TRBJ1-1
TGTGCCAGCAGCGATGACAGGGGAACTGGAAACACCATATATTTT	CASSDDRGTGNTIYF	TRBV13	TRBJ1-3
TGTGCCAGCAGCTGGTACCCCTACAGGGTCTCTGGAAACACCATATATTTT	CASSWYPYRVSGNTIYF	TRBV25-1	TRBJ1-3
TGTGCCAGCAGTCAGACAGATTACTATGGCTACACCTTC	CASSQTDYYGYTF	TRBV6-1	TRBJ1-2
TGTGCCAGCTCACCACCTTCGGGGGGGCATTGCGAGCAGTACTTC	CASSPPSGGHCEQYF	TRBV18	TRBJ2-7
TGTGCCAGCAGTTACTCCCCGGGGGCCTATGGCTACACCTTC	CASSYSPGAYGYTF	TRBV6-5	TRBJ1-2
TGTGCCAGCACATTCAGCAACGAGCAGTACTTC	CASTFSNEQYF	TRBV7-3	TRBJ2-7
TGTGCCAGCAGCGTACTAAACGAGCAGTACTTC	CASSVLNEQYF	TRBV7-6	TRBJ2-7
TGTGCCAGCCCAGAGCGGGAGAAGAATCAGCCCCAGCATTTT	CASPEREKNQPQHF	TRBV6-5	TRBJ1-5
TGTGCCAGCATCCGTCGTCATGGACAGGGTGGGAAGGAGACCCAGTACTTC	CASIRRHGQGGKETQYF	TRBV6-5	TRBJ2-5
TGTGCTAGTATGGAGGCTAAGGACGAGCAGTACTTC	CASMEAKDEQYF	TRBV12-5	TRBJ2-7
TGCAGTGCTAGAGATCGAGAGGGACATAGGAACTATGGCTACACCTTC	CSARDREGHRNYGYTF	TRBV20-1	TRBJ1-2
TGTGCCAGCAGCGGAGGGGTGTGGAATGAAAAACTGTTTTTT	CASSGGVWNEKLFF	TRBV13	TRBJ1-4
TGTGCCACCAGTTGGACTAGCGGGGGCTCTGCTAGCACAGATACGCAGTATTTT	CATSWTSGGSASTDTQYF	TRBV24-1	TRBJ2-3
TGTGCCAGCAAAGGGGACAAGGCTAGCAATCAGCCCCAGCATTTT	CASKGDKASNQPQHF	TRBV9	TRBJ1-5
TGTGCCAGCCCACTGGGGGGGCCGGACTCCTACAATGAGCAGTTCTTC	CASPLGGPDSYNEQFF	TRBV19	TRBJ2-1
TGTGCCAGCGGGACAGGGGGAACTAACTATGGCTACACCTTC	CASGTGGTNYGYTF	TRBV27	TRBJ1-2
TGTGGCGGGCAGAATGGAAACTATGGCTACACCTTC	CGGQNGNYGYTF	TRBV18	TRBJ1-2
TGTGCCAGCGGGTTCCAGGGGAGAGGGGAGACCCAGTACTTC	CASGFQGRGETQYF	TRBV2	TRBJ2-5
TGTGCCAGCAGTTACAGTACCACAGGAATTTTGGTTCAGCCCCAGCATTTT	CASSYSTTGILVQPQHF	TRBV6-5	TRBJ1-5
TGTGCCATCACCGGGACTAGCGGAAAAGGGCTAAAACGATGCTACGAGCAGTACTTC	CAITGTSGKGLKRCYEQYF	TRBV10-3	TRBJ2-7
TGTGCCAGCAGTGACAGGGCCAGGGAGACCCAGTACTTC	CASSDRARETQYF	TRBV6-4	TRBJ2-5
TGCGCCAGCAGCTTGACACAGGGGGCCTACGAGCAGTACTTC	CASSLTQGAYEQYF	TRBV5-1	TRBJ2-7
TGTGCCAGCAGTACGGGGGGCGGGAGCAATCAGCCCCAGCATTTT	CASSTGGGSNQPQHF	TRBV6-2	TRBJ1-5
TGCAGTGCTATGAGGACTCGGCAAGAGACCCAGTACTTC	CSAMRTRQETQYF	TRBV20-1	TRBJ2-5
TGTGCCAGCAGCTTAGCCGGGTATCTAGCGGGAGGAGATTCACCCCTCCACTTT	CASSLAGYLAGGDSPLHF	TRBV13	TRBJ1-6
TGTGCCAGCACAGGGGGGATATTGGGGGGAGGCAATCAGCCCCAGCATTTT	CASTGGILGGGNQPQHF	TRBV28	TRBJ1-5
TGCGCCAGCAGCTTGGGAGGGGGGCGGAGGGGTGAGACCCAGTACTTC	CASSLGGGRRGETQYF	TRBV5-1	TRBJ2-5
TGTGCCAGCAGTATTGACACCTACGAGCAGTACTTC	CASSIDTYEQYF	TRBV6-5	TRBJ2-7
TGTGCCAGCAGCGGGGGCGGGGGAAACACCATATATTTT	CASSGGGGNTIYF	TRBV6-4	TRBJ1-3
TGCAGCGTTGAAGATTACTTCACCCGCGGCACTCATGAGCAGTTCTTC	CSVEDYFTRGTHEQFF	TRBV29-1	TRBJ2-1
TGTGCCATCAGGGGGGGACAGGGGTCGCGCGTCTCCTACGAGCAGTACTTC	CAIRGGQGSRVSYEQYF	TRBV10-3	TRBJ2-7
TGTGCCAGCAGTACCGTGATCTCGGACAGGTCCTCTGGGGCCAACGTCCTGACTTTC	CASSTVISDRSSGANVLTF	TRBV6-5	TRBJ2-6
TGTGCCAGCAGCTTCCCTCGAACCGGGGAGCTGTTTTTT	CASSFPRTGELFF	TRBV7-9	TRBJ2-2
TGTGCCAGCATCGCGGGAGCTTTTAATAACGAGCAGTACTTC	CASIAGAFNNEQYF	TRBV6-5	TRBJ2-7
TGTGCCAGCTCACCACAGCCATTCCTTATCGGGGAGCTGTTTTTT	CASSPQPFLIGELFF	TRBV18	TRBJ2-2
TGTGCCAGCAGCGCGGGACAGGGAGAAGACTACAATGAGCAGTTCTTC	CASSAGQGEDYNEQFF	TRBV9	TRBJ2-1
TGTGCCAGCAGCCAAGAAAAGATGAGCGGGACTCTATTAGAGACCCAGTACTTC	CASSQEKMSGTLLETQYF	TRBV3-1	TRBJ2-5
TGCAGTGCTGCAATTCCAGGGACATATGAGCAGTTCTTC	CSAAIPGTYEQFF	TRBV20-1	TRBJ2-1
TGTGCCCTCTGCCACAGGGGTCGTTGGCCTAATGAAAAACTGTTTTTT	CALCHRGRWPNEKLFF	TRBV12-3	TRBJ1-4
TGTGCCAGCAGGCGGGGGGAGACCTACTACGAGCAGTACTTC	CASRRGETYYEQYF	TRBV7-6	TRBJ2-7
TGTGCCAGCAGAGGACAGGGATTTCGCATGAACACTGAAGCTTTCTTT	CASRGQGFRMNTEAFF	TRBV11-2	TRBJ1-1
TGTGCCAGCAGCCAGACAGCAGAGGGGACGATCTACGAGCAGTACTTC	CASSQTAEGTIYEQYF	TRBV14	TRBJ2-7
TGTGCCAGCAGCCCATCCGGACAGGGCTCCTACAATGAGCAGTTCTTC	CASSPSGQGSYNEQFF	TRBV9	TRBJ2-1
TGCGCCAGCAGCCAAGCCCGCTCGGGACGTGAAGTTGTTAGCAATCAGCCCCAGCATTTT	CASSQARSGREVVSNQPQHF	TRBV4-3	TRBJ1-5
TGTGCCAGCAGTTTGTCCGGGACATCCTACGAGCAGTACTTC	CASSLSGTSYEQYF	TRBV12-3	TRBJ2-7
TGTGCCAGCAGCCGCCAGACGGTGGCAGATACGCAGTATTTT	CASSRQTVADTQYF	TRBV9	TRBJ2-3
TGTGCCAGCAGCTTAAGATCATATCAGCCCCAGCATTTT	CASSLRSYQPQHF	TRBV5-4	TRBJ1-5
TGTGCCAGCCTGGGGGGGTGGAATTCACCCCTCCACTTT	CASLGGWNSPLHF	TRBV6-4	TRBJ1-6
TGTGCCAGCAGCTTAGAAGGCAGTTGCTACTACAATGAGCAGTTCTTC	CASSLEGSCYYNEQFF	TRBV7-8	TRBJ2-1
TGTGCCAGCAGTGACCCCGGGACAGGGGACCCGGGTGAAAAACTGTTTTTT	CASSDPGTGDPGEKLFF	TRBV6-4	TRBJ1-4
TGTGCCAGCAGCGATTCGGGGGAAGGGAATCAGCCCCAGCATTTT	CASSDSGEGNQPQHF	TRBV9	TRBJ1-5
TGTGCCAGCAGCTTAAACATAGCGGGCTTCTACGAGCAGTACTTC	CASSLNIAGFYEQYF	TRBV11-2	TRBJ2-7
TGTGCCAGCAAGGAAACAGGGGGGAAACTGTTTTTT	CASKETGGKLFF	TRBV6-5	TRBJ1-4
TGTGCCAGCAGTCCGGACACCAATCTGCCCGGCAATCAGCCCCAGCATTTT	CASSPDTNLPGNQPQHF	TRBV6-1	TRBJ1-5
TGTGCCAGCAGTCCCGACAGGTATGGCTACACCTTC	CASSPDRYGYTF	TRBV12-3	TRBJ1-2
TGTGCCAGCAGCCGAAAAGGACAGAATGGACAAGAGACCCAGTACTTC	CASSRKGQNGQETQYF	TRBV3-1	TRBJ2-5
TGTGCCAGCAGCTTAAGAACTAGCGGCGTAAGCTCCTACGAGCAGTACTTC	CASSLRTSGVSSYEQYF	TRBV11-2	TRBJ2-7
TGTGCCAGCAGCTTACCTGTTGCCTACGAGCAGTACTTC	CASSLPVAYEQYF	TRBV11-3	TRBJ2-7
TGTGCCAGTAGGATGTATGGCTACACCTTC	CASRMYGYTF	TRBV19	TRBJ1-2
TGTGCCAGCAGCAACCAAGCACCACAGGGCCCCATTAGGTACGAGCAGTACTTC	CASSNQAPQGPIRYEQYF	TRBV7-8	TRBJ2-7
TGTGCCAGCGCCCCACTAGCGGGAGTCGGGTTTTTGTACTACGAGCAGTACTTC	CASAPLAGVGFLYYEQYF	TRBV7-4	TRBJ2-7
TGTGCCAGCAGCCAGGGCAGGGGAAGGTACCTAGAGCAGTACTTC	CASSQGRGRYLEQYF	TRBV5-4	TRBJ2-7
TGTGCCAGCAGTGATAGACAGTGGTTGGTCTACAATGAGCAGTTCTTC	CASSDRQWLVYNEQFF	TRBV18	TRBJ2-1
TGTGCCAGCAGCTTCCCTACAGGGATTTATCAGCCCCAGCATTTT	CASSFPTGIYQPQHF	TRBV11-3	TRBJ1-5
TGCAGTGCTAGTGGTTACAAAGGACATTTAGACACTGAAGCTTTCTTT	CSASGYKGHLDTEAFF	TRBV20-1	TRBJ1-1
TGCAGTGCTGGCGGGGGCGACTCCGCTGAAGCTTTCTTT	CSAGGGDSAEAFF	TRBV20-1	TRBJ1-1
TGTGCCAGTTCGGAAGGTGCCTATGGCTACACCTTC	CASSEGAYGYTF	TRBV19	TRBJ1-2
TGTGCCAGAAAAACTAGCGGGGGGGCAAGTTTCGAGCAGTACTTC	CARKTSGGASFEQYF	TRBV6-6	TRBJ2-7
TGTGCCAGCAGCGTAGTGCACTGGCCTGGAGGAGATCTCTACGAGCAGTACTTC	CASSVVHWPGGDLYEQYF	TRBV9	TRBJ2-7
TGTGCCAGCAGCACTGCGCAGCCCCAGCATTTT	CASSTAQPQHF	TRBV13	TRBJ1-5
TGTGCCAGCAGTGAACGGGCCAGTGACAATGAGCAGTTCTTC	CASSERASDNEQFF	TRBV2	TRBJ2-1
TGTGCCAGCAGCGCGACAGGTGGTTATAATTCACCCCTCCACTTT	CASSATGGYNSPLHF	TRBV13	TRBJ1-6
TGTGCCAGCTCACGAGGGGGTACTGAAGCTTTCTTT	CASSRGGTEAFF	TRBV18	TRBJ1-1
TGTGCCAGCAGCTTTCCCTTAGGGCGACCCGGTAATGAGCAGTTCTTC	CASSFPLGRPGNEQFF	TRBV7-6	TRBJ2-1
TGTGCCAGCAGCCCACAGGGCCTGGCGGACACCATATATTTT	CASSPQGLADTIYF	TRBV7-9	TRBJ1-3
TGTGCCAGCAGCGAGCGGACTAGCTCCTACGAGCAGTACTTC	CASSERTSSYEQYF	TRBV9	TRBJ2-7
TGTGCCAGCATAGTCTTCCCAGGGGGCGGGAGCATGAACACTGAAGCTTTCTTT	CASIVFPGGGSMNTEAFF	TRBV27	TRBJ1-1
TGTGCCAGCAGCCAAGATGGACAGGTTCACAATGAGCAGTTCTTC	CASSQDGQVHNEQFF	TRBV3-1	TRBJ2-1
TGTGCCAGCAGCGTCCGACAGGGGGCACGGACCTACGAGCAGTACTTC	CASSVRQGARTYEQYF	TRBV5-6	TRBJ2-7
TGTGCCAGCAAAAATGGCTTAGGGATCCTCGCGGGGGAGCTGTTTTTT	CASKNGLGILAGELFF	TRBV6-1	TRBJ2-2
TGTGCCAGCAGTGAGGGGACAGAGGTATGCTCCTACGAGCAGTACTTC	CASSEGTEVCSYEQYF	TRBV6-5	TRBJ2-7
TGTGCCAGCAGCCGTCAGGGTAAGACCCAGTACTTC	CASSRQGKTQYF	TRBV13	TRBJ2-5
TGTGCCAGCAGCTTAGATCCGAGAACTCCGGGACAGGGTCCCTATAATTCACCCCTCCACTTT	CASSLDPRTPGQGPYNSPLHF	TRBV11-2	TRBJ1-6
TGTGCCAGTAGAGGACTAGTAAGGGGGCGAAACGAGCAGTACTTC	CASRGLVRGRNEQYF	TRBV12-3	TRBJ2-7
TGTGCCAGCGTATACCAGGGGAACACTGAAGCTTTCTTT	CASVYQGNTEAFF	TRBV2	TRBJ1-1
TGTGCCAGCAGCTTAGACAGGCCGAGGAGGGGAGATGGCTACACCTTC	CASSLDRPRRGDGYTF	TRBV7-3	TRBJ1-2
TGCAGTGCTAGAGGGGCGGGAGAGAGCTCTGGAAACACCATATATTTT	CSARGAGESSGNTIYF	TRBV20-1	TRBJ1-3
TGTGCCAGCTCACCTAAACACACTGAAGCTTTCTTT	CASSPKHTEAFF	TRBV18	TRBJ1-1
TGTGCCAGCAGTGTTTCCGGGGGTACTAACTATGGCTACACCTTC	CASSVSGGTNYGYTF	TRBV7-9	TRBJ1-2
TGTGCCAGCAAAAGTGACTGGATGAACACCGGGGAGCTGTTTTTT	CASKSDWMNTGELFF	TRBV6-6	TRBJ2-2
TGTGCCGAGGACAGCCCGGAAGCTTTCTTT	CAEDSPEAFF	TRBV24-1	TRBJ1-1
TGTGCCAGCATCCTTCCGGGACAGGGGGAAGATACGCAGTATTTT	CASILPGQGEDTQYF	TRBV6-1	TRBJ2-3
TGTGCCAGCAGCCAAGCGCCGATTTTACGACAGTTCTCTGGGGCCAACGTCCTGACTTTC	CASSQAPILRQFSGANVLTF	TRBV14	TRBJ2-6
TGTGCCAGCAGCGTCCTTTCCTACGAGCAGTACTTC	CASSVLSYEQYF	TRBV11-3	TRBJ2-7
TGTGCCAGCAGCTTAGACCCGGATGGGGGGGACCATAGCAATCAGCCCCAGCATTTT	CASSLDPDGGDHSNQPQHF	TRBV7-9	TRBJ1-5
TGTGCCAGCAGCGAGGGCGATAACACTGAAGCTTTCTTT	CASSEGDNTEAFF	TRBV13	TRBJ1-1
TGTGCCAGCAGTGTCGAAGGGGAAGAGACCCAGTACTTC	CASSVEGEETQYF	TRBV27	TRBJ2-5
TGCAGTGCTAGGTGTCACAGGCTCTACGAGCAGTACTTC	CSARCHRLYEQYF	TRBV20-1	TRBJ2-7
TGTGCCAGCAGCGGGGGATATAGTAGGGTACTTCCCCAGCATTTT	CASSGGYSRVLPQHF	TRBV9	TRBJ1-5
TGTGCCACCCCCCGGGGCACCCCGATGCAGCCCCAGCATTTT	CATPRGTPMQPQHF	TRBV27	TRBJ1-5
TGTGCACTCCTAGCGGTCTCCTACAATGAGCAGTTCTTC	CALLAVSYNEQFF	TRBV11-3	TRBJ2-1
TGTGCCTGGACTAAGGACAGTGCTAATGAAAAACTGTTTTTT	CAWTKDSANEKLFF	TRBV30	TRBJ1-4
TGTGCCAGACCGAGAAGTGAGGGAGAGACCCAGTACTTC	CARPRSEGETQYF	TRBV9	TRBJ2-5
TGCGCCAGCAGTGAGTACCCTCAGCCCCAGCATTTT	CASSEYPQPQHF	TRBV10-1	TRBJ1-5
TGTGCCAGCAGGGCACTTCTTTCTCAGCCCCAGCATTTT	CASRALLSQPQHF	TRBV28	TRBJ1-5
TGTGCCATCAGCCCCCCAAAAACAGGGGGAACTGAAGCTTTCTTT	CAISPPKTGGTEAFF	TRBV10-3	TRBJ1-1
TGCGCCAGCAGCTTGCGTGCCAGGGAGGCCCTGAATGAAAAACTGTTTTTT	CASSLRAREALNEKLFF	TRBV5-1	TRBJ1-4
TGTGCCAGCAGAGAACCCGTAGGGACAGGGGACGGCTACACCTTC	CASREPVGTGDGYTF	TRBV12-3	TRBJ1-2
TGTGCCAGCAGCTTTAGAGGGAGTTTCGCCTACGAGCAGTACTTC	CASSFRGSFAYEQYF	TRBV7-3	TRBJ2-7
TGTGCCTGTCGTCCCCGGACAGGGGATGCCTACAATGAGCAGTTCTTC	CACRPRTGDAYNEQFF	TRBV30	TRBJ2-1
TGTGCCAGCAGCGCCCGCCAGGGGGTCACTGAAGCTTTCTTT	CASSARQGVTEAFF	TRBV9	TRBJ1-1
TGCGCCAGCAGTCGGCGGCCAGGGACAGTTCCCGGCAGGGTTGCAACTAATGAAAAACTGTTTTTT	CASSRRPGTVPGRVATNEKLFF	TRBV10-1	TRBJ1-4
TGTGCCAGCTCCCACGTCCAGGGCCCGGGCTCTGAAGCTTTCTTT	CASSHVQGPGSEAFF	TRBV27	TRBJ1-1
TGTGCCAGCAGCTCATCCCGGCGCCGACAGGGGTTTGGCTACACCTTC	CASSSSRRRQGFGYTF	TRBV7-7	TRBJ1-2
TGTGCCAGCAGGGGGCGGGGGTCTGGGGCCAACGTCCTGACTTTC	CASRGRGSGANVLTF	TRBV7-9	TRBJ2-6
TGTGCCAGCTCACCACCGAGGACGGGGGGTTCCCACGAGCAGTACTTC	CASSPPRTGGSHEQYF	TRBV18	TRBJ2-7
TGTGCCAGCAAGAGGAGTTACGAGCAGTACTTC	CASKRSYEQYF	TRBV9	TRBJ2-7
TGTGCCTGGAGTGTAAGTGGACAGGGGGATGAGCAGTTCTTC	CAWSVSGQGDEQFF	TRBV30	TRBJ2-1
TGTGCTAGTGGTTTGATTGGGACAAGGCAAGAGACCCAGTACTTC	CASGLIGTRQETQYF	TRBV12-5	TRBJ2-5
TGCGCCAGCACTCGTGGGCCCTACGAGCAGTACTTC	CASTRGPYEQYF	TRBV10-1	TRBJ2-7
TGTGCCAGAAGCTGTTTATATGGCTACACCTTC	CARSCLYGYTF	TRBV6-4	TRBJ1-2
TGTGCCAGCAGCCCTAAGGACGAAAAACTGTTTTTT	CASSPKDEKLFF	TRBV7-7	TRBJ1-4
TGTGCCAGCGGCTGGGTCGTTCCCCGGGGGAGCACAGCTAACTATGGCTACACCTTC	CASGWVVPRGSTANYGYTF	TRBV7-9	TRBJ1-2
TGTGCCAGCAGTTTCCCCCCGAGTGACGGCGAGCAGTACTTC	CASSFPPSDGEQYF	TRBV7-4	TRBJ2-7
TGTGCCAGCAGTTCGCCAGGCTGGGGGGGGGAGGATCAGCCCCAGCATTTT	CASSSPGWGGEDQPQHF	TRBV6-5	TRBJ1-5
TGTGCCAGCAGCGAAATCATGACAGGTGGGAGCAATCAGCCCCAGCATTTT	CASSEIMTGGSNQPQHF	TRBV9	TRBJ1-5
TGTGCCAGCTCACCACAAGGGGCTTACTCCTACGAGCAGTACTTC	CASSPQGAYSYEQYF	TRBV18	TRBJ2-7
TGTGCCAGCAGACCCCAGGGACTAGTAGGATCCTACGAGCAGTACTTC	CASRPQGLVGSYEQYF	TRBV7-3	TRBJ2-7
TGTGCCTGGCGGGGGCTATTTGGCTACACCTTC	CAWRGLFGYTF	TRBV30	TRBJ1-2
TGTGCCAGCAGCCCTCCGGCGACAGGGCGAAATCAGCCCCAGCATTTT	CASSPPATGRNQPQHF	TRBV13	TRBJ1-5
TGTGCCAGTAGTAGCCCAAGGGGTTTGAACACTGAAGCTTTCTTT	CASSSPRGLNTEAFF	TRBV19	TRBJ1-1
TGTGCCAGCAGCCAAGACAGCTTGACTAGAATCCAAGAGACCCAGTACTTC	CASSQDSLTRIQETQYF	TRBV14	TRBJ2-5
TGTGCCACCACTGCTAGAGCGGGGGGAATCTACGAGCAGTACTTC	CATTARAGGIYEQYF	TRBV24-1	TRBJ2-7
TGCAGTGCTAGAGCTCCCCCTACCGACAGGGGGCACGAGCAGTACTTC	CSARAPPTDRGHEQYF	TRBV20-1	TRBJ2-7
TGCGCCAGCATGGGCCTCTATGGCTACACCTTC	CASMGLYGYTF	TRBV5-1	TRBJ1-2
TGTGCCAGCAGCTTAGGGGGGGGACGGTCAGGGGCCTCCTACAATGAGCAGTTCTTC	CASSLGGGRSGASYNEQFF	TRBV11-3	TRBJ2-1
TGCGCCAGCAGCAGCCCACGCCTAGCGGGTCCGAACACCGGGGAGCTGTTTTTT	CASSSPRLAGPNTGELFF	TRBV5-1	TRBJ2-2
TGTGCCAGCAGCTTAATCAGACAAGTCCGGGACAGGGTCTACAATGAGCAGTTCTTC	CASSLIRQVRDRVYNEQFF	TRBV7-3	TRBJ2-1
TGTGCCAGCAGGTTTGGACCCGGCTACGAGCAGTACTTC	CASRFGPGYEQYF	TRBV6-5	TRBJ2-7
TGTGCCAGCAGCTCGTTGGGGGGTGAGCAGTTCTTC	CASSSLGGEQFF	TRBV5-6	TRBJ2-1
TGTGCCAGCAGCCAGAGACGAGACTTAGAAATAAATCTCTACGAGCAGTACTTC	CASSQRRDLEINLYEQYF	TRBV14	TRBJ2-7
TGTGCCAGCAGCTTCTCTTACGGCTCTGGAAACACCATATATTTT	CASSFSYGSGNTIYF	TRBV5-4	TRBJ1-3
TGTGCCACCCGCGGGAGGAGCACCGGGGAGCTGTTTTTT	CATRGRSTGELFF	TRBV24-1	TRBJ2-2
TGCCCTGGGGGGGCCTACGAGCAGTACTTC	CPGGAYEQYF	TRBV20-1	TRBJ2-7
TGTGCCAGTAGCCCTGACAGTAACACTGAAGCTTTCTTT	CASSPDSNTEAFF	TRBV19	TRBJ1-1
TGTGCCAGCAGGAACCCCGACGGACAGGGCCCCGTCGAAGCTTTCTTT	CASRNPDGQGPVEAFF	TRBV7-6	TRBJ1-1
TGTGCCAGTAGTATAAGAGGACTGAACAGGGGCCAGCCCCAGCATTTT	CASSIRGLNRGQPQHF	TRBV19	TRBJ1-5
TGTGCCGTGGGAGAGCCCCAGCATTTT	CAVGEPQHF	TRBV28	TRBJ1-5
TGTGCCAGCCCGGTCTGCTACCTGACAGTGGGGAATGAAAAACTGTTTTTT	CASPVCYLTVGNEKLFF	TRBV2	TRBJ1-4
TGTGCCAGCAGTTCCCTAGCGGGAGAGACCCAGTACTTC	CASSSLAGETQYF	TRBV27	TRBJ2-5
TGCGCCAGCAGGGGGGGGCCACGAGATACGCAGTATTTT	CASRGGPRDTQYF	TRBV10-1	TRBJ2-3
TGTGCCAGCAGCTCGACGGGGTCGGAAGATTGCAATCAGCCCCAGCATTTT	CASSSTGSEDCNQPQHF	TRBV7-2	TRBJ1-5
TGCGCCAGCAGCCGAGGCCCCAGCTCTGGAAACACCATATATTTT	CASSRGPSSGNTIYF	TRBV4-3	TRBJ1-3
TGCGCCAGCAGCCAAATACGGACTGAAGCTTTCTTT	CASSQIRTEAFF	TRBV4-1	TRBJ1-1
TGTGCTAGTGGTGCCAGAACAAAACTGTTTTTT	CASGARTKLFF	TRBV12-5	TRBJ1-4
TGTGCCAGCAGCTTAGGGAGACAGGGTTCAGATACGCAGTATTTT	CASSLGRQGSDTQYF	TRBV11-2	TRBJ2-3
TGTGCCAGCAGCATGGGAGGAGGGTCGTACTTC	CASSMGGGSYF	TRBV5-6	TRBJ2-4
TGTGCCTGGAGCAAAAATCAGGGAAGGGGGTGTCAGGGGGAGAGGGACTCTAACTATGGCTACACCTTC	CAWSKNQGRGCQGERDSNYGYTF	TRBV30	TRBJ1-2
TGTGCCTGGAGTAGCAGGGCGGAGGAAACCTATGGCTACACCTTC	CAWSSRAEETYGYTF	TRBV30	TRBJ1-2
TGCGCCAGCAGTGATCGACTAGCGGACAATGAGCAGTTCTTC	CASSDRLADNEQFF	TRBV10-2	TRBJ2-1
TGCAGTGCTAGACAGGGTACCGGCTACACCTTC	CSARQGTGYTF	TRBV20-1	TRBJ1-2
TGTGCCAGCAGCGTTATCCAGGGGTTTTGTAATTCACCCCTCCACTTT	CASSVIQGFCNSPLHF	TRBV9	TRBJ1-6
TGTGCCAGCAGCTTAGAGGGACGCCAGGTCATCACTGAAGCTTTCTTT	CASSLEGRQVITEAFF	TRBV11-2	TRBJ1-1
TGTGCCAGCAGCTTAGCGATCGACAGGGGGCTCCTCTACGAGCAGTACTTC	CASSLAIDRGLLYEQYF	TRBV7-9	TRBJ2-7
TGTGCCATCGGGATTTCCAACGAGCAGTACTTC	CAIGISNEQYF	TRBV6-4	TRBJ2-7
TGTGCCAGCATCCAAAAGACTAGCGGGAGGGCGACCGAGACCCAGTACTTC	CASIQKTSGRATETQYF	TRBV14	TRBJ2-5
TGCGCCAGCAGCCCCGGGCAACCAGAGCAGTACTTC	CASSPGQPEQYF	TRBV4-1	TRBJ2-7
TGCAGTGCTAGATTCCGGTCGATAGCCAAAAACATTCAGTACTTC	CSARFRSIAKNIQYF	TRBV20-1	TRBJ2-4
TGTGCCAGCAGCCTGGGCTATGGCTACACCTTC	CASSLGYGYTF	TRBV13	TRBJ1-2
TGTGCCAGCAGCCCGGAAGGACCGTATAACACTGAAGCTTTCTTT	CASSPEGPYNTEAFF	TRBV27	TRBJ1-1
TGCGCCAGCAGCTTGGACTATAACCGACAGGGGTACTATGGCTACACCTTC	CASSLDYNRQGYYGYTF	TRBV5-1	TRBJ1-2
TGTGCCAGCAGCGTCAACGAGCAGGTCACTGAAGCTTTCTTT	CASSVNEQVTEAFF	TRBV6-2	TRBJ1-1
TGTGCCAGCAGCTTAGATGGACAGGGACATGGCTACACCTTC	CASSLDGQGHGYTF	TRBV11-2	TRBJ1-2
TGTGCCAGCAGTTTAGGGACGACAAGAAACACTGAAGCTTTCTTT	CASSLGTTRNTEAFF	TRBV27	TRBJ1-1
TGTGCCAGCAGCGTAGATTTAAGGCAATCGGTAGGGAACACTGAAGCTTTCTTT	CASSVDLRQSVGNTEAFF	TRBV9	TRBJ1-1
TGTGCCAGCAGTGATTCGATAGACAGGGTCTCTAGCACAGATACGCAGTATTTT	CASSDSIDRVSSTDTQYF	TRBV2	TRBJ2-3
TGCGCCAGCAGCCGAAATGGGGGGGGGGGGACTAGCACAGATACGCAGTATTTT	CASSRNGGGGTSTDTQYF	TRBV5-1	TRBJ2-3
TGTGCCAGCAGCCAAGAACTGGTCCAATACTATGGCTACACCTTC	CASSQELVQYYGYTF	TRBV4-2	TRBJ1-2
TGTGCCAGCAGCGGAAACAGGGCCCACTCACCCCTCCACTTT	CASSGNRAHSPLHF	TRBV13	TRBJ1-6
TGTGCCAGCAGTAGCTATCAGCCCCAGCATTTT	CASSSYQPQHF	TRBV7-3	TRBJ1-5
TGTGCCAGCAGTACTAGACTAGCGTCTGAGCAGTTCTTC	CASSTRLASEQFF	TRBV5-6	TRBJ2-1
TGTGCCAGCAGCCAAGATAACCCGGTCACAGATACGCAGTATTTT	CASSQDNPVTDTQYF	TRBV4-2	TRBJ2-3
TGTGCCAGCAGTTCGGGAGTTACAGGGGTTAATCAGCCCCAGCATTTT	CASSSGVTGVNQPQHF	TRBV28	TRBJ1-5
TGTGCCAGCAGCCAAGCACCCTACCTCCGGGACGGGGTCGGGGAGCTGTTTTTT	CASSQAPYLRDGVGELFF	TRBV3-1	TRBJ2-2
TGTGCCAGCAGTGCCCCCGATTGCACAGATACGCAGTATTTT	CASSAPDCTDTQYF	TRBV2	TRBJ2-3
TGTGCCAGCTCACCACCTCGGCGGACCGCTGTGAGCTACGAGCAGTACTTC	CASSPPRRTAVSYEQYF	TRBV18	TRBJ2-7
TGTGCCACCAGTGAAGTAAATACGGGGACAGGGGGCAAAGAGAGCAATAATTCACCCCTCCACTTT	CATSEVNTGTGGKESNNSPLHF	TRBV24-1	TRBJ1-6
TGCGCCAGCAGCTTGAGCCGACAGGGGGCCCCCTGTGAAAAACTGTTTTTT	CASSLSRQGAPCEKLFF	TRBV5-1	TRBJ1-4
TGTGCCAGCAGCCATCGGGGGCTCGCCGGCATATATTTT	CASSHRGLAGIYF	TRBV5-6	TRBJ1-3
TGTGCCAGCACCAGGGGGGGGTCCTACGAGCAGTACTTC	CASTRGGSYEQYF	TRBV7-9	TRBJ2-7
TGCGCCAGCAGCCAACTCGAAGGACAGGGCCTCAGCTCTGGAAACACCATATATTTT	CASSQLEGQGLSSGNTIYF	TRBV4-1	TRBJ1-3
TGTGCCAGTAACATCAGAGGCTGCTACGAGCAGTACTTC	CASNIRGCYEQYF	TRBV2	TRBJ2-7
TGTGCCAGCAGTTACTCACAGCTAGAGACCCAGTACTTC	CASSYSQLETQYF	TRBV27	TRBJ2-5
TGTGCCAGCATCATTGGGGCAACAGCTGGAAACACCATATATTTT	CASIIGATAGNTIYF	TRBV2	TRBJ1-3
TGCGCCAGCAGCTTGGGTCTGGCCGGGAAGTACGAGCAGTACTTC	CASSLGLAGKYEQYF	TRBV5-1	TRBJ2-7
TGTGCCAGCAGCGACCTAGAGGGGGTGGAGTACTTC	CASSDLEGVEYF	TRBV13	TRBJ2-7
TGTGCCAGCAGCGGGAGTAGGAGGAACACCGGGGAGCTGTTTTTT	CASSGSRRNTGELFF	TRBV9	TRBJ2-2
TGTGCCTGGAGTGTACAAAGGGCTAGCGGGGGGGCCCCAGGAGGCTACGAGCAGTACTTC	CAWSVQRASGGAPGGYEQYF	TRBV30	TRBJ2-7
TGTGCCAGCAGTCCCGAACTCCGTGCGAACACCGGGGAGCTGTTTTTT	CASSPELRANTGELFF	TRBV28	TRBJ2-2
TGTGCCAGCAGCGGTAAATCAACTAATGAAAAACTGTTTTTT	CASSGKSTNEKLFF	TRBV9	TRBJ1-4
TGTGCCACCAGCCGCGGGACAGGGGGTCAGCCCCAGCATTTT	CATSRGTGGQPQHF	TRBV15	TRBJ1-5
TGTGCCAGCAGTGAGGGGGCGGCGAACACTGAAGCTTTCTTT	CASSEGAANTEAFF	TRBV27	TRBJ1-1
TGCGCCAGCAGTGAGTGGGGGGTCGACAATGAGCAGTTCTTC	CASSEWGVDNEQFF	TRBV10-1	TRBJ2-1
TGTGCCAGCAACAGGGACTACGAGCAGTACTTC	CASNRDYEQYF	TRBV9	TRBJ2-7
TGTGCCAGCAGCTTCGCAACGACAGGGAGGCGACGCAATCAGCCCCAGCATTTT	CASSFATTGRRRNQPQHF	TRBV5-4	TRBJ1-5
TGTGCCAGCATGCTTCCCGGGGGCACAGATACGCAGTATTTT	CASMLPGGTDTQYF	TRBV6-5	TRBJ2-3
TGTGCCAGCAGTTTGGGACAGTCATACAATGAGCAGTTCTTC	CASSLGQSYNEQFF	TRBV27	TRBJ2-1
TGTGCCAGCAGGACAGAGCTGAACACTGAAGCTTTCTTT	CASRTELNTEAFF	TRBV7-2	TRBJ1-1
TGTGCCAGCAGCGTACCTGGGTGCAATCAGCCCCAGCATTTT	CASSVPGCNQPQHF	TRBV7-2	TRBJ1-5
TGTGCCAGCAGCCCGGGACAGGAACAGGGCTCTGGAAACACCATATATTTT	CASSPGQEQGSGNTIYF	TRBV6-5	TRBJ1-3
TGTGCCAGCTCACCCCACGAGCATTTTCGTTACGAGCAGTACTTC	CASSPHEHFRYEQYF	TRBV18	TRBJ2-7
TGTGCCAGCAGCTTAGGTTTGACCGGGGGAGTTGGAAACACCATATATTTT	CASSLGLTGGVGNTIYF	TRBV7-2	TRBJ1-3
TGTGCCAGCAGTTTATCCCAGTTCGGTCAGCCCCAGCATTTT	CASSLSQFGQPQHF	TRBV27	TRBJ1-5
TGTGCCAGCAGTTTACGGGGGACTAGCGGGAGGCACTCCTACGAGCAGTACTTC	CASSLRGTSGRHSYEQYF	TRBV28	TRBJ2-7
TGTGCTAGTGGTTTGGTCAAAAGCGGGTGCGCGAGCTCCTACAATGAGCAGTTCTTC	CASGLVKSGCASSYNEQFF	TRBV12-5	TRBJ2-1
TGTGCCAGCAACTACGGGGGCTCCAATCAGCCCCAGCATTTT	CASNYGGSNQPQHF	TRBV6-1	TRBJ1-5
TGTGCCAGCAGCGGTACGGGGACAGGGGGGCAGAACACTGAAGCTTTCTTT	CASSGTGTGGQNTEAFF	TRBV5-4	TRBJ1-1
TGTGCCAGCAGTTTAATCTACTTGGTCGAGCAGTACTTC	CASSLIYLVEQYF	TRBV12-4	TRBJ2-7
TGTGCCAGCAGCCCAACAGGGGGCGCGGGGGTAAAGCCCCAGCATTTT	CASSPTGGAGVKPQHF	TRBV12-4	TRBJ1-5
TGTGCCACCCCCCCCTATGACAGGGGCTACACCTTC	CATPPYDRGYTF	TRBV24-1	TRBJ1-2
TGTGCCAGCAGCAAAGTCGAGGGACAGATGAACACTGAAGCTTTCTTT	CASSKVEGQMNTEAFF	TRBV7-3	TRBJ1-1
TGCAGTGCGGCCGGGACTAGCAATACGCAGTATTTT	CSAAGTSNTQYF	TRBV20-1	TRBJ2-3
TGTGCCAGCATTGCCACGGCGACAGTTAAAGAGACCCAGTACTTC	CASIATATVKETQYF	TRBV2	TRBJ2-5
TGTGCCAGCAGCTGGACTTGGGGGATTACGCAGTATTTT	CASSWTWGITQYF	TRBV7-9	TRBJ2-3
TGTACGGGACTAGCGGGGGAGTCGTCCTACAATGAGCAGTTCTTC	CTGLAGESSYNEQFF	TRBV27	TRBJ2-1
TGTGCCAGCAGCCTATGGGACAGGACCGATCAGCCCCAGCATTTT	CASSLWDRTDQPQHF	TRBV13	TRBJ1-5
TGCAGTGCTAGAGAGAGAATCGGGACAGGGGACTACTACGAGCAGTACTTC	CSARERIGTGDYYEQYF	TRBV20-1	TRBJ2-7
TGTGCCAGTAGTATAGGTTTCGTACCAGGGGGCGGAGCGAACACTGAAGCTTTCTTT	CASSIGFVPGGGANTEAFF	TRBV19	TRBJ1-1
TGTGCCACTAGCGGGTCAGTAAATGAGCAGTTCTTC	CATSGSVNEQFF	TRBV5-5	TRBJ2-1
TGTGCCAGCAGCCCAAAAAGGGACAGAATTAGCTCCTACGAGCAGTACTTC	CASSPKRDRISSYEQYF	TRBV3-1	TRBJ2-7
TGCAGCGTTCCGGGACTAGCGGGACCCCCCAAGGCCTACGAGCAGTACTTC	CSVPGLAGPPKAYEQYF	TRBV29-1	TRBJ2-7
TGCAGTGCTAGAGATGCTAGGAATAAAGAGACCCAGTACTTC	CSARDARNKETQYF	TRBV20-1	TRBJ2-5
TGTGCCAGCAGCGTTGGCCAAGTCTCATACGAGCAGTACTTC	CASSVGQVSYEQYF	TRBV7-6	TRBJ2-7
TGTGCCAGCAGCCCCCCAGGGAAAGTCAACACTGAAGCTTTCTTT	CASSPPGKVNTEAFF	TRBV14	TRBJ1-1
TGTGCCAGCAGCCCCCGAGCGGGACAAGAGACCCAGTACTTC	CASSPRAGQETQYF	TRBV6-3	TRBJ2-5
TGTGCCAGCAGGACAAGAGGGGAAGACGAGCAGTACTTC	CASRTRGEDEQYF	TRBV7-7	TRBJ2-7
TGTGCCAGCAGCTTAGTAGTCTACGGCAGGTATGAGCAGTTCTTC	CASSLVVYGRYEQFF	TRBV11-3	TRBJ2-1
TGTGCTAGTGGTTTGGGGGCTAGAAAAGCTAACTATGGCTACACCTTC	CASGLGARKANYGYTF	TRBV12-5	TRBJ1-2
TGTGCCAGCAGATTGGGACAGCTGAACACTGAAGCTTTCTTT	CASRLGQLNTEAFF	TRBV6-1	TRBJ1-1
TGTGCCAGCAGCTGCACGGCCCCTAGCTCCTACGAGCAGTACTTC	CASSCTAPSSYEQYF	TRBV5-4	TRBJ2-7
TGTGCCAGCGAACCGGTGAGGGGCCATGTGAACACTGAAGCTTTCTTT	CASEPVRGHVNTEAFF	TRBV6-2	TRBJ1-1
TGCGCCAGCGGGGGGGCTTTCTTT	CASGGAFF	TRBV10-1	TRBJ1-1
TGTGCCAGCCCCCTGGGGGGGAACTATGGCTACACCTTC	CASPLGGNYGYTF	TRBV6-2	TRBJ1-2
TGTGCCAGCAGCCAACTGCGACCTTTCTCTGAGCAGTTCTTC	CASSQLRPFSEQFF	TRBV3-1	TRBJ2-1
TGTGCCTGGAGTTTAATGCGGGGGTCGGTAAGCGAGCAGTACTTC	CAWSLMRGSVSEQYF	TRBV30	TRBJ2-7
TGTTATCCCAGGGATCAGCCCCAGCATTTT	CYPRDQPQHF	TRBV10-3	TRBJ1-5
TGTGCCAGCGGGAAGACAGGCCTTGGCGAAGCTTTCTTT	CASGKTGLGEAFF	TRBV2	TRBJ1-1
TGTGCCAGCAGCTTAGCGTATTGTGTGGGACTAGCGGGTCCGGGGGATGAGACCCAGTACTTC	CASSLAYCVGLAGPGDETQYF	TRBV11-2	TRBJ2-5
TGTGCCAGCAGCTCCCACGGCTATCGGTGGGGTTGTCCCGGGGAGCTGTTTTTT	CASSSHGYRWGCPGELFF	TRBV12-3	TRBJ2-2
TGTGCCAGCAGTTACTCGCTCTGGGGGCGTGACTCCTACAATGAGCAGTTCTTC	CASSYSLWGRDSYNEQFF	TRBV6-5	TRBJ2-1
TGCGCCAGCAGCTCTCCCTTGTCGTCAGCGGGGGGGCTCTTACCATATGAGCAGTTCTTC	CASSSPLSSAGGLLPYEQFF	TRBV5-1	TRBJ2-1
TGTGCCAGCAGCCAAAAAAGGGAAATCAAGCAGCCCCAGCATTTT	CASSQKREIKQPQHF	TRBV5-5	TRBJ1-5
TGCGCCAGCGCGAGGACAGGGGGCCCGACAGAGAGCTCCTACGAGCAGTACTTC	CASARTGGPTESSYEQYF	TRBV5-1	TRBJ2-7
TGTGCCAGTCCCAGGACTAGCGGGACTGAGCAGTTCTTC	CASPRTSGTEQFF	TRBV19	TRBJ2-1
TGTGCCAGCAGCGCCTCTGGGACAGGGGAGAGCAATCAGCCCCAGCATTTT	CASSASGTGESNQPQHF	TRBV13	TRBJ1-5
TGTGCCAGCCGGGACCAGGAGCAGTACTTC	CASRDQEQYF	TRBV27	TRBJ2-7
TGTGCCAGCAGCTACCAGGGGGGGGCCAAAAACATTCAGTACTTC	CASSYQGGAKNIQYF	TRBV11-3	TRBJ2-4
TGTGCCAGCAGCGGACAGGGATCCTACGAGCAGTACTTC	CASSGQGSYEQYF	TRBV13	TRBJ2-7
TGTGCCAGCAGCCCCGGACAGGATACGCAGTATTTT	CASSPGQDTQYF	TRBV7-6	TRBJ2-3
TGTGCCACCAGCGGGTTCGACAGGGGGGACGAGCAGTACTTC	CATSGFDRGDEQYF	TRBV24-1	TRBJ2-7
TGTGCCAGTAGTCTGAGCACAGATACGCAGTATTTT	CASSLSTDTQYF	TRBV19	TRBJ2-3
TGCAGTTTAAGGTGTAATAGCCAGGGCACAGATACGCAGTATTTT	CSLRCNSQGTDTQYF	TRBV20-1	TRBJ2-3
TGTGCCTTACAACCGGGGATCAATCAGCCCCAGCATTTT	CALQPGINQPQHF	TRBV19	TRBJ1-5
TGCGCCAGCAGCCCAGACGCAGGTGCGAACACCGGGGAGCTGTTTTTT	CASSPDAGANTGELFF	TRBV4-3	TRBJ2-2
TGTGCCAGCAGTTTACCTGGGACAGGGGGACACGAGCAGTACTTC	CASSLPGTGGHEQYF	TRBV12-3	TRBJ2-7
TGTGCCAGCAGCGTCCGGGGTTTCTTGTCAGCAACTAATGAAAAACTGTTTTTT	CASSVRGFLSATNEKLFF	TRBV9	TRBJ1-4
TGCGCCAGCAGAGGTCAGGGACTCAGGTACTTC	CASRGQGLRYF	TRBV5-1	TRBJ2-7
TGTGCCAGCAGCTTAGCCTTAGGGGGACAGTACTTC	CASSLALGGQYF	TRBV7-2	TRBJ2-7
TGTGCCATCAGTGTTTCCCCTAGCAAGTCAAAAAAAGAGACCCAGTACTTC	CAISVSPSKSKKETQYF	TRBV10-3	TRBJ2-5
TGTGCCAGCAGTCCTTTATCCCGGGCAGATTACGAGCAGTACTTC	CASSPLSRADYEQYF	TRBV6-5	TRBJ2-7
TGTGCCAGCAGCCAAGCGGCGGGACAGGGCACTGAAGCTTTCTTT	CASSQAAGQGTEAFF	TRBV14	TRBJ1-1
TGTGCCAGCCTCCTTGCTAGGGGGACAGATACGCAGTATTTT	CASLLARGTDTQYF	TRBV6-4	TRBJ2-3
TGTGCCAGCAGTGACTCGACCAAGACCAGCGGAGCGGCAGATACGCAGTATTTT	CASSDSTKTSGAADTQYF	TRBV6-4	TRBJ2-3
TGTGCCAGCAGTTACCCGGGACTAGCTATGTCCTACGAGCAGTACTTC	CASSYPGLAMSYEQYF	TRBV6-5	TRBJ2-7
TGTGCCAGCAGTTTACCAACACCCGGGGCTGCTCTTCAAGAGACCCAGTACTTC	CASSLPTPGAALQETQYF	TRBV28	TRBJ2-5
TGTGCCAGCAGTGACGTCAGGGCTGACGAGCAGTACTTC	CASSDVRADEQYF	TRBV6-1	TRBJ2-7
TGCGCCAGCAGCCAGGCCAGGGGCCGATTCCGTTCACCCCTCCACTTT	CASSQARGRFRSPLHF	TRBV4-1	TRBJ1-6
TGTGCCAGCAGTCAACTCGGAGACGAGCAGTACTTC	CASSQLGDEQYF	TRBV27	TRBJ2-7
TGTGCCAGCAGCCAATGTTCGCACCTACTTGATCCCGAGACCCAGTACTTC	CASSQCSHLLDPETQYF	TRBV14	TRBJ2-5
TGTGCCAGCAGACTCCTGTGGGGGCCTTGGGGCTATGGCTACACCTTC	CASRLLWGPWGYGYTF	TRBV2	TRBJ1-2
TGTGCCAGCAGCGAAGGTCGAAACGAGCAGTACTTC	CASSEGRNEQYF	TRBV5-6	TRBJ2-7
TGTGCCAGCGGATCCTGGCAAGAGACCCAGTACTTC	CASGSWQETQYF	TRBV5-4	TRBJ2-5
TGTGCCAGCGGGACACTAGCGGGAGTTAGCTATGGCTACACCTTC	CASGTLAGVSYGYTF	TRBV14	TRBJ1-2
TGTGCCAGCAGATACGGGACTAGGATCCGGGGCGAGCAGTACTTC	CASRYGTRIRGEQYF	TRBV12-4	TRBJ2-7
TGCAGCGTAGGATCTTCAGGGGGGTCCCCGTACAATGAGCAGTTCTTC	CSVGSSGGSPYNEQFF	TRBV29-1	TRBJ2-1
TGTGCCAGCAGCTTACCGTCGGGGAGGGGCAATCAGCCCCAGCATTTT	CASSLPSGRGNQPQHF	TRBV7-3	TRBJ1-5
TGTGCCAGCAGCGTACTAGCGGGAGATTACTACGAGCAGTACTTC	CASSVLAGDYYEQYF	TRBV9	TRBJ2-7
TGTGCCAGCAGAGCGGGACGATACGGGGAGCTGTTTTTT	CASRAGRYGELFF	TRBV11-3	TRBJ2-2
TGTGCCAGCAGTTACTCCCGGGGCAGATTCGCCAAAAACATTCAGTACTTC	CASSYSRGRFAKNIQYF	TRBV6-5	TRBJ2-4
TGTGCCACCTGGGTAGACGCGGTCTACGAGCAGTACTTC	CATWVDAVYEQYF	TRBV24-1	TRBJ2-7
TGTGCCAGGCCCGGCACAGAAGGATACGAGCAGTACTTC	CARPGTEGYEQYF	TRBV5-6	TRBJ2-7
TGCGCCAGCAGCGGTAGCCGGGAGGGGTCTTCACGGCAAGAGACCCAGTACTTC	CASSGSREGSSRQETQYF	TRBV5-1	TRBJ2-5
TGTGCCACCCCGGGACAGGGATCTGAAGCTTTCTTT	CATPGQGSEAFF	TRBV6-4	TRBJ1-1
TGTGCCAGCAGTTGGGGGGCGCCGCCCCCAGATACGCAGTATTTT	CASSWGAPPPDTQYF	TRBV12-3	TRBJ2-3
TGTGCCACCAGCAACATTTCAGGGGGGGCCAAAAACATTCAGTACTTC	CATSNISGGAKNIQYF	TRBV15	TRBJ2-4
TGTGCTAGTGGTTTGGTACTGGAGGGGAGACCCATGAACACTGAAGCTTTCTTT	CASGLVLEGRPMNTEAFF	TRBV12-5	TRBJ1-1
TGTGCCAGCGAAGTAAGGAGCTCCTATAATTCACCCCTCCACTTT	CASEVRSSYNSPLHF	TRBV7-3	TRBJ1-6
TGCGCCAGCCCACGGGAGCCGACCCTCTACGAGCAGTACTTC	CASPREPTLYEQYF	TRBV10-1	TRBJ2-7
TGTGCCAGCAGCCACCGCGACCGGGAGCAGTACTTC	CASSHRDREQYF	TRBV7-3	TRBJ2-7
TGTGCCAGTAAAGACAGGGGGCGGGTAGCCAAAAACATTCAGTACTTC	CASKDRGRVAKNIQYF	TRBV14	TRBJ2-4
TGTGCCAGCATACTGGATATCCGGGACAAGCAGGGCAATCAGCCCCAGCATTTT	CASILDIRDKQGNQPQHF	TRBV6-2	TRBJ1-5
TGTGCCTGGAATCACAGGGGGCGGGTGAGAGCTGAAGCTTTCTTT	CAWNHRGRVRAEAFF	TRBV30	TRBJ1-1
TGCGCCAGCAGCTTAGCGGGACAGTCCTCCTACGAGCAGTACTTC	CASSLAGQSSYEQYF	TRBV5-1	TRBJ2-7
TGTGCCAGCAGCGTAGCGAACTGGGAGAACACTGAAGCTTTCTTT	CASSVANWENTEAFF	TRBV9	TRBJ1-1
TGCGCCAGCAGCGACCTGGCAGAGACCCAGTACTTC	CASSDLAETQYF	TRBV4-1	TRBJ2-5
TGTGCCAGCAGCGTAAGCGCTGGAAACACCATATATTTT	CASSVSAGNTIYF	TRBV9	TRBJ1-3
TGCGCCAGCAGCTCCTTGACCGAGGGCTACACCTTC	CASSSLTEGYTF	TRBV5-1	TRBJ1-2
TGTGCCAGCAGGTACCGTTACAGGGGGGAGCTGTTTTTT	CASRYRYRGELFF	TRBV6-5	TRBJ2-2
TGCAGCGCCTCTGGGGACATGAACTATGGCTACACCTTC	CSASGDMNYGYTF	TRBV29-1	TRBJ1-2
TGCGCCAGCAGCTTGCAGGGGACGCGCAATCAGCCCCAGCATTTT	CASSLQGTRNQPQHF	TRBV5-1	TRBJ1-5
TGTGCCAGCAGTGGCTGCAGGAGGATGGCTAGCGATCAGCCCCAGCATTTT	CASSGCRRMASDQPQHF	TRBV25-1	TRBJ1-5
TGTGCCAGCAGCCGGCAGGTTCACTCTGGGGCCAACGTCCTGACTTTC	CASSRQVHSGANVLTF	TRBV13	TRBJ2-6
TGCGCCAGCAGCCTGAGGACAGATCCGGGAAACACTGAAGCTTTCTTT	CASSLRTDPGNTEAFF	TRBV4-1	TRBJ1-1
TGTGCCACCAGTGATTTGTCCGAGGGAAAGCCCGGGGAGCTGTTTTTT	CATSDLSEGKPGELFF	TRBV24-1	TRBJ2-2
TGTGCCAGCAGCGCGGGACTAGCGGGCCGATATGAGCAGTTCTTC	CASSAGLAGRYEQFF	TRBV9	TRBJ2-1
TGTGCCAGCAGCCCTCAGGAGTGGGGTTCCTACGAGCAGTACTTC	CASSPQEWGSYEQYF	TRBV11-3	TRBJ2-7
TGTGCCAGCAGCCTCGGGTTCCCGCCCTACGAGCAGTACTTC	CASSLGFPPYEQYF	TRBV4-2	TRBJ2-7
TGTGCCAGCAGCCCAGGGGACAAATTCCACAATGAGCAGTTCTTC	CASSPGDKFHNEQFF	TRBV11-1	TRBJ2-1
TGTGCCAGCAGTGTGGACAGGGTCACTGAAGCTTTCTTT	CASSVDRVTEAFF	TRBV6-1	TRBJ1-1
TGTGCCAGCAGCAACCGGGGACAGTTAAACACCATATATTTT	CASSNRGQLNTIYF	TRBV11-3	TRBJ1-3
TGTGCCAGCAGTACTAGCGGGGGGCCAGTCTCCTACGAGCAGTACTTC	CASSTSGGPVSYEQYF	TRBV6-5	TRBJ2-7
TGTGCCAGCAGAGGGGGCTACTGGGGCAATGAGCAGTTCTTC	CASRGGYWGNEQFF	TRBV5-6	TRBJ2-1
TGTGCCAGCCCGCTAGGACCGGTAACCTACGAGCAGTACTTC	CASPLGPVTYEQYF	TRBV6-4	TRBJ2-7
TGTGCCAGCAGCACGTCGGACAAGGATGAGCAGTTCTTC	CASSTSDKDEQFF	TRBV13	TRBJ2-1
TGCGCCAGCAGCACCGCTCGTGGGGGGCCGGGGACAGATACGCAGTATTTT	CASSTARGGPGTDTQYF	TRBV5-1	TRBJ2-3
TGTGCCAGCAGGTGGGCGAACGAGCAGTACTTC	CASRWANEQYF	TRBV6-5	TRBJ2-7
TGTGCCAGCAGTGAAGGGGGGGGACACCCAGATACGCAGTATTTT	CASSEGGGHPDTQYF	TRBV6-1	TRBJ2-3
TGTGCCAGCAGTTACAGTCTTGGGGGGGCCCCCACAGATACGCAGTATTTT	CASSYSLGGAPTDTQYF	TRBV6-5	TRBJ2-3
TGCAGCGGGGGCTCCTACGAGCAGTACTTC	CSGGSYEQYF	TRBV29-1	TRBJ2-7
TGTGCCAGCAGTCAGGGTCCCCCACGCCATAAGAGGGCAGATACGCAGTATTTT	CASSQGPPRHKRADTQYF	TRBV27	TRBJ2-3
TGTGCCCCCTGGGGTAGATATAGCAATCAGCCCCAGCATTTT	CAPWGRYSNQPQHF	TRBV10-3	TRBJ1-5
TGTGCCAGCACGGCCGGACAGGGTCTTAACTATGGCTACACCTTC	CASTAGQGLNYGYTF	TRBV7-9	TRBJ1-2
TGTGCCAGTACCCGGACAGGGGAAAAACTGTTTTTT	CASTRTGEKLFF	TRBV19	TRBJ1-4
TGTGCCAGCAGCCCACGCCTCTCCTACGAGCAGTACTTC	CASSPRLSYEQYF	TRBV13	TRBJ2-7
TGCAGTGCACCAGCGGGACTCCAAGAGACCCAGTACTTC	CSAPAGLQETQYF	TRBV20-1	TRBJ2-5
TGTGCCAGTAGTAAAATCGCGGGAGCGTCCAACTACGAGCAGTACTTC	CASSKIAGASNYEQYF	TRBV19	TRBJ2-7
TGTGCCAGCAGCTCTGATACTCGGGGGTTTGAGGAGGGCTACGAGCAGTACTTC	CASSSDTRGFEEGYEQYF	TRBV7-3	TRBJ2-7
TGTGCCAACGGGGAAAGGATCAACACTGAAGCTTTCTTT	CANGERINTEAFF	TRBV3-1	TRBJ1-1
TGTGCCAGCAGTTCTCGACAGGGGGCGAGGAGGTCTAATGAAAAACTGTTTTTT	CASSSRQGARRSNEKLFF	TRBV28	TRBJ1-4
TGTGCCACCAGAATCACCCGGAGGGCTACTAGCTCTGGGGCCAACGTCCTGACTTTC	CATRITRRATSSGANVLTF	TRBV24-1	TRBJ2-6
TGTGCCAGTAGTGACCGGGGAAATGGCGCCTACGAGCAGTACTTC	CASSDRGNGAYEQYF	TRBV19	TRBJ2-7
TGCGCCAGCAGTTTGCGGGCGGGGAACAAAAACATTCAGTACTTC	CASSLRAGNKNIQYF	TRBV10-1	TRBJ2-4
TGTGCCAGCAGTCCCACTAGCCCCCGATGTGCTAGCACAGATACGCAGTATTTT	CASSPTSPRCASTDTQYF	TRBV6-5	TRBJ2-3
TGTGCCAGCAGCCTCCCACTAGCGGGAGTTGCAAAGGCGTCGGGTCACGAGCAGTACTTC	CASSLPLAGVAKASGHEQYF	TRBV14	TRBJ2-7
TGTGCCAGCAGCTCACAGGGGTCCTACGAGCAGTACTTC	CASSSQGSYEQYF	TRBV13	TRBJ2-7
TGTGCCAGATTTCTTTTAATGGGGGGACCCCTCTCGACTGGGGCCAACGTCCTGACTTTC	CARFLLMGGPLSTGANVLTF	TRBV19	TRBJ2-6
TGTGCCAGCAGCTTACCTATAGGGGCTGGGGTTCGAGCAGTTAATACCTACGAGCAGTACTTC	CASSLPIGAGVRAVNTYEQYF	TRBV7-9	TRBJ2-7
TGTGCCAGCAGCGGAGTATTGTTGGGGGCGACAAACACTGAAGCTTTCTTT	CASSGVLLGATNTEAFF	TRBV7-3	TRBJ1-1
TGTGCCAGCAGCTTAGGGGGTAGCTCTGGAAACACCATATATTTT	CASSLGGSSGNTIYF	TRBV11-3	TRBJ1-3
TGTGCCAGCGAATCTCCCCAGCGGGAGATGGGAGGGCCTGAAAAACTGTTTTTT	CASESPQREMGGPEKLFF	TRBV7-3	TRBJ1-4
TGCAGCGTCTGGGCCTATAGCAATCAGCCCCAGCATTTT	CSVWAYSNQPQHF	TRBV29-1	TRBJ1-5
TGTGCCAGCAGCGAGACAGGGTCTTCGAGTGAAAAACTGTTTTTT	CASSETGSSSEKLFF	TRBV5-6	TRBJ1-4
TGCGCCAGCAGCTTGGATTCAGAAGTCACTGAAGCTTTCTTT	CASSLDSEVTEAFF	TRBV5-1	TRBJ1-1
TGCAGTGCAATGGGCGGGGTTGAAGCTTTCTTT	CSAMGGVEAFF	TRBV20-1	TRBJ1-1
TGTGCCAGCAGCTTTTGTGGACAATACACCTTC	CASSFCGQYTF	TRBV11-3	TRBJ1-2
TGTGCCAGTAGTCCCTACATCCCGGCCCCTAGCACAGATACGCAGTATTTT	CASSPYIPAPSTDTQYF	TRBV19	TRBJ2-3
TGTGCCACAACCGGATCAGGGCCGACCGAAGGTTGCGCCCGGAATCTCCGTGAGACCCAGTACTTC	CATTGSGPTEGCARNLRETQYF	TRBV24-1	TRBJ2-5
TGCGCCAGCAGCTTATCCTCATCGGGGAGGAACACTGAAGCTTTCTTT	CASSLSSSGRNTEAFF	TRBV5-1	TRBJ1-1
TGTGCCAGCAGTTTTACGGGTCTCCCCCCGAAGGGGGGAGGGCGCAATGAGCAGTTCTTC	CASSFTGLPPKGGGRNEQFF	TRBV27	TRBJ2-1
TGTGCCAGCAGCCCTGAGCAGTACTTC	CASSPEQYF	TRBV7-9	TRBJ2-7
TGTGCCAGCAAAAGCCCCTGGGGGGACCCTTACAATGAGCAGTTCTTC	CASKSPWGDPYNEQFF	TRBV7-2	TRBJ2-1
TGTGCCAGCAGTTGCCCGGCTAACTATGGCTACACCTTC	CASSCPANYGYTF	TRBV27	TRBJ1-2
TGTGCTAGTGGTTACGCAGTAAAGCGGAGCAATGAGCAGTTCTTC	CASGYAVKRSNEQFF	TRBV12-5	TRBJ2-1
TGTGCCAGCAGCCCGAACCACCATGAAAAACTGTTTTTT	CASSPNHHEKLFF	TRBV6-4	TRBJ1-4
TGTGCCAGCAGCTTGCGGAGTTACGGGGGGTACGAGCAGTACTTC	CASSLRSYGGYEQYF	TRBV5-8	TRBJ2-7
TGCAGTGCTCGAAATAGGGACTGGGAAGAGACCCAGTACTTC	CSARNRDWEETQYF	TRBV20-1	TRBJ2-5
TGTGCCAGCAGTTACTCGATCACCCCCCCGGATAATGAAAAACTGTTTTTT	CASSYSITPPDNEKLFF	TRBV6-2	TRBJ1-4
TGCGCCAGCAGCTTGGGATCCGGTTATCGGGCCGAGCAGTTCTTC	CASSLGSGYRAEQFF	TRBV5-1	TRBJ2-1
TGTGCCAGCAGTGAGGGGATACAGGGGGCGGGGCAGCAGTACTTC	CASSEGIQGAGQQYF	TRBV6-5	TRBJ2-7
TGCGCCAGCAGCTGCGTCTGGGGTGAGCAGTTCTTC	CASSCVWGEQFF	TRBV5-1	TRBJ2-1
TGTGCCAGCAGACTTTTCCCTGAGACGCCCAAAAACATTCAGTACTTC	CASRLFPETPKNIQYF	TRBV5-6	TRBJ2-4
TGTGCCAGCCACCACAGGGAGAGGGTGAACGAGCAGTACTTC	CASHHRERVNEQYF	TRBV9	TRBJ2-7
TGTGCCAGCAAGGTTACAGGGGGTTACAATGAGCAGTTCTTC	CASKVTGGYNEQFF	TRBV5-6	TRBJ2-1
TGTGCCAGCAGCATTGGGACAGGGTCCGTCAACGAGCAGTACTTC	CASSIGTGSVNEQYF	TRBV6-1	TRBJ2-7
TGTGCCACCGGAGGTCGGGGACCAGCCAAAAACATTCAGTACTTC	CATGGRGPAKNIQYF	TRBV7-8	TRBJ2-4
TGCGCCAGCAGGGTGCGTGATACCGGGGAGCTGTTTTTT	CASRVRDTGELFF	TRBV4-1	TRBJ2-2
TGTGCCAGCACACAGGCCCGGGGCACTGAAGCTTTCTTT	CASTQARGTEAFF	TRBV9	TRBJ1-1
TGTGCTAGTAGGGCCGGGTCTCGCCGGGGGGAAGAGACCCAGTACTTC	CASRAGSRRGEETQYF	TRBV12-5	TRBJ2-5
TGTGCCACCAGTGACCCTGGGCTCTTACAAGAGACCCAGTACTTC	CATSDPGLLQETQYF	TRBV24-1	TRBJ2-5
TGTGCTAGTGGTTTGCATGGGAGGGCTAATGAGCAGTTCTTC	CASGLHGRANEQFF	TRBV12-5	TRBJ2-1
TGTGCCACCAGTGAAATGGGGCACGACACTGAAGCTTTCTTT	CATSEMGHDTEAFF	TRBV24-1	TRBJ1-1
TGCGCCAGCAGCTGCAAAGATCACACTGAAGCTTTCTTT	CASSCKDHTEAFF	TRBV5-1	TRBJ1-1
TGTGCCAGCAGCGAGGACTTACTATACAGCTCTGGGGCCAACGTCCTGACTTTC	CASSEDLLYSSGANVLTF	TRBV9	TRBJ2-6
TGTGCCAGCAGCAGGAACCAGGGGGGCCTCGAGTTTCAGGGCTGGGTAAGCTCCTATAATTCACCCCTCCACTTT	CASSRNQGGLEFQGWVSSYNSPLHF	TRBV11-3	TRBJ1-6
TGTGCCAGCAACAATCACCCCTCCATACCGGGACAGGGGAAGTACGAGCAGTACTTC	CASNNHPSIPGQGKYEQYF	TRBV7-3	TRBJ2-7
TGCAGTGCTAGAGAAGGTCACGGGGGCGAGGATGGCTACACCTTC	CSAREGHGGEDGYTF	TRBV20-1	TRBJ1-2
TGTGCCAGCAGGAACTATCGCCGAGGGCCGAACACCGGGGAGCTGTTTTTT	CASRNYRRGPNTGELFF	TRBV13	TRBJ2-2
TGTGCCAGTCCAGCGAACACTGAAGCTTTCTTT	CASPANTEAFF	TRBV9	TRBJ1-1
TGCAGTGCTCCGGTCGATGTCAGGGGGGCTGAAGCTTTCTTT	CSAPVDVRGAEAFF	TRBV20-1	TRBJ1-1
TGTGCCAGCAGCGGCCCCCGGGAAAGCAATCAGCCCCAGCATTTT	CASSGPRESNQPQHF	TRBV9	TRBJ1-5
TGTGCCAGCAGTTTTCCCGGGACAGGGAAACTGAACACCGGGGAGCTGTTTTTT	CASSFPGTGKLNTGELFF	TRBV12-4	TRBJ2-2
TGTGGGAAGAAACTGCATTCGAACACCGGGGAGCTGTTTTTT	CGKKLHSNTGELFF	TRBV11-3	TRBJ2-2
TGTGCCAGCAGTAGCGGGAACGCGAATGAGCAGTTCTTC	CASSSGNANEQFF	TRBV27	TRBJ2-1
TGTGCCAGCAGCTTAGGTAGCTCGGGAGGGCCCGGAGAGGGGGCGAGATGCTACGAGCAGTACTTC	CASSLGSSGGPGEGARCYEQYF	TRBV11-2	TRBJ2-7
TGTGCCAGCAGTACTGCGGACGAGCAGTACTTC	CASSTADEQYF	TRBV27	TRBJ2-7
TGCAGTGCAAAGGGGGTGGGTGATAGCAATCAGCCCCAGCATTTT	CSAKGVGDSNQPQHF	TRBV20-1	TRBJ1-5
TGCGCCAGCAGCCCCAGGGGCCAGGAGACCCAGTACTTC	CASSPRGQETQYF	TRBV5-1	TRBJ2-5
TGTGCCAGCAGCTTAGGGGGCAATCGCAATCAGCCCCAGCATTTT	CASSLGGNRNQPQHF	TRBV7-2	TRBJ1-5
TGTGCCAGCCACTCCGGGCGCGACGTAGGGTACCAAGAGACCCAGTACTTC	CASHSGRDVGYQETQYF	TRBV27	TRBJ2-5
TGTGCCAGCAAATTCCCTGGACAGAAAGAGACCCAGTACTTC	CASKFPGQKETQYF	TRBV2	TRBJ2-5
TGTGCCACCAGCCATCGGGGGCCCTCGAATCAGCCCCAGCATTTT	CATSHRGPSNQPQHF	TRBV15	TRBJ1-5
TGTGCCAGCAGCTGGCCTGAGGGACTAGGGGGGGGTGACGAGCAGTACTTC	CASSWPEGLGGGDEQYF	TRBV11-2	TRBJ2-7
TGTGCCAGCATGTCAGTAACGGGGGGGATGTTTGGCTACACCTTC	CASMSVTGGMFGYTF	TRBV27	TRBJ1-2
TGTGCCAGCAGCTTTACAGTCTCCTTCCCGTCAGGACTAGGTTCCGGCCAAGAGACCCAGTACTTC	CASSFTVSFPSGLGSGQETQYF	TRBV7-9	TRBJ2-5
TGTGCCAGCAGGATAGAAAAACTGTTTTTT	CASRIEKLFF	TRBV6-5	TRBJ1-4
TGTGCCAGCAGTTTAGGGGAGCAAGAGACCCAGTACTTC	CASSLGEQETQYF	TRBV28	TRBJ2-5
TGTGCCAGACGGTCCGGTACAGAATCCCTCCACTTT	CARRSGTESLHF	TRBV24-1	TRBJ1-6
TGCGCCAGCAGCTTACGACAGGGCGGCGAGCAGTACTTC	CASSLRQGGEQYF	TRBV5-1	TRBJ2-7
TGCGCCAGCGCTCCAAGGGGACACGAGCAGTACTTC	CASAPRGHEQYF	TRBV10-1	TRBJ2-7
TGTGCCAGCAGCCAGGGCTCCTACGAGCAGTACTTC	CASSQGSYEQYF	TRBV7-2	TRBJ2-7
TGTGCCAGCAGCTTGGTGGTCCGGGACAGGGGGAGTAGCAATCAGCCCCAGCATTTT	CASSLVVRDRGSSNQPQHF	TRBV11-2	TRBJ1-5
TGTGCCAGCAGCTCCTGCGGACTAGTTGGAGGGGGTTCCTACGAGCAGTACTTC	CASSSCGLVGGGSYEQYF	TRBV7-6	TRBJ2-7
TGTGCCAGCAGGGACCGCCCCCCGGGACAGGGCGTCTCGGATTTCAATCAGCCCCAGCATTTT	CASRDRPPGQGVSDFNQPQHF	TRBV28	TRBJ1-5
TGCAGTGCTAGAGTGAGGGAGGGCACCGGGGAGCTGTTTTTT	CSARVREGTGELFF	TRBV20-1	TRBJ2-2
TGTGCCAGCAGTGGAGTGGGGGGGTCCAATCAGCCCCAGCATTTT	CASSGVGGSNQPQHF	TRBV2	TRBJ1-5
TGTGCCAGCAGCATAACGGGACTAGCGGGTCAGCGCGGTATGGAGCAGTACTTC	CASSITGLAGQRGMEQYF	TRBV7-4	TRBJ2-7
TGTGCCAGCAGAAGGGTGACCTGGCGGTTAGGCTCCTACGAGCAGTACTTC	CASRRVTWRLGSYEQYF	TRBV6-4	TRBJ2-7
TGTGCCAGCAGCGAAGGCGGCTCAAGCACAGATACGCAGTATTTT	CASSEGGSSTDTQYF	TRBV9	TRBJ2-3
TGTGCCAGTAGTATAGAAAGAGCGGAGGTCCACGAGCAGTACTTC	CASSIERAEVHEQYF	TRBV19	TRBJ2-7
TGTGCCAGCAGCTTAAAGGGGGGGGCTGAAGCTTTCTTT	CASSLKGGAEAFF	TRBV7-3	TRBJ1-1
TGTGCCAGCAGCTTAGATCCGGGGTGGAACTGGAATGAAAAACTGTTTTTT	CASSLDPGWNWNEKLFF	TRBV11-2	TRBJ1-4
TGTGCCAGCAGCGTACGGTGCAGTGGCTGTAGGCGGGCCGGGGAGCTGTTTTTT	CASSVRCSGCRRAGELFF	TRBV9	TRBJ2-2
TGTGCCAGCAGTCGGCGCACTAAGCCTGGCAATCAGCCCCAGCATTTT	CASSRRTKPGNQPQHF	TRBV6-6	TRBJ1-5
TGTGCCAGCAGCTTATTGGCCGGGACAGGGCTGTATTTT	CASSLLAGTGLYF	TRBV7-9	TRBJ2-3
TGTGCCAGCAGCTTAGAGCGGGGGCATGAACTCTATGGCTACACCTTC	CASSLERGHELYGYTF	TRBV11-2	TRBJ1-2
TGTGCCAGCAGCACCGGAGGCTCCTACAATGAGCAGTTCTTC	CASSTGGSYNEQFF	TRBV14	TRBJ2-1
TGTGCCAGCAGAATCAGTTGTCTGGTTAAGGAGACCCAGTACTTC	CASRISCLVKETQYF	TRBV28	TRBJ2-5
TGTGCCAGCTTCCTAGGAGGGCCACGCTACGAGCAGTACTTC	CASFLGGPRYEQYF	TRBV6-5	TRBJ2-7
TGTGCCAGCAGTTTCCTTCGCTTC	CASSFLRF	TRBV28	TRBJ1-2
TGTGCCAGCAGCCCTGGACAGAAAAAGCAAGAGACCCAGTACTTC	CASSPGQKKQETQYF	TRBV13	TRBJ2-5
TGTGCCACCAGCCGGAATGAGACAGCCCCGTCCTATAGCAATCAGCCCCAGCATTTT	CATSRNETAPSYSNQPQHF	TRBV15	TRBJ1-5
TGTGCCACCCTCGGGACTGAGCAGTTCTTC	CATLGTEQFF	TRBV24-1	TRBJ2-1
TGCGCCAGCAGACCCTCCTTGAGCGGGCGGGGGGGGGCCAACGTCCTGACTTTC	CASRPSLSGRGGANVLTF	TRBV5-1	TRBJ2-6
TGTGCCAGCAGTCTCAAGTCGGATCCCGGCAATTCACCCCTCCACTTT	CASSLKSDPGNSPLHF	TRBV27	TRBJ1-6
TGTGCCAGCAGCCGTCACAGGGTATTATTAGGGTTCTTT	CASSRHRVLLGFF	TRBV4-2	TRBJ1-1
TGTGCCAGCAGTTACTCGGCACGAAACACCGGGGAGCTGTTTTTT	CASSYSARNTGELFF	TRBV6-2	TRBJ2-2
TGTGCCAGCAAGGGGGTGGGGACTGAAGCTTTCTTT	CASKGVGTEAFF	TRBV12-3	TRBJ1-1
TGCAGTGCGGGCTTCGGCGCAACTAATGAAAAACTGTTTTTT	CSAGFGATNEKLFF	TRBV20-1	TRBJ1-4
TGTGCCAGCAGCTCGTCACCACGTACAGGGGGCTACGACACTGAAGCTTTCTTT	CASSSSPRTGGYDTEAFF	TRBV7-2	TRBJ1-1
TGTGCCAGTAGTATTTCTTGTTGCGTGACCTCCGCTGAAGCTTTCTTT	CASSISCCVTSAEAFF	TRBV19	TRBJ1-1
TGTGCCAGCAGCCCTAGGGTACTCCACTATGGCTACACCTTC	CASSPRVLHYGYTF	TRBV14	TRBJ1-2
TGTGCCAGCAGCTGGACTAGCCGGGACAGGAACTTCCAGGGGTATAGCAATCAGCCCCAGCATTTT	CASSWTSRDRNFQGYSNQPQHF	TRBV5-4	TRBJ1-5
TGTGCCAGCAGTTTCTCCACTAGCGGCGGTGGGGAGCAGTACTTC	CASSFSTSGGGEQYF	TRBV27	TRBJ2-7
TGCAGTGCTAGTCTAGGGAGTAATGGCTACACCTTC	CSASLGSNGYTF	TRBV20-1	TRBJ1-2
TGCAGTGCTAGAGGAGGACAGGACAATGAGCAGTTCTTC	CSARGGQDNEQFF	TRBV20-1	TRBJ2-1
TGTGCCAGCAGTAGCAGGGGGCCTGATACGCAGTATTTT	CASSSRGPDTQYF	TRBV27	TRBJ2-3
TGTGCCAGCAGCCAAGATCCGAAAATTGACAGGGCACACCCTGGCTACACCTTC	CASSQDPKIDRAHPGYTF	TRBV4-2	TRBJ1-2
TGTGCCTGGCCGGGAAGAAGGGACCCTGAGGAGCAGCCCCAGCATTTT	CAWPGRRDPEEQPQHF	TRBV30	TRBJ1-5
TGTGCCAGCAGCCAGGAAGGGGACAGATGCTCCTACAATGAGCAGTTCTTC	CASSQEGDRCSYNEQFF	TRBV3-1	TRBJ2-1
TGTGCCATCCGGGACAGGGGGCACTATGGCTACACCTTC	CAIRDRGHYGYTF	TRBV10-3	TRBJ1-2
TGTGCCAGCAACAGGATAGCGCAAGCGGTCGAGCAGGGCACCGGGGAGCTGTTTTTT	CASNRIAQAVEQGTGELFF	TRBV6-4	TRBJ2-2
TGCGCCAGCAGCTCGCCGCGGGAGTGTTGGGGCTACACCTTC	CASSSPRECWGYTF	TRBV5-1	TRBJ1-2
TGTGCCAGCAGTCGTGGGGGGGGGGGCTCAGATACGCAGTATTTT	CASSRGGGGSDTQYF	TRBV6-1	TRBJ2-3
TGTGCCAGCAGCTTAAACGACTATGGCTACACCTTC	CASSLNDYGYTF	TRBV11-2	TRBJ1-2
TGTGCCAGCAGCCGCCATAGGGGGGGAGGACCCACAGATACGCAGTATTTT	CASSRHRGGGPTDTQYF	TRBV13	TRBJ2-3
TGTGCCAGCAGCCTGATGGCTAGGACAGGGACAGATACGCAGTATTTT	CASSLMARTGTDTQYF	TRBV13	TRBJ2-3
TGTGCCAGCAGCCAAGGGAGGGGGGGCAGATACGAGCAGTACTTC	CASSQGRGGRYEQYF	TRBV14	TRBJ2-7
TGTGCCAGCAGCCTGGACAAGCAGGGCTCCTATAATTCACCCCTCCACTTT	CASSLDKQGSYNSPLHF	TRBV7-4	TRBJ1-6
TGTGCCAGCATAGGAAAAGGGGGACAGCAGTACTTC	CASIGKGGQQYF	TRBV6-6	TRBJ2-7
TGTGCCAGCAAAGGTGTAAATCCTGGACTAGCGGGCGAGCAGTACTTC	CASKGVNPGLAGEQYF	TRBV12-3	TRBJ2-7
TGCAGTGCGACTCACGACAGCACCTTC	CSATHDSTF	TRBV20-1	TRBJ1-2
TGTGCCAGCAGTCCGGGAAACAGGGCCGAAAAACTGTTTTTT	CASSPGNRAEKLFF	TRBV27	TRBJ1-4
TGTGCCATCACGTCTCGACAGTCCTACGAGCAGTACTTC	CAITSRQSYEQYF	TRBV10-3	TRBJ2-7
TGTGCCAGCTCACGAATCCGACGGACTAGCGGGATTATGGGGGGGGGCACAGATACGCAGTATTTT	CASSRIRRTSGIMGGGTDTQYF	TRBV18	TRBJ2-3
TGTGCCAGCCGTATGGGGGGGCATCGCTACGAGCAGTACTTC	CASRMGGHRYEQYF	TRBV6-5	TRBJ2-7
TGTGCCAGCCGGTGCTCCTACGAGCAGTACTTC	CASRCSYEQYF	TRBV12-3	TRBJ2-7
TGCGCCAGCAGCGGGGAAAATCCCTACGAGCAGTACTTC	CASSGENPYEQYF	TRBV5-1	TRBJ2-7
TGCGCCAGAGGACGGTCCAGCTCCTATAATTCACCCCTCCACTTT	CARGRSSSYNSPLHF	TRBV5-1	TRBJ1-6
TGTGCCAGCAGTCCGGCACTAGCGGCAGGAGGAAATGAGCAGTTCTTC	CASSPALAAGGNEQFF	TRBV12-3	TRBJ2-1
TGTGCCACCAGTGATTTGCCTTCCCGGGACAGGGTTCCCTACGAGCAGTACTTC	CATSDLPSRDRVPYEQYF	TRBV24-1	TRBJ2-7
TGTGCCAGCAGCGGGGCCTACAATGAGCAGTTCTTC	CASSGAYNEQFF	TRBV13	TRBJ2-1
TGTGCCAGCAGCGAGACCGAAGACCCAGAGCAGTACTTC	CASSETEDPEQYF	TRBV7-9	TRBJ2-7
TGTGCCAGCAGCTTAGTTCCGGGGGAACCCTACGAGCAGTACTTC	CASSLVPGEPYEQYF	TRBV11-3	TRBJ2-7
TGTGCCACGCGGACTCAGCCCCAGCATTTT	CATRTQPQHF	TRBV25-1	TRBJ1-5
TGCAGTGCCGTAGGGAGGCCGTGGGAGCAGTACTTC	CSAVGRPWEQYF	TRBV20-1	TRBJ2-7
TGTGCCAGTATGCGCTTGACCCTAAAGGGGATAGAGACCCAGTACTTC	CASMRLTLKGIETQYF	TRBV19	TRBJ2-5
TGTGCCAGCTCCGATGGCTACACCTTC	CASSDGYTF	TRBV7-9	TRBJ1-2
TGTGCCAGCAGCAATGAAGGACAGACGGCAGATACGCAGTATTTT	CASSNEGQTADTQYF	TRBV13	TRBJ2-3
TGTGCCAGCAGAAGGCCGGGACCGGGTGAGCAGTTCTTC	CASRRPGPGEQFF	TRBV6-2	TRBJ2-1
TGTGCCACCAGACGGGGGGCCAGGACCTACAATGAGCAGTTCTTC	CATRRGARTYNEQFF	TRBV24-1	TRBJ2-1
TGCAGTGCTATTCAAAAGTATACCGAAGAGACCCAGTACTTC	CSAIQKYTEETQYF	TRBV20-1	TRBJ2-5
TGCGCCAGCAGTGAGTCTCTCCCCAGGGCGCACGGTAATCAGCCCCAGCATTTT	CASSESLPRAHGNQPQHF	TRBV10-1	TRBJ1-5
TGTGCCAGCAGCTTAGGAGGGATTGCCGAGCAGTACTTC	CASSLGGIAEQYF	TRBV7-6	TRBJ2-7
TGTGCCAGCTCGCCGAAGGGGACAGAGGACTACAATGAGCAGTTCTTC	CASSPKGTEDYNEQFF	TRBV18	TRBJ2-1
TGTGCCAGCAGCTGGGACCCCCGTGGACTAGCTAGCTCCTACGAGCAGTACTTC	CASSWDPRGLASSYEQYF	TRBV7-3	TRBJ2-7
TGCGCCAGCAGCAAGAGCAGAGGGTTGGTCACCGGGGAGCTGTTTTTT	CASSKSRGLVTGELFF	TRBV5-1	TRBJ2-2
TGCGCCAGCGACAGCGGAGAAACACTGACTTACAATGAGCAGTTCTTC	CASDSGETLTYNEQFF	TRBV10-1	TRBJ2-1
TGCGCCAGCAGCTTGAGGGGAGGACTGTTTTTT	CASSLRGGLFF	TRBV5-1	TRBJ1-4
TGTGCCAGCAGTTTGGCCACAGGGGGCACTGAAGCTTTCTTT	CASSLATGGTEAFF	TRBV12-4	TRBJ1-1
TGTGCCAGCAGTTATTGGGGGGAGGGCCCTTTTCAAGAGACCCAGTACTTC	CASSYWGEGPFQETQYF	TRBV6-5	TRBJ2-5
TGCGCCAGCAGCCAATTTTTCGGCCAAGAGACCCAGTACTTC	CASSQFFGQETQYF	TRBV5-1	TRBJ2-5
TGCAGTGTGAGAAGCGGGACCCTTTTTGGTTACGAGCAGTACTTC	CSVRSGTLFGYEQYF	TRBV20-1	TRBJ2-7
TGCGCCAGCAGCCACAAACCCGGTAGGGATGCAACTAATGAAAAACTGTTTTTT	CASSHKPGRDATNEKLFF	TRBV4-1	TRBJ1-4
TGTGCCAGCAGAACAGTGGGAGATACGCAGTATTTT	CASRTVGDTQYF	TRBV9	TRBJ2-3
TGTGCCAGCAGTTTGGAGCGCCCCTGGGGGGGCCTTCGGAACACTGAAGCTTTCTTT	CASSLERPWGGLRNTEAFF	TRBV28	TRBJ1-1
TGTGCCAGCCGGAGACAGCCCCAGCATTTT	CASRRQPQHF	TRBV2	TRBJ1-5
TGTGCCAGCACGCTTCCCGGGACTAGCACCGGGGAGCTGTTTTTT	CASTLPGTSTGELFF	TRBV5-5	TRBJ2-2
TGCAGTGCTAGAGTATCCCTCGCTTTCCCGGGGCCGAACACCGGGGAGCTGTTTTTT	CSARVSLAFPGPNTGELFF	TRBV20-1	TRBJ2-2
TGCGGGACTCGAAACTATGGCTACACCTTC	CGTRNYGYTF	TRBV10-1	TRBJ1-2
TGTGCCAGCAGCAAAATGAGGGGAACTTCCTACGAGCAGTACTTC	CASSKMRGTSYEQYF	TRBV7-9	TRBJ2-7
TGTGCCAGCAGTGACTCGCACCTGAACAGGACAGAGGGACTGGCCGGGGAGCTGTTTTTT	CASSDSHLNRTEGLAGELFF	TRBV6-4	TRBJ2-2
TGCGCCAGCAGTGAGGAAAAGGGCGGGTTCGTTCGGAATCAGCCCCAGCATTTT	CASSEEKGGFVRNQPQHF	TRBV10-1	TRBJ1-5
TGTGCCAGCAGCGTAAATTACCTACAGGGATGGCCGACAGCTTTCTTT	CASSVNYLQGWPTAFF	TRBV9	TRBJ1-1
TGTGCCAGCAAACCGGTCTCCGGGACTAGGCCAAGTCTCTCCTACGAGCAGTACTTC	CASKPVSGTRPSLSYEQYF	TRBV7-2	TRBJ2-7
TGTGCCAGTAGTACTAGCGACACAGATACGCAGTATTTT	CASSTSDTDTQYF	TRBV19	TRBJ2-3
TGTGCCAGCAGTTCGTCAGCCCCCCGGGCGCAGGAGAGCTCCTACAATGAGCAGTTCTTC	CASSSSAPRAQESSYNEQFF	TRBV28	TRBJ2-1
TGCGCCAGCCTGGGGGCTCCGGAGAACACTGAAGCTTTCTTT	CASLGAPENTEAFF	TRBV5-1	TRBJ1-1
TGTGCCAGCAGAGTAGGACTCCTCCTTGCAACTAATGAAAAACTGTTTTTT	CASRVGLLLATNEKLFF	TRBV12-4	TRBJ1-4
TGTGCCAGCAGCTTAGCAGGGACCGCTAGGGGAATGGAGCAGTACTTC	CASSLAGTARGMEQYF	TRBV7-2	TRBJ2-7
TGTGCCAGCAGCGCAGGGGGTGGGGTCATTTCCTACAATGAGCAGTTCTTC	CASSAGGGVISYNEQFF	TRBV6-5	TRBJ2-1
TGCGCCAGCAGCCGGAGGGGTTCTCGGGATGAAAAACTGTTTTTT	CASSRRGSRDEKLFF	TRBV5-1	TRBJ1-4
TGTGCCAGCAGCTTAGAACCGGGACAGGGGCCCACTCAGCCCCAGCATTTT	CASSLEPGQGPTQPQHF	TRBV7-6	TRBJ1-5
TGCGCCAGCAGGGAACAGAGAAACTACGAGCAGTACTTC	CASREQRNYEQYF	TRBV10-1	TRBJ2-7
TGTGCCAGCAGCGGTACAGGGCTCTATGGCACCGGGGAGCTGTTTTTT	CASSGTGLYGTGELFF	TRBV7-2	TRBJ2-2
TGTGCCAGCACCTGGACAGGGCTGGAGACCTACGAGCAGTACTTC	CASTWTGLETYEQYF	TRBV7-7	TRBJ2-7
TGCGCCAGCAGGAAGACAGGGGATGGCTACACCTTC	CASRKTGDGYTF	TRBV5-1	TRBJ1-2
TGTGCCAGCTGGGATTGCAGCCCCGTGAACACTGAAGCTTTCTTT	CASWDCSPVNTEAFF	TRBV6-2	TRBJ1-1
TGCGCCAGCATGAGGGGGCGAGATTATAGCAATCAGCCCCAGCATTTT	CASMRGRDYSNQPQHF	TRBV10-1	TRBJ1-5
TGCGCCAGCGGCTCTTCCTACGACTTCGTCGAGCAGTACTTC	CASGSSYDFVEQYF	TRBV4-1	TRBJ2-7
TGTGCCAGCAGTTGGGGAATCCACTATGGCTACACCTTC	CASSWGIHYGYTF	TRBV12-3	TRBJ1-2
TGTGCCACCAGTGAGGTCCCGGGGGAGCGCACCTTC	CATSEVPGERTF	TRBV24-1	TRBJ1-2
TGTGCCAGCAGCTTAACCCCACTCACAGATACGCAGTATTTT	CASSLTPLTDTQYF	TRBV7-3	TRBJ2-3
TGTGCCACCAGCAGAGGTCCATTTATAAACAATCAGCCCCAGCATTTT	CATSRGPFINNQPQHF	TRBV15	TRBJ1-5
TGCAGTGCTAGCGGTCCTTTGGGACAGGAGCAGTACTTC	CSASGPLGQEQYF	TRBV20-1	TRBJ2-7
TGTGCCTCGGCCGTCCCGGCCGGGACTAGCGGGGGGAATGAGATTATGACCCAGTACTTC	CASAVPAGTSGGNEIMTQYF	TRBV5-5	TRBJ2-5
TGCAGTGCTAGTCCAAGACTAGCGGGGGGGCCAGAGACCCAGTACTTC	CSASPRLAGGPETQYF	TRBV20-1	TRBJ2-5
TGTGCCAGCAGCAGCCGGGGCAATCAGCCCCAGCATTTT	CASSSRGNQPQHF	TRBV7-9	TRBJ1-5
TGTGCCTGGAGTGTACCCCTCCTCCGGGACAGCTACGAGCAGTACTTC	CAWSVPLLRDSYEQYF	TRBV30	TRBJ2-7
TGTGCCAGCAATCCCCGGGGGAGGGTTCAGCCCCAGCATTTT	CASNPRGRVQPQHF	TRBV27	TRBJ1-5
TGCAGTGCTACCCGACAGGGCTCTGGGGCCAACGTCCTGACTTTC	CSATRQGSGANVLTF	TRBV20-1	TRBJ2-6
TGTGCCAGCAGTGCGGTCGACAGGGGCGACCCGGGAAGCAATCAGCCCCAGCATTTT	CASSAVDRGDPGSNQPQHF	TRBV2	TRBJ1-5
TGTGCCAGCAGTTCAGGTCGAAAATACCGCTATGGCTACACCTTC	CASSSGRKYRYGYTF	TRBV6-5	TRBJ1-2
TGTGCCAGCAGTACTCGGGGGGGCCCGCGGCGGTCGTACGAGCAGTACTTC	CASSTRGGPRRSYEQYF	TRBV13	TRBJ2-7
TGTGCCAGCAGTGCCCGCACCGTAGGGGTCGAGCAGTACTTC	CASSARTVGVEQYF	TRBV28	TRBJ2-7
TGCGCCAGCAGTGAAAAGACAGGGGGCGATAACGAGCAGTACTTC	CASSEKTGGDNEQYF	TRBV10-1	TRBJ2-7
TGTGCCAGCAGTTACTGTGGTGAACGACTAGGGGCCTTTGGCACAGATACGCAGTATTTT	CASSYCGERLGAFGTDTQYF	TRBV6-5	TRBJ2-3
TGTGCCAGCAGCTACTGGGGTCCCGGAGAGACCCAGTACTTC	CASSYWGPGETQYF	TRBV7-6	TRBJ2-5
TGTGCCAGCAGCTTAAGTCCGGGACAAAGACCGAGTGAAGCTTTCTTT	CASSLSPGQRPSEAFF	TRBV7-3	TRBJ1-1
TGTGCCAGCAGTTTGGGGGGGGGGGTCTTC	CASSLGGGVF	TRBV28	TRBJ2-1
TGCGCCAGCAGCCAAGATCGGGACAGGGGGTATGGCTACACCTTC	CASSQDRDRGYGYTF	TRBV4-1	TRBJ1-2
TGTGCCAGCAGCTTATCAGGGGGGGGTGACTATGGCTACACCTTC	CASSLSGGGDYGYTF	TRBV7-7	TRBJ1-2
TGTGCCAGCAGTGGGAATCTTGGAGGGTGTCCGGACAATGAGCAGTTCTTC	CASSGNLGGCPDNEQFF	TRBV6-4	TRBJ2-1
TGTGCCAGTAGGGGACTTGAAGCTTTCTTT	CASRGLEAFF	TRBV30	TRBJ1-1
TGTGCCAGAACCCCCATTTCGGACAGGGGGCCGTACCAAGAGACCCAGTACTTC	CARTPISDRGPYQETQYF	TRBV6-4	TRBJ2-5
TGTGCCAGCAGTGATAGTAAGGGACAGGGCTTCTGTATGTACTTCTGGGCCTTCTTAAGAGAGACCCAGTACTTC	CASSDSKGQGFCMYFWAFLRETQYF	TRBV6-1	TRBJ2-5
TGTGCCAGCAGCGGGCCGCCCCGGGGTAGATTACTTACCTCGGATCAGCCCCAGCATTTT	CASSGPPRGRLLTSDQPQHF	TRBV13	TRBJ1-5
TGTGCCATCGGCGAAGCACGGTGTCGTAAAAGTTTGCTCTACGAGCAGTACTTC	CAIGEARCRKSLLYEQYF	TRBV10-3	TRBJ2-7
TGCAGCGTAGGCCGCGACTCCTACAATGAGCAGTTCTTC	CSVGRDSYNEQFF	TRBV29-1	TRBJ2-1
TGTGCCAGCAGCCAAGATTCAGATTTGACCTACGAGCAGTACTTC	CASSQDSDLTYEQYF	TRBV3-1	TRBJ2-7
TGTGCCAGCAGGACTAGCGGGTACACGCAGGGCAATGAGCAGTTCTTC	CASRTSGYTQGNEQFF	TRBV11-3	TRBJ2-1
TGTGCCAGCAGTCCGCGGACGGGGTATGGCTACACCTTC	CASSPRTGYGYTF	TRBV6-1	TRBJ1-2
TGTGCCAGCACGCAGGGGGCATGGGGGTCCTCTGGGGCCAACGTCCTGACTTTC	CASTQGAWGSSGANVLTF	TRBV6-5	TRBJ2-6
TGTGCCAGCAGCCGGGACGATAATGAAAAACTGTTTTTT	CASSRDDNEKLFF	TRBV9	TRBJ1-4
TGTGCCAGCAGTTACTCGGACAGGCCAGATACGCAGTATTTT	CASSYSDRPDTQYF	TRBV6-2	TRBJ2-3
TGTGCCAGCGGGGGCAGCGGCTTT	CASGGSGF	TRBV7-4	TRBJ1-1
TGTGCCAGCAGCCGCAGGGGGACTGAAGCTTTCTTT	CASSRRGTEAFF	TRBV27	TRBJ1-1
TGTGCCAGCAGCTTCTCAGTGAATGAAAAACTGTTTTTT	CASSFSVNEKLFF	TRBV7-7	TRBJ1-4
TGTGCCAGCAGTTACTCGAGGGACAGGGGGACCTGGATTGGCCAGCCCCAGCATTTT	CASSYSRDRGTWIGQPQHF	TRBV6-5	TRBJ1-5
TGTGCCAGCAGCTTAGTACTAATTTCTCGGACCTACAATGAGCAGTTCTTC	CASSLVLISRTYNEQFF	TRBV11-2	TRBJ2-1
TGTGCCAGCAGCGCCGTACGGAAAGAGGGGCGAGGCACTGAAGCTTTCTTT	CASSAVRKEGRGTEAFF	TRBV4-2	TRBJ1-1
TGTGCCAGCCGCAACGGGGCTGGAAACACCATATATTTT	CASRNGAGNTIYF	TRBV7-7	TRBJ1-3
TGTGCCAGCAGAGGCCGGGGGAAAAACATTCAGTACTTC	CASRGRGKNIQYF	TRBV5-4	TRBJ2-4
TGTGCCAGTTGCCAGGCTAACTATGGCTACACCTTC	CASCQANYGYTF	TRBV11-3	TRBJ1-2
TGCGCCAGCAGCTTGGGATCCTTTAGAAGGTCGGACAGGGGTCGGAACACTGAAGCTTTCTTT	CASSLGSFRRSDRGRNTEAFF	TRBV5-1	TRBJ1-1
TGTGCCACCATTCCGGGGGCTCGGGAGCAGTACTTC	CATIPGAREQYF	TRBV24-1	TRBJ2-7
TGTGCCAGCAGCAATAGCGGGACTAATCGGGGCTACGAGCAGTACTTC	CASSNSGTNRGYEQYF	TRBV7-9	TRBJ2-7
TGTGCCTGGAAAATGAGAGTCGGACTGGTATTCTCCGACACCTACGAGCAGTACTTC	CAWKMRVGLVFSDTYEQYF	TRBV30	TRBJ2-7
TGTGCCAGCAGTAACCCGGGACAGCAGAACCCGAATCAGCCCCAGCATTTT	CASSNPGQQNPNQPQHF	TRBV28	TRBJ1-5
TGTGCCAGCAGTTTATCGCGGGACGGAGGTCGCTACAATGAGCAGTTCTTC	CASSLSRDGGRYNEQFF	TRBV27	TRBJ2-1
TGCAGTGCACACAGAGCTGGCTACACCTTC	CSAHRAGYTF	TRBV20-1	TRBJ1-2
TGTGCCAGATGGTATAGGGGGCACGGAAACACCATATATTTT	CARWYRGHGNTIYF	TRBV19	TRBJ1-3
TGTGCCAGCACTTACAGGGGTGTAGCCAAAAACATTCAGTACTTC	CASTYRGVAKNIQYF	TRBV6-3	TRBJ2-4
TGTGCCAGCAGCTGTCAGGGGATCAATCAGCCCCAGCATTTT	CASSCQGINQPQHF	TRBV7-9	TRBJ1-5
TGTGCCAGCAGCTCGGGGGTATATAGCAATCAGCCCCAGCATTTT	CASSSGVYSNQPQHF	TRBV7-3	TRBJ1-5
TGCAGTGCGACTAGCGGGGGGCGGAATGAGCAGTTCTTC	CSATSGGRNEQFF	TRBV20-1	TRBJ2-1
TGTGCCAGCAGCAGGAGAGGATTGAGGAGCAATCAGCCCCAGCATTTT	CASSRRGLRSNQPQHF	TRBV7-4	TRBJ1-5
TGTGCCAGCAGCTCTACGAGCACAGATACGCAGTATTTT	CASSSTSTDTQYF	TRBV13	TRBJ2-3
TGTGCCAGCAGATCGGGGAGTGAAAGCTCCTACAATGAGCAGTTCTTC	CASRSGSESSYNEQFF	TRBV13	TRBJ2-1
TGTGCCAGCAGCTCTGGGATGACAGCCACTGAAGCTTTCTTT	CASSSGMTATEAFF	TRBV12-3	TRBJ1-1
TGTGCCAGCAGCCGGAGGACAGTCCCAAACACCGGGGAGCTGTTTTTT	CASSRRTVPNTGELFF	TRBV7-9	TRBJ2-2
TGTGCCAGCAGTTACAATGAAATATTAACCAAAAACATTCAGTACTTC	CASSYNEILTKNIQYF	TRBV6-6	TRBJ2-4
TGCAGCTCTAAGCGGGAGGGGATCATGGGCAATCAGCCCCAGCATTTT	CSSKREGIMGNQPQHF	TRBV20-1	TRBJ1-5
TGTGCCAGCTGGCAGGTTTTTGGTGAGCAGTTCTTC	CASWQVFGEQFF	TRBV2	TRBJ2-1
TGTGCCAGCAGCCAAGCATGCCGGGTTCCTGAAAAACTGTTTTTT	CASSQACRVPEKLFF	TRBV4-2	TRBJ1-4
TGTGCCAGCAGCACGCCGCAAGAGACCCAGTACTTC	CASSTPQETQYF	TRBV5-4	TRBJ2-5
TGTGCCAGCTCACCACCTTCCTTCAATCAGCCCCAGCATTTT	CASSPPSFNQPQHF	TRBV18	TRBJ1-5
TGTGCCAGCAGTTTATTTCTAGGACGTACCGGGGAGCTGTTTTTT	CASSLFLGRTGELFF	TRBV12-3	TRBJ2-2
TGTGCCAGCAGCTTAGCCCCGGGGGGCTACACCTTC	CASSLAPGGYTF	TRBV7-9	TRBJ1-2
TGTGCCAGCAGCCATTGGGGACTCCCAGAAGTAACCTGTAACACCGGGGAGCTGTTTTTT	CASSHWGLPEVTCNTGELFF	TRBV14	TRBJ2-2
TGTGCCAGCAGCGCGGGGGGAAAGGCCACCGGGGAGCTGTTTTTT	CASSAGGKATGELFF	TRBV14	TRBJ2-2
TGTGCCAGCAGCCAAAGGGGACCGACAGCGAACACCGGGGAGCTGTTTTTT	CASSQRGPTANTGELFF	TRBV7-6	TRBJ2-2
TGTGCCAGCAGTTTGAGCTTTGGGCGAGACACTGAAGCTTTCTTT	CASSLSFGRDTEAFF	TRBV12-4	TRBJ1-1
TGCGCCAGCAGCGGGTGCCTTACCGGCACTGAAGCTTTCTTT	CASSGCLTGTEAFF	TRBV4-1	TRBJ1-1
TGTGCCAGCAGCTTAGTCAATGAGTTTGAGCATTACGAGCAGTACTTC	CASSLVNEFEHYEQYF	TRBV7-2	TRBJ2-7
TGTGCCAGCAGCCAACAGCCTAACTACAATGAGCAGTTCTTC	CASSQQPNYNEQFF	TRBV14	TRBJ2-1
TGTGCCAGCAGATCCTCCATCCCGAACGAGCAGTACTTC	CASRSSIPNEQYF	TRBV6-5	TRBJ2-7
TGTGCCAGCAGCCAAGCTACTCTGACAGGGCCGACTTCCTACGAGCAGTACTTC	CASSQATLTGPTSYEQYF	TRBV14	TRBJ2-7
TGCGCCAGTGGGGCTTGGGAGCAGTTCTTC	CASGAWEQFF	TRBV10-1	TRBJ2-1
TGTGCCAGCAGTGATCATATACCGGGACTAGCGGAGGAAGCAGAGACCCAGTACTTC	CASSDHIPGLAEEAETQYF	TRBV6-4	TRBJ2-5
TGTGCCAGCCGGCGGGAGGGCCCTCGATATACGCAGTATTTT	CASRREGPRYTQYF	TRBV19	TRBJ2-3
TGTGCCAGCAGCGCCCGGGCAGGGTTCAATCAGCCCCAGCATTTT	CASSARAGFNQPQHF	TRBV7-3	TRBJ1-5
TGTGCCACCAGTGAGCTGACAGGTACCGGGATTACTAACTATGGCTACACCTTC	CATSELTGTGITNYGYTF	TRBV24-1	TRBJ1-2
TGTGCCAGCAGCGGGGACAGGGGGAATCAGCCCCAGCATTTT	CASSGDRGNQPQHF	TRBV13	TRBJ1-5
TGTGCCAGCAGCAAATCGCGCCCGGGACAGGGGTTAGGCTACACCTTC	CASSKSRPGQGLGYTF	TRBV7-3	TRBJ1-2
TGTGCCAGCCGTAGGGGCCAAGACGAGCAGTACTTC	CASRRGQDEQYF	TRBV6-1	TRBJ2-7
TGTGCTAGTGGCACGGGGAGACTTTGTCGAAACACCATATATTTT	CASGTGRLCRNTIYF	TRBV12-5	TRBJ1-3
TGTGCCAGCAGCATGATCGGGTCACCCAGTTGGCGCGGAAACACCATATATTTT	CASSMIGSPSWRGNTIYF	TRBV7-3	TRBJ1-3
TGCAGTGCTAGAGGACGGGACAGGGGGCACACAGATACGCAGTATTTT	CSARGRDRGHTDTQYF	TRBV20-1	TRBJ2-3
TGTGCCAGCAGCCAAGATCGCTGGGGCTACACCTTC	CASSQDRWGYTF	TRBV4-2	TRBJ1-2
TGTGCCAGCAGCATGGTGGGGGCCCCGGGAGAACTCATAAACACTGAAGCTTTCTTT	CASSMVGAPGELINTEAFF	TRBV13	TRBJ1-1
TGTGCCAGCAGCTATACCCAAGGGGGGGGAGAGGCCAAAAACATTCAGTACTTC	CASSYTQGGGEAKNIQYF	TRBV13	TRBJ2-4
TGTGCCACCTGCACTAGCGGTATGGGGTACACCGGGGAGCTGTTTTTT	CATCTSGMGYTGELFF	TRBV11-3	TRBJ2-2
TGTGCCAGCAGTTTACCCCCGGGGACAGGGCCCATCTCCTATAATTCACCCCTCCACTTT	CASSLPPGTGPISYNSPLHF	TRBV27	TRBJ1-6
TGTGCCACCAGTGATTTGGAACGACGAGTGGAGTCCTACGAGCAGTACTTC	CATSDLERRVESYEQYF	TRBV24-1	TRBJ2-7
TGTGCCAGTATCCTTGAGGGCACAGATACGCAGTATTTT	CASILEGTDTQYF	TRBV19	TRBJ2-3
TGCGCCAGCAGCTACCGTCCGGTTAGGGACGAGCAGTACTTC	CASSYRPVRDEQYF	TRBV5-1	TRBJ2-7
TGTGCCATCATTTGCGATGGACCCTCTGGAAACACCATATATTTT	CAIICDGPSGNTIYF	TRBV10-3	TRBJ1-3
TGTGCCACCAGCAGAGATGGTGACCCTCCGGGACGAACGCAGCCCCAGCATTTT	CATSRDGDPPGRTQPQHF	TRBV15	TRBJ1-5
TGCAGTGCTACCCGGAGGTTGATCACTGAAGCTTTCTTT	CSATRRLITEAFF	TRBV20-1	TRBJ1-1
TGTGCCAGCAGCTTAGGCAATCCGGAAGAGACCCAGTACTTC	CASSLGNPEETQYF	TRBV7-2	TRBJ2-5
TGTGCCACCAGCATCCAGGGACAGGGCTCTGGAAACACCATATATTTT	CATSIQGQGSGNTIYF	TRBV15	TRBJ1-3
TGCGCCAGCAGCTCGTTTGTAAGGGGGTGGACCTATGGCTACACCTTC	CASSSFVRGWTYGYTF	TRBV5-1	TRBJ1-2
TGTGCCAGCAGCTTAGTTTGGGCTGGAACAACCGGGGAGCTGTTTTTT	CASSLVWAGTTGELFF	TRBV11-3	TRBJ2-2
TGTGCCAGCAGTGAAGCCTTGTCAACTGTGGGGGACTGCTTCCACCATAATGAAAAACTGTTTTTT	CASSEALSTVGDCFHHNEKLFF	TRBV6-1	TRBJ1-4
TGTGCCAGCAGCAAACTCTATTGCCACCCGTCGACTAGCTATGGCTACACCTTC	CASSKLYCHPSTSYGYTF	TRBV27	TRBJ1-2
TGTGCCAGCAGATCCCGGAAGCCCTACGAGCAGTACTTC	CASRSRKPYEQYF	TRBV6-5	TRBJ2-7
TGCGCCAGCAGCAAGAGAAACACAGGGGACGCAAGGTATAGCAATCAGCCCCAGCATTTT	CASSKRNTGDARYSNQPQHF	TRBV5-1	TRBJ1-5
TGTGCCACCGGCAGGGCCGGGTTGAACACTGAAGCTTTCTTT	CATGRAGLNTEAFF	TRBV15	TRBJ1-1
TGTGCCAGCAGCTTACCAGATCGACAGGAGGGGACTATAAACGGCTACACCTTC	CASSLPDRQEGTINGYTF	TRBV11-1	TRBJ1-2
TGTGCCAGCACGGACAGGTGCCACAGTCCTCGGGGCTACAATGAGCAGTTCTTC	CASTDRCHSPRGYNEQFF	TRBV6-5	TRBJ2-1
TGCGCCAGCAGCCAACTTACTAGCGGGTCCGCTGAGCAGTTCTTC	CASSQLTSGSAEQFF	TRBV4-1	TRBJ2-1
TGTGCCAGCAGAAAGGGGCTGAACACTGAAGCTTTCTTT	CASRKGLNTEAFF	TRBV7-9	TRBJ1-1
TGCAGCGTTGCTTTCCCGCGGACTAGCGGGCTAGGGGAGCTGTTTTTT	CSVAFPRTSGLGELFF	TRBV29-1	TRBJ2-2
TGTGCCATAATCCCGCGGGGCTCTGGAAACACCATATATTTT	CAIIPRGSGNTIYF	TRBV6-2	TRBJ1-3
TGTGCCAGCAGTTATTCCGACCGGGACAGGGCGTATGGCTACACCTTC	CASSYSDRDRAYGYTF	TRBV6-9	TRBJ1-2
TGCGCCAGCAGCTTGGCCGGTCGGGACCGCCTCAATGAGCAGTTCTTC	CASSLAGRDRLNEQFF	TRBV5-1	TRBJ2-1
TGCGCAGGCAGGAAGAGGGCCAAAAACATTCAGTACTTC	CAGRKRAKNIQYF	TRBV5-1	TRBJ2-4
TGCGCCACCGGGCGGACGGAAAGCAATCAGCCCCAGCATTTT	CATGRTESNQPQHF	TRBV10-1	TRBJ1-5
TGTGCCAGCAGCTTAATGATGAGTCTCGCAGTTAATCAGCCCCAGCATTTT	CASSLMMSLAVNQPQHF	TRBV11-3	TRBJ1-5
TGTGCCAGCAGGCCGGGGACAATCATGAACACTGAAGCTTTCTTT	CASRPGTIMNTEAFF	TRBV3-1	TRBJ1-1
TGTGCCAAGGCCAGGCTCCCCGAGCTCACCTACAATGAGCAGTTCTTC	CAKARLPELTYNEQFF	TRBV15	TRBJ2-1
TGTGCCAGCAGACAGGGGGCGGGCAATCAGCCCCAGCATTTT	CASRQGAGNQPQHF	TRBV6-5	TRBJ1-5
TGCGCCAGCAGCTCGGTCGATCTCGCCTACGAGCAGTACTTC	CASSSVDLAYEQYF	TRBV5-1	TRBJ2-7
