TGCAGTGCTAGAGCGCCGCCCAGGGGGCAACGAGTGACCGGGGAGCTGTTTTTT	CSARAPPRGQRVTGELFF	TRBV20-1	TRBJ2-2
TGCGCCAGCATCCCGGGGACGGTTACCTTC	CASIPGTVTF	TRBV5-1	TRBJ2-7
TGTGCCAGCAGCAGAGCAGACAGGGTCGTACACGAGCAGTACTTC	CASSRADRVVHEQYF	TRBV25-1	TRBJ2-7
TGTGCCAGCAGAGGGACTAGCCAGGGAGAGCCTAGCGGGGAGCTGTTTTTT	CASRGTSQGEPSGELFF	TRBV6-5	TRBJ2-2
TGTGCCAGCAGCAGAAAAGGGAGGACGACAGGGGGCAATCAGCCCCAGCATTTT	CASSRKGRTTGGNQPQHF	TRBV13	TRBJ1-5
TGTGCCACCAGTGATTTGGAGACAGGCAGCCTACGAAACACCATATATTTT	CATSDLETGSLRNTIYF	TRBV24-1	TRBJ1-3
TGTGCCAGGACCACTAGCGGCGGGGAGCAGTTCTTC	CARTTSGGEQFF	TRBV6-3	TRBJ2-1
TGTGCCAGCAGTTGCCTACAGGGGAGGGCCACCAAAGAAGGCTCCTACGAGCAGTACTTC	CASSCLQGRATKEGSYEQYF	TRBV6-4	TRBJ2-7
TGTGCCAGCAGCGGGAGGACATGCAGGAACTATGGCTACACCTTC	CASSGRTCRNYGYTF	TRBV9	TRBJ1-2
TGTGCCATAGGACCTGGGAGTACCTCCTACAATGAGCAGTTCTTC	CAIGPGSTSYNEQFF	TRBV5-5	TRBJ2-1
TGCAGTGCTAGTGCAGGGACTAGCGGTAACGAGCAGTACTTC	CSASAGTSGNEQYF	TRBV20-1	TRBJ2-7
TGTGCCAGTAGTAGGCGACGGGACAGGGCAAAGGTCTTCCGCACAGATACGCAGTATTTT	CASSRRRDRAKVFRTDTQYF	TRBV19	TRBJ2-3
TGTGCCAGCAGCTTAACCGCTAATGAAAAACTGTTTTTT	CASSLTANEKLFF	TRBV7-3	TRBJ1-4
TGTGCCAGCAGCTGGGCGACAAGTCACTACGAGCAGTACTTC	CASSWATSHYEQYF	TRBV11-3	TRBJ2-7
TGCGCCAGCCGCCTCCCGGGAGCTCGTGGAAACACCATATATTTT	CASRLPGARGNTIYF	TRBV10-2	TRBJ1-3
TGCGCCAGCAGCTTGCCCAGATTTTTCAAACACAGGGGGCGGGTGCAGTTCTTC	CASSLPRFFKHRGRVQFF	TRBV5-1	TRBJ2-1
TGTGCCAGCAGTTTGACAAGGACAGCCTATAGCAATCAGCCCCAGCATTTT	CASSLTRTAYSNQPQHF	TRBV12-4	TRBJ1-5
TGCGCCAGCAGTCCCCCGTCACCGCCCCAGCCCCAGCATTTT	CASSPPSPPQPQHF	TRBV10-1	TRBJ1-5
TGTGCCTTTCGCGGGAGTTTCCATCAGCCCCAGCATTTT	CAFRGSFHQPQHF	TRBV12-5	TRBJ1-5
TGTGCCAGCAGCATGGGACAGGACACCTACGAGCAGTACTTC	CASSMGQDTYEQYF	TRBV11-3	TRBJ2-7
TGCGCCAGCAGCTCCCCGGGGAGGAACACCGGGGAGCTGTTTTTT	CASSSPGRNTGELFF	TRBV5-1	TRBJ2-2
TGTGCCAGCAGTCCCCACAGGGATAGCTCCTACGAGCAGTACTTC	CASSPHRDSSYEQYF	TRBV27	TRBJ2-7
TGCGCCAGCAGCCAAGATGTCATCTTGACCCGGACCGGGGAGCTGTTTTTT	CASSQDVILTRTGELFF	TRBV4-1	TRBJ2-2
TGTGCCAGCAGTTACGCGCCACGGACAGGGAGAGGGCCCCAGCATTTT	CASSYAPRTGRGPQHF	TRBV6-3	TRBJ1-5
TGCAGTGCCCAAAAGGGTATTAAGGACACTGAAGCTTTCTTT	CSAQKGIKDTEAFF	TRBV20-1	TRBJ1-1
TGTGCCATTCCTCGACAGGGGGCGGCAGCTTTCTTT	CAIPRQGAAAFF	TRBV6-6	TRBJ1-1
TGTGCCAGCAGTTTAGTGAGGGTCAGGGCCCTTAATCAGCCCCAGCATTTT	CASSLVRVRALNQPQHF	TRBV12-3	TRBJ1-5
TGTGCCAGCAAGGGACTCTACGAGCAGTACTTC	CASKGLYEQYF	TRBV9	TRBJ2-7
TGTGCCAGCAGTTACTCTACTGTGGGACTAATAAAAGGAAACACCATATATTTT	CASSYSTVGLIKGNTIYF	TRBV6-2	TRBJ1-3
TGTGCTAGTGGTTGGCTCTCCGGGGATGGGCATAGCAATCAGCCCCAGCATTTT	CASGWLSGDGHSNQPQHF	TRBV12-5	TRBJ1-5
TGTGCCACCATACCGGGACAGTGTAATGAAAAACTGTTTTTT	CATIPGQCNEKLFF	TRBV24-1	TRBJ1-4
TGTGCCAGCAGCTCACAGGCTCGGGCCAACGTCCTGACTTTC	CASSSQARANVLTF	TRBV7-8	TRBJ2-6
TGTGCCAGCAGCACCGAAGACAGGGTTCTGGGCAAGGAGACCCAGTACTTC	CASSTEDRVLGKETQYF	TRBV7-3	TRBJ2-5
TGCAGCGTGCAGGGGAAGGCTGAAGCTTTCTTT	CSVQGKAEAFF	TRBV29-1	TRBJ1-1
TGTGCCAGCAGCTTAGGGACCAAACTGCTCCCGAACACTGAAGCTTTCTTT	CASSLGTKLLPNTEAFF	TRBV11-3	TRBJ1-1
TGTGCTAGTGGTTTGGCCCCCAAAGGCACAGATACGCAGTATTTT	CASGLAPKGTDTQYF	TRBV12-5	TRBJ2-3
TGCAGTGCTAGAAAGACAGGGAGGGGGGGCAATCAGCCCCAGCATTTT	CSARKTGRGGNQPQHF	TRBV20-1	TRBJ1-5
TGTGCCAGTAGTACGACCGTCTATTCCTACAATGAGCAGTTCTTC	CASSTTVYSYNEQFF	TRBV19	TRBJ2-1
TGCAGTGCTAGAGATTACGGGGACAGGGGAAAGGGGTACGTTTTTAGGGGGAGCTCCTACAATGAGCAGTTCTTC	CSARDYGDRGKGYVFRGSSYNEQFF	TRBV20-1	TRBJ2-1
TGCGCCAGCGGCGACAGGGGCTGGCAAAATTATTCACCCCTCCACTTT	CASGDRGWQNYSPLHF	TRBV5-1	TRBJ1-6
TGCGCCAGCAGTGATGCCGACAGGGGGTCTACTAATGAAAAACTGTTTTTT	CASSDADRGSTNEKLFF	TRBV10-1	TRBJ1-4
TGTGCCAGCAGCCAGAGAGGGGCGGATCTGCCTGAAGCTTTCTTT	CASSQRGADLPEAFF	TRBV7-3	TRBJ1-1
TGTGCCAGCAGCAAAACCGGGACTAGCGCGACTAGTACGCAGTATTTT	CASSKTGTSATSTQYF	TRBV11-2	TRBJ2-3
TGTGCCGTACCGGGAATCAAGAAACCCCTCCACTTT	CAVPGIKKPLHF	TRBV7-3	TRBJ1-6
TGTGCCAGCAGCCGGTGCCCCCGGTATGCCTACGAGCAGTACTTC	CASSRCPRYAYEQYF	TRBV3-1	TRBJ2-7
TGTGCCAGCAAAAGACAGGGAACCTCCTCCTACGAGCAGTACTTC	CASKRQGTSSYEQYF	TRBV28	TRBJ2-7
TGTGCCAGCAGCAACCGGGGGGGGGAGGTAAGCACAGATACGCAGTATTTT	CASSNRGGEVSTDTQYF	TRBV7-9	TRBJ2-3
TGTGCCAGTAGTTCCCTAAAGGGACAGAGCACAGATACGCAGTATTTT	CASSSLKGQSTDTQYF	TRBV19	TRBJ2-3
TGTGCCAGCAGCCAAGTGACAGTCTACGAGCAGTACTTC	CASSQVTVYEQYF	TRBV3-1	TRBJ2-7
TGTGCCAGCAGCCCCCCCTGGATGGGACAGGGGGCGGAGCCCCAGCATTTT	CASSPPWMGQGAEPQHF	TRBV13	TRBJ1-5
TGTGCCACCAGCGCCCTCCCGGGTAACTCTGGGGCCAACGTCCTGACTTTC	CATSALPGNSGANVLTF	TRBV15	TRBJ2-6
TGTGCCAGCAGCTTTGGACACTGTGGGTCCTACGAGCAGTACTTC	CASSFGHCGSYEQYF	TRBV7-2	TRBJ2-7
TGTGCCAGCAGTGAGACAGGAGGGGCTGAAGCTTTCTTT	CASSETGGAEAFF	TRBV6-4	TRBJ1-1
TGTGCCAGCAGCTTGGGACAAGCGCGCCAACGGTCCTACGAGCAGTACTTC	CASSLGQARQRSYEQYF	TRBV5-6	TRBJ2-7
TGTGCCAGCAGCCGTAAACGTGTAAAGGGGGCCGGCTACACCTTC	CASSRKRVKGAGYTF	TRBV11-3	TRBJ1-2
TGTGCCAGCAGCCTAGGTGAGCAGTACTTC	CASSLGEQYF	TRBV13	TRBJ2-7
TGTGCCAGCAGCTCGTCGGACTGTGGGACAGATTTATATAACGAGCAGTACTTC	CASSSSDCGTDLYNEQYF	TRBV7-6	TRBJ2-7
TGTGCCAGCAGCTCTGTTAGACAGTCCTATAATTCACCCCTCCACTTT	CASSSVRQSYNSPLHF	TRBV11-3	TRBJ1-6
TGTGCCAGGAGGAGGGGAACGGTCACTGAAGCTTTCTTT	CARRRGTVTEAFF	TRBV7-2	TRBJ1-1
TGCGCCAGCAGCTTGGGACGAGACACAGATACGCAGTATTTT	CASSLGRDTDTQYF	TRBV5-1	TRBJ2-3
TGTGCCAGCAGTTCCCCCCAAACAGGGGGCGAGTCTGGGGCCAACGTCCTGACTTTC	CASSSPQTGGESGANVLTF	TRBV28	TRBJ2-6
TGTGCCTGGAGTGATACTTCTATTTCCTTAAAACTAGAGACCCAGTACTTC	CAWSDTSISLKLETQYF	TRBV30	TRBJ2-5
TGTGCCACCAGTGTCCCGAGGGGAGGAGGCTACGAGCAGTACTTC	CATSVPRGGGYEQYF	TRBV24-1	TRBJ2-7
TGCGCCAGCAGTGAAGCTAGCGGGGATACGCAGTATTTT	CASSEASGDTQYF	TRBV10-2	TRBJ2-3
TGTGCCAGCAGCGTAGGGTCGGGCGGTGGAGGGTCCCAGTACTTC	CASSVGSGGGGSQYF	TRBV9	TRBJ2-5
TGCGCCAGCAGCCACATCCCGGGACAGGAGCTCCGAGAGAGCGGGAACACTGAAGCTTTCTTT	CASSHIPGQELRESGNTEAFF	TRBV4-3	TRBJ1-1
TGCGCCAGCAGCTTGCTGCGTGTTGTGAGCGGGACAACAGATACGCAGTATTTT	CASSLLRVVSGTTDTQYF	TRBV5-1	TRBJ2-3
TGTGCCAGCAAGTCTAGCGGGAGGATATGCCCTGATCGCAATCAGCCCCAGCATTTT	CASKSSGRICPDRNQPQHF	TRBV27	TRBJ1-5
TGTGCCAGCAGCTTAGCCAAGGGACAGGAAGGGAGCTCCTACGAGCAGTACTTC	CASSLAKGQEGSSYEQYF	TRBV7-9	TRBJ2-7
TGTGCCAGCAGGATCCCAAGCGGCGGAAAGAGCTCCTACGAGCAGTACTTC	CASRIPSGGKSSYEQYF	TRBV27	TRBJ2-7
TGTGCCAGCAGTGTCGGGGTCCCTATCAGTCGGGCGGGCGGGAGGGAGAGACCCGAGCAGTACTTC	CASSVGVPISRAGGRERPEQYF	TRBV6-1	TRBJ2-7
TGTGCCAGCAGCCAAAGCGGACAGGGAAACACCATATATTTT	CASSQSGQGNTIYF	TRBV4-2	TRBJ1-3
TGTGCCAGCAGCCCCTTACCTGGTAATGAAAAACTGTTTTTT	CASSPLPGNEKLFF	TRBV7-8	TRBJ1-4
TGCGCCAGCAGACCGAGGGGAACGCGGTACTTC	CASRPRGTRYF	TRBV5-1	TRBJ2-4
TGTGCCAGCAGTTTATGTAGCCGGGACAGCAATCAGCCCCAGCATTTT	CASSLCSRDSNQPQHF	TRBV27	TRBJ1-5
TGTGCCAGCAGTGAGCCAGGGGCGAGCATCGGGAGGCAAGAGACCCAGTACTTC	CASSEPGASIGRQETQYF	TRBV6-4	TRBJ2-5
TGTGCCAGCAGTGACTCCCTAGCGGGGGCTCGCTACGAGCAGTACTTC	CASSDSLAGARYEQYF	TRBV6-4	TRBJ2-7
TGTGCCAGCAGCTTACGACGGCTTCAAGAGACCCAGTACTTC	CASSLRRLQETQYF	TRBV11-3	TRBJ2-5
TGTGCCAGCCGGGAAACTGAAGCTTTCTTT	CASRETEAFF	TRBV6-4	TRBJ1-1
TGTGCCAGCGAAGGAGTCATTTACTTC	CASEGVIYF	TRBV12-3	TRBJ2-5
TGTGCCAGCAAAGACCTGTGCGGTGAGCAGTTCTTC	CASKDLCGEQFF	TRBV28	TRBJ2-1
TGTGCCTGGAGTACCGGACAGGGGATGGTGTGGAACACTGAAGCTTTCTTT	CAWSTGQGMVWNTEAFF	TRBV30	TRBJ1-1
TGTGCCATCAGTGAGTTACTGACCACTGAAGCTTTCTTT	CAISELLTTEAFF	TRBV10-3	TRBJ1-1
TGTGCCAGCAGCGTCAGACAGGGGAGGTGTTGTCAGCCCCAGCATTTT	CASSVRQGRCCQPQHF	TRBV7-2	TRBJ1-5
TGTGCCAGCAGGTATGAATCAGGGGGGGGAAACACCATATATTTT	CASRYESGGGNTIYF	TRBV28	TRBJ1-3
TGTGCCAGCAAGGGGGCTCGGTCACCCCTCCACTTT	CASKGARSPLHF	TRBV6-4	TRBJ1-6
TGTGCGGCCATTCCTGGGAGGGGGGTTGAGACCCAGTACTTC	CAAIPGRGVETQYF	TRBV28	TRBJ2-5
TGTGCCACCAGTGAACTAGCGGGAGGGGAGAACAATGAGCAGTTCTTC	CATSELAGGENNEQFF	TRBV24-1	TRBJ2-1
TGTGCCAGCAGCCGGTCTGTAAAAGAGACCCAGTACTTC	CASSRSVKETQYF	TRBV6-8	TRBJ2-5
TGTGCCAGATTATGGGATGAGCAGTTCTTC	CARLWDEQFF	TRBV11-3	TRBJ2-1
TGCGCCAGCAGCTTTTGGACAGGGGTGGGCTATGGCTACACCTTC	CASSFWTGVGYGYTF	TRBV5-1	TRBJ1-2
TGTGCCAGCAGCGGACTAGCGGGAGCGAGCTACGAGCAGTACTTC	CASSGLAGASYEQYF	TRBV11-2	TRBJ2-7
TGTGCCAGCAGCTTAAAAAGTAAGCGGGGTAATATCAGAAACACCATATATTTT	CASSLKSKRGNIRNTIYF	TRBV7-3	TRBJ1-3
TGTGCCAGCACCTTAGGGAGCTCCTACGAGCAGTACTTC	CASTLGSSYEQYF	TRBV6-4	TRBJ2-7
TGTGCCAGCAGTGTACATGAAAAACCGGAGCAGTTCTTC	CASSVHEKPEQFF	TRBV6-4	TRBJ2-1
TGTGCCACCAGTCTCCCTCTTAGGACAGGGGCAATAGCCTACGAGCAGTACTTC	CATSLPLRTGAIAYEQYF	TRBV24-1	TRBJ2-7
TGTGCCAGTAGTGACAAAGGATCTGGGGCCAACGTCCTGACTTTC	CASSDKGSGANVLTF	TRBV19	TRBJ2-6
TGCGCCAGCTCTCTGTCGGGACTGGCTGACTCCTACGAGCAGTACTTC	CASSLSGLADSYEQYF	TRBV10-1	TRBJ2-7
TGTGCCAGCAGCGGTGGGGGGCCCTTCCGAACAGATACGCAGTATTTT	CASSGGGPFRTDTQYF	TRBV6-1	TRBJ2-3
TGTGCCAGCAGTGACTCCGAGACCCTCAATCAGCCCCAGCATTTT	CASSDSETLNQPQHF	TRBV6-4	TRBJ1-5
TGCGCCAGCATGTCAGCAGGACAGGTAGAGACCCAGTACTTC	CASMSAGQVETQYF	TRBV10-2	TRBJ2-5
TGCGCCAGCAGCAGCCAGGGGGACGGAAGGGAGGATGAAGCTTTCTTT	CASSSQGDGREDEAFF	TRBV10-1	TRBJ1-1
TGTGCCAGCACCCCTAGCTACGAGCAGTACTTC	CASTPSYEQYF	TRBV6-4	TRBJ2-7
TGTGCCAGCAGCTTAGAAACCCGAATTGGTACCTCTAACTATGGCTACACCTTC	CASSLETRIGTSNYGYTF	TRBV7-6	TRBJ1-2
TGTGCCACTTGGACACTGAAGCCCCAGCATTTT	CATWTLKPQHF	TRBV2	TRBJ1-5
TGTGCCAGCAGCGTGAGGGCGGGACAGGGCGTTTCCTCGGAAGCTTTCTTT	CASSVRAGQGVSSEAFF	TRBV9	TRBJ1-1
TGTGCCAGCAGCTTCAGCCGGGGTACTTGCTCTGGAAACACCATATATTTT	CASSFSRGTCSGNTIYF	TRBV5-6	TRBJ1-3
TGTGCCAGCAGCCCAAGTACAGGGGAAGAGACCCAGTACTTC	CASSPSTGEETQYF	TRBV13	TRBJ2-5
TGTGCCAGCAGGACATATCCGCTCACATGCTACGAGCAGTACTTC	CASRTYPLTCYEQYF	TRBV14	TRBJ2-7
TGTGCCAGCAGCGGGACAGTTGCCTATGGCTACACCTTC	CASSGTVAYGYTF	TRBV6-4	TRBJ1-2
TGTGCCAGCAGCGAGCACTGGGGCTTCTACGAGCAGTACTTC	CASSEHWGFYEQYF	TRBV13	TRBJ2-7
TGTGCCAGCAGTGTTTGTTCAGCTAGCAATCAGCCCCAGCATTTT	CASSVCSASNQPQHF	TRBV6-1	TRBJ1-5
TGTGCCTGGAGACCAGGGCTTCCCGGGGAGCGGGGATCCGAGAACACTGAAGCTTTCTTT	CAWRPGLPGERGSENTEAFF	TRBV30	TRBJ1-1
TGCAGCCCCAAGCACCTGGACAGGGGGCACGATCAGCCCCAGCATTTT	CSPKHLDRGHDQPQHF	TRBV29-1	TRBJ1-5
TGTGCCAGCAGCCAAGATGCCGTCAACAGGCCGGACGAGCAGTACTTC	CASSQDAVNRPDEQYF	TRBV14	TRBJ2-7
TGCAGCGTGCGGGAGGCGAGCGAGCAGTACTTC	CSVREASEQYF	TRBV29-1	TRBJ2-7
TGTGCCAGCAGCAGGAAGGGGACTAGCGGGCTTGACGAGCAGTACTTC	CASSRKGTSGLDEQYF	TRBV7-3	TRBJ2-7
TGTGCCAGCAGTTACACCGAGGGTCGGACAGGGGGATCTGAAAAACTGTTTTTT	CASSYTEGRTGGSEKLFF	TRBV6-6	TRBJ1-4
TGTGCCAGCAGGGCCACAACTAGGAAATCTGAGCAGTACTTC	CASRATTRKSEQYF	TRBV6-5	TRBJ2-7
TGTGCCAGCAGCACCGGGACAGATTTTTACGAGCAGTACTTC	CASSTGTDFYEQYF	TRBV13	TRBJ2-7
TGTGCCAGCAGCCGAGAAAGAGGGTGGGGTTTTAACTATGGCTACACCTTC	CASSRERGWGFNYGYTF	TRBV4-2	TRBJ1-2
TGTGCCAGCAGCGTGTACAGGGGGGATCAGCCCCAGCATTTT	CASSVYRGDQPQHF	TRBV9	TRBJ1-5
TGCGCCAGCAGAAGACTGGGGACGCGGCCTGGAAACACCATATATTTT	CASRRLGTRPGNTIYF	TRBV10-2	TRBJ1-3
TGCGCCAGCAGCCAGAGGAGGCCGGACAGGGCAGGCAGGGAGAACACTGAAGCTTTCTTT	CASSQRRPDRAGRENTEAFF	TRBV5-1	TRBJ1-1
TGTGCCAGCAGCACAGGGCGGGATAGCAATCAGCCCCAGCATTTT	CASSTGRDSNQPQHF	TRBV7-4	TRBJ1-5
TGCGCCAGCAGCTTGGCAAACCTCGTTGGACAGGTAGCCTCCTACGAGCAGTACTTC	CASSLANLVGQVASYEQYF	TRBV5-1	TRBJ2-7
TGTGCCAGCAGTGAGACGACAGGGAGGGGAACCCTTGTCTATAGCAATCAGCCCCAGCATTTT	CASSETTGRGTLVYSNQPQHF	TRBV6-2	TRBJ1-5
TGCGCCAGCGGACGGGGTAATTCACCCCTCCACTTT	CASGRGNSPLHF	TRBV5-1	TRBJ1-6
TGTGCCAGCAGCCGGGGGGGAACTGAGACCCAGTACTTC	CASSRGGTETQYF	TRBV5-6	TRBJ2-5
TGTGCCAGCTCACCAGCGAGGGGGCGTGAAGAGCGAGCCAAAAACATTCAGTACTTC	CASSPARGREERAKNIQYF	TRBV18	TRBJ2-4
TGCGCCAGCAACAGGGCAGGGGTGGCGAACACTGAAGCTTTCTTT	CASNRAGVANTEAFF	TRBV4-1	TRBJ1-1
TGTGCTAGTGAGGGACCGACAGGGAAGAATCAGCCCCAGCATTTT	CASEGPTGKNQPQHF	TRBV12-5	TRBJ1-5
TGTGCCAGCAGTTTGCAGCCCTACGAGCAGTACTTC	CASSLQPYEQYF	TRBV6-3	TRBJ2-7
TGTGCCAGCAGCTTAGGTGGGGGACAGGGGTACAATGAGCAGTTCTTC	CASSLGGGQGYNEQFF	TRBV7-4	TRBJ2-1
TGTGCCAGCCTGCATCACCTTCGATCAGGATACGAGCAGTACTTC	CASLHHLRSGYEQYF	TRBV25-1	TRBJ2-7
TGTGCCAGCAGTTCCCGGGGGCACTACGAGCAGTACTTC	CASSSRGHYEQYF	TRBV27	TRBJ2-7
TGTGCCTGGAGTGTACCCACTCCGGGACAGGGGGGCCATAGCAATCAGCCCCAGCATTTT	CAWSVPTPGQGGHSNQPQHF	TRBV30	TRBJ1-5
TGTGCCAGCAGTCGGTCCCCCTACGGGGACATTCAGTACTTC	CASSRSPYGDIQYF	TRBV6-4	TRBJ2-4
TGTGCCAGCACGGGGGGGTCGGAGGAGCTGTTTTTT	CASTGGSEELFF	TRBV6-4	TRBJ2-2
TGTGCCAGTAGTCATTGTACCGGGACTAGCGGGAGGAGAGAAAAGGGCTACACCTTC	CASSHCTGTSGRREKGYTF	TRBV19	TRBJ1-2
TGTGCCAGCACTAAACAGGGGAGCATTCAGTACTTC	CASTKQGSIQYF	TRBV27	TRBJ2-4
TGTGCCAGCAGCCCTAGCGGCTCCTACGAGCAGTACTTC	CASSPSGSYEQYF	TRBV7-9	TRBJ2-7
TGTGCCAGCAATTCCCCCTTTAGGCTAGCGGGGTACGAGCAGTACTTC	CASNSPFRLAGYEQYF	TRBV28	TRBJ2-7
TGTGCCAGCAGTTCTGAGGACACCGGGGAGCTGTTTTTT	CASSSEDTGELFF	TRBV27	TRBJ2-2
TGCAGTGCTTGGACAGGCTATGGCTACACCTTC	CSAWTGYGYTF	TRBV20-1	TRBJ1-2
TGTGCCAGCAGCTTATCCCGCGGGAGGGGATATACGCAGTATTTT	CASSLSRGRGYTQYF	TRBV7-9	TRBJ2-3
TGCGCCAACGGAGGGCTTTACACTGAAGCTTTCTTT	CANGGLYTEAFF	TRBV10-1	TRBJ1-1
TGCGCCAGCATGAGGGGACAGGACAATCAGCCCCAGCATTTT	CASMRGQDNQPQHF	TRBV10-2	TRBJ1-5
TGTGCCAGCAGCGAATTTAGAACTCTGAGCACAGATACGCAGTATTTT	CASSEFRTLSTDTQYF	TRBV5-5	TRBJ2-3
TGTGCCAGTAGTCGAAACGGGGAGCATATACGGAATGAAAAACTGTTTTTT	CASSRNGEHIRNEKLFF	TRBV19	TRBJ1-4
TGTGCCAGCAGCCCACCTCAAACTAGGTCGGAAGAGACCCAGTACTTC	CASSPPQTRSEETQYF	TRBV7-8	TRBJ2-5
TGCTTTTCCCCTTATTATTGTTCCGGAGATCAGCCCCAGCATTTT	CFSPYYCSGDQPQHF	TRBV10-1	TRBJ1-5
TGTGCCAGCAGTTACTCGACGGGCCGGGGGCCCCGGAACTCCTACGAGCAGTACTTC	CASSYSTGRGPRNSYEQYF	TRBV6-5	TRBJ2-7
TGCAGTGCATCGGGCGTGGAAGCGAACCGGACCGGGGAGCTGTTTTTT	CSASGVEANRTGELFF	TRBV20-1	TRBJ2-2
TGTGCCTGGAGGAGGTTCCCCCAAGAGACCCAGTACTTC	CAWRRFPQETQYF	TRBV30	TRBJ2-5
TGTGCCAGCAGCGGGACTAGCGGAGGACACAATGAGCAGTTCTTC	CASSGTSGGHNEQFF	TRBV7-9	TRBJ2-1
TGTGCCACCGTCCCAAAAACAGGGGATTCGTTCTCTGGAAACACCATATATTTT	CATVPKTGDSFSGNTIYF	TRBV24-1	TRBJ1-3
TGTGCCAGCAGTTACCCTAGCGGGGGTTACTACGAGCAGTACTTC	CASSYPSGGYYEQYF	TRBV6-6	TRBJ2-7
TGTGCCAGCAGTGATACTCCTAGAACTAATCAGCCCCAGCATTTT	CASSDTPRTNQPQHF	TRBV2	TRBJ1-5
TGTGCCAGCAGTTTTTCGGCCTTGGTTGGGTCAAGAGACGAGCAGTACTTC	CASSFSALVGSRDEQYF	TRBV27	TRBJ2-7
TGTGCCAGCAGTTTTCGGGGTGACCGTCAGCCCCAGCATTTT	CASSFRGDRQPQHF	TRBV12-3	TRBJ1-5
TGTGCCAGCAGTCTTAATCGGACAGGGAGGGAGCAGTACTTC	CASSLNRTGREQYF	TRBV6-4	TRBJ2-7
TGTGCCAGCAGCCAAGTCCCCTACTGGACAGGGGCAAAACTCGTTTCGTTGAAGTATGGCTACACCTTC	CASSQVPYWTGAKLVSLKYGYTF	TRBV14	TRBJ1-2
TGCAGTGCCCCGGGACTGAACAATCAGCCCCAGCATTTT	CSAPGLNNQPQHF	TRBV20-1	TRBJ1-5
TGTGCCAGCAGCTGCCCCCAGGGCTACGAGCAGTACTTC	CASSCPQGYEQYF	TRBV13	TRBJ2-7
TGCGCCAGCAGCCAAAACTGGGACCGGCACAATGAGCAGTTCTTC	CASSQNWDRHNEQFF	TRBV4-3	TRBJ2-1
TGTGCCAGCAGCCAAGATTACGGCAGGGATTCACCCCTCCACTTT	CASSQDYGRDSPLHF	TRBV3-1	TRBJ1-6
TGTGCCAGCTGGAGTTATATTTCCATCTTTGCCTACAATGAGCAGTTCTTC	CASWSYISIFAYNEQFF	TRBV28	TRBJ2-1
TGCAGTGCTAAGCTGGTCTACACCGGGGAGCTGTTTTTT	CSAKLVYTGELFF	TRBV20-1	TRBJ2-2
TGCGCCAGCAGTGATCGCCCTTACCTAGCCTACTTACCCTACGAGCAGTACTTC	CASSDRPYLAYLPYEQYF	TRBV10-1	TRBJ2-7
TGTGCCAGCAGCGAGGATAGAGGGGCCAACGTCCTGACTTTC	CASSEDRGANVLTF	TRBV27	TRBJ2-6
TGTGCCACCATGGGCAGGGGGGGCCTCTATGGCTACACCTTC	CATMGRGGLYGYTF	TRBV24-1	TRBJ1-2
TGTGCCAGCAGCTTAGTAGCCAGGGGGACTGAAGCTTTCTTT	CASSLVARGTEAFF	TRBV7-2	TRBJ1-1
TGTGCCAGCAGCCAAGAGTACGGGGGGTTAGGTAGCGAAAGCAATGAGCAGTTCTTC	CASSQEYGGLGSESNEQFF	TRBV4-2	TRBJ2-1
TGTGCCACCAGGGAATGTGGGGGAGCCCAGTACTTC	CATRECGGAQYF	TRBV24-1	TRBJ2-5
TGTGCCAGCAGTTTGAAAGCTGAAGCTTTCTTT	CASSLKAEAFF	TRBV27	TRBJ1-1
TGCAGTGCGTCCAGACCGGGACTAGGATACAATGAGCAGTTCTTC	CSASRPGLGYNEQFF	TRBV20-1	TRBJ2-1
TGTGCCAGCGCAGAAATGACAGGTTGGAACACCGGGGAGCTGTTTTTT	CASAEMTGWNTGELFF	TRBV5-6	TRBJ2-2
TGTGCCAGCAGTGCCCCCAAACTATCAGGGCGCAATTATAGCAATCAGCCCCAGCATTTT	CASSAPKLSGRNYSNQPQHF	TRBV6-1	TRBJ1-5
TGTGCCAGGCTCGGGGGGGGGACCCCACTGGCGAACACCGGGGAGCTGTTTTTT	CARLGGGTPLANTGELFF	TRBV12-3	TRBJ2-2
TGCAGTGCTAGAGATCACGTATACGAGCAGTACTTC	CSARDHVYEQYF	TRBV20-1	TRBJ2-7
TGTGTGGAGGTGCCGGGACAGGGCGGAAGGCAGTATTTT	CVEVPGQGGRQYF	TRBV24-1	TRBJ2-3
TGTGCCAGCAGAGTAAAAACGGACAGGCCACTTCATAATGAAAAACTGTTTTTT	CASRVKTDRPLHNEKLFF	TRBV28	TRBJ1-4
TGTGCCAGCAGCAATCTCCAGGACAGCACAGATACGCAGTATTTT	CASSNLQDSTDTQYF	TRBV7-2	TRBJ2-3
TGTGCCAGCAGCTTGGGACAGGGCGTCTGCAATCAGCCCCAGCATTTT	CASSLGQGVCNQPQHF	TRBV7-2	TRBJ1-5
TGTGCCAGCAGTTATGGAGGGGATGAGCAGTTCTTC	CASSYGGDEQFF	TRBV6-5	TRBJ2-1
TGTGCCAGCAGCCAAGATTCCTGGGCCCTAGATGAGCAGTTCTTC	CASSQDSWALDEQFF	TRBV4-2	TRBJ2-1
TGCGCCAGCAGCCGCACTAGGCCATACGAGCAGTACTTC	CASSRTRPYEQYF	TRBV5-1	TRBJ2-7
TGTGCCAGCAGTTACTCCCGGCCCGAGTCCTATGGCTACACCTTC	CASSYSRPESYGYTF	TRBV6-5	TRBJ1-2
TGTGCCAGCAGCTTAGATTCTAGGATCTACGAGCAGTACTTC	CASSLDSRIYEQYF	TRBV11-3	TRBJ2-7
TGCAGTGCTAAAGGGGGACAGAATTATGGCTACACCTTC	CSAKGGQNYGYTF	TRBV20-1	TRBJ1-2
TGCAGTGCTAGACAGGCTTCCTACAATGAGCAGTTCTTC	CSARQASYNEQFF	TRBV20-1	TRBJ2-1
TGTGCCAGCAGCGTGGACAGAAACTCTGGAAACACCATATATTTT	CASSVDRNSGNTIYF	TRBV9	TRBJ1-3
TGTGCCAGCATTTCGGGACAGGGGAAGGTATCTAATGAAAAACTGTTTTTT	CASISGQGKVSNEKLFF	TRBV28	TRBJ1-4
TGTGCCAGCAGTCGGCGATACTACGAGCAGTACTTC	CASSRRYYEQYF	TRBV5-4	TRBJ2-7
TGTGCCAGCAGCCCGGCTAGCGGGGTAAATGAGCAGTTCTTC	CASSPASGVNEQFF	TRBV12-4	TRBJ2-1
TGTGCCAGCAGCTTAGTTAGCCAGCGGGGAAACACCGGGGAGCTGTTTTTT	CASSLVSQRGNTGELFF	TRBV11-2	TRBJ2-2
TGTGCCAGCAGCTTACAGGCAGGACTAGCGGGGTTTATAGAGACCCAGTACTTC	CASSLQAGLAGFIETQYF	TRBV7-6	TRBJ2-5
TGCAGCGTTGAAAGGGGGGGAGGGGGATACGAGCAGTACTTC	CSVERGGGGYEQYF	TRBV29-1	TRBJ2-7
TGCAGTGCTGGTAGCGGGAGGGGGGACCGGGGCAATCAGCCCCAGCATTTT	CSAGSGRGDRGNQPQHF	TRBV20-1	TRBJ1-5
TGTGCCAGCAGTCTCAGGTCCCACACCGGGGAGCTGTTTTTT	CASSLRSHTGELFF	TRBV6-2	TRBJ2-2
TGTGCCAGCAGTTACACTAGCGGGAGAAGGAATCAGCCCCAGCATTTT	CASSYTSGRRNQPQHF	TRBV27	TRBJ1-5
TGTGCCAGCAGCTTATCCGGGACAGGGTTAGGACACGAGCAGTACTTC	CASSLSGTGLGHEQYF	TRBV11-2	TRBJ2-7
TGTGAGTTCGGGACAGCGTTAGATACGCAGTATTTT	CEFGTALDTQYF	TRBV28	TRBJ2-3
TGTGCCAGCAGTTTAGAACGGGGTAGGGAATCTGATAGCAATCAGCCCCAGCATTTT	CASSLERGRESDSNQPQHF	TRBV28	TRBJ1-5
TGTGCCAGCAGCTTTTTCTTGACGGGACAGGGTGGTAATTCACCCCTCCACTTT	CASSFFLTGQGGNSPLHF	TRBV5-5	TRBJ1-6
TGTGCCAGCAGGACCGGGACTAGCGGGTGGACCCAGTACTTC	CASRTGTSGWTQYF	TRBV6-5	TRBJ2-5
TGTGCCAGCAGTGAAGATGGTCCTGGCCGCGGGACTAGAGGCACAGATACGCAGTATTTT	CASSEDGPGRGTRGTDTQYF	TRBV6-4	TRBJ2-3
TGTGCCAGCAGCATCCCTCTTTTTAGGTACACCGGGGAGCTGTTTTTT	CASSIPLFRYTGELFF	TRBV9	TRBJ2-2
TGTGCCAGCAACCCCACAGGGGAAGTATCAACAACTGAAGCTTTCTTT	CASNPTGEVSTTEAFF	TRBV11-1	TRBJ1-1
TGCGCCAGCTCTATAGGTGACGCGAACACCGGGGAGCTGTTTTTT	CASSIGDANTGELFF	TRBV4-3	TRBJ2-2
TGTGCCAGCAGGGGCGGAAGGGCGGCAGCTTTCTTT	CASRGGRAAAFF	TRBV6-4	TRBJ1-1
TGTGTGGTAAAAAGGAGGACCACGTGCTATGGCTACACCTTC	CVVKRRTTCYGYTF	TRBV14	TRBJ1-2
TGCGCCAGCAGCTGGTATCGGGAAGTTGGCTACACCTTC	CASSWYREVGYTF	TRBV5-1	TRBJ1-2
TGTGCCAGAGGGGAAGCTTTCTTT	CARGEAFF	TRBV12-3	TRBJ1-1
TGTGCCAGCAGTTGGCTAGCGGACACCGGGGAGCTGTTTTTT	CASSWLADTGELFF	TRBV6-2	TRBJ2-2
TGTGCCAGCAGTAGAGGGACGACTTTCTACGAGCAGTACTTC	CASSRGTTFYEQYF	TRBV28	TRBJ2-7
TGTGCCAGCAGCCCCCGCCGCCCGGACAGTTTACGCACCATATATTTT	CASSPRRPDSLRTIYF	TRBV7-9	TRBJ1-3
TGTGCCAGCAGAGACCCCGGCTCTGGAAACACCATATATTTT	CASRDPGSGNTIYF	TRBV25-1	TRBJ1-3
TGTGCCAGCAGGGAGTATCCGACAGGGGATCAACCCAATTCACCCCTCCACTTT	CASREYPTGDQPNSPLHF	TRBV2	TRBJ1-6
TGCGCCAGCAGTGACGGTCCTAGCACAGATACGCAGTATTTT	CASSDGPSTDTQYF	TRBV10-2	TRBJ2-3
TGTGCATCTAGCAGGGCGGCATCCAGCAATCAGCCCCAGCATTTT	CASSRAASSNQPQHF	TRBV24-1	TRBJ1-5
TGTGCCAGCAGCTTAGTTCAGGGCCTTAGGTTCGGGGAGCTGTTTTTT	CASSLVQGLRFGELFF	TRBV7-6	TRBJ2-2
TGTGCCACCAGTGATGGACTAGCGTACGAGCAGTACTTC	CATSDGLAYEQYF	TRBV24-1	TRBJ2-7
TGTGCTAGTGAGTCCCCGGAGGGGTCGGATGAGCAGTTCTTC	CASESPEGSDEQFF	TRBV12-5	TRBJ2-1
TGTGCCAGCAGCCCCCTGGGCGGGACCTGTAGCAATCAGCCCCAGCATTTT	CASSPLGGTCSNQPQHF	TRBV7-8	TRBJ1-5
TGTGCCAGCAGTTGGGTCAGGGGGGGTCCGTTGTTAGTTAACACTGAAGCTTTCTTT	CASSWVRGGPLLVNTEAFF	TRBV12-4	TRBJ1-1
TGTGCCTGGAGTGATGTCCAGGGCAGGTCTGGAAACACCATATATTTT	CAWSDVQGRSGNTIYF	TRBV30	TRBJ1-3
TGTGCCAGCAGCTTTGACAGGGAGCCCCAGCATTTT	CASSFDREPQHF	TRBV7-2	TRBJ1-5
TGTGCCAGCAGTGAGGTCCGAACTAGCGGAAGTTACGAGCAGTACTTC	CASSEVRTSGSYEQYF	TRBV6-1	TRBJ2-7
TGCAGTGCTAGCCCTGGAGGTGGGCAGCCCCAGCATTTT	CSASPGGGQPQHF	TRBV20-1	TRBJ1-5
TGTGCCAGCAGTAACAGGGGCCTACAGCCCCAGCATTTT	CASSNRGLQPQHF	TRBV12-4	TRBJ1-5
TGTGCCACCAGTGACGAATACCATCAGCCCCAGCATTTT	CATSDEYHQPQHF	TRBV24-1	TRBJ1-5
TGTGCCAGCACAGGGGTAAAGTTGGACGAGCAGTACTTC	CASTGVKLDEQYF	TRBV6-4	TRBJ2-7
TGCAGTGCTAGTTCCGGGAGATACTCTGGAAACACCATATATTTT	CSASSGRYSGNTIYF	TRBV20-1	TRBJ1-3
TGTGCCAGCAGCCAATACGCGGGTGGATCCTACGAGCAGTACTTC	CASSQYAGGSYEQYF	TRBV14	TRBJ2-7
TGTGCCAGCAGGGACAGCCAGTACGAGCAGTACTTC	CASRDSQYEQYF	TRBV28	TRBJ2-7
TGTGCCAGCAGTGAAGCCTGTCGACCGTCTGGAAACACCATATATTTT	CASSEACRPSGNTIYF	TRBV2	TRBJ1-3
TGTGCCAGTACCGGCTACGAGCAGTACTTC	CASTGYEQYF	TRBV19	TRBJ2-7
TGTGCCACCAGTGATCTAGGTAAAGATACGCAGTATTTT	CATSDLGKDTQYF	TRBV24-1	TRBJ2-3
TGTGCCAGCAGCCCTACAGGAGTCCCTATTAATTCACCCCTCCACTTT	CASSPTGVPINSPLHF	TRBV7-2	TRBJ1-6
TGTGCCTGGAGTGCCCGGGACAATGGCTACACCTTC	CAWSARDNGYTF	TRBV30	TRBJ1-2
TGCGCCAGCAGCCTCCGGGAGGACTTC	CASSLREDF	TRBV4-3	TRBJ2-7
TGTGCCAGCAGAGAACTAGCGGGGGAAATAGAGACCCAGTACTTC	CASRELAGEIETQYF	TRBV27	TRBJ2-5
TGCGCCAGCATAAGATCGGATAGTGGAAACACCATATATTTT	CASIRSDSGNTIYF	TRBV10-2	TRBJ1-3
TGTGCCAGCAGTGACTCAGGGTCTGGCTACACCTTC	CASSDSGSGYTF	TRBV6-1	TRBJ1-2
TGTGCCAGTAGTAAACAATGCGGGGAGCTGTTTTTT	CASSKQCGELFF	TRBV19	TRBJ2-2
TGTGCTAGTGGACCTGGACTAGCGGGTACTATCCTCCCACCCGTAATCGAGCAGTACTTC	CASGPGLAGTILPPVIEQYF	TRBV12-5	TRBJ2-7
TGTGCCAGCAGCTCCCTGGAGGACAGGGGGCATTTT	CASSSLEDRGHF	TRBV7-2	TRBJ1-5
TGTGCCACCAGCAGAGTACCTGTCGGCTCAACCGGGGAGCTGTTTTTT	CATSRVPVGSTGELFF	TRBV15	TRBJ2-2
TGCAGTGCTAGTCGGACTGGGCATGGCTACACCTTC	CSASRTGHGYTF	TRBV20-1	TRBJ1-2
TGCGCCAGCAGCTTGTTCCCCGGGACAGGGCAGCCCCAGCATTTT	CASSLFPGTGQPQHF	TRBV5-1	TRBJ1-5
TGTGCCGGAAACCACAGGGACAGGGGCTCTGGAAACACCATATATTTT	CAGNHRDRGSGNTIYF	TRBV6-2	TRBJ1-3
TGTGCCAGCAGCTGCGGGACAGGCTCCTACGAGCAGTACTTC	CASSCGTGSYEQYF	TRBV7-8	TRBJ2-7
TGTGCCAGCAGTTTATTCGGGACTAGGGTCTCCTACAATGAGCAGTTCTTC	CASSLFGTRVSYNEQFF	TRBV12-3	TRBJ2-1
TGTGCCGCAGAAAGGGCACACGGGCTTCAGCCCCAGCATTTT	CAAERAHGLQPQHF	TRBV5-6	TRBJ1-5
TGTGCCACCAGCAGAGCCCCACCGGGGATTGGGATTTTTTTTTTCTCCCAGCATTTT	CATSRAPPGIGIFFFSQHF	TRBV15	TRBJ1-5
TGTGCCAGCAGCGATATACAGGAAATCCAAGAGACCCAGTACTTC	CASSDIQEIQETQYF	TRBV13	TRBJ2-5
TGTGCCGAGAACAGGGCACCAGGAAATCAGCCCCAGCATTTT	CAENRAPGNQPQHF	TRBV10-3	TRBJ1-5
TGTGCCAGCAGCTTAGGGCATCAAGCTTTCTTT	CASSLGHQAFF	TRBV7-9	TRBJ1-1
TGTGCCAGCAGTTTTGGGCCCTATGGCTACACCTTC	CASSFGPYGYTF	TRBV27	TRBJ1-2
TGCAGTGCTGCCGCGGGGGGGGGGAACAATGAGCAGTTCTTC	CSAAAGGGNNEQFF	TRBV20-1	TRBJ2-1
TGCGCCAGCAGCGTGGACAGGCCCGAGACCCAGTACTTC	CASSVDRPETQYF	TRBV5-1	TRBJ2-5
TGTGCCAGCGACAGTGGTCCAGATACGCAGTATTTT	CASDSGPDTQYF	TRBV4-2	TRBJ2-3
TGTGCCAGCAGCTTACCCCTAGCGGGCCAGTACCAAGAGACCCAGTACTTC	CASSLPLAGQYQETQYF	TRBV11-2	TRBJ2-5
TGTGCCAGCAGCGCGGGGGATGGCTACACCTTC	CASSAGDGYTF	TRBV5-6	TRBJ1-2
TGCAGTGCTAGAGATCCCAGCCACACAGGGGCTCACACTGAAGCTTTCTTT	CSARDPSHTGAHTEAFF	TRBV20-1	TRBJ1-1
TGTGCCAGCAGTTCGCTTGGGCCCCTGGCAGATACGCAGTATTTT	CASSSLGPLADTQYF	TRBV6-3	TRBJ2-3
TGTGCCAGCAGTTTTACGCATAGGGAGGCCATATATTTT	CASSFTHREAIYF	TRBV6-5	TRBJ1-3
TGCAGTGCTAGCTCCCAGACAGGGATGAATAATTCACCCCTCCACTTT	CSASSQTGMNNSPLHF	TRBV20-1	TRBJ1-6
TGTGCCAGCAGCGGGCCGGGACTAGCGGCGGAGCAGTACTTC	CASSGPGLAAEQYF	TRBV7-2	TRBJ2-7
TGTGCCACGGGGGCGGACTATGGCTACACCTTC	CATGADYGYTF	TRBV24-1	TRBJ1-2
TGCGCCAGGGGGACTAGCGGGAAGGGAGCCAAAAACATTCAGTACTTC	CARGTSGKGAKNIQYF	TRBV10-1	TRBJ2-4
TGTGCCAGCAGTGTTCAGGGGCCCTGGGAGCAGTACTTC	CASSVQGPWEQYF	TRBV2	TRBJ2-7
TGTGCCAGCAGTCTTAGGGGCACCACTGAAGCTTTCTTT	CASSLRGTTEAFF	TRBV27	TRBJ1-1
TGTGCCAGCAGTTTCTGGGGAGCATATCTTACCGACACAGATACGCAGTATTTT	CASSFWGAYLTDTDTQYF	TRBV28	TRBJ2-3
TGTGCCAGCAGCTTCATGGGCGTAGCTTTCTTT	CASSFMGVAFF	TRBV13	TRBJ1-1
TGCGCCAGCCGAACCGGCACTCCCGGGCGGGAGCGACAGGGCCTCTATGGCTACACCTTC	CASRTGTPGRERQGLYGYTF	TRBV5-1	TRBJ1-2
TGTGCCAGCAGCTCGGGGGGGACAGGGACGGATGGCTACACCTTC	CASSSGGTGTDGYTF	TRBV14	TRBJ1-2
TGTGCCATCCAGGACAGCAGGGGAACCGCCTCTAGTAGCAATCAGCCCCAGCATTTT	CAIQDSRGTASSSNQPQHF	TRBV19	TRBJ1-5
TGTGCCAGCAGCGGGGGGACTAGCGAAACTAGCACAGATACGCAGTATTTT	CASSGGTSETSTDTQYF	TRBV13	TRBJ2-3
TGTGCCAGCAGGAAACCGTTGACTTTTAAGAACGAGCAGTACTTC	CASRKPLTFKNEQYF	TRBV27	TRBJ2-7
TGTGCCACGCTGGACAGGGAACCGACCCAGTACTTC	CATLDREPTQYF	TRBV10-3	TRBJ2-5
TGTGCCATCAGTGAACTTACCCCTAGCGGCGAGAGGGCGTATTTT	CAISELTPSGERAYF	TRBV10-3	TRBJ2-3
TGTGCCAGCAGCCGTCGCGAGACTGGCTACACCTTC	CASSRRETGYTF	TRBV5-8	TRBJ1-2
TGTGCCAGCACCTTGGGGTTCTTT	CASTLGFF	TRBV6-8	TRBJ1-1
TGTGCTAGTGGTTTGGTCCTTCGTCACAATCAGCCCCAGCATTTT	CASGLVLRHNQPQHF	TRBV12-5	TRBJ1-5
TGTGCCTTCGGACGAGAAAACGAGCAGTACTTC	CAFGRENEQYF	TRBV3-1	TRBJ2-7
TGTGCCAGCAGCTTAAGGGGGCGAGTCTACACTGAAGCTTTCTTT	CASSLRGRVYTEAFF	TRBV11-1	TRBJ1-1
TGCAGTCTTACAGGCCGGTCCAGGCGGAATGAAAAACTGTTTTTT	CSLTGRSRRNEKLFF	TRBV20-1	TRBJ1-4
TGTGATAAGCCCGGGACAGGGGAGCAGTACTTC	CDKPGTGEQYF	TRBV10-3	TRBJ2-7
TGTGCCAGCCCCCCACGGGACAGGGAAGATCAGCCCCAGCATTTT	CASPPRDREDQPQHF	TRBV6-5	TRBJ1-5
TGTGCCAGCAGCGTAGAGCAGTCTGCCAAAAACATTCAGTACTTC	CASSVEQSAKNIQYF	TRBV9	TRBJ2-4
TGTGCCAGCAGTCCATTGGACACGTCCTATGGCTACACCTTC	CASSPLDTSYGYTF	TRBV25-1	TRBJ1-2
TGTGCCAGCAGCTTAGGCTGCAGGACGGGGGGACAGGGGTTCTTAACGAACACTGAAGCTTTCTTT	CASSLGCRTGGQGFLTNTEAFF	TRBV7-6	TRBJ1-1
TGCGCCAGCAGAACCGGGGCGCGGGGAAACACCATATATTTT	CASRTGARGNTIYF	TRBV10-1	TRBJ1-3
TGTGCCAGCAGCTTAGCCGGACAGGGGGTGCGCTACGAGCAGTACTTC	CASSLAGQGVRYEQYF	TRBV11-2	TRBJ2-7
TGTGCCAGCATGGGGGGAGAAGCCCAAGAGACCCAGTACTTC	CASMGGEAQETQYF	TRBV7-2	TRBJ2-5
TGTGCCAAACAGGGAGGGGAGACCCAGTACTTC	CAKQGGETQYF	TRBV11-3	TRBJ2-5
TGCGCCAGCAGGTGGACTATTGGCTACGAGCAGTACTTC	CASRWTIGYEQYF	TRBV5-1	TRBJ2-7
TGTGCCAGCAGGCTGGGGCCACAGCCCCAGCATTTT	CASRLGPQPQHF	TRBV6-5	TRBJ1-5
TGCGCCAGCAGAGGAAACAGGGCTAATTCACCCCTCCACTTT	CASRGNRANSPLHF	TRBV5-1	TRBJ1-6
TGTGCCAGCAGGGGACAGGTAGGGACCCTCCACTTT	CASRGQVGTLHF	TRBV7-2	TRBJ1-6
TGTGCCAGCAGCTTATCTTTAGACAGGGTCACCAATCAGCCCCAGCATTTT	CASSLSLDRVTNQPQHF	TRBV7-3	TRBJ1-5
TGTGCCAGCAGCCACACGGCAACAGGGAGCTCCTATAATTCACCCCTCCACTTT	CASSHTATGSSYNSPLHF	TRBV14	TRBJ1-6
TGTGCCAGTAGCGGCCGTCAGCCCCAGCATTTT	CASSGRQPQHF	TRBV19	TRBJ1-5
TGTGCCAGCAGCCCAACGGACAGGATCATTTATAGCAATCAGCCCCAGCATTTT	CASSPTDRIIYSNQPQHF	TRBV11-3	TRBJ1-5
TGTGCCAGCAGCTTAACTAGCGGGAGGGCGAGGCTTAAGCCCCAGCATTTT	CASSLTSGRARLKPQHF	TRBV7-9	TRBJ1-5
TGCGCCAGCAGTGAGCCCCGACAGAGCTCCTATAATTCACCCCTCCACTTT	CASSEPRQSSYNSPLHF	TRBV10-1	TRBJ1-6
TGTGCCAGCAGTTTATGCGGGAACAGGGCTATCAATAGCAATCAGCCCCAGCATTTT	CASSLCGNRAINSNQPQHF	TRBV28	TRBJ1-5
TGTGCCAGCATACGAGGGGGACGAACTGAAGCTTTCTTT	CASIRGGRTEAFF	TRBV12-3	TRBJ1-1
TGCAGTGCTAGCGGGACAGGGATCTCCTACGAGCAGTACTTC	CSASGTGISYEQYF	TRBV20-1	TRBJ2-7
TGCAGTGCTCTGGGGAGGATCGATGCAGATACGCAGTATTTT	CSALGRIDADTQYF	TRBV20-1	TRBJ2-3
TGCGCCAGCAGCTTGGTCCTCGAGGGGGACAATGAGCAGTTCTTC	CASSLVLEGDNEQFF	TRBV5-1	TRBJ2-1
TGTGCCACGAGCGCGGGTTCACCCCTCCACTTT	CATSAGSPLHF	TRBV24-1	TRBJ1-6
TGTGCCAGCAGTTTATCGGCCGTCTGGGGCGGGATGATCTCCTACGAGCAGTACTTC	CASSLSAVWGGMISYEQYF	TRBV27	TRBJ2-7
TGTGCTAGTGGTTTGACTAGGCCCTACAATGAGCAGTTCTTC	CASGLTRPYNEQFF	TRBV12-5	TRBJ2-1
TGTGCCAGCAGCGTGACAGCAGGCTACCATCAGCCCCAGCATTTT	CASSVTAGYHQPQHF	TRBV7-2	TRBJ1-5
TGTGCCAGCAGCAGATTCCTTGTAGCGGGAGACAATGAGCAGTTCTTC	CASSRFLVAGDNEQFF	TRBV7-6	TRBJ2-1
TGTGCCAGCAGCCAAGAGGGGGGGTCAGAGACCCAGTACTTC	CASSQEGGSETQYF	TRBV3-1	TRBJ2-5
TGTGCCAGCAGTTACCGGGGGGGGGGTGTCTATGGCTACACCTTC	CASSYRGGGVYGYTF	TRBV6-3	TRBJ1-2
TGTGCCAACCCTCAAGGGGGGCGGGCCTACGAGCAGTACTTC	CANPQGGRAYEQYF	TRBV6-4	TRBJ2-7
TGTGCCAGCAGCATTGGAGACACGGCGAGGGAGGTAAATGAAAAACTGTTTTTT	CASSIGDTAREVNEKLFF	TRBV13	TRBJ1-4
TGTGCCAGCACCCCCCTGCGGGGGGGAGGGTATGCAGATACGCAGTATTTT	CASTPLRGGGYADTQYF	TRBV7-9	TRBJ2-3
TGTGCCAGCAGCGATTCCGATAGACTAGCGGGCTCCTACGAGCAGTACTTC	CASSDSDRLAGSYEQYF	TRBV7-2	TRBJ2-7
TGTGCCAGCAGTGAAAAAGGGGGGGGACTAGGACGCTCCTACAATGAGCAGTTCTTC	CASSEKGGGLGRSYNEQFF	TRBV6-1	TRBJ2-1
TGTGCCAGCAGCTGCCTCAACCTAGGACAGGCAGATACGCAGTATTTT	CASSCLNLGQADTQYF	TRBV7-3	TRBJ2-3
TGTGCTAGTGGTTTCGACAGGGGCTATGGCTACACCTTC	CASGFDRGYGYTF	TRBV12-5	TRBJ1-2
TGCAGTGCTAGGGAGGGGATGGACACCCAAGAGACCCAGTACTTC	CSAREGMDTQETQYF	TRBV20-1	TRBJ2-5
TGTGCCAGCAGTTATTTCTGGACGAGGGGGTATCAATATAGCAATCAGCCCCAGCATTTT	CASSYFWTRGYQYSNQPQHF	TRBV6-6	TRBJ1-5
TGCGCCAGCAGCTTTTACCAGATGAACACTGAAGCTTTCTTT	CASSFYQMNTEAFF	TRBV5-1	TRBJ1-1
TGTGCCAGCAGTTTACAATCTAGAGGCACAGATACGCAGTATTTT	CASSLQSRGTDTQYF	TRBV28	TRBJ2-3
TGTGCCAGCAGGACGGGGACTAGTAGCTACGAGCAGTACTTC	CASRTGTSSYEQYF	TRBV7-3	TRBJ2-7
TGTGCCATCAGTGCGGAGGGGAGTAGCTCCTACGAGCAGTACTTC	CAISAEGSSSYEQYF	TRBV10-3	TRBJ2-7
TGCGCCAGCAGCTTCCAGGGGTACGAGCAGTACTTC	CASSFQGYEQYF	TRBV5-1	TRBJ2-7
TGCAGTAAAACGGGACAGGGACTTGGGACGGACCCCAATCAGCCCCAGCATTTT	CSKTGQGLGTDPNQPQHF	TRBV20-1	TRBJ1-5
TGTGCCAGCAGTTCCCGGGGGGCCATGGAACATGAGCAGTTCTTC	CASSSRGAMEHEQFF	TRBV27	TRBJ2-1
TGTGCCATGCCATTAACAGGGGGTCCTCCAGATACGCAGTATTTT	CAMPLTGGPPDTQYF	TRBV9	TRBJ2-3
TGTGCCAGCAGCGAAGGGACAGGGGGGTCACCCCTCCACTTT	CASSEGTGGSPLHF	TRBV7-7	TRBJ1-6
TGTGCCAGCAGCAACGGAGAAAGGGAAAATCAGCCCCAGCATTTT	CASSNGERENQPQHF	TRBV5-6	TRBJ1-5
TGTGCCAGCAGTGACGGACATGTTAAGACTAACTATGGCTACACCTTC	CASSDGHVKTNYGYTF	TRBV6-4	TRBJ1-2
TGTGCCAGCAGCTTCGCTCCAGGACAGGGGTTTAGCAATCAGCCCCAGCATTTT	CASSFAPGQGFSNQPQHF	TRBV7-2	TRBJ1-5
TGTGCCAGCAGGGGGGCCTACGAGCAGTACTTC	CASRGAYEQYF	TRBV27	TRBJ2-7
TGTGCCAGTAGTGACCGGGGAAACTATGGCTACACCTTC	CASSDRGNYGYTF	TRBV19	TRBJ1-2
TGTGCCTGGAAGGGGGCGAATGAAAAACTGTTTTTT	CAWKGANEKLFF	TRBV30	TRBJ1-4
TGTGCCAGCAGTCGGGACAGGGATAATCAGCCCCAGCATTTT	CASSRDRDNQPQHF	TRBV27	TRBJ1-5
TGTGCCAGCAGTGACGGTAGGCACTCTAATTCACCCCTCCACTTT	CASSDGRHSNSPLHF	TRBV6-4	TRBJ1-6
TGTGCCAGCAGCACAGGGGGGGAGTACTTC	CASSTGGEYF	TRBV7-3	TRBJ2-4
TGTGCCAGCAGTTCCAGACGTGAGCAGTTCTTC	CASSSRREQFF	TRBV6-2	TRBJ2-1
TGTGCCAGCAGCCGGATCCGCAGACTGTGCGAGACCCAGTACTTC	CASSRIRRLCETQYF	TRBV5-4	TRBJ2-5
TGTTCCGCAGGGAGAGCGAACACTGAAGCTTTCTTT	CSAGRANTEAFF	TRBV27	TRBJ1-1
TGTGCCAGCAGCGGCGGGAACTCAGATACGCAGTATTTT	CASSGGNSDTQYF	TRBV13	TRBJ2-3
TGTGCCAGCAGTTACGATACGGGTGGAGGTGGGGACGAGCAGTACTTC	CASSYDTGGGGDEQYF	TRBV6-3	TRBJ2-7
TGCAGCGTTGAAGATGACATAAATGGCTACACCTTC	CSVEDDINGYTF	TRBV29-1	TRBJ1-2
TGTGCCAGCAGTCCGGTAATCAGAGCTTTCTTT	CASSPVIRAFF	TRBV6-1	TRBJ1-1
TGCGCCAGCAGCCAAAGGACAGTTCAAGAGACCCAGTACTTC	CASSQRTVQETQYF	TRBV4-1	TRBJ2-5
TGCAGTGCTAGAGATCATGGGACTAGCATTCAGTACTTC	CSARDHGTSIQYF	TRBV20-1	TRBJ2-4
TGTGCCAGCAGCTTGGGGACAGGGAGGGGTAAAGTGAATCAGCCCCAGCATTTT	CASSLGTGRGKVNQPQHF	TRBV7-9	TRBJ1-5
TGCGCCAGCAGTGAGCACCAGACAGGGGGCTTAGAAAACACTGAAGCTTTCTTT	CASSEHQTGGLENTEAFF	TRBV10-2	TRBJ1-1
TGTGCCAGCAGCAGAATCGCACTCCCTGGGGGGCCCTACGAGCAGTACTTC	CASSRIALPGGPYEQYF	TRBV7-9	TRBJ2-7
TGCGCCAGCAGGGGACAGGGGAATCAGCCCCAGCATTTT	CASRGQGNQPQHF	TRBV10-1	TRBJ1-5
TGTGCCAGCAGCCCTAGTTGGAAAGGGACAGATACGCAGTATTTT	CASSPSWKGTDTQYF	TRBV4-2	TRBJ2-3
TGTGCCAGCAGCGTGGGGACGGTACAGAATGAGCAGTTCTTC	CASSVGTVQNEQFF	TRBV9	TRBJ2-1
TGTGCGACGTTACCGGGTTGCACAGATACGCAGTATTTT	CATLPGCTDTQYF	TRBV7-9	TRBJ2-3
TGTGCCAGCAATGTACCCAATAGCGGCATCACCGGGGAGCTGTTTTTT	CASNVPNSGITGELFF	TRBV6-1	TRBJ2-2
TGTGCCAGCAGCCTGGGGGGCACCCATCAGCCCCAGCATTTT	CASSLGGTHQPQHF	TRBV13	TRBJ1-5
TGTGCCAGCAGCTTAACGCGTATGACTAGCGGGAGCTCCTACGAGCAGTACTTC	CASSLTRMTSGSSYEQYF	TRBV7-3	TRBJ2-7
TGTGCCAGCAGCCTCACCCAGGGGGCAGAGTACACCGGGGAGCTGTTTTTT	CASSLTQGAEYTGELFF	TRBV11-3	TRBJ2-2
TGCGCCAGCAGAAGGGACAATAACACTGAAGCTTTCTTT	CASRRDNNTEAFF	TRBV5-1	TRBJ1-1
TGTGCCAGCAGCCATTGGGTCGGCTACACCTTC	CASSHWVGYTF	TRBV11-2	TRBJ1-2
TGTGCCAGCAGCTTGATACTAGCGGGAACCGATGAGCAGTTCTTC	CASSLILAGTDEQFF	TRBV5-4	TRBJ2-1
TGTGCCAGCAGTGACTCCTCACCGGGACAGGGGGCGGGACCCAGGGGCTACACCTTC	CASSDSSPGQGAGPRGYTF	TRBV6-4	TRBJ1-2
TGTGCCAGCAGTGAGATGGGTCGGCGGTGTAATGAGCAGTTCTTC	CASSEMGRRCNEQFF	TRBV6-1	TRBJ2-1
TGCAGTGCTAGAATACCATCGGGGAGGGAGTATGGCTACACCTTC	CSARIPSGREYGYTF	TRBV20-1	TRBJ1-2
TGTGCCAGCCTAAGCGGGACTGGCAATGGCTACACCTTC	CASLSGTGNGYTF	TRBV2	TRBJ1-2
TGTGCCAGTAGTATAGTATTGGGACTAGGGGACGCAGATACGCAGTATTTT	CASSIVLGLGDADTQYF	TRBV19	TRBJ2-3
TGTGCCATCAACGGCCAGGGGAGACAGCCCCAGCATTTT	CAINGQGRQPQHF	TRBV10-3	TRBJ1-5
TGTGCCACCAGCAGACCGGCGGGTTCAGATACGCAGTATTTT	CATSRPAGSDTQYF	TRBV15	TRBJ2-3
TGTGCCAGCAGTTACAGGGACAGCGGCAATTCAACCACCGGGGAGCTGTTTTTT	CASSYRDSGNSTTGELFF	TRBV6-2	TRBJ2-2
TGTGCCAGCAGATGTATCGAGCGGGATGTTGGAACCCACATATACGAGCAGTACTTC	CASRCIERDVGTHIYEQYF	TRBV6-2	TRBJ2-7
TGTGCCACCAGTGAAATATGGTACTTC	CATSEIWYF	TRBV24-1	TRBJ2-5
TGTGCCAGCAGTTTTGACAGGGGAAAACGGGCCAAAAACATTCAGTACTTC	CASSFDRGKRAKNIQYF	TRBV27	TRBJ2-4
TGTGCCAGCAGCGGCCTGAGGACAGGAGTTTTTAACTATGGCTACACCTTC	CASSGLRTGVFNYGYTF	TRBV9	TRBJ1-2
TGTGCCAGTAGTATCAGACAGGGAAGAGTACAGCCCCAGCATTTT	CASSIRQGRVQPQHF	TRBV19	TRBJ1-5
TGTGCCAGCAGCGGGTCAGCTGGAAACACCATATATTTT	CASSGSAGNTIYF	TRBV13	TRBJ1-3
TGCAGCGTTGAAATCCCCACTAGCGGGCAAGAGACCCAGTACTTC	CSVEIPTSGQETQYF	TRBV29-1	TRBJ2-5
TGTGCCAGCAGTCGAGGACAGGGACGGTGGGAGAAGGATAACTATGGCTACACCTTC	CASSRGQGRWEKDNYGYTF	TRBV6-5	TRBJ1-2
TGCAGACGGGAGGTCCACACAGATACGCAGTATTTT	CRREVHTDTQYF	TRBV20-1	TRBJ2-3
TGTGCCACCAGTGATATACAACTGCGGCAGCCCCAGCATTTT	CATSDIQLRQPQHF	TRBV24-1	TRBJ1-5
TGTGCCAGCAGTGTGTTAGAACGGACCTACGAGCAGTACTTC	CASSVLERTYEQYF	TRBV2	TRBJ2-7
TGTGCCACCAGCATCGAGGACAGGGAACAGGATACGCAGTATTTT	CATSIEDREQDTQYF	TRBV15	TRBJ2-3
TGTGCCAGCAGCTTAGGGATACCCAGAGGCCTAGTGAACACTGAAGCTTTCTTT	CASSLGIPRGLVNTEAFF	TRBV7-9	TRBJ1-1
TGCAGCGCCTCTTCCAAGGGGGGCTCGTCGGGCACAGATACGCAGTATTTT	CSASSKGGSSGTDTQYF	TRBV29-1	TRBJ2-3
TGTGCCAGCAGTCAAGATACCGGACTAGCGGTCCACGAGCAGTACTTC	CASSQDTGLAVHEQYF	TRBV6-1	TRBJ2-7
TGTGCCAGCAGCCGGGCGGGCTACGAGCAGTACTTC	CASSRAGYEQYF	TRBV6-1	TRBJ2-7
TGCAGTGCCCTAGCGGGGGAAGCAACAGATACGCAGTATTTT	CSALAGEATDTQYF	TRBV20-1	TRBJ2-3
TGTGCCAGTAAAGGGGGACAGGGGCAGGACACTGAAGCTTTCTTT	CASKGGQGQDTEAFF	TRBV19	TRBJ1-1
TGTGCCAGCAGCAGCATGACTAGCGGCCCAGCCGGGGAGCTGTTTTTT	CASSSMTSGPAGELFF	TRBV7-3	TRBJ2-2
TGTGCCAGCAGCAGGGGGGCATGCGGCAATGAGCAGTTCTTC	CASSRGACGNEQFF	TRBV7-8	TRBJ2-1
TGTCCGGCAGGGGGCCCCTCCCGATCACCCCTCCACTTT	CPAGGPSRSPLHF	TRBV7-9	TRBJ1-6
TGCGCCAGCAGCAGGCTCGCCCGGACAGGGGGTAATGAAAAACTGTTTTTT	CASSRLARTGGNEKLFF	TRBV5-1	TRBJ1-4
TGTGCCAGTAGTCTTTCGCCTAGAACGGATCAAGACACCGGGGAGCTGTTTTTT	CASSLSPRTDQDTGELFF	TRBV19	TRBJ2-2
TGTGCCCCGAATACCGACAGGGGGCACACTGAAGCTTTCTTT	CAPNTDRGHTEAFF	TRBV2	TRBJ1-1
TGTGCCTGGAGTCGAACGAATTACCGGACCCAAGAGACCCAGTACTTC	CAWSRTNYRTQETQYF	TRBV30	TRBJ2-5
TGTGCCAGCAGTCTGCCCAGGGCCAAAAAGCCGGTGCAAGAGACCCAGTACTTC	CASSLPRAKKPVQETQYF	TRBV12-4	TRBJ2-5
TGTGCCAGCAGCTTATTAGGGGGGGCGATCACAGATACGCAGTATTTT	CASSLLGGAITDTQYF	TRBV7-2	TRBJ2-3
TGTGCCAGCAGCCGGGGGGGGAAGTCATCTAGCACAGATACGCAGTATTTT	CASSRGGKSSSTDTQYF	TRBV12-3	TRBJ2-3
TGCAGCGTTGTACAGGACCCCCCCCGCGGCAATCAGCCCCAGCATTTT	CSVVQDPPRGNQPQHF	TRBV29-1	TRBJ1-5
TGTGCCAGCAGTTACTCAGATAAAAAACTGTTTTTT	CASSYSDKKLFF	TRBV6-9	TRBJ1-4
TGTGCCAGCAGCCTTTATTGGGGGCGAGGGGATTCACCCCTCCACTTT	CASSLYWGRGDSPLHF	TRBV13	TRBJ1-6
TGTGCCACCAGTGTGGCGGGGTTGGCGAACACCGGGGAGCTGTTTTTT	CATSVAGLANTGELFF	TRBV24-1	TRBJ2-2
TGTGCCAGCAGCCAACACCTAATGACCTACGAGCAGTACTTC	CASSQHLMTYEQYF	TRBV13	TRBJ2-7
TGTGCCAGCTCAGGCGAAGCCTCACCGGACCTACCGTACGAGCAGTACTTC	CASSGEASPDLPYEQYF	TRBV18	TRBJ2-7
TGTGCCAGCACTCAGGGGAAATTGAACACTGAAGCTTTCTTT	CASTQGKLNTEAFF	TRBV9	TRBJ1-1
TGTGCCAGCACAGGCTCCTACGAGCAGTACTTC	CASTGSYEQYF	TRBV6-1	TRBJ2-7
TGTGCCTGGAGATCGGCCCCGGTCTTC	CAWRSAPVF	TRBV30	TRBJ2-1
TGTGCCAGCACGAACCAGGTAGAGACCCAGTACTTC	CASTNQVETQYF	TRBV6-3	TRBJ2-5
TGTGCCAGCAGCAATCAGCCAGGGGGCGGGGACACCTTC	CASSNQPGGGDTF	TRBV7-3	TRBJ1-2
TGCGCCAGAAGCCCGGGACAGAGCTACGAGCAGTACTTC	CARSPGQSYEQYF	TRBV10-1	TRBJ2-7
TGTGCCAGCAGTGTTAGTTCCGACTGGAATGAGCAGTTCTTC	CASSVSSDWNEQFF	TRBV6-1	TRBJ2-1
TGCGCCAGCAGCTTGGGTTTAGGACGGGGGAACACTGAAGCTTTCTTT	CASSLGLGRGNTEAFF	TRBV5-1	TRBJ1-1
TGTGCCAGCATGACCCCGGGGAAAGTGGGGGGGAAGACTGAAGCTTTCTTT	CASMTPGKVGGKTEAFF	TRBV11-3	TRBJ1-1
TGTGCCAGCAGTTGGCTTGAAAAACTGTTTTTT	CASSWLEKLFF	TRBV27	TRBJ1-4
TGTGCCAGCATGTTCACTAGCGGGATGGTCTTC	CASMFTSGMVF	TRBV7-9	TRBJ2-1
TGCGCCAGCAGCTCCTGTCTGAAATCTCGGGGGGAGCAGTACTTC	CASSSCLKSRGEQYF	TRBV5-1	TRBJ2-7
TGTGGGGCTCGGGCTAACTATGGCTACACCTTC	CGARANYGYTF	TRBV27	TRBJ1-2
TGTGCCAGCAGCCTGTCCGGGGGGTCTTGGTTGGAGAGCACAGATACGCAGTATTTT	CASSLSGGSWLESTDTQYF	TRBV2	TRBJ2-3
TGTGCCAGCAGCTCCCTCCGGGACAAGGGGCATTTT	CASSSLRDKGHF	TRBV5-4	TRBJ1-5
TGTGCCAGCACAAGAGGGAAAGTGGCTAATGAAAAACTGTTTTTT	CASTRGKVANEKLFF	TRBV6-3	TRBJ1-4
TGCGCCAGCAGGTGTAGTGACAAGGGACGGAAGTGGGAAAAACTGTTTTTT	CASRCSDKGRKWEKLFF	TRBV10-1	TRBJ1-4
TGTGCCAGCAGCATTCAGGGGACAGGGGGTAATGAGCAGTTCTTC	CASSIQGTGGNEQFF	TRBV13	TRBJ2-1
TGTGCCAGCAGCAATAGGGCCGCCTACGAGCAGTACTTC	CASSNRAAYEQYF	TRBV7-3	TRBJ2-7
TGTGCCAGCAGCTTACACCCTAGTGTGCCCATAAGCGGGAAAAGGATGAACACCGGGGAGCTGTTTTTT	CASSLHPSVPISGKRMNTGELFF	TRBV7-3	TRBJ2-2
TGTGCCAGCAGCAGATGGTGCCACAAGATTCTAGCGAACACAGATACGCAGTATTTT	CASSRWCHKILANTDTQYF	TRBV13	TRBJ2-3
TGTGCCATCAGTGAGTCGACCCCGGGACTAGGGAGTGAGACCCAGTACTTC	CAISESTPGLGSETQYF	TRBV10-3	TRBJ2-5
TGCAGCATCTCTCAGGGAGTGGGCGGGAACACTGAAGCTTTCTTT	CSISQGVGGNTEAFF	TRBV29-1	TRBJ1-1
TGTGCCAGCACGAGGGGCTCGGTGGGTTCCAGCAATCAGCCCCAGCATTTT	CASTRGSVGSSNQPQHF	TRBV6-3	TRBJ1-5
TGTGCCTGGAGACGAAGCATGAAGCACGAGCAGTACTTC	CAWRRSMKHEQYF	TRBV30	TRBJ2-7
TGTGCCACCAGTGATTGGGGGACCTACGAGCAGTACTTC	CATSDWGTYEQYF	TRBV24-1	TRBJ2-7
TGTGCCAGCTCACCACCTGGGTCAAAGGACAGGGGTCAGCCCCAGCATTTT	CASSPPGSKDRGQPQHF	TRBV18	TRBJ1-5
TGTGCCAAAATGAAGTGGCAAAGTAGAACTAATGAAAAACTGTTTTTT	CAKMKWQSRTNEKLFF	TRBV28	TRBJ1-4
TGTGCCAGCAGCCAAGATTCCGGGACAGTCGCCACCGGGGAGCTGTTTTTT	CASSQDSGTVATGELFF	TRBV14	TRBJ2-2
TGTGCCAGCAGGGGCGATCCCGGGGAGCTGTTTTTT	CASRGDPGELFF	TRBV7-9	TRBJ2-2
TGTGCCAGCAGCTGGGGGACTAGCGGGGTGGGAGAGACCCAGTACTTC	CASSWGTSGVGETQYF	TRBV13	TRBJ2-5
TGTGCCAGCGACGAGGGGAGTGGACAAGAGACCCAGTACTTC	CASDEGSGQETQYF	TRBV6-1	TRBJ2-5
TGCGCCAGCAGTGCTGAGCCTCCGGGCTTGTCCTACAATGAGCAGTTCTTC	CASSAEPPGLSYNEQFF	TRBV10-1	TRBJ2-1
TGTGCCATCACACGGTACCCGGGACAGGGAAGTTATGGCTACACCTTC	CAITRYPGQGSYGYTF	TRBV10-3	TRBJ1-2
TGTGCTAGTGGACAGGGAGGCCATTATGGCTACACCTTC	CASGQGGHYGYTF	TRBV12-5	TRBJ1-2
TGTGCCAGCAGCAGCACAGGGTTGGGGCGCTCTGGAAACACCATATATTTT	CASSSTGLGRSGNTIYF	TRBV11-3	TRBJ1-3
TGTGCCAGCAGTTTCCACTCGGATTCAACTAATGAAAAACTGTTTTTT	CASSFHSDSTNEKLFF	TRBV27	TRBJ1-4
TGTGCCAATCGGCTATTCACAGATACGCAGTATTTT	CANRLFTDTQYF	TRBV24-1	TRBJ2-3
TGTGCCAGGCCCCCACGTACGGGATACTACGAGCAGTACTTC	CARPPRTGYYEQYF	TRBV28	TRBJ2-7
TGTGCCAGCAGCGTAGCTAACTTCATTATACAGGGGCGGAAAAACTATGGCTACACCTTC	CASSVANFIIQGRKNYGYTF	TRBV9	TRBJ1-2
TGTGCCAGCAGGCCCCGACTAGCCTCAGATACGCAGTATTTT	CASRPRLASDTQYF	TRBV6-5	TRBJ2-3
TGTGCCACCAGCAGAGTCCCTGTGAACACTGAAGCTTTCTTT	CATSRVPVNTEAFF	TRBV15	TRBJ1-1
TGTGACTCCCCGGGACAGGGGTCCGAAGGCAATCAGCCCCAGCATTTT	CDSPGQGSEGNQPQHF	TRBV11-3	TRBJ1-5
TGCGCCAGCAGCCCGGACAGGGGACCCCTCCACTTT	CASSPDRGPLHF	TRBV5-1	TRBJ1-6
TGTGCCAGCAGTAGGGACAGGGAAATTGCGGACGAGCAGTACTTC	CASSRDREIADEQYF	TRBV6-5	TRBJ2-7
TGTGCCAGCAGCTCCTGCCCACCGGACGGAGACCCCAATCAGCCCCAGCATTTT	CASSSCPPDGDPNQPQHF	TRBV7-3	TRBJ1-5
TGTGCCAGCAGACGGGACGACGAAACAAATTCACCCCTCCACTTT	CASRRDDETNSPLHF	TRBV6-2	TRBJ1-6
TGTGCCAGCAGCCAAGATAGGACAGAGAACTATGGCTACACCTTC	CASSQDRTENYGYTF	TRBV3-1	TRBJ1-2
TGCAGCGCGGGGGGAACCCCCGGGACTATCACCGGGGAGCTGTTTTTT	CSAGGTPGTITGELFF	TRBV29-1	TRBJ2-2
TGTGCCAGTAGTGGGGACAGAGAACATGCAACTAATGAAAAACTGTTTTTT	CASSGDREHATNEKLFF	TRBV19	TRBJ1-4
TGTGCCAGCTGGACCGCAGGAGACGTTGAGACCCAGTACTTC	CASWTAGDVETQYF	TRBV27	TRBJ2-5
TGTGCCATCAGGCTCATCTGGGCAGCTAACTATGGCTACACCTTC	CAIRLIWAANYGYTF	TRBV10-3	TRBJ1-2
TGTGCCAGCAGGAAGGGACTAGCCGGCCCCGGGGAGCTGTTTTTT	CASRKGLAGPGELFF	TRBV7-9	TRBJ2-2
TGTGCCAGCAGGCATATGAAAGGACAGGGGGGGACAAGCTCCTACGAGCAGTACTTC	CASRHMKGQGGTSSYEQYF	TRBV7-9	TRBJ2-7
TGTGCCAGCAGCGCTCTCCCTTCCGGCCGGGCCCTCCACTTT	CASSALPSGRALHF	TRBV13	TRBJ1-6
TGTGCCAGCAGCCAAGGGCCCAGGATATACGAGCAGTACTTC	CASSQGPRIYEQYF	TRBV14	TRBJ2-7
TGTGCCAGCAGTTACTCGCTGGGTACAGGGGGAGTCAATCAGCCCCAGCATTTT	CASSYSLGTGGVNQPQHF	TRBV6-6	TRBJ1-5
TGTGCCAGCAGTGAATCCCGGGGGGGTGGAAATGAAAAACTGTTTTTT	CASSESRGGGNEKLFF	TRBV25-1	TRBJ1-4
TGCGCCAGCAGGAGCACGGGACTAGTCGCCAGTGATACGCAGTATTTT	CASRSTGLVASDTQYF	TRBV5-1	TRBJ2-3
TGTGCCAGCAGCCGGGGGCAAGGGGGGGGCTATGGCTACACCTTC	CASSRGQGGGYGYTF	TRBV5-4	TRBJ1-2
TGCAGCGTTGCGAGGAGGGACACAGATACGCAGTATTTT	CSVARRDTDTQYF	TRBV29-1	TRBJ2-3
TGTGCCATCAGTGAGCCGGACAGGGGCGCTGAAGCTTTCTTT	CAISEPDRGAEAFF	TRBV10-3	TRBJ1-1
TGTGCCAGCAGTGGAATTGCGAACAGGGGTGAACGGGAAGCTTTCTTT	CASSGIANRGEREAFF	TRBV2	TRBJ1-1
TGTGCCACCAGTGCTGGGGACCGGGACAGGGGAACTGAAGCTTTCTTT	CATSAGDRDRGTEAFF	TRBV24-1	TRBJ1-1
TGTGCCAGCAGTGAATGGGCTAGCGGGTATCGGGACAATGAGCAGTTCTTC	CASSEWASGYRDNEQFF	TRBV25-1	TRBJ2-1
TGCGCCAGCAGTGAGCCCCCGGGACAGGGGAGGGGCTCCTACGAGCAGTACTTC	CASSEPPGQGRGSYEQYF	TRBV10-1	TRBJ2-7
TGCGCCATTCGGGAGGGGATGTGGAGAGGCCTCAATGAGCAGTTCTTC	CAIREGMWRGLNEQFF	TRBV4-1	TRBJ2-1
TGTGCCAGCAGCACCTCCCGGGAAAAAAACATTCAGTACTTC	CASSTSREKNIQYF	TRBV13	TRBJ2-4
TGTGCCAGCAGCGACAGGAAACATAGTCGAACAAAAGGCTACACCTTC	CASSDRKHSRTKGYTF	TRBV13	TRBJ1-2
TGTGCCAGCAGCGACTTGCTCTCCTACGAGCAGTACTTC	CASSDLLSYEQYF	TRBV5-8	TRBJ2-7
TGTGCCAGCAATTTAGGGACAGGGTTCTGTGGGTCCTATAATTCACCCCTCCACTTT	CASNLGTGFCGSYNSPLHF	TRBV28	TRBJ1-6
TGTGCCAGCAGCTTAGCGGAATTCGGGACTAGCCAAGGCTTGGGCACAGATACGCAGTATTTT	CASSLAEFGTSQGLGTDTQYF	TRBV11-2	TRBJ2-3
TGTGCCAGCAGTTTAGGACTAGCGGGGCCGCTGCCGACAGATACGCAGTATTTT	CASSLGLAGPLPTDTQYF	TRBV12-4	TRBJ2-3
TGCGCCAGTTTTGAACAGGAGGGCACTGAAGCTTTCTTT	CASFEQEGTEAFF	TRBV5-1	TRBJ1-1
TGTGCCACCAGCATTCTTGGGCCCGAGCAGTACTTC	CATSILGPEQYF	TRBV15	TRBJ2-7
TGTGCCAGCAGCCCACGAAGACTAGTGGCCTACGAGCAGTACTTC	CASSPRRLVAYEQYF	TRBV5-6	TRBJ2-7
TGTGCCAGCAGTTACTTCGACAGCTGCCACGAGCAGTACTTC	CASSYFDSCHEQYF	TRBV6-5	TRBJ2-7
TGTGCCAGCAGTTCCAGGGGGGGCGTGGCCCTGCTTTTGTATACGCAGTATTTT	CASSSRGGVALLLYTQYF	TRBV6-3	TRBJ2-3
TGCGCCAGTCCGGGGCTAAGCAATGAGCAGTTCTTC	CASPGLSNEQFF	TRBV5-1	TRBJ2-1
TGTGCCAGCAGTTTCCTAGGGTTAAGGCTCAAAAACATTCAGTACTTC	CASSFLGLRLKNIQYF	TRBV12-3	TRBJ2-4
TGCGGACTAGCGGGCTGGAACACCGGGGAGCTGTTTTTT	CGLAGWNTGELFF	TRBV5-1	TRBJ2-2
TGTGCCAGCAGCTCACCGAGGGCCCCCAGGACAGGATACGACGCCAAAAACATTCAGTACTTC	CASSSPRAPRTGYDAKNIQYF	TRBV7-4	TRBJ2-4
TGTGCCAGCAGCTCATACAAGGCCCAGGGCTACGAGCAGTACTTC	CASSSYKAQGYEQYF	TRBV7-6	TRBJ2-7
TGCAGTGCTAGTCTCGTGGTCCCGGGACTAGCGGGAGCAGTAGCCAAAAACATTCAGTACTTC	CSASLVVPGLAGAVAKNIQYF	TRBV20-1	TRBJ2-4
TGTGCCAGCAGTAATGGGAGACAAGACTACGAGCAGTACTTC	CASSNGRQDYEQYF	TRBV27	TRBJ2-7
TGTGCCAGCAGAGCCAGTGGCACCGGGGACGAGCAGTACTTC	CASRASGTGDEQYF	TRBV6-6	TRBJ2-7
TGTGCCAGCAGCCAAAGCGGGGGACTAACCCAGTACTTC	CASSQSGGLTQYF	TRBV14	TRBJ2-5
TGTGCCAGCAGCAGGGGGAAAGATACGCAGTATTTT	CASSRGKDTQYF	TRBV6-1	TRBJ2-3
TGTGCCAGCAGTAGGATGGGGACTAGCGGGGGAGATCCCTACAATGAGCAGTTCTTC	CASSRMGTSGGDPYNEQFF	TRBV12-3	TRBJ2-1
TGTGCCAGCAGAATTGGGTCTAGCATGAACACTGAAGCTTTCTTT	CASRIGSSMNTEAFF	TRBV12-4	TRBJ1-1
TGTGCCAGCAGCTTAGCAGAGGGGGACTATGGCTACACCTTC	CASSLAEGDYGYTF	TRBV11-1	TRBJ1-2
TGCGCCAGCTGTCCGACAGATCAGCCCCAGCATTTT	CASCPTDQPQHF	TRBV5-1	TRBJ1-5
TGCGCCAGAAACGGGACAGACACGGACTCCCAAGCCTACGAGCAGTACTTC	CARNGTDTDSQAYEQYF	TRBV4-1	TRBJ2-7
TGCGCCAGCAGCCCGGGACAGGGCTCCACTTTCTTT	CASSPGQGSTFF	TRBV10-1	TRBJ1-1
TGTGCCAGCAGCAGGGGACTACATACCGGGGAGCTGTTTTTT	CASSRGLHTGELFF	TRBV3-1	TRBJ2-2
TGTGCCACCCTATGGGACAGCTCAATGGACTATGGCTACACCTTC	CATLWDSSMDYGYTF	TRBV24-1	TRBJ1-2
TGTGCCAGCAGCCAAGGGGGAGGGGTTGAGCAGTACTTC	CASSQGGGVEQYF	TRBV3-1	TRBJ2-7
TGTGCCAGCGAGAAGAAGATGGAGGGGCTCGAAAAACAAAACTATGGCTACACCTTC	CASEKKMEGLEKQNYGYTF	TRBV6-4	TRBJ1-2
TGTGCCAGCAGTTTCCATAGGAGCTCCTACAATGAGCAGTTCTTC	CASSFHRSSYNEQFF	TRBV27	TRBJ2-1
TGTGCCACCCCAGGTCCACCACCTAAAAAACAGACAGGGGGCGGGTCCACTAATGAAAAACTGTTTTTT	CATPGPPPKKQTGGGSTNEKLFF	TRBV11-2	TRBJ1-4
TGTGCCAGCAGTTTAGGTACGCATCTCTTGGGGTCCTACGAGCAGTACTTC	CASSLGTHLLGSYEQYF	TRBV12-4	TRBJ2-7
TGTGCCAGCAGCCCCCAGGCCTTCTATTACGAGCAGTACTTC	CASSPQAFYYEQYF	TRBV13	TRBJ2-7
TGTGCCAGCAGCGTCACCCGTTCAGGGGTAGACATGAACACTGAAGCTTTCTTT	CASSVTRSGVDMNTEAFF	TRBV9	TRBJ1-1
TGTGCCAGCAGCGGTCGGGGGGGTCTCAATGAGCAGTTCTTC	CASSGRGGLNEQFF	TRBV11-2	TRBJ2-1
TGTGCCAGCAAAAAACGCCCTAGCAACGTCCTATCCTACGAGCAGTACTTC	CASKKRPSNVLSYEQYF	TRBV27	TRBJ2-7
TGTGCCAGCAGCCAAAGTGTAATGGCCGGGGAGCTGTTTTTT	CASSQSVMAGELFF	TRBV3-1	TRBJ2-2
TGCAGCGTTGAGATTTTCGGCCAGCGGGGGGCGGGGGACCAAGAGACCCAGTACTTC	CSVEIFGQRGAGDQETQYF	TRBV29-1	TRBJ2-5
TGTGCCAGCCTAACAGGGCGTGATCAGCCCCAGCATTTT	CASLTGRDQPQHF	TRBV6-4	TRBJ1-5
TGTGCCAGCAGTGAGGTTACAGTCTACGAGCAGTACTTC	CASSEVTVYEQYF	TRBV6-4	TRBJ2-7
TGCGCCAGCAGGATAGTGTGGGGAATGAACACTGAAGCTTTCTTT	CASRIVWGMNTEAFF	TRBV10-1	TRBJ1-1
TGTGCCAGCAGCCAATGGGGTGACTTCACTGAAGCTTTCTTT	CASSQWGDFTEAFF	TRBV11-2	TRBJ1-1
TGTGCCAGCAGTATCCCGAACGAGGGGACCCAGTACTTC	CASSIPNEGTQYF	TRBV27	TRBJ2-5
TGTGCCAGCAGCTGGGAAGACGATCCAGATACGCAGTATTTT	CASSWEDDPDTQYF	TRBV7-3	TRBJ2-3
TGTGCCAGCAGCGTGGGCCTTAGGGGTCTCCAGGGTAATGAGCAGTTCTTC	CASSVGLRGLQGNEQFF	TRBV7-9	TRBJ2-1
TGTGCCAGCAGTTTAGGGGGGAGGACCACTGAAGCTTTCTTT	CASSLGGRTTEAFF	TRBV12-4	TRBJ1-1
TGTGCCAGCAGCGTCGGGACAGGCACGGATCAGCCCCAGCATTTT	CASSVGTGTDQPQHF	TRBV11-2	TRBJ1-5
TGCGCCAGCAGCGCCGGAATTCCCCCAGGTAAGGACGAGCAGTACTTC	CASSAGIPPGKDEQYF	TRBV4-1	TRBJ2-7
TGTGCCAGCAGCCCCCCCGCGGAAAGGGCGCAATGCTACACCTTC	CASSPPAERAQCYTF	TRBV5-6	TRBJ1-2
TGTGCCAGCAGTGAAGATCCCTGGGGGTTGTGTTACGAGCAGTACTTC	CASSEDPWGLCYEQYF	TRBV6-4	TRBJ2-7
TGTGCTAGTGGTCCATGGCCTCTATGGATGAACACTGAAGCTTTCTTT	CASGPWPLWMNTEAFF	TRBV12-5	TRBJ1-1
TGTGCCAGCAGCTTGGGGGGACGGGGGCTAGACTCTGGAAACACCATATATTTT	CASSLGGRGLDSGNTIYF	TRBV5-4	TRBJ1-3
TGCGCCAGCACAACCCGGGGGGACGAGCAGTACTTC	CASTTRGDEQYF	TRBV5-1	TRBJ2-7
TGTGCCAGCTCACCCGCAGTTTTGGGCAAGCCCCAGCATTTT	CASSPAVLGKPQHF	TRBV18	TRBJ1-5
TGCAGTGCTAGAGCCGGAGGACAGGGAGGCAGCTCCTATAATTCACCCCTCCACTTT	CSARAGGQGGSSYNSPLHF	TRBV20-1	TRBJ1-6
TGCGCCAGCATCCCCGCGCAGTATTTT	CASIPAQYF	TRBV4-1	TRBJ2-3
TGTGCCAGCAGCTTGGTTCGGGTGGGTTTCTACGAGCAGTACTTC	CASSLVRVGFYEQYF	TRBV5-4	TRBJ2-7
TGTGCCAGCAGCTTGCGGGTCCCGACAAGCGAGCAGTACTTC	CASSLRVPTSEQYF	TRBV5-5	TRBJ2-7
TGCAGTGCTAGAGACAACGGACAGGGCATCTTGGATGAAAAACTGTTTTTT	CSARDNGQGILDEKLFF	TRBV20-1	TRBJ1-4
TGTGCTAGTAGGGGCCCAAAAAACTATGGCTACACCTTC	CASRGPKNYGYTF	TRBV12-5	TRBJ1-2
TGTGCCAGCAGTGACCTAGCTCGCCGGTGGGACTCACCCCTCCACTTT	CASSDLARRWDSPLHF	TRBV27	TRBJ1-6
TGTGCCAGCATGACAGGGGAGATTAACTATGGCTACACCTTC	CASMTGEINYGYTF	TRBV6-5	TRBJ1-2
TGTGCCATCAGTTTCGCGTGGGGACAGGGGGTTAACTATGGCTACACCTTC	CAISFAWGQGVNYGYTF	TRBV10-3	TRBJ1-2
TGTGCCAGCAGCCGAAGAAACTCAGATACGCAGTATTTT	CASSRRNSDTQYF	TRBV9	TRBJ2-3
TGTGCCAGCAGCGGGCTGCCAGGGCCTACACGCGTCAAGGAGCAGTACTTC	CASSGLPGPTRVKEQYF	TRBV6-2	TRBJ2-7
TGTGCCAGCAGCTTACAGCTAGCGGGCGATACGCAGTATTTT	CASSLQLAGDTQYF	TRBV7-8	TRBJ2-3
TGTGCCAGCAGCCAAGAGACAGGGGGGACAACTAATGAAAAACTGTTTTTT	CASSQETGGTTNEKLFF	TRBV3-1	TRBJ1-4
TGCTTAGGCACCGGGGAGCTGTTTTTT	CLGTGELFF	TRBV19	TRBJ2-2
TGCGCCAGCGCGGGACAGGGGTCTACATATAGCAATCAGCCCCAGCATTTT	CASAGQGSTYSNQPQHF	TRBV10-1	TRBJ1-5
TGTGCCAGCAGTTACCCCCTCCGTTACCCGGGACCGGCCTACAATGAGCAGTTCTTC	CASSYPLRYPGPAYNEQFF	TRBV6-5	TRBJ2-1
TGTGCCAGCAGTTGTAATGGGGGGGAATATGAGACCCAGTACTTC	CASSCNGGEYETQYF	TRBV6-2	TRBJ2-5
TGTGCCAGCAGCCGACTAGTTTATACGCAGTATTTT	CASSRLVYTQYF	TRBV14	TRBJ2-3
TGTGCCAGCAGCTTAGGGACTCCAGTTGTAAGGGTGGTGAACGAGCAGTACTTC	CASSLGTPVVRVVNEQYF	TRBV11-2	TRBJ2-7
TGTGCCAGCAGTTACCCCAGTACGGGACAGGACGGGAACACTGAAGCTTTCTTT	CASSYPSTGQDGNTEAFF	TRBV6-3	TRBJ1-1
TGTGCCTTTACGAAGATGCCCCGACACAGCTACGAGCAGTACTTC	CAFTKMPRHSYEQYF	TRBV27	TRBJ2-7
TGTGCCAGCAGTTTAGACAGGGCACGAGACGAGCAGTACTTC	CASSLDRARDEQYF	TRBV27	TRBJ2-7
TGTGCCATGGATTGGGGGGGTTCCTACGAGCAGTACTTC	CAMDWGGSYEQYF	TRBV15	TRBJ2-7
TGTGCTAGTGGTATTGAAGCTCTCAATCAGCCCCAGCATTTT	CASGIEALNQPQHF	TRBV12-5	TRBJ1-5
TGTGCCAGCAGCTTAGATGGGGCGCCCGGCTATGGCTACACCTTC	CASSLDGAPGYGYTF	TRBV11-3	TRBJ1-2
TGTCCTTTTCGGCCCCTCAGCAATCAGCCCCAGCATTTT	CPFRPLSNQPQHF	TRBV7-9	TRBJ1-5
TGTGCCAGCAGAGGTAGCTCCTACGAGCAGTACTTC	CASRGSSYEQYF	TRBV12-3	TRBJ2-7
TGTGCCAGCAGCTTTGGGACAGGGGGCGAGGGCTATGGCTACACCTTC	CASSFGTGGEGYGYTF	TRBV7-9	TRBJ1-2
TGTGCCAGCAGTAGGGGGGCGTGGGATGAGCAGTTCTTC	CASSRGAWDEQFF	TRBV6-4	TRBJ2-1
TGCGCCAGCAGCCCCCGGGACGGACTCGGTAACTATGGCTACACCTTC	CASSPRDGLGNYGYTF	TRBV5-1	TRBJ1-2
TGTGCCAGCAGCGTGGACAGTCCCGGGGAGCTGTTTTTT	CASSVDSPGELFF	TRBV14	TRBJ2-2
TGCGCCAGCAGCACTTCACGGGACAGTTGCGGGGAGCTGTTTTTT	CASSTSRDSCGELFF	TRBV5-1	TRBJ2-2
TGTGCCAGCAGCGGGGGGGGGTACGGTGACCTAGGTCCGGCTCTACTTAGAAGCTCCTACGAGCAGTACTTC	CASSGGGYGDLGPALLRSSYEQYF	TRBV3-1	TRBJ2-7
TGTGCCAGCAGCCAAGATATACAGGGGGACGGCGAGCAGTACTTC	CASSQDIQGDGEQYF	TRBV14	TRBJ2-7
TGTGCCAGCAGCTCTAGCGGGGCTACGGAGTTCAATGAGCAGTTCTTC	CASSSSGATEFNEQFF	TRBV7-9	TRBJ2-1
TGTGCCAGCAGTAATAGGACTAGCGGGGATTCCTACAATGAGCAGTTCTTC	CASSNRTSGDSYNEQFF	TRBV27	TRBJ2-1
TGTGCCAGCAGCTTAGATAGGACTAGGCCCTACAATGAGCAGTTCTTC	CASSLDRTRPYNEQFF	TRBV11-2	TRBJ2-1
TGTGCCAGCAAATTGAGGGGCTCTGGAAACACCATATATTTT	CASKLRGSGNTIYF	TRBV12-3	TRBJ1-3
TGTGCCAGCAGTTTAGCGGCCGCCTACGAGCAGTACTTC	CASSLAAAYEQYF	TRBV12-3	TRBJ2-7
TGTGCCAGCAGCCGGCAGTCCAGGGACAGGGGAGACTACGAGCAGTACTTC	CASSRQSRDRGDYEQYF	TRBV5-8	TRBJ2-7
TGTGCCAGCACGGGACTAGCTTCTGGGGCCAACGTCCTGACTTTC	CASTGLASGANVLTF	TRBV28	TRBJ2-6
TGTGCCAGCAGCCCGGGGTGTGTTAATACGCAGTATTTT	CASSPGCVNTQYF	TRBV7-4	TRBJ2-3
TGTGCCAGCACTGACAGGGGGCTGGGCTATGGCTACACCTTC	CASTDRGLGYGYTF	TRBV7-8	TRBJ1-2
TGTGCCAGCAGTCCGAGTCATGGCTACACCTTC	CASSPSHGYTF	TRBV12-4	TRBJ1-2
TGCGCCACGGGACAGGGCACGTATATTGACACCTATGGCTACACCTTC	CATGQGTYIDTYGYTF	TRBV5-1	TRBJ1-2
TGTGCCAGCAGCCAAGATGGACAGGGATACACCGGGGAGCTGTTTTTT	CASSQDGQGYTGELFF	TRBV4-2	TRBJ2-2
TGTGCCAGCAGCGTCCGGACAGGGGAACATCAGCCCCAGCATTTT	CASSVRTGEHQPQHF	TRBV11-3	TRBJ1-5
TGTGCCAGCAAATCGGTAGAACCCGAGCAGTACTTC	CASKSVEPEQYF	TRBV6-5	TRBJ2-7
TGTGCCAGCAACAGTTACACGGGACAGGGCAATCAGCCCCAGCATTTT	CASNSYTGQGNQPQHF	TRBV7-2	TRBJ1-5
TGCGCCAGCTGGGGGGGTGACACTGAAGCTTTCTTT	CASWGGDTEAFF	TRBV10-1	TRBJ1-1
TGTGCCAGCAGCCCGTTGGACAATAATGAAAAACTGTTTTTT	CASSPLDNNEKLFF	TRBV28	TRBJ1-4
TGTGCCAGCTCACCAGGGTGGGGGGGATTTAATGAAAAACTGTTTTTT	CASSPGWGGFNEKLFF	TRBV18	TRBJ1-4
TGTGCCAGCAGTGCCCCCAGGAGTCAGCCCCAGCATTTT	CASSAPRSQPQHF	TRBV2	TRBJ1-5
TGTGCCAGCAGACGGGACAGTGGGGCCGAGCAGTTCTTC	CASRRDSGAEQFF	TRBV6-4	TRBJ2-1
TGTGCCAGCAGACCAGGGGCGCACTATGGCTACACCTTC	CASRPGAHYGYTF	TRBV14	TRBJ1-2
TGTGCCAAATGCCCACAGGACGGTGGCTCTGGGGCCAACGTCCTGACTTTC	CAKCPQDGGSGANVLTF	TRBV4-2	TRBJ2-6
TGTGCCAGCCTGTCATGTGGCTACACCTTC	CASLSCGYTF	TRBV7-3	TRBJ1-2
TGCAGTGCCGTAGCTACAGGGAGTAGTATAACTAGCACAGATACGCAGTATTTT	CSAVATGSSITSTDTQYF	TRBV20-1	TRBJ2-3
TGTGCCAGCAGTTACTCGCATAGTGGGCTGATCATTCAGTACTTC	CASSYSHSGLIIQYF	TRBV6-5	TRBJ2-4
TGTGCCAGCAGGGGACTGCCCGGGGAGCAGTACTTC	CASRGLPGEQYF	TRBV2	TRBJ2-7
TGTGCGGACAGGGGGCTGCTTAACTATGGCTACACCTTC	CADRGLLNYGYTF	TRBV30	TRBJ1-2
TGTGCCAGCAGTTTACTTTCCTTGCCTAGTGGAGAAGAGACCCAGTACTTC	CASSLLSLPSGEETQYF	TRBV27	TRBJ2-5
TGTGCCAGCAGCTTCCCCAAAACAGGGGATAGGAATAGCAATCAGCCCCAGCATTTT	CASSFPKTGDRNSNQPQHF	TRBV7-3	TRBJ1-5
TGTGCCAGCAGCTTAGCGTGGCTAATGACAGTCACGAACACTGAAGCTTTCTTT	CASSLAWLMTVTNTEAFF	TRBV7-2	TRBJ1-1
TGTGCCAGCAGTGATCAAAAGACTGCACTCGATACGCAGTATTTT	CASSDQKTALDTQYF	TRBV6-1	TRBJ2-3
TGTGCCAGCAGCTTGGTTCAGGGGATGCAGTACTTC	CASSLVQGMQYF	TRBV5-4	TRBJ2-7
TGTGCCAGTAGTATTAGGGGCTACGAGCAGTACTTC	CASSIRGYEQYF	TRBV19	TRBJ2-7
TGCAGTCACGAGGGGGGGGGTAATCAGCCCCAGCATTTT	CSHEGGGNQPQHF	TRBV20-1	TRBJ1-5
TGCGCCAGCAGCTTGACAGGGGCACAGATCTTT	CASSLTGAQIF	TRBV5-1	TRBJ1-1
TGCAGTGCGGCGGGAGATACGCAGTATTTT	CSAAGDTQYF	TRBV20-1	TRBJ2-3
TGTGCCATCAGTGAGTCGTGCACAGCCCGGGAATTATTTGGCGAGCAGTACTTC	CAISESCTARELFGEQYF	TRBV10-3	TRBJ2-7
TGTGCCACCAGTGATGGACGAGGGAACGGGGAAAAACTGTTTTTT	CATSDGRGNGEKLFF	TRBV24-1	TRBJ1-4
TGTGCCAGCAGCTTCCCACTAGCGGGAGTACCTACACGCGGCCAAGAGACCCAGTACTTC	CASSFPLAGVPTRGQETQYF	TRBV7-4	TRBJ2-5
TGTGCCAGCAGCCCCCACCGGACAGCAACTAATGAAAAACTGTTTTTT	CASSPHRTATNEKLFF	TRBV7-3	TRBJ1-4
TGCAGTGCTAGGACAGTCTATGGCTACACCTTC	CSARTVYGYTF	TRBV20-1	TRBJ1-2
TGTGCCAGCGGGAAACAGGGGAAGTTGGGGAGCTACGAGCAGTACTTC	CASGKQGKLGSYEQYF	TRBV9	TRBJ2-7
TGTGCCAGCAGCGGTGGGGACAGGGCGGCCTATAATTCACCCCTCCACTTT	CASSGGDRAAYNSPLHF	TRBV7-3	TRBJ1-6
TGTGCCAGCAGTGACTGTGAGGCTGGGCCCGAGTACGAGCAGTACTTC	CASSDCEAGPEYEQYF	TRBV6-4	TRBJ2-7
TGTGCCAGCAGCCTCAGCTGTCCGGTTAGCTCCTACGAGCAGTACTTC	CASSLSCPVSSYEQYF	TRBV7-3	TRBJ2-7
TGCGCCAGCAGCGTAGGACGTGAGCGCCCGCGCTATGGCTACACCTTC	CASSVGRERPRYGYTF	TRBV5-1	TRBJ1-2
TGTGCCAGCAGCACTCTCCCTGTGGACAGAAGAAAACTCCAAGAGACCCAGTACTTC	CASSTLPVDRRKLQETQYF	TRBV7-3	TRBJ2-5
TGTGCCAGCAGCTTGGCCTATGGCCATAGGGGGGCAGGCAACACTGAAGCTTTCTTT	CASSLAYGHRGAGNTEAFF	TRBV5-6	TRBJ1-1
TGTGCCACCAGCAGTAAGGCTATAACTAATGAAAAACTGTTTTTT	CATSSKAITNEKLFF	TRBV15	TRBJ1-4
TGTGCCAGCAGCTTAATACAACTGGAACGGGACGAATGCACAGATACGCAGTATTTT	CASSLIQLERDECTDTQYF	TRBV7-3	TRBJ2-3
TGCGCCAGCAGCTTGGCGCGGGGATCCTACGAGCAGTACTTC	CASSLARGSYEQYF	TRBV5-1	TRBJ2-7
TGTGCCAGCAGTGAGTCGCGCCCAGGGAGCCACGGGCGGGCCTACGAGCAGTACTTC	CASSESRPGSHGRAYEQYF	TRBV6-4	TRBJ2-7
TGTGCCAGCAGGCAATCCCTGGGACTAGGCACAGATACGCAGTATTTT	CASRQSLGLGTDTQYF	TRBV6-6	TRBJ2-3
TGTGCCAGTAGTATACTAGGACAGGGGGGTCATCAGCCCCAGCATTTT	CASSILGQGGHQPQHF	TRBV19	TRBJ1-5
TGTGCCAGCAGCTTGCCAAAGTTAGAGAGCTACGAGCAGTACTTC	CASSLPKLESYEQYF	TRBV5-4	TRBJ2-7
TGCGCCAGGCAGGCAGGGGGATCGAACACTGAAGCTTTCTTT	CARQAGGSNTEAFF	TRBV10-1	TRBJ1-1
TGTGCCAGCAGCCTGACCATAGCGGGGCCCGCCAAAAACATTCAGTACTTC	CASSLTIAGPAKNIQYF	TRBV3-1	TRBJ2-4
TGCGCCAGCAGCTTGCTGGTAGCGGGTCGCACAGATACGCAGTATTTT	CASSLLVAGRTDTQYF	TRBV5-1	TRBJ2-3
TGTGCCAGTAGTAGGGGTAGGAGTCAGGGGCGCTACTACGAGCAGTACTTC	CASSRGRSQGRYYEQYF	TRBV19	TRBJ2-7
TGTGCCAGCAGCTTCCGTACCCGGGGAGGGGGCTATGGCTACACCTTC	CASSFRTRGGGYGYTF	TRBV5-6	TRBJ1-2
TGTGCCAGCAGCTCCTTACTAGCGGGAGCTCGGTGGAACACCGGGGAGCTGTTTTTT	CASSSLLAGARWNTGELFF	TRBV5-4	TRBJ2-2
TGTGCCAGCACACCAGGTACCCGGGACAGGGAGGGCATTGAACGGTATGGCTACACCTTC	CASTPGTRDREGIERYGYTF	TRBV27	TRBJ1-2
TGTGCCAGCAGTTACTCGGAGCAGGGTCTGAATCAGCCCCAGCATTTT	CASSYSEQGLNQPQHF	TRBV6-6	TRBJ1-5
TGTGCCAGCAGCGACAGGGGGCTTAGCTACGAGCAGTACTTC	CASSDRGLSYEQYF	TRBV13	TRBJ2-7
TGCGCCAGCAGCCAAGATGTGGTTCCCGCCGGGACAGGGCTTTGGATGAACACTGAAGCTTTCTTT	CASSQDVVPAGTGLWMNTEAFF	TRBV4-1	TRBJ1-1
TGTGCCAGCTCACCACATGGGGGGGGGGTTAGGTGGGTCGAGCAGTACTTC	CASSPHGGGVRWVEQYF	TRBV18	TRBJ2-7
TGTGCCAGCAGTGAAGGACTTTTACGTAACAATGAGCAGTTCTTC	CASSEGLLRNNEQFF	TRBV6-1	TRBJ2-1
TGTGCCAGCAGCGACCGAAACACTGAAGCTTTCTTT	CASSDRNTEAFF	TRBV13	TRBJ1-1
TGTGCCAGCAGGATTGGTCGGGTCAAGGATACGCAGTATTTT	CASRIGRVKDTQYF	TRBV7-9	TRBJ2-3
TGTGCCAGCACAAATACTTTTTCAGGGAAGGGGTCGCACGGAAACACCATATATTTT	CASTNTFSGKGSHGNTIYF	TRBV6-4	TRBJ1-3
TGTGCCAGCACCGCCGCCGGCTTCCCTACAGATACGCAGTATTTT	CASTAAGFPTDTQYF	TRBV6-5	TRBJ2-3
TGTGCCAGCAGAAGACTTTGGACGGGTGATGAGCAGTTCTTC	CASRRLWTGDEQFF	TRBV7-4	TRBJ2-1
TGTGCCAGCAGTTTGGCCTACGAGCAGTACTTC	CASSLAYEQYF	TRBV27	TRBJ2-7
TGCAGTGCTAAGGGACAGGGGGCGCCTCACTTGAACACTGAAGCTTTCTTT	CSAKGQGAPHLNTEAFF	TRBV20-1	TRBJ1-1
TGTGCCATCAGAAGCTGGGGCCTGGCCAATCAGCCCCAGCATTTT	CAIRSWGLANQPQHF	TRBV10-3	TRBJ1-5
TGTGCCAGCAACCCCAGGGTTGTAGAGACCCAGTACTTC	CASNPRVVETQYF	TRBV6-4	TRBJ2-5
TGTGCCAGCAGCCAGCGGACTAGATGGTCCGAGACCCAGTACTTC	CASSQRTRWSETQYF	TRBV3-1	TRBJ2-5
TGTGCCAGCTCCCGGACAGGGGGATATGGCTACACCTTC	CASSRTGGYGYTF	TRBV18	TRBJ1-2
TGTGCCCACCAGCCTAGGACAGGACTTCACTCTGAAGCTTTCTTT	CAHQPRTGLHSEAFF	TRBV7-9	TRBJ1-1
TGTGCCACCAGTGATTCGCCAGCACCCTCGCGCTATGGCTACACCTTC	CATSDSPAPSRYGYTF	TRBV24-1	TRBJ1-2
TGCGCCAGCAGTGGGGGGGGACCTAGGGGAAACACCATATATTTT	CASSGGGPRGNTIYF	TRBV10-1	TRBJ1-3
TGTGCCAGCAGCCTTAGACGAAACACCATATATTTT	CASSLRRNTIYF	TRBV12-4	TRBJ1-3
TGTGCCAGTAGTATAACAGGGGCCTACAATGAGCAGTTCTTC	CASSITGAYNEQFF	TRBV19	TRBJ2-1
TGTGCCAGCAGCGTAGGCCCAGGGACCCTTCATGGTGGCAATGAGCAGTTCTTC	CASSVGPGTLHGGNEQFF	TRBV9	TRBJ2-1
TGTGCCAGCAGTTTAGTACCCACCAAGACTATTAACAACTACGAGCAGTACTTC	CASSLVPTKTINNYEQYF	TRBV28	TRBJ2-7
TGTGCCAGCAGCGTCCAGGGGGCGCGGGATCAGCCCCAGCATTTT	CASSVQGARDQPQHF	TRBV9	TRBJ1-5
TGTGCCTGGAGTGTGAGTTCCAGGCAGGTCGGCCAGGTCGAGCAGTACTTC	CAWSVSSRQVGQVEQYF	TRBV30	TRBJ2-7
TGTGCCAGCAGCTTAAGACAGGGGACTGAAGCTTTCTTT	CASSLRQGTEAFF	TRBV13	TRBJ1-1
TGTGCTTCAAATAGCGGGAACAATGAGCAGTTCTTC	CASNSGNNEQFF	TRBV6-5	TRBJ2-1
TGTGCCAGCAGCTTTTGGGACAGGGCGGGAAACACCATATATTTT	CASSFWDRAGNTIYF	TRBV11-2	TRBJ1-3
TGTGCCACGGCCACTAGCGGGAGACCGAATCAGCCCCAGCATTTT	CATATSGRPNQPQHF	TRBV6-2	TRBJ1-5
TGTGCCAGCAGTTTCACGGGACTAGCGGGAGAACGAAATGAGCAGTTCTTC	CASSFTGLAGERNEQFF	TRBV27	TRBJ2-1
TGTGCCAGCAGCTGGTTACGAGAGGGCTACGAGCAGTACTTC	CASSWLREGYEQYF	TRBV7-8	TRBJ2-7
TGTGCCAGCAGTCCCTCCTTTCAGGGGCCTACTGAAGCTTTCTTT	CASSPSFQGPTEAFF	TRBV27	TRBJ1-1
TGTGCCAGCAGTGATATAGGTCGCGGGAAAGGCGAGCAGTACTTC	CASSDIGRGKGEQYF	TRBV25-1	TRBJ2-7
TGTGCCAGCAGGGCCCGAGTCTATAGCAATCAGCCCCAGCATTTT	CASRARVYSNQPQHF	TRBV6-5	TRBJ1-5
TGTGCCAGCAGTTCAGGGTACGAGACCCAGTACTTC	CASSSGYETQYF	TRBV6-3	TRBJ2-5
TGCGCCAGCAGTGAGCCCGCTAGCGGGGGCTCCTACGAGCAGTACTTC	CASSEPASGGSYEQYF	TRBV10-1	TRBJ2-7
TGTGCCAGCAGGGGACAGGGGGACACTGAAGCTTTCTTT	CASRGQGDTEAFF	TRBV7-4	TRBJ1-1
TGTGCCAGTAGTATAGTAATAGATAAGGTCTACGAGCAGTACTTC	CASSIVIDKVYEQYF	TRBV19	TRBJ2-7
TGTGCCAGCAGTCTCTTCTCTGGGGGGCGGTCCTACGAGCAGTACTTC	CASSLFSGGRSYEQYF	TRBV27	TRBJ2-7
TGTGCCAGCAGCTCCGACTTGGATGCCAAAAACATTCAGTACTTC	CASSSDLDAKNIQYF	TRBV5-4	TRBJ2-4
TGTGCCAGCAAGATGGGGGGGGGAAACGAGCAGTACTTC	CASKMGGGNEQYF	TRBV9	TRBJ2-7
TGTGCCAGCAGCTTAAGGGACTGGAACTATGGCTACACCTTC	CASSLRDWNYGYTF	TRBV7-3	TRBJ1-2
TGTGCCACCAGTGATTTGCCTAACACCCGGGGAGGAGCTTTCTTT	CATSDLPNTRGGAFF	TRBV24-1	TRBJ1-1
TGTGCCAGCAGCCAGCGGGAGGACCTGAACACTGAAGCTTTCTTT	CASSQREDLNTEAFF	TRBV7-9	TRBJ1-1
TGTGCCAGCAGGTACCGTCGGGTCCTGGAACCCTACGAGCAGTACTTC	CASRYRRVLEPYEQYF	TRBV12-3	TRBJ2-7
TGTGCCAGCAGCGGGCGTGAAGCTTTCTTT	CASSGREAFF	TRBV5-4	TRBJ1-1
TGTGCCAGCAGCCGGACTACCAAACACGAGCAGTACTTC	CASSRTTKHEQYF	TRBV13	TRBJ2-7
TGTGCCAGCAGCCTCCGACAGAACGGGAACGAGCAGTACTTC	CASSLRQNGNEQYF	TRBV13	TRBJ2-7
TGTGCCAGCTACGTCAATCGTAATCAGCCCCAGCATTTT	CASYVNRNQPQHF	TRBV11-3	TRBJ1-5
TGTGCCAGCAGCCTAAGAAAACATCTAGCGCAGTTCTTC	CASSLRKHLAQFF	TRBV5-4	TRBJ2-1
TGCGCCAGCAGTGAGACCTCGATGGGCCCCAGCTCCTACGAGCAGTACTTC	CASSETSMGPSSYEQYF	TRBV10-1	TRBJ2-7
TGTGCCACCAGGGCCAGAAAGACTAGGCTGGGTTTCTACGAGCAGTACTTC	CATRARKTRLGFYEQYF	TRBV24-1	TRBJ2-7
TGTGCCAGCAGCGAGCTGCTATACGGCTACGAGCAGTACTTC	CASSELLYGYEQYF	TRBV13	TRBJ2-7
TGTGCCAGCAGTTACTCGCTTACGACTAGTCCCTACGAGCAGTACTTC	CASSYSLTTSPYEQYF	TRBV6-5	TRBJ2-7
TGCGCCAGCAGCGACAGGGGGCAAGGCTACGAGCAGTACTTC	CASSDRGQGYEQYF	TRBV5-1	TRBJ2-7
TGCGCCAGCACCCCTTGTAATCCGGGTTATGGCTCCTACAATGAGCAGTTCTTC	CASTPCNPGYGSYNEQFF	TRBV5-1	TRBJ2-1
TGCGCCAGCAGCTTGCAAGGCTCAGGGAGGGTTAACTATGGCTACACCTTC	CASSLQGSGRVNYGYTF	TRBV5-1	TRBJ1-2
TGCAGTGCTTCCGGGACAGGTCATTCCTACGAGCAGTACTTC	CSASGTGHSYEQYF	TRBV20-1	TRBJ2-7
TGTGCCAGTCCCGAGGGTGGCTACACCTTC	CASPEGGYTF	TRBV19	TRBJ1-2
TGTGCCAGCAGCAAGGTAGCGGGTTCCTACAATGAGCAGTTCTTC	CASSKVAGSYNEQFF	TRBV13	TRBJ2-1
TGTGCCAGCAGCCAAGATCCCAATCTTCGGACAGAGTCCGTGGAAGTACAGCCCCAGCATTTT	CASSQDPNLRTESVEVQPQHF	TRBV14	TRBJ1-5
TGTGCCAGCATATACCCCTGGACAGTAGCCAAAAACATTCAGTACTTC	CASIYPWTVAKNIQYF	TRBV27	TRBJ2-4
TGCAGTGCTCTAGGTGTGATCCCGGGACAGGGCCGCCGTTATACGCAGTATTTT	CSALGVIPGQGRRYTQYF	TRBV20-1	TRBJ2-3
TGTGCCAGCAGCTGGACAGGGACCGCGGTTGCAGATACGCAGTATTTT	CASSWTGTAVADTQYF	TRBV13	TRBJ2-3
TGTGCCAGCTCACTTTCAGCCGGGACAGAGGGACCCTACGAGCAGTACTTC	CASSLSAGTEGPYEQYF	TRBV18	TRBJ2-7
TGTGCCAGCAGAAAGCTAGCGGACGCGGAGCAGTACTTC	CASRKLADAEQYF	TRBV14	TRBJ2-7
TGCAGCGCTCCGGGACTAGCAAGGAACACCGGGGAGCTGTTTTTT	CSAPGLARNTGELFF	TRBV29-1	TRBJ2-2
TGTGCCAGCAGCTTGAAGGGGGGGGGACGTGAGACCCAGTACTTC	CASSLKGGGRETQYF	TRBV5-5	TRBJ2-5
TGTGCCAGTAGTATAGATCCGACTAGCGGGCAGTACGAGCAGTACTTC	CASSIDPTSGQYEQYF	TRBV19	TRBJ2-7
TGTGCCAGCAGCGCCCAGTTCTACGAGCAGTACTTC	CASSAQFYEQYF	TRBV13	TRBJ2-7
TGTGCCAGCAGCGAGTCTAACCGGGGGACCGGGGAGCTGTTTTTT	CASSESNRGTGELFF	TRBV13	TRBJ2-2
TGTGCCAGCAGACAGGGGCCCCAAGAGACCCAGTACTTC	CASRQGPQETQYF	TRBV7-6	TRBJ2-5
TGTGCCAGCAGGAACAGCGGCCTCACAGATACGCAGTATTTT	CASRNSGLTDTQYF	TRBV6-5	TRBJ2-3
TGTGCCAGCAGCTTTAGCCGGGACAGCTACGAGCAGTACTTC	CASSFSRDSYEQYF	TRBV7-6	TRBJ2-7
TGTGCCAGCAGTTACCCCTTAAACGTAAAACCCCCGGGACTAGCGGGAGAAGAAGGTCCGGGAGAGACCCAGTACTTC	CASSYPLNVKPPGLAGEEGPGETQYF	TRBV6-3	TRBJ2-5
TGCGCCAGCAGCCAGGGACAGGGTCATGGAAACACCATATATTTT	CASSQGQGHGNTIYF	TRBV4-1	TRBJ1-3
TGCAGTGCTAGAGATATGGACCGGAACAAGTACAATGAGCAGTTCTTC	CSARDMDRNKYNEQFF	TRBV20-1	TRBJ2-1
TGTGCCAGCAGACAGGTAGGGGAGGCTAACCTGACAGGCTACGAGCAGTACTTC	CASRQVGEANLTGYEQYF	TRBV6-5	TRBJ2-7
TGTGCCAGCAGTGAACTATACCGGGGACAGGGCGGGGAGCTGTTTTTT	CASSELYRGQGGELFF	TRBV6-1	TRBJ2-2
TGTGCCAGCAGCTTACCGGCAGCCAATGAGCAGTTCTTC	CASSLPAANEQFF	TRBV7-9	TRBJ2-1
TGTGCCAGCAGCTTGGTCTCTTCGGAGGACCTTCAGCCCCAGCATTTT	CASSLVSSEDLQPQHF	TRBV5-6	TRBJ1-5
TGTGCCAGTAATCGACTAGCGAGCGAGCAGTACTTC	CASNRLASEQYF	TRBV19	TRBJ2-7
TGTGCCAGCAGCGACAGTCAGAGATATGGCTACACCTTC	CASSDSQRYGYTF	TRBV4-2	TRBJ1-2
TGTGCCAGTAGCCGGGGGGGAGGAGGTTCCTACGAGCAGTACTTC	CASSRGGGGSYEQYF	TRBV19	TRBJ2-7
TGTGCCAGCAGCACGGACAGCACAGATACGCAGTATTTT	CASSTDSTDTQYF	TRBV13	TRBJ2-3
TGCGCCAGCACTGGGGACAGGTCTGATGGCTACACCTTC	CASTGDRSDGYTF	TRBV10-1	TRBJ1-2
TGTGCCAGCAGCTCATTGGCTAGCGGGGGGGGGACGGCCTACGAGCAGTACTTC	CASSSLASGGGTAYEQYF	TRBV7-3	TRBJ2-7
TGTGCCAGCAGCGACGGACAGGACCTTACTGGAAACACCATATATTTT	CASSDGQDLTGNTIYF	TRBV7-3	TRBJ1-3
TGTGCCAGCAGTTACTCGAGGACTAGGCGTTGGAACACCGGGGAGCTGTTTTTT	CASSYSRTRRWNTGELFF	TRBV6-5	TRBJ2-2
TGTGCTAGCAGCTTAGCGCAAGATCGACTAGCGGTCCCGAGCACAGATACGCAGTATTTT	CASSLAQDRLAVPSTDTQYF	TRBV7-7	TRBJ2-3
TGTGCCTGGAGGGGAGGCGGGTCTGGGGCCAACGTCCTGACTTTC	CAWRGGGSGANVLTF	TRBV30	TRBJ2-6
TGTGCCAGCAGCGGGCGGGGCGACTATGGCTACACCTTC	CASSGRGDYGYTF	TRBV7-6	TRBJ1-2
TGTGCCAGCATCAGGAATGCGGTCGAGGCTACAGATACGCAGTATTTT	CASIRNAVEATDTQYF	TRBV25-1	TRBJ2-3
TGTGCCAGTAGTACCCTCCCTTTCTCCAAGCGACACACTGAAGCTTTCTTT	CASSTLPFSKRHTEAFF	TRBV19	TRBJ1-1
TGTGCCTGGAGTAGAGGACAGGGTTGCTTGAACACTGAAGCTTTCTTT	CAWSRGQGCLNTEAFF	TRBV30	TRBJ1-1
TGTGCCAGCAGTCAAGGTCCGGGACAAAGCAGACCCCGGGCCTATAATTCACCCCTCCACTTT	CASSQGPGQSRPRAYNSPLHF	TRBV28	TRBJ1-6
TGTGCCAGCAGCGTAGAGGTGTTGGACAGGGGGGGGAGCAATCAGCCCCAGCATTTT	CASSVEVLDRGGSNQPQHF	TRBV9	TRBJ1-5
TGCGCCAGCAGCCCAGGAGGATCCACACAGGGAGAGACCCAGTACTTC	CASSPGGSTQGETQYF	TRBV4-1	TRBJ2-5
TGCGCCAGCAGTAACAGGGTGTCTGGGGCCAACGTCCTGACTTTC	CASSNRVSGANVLTF	TRBV5-1	TRBJ2-6
TGTGCCAGCAGTGAATACAGGAGCGGGATAGGAGGTAGCAATCAGCCCCAGCATTTT	CASSEYRSGIGGSNQPQHF	TRBV6-1	TRBJ1-5
TGTGCCAGCAGCCAACCGGTGTCTGGAAACACCATATATTTT	CASSQPVSGNTIYF	TRBV7-4	TRBJ1-3
TGCGCCAGCAGCCAAGGGGGGGTTTGGGTCTACAATGAGCAGTTCTTC	CASSQGGVWVYNEQFF	TRBV4-1	TRBJ2-1
TGTGCCAGGCACACAGGGCTGGTCAGTGAAAAACTGTTTTTT	CARHTGLVSEKLFF	TRBV19	TRBJ1-4
TGTGCCAGCAGTGAGGTTTTAGAGCAGTACTTC	CASSEVLEQYF	TRBV6-6	TRBJ2-7
TGTGCCATCAGTGCCGGGACAGAGGATAGCAATCAGCCCCAGCATTTT	CAISAGTEDSNQPQHF	TRBV10-3	TRBJ1-5
TGTGCCAGCAGCGGGACCAGGGGTTGCTATGGCTACACCTTC	CASSGTRGCYGYTF	TRBV5-8	TRBJ1-2
TGTGCCAGCAGCGAAGGGAGACTAGCGGGCGTTAACACCGGGGAGCTGTTTTTT	CASSEGRLAGVNTGELFF	TRBV13	TRBJ2-2
TGTGGAGCCAGCTTTTGGGTCAAAAACATTCAGTACTTC	CGASFWVKNIQYF	TRBV3-1	TRBJ2-4
TGTGCCAGCAGTGTACTGTCGAAGCTTCGGGCTGGAAACACCATATATTTT	CASSVLSKLRAGNTIYF	TRBV6-4	TRBJ1-3
TGTGCCAGCAGCCCCCCCGGGGACATATCTGATAACTATGGCTACACCTTC	CASSPPGDISDNYGYTF	TRBV3-1	TRBJ1-2
TGTGCCAGCAGCTGGGCAGTGGTCTTAGAAGCTTTCTTT	CASSWAVVLEAFF	TRBV6-2	TRBJ1-1
TGTGCCAGCAGCCAGGATCAGTTAGAAGAGACCCAGTACTTC	CASSQDQLEETQYF	TRBV11-1	TRBJ2-5
TGTGCCAGCTGGGGAAAAAGGGTACAGCCCCAGCATTTT	CASWGKRVQPQHF	TRBV7-9	TRBJ1-5
TGTGCCAGCAGCGTAGCTACTCACTGGAAGCCCGACGGTAGAGAGACCCAGTACTTC	CASSVATHWKPDGRETQYF	TRBV9	TRBJ2-5
TGTGCCACCAGTGGGGCCGGTCACAATGAGCAGTTCTTC	CATSGAGHNEQFF	TRBV24-1	TRBJ2-1
TGCAGTGCTAGCAAGCATGGGACTGAAGCTTTCTTT	CSASKHGTEAFF	TRBV20-1	TRBJ1-1
TGTGCCAGCAGCTCCATCCCTGGGGGCGAGCAGTACTTC	CASSSIPGGEQYF	TRBV11-2	TRBJ2-7
TGTGCCAGCGGCAGGGGAGGTGGTCCCTCCTACGAGCAGTACTTC	CASGRGGGPSYEQYF	TRBV6-1	TRBJ2-7
TGTGCCAGCAGTTTCAGGGGCCGTAACCCAGATACGCAGTATTTT	CASSFRGRNPDTQYF	TRBV12-3	TRBJ2-3
TGTGCCAGCAGCAAAAACAGGGCTGGGAACTATGGCTACACCTTC	CASSKNRAGNYGYTF	TRBV13	TRBJ1-2
TGTGCCATCAGTGCGAGGGGGCTGCGGTTTGAGACCCAGTACTTC	CAISARGLRFETQYF	TRBV10-3	TRBJ2-5
TGTGCCACCAGTGATCCAACGAGGGCGAACACTGAAGCTTTCTTT	CATSDPTRANTEAFF	TRBV24-1	TRBJ1-1
TGTGCCAGCAGCAACTGGGTACTAGCGGGAGGACCTGGGGCCAACGTCCTGACTTTC	CASSNWVLAGGPGANVLTF	TRBV7-9	TRBJ2-6
TGTGCCAGCAGCTTAGGTATTCAGGCCTACGAGCAGTACTTC	CASSLGIQAYEQYF	TRBV7-6	TRBJ2-7
TGTGCCAGCAGTTACTCCCGGGCAGCTTTCTTT	CASSYSRAAFF	TRBV6-5	TRBJ1-1
TGCGCCAGCAGGCCGGAGGGCGAGTGTGCTGGAAACACCATATATTTT	CASRPEGECAGNTIYF	TRBV10-2	TRBJ1-3
TGTGCCAGCAGCTGCCATCTTTTCACTTCCGGTTCCGAGCAGTACTTC	CASSCHLFTSGSEQYF	TRBV13	TRBJ2-7
TGCGCCAGCAGCTACCCCCGTGGGAGCTCCGTAAATCAGCCCCAGCATTTT	CASSYPRGSSVNQPQHF	TRBV5-1	TRBJ1-5
TGTGCCAGCAGCTTAGAGCAGGTCGTAGCTAACTATGGCTACACCTTC	CASSLEQVVANYGYTF	TRBV7-9	TRBJ1-2
TGTGCCAGCAGTTCGGGAGTAGGGGCGAACACTGAAGCTTTCTTT	CASSSGVGANTEAFF	TRBV12-4	TRBJ1-1
TGTGCCTGGAGTGTACGAATAGGGATTACCTACAATGAGCAGTTCTTC	CAWSVRIGITYNEQFF	TRBV30	TRBJ2-1
TGTGCCAGCAGCTGCGGGGGCTGTGGCTACACCTTC	CASSCGGCGYTF	TRBV11-3	TRBJ1-2
TGTGCCAGCAGCCGGGCCAGCACAGATACGCAGTATTTT	CASSRASTDTQYF	TRBV7-4	TRBJ2-3
TGCGCCAGCAGTGATCAAGACAGGGCTCACTATGGCTACACCTTC	CASSDQDRAHYGYTF	TRBV10-1	TRBJ1-2
TGTGCCAGCTCACTAAAATGGGACAGGGAGATCCCCATGGAGTATCAGCCCCAGCATTTT	CASSLKWDREIPMEYQPQHF	TRBV18	TRBJ1-5
TGTGCCAGCAGCAAGCCCTCCGGGCATTACGTC	CASSKPSGHYV	TRBV13	TRBJ2-7
TGTGCCAGTCAAAGGAAGGCGCAAGAGACCCAGTACTTC	CASQRKAQETQYF	TRBV19	TRBJ2-5
TGTGCCAGCAGTGGGAAGTCTCAGCAGCGTGGCCAAGAGACCCAGTACTTC	CASSGKSQQRGQETQYF	TRBV7-8	TRBJ2-5
TGCAGTGCGGACACCAATTCACCCCTCCACTTT	CSADTNSPLHF	TRBV20-1	TRBJ1-6
TGCGCCATGGACAGGGGGTACTTC	CAMDRGYF	TRBV10-1	TRBJ2-7
TGTGCCACCATGGGGTCGGACAGGCAAAGGACCCAGTACTTC	CATMGSDRQRTQYF	TRBV24-1	TRBJ2-5
TGCGCCAGCAGCTCATACCGGGACCGTTTAAGGCCCTCCTACGAGCAGTACTTC	CASSSYRDRLRPSYEQYF	TRBV5-1	TRBJ2-7
TGCGCCAGCAGCCACCCTTGCCCGGGACTAGCGGGTAATGAGCAGTTCTTC	CASSHPCPGLAGNEQFF	TRBV4-1	TRBJ2-1
TGTGCCAGCAGTTATGAAGAGGAAGATAGCAATCAGCCCCAGCATTTT	CASSYEEEDSNQPQHF	TRBV12-3	TRBJ1-5
TGTGCCAGCAGGGGGGGGCCCTCTGGGGCCAACGTCCTGACTTTC	CASRGGPSGANVLTF	TRBV6-5	TRBJ2-6
TGCAGCGCAGTACTGGCGGAAACCGAGCAGTACTTC	CSAVLAETEQYF	TRBV29-1	TRBJ2-7
TGTGCCAGCAGCAGAGCCGGGACTAGATCGGGCACAGATACGCAGTATTTT	CASSRAGTRSGTDTQYF	TRBV7-4	TRBJ2-3
TGCGCCAGCAGGGGGGGGCCCAACAATGAGCAGTTCTTC	CASRGGPNNEQFF	TRBV4-3	TRBJ2-1
TGTGCCAGCAGTGACAGGGGGGGGAGGGGTAGGGCTAATGGTCAGCCCCAGCATTTT	CASSDRGGRGRANGQPQHF	TRBV6-4	TRBJ1-5
TGCGCCAGCAGCTGGGGGCACCAAGAGACCCAGTACTTC	CASSWGHQETQYF	TRBV5-1	TRBJ2-5
TGTGCCAGCACCGTCCCTAGGACTAGCGGGAGGAGATTCTACACCGGGGAGCTGTTTTTT	CASTVPRTSGRRFYTGELFF	TRBV6-6	TRBJ2-2
TGTGCCAGCAGTAGGCTACTAGTAAGCTCCTACGAGCAGTACTTC	CASSRLLVSSYEQYF	TRBV6-1	TRBJ2-7
TGTGCCAGCAGCTTCAGGGAGAACATTCAGTACTTC	CASSFRENIQYF	TRBV13	TRBJ2-4
TGTGCCAGCAGCTTAACAGGGCACTCTGGAAACACCATATATTTT	CASSLTGHSGNTIYF	TRBV7-4	TRBJ1-3
TGTGCCAGCAGCCAATTGGCGGACAGAGAAGACGAGCAGTACTTC	CASSQLADREDEQYF	TRBV14	TRBJ2-7
TGCGCCAGCAGCTCCCTTAAGGGACTATGGGCAGATACGCAGTATTTT	CASSSLKGLWADTQYF	TRBV5-1	TRBJ2-3
TGCAGTGCTAGAGATGCCCGGATTGCCGGGGAGCTGTTTTTT	CSARDARIAGELFF	TRBV20-1	TRBJ2-2
TGTGCCAGCAGTTGCTTGGGGCTTTCTGGCTACACCTTC	CASSCLGLSGYTF	TRBV6-5	TRBJ1-2
TGTGCCAGCAGTGATCGGACTATCTTCAGCTCCTACGAGCAGTACTTC	CASSDRTIFSSYEQYF	TRBV6-1	TRBJ2-7
TGTGCTAGTGGTTTGGTAGTGGGGATACAGGCACCATACTACGAGCAGTACTTC	CASGLVVGIQAPYYEQYF	TRBV12-5	TRBJ2-7
TGTGCCAGGCTGGGGGACAGGGTAAACTATGGCTACACCTTC	CARLGDRVNYGYTF	TRBV5-6	TRBJ1-2
TGTGCCACCAGTGATTCCCGGAGGGGTGAAAAACTGTTTTTT	CATSDSRRGEKLFF	TRBV24-1	TRBJ1-4
TGTGCTAGTGGTTTAAAGCTCCAATGGGCCCAAGTTTCTGGGACCCAGTACTTC	CASGLKLQWAQVSGTQYF	TRBV12-5	TRBJ2-5
TGCAGCGTTGAAGATACCGGGCGGAAGAAACTGTTTTTT	CSVEDTGRKKLFF	TRBV29-1	TRBJ1-4
TGCGCCAGCAGTGACTTCAGGGGACCCAACAATCAGCCCCAGCATTTT	CASSDFRGPNNQPQHF	TRBV10-1	TRBJ1-5
TGTGCCAGCAGCGGGGACGAAAAACTGTTTTTT	CASSGDEKLFF	TRBV9	TRBJ1-4
TGTGCCAGCAGCTCCCAGGGGGGGGGCCCGAATGAGCAGTTCTTC	CASSSQGGGPNEQFF	TRBV7-4	TRBJ2-1
TGTGCCAGCAGTTGCGTCCGGGAGGGGGGACACTCCCAGCCCCAGCATTTT	CASSCVREGGHSQPQHF	TRBV28	TRBJ1-5
TGCAGTGCTAGAGATGAGGGTGACATGTATGAAGGCTACACCTTC	CSARDEGDMYEGYTF	TRBV20-1	TRBJ1-2
TGTGCCAGCAAGGACAGGGGCATGCACTACGAGCAGTACTTC	CASKDRGMHYEQYF	TRBV6-5	TRBJ2-7
TGTGCCAGCAGCTGGGGGGGACACTCCTACGAGCAGTACTTC	CASSWGGHSYEQYF	TRBV5-5	TRBJ2-7
TGTGCCAGCAGCTATAGCGAGGACACTGAAGCTTTCTTT	CASSYSEDTEAFF	TRBV13	TRBJ1-1
TGCGCCAGCAGCTCCGGGAGGGAATCCTACGAGCAGTACTTC	CASSSGRESYEQYF	TRBV5-1	TRBJ2-7
TGCGCCAGCAGCCAAGAATCAGAAACAGGGACCTACGAGCAGTACTTC	CASSQESETGTYEQYF	TRBV4-1	TRBJ2-7
TGTGCCAGCAGTAGACTGGGGGGGGGGGGAGTCAATCAGCCCCAGCATTTT	CASSRLGGGGVNQPQHF	TRBV12-3	TRBJ1-5
TGCAGCAGTAAATCGATTCCAGGGTACTATGGCTACACCTTC	CSSKSIPGYYGYTF	TRBV29-1	TRBJ1-2
TGTGCCAGCAGCACCTCCCCGACAGCAACTAATGAAAAACTGTTTTTT	CASSTSPTATNEKLFF	TRBV28	TRBJ1-4
TGCAGTGCAAAGCCCCGGGACAGGGGGGTACTTGAAGCTTTCTTT	CSAKPRDRGVLEAFF	TRBV20-1	TRBJ1-1
TGTGCCAGCAGTGACTTGTCAAGGGGCACCGGGGAGCTGTTTTTT	CASSDLSRGTGELFF	TRBV2	TRBJ2-2
TGTGCCAGCATTAACCCCGCTCCGGAACTAGCGGTGGAGACCCAGTACTTC	CASINPAPELAVETQYF	TRBV12-3	TRBJ2-5
TGCGCCAGCAGCTTGTGTCTAGGGGAGTCGGGGTCGACGGCCTACGAGCAGTACTTC	CASSLCLGESGSTAYEQYF	TRBV5-1	TRBJ2-7
TGCAGCGACAGGACAGGGGATACCTACGAGCAGTACTTC	CSDRTGDTYEQYF	TRBV29-1	TRBJ2-7
TGTGCCAGCAGTGTCACCACGGGGACAGGGAAGGAAGAGTATAGCAATCAGCCCCAGCATTTT	CASSVTTGTGKEEYSNQPQHF	TRBV6-1	TRBJ1-5
TGTGCCAGCAGTTACACTAGCGGGAGTCCCGCGGGATATGGCTACACCTTC	CASSYTSGSPAGYGYTF	TRBV6-5	TRBJ1-2
TGCAGTCATACTAGGAGGGCCCGACCACTAGCGGGGTTGGCAGATACGCAGTATTTT	CSHTRRARPLAGLADTQYF	TRBV20-1	TRBJ2-3
TGTGCCAGATCCAATGAGCAGTTCTTC	CARSNEQFF	TRBV2	TRBJ2-1
TGTGCTAGTGGTTTCGTAGCCCGGGAAAAACTGTTTTTT	CASGFVAREKLFF	TRBV12-5	TRBJ1-4
TGTGCCAGCAGCCGACGACCCAATACGCAGTATTTT	CASSRRPNTQYF	TRBV13	TRBJ2-3
TGTGCCAGCAGCTTAAAAGTAGATGACAGGTTTTTAGGCGGAAACACCATATATTTT	CASSLKVDDRFLGGNTIYF	TRBV7-9	TRBJ1-3
TGTGCCAGTAGTATAGCCACGGTGGGAGATGAAAAACTGTTTTTT	CASSIATVGDEKLFF	TRBV19	TRBJ1-4
TGTGCCAGCAGCTTACTCGGGAGGGGCCCATTATACAATGAGCAGTTCTTC	CASSLLGRGPLYNEQFF	TRBV7-2	TRBJ2-1
TGCAGTGCTAGATCGACAGGTGTCTACCAGCCCCAGCATTTT	CSARSTGVYQPQHF	TRBV20-1	TRBJ1-5
TGTAGAGACAGGGGGCGGAGCAATCAGCCCCAGCATTTT	CRDRGRSNQPQHF	TRBV30	TRBJ1-5
TGTGCCAGCAGCTTGGAGACTAGCGGGACTATTAGCACAGATACGCAGTATTTT	CASSLETSGTISTDTQYF	TRBV5-6	TRBJ2-3
TGTGCCAGCAGCTTAGCCCCAGGGCGGTTAGGCAATCAGCCCCAGCATTTT	CASSLAPGRLGNQPQHF	TRBV7-2	TRBJ1-5
TGCAGCGTTGGACAGGGGTCAGATAGCAATCAGCCCCAGCATTTT	CSVGQGSDSNQPQHF	TRBV29-1	TRBJ1-5
TGTGCCACCAGTGATTCGGCTAGCGGGTATCCCTACGAGCAGTACTTC	CATSDSASGYPYEQYF	TRBV24-1	TRBJ2-7
TGCAGTGCTAGACTGAGCACGGTTTCCAGGATAATAACTGAAGCTTTCTTT	CSARLSTVSRIITEAFF	TRBV20-1	TRBJ1-1
TGTGCCAGCAGCATTGATCCGGGGACTTGCAGAGATGAGCAGTTCTTC	CASSIDPGTCRDEQFF	TRBV7-4	TRBJ2-1
TGTGCCAGCAGCGGTAGGGGGGACCGTCCGAGGCTAGCCAAAAACATTCAGTACTTC	CASSGRGDRPRLAKNIQYF	TRBV7-9	TRBJ2-4
TGTGCCAGCAGGGCTGATCTTTGGGACAGGGAGGACGAGACCCAGTACTTC	CASRADLWDREDETQYF	TRBV7-3	TRBJ2-5
TGTGCCAGCAGTCAAGCCCGCCTAGCGGGCCTCGAGCAGTTCTTC	CASSQARLAGLEQFF	TRBV25-1	TRBJ2-1
TGTGCCAGCAGCAGCCTAGGGGTGACCCAGTACTTC	CASSSLGVTQYF	TRBV7-3	TRBJ2-5
TGTGCCAGCACCCAGGGTGGAGAGCAGTACTTC	CASTQGGEQYF	TRBV3-1	TRBJ2-7
TGTGCCAGCAGTTTAAGTGTAGTAGACAGGGCCTACGAGCAGTACTTC	CASSLSVVDRAYEQYF	TRBV12-3	TRBJ2-7
TGTGCCAGCAGCCAAGCCCCGGGGACTAGCGGGTTCCGGGACAATGAGCAGTTCTTC	CASSQAPGTSGFRDNEQFF	TRBV4-2	TRBJ2-1
TGTGCCAGCAGCCCAACCGACTGGGGCGTCCGTTCTGAAGCTTTCTTT	CASSPTDWGVRSEAFF	TRBV7-3	TRBJ1-1
TGTGCCAGCGGCCCAAACCTCCACTTT	CASGPNLHF	TRBV7-3	TRBJ1-6
TGTGCCAGCTCACCAGGAACAGGGGATTCGGTGCACGAGCAGTACTTC	CASSPGTGDSVHEQYF	TRBV18	TRBJ2-7
TGTGCCAGCAGCTTAACAAACCGGCCTAGACAGGGGGGCGAGCAGTACTTC	CASSLTNRPRQGGEQYF	TRBV7-3	TRBJ2-7
TGCGCCCCAGGACAGGGGGATACGCAGTATTTT	CAPGQGDTQYF	TRBV10-1	TRBJ2-3
TGTGCCAGCAGCGGGGAGGATGAGCAGTTCTTC	CASSGEDEQFF	TRBV13	TRBJ2-1
TGCAGTGCTAGAGATGGTGAGGGGGCTGCGACCTACGAGCAGTACTTC	CSARDGEGAATYEQYF	TRBV20-1	TRBJ2-7
TGTGCCAGCGTCAAGTATCGGGGGGCCCAGTGTAGCTCTGGAAACACCATATATTTT	CASVKYRGAQCSSGNTIYF	TRBV6-5	TRBJ1-3
TGTGCCAGCAGCGGGGCCGGGACAGGGCAAGAGACCCAGTACTTC	CASSGAGTGQETQYF	TRBV7-9	TRBJ2-5
TGTGCCAGCAGCTTAAAAGAGAGGGACCTAGAAGCTTTCTTT	CASSLKERDLEAFF	TRBV11-2	TRBJ1-1
TGTGCCCCCAGAAGTCCCCCCGAACAGCGAACTCTAGTTAGCACAGATACGCAGTATTTT	CAPRSPPEQRTLVSTDTQYF	TRBV30	TRBJ2-3
TGTGCCTGGAGTGCTAGCTACGAGCAGTACTTC	CAWSASYEQYF	TRBV30	TRBJ2-7
TGTGCCACCACGACCCATACAGGGAAGGCCAACGTCCTGACTTTC	CATTTHTGKANVLTF	TRBV24-1	TRBJ2-6
TGTGCCAGCAGCCATCCCTCCCGGGGGCGGCGCAATCAGCCCCAGCATTTT	CASSHPSRGRRNQPQHF	TRBV4-2	TRBJ1-5
TGCGCCAGCAGCCAGGGGGCAGGAATTAAAGAGACCCAGTACTTC	CASSQGAGIKETQYF	TRBV5-1	TRBJ2-5
TGTGCCAGTAGTATAGCCCCTAGCGAGGACAATGAGCAGTTCTTC	CASSIAPSEDNEQFF	TRBV19	TRBJ2-1
TGTGCCAGCAGTTACTCGAGGGTTTCGGACAGTCTCGTGTTTAATGAAAAACTGTTTTTT	CASSYSRVSDSLVFNEKLFF	TRBV6-5	TRBJ1-4
TGTGCCACCAGTGACCCGGACAGGTATACCTTATCCACCTGGACTGAAGCTTTCTTT	CATSDPDRYTLSTWTEAFF	TRBV24-1	TRBJ1-1
TGTGCCAGCAGCATTTGCCGACAGACGGCCTACGAGCAGTACTTC	CASSICRQTAYEQYF	TRBV5-6	TRBJ2-7
TGTGCCAGTAGTATGGGGGGGAGGGGACACGAGCAGTACTTC	CASSMGGRGHEQYF	TRBV19	TRBJ2-7
TGCGCCAGCAGCCACAGGAGAGCGGGAGGCTCCTACGAGCAGTACTTC	CASSHRRAGGSYEQYF	TRBV4-3	TRBJ2-7
TGTGCCAGCAATAGAGGGGAGACCCAGTACTTC	CASNRGETQYF	TRBV28	TRBJ2-5
TGTGCCAGCAGTGGAACTAGCGGAAACAATGAGCAGTTCTTC	CASSGTSGNNEQFF	TRBV27	TRBJ2-1
TGTGCCAGCAGCCACCGGACAGGGGGCATATCCTACGAGCAGTACTTC	CASSHRTGGISYEQYF	TRBV11-3	TRBJ2-7
TGTGCCACCAGTGAGGGACTCTACGAGCAGTACTTC	CATSEGLYEQYF	TRBV24-1	TRBJ2-7
TGTGCCTCCAAGCGTTCACAGGGGTATGGCTACACCTTC	CASKRSQGYGYTF	TRBV28	TRBJ1-2
TGTGCCAACCACCTAACAGGGGGAGATGAGCAGTACTTC	CANHLTGGDEQYF	TRBV2	TRBJ2-7
TGTGCCAGCAGCCTTCGGACTGCCTACGAGCAGTACTTC	CASSLRTAYEQYF	TRBV7-3	TRBJ2-7
TGCAGCGTTGAAGATCTTGGGACCGGGCCTGACTACGAGCAGTACTTC	CSVEDLGTGPDYEQYF	TRBV29-1	TRBJ2-7
TGTGCCAGCAGCTTAATGCCGCAGCGGGGCCGAGCTTTCTTT	CASSLMPQRGRAFF	TRBV7-3	TRBJ1-1
TGTGCCAGTAGTATTCTCCGACTAGCGGGGGAAAACATTCAGTACTTC	CASSILRLAGENIQYF	TRBV19	TRBJ2-4
TGTGCTAGTGGTTCTCGCCGACAGCGGTCCTACGAGCAGTACTTC	CASGSRRQRSYEQYF	TRBV12-5	TRBJ2-7
TGCAGTGCTAGAGACCTCCACAGGCCACGAGGAAAAGGCAATCAGCCCCAGCATTTT	CSARDLHRPRGKGNQPQHF	TRBV20-1	TRBJ1-5
TGTGCCAGCTCACCAACAGTTCACAGGGGGCGCTCAGCTTTCTTT	CASSPTVHRGRSAFF	TRBV18	TRBJ1-1
TGTGCCAGCAGCGTCGGGGGGCACACTGAAGCTTTCTTT	CASSVGGHTEAFF	TRBV9	TRBJ1-1
TGTGCCACCAGTTTAAAAAGGGGGGTCTCCCGCAATGAGCAGTTCTTC	CATSLKRGVSRNEQFF	TRBV24-1	TRBJ2-1
TGTGCCAGCGCCGACAGGGCGGAAGGCTACACCTTC	CASADRAEGYTF	TRBV6-5	TRBJ1-2
TGTGCCAGCAGCAAGGACAGGGCCTACGAGCAGTACTTC	CASSKDRAYEQYF	TRBV7-4	TRBJ2-7
TGTGCCAGCAGTGACACTCAGCCCCAGCATTTT	CASSDTQPQHF	TRBV27	TRBJ1-5
TGTGCCAGCAGCTTAGGGGCCTACGAGCAGTACTTC	CASSLGAYEQYF	TRBV7-3	TRBJ2-7
TGTGCCAGCAGCTTGGGAGTATCAGGGAATGGCGGCAATCAGCCCCAGCATTTT	CASSLGVSGNGGNQPQHF	TRBV5-6	TRBJ1-5
TGTGCCAGCAGCCGGCACTCGTCGGCCGGGGAGCTGTTTTTT	CASSRHSSAGELFF	TRBV9	TRBJ2-2
TGTGCTAGTGAAGGGGGGCTCTCCTACGAGCAGTACTTC	CASEGGLSYEQYF	TRBV12-5	TRBJ2-7
TGTGCCAGCTCACCAGTTACTGCCGGGACAGGGCCGAATTCACCCCTCCACTTT	CASSPVTAGTGPNSPLHF	TRBV18	TRBJ1-6
TGTGCCAGCAGCTTGAGGGTACACAATGAGCAGTTCTTC	CASSLRVHNEQFF	TRBV5-8	TRBJ2-1
TGTGCCAGCCTCGCTCGACTAGCGGGGACGGACTGGAAAGAGACCCAGTACTTC	CASLARLAGTDWKETQYF	TRBV28	TRBJ2-5
TGTGCCAGCAGTGACCGGGGCTGGGACAGCTACGAGCAGTACTTC	CASSDRGWDSYEQYF	TRBV6-4	TRBJ2-7
TGTGCCAGCTCGAACCCCGGGACAGGGGGTAACACCGGGGAGCTGTTTTTT	CASSNPGTGGNTGELFF	TRBV9	TRBJ2-2
TGTGCCATTGGTGGGGGGGCTAACCCCTACGAGCAGTACTTC	CAIGGGANPYEQYF	TRBV6-4	TRBJ2-7
TGTGCCAGCAGCCAAGCAGAAGGTAATGAAAAACTGTTTTTT	CASSQAEGNEKLFF	TRBV3-1	TRBJ1-4
TGTGCCAGCAGTTTAGCGCAGCGGGGGTACTCGGCAGATACGCAGTATTTT	CASSLAQRGYSADTQYF	TRBV12-3	TRBJ2-3
TGTGCCACCGGGACGCGGGAGTACTCCTACGAGCAGTACTTC	CATGTREYSYEQYF	TRBV24-1	TRBJ2-7
TGTGCCAGACAGGGGTCCAATGGAAGGGCTTTCTTT	CARQGSNGRAFF	TRBV6-1	TRBJ1-1
TGCGCCAGCAGCCAAGAACTGTCAGAGCTAGCGGGGGGGCCAGAGTTCTTCAATGAGCAGTTCTTC	CASSQELSELAGGPEFFNEQFF	TRBV4-1	TRBJ2-1
TGTGCCAGCAGCCGGGAGGGTTTTCGGGGCTACGAGCAGTACTTC	CASSREGFRGYEQYF	TRBV3-1	TRBJ2-7
TGTGCCAGCAGCTATGGCAGGGGGCCGGTGAACACTGAAGCTTTCTTT	CASSYGRGPVNTEAFF	TRBV7-9	TRBJ1-1
TGTGCCATTGACGACGGTAAGGTGCATAGTTATTCACCCCTCCACTTT	CAIDDGKVHSYSPLHF	TRBV12-3	TRBJ1-6
TGCGCCAGCAGTGAAACCGGGACATCCTACGAGCAGTACTTC	CASSETGTSYEQYF	TRBV10-1	TRBJ2-7
TGTGCCAGCAGCCAAGAGGAGGGCGGAGGGGGCGACGAGCAGTACTTC	CASSQEEGGGGDEQYF	TRBV14	TRBJ2-7
TGTGCCAGCCAGGACGGGGAGGAAAAACTGTTTTTT	CASQDGEEKLFF	TRBV27	TRBJ1-4
TGCAGTGCTAGAGATGCCAGGATGGGCTACACCTTC	CSARDARMGYTF	TRBV20-1	TRBJ1-2
TGTGCCAGCCCCGCGGGGGCGAAAGAGCAGTACTTC	CASPAGAKEQYF	TRBV7-8	TRBJ2-7
TGTGCCAGCAGTTACTCCGGACCATCCTACAATGAGCAGTTCTTC	CASSYSGPSYNEQFF	TRBV6-6	TRBJ2-1
TGTGCCAGCAGTTTGGGGAGGAAATGCTATGGCTACACCTTC	CASSLGRKCYGYTF	TRBV6-3	TRBJ1-2
TGCGCCAGCAGCAACAGGGGGGAGCAGTACTTC	CASSNRGEQYF	TRBV5-1	TRBJ2-7
TGTGCCAGCAGCCTAGCGGGCTACAATGAGCAGTTCTTC	CASSLAGYNEQFF	TRBV13	TRBJ2-1
TGCGCCAGCAGCACTCGGACGGGACGGAGAAGATTCGGGGAGCTGTTTTTT	CASSTRTGRRRFGELFF	TRBV5-1	TRBJ2-2
TGTGCCAGCAGCTTATACAGGGCCAACTACGAGCAGTACTTC	CASSLYRANYEQYF	TRBV7-9	TRBJ2-7
TGTGCTAGTGCCGGGACAGCCGTGAACACTGAAGCTTTCTTT	CASAGTAVNTEAFF	TRBV12-5	TRBJ1-1
TGTGCCAGCAGTTACAAAAATACTGGCTACGAGCAGTACTTC	CASSYKNTGYEQYF	TRBV6-5	TRBJ2-7
TGCGCCAGCAGCTTGGTGACAGGGGCATTAGACGGCAATCAGCCCCAGCATTTT	CASSLVTGALDGNQPQHF	TRBV5-1	TRBJ1-5
TGTGCCAGCAGCCCGAACAGGGAATGTGGCTACACCTTC	CASSPNRECGYTF	TRBV5-6	TRBJ1-2
TGTGCCAGTTGGACAGGGGCGCCCCAGCCCCAGCATTTT	CASWTGAPQPQHF	TRBV2	TRBJ1-5
TGTGCCAGCAGTTTATCCGCAAGGCATACGCAGTATTTT	CASSLSARHTQYF	TRBV27	TRBJ2-3
TGTGCCAGCAGTTACGGATCCCCTAGCCCGGAGTTCGAGCAGTACTTC	CASSYGSPSPEFEQYF	TRBV6-5	TRBJ2-7
TGCATCGCTTGTCCGTTTAATCAGCCCCAGCATTTT	CIACPFNQPQHF	TRBV20-1	TRBJ1-5
TGTGCCAGCAGCGTTCTGAGGACAGGGAGCTCCTACGAGCAGTACTTC	CASSVLRTGSSYEQYF	TRBV7-2	TRBJ2-7
TGTGCCAGCAGAACAGACGTGGCGAACACTGAAGCTTTCTTT	CASRTDVANTEAFF	TRBV6-1	TRBJ1-1
TGTGCCAGCAGCTTACCCCCCCCGAGGAGGCGCTATGGCTACACCTTC	CASSLPPPRRRYGYTF	TRBV11-2	TRBJ1-2
TGTGCCAGCAGTAAGGGGTCTTTCGATCAGCCCCAGCATTTT	CASSKGSFDQPQHF	TRBV6-5	TRBJ1-5
TGTGCCAGCAGCGGAGTGGGCACAGATACGCAGTATTTT	CASSGVGTDTQYF	TRBV7-3	TRBJ2-3
TGTGCCAGCAGTAATCGGACCACAGATACGCAGTATTTT	CASSNRTTDTQYF	TRBV7-8	TRBJ2-3
TGTGCCAGCAGCAAGGGACTAGCGGGAGACTCTGGGGCCAACGTCCTGACTTTC	CASSKGLAGDSGANVLTF	TRBV7-2	TRBJ2-6
TGTGCCAGCAGTGACGATAACAGGGGACCTGAAAAACTGTTTTTT	CASSDDNRGPEKLFF	TRBV6-4	TRBJ1-4
TGTGCCAGCAGCTTAGCCCCTAGCGGGTTGCATTCCAAAAACATTCAGTACTTC	CASSLAPSGLHSKNIQYF	TRBV7-9	TRBJ2-4
TGTGCCATCAGGGGACTAGGGGGCTACAATGAGCAGTTCTTC	CAIRGLGGYNEQFF	TRBV10-3	TRBJ2-1
TGTGCCAGCAGCCTTCCTCCGGGGGGGGGGAGGAGGAGGAGGGCCAAAAACATTCAGTACTTC	CASSLPPGGGRRRRAKNIQYF	TRBV7-2	TRBJ2-4
TGCAGTGCTACCACAGGGACAGGGGTCTACAATGAGCAGTTCTTC	CSATTGTGVYNEQFF	TRBV20-1	TRBJ2-1
TGTGCCAGCAGCTTGCTCTGGACAGGGGAGGACATTGAAAAACTGTTTTTT	CASSLLWTGEDIEKLFF	TRBV7-7	TRBJ1-4
TGTGCCACCCTCCGGACAGGGGAAAAGAACACTGAAGCTTTCTTT	CATLRTGEKNTEAFF	TRBV24-1	TRBJ1-1
TGTGCCAGCAGCGTAGCCCCACGACGGGACACCGGGGAGCTGTTTTTT	CASSVAPRRDTGELFF	TRBV9	TRBJ2-2
TGTGCCAGCAGTTTATTCCGTTTACTAGCGGGAGGCAGGGACACCGGGGAGCTGTTTTTT	CASSLFRLLAGGRDTGELFF	TRBV27	TRBJ2-2
TGCAGTGCTGGGGCCAGGTCCACTGAAGCTTTCTTT	CSAGARSTEAFF	TRBV20-1	TRBJ1-1
TGTGCCAGCAGCCAAGGGGGTGGCACCTTC	CASSQGGGTF	TRBV14	TRBJ1-2
TGCGCCACATCTAGCGGGAAGGACGAGCAGTACTTC	CATSSGKDEQYF	TRBV4-3	TRBJ2-7
TGCAGTGCTAGAGATCGGTGGAGGAGGGGGACAGGGTTGAGCACAGATACGCAGTATTTT	CSARDRWRRGTGLSTDTQYF	TRBV20-1	TRBJ2-3
TGTGCCAGCACACCGGGGGGTAGCTCTCTCGAGCAGTACTTC	CASTPGGSSLEQYF	TRBV6-4	TRBJ2-7
TGTGCCGGGCCGAGCACCGGGGACAGAATCTACGAGCAGTACTTC	CAGPSTGDRIYEQYF	TRBV10-3	TRBJ2-7
TGTGCCAGCAGCGGGGCACGCTATGGCTACACCTTC	CASSGARYGYTF	TRBV7-4	TRBJ1-2
TGTGCCGGGGTCATGGCTTATCAAAGGGGAAGACCCGAGCAGTACTTC	CAGVMAYQRGRPEQYF	TRBV2	TRBJ2-7
TGTGCCAGCAGCTTAGATGAAGCCAGGGGAAATTCACCCCTCCACTTT	CASSLDEARGNSPLHF	TRBV11-2	TRBJ1-6
TGTGCCAGCAGCTTAGTCTTAGACAGTAGCAATCAGCCCCAGCATTTT	CASSLVLDSSNQPQHF	TRBV7-9	TRBJ1-5
TGTGCCAGCAGCTTATTTCGGGCGGGAGGACACGAGCAGTACTTC	CASSLFRAGGHEQYF	TRBV5-8	TRBJ2-7
TGTGCCAGCAGCCAAGGTTCCCCGACAAGCAATCAGCCCCAGCATTTT	CASSQGSPTSNQPQHF	TRBV14	TRBJ1-5
TGTGCCAGCAGCAACGGTTGTTCAGGGTTGGGCTATGGCTACACCTTC	CASSNGCSGLGYGYTF	TRBV7-9	TRBJ1-2
TGCGCCTACGGTACCGGCACTCCTAGCACAGATACGCAGTATTTT	CAYGTGTPSTDTQYF	TRBV5-1	TRBJ2-3
TGCGCCAGCAGGGGGTCTCCCGGGGGACACTATGGCTACACCTTC	CASRGSPGGHYGYTF	TRBV10-1	TRBJ1-2
TGTGCCACCACGGAGACTTTGGAAAACACCGGGGAGCTGTTTTTT	CATTETLENTGELFF	TRBV24-1	TRBJ2-2
TGTGCCAGCAGCGGGACAGGAGGCTATGGCTACACCTTC	CASSGTGGYGYTF	TRBV7-9	TRBJ1-2
TGTGCCAGCAGCCACGTGACCCGCTGGAGGGGGGGGCTAGAGCAGTACTTC	CASSHVTRWRGGLEQYF	TRBV14	TRBJ2-7
TGCGCCAGCCTTCGAGATGGCAGCAATCAGCCCCAGCATTTT	CASLRDGSNQPQHF	TRBV5-1	TRBJ1-5
TGTGCCAGCGCGGGGAATTACGAGCAGTACTTC	CASAGNYEQYF	TRBV3-1	TRBJ2-7
TGTGCCAGCAGAATGGGGGCTCTGAACACTGAAGCTTTCTTT	CASRMGALNTEAFF	TRBV28	TRBJ1-1
TGCAGTGCAAGGCAGGGTTATGCAACTAATGAAAAACTGTTTTTT	CSARQGYATNEKLFF	TRBV20-1	TRBJ1-4
TGTGCCAGCAGGACAGACCAGGCCTCTTCTAGCACAGATACGCAGTATTTT	CASRTDQASSSTDTQYF	TRBV7-2	TRBJ2-3
TGTGCCAGCAGTGGACAGGGGTCCTACGAGCAGTACTTC	CASSGQGSYEQYF	TRBV27	TRBJ2-7
TGTGCCAGCAGCTTAACAGGCTACACCTTC	CASSLTGYTF	TRBV11-3	TRBJ1-2
TGTGCCAGCACCATCCGTTGGTACTGGGGTGGCTACACCTTC	CASTIRWYWGGYTF	TRBV7-9	TRBJ1-2
TGTGCCACCAGCAAGGTACTCAGGGCTAACACTGAAGCTTTCTTT	CATSKVLRANTEAFF	TRBV15	TRBJ1-1
TGCAGTACAGGGCTGCGAGATGGCTACACCTTC	CSTGLRDGYTF	TRBV20-1	TRBJ1-2
TGTGCCAGCAGAGAACCAGAAGCTTTCTTT	CASREPEAFF	TRBV14	TRBJ1-1
TGCAGTGCTTATGGTCAGTTTGGGGGGGGGAACACCGGGGAGCTGTTTTTT	CSAYGQFGGGNTGELFF	TRBV20-1	TRBJ2-2
TGTGCCAGCAGGTCCCGGGCCGGGACTAGCGGGAGAGACTACAATGAGCAGTTCTTC	CASRSRAGTSGRDYNEQFF	TRBV6-5	TRBJ2-1
TGTGCCAGCACACGTTTTAGGGCCCTACCCTCTGAAGCTTTCTTT	CASTRFRALPSEAFF	TRBV12-4	TRBJ1-1
TGTGCCAGCAGCCAAGATCGGGGACAGGGAGCTTTCTTT	CASSQDRGQGAFF	TRBV3-1	TRBJ1-1
TGTGCCAGCAGCGGTCTCGGGGAACCAGGGGGCTGCAACTATGGCTACACCTTC	CASSGLGEPGGCNYGYTF	TRBV9	TRBJ1-2
TGTGCCAGCCAGACCGATGTAGCGGAAGACACAGATACGCAGTATTTT	CASQTDVAEDTDTQYF	TRBV27	TRBJ2-3
TGTGCCATGACAGGGGCTTCTGAAGCTTTCTTT	CAMTGASEAFF	TRBV19	TRBJ1-1
TGCGCCAGCAGCCAAGTGACCCCCGGGACGGCTGGCTCCTACGAGCAGTACTTC	CASSQVTPGTAGSYEQYF	TRBV4-3	TRBJ2-7
TGTGCCAGCAGTAATAAACTACCCGTTTCGAACACCGGGGAGCTGTTTTTT	CASSNKLPVSNTGELFF	TRBV12-3	TRBJ2-2
TGTGCCAGCAGCAAGACAGGTAAGGTCTTC	CASSKTGKVF	TRBV6-1	TRBJ2-1
TGTGCCAGCAGCGCCCCCAGGGGGCAGCGATTAGCCAAAAACATTCAGTACTTC	CASSAPRGQRLAKNIQYF	TRBV9	TRBJ2-4
TGTGCCAGCAGGCTTTGCCCACTAGCGGGAGTGGCCTCCTACAATGAGCAGTTCTTC	CASRLCPLAGVASYNEQFF	TRBV27	TRBJ2-1
TGTGCCTGGAGTGTATTAGAAGGCACAGATACGCAGTATTTT	CAWSVLEGTDTQYF	TRBV30	TRBJ2-3
TGTGCCTGGAGCGGTCTGGGACAGGATAGCAATCAGCCCCAGCATTTT	CAWSGLGQDSNQPQHF	TRBV30	TRBJ1-5
TGTGCCAGCAGTTACCCCGACAGGAAAGCTAACTATGGCTACACCTTC	CASSYPDRKANYGYTF	TRBV6-5	TRBJ1-2
TGCGCCAGCAGCGACAGCGGGAAGTATAACTATGGCTACACCTTC	CASSDSGKYNYGYTF	TRBV5-1	TRBJ1-2
TGTGCCAGCAGATTTGCAGGGGCCTACGAGCAGTACTTC	CASRFAGAYEQYF	TRBV7-3	TRBJ2-7
TGTGCCAGCACCTGGGCAATGTATGGCTACACCTTC	CASTWAMYGYTF	TRBV7-9	TRBJ1-2
TGTGCCAGCAGCTTAGTTGGGGGGGCCATCGAGCAGTACTTC	CASSLVGGAIEQYF	TRBV7-4	TRBJ2-7
TGTGCCTGGATTTTACTCTCGGGAGGGGCTGATACGCAGTATTTT	CAWILLSGGADTQYF	TRBV30	TRBJ2-3
TGCAGTGCTAGAGATGATCCAATCCGACAGAACACTGAAGCTTTCTTT	CSARDDPIRQNTEAFF	TRBV20-1	TRBJ1-1
TGTGCCACCAGTGATGGCCCGACAGCTACGTACGAGCAGTACTTC	CATSDGPTATYEQYF	TRBV24-1	TRBJ2-7
TGCAGTGCTAGCAGCGTCCCCGCTAATGAAAAACTGTTTTTT	CSASSVPANEKLFF	TRBV20-1	TRBJ1-4
TGTGCCTGGAGTGCTGAGGGGCGCGGAAACACCATATATTTT	CAWSAEGRGNTIYF	TRBV30	TRBJ1-3
TGTGCCAGCAGCAATCGGCCCCCAAAACTGGACTGGGGGGGCAATCAGCCCCAGCATTTT	CASSNRPPKLDWGGNQPQHF	TRBV13	TRBJ1-5
TGCAGTGCGTGTACAGGGAATGAGACCCAGTACTTC	CSACTGNETQYF	TRBV20-1	TRBJ2-5
TGTGCCAGCAGCTTAATGAGACATGGACAGGAGATAAAACTGTTTTTT	CASSLMRHGQEIKLFF	TRBV11-3	TRBJ1-4
TGTGCCAGCAGTGCCGACAGGCACTGTACAGATACGCAGTATTTT	CASSADRHCTDTQYF	TRBV2	TRBJ2-3
TGCGCCAGCAGTGAGGTGACAGGGGGCCGGCGTTTGGCTTACGAGCAGTACTTC	CASSEVTGGRRLAYEQYF	TRBV10-1	TRBJ2-7
TGTGCCAGCAGTTCCCGGGAGACCCAGTACTTC	CASSSRETQYF	TRBV6-9	TRBJ2-5
TGCAGTGGACACCTCCCTAGGGGTATCTCCTACGAGCAGTACTTC	CSGHLPRGISYEQYF	TRBV20-1	TRBJ2-7
TGCGCCAGCAGCTGTGACAGGGGAAGCACAGATACGCAGTATTTT	CASSCDRGSTDTQYF	TRBV5-1	TRBJ2-3
TGTGCCAGCAGTTACCCGCGCGGACAGGAAAAAAATGGGTGTGAGCCCCAGCATTTT	CASSYPRGQEKNGCEPQHF	TRBV6-5	TRBJ1-5
TGTGCCACCTCCGGAGGGAACAGAACTAATGAAAAACTGTTTTTT	CATSGGNRTNEKLFF	TRBV15	TRBJ1-4
TGCAGTGCTGGGGGCACTGAAGCTTTCTTT	CSAGGTEAFF	TRBV20-1	TRBJ1-1
TGTGCCAGCAGCGGCTCTCCAGCGGCCAATCAGCCCCAGCATTTT	CASSGSPAANQPQHF	TRBV7-3	TRBJ1-5
TGCAGTGCTGAGAGGGGGGGGCCCCTCCGCACAGATACGCAGTATTTT	CSAERGGPLRTDTQYF	TRBV20-1	TRBJ2-3
TGTGCCAGCAGCCAAGATACCATCCGCCGGGACAGGCTTGAAGCTTTCTTT	CASSQDTIRRDRLEAFF	TRBV3-1	TRBJ1-1
TGTGCCAGCAGCCAGGGAGGGGCAATCTACAATGAGCAGTTCTTC	CASSQGGAIYNEQFF	TRBV7-2	TRBJ2-1
TGTGCCAGCTCACCCGCGACAGGGCGATCTTTACATGGCTACACCTTC	CASSPATGRSLHGYTF	TRBV18	TRBJ1-2
TGTGCCAGCAGCCAAGATAGGGGGTGGAGGAGCTCTGGGGCCAACGTCCTGACTTTC	CASSQDRGWRSSGANVLTF	TRBV3-1	TRBJ2-6
