TGTGCCAGCAGCTTTGTAACGCACAGGGGGCCTCGGCCTCGCTACGAGCAGTACTTC	CASSFVTHRGPRPRYEQYF	TRBV5-8	TRBJ2-7
TGTGCCAGCAGCTTATTTGCCGAGGTAGTAGATACGCAGTATTTT	CASSLFAEVVDTQYF	TRBV7-3	TRBJ2-3
TGTGCCAGCAGTGACAGGGACGAGCAGTACTTC	CASSDRDEQYF	TRBV6-4	TRBJ2-7
TGTGCCAGCAGCCAAGGCCGGCGAGGTGATACGCAGTATTTT	CASSQGRRGDTQYF	TRBV3-1	TRBJ2-3
TGTGCCAGCAGTGAAGCTCGACGAGGCGGACCGGAGACCCAGTACTTC	CASSEARRGGPETQYF	TRBV6-1	TRBJ2-5
TGCAGCGTTGGGGGATGGGTCGTTAAGGATGGCTACACCTTC	CSVGGWVVKDGYTF	TRBV29-1	TRBJ1-2
TGTGCCAGCAGCCAAGATCGCCTAGTGGACAATGAGCAGTTCTTC	CASSQDRLVDNEQFF	TRBV14	TRBJ2-1
TGCAGTGCTAGATACCAGACGTATAAGTGGTACGAGCAGTACTTC	CSARYQTYKWYEQYF	TRBV20-1	TRBJ2-7
TGCGCCAGCAGCTTGTTGACCCAAGACCTACGGATGAACACTGAAGCTTTCTTT	CASSLLTQDLRMNTEAFF	TRBV5-1	TRBJ1-1
TGTGCCAGCAGTGAGAGGGTTGGACTAGCGGGACGGGTCGGTTCCTACAATGAGCAGTTCTTC	CASSERVGLAGRVGSYNEQFF	TRBV2	TRBJ2-1
TGTGCCATCAGTGCGATGGGTCCAGCACTGGCTGGGGGGACTGAAGCTTTCTTT	CAISAMGPALAGGTEAFF	TRBV10-3	TRBJ1-1
TGTGCCAGCAGCCAAGGAGGATGTCACAATGAGCAGTTCTTC	CASSQGGCHNEQFF	TRBV3-1	TRBJ2-1
TGTGCCAGTAGTACAGACCATCAGCCCCAGCATTTT	CASSTDHQPQHF	TRBV19	TRBJ1-5
TGTGCCAGCCCGAGCGTTAGCTCCTACAATGAGCAGTTCTTC	CASPSVSSYNEQFF	TRBV7-3	TRBJ2-1
TGTGCCAGCAGTGAATATGGTCAGGGGAGAAAGCTAATGCTTCAATATCAGCCCCAGCATTTT	CASSEYGQGRKLMLQYQPQHF	TRBV25-1	TRBJ1-5
TGTGCCATCAGCTCGACAGGCTTGGCCTACAATGAGCAGTTCTTC	CAISSTGLAYNEQFF	TRBV10-3	TRBJ2-1
TGTGCCAGCAGCTTACGAATCCCTGTCAAAAACATTCAGTACTTC	CASSLRIPVKNIQYF	TRBV28	TRBJ2-4
TGTGCCAGCAGCTTACTACTAGCGGGAGTGGGAATCTACGAGCAGTACTTC	CASSLLLAGVGIYEQYF	TRBV7-9	TRBJ2-7
TGTGCCACCAGTGATGAGGAGGCGGAGCGCTATGGCTACACCTTC	CATSDEEAERYGYTF	TRBV24-1	TRBJ1-2
TGTGCCAGCAGCGGCCGTTATCAGCCCCAGCATTTT	CASSGRYQPQHF	TRBV11-3	TRBJ1-5
TGTGCCAGCACGACCGGGACTCTGAACAATGAGCAGTTCTTC	CASTTGTLNNEQFF	TRBV28	TRBJ2-1
TGTGCCACTCAGAAATACACTGAAGCTTTCTTT	CATQKYTEAFF	TRBV7-6	TRBJ1-1
TGTGCCAGCAGCCTACATTATAAAAACGGGGAACCCAATGAGCAGTTCTTC	CASSLHYKNGEPNEQFF	TRBV7-3	TRBJ2-1
TGTGCCAGCAGCCCAGGGGACAGGGGGCGGGCCAAAAACATTCAGTACTTC	CASSPGDRGRAKNIQYF	TRBV27	TRBJ2-4
TGTGCCAGCAGCAGGACTAGCGGCAATGAGCAGTTCTTC	CASSRTSGNEQFF	TRBV13	TRBJ2-1
TGTGCCAGCAGCTTATTCCGGTTTGAGCAGTTCTTC	CASSLFRFEQFF	TRBV11-3	TRBJ2-1
TGTGCCAGCATGTTTGAGGTTTGGCACAACACTGAAGCTTTCTTT	CASMFEVWHNTEAFF	TRBV6-6	TRBJ1-1
TGTGCCAGCAGAGCTAACTGGTGTGGGGATGGGAGCGATGAGCAGTTCTTC	CASRANWCGDGSDEQFF	TRBV2	TRBJ2-1
TGTGCCAGCAGCCACATTCGGCAGGGAGCTGGAAATGAAAAACTGTTTTTT	CASSHIRQGAGNEKLFF	TRBV6-2	TRBJ1-4
TGTGCCAGCAGCCCCTATCGACCGTTCGGGACATGTGGCGATACGCAGTATTTT	CASSPYRPFGTCGDTQYF	TRBV13	TRBJ2-3
TGTGCCAGTAGAACCCGTCGGAGGGCCGAGCAGTACTTC	CASRTRRRAEQYF	TRBV19	TRBJ2-7
TGTGCCAGTATCTGGGGACTAGCGGTTTCCTACGAGCAGTACTTC	CASIWGLAVSYEQYF	TRBV19	TRBJ2-7
TGTGCCAGCAGCTTAAGTAGTGGACTAGCGGGGGGCAGGTGCGAGCAGTACTTC	CASSLSSGLAGGRCEQYF	TRBV7-2	TRBJ2-7
TGTGCCGGCGCGCGCTACGAGCAGTACTTC	CAGARYEQYF	TRBV19	TRBJ2-7
TGTGCCAGCAGGCTTGGACAGGCCGCTGAAGCTTTCTTT	CASRLGQAAEAFF	TRBV27	TRBJ1-1
TGTGCCAGCAGCGGGGGACAGAGGAAAATGAACACTGAAGCTTTCTTT	CASSGGQRKMNTEAFF	TRBV7-6	TRBJ1-1
TGTGCCACCAGTGCCAGGGCGGAACAAGAGACCCAGTACTTC	CATSARAEQETQYF	TRBV24-1	TRBJ2-5
TGTGCCAGCAGTGATCAGAGGGACACCCGCAATCAGCCCCAGCATTTT	CASSDQRDTRNQPQHF	TRBV6-4	TRBJ1-5
TGCAGCGTTGAAGGACTCACAGATACGCAGTATTTT	CSVEGLTDTQYF	TRBV29-1	TRBJ2-3
TGTGCCAGGTCCGGGACAGGGCAAGACAAGGACACTGAAGCTTTCTTT	CARSGTGQDKDTEAFF	TRBV19	TRBJ1-1
TGCAGTGCGGTTCGGGACAGGCTGCGGGAAACTTCCCGCACAGATACGCAGTATTTT	CSAVRDRLRETSRTDTQYF	TRBV20-1	TRBJ2-3
TGTGCCAGCAGCCAAGCCGCAGTCCCGGTCGCCGGGGCCGAAAAACTGTTTTTT	CASSQAAVPVAGAEKLFF	TRBV14	TRBJ1-4
TGTGCCAGCAGCTTTCAGGGCGAGGCTTTTATGAACACTGAAGCTTTCTTT	CASSFQGEAFMNTEAFF	TRBV13	TRBJ1-1
TGTGCCAGCAGCTTAGGAACAGGGAACTATGGCTACACCTTC	CASSLGTGNYGYTF	TRBV11-2	TRBJ1-2
TGTGCCAGCAGCCCCCTCGCGGGACCATACACAGATACGCAGTATTTT	CASSPLAGPYTDTQYF	TRBV11-2	TRBJ2-3
TGTGCCAGCAGAATGCTCTCGCCCCAGCATTTT	CASRMLSPQHF	TRBV6-5	TRBJ1-5
TGTGCCAGCTCAAAAAGGCCGGGGCACGAGCAGTACTTC	CASSKRPGHEQYF	TRBV7-9	TRBJ2-7
TGCAGTGCTAGACTTTGGAAAGAGACCCAGTACTTC	CSARLWKETQYF	TRBV20-1	TRBJ2-5
TGTGCCAAAGCATCCCCCAGGGAGGAGACCCAGTACTTC	CAKASPREETQYF	TRBV6-4	TRBJ2-5
TGTGCCAGCAGCTGTCCATGCGCAGGGGGCGGGGGGTCAACTAATGAAAAACTGTTTTTT	CASSCPCAGGGGSTNEKLFF	TRBV11-2	TRBJ1-4
TGTGCCAGCAGTTTTCCTCCGGTTTATAGCAATCAGCCCCAGCATTTT	CASSFPPVYSNQPQHF	TRBV27	TRBJ1-5
TGTGCCAGCAGCCGGGGTAACGAGCAGTACTTC	CASSRGNEQYF	TRBV13	TRBJ2-7
TGCGCCAGCCTGGACCAGCGGGACTACAATGAGCAGTTCTTC	CASLDQRDYNEQFF	TRBV4-1	TRBJ2-1
TGTGCCAGCACCCTCACTAGCGGGAGTCAAAACATTCAGTACTTC	CASTLTSGSQNIQYF	TRBV7-8	TRBJ2-4
TGTGCCTGGAAGCGGGGGTTTAGCAATCAGCCCCAGCATTTT	CAWKRGFSNQPQHF	TRBV30	TRBJ1-5
TGTGCCACCAGTGATTTGCGAGGGTACAATGAGCAGTTCTTC	CATSDLRGYNEQFF	TRBV24-1	TRBJ2-1
TGTGCCAGCACGTTCGTCACCCGGGCCCGCCGACGGGTTATTTTTTCCTACGAGCAGTACTTC	CASTFVTRARRRVIFSYEQYF	TRBV27	TRBJ2-7
TGCAGTGCTAGTAGAGCTGGGACAACTAATGAAAAACTGTTTTTT	CSASRAGTTNEKLFF	TRBV20-1	TRBJ1-4
TGTGCCAGCAGCGGCCGGGACAGAGGGTACGAGCAGTACTTC	CASSGRDRGYEQYF	TRBV13	TRBJ2-7
TGTGCCAGCACCGGGACAGGGCAGAACTATGGCTACACCTTC	CASTGTGQNYGYTF	TRBV7-3	TRBJ1-2
TGTGCCAGCAGCCGGGCTGACGAGCAGTACTTC	CASSRADEQYF	TRBV7-8	TRBJ2-7
TGCGAACACAGGGCAGGGGAGCAGTACTTC	CEHRAGEQYF	TRBV5-1	TRBJ2-7
TGTGCCAGCAGTTCCGACGACAGGGGTCAGAACACTGAAGCTTTCTTT	CASSSDDRGQNTEAFF	TRBV12-3	TRBJ1-1
TGTGCCAGCAGCGGAAAGGGGGGCCGACACACCGGGGAGCTGTTTTTT	CASSGKGGRHTGELFF	TRBV5-5	TRBJ2-2
TGTGCCATCAGGGGGGGAAGCTACGAGCAGTACTTC	CAIRGGSYEQYF	TRBV10-3	TRBJ2-7
TGTGCCAGCAGCCAACCCGGGACGAACACCGGGGAGCTGTTTTTT	CASSQPGTNTGELFF	TRBV14	TRBJ2-2
TGCGCCAGCAGCCAAGATTTTAGCTTAACGGGACAGGGGGGCTCTCGCCGAAACACCATATATTTT	CASSQDFSLTGQGGSRRNTIYF	TRBV4-1	TRBJ1-3
TGTGCCTGGAGTGTAGACCGTGCGAATCAGCCCCAGCATTTT	CAWSVDRANQPQHF	TRBV30	TRBJ1-5
TGTGCCAGCAGTTGTCGGGGGACTGAAGCTTTCTTT	CASSCRGTEAFF	TRBV28	TRBJ1-1
TGTGCCAGCAGCCACCCACGGGGGGTTCAAGAGACCCAGTACTTC	CASSHPRGVQETQYF	TRBV4-2	TRBJ2-5
TGTGCCAGCAGCCCTTGGACTAGCGGGTGGGATGCCGGCAGCTCCTACAATGAGCAGTTCTTC	CASSPWTSGWDAGSSYNEQFF	TRBV7-3	TRBJ2-1
TGTGCCAGCAGTTTTACCAGGGACACCATATATTTT	CASSFTRDTIYF	TRBV28	TRBJ1-3
TGCAGTGCTAGAGATCGTCCCCACAGGGCGAAGGGGGCCTGCTATGGCTACACCTTC	CSARDRPHRAKGACYGYTF	TRBV20-1	TRBJ1-2
TGTGCCATCAGTGTAAAGAAGACAGGAGTCCGCTACGAGCAGTACTTC	CAISVKKTGVRYEQYF	TRBV10-3	TRBJ2-7
TGCGCCAGGTCTTATCGGGGAGGGAGGTCTCATGAGCAGTTCTTC	CARSYRGGRSHEQFF	TRBV5-1	TRBJ2-1
TGCGCCAGCAGTGAGCCCAACGGGGGAGTACCTCACGAGCAGTACTTC	CASSEPNGGVPHEQYF	TRBV10-1	TRBJ2-7
TGTGCCAGCAGCTTGGACAGTGGACGGACAGAAAACATTCAGTACTTC	CASSLDSGRTENIQYF	TRBV5-4	TRBJ2-4
TGCAATCGGATTCGACGGGTATTCATGGGGCTTATCGCCTACGAGCAGTACTTC	CNRIRRVFMGLIAYEQYF	TRBV10-2	TRBJ2-7
TGTGCCAGCAGTTTTACACCGGGACAGCACGCCGGGGAGCTGTTTTTT	CASSFTPGQHAGELFF	TRBV12-4	TRBJ2-2
TGTGCCAGCATTCGGGGGCCCTGGCTGGGGGGCGGCTACACCTTC	CASIRGPWLGGGYTF	TRBV27	TRBJ1-2
TGTGCCAGCAGTGCTTCCACTGGAGCAGGCCGATTTAGCAATCAGCCCCAGCATTTT	CASSASTGAGRFSNQPQHF	TRBV2	TRBJ1-5
TGTGCCAGCAGTTTTTCGGGAACCAGCAATCAGCCCCAGCATTTT	CASSFSGTSNQPQHF	TRBV27	TRBJ1-5
TGTGCCAGCAGCACGCGGACTAGCGGGTCCACAGATACGCAGTATTTT	CASSTRTSGSTDTQYF	TRBV14	TRBJ2-3
TGCGCCAGCAGCCAAGTAAGGGGGACAGGGGCCTGGTCCTACGAGCAGTACTTC	CASSQVRGTGAWSYEQYF	TRBV4-1	TRBJ2-7
TGTGCCAGCAGCTTAGATATCCCGGAAGGGGGGGATGAAGCTTTCTTT	CASSLDIPEGGDEAFF	TRBV11-3	TRBJ1-1
TGTGCCAGCAGTGAAAGCATACAAAGTTATGGCTACACCTTC	CASSESIQSYGYTF	TRBV6-4	TRBJ1-2
TGTGCCAAAATCTCACGGGACGGAATTAGCGCTGGGGCCAACGTCCTGACTTTC	CAKISRDGISAGANVLTF	TRBV7-3	TRBJ2-6
TGTGCCAGCAGCGGGGTGCAGGAGAAAACCGGCTGGAACACTGAAGCTTTCTTT	CASSGVQEKTGWNTEAFF	TRBV9	TRBJ1-1
TGTGCCAGCAGAGCGGGGGCGTGCGGGGAGCTGTTTTTT	CASRAGACGELFF	TRBV2	TRBJ2-2
TGTGCTAGCAGCCAGTGCAGGGCTAGTGATCAGCCCCAGCATTTT	CASSQCRASDQPQHF	TRBV7-7	TRBJ1-5
TGCGCCAGCAGCCGACGAGGGGGCGGTAACACCGGGGAGCTGTTTTTT	CASSRRGGGNTGELFF	TRBV4-1	TRBJ2-2
TGTGCCACCACGCAGGTTAAGGCAACTAATGAAAAACTGTTTTTT	CATTQVKATNEKLFF	TRBV24-1	TRBJ1-4
TGCGCCAGCAGCTTGGAGATTCGCCGGGACAGTGTGGATAATCCTGTCAATGAGCAGTTCTTC	CASSLEIRRDSVDNPVNEQFF	TRBV5-1	TRBJ2-1
TGTGCCAGCAGTTACTCCGGGGGGAGCGTTAACGAGCAGTACTTC	CASSYSGGSVNEQYF	TRBV6-2	TRBJ2-7
TGTGCCAGCAATCCAGGGTCACCCCTCCACTTT	CASNPGSPLHF	TRBV3-1	TRBJ1-6
TGTGCCAGCAGCTTTTTTCTCGTCGAAAACAGTTGGAACCCGGGCTACGAGCAGTACTTC	CASSFFLVENSWNPGYEQYF	TRBV7-6	TRBJ2-7
TGCGCCAGCAGCTTGGTCGGGGTCGGCCGCCTTCAGCCCCAGCATTTT	CASSLVGVGRLQPQHF	TRBV5-1	TRBJ1-5
TGCAGCGTTGCCTCGAGGAAGGAGACCCAGTACTTC	CSVASRKETQYF	TRBV29-1	TRBJ2-5
TGTGCCTGGTGGCCTTCCTACGAGCAGTACTTC	CAWWPSYEQYF	TRBV30	TRBJ2-7
TGTGCCAGCTCAAACGGGGTCTTATCCCAAGGGAGCCAAGAGACCCAGTACTTC	CASSNGVLSQGSQETQYF	TRBV18	TRBJ2-5
TGTGCCACCGAACTCCTTGACAGGAGGGGTTACTATGGCTACACCTTC	CATELLDRRGYYGYTF	TRBV24-1	TRBJ1-2
TGTGCTCTGGACAGGGGCAATCAGCCCCAGCATTTT	CALDRGNQPQHF	TRBV27	TRBJ1-5
TGCATACTGCAGACAGGGGGCGTGGTGCATTTT	CILQTGGVVHF	TRBV20-1	TRBJ1-5
TGTGCCAGCAGTTACGTGGCTAGCGGGGGGGCCGGAACGAGCTCCTACAATGAGCAGTTCTTC	CASSYVASGGAGTSSYNEQFF	TRBV6-5	TRBJ2-1
TGTGCCAGCAGCTTGAGGCCCCGAGGGTCAGGAGCGCGCAATGAGCAGTTCTTC	CASSLRPRGSGARNEQFF	TRBV7-6	TRBJ2-1
TGTGCCAGCAGCTTAGGGTGGGGGAACACTGAAGCTTTCTTT	CASSLGWGNTEAFF	TRBV11-3	TRBJ1-1
TGCGCCAGCAGCTTGCCTCGTCGAGGGTTGTACCAAGAGACCCAGTACTTC	CASSLPRRGLYQETQYF	TRBV5-1	TRBJ2-5
TGCAGTCCTCTGGCAGGCGGATATAATTCACCCCTCCACTTT	CSPLAGGYNSPLHF	TRBV20-1	TRBJ1-6
TGCAGTGCTAGACCCAACACTTTCATAGGCACTGAAGCTTTCTTT	CSARPNTFIGTEAFF	TRBV20-1	TRBJ1-1
TGTGCCAGCAGGGGCGCTAACTATGGCTACACCTTC	CASRGANYGYTF	TRBV28	TRBJ1-2
TGTGCCAACCGGGACAGGGAAAGTGGCTACACCTTC	CANRDRESGYTF	TRBV6-5	TRBJ1-2
TGTGCCAGCAGGAAAGGACGGGGGCTAACGGGCACAGATACGCAGTATTTT	CASRKGRGLTGTDTQYF	TRBV27	TRBJ2-3
TGTGCCAGCAGTGAATTGAGGACAGGGGGAAAGACCTACAATGAGCAGTTCTTC	CASSELRTGGKTYNEQFF	TRBV25-1	TRBJ2-1
TGTGCCAGCAGTTCGTTTACTCATCCCCGGACGGTTGGGGAGTACTTC	CASSSFTHPRTVGEYF	TRBV6-6	TRBJ2-7
TGTGCCACCAGTGATTCCCAGACTAGCGGGAGGGCCCATGAGCAGTTCTTC	CATSDSQTSGRAHEQFF	TRBV24-1	TRBJ2-1
TGTGCCAGTAGTCAGGTTCTGGGAGGGTTCAATCAGCCCCAGCATTTT	CASSQVLGGFNQPQHF	TRBV19	TRBJ1-5
TGTGCCAGCAGCAACCCCTACAGGGGGCGCCTCTCCTACGAGCAGTACTTC	CASSNPYRGRLSYEQYF	TRBV7-3	TRBJ2-7
TGTGCCAGCAGCTTCGTCCCCGGGAGAGACATTCAGTACTTC	CASSFVPGRDIQYF	TRBV7-2	TRBJ2-4
TGTGCCACCAGTGGCACAAGAGGGGACCCTGAGCAGTTCTTC	CATSGTRGDPEQFF	TRBV24-1	TRBJ2-1
TGTGCCACACACCCCGATGGGCCTCCTCGTGTCCGGGACAAGGACAACACCGGGGAGCTGTTTTTT	CATHPDGPPRVRDKDNTGELFF	TRBV3-1	TRBJ2-2
TGTGCCAGCAGGTTCCCGCCCCGAAGGGGCTACACCTTC	CASRFPPRRGYTF	TRBV7-8	TRBJ1-2
TGTGCCAGCCCAGACATGTACGAGCAGTACTTC	CASPDMYEQYF	TRBV6-4	TRBJ2-7
TGTGCCAGCAGTTCCCTAAGCTCCTACAATGAGCAGTTCTTC	CASSSLSSYNEQFF	TRBV27	TRBJ2-1
TGTGCCAGCAGCTTAGATGCGCAGTCAAGAGGACGCCCTCCCTACGAGCAGTACTTC	CASSLDAQSRGRPPYEQYF	TRBV11-3	TRBJ2-7
TGCAGTGCTAGAGCGGGGGGGGGACTTCCATCTAGCACAGATACGCAGTATTTT	CSARAGGGLPSSTDTQYF	TRBV20-1	TRBJ2-3
TGTGCCAGCAGTTTATGCCCGGTGGGGAAGATCAGAGACTCCTACGAGCAGTACTTC	CASSLCPVGKIRDSYEQYF	TRBV28	TRBJ2-7
TGCGCCAGCATGCCCATGGACAGGGGGCAGCCCCAGCATTTT	CASMPMDRGQPQHF	TRBV10-1	TRBJ1-5
TGTGCCACCAGTGATTTGCAGGGACCCCGCCACCACGAGCAGTACTTC	CATSDLQGPRHHEQYF	TRBV24-1	TRBJ2-7
TGTGCCACCAGTGCCCCTAAAATGGAGAACACCGGGGAGCTGTTTTTT	CATSAPKMENTGELFF	TRBV24-1	TRBJ2-2
TGCGCCAGCAGTTCCACTAGCGGGAGGTATGGCTACACCTTC	CASSSTSGRYGYTF	TRBV10-1	TRBJ1-2
TGCAGCTCGAGGGCTTACGGGGGAACCTACGAGCAGTACTTC	CSSRAYGGTYEQYF	TRBV29-1	TRBJ2-7
TGTGCCACCAACCTCCACAGGGGGGTCGGGGAGCTGTTTTTT	CATNLHRGVGELFF	TRBV24-1	TRBJ2-2
TGTGCCAGTAGTATGTCGGAAACCAAAAACATTCAGTACTTC	CASSMSETKNIQYF	TRBV19	TRBJ2-4
TGTGCCAGCAGCGCGTCGAACACCGGGGAGCTGTTTTTT	CASSASNTGELFF	TRBV7-9	TRBJ2-2
TGTGCCAACCGAGCCCCCGACGTCACAGATACGCAGTATTTT	CANRAPDVTDTQYF	TRBV7-9	TRBJ2-3
TGTGCCAGCAGCTCCAGGGGAGTCTCAGATACGCAGTATTTT	CASSSRGVSDTQYF	TRBV13	TRBJ2-3
TGTGCCAGCACGCGTAAAGGGGGGCCCTGGACCGGGGAGCTGTTTTTT	CASTRKGGPWTGELFF	TRBV6-3	TRBJ2-2
TGTGCCAGCACTAGCGGGGGGGTAGCCAAAAACATTCAGTACTTC	CASTSGGVAKNIQYF	TRBV25-1	TRBJ2-4
TGTGCCAGCTCACCAGTTGGGGACACCTCTGGGGCCAACGTCCTGACTTTC	CASSPVGDTSGANVLTF	TRBV18	TRBJ2-6
TGTGCCACCAGTGTGACAGATCATGAAAAACTGTTTTTT	CATSVTDHEKLFF	TRBV24-1	TRBJ1-4
TGTGCCAGCTCACCACAGGGGGGGTTAGATACGCAGTATTTT	CASSPQGGLDTQYF	TRBV18	TRBJ2-3
TGTGCCACCAGTGATCGGACAGGTGGCTACACCTTC	CATSDRTGGYTF	TRBV24-1	TRBJ1-2
TGCAGCGTTCGCACTAGCGGGAGAATAGCTTTCTTT	CSVRTSGRIAFF	TRBV29-1	TRBJ1-1
TGTGCCAGCAGCCGGCCCCTCCGGGACAGAGATACGCAGTATTTT	CASSRPLRDRDTQYF	TRBV7-9	TRBJ2-3
TGTGCCAGCAGCGGGCGACGGCCACACCGGGCCCGCCCTGCGGCAGAGCAGTTCTTC	CASSGRRPHRARPAAEQFF	TRBV7-3	TRBJ2-1
TGTGCCAGCAGCGTTCGGTCTGCAGATTCACCCCTCCACTTT	CASSVRSADSPLHF	TRBV9	TRBJ1-6
TGTGCCAGTAGTCCCGGGAGGGACGAGCAGTACTTC	CASSPGRDEQYF	TRBV19	TRBJ2-7
TGTGCCAGCAGTGACCTCAGGGCAAATGAAAAACTGTTTTTT	CASSDLRANEKLFF	TRBV6-1	TRBJ1-4
TGTGCCAGCAGCTTACCCGGGAGGTACTTC	CASSLPGRYF	TRBV7-3	TRBJ2-5
TGTGCCAGCAGCCCCGGACTAGGAACCTACTACGAGCAGTACTTC	CASSPGLGTYYEQYF	TRBV13	TRBJ2-7
TGTGCCTCCTTGACAGGCGGTTACTATGGCTACACCTTC	CASLTGGYYGYTF	TRBV19	TRBJ1-2
TGTGCCAGCATTTTAACACTAGAACCAAACACCGGGGAGCTGTTTTTT	CASILTLEPNTGELFF	TRBV14	TRBJ2-2
TGCAGTGGAGAGGGTTGCCAAGAGACCCAGTACTTC	CSGEGCQETQYF	TRBV20-1	TRBJ2-5
TGTGCCAGCAGTTACCGTCCGAGGGCCGGCGAGCAGTACTTC	CASSYRPRAGEQYF	TRBV6-5	TRBJ2-7
TGTGCCAGCAGTTACGAAGGCTGGGGGTCGGCTAGTGAGCAGTTCTTC	CASSYEGWGSASEQFF	TRBV6-2	TRBJ2-1
TGTGCCAGTATCTGGGTTAGAGACAGGATGCAAGAGACCCAGTACTTC	CASIWVRDRMQETQYF	TRBV19	TRBJ2-5
TGCGCCAGCAGTGGGACAGGGGGCGAGGAGCTGTTTTTT	CASSGTGGEELFF	TRBV5-1	TRBJ2-2
TGTGCCAGCAGCTTAGATAAGGGGGGGCCAGATACGCAGTATTTT	CASSLDKGGPDTQYF	TRBV7-2	TRBJ2-3
TGTGCCAGCAGCGTTCTGGACAGGGAAAATGAAGCTTTCTTT	CASSVLDRENEAFF	TRBV7-6	TRBJ1-1
TGCAGTGCACCGGGTGCGGGAGGCACAGCTAACTATGGCTACACCTTC	CSAPGAGGTANYGYTF	TRBV20-1	TRBJ1-2
TGCGCCAGCAAGCCGGCGGGGGAGGGCAGGGTTCGCCCCGGCAATCCCGGGGAGCTGTTTTTT	CASKPAGEGRVRPGNPGELFF	TRBV10-1	TRBJ2-2
TGTGCCATCACTGGAGCACTGGCCCGGTCCTACGAGCAGTACTTC	CAITGALARSYEQYF	TRBV10-3	TRBJ2-7
TGTGCCAGGTTCTCTCTCCTTAAGTGGGGGAGGGGAAACATGAACACTGAAGCTTTCTTT	CARFSLLKWGRGNMNTEAFF	TRBV28	TRBJ1-1
TGTGCCAGCAGTTCGGGGAGGGATGGCTACACCTTC	CASSSGRDGYTF	TRBV6-3	TRBJ1-2
TGTGCCATCAGGTCTAGCGGGGAGACCCAGTACTTC	CAIRSSGETQYF	TRBV10-3	TRBJ2-5
TGTGCCAGCAGAGTCCACCAGACGCAGTATTTT	CASRVHQTQYF	TRBV11-3	TRBJ2-3
TGTGCCAGCAGTTCCACTAGCGGGAGGGTGGCTAGCACAGATACGCAGTATTTT	CASSSTSGRVASTDTQYF	TRBV6-8	TRBJ2-3
TGTGCCAGCAGGCTTTGGGGTGCTCTCTCCTATAATTCACCCCTCCACTTT	CASRLWGALSYNSPLHF	TRBV28	TRBJ1-6
TGTGCCAGCAGTAGAGGGGGGCTGGACAACGAGCAGTACTTC	CASSRGGLDNEQYF	TRBV6-4	TRBJ2-7
TGTGCCAGCAGTTTCTCTAGGCTAGCGGGGGGGCCGCGGACCTACAATGAGCAGTTCTTC	CASSFSRLAGGPRTYNEQFF	TRBV12-3	TRBJ2-1
TGTGCCAGCTCACCCCGGCGGGCAGGTGCATCTGGACCTAGCTACACCTTC	CASSPRRAGASGPSYTF	TRBV18	TRBJ1-2
TGTGCCAGCAGTTTGGGACAGGGGTCTGAAGCTTTCTTT	CASSLGQGSEAFF	TRBV6-1	TRBJ1-1
TGTGCCAGCAGTTCTGGTCCTCCGGGACATGGCTACACCTTC	CASSSGPPGHGYTF	TRBV28	TRBJ1-2
TGTGCCAGCAAGATCATGACTAGCGGGTATCTAGAATCCTACAATGAGCAGTTCTTC	CASKIMTSGYLESYNEQFF	TRBV7-3	TRBJ2-1
TGCAGTGGAGGGGAGTACCCCGGCTACACCTTC	CSGGEYPGYTF	TRBV20-1	TRBJ1-2
TGTGCCAGCATCGCAGGGCGTTACGAGCAGTACTTC	CASIAGRYEQYF	TRBV27	TRBJ2-7
TGTGCCAGCAGCAAGAGTCCAGGGACTAGGGACGCAGATACGCAGTATTTT	CASSKSPGTRDADTQYF	TRBV7-2	TRBJ2-3
TGTGCCAGCAGACGATCTCCGGCAAGCTCCTACGAGCAGTACTTC	CASRRSPASSYEQYF	TRBV6-5	TRBJ2-7
TGCGCCACCAGGGCTTCTGAGTGCGGCCCACAAGAGACCCAGTACTTC	CATRASECGPQETQYF	TRBV10-1	TRBJ2-5
TGTGCCATAGGAGACAATGAGCAGTTCTTC	CAIGDNEQFF	TRBV11-3	TRBJ2-1
TGTGCCAGCAGCTTCCAGACAGGGGGAAAGCATAGCAATCAGCCCCAGCATTTT	CASSFQTGGKHSNQPQHF	TRBV11-3	TRBJ1-5
TGTGCCAGCTCACCACCCGGGAGCAAGCGAGCCAAAAACATTCAGTACTTC	CASSPPGSKRAKNIQYF	TRBV18	TRBJ2-4
TGTGCCAGCAGCAACAGTCACGGCAATGAGCAGTTCTTC	CASSNSHGNEQFF	TRBV13	TRBJ2-1
TGTGCCAGCAGCCAAACTGGGGAACGCGAGCAGTACTTC	CASSQTGEREQYF	TRBV13	TRBJ2-7
TGTGCTAGTGGACCGGAGTATGGCTACACCTTC	CASGPEYGYTF	TRBV12-5	TRBJ1-2
TGCGCCAGCAGCCACCGACAGGGGGGTCGCAATCAGCCCCAGCATTTT	CASSHRQGGRNQPQHF	TRBV4-1	TRBJ1-5
TGTGCCAGCAGCCCCCCCGGGACAGCCTCCACAGATACGCAGTATTTT	CASSPPGTASTDTQYF	TRBV7-9	TRBJ2-3
TGTGCCATCAGTGAGTCGGTACCGGGGAATAAGGGCTACAATGAGCAGTTCTTC	CAISESVPGNKGYNEQFF	TRBV10-3	TRBJ2-1
TGTGCCACCATCCCCGGGGGATACTTGCAGTACTTC	CATIPGGYLQYF	TRBV24-1	TRBJ2-7
TGCGCCAGCAGCCGGACTAGCGGAATAGCCGGCACCGGGGAGCTGTTTTTT	CASSRTSGIAGTGELFF	TRBV5-1	TRBJ2-2
TGTGCCAGCAGCTTACTAGCGGGAGCGCCGGCCAAAAACATTCAGTACTTC	CASSLLAGAPAKNIQYF	TRBV13	TRBJ2-4
TGTGCCAGCAGCTTAATCACCGGGGCAGAGACCCAGTACTTC	CASSLITGAETQYF	TRBV7-3	TRBJ2-5
TGTGCCAGCAGCCTCCTACTGAACACTGAAGCTTTCTTT	CASSLLLNTEAFF	TRBV7-7	TRBJ1-1
TGTGCCAGCAGCTGGGGTAAAAGAACCTACGAGCAGTACTTC	CASSWGKRTYEQYF	TRBV5-6	TRBJ2-7
TGTGCCAGCAGTCAGTATGGAACTGGTCGGACAAGCCAGCCCCAGCATTTT	CASSQYGTGRTSQPQHF	TRBV27	TRBJ1-5
TGTGCCAGTAGTATACGGGCTTGGCTCAGGGGGGCGAGGATAGAGACCCAGTACTTC	CASSIRAWLRGARIETQYF	TRBV19	TRBJ2-5
TGCAGTGCTAGTACTACTAGCGGGCGGTACCAAGAGACCCAGTACTTC	CSASTTSGRYQETQYF	TRBV20-1	TRBJ2-5
TGTGCCAGCAGCTTGGCTTCCCACGCCGGCTACGAGCAGTACTTC	CASSLASHAGYEQYF	TRBV5-6	TRBJ2-7
TGTGCCATCAGGGCAAGGTTCAGGGACAGGGGTGGCTACACCTTC	CAIRARFRDRGGYTF	TRBV10-3	TRBJ1-2
TGTGCCATCAGAAGACCGTTTCCGGGGGTACGCAGGAGCTCCTACGAGCAGTACTTC	CAIRRPFPGVRRSSYEQYF	TRBV10-3	TRBJ2-7
TGTGCCAGCAGCGTCCCCGGGACAATTACCGGGGAGCTGTTTTTT	CASSVPGTITGELFF	TRBV9	TRBJ2-2
TGTGCCAGCAGTTACTTCGTCTTGCTAGCGGGAGGGGGGCATCCCGGGGAGCTGTTTTTT	CASSYFVLLAGGGHPGELFF	TRBV6-3	TRBJ2-2
TGTGCCCAAGAAGCTTTCTTT	CAQEAFF	TRBV19	TRBJ1-1
TGTGCCAGCAGTTTCTATACACCTTTTTTTACTAGCACAGATACGCAGTATTTT	CASSFYTPFFTSTDTQYF	TRBV28	TRBJ2-3
TGTGCCATCAGTAGACTAGCGGGGTTTTACAATGAGCAGTTCTTC	CAISRLAGFYNEQFF	TRBV10-3	TRBJ2-1
TGTGCCAGCAGCTTCTCGCAGGGGAATAAGAATCAGCCCCAGCATTTT	CASSFSQGNKNQPQHF	TRBV5-4	TRBJ1-5
TGTGCCAGCAGCAATCGGACAGGGGGCATGGTTGGAGAGACCCAGTACTTC	CASSNRTGGMVGETQYF	TRBV7-3	TRBJ2-5
TGCAGTGCGAGTGACAGGATAGTCGAGCAGTACTTC	CSASDRIVEQYF	TRBV20-1	TRBJ2-7
TGTGCCAGCAGCCTCGGGGGCCTACTTTCACTCTGCAATCAGCCCCAGCATTTT	CASSLGGLLSLCNQPQHF	TRBV14	TRBJ1-5
TGTGCCAGCAGCCTGAGAAATCTGGACAGTGGGGGCTACGAGCAGTACTTC	CASSLRNLDSGGYEQYF	TRBV9	TRBJ2-7
TGTGCCAGCAGCTTAGCCGGGGGGGCGGGTACCTACGAGCAGTACTTC	CASSLAGGAGTYEQYF	TRBV11-3	TRBJ2-7
TGTGCCAGCAGGAGAGGACGGGGCCTGCCCACCGGGGAGCTGTTTTTT	CASRRGRGLPTGELFF	TRBV28	TRBJ2-2
TGCGCCGGACAGGGGGCCCCGGCCTTC	CAGQGAPAF	TRBV10-1	TRBJ1-2
TGTGCCAGCAGCGTTCCAACGCCCGGGACAGGGACTGGTTCTGAAGCTTTCTTT	CASSVPTPGTGTGSEAFF	TRBV5-4	TRBJ1-1
TGTGCCAGCAGCCGCGGACAGGATAGCCTCCACTTT	CASSRGQDSLHF	TRBV14	TRBJ1-6
TGCGCCAGCAGCCAATCCGAGGTCGGTACGCAGTATTTT	CASSQSEVGTQYF	TRBV4-1	TRBJ2-3
TGTGCCAGCCTTAATGGACGCGAGCAGTACTTC	CASLNGREQYF	TRBV19	TRBJ2-7
TGTGCCAGCAGTTTATCGTTTGGCACAGAAGAAGCCAATGAGCAGTTCTTC	CASSLSFGTEEANEQFF	TRBV27	TRBJ2-1
TGTGCCACCAGCAGCTCTAGGACCACTGAAGCTTTCTTT	CATSSSRTTEAFF	TRBV15	TRBJ1-1
TGCAGCGTTTGGACAGGGTCGGCTGGGGGGAACATTCAGTACTTC	CSVWTGSAGGNIQYF	TRBV29-1	TRBJ2-4
TGTGCCAGCAGCTGGACGGGGCACGAGCAGTACTTC	CASSWTGHEQYF	TRBV7-2	TRBJ2-7
TGTGCCAGCAGCTGCCCCATGCGGACAACGTCCTACGAGCAGTACTTC	CASSCPMRTTSYEQYF	TRBV5-4	TRBJ2-7
TGTGCCAGCAGACAGGGGACAGATACGCAGTATTTT	CASRQGTDTQYF	TRBV28	TRBJ2-3
TGTGCCAGCAGCCTGGGGTTAGTTGATTTTAACTATGGCTACACCTTC	CASSLGLVDFNYGYTF	TRBV7-8	TRBJ1-2
TGTGCCAGCTTTAGTTCATTTCAGCCCCAGCATTTT	CASFSSFQPQHF	TRBV9	TRBJ1-5
TGTGCCACCAGTGTACGTTCAAGGGGGCGCTACGAGCAGTACTTC	CATSVRSRGRYEQYF	TRBV24-1	TRBJ2-7
TGCGCCAGCACAAGGGTCCCGGAGGGGCAGTTCTTC	CASTRVPEGQFF	TRBV5-1	TRBJ2-1
TGTGCCAGCAGTGCGGTCTACTGGACAGGGGGGGACACCTTC	CASSAVYWTGGDTF	TRBV6-1	TRBJ1-2
TGCGCCAGCAGCCAAGACCAGACTCGAGGGAAAACATGCGGGGAGCTGTTTTTT	CASSQDQTRGKTCGELFF	TRBV4-1	TRBJ2-2
TGTAACCTGGACAGGGGCTCTGGAAACACCATATATTTT	CNLDRGSGNTIYF	TRBV20-1	TRBJ1-3
TGTGCCAGCAGCAGACAACCTACAGGGGGGTTTCACACTGAAGCTTTCTTT	CASSRQPTGGFHTEAFF	TRBV13	TRBJ1-1
TGTGCCAGCATCGACAGAGAGGGGAATACCGTACAGACCCAGTACTTC	CASIDREGNTVQTQYF	TRBV6-6	TRBJ2-5
TGTGCCAGCAGCATCACCGGGACTAGCGGGAGTTATAGCTCCTACGAGCAGTACTTC	CASSITGTSGSYSSYEQYF	TRBV13	TRBJ2-7
TGTGCCACCACCAAAAAGGCGGATGAAAAACTGTTTTTT	CATTKKADEKLFF	TRBV24-1	TRBJ1-4
TGTGCCAGCAGGGCGGCGCAGGAGACCCAGTACTTC	CASRAAQETQYF	TRBV6-4	TRBJ2-5
TGTGCCAGCAGCTTGGTAAGGAGGGTGAACCCAAAGTCAACAGATACGCAGTATTTT	CASSLVRRVNPKSTDTQYF	TRBV5-4	TRBJ2-3
TGCGCCAGCAGCTTGGCTCGGGACAGGGCACCCTGGGCCTACGAGCAGTACTTC	CASSLARDRAPWAYEQYF	TRBV5-1	TRBJ2-7
TGTGCCAGCAAGGGACACGAGCAGTACTTC	CASKGHEQYF	TRBV27	TRBJ2-7
TGTGCCAGCAGTCCCGGGACAGCCCGCCGGGACGAGCAGTACTTC	CASSPGTARRDEQYF	TRBV9	TRBJ2-7
TGTGCCACCAGCAGAGGAGGGTGTTACACTGAAGCTTTCTTT	CATSRGGCYTEAFF	TRBV15	TRBJ1-1
TGTGCCATCATACGGCCGGCCCATGGACAGGGTCACGACACAGATACGCAGTATTTT	CAIIRPAHGQGHDTDTQYF	TRBV10-3	TRBJ2-3
TGCGCCAGCCGAAGGGTGCAGGGGGCGGTGCAAAACACCGGGGAGCTGTTTTTT	CASRRVQGAVQNTGELFF	TRBV5-1	TRBJ2-2
TGTGCCAGCAGCTTAAGGGGGGAAGACACTGAAGCTTTCTTT	CASSLRGEDTEAFF	TRBV7-3	TRBJ1-1
TGTGCCAGTAGTCATCCTAGCGGGCAAACTGGCACCGGGGAGCTGTTTTTT	CASSHPSGQTGTGELFF	TRBV19	TRBJ2-2
TGTGCCACCAGTGATTTGCAACTAATCCCCTACGAGCAGTACTTC	CATSDLQLIPYEQYF	TRBV24-1	TRBJ2-7
TGTGCCAGCAGTGAAGTATCCGGGACAGATAGCAATCAGCCCCAGCATTTT	CASSEVSGTDSNQPQHF	TRBV2	TRBJ1-5
TGTGCCAGCAGCTTGGTTCACGGGATCAATAATGAAAAACTGTTTTTT	CASSLVHGINNEKLFF	TRBV7-9	TRBJ1-4
TGTGCCACCAGTGATAAAGTTAGGAGGGGGTTAAGCTCCTACAATGAGCAGTTCTTC	CATSDKVRRGLSSYNEQFF	TRBV24-1	TRBJ2-1
TGTGCCAGCAGCAGGGGCGGATCTGAGGGTGGCGAGCAGTACTTC	CASSRGGSEGGEQYF	TRBV6-5	TRBJ2-7
TGTGTACCGTGCCCAAACCTAAGCAATCAGCCCCAGCATTTT	CVPCPNLSNQPQHF	TRBV12-3	TRBJ1-5
TGCGCCAGCAGCTTGTTACGGCGGCCTTATGGCTACACCTTC	CASSLLRRPYGYTF	TRBV5-1	TRBJ1-2
TGTGCCAGCAGCTTACGGGCCGACACCATATATTTT	CASSLRADTIYF	TRBV11-3	TRBJ1-3
TGTGCCACCAGTGACGGGCATTATAGCAATCAGCCCCAGCATTTT	CATSDGHYSNQPQHF	TRBV24-1	TRBJ1-5
TGTGCCAGCAGTGGAGAAGCGCTTTTCCGACTAGCCGCGCCCTACAATGAGCAGTTCTTC	CASSGEALFRLAAPYNEQFF	TRBV6-4	TRBJ2-1
TGCGCCAGCAGGAACAGTTTCCAAAACACTGAAGCTTTCTTT	CASRNSFQNTEAFF	TRBV5-1	TRBJ1-1
TGTGCCAGCAGGCCCGGTACCGGCAGACAGCCCCAGCATTTT	CASRPGTGRQPQHF	TRBV5-5	TRBJ1-5
TGCAGTGCTAGCGGGGGGGCACTAGCGGGTTCCTACAATGAGCAGTTCTTC	CSASGGALAGSYNEQFF	TRBV20-1	TRBJ2-1
TGCAGCGTTTATAGACAGGGGGCGAGTGAGGGTGGGAACACCGGGGAGCTGTTTTTT	CSVYRQGASEGGNTGELFF	TRBV29-1	TRBJ2-2
TGTGCCAGCAGACTTTCTTCGAGACTAGCGGGATTGATAGTGAGCTCCTACAATGAGCAGTTCTTC	CASRLSSRLAGLIVSSYNEQFF	TRBV6-1	TRBJ2-1
TGTGCCAGCAGCGTGAGGGACACTAACTATGGCTACACCTTC	CASSVRDTNYGYTF	TRBV11-3	TRBJ1-2
TGTGCCAGCAGCGCTAGGGAAGAGACCCAGTACTTC	CASSAREETQYF	TRBV13	TRBJ2-5
TGTGAAGGGACTGAAAAACTGTTTTTT	CEGTEKLFF	TRBV6-4	TRBJ1-4
TGCGCCAGCAGCCAAGATGAAGATAGCGGGACAGTAAGCAATCAGCCCCAGCATTTT	CASSQDEDSGTVSNQPQHF	TRBV4-1	TRBJ1-5
TGTGCCAGCGGGCGGGACAGGGGCCCCTATGGCTACACCTTC	CASGRDRGPYGYTF	TRBV27	TRBJ1-2
TGTGCCAGCAGCTTAGAGGCGCTAGAGACATGGGATGAGCAGTTCTTC	CASSLEALETWDEQFF	TRBV11-2	TRBJ2-1
TGTGCCAGCAGCGGGCCGCGACAGGCGCCTAGATCGCAGTATTTT	CASSGPRQAPRSQYF	TRBV5-5	TRBJ2-3
TGTGCCAGCAGAGAGGGGGGCCGACAGTACAATGAGCAGTTCTTC	CASREGGRQYNEQFF	TRBV6-3	TRBJ2-1
TGCGCCAGCAGCAGAGGGCCTGCCCATGAAGCTTTCTTT	CASSRGPAHEAFF	TRBV10-1	TRBJ1-1
TGCGCCAGCAGCTTGGGTTCCCTTTCACTAGGAGGACAGGGGTACGAGCAGTACTTC	CASSLGSLSLGGQGYEQYF	TRBV5-1	TRBJ2-7
TGCAGTGCTAGCCTAGCAGATGAGCAGTTCTTC	CSASLADEQFF	TRBV20-1	TRBJ2-1
TGTGCCAGCAGTGGAGTGGGGGCCCTGATATTCATGAACACTGAAGCTTTCTTT	CASSGVGALIFMNTEAFF	TRBV7-3	TRBJ1-1
TGTGCCAGCAGTTTACCCCCAGTTTCGGAGGATACATTGAAGGGGAACACTGAAGCTTTCTTT	CASSLPPVSEDTLKGNTEAFF	TRBV27	TRBJ1-1
TGTGCCACGGGGAGGGAAGAATACACTGAAGCTTTCTTT	CATGREEYTEAFF	TRBV2	TRBJ1-1
TGTGCCAGCAGCCCGGACAGGGTTTGGGATCACGAGCAGTACTTC	CASSPDRVWDHEQYF	TRBV5-6	TRBJ2-7
TGCGCCAGCAGCTTGGGGAATGGAACGACAGGGTACAATGAGCAGTTCTTC	CASSLGNGTTGYNEQFF	TRBV5-1	TRBJ2-1
TGTGCCAGCAGCCTAGCGATATTGAGGTACGAGCAGTACTTC	CASSLAILRYEQYF	TRBV6-4	TRBJ2-7
TGCGCCAGCAGATGGGACAGGAGCACTGAAGCTTTCTTT	CASRWDRSTEAFF	TRBV10-1	TRBJ1-1
TGTGCCAGCAGTTTAGCATCACCCCTCCACTTT	CASSLASPLHF	TRBV12-4	TRBJ1-6
TGTGCCAGCACCACCGGGACAGGGGCCTCCGAGCAGTACTTC	CASTTGTGASEQYF	TRBV9	TRBJ2-7
TGTGCCAGCAGCCCTTACCGGACAGCCGGGTACTGGGAGCAGTACTTC	CASSPYRTAGYWEQYF	TRBV7-3	TRBJ2-7
TGCGCCAGCAGGAAGGTGACAGGGCTTGGGAACTCCTACGAGCAGTACTTC	CASRKVTGLGNSYEQYF	TRBV10-1	TRBJ2-7
TGTGCCAGTCCGGCCCCCCCGGGACAGGAAGCAGGGCATGAGCAGTTCTTC	CASPAPPGQEAGHEQFF	TRBV19	TRBJ2-1
TGTGCCAGCAGCCATCCTAGCTTGACTGAAGCTTTCTTT	CASSHPSLTEAFF	TRBV14	TRBJ1-1
TGTGCCAGCAGCGCTCTTACAGAGACAGGGGGGGGGGATCAGCCCCAGCATTTT	CASSALTETGGGDQPQHF	TRBV7-6	TRBJ1-5
TGCAGTGCTCGGGGAAAGTCAGTGAAAAGCAATCAGCCCCAGCATTTT	CSARGKSVKSNQPQHF	TRBV20-1	TRBJ1-5
TGTGCCAGCAGCTCCGGGACAGATGGGACGTCAACTAATGAAAAACTGTTTTTT	CASSSGTDGTSTNEKLFF	TRBV5-6	TRBJ1-4
TGTGCCAGCAGCCTGCTGGACAGCTTCCACTATGGCTACACCTTC	CASSLLDSFHYGYTF	TRBV14	TRBJ1-2
TGTGCCAGCAGTTCGGGGGGGTGCACTGAAGCTTTCTTT	CASSSGGCTEAFF	TRBV28	TRBJ1-1
TGCAGTGCTGAGGCTGGGGACAGATTTGGGCAGTTTCAGCCCCAGCATTTT	CSAEAGDRFGQFQPQHF	TRBV20-1	TRBJ1-5
TGTGCCAGCAGTAAGGGGGTGGGAGGGCTGAAGACCCAGTACTTC	CASSKGVGGLKTQYF	TRBV27	TRBJ2-5
TGTGCCAGCAGCTCCGACGCTAGAAGTAGGGAGCTGTTTTTT	CASSSDARSRELFF	TRBV7-9	TRBJ2-2
TGCGCCAGCAGTTGCAGTTATGGCTACACCTTC	CASSCSYGYTF	TRBV5-1	TRBJ1-2
TGTGCCAGCAGCCCCCTTCAGGGTTATAGCAATCAGCCCCAGCATTTT	CASSPLQGYSNQPQHF	TRBV27	TRBJ1-5
TGTGCCAGCAAGACCGAGGGGGGTGGGATCTCCTACGAGCAGTACTTC	CASKTEGGGISYEQYF	TRBV28	TRBJ2-7
TGTGCCACCAGCAGGCTGGGGGACAGGGATCAGCCCCAGCATTTT	CATSRLGDRDQPQHF	TRBV15	TRBJ1-5
TGTGCCAGCAGTCTCTCCCCAAAGGAGGGATTCCAGCCCCAGCATTTT	CASSLSPKEGFQPQHF	TRBV27	TRBJ1-5
TGTGCCAGCAGTGGAGGATTCTTGGAGACCCAGTACTTC	CASSGGFLETQYF	TRBV27	TRBJ2-5
TGCGCCAGCCGTTCTCGGAGGGCCACTGAAGCTTTCTTT	CASRSRRATEAFF	TRBV5-1	TRBJ1-1
TGTGCCAGCAGCTCCAGTGGACAGGGCCACCGCGGCTACACCTTC	CASSSSGQGHRGYTF	TRBV7-3	TRBJ1-2
TGCGCCAGCATCCGGTATGAGCAGTTCTTC	CASIRYEQFF	TRBV4-3	TRBJ2-1
TGTGCCAGCAGCTTGGATCACAGGGTCAAGATGCTGGAGAGCGTTCATAGCAATCAGCCCCAGCATTTT	CASSLDHRVKMLESVHSNQPQHF	TRBV5-6	TRBJ1-5
TGTGCCAGCAGGCAAGACAGGGCCTCCGTCGAGCAGTACTTC	CASRQDRASVEQYF	TRBV27	TRBJ2-7
TGTGCCAGCAGTGAATATATAGGACAGGGAAGTGAAGCTTTCTTT	CASSEYIGQGSEAFF	TRBV25-1	TRBJ1-1
TGTGCCAGCAGGGGACGACACACCATATATTTT	CASRGRHTIYF	TRBV6-3	TRBJ1-3
TGTGCCAGCAGCCAGGGGGGCTACGAGCAGTACTTC	CASSQGGYEQYF	TRBV3-1	TRBJ2-7
TGCGCCAGCAGTGACCTTAGGGGGCTTCGTTGGGGGACGCCCCCCTACGAGCAGTACTTC	CASSDLRGLRWGTPPYEQYF	TRBV10-1	TRBJ2-7
TGTGCCAGCAGTTTACACGGACAGACTAACTATGGCTACACCTTC	CASSLHGQTNYGYTF	TRBV12-4	TRBJ1-2
TGTGCCAGCAGCTTGAAACAGCATGAGCAGTTCTTC	CASSLKQHEQFF	TRBV5-5	TRBJ2-1
TGTGCCATCAGTGGTTACAGGGGGCGGGGGTGTAAAGAAAAACTGTTTTTT	CAISGYRGRGCKEKLFF	TRBV10-3	TRBJ1-4
TGTGCCAGCAGCTTAATTAACGAGCTCAGGGACACGGACGAGCAGTACTTC	CASSLINELRDTDEQYF	TRBV7-3	TRBJ2-7
TGTGCCAGCAGTTACTCTTCACAGGGCTATGGCTACACCTTC	CASSYSSQGYGYTF	TRBV6-2	TRBJ1-2
TGTGCCAGCAGCGTCATGACAGGAACCCACCGGGCGAACACTGAAGCTTTCTTT	CASSVMTGTHRANTEAFF	TRBV11-2	TRBJ1-1
TGTGCCAGCAGCCCGGGGGGGCGCCGAATCGGGGGCTACACCTTC	CASSPGGRRIGGYTF	TRBV11-1	TRBJ1-2
TGTGCCAGCAGCGACCAAGCAGGCGTATCCTACGAGCAGTACTTC	CASSDQAGVSYEQYF	TRBV7-9	TRBJ2-7
TGTGCCTGGAAACTTACCGACACTTCTGAAGCTTTCTTT	CAWKLTDTSEAFF	TRBV30	TRBJ1-1
TGTGCCAGCAGCCAAGAGAGGGACACTGAAGCTTTCTTT	CASSQERDTEAFF	TRBV14	TRBJ1-1
TGTGCCAGCCATCATCTGGGGTACGGATATACAGATACGCAGTATTTT	CASHHLGYGYTDTQYF	TRBV6-1	TRBJ2-3
TGTGCCAGCAGCATTTCACTGGGCACCGGGGAGCTGTTTTTT	CASSISLGTGELFF	TRBV27	TRBJ2-2
TGTGCCAGTAGTATGTTAACAGGGCCCGAAGATACGCAGTATTTT	CASSMLTGPEDTQYF	TRBV19	TRBJ2-3
TGTGCCAGCAGTGGGACAGGCTACGAGCAGTACTTC	CASSGTGYEQYF	TRBV27	TRBJ2-7
TGTGCCAGCAGCGACGGGCCTGGGAACACCGGGGAGCTGTTTTTT	CASSDGPGNTGELFF	TRBV13	TRBJ2-2
TGTGCCACGTACCGGTCTGGAAACACCATATATTTT	CATYRSGNTIYF	TRBV24-1	TRBJ1-3
TGTGCCAGCAGTCCGGTAACTCACATGAACACTGAAGCTTTCTTT	CASSPVTHMNTEAFF	TRBV28	TRBJ1-1
TGTGCCAGCAGCTTACAGACGGGGTTAAACAATCAGCCCCAGCATTTT	CASSLQTGLNNQPQHF	TRBV7-3	TRBJ1-5
TGTGCCAGCAGTCCCTCGCGGTTGGGCTACACCTTC	CASSPSRLGYTF	TRBV6-5	TRBJ1-2
TGCGCCAGCAGTGACGTGGGAGAAGGGAACACTGAAGCTTTCTTT	CASSDVGEGNTEAFF	TRBV10-1	TRBJ1-1
TGTGCCAGCAGCCGCCCGGGACTAGCGCAGGAGACCCAGTACTTC	CASSRPGLAQETQYF	TRBV14	TRBJ2-5
TGTGCCAGCAGCAGAAGAGGGGGGCCCGGGCAAGAGACCCAGTACTTC	CASSRRGGPGQETQYF	TRBV13	TRBJ2-5
TGTGCCACCAGTGGCTCTCCGGGACGTACTGGAAACACCATATATTTT	CATSGSPGRTGNTIYF	TRBV24-1	TRBJ1-3
TGTGCCAGCAGTTCCCAGGGCCCTAATGAAAAACTGTTTTTT	CASSSQGPNEKLFF	TRBV27	TRBJ1-4
TGTGCCAGCATCTACATCACCGGGGAGCTGTTTTTT	CASIYITGELFF	TRBV6-1	TRBJ2-2
TGTGCCAGCAGTGAGGTGCGGGCCTCAGGAAAAAATGAGCAGTTCTTC	CASSEVRASGKNEQFF	TRBV6-4	TRBJ2-1
TGTGCCAGCAGTGTAACCCAACAGCGCACCGGGGAGCTGTTTTTT	CASSVTQQRTGELFF	TRBV12-4	TRBJ2-2
TGTGCCAGCAGTTACTCACAGGGGGCGGCCACGGCCGATGAGCAGTTCTTC	CASSYSQGAATADEQFF	TRBV6-2	TRBJ2-1
TGTGCCAGTAGTATGCGAACCAATGCGCTTATCCCCTGGTCTGGGGCCAACGTCCTGACTTTC	CASSMRTNALIPWSGANVLTF	TRBV19	TRBJ2-6
TGTGCCAGCTCACATGGGGGGCCCCTCGAGCAGTACTTC	CASSHGGPLEQYF	TRBV18	TRBJ2-7
TGTGCCATCAGATCCCCCCAGACTAGCGGGGGGAGTAGCACAGATACGCAGTATTTT	CAIRSPQTSGGSSTDTQYF	TRBV10-3	TRBJ2-3
TGCGCCAGCAGCTTTTGGCCAGGGCTAGGGGGCTACACCTTC	CASSFWPGLGGYTF	TRBV5-1	TRBJ1-2
TGTGCCACGGACAGGGGGCTAGATCCCGGAGAGACCCAGTACTTC	CATDRGLDPGETQYF	TRBV7-9	TRBJ2-5
TGTGCCACCCCACAGGGCGACACTGAAGCTTTCTTT	CATPQGDTEAFF	TRBV6-6	TRBJ1-1
TGTGCCAGCAGCGAAGCTTATGAGCAGTTCTTC	CASSEAYEQFF	TRBV7-3	TRBJ2-1
TGTGCCAGCAGTTACAGGGACGCCGACTGGACCGAGTCCTATGGCTACACCTTC	CASSYRDADWTESYGYTF	TRBV6-5	TRBJ1-2
TGCAGTGCGCCAACTGGGGGGCTGGAGACCCAGTACTTC	CSAPTGGLETQYF	TRBV20-1	TRBJ2-5
TGTGCCAGCAGCTTGGTTGGAGACTTAACAGATACGCAGTATTTT	CASSLVGDLTDTQYF	TRBV7-9	TRBJ2-3
TGCGCCAGCGTGTACCACAGGGGGCGCCAGCCCCAGCATTTT	CASVYHRGRQPQHF	TRBV10-2	TRBJ1-5
TGTGCCAGCAGTTACTCCAGAAGGGGTGATAAAGACTATGGCTACACCTTC	CASSYSRRGDKDYGYTF	TRBV6-5	TRBJ1-2
TGTGCCAGCAGTTACGGGCGTTATGAAAAACTGTTTTTT	CASSYGRYEKLFF	TRBV6-6	TRBJ1-4
TGTGCCAGCATATTTAACCTCCCAGGGGCCAATCGCTACGAGCAGTACTTC	CASIFNLPGANRYEQYF	TRBV6-1	TRBJ2-7
TGCAGTGCTAGGGTAGCTGATACGCAGTATTTT	CSARVADTQYF	TRBV20-1	TRBJ2-3
TGTGCCAGTCCGCAGGGTTCGACCCAGTACTTC	CASPQGSTQYF	TRBV6-5	TRBJ2-5
TGTGCCAGCAGCGCCCAAGGCCGGGACAGGGGGCACGAGCAGTACTTC	CASSAQGRDRGHEQYF	TRBV7-9	TRBJ2-7
TGTGCCAGCAGCTTGAAGGCGAAAGGCTACGAGCAGTACTTC	CASSLKAKGYEQYF	TRBV13	TRBJ2-7
TGTGCCAGCAGCCGCGGGACTAGCGCGCTTGGGTACGAGCAGTACTTC	CASSRGTSALGYEQYF	TRBV7-4	TRBJ2-7
TGTGCCAGCAGCCAAGTTTCACGGGGAACGCGGTCTGAAGCTTTCTTT	CASSQVSRGTRSEAFF	TRBV14	TRBJ1-1
TGTGCCATCAGCATTTCCGAGGGGGCTAGTATGTACGAGCAGTACTTC	CAISISEGASMYEQYF	TRBV10-3	TRBJ2-7
TGCGCCAGCAGCATGACGGGCTATAATTCACCCCTCCACTTT	CASSMTGYNSPLHF	TRBV10-2	TRBJ1-6
TGCGCCAGCAGCCCGGGACCGATGAACACTGAAGCTTTCTTT	CASSPGPMNTEAFF	TRBV4-1	TRBJ1-1
TGCAGTGCTAGAGATCTAGGGCGGCCGGAGACCCAGTACTTC	CSARDLGRPETQYF	TRBV20-1	TRBJ2-5
TGTGCCAGCAGTTTGGGTGAGAGATACAATGAGCAGTTCTTC	CASSLGERYNEQFF	TRBV27	TRBJ2-1
TGTGCCAGCAGCAGCCTTTTGATAGGAGAGAGGGGCTCCTACAATGAGCAGTTCTTC	CASSSLLIGERGSYNEQFF	TRBV11-3	TRBJ2-1
TGCAGTGCTCTAACATCGACAGGGATAAATGGCTACACCTTC	CSALTSTGINGYTF	TRBV20-1	TRBJ1-2
TGTGCCACCAGTGCCAGGCCGGGTTTTCACAGGGGAATTTCCAACTACGAGCAGTACTTC	CATSARPGFHRGISNYEQYF	TRBV24-1	TRBJ2-7
TGTGCCACACTTGACAGGGAATACGAGCAGTACTTC	CATLDREYEQYF	TRBV7-6	TRBJ2-7
TGCGCCAGCAGTGAGGAATCGCGAAACTATGGCTACACCTTC	CASSEESRNYGYTF	TRBV10-1	TRBJ1-2
TGTGCCAGCAGCTTTCAGGAGGGACAGGGAGCTCACACTGAAGCTTTCTTT	CASSFQEGQGAHTEAFF	TRBV3-1	TRBJ1-1
TGTGCCAGCAGCTTATGTGCATGCGAAGGCAATCAGCCCCAGCATTTT	CASSLCACEGNQPQHF	TRBV11-1	TRBJ1-5
TGTGCCAGCAGCTTAGCGTTAAAACTAGGGGGAGAGCAGTTCTTC	CASSLALKLGGEQFF	TRBV7-9	TRBJ2-1
TGTGCCAGTACCCTCACAGGGGGATCTGAAGCTTTCTTT	CASTLTGGSEAFF	TRBV19	TRBJ1-1
TGTGCCAGCAGTGATCAGTGCTACGAGCAGTACTTC	CASSDQCYEQYF	TRBV6-4	TRBJ2-7
TGTGCCAGCAGTCCACCCTGGGGGGGCTACACCTTC	CASSPPWGGYTF	TRBV2	TRBJ1-2
TGTGCCAGCTCCATACTAGCGGGAGGCTTGGATGAGCAGTTCTTC	CASSILAGGLDEQFF	TRBV18	TRBJ2-1
TGTGCCAGTAGTCCCAAGTACGAACGAAACACCATATATTTT	CASSPKYERNTIYF	TRBV19	TRBJ1-3
TGTGCCAGCAGTTGGGATGGGGTGGGGAACACTGAAGCTTTCTTT	CASSWDGVGNTEAFF	TRBV6-9	TRBJ1-1
TGTGCCAGCTCACCACGAAGGGCCCATGGAGAAAAACTGTTTTTT	CASSPRRAHGEKLFF	TRBV18	TRBJ1-4
TGCGCCAGCAGTTGGAGTGGGACGGGGAGGCACTATGGCTACACCTTC	CASSWSGTGRHYGYTF	TRBV5-1	TRBJ1-2
TGTGCCAGCAGTGGACTAGCGGGCGAAAGGGGCATCGAGCAGTACTTC	CASSGLAGERGIEQYF	TRBV2	TRBJ2-7
TGTGCCAGCACCGGGGCGCTCGCGGAGGGAGGGAACACTGAAGCTTTCTTT	CASTGALAEGGNTEAFF	TRBV6-5	TRBJ1-1
TGTGCCAGCAGCCAAGATGGATGGACAGCCCCCACTGAAGCTTTCTTT	CASSQDGWTAPTEAFF	TRBV4-2	TRBJ1-1
TGTGCCAGCAGCCGGGGACGAGCCCTCCACTTT	CASSRGRALHF	TRBV9	TRBJ1-6
TGTGCCAGCAGCTTGGCGGGGTACCAAGAGACCCAGTACTTC	CASSLAGYQETQYF	TRBV5-5	TRBJ2-5
TGTGCCAGCAGTGATTACCGAAATAGGTTGCATAATGAAAAACTGTTTTTT	CASSDYRNRLHNEKLFF	TRBV6-4	TRBJ1-4
TGTGCCAGCAAGTTGAGGACAGGGGGGGGTGCCAAAAACATTCAGTACTTC	CASKLRTGGGAKNIQYF	TRBV5-6	TRBJ2-4
TGTGCCAGCAGCTTAGAATCTGGTACGGGACAGGAGATAGATTATTCACCCCTCCACTTT	CASSLESGTGQEIDYSPLHF	TRBV7-9	TRBJ1-6
TGCAGTGCTAGAGAGCAGGGTCCCTATCAGCCCCAGCATTTT	CSAREQGPYQPQHF	TRBV20-1	TRBJ1-5
TGTGCCAGCAGTTTGGAACTCACTTGTCGGCCGGGACAGAGAAATCAGCCCCAGCATTTT	CASSLELTCRPGQRNQPQHF	TRBV27	TRBJ1-5
TGTGCCAGCAGCTTAGGCGAGATTGACCCCTACGAGCAGTACTTC	CASSLGEIDPYEQYF	TRBV7-9	TRBJ2-7
TGTGCCAGCAGCCACGCCCCCTACGAGCAGTACTTC	CASSHAPYEQYF	TRBV7-2	TRBJ2-7
TGTGCCAGCAGCCGACCCGAGGGAATCTACGAGCAGTACTTC	CASSRPEGIYEQYF	TRBV5-8	TRBJ2-7
TGCGCCAGCAGCCTCGGTAAGGCGTACGAGCAGTACTTC	CASSLGKAYEQYF	TRBV10-1	TRBJ2-7
TGTGCCAGCAGCTTCGAGTACCCAGATACGCAGTATTTT	CASSFEYPDTQYF	TRBV13	TRBJ2-3
TGTGCCAGCAGTGGGGACCCCCGGTTCGAGACCCAGTACTTC	CASSGDPRFETQYF	TRBV27	TRBJ2-5
TGTGCCACGAGGCTAACAGGGGCCGGTGAAAAACTGTTTTTT	CATRLTGAGEKLFF	TRBV19	TRBJ1-4
TGTGCCAGCAGTTTACCGGGGGACCCAGGCTTGAGCTCCTACGAGCAGTACTTC	CASSLPGDPGLSSYEQYF	TRBV12-3	TRBJ2-7
TGTGCCAAAAGGTTACAGGGGGCGGGCTCCTACGAGCAGTACTTC	CAKRLQGAGSYEQYF	TRBV27	TRBJ2-7
TGCGCCAGCATGGCCCGGTTCTGGGACAAGGCTAATGAAAAACTGTTTTTT	CASMARFWDKANEKLFF	TRBV5-1	TRBJ1-4
TGTGCCAGCAGTGGGGACAGGCTCATGAACACTGAAGCTTTCTTT	CASSGDRLMNTEAFF	TRBV6-3	TRBJ1-1
TGCAGCGTTGAGGGGGGGAATTGTCTAACTACCTACAATGAGCAGTTCTTC	CSVEGGNCLTTYNEQFF	TRBV29-1	TRBJ2-1
TGCGCCAGCAGCAGGGGGGTGCGCAGGGGGAGCCGAGCAATGAACACTGAAGCTTTCTTT	CASSRGVRRGSRAMNTEAFF	TRBV5-1	TRBJ1-1
TGTGCCAGCAGCCGTAGGGACAGGAATGGGGCCAACGTCCTGACTTTC	CASSRRDRNGANVLTF	TRBV14	TRBJ2-6
TGCAGTGCTAGAGAAGTTTTAATAACTCCCGGGACAGGGAGCCCCGGGGAGCTGTTTTTT	CSAREVLITPGTGSPGELFF	TRBV20-1	TRBJ2-2
TGTGCCAGCAGTGGGGGGGGTGGACAGGGAGCCTTCTACGAGCAGTACTTC	CASSGGGGQGAFYEQYF	TRBV6-4	TRBJ2-7
TGCGCCAGCAGCTTGCATGGAGCCAGGGTCCGGTTAGTTTACGAGCAGTACTTC	CASSLHGARVRLVYEQYF	TRBV5-1	TRBJ2-7
TGTGCTAGTGGTTTGGGAGCGGGAGTAAAACTGTTTTTT	CASGLGAGVKLFF	TRBV12-5	TRBJ1-4
TGCGCCAGCAGCGTGACTCAAGGGGCGGGCATCTTGGGGCCCCAGCATTTT	CASSVTQGAGILGPQHF	TRBV5-1	TRBJ1-5
TGTGCCCTCCCCCCCAGGAGCAGGCCGGTGCCCCGCACTGAAGCTTTCTTT	CALPPRSRPVPRTEAFF	TRBV24-1	TRBJ1-1
TGCGCCAGCAGCCAAGTAATGCAGACTGGCCCACGTGGCCAAGAGACCCAGTACTTC	CASSQVMQTGPRGQETQYF	TRBV4-3	TRBJ2-5
TGTGCCAGCCTGGAGGGAGGGGGGGCGTCCTACGAGCAGTACTTC	CASLEGGGASYEQYF	TRBV27	TRBJ2-7
TGTGCCAGTAGTATAGACGGGCGTAGGAGCTCCTACGAGCAGTACTTC	CASSIDGRRSSYEQYF	TRBV19	TRBJ2-7
TGTGCCAGCAATCTAGTACCGTCCGGGACAGATGAGCAGTTCTTC	CASNLVPSGTDEQFF	TRBV27	TRBJ2-1
TGCGCCAGCAGCCAAGATGGTCGGAGCTATGGCTACACCTTC	CASSQDGRSYGYTF	TRBV4-1	TRBJ1-2
TGCGCCAGCAGGGAACGACCGGGTAATTCACCCCTCCACTTT	CASRERPGNSPLHF	TRBV4-3	TRBJ1-6
TGCGCCAGCAGCCCCAACATCGTCCCCGACGGCCGGGAGGGGAATGAGCAGTTCTTC	CASSPNIVPDGREGNEQFF	TRBV4-3	TRBJ2-1
TGTGCCAGCAGCCAAGAGGGGGGACCCTCCTACGAGCAGTACTTC	CASSQEGGPSYEQYF	TRBV14	TRBJ2-7
TGTGCCAGCAAGGTAGACGGGGCCTTGAACACTGAAGCTTTCTTT	CASKVDGALNTEAFF	TRBV6-5	TRBJ1-1
TGCGCCAGCAGCTTCCCAGTGGACGCGACTAGCGGGCGGGATGAGCAGTTCTTC	CASSFPVDATSGRDEQFF	TRBV5-1	TRBJ2-1
TGTGCCAGCAGCTCAGGACAGAGCCGTCCGACCCCTGACAGCTCCTACGAGCAGTACTTC	CASSSGQSRPTPDSSYEQYF	TRBV6-1	TRBJ2-7
TGTGCCAGCAGCCAAGAAGGACAGGGGAGGAACACTGAAGCTTTCTTT	CASSQEGQGRNTEAFF	TRBV3-1	TRBJ1-1
TGTGCCAGCAGCCAAGAATTTACCTGGAGGGGCGCAGATACGCAGTATTTT	CASSQEFTWRGADTQYF	TRBV4-2	TRBJ2-3
TGTGCCAGCAGCGTAGCGAAGCTCGGGACTAACTATGGCTACACCTTC	CASSVAKLGTNYGYTF	TRBV9	TRBJ1-2
TGTGCCAGCAGTTATCTACGGGACAGCTTAAACAGCTCCTACGAGCAGTACTTC	CASSYLRDSLNSSYEQYF	TRBV6-5	TRBJ2-7
TGTGCCAGCAGTCTTCCTCAGGGACTAGCGGGCACTAGCTACAATGAGCAGTTCTTC	CASSLPQGLAGTSYNEQFF	TRBV28	TRBJ2-1
TGCAGTGCTAGATGGGGGAACACTGAAGCTTTCTTT	CSARWGNTEAFF	TRBV20-1	TRBJ1-1
TGTGCCACCTTGAGACTAGCCTACGAGCAGTACTTC	CATLRLAYEQYF	TRBV24-1	TRBJ2-7
TGTGCCAGCATAGCAGCGGGTGGGGAGCTGTTTTTT	CASIAAGGELFF	TRBV6-6	TRBJ2-2
TGCACAGCAGGGGGGTCCCACGAGCAGTACTTC	CTAGGSHEQYF	TRBV20-1	TRBJ2-7
TGTGCCAGCAGTGAATCGGATCTGAACAGAGGGCGGGAGTCCTCTGGAAACACCATATATTTT	CASSESDLNRGRESSGNTIYF	TRBV2	TRBJ1-3
TGTGCCACCAGGGCCGGGACGGGATTGTGCTCTGGAAACACCATATATTTT	CATRAGTGLCSGNTIYF	TRBV24-1	TRBJ1-3
TGTGCCAGCAGCGTTCGGGGGGGTGGGTATCGAATGTACAATGAGCAGTTCTTC	CASSVRGGGYRMYNEQFF	TRBV9	TRBJ2-1
TGTGCCATAACACTAGCGGGTAAAGGAGGTTACAATGAGCAGTTCTTC	CAITLAGKGGYNEQFF	TRBV25-1	TRBJ2-1
TGTGCCAGCAGTGGTCCCGGGCAAGACACCGGGGAGCTGTTTTTT	CASSGPGQDTGELFF	TRBV2	TRBJ2-2
TGTGCCAGCAGCGCGCCGAGGGAAGGTGGTAATAATCAGCCCCAGCATTTT	CASSAPREGGNNQPQHF	TRBV5-4	TRBJ1-5
TGCGCCAGCAAACAGCGAGAGCAGTACTTC	CASKQREQYF	TRBV5-1	TRBJ2-7
TGTGCCAAGGGGAATTTTTTCGAGCAGTACTTC	CAKGNFFEQYF	TRBV6-1	TRBJ2-7
TGTGCCAGTGCCCCCCGCTATGAGCAGTTCTTC	CASAPRYEQFF	TRBV19	TRBJ2-1
TGTGCCTGGAGTGGGACGGCGACAGGGCAGGCCTCCTACAATGAGCAGTTCTTC	CAWSGTATGQASYNEQFF	TRBV30	TRBJ2-1
TGCGCCAGCAGCGCTGGACTAGCGGGCCCGGAGCTGTTTTTT	CASSAGLAGPELFF	TRBV5-1	TRBJ2-2
TGCAGTGCGGGCGGACAGCTGTTTGGCGTTCCTATTGCTAACTATGGCTACACCTTC	CSAGGQLFGVPIANYGYTF	TRBV20-1	TRBJ1-2
TGTGCCAGCAGCAAAGAACGCCCGTCGGACCCCACTTCAAAAGAGACCCAGTACTTC	CASSKERPSDPTSKETQYF	TRBV9	TRBJ2-5
TGTGCCACCAGTGTAAAAGGGGTTTATGGCTACACCTTC	CATSVKGVYGYTF	TRBV24-1	TRBJ1-2
TGTGCCAGCAGTATACGACAGGGGGGACCAACTAATGAAAAACTGTTTTTT	CASSIRQGGPTNEKLFF	TRBV12-3	TRBJ1-4
TGCGCCAGCAGCTTTAGCAGGGCTAACTATGGCTACACCTTC	CASSFSRANYGYTF	TRBV5-1	TRBJ1-2
TGTGCCAGCACAAGGGGGCCCAAGGGCTACAATGAGCAGTTCTTC	CASTRGPKGYNEQFF	TRBV6-2	TRBJ2-1
TGTGCCAGTAGTATAGATCTGCAGAATTCACCCCTCCACTTT	CASSIDLQNSPLHF	TRBV19	TRBJ1-6
TGCGCCAGCAGTGAGATCGTGGGAGGGCAAGAGACCCAGTACTTC	CASSEIVGGQETQYF	TRBV10-1	TRBJ2-5
TGCAGTGCTAGAGATCCGTTTCCAGCGTGCGAGCAGTACTTC	CSARDPFPACEQYF	TRBV20-1	TRBJ2-7
TGTGCCAGCAGTGACAGAAGGACGAACAGCACTGAAGCTTTCTTT	CASSDRRTNSTEAFF	TRBV6-4	TRBJ1-1
TGTGCCAGCAGGGAGGGGCATCATCAGCCCCAGCATTTT	CASREGHHQPQHF	TRBV6-5	TRBJ1-5
TGTGCCAGCAGTTCGGGGTCGGGTGCCCCAAGCTACGAGCAGTACTTC	CASSSGSGAPSYEQYF	TRBV27	TRBJ2-7
TGTGCCAGCAGCTTAAGGGGACAGCTATATAGCAATCAGCCCCAGCATTTT	CASSLRGQLYSNQPQHF	TRBV7-4	TRBJ1-5
TGTGCCAGCAGTGAAGTTCCCGGGAGGGGGCCGCATTTT	CASSEVPGRGPHF	TRBV6-1	TRBJ1-5
TGTGCCAGTAGTGCGCGGGGTCCCAAAGACAGCGACCGGGTGGACTATAATTCACCCCTCCACTTT	CASSARGPKDSDRVDYNSPLHF	TRBV19	TRBJ1-6
TGTGCTAGTGGTTTGGTATTCCCCATCCTATACGAGCAGTACTTC	CASGLVFPILYEQYF	TRBV12-5	TRBJ2-7
TGTGCCAGCAGCTTGGGACTATCACATGAGACCCAGTACTTC	CASSLGLSHETQYF	TRBV5-5	TRBJ2-5
TGTGCCAGCAGGAAAGACGACAGGGTGTTAACACATCAGCCCCAGCATTTT	CASRKDDRVLTHQPQHF	TRBV7-2	TRBJ1-5
TGTGCCAGGACGGGACCAAATAGAACTGGAAACACCATATATTTT	CARTGPNRTGNTIYF	TRBV7-9	TRBJ1-3
TGCGCCAGCAGTGAGCTGGTGGCCTCGACCGAGACCCAGTACTTC	CASSELVASTETQYF	TRBV10-1	TRBJ2-5
TGTGTAATAGACTACGCCAACTACGAGCAGTACTTC	CVIDYANYEQYF	TRBV5-6	TRBJ2-7
TGCAGTGCTAGAGAAGGACTAGCTGGCTACACCTTC	CSAREGLAGYTF	TRBV20-1	TRBJ1-2
TGTGCCAGCAGCCAGACGGGGCGTTACAATGAGCAGTTCTTC	CASSQTGRYNEQFF	TRBV7-7	TRBJ2-1
TGTGCCAGTACTATACGGGGGGGCGGTAACTATAATTCACCCCTCCACTTT	CASTIRGGGNYNSPLHF	TRBV19	TRBJ1-6
TGTGCCAGCAGTGTCAGGACCCGGGACAGCGGGAGAAACACCATATATTTT	CASSVRTRDSGRNTIYF	TRBV12-4	TRBJ1-3
TGTGCCAGCAGTGACGAAAGCGGGACAGCGTGGGCGGGTCAGCCCCAGCATTTT	CASSDESGTAWAGQPQHF	TRBV6-4	TRBJ1-5
TGTGCCAGCAGCCGACTAGCGGGAGTGTTCACAGATACGCAGTATTTT	CASSRLAGVFTDTQYF	TRBV13	TRBJ2-3
TGTGCCAGCAGGTGGACAGGGCGGTTCTCCAGTATTAACACTGAAGCTTTCTTT	CASRWTGRFSSINTEAFF	TRBV2	TRBJ1-1
TGTGCCAGCAGCCCGACAGGGAGAGCGTATGGCTACACCTTC	CASSPTGRAYGYTF	TRBV6-2	TRBJ1-2
TGTGCCAGCAGCACTGGGGTTACGTATAGCAATCAGCCCCAGCATTTT	CASSTGVTYSNQPQHF	TRBV7-9	TRBJ1-5
TGTGCCAGCAGCTTACGGACAGAGTATTTT	CASSLRTEYF	TRBV7-3	TRBJ1-3
TGCAGTGCGCCAGGGGGAGAAGAGACCCAGTACTTC	CSAPGGEETQYF	TRBV20-1	TRBJ2-5
TGTGCCACCAGTGATTTTGGGGGCCCCGCTGAGACCCAGTACTTC	CATSDFGGPAETQYF	TRBV24-1	TRBJ2-5
TGTGCCAGCAGCTTGGACATGGGCAGGGGCCCCGATCTATGCGTCGAGCAGTACTTC	CASSLDMGRGPDLCVEQYF	TRBV5-6	TRBJ2-7
TGCAGTGCTGTATCTAGACGTATAGCCAAAAACATTCAGTACTTC	CSAVSRRIAKNIQYF	TRBV20-1	TRBJ2-4
TGTGCCACCAGTGATACCGGGACTAGCGGGACTGCTAGCACAGATACGCAGTATTTT	CATSDTGTSGTASTDTQYF	TRBV24-1	TRBJ2-3
TGTGCCAGCAGCCTATTCCTGAGTCCGAACACTGAAGCTTTCTTT	CASSLFLSPNTEAFF	TRBV14	TRBJ1-1
TGTGCCAGCCCCCAAGCGGGAGGGAGGTACAATGAGCAGTTCTTC	CASPQAGGRYNEQFF	TRBV18	TRBJ2-1
TGCGCCAGCAGCTTGCCTAGACCTTCAGATACGCAGTATTTT	CASSLPRPSDTQYF	TRBV5-1	TRBJ2-3
TGTGCCAGCAGCAGACAGGTGGGCTACGAGCAGTACTTC	CASSRQVGYEQYF	TRBV7-8	TRBJ2-7
TGTGCCAGCAGCTCCACGGAGGCAAGTGAGACCCAGTACTTC	CASSSTEASETQYF	TRBV11-2	TRBJ2-5
TGTGCCAGCAGTGAATCGAGTCCGGCGATTACGGTTTACGAGCAGTACTTC	CASSESSPAITVYEQYF	TRBV2	TRBJ2-7
TGCAGTGCTAGCTTAGGACAGGGTCCTGCAACTAATGAAAAACTGTTTTTT	CSASLGQGPATNEKLFF	TRBV20-1	TRBJ1-4
TGTGCCAGCAGTGAAGGCAGGGGTGGACAAGAGACCCAGTACTTC	CASSEGRGGQETQYF	TRBV27	TRBJ2-5
TGTGCCAGCAGTGTCGGTTACGCCCAAGAGACCCAGTACTTC	CASSVGYAQETQYF	TRBV6-5	TRBJ2-5
TGTGCCAGCAGCTTAAACGAAGCCGCAGGGACAGGGTCACTTATCTACGAGCAGTACTTC	CASSLNEAAGTGSLIYEQYF	TRBV7-7	TRBJ2-7
TGTGCCAGCAGCGAAGAGGAGGGGATGAACACTGAAGCTTTCTTT	CASSEEEGMNTEAFF	TRBV7-7	TRBJ1-1
TGTGCCAGCGACCGGGACAGGGGGGACCGCTATGGCTACACCTTC	CASDRDRGDRYGYTF	TRBV9	TRBJ1-2
TGTGCCAGCAGTGAATTGAACACTGAAGCTTTCTTT	CASSELNTEAFF	TRBV25-1	TRBJ1-1
TGTGCCAGCAGGAACCCCGGATCCTCCTACAATGAGCAGTTCTTC	CASRNPGSSYNEQFF	TRBV7-2	TRBJ2-1
TGTGCCTGGAAACGACAGGGGGCTTTCTTT	CAWKRQGAFF	TRBV30	TRBJ1-1
TGTGCCAGCAGCTTACTAGCCGGGACATTAGAAAGGGCAGTGAACACTGAAGCTTTCTTT	CASSLLAGTLERAVNTEAFF	TRBV11-3	TRBJ1-1
TGTGCCAGCAGTGGGGGCGGCGACTATGGCTACACCTTC	CASSGGGDYGYTF	TRBV6-1	TRBJ1-2
TGTGCCAGCAGCATTCCGGGGGAGTGGCAAGAGACCCAGTACTTC	CASSIPGEWQETQYF	TRBV7-9	TRBJ2-5
TGTGCCAGCAGCCTAAGGCATTGCTCCTACGAGCAGTACTTC	CASSLRHCSYEQYF	TRBV7-3	TRBJ2-7
TGTGCCAGCGGCACGCCCGGGGCGAGGGGGGCCCGGATTTACACCGGGGAGCTGTTTTTT	CASGTPGARGARIYTGELFF	TRBV13	TRBJ2-2
TGTGCCACCAGTGATTTAAAACCCTTCACCAGGTGTCCCAGTGCCCAGTACTTC	CATSDLKPFTRCPSAQYF	TRBV24-1	TRBJ2-5
TGTGCCAGCAGTCCTTTCCCAAAGCAGGAGAACACTGAAGCTTTCTTT	CASSPFPKQENTEAFF	TRBV28	TRBJ1-1
TGTGCCAGCAGCCTCTCGGTTCGGGACGAGCAAGAGACCCAGTACTTC	CASSLSVRDEQETQYF	TRBV4-2	TRBJ2-5
TGTGCCAGCAGTGAAGCCCCCCAGGGTTTGCGAATTCACAATCAGCCCCAGCATTTT	CASSEAPQGLRIHNQPQHF	TRBV6-1	TRBJ1-5
TGCAGTGCTTCAAGGTCCTACGAGCAGTACTTC	CSASRSYEQYF	TRBV20-1	TRBJ2-7
TGCGCCAGCAATGAGGGGAAACCGGGTCCCAATCAGCCCCAGCATTTT	CASNEGKPGPNQPQHF	TRBV10-1	TRBJ1-5
TGTGCCAGCGGTACGGGACTAGAAAAACTGTTTTTT	CASGTGLEKLFF	TRBV6-1	TRBJ1-4
TGCGCCAGCAGTCTATGCCCTGCAGGGTGCGCCTACGAGCAGTACTTC	CASSLCPAGCAYEQYF	TRBV10-1	TRBJ2-7
TGCGCCAGCAGTGAACAGGTGTCCTACGAGCAGTACTTC	CASSEQVSYEQYF	TRBV10-1	TRBJ2-7
TGCAGCGTAGGCCCTACAGGGCCAGATACGCAGTATTTT	CSVGPTGPDTQYF	TRBV29-1	TRBJ2-3
TGCGCCAGCAGCGGGGGGGAGACCCAGTACTTC	CASSGGETQYF	TRBV5-1	TRBJ2-5
TGCGCCAGCAGCTTGTCCGGACAGGCCGTTAACTATGGCTACACCTTC	CASSLSGQAVNYGYTF	TRBV5-1	TRBJ1-2
TGTGCCAGCAGTTATCCCTCAACGGGACAGGGGGGGCACGAGCAGTACTTC	CASSYPSTGQGGHEQYF	TRBV6-2	TRBJ2-7
TGTGCCAGCAGTGAGCGATGGGAACGGAATCAGCCCCAGCATTTT	CASSERWERNQPQHF	TRBV6-4	TRBJ1-5
TGCGCCAGCGCTGGGAGAGGTCCTCGGGAAGAGACCCAGTACTTC	CASAGRGPREETQYF	TRBV10-1	TRBJ2-5
TGCAGCCGCCGGGACACGTCTGGAAACACCATATATTTT	CSRRDTSGNTIYF	TRBV29-1	TRBJ1-3
TGCAGTGCTAGACTTCCTCGGCTCTGTAAGCAGTTCTTC	CSARLPRLCKQFF	TRBV20-1	TRBJ2-1
TGTGCCAGCAGCTTCCGGACTAGCGGGAGTCTCCAAGAGACCCAGTACTTC	CASSFRTSGSLQETQYF	TRBV5-8	TRBJ2-5
TGTGCCAGCAGCGTAGCTACGGGGCTCCCTTACGAGCAGTACTTC	CASSVATGLPYEQYF	TRBV9	TRBJ2-7
TGTGCCAGCAGTACTATAGGGGGGGGCGGCCTTGGTGATCCTTGCAATGAGCAGTTCTTC	CASSTIGGGGLGDPCNEQFF	TRBV27	TRBJ2-1
TGTGCCAGCAGCTTGTGGAGGTCAGATACGCAGTATTTT	CASSLWRSDTQYF	TRBV5-5	TRBJ2-3
TGTGCCAGCAGTGAAACGCAGCCGGTGGGGGCCAACGTCCTGACTTTC	CASSETQPVGANVLTF	TRBV6-1	TRBJ2-6
TGTGCCAGCTCACACAGGGAGGGAGCTAACTATGGCTACACCTTC	CASSHREGANYGYTF	TRBV18	TRBJ1-2
TGTGCCAGCAGCTTCATGACAGGGGAGCGGGGGGGCACAGATACGCAGTATTTT	CASSFMTGERGGTDTQYF	TRBV11-2	TRBJ2-3
TGTGCCATCAACGCAGAAGTTACCAGGGTTGGAGCGTATGAAAAACTGTTTTTT	CAINAEVTRVGAYEKLFF	TRBV10-3	TRBJ1-4
TGCGCCAGCAGCTCGAGGGGGACAGATCCTATAGGCACCGGGGAGCTGTTTTTT	CASSSRGTDPIGTGELFF	TRBV5-1	TRBJ2-2
TGTGCCAGCAGTGACTCGGGGCCGGTTGAGCAGTTCTTC	CASSDSGPVEQFF	TRBV6-4	TRBJ2-1
TGTGCCACCAGTGAGGGGGGTCATGGCTACACCTTC	CATSEGGHGYTF	TRBV24-1	TRBJ1-2
TGTGCCAGCAGTACGGTGGACACTGAAGCTTTCTTT	CASSTVDTEAFF	TRBV6-4	TRBJ1-1
TGCGCCAGCAGTACTTCATGGACCTATGGCTACACCTTC	CASSTSWTYGYTF	TRBV10-1	TRBJ1-2
TGTGCCAGTAGGAATGGACAGCGGGATCCCCCGGAGGCTTTCTTT	CASRNGQRDPPEAFF	TRBV19	TRBJ1-1
TGTGCCAGCAGTCGGGGTCCCGGACAGGGGGGAACTGAAGCTTTCTTT	CASSRGPGQGGTEAFF	TRBV27	TRBJ1-1
TGCAGTGCTAGAGGGGACAGGCGCTATGGCTACACCTTC	CSARGDRRYGYTF	TRBV20-1	TRBJ1-2
TGTGCCATCCCAGGAAGCTTC	CAIPGSF	TRBV6-2	TRBJ1-2
TGCGCCAGCAGCTTATCGGAGGACAGGGGGAGCTACGAGCAGTACTTC	CASSLSEDRGSYEQYF	TRBV5-1	TRBJ2-7
TGTGCCAGCACACTAGCGGGTGTGCCAGATACGCAGTATTTT	CASTLAGVPDTQYF	TRBV6-2	TRBJ2-3
TGTGCCAGCAGTTACTGCCCGGACAGGGACACTGAAGCTTTCTTT	CASSYCPDRDTEAFF	TRBV6-2	TRBJ1-1
TGCGCCAGCCGGGCTGAGGAATGCACAGATACGCAGTATTTT	CASRAEECTDTQYF	TRBV10-1	TRBJ2-3
TGTGCCAGCAGCGAGACCGGGACACGAAAAAACTACGAGCAGTACTTC	CASSETGTRKNYEQYF	TRBV11-3	TRBJ2-7
TGCAGTGCTAGAAACAGGGGTAGAAATCAGCCCCAGCATTTT	CSARNRGRNQPQHF	TRBV20-1	TRBJ1-5
TGCGCCAGCAGCAGCGGGACCCCCTCCTACGAGCAGTACTTC	CASSSGTPSYEQYF	TRBV4-3	TRBJ2-7
TGCGCCAGCAGCGCGGGGGGGTACAGGGGAGTGCGTAGCACAGATACGCAGTATTTT	CASSAGGYRGVRSTDTQYF	TRBV5-1	TRBJ2-3
TGTGCCAGCAGCCAAGAGATGGGAGCGGAACGTAGCACCTACGAGCAGTACTTC	CASSQEMGAERSTYEQYF	TRBV3-1	TRBJ2-7
TGTGCCAGCAGTTCCTTTAATCATCAGGGACAGCGTGAAGCTTTCTTT	CASSSFNHQGQREAFF	TRBV27	TRBJ1-1
TGTGCCAGCAGCTATCAGGGCCATGGCTACACCTTC	CASSYQGHGYTF	TRBV13	TRBJ1-2
TGCAGCGTTGACTTCTCGGGCTACGAGCAGTACTTC	CSVDFSGYEQYF	TRBV29-1	TRBJ2-7
TGTGCCACGAGTGGAAATACGCAGGGCTCTGGGGCCAACGTCCTGACTTTC	CATSGNTQGSGANVLTF	TRBV19	TRBJ2-6
TGTGCCAGCAGTCGAAGGGCCCGGGGGGGCTACAATGAGCAGTTCTTC	CASSRRARGGYNEQFF	TRBV28	TRBJ2-1
TGTGCCAGCAGTTACTGCCATGGGCCATACAATGAGCAGTTCTTC	CASSYCHGPYNEQFF	TRBV6-5	TRBJ2-1
TGTGCCAGCAGCCACGGATTTGCGCAGTACTTC	CASSHGFAQYF	TRBV7-9	TRBJ2-7
TGTGCCAGCAGTTTTTGTCCGGACAGGTTCTTTTACGAGCAGTACTTC	CASSFCPDRFFYEQYF	TRBV12-4	TRBJ2-7
TGTGCCAGCAGCGAATTTCTTATACCCTACGAGCAGTACTTC	CASSEFLIPYEQYF	TRBV9	TRBJ2-7
TGTGCCAGCAGCGTACCTAGCGGGTACGAGCAGTACTTC	CASSVPSGYEQYF	TRBV13	TRBJ2-7
TGTGCCAGCAGTTCCAGGGGTAACGTTGGGGCCAACGTCCTGACTTTC	CASSSRGNVGANVLTF	TRBV27	TRBJ2-6
TGCGCCAGCAGCTGCCCTACGGTTGGTGAGCAGTTCTTC	CASSCPTVGEQFF	TRBV5-1	TRBJ2-1
TGTGCCAGCAGCCGTCCGGGACAGGGGTACGAGCAGTACTTC	CASSRPGQGYEQYF	TRBV7-3	TRBJ2-7
TGTGCCAGCAGCCAAGGGACAGACAACTATGGCTACACCTTC	CASSQGTDNYGYTF	TRBV7-3	TRBJ1-2
TGCGCCAGCAGCTTGAACGGCGGTACGAACACCGGGGAGCTGTTTTTT	CASSLNGGTNTGELFF	TRBV5-1	TRBJ2-2
TGTGCCAGCAGCGTTGAGGGTTCGAGGGCCCTTCGAACACCAAATCAGCCCCAGCATTTT	CASSVEGSRALRTPNQPQHF	TRBV13	TRBJ1-5
TGTGCCAGCAGCTTGTTGCACCCAGGCCCCCAGGGGAGGGATTCACCCCTCCACTTT	CASSLLHPGPQGRDSPLHF	TRBV5-4	TRBJ1-6
TGCAGTGCTAGCGGCCCCTGGCGGGGGCCCCGTTCTGGGGCCAACGTCCTGACTTTC	CSASGPWRGPRSGANVLTF	TRBV20-1	TRBJ2-6
TGTGCCAGCAGCAGAATCATCATCTCCTACGAGCAGTACTTC	CASSRIIISYEQYF	TRBV9	TRBJ2-7
TGTGCCAGCAGGGGGGCAGATACGCAGTATTTT	CASRGADTQYF	TRBV5-4	TRBJ2-3
TGCGCCAGCAGGGCTGGGGTCTTC	CASRAGVF	TRBV10-1	TRBJ2-1
TGTGCCAGCAGTCACAAAGTCGAGACTTACGAGCAGTACTTC	CASSHKVETYEQYF	TRBV27	TRBJ2-7
TGTGCCAGCAGGACAGGAGGGGCTTTCTTT	CASRTGGAFF	TRBV7-3	TRBJ1-1
TGTGCCAGCAGTTCATTCTCTAGGAACACTGAAGCTTTCTTT	CASSSFSRNTEAFF	TRBV6-5	TRBJ1-1
TGCGCCAGCAGGGGAGCCTACCTACTAGCCAAAAACATTCAGTACTTC	CASRGAYLLAKNIQYF	TRBV10-1	TRBJ2-4
TGCAGTGCTAACCCCGTAGGCCATGATACGCAGTATTTT	CSANPVGHDTQYF	TRBV20-1	TRBJ2-3
TGCGCCAGCAGTGACTTCTTCACAGGCCCACTAAGCAATCAGCCCCAGCATTTT	CASSDFFTGPLSNQPQHF	TRBV10-1	TRBJ1-5
TGTGCCAGCAGCCACCAGGGTCAAGAGACCCAGTACTTC	CASSHQGQETQYF	TRBV7-4	TRBJ2-5
TGTGCCAGCAGCCAATCACCAGACGAGCAGTACTTC	CASSQSPDEQYF	TRBV3-1	TRBJ2-7
TGTGCCAGCAGGTTTCGGACTGCATCAGATACGCAGTATTTT	CASRFRTASDTQYF	TRBV6-8	TRBJ2-3
TGCGCCAGCAGCCAAGAGGGTGCGTTCTGGCGGACCTACAATGAGCAGTTCTTC	CASSQEGAFWRTYNEQFF	TRBV4-1	TRBJ2-1
TGTGCCAGCACGGGGCGAAATGGCTACACCTTC	CASTGRNGYTF	TRBV7-2	TRBJ1-2
TGTGCCAGCAGTTTCGTCCAGGCATACCTGTACGAGCAGTACTTC	CASSFVQAYLYEQYF	TRBV12-4	TRBJ2-7
TGCGCCAGCAGCGTAAAAGACAGGGGGTACGAGCAGTACTTC	CASSVKDRGYEQYF	TRBV5-1	TRBJ2-7
TGTGCCAGCAGCCAAGACGGCTCCTACGAGCAGTACTTC	CASSQDGSYEQYF	TRBV14	TRBJ2-7
TGTGCCAGCAGTCAATACCGGGAGGAGATCTTTGGGTATGAGCAGTTCTTC	CASSQYREEIFGYEQFF	TRBV27	TRBJ2-1
TGCGCCAGCAGCCGAGACCGGGACAGGGCGGGCTACGAGCAGTACTTC	CASSRDRDRAGYEQYF	TRBV4-3	TRBJ2-7
TGTGCCAGCAGCTCACCCGGGGGGGTAGTTGGCTACACCTTC	CASSSPGGVVGYTF	TRBV7-6	TRBJ1-2
TGTGCCAGCAGCCCGACCGGACAGGTTATAGAAAAACTGTTTTTT	CASSPTGQVIEKLFF	TRBV7-6	TRBJ1-4
TGTGCCAGCAGCCAAGGATATGAAACCCGTCGATCTCTAGCCAAAAACATTCAGTACTTC	CASSQGYETRRSLAKNIQYF	TRBV3-1	TRBJ2-4
TGTGCCAGCAGTTCCCAGGCCTACGAGCAGTACTTC	CASSSQAYEQYF	TRBV6-5	TRBJ2-7
TGTGCCAGCAGCTTAGGCGAGCAGTACTTC	CASSLGEQYF	TRBV7-6	TRBJ2-7
TGTGCCAGCAGACCCCCGGGGCCCGAGACCCAGTACTTC	CASRPPGPETQYF	TRBV6-5	TRBJ2-5
TGTGCCATCAGTGTGCCCCCTGTCGGTGGAAATGGCTACACCTTC	CAISVPPVGGNGYTF	TRBV10-3	TRBJ1-2
TGTGCCAGCAGTTACACCCGGGAGGGACAGGGCTTTAGGTACCTGGAGGGCTACACCTTC	CASSYTREGQGFRYLEGYTF	TRBV6-5	TRBJ1-2
TGTGCCAGCACCAGTCAGAGATCACTGTTTTTT	CASTSQRSLFF	TRBV6-4	TRBJ1-4
TGTGCCAGTAGTATGCGACCGAATCCCCAGGGACAGTCTTCACCCCTCCACTTT	CASSMRPNPQGQSSPLHF	TRBV19	TRBJ1-6
TGTGCCAGCAGTGTTACTAGCGGGAGGGGGTGCTCCTACAATGAGCAGTTCTTC	CASSVTSGRGCSYNEQFF	TRBV2	TRBJ2-1
TGTGCCAGCAGCCGAGCGGATGGCCGGCAAGAGACCCAGTACTTC	CASSRADGRQETQYF	TRBV9	TRBJ2-5
TGTGCCACCCGGACCGATGGCTACACCTTC	CATRTDGYTF	TRBV24-1	TRBJ1-2
TGTGCCAGCAGTATATCGGGACAGGGGGGCTCTGGGGCCAACGTCCTGACTTTC	CASSISGQGGSGANVLTF	TRBV28	TRBJ2-6
TGCAGTGCTGGACAGGGGTTACCCTACAATGAGCAGTTCTTC	CSAGQGLPYNEQFF	TRBV20-1	TRBJ2-1
TGTGCCAGCAGCCCCGGGACTAGAAATGAGCAGTTCTTC	CASSPGTRNEQFF	TRBV9	TRBJ2-1
TGTGCCAGTTCACCAATGACGACATTCTCCTACGAGCAGTACTTC	CASSPMTTFSYEQYF	TRBV19	TRBJ2-7
TGTGCCAGCAGGGGAACGGTACGGGACAGGGCTTTTAGCAATCAGCCCCAGCATTTT	CASRGTVRDRAFSNQPQHF	TRBV12-3	TRBJ1-5
TGCGCCAGCAGCTTGGAGGATGGTAGAGGGAAGGACAGCGGACCCGGGGAGCTGTTTTTT	CASSLEDGRGKDSGPGELFF	TRBV5-1	TRBJ2-2
TGTGCCAGCAGCGGTTATCCTCAGCAGGGGACCCTCAATGAGCAGTTCTTC	CASSGYPQQGTLNEQFF	TRBV7-3	TRBJ2-1
TGTGCCATCATCTCCCAGACGGGGCCTCAGTATTTT	CAIISQTGPQYF	TRBV10-3	TRBJ2-3
TGTGCCAGCAGTTACGGGGGCTGGAACGAGCAGTACTTC	CASSYGGWNEQYF	TRBV6-5	TRBJ2-7
TGTGCCAGCAGTGAAGGAGACAGGGGGCTTCCCCCGATCAATTCACCCCTCCACTTT	CASSEGDRGLPPINSPLHF	TRBV6-4	TRBJ1-6
TGTGCCAGCAGTTCTTTCCCAGCGGGAAATACTGAAGCTTTCTTT	CASSSFPAGNTEAFF	TRBV27	TRBJ1-1
TGTGCCACCAGTCTCCTCGGGGGCTCTGGAAACACCATATATTTT	CATSLLGGSGNTIYF	TRBV24-1	TRBJ1-3
TGTGCCAGCAGTGACACCCCTCGGAAGGGGGACACCTTC	CASSDTPRKGDTF	TRBV6-4	TRBJ1-2
TGTGCCAGCAGTTTCTGGACTACCAGCCGAGGCACAGATACGCAGTATTTT	CASSFWTTSRGTDTQYF	TRBV28	TRBJ2-3
TGTGCCAGCAGCGGTGCAGAAGGCTATGGCTACACCTTC	CASSGAEGYGYTF	TRBV5-8	TRBJ1-2
TGTGCCAGCAGTGACTCGACCCTCGGGTACGAGCAGTACTTC	CASSDSTLGYEQYF	TRBV6-4	TRBJ2-7
TGCGCCAGTCGCGGACTAGAAGAGACCCAGTACTTC	CASRGLEETQYF	TRBV4-1	TRBJ2-5
TGTGGCGACAAGCGGTCCCAAGAGACCCAGTACTTC	CGDKRSQETQYF	TRBV28	TRBJ2-5
TGTGCCAGCATGGACAGGGACTACGAATCCTACGAGCAGTACTTC	CASMDRDYESYEQYF	TRBV9	TRBJ2-7
TGTGCCAGCAGCTTGGAGGGGAGTCGAGAGGTCAATGAGCAGTTCTTC	CASSLEGSREVNEQFF	TRBV7-9	TRBJ2-1
TGCGCCAGCAGTTTAGGGGCTCGGGACACTGAAGCTTTCTTT	CASSLGARDTEAFF	TRBV10-2	TRBJ1-1
TGTGCCACCAATCATGGACAGGAAAACTCGGAATCATCCTACGAGCAGTACTTC	CATNHGQENSESSYEQYF	TRBV6-1	TRBJ2-7
TGCGCCAGCAGGCAAAGCGTGCACTTCACAGATACGCAGTATTTT	CASRQSVHFTDTQYF	TRBV5-1	TRBJ2-3
TGCGCCAGCAGCCCCTTGTCCGCCGGGGGTAGGGGGAACGAGCAGTACTTC	CASSPLSAGGRGNEQYF	TRBV4-1	TRBJ2-7
TGTGCCAGGCCCGAGTATGGCTACACCTTC	CARPEYGYTF	TRBV7-3	TRBJ1-2
TGTGCCAGCAGTGACCCTGGGATCTGGGGGGGGTGGGGGGAAGTCTACGAGCAGTACTTC	CASSDPGIWGGWGEVYEQYF	TRBV6-4	TRBJ2-7
TGTGCCAGCAGCTTGGGCCTCAGGACCCAGACTGAAGCTTTCTTT	CASSLGLRTQTEAFF	TRBV5-4	TRBJ1-1
TGTGCCAGCAGCCAAGATAAAGACAGGGACTATGGCTACACCTTC	CASSQDKDRDYGYTF	TRBV14	TRBJ1-2
TGTGCCAGCAGTTGGGGGCGCCCTTACACCTTC	CASSWGRPYTF	TRBV6-9	TRBJ1-2
TGTGCCAGCAGTTACGGGAGAGGAGGCTACGAGCAGTACTTC	CASSYGRGGYEQYF	TRBV6-5	TRBJ2-7
TGCGCCAGCAAATCCGCCAGGGTAAGAAACTATGGCTACACCTTC	CASKSARVRNYGYTF	TRBV10-1	TRBJ1-2
TGCGCCAGCAGTTGGGCGAGCAGAGCCGGGGAGCTGTTTTTT	CASSWASRAGELFF	TRBV10-1	TRBJ2-2
TGCAGTGCTAGAGATGACGCGGGGTTCACTGAAGCTTTCTTT	CSARDDAGFTEAFF	TRBV20-1	TRBJ1-1
TGTGCCAGCAGCGGGGGTTGCTATCGGGGTTACAATGAGCAGTTCTTC	CASSGGCYRGYNEQFF	TRBV13	TRBJ2-1
TGTGCCAGCAGCGGCAGGCACACCACAACGCGGGGTGCTGATACGCAGTATTTT	CASSGRHTTTRGADTQYF	TRBV5-4	TRBJ2-3
TGTGCCAGTAGTGACAGGGGCCTAGTTGATACGCAGTATTTT	CASSDRGLVDTQYF	TRBV19	TRBJ2-3
TGTGCCACCAGTGAACGGGGGCCACTGAATGAGCAGTTCTTC	CATSERGPLNEQFF	TRBV24-1	TRBJ2-1
TGTGCCTTCTGGGGGCGGAGAGCGGGGAATGAGCAGTTCTTC	CAFWGRRAGNEQFF	TRBV11-2	TRBJ2-1
TGTGCCAGCAGCTTAGGACAGGGCTGTATGTATGGCTACACCTTC	CASSLGQGCMYGYTF	TRBV7-3	TRBJ1-2
TGTGCCAGCATCCAAAGGACCCTACCTTCCTCTGGAAACACCATATATTTT	CASIQRTLPSSGNTIYF	TRBV27	TRBJ1-3
TGTGCCAGCAGCGTGTACACCCCCTGTTTTAAAGCCAAAAACATTCAGTACTTC	CASSVYTPCFKAKNIQYF	TRBV9	TRBJ2-4
TGCAGTGCTAGAGATCCTAGCAAGGACAGAGCTAACTATGGCTACACCTTC	CSARDPSKDRANYGYTF	TRBV20-1	TRBJ1-2
TGCGCCAGCAGGACAGGCAATCAGCCCCAGCATTTT	CASRTGNQPQHF	TRBV10-1	TRBJ1-5
TGCGCCAGCAGGTCACCCCCCTCAGGGACTAGAGAGAGCACCGGGGAGCTGTTTTTT	CASRSPPSGTRESTGELFF	TRBV5-1	TRBJ2-2
TGCGCCAGCGCCAAGGAGACTAGCGGGGACTCCTACAATGAGCAGTTCTTC	CASAKETSGDSYNEQFF	TRBV10-1	TRBJ2-1
TGTGCCAGCACGCCCAGGGGGGTTTTCTACGAGCAGTACTTC	CASTPRGVFYEQYF	TRBV12-4	TRBJ2-7
TGTGCCAGCATTGACAGAGGGGCTGAAAAATATGGCTACACCTTC	CASIDRGAEKYGYTF	TRBV9	TRBJ1-2
TGTGCCAGCAGGTATGAGACCCTGGGGATCGAAAACACTGAAGCTTTCTTT	CASRYETLGIENTEAFF	TRBV9	TRBJ1-1
TGCGCCAGCAGTGAGCCCCCAGTAGCGCCCTCTGGAAACACCATATATTTT	CASSEPPVAPSGNTIYF	TRBV10-1	TRBJ1-3
TGTGCCAGCAGTTACCAGGACAATCAGCCCCAGCATTTT	CASSYQDNQPQHF	TRBV6-6	TRBJ1-5
TGCGCCAGCAGTGAGTTCCTAGGGAGGGAGGGACTCTCTGGAAACACCATATATTTT	CASSEFLGREGLSGNTIYF	TRBV10-1	TRBJ1-3
TGTGCCAGCAGCTTACCCAGCGGGGCTGGCTACACCTTC	CASSLPSGAGYTF	TRBV7-4	TRBJ1-2
TGCAGTGCTAGAGATCCCGGAGATCAAGAAGGCTCTGGAAACACCATATATTTT	CSARDPGDQEGSGNTIYF	TRBV20-1	TRBJ1-3
TGTGCCAGCAGCTTCGGACAAGGGGGGGCCGGGGAGCTGTTTTTT	CASSFGQGGAGELFF	TRBV7-8	TRBJ2-2
TGTGCCAGCAGCCGTACGGGAGCCTGGGGTGCCTACAATGAGCAGTTCTTC	CASSRTGAWGAYNEQFF	TRBV13	TRBJ2-1
TGTGCCAGCAGTGGCATTCGAGGAGGGCCGCTCTATGGCTACACCTTC	CASSGIRGGPLYGYTF	TRBV6-1	TRBJ1-2
TGTGCCAGCAGCCCGGACTACGAGCAGTACTTC	CASSPDYEQYF	TRBV9	TRBJ2-7
TGCGCCAGCAGCCAATTAGGTTGGAGGGGGGGGCGGCAAGAGACCCAGTACTTC	CASSQLGWRGGRQETQYF	TRBV4-1	TRBJ2-5
TGCGCCATTCGGATAGTTAGCGGGCCCACAGATACGCAGTATTTT	CAIRIVSGPTDTQYF	TRBV10-1	TRBJ2-3
TGTGCCAGCAGCGGGGCCCCGGCCTTGAGCTCTGGAAACACCATATATTTT	CASSGAPALSSGNTIYF	TRBV13	TRBJ1-3
TGTGCCATCAGTGAGTACTCAACCGCGGGGGAACTTGGGAGCACAGATACGCAGTATTTT	CAISEYSTAGELGSTDTQYF	TRBV10-3	TRBJ2-3
TGCGCCAGCAGCTTGCCCACGGTTTCTAATTCCTACGAGCAGTACTTC	CASSLPTVSNSYEQYF	TRBV5-1	TRBJ2-7
TGCGCCAGCAGCCAAGGGGGCGTTGCGGGGGGTGAAAAACTGTTTTTT	CASSQGGVAGGEKLFF	TRBV4-3	TRBJ1-4
TGTGCCAGCAGTGACTGCCAGGCGCCCAATCAGCCCCAGCATTTT	CASSDCQAPNQPQHF	TRBV6-4	TRBJ1-5
TGTGCCAGCAGTGACACAGGCTCCTACGAGCAGTACTTC	CASSDTGSYEQYF	TRBV6-1	TRBJ2-7
TGCAGTGCTAGATCCTCTGGGGGAGAGACCCAGTACTTC	CSARSSGGETQYF	TRBV20-1	TRBJ2-5
TGTGCCAGCAGCCGACGCACAGGGTCGATCGGGGAGCTGTTTTTT	CASSRRTGSIGELFF	TRBV14	TRBJ2-2
TGCGCCAGCAGCCCCTGGTCGGGGGCATATGGCTACACCTTC	CASSPWSGAYGYTF	TRBV5-1	TRBJ1-2
TGTGCCATCAAAAAACAGGGCGTGCGAATCCCCGGGGCTAGGGGAGTACCCACTGAAGCTTTCTTT	CAIKKQGVRIPGARGVPTEAFF	TRBV10-3	TRBJ1-1
TGTGCCAGCAGCTGCTCAGAAAGAAGCGGGCGCCCACCCCGTAGCACAGATACGCAGTATTTT	CASSCSERSGRPPRSTDTQYF	TRBV7-2	TRBJ2-3
TGTGCCAGCAGCTTACTCGGCCTACAAGAGACCCAGTACTTC	CASSLLGLQETQYF	TRBV11-2	TRBJ2-5
TGCAGTGCTTACGCAGGGGTTCCAAATCCGAACACTGAAGCTTTCTTT	CSAYAGVPNPNTEAFF	TRBV20-1	TRBJ1-1
TGTGCCACCCCCGGACCCGGGACAATTACTGAGACCCAGTACTTC	CATPGPGTITETQYF	TRBV6-2	TRBJ2-5
TGTGCCACCAGCTGGGCTGGAGACTATGGCTACACCTTC	CATSWAGDYGYTF	TRBV15	TRBJ1-2
TGTGCCACGCAAGTCTTGACCCAGTACTTC	CATQVLTQYF	TRBV6-4	TRBJ2-5
TGTGCCAGCAGAAGAAAAGCCTACAATGAGCAGTTCTTC	CASRRKAYNEQFF	TRBV9	TRBJ2-1
TGTGCCAGCAGTGCAGGGGGGACCTATGGCTACACCTTC	CASSAGGTYGYTF	TRBV6-2	TRBJ1-2
TGCGCCAGCAGCCCACCCGCAAGACAGGGGAATGAAAAACTGTTTTTT	CASSPPARQGNEKLFF	TRBV4-3	TRBJ1-4
TGTGCCAGCAGTTACTCGACCCGCTGGGGGACCTACGAGCAGTACTTC	CASSYSTRWGTYEQYF	TRBV6-5	TRBJ2-7
TGCGCCAGCAGCTTGAAATGCCCGACAGGGGGCTACACCTTC	CASSLKCPTGGYTF	TRBV5-1	TRBJ1-2
TGTGCCAGCAGCGGCCGCTTGTGTTCCCCGGGACTAGCGGGAGGCCTTTCTAATCAGCCCCAGCATTTT	CASSGRLCSPGLAGGLSNQPQHF	TRBV9	TRBJ1-5
TGTGCCAGCAGCGTGTCGTTAGGACCGAACACCGGGGAGCTGTTTTTT	CASSVSLGPNTGELFF	TRBV5-5	TRBJ2-2
TGTGCCAGCAGCTTGGAACGCACGGCAGATACGCAGTATTTT	CASSLERTADTQYF	TRBV7-2	TRBJ2-3
TGTGCCAGCAGCGTAACTGTCGGAAGAGATTTCCCAAACTATGGCTACACCTTC	CASSVTVGRDFPNYGYTF	TRBV7-4	TRBJ1-2
TGTGCCAGCAGTGACGGGACTGGTCCTTTCTATGGCTACACCTTC	CASSDGTGPFYGYTF	TRBV6-4	TRBJ1-2
TGTGCCAGCAGCTTAGTAAAACGGGGTAAGAACACCGGGGAGCTGTTTTTT	CASSLVKRGKNTGELFF	TRBV7-9	TRBJ2-2
TGTGCCAGCAGTGCGCGGGGAGCGAGCACAGATACGCAGTATTTT	CASSARGASTDTQYF	TRBV12-3	TRBJ2-3
TGTGCCAGCAGCTTGGTTATTAGGGGCCCGAAGGGGGAGGAGACCCAGTACTTC	CASSLVIRGPKGEETQYF	TRBV5-6	TRBJ2-5
TGTGCCAGTAGCTGGGGGCATAGCTCCTATAATTCACCCCTCCACTTT	CASSWGHSSYNSPLHF	TRBV9	TRBJ1-6
TGCGCCAGCAGTGACTCCTGTCTAGCAGATACAGATACGCAGTATTTT	CASSDSCLADTDTQYF	TRBV10-2	TRBJ2-3
TGTGCCAGCAGTGAATGGAATGAGACCGCAGAGAATGAGCAGTTCTTC	CASSEWNETAENEQFF	TRBV25-1	TRBJ2-1
TGTGCCAGCAGCTGGGGGTTGGGAGGGAACTATGGCTACACCTTC	CASSWGLGGNYGYTF	TRBV5-6	TRBJ1-2
TGTGCCAGCAGTGTGAGGACCCCTAGCAATCAGCCCCAGCATTTT	CASSVRTPSNQPQHF	TRBV6-4	TRBJ1-5
TGTGCCACCGGTAGGGGGAGAGACACTGAAGCTTTCTTT	CATGRGRDTEAFF	TRBV24-1	TRBJ1-1
TGTGCCAGCAGCCTCAGGGACTGCGGGGAGCTGTTTTTT	CASSLRDCGELFF	TRBV13	TRBJ2-2
TGCGCCAGCTTGGGGTCTTTGGACTATGGCTACACCTTC	CASLGSLDYGYTF	TRBV5-1	TRBJ1-2
TGTGCCAGCAGCTTAACAAGACAGAGCGGTGGCAATCAGCCCCAGCATTTT	CASSLTRQSGGNQPQHF	TRBV11-1	TRBJ1-5
TGTGCCCATGGACGTGAAAAACTGTTTTTT	CAHGREKLFF	TRBV7-9	TRBJ1-4
TGCAGTGCTGTCTTAGAAGGCACAGATACGCAGTATTTT	CSAVLEGTDTQYF	TRBV20-1	TRBJ2-3
TGTGCCAGCCCGGACAGGCTCTCCTACGAGCAGTACTTC	CASPDRLSYEQYF	TRBV25-1	TRBJ2-7
TGTGCCAGCAGCGCTCGGGACAAGAGCTACGAGCAGTACTTC	CASSARDKSYEQYF	TRBV13	TRBJ2-7
TGTGCCAGCACCTCCACGGGGGGGGGAAACACCATATATTTT	CASTSTGGGNTIYF	TRBV6-1	TRBJ1-3
TGTGCCAGCAGCAGGGGAGTCGAGCAGTACTTC	CASSRGVEQYF	TRBV6-1	TRBJ2-7
TGTGCCAGCAGCGGTTCGAAGCGGGGGGTGAAACAAGGCACTGAAGCTTTCTTT	CASSGSKRGVKQGTEAFF	TRBV7-3	TRBJ1-1
TGTGCCAGCAGCTTAGTAACAGGGGCAGTAGTGCACGAGCAGTACTTC	CASSLVTGAVVHEQYF	TRBV7-4	TRBJ2-7
TGTGCCAGCAGTGATGGGCCCAGACTTCACGAGCAGTACTTC	CASSDGPRLHEQYF	TRBV27	TRBJ2-7
TGTGCCAGCAGCGGACAGGGTCCTTCAGCTTTCTTT	CASSGQGPSAFF	TRBV7-2	TRBJ1-1
TGTGCCAGCAGCCTGGGACTAGGGGTGGGAGAGCAGTTCTTC	CASSLGLGVGEQFF	TRBV9	TRBJ2-1
TGTGCCAGCAGTTACTCGGTGGACAGGGAGGGAATGGCAGATACGCAGTATTTT	CASSYSVDREGMADTQYF	TRBV6-3	TRBJ2-3
TGTGCCAGCAGCAGGGACAGGGGTAAGTACTTC	CASSRDRGKYF	TRBV5-4	TRBJ2-5
TGTGCCAGCAGTTATCAAGGGACAGTTTTCGTAGACACCATATATTTT	CASSYQGTVFVDTIYF	TRBV6-5	TRBJ1-3
TGTGCCATCAGTGAGAATACCGGCGGCTACACCTTC	CAISENTGGYTF	TRBV10-3	TRBJ1-2
TGTGCCAGCTCACCACCGGGTTCAGGGGGGGGGGAGCTGTTTTTT	CASSPPGSGGGELFF	TRBV18	TRBJ2-2
TGCAGCGTTTTTTGGGGGTTTGGCTACACCTTC	CSVFWGFGYTF	TRBV29-1	TRBJ1-2
TGTGCCAGCAGTTACTCGGCAGGGTGGGTCCCGCCACCGGGACAGGGGCCGGGCTACGAGCAGTACTTC	CASSYSAGWVPPPGQGPGYEQYF	TRBV6-2	TRBJ2-7
TGTGCCAGCACCAGGGCCTTGGGTGTAGAGACCCAGTACTTC	CASTRALGVETQYF	TRBV25-1	TRBJ2-5
TGTGCCAGCCGATCCAGGGGGGGTTTCTACGAGCAGTACTTC	CASRSRGGFYEQYF	TRBV25-1	TRBJ2-7
TGTGCCAGCAGCCTGTGCACTAGAGCTGACTACGAGCAGTACTTC	CASSLCTRADYEQYF	TRBV11-3	TRBJ2-7
TGCGCCAGCAGCTATGGACAGGGGGCCCCCCGGGGGACCAAACAGTACTTC	CASSYGQGAPRGTKQYF	TRBV5-1	TRBJ2-5
TGTGCCACCAGCAGAGATTTCGCTAGCGGGGAGGAGTCCTACAATGAGCAGTTCTTC	CATSRDFASGEESYNEQFF	TRBV15	TRBJ2-1
TGTGCCAGCAGTGAATGGGAGGGGGACTCCTACGAGCAGTACTTC	CASSEWEGDSYEQYF	TRBV6-1	TRBJ2-7
TGTGCCAGCAGCTTGATGACTATCACAGATACGCAGTATTTT	CASSLMTITDTQYF	TRBV7-9	TRBJ2-3
TGTGCCAGCTCCCGAGACAGGCCCTACGAGCAGTACTTC	CASSRDRPYEQYF	TRBV7-9	TRBJ2-7
TGTGCCAGCAGCTTTAGGGCCGAGCAGTACTTC	CASSFRAEQYF	TRBV5-6	TRBJ2-7
TGTGCCATGGACGGGGTCTACGAGCAGTACTTC	CAMDGVYEQYF	TRBV25-1	TRBJ2-7
TGTGCCAGCATTTGGGGACCGGGACAGGGGCAAGTCCACAATCAGCCCCAGCATTTT	CASIWGPGQGQVHNQPQHF	TRBV6-5	TRBJ1-5
TGTGCTAGTGGTGTTCCATGCACTAGCGGGGTCGAGCAGTACTTC	CASGVPCTSGVEQYF	TRBV12-5	TRBJ2-7
TGTGCCAGCCGCCTGGTGGTCACCGGGGAGCTGTTTTTT	CASRLVVTGELFF	TRBV19	TRBJ2-2
TGTGCCAGCAGCTTAGCGGAAGTGACCTGTAGGGGCGGTTCTAACTATGGCTACACCTTC	CASSLAEVTCRGGSNYGYTF	TRBV7-9	TRBJ1-2
TGTGCCAGCAGTGAGACTTTGGGGGGGGGCGGTAGGCACGAGCAGTACTTC	CASSETLGGGGRHEQYF	TRBV2	TRBJ2-7
TGTGCCAGCAGCGACCTAATCGGACGGGAGACCCAGTACTTC	CASSDLIGRETQYF	TRBV11-3	TRBJ2-5
TGTGCCAGCAGCCCGCCTCCACAGGGGGCACGCTATGGCTACACCTTC	CASSPPPQGARYGYTF	TRBV13	TRBJ1-2
TGCGCCAGCAGTGCCAAGGAGGCCGATACGCAGTATTTT	CASSAKEADTQYF	TRBV10-1	TRBJ2-3
TGTGCCAGCAGCGCTCAGTTTTCCGGCCGGACAGATACGCAGTATTTT	CASSAQFSGRTDTQYF	TRBV7-2	TRBJ2-3
TGTGCCAGCAGGCGTGTGGTAGCGTTTCAGCCCCAGCATTTT	CASRRVVAFQPQHF	TRBV6-4	TRBJ1-5
TGCAGCGTTGAGGGCGGGGGAGACAATCAGCCCCAGCATTTT	CSVEGGGDNQPQHF	TRBV29-1	TRBJ1-5
TGTGCCAGCAGCAAAGGACACAAATTTACCTACGAGCAGTACTTC	CASSKGHKFTYEQYF	TRBV9	TRBJ2-7
TGTCGGCGCTGCGGGAGAAAGTACTTC	CRRCGRKYF	TRBV6-1	TRBJ2-7
TGTGCCAGCAGCTGGGCTCCGGGCTCCTACGAGCAGTACTTC	CASSWAPGSYEQYF	TRBV11-2	TRBJ2-7
TGTGCCAGCAGCAACCGGGGGGGGCATACTAATCAGCCCCAGCATTTT	CASSNRGGHTNQPQHF	TRBV11-3	TRBJ1-5
TGCAGCGAGCTATACCCAGGCACGGGGGGGTTGACTGAAGCTTTCTTT	CSELYPGTGGLTEAFF	TRBV29-1	TRBJ1-1
TGTGCCAGCAGCGGGAATCCGGACAGGTTACAAGAGACCCAGTACTTC	CASSGNPDRLQETQYF	TRBV11-2	TRBJ2-5
TGCAAAAGCCGGGACAGGGCCCTTGGCTACACCTTC	CKSRDRALGYTF	TRBV29-1	TRBJ1-2
TGTGCCAGCACCCCCAACCCAGGGGATGAGACCCAGTACTTC	CASTPNPGDETQYF	TRBV6-2	TRBJ2-5
TGCAGTATAAAAAGCGGTAGGGACGAGCAGTACTTC	CSIKSGRDEQYF	TRBV20-1	TRBJ2-7
TGTGCCAGCGGAACTAGCGGGAGGGCGATGGTTGGGCACCGCGGGGAGCTGTTTTTT	CASGTSGRAMVGHRGELFF	TRBV25-1	TRBJ2-2
TGTGCCACCAGTGATACCCCATTTAACAGGGGCGACTCCGGGGAGCTGTTTTTT	CATSDTPFNRGDSGELFF	TRBV24-1	TRBJ2-2
TGTGCCAGCAGTAAGGCCCGGTCGGACAGGGGATATAGCAATCAGCCCCAGCATTTT	CASSKARSDRGYSNQPQHF	TRBV12-3	TRBJ1-5
TGTGCCAGGAGGGCTCTCACTGAAGCTTTCTTT	CARRALTEAFF	TRBV6-1	TRBJ1-1
TGTGCTAGTGGTTTGGTACCCTCAGAACGAGAGACCCAGTACTTC	CASGLVPSERETQYF	TRBV12-5	TRBJ2-5
TGCAGTGCTCCCGGGACCAAGGGGGGTACGTGGAACACTGAAGCTTTCTTT	CSAPGTKGGTWNTEAFF	TRBV20-1	TRBJ1-1
TGTGCCAGCAGCTTGTCTTTGGTGGTGTTTACAGGGCGGAGTATCTACGAGCAGTACTTC	CASSLSLVVFTGRSIYEQYF	TRBV5-6	TRBJ2-7
TGTGCCAGCAGTCACGGGGCCTACGAGCAGTACTTC	CASSHGAYEQYF	TRBV27	TRBJ2-7
TGTGCCAGCAGTTTATGCCAAGACATCCTACGCTACACCTTC	CASSLCQDILRYTF	TRBV28	TRBJ1-2
TGTGCCACTAGCGCTAGGCAGGATACGCAGTATTTT	CATSARQDTQYF	TRBV27	TRBJ2-3
TGTGCCAGCAGCCAAACCCGGGGGGCCGAACCGAGGGGACTAGCGGGTGACAATGAGCAGTTCTTC	CASSQTRGAEPRGLAGDNEQFF	TRBV14	TRBJ2-1
TGTGCCAGCAGCTTAGAAGAGACCGCGGGACGAGATCAGCCCCAGCATTTT	CASSLEETAGRDQPQHF	TRBV7-3	TRBJ1-5
TGCGCCAGCAGCCAAGGACAGGGGGCTCCAAATTCACCCCTCCACTTT	CASSQGQGAPNSPLHF	TRBV4-3	TRBJ1-6
TGTGCCAGCATCGTCCTGGACAGCCTAGAGACCCAGTACTTC	CASIVLDSLETQYF	TRBV28	TRBJ2-5
TGTGCCAGCAGTTTCCGCAGGGGGGGGTACGAGCAGTACTTC	CASSFRRGGYEQYF	TRBV27	TRBJ2-7
TGCGCCAGCAGTGACCGGACAGGGAGGTCTAATAGCAATCAGCCCCAGCATTTT	CASSDRTGRSNSNQPQHF	TRBV10-1	TRBJ1-5
TGTGCCAGTTGCGGGGGTCCGACCCAGTACTTC	CASCGGPTQYF	TRBV19	TRBJ2-5
TGTGCCAGGGAACCTAGCGGGACGGGCTCCTACGAGCAGTACTTC	CAREPSGTGSYEQYF	TRBV9	TRBJ2-7
TGTGCCAGCACCGCTCGGGTAAATCAGCCCCAGCATTTT	CASTARVNQPQHF	TRBV6-4	TRBJ1-5
TGTGCCAGCAGCCGCAGTGGGACCCAGTACTTC	CASSRSGTQYF	TRBV9	TRBJ2-5
TGTGCCAGCAGCTGCCGGGACAGGGTGCCCGAGCAGTACTTC	CASSCRDRVPEQYF	TRBV11-3	TRBJ2-7
TGTGCCACCAGTGATCCGACAGGGGAGGCTGGGGCCAACGTCCTGACTTTC	CATSDPTGEAGANVLTF	TRBV24-1	TRBJ2-6
TGCAGTCAATCTAGCGGGCCCTACGAGCAGTACTTC	CSQSSGPYEQYF	TRBV20-1	TRBJ2-7
TGTGCCAGCAGTTTACGACCTGACGTCGTCGACACTGAAGCTTTCTTT	CASSLRPDVVDTEAFF	TRBV12-4	TRBJ1-1
TGTGCCAGCAGCGGATCAGTCGGGGGGGAACTACACCAAGAGACCCAGTACTTC	CASSGSVGGELHQETQYF	TRBV11-1	TRBJ2-5
TGCGCCAGCAGCTTCGGGACAGGGGACGAGCAGTACTTC	CASSFGTGDEQYF	TRBV5-1	TRBJ2-7
TGTGCCAGCAGTTACCTCTCCTACAATGAGCAGTTCTTC	CASSYLSYNEQFF	TRBV6-2	TRBJ2-1
TGTGCCAGCAGCGTAGCAGGCCCGGGACAGGGTCAGCCCCAGCATTTT	CASSVAGPGQGQPQHF	TRBV9	TRBJ1-5
TGTGCCATCAGAACGATCGGAGAGAACACTGAAGCTTTCTTT	CAIRTIGENTEAFF	TRBV10-3	TRBJ1-1
TGCAGTGCTAGAGCGGGCCCTTCACCCCTCCACTTT	CSARAGPSPLHF	TRBV20-1	TRBJ1-6
TGTGCCAGCAGCGGGGACGAGTCGCCCCAGCATTTT	CASSGDESPQHF	TRBV7-9	TRBJ1-5
TGTGCCAGCAGCCAAAACATTCGACCCTCCTACGAGCAGTACTTC	CASSQNIRPSYEQYF	TRBV14	TRBJ2-7
TGTGCCAGCAGCGGTGGACATGTTAATGAAAAACTGTTTTTT	CASSGGHVNEKLFF	TRBV13	TRBJ1-4
TGTGCCAGCAGCTTACTGGGGCGTGATGGCTACACCTTC	CASSLLGRDGYTF	TRBV13	TRBJ1-2
TGTGCCTGGATTCGGGTCTCCTACGAGCAGTACTTC	CAWIRVSYEQYF	TRBV30	TRBJ2-7
TGTGCCAGCTCACCACCCTCCCACAGGAATAATGAAAAACTGTTTTTT	CASSPPSHRNNEKLFF	TRBV18	TRBJ1-4
TGTGCCAGCAGCTTAGCGACCGCCATAGTCAGATGGGTGCAGCCCCAGCATTTT	CASSLATAIVRWVQPQHF	TRBV7-6	TRBJ1-5
TGTGCCAGCAGTGGCGACAGGCCCGCCTATAATTCACCCCTCCACTTT	CASSGDRPAYNSPLHF	TRBV6-3	TRBJ1-6
TGTGCCAGCAGTTTTTCCATCCCTATCAGGAAGTCAGATACGCAGTATTTT	CASSFSIPIRKSDTQYF	TRBV28	TRBJ2-3
TGTGCCAGCAGTAGAGAGGCCGGACCAGATACGCAGTATTTT	CASSREAGPDTQYF	TRBV28	TRBJ2-3
TGTGCCATCAGTTCTTTGTGGGACAGGAGTGGGCCCCAGCATTTT	CAISSLWDRSGPQHF	TRBV10-3	TRBJ1-5
TGTGCCACCAGGGAGGGGCGGGAGTTTTCAGATACGCAGTATTTT	CATREGREFSDTQYF	TRBV24-1	TRBJ2-3
TGTGCCAGCAGCCAAGATCCCGAAAGAGACCACCTTAGGACAGATTACAATTCACCCCTCCACTTT	CASSQDPERDHLRTDYNSPLHF	TRBV14	TRBJ1-6
TGTGCCAGCAGTAAAGTCGCGGTCCTGTACACCGGGGAGCTGTTTTTT	CASSKVAVLYTGELFF	TRBV28	TRBJ2-2
TGTGCCAGCAGTTTATTCGCGGAAGGGGATGGCTATCAAGAGACCCAGTACTTC	CASSLFAEGDGYQETQYF	TRBV27	TRBJ2-5
TGTGCCAGCAGCGCATCAGGGTGCAATCAGCCCCAGCATTTT	CASSASGCNQPQHF	TRBV13	TRBJ1-5
TGTGCCAGCCTCAAGCAACCTGGGACATCCTACGAGCAGTACTTC	CASLKQPGTSYEQYF	TRBV6-5	TRBJ2-7
TGTGCCAACAGGACGAGGTTAAGACGGAGCTCCTACGAGCAGTACTTC	CANRTRLRRSSYEQYF	TRBV19	TRBJ2-7
TGTGCCAGCAGTTTATTCCGGGGGTACTATGGCTACACCTTC	CASSLFRGYYGYTF	TRBV27	TRBJ1-2
TGTGCCAGGGGGGGGGGGCCACAAGCTTTCTTT	CARGGGPQAFF	TRBV27	TRBJ1-1
TGTGCTAGCAGCTTAGCGGTCGACAGAGGCTCTGGAAACACCATATATTTT	CASSLAVDRGSGNTIYF	TRBV7-7	TRBJ1-3
TGCGCCAGCAGCTTGTCTAAAGGGAAGCGGTTCTACGAGCAGTACTTC	CASSLSKGKRFYEQYF	TRBV5-1	TRBJ2-7
TGTGCCAGCAGTAAGGTCCGAGGGGGATACGAGCAGTACTTC	CASSKVRGGYEQYF	TRBV6-1	TRBJ2-7
TGTGCCAGCAGTTTGAACGGACGAAAAAGTAACTATGGCTACACCTTC	CASSLNGRKSNYGYTF	TRBV6-6	TRBJ1-2
TGCGCCAGCAGCCCCCCAAGGGGTGAGGGCTACACCTTC	CASSPPRGEGYTF	TRBV4-1	TRBJ1-2
TGCAGTGCTAGGAGGAGGCAGGATGAGCAGTTCTTC	CSARRRQDEQFF	TRBV20-1	TRBJ2-1
TGCGCCAGCACTCTCCCCAGTAGCTCTGGAAACACCATATATTTT	CASTLPSSSGNTIYF	TRBV10-2	TRBJ1-3
TGTGCCAGCAGGACAGTTTACGAGCAGTACTTC	CASRTVYEQYF	TRBV28	TRBJ2-7
TGCGCCAGCAGCCATCCGGGACAGGGTAGCACAGATACGCAGTATTTT	CASSHPGQGSTDTQYF	TRBV4-1	TRBJ2-3
TGTGCCAGCAGGAAACAGGGCTCCTACGAGCAGTACTTC	CASRKQGSYEQYF	TRBV12-4	TRBJ2-7
TGTGCCCCTCTCTGGACCTGTTTTGAAAAACTGTTTTTT	CAPLWTCFEKLFF	TRBV6-5	TRBJ1-4
TGTGCCTGGAGTGCGACAGGGTTTGGGGGGCTGAATCAGCCCCAGCATTTT	CAWSATGFGGLNQPQHF	TRBV30	TRBJ1-5
TGTGCCAGAGGCGACGGGGAGCTGTTTTTT	CARGDGELFF	TRBV6-4	TRBJ2-2
TGTGCCAGCAGTGAAGGTGGGAATTGGCGGGGGCATGAGGTTAATGAAAAACTGTTTTTT	CASSEGGNWRGHEVNEKLFF	TRBV6-1	TRBJ1-4
TGTGCCAGTGTCTCACAAGCCAAAAACATTCAGTACTTC	CASVSQAKNIQYF	TRBV19	TRBJ2-4
TGTGCCAGCACCGAACAGGACGGCTACACCTTC	CASTEQDGYTF	TRBV6-4	TRBJ1-2
TGCAGCGTTGCCGTCGGGACCTGGAGTGGGGAGAACACCATATATTTT	CSVAVGTWSGENTIYF	TRBV29-1	TRBJ1-3
TGCAGCGCCGACGACAGTTTTAAGGAGACTGGGGGGGACTCTGGAAACACCATATATTTT	CSADDSFKETGGDSGNTIYF	TRBV29-1	TRBJ1-3
TGTGCCAGCAGCTCAGGTTTTCACTACGAGCAGTACTTC	CASSSGFHYEQYF	TRBV5-4	TRBJ2-7
TGTGCCAGCAGCTTTCGGGGGATAAAAAACAATGAGCAGTTCTTC	CASSFRGIKNNEQFF	TRBV7-8	TRBJ2-1
TGCGCCCCTCAGGGGCCGCTTGGCTACACCTTC	CAPQGPLGYTF	TRBV10-1	TRBJ1-2
TGTGCCACCAGTGATTTGCCTCCGACAGGGTGTGTTTCAGATACGCAGTATTTT	CATSDLPPTGCVSDTQYF	TRBV24-1	TRBJ2-3
TGTGCCAGCAGCTTAAGCAGACAGGGCTACGAGCAGTACTTC	CASSLSRQGYEQYF	TRBV14	TRBJ2-7
TGTGCCAGCATAAGGGGCCACAGGGGCCGGCGGGGGCCCCAGCATTTT	CASIRGHRGRRGPQHF	TRBV6-5	TRBJ1-5
TGTGCCAGCAGCCCGGTAGGACAGGGGGTGGGCTACACCTTC	CASSPVGQGVGYTF	TRBV13	TRBJ1-2
TGTGCCAGCATTCAGGGTCGGAACGTCCTGACTTTC	CASIQGRNVLTF	TRBV27	TRBJ2-6
TGTGCCAGCAGCCAAGTAGGACTAAGGTTCACTAATGAGCAGTTCTTC	CASSQVGLRFTNEQFF	TRBV4-2	TRBJ2-1
TGTGCCAGCAAAGCACTGCAGGTTTATAGCAATCAGCCCCAGCATTTT	CASKALQVYSNQPQHF	TRBV7-3	TRBJ1-5
TGTGCCAGCCCTCCAGGCGGGTCCTTAACTGGGGCCAACGTCCTGACTTTC	CASPPGGSLTGANVLTF	TRBV6-4	TRBJ2-6
TGTGCCAGCAGTTACTCGAATCGCCCGCGGGCCTACAATGAGCAGTTCTTC	CASSYSNRPRAYNEQFF	TRBV27	TRBJ2-1
TGTGCCAGCAGCCGGACAGGGAGCTCCTACGAGCAGTACTTC	CASSRTGSSYEQYF	TRBV7-3	TRBJ2-7
TGTGCCACCAGTGATTCATCTCCTGGAATTACCAGGGAGCCTGGTGTCATGGCGTACTTC	CATSDSSPGITREPGVMAYF	TRBV24-1	TRBJ2-7
TGTGCCAGATTCAACTGGCCGGGACTAGCGGTAGGAATGCGAGATACGCAGTATTTT	CARFNWPGLAVGMRDTQYF	TRBV27	TRBJ2-3
TGTGCCAGCAGTGAGCCCCAGACTAGCGGGGATAGAAGTTACAATGAGCAGTTCTTC	CASSEPQTSGDRSYNEQFF	TRBV6-1	TRBJ2-1
TGTGCCAGCAGTGAATACCTCGGGGGGTATAATTCACCCCTCCACTTT	CASSEYLGGYNSPLHF	TRBV25-1	TRBJ1-6
TGCGCCAGCACAGGAGCGGAGGGCTACGAGCAGTACTTC	CASTGAEGYEQYF	TRBV10-1	TRBJ2-7
TGTGCCAGCAGCCAAGATTTTGGACACGGACAGGGTAAAAAAAGCCGAGAGCAGTACTTC	CASSQDFGHGQGKKSREQYF	TRBV3-1	TRBJ2-7
TGTGCCAGCAGTTTGGACATTTTCGAGCAGTACTTC	CASSLDIFEQYF	TRBV27	TRBJ2-7
TGTGCCACCGCCGGCAGTTTGGTAAAATATAGCAATCAGCCCCAGCATTTT	CATAGSLVKYSNQPQHF	TRBV24-1	TRBJ1-5
TGCGCCAGCAGCCAAGATAATCAATCGAACAATGAGCAGTTCTTC	CASSQDNQSNNEQFF	TRBV4-3	TRBJ2-1
TGTGCCAGCATCAGGGGGGGGCCCGGCAATGAGCAGTTCTTC	CASIRGGPGNEQFF	TRBV5-6	TRBJ2-1
TGTGCCAGCAGCTCTCGGGACAGGACGAACACCGGGGAGCTGTTTTTT	CASSSRDRTNTGELFF	TRBV7-3	TRBJ2-2
TGCAGTGCCGGATTACTAGCGGGTACCTACGAGCAGTACTTC	CSAGLLAGTYEQYF	TRBV20-1	TRBJ2-7
TGCGCCAGCAGCCACCGACTAGGCAATCAGCCCCAGCATTTT	CASSHRLGNQPQHF	TRBV4-1	TRBJ1-5
TGTGCCAGCAGCTCAAGGAGTGGGTATGCCACTAATGAAAAACTGTTTTTT	CASSSRSGYATNEKLFF	TRBV7-4	TRBJ1-4
TGTGCCAGCAGCCAAGGGACTAGCGGCACAGATACGCAGTATTTT	CASSQGTSGTDTQYF	TRBV9	TRBJ2-3
TGTGCCAGGCAGTACAATGAGCAGTTCTTC	CARQYNEQFF	TRBV28	TRBJ2-1
TGTGCCAGCAGTGCCGACAGGGGATCAAATGAGCAGTTCTTC	CASSADRGSNEQFF	TRBV25-1	TRBJ2-1
TGTGCCAGCACGGTCCCGGACAGGGGGGGTAGCAATCAGCCCCAGCATTTT	CASTVPDRGGSNQPQHF	TRBV25-1	TRBJ1-5
TGTGCCAGCCCGGGCTCTGGGGCCAACGTCCTGACTTTC	CASPGSGANVLTF	TRBV11-3	TRBJ2-6
TGTGCCAGCAGTTCCTGGACCGGGCGGCCCCAGCATTTT	CASSSWTGRPQHF	TRBV28	TRBJ1-5
TGTGCCAGCAGTAACGTTCCCGACTACAATGAGCAGTTCTTC	CASSNVPDYNEQFF	TRBV6-3	TRBJ2-1
TGTGCCATACAAAGAGGGACAGGGTTCAAATTGGCAGCTTTCTTT	CAIQRGTGFKLAAFF	TRBV10-3	TRBJ1-1
TGTGCCAGCAGTGAGGGACAGGGGGGGGAGACCCAGTACTTC	CASSEGQGGETQYF	TRBV6-4	TRBJ2-5
TGTGCCAGCAGCGGGGGAGCGAGGGGCACAGATACGCAGTATTTT	CASSGGARGTDTQYF	TRBV9	TRBJ2-3
TGTGCCAGCAGCCAAGCCAGAGGTCTCTTCACAGATACGCAGTATTTT	CASSQARGLFTDTQYF	TRBV3-1	TRBJ2-3
TGTGCCAGCAGCTTGGCCGCAGGGGCGTCCTACGAGCAGTACTTC	CASSLAAGASYEQYF	TRBV5-6	TRBJ2-7
TGTGCCAGCAAGCGGGACCGATACGAGCAGTACTTC	CASKRDRYEQYF	TRBV7-9	TRBJ2-7
TGTGCCACCAGTGACCAGGTAAGTCCCGGGGAGCTGTTTTTT	CATSDQVSPGELFF	TRBV24-1	TRBJ2-2
TGTGCCAGCAGACATCCTAGGACAGATACGCAGTATTTT	CASRHPRTDTQYF	TRBV12-4	TRBJ2-3
TGTGCCAGTAGTACCGGCGGACAGGGCTATGGCTACACCTTC	CASSTGGQGYGYTF	TRBV19	TRBJ1-2
TGTGCCTGGGGCGGCAATCAGCCCCAGCATTTT	CAWGGNQPQHF	TRBV30	TRBJ1-5
TGCAGTGCGTTGGGACTCTGGTGGCCGCAAAGCAATCAGCCCCAGCATTTT	CSALGLWWPQSNQPQHF	TRBV20-1	TRBJ1-5
TGTGCCAGCAGCTTCTTAGCCTACGAGCAGTACTTC	CASSFLAYEQYF	TRBV5-6	TRBJ2-7
TGCGCCAGCAGCCAAGACTGGGGGGTAGGGAACACTGAAGCTTTCTTT	CASSQDWGVGNTEAFF	TRBV4-3	TRBJ1-1
TGTGCCAGCGGTCACCGGGAGTCCGGTAAGGTGAACACCGGGGAGCTGTTTTTT	CASGHRESGKVNTGELFF	TRBV12-3	TRBJ2-2
TGTGCCAGCAGCCAAGGGAATTGGACAGGCGAGCAGTACTTC	CASSQGNWTGEQYF	TRBV3-1	TRBJ2-7
TGTGCCAGCAGCTTAGATAGCGGGTTGTTCTTC	CASSLDSGLFF	TRBV7-9	TRBJ2-1
TGTGCCAGCAGGAAAATGACAGAGGTGCGGCGCGAAGCTTTCTTT	CASRKMTEVRREAFF	TRBV27	TRBJ1-1
TGCGCCAGCAGCTTGCAACAGGGGGCTGGCGAAGCTTTCTTT	CASSLQQGAGEAFF	TRBV5-1	TRBJ1-1
TGTGCCAGCAGCCCTCTAGCGGCTCGGAAGCCTCATGAGCAGTTCTTC	CASSPLAARKPHEQFF	TRBV14	TRBJ2-1
TGTGCCAGCAGTCGACCAGCGGCAGGGGGGTACGAGCAGTACTTC	CASSRPAAGGYEQYF	TRBV27	TRBJ2-7
TGCGCCAGCAGCCAGTTAGGGGTCGTCTCTGGGGCCAACGTCCTGACTTTC	CASSQLGVVSGANVLTF	TRBV4-1	TRBJ2-6
TGTGCCAGCAGCACGAGGGTCTACGAGCAGTACTTC	CASSTRVYEQYF	TRBV7-9	TRBJ2-7
TGCAGTGCTAGAGAAGCAGCGGGAGCCGAGCAGTACTTC	CSAREAAGAEQYF	TRBV20-1	TRBJ2-7
TGTGCCAGCACGGGTCTCGGAAGGGTGGCTCCAGGGCAGCCCCAGCATTTT	CASTGLGRVAPGQPQHF	TRBV7-8	TRBJ1-5
TGTGCCACAGGGACGTATGGCTACACCTTC	CATGTYGYTF	TRBV7-9	TRBJ1-2
TGTGCCAGCAGCAGGTTGGCGTCCAGGGGCGCTGCAACTAATGAAAAACTGTTTTTT	CASSRLASRGAATNEKLFF	TRBV7-3	TRBJ1-4
TGTGCCAGCAGTACCCCACGGGGGTTCTTTTCCAAGTACGAGCAGTACTTC	CASSTPRGFFSKYEQYF	TRBV6-5	TRBJ2-7
TGTGCCAGCAGTTACTGCGGGACAGGGCCTTGCTACACCTTC	CASSYCGTGPCYTF	TRBV6-6	TRBJ1-2
TGTGCCAGCTCACCGGGGGCGGAGGCATGGTATGGCTACACCTTC	CASSPGAEAWYGYTF	TRBV18	TRBJ1-2
TGTGCCACCGAGTCCACTGAAGCTTTCTTT	CATESTEAFF	TRBV19	TRBJ1-1
TGTGCCAGCAGCGGAGACAGGGTTGCCTACGAGCAGTACTTC	CASSGDRVAYEQYF	TRBV7-9	TRBJ2-7
TGTGCCACCAGTGATAGTTTAAACTATGGCTACACCTTC	CATSDSLNYGYTF	TRBV24-1	TRBJ1-2
TGTGCCAGCAGCGGGGCCAGGGTCGCTATGGATGAGCAGTTCTTC	CASSGARVAMDEQFF	TRBV7-3	TRBJ2-1
TGTGCCAGCAGTGCGGCTCCGTGTGTCTACGAGCAGTACTTC	CASSAAPCVYEQYF	TRBV6-4	TRBJ2-7
TGTGCTAGCAGCTTAGGGTTCCTCCCGGAAGAGGGCGACTTTAATGAGCAGTTCTTC	CASSLGFLPEEGDFNEQFF	TRBV7-7	TRBJ2-1
TGTGCCAGCGACAACCTGTCTAATGAAAAACTGTTTTTT	CASDNLSNEKLFF	TRBV6-4	TRBJ1-4
TGCGCCAGCAGCCGCCCCTTACAACTAGCGGGAGGGGCAGGCAATCAGCCCCAGCATTTT	CASSRPLQLAGGAGNQPQHF	TRBV4-3	TRBJ1-5
TGTGCCAGCAGTTACCTAGGCCGGGGGGTGAACACTGAAGCTTTCTTT	CASSYLGRGVNTEAFF	TRBV6-6	TRBJ1-1
TGTGCCAGCAGCGGAGACAGGGCGAGCCACGAGCAGTACTTC	CASSGDRASHEQYF	TRBV13	TRBJ2-7
TGTGCCAGCAGTTACTCCTACGGGACAGAATCGGACGAGCAGTACTTC	CASSYSYGTESDEQYF	TRBV6-5	TRBJ2-7
TGCGCCAGACAACGGGGGGCGTATAGCAATCAGCCCCAGCATTTT	CARQRGAYSNQPQHF	TRBV10-1	TRBJ1-5
TGTGCCACCAGCAGAGATCTCGGCTCTGGGGGGGCGAGATACAATGAGCAGTTCTTC	CATSRDLGSGGARYNEQFF	TRBV15	TRBJ2-1
TGTGCTAGCAGCTTGGATGGAGGGGCTCGTCCAAACACCATATATTTT	CASSLDGGARPNTIYF	TRBV7-7	TRBJ1-3
TGTGCCAGCAGGACGACAGATGGAAGCAATCAGCCCCAGCATTTT	CASRTTDGSNQPQHF	TRBV2	TRBJ1-5
TGTGCCAGCAGTCTGGGGGCAGATACGCAGTATTTT	CASSLGADTQYF	TRBV6-5	TRBJ2-3
TGTGCCAGCTCACACGTGGCTATAGCCAAAAACATTCAGTACTTC	CASSHVAIAKNIQYF	TRBV18	TRBJ2-4
TGTGCCACCAGTGAAGCCGGGAGGGGGGGATTAGTAGATACGCAGTATTTT	CATSEAGRGGLVDTQYF	TRBV24-1	TRBJ2-3
TGCAGCGTCTTCGATTTCGGAGAGCCCCAGCATTTT	CSVFDFGEPQHF	TRBV29-1	TRBJ1-5
TGTGCCAGCAGTTGCGTCCGGGACAGGGGCTACACCTTC	CASSCVRDRGYTF	TRBV6-2	TRBJ1-2
TGTGCCAGCAGCTTAGGGTACGAGCAGTACTTC	CASSLGYEQYF	TRBV5-8	TRBJ2-7
TGCAGCGGACAGGCGGTGGGCACTGAAGCTTTCTTT	CSGQAVGTEAFF	TRBV29-1	TRBJ1-1
TGTGCCAGCAGCCAAGGGGAGGACGGGGGGGGGGAGCAGTTCTTC	CASSQGEDGGGEQFF	TRBV14	TRBJ2-1
TGTGCCACCAGTGGGGGGACGTCGTACAGGGGCGGAGGCTACGAGCAGTACTTC	CATSGGTSYRGGGYEQYF	TRBV24-1	TRBJ2-7
TGTGCCAGCACGGACAGGATAGGCTACCAAGAGACCCAGTACTTC	CASTDRIGYQETQYF	TRBV6-5	TRBJ2-5
TGTGCCAGTAGTAAAACCCCAGGGGGTCTTTCACCCCTCCACTTT	CASSKTPGGLSPLHF	TRBV19	TRBJ1-6
TGTGCCAGCAGCTTAGCCGGGATGAGGTGGAACACCGGGGAGCTGTTTTTT	CASSLAGMRWNTGELFF	TRBV11-2	TRBJ2-2
TGTGCCAGCAGCGAGGCATGGGTGGGCCTCTATCCCAATGAGCAGTTCTTC	CASSEAWVGLYPNEQFF	TRBV9	TRBJ2-1
TGTGCCAGCAGTTTGCAGTCAGGGGTCGGGGGCCGAGCTAGCACAGATACGCAGTATTTT	CASSLQSGVGGRASTDTQYF	TRBV27	TRBJ2-3
TGTCATGGTTCAGATACGCAGTATTTT	CHGSDTQYF	TRBV7-9	TRBJ2-3
TGCAGCCAGGGAAGCGGCGCCTCTGGGGCCAACGTCCTGACTTTC	CSQGSGASGANVLTF	TRBV29-1	TRBJ2-6
TGCCGTGGGGGGGGGGGGGATGAGCAGTTCTTC	CRGGGGDEQFF	TRBV20-1	TRBJ2-1
TGTGCCAGCAGTTTAGGGACTAGCGGGAGGTGGGTTTCCTATAATTCACCCCTCCACTTT	CASSLGTSGRWVSYNSPLHF	TRBV12-3	TRBJ1-6
TGCGCCAGCAGCTTGGCGGACAGGGGCTTCTATGGCTACACCTTC	CASSLADRGFYGYTF	TRBV5-1	TRBJ1-2
TGTGCCAGCAGCTTAATAGACGGGACAGACACAGATACGCAGTATTTT	CASSLIDGTDTDTQYF	TRBV7-9	TRBJ2-3
TGTGCCAGCAGTTTAGATCTGGTTTCAGAGACCCAGTACTTC	CASSLDLVSETQYF	TRBV6-2	TRBJ2-5
TGTGCCCGGGGGGGGAGGGTATCGAAGACCGGAGAGACCCAGTACTTC	CARGGRVSKTGETQYF	TRBV10-3	TRBJ2-5
TGCGCCAGCAGCTTGGTCTATGGGACACAGGGCTACACCTTC	CASSLVYGTQGYTF	TRBV5-1	TRBJ1-2
TGTGCCAGCAGCGTATCCCTTCCGCTGTATTCATACGAGCAGTACTTC	CASSVSLPLYSYEQYF	TRBV9	TRBJ2-7
TGTGCCAGCAGTGAAGCACCTGCGACAGTCTCTGAAAAACTGTTTTTT	CASSEAPATVSEKLFF	TRBV6-1	TRBJ1-4
TGTGCCAGCAGTTTCCGGGGCAGCTCCTACGAGCAGTACTTC	CASSFRGSSYEQYF	TRBV27	TRBJ2-7
TGTGCCAGTAGTATAGATCCCGTCGGAGGGACAGGGGGGGGATTCCTCAATCAGCCCCAGCATTTT	CASSIDPVGGTGGGFLNQPQHF	TRBV19	TRBJ1-5
TGTGCCACCCGCGGGACTAGCAGGTACAATGAGCAGTTCTTC	CATRGTSRYNEQFF	TRBV24-1	TRBJ2-1
TGCGCCAGCAGGGGGGCTAGCACAGATACGCAGTATTTT	CASRGASTDTQYF	TRBV5-1	TRBJ2-3
TGCAGTGCTGAAAGGACAGGGAAAGGCTACACCTTC	CSAERTGKGYTF	TRBV20-1	TRBJ1-2
TGTGCCAGCAGCCACCCTGGGGACAGGGGCGGCTCCTACAATGAGCAGTTCTTC	CASSHPGDRGGSYNEQFF	TRBV14	TRBJ2-1
TGTGCCAGCAGTTTCATTCTAGGGACAGGGATTATAGAAAAACTGTTTTTT	CASSFILGTGIIEKLFF	TRBV27	TRBJ1-4
TGTGCCAGTAGTCCGTCGAGCACCGGGGAGCTGTTTTTT	CASSPSSTGELFF	TRBV19	TRBJ2-2
TGTGCCAGCAGCTCCAGGGGAGTAACCCGACGAAAAAACATTCAGTACTTC	CASSSRGVTRRKNIQYF	TRBV7-9	TRBJ2-4
TGTGCCAGCAGGGGGGGGAAGTATTACAATGAGCAGTTCTTC	CASRGGKYYNEQFF	TRBV2	TRBJ2-1
TGTGCCAGCAGTTCCTACCGGGACAGGGGGGAAACTGGAAACACCATATATTTT	CASSSYRDRGETGNTIYF	TRBV27	TRBJ1-3
TGTGCCAGCAGCGGGGCTAGCGGGTTACCCATCTACGAGCAGTACTTC	CASSGASGLPIYEQYF	TRBV7-9	TRBJ2-7
TGTGCCAGCAGTTTGTCCCAGGGGAACCGGTACAATGAGCAGTTCTTC	CASSLSQGNRYNEQFF	TRBV12-3	TRBJ2-1
TGCAGTGCTAGAGAAACAGGGGGTTTAACCTACGAGCAGTACTTC	CSARETGGLTYEQYF	TRBV20-1	TRBJ2-7
TGTGCCAGCAGCTTTTCGGCGGTTTGGACCCAGTACTTC	CASSFSAVWTQYF	TRBV5-4	TRBJ2-5
TGTGCCTGGAGTGTAGAGGAGGGACAAGGCAATCAGCCCCAGCATTTT	CAWSVEEGQGNQPQHF	TRBV30	TRBJ1-5
TGCAGCCGAGTCGGGAGGGTTGATTATGGCTACACCTTC	CSRVGRVDYGYTF	TRBV29-1	TRBJ1-2
TGTGCCAGCAGCTTAGGATCGTCAGGGACCGGGGAGCTGTTTTTT	CASSLGSSGTGELFF	TRBV7-3	TRBJ2-2
TGTGCCAGCGGAAGAGGCCTTCTATCTAGCTACGAGCAGTACTTC	CASGRGLLSSYEQYF	TRBV6-5	TRBJ2-7
TGCAGTGCTAGAAAAAACTGCCATGCTTCGACCGGGGTCAATCAGCCCCAGCATTTT	CSARKNCHASTGVNQPQHF	TRBV20-1	TRBJ1-5
TGCGCCAGCAGCGGGGAGAGCCGAAACACCATATATTTT	CASSGESRNTIYF	TRBV5-1	TRBJ1-3
TGTGCCAGCACTCGGGTCGGACAAGAGACCCAGTACTTC	CASTRVGQETQYF	TRBV6-1	TRBJ2-5
TGTGCCAGCACCAGGGCTGGGGCCAACGTCCTGACTTTC	CASTRAGANVLTF	TRBV7-9	TRBJ2-6
TGTGCCAGCAGCCTATCCGGGACTAGGGTTTATCTACGGTCCTACGAGCAGTACTTC	CASSLSGTRVYLRSYEQYF	TRBV13	TRBJ2-7
TGTGCCAGTAGTATAGTTACACAGGGGGCATTTTGGAACATTCAGTACTTC	CASSIVTQGAFWNIQYF	TRBV19	TRBJ2-4
TGTGCCAGCTCGGGGGGCAGCTTTAGGAGCGAGGCCGCCGGGATGACCGGGGAGCTGTTTTTT	CASSGGSFRSEAAGMTGELFF	TRBV6-2	TRBJ2-2
TGTGCCAGCATCACCCCAGGGACAAGATATGAGCAGTTCTTC	CASITPGTRYEQFF	TRBV6-4	TRBJ2-1
TGTGCCAGCAGCTTAGGTAAATGGACCTTC	CASSLGKWTF	TRBV7-4	TRBJ1-2
TGCGCCAGCAGCTTGCGGCGCCCAACGCACAGGATTGAAGCTTTCTTT	CASSLRRPTHRIEAFF	TRBV5-1	TRBJ1-1
TGTGCCAGCAGTTATCCCAGGGAGAACAATCAGCCCCAGCATTTT	CASSYPRENNQPQHF	TRBV6-3	TRBJ1-5
TGTGCCAGCAGTTCCGGACTAGCGGGGCTTCTGAGGGAGCAAGAGACCCAGTACTTC	CASSSGLAGLLREQETQYF	TRBV6-6	TRBJ2-5
TGTGCCAGCAGCGGGGGGGACAGGGGGGCTAGCAATCAGCCCCAGCATTTT	CASSGGDRGASNQPQHF	TRBV7-9	TRBJ1-5
TGTGCCTGGAATAGCCAACGGCTTGCAACTAATGAAAAACTGTTTTTT	CAWNSQRLATNEKLFF	TRBV30	TRBJ1-4
TGTGCCAGCAGCCAAGATAATGGCTACACCTTC	CASSQDNGYTF	TRBV3-1	TRBJ1-2
TGTGCCAGCACGAGGGGACCCCCCAATCAGCCCCAGCATTTT	CASTRGPPNQPQHF	TRBV27	TRBJ1-5
TGTGCCACCAGTGATTTGCAAGACGGACAGGAAAATCAGCCCCAGCATTTT	CATSDLQDGQENQPQHF	TRBV24-1	TRBJ1-5
TGCAGCGTTGTGGCTGAGGAGTCCTACGAGCAGTACTTC	CSVVAEESYEQYF	TRBV29-1	TRBJ2-7
TGTGCCAGCAGCCCTCGACAGGGGCTCCCCTGCAATCAGCCCCAGCATTTT	CASSPRQGLPCNQPQHF	TRBV7-7	TRBJ1-5
TGTGCCAGCAGCTTAACGCCCTCGACATTAGCGAAAGAGACCCAGTACTTC	CASSLTPSTLAKETQYF	TRBV7-3	TRBJ2-5
TGTGCCAGCAGTAGGGAGCTTCCTGAAGCTTTCTTT	CASSRELPEAFF	TRBV12-4	TRBJ1-1
TGCAGTGCTTCGGGGTATAGCAATCAGCCCCAGCATTTT	CSASGYSNQPQHF	TRBV20-1	TRBJ1-5
TGTGCCAGCAGTTTTACCCGGGACAGGGACCACTACGAGCAGTACTTC	CASSFTRDRDHYEQYF	TRBV28	TRBJ2-7
TGTGCCAGCAGCGTCGGGGGCGGGTATAATTCACCCCTCCACTTT	CASSVGGGYNSPLHF	TRBV13	TRBJ1-6
TGTGCCAGCAGCCGGCAAGGACTAACCTTTAGCTCCTACAATGAGCAGTTCTTC	CASSRQGLTFSSYNEQFF	TRBV14	TRBJ2-1
TGCAGTGCCAGGGGCGGAGAGCAGTTCTTC	CSARGGEQFF	TRBV20-1	TRBJ2-1
TGTGCCAGCAGTTTATGTGGGGGGAGTCGCACAGATACGCAGTATTTT	CASSLCGGSRTDTQYF	TRBV28	TRBJ2-3
TGTGCCAGCAGCTGTCCGGGGGGGGCGAGTGAGCAGTATTTT	CASSCPGGASEQYF	TRBV11-3	TRBJ2-3
TGTGCCAGCAGTGAAGAGATTCCATCAGGGAGAGGGGCCTACGAGCAGTACTTC	CASSEEIPSGRGAYEQYF	TRBV2	TRBJ2-7
TGTGCCAGCAGCCAGGGACGGGGGGACGAGCAGTACTTC	CASSQGRGDEQYF	TRBV7-4	TRBJ2-7
TGTGCCACCGGCAACCTGGCTGTGAGTCTCGGAAACACCATATATTTT	CATGNLAVSLGNTIYF	TRBV24-1	TRBJ1-3
TGTGCCAGCAGCCAAGACAGAACCCCGGACAGGGTAAGCTATGGCTACACCTTC	CASSQDRTPDRVSYGYTF	TRBV14	TRBJ1-2
TGTGCCAGCAGTTTCAGCGGGAAATACAATGAGCAGTTCTTC	CASSFSGKYNEQFF	TRBV27	TRBJ2-1
TGTGCCAGCAGGACAGGGGAGACTTTTTACAATGAGCAGTTCTTC	CASRTGETFYNEQFF	TRBV11-3	TRBJ2-1
TGCAGTGCTAGAAGGTCTCGGGGGGGGCCGCCCTATGGCTACACCTTC	CSARRSRGGPPYGYTF	TRBV20-1	TRBJ1-2
TGTGCCACTGGGACGTACACTGAAGCTTTCTTT	CATGTYTEAFF	TRBV12-3	TRBJ1-1
TGTGCCAGCAGTTTTTCCCCCGGACTGACAGGGGAGACCTACGAGCAGTACTTC	CASSFSPGLTGETYEQYF	TRBV12-3	TRBJ2-7
TGTGCCAGCAGCCCCCCAGGGGGGAACGAGCAGTACTTC	CASSPPGGNEQYF	TRBV11-3	TRBJ2-7
TGCGCCAGCAGTGAGCCCAATGCATACGAGCAGTACTTC	CASSEPNAYEQYF	TRBV10-2	TRBJ2-7
TGCGCCAGCAGCCAAGATGGGACTAAAACGTACGAGCAGTACTTC	CASSQDGTKTYEQYF	TRBV4-1	TRBJ2-7
TGTGCCAGCAGTCCCCGAGGGACTAGCGGGAAAGACAATGAGCAGTTCTTC	CASSPRGTSGKDNEQFF	TRBV7-3	TRBJ2-1
TGTGCCAGCAGAAGCCCGGAGGGCGCCTACGAGCAGTACTTC	CASRSPEGAYEQYF	TRBV6-4	TRBJ2-7
TGCGCCACTCGGCTAGAACAAGAGACCCAGTACTTC	CATRLEQETQYF	TRBV5-1	TRBJ2-5
TGCGCCAGTCCCCGACGCTACGAGCAGTACTTC	CASPRRYEQYF	TRBV10-1	TRBJ2-7
TGTGCCAGCAGTGAAGCTCCTATGAACAATCAGCCCCAGCATTTT	CASSEAPMNNQPQHF	TRBV2	TRBJ1-5
TGCGCCAGCAGTGAGGGACACGGGAACACTGAAGCTTTCTTT	CASSEGHGNTEAFF	TRBV10-1	TRBJ1-1
TGTGCCAGCAGTTTACACCTCCGTTTCAGCTACACTAATGAAAAACTGTTTTTT	CASSLHLRFSYTNEKLFF	TRBV12-3	TRBJ1-4
TGCAGTGCGGGCTACAATGAGCAGTTCTTC	CSAGYNEQFF	TRBV20-1	TRBJ2-1
TGTGCCAGCCAGGCGTACGAGCAGTACTTC	CASQAYEQYF	TRBV27	TRBJ2-7
TGTGCCAGCAGTTTTGCACGGGCGGTTTTGAACACTGAAGCTTTCTTT	CASSFARAVLNTEAFF	TRBV12-3	TRBJ1-1
TGCGCCAGCAGTGAGACAGGGCCACAGCCCCAGCATTTT	CASSETGPQPQHF	TRBV10-1	TRBJ1-5
TGTGCCAGCAGTTACCAACAGGAAAGCGATGCAACTAATGAAAAACTGTTTTTT	CASSYQQESDATNEKLFF	TRBV6-6	TRBJ1-4
TGTGCCAGCAGCCCCGGACAGGGCGGGGGTATCTATGGCTACACCTTC	CASSPGQGGGIYGYTF	TRBV13	TRBJ1-2
TGTGCCAGCGAAACTCACAACTATGGCTACACCTTC	CASETHNYGYTF	TRBV7-3	TRBJ1-2
TGTGCCAGCACGGGGGGGAGCACAGATACGCAGTATTTT	CASTGGSTDTQYF	TRBV6-4	TRBJ2-3
TGTGCCAGCAGTTCTCCCTTATCGGGACAGGGGCGGGGAAAACTGTTTTTT	CASSSPLSGQGRGKLFF	TRBV6-2	TRBJ1-4
TGTGCCAGCAGTTCTGGACAGGGAGGGTATGAGCAGTTCTTC	CASSSGQGGYEQFF	TRBV2	TRBJ2-1
TGCAGTGCTGTTTGTCGTAATGAAAAACTGTTTTTT	CSAVCRNEKLFF	TRBV20-1	TRBJ1-4
TGTGCCAGCAGCTTATTGGGCGGACAGGCTAGCTCCTACGAGCAGTACTTC	CASSLLGGQASSYEQYF	TRBV7-3	TRBJ2-7
TGTGCCAGCAGTGACCAGGACGAGCAGTACTTC	CASSDQDEQYF	TRBV6-4	TRBJ2-7
TGTGCCACCGTAGTCTACTCTGGAAACACCATATATTTT	CATVVYSGNTIYF	TRBV24-1	TRBJ1-3
TGTGCCAGCAGTTTAAGGCAAGGACTATATTTCTTC	CASSLRQGLYFF	TRBV28	TRBJ2-1
TGTGCCAGCAGCTCCCGACAGGGTCGGACAGATACGCAGTATTTT	CASSSRQGRTDTQYF	TRBV5-5	TRBJ2-3
TGTGCCAGCAGCTTACGGGGAAAACTAGCGAGGCGGTACAATGAGCAGTTCTTC	CASSLRGKLARRYNEQFF	TRBV7-4	TRBJ2-1
TGTGCCAGCAGTTTGGACAGGGGAGAGACCCAGTACTTC	CASSLDRGETQYF	TRBV12-4	TRBJ2-5
TGCGCCAGCAGCTTTCCCCCCCCGGGACAGGGCCGACTCTTCGAAAAACTGTTTTTT	CASSFPPPGQGRLFEKLFF	TRBV5-1	TRBJ1-4
TGTGCCAGCACCAGCGGGAGGTTCTACGAGCAGTACTTC	CASTSGRFYEQYF	TRBV5-6	TRBJ2-7
TGTGCCAGCAGCTTAACGGGTGGGGGCATCTTCAATTCACCCCTCCACTTT	CASSLTGGGIFNSPLHF	TRBV7-3	TRBJ1-6
TGTGCCACAGCCAGCGGGAAGCTGGAGTGCTCCTACAATGAGCAGTTCTTC	CATASGKLECSYNEQFF	TRBV28	TRBJ2-1
TGTGCCAGTAGTACAGGGGGGACCGGGGAGCTGTTTTTT	CASSTGGTGELFF	TRBV19	TRBJ2-2
TGCGCCAGCAGCCAAGCGGGGACCCCTCAGCCCCAGCATTTT	CASSQAGTPQPQHF	TRBV4-1	TRBJ1-5
TGTGCCAGCAGGGGGATCCAAGAGACCCAGTACTTC	CASRGIQETQYF	TRBV6-4	TRBJ2-5
TGTGCCACCCCGTTAGGTGGTGGCTACACCTTC	CATPLGGGYTF	TRBV24-1	TRBJ1-2
TGTGCCAGTTCGACAGGGGGGAACTGCAATCAGCCCCAGCATTTT	CASSTGGNCNQPQHF	TRBV19	TRBJ1-5
TGTGCCAGCAGTGAAGCGCTCCCAACTGAAGCTTTCTTT	CASSEALPTEAFF	TRBV6-1	TRBJ1-1
TGCAGTGCTAGATTCAACCACGGATCTGGGGCCAACGTCCTGACTTTC	CSARFNHGSGANVLTF	TRBV20-1	TRBJ2-6
TGTGCCAGCAGCTTAGGACTAGCGGGGAGAGGATTGGGCGAGCAGTACTTC	CASSLGLAGRGLGEQYF	TRBV7-3	TRBJ2-7
TGTGCCAGCAGTTGGGAACAGGGTGGCGAGAATTCACCCCTCCACTTT	CASSWEQGGENSPLHF	TRBV6-6	TRBJ1-6
TGTGCCAGCAGTTACTTAAGGCAGGTGTCCTACGAGCAGTACTTC	CASSYLRQVSYEQYF	TRBV6-5	TRBJ2-7
TGCAGTTGGCCATCCCCGGGACAGGGGGATTACACTGAAGCTTTCTTT	CSWPSPGQGDYTEAFF	TRBV20-1	TRBJ1-1
