TGCAGTGCTAGAGTTCGACCGGGACAGGGCGAGTTCGAAAAACTGTTTTTT	CSARVRPGQGEFEKLFF	TRBV20-1	TRBJ1-4
TGTGCCAGCAGCTTGGCCCCGGGACAGGGGGCGGAATACAATGAGCAGTTCTTC	CASSLAPGQGAEYNEQFF	TRBV5-6	TRBJ2-1
TGTGCCAGCAGCACCTCCCATCAGGGGCCGTGGCCCCAGCATTTT	CASSTSHQGPWPQHF	TRBV7-9	TRBJ1-5
TGTGCCAGCAGCTTAGCCTGCGACCCCAGGGATAGAGCGACTGCAACTAATGAAAAACTGTTTTTT	CASSLACDPRDRATATNEKLFF	TRBV7-4	TRBJ1-4
TGTGCCAGCAGCTGGAGACTAGCGCCCTTCGGGGAGCTGTTTTTT	CASSWRLAPFGELFF	TRBV5-6	TRBJ2-2
TGTGCCAGCAGTCGGCGGGGGGGGTGGAGCAATCAGCCCCAGCATTTT	CASSRRGGWSNQPQHF	TRBV27	TRBJ1-5
TGTGCCAGCAGTTATGGACTGGGAAGCTCCTACGAGCAGTACTTC	CASSYGLGSSYEQYF	TRBV6-3	TRBJ2-7
TGTGCCAGCAGCGGGCCCCGCAGGGAAGCCTACTCTGGGGCCAACGTCCTGACTTTC	CASSGPRREAYSGANVLTF	TRBV13	TRBJ2-6
TGCAGTGCTCCTTTTCACCAGGGGTCGGAAAACACCGGGGAGCTGTTTTTT	CSAPFHQGSENTGELFF	TRBV20-1	TRBJ2-2
TGTGCCAGCACCAGGGCAACGGACCATCAGCCCCAGCATTTT	CASTRATDHQPQHF	TRBV25-1	TRBJ1-5
TGTGCCAGCAGCCCCAGGGGGAGCTACGAGCAGTACTTC	CASSPRGSYEQYF	TRBV5-4	TRBJ2-7
TGTGCCAGCAGGGGGGTCGCGAAGACCCAGTACTTC	CASRGVAKTQYF	TRBV11-2	TRBJ2-5
TGTGCCAGCAGTTACGATTATCGGTCCTACGAGCAGTACTTC	CASSYDYRSYEQYF	TRBV6-5	TRBJ2-7
TGTGCCAGCAGTGAACCTAGGAGTTTGAACACTGAAGCTTTCTTT	CASSEPRSLNTEAFF	TRBV2	TRBJ1-1
TGCGCCAGCAGCTCTCCACAGCGGGAGGTACTAGCCAAAAACATTCAGTACTTC	CASSSPQREVLAKNIQYF	TRBV5-1	TRBJ2-4
TGTGCCAGCAGTTCGATAGCAGGGAGGGATTCCATCTCCTACGAGCAGTACTTC	CASSSIAGRDSISYEQYF	TRBV6-5	TRBJ2-7
TGTGCCAGCAGGCGTCGGGAGGGGTCCGTAACCGGGGAGCTGTTTTTT	CASRRREGSVTGELFF	TRBV9	TRBJ2-2
TGTGCCAGCAGCGTGGGGGGGCGGGTAGATACGCAGTATTTT	CASSVGGRVDTQYF	TRBV6-4	TRBJ2-3
TGTGCCAGCAGCGGGGGGGGGGACTACGAGCAGTACTTC	CASSGGGDYEQYF	TRBV9	TRBJ2-7
TGTGCCAGCGGTGTTGCTAGCGGAAGCAGCGGCTACACCTTC	CASGVASGSSGYTF	TRBV6-5	TRBJ1-2
TGTGCCACCAGTGAAGGCTGGGGCAGCAATCAGCCCCAGCATTTT	CATSEGWGSNQPQHF	TRBV24-1	TRBJ1-5
TGTGCCAGCAGCCAAGTCTGTCTAGGGAAGATTGAGACCCAGTACTTC	CASSQVCLGKIETQYF	TRBV3-1	TRBJ2-5
TGTGCCAGCAGCTACAGTAAGTATAGCAATCAGCCCCAGCATTTT	CASSYSKYSNQPQHF	TRBV2	TRBJ1-5
TGTGCCAGCAGTACCCCCGACAGGGGCGCCGAGTTGGCCCAGCATTTT	CASSTPDRGAELAQHF	TRBV6-5	TRBJ1-5
TGTGCCAGCCCAAGACTGGGGTGCACAGATACGCAGTATTTT	CASPRLGCTDTQYF	TRBV6-2	TRBJ2-3
TGTGCCAGTAGTAATAATTGGGATGAGCAGTTCTTC	CASSNNWDEQFF	TRBV19	TRBJ2-1
TGTGCCAGCTCACCATCTGGACTCTCTGGAAACACCATATATTTT	CASSPSGLSGNTIYF	TRBV18	TRBJ1-3
TGTGCCAGCAGTTATGGGGGAGTAAACATTCAGTACTTC	CASSYGGVNIQYF	TRBV27	TRBJ2-4
TGTGCCAGCAGCGGATCCATTCAGTGTTATAGGAACACTGAAGCTTTCTTT	CASSGSIQCYRNTEAFF	TRBV9	TRBJ1-1
TGTGCGGGGGATCCCTACGAGCAGTACTTC	CAGDPYEQYF	TRBV12-5	TRBJ2-7
TGCCCCACAGGGTACCATAATAGCAATCAGCCCCAGCATTTT	CPTGYHNSNQPQHF	TRBV10-2	TRBJ1-5
TGTGCCAGCAGTGTACCCAAGCACTACTGGTACGAGCAGTACTTC	CASSVPKHYWYEQYF	TRBV27	TRBJ2-7
TGTGCCAGCAGCGTCGCATGGACAGGGCGCACAGATACGCAGTATTTT	CASSVAWTGRTDTQYF	TRBV9	TRBJ2-3
TGTGCCTGGAGTGAAGCAGGAGGCTCCTACGAGCAGTACTTC	CAWSEAGGSYEQYF	TRBV30	TRBJ2-7
TGTGCCAGCAGCACGGAAGAGGTTTACAATGAGCAGTTCTTC	CASSTEEVYNEQFF	TRBV11-2	TRBJ2-1
TGCAGCAACCCGGGACAGGGCAACTACGAGCAGTACTTC	CSNPGQGNYEQYF	TRBV29-1	TRBJ2-7
TGTGCCAGCAGGTACGCGGGGTCCTACGAGCAGTACTTC	CASRYAGSYEQYF	TRBV6-8	TRBJ2-7
TGTGCCAGCATTACGGTGAACACCGGGGAGCTGTTTTTT	CASITVNTGELFF	TRBV6-4	TRBJ2-2
TGTGCCAGCAGCTTACATAGTAGCAGGCCCGGTCAGCCCCAGCATTTT	CASSLHSSRPGQPQHF	TRBV7-9	TRBJ1-5
TGTGCCTGGGTTGGAGGTTTAAAACAGCCCCAGCATTTT	CAWVGGLKQPQHF	TRBV30	TRBJ1-5
TGCGCCAGCAGTGAGCAATTCACAGGGAGCGCAACTAATGAAAAACTGTTTTTT	CASSEQFTGSATNEKLFF	TRBV10-1	TRBJ1-4
TGTGCCAGCAGTCGCGGACCTAGAGCTCAGCCCCAGCATTTT	CASSRGPRAQPQHF	TRBV6-4	TRBJ1-5
TGTGCCAGCACCCAACCGGCCCGGGACTACCTCAACTACGAGCAGTACTTC	CASTQPARDYLNYEQYF	TRBV11-2	TRBJ2-7
TGTGCCAGCAGTGAAGCCCGGGGCTCTGGAAACACCATATATTTT	CASSEARGSGNTIYF	TRBV6-1	TRBJ1-3
TGTGCCAGCAGCGGGACAGGGGCCGGGGGCTACACCTTC	CASSGTGAGGYTF	TRBV13	TRBJ1-2
TGTGCCACCAGTGATTGTGGACAGGGGGGGGAGAACACTGAAGCTTTCTTT	CATSDCGQGGENTEAFF	TRBV24-1	TRBJ1-1
TGCGCCAGCCCGGGGGGAGTCAATCAGCCCCAGCATTTT	CASPGGVNQPQHF	TRBV5-1	TRBJ1-5
TGCAGCGTTGCGACAGACACTAATGAAAAACTGTTTTTT	CSVATDTNEKLFF	TRBV29-1	TRBJ1-4
TGTGCCAGCAGCTTGGAACCAACAGCGGTTGGCTACACCTTC	CASSLEPTAVGYTF	TRBV5-4	TRBJ1-2
TGCAGTGCTAGAGTAGGGGGTCCGACGGAAGAGACCCAGTACTTC	CSARVGGPTEETQYF	TRBV20-1	TRBJ2-5
TGCGCCAGCAGCTTGCGGACAGGGGGGGGTAATTCACCCCTCCACTTT	CASSLRTGGGNSPLHF	TRBV5-1	TRBJ1-6
TGTGCCAGCAGCACTCGGGGACTAGCGGGGGGGCCCTGCTACGAGCAGTACTTC	CASSTRGLAGGPCYEQYF	TRBV7-9	TRBJ2-7
TGTGCCATCAGGTTGCCGGGACATGAAGCCTACGAGCAGTACTTC	CAIRLPGHEAYEQYF	TRBV10-3	TRBJ2-7
TGCGCCAGCAGCTTGCCTTCGAGACCGGGACTAGCGGGGGGGCAAAATGAGCAGTTCTTC	CASSLPSRPGLAGGQNEQFF	TRBV5-1	TRBJ2-1
TGTGCCAGCAGCTTGGAATCGCACCTCTGTTACGAGCAGTACTTC	CASSLESHLCYEQYF	TRBV5-4	TRBJ2-7
TGCAGTGCTAGTACCGGACTAGCGGTCGACAATGAGCAGTTCTTC	CSASTGLAVDNEQFF	TRBV20-1	TRBJ2-1
TGTGCCAGGCCTGGGGATGGAAACACCATATATTTT	CARPGDGNTIYF	TRBV13	TRBJ1-3
TGTGCCAGCAGTCCGAGCGACACCGGGGAGCTGTTTTTT	CASSPSDTGELFF	TRBV27	TRBJ2-2
TGTGCCAGCAGCTTAACTTACAGAATCTACGAGCAGTACTTC	CASSLTYRIYEQYF	TRBV7-9	TRBJ2-7
TGTGCCAGCCGGGGAGATTTCACAGATACGCAGTATTTT	CASRGDFTDTQYF	TRBV19	TRBJ2-3
TGTGCCACGGGGAGGGGGGCTTATGAGCAGTTCTTC	CATGRGAYEQFF	TRBV24-1	TRBJ2-1
TGTGCCAGCGACAGGGGCTTCGTCAACGAGCAGTACTTC	CASDRGFVNEQYF	TRBV5-8	TRBJ2-7
TGTGCCAGCAGCTGGGGGGGCGGTTCGGGCTACACCTTC	CASSWGGGSGYTF	TRBV5-5	TRBJ1-2
TGTGCCAGCAGTGAATCCCAAATTTGCCCAGGGATGAAATCGGAAGCTTTCTTT	CASSESQICPGMKSEAFF	TRBV25-1	TRBJ1-1
TGTGCCAGCAGTTTACGGGACAGTCGGATCGGGGGGTATAATTCACCCCTCCACTTT	CASSLRDSRIGGYNSPLHF	TRBV28	TRBJ1-6
TGTGCCAGCAGTGAAGCTTCCCAAGAAGAAGAAGAGACCCAGTACTTC	CASSEASQEEEETQYF	TRBV2	TRBJ2-5
TGTGAACTAGCGGGAGAGGCTTCCTACGAGCAGTACTTC	CELAGEASYEQYF	TRBV9	TRBJ2-7
TGTGCCAGCAGTGGGAATTCACAGGGGGCGCAACGACCCAACTATGGCTACACCTTC	CASSGNSQGAQRPNYGYTF	TRBV6-4	TRBJ1-2
TGTGCCTGGATGACTGAAGCTTTCTTT	CAWMTEAFF	TRBV30	TRBJ1-1
TGTGCCAGCAGTCGGCAGGAAGAGACCCAGTACTTC	CASSRQEETQYF	TRBV12-4	TRBJ2-5
TGCGCCAGCAGCCACACAAGTTCACCGGAGTGGCGGTGTCAAGAGACCCAGTACTTC	CASSHTSSPEWRCQETQYF	TRBV4-3	TRBJ2-5
TGTGCCAGCAGCCCCCTCAGCCGAGAGTACGAGCAGTACTTC	CASSPLSREYEQYF	TRBV13	TRBJ2-7
TGTGCCAGCAGCCGATCCCGACCAGGGGTTGACGAGCAGTACTTC	CASSRSRPGVDEQYF	TRBV3-1	TRBJ2-7
TGCAGTGCTAGAGATACGGGATGCTCCTACAATGAGCAGTTCTTC	CSARDTGCSYNEQFF	TRBV20-1	TRBJ2-1
TGTGCCAGCAGCGTTGTAGAGCCCCACGAGCAGTACTTC	CASSVVEPHEQYF	TRBV9	TRBJ2-7
TGTGCCAGCAGAAACCAGGCGCTGTCCCAAGAGACCCAGTACTTC	CASRNQALSQETQYF	TRBV27	TRBJ2-5
TGCAGTGCCGGGGACAGTCTGGGCTCTAATGAAAAACTGTTTTTT	CSAGDSLGSNEKLFF	TRBV20-1	TRBJ1-4
TGTGCCAGCAGTTGGGCCAGGGGGCAGCCCCAGCATTTT	CASSWARGQPQHF	TRBV6-9	TRBJ1-5
TGTGCCAGCAGTTACTCCCTAGCGGGGTCCGCCCGCTACAATGAGCAGTTCTTC	CASSYSLAGSARYNEQFF	TRBV6-6	TRBJ2-1
TGTGCCAGCAGACCCCGGGACTTTGAGCAGTTCTTC	CASRPRDFEQFF	TRBV6-3	TRBJ2-1
TGTGCCTGGAGTGTATCCCCGGGACAGGGGACTCCTGCTTTCTTT	CAWSVSPGQGTPAFF	TRBV30	TRBJ1-1
TGTGCCAGCAGCTTAGAACCGAAAACCGACACAGATACGCAGTATTTT	CASSLEPKTDTDTQYF	TRBV11-2	TRBJ2-3
TGTGCTAGCAGCTTCTTTAGGGACACAGATACGCAGTATTTT	CASSFFRDTDTQYF	TRBV7-7	TRBJ2-3
TGTGCCAGCAGCATAAGGGAGGCAGATACGCAGTATTTT	CASSIREADTQYF	TRBV13	TRBJ2-3
TGTGCCACCAGTCCTCCTCCGGGACTAGCGGCCCCTTACTCCTACAATGAGCAGTTCTTC	CATSPPPGLAAPYSYNEQFF	TRBV24-1	TRBJ2-1
TGTGCCAGCAGCCAAGCACTTCAGGCCGCTTTCTTT	CASSQALQAAFF	TRBV3-1	TRBJ1-1
TGTGCCAGCAGTCAGAGGGACAGGGCCACAGATACGCAGTATTTT	CASSQRDRATDTQYF	TRBV6-3	TRBJ2-3
TGCGCCAGCAGCAGCGACCCCCCTATAAAATCTGGAAACACCATATATTTT	CASSSDPPIKSGNTIYF	TRBV10-1	TRBJ1-3
TGTGCCAGCAGCTTAACTCGGGACAGGGAAAAACTGTTTTTT	CASSLTRDREKLFF	TRBV7-2	TRBJ1-4
TGCAGTGCTAGAGATACCGAGGGGAGGCTGCACGAGCAGTACTTC	CSARDTEGRLHEQYF	TRBV20-1	TRBJ2-7
TGTGCCATCAGTGAGTGTGGGCTCCTGCTACTGAACACCGGGGAGCTGTTTTTT	CAISECGLLLLNTGELFF	TRBV10-3	TRBJ2-2
TGCGCCGGCCCGTCCAGGGTACTATCACCCCTCCACTTT	CAGPSRVLSPLHF	TRBV10-2	TRBJ1-6
TGTGCCAGATTTACTCAGGGGGAGCACACCGGGGAGCTGTTTTTT	CARFTQGEHTGELFF	TRBV6-1	TRBJ2-2
TGTGCCAGCAGCGGGACGATGTATGGCTACACCTTC	CASSGTMYGYTF	TRBV2	TRBJ1-2
TGTGCCAGCAGCTTGTGGACTAGCGGGAAAGTGCAGTACTTC	CASSLWTSGKVQYF	TRBV7-2	TRBJ2-7
TGTGCCAGCAGCTCCGCAAGGGACACCGGGGAGCTGTTTTTT	CASSSARDTGELFF	TRBV7-7	TRBJ2-2
TGTGCCAGCAGCTTACTTGGCGGGAGAAAGCCGCAGTACTTC	CASSLLGGRKPQYF	TRBV11-3	TRBJ2-7
TGTGCCAGCAGCTTAGGGCACTGGCTAGAGACCCAGTACTTC	CASSLGHWLETQYF	TRBV7-2	TRBJ2-5
TGCAGTGCTAGATCCCCTAGCTCCTACGAGCAGTACTTC	CSARSPSSYEQYF	TRBV20-1	TRBJ2-7
TGTGCTAGGCCTAAGGGGGGGGAGAGCTACGAGCAGTACTTC	CARPKGGESYEQYF	TRBV12-5	TRBJ2-7
TGTGCCAGCAGCTACCAGGCGGACTCTGGAAACACCATATATTTT	CASSYQADSGNTIYF	TRBV5-4	TRBJ1-3
TGCGCCAGCAGTGAGCGAAATTCGCGACAGGGGGCGTATCAGCCCCAGCATTTT	CASSERNSRQGAYQPQHF	TRBV10-1	TRBJ1-5
TGCAGCGTTGAAGGACAGGGAGGTCCGGCGAACACTGAAGCTTTCTTT	CSVEGQGGPANTEAFF	TRBV29-1	TRBJ1-1
TGCGCCAGCAGCCCCGGACACGGGGCCGGCAATCAGCCCCAGCATTTT	CASSPGHGAGNQPQHF	TRBV5-1	TRBJ1-5
TGTGCCACATCTACGGACAGGGAAGGTAATTCACCCCTCCACTTT	CATSTDREGNSPLHF	TRBV6-5	TRBJ1-6
TGTGCCAGCAGCGAACAGCCAGGCTACGAGCAGTACTTC	CASSEQPGYEQYF	TRBV7-3	TRBJ2-7
TGTGCCAGCAGCCGGGAACGGCCGCCCTACGAGCAGTACTTC	CASSRERPPYEQYF	TRBV11-2	TRBJ2-7
TGTGCCACCCCGACAGGGGGAGCTCGCACAGATACGCAGTATTTT	CATPTGGARTDTQYF	TRBV6-1	TRBJ2-3
TGTGCCAGCAGTTACTCGCGGGCTTATGGCTACACCTTC	CASSYSRAYGYTF	TRBV6-5	TRBJ1-2
TGTGCCACCACTCTGTCAGGGAGTCTCTTC	CATTLSGSLF	TRBV24-1	TRBJ2-1
TGTGCCAGCAGCGGTTACGAGGAACACAGGGGGAAGAATCAGCCCCAGCATTTT	CASSGYEEHRGKNQPQHF	TRBV6-4	TRBJ1-5
TGTGCCAGCAGGGGGGGCTACACCTTC	CASRGGYTF	TRBV5-4	TRBJ1-2
TGCGCCAGCAGATTGGTAGACCTAGAGACCCAGTACTTC	CASRLVDLETQYF	TRBV10-1	TRBJ2-5
TGTGCCAGCAGCCACCTTCCCCGGGGTCAGGCCTATGGCTACACCTTC	CASSHLPRGQAYGYTF	TRBV3-1	TRBJ1-2
TGCGCCAGGGAGGGACAGCGAAACACCATATATTTT	CAREGQRNTIYF	TRBV5-1	TRBJ1-3
TGTGCCAGCAGCTCATCGACGAATGAGCAGTTCTTC	CASSSSTNEQFF	TRBV5-6	TRBJ2-1
TGTGCCAGCAGCCAATTAGGGGCCCAAGAGACCCAGTACTTC	CASSQLGAQETQYF	TRBV3-1	TRBJ2-5
TGCGCCAGCAGTGACTTCCGGGACAGGGGGCGCCGTTCAGATACGCAGTATTTT	CASSDFRDRGRRSDTQYF	TRBV10-1	TRBJ2-3
TGTGCCAGCAGCTTTTTCTCGGGGACTAGCGGGCCCAATGAGCAGTTCTTC	CASSFFSGTSGPNEQFF	TRBV5-4	TRBJ2-1
TGTGCCAGCAGCCAAGCTACCCGGGACCAAGAGACCCAGTACTTC	CASSQATRDQETQYF	TRBV3-1	TRBJ2-5
TGTGCCAGCAGCTTAGGACTAATGACGGCAACCGGGGAGCTGTTTTTT	CASSLGLMTATGELFF	TRBV11-2	TRBJ2-2
TGTGCCAGCAGCCCTAAGGGGAGAAACGCGGACGGGGAGCTGTTTTTT	CASSPKGRNADGELFF	TRBV25-1	TRBJ2-2
TGTGCCAGCAGCTTAGGCGTCGGGGCCTACGAGCAGTACTTC	CASSLGVGAYEQYF	TRBV7-6	TRBJ2-7
TGCGCCAGCAGCTTGGTGCCCAGGGATGGCTACACCTTC	CASSLVPRDGYTF	TRBV5-1	TRBJ1-2
TGTGCCAGCAGTGACAATCGGACCTACAATGAGCAGTTCTTC	CASSDNRTYNEQFF	TRBV6-1	TRBJ2-1
TGTGCCAGCAGACCGGTCTCACAGGGGGATGGCTACACCTTC	CASRPVSQGDGYTF	TRBV5-6	TRBJ1-2
TGTGCCAGCAGAGTGGGCGGGACAGGGGCTTCACCCCTCCACTTT	CASRVGGTGASPLHF	TRBV11-3	TRBJ1-6
TGTGCCAGCAGCCGGGACAGGGGGCCGGCCAAAAACATTCAGTACTTC	CASSRDRGPAKNIQYF	TRBV3-1	TRBJ2-4
TGTGCCAGCAGCCTGAGGGGCGCCTGTGAGACCCAGTACTTC	CASSLRGACETQYF	TRBV7-9	TRBJ2-5
TGTGCCATCAGTAACTACACTGGGAGTGAGCAAGAGACCCAGTACTTC	CAISNYTGSEQETQYF	TRBV10-3	TRBJ2-5
TGTGCCACCAGTGATTTGCAACCCAGGCTGTTCTACGAGCAGTACTTC	CATSDLQPRLFYEQYF	TRBV24-1	TRBJ2-7
TGTGCCAGCAGCATGGGACGCTTACAGGATGGCTACACCTTC	CASSMGRLQDGYTF	TRBV7-4	TRBJ1-2
TGTGCCTGGAGTTTTAACCGGGTGACAGGATTAGGGGGCCAGCCCCAGCATTTT	CAWSFNRVTGLGGQPQHF	TRBV30	TRBJ1-5
TGTGCCAGCAGTCTTCGAACTCGGACTAGAGACAATGAGCAGTTCTTC	CASSLRTRTRDNEQFF	TRBV27	TRBJ2-1
TGTGCCAGCAGCTTACAGGGTCTCCGAAACACCATATATTTT	CASSLQGLRNTIYF	TRBV7-8	TRBJ1-3
TGCGCCAGCAGTCGAATCGGCTCCTCACAGGGACCTAACTATGGCTACACCTTC	CASSRIGSSQGPNYGYTF	TRBV10-1	TRBJ1-2
TGTGCCAGCAGCACACAGGGCAGGAGGGAATATGGCTACACCTTC	CASSTQGRREYGYTF	TRBV13	TRBJ1-2
TGTGCCAGCAGCAGAGGGGATCAGGGCGGCTACAATGAGCAGTTCTTC	CASSRGDQGGYNEQFF	TRBV13	TRBJ2-1
TGTGCCAGCTCACCACCCACAGGGTGGTATGGCTACACCTTC	CASSPPTGWYGYTF	TRBV18	TRBJ1-2
TGTGCCAGCAGCTTAACTGGGACAGGGGAGTTCTCTGGGGCCAACGTCCTGACTTTC	CASSLTGTGEFSGANVLTF	TRBV7-4	TRBJ2-6
TGTGCCAGCAGCTCGGTCAAGTGCGTTGGCCGTCAGACTAGACTTAATGAGCAGTTCTTC	CASSSVKCVGRQTRLNEQFF	TRBV7-9	TRBJ2-1
TGTGCCAGCAGTCAAACCTTTCTGAGCTGGGAGACCCAGTACTTC	CASSQTFLSWETQYF	TRBV6-2	TRBJ2-5
TGTGCCAGCAGTTTAACGGCTAGCGGGGGGGCCGATACGCAGTATTTT	CASSLTASGGADTQYF	TRBV28	TRBJ2-3
TGTGCCAGCAGCTTAGAGACAGGGCGAGTCTATGGCTACACCTTC	CASSLETGRVYGYTF	TRBV11-3	TRBJ1-2
TGTGCCAGCAGCCGGGGGTCCGGACTAGCGGGACTTGGATACACCGGGGAGCTGTTTTTT	CASSRGSGLAGLGYTGELFF	TRBV11-1	TRBJ2-2
TGTGCCAGTTGGAGTCAGACCCAGTACTTC	CASWSQTQYF	TRBV25-1	TRBJ2-5
TGCGCCAGCACTTACCCCAACTATGGCTACACCTTC	CASTYPNYGYTF	TRBV5-1	TRBJ1-2
TGTGCCAGCATCGGGACTAGCGGCGGAAATGAGCAGTTCTTC	CASIGTSGGNEQFF	TRBV6-2	TRBJ2-1
TGTGCCAGCAGTTATGACTGTAAAGAATCGCAGTACTTC	CASSYDCKESQYF	TRBV12-4	TRBJ2-7
TGTGCCAGCAGTGGACCCGGGACTCTTGCCACTGAAGCTTTCTTT	CASSGPGTLATEAFF	TRBV27	TRBJ1-1
TGTGCCAGCAGTTACTCGTCACAGACTAGCGGTCTTAAGGTTAATGAGCAGTTCTTC	CASSYSSQTSGLKVNEQFF	TRBV6-3	TRBJ2-1
TGCAGCGTTGTACGGGATGACAGGGGGACTGAAGCTTTCTTT	CSVVRDDRGTEAFF	TRBV29-1	TRBJ1-1
TGTGCCAGCAGCCAAGAATATTGGGGGGGCTTAGCCAAGCAAGAGACCCAGTACTTC	CASSQEYWGGLAKQETQYF	TRBV3-1	TRBJ2-5
TGTGCCAGCAGCGTGGGACAGGGGGGGAAGAACACTGAAGCTTTCTTT	CASSVGQGGKNTEAFF	TRBV6-5	TRBJ1-1
TGTGCCAGCAGTAGGCTAGCCTTTAGAACAGATACGCAGTATTTT	CASSRLAFRTDTQYF	TRBV27	TRBJ2-3
TGCAGTGCAACCCGGGCGTGTCATCAGCCCCAGCATTTT	CSATRACHQPQHF	TRBV20-1	TRBJ1-5
TGTGCCAGCAGTTCCCTGCCCCACAGGGATAATCTGGGGGAGTACGAGCAGTACTTC	CASSSLPHRDNLGEYEQYF	TRBV27	TRBJ2-7
TGTGCCACCAGTGATTTGCAAAAAAACAGGGAGAAAAACATTCAGTACTTC	CATSDLQKNREKNIQYF	TRBV24-1	TRBJ2-4
TGCAGTGCTAGACCAGGGGGGAGGGCTGGGGCCAACGTCCTGACTTTC	CSARPGGRAGANVLTF	TRBV20-1	TRBJ2-6
TGTGCCAGCAGTTGGGGACGGTCCTACGAGCAGTACTTC	CASSWGRSYEQYF	TRBV6-3	TRBJ2-7
TGTGCCAGCAGCGAGCTGGGCTACACCTTC	CASSELGYTF	TRBV13	TRBJ1-2
TGTGCCAGCAGAAGCCAGGGGGATCAGCCCCAGCATTTT	CASRSQGDQPQHF	TRBV27	TRBJ1-5
TGTGCCAGCAGTGAAGGAAGAGGGAAGAATAGCACTGAAGCTTTCTTT	CASSEGRGKNSTEAFF	TRBV2	TRBJ1-1
TGTGCCAGCACGGGCTTCAAGCCCTCAACGGGACAGGGGACGGGCTCCTACAATGAGCAGTTCTTC	CASTGFKPSTGQGTGSYNEQFF	TRBV9	TRBJ2-1
TGTGCCAGCCTGGACAGATCGGGCACTAATGAAAAACTGTTTTTT	CASLDRSGTNEKLFF	TRBV28	TRBJ1-4
TGTGCCAGCAGCCCCCAGGGCATCAACTCTGGGGCCAACGTCCTGACTTTC	CASSPQGINSGANVLTF	TRBV3-1	TRBJ2-6
TGTGCTAGCAGCTCACAAACAGGGCAGGAAAAACTGTTTTTT	CASSSQTGQEKLFF	TRBV7-7	TRBJ1-4
TGTGCCGGAGGAGTATGGACAGTGGGAGTCTACATTGGCTACACCTTC	CAGGVWTVGVYIGYTF	TRBV6-5	TRBJ1-2
TGTGCCAGCAGACATCAGGTGAACACTGAAGCTTTCTTT	CASRHQVNTEAFF	TRBV6-1	TRBJ1-1
TGTGCCAGCCCGGGACGGACAAGGAGGAACACCGGGGAGCTGTTTTTT	CASPGRTRRNTGELFF	TRBV7-3	TRBJ2-2
TGTGCCAAGTCCCTTAGCTACTTTGCCTACGAGCAGTACTTC	CAKSLSYFAYEQYF	TRBV13	TRBJ2-7
TGCAGCGTTGCCCCGACAGGGGTAAGTACAGGGGTCCCGGACGAGCAGTACTTC	CSVAPTGVSTGVPDEQYF	TRBV29-1	TRBJ2-7
TGCGCCAGCAGCGGGCCCCCTAACTATGGCTACACCTTC	CASSGPPNYGYTF	TRBV4-1	TRBJ1-2
TGTGCCAGCAGTGGTCTAGCAGGGGAAGGCTACACCTTC	CASSGLAGEGYTF	TRBV27	TRBJ1-2
TGCGCCAGCAGCCAAGGCGGGACTGAGCAGTACTTC	CASSQGGTEQYF	TRBV4-1	TRBJ2-7
TGCAGTGCTAGTCTCGGGACTAGCGGGGGGAGTTCGTCCACCGGGGAGCTGTTTTTT	CSASLGTSGGSSSTGELFF	TRBV20-1	TRBJ2-2
TGTGCCAGCAGATGGACTAGCACGAACAGGCAGAGCACCGGGGAGCTGTTTTTT	CASRWTSTNRQSTGELFF	TRBV6-1	TRBJ2-2
TGTGCCAGCTCCGCCAGTTCCCAGGGCCCCTCACCCCTCCACTTT	CASSASSQGPSPLHF	TRBV6-1	TRBJ1-6
TGCGCCAGCAGCTATTATTGGACCGACAGGGTAGAGGTGTACAATGAGCAGTTCTTC	CASSYYWTDRVEVYNEQFF	TRBV5-1	TRBJ2-1
TGTGCCAGCAGCGGACAGGCTTGGGAGGCCTACGAGCAGTACTTC	CASSGQAWEAYEQYF	TRBV5-4	TRBJ2-7
TGTGCCAGCAGCATAAACGGCGAGGCACAATCTAACTATGGCTACACCTTC	CASSINGEAQSNYGYTF	TRBV13	TRBJ1-2
TGTGCCAGCAGTTTCTCGGGATACTACGAGCAGTACTTC	CASSFSGYYEQYF	TRBV12-3	TRBJ2-7
TGTGCCAGCAGCTTACCGAATGTCGGCGAAGAGACCCAGTACTTC	CASSLPNVGEETQYF	TRBV11-2	TRBJ2-5
TGTGCCAGTAGTATGCCATCGGATCCCTACTCGTCAACGGGTTCCTACGAGCAGTACTTC	CASSMPSDPYSSTGSYEQYF	TRBV19	TRBJ2-7
TGCGCCAGGGGGGGGCAGTTTCAGAACAGCAATCAGCCCCAGCATTTT	CARGGQFQNSNQPQHF	TRBV10-1	TRBJ1-5
TGTGCCACCAGTGATTTGCCTAGAAGGGACCGCAATCAGCCCCAGCATTTT	CATSDLPRRDRNQPQHF	TRBV24-1	TRBJ1-5
TGTGCCAGCAGCCTCCAACCCAACGCTCAAGAGACCCAGTACTTC	CASSLQPNAQETQYF	TRBV14	TRBJ2-5
TGCAGTGCTAGGGAAACAGGGGAGCGAGTCCTGCGACCCCGCGGGCCCTACGAGCAGTACTTC	CSARETGERVLRPRGPYEQYF	TRBV20-1	TRBJ2-7
TGTGCCAGCCGGATAGCACAAGAGACCCAGTACTTC	CASRIAQETQYF	TRBV7-6	TRBJ2-5
TGCAGCGCTGCCGGGACAGGGTATAACTATGGCTACACCTTC	CSAAGTGYNYGYTF	TRBV29-1	TRBJ1-2
TGTGCCAGCAGTGTCTGTGTTCGACGGACCGGTGGAGTGAACACTGAAGCTTTCTTT	CASSVCVRRTGGVNTEAFF	TRBV6-1	TRBJ1-1
TGTGCCAGTAGGTCAGGGAACTATGGCTACACCTTC	CASRSGNYGYTF	TRBV19	TRBJ1-2
TGCGCCAGCAGCTTAGGTCAGGGTTCGACAGGAGGAATCTATAATTCACCCCTCCACTTT	CASSLGQGSTGGIYNSPLHF	TRBV5-1	TRBJ1-6
TGTGCCAGCAGTTTATTGACCTCCTACGAGCAGTACTTC	CASSLLTSYEQYF	TRBV27	TRBJ2-7
TGTGCCAGCAGTCCACTAGCCTCTAATGAAAAACTGTTTTTT	CASSPLASNEKLFF	TRBV12-4	TRBJ1-4
TGTGCCAGCAGCTACCGCCCGGGGATCAATTGGACCCAGTACTTC	CASSYRPGINWTQYF	TRBV7-3	TRBJ2-5
TGTGCCAGCAGCCCACTAGCGTTCCAGACCCAGTACTTC	CASSPLAFQTQYF	TRBV9	TRBJ2-5
TGTGCCAGCAGTTATTTGTTCACATTAAGCTCCTACGAGCAGTACTTC	CASSYLFTLSSYEQYF	TRBV6-5	TRBJ2-7
TGTGCCAGCAATCTAGCGGGCTCCTACAATGAGCAGTTCTTC	CASNLAGSYNEQFF	TRBV6-5	TRBJ2-1
TGCAGTGCAAAACTAGAGAACAATGAGCAGTTCTTC	CSAKLENNEQFF	TRBV20-1	TRBJ2-1
TGTGCCAGCCTAAAGGCCCACCGCCAAGAGACCCAGTACTTC	CASLKAHRQETQYF	TRBV27	TRBJ2-5
TGTGCCACCAGTGATCGCGGGCCTAGACAAGCTGCTTATAGCAATCAGCCCCAGCATTTT	CATSDRGPRQAAYSNQPQHF	TRBV24-1	TRBJ1-5
TGCAGTGCAACCCGTCGCACTGAAGCTTTCTTT	CSATRRTEAFF	TRBV20-1	TRBJ1-1
TGTGCCAGCAGCTTAGTCACAGGGCAGCCCCAGCATTTT	CASSLVTGQPQHF	TRBV7-2	TRBJ1-5
TGTGCCAGCAGTTACTCCTCCCCCTCCGGGACAGCCCAGACCCCCGGCCGGCAGCCCCAGCATTTT	CASSYSSPSGTAQTPGRQPQHF	TRBV6-5	TRBJ1-5
TGTGCCAGCTCACTCAGGGCGGGACTAGCGGGCCAAACCGGGGAGCTGTTTTTT	CASSLRAGLAGQTGELFF	TRBV18	TRBJ2-2
TGTGCCAGCGGCAGACATCAGCCCCAGCATTTT	CASGRHQPQHF	TRBV6-1	TRBJ1-5
TGTGCCAGCAGGCGGGATGGCTACACCTTC	CASRRDGYTF	TRBV6-3	TRBJ1-2
TGCAGTGCTAGACGGTTCGACAGGTTTCAGAACACTGAAGCTTTCTTT	CSARRFDRFQNTEAFF	TRBV20-1	TRBJ1-1
TGTGCCAGCAGCCTAGGGGAACCAGTTGGCTGCCCTAACTTGGGGGAACGGGGCCAAGAGACCCAGTACTTC	CASSLGEPVGCPNLGERGQETQYF	TRBV6-5	TRBJ2-5
TGTGCCGGGCCGTGGACAGAGCGGTACGAGCAGTACTTC	CAGPWTERYEQYF	TRBV27	TRBJ2-7
TGTGCCAGCTCCGGGACAGGCGCTCATAAGGATCAGCCCCAGCATTTT	CASSGTGAHKDQPQHF	TRBV6-5	TRBJ1-5
TGTGCCAGCAGCGAAAGAGGGACAGGTAATCAGCCCCAGCATTTT	CASSERGTGNQPQHF	TRBV13	TRBJ1-5
TGTGCCAGCAGCCCTTCTAGCTACGAGCAGTACTTC	CASSPSSYEQYF	TRBV7-8	TRBJ2-7
TGCAGTGCTAGCCCTCCGGGACAGGGCGAAAATGAAAAACTGTTTTTT	CSASPPGQGENEKLFF	TRBV20-1	TRBJ1-4
TGCGCCAGCAGCTTTCCCAAGGCCCCATCGGGGACTAGCGGGAACGGGGAGCTGTTTTTT	CASSFPKAPSGTSGNGELFF	TRBV5-1	TRBJ2-2
TGTGCCAGCAGTTACCAGAGGGAAAAACTGTTTTTT	CASSYQREKLFF	TRBV6-3	TRBJ1-4
TGTGCCAGCAGCCCGCGGGAGAGCAACGAGCAGTACTTC	CASSPRESNEQYF	TRBV12-4	TRBJ2-7
TGTGCCAGCACGACAGATCCTGGAAACACCATATATTTT	CASTTDPGNTIYF	TRBV27	TRBJ1-3
TGTCTCACTTGGGACAGGCTGCCCACCAAAGGCAATCAGCCCCAGCATTTT	CLTWDRLPTKGNQPQHF	TRBV30	TRBJ1-5
TGTGCCAGCAGCGGCCACCGCGTTGAAAAGAACACTGAAGCTTTCTTT	CASSGHRVEKNTEAFF	TRBV11-3	TRBJ1-1
TGTGCCATCAGTGACCGGATCCAGGGAACTTTCTTT	CAISDRIQGTFF	TRBV10-3	TRBJ1-1
TGTGCCAGCAGTGGGAAACGGGGACAGGGGGCGGGTTTAGCCAAAAACATTCAGTACTTC	CASSGKRGQGAGLAKNIQYF	TRBV6-1	TRBJ2-4
TGTGCCAGAACCAGGGAAGGCTCTGGAAACACCATATATTTT	CARTREGSGNTIYF	TRBV6-4	TRBJ1-3
TGCGCCAGCAGCCAAAGAACGGGGGTCACCGGGGAGCTGTTTTTT	CASSQRTGVTGELFF	TRBV4-3	TRBJ2-2
TGTGCCAGCAGTTACCACAGCCACGAGCAGTACTTC	CASSYHSHEQYF	TRBV6-2	TRBJ2-7
TGTGCCTGGAGTACAGGGGGTGCCGGCGGGGAGCTGTTTTTT	CAWSTGGAGGELFF	TRBV30	TRBJ2-2
TGCGCCAGCAAATCTCCCGGGACAGCCTGCACTGAAGCTTTCTTT	CASKSPGTACTEAFF	TRBV10-1	TRBJ1-1
TGTGCCATCAGTGAGGTACAGGGGCCAGATGCTGGTAGCAATCAGCCCCAGCATTTT	CAISEVQGPDAGSNQPQHF	TRBV10-3	TRBJ1-5
TGTGCCAGCAGTTCCGGACAGGGGAGGCCTAATGCGTCCTACGAGCAGTACTTC	CASSSGQGRPNASYEQYF	TRBV27	TRBJ2-7
TGTGCCACCAGTGATATACAGGTCGCCTACAATGAGCAGTTCTTC	CATSDIQVAYNEQFF	TRBV24-1	TRBJ2-1
TGCAGTGCTAGAGATGAAAACGAGAACACTGAAGCTTTCTTT	CSARDENENTEAFF	TRBV20-1	TRBJ1-1
TGTGCCAGCAGTGCCCAGCTTACGCAGTACTTC	CASSAQLTQYF	TRBV6-4	TRBJ2-7
TGTGCCACCTCAATCTTAAACACTGAAGCTTTCTTT	CATSILNTEAFF	TRBV6-5	TRBJ1-1
TGTGCCAGCAGCTTACCGCGGGAGATGAACACTGAAGCTTTCTTT	CASSLPREMNTEAFF	TRBV7-4	TRBJ1-1
TGTGCCAGCTCACCACGGGACAGGGCTGGAAACACCATATATTTT	CASSPRDRAGNTIYF	TRBV18	TRBJ1-3
TGCGCCAGCAGCTTGACCCAGGGAGATGAGGAGCAGTACTTC	CASSLTQGDEEQYF	TRBV5-1	TRBJ2-7
TGTGCCAGTAACGGGGGGCCCAACAGCTCCTACAATGAGCAGTTCTTC	CASNGGPNSSYNEQFF	TRBV19	TRBJ2-1
TGTGCCAGCAGTTTACATAATTCCAGGGGAAACGGTGATCAGCCCCAGCATTTT	CASSLHNSRGNGDQPQHF	TRBV27	TRBJ1-5
TGTGCCAGCAGCTTAGATAGGGGACTAGCGGGAGAGTTAGGGTCCTACGAGCAGTACTTC	CASSLDRGLAGELGSYEQYF	TRBV7-3	TRBJ2-7
TGCAGTGCTGGTAGGGGGGGCACCTACGAGCAGTACTTC	CSAGRGGTYEQYF	TRBV20-1	TRBJ2-7
TGTGCCACCAGTGACCAGCGGACCTCTGGAAACACCATATATTTT	CATSDQRTSGNTIYF	TRBV24-1	TRBJ1-3
TGCGCCAGCAGCTTGGCGGTCGGACGGGCGATCAGCTACGAGCAGTACTTC	CASSLAVGRAISYEQYF	TRBV5-1	TRBJ2-7
TGTGCCAGCAGCTGGAGAGCGGAACCCAGGTTTTGGTCTAGCACAGATACGCAGTATTTT	CASSWRAEPRFWSSTDTQYF	TRBV7-2	TRBJ2-3
TGTGCCAGCAGTGACCACCTCAGGGACCAAGAGACCCAGTACTTC	CASSDHLRDQETQYF	TRBV6-1	TRBJ2-5
TGTGCCAGCAGTTTAGTGCCCTCGATACAGGGTCCTCAGCCCCAGCATTTT	CASSLVPSIQGPQPQHF	TRBV27	TRBJ1-5
TGTGCCAGCAGTTTGCCTGCGGGGTATAAGACTGAAGCTTTCTTT	CASSLPAGYKTEAFF	TRBV27	TRBJ1-1
TGCAGTGCTAGTGTCGGGATTAATCAGCCCCAGCATTTT	CSASVGINQPQHF	TRBV20-1	TRBJ1-5
TGCAGCGTTAAGCCAGGGGGCAACTATGGCTACACCTTC	CSVKPGGNYGYTF	TRBV29-1	TRBJ1-2
TGTGCCAGCAGTTACAGGGAGGTAGTGCAGGTTACTAATGAAAAACTGTTTTTT	CASSYREVVQVTNEKLFF	TRBV6-5	TRBJ1-4
TGTGCCAGCAGCGCCGACACAGGGGCCAACGTCCTGACTTTC	CASSADTGANVLTF	TRBV7-4	TRBJ2-6
TGTGCCAGCAGTGTCACCGGGACTAGCGGGAGGCTGGATCAGCCCCAGCATTTT	CASSVTGTSGRLDQPQHF	TRBV25-1	TRBJ1-5
TGTGCCAGCAGTTTGTTCACTATCGTGAACACCGGGGAGCTGTTTTTT	CASSLFTIVNTGELFF	TRBV12-3	TRBJ2-2
TGCGCCAGCAGTCGGGATTGGGCCCGGGACGAGCAGTACTTC	CASSRDWARDEQYF	TRBV5-1	TRBJ2-7
TGTGTAGACGGTAAGGAGACCCAGTACTTC	CVDGKETQYF	TRBV25-1	TRBJ2-5
TGTGCCAGCAGCCAATGGACTAGCGGAGAGACCCAGTACTTC	CASSQWTSGETQYF	TRBV9	TRBJ2-5
TGCGCCAGCAGTGACCAGGGAGGGGCCAACGTCCTGACTTTC	CASSDQGGANVLTF	TRBV10-1	TRBJ2-6
TGTGCCAGCAGTTGCCTCTCCTACGAGCAGTACTTC	CASSCLSYEQYF	TRBV6-4	TRBJ2-7
TGCGCCAGCAGCTTGGTCACAGGGGACAGCTCCTATAATTCACCCCTCCACTTT	CASSLVTGDSSYNSPLHF	TRBV5-1	TRBJ1-6
TGTGCCAGCAATGGCGACAGCAATGAGCAGTTCTTC	CASNGDSNEQFF	TRBV2	TRBJ2-1
TGCGCCAGCAGCTTGGGGACCGAGGGTTGCTCTGGAAACACCATATATTTT	CASSLGTEGCSGNTIYF	TRBV5-1	TRBJ1-3
TGTGCCTGGACGGGGTACCGGGACAGGGGGCAGGCAGATACGCAGTATTTT	CAWTGYRDRGQADTQYF	TRBV30	TRBJ2-3
TGCGCCAGCGATAGATGGCGGGGCAATCAGCCCCAGCATTTT	CASDRWRGNQPQHF	TRBV5-1	TRBJ1-5
TGTGCCAGCAGCCAAGATCCAAGGGGCCGACAGCTTAATTCACCCCTCCACTTT	CASSQDPRGRQLNSPLHF	TRBV14	TRBJ1-6
TGCGCCAGCAGCCAAACTAGTCGGGGGGGCCGGAATCAGCCCCAGCATTTT	CASSQTSRGGRNQPQHF	TRBV4-1	TRBJ1-5
TGTGCCTGGAGTGGATCCAGGTGGTCGGAGGGACTGGGAAACACCATATATTTT	CAWSGSRWSEGLGNTIYF	TRBV30	TRBJ1-3
TGCAGTGCTAGACCCCTACCGGGACAGAGCGAGCAGTACTTC	CSARPLPGQSEQYF	TRBV20-1	TRBJ2-7
TGCGCCAGCAGCCCCCGAAAGACAGGGAAAACGGAGACCCAGTACTTC	CASSPRKTGKTETQYF	TRBV5-1	TRBJ2-5
TGTGCCAGCAGTTCAAACCGGGACAGGGAAGTCCGGGGCGAAGCTTTCTTT	CASSSNRDREVRGEAFF	TRBV6-9	TRBJ1-1
TGTGCCAGTAGTATACTAGCGGGACCCAACACCGGGGAGCTGTTTTTT	CASSILAGPNTGELFF	TRBV19	TRBJ2-2
TGCGCCAGCAGCTTGGTGGGGCGGGTGCCCTACGAGCAGTACTTC	CASSLVGRVPYEQYF	TRBV5-1	TRBJ2-7
TGCGCCAGCAGCCAAGGCGGGACTAGCGGTCAAGAGACCCAGTACTTC	CASSQGGTSGQETQYF	TRBV4-1	TRBJ2-5
TGTGCCAGTAGTATAGCTCAAAACCGGGGAGGCTTC	CASSIAQNRGGF	TRBV19	TRBJ2-7
TGTGCCAGCAGTTATTTCCCACTAAACACACAAGAGACCCAGTACTTC	CASSYFPLNTQETQYF	TRBV6-9	TRBJ2-5
TGTGCCAGCAGTTACAAAGAGCGGGTAGCGGAGACCCAGTACTTC	CASSYKERVAETQYF	TRBV6-5	TRBJ2-5
TGTGCCTGGAGTATGATCCCGAGGACAGGGAAGTCACCCCTCCACTTT	CAWSMIPRTGKSPLHF	TRBV30	TRBJ1-6
TGTGCCAGCAGCAACAGGGGGCTAAGCGATCAGCCCCAGCATTTT	CASSNRGLSDQPQHF	TRBV7-3	TRBJ1-5
TGTGCCAGTAGTATCCCTATTACAGGGAACACTGAAGCTTTCTTT	CASSIPITGNTEAFF	TRBV19	TRBJ1-1
TGTGCCAGCAGTTTACACGGAGAATCTGGGGCCAACGTCCTGACTTTC	CASSLHGESGANVLTF	TRBV27	TRBJ2-6
TGTGCCACAACCGGGACAGAGAACTATGGCTACACCTTC	CATTGTENYGYTF	TRBV6-8	TRBJ1-2
TGTGCCAGCACACCCAACGGCGGGCCTCCTCAGCCCCAGCATTTT	CASTPNGGPPQPQHF	TRBV6-2	TRBJ1-5
TGTGCCACCAGTGATGGGACTAGGCGGTTCGACTCCTACGAGCAGTACTTC	CATSDGTRRFDSYEQYF	TRBV24-1	TRBJ2-7
TGCGCCAGCAGTGAGGGAGGTGTTGGACAAGAGACCCAGTACTTC	CASSEGGVGQETQYF	TRBV10-1	TRBJ2-5
TGTGCCAGCACCCTCGATCCGGACCCGGGCTATGGCTACACCTTC	CASTLDPDPGYGYTF	TRBV27	TRBJ1-2
TGTGCCAGCAGCCATCCCCGGGACAGGGGGACCCAGTACTTC	CASSHPRDRGTQYF	TRBV14	TRBJ2-5
TGTGCCAGCAGCTTGCTGGACAGGCTCAGGACTGAAGCTTTCTTT	CASSLLDRLRTEAFF	TRBV14	TRBJ1-1
TGTGCCATCAGTGTTCGGGACAGGGGATCCTACAATGAGCAGTTCTTC	CAISVRDRGSYNEQFF	TRBV10-3	TRBJ2-1
TGTGCCAGCAGCGACAAAAGCCAGAGCACTGAAGCTTTCTTT	CASSDKSQSTEAFF	TRBV7-9	TRBJ1-1
TGTGCCAGCAGCTCAACAGGGGGCGGGAATGTAGAGACCCAGTACTTC	CASSSTGGGNVETQYF	TRBV5-6	TRBJ2-5
TGCGCCAGCAGCGAAGGCCCCCCTCAGGTAAGCTACGAGCAGTACTTC	CASSEGPPQVSYEQYF	TRBV5-1	TRBJ2-7
TGTGCCATCAACCCCGGGACAGGGAGGGGGGAGACCCAGTACTTC	CAINPGTGRGETQYF	TRBV10-3	TRBJ2-5
TGCAGTGCTAGAGATAGGGGGCGAAGCTCCTATAATTCACCCCTCCACTTT	CSARDRGRSSYNSPLHF	TRBV20-1	TRBJ1-6
TGTGCCAGCAGCTTGGCTGGGACAGGATCGGGCTACGAGCAGTACTTC	CASSLAGTGSGYEQYF	TRBV5-4	TRBJ2-7
TGCGCCAGCACATCCTGCGTCACCGGGGAGCTGTTTTTT	CASTSCVTGELFF	TRBV5-1	TRBJ2-2
TGTGCCAGCAGCCAAGATTGTATTCACGACTATGGCTACACCTTC	CASSQDCIHDYGYTF	TRBV14	TRBJ1-2
TGTGCCAGCAGCTTCTGGACAGGGCCGGGCTCCTACAATGAGCAGTTCTTC	CASSFWTGPGSYNEQFF	TRBV9	TRBJ2-1
TGTGCCAGCAGTTTATGCATCCTGGCCATTGGCTACACCTTC	CASSLCILAIGYTF	TRBV28	TRBJ1-2
TGTGCCAGCAGTTCCCCAACACCCCCGGGACTAGGGGACGAGCAGTACTTC	CASSSPTPPGLGDEQYF	TRBV12-3	TRBJ2-7
TGCGCCAGCAGCTGCTATGGACCCTACGAGCAGTACTTC	CASSCYGPYEQYF	TRBV5-1	TRBJ2-7
TGTGCCAGCAGTCAAGGGGGGATCTACTACGAGCAGTACTTC	CASSQGGIYYEQYF	TRBV27	TRBJ2-7
TGTGCCAGCAGTGAGAAGGATACTAGCGGGAGGGAGGAGACCCAGTACTTC	CASSEKDTSGREETQYF	TRBV2	TRBJ2-5
TGTGCTAGTGGTCACCCTAAAGGGGTGGGCTACAATGAGCAGTTCTTC	CASGHPKGVGYNEQFF	TRBV12-5	TRBJ2-1
TGCGCCAGCAGCCTAAGGGATTCAGGGGGCAAAAATCAGCCCCAGCATTTT	CASSLRDSGGKNQPQHF	TRBV4-3	TRBJ1-5
TGTGCCAGCAGTTTATCGCCCGGGCAGGGGGACTACGAGCAGTACTTC	CASSLSPGQGDYEQYF	TRBV27	TRBJ2-7
TGTGCCAGCAGCCAAGAGCCGGACGGGATGGACTATGGCTACACCTTC	CASSQEPDGMDYGYTF	TRBV14	TRBJ1-2
TGTGCCAGCACTACTTGGGCTGAAAAACTGTTTTTT	CASTTWAEKLFF	TRBV6-8	TRBJ1-4
TGTGCTAGCAGCTCTAATAACACTAGCGGGAGGTATGAGCAGTACTTC	CASSSNNTSGRYEQYF	TRBV7-7	TRBJ2-7
TGTGCCAGCAGCCAAGCGAGGCTAAATTCACCCCTCCACTTT	CASSQARLNSPLHF	TRBV3-1	TRBJ1-6
TGTGCCAGCAGCTTCACGGACAGGCTCAGAGAACTGTTTTTT	CASSFTDRLRELFF	TRBV3-1	TRBJ1-4
TGTGCCAGCAAACTTAAATCAGGGGGCTGGGTGAGCTATGGCTACACCTTC	CASKLKSGGWVSYGYTF	TRBV11-2	TRBJ1-2
TGTGCCACCAGTGATTCCCGAGGTAGCCGTGCCTACGAGCAGTACTTC	CATSDSRGSRAYEQYF	TRBV24-1	TRBJ2-7
TGTGCCAGGACTGAAAAACTGTTTTTT	CARTEKLFF	TRBV6-4	TRBJ1-4
TGTGCCAGCAGTTTGTCAAGGACGCAAAACATTCAGTACTTC	CASSLSRTQNIQYF	TRBV28	TRBJ2-4
TGTGCCAGCAGCTTGGCAGACAGGCCTCGGAACACTGAAGCTTTCTTT	CASSLADRPRNTEAFF	TRBV5-6	TRBJ1-1
TGTGCCAGCAGCGCCCCCCGGGACAGACGGCAAGAGACCCAGTACTTC	CASSAPRDRRQETQYF	TRBV9	TRBJ2-5
TGCGCCAGCAGCCGCGGGGGACTAGCGGGGGGTGAGCTTACCACCGGGGAGCTGTTTTTT	CASSRGGLAGGELTTGELFF	TRBV5-1	TRBJ2-2
TGCGCCAGCAGCGCAACCGGGACAGATACGCAGTATTTT	CASSATGTDTQYF	TRBV5-1	TRBJ2-3
TGTGCCAGCTCACCTGCGGGGGGGTCGGGAGTACAAGAGACCCAGTACTTC	CASSPAGGSGVQETQYF	TRBV18	TRBJ2-5
TGTGCCACCAGTGATTTGAACCCAAGTCGGGATCCAGATAATTCACCCCTCCACTTT	CATSDLNPSRDPDNSPLHF	TRBV24-1	TRBJ1-6
TGCGCCAGCAGAAGACAGGGGGTGGATGCAACTAATGAAAAACTGTTTTTT	CASRRQGVDATNEKLFF	TRBV5-1	TRBJ1-4
TGTGCTGTTTTAGTGGGGGATACGCAGTATTTT	CAVLVGDTQYF	TRBV28	TRBJ2-3
TGCGCCAGCAGCCAAGATCGGGTACTTGGGGAGTGTAATGAAAAACTGTTTTTT	CASSQDRVLGECNEKLFF	TRBV4-1	TRBJ1-4
TGCAGTGCTAGGACATTGGCAGGCACAGATACGCAGTATTTT	CSARTLAGTDTQYF	TRBV20-1	TRBJ2-3
TGTGCCACCAGCAACGGGGGCGGGAGGGCACCCACCATATATTTT	CATSNGGGRAPTIYF	TRBV24-1	TRBJ1-3
TGCGCCAGCAGTGCCCGGGACAGGGGTGATGGCTACACCTTC	CASSARDRGDGYTF	TRBV10-1	TRBJ1-2
TGTGCCAGCAGCCCGGCATCTGGGGCCCGCCTCAATGAGCAGTTCTTC	CASSPASGARLNEQFF	TRBV28	TRBJ2-1
TGTGCCACCAGCAGAGGCCCCCTGACTAGCGGGGCCAAAAACATTCAGTACTTC	CATSRGPLTSGAKNIQYF	TRBV15	TRBJ2-4
TGTGCCAGCAGCTTATCGAAAGCCCGGGACAACACCGGGGAGCTGTTTTTT	CASSLSKARDNTGELFF	TRBV7-9	TRBJ2-2
TGCGCCAGCAGCTTGAAGCCGGGCGCAGGGAACACTGAAGCTTTCTTT	CASSLKPGAGNTEAFF	TRBV5-1	TRBJ1-1
TGTGCCAGCAGCTCGAGGACAGGGCTCTACGAGCAGTACTTC	CASSSRTGLYEQYF	TRBV7-2	TRBJ2-7
TGTGCCAGTAGTAAATTAAGAATAGAGGCCTACAATGAGCAGTTCTTC	CASSKLRIEAYNEQFF	TRBV19	TRBJ2-1
TGTGCCAGCAGTTTAAAGGGGGGGGAGGTATGTTACGAGCAGTACTTC	CASSLKGGEVCYEQYF	TRBV12-3	TRBJ2-7
TGTGCTAGTGGTTTTCCTACGTATAATTCACCCCTCCACTTT	CASGFPTYNSPLHF	TRBV12-5	TRBJ1-6
TGTGCCAGCACTCACCACACTGAAGCTTTCTTT	CASTHHTEAFF	TRBV27	TRBJ1-1
TGCGCCAGCACGAAAAGGGCCCGCGGTGAGGCGGTAAAAATTAATGAAAAACTGTTTTTT	CASTKRARGEAVKINEKLFF	TRBV4-3	TRBJ1-4
TGCGCCAGCAAGGGGCGTCAGCCCCAGCATTTT	CASKGRQPQHF	TRBV5-1	TRBJ1-5
TGCAGCCCGAGCGAGACACAGGATTTGAACACCGGGGAGCTGTTTTTT	CSPSETQDLNTGELFF	TRBV29-1	TRBJ2-2
TGCGCCAGCAGCTGGGGGGGCGGTTCTCTCAATGAGCAGTTCTTC	CASSWGGGSLNEQFF	TRBV5-1	TRBJ2-1
TGTGCCAGCAGCTTGCCCGGGGACGAAAGGAATTCACCCCTCCACTTT	CASSLPGDERNSPLHF	TRBV7-9	TRBJ1-6
TGTGCCATCAGCCAGTCAGTTAAGGATGGCTACACCTTC	CAISQSVKDGYTF	TRBV10-3	TRBJ1-2
TGTGCCACCCGAGGGAGTACTGAAGCTTTCTTT	CATRGSTEAFF	TRBV24-1	TRBJ1-1
TGTGCCAGCAGCTGCCCTCGGGGGGAATTGACGTTTGGCTACACCTTC	CASSCPRGELTFGYTF	TRBV7-2	TRBJ1-2
TGTGCCAGCAGCTTGGGGGCAAATAGCAATCAGCCCCAGCATTTT	CASSLGANSNQPQHF	TRBV5-4	TRBJ1-5
TGCAGTGCTAGAGACCGACTAGCGGGCAAAGAGACCCAGTACTTC	CSARDRLAGKETQYF	TRBV20-1	TRBJ2-5
TGTGCCAGCAGCCAAGAGACGCAACTAGGCGAGACCCAGTACTTC	CASSQETQLGETQYF	TRBV3-1	TRBJ2-5
TGTGCCACCTGTTTGGAACCCAGCATAAAGGTCAATCAGCCCCAGCATTTT	CATCLEPSIKVNQPQHF	TRBV7-9	TRBJ1-5
TGTGCCAGCATCAGTCCGTACCAGGCGACCGGGGAGCTGTTTTTT	CASISPYQATGELFF	TRBV6-2	TRBJ2-2
TGCGCCAGCAGATACCCTGGGGGCGGAAACACCATATATTTT	CASRYPGGGNTIYF	TRBV10-1	TRBJ1-3
TGTGCTAGTGGTGAACCTCCCGGACAGGGGGGCAATCAGCCCCAGCATTTT	CASGEPPGQGGNQPQHF	TRBV12-5	TRBJ1-5
TGTGCCAGCAGCCTCGGCCCCGGACAGGCCACCTATGGCTACACCTTC	CASSLGPGQATYGYTF	TRBV13	TRBJ1-2
TGTGCCAGCAGTGAGGAAGACACACGGTATGGCTATGGCTACACCTTC	CASSEEDTRYGYGYTF	TRBV25-1	TRBJ1-2
TGTGCCAGCAGCCAATGCTTTCCGGACAGTACAGGAGGAAACGAGCAGTACTTC	CASSQCFPDSTGGNEQYF	TRBV14	TRBJ2-7
TGTGCCAGCAGTTACAGGGGACAGGCCCCCTCAGATACGCAGTATTTT	CASSYRGQAPSDTQYF	TRBV6-6	TRBJ2-3
TGTGCCAGCTATTGCAGGGGGCCATCGCCCCAGCATTTT	CASYCRGPSPQHF	TRBV6-8	TRBJ1-5
TGCGCCAGCAGTGGCCCTATCAAACAGGCTAGCGAGCAGTACTTC	CASSGPIKQASEQYF	TRBV10-1	TRBJ2-7
TGCAGTGCTTCCTTTGGACAGGGGGCGGGGGGTTTAGATGAGCAGTTCTTC	CSASFGQGAGGLDEQFF	TRBV20-1	TRBJ2-1
TGTGCCAGCAGTGCCCCAGGGACATTGGGAGATGAGCAGTTCTTC	CASSAPGTLGDEQFF	TRBV25-1	TRBJ2-1
TGTGCCACCAGTGCTACAGGTCCCTATGGCTACACCTTC	CATSATGPYGYTF	TRBV24-1	TRBJ1-2
TGCGCCAGCAGCTTGGCCCAATCCCGCCGGGACAGGGGGCCCCAGCAGCCCCAGCATTTT	CASSLAQSRRDRGPQQPQHF	TRBV5-1	TRBJ1-5
TGCAGTGCTAGAGATCCAACCGGGGGGCCGTCAGATACGCAGTATTTT	CSARDPTGGPSDTQYF	TRBV20-1	TRBJ2-3
TGTGCCAGCAGTTTACAGAAGCCCCTTCATACCGCTTTCTTT	CASSLQKPLHTAFF	TRBV12-3	TRBJ1-1
TGTGCCAGCAGCGATTCTCTAGGTGAAGGCTACGAGCAGTACTTC	CASSDSLGEGYEQYF	TRBV13	TRBJ2-7
TGTGCCAGCAGCGTGAGACGAGCTAGGGGGGGTCCACCCGAGCAGTACTTC	CASSVRRARGGPPEQYF	TRBV9	TRBJ2-7
TGCGCCAGCAGCCAACCCGCGGGCTCCTACGAGCAGTACTTC	CASSQPAGSYEQYF	TRBV4-1	TRBJ2-7
TGTGCCAGCAGTCGGAAAAAACTAGCGGGAGACTCCGGGGAGCTGTTTTTT	CASSRKKLAGDSGELFF	TRBV28	TRBJ2-2
TGTGCCCGGACTAAACTCTACGAGCAGTACTTC	CARTKLYEQYF	TRBV25-1	TRBJ2-7
TGTGCCAGCAGCTCTGGGACGTGGGTTCGGCACAATGAGCAGTTCTTC	CASSSGTWVRHNEQFF	TRBV11-3	TRBJ2-1
TGTGCCATCCCCAATAGCGGGAACACCGGGGAGCTGTTTTTT	CAIPNSGNTGELFF	TRBV6-5	TRBJ2-2
TGCGCCAGCAAGCTAGATACGCAGTATTTT	CASKLDTQYF	TRBV5-1	TRBJ2-3
TGTGCTAGTGGGACTAGACTAGCGGGGATAGGGGAGCAAACAGATACGCAGTATTTT	CASGTRLAGIGEQTDTQYF	TRBV12-5	TRBJ2-3
TGTGCCAGCAGCTTAGCCCAGGAGGGGGATTGGGCCTACGAGCAGTACTTC	CASSLAQEGDWAYEQYF	TRBV7-6	TRBJ2-7
TGCAGTGCTAGTCTAGCGCGGGAGGAAAGTGTAGGGAGCTCCTACAATGAGCAGTTCTTC	CSASLAREESVGSSYNEQFF	TRBV20-1	TRBJ2-1
TGCGCCAGCAGCTTGGACCTTAGGGGAAATGAAAAACTGTTTTTT	CASSLDLRGNEKLFF	TRBV5-1	TRBJ1-4
TGTGCCAGCTCACTGCACCCAGTATACACTGAAGCTTTCTTT	CASSLHPVYTEAFF	TRBV18	TRBJ1-1
TGCGCCAGCAGCAACTTCCTTCGAAGCGGGCCCAGCTCCTACGAGCAGTACTTC	CASSNFLRSGPSSYEQYF	TRBV5-1	TRBJ2-7
TGTGCCAGTAGTATGGGGCTAGAATGGACGCAGTCGGACACTGAAGCTTTCTTT	CASSMGLEWTQSDTEAFF	TRBV19	TRBJ1-1
TGCAGTGTCGGGCCGAGCACAGATACGCAGTATTTT	CSVGPSTDTQYF	TRBV20-1	TRBJ2-3
TGTGCCAGCAGCAAAAAAAACCGGGACATGTTTGCGGGGGGAGGTAACTATGGCTACACCTTC	CASSKKNRDMFAGGGNYGYTF	TRBV6-5	TRBJ1-2
TGCAGCGACGCGCCGGGACAGGGCTTCGAGACCCAGTACTTC	CSDAPGQGFETQYF	TRBV29-1	TRBJ2-5
TGTGCCAGCAGCGCGACAGGCGGGAACGAGCAGTACTTC	CASSATGGNEQYF	TRBV9	TRBJ2-7
TGTGCCAGCAGTGATTTGCAACCGGAATCCAATGGCTACACCTTC	CASSDLQPESNGYTF	TRBV6-4	TRBJ1-2
TGTGCCAGCAGCTATGCCAGGGCCCCCAGGTACAATGAGCAGTTCTTC	CASSYARAPRYNEQFF	TRBV7-4	TRBJ2-1
TGTGCCAGCAGCGGGGGGGTGGCCTCTGGGGCCAACGTCCTGACTTTC	CASSGGVASGANVLTF	TRBV7-3	TRBJ2-6
TGCGCCAGCAGCCGCTGGAGGGGGTACGAGCAGTACTTC	CASSRWRGYEQYF	TRBV4-1	TRBJ2-7
TGTGCCAGCTCACCACCGGGACTAGCGGGTGAGCAGTTCTTC	CASSPPGLAGEQFF	TRBV18	TRBJ2-1
TGTGCCAGCAGCATGTTGAATAATAGGGGGACTGCCAAAAACATTCAGTACTTC	CASSMLNNRGTAKNIQYF	TRBV6-4	TRBJ2-4
TGTGCCAGCAGCGAACATTGTATGCACGTGCGACAGGGGGAGATAAACTATGGCTACACCTTC	CASSEHCMHVRQGEINYGYTF	TRBV11-1	TRBJ1-2
TGTGCCAGCAAAACAGGGGCCTATGGCTACACCTTC	CASKTGAYGYTF	TRBV6-4	TRBJ1-2
TGCGCCAGCAGCTTGGTGGGGGGAAGTGCAGATACGCAGTATTTT	CASSLVGGSADTQYF	TRBV5-1	TRBJ2-3
TGCAGCGTTGCGGGGGGGGGGGCTGCTACCGGGGAGCTGTTTTTT	CSVAGGGAATGELFF	TRBV29-1	TRBJ2-2
TGTGCCAGCAGCATCTTCGTGTCCGGGACCCACTCCTACAATGAGCAGTTCTTC	CASSIFVSGTHSYNEQFF	TRBV5-5	TRBJ2-1
TGTGCCAGCAGCTTACCAGTCGACTACGAGCAGTACTTC	CASSLPVDYEQYF	TRBV11-2	TRBJ2-7
TGTGCCACCAAGGAGGGGCAAAGAGAGGGAGGCCGATATGAGCAGTTCTTC	CATKEGQREGGRYEQFF	TRBV24-1	TRBJ2-1
TGTGCCAGCATCACCTCACGAAACACTGAAGCTTTCTTT	CASITSRNTEAFF	TRBV6-6	TRBJ1-1
TGTGCCAGCCCTGGACTAGTAGCGGCCTACGAGCAGTACTTC	CASPGLVAAYEQYF	TRBV11-2	TRBJ2-7
TGTGCCAGCAGCTTAGAAATTCGGCGCAGCTCTGGGGCCAACGTCCTGACTTTC	CASSLEIRRSSGANVLTF	TRBV7-9	TRBJ2-6
TGTGCCAGCAGCTGGGGAGGGTTTGGCTACACCTTC	CASSWGGFGYTF	TRBV7-6	TRBJ1-2
TGCAGTGAAGACAGGCGAAACTATAGCAATCAGCCCCAGCATTTT	CSEDRRNYSNQPQHF	TRBV20-1	TRBJ1-5
TGCGCCAGCAGCTTGGATCCCAGGGGGGTCCAAGAAAACACCGGGGAGCTGTTTTTT	CASSLDPRGVQENTGELFF	TRBV5-1	TRBJ2-2
TGTGCCAGCACCTACAGGGCGGACTTTCTGTACGAGCAGTACTTC	CASTYRADFLYEQYF	TRBV27	TRBJ2-7
TGTGCCAGCAGCCAAGATATAGAGCGGGGCTACGAGCAGTACTTC	CASSQDIERGYEQYF	TRBV3-1	TRBJ2-7
TGTGCCAGAGAGGGTTGGGACACCGGGGAGCTGTTTTTT	CAREGWDTGELFF	TRBV6-4	TRBJ2-2
TGCGCCAGCAGCCAAGATCGGAGCTACGAGCAGTACTTC	CASSQDRSYEQYF	TRBV4-1	TRBJ2-7
TGCGCCAGCAGTGAATACGGCCACACTGAAGCTTTCTTT	CASSEYGHTEAFF	TRBV10-1	TRBJ1-1
TGTGCCACCAGTGATCCAATGGCAAATGACACTGAAGCTTTCTTT	CATSDPMANDTEAFF	TRBV24-1	TRBJ1-1
TGTGCCAGCAGTTACGCCTGGTGTAGCGGGTACATCTCCTACGAGCAGTACTTC	CASSYAWCSGYISYEQYF	TRBV2	TRBJ2-7
TGTGCCAGCAGCTTAAGGGACAGGGGCTGGGATCCGGAAAAACTGTTTTTT	CASSLRDRGWDPEKLFF	TRBV7-2	TRBJ1-4
TGTGCCAGCAGTTATCCAAAGGGGGGGGGGACCGGGGAGCTGTTTTTT	CASSYPKGGGTGELFF	TRBV6-5	TRBJ2-2
TGTGCCAGCAGCCAAGATAACCCCTTCCTAGGGTACTACGAGCAGTACTTC	CASSQDNPFLGYYEQYF	TRBV14	TRBJ2-7
TGCGCCAGCAGGAAGGGACAGGCTTTCTTT	CASRKGQAFF	TRBV5-1	TRBJ1-1
TGCAGTGCTAGAGCAAGGGTCACCTATAATTCACCCCTCCACTTT	CSARARVTYNSPLHF	TRBV20-1	TRBJ1-6
TGTGCCACCCCCGGGGGTACCGGGGAGCTGTTTTTT	CATPGGTGELFF	TRBV24-1	TRBJ2-2
TGTGCCACCAGTGATTCACCCGCAGGGGAGAGATACGAGCAGTACTTC	CATSDSPAGERYEQYF	TRBV24-1	TRBJ2-7
TGTGCCAATAGCTTGACAGTCGAGACCCAGTACTTC	CANSLTVETQYF	TRBV6-1	TRBJ2-5
TGTGCCAGCAGCATATTGCCGGGACTAGCGGGAGACCTGAACACTGAAGCTTTCTTT	CASSILPGLAGDLNTEAFF	TRBV9	TRBJ1-1
TGCGCCAGCAGCCAATACCCCTACAGGGTTTTGGCTGGAAACACCATATATTTT	CASSQYPYRVLAGNTIYF	TRBV4-1	TRBJ1-3
TGCAGTGCCGAGGACCAAGAGACCCAGTACTTC	CSAEDQETQYF	TRBV20-1	TRBJ2-5
TGCAGTGCTAGTCCGGCGACAGCGGGTAGGCCTGAAGCTTTCTTT	CSASPATAGRPEAFF	TRBV20-1	TRBJ1-1
TGTGCCAGCAGCCGGACTCTAGCGGGAACCTCCTACAATGAGCAGTTCTTC	CASSRTLAGTSYNEQFF	TRBV13	TRBJ2-1
TGTGCCAGCACTTGGGGCTCCGGGACAGGGGGACCCCCCTCCTACGAGCAGTACTTC	CASTWGSGTGGPPSYEQYF	TRBV6-4	TRBJ2-7
TGCGCCAGCAGCTTTGTCGGACAGGGGTCTCTGGTTTACTATGGCTACACCTTC	CASSFVGQGSLVYYGYTF	TRBV5-1	TRBJ1-2
TGTGCCAGCAGCTTCACGAGGGACATTGGTACTGAAGCTTTCTTT	CASSFTRDIGTEAFF	TRBV5-8	TRBJ1-1
TGTGCCAGCAGTGAAAATAGGAATGGATACGAGCAGTACTTC	CASSENRNGYEQYF	TRBV6-1	TRBJ2-7
TGTGCCAGCAGTCATGGGACAGGATTTAGCAATCAGCCCCAGCATTTT	CASSHGTGFSNQPQHF	TRBV6-2	TRBJ1-5
TGTGCCAGCAGCCCAGACCGGGACAGGGGGGATACAAACAATGAGCAGTTCTTC	CASSPDRDRGDTNNEQFF	TRBV28	TRBJ2-1
TGTGCCACCAGCAACGCAACGAAAGGCGAGCAGTACTTC	CATSNATKGEQYF	TRBV15	TRBJ2-7
TGTGCCAGCAGTAGTCTGTTCTTC	CASSSLFF	TRBV6-4	TRBJ2-1
TGTGCCAGCAGAAGGGACAGCCAAGAGACCCAGTACTTC	CASRRDSQETQYF	TRBV7-2	TRBJ2-5
TGTGCCAGCAGGGCCAACTCTAGCGGGGGAGGTTGCTACGAGCAGTACTTC	CASRANSSGGGCYEQYF	TRBV7-2	TRBJ2-7
TGTGCCAGCAGTTACAGGAGGGGGGGCTGGTATGAGCAGTTCTTC	CASSYRRGGWYEQFF	TRBV6-2	TRBJ2-1
TGTGCCAGCAGCTTAACGCCCACCGGGAGCAATCAGCCCCAGCATTTT	CASSLTPTGSNQPQHF	TRBV7-3	TRBJ1-5
TGTGCCAGCACTAGCGGCTGGAACTACGAGCAGTACTTC	CASTSGWNYEQYF	TRBV28	TRBJ2-7
TGTGCCAGCAGCCAGGAATGCCGGGACCCTACGGAAGCAGATACGCAGTATTTT	CASSQECRDPTEADTQYF	TRBV13	TRBJ2-3
TGTGCCAGCAGCAATGGACGGGGGGGCACAGATACGCAGTATTTT	CASSNGRGGTDTQYF	TRBV6-5	TRBJ2-3
TGTGCCAGCACTCCGGAGAGGGGGAGGTCCTATAATTCACCCCTCCACTTT	CASTPERGRSYNSPLHF	TRBV27	TRBJ1-6
TGTGCCAGCAGCCTTCCGGGGGACAGGGACTTTTACGAGCAGTACTTC	CASSLPGDRDFYEQYF	TRBV9	TRBJ2-7
TGTGCCAGCAACGACCCGGAGACCCAGTACTTC	CASNDPETQYF	TRBV25-1	TRBJ2-5
TGTGCCAGCAGCCCCGAAGTGGGGAACGGTTTCTATAATTCACCCCTCCACTTT	CASSPEVGNGFYNSPLHF	TRBV13	TRBJ1-6
TGTGCCAGCAGCTTAGCAGGGACAGGGGCGAACACTGAAGCTTTCTTT	CASSLAGTGANTEAFF	TRBV7-2	TRBJ1-1
TGTGCCAGCAGCGGAGGGTATGCTTTCTTT	CASSGGYAFF	TRBV13	TRBJ1-1
TGTGCCAGCAGGGGATACAGGGACGAGCAGTACTTC	CASRGYRDEQYF	TRBV12-4	TRBJ2-7
TGTGCCAGCAGCGCAAGTAGTGACGTAGGAACCACAGATACGCAGTATTTT	CASSASSDVGTTDTQYF	TRBV7-2	TRBJ2-3
TGTGCCAGTAGTATGGGGCCTAACTATGGCTACACCTTC	CASSMGPNYGYTF	TRBV19	TRBJ1-2
TGTGCCAGCAGTTCAGCAGTCAATCAGCCCCAGCATTTT	CASSSAVNQPQHF	TRBV28	TRBJ1-5
TGTGCCTGGACAGGGACAGGGGATGTTGGGCTAGCGGTGAAAAGGTACAATGAGCAGTTCTTC	CAWTGTGDVGLAVKRYNEQFF	TRBV30	TRBJ2-1
TGTGCCTGGACCAGCCGGGGCATGAACACTGAAGCTTTCTTT	CAWTSRGMNTEAFF	TRBV30	TRBJ1-1
TGTGCCAGCAGCTTCAGGAGATTCTCCTACGAGCAGTACTTC	CASSFRRFSYEQYF	TRBV11-2	TRBJ2-7
TGTGCCAGCAGTTACTCCAACCAAAAAGGGAGGTTTACGGAGTCCTACGAGCAGTACTTC	CASSYSNQKGRFTESYEQYF	TRBV6-2	TRBJ2-7
TGTGCCAGCAGTTACGCCCAAAGCTGGCTGTGCTATGGCTACACCTTC	CASSYAQSWLCYGYTF	TRBV6-5	TRBJ1-2
TGCAGTGCTAGGTCGCGGGAGCTGGAAAAACTGTTTTTT	CSARSRELEKLFF	TRBV20-1	TRBJ1-4
TGTGCCACCAGCAGAGGGAGTCGATATAGCAATCAGCCCCAGCATTTT	CATSRGSRYSNQPQHF	TRBV15	TRBJ1-5
TGTGCCAGCGTTCCGTGGACGCCCCAGCATTTT	CASVPWTPQHF	TRBV5-6	TRBJ1-5
TGTGCCAGCAGCTACGGGGACAGGTTAAGGTACGAGCAGTACTTC	CASSYGDRLRYEQYF	TRBV7-2	TRBJ2-7
TGCAGTGCACTTACCCCCGACCCCCAGTACTTC	CSALTPDPQYF	TRBV20-1	TRBJ2-5
TGTGCCACCAGGGGGCTAAACACCGGGGAGCTGTTTTTT	CATRGLNTGELFF	TRBV24-1	TRBJ2-2
TGCGCCGGCCCTCCCCCGGGACACACCTACAATGAGCAGTTCTTC	CAGPPPGHTYNEQFF	TRBV4-3	TRBJ2-1
TGTGCCAGCAGCTTAGTGACAGGGAGAGCAGATACGCAGTATTTT	CASSLVTGRADTQYF	TRBV7-7	TRBJ2-3
TGTGCCAGCAAAGCTAAAGGGTACCAAGAGACCCAGTACTTC	CASKAKGYQETQYF	TRBV7-4	TRBJ2-5
TGTGCCAGCAGCCGGGGGGCTGGAAACACCATATATTTT	CASSRGAGNTIYF	TRBV3-1	TRBJ1-3
TGTGCCAGCAGTGACTCGACGCATGCCGGGACAGGGGTGGCCTTTTTCGATGGCTACACCTTC	CASSDSTHAGTGVAFFDGYTF	TRBV6-4	TRBJ1-2
TGTGCCAGCAGCTCGACAGGGAGCTATGGCTACACCTTC	CASSSTGSYGYTF	TRBV9	TRBJ1-2
TGTGCCAGCAGCTTAGATCGGACGAAGGGGGAGGGAGGCTATGGCTACACCTTC	CASSLDRTKGEGGYGYTF	TRBV11-2	TRBJ1-2
TGTGCCAGCAGCCGGGAAGGAGAGCAGTTCTTC	CASSREGEQFF	TRBV7-9	TRBJ2-1
TGTGCCAGCAGTGGGCACAGGGCCTCTGGAAACACCATATATTTT	CASSGHRASGNTIYF	TRBV27	TRBJ1-3
TGTGCCAGTAGTAGTTTTGGCACTGAAGCTTTCTTT	CASSSFGTEAFF	TRBV19	TRBJ1-1
TGTGCCTGGAGTGTACATAACCGAGCAGAGGACTCCTACGAGCAGTACTTC	CAWSVHNRAEDSYEQYF	TRBV30	TRBJ2-7
TGTGCCAGCAGCGAGGATATGACCGGGACAGGATATAGCAATCAGCCCCAGCATTTT	CASSEDMTGTGYSNQPQHF	TRBV9	TRBJ1-5
TGCGCCAGCGGCGGTACCCACAACGAGCAGTACTTC	CASGGTHNEQYF	TRBV5-1	TRBJ2-7
TGCGCCAGCAGCCCTAAGGGGGGCCCTAAACGGGGCTACGAGCAGTACTTC	CASSPKGGPKRGYEQYF	TRBV5-1	TRBJ2-7
TGCGCCAGCAGCCTGGATGAGACAGGGAGTTCAGCGAGCAATCAGCCCCAGCATTTT	CASSLDETGSSASNQPQHF	TRBV10-1	TRBJ1-5
TGTGCCAGCAGCTTACTAGCGGGCACCGGGGAGCTGTTTTTT	CASSLLAGTGELFF	TRBV7-3	TRBJ2-2
TGCAGCGTTGCACTCTGCGGAGGGCAGTACCAAGAGACCCAGTACTTC	CSVALCGGQYQETQYF	TRBV29-1	TRBJ2-5
TGTGCCAGCAGCAAACGGGACGGAGGTTCACCCCTCCACTTT	CASSKRDGGSPLHF	TRBV9	TRBJ1-6
TGTGCCAGCAGCCTCCCGCACTTC	CASSLPHF	TRBV7-3	TRBJ2-5
TGTGCCAGCGACGGAAATGAAAAACTGTTTTTT	CASDGNEKLFF	TRBV5-5	TRBJ1-4
TGTGCCAGCAGCTATCACTTGGGGGGGTTTACTAGCACAGATACGCAGTATTTT	CASSYHLGGFTSTDTQYF	TRBV7-7	TRBJ2-3
TGCAGCGTTTCCGGGGGGCCCGAGACCCAGTACTTC	CSVSGGPETQYF	TRBV29-1	TRBJ2-5
TGTGCCAGCAGCCTCCAGGGGGGGTATTTT	CASSLQGGYF	TRBV4-2	TRBJ2-3
TGTGCCAGTAGTATTAAGTCAAAGCTTTCCTACAATGAGCAGTTCTTC	CASSIKSKLSYNEQFF	TRBV19	TRBJ2-1
TGCGCCAGCAAACAGGCCTACGAGCAGTACTTC	CASKQAYEQYF	TRBV10-1	TRBJ2-7
TGCAGTGCTAGAATTGCGAGGGCCCCAGTCAATCAGCCCCAGCATTTT	CSARIARAPVNQPQHF	TRBV20-1	TRBJ1-5
TGCGCCAGCAGATATGCAGTGGGCTACACCTTC	CASRYAVGYTF	TRBV5-1	TRBJ1-2
TGTGCCAGCAGTCTTTCCCTAGAAGGGGGGGATGAGCAGTTCTTC	CASSLSLEGGDEQFF	TRBV6-4	TRBJ2-1
TGTGCCAGCTCACCAACCGCCGCCACAGGGGAGGGGGGCGAGCAGTACTTC	CASSPTAATGEGGEQYF	TRBV18	TRBJ2-7
TGCGCCAGCAGTGAGGGTCCGACTAGCGGGCCCTACGAGCAGTACTTC	CASSEGPTSGPYEQYF	TRBV10-1	TRBJ2-7
TGCGCCAGCAGCCACAAGGGTCAACTCAACACCATATATTTT	CASSHKGQLNTIYF	TRBV4-3	TRBJ1-3
TGCGCCAGCAGCTTGAAACCAGCTACCTACGAGCAGTACTTC	CASSLKPATYEQYF	TRBV5-1	TRBJ2-7
TGTGCCAGCAGCGTTTCCCAGGTGACGAATCAGCCCCAGCATTTT	CASSVSQVTNQPQHF	TRBV9	TRBJ1-5
TGCAGTGCTGGCGGGACTCTGTACCAAGAGACCCAGTACTTC	CSAGGTLYQETQYF	TRBV20-1	TRBJ2-5
TGTGCCAGCAGCAGTAAGGGGCAACGACTGAACACTGAAGCTTTCTTT	CASSSKGQRLNTEAFF	TRBV12-3	TRBJ1-1
TGTGCCAGCCCGACCCTTGCCTACGAGCAGTACTTC	CASPTLAYEQYF	TRBV11-3	TRBJ2-7
TGTGCCAGCAGTTGGAACCCTGGGACAAGGTACTTGGGAAGCAATCAGCCCCAGCATTTT	CASSWNPGTRYLGSNQPQHF	TRBV27	TRBJ1-5
TGTGCCAGCAGTGACTCCTTGGGTCTTTACGAGCAGTACTTC	CASSDSLGLYEQYF	TRBV6-4	TRBJ2-7
TGTGCCAGCAGCTTGGCCGGACAGGGAAGTTATAGCAATCAGCCCCAGCATTTT	CASSLAGQGSYSNQPQHF	TRBV5-6	TRBJ1-5
TGTGCCAGCAGTTTAAGTGTGGGGGCTTACCAGCCCCAGCATTTT	CASSLSVGAYQPQHF	TRBV28	TRBJ1-5
TGCAGCGTCTGGGGGCCCAAGGCTGAAGCTTTCTTT	CSVWGPKAEAFF	TRBV29-1	TRBJ1-1
TGCGCCAGCAGTGAGCTCAGGACAGGGGGATCCTACGAGCAGTACTTC	CASSELRTGGSYEQYF	TRBV10-1	TRBJ2-7
TGTGCCAGCAGCTTGGAGTATCTTACTGAAGCGGGTGAGCAGTTCTTC	CASSLEYLTEAGEQFF	TRBV5-6	TRBJ2-1
TGTGCCAGCAGTTCCAAGAAGACAGGGGGAGCAGGCGAGCAGTACTTC	CASSSKKTGGAGEQYF	TRBV27	TRBJ2-7
TGCGCCAGCACAAGGGGGGGATATGGCTACACCTTC	CASTRGGYGYTF	TRBV5-1	TRBJ1-2
TGTGCCAGCAGTTTAGGCCGACGGGACAGTCCCTACGAGCAGTACTTC	CASSLGRRDSPYEQYF	TRBV12-3	TRBJ2-7
TGTGCCAGCAGCTTAGGTTCGCCCAAGGTCCGGGGGCCCGGCTACACCTTC	CASSLGSPKVRGPGYTF	TRBV11-3	TRBJ1-2
TGTGCCAGCAGCCAGGGGAATTACGAGCAGTACTTC	CASSQGNYEQYF	TRBV7-4	TRBJ2-7
TGTGCCAGCAGCCCGGACAGGAATTTTAATGAAAAACTGTTTTTT	CASSPDRNFNEKLFF	TRBV13	TRBJ1-4
TGTGCCAGCAGCAACCGGGACAGAAGTAGTCTGAACACTGAAGCTTTCTTT	CASSNRDRSSLNTEAFF	TRBV5-6	TRBJ1-1
TGTGCCAGCAGCTGCAGACGGGGACAAGAGACCCAGTACTTC	CASSCRRGQETQYF	TRBV5-6	TRBJ2-5
TGCGCCAGCAGCTTGGAATATAAACCGGACAGAGACTATGGCTACACCTTC	CASSLEYKPDRDYGYTF	TRBV5-1	TRBJ1-2
TGTGCCACCAGTGAGACATGTCTACGCCAAGAGACCCAGTACTTC	CATSETCLRQETQYF	TRBV24-1	TRBJ2-5
TGCAGTGCTAGAGATTCTGTCGGGGTTGAGACCCAGTACTTC	CSARDSVGVETQYF	TRBV20-1	TRBJ2-5
TGTGCCAGCAGCGTAAGGTCGGACAGTGTTGGAAACACCATATATTTT	CASSVRSDSVGNTIYF	TRBV6-2	TRBJ1-3
TGTGCCAGCGGTCACGATGAGCAGTTCTTC	CASGHDEQFF	TRBV12-3	TRBJ2-1
TGTGCCAGCAGTTTACTACCTGTCGGGATTCTGACTGCAGTTGGCTACACCTTC	CASSLLPVGILTAVGYTF	TRBV27	TRBJ1-2
TGTGCCAGCAGTTATGGGACAGGATTCCTAAACGGCGATGGCAAAAACATTCAGTACTTC	CASSYGTGFLNGDGKNIQYF	TRBV6-5	TRBJ2-4
TGTGCCAGCAGCTTGGGACCCCTTGACAGGGGATACAATGAGCAGTTCTTC	CASSLGPLDRGYNEQFF	TRBV5-8	TRBJ2-1
TGCAGCGTTGTTCCGGGGGTGAAAGACTATGGCTACACCTTC	CSVVPGVKDYGYTF	TRBV29-1	TRBJ1-2
TGCAGTGCTACATCAGGGCCCTCCTACGAGCAGTACTTC	CSATSGPSYEQYF	TRBV20-1	TRBJ2-7
TGCAGCGCAGGCGGACTGGACTTAGAGACCCGCTACGAGCAGTACTTC	CSAGGLDLETRYEQYF	TRBV29-1	TRBJ2-7
TGTGCCAGCAGTTACCCACCGTGCACTGGGTCAGATACGCAGTATTTT	CASSYPPCTGSDTQYF	TRBV6-2	TRBJ2-3
TGTGCCAGCAGCTTAGTCCCCCCAGGACGAAACACCATATATTTT	CASSLVPPGRNTIYF	TRBV7-8	TRBJ1-3
TGTGCCAGCAGCAGGGACAGAACGCCCTATGGCTACACCTTC	CASSRDRTPYGYTF	TRBV13	TRBJ1-2
TGCGCCAGCAGCCTTTTATGCGCCGAAAGCTTGACTAGCGGTCGTAAACTGGGCGAGCAGTACTTC	CASSLLCAESLTSGRKLGEQYF	TRBV4-1	TRBJ2-7
TGTGCCAGCTCACCCCACGGGGTTTACGAGCAGTACTTC	CASSPHGVYEQYF	TRBV18	TRBJ2-7
TGTGCCAGCAGCTTAGCATCTCCCTATGGCTACACCTTC	CASSLASPYGYTF	TRBV7-6	TRBJ1-2
TGTGCCAGCAGCTTACTCCCCCGACAGAGTGTCAATAGCAATCAGCCCCAGCATTTT	CASSLLPRQSVNSNQPQHF	TRBV7-2	TRBJ1-5
TGTGCCAGCAGCCCTACTTCCGGGACAGGGACCTACGAGCAGTACTTC	CASSPTSGTGTYEQYF	TRBV3-1	TRBJ2-7
TGTGCCAGCAGTTACGACCGTACCCAGTACTTC	CASSYDRTQYF	TRBV6-6	TRBJ2-5
TGTGCCAGCAGCCAAGTCAGGGGTAGGGGACAAGGAGACGAGCAGTACTTC	CASSQVRGRGQGDEQYF	TRBV4-2	TRBJ2-7
TGTGCCAGCAGTGATACTAACTCTGGAAACACCATATATTTT	CASSDTNSGNTIYF	TRBV6-1	TRBJ1-3
TGTGCCTGGAGCCTTTCACAGACCTATGGCTACACCTTC	CAWSLSQTYGYTF	TRBV30	TRBJ1-2
TGTAGGCCCGGGACAGGGCGGGGCGGAAACACCATATATTTT	CRPGTGRGGNTIYF	TRBV30	TRBJ1-3
TGCGCCAGCAGCCCCCGAAGGGAAGGGGACGAGCAGTACTTC	CASSPRREGDEQYF	TRBV5-1	TRBJ2-7
TGTGCCAGCAGCTCCCACCACAGCTACACCTTC	CASSSHHSYTF	TRBV13	TRBJ1-2
TGCAGCGTAAACCTAGCGGTTGAGACCCAGTACTTC	CSVNLAVETQYF	TRBV29-1	TRBJ2-5
TGTGCCAGCAGTTTATGCCAACGAACCGTAACCAAGGGATGCTCTAGCGATATTGCAGAGACCCAGTACTTC	CASSLCQRTVTKGCSSDIAETQYF	TRBV27	TRBJ2-5
TGTGCCAGCAGTGAATCGGGTAAAGGGATATACGAGCAGTACTTC	CASSESGKGIYEQYF	TRBV6-1	TRBJ2-7
TGTGCCAGTAATTTTCTAGCGGCCTACGAGCAGTACTTC	CASNFLAAYEQYF	TRBV28	TRBJ2-7
TGTGCCAGCAGTAACCAGGGGCGTATTTTAAAACTGTTTTTT	CASSNQGRILKLFF	TRBV28	TRBJ1-4
TGTGCCAGCAGCGGGTGGGAAAAACTGTTTTTT	CASSGWEKLFF	TRBV28	TRBJ1-4
TGTGCTTGCCAGGGGGTTCAGCCCCAGCATTTT	CACQGVQPQHF	TRBV7-7	TRBJ1-5
TGTGCCAGCAGATCCTCATTGGGAGTACCTGAGCAGTTCTTC	CASRSSLGVPEQFF	TRBV6-2	TRBJ2-1
TGCAGTCTCATGCTAACTTACTACGTGGGGACCTACGAGCAGTACTTC	CSLMLTYYVGTYEQYF	TRBV20-1	TRBJ2-7
TGTGCCAGCTCACCGGACAGGGGAATAATCTTAGAGACCCAGTACTTC	CASSPDRGIILETQYF	TRBV18	TRBJ2-5
TGTGCCAGCAGCTTAATTCCACCTTCGGGGGGTCCTCCTGCTACTGAGCAGTTCTTC	CASSLIPPSGGPPATEQFF	TRBV7-9	TRBJ2-1
TGTGCCAGCAGCAGCTGGCACTACAATGAGCAGTTCTTC	CASSSWHYNEQFF	TRBV7-9	TRBJ2-1
TGTGCCAGCAGGGGAGGGGGGAACACTGAAGCTTTCTTT	CASRGGGNTEAFF	TRBV6-3	TRBJ1-1
TGTGCCAGCAGTTCTGGGGGGTCCTACGAGCAGTACTTC	CASSSGGSYEQYF	TRBV6-3	TRBJ2-7
TGTGCCAGCACAGGGGACAGGATAGCCAAAAACATTCAGTACTTC	CASTGDRIAKNIQYF	TRBV6-5	TRBJ2-4
TGCGCCAGCAGTAACGTAGCAAGCTACACCATATATTTT	CASSNVASYTIYF	TRBV10-1	TRBJ1-3
TGTGCCAGCAGCTTCATAGTACAGGCGGTCCACTACGAGCAGTACTTC	CASSFIVQAVHYEQYF	TRBV5-8	TRBJ2-7
TGTGCCAGCAGCGGGGGACAGTACTACGAGCAGTACTTC	CASSGGQYYEQYF	TRBV7-3	TRBJ2-7
TGTGCCACCAGCCACGGGATGAACACTGAAGCTTTCTTT	CATSHGMNTEAFF	TRBV15	TRBJ1-1
TGTGCCAGCAGAGATCCGGGACAGACAAACACCGGGGAGCTGTTTTTT	CASRDPGQTNTGELFF	TRBV7-3	TRBJ2-2
TGTGCCAGTAGTACTCGCGCCGCTAGCACAGATACGCAGTATTTT	CASSTRAASTDTQYF	TRBV19	TRBJ2-3
TGTGCCACCAGCAATCCTGAACACTACAATGAGCAGTTCTTC	CATSNPEHYNEQFF	TRBV15	TRBJ2-1
TGTGCCAGCAGCTTGAACAGGGGAGGTGGGGAGCTGTTTTTT	CASSLNRGGGELFF	TRBV9	TRBJ2-2
TGTGCCAGTAGTATCGGCACGACTAATGAAAAACTGTTTTTT	CASSIGTTNEKLFF	TRBV19	TRBJ1-4
TGTGCCAGCAGTATTACTAGAGCCTACGAGCAGTACTTC	CASSITRAYEQYF	TRBV11-3	TRBJ2-7
TGCGCCAGCAGGTGGGCTAACGAGCAGTACTTC	CASRWANEQYF	TRBV10-2	TRBJ2-7
TGTGCCAGTAGTACCCCAATACTACTCAGGGGTAGCCAAGAGACCCAGTACTTC	CASSTPILLRGSQETQYF	TRBV19	TRBJ2-5
TGCAGCGGTAAACCCGAGCTATTCCAAGAGACCCAGTACTTC	CSGKPELFQETQYF	TRBV29-1	TRBJ2-5
TGTGCCAGCAGCCAGGGGGTGAACACTGAAGCTTTCTTT	CASSQGVNTEAFF	TRBV3-1	TRBJ1-1
TGTGCCAGCGGGACAGGGCTGGAAGAGACCCAGTACTTC	CASGTGLEETQYF	TRBV19	TRBJ2-5
TGTGCCAGCAGAAGAGGGTACGAGCAGTACTTC	CASRRGYEQYF	TRBV6-1	TRBJ2-7
TGCATAGGTCGTCAGCTCCAAGAGACCCAGTACTTC	CIGRQLQETQYF	TRBV20-1	TRBJ2-5
TGTGCCACGGACGGCAAATATAGCAATCAGCCCCAGCATTTT	CATDGKYSNQPQHF	TRBV30	TRBJ1-5
TGCAGTGCTCCTAATGGTTCTGGGGGGGCAGGAATCACAGATACGCAGTATTTT	CSAPNGSGGAGITDTQYF	TRBV20-1	TRBJ2-3
TGTGCCAGCAGTTACATAGCCGCTGGACAGGCCGGCAATCAGCCCCAGCATTTT	CASSYIAAGQAGNQPQHF	TRBV6-6	TRBJ1-5
TGCGCCAGCAGCTTGACCCATTCCGAGGTCAATCAGCCCCAGCATTTT	CASSLTHSEVNQPQHF	TRBV5-1	TRBJ1-5
TGTGCCAGCAGTGAAAGACAGGGGGCGAACACTGAAGCTTTCTTT	CASSERQGANTEAFF	TRBV6-4	TRBJ1-1
TGTGCCAGCAGTTACAAAGCGGGACGGGCAGTCTCTGGGGCCAACGTCCTGACTTTC	CASSYKAGRAVSGANVLTF	TRBV6-2	TRBJ2-6
TGTGCCAGCAGCCAAGATTGGAAGGAGCAGTACTTC	CASSQDWKEQYF	TRBV14	TRBJ2-7
TGCAGTGCTCCGAGGGAGCGACTGTGCACCTTC	CSAPRERLCTF	TRBV20-1	TRBJ1-2
TGCGCCAGCAGCTTCCATACGGTAGGAGTGGGAGAGACCCAGTACTTC	CASSFHTVGVGETQYF	TRBV5-1	TRBJ2-5
TGTGCCAGCAGGCTCGTATACACCTACGAGCAGTACTTC	CASRLVYTYEQYF	TRBV5-6	TRBJ2-7
TGTGCCCCCGGACGTTTAGTGGTTACGGGGGGAAAAAACTATGGCTACACCTTC	CAPGRLVVTGGKNYGYTF	TRBV30	TRBJ1-2
TGCAGTGCTTGGGACAGGGACACAACGGGCTACACCTTC	CSAWDRDTTGYTF	TRBV20-1	TRBJ1-2
TGCACGGGTCGGCTTCGTGGCACAGATACGCAGTATTTT	CTGRLRGTDTQYF	TRBV29-1	TRBJ2-3
TGTGCCAGCAGTTTAGGCCAGGCCCGGAACACTGAAGCTTTCTTT	CASSLGQARNTEAFF	TRBV6-5	TRBJ1-1
TGTGCCTGGAGACCGACGCTAAGGAACACCGGGGAGCTGTTTTTT	CAWRPTLRNTGELFF	TRBV30	TRBJ2-2
TGCGCCGCCGGTGCTTTCTTT	CAAGAFF	TRBV10-1	TRBJ1-1
TGTGCCAGCAGCCAAGCGGTGAATGAGCAGTTCTTC	CASSQAVNEQFF	TRBV3-1	TRBJ2-1
TGTGCCAGCAGCGTAGACTCCGGTAGGGCTGATACGCAGTATTTT	CASSVDSGRADTQYF	TRBV9	TRBJ2-3
TGTGCCAGTAGTATCCCGGACGGACGAGTTCAGGAGAGTGGCTACACCTTC	CASSIPDGRVQESGYTF	TRBV19	TRBJ1-2
TGTGCCAGCAGCAGAATGTCACTGGGTATACGTCAGCCCCAGCATTTT	CASSRMSLGIRQPQHF	TRBV7-3	TRBJ1-5
TGTGCCAGCAGTGAACGGGTCTCTGGGGCCAACGTCCTGACTTTC	CASSERVSGANVLTF	TRBV6-4	TRBJ2-6
TGTGCCAGCAAAGTTGACGGTAGGGAGCAGTACTTC	CASKVDGREQYF	TRBV9	TRBJ2-7
TGCAGTGCTAGAGATTCCAGGGCGGTAGATCAGCCCCAGCATTTT	CSARDSRAVDQPQHF	TRBV20-1	TRBJ1-5
TGTGCCAGCAGCCAAGGCCCCCGGGAGGGAGATCAGCCCCAGCATTTT	CASSQGPREGDQPQHF	TRBV3-1	TRBJ1-5
TGTGCCACCTGCGGATCTGAAGCTTTCTTT	CATCGSEAFF	TRBV6-4	TRBJ1-1
TGCAGCGTAGGCAAGAGGGGCCACGGGGCTGAAGCTTTCTTT	CSVGKRGHGAEAFF	TRBV29-1	TRBJ1-1
TGTGCCAGCAGTTACCACATGGGGACAGGAAACGAGCAGTTCTTC	CASSYHMGTGNEQFF	TRBV6-5	TRBJ2-1
TGCAGCGTTGAAGGGGGACAAACTGAAGCTTTCTTT	CSVEGGQTEAFF	TRBV29-1	TRBJ1-1
TGTGCCAGCAGAAGGGACAGGTTCGACAATGAGCAGTTCTTC	CASRRDRFDNEQFF	TRBV12-4	TRBJ2-1
TGCAGTGCTGCACGTCAGCCCCAGCATTTT	CSAARQPQHF	TRBV20-1	TRBJ1-5
TGTGCCTGCGGGACACTTAGCACAGATACGCAGTATTTT	CACGTLSTDTQYF	TRBV24-1	TRBJ2-3
TGCGCCAGCAGTGACACGGGGTCGGGGGGGCTGGGGGGAGAGACCCAGTACTTC	CASSDTGSGGLGGETQYF	TRBV10-1	TRBJ2-5
TGTGCCAGCAGAAGGACTAGCGCGGGCACCGGGGAGCTGTTTTTT	CASRRTSAGTGELFF	TRBV28	TRBJ2-2
TGCGCCAGCACCTACAGCGGGAAACACACCGGGGAGCTGTTTTTT	CASTYSGKHTGELFF	TRBV5-1	TRBJ2-2
TGTGCCAGCAAGCTGCCAGGTGGGGCCGACTATGGCTACACCTTC	CASKLPGGADYGYTF	TRBV12-3	TRBJ1-2
TGCGCCAGCAGCTTTTCAGACAGGGGCGAAAAACTGTTTTTT	CASSFSDRGEKLFF	TRBV5-1	TRBJ1-4
TGTTCAGGGTTTAACTATGGCTACACCTTC	CSGFNYGYTF	TRBV10-3	TRBJ1-2
TGTGCCAGCAGGGCCCTTCCGGGACAGGCTAACACTGAAGCTTTCTTT	CASRALPGQANTEAFF	TRBV6-5	TRBJ1-1
TGTGCCAGCAGTGGACATAGGGATTATCGTAAGTCCTCCTACAATGAGCAGTTCTTC	CASSGHRDYRKSSYNEQFF	TRBV27	TRBJ2-1
TGTGCCAGCACTAGCGGGAGGGGCGATGAGCAGTTCTTC	CASTSGRGDEQFF	TRBV7-7	TRBJ2-1
TGTGCCAGCAGAGGACGCATAGGCGGGGAGCTGTTTTTT	CASRGRIGGELFF	TRBV6-6	TRBJ2-2
TGCAGTGCGCCATTTAGCGGGGCCTACAATGAGCAGTTCTTC	CSAPFSGAYNEQFF	TRBV20-1	TRBJ2-1
TGTGCCAGCAGCCACCCGGGGGGCCGGAAAGAGACCCAGTACTTC	CASSHPGGRKETQYF	TRBV3-1	TRBJ2-5
TGTGCCAGCAGTTTTCCCGGACGAGGGGAGCTGTTTTTT	CASSFPGRGELFF	TRBV6-3	TRBJ2-2
TGCGCCAGCAGCCAAGGAGGTAGCGGGAAGACTACCCGAACGAACACCGGGGAGCTGTTTTTT	CASSQGGSGKTTRTNTGELFF	TRBV4-1	TRBJ2-2
TGTGCCAAGCCCCCCAGGGGGCCGGGCAATCAGCCCCAGCATTTT	CAKPPRGPGNQPQHF	TRBV27	TRBJ1-5
TGTGCCAGCAGGACAGGGGGAATCTTTGGATCACCCCTCCACTTT	CASRTGGIFGSPLHF	TRBV27	TRBJ1-6
TGCAGTGCGACAGGACAGGAAACATACGAGCAGTACTTC	CSATGQETYEQYF	TRBV20-1	TRBJ2-7
TGCGCCACCTTTGCCGGGTACCAAACAAAAAGTGAGGGGGCTGAAGCTTTCTTT	CATFAGYQTKSEGAEAFF	TRBV10-1	TRBJ1-1
TGTGCCAGCAGTGCTGGACTCCGTAGCTCCTACGAGCAGTACTTC	CASSAGLRSSYEQYF	TRBV6-4	TRBJ2-7
TGCGCCAGCAGCACATTCCCCTCCGGTCGACAGGAATACTTC	CASSTFPSGRQEYF	TRBV4-1	TRBJ2-4
TGTGCCAGCCCTAGAGATACTAACTATGGCTACACCTTC	CASPRDTNYGYTF	TRBV27	TRBJ1-2
TGTGCCAGCAGTTCAAGACAGGGTAAATACGAGCAGTACTTC	CASSSRQGKYEQYF	TRBV6-5	TRBJ2-7
TGTGCCACCAGCAGATTTTTCTGGTTACTGAACACTGAAGCTTTCTTT	CATSRFFWLLNTEAFF	TRBV15	TRBJ1-1
TGTGCCAGCAGCCGCACCATTTGGGCCCAAAATCAGCCCCAGCATTTT	CASSRTIWAQNQPQHF	TRBV7-2	TRBJ1-5
TGCGCCAGCAGTGGGGTGATATTCCAAGAGACCCAGTACTTC	CASSGVIFQETQYF	TRBV10-1	TRBJ2-5
TGCGCCAGCAGTTATCAAGTGCATAATTCACCCCTCCACTTT	CASSYQVHNSPLHF	TRBV10-2	TRBJ1-6
TGTGCCAGCAGTGAACTAGCGGGAGGAGAGAGGTACTTC	CASSELAGGERYF	TRBV2	TRBJ2-5
TGTGTTAATGGACAGCTTGGACCATCCTACGAGCAGTACTTC	CVNGQLGPSYEQYF	TRBV6-2	TRBJ2-7
TGTGCCAGCAGACCCCCGGGGGGGCCCGTAACCGGAAAAGAGACCCAGTACTTC	CASRPPGGPVTGKETQYF	TRBV12-3	TRBJ2-5
TGTGCCAGCAGTGAATATCGACAGGCCTACTTGGGATCCTATGGCTACACCTTC	CASSEYRQAYLGSYGYTF	TRBV2	TRBJ1-2
TGCAGCGTTGAAGATTCAAGTAACTTTGAGAGGTACGAGCAGTACTTC	CSVEDSSNFERYEQYF	TRBV29-1	TRBJ2-7
TGTGCCAGCAGCGCGGGAGGGGATGCTGAAAAACTGTTTTTT	CASSAGGDAEKLFF	TRBV5-6	TRBJ1-4
TGTGCCAGCAGCTCGGCTGGGACAGGGGTGAACACTGAAGCTTTCTTT	CASSSAGTGVNTEAFF	TRBV11-2	TRBJ1-1
TGTGCCACCCGGGACAGGGGGGGGAACACTGAAGCTTTCTTT	CATRDRGGNTEAFF	TRBV24-1	TRBJ1-1
TGTGCCACCAGTGATTTGACGGGATTGGAAGCTTTCTTT	CATSDLTGLEAFF	TRBV24-1	TRBJ1-1
TGTGCCAGCAGCTTAGCGGGTGGAATCCAGGGGAAGGCCAAAAACATTCAGTACTTC	CASSLAGGIQGKAKNIQYF	TRBV7-6	TRBJ2-4
TGTGCCAGCAGTCCGGAGGGGCATGAGCAGTTCTTC	CASSPEGHEQFF	TRBV12-4	TRBJ2-1
TGCGCCAGCAGCTTGTACGCGAGACAGGTAATTTGCCCCTATAATTCACCCCTCCACTTT	CASSLYARQVICPYNSPLHF	TRBV5-1	TRBJ1-6
TGTGCCAGCAGCTCCAACAAGACTCCAAACTATGGCTACACCTTC	CASSSNKTPNYGYTF	TRBV5-8	TRBJ1-2
TGTGCCAGCAGTTACTCGAGACTAGCGGGAGCGTTCCGGCGGTCACCCCTCCACTTT	CASSYSRLAGAFRRSPLHF	TRBV6-5	TRBJ1-6
TGTGCCAGCGACAGGGGGCTTGACACCGGGGAGCTGTTTTTT	CASDRGLDTGELFF	TRBV28	TRBJ2-2
TGTGCCAGCAGTTTATCGGGACATGAGTCACCCCTCCACTTT	CASSLSGHESPLHF	TRBV27	TRBJ1-6
TGTGCCAGCAGTGAACCGGTTGCACTTCGGTTTTTGGTTGAAGCTTTCTTT	CASSEPVALRFLVEAFF	TRBV6-1	TRBJ1-1
TGTGCCAGCAGCATCAGTCCCGGGACAGTGAGCAATCAGCCCCAGCATTTT	CASSISPGTVSNQPQHF	TRBV9	TRBJ1-5
TGTGCCAGCAGCCAAGATCCGAGCGGGATTCGTGACACCGGGGAGCTGTTTTTT	CASSQDPSGIRDTGELFF	TRBV14	TRBJ2-2
TGCGCCAGCAGCCAAGACTCCTCCCTAAGGGGCACCATATATTTT	CASSQDSSLRGTIYF	TRBV4-3	TRBJ1-3
TGTGCCAGTCGGGCCGGGGGCGGGATATGCACTGAAGCTTTCTTT	CASRAGGGICTEAFF	TRBV6-4	TRBJ1-1
TGTGCCAGCGGGACGCGGAACGAGCAGTACTTC	CASGTRNEQYF	TRBV25-1	TRBJ2-7
TGCAGTGCTAGAGATCGAGGCGATACGCAGTATTTT	CSARDRGDTQYF	TRBV20-1	TRBJ2-3
TGTGCCTGGAGAACAGGGGGCTACGAGCAGTACTTC	CAWRTGGYEQYF	TRBV30	TRBJ2-7
TGTGCCAGCAGTGCCCCGCGGGAGGGGAAGGGGAGCAATCAGCCCCAGCATTTT	CASSAPREGKGSNQPQHF	TRBV2	TRBJ1-5
TGTGCCAGCAGTACGACATCTGGCTACACCTTC	CASSTTSGYTF	TRBV27	TRBJ1-2
TGTGCCAGCATTAAACCCCCCGGGCCTAGCTCTCAGCCCCAGCATTTT	CASIKPPGPSSQPQHF	TRBV7-4	TRBJ1-5
TGTGCCAGCATTTACAGGGGCCCGGCCCAAGAGACCCAGTACTTC	CASIYRGPAQETQYF	TRBV25-1	TRBJ2-5
TGTTCAGTAAACACTGAAGCTTTCTTT	CSVNTEAFF	TRBV7-9	TRBJ1-1
TGTGCCAGCAGTGAGGTCGTGGACAGGGGGCCTACCGGGGAGCTGTTTTTT	CASSEVVDRGPTGELFF	TRBV6-4	TRBJ2-2
TGTGCCAGCTCAGGTTTCCCCCCGACTAGCGGGAAAAACATTCAGTACTTC	CASSGFPPTSGKNIQYF	TRBV18	TRBJ2-4
TGTGCCACCAGCAGAGATCGGGCCGATTCAGATACGCAGTATTTT	CATSRDRADSDTQYF	TRBV15	TRBJ2-3
TGTGCCATCGGACTAGCGGGAGGGCCCGTGTGGGGGACTGAAGCTTTCTTT	CAIGLAGGPVWGTEAFF	TRBV10-3	TRBJ1-1
TGTGCCAGCAGCTTGGATAGTAGGGGGGTGCCCTACGAGCAGTACTTC	CASSLDSRGVPYEQYF	TRBV5-5	TRBJ2-7
TGTGCCAGCAGCCATGTTCGAGAAGACAATGAGCAGTTCTTC	CASSHVREDNEQFF	TRBV14	TRBJ2-1
TGTGCCCTGAAAGGGGGGCCTTACGAGCAGTACTTC	CALKGGPYEQYF	TRBV6-5	TRBJ2-7
TGTGCCAGCAGCCGCTTTAAACGTGAAAAACTGTTTTTT	CASSRFKREKLFF	TRBV5-5	TRBJ1-4
TGTGCCAGCAAAGACAGGAATTTGGCCTACGAGCAGTACTTC	CASKDRNLAYEQYF	TRBV6-4	TRBJ2-7
TGTGCCAGCAGTTTAGGACGTCGGACAGATACGCAGTATTTT	CASSLGRRTDTQYF	TRBV12-3	TRBJ2-3
TGTGCCAGCAGCTTCCCCCGGGGACTTCTCAATCAGCCCCAGCATTTT	CASSFPRGLLNQPQHF	TRBV5-5	TRBJ1-5
TGTGCCAGCAGTGACGGGACTAGCGGGGACAATGAGCAGTTCTTC	CASSDGTSGDNEQFF	TRBV6-1	TRBJ2-1
TGTGCCAGCAGCTCCAATATGCCGGGACTGCGGACAGATACGCAGTATTTT	CASSSNMPGLRTDTQYF	TRBV13	TRBJ2-3
TGTGCCAGCAGTTACAGGTCCAAGGCTAGCAAACACCGGAGCTCCTACGAGCAGTACTTC	CASSYRSKASKHRSSYEQYF	TRBV6-8	TRBJ2-7
TGTGCCAGCTCACCACCGGACCGTGGCATGAACACTGAAGCTTTCTTT	CASSPPDRGMNTEAFF	TRBV18	TRBJ1-1
TGCGCCAGCAGCCAAGATCAAAGAGGGGGGGATAGCAATCAGCCCCAGCATTTT	CASSQDQRGGDSNQPQHF	TRBV4-1	TRBJ1-5
TGTGCCAGCAGCCAGGGGCCGGAGCAGTACTTC	CASSQGPEQYF	TRBV11-2	TRBJ2-7
TGTGCCAGTAGTACACGTTCTGGAGGAAACACCATATATTTT	CASSTRSGGNTIYF	TRBV19	TRBJ1-3
TGCAGTGCTATAGGGGGGACGTCACCCCTCCACTTT	CSAIGGTSPLHF	TRBV20-1	TRBJ1-6
TGTGCCAGCAGCTTGGTAGAGTGCAAAGGCTACGAGCAGTACTTC	CASSLVECKGYEQYF	TRBV5-6	TRBJ2-7
TGTGCCAGCAGTGATAGCGGGTTTCACACCGGGGAGCTGTTTTTT	CASSDSGFHTGELFF	TRBV2	TRBJ2-2
TGTGCCAGCAGCCATGGTTGCCGGACTGGAAACACCATATATTTT	CASSHGCRTGNTIYF	TRBV7-9	TRBJ1-3
TGTGCCAGCAGCTTAGTCGGGGCGAATGAAAAACTGTTTTTT	CASSLVGANEKLFF	TRBV7-9	TRBJ1-4
TGCGCCAGCAGTGAGGCAGGGGGCTCTCCTCAGCCCCAGCATTTT	CASSEAGGSPQPQHF	TRBV10-1	TRBJ1-5
TGCGCCAGCAGTACAGGGTCCCGGGGGAGAGATAACTATGGCTACACCTTC	CASSTGSRGRDNYGYTF	TRBV10-1	TRBJ1-2
TGCGCCAGCAGGCGACTCCTGAGCAATCAGCCCCAGCATTTT	CASRRLLSNQPQHF	TRBV4-1	TRBJ1-5
TGTGCCAGTAGTCGGGCGGGAGGTGTTAACTACGAGCAGTACTTC	CASSRAGGVNYEQYF	TRBV19	TRBJ2-7
TGCAGTGCTAGATATAACGGGGTGTGGAGGGGTGGAAACACCATATATTTT	CSARYNGVWRGGNTIYF	TRBV20-1	TRBJ1-3
TGTGCCAGCAGTTACTCGATCTACGGACAGGGAACCTACGAGCAGTACTTC	CASSYSIYGQGTYEQYF	TRBV6-8	TRBJ2-7
TGCAGTGCACAGGGGGGGGTAGGCTCTGGAAACACCATATATTTT	CSAQGGVGSGNTIYF	TRBV20-1	TRBJ1-3
TGTGCCAGCAGCCCCTGTCCACAGGGGGTCTGGGGGTACACTGAAGCTTTCTTT	CASSPCPQGVWGYTEAFF	TRBV5-4	TRBJ1-1
TGTGCCAGCAGCTTCAAGTGGGACGGAACCGGGAGCACAGATACGCAGTATTTT	CASSFKWDGTGSTDTQYF	TRBV11-3	TRBJ2-3
TGTGCCAGCAGCGAGGATCAAGAGACCCAGTACTTC	CASSEDQETQYF	TRBV13	TRBJ2-5
TGTGCCAGCAGCGGTTCAGGGGTCAATCAGCCCCAGCATTTT	CASSGSGVNQPQHF	TRBV9	TRBJ1-5
TGCGCCAGCAACACCGGGACAGCCATCGGGTATAATTCACCCCTCCACTTT	CASNTGTAIGYNSPLHF	TRBV5-1	TRBJ1-6
TGTGCCAGCAGCAGGGGACAGGCCATGCCTAGACAGCCCCAGCATTTT	CASSRGQAMPRQPQHF	TRBV7-6	TRBJ1-5
TGTGCCTGGAGTCTTAAAGGGATTTATCGAATTGAGACCCAGTACTTC	CAWSLKGIYRIETQYF	TRBV30	TRBJ2-5
TGTGCCTGGGGCAGGGACTATGGCTACACCTTC	CAWGRDYGYTF	TRBV30	TRBJ1-2
TGTGCCAGCAGCTTTGACAGATATGGCTACACCTTC	CASSFDRYGYTF	TRBV13	TRBJ1-2
TGTGCTGGGAGGAGTAGGGACCGACGTCCCCAGCATTTT	CAGRSRDRRPQHF	TRBV9	TRBJ1-5
TGTGCCAGCAGCTTCCTATCCGGGGACCCCCCAACTTGCATCTACACTGAAGCTTTCTTT	CASSFLSGDPPTCIYTEAFF	TRBV7-2	TRBJ1-1
TGTGCCAGCAGCTTGAGGGTAAGTGGTTACGAGCAGTACTTC	CASSLRVSGYEQYF	TRBV11-2	TRBJ2-7
TGTGCCAGCAGCCTATCATGTCAATATGGCTACACCTTC	CASSLSCQYGYTF	TRBV14	TRBJ1-2
TGTGCCAGGCTAGGGACAGGGGTTCCCCTGGGGGCCAACGTCCTGACTTTC	CARLGTGVPLGANVLTF	TRBV6-5	TRBJ2-6
TGCAGTGCTCAGCCAGGACGTAGTGCAGAAAGCTCCTACAATGAGCAGTTCTTC	CSAQPGRSAESSYNEQFF	TRBV20-1	TRBJ2-1
TGCGCCAGCAGTGTCCTGTGGTGGGGGAGTTACAATGAGCAGTTCTTC	CASSVLWWGSYNEQFF	TRBV10-1	TRBJ2-1
TGTGCCAGCACAGCAGATACGCAGTATTTT	CASTADTQYF	TRBV6-1	TRBJ2-3
TGTGCCAAAAAAGGGGAACACCCCTACGAGCAGTACTTC	CAKKGEHPYEQYF	TRBV6-4	TRBJ2-7
TGTGCCAGCTACAGCAGAATACACTATGGCTACACCTTC	CASYSRIHYGYTF	TRBV2	TRBJ1-2
TGTGCCAGCAGGACGGAGTCCTACGAGCAGTACTTC	CASRTESYEQYF	TRBV28	TRBJ2-7
TGTGCCAGCAGCTTAGTGGGACAGGGCGGGGAGCTGTTTTTT	CASSLVGQGGELFF	TRBV7-9	TRBJ2-2
TGTGCCAGCAGTGACGAAATAGCCCCAGAGGGGGGCCAGGAGACCCAGTACTTC	CASSDEIAPEGGQETQYF	TRBV6-4	TRBJ2-5
TGTGCCAGCAGCAGGGGGCAGAATTCACCCCTCCACTTT	CASSRGQNSPLHF	TRBV13	TRBJ1-6
TGTGCCAGCAGCGTAGGCCAGCGGGAGACCCAGTACTTC	CASSVGQRETQYF	TRBV9	TRBJ2-5
TGTGCCAGTAGGCAGGGCACAGATACGCAGTATTTT	CASRQGTDTQYF	TRBV19	TRBJ2-3
TGCAGTGCCTCTCCACCGACTAAAGGAACTAGAAACACCATATATTTT	CSASPPTKGTRNTIYF	TRBV20-1	TRBJ1-3
TGCAGTGCTATACGGTTTGAGCAGTTCTTC	CSAIRFEQFF	TRBV20-1	TRBJ2-1
TGTGCCACCAGTGATATAGAGTTAATGTACGAGCAGTACTTC	CATSDIELMYEQYF	TRBV24-1	TRBJ2-7
TGTGCCAGCAGACACAGGGCCCCGATGAACACTGAAGCTTTCTTT	CASRHRAPMNTEAFF	TRBV5-4	TRBJ1-1
TGTGCCAGCAGCTTGGCCCGGGCGATTCGCTACGAGCAGTACTTC	CASSLARAIRYEQYF	TRBV7-9	TRBJ2-7
TGTGCCAGCAGCCAAACACACATTCAGTACTTC	CASSQTHIQYF	TRBV28	TRBJ2-4
TGTGCCACCAGTGATTTCCTGGGGGCTTTTCAGCCCCAGCATTTT	CATSDFLGAFQPQHF	TRBV24-1	TRBJ1-5
TGTGCCAGCAGCCAAGGCGGACAGCCTCAACAGGATCAGCCCCAGCATTTT	CASSQGGQPQQDQPQHF	TRBV14	TRBJ1-5
TGTGCCTCTACAGGGAAGAATCAGCCCCAGCATTTT	CASTGKNQPQHF	TRBV10-3	TRBJ1-5
TGTGCCACCAGTGATTGCGCCGACAGGGGGAAACTCAATAGCAATCAGCCCCAGCATTTT	CATSDCADRGKLNSNQPQHF	TRBV24-1	TRBJ1-5
TGCGCCAGCAGTGGGACTAGCGGGACATCCTGGGGTTCCGCCTACGAGCAGTACTTC	CASSGTSGTSWGSAYEQYF	TRBV4-3	TRBJ2-7
TGCAGCGTTTTCCCCGACGGGGGGGCTTCCTACGAGCAGTACTTC	CSVFPDGGASYEQYF	TRBV29-1	TRBJ2-7
TGTGCCACCAGTGATTTTAGTTCAGTGGGTAAGCCCATAACTAATGAAAAACTGTTTTTT	CATSDFSSVGKPITNEKLFF	TRBV24-1	TRBJ1-4
TGCGCCAGCAGCTTGATTCGGGTCTGGGACTCTGGAAACACCATATATTTT	CASSLIRVWDSGNTIYF	TRBV5-1	TRBJ1-3
TGTGCCAGCAGGAGCTGGGGACTAGGACGGGGGTACGAGCAGTACTTC	CASRSWGLGRGYEQYF	TRBV6-4	TRBJ2-7
TGTGCCAGCAGTTTGGACAGGTCGTATAGCAATCAGCCCCAGCATTTT	CASSLDRSYSNQPQHF	TRBV27	TRBJ1-5
TGTGCCACCAGTGAGACCTCTGGAAACACCATATATTTT	CATSETSGNTIYF	TRBV24-1	TRBJ1-3
TGCGCCAGCAGTTACCCGGAGAGCCGCTCTGGGGCCAACGTCCTGACTTTC	CASSYPESRSGANVLTF	TRBV10-2	TRBJ2-6
TGTGCCATCAGTGAGTCCTTGGAGTCAGGGGTCGAGATTGGGGGACCCTACGAGCAGTACTTC	CAISESLESGVEIGGPYEQYF	TRBV10-3	TRBJ2-7
TGCAGTGCTAGAAGGGCCCAATACGAGCAGTACTTC	CSARRAQYEQYF	TRBV20-1	TRBJ2-7
TGCGCCGTGCTGTCTGGGGCCAACGTCCTGACTTTC	CAVLSGANVLTF	TRBV5-1	TRBJ2-6
TGTGCCAGCGGACTAGCGGGGCCCAAAAACATTCAGTACTTC	CASGLAGPKNIQYF	TRBV27	TRBJ2-4
TGTGCCAGCAGCGTAGGCCCAGGGGGGATTGAAGCTTTCTTT	CASSVGPGGIEAFF	TRBV9	TRBJ1-1
TGTGCCAGCAGTTTAGACATACCGAGACAGCGACAGCATTCACCCCTCCACTTT	CASSLDIPRQRQHSPLHF	TRBV12-4	TRBJ1-6
TGTGCCAGCAGCAAACAGGGACTCTGTGAAAAACTGTTTTTT	CASSKQGLCEKLFF	TRBV13	TRBJ1-4
TGTGCCAGCAGTCCTTGGACAGATTATGGCTACACCTTC	CASSPWTDYGYTF	TRBV6-2	TRBJ1-2
TGCGCCAGCAGCCGGACGGGACACCCGAGCTACGAGCAGTACTTC	CASSRTGHPSYEQYF	TRBV4-1	TRBJ2-7
TGTGCCAGCAGCTTGGGGACCTCGGCAGAAAGCTCCTATAATTCACCCCTCCACTTT	CASSLGTSAESSYNSPLHF	TRBV5-6	TRBJ1-6
TGTGCCAGCAGCTCCAAGGGAACCCAGTACTTC	CASSSKGTQYF	TRBV7-6	TRBJ2-5
TGCGCCAGCAGCGACAGGGAGGTTCCTCGCCTGGGTCAGCCCCAGCATTTT	CASSDREVPRLGQPQHF	TRBV5-1	TRBJ1-5
TGTGCCAGCAGCGTAGTTGGGACTAGGTATCGAAGCACAGATACGCAGTATTTT	CASSVVGTRYRSTDTQYF	TRBV9	TRBJ2-3
TGTGCCAGCAGGGCAGGGGGGGAGAATAGCAATCAGCCCCAGCATTTT	CASRAGGENSNQPQHF	TRBV27	TRBJ1-5
TGCAGCGTTGAGCGGGATGGGGTCTATGGCTACACCTTC	CSVERDGVYGYTF	TRBV29-1	TRBJ1-2
TGCGCCAGCAGTGAGCAATCGACCCGGGACAGCGGTAATGAGCAGTTCTTC	CASSEQSTRDSGNEQFF	TRBV10-1	TRBJ2-1
TGTGCCAGCAGCCCCCTACTGAGTTTATCCGGGGAGCTGTTTTTT	CASSPLLSLSGELFF	TRBV6-1	TRBJ2-2
TGTGCCAGCGACCACATGAGGGCCCTGTTTTTT	CASDHMRALFF	TRBV6-5	TRBJ1-4
TGTGCCAGCAGCTCCTGGGGACCTTGGAACGCTAATTCTACTAATGAAAAACTGTTTTTT	CASSSWGPWNANSTNEKLFF	TRBV11-3	TRBJ1-4
TGTGCCAGCAGTTTAAAATGGCCGAACTATGGCTACACCTTC	CASSLKWPNYGYTF	TRBV12-3	TRBJ1-2
TGTGCCAGCAGCCCGGACAGCCGGACATATAATTCACCCCTCCACTTT	CASSPDSRTYNSPLHF	TRBV9	TRBJ1-6
TGTGCCAGCAGTTTAAGGCAGCGACCCACTGAAGCTTTCTTT	CASSLRQRPTEAFF	TRBV27	TRBJ1-1
TGTGCCAGCAGTTTTCGGACCCTCCTAAGTCCAGATACGCAGTATTTT	CASSFRTLLSPDTQYF	TRBV28	TRBJ2-3
TGTGCCAGCAGTTGGGACAGGGAGACAAGGAACTACACTGAAGCTTTCTTT	CASSWDRETRNYTEAFF	TRBV27	TRBJ1-1
TGTGCCAGCCGGACAGAGACCCAGTACTTC	CASRTETQYF	TRBV7-9	TRBJ2-5
TGCGCCAGCAGTGATCCCCGGACAGGTGGCTACACCTTC	CASSDPRTGGYTF	TRBV10-1	TRBJ1-2
TGTGCCAGCAGTTCGTGGAGCCCAGAGATAGGCTACACCTTC	CASSSWSPEIGYTF	TRBV6-3	TRBJ1-2
TGCGCCAGCGAGGGCTACGAGCAGTACTTC	CASEGYEQYF	TRBV5-1	TRBJ2-7
TGTGCCAGCACCCTAGCGGGGCGCACAGATACGCAGTATTTT	CASTLAGRTDTQYF	TRBV7-9	TRBJ2-3
TGCGCCAGCAGCTTGCCCGGGGGGGAGACAGATACGCAGTATTTT	CASSLPGGETDTQYF	TRBV5-1	TRBJ2-3
TGTGCCAGCAGCTTACAAGGGCAAAAGTTGGAGCAGTACTTC	CASSLQGQKLEQYF	TRBV7-3	TRBJ2-7
TGTGCCAGCAGCTTAGGAAGGGGGTCACTCGAGCAGTACTTC	CASSLGRGSLEQYF	TRBV11-2	TRBJ2-7
TGTGCCACCAGTGATTTGAGGGGGGGTGAAGAGACCCAGTACTTC	CATSDLRGGEETQYF	TRBV24-1	TRBJ2-5
TGTGCCAGCAGTTTAACCTCCTCCCCACTGAACACCGGGGAGCTGTTTTTT	CASSLTSSPLNTGELFF	TRBV12-3	TRBJ2-2
TGTGCCAGCAGGGGTCTGGAACAGGGGTGGGACTATGGCTACACCTTC	CASRGLEQGWDYGYTF	TRBV28	TRBJ1-2
TGTGCCAGCAGCTCCCTCCCATCTAGCGGGCGGGCGGAATTGATGCAAGAGACCCAGTACTTC	CASSSLPSSGRAELMQETQYF	TRBV7-8	TRBJ2-5
TGTGCCAGCAGGGGTAGCACAGATACGCAGTATTTT	CASRGSTDTQYF	TRBV25-1	TRBJ2-3
TGCGCCAGCAGAAACCTGGCTGTCAATGAGCAGTTCTTC	CASRNLAVNEQFF	TRBV10-2	TRBJ2-1
TGTGCCAGCATACAGAGATCCTCAAAAAACGGGACTCAGGAGACCCAGTACTTC	CASIQRSSKNGTQETQYF	TRBV6-1	TRBJ2-5
TGTGCCAGCAGTGAGTATAGCAATCAGCCCCAGCATTTT	CASSEYSNQPQHF	TRBV6-4	TRBJ1-5
TGTGCAGAGGAATCCGAGCAGTACTTC	CAEESEQYF	TRBV27	TRBJ2-7
TGTGCCAGCAGCCTGAAGAGGTACTCGTACTACGAGCAGTACTTC	CASSLKRYSYYEQYF	TRBV7-3	TRBJ2-7
TGCGCCAGCAGCCAAGACGGTTCCGAGGGGGCCGGGGTACCGGGAGCCTACGAGCAGTACTTC	CASSQDGSEGAGVPGAYEQYF	TRBV4-3	TRBJ2-7
TGTGCTAGTGGTCAATCTAGGACAGGCTACGAGCAGTACTTC	CASGQSRTGYEQYF	TRBV12-5	TRBJ2-7
TGTGCCAGCAGCTTGGCCGAACGACACGTACCCGGGGAGCTGTTTTTT	CASSLAERHVPGELFF	TRBV5-6	TRBJ2-2
TGTGCCAGCAGCTTCATCAGGGAGTACTTC	CASSFIREYF	TRBV7-2	TRBJ2-7
TGTGCCAGCAGTGAACCGAGAATTGTTAACTTAAACAGGGGAATGAACACTGAAGCTTTCTTT	CASSEPRIVNLNRGMNTEAFF	TRBV6-1	TRBJ1-1
TGTGCCGGACCCGGGACTAGGCTGCCGACCGAGCAGTACTTC	CAGPGTRLPTEQYF	TRBV12-3	TRBJ2-7
TGTGCCAGCAGCTTAGTACCAATGGACAGGGCCTTAGGCAATCAGCCCCAGCATTTT	CASSLVPMDRALGNQPQHF	TRBV7-3	TRBJ1-5
TGTGCCAGCAGCGGAGGGATTTCTGCTTTCTTT	CASSGGISAFF	TRBV9	TRBJ1-1
TGCGCCAGCAGCTTGCGACGGAGGGTTAACTATGGCTACACCTTC	CASSLRRRVNYGYTF	TRBV5-1	TRBJ1-2
TGTGCCAGCAGTTTATGTAAATCGGCCGGAGATGAGCAGTTCTTC	CASSLCKSAGDEQFF	TRBV28	TRBJ2-1
TGTGCCAGCAGCCCCGGGACCTCAGATACGCAGTATTTT	CASSPGTSDTQYF	TRBV14	TRBJ2-3
TGTGCCAGCAGCCAAGACGGACAGAGGCGATTGGGCAACACTGAAGCTTTCTTT	CASSQDGQRRLGNTEAFF	TRBV4-2	TRBJ1-1
TGTGCCAGCAGCGTAGAGGCGGACCGGGCATATGGCTACACCTTC	CASSVEADRAYGYTF	TRBV9	TRBJ1-2
TGTGCCAGCAGCCCCCCACTAGCGGGGGGAAACGAGCAGTACTTC	CASSPPLAGGNEQYF	TRBV5-6	TRBJ2-7
TGCGCCAGCATTCCATTCGGGCCGAACACCGGGGAGCTGTTTTTT	CASIPFGPNTGELFF	TRBV10-2	TRBJ2-2
TGTGCCAGCTACGATAACCGCACTGAAGCTTTCTTT	CASYDNRTEAFF	TRBV6-4	TRBJ1-1
TGTGCCAGCAGCGGAGGGGCCTACAATGAGCAGTTCTTC	CASSGGAYNEQFF	TRBV13	TRBJ2-1
TGCGCCAGCAGCCAAGATTCGGACAGGGGGCTACAGGAGACCCAGTACTTC	CASSQDSDRGLQETQYF	TRBV4-1	TRBJ2-5
TGTGCCAGTAGTATCCTCTTAGGGGGACAAGAGACCCAGTACTTC	CASSILLGGQETQYF	TRBV19	TRBJ2-5
TGTGCCAGCACCCCTCCCGAGATGGACAGAGATAGGAAGTTGAACACTGAAGCTTTCTTT	CASTPPEMDRDRKLNTEAFF	TRBV28	TRBJ1-1
TGTGCCAGCAGCTTGGGGGGTGAAAAACTGTTTTTT	CASSLGGEKLFF	TRBV5-6	TRBJ1-4
TGTGCCAGCAGCGTAGCCGGGACAGGGGGCCTCGGCAATCAGCCCCAGCATTTT	CASSVAGTGGLGNQPQHF	TRBV9	TRBJ1-5
TGTGCCAGCAGTCCTAGACTAGCCAGTTATTGCAATGAGCAGTTCTTC	CASSPRLASYCNEQFF	TRBV6-1	TRBJ2-1
TGTGCCACCAGTGATAGGCTTAATGAGCAGTTCTTC	CATSDRLNEQFF	TRBV24-1	TRBJ2-1
TGTGCCAGCAGCTTAGATGGGGGGGTGTGTGTTCACAATGAGCAGTTCTTC	CASSLDGGVCVHNEQFF	TRBV11-3	TRBJ2-1
TGTGCCATTCCCACAGGGGTTAGCTCCTACGAGCAGTACTTC	CAIPTGVSSYEQYF	TRBV28	TRBJ2-7
TGTGCCACCAGCAGAGCGTGGACAAAAAACGAGCAGTACTTC	CATSRAWTKNEQYF	TRBV15	TRBJ2-7
TGTGCCAGCAGCCAAGACGGACAGGGGGCCTACGAGCAGTACTTC	CASSQDGQGAYEQYF	TRBV4-2	TRBJ2-7
TGTGCCATCAGTGAGTCGCGGTTTGGGCGGACTAGGAGCTACAATGAGCAGTTCTTC	CAISESRFGRTRSYNEQFF	TRBV10-3	TRBJ2-1
TGTGCCAGCAGTCTAGGGGAGCTGTTTTTT	CASSLGELFF	TRBV27	TRBJ2-2
TGCGCCAGCAGCACCTTTCCCGGGACAGTCAGCTCTGGAAACACCATATATTTT	CASSTFPGTVSSGNTIYF	TRBV5-1	TRBJ1-3
TGCAGTGCTAGTTCCATTCGGGGGGCTTACAATGAGCAGTTCTTC	CSASSIRGAYNEQFF	TRBV20-1	TRBJ2-1
TGCGCCAGCAACCCCGGCTGGAAAGGCACCGGGGAGCTGTTTTTT	CASNPGWKGTGELFF	TRBV10-1	TRBJ2-2
TGTGCCAGTAACCCCCAGGCGGCACGACGGAGCACTGAAGCTTTCTTT	CASNPQAARRSTEAFF	TRBV19	TRBJ1-1
TGTGCCAGCAGCGCGAAGCCTAACTCAGGACAGCTAAGCAATCAGCCCCAGCATTTT	CASSAKPNSGQLSNQPQHF	TRBV9	TRBJ1-5
TGTGCCAGCATTTTTGTCCGGGCCCAAGAGACCCAGTACTTC	CASIFVRAQETQYF	TRBV27	TRBJ2-5
TGTGCCAGCACTGGCCCGAGCCGGACTAGCGGGAGCAGGGAGCAGTACTTC	CASTGPSRTSGSREQYF	TRBV28	TRBJ2-7
TGTGCCAGCAGCTTAAACATCGAACTAGCGGGAGGGGGAAACACCATATATTTT	CASSLNIELAGGGNTIYF	TRBV7-3	TRBJ1-3
TGTGCCAGCAGCGGGGATCAGGGGGCCAACGTCCTGACTTTC	CASSGDQGANVLTF	TRBV9	TRBJ2-6
TGCAGTGCTAGAGGGGGGCGCTATAGCAATCAGCCCCAGCATTTT	CSARGGRYSNQPQHF	TRBV20-1	TRBJ1-5
TGCAGCGTCCGTGAGGGACGAAGAGAGAGCAATCAGCCCCAGCATTTT	CSVREGRRESNQPQHF	TRBV29-1	TRBJ1-5
TGTGCCAGCAGTTACAGCATCTCGGGGATGCAGGGCTCCTACAATGAGCAGTTCTTC	CASSYSISGMQGSYNEQFF	TRBV6-2	TRBJ2-1
TGTGCCAGCAGCTTAGTAGGCAGCCGGCAGTTCTCTGGAAACACCATATATTTT	CASSLVGSRQFSGNTIYF	TRBV11-2	TRBJ1-3
TGTGCCAGCAGCACTTTCCCGCAGGGCTCGAGCTCCTATAATTCACCCCTCCACTTT	CASSTFPQGSSSYNSPLHF	TRBV7-4	TRBJ1-6
TGTGCCAGCATGGTCAGGGCTTCCCAGCCCCAGCATTTT	CASMVRASQPQHF	TRBV7-3	TRBJ1-5
TGTGCCAGCAGACTCTCAGGGGGGCCAAACGAGCAGTACTTC	CASRLSGGPNEQYF	TRBV28	TRBJ2-7
TGTGCCAGCAGCCGGGGTGGGGCAGCCGCCTACGAGCAGTACTTC	CASSRGGAAAYEQYF	TRBV9	TRBJ2-7
TGTGCCAGCAGCGCGGCCCAAGAAAAACTGTTTTTT	CASSAAQEKLFF	TRBV5-6	TRBJ1-4
TGTGCCAGCAGCCGAGGGGGAGATGGCTACACCTTC	CASSRGGDGYTF	TRBV9	TRBJ1-2
TGTGCTAGTGGTTTGGGAGACCCCGGCGCGGGAGCTGGAAACACCATATATTTT	CASGLGDPGAGAGNTIYF	TRBV12-5	TRBJ1-3
TGTGCCAGCAGCTCTAACGACAGGTGTAATCAGCCCCAGCATTTT	CASSSNDRCNQPQHF	TRBV6-5	TRBJ1-5
TGTGCCAGCAGCTTGGGACGCCTTAGGAGAGACACCATATATTTT	CASSLGRLRRDTIYF	TRBV5-6	TRBJ1-3
TGTGCTAGTGGTTCTTGGGACAGCACTGAAGCTTTCTTT	CASGSWDSTEAFF	TRBV12-5	TRBJ1-1
TGCAGTGCTAGAGACTTGGAGCGGGGGAGCGGAGAGAACACCGGGGAGCTGTTTTTT	CSARDLERGSGENTGELFF	TRBV20-1	TRBJ2-2
TGTGCCAGCAGCTTAGGCGGACAGGGAAGCCCCTACGAGCAGTACTTC	CASSLGGQGSPYEQYF	TRBV7-2	TRBJ2-7
TGTGCCGCATCCGGGACACTGTGCTCCTACAATGAGCAGTTCTTC	CAASGTLCSYNEQFF	TRBV24-1	TRBJ2-1
TGCAGTGCTAAGGGGATGGACGGGGAGCTGTTTTTT	CSAKGMDGELFF	TRBV20-1	TRBJ2-2
TGTGCCAGTCCCCGGGACAGGGGTAATGAAAAACTGTTTTTT	CASPRDRGNEKLFF	TRBV9	TRBJ1-4
TGTGCCTGGTTAGGCTTCCAGGGGGACTACGAGCAGTACTTC	CAWLGFQGDYEQYF	TRBV30	TRBJ2-7
TGCGCCAGCAGCCAAGATTGGGGGACTAGCGCCAATGAGCAGTTCTTC	CASSQDWGTSANEQFF	TRBV4-3	TRBJ2-1
TGTGCCAGCGCCGGGACAGGAAGGCCTTCCTCCTACAATGAGCAGTTCTTC	CASAGTGRPSSYNEQFF	TRBV12-3	TRBJ2-1
TGTGCCAGCAGCTTATACGGAGGACTAGCGGGGGATATTAAAAACATTCAGTACTTC	CASSLYGGLAGDIKNIQYF	TRBV7-4	TRBJ2-4
TGTGCCAGCTCACCAGCTGCGATAATTCTAGCGATGGTTAGCTACGAGCAGTACTTC	CASSPAAIILAMVSYEQYF	TRBV18	TRBJ2-7
TGTGCCAGCAGTTACTGTCCGGACAGGGAAGAGCAGTTCTTC	CASSYCPDREEQFF	TRBV6-3	TRBJ2-1
TGCGCCAGCAGCTTGGTTGTGGGCCTCTATGGCTACACCTTC	CASSLVVGLYGYTF	TRBV5-1	TRBJ1-2
TGTGCCATCACCCCTAGGTCCCCTACCGAAAAAGAGACCCAGTACTTC	CAITPRSPTEKETQYF	TRBV10-3	TRBJ2-5
TGCGCCAGCAGATTGGGGGGCCCAGAGACCCAGTACTTC	CASRLGGPETQYF	TRBV4-1	TRBJ2-5
TGTGCCTGGAGGGTTCGACTAGTAGCCAAAAACATTCAGTACTTC	CAWRVRLVAKNIQYF	TRBV30	TRBJ2-4
TGTGCCAGCAGCCTTGCTAGCGGGGACTGGGAGCTGTTTTTT	CASSLASGDWELFF	TRBV13	TRBJ2-2
TGTGCCAGCAGCCCGCCTCCAAGCTCCTACGAGCAGTACTTC	CASSPPPSSYEQYF	TRBV7-3	TRBJ2-7
TGCGCCAGCGCCGACAGTGACACTGAAGCTTTCTTT	CASADSDTEAFF	TRBV10-1	TRBJ1-1
TGTGCTAGTGGTTATCGTTCTTCTACGGAAACCGGGGAGCTGTTTTTT	CASGYRSSTETGELFF	TRBV12-5	TRBJ2-2
TGTGCCAGCAGTTTACTAACATCGGGCAATCAGCCCCAGCATTTT	CASSLLTSGNQPQHF	TRBV12-4	TRBJ1-5
TGTGCCAGCAGTGCAGCCCAGTACTTC	CASSAAQYF	TRBV27	TRBJ2-5
TGTGCCAGCAGTGAAGGAGAACGGGGGGATAGCGGAAACACCATATATTTT	CASSEGERGDSGNTIYF	TRBV6-1	TRBJ1-3
TGTGCCCGGGGGACCACTGAAGCTTTCTTT	CARGTTEAFF	TRBV6-5	TRBJ1-1
TGTGCCAGCAGTTATAACCGGCCTGAAGCTTTCTTT	CASSYNRPEAFF	TRBV6-5	TRBJ1-1
TGTGCCAGCAGTTACACCCAGGGACAGGGGAACTATGGCTACACCTTC	CASSYTQGQGNYGYTF	TRBV6-6	TRBJ1-2
TGTGCCAGCAGCGGCCCGGAGGCGACATTAACCTACGAGCAGTACTTC	CASSGPEATLTYEQYF	TRBV7-2	TRBJ2-7
TGTGCCAGCAGTTACCTACTAGCGGATGCCAACGAGCAGTACTTC	CASSYLLADANEQYF	TRBV6-5	TRBJ2-7
TGTGCCAGCAGCTTTAATCCGTACGGAGTGAAGAAACGACCTAGCACAGATACGCAGTATTTT	CASSFNPYGVKKRPSTDTQYF	TRBV5-6	TRBJ2-3
TGTGCCAGCAGCTGCAGGGGGTGTGATAGCAATCAGCCCCAGCATTTT	CASSCRGCDSNQPQHF	TRBV7-9	TRBJ1-5
TGTGCCAGCAGCCTTCAGGGGGCACCGGATAAGCCCCAGCATTTT	CASSLQGAPDKPQHF	TRBV4-2	TRBJ1-5
TGCGCCAGCAGCTTAGCCCCGAGCTTGTGCACAACTAATGAAAAACTGTTTTTT	CASSLAPSLCTTNEKLFF	TRBV5-1	TRBJ1-4
TGTGCCAGCAGCTTAGGGAGCCGGGACAGTAACTTCAATGAGCAGTTCTTC	CASSLGSRDSNFNEQFF	TRBV11-3	TRBJ2-1
TGTGCCAGCAGTGACGCGCCCCTCCGGGACAGGGGGCCGGAGAACACTGAAGCTTTCTTT	CASSDAPLRDRGPENTEAFF	TRBV2	TRBJ1-1
TGTGCCAGCAACAAGGAGACCCAGTACTTC	CASNKETQYF	TRBV28	TRBJ2-5
TGTGCCAGCAGCCAGGGGGGGGTCGAGCAGTACTTC	CASSQGGVEQYF	TRBV7-9	TRBJ2-7
TGTGCCAGCAGCCTTCGACAAAATGTATATGGCTACACCTTC	CASSLRQNVYGYTF	TRBV13	TRBJ1-2
TGCGCCAGCAGCCGGCCCCCAGGGGGAGATAATGAAAAACTGTTTTTT	CASSRPPGGDNEKLFF	TRBV5-1	TRBJ1-4
TGTGCCAGCAGCTTTGAGGGCCTCGCCCCTGAGCAGTACTTC	CASSFEGLAPEQYF	TRBV7-4	TRBJ2-7
TGCAGTGCTAGAAATGGAAATGAGCAGTTCTTC	CSARNGNEQFF	TRBV20-1	TRBJ2-1
TGTGCCAGCAGCTTAGGGACCCGAGGACAGCTGGATTCTAATGAGCAGTTCTTC	CASSLGTRGQLDSNEQFF	TRBV7-4	TRBJ2-1
TGTGCCAGCAGCTTTATCCGGGACTACCTGAGCTGGGAGAACACCTACGAGCAGTACTTC	CASSFIRDYLSWENTYEQYF	TRBV11-2	TRBJ2-7
TGTGCCAGCAGTAAAGAATGGGCTGACGGAGCAGCAGATACGCAGTATTTT	CASSKEWADGAADTQYF	TRBV6-3	TRBJ2-3
TGTGCCAGCTCGCTCGGGGGGGACTCTAGCACAGATACGCAGTATTTT	CASSLGGDSSTDTQYF	TRBV18	TRBJ2-3
TGTGCCACCAGTGACGGGCAGGGCGGGGGGTATGGCTACACCTTC	CATSDGQGGGYGYTF	TRBV24-1	TRBJ1-2
TGTGCCAGCCCGTCGGTTTGCTACGAGCAGTACTTC	CASPSVCYEQYF	TRBV7-3	TRBJ2-7
TGCGCCAGCAGTGAGGCGGGGGGGGCCTGGTACAATGAGCAGTTCTTC	CASSEAGGAWYNEQFF	TRBV10-1	TRBJ2-1
TGTGCCGGCGACTCCACTGAAGCTTTCTTT	CAGDSTEAFF	TRBV7-2	TRBJ1-1
TGTGCCACCAGTGACGGGGGCGGGAGAATGAACACTGAAGCTTTCTTT	CATSDGGGRMNTEAFF	TRBV24-1	TRBJ1-1
TGCGCCAGCAGCCAGAGGGGCACTGAAGCTTTCTTT	CASSQRGTEAFF	TRBV4-1	TRBJ1-1
TGTGCCAGCAGCCAAGAGGACAGGGGGACAGCGGGCTCACTGAACACTGAAGCTTTCTTT	CASSQEDRGTAGSLNTEAFF	TRBV14	TRBJ1-1
TGTGCCAGCCGCCCGGGACATCAGCCCCAGCATTTT	CASRPGHQPQHF	TRBV9	TRBJ1-5
TGTGCCAGCAGCTTGAAGCGCCCGGGACTAGCGGGCCGGGGGCAGTTCTTC	CASSLKRPGLAGRGQFF	TRBV5-4	TRBJ2-1
TGTGCCAGCAGTGGTGTTTCGAATGGGACCCGTTCACCCCTCCACTTT	CASSGVSNGTRSPLHF	TRBV25-1	TRBJ1-6
TGTGCCAGCAGCCAAGATGACAAGAGCACTAATTGCACAGATACGCAGTATTTT	CASSQDDKSTNCTDTQYF	TRBV3-1	TRBJ2-3
TGTGCCAGCAGGGGGCTCTGGGGGTACTTC	CASRGLWGYF	TRBV6-5	TRBJ2-7
TGTGCCAGCAGCGACAGGTCCGATCAGCCCCAGCATTTT	CASSDRSDQPQHF	TRBV5-5	TRBJ1-5
TGTGCCAGCAGTGTGTGGGACAGGGCTCATTACATTCAGTACTTC	CASSVWDRAHYIQYF	TRBV27	TRBJ2-4
TGTGCCAGCAGCCCCCGGCGACAGGGGGGTGATTCACCCCTCCACTTT	CASSPRRQGGDSPLHF	TRBV27	TRBJ1-6
TGTGCCACAGAAGGCTACGAGCAGTACTTC	CATEGYEQYF	TRBV10-3	TRBJ2-7
TGTGCCAGCTCACCAACGGGGACTGCCGGGGAGCTGTTTTTT	CASSPTGTAGELFF	TRBV18	TRBJ2-2
TGTGCCAGGAGGCCGTGGTATAGCAATCAGCCCCAGCATTTT	CARRPWYSNQPQHF	TRBV14	TRBJ1-5
TGCAGCGTTGAAGATCGCAGTGAAGTAGTCGAGCAGTACTTC	CSVEDRSEVVEQYF	TRBV29-1	TRBJ2-7
TGCGCCAGCAGCCAATTAATCCAGGGAGGGGCTGAAAAACTGTTTTTT	CASSQLIQGGAEKLFF	TRBV4-1	TRBJ1-4
TGTGCCAAAGGGGGCGGTACTAATGAAAAACTGTTTTTT	CAKGGGTNEKLFF	TRBV6-5	TRBJ1-4
TGTGCCTGGAAAAAACAAGGTGTCCTTCCGGGGGGGCGTTCCCCTCCTGAGGGGGTGGAAGTTGAAAAACTGTTTTTT	CAWKKQGVLPGGRSPPEGVEVEKLFF	TRBV30	TRBJ1-4
TGTGCCAGCGACGGAGGGGTCTACGAGCAGTACTTC	CASDGGVYEQYF	TRBV28	TRBJ2-7
TGTGCCTGGAAAATCCCAACTAGCGGGAGAAAAAGCACAGATACGCAGTATTTT	CAWKIPTSGRKSTDTQYF	TRBV30	TRBJ2-3
TGTGCCAGCAGCTTTCGTATCGGGGGACACACTGAAGCTTTCTTT	CASSFRIGGHTEAFF	TRBV5-4	TRBJ1-1
TGTGCCAGCAGTTCCCAGCATCATAGGCGGGACAGTGAGACCCAGTACTTC	CASSSQHHRRDSETQYF	TRBV6-5	TRBJ2-5
TGTGCCAGCAGCGCCGGGCGGGGCCTAGCTTTCTTT	CASSAGRGLAFF	TRBV7-2	TRBJ1-1
TGTGCCAGCAGCAGAGGGCGAAAAGGGGTGCGTGTGAGATACAATGAGCAGTTCTTC	CASSRGRKGVRVRYNEQFF	TRBV6-4	TRBJ2-1
TGCAGTGCTAGAGAAAGCCGGCGCAATGAGCAGTTCTTC	CSARESRRNEQFF	TRBV20-1	TRBJ2-1
TGCAGTGCTAGAGTCAGCGGTCACAATGAGCAGTTCTTC	CSARVSGHNEQFF	TRBV20-1	TRBJ2-1
TGTGCCAGGCTCGGGAGGGGGTTGAGGACTAATGAAAAACTGTTTTTT	CARLGRGLRTNEKLFF	TRBV19	TRBJ1-4
TGTGCCAGCAGCCAAGCACTTTCCCGGGGGGGCGAGCAGTACTTC	CASSQALSRGGEQYF	TRBV4-2	TRBJ2-7
TGTGCCAGCCTCTTCCGGGACTGTGAGACCCAGTACTTC	CASLFRDCETQYF	TRBV7-3	TRBJ2-5
TGTGCCAGCAGTTACGGGGGTGGTTCCTACGAGCAGTACTTC	CASSYGGGSYEQYF	TRBV6-6	TRBJ2-7
TGCGCCAGCAGCCCTTCCCACAGCGGGAATCATGAAAAACTGTTTTTT	CASSPSHSGNHEKLFF	TRBV5-1	TRBJ1-4
TGTGCCAGCAGTTACTTGAACACTGAAGCTTTCTTT	CASSYLNTEAFF	TRBV28	TRBJ1-1
TGTGCCAGCAGTTCAAAGCTAGCGGAAACGATCTACGAGCAGTACTTC	CASSSKLAETIYEQYF	TRBV28	TRBJ2-7
TGTGCCAGCAGCTACGCGGATTACGAGCAGTACTTC	CASSYADYEQYF	TRBV11-3	TRBJ2-7
TGTGCCTGGCAGACGCTCTCACCCCTCCACTTT	CAWQTLSPLHF	TRBV30	TRBJ1-6
TGCAGTGAATCGACAGGGGAGAACACTGAAGCTTTCTTT	CSESTGENTEAFF	TRBV20-1	TRBJ1-1
TGTGCCAGCAGTGAATCCAACACTAAACCTCAGCCCCAGCATTTT	CASSESNTKPQPQHF	TRBV25-1	TRBJ1-5
TGTGCCAGCCCGGGGGGTGATAATTCACCCCTCCACTTT	CASPGGDNSPLHF	TRBV2	TRBJ1-6
TGCGCCAGCAGCCCACGTGACCTTGGAGAGCAGTACTTC	CASSPRDLGEQYF	TRBV4-3	TRBJ2-7
TGTGCCAGCAGAACCCCCAGGGGCGGCCATTTTTATAATTCACCCCTCCACTTT	CASRTPRGGHFYNSPLHF	TRBV6-5	TRBJ1-6
TGCGCCAGCAGCCATACGGCAGCTCAGCCCCAGCATTTT	CASSHTAAQPQHF	TRBV4-3	TRBJ1-5
TGCGCCAGCAGCCATGTCCCTGGACGGGGGGATACGCAGTATTTT	CASSHVPGRGDTQYF	TRBV5-1	TRBJ2-3
TGTGCCAGCAGTGATAGGCGTGAGGGAGTTGGACGGGAGCTGTTTTTT	CASSDRREGVGRELFF	TRBV6-1	TRBJ2-2
TGTGCCAGCAGCGTAGAGAGCGGGAGAATCCAAGAGACCCAGTACTTC	CASSVESGRIQETQYF	TRBV9	TRBJ2-5
TGCAGCGTTGGGGCCGGGGGGTCCTACGAGCAGTACTTC	CSVGAGGSYEQYF	TRBV29-1	TRBJ2-7
TGTGCCACCCAGTGTCTAGCGGGGAATAGCACAGATACGCAGTATTTT	CATQCLAGNSTDTQYF	TRBV28	TRBJ2-3
TGTGCCAGCAGCTGGGGGACTAGCGGGTATGAGCAGTACTTC	CASSWGTSGYEQYF	TRBV5-4	TRBJ2-7
TGCAGTGCTAGAATGGGGGGGGGGGGTTCTGGAAACACCATATATTTT	CSARMGGGGSGNTIYF	TRBV20-1	TRBJ1-3
TGTGCCAGCAGCTTCTCCACAGGGGGGTCTGGGGCCAACGTCCTGACTTTC	CASSFSTGGSGANVLTF	TRBV7-9	TRBJ2-6
TGCAGTGCAAGGACGTCCAAGGGAACTAATGAAAAACTGTTTTTT	CSARTSKGTNEKLFF	TRBV20-1	TRBJ1-4
TGTGCCAGCAGTGCGGGACAGTGCAAGTATTTT	CASSAGQCKYF	TRBV6-1	TRBJ2-3
TGTGCCAGCTCACCTTGGGAGGACGGGATTCAAGAGACCCAGTACTTC	CASSPWEDGIQETQYF	TRBV18	TRBJ2-5
TGTGCCAGCAGCTGTGCACGGCTTGAAGCTTTCTTT	CASSCARLEAFF	TRBV11-2	TRBJ1-1
TGTGCCAGCAGCCACTACACAGGCGGGACGGGGGACGAGCAGTACTTC	CASSHYTGGTGDEQYF	TRBV3-1	TRBJ2-7
TGTGCCAGCAGCTTAGGAAGGACAGGGGGTAGTAACACTGAAGCTTTCTTT	CASSLGRTGGSNTEAFF	TRBV7-3	TRBJ1-1
TGTCGCCCTTCGCTAGCGGCCGCTTACAATGAGCAGTTCTTC	CRPSLAAAYNEQFF	TRBV10-3	TRBJ2-1
TGCAGCGTTGAACCTTCAGGGGGGGCCAGGAGAGATACGCAGTATTTT	CSVEPSGGARRDTQYF	TRBV29-1	TRBJ2-3
TGCGCCGCAACCCGGGGGGGCTCCTACGAGCAGTACTTC	CAATRGGSYEQYF	TRBV5-1	TRBJ2-7
TGTGCCAGCAGCCTTGACAGGAAACGGCCCTACGAGCAGTACTTC	CASSLDRKRPYEQYF	TRBV7-3	TRBJ2-7
TGCAGTGCTAGTACTATCCCTCTAGCGGGAGTACCCCAAGAGACCCAGTACTTC	CSASTIPLAGVPQETQYF	TRBV20-1	TRBJ2-5
TGCGCCAGCAGCCAAGATTGGTCGGGACAGGAATGCTACGAGCAGTACTTC	CASSQDWSGQECYEQYF	TRBV4-1	TRBJ2-7
TGTGCCAGTAGTATAACCGGACTAGCGGGTATAGGGGGCGATACGCAGTATTTT	CASSITGLAGIGGDTQYF	TRBV19	TRBJ2-3
TGTGCCAGTGCAGGGCATCAGCCCCAGCATTTT	CASAGHQPQHF	TRBV11-3	TRBJ1-5
TGTGCCACCATTCCCTCAGGGTTTCTTCATCAGCCCCAGCATTTT	CATIPSGFLHQPQHF	TRBV24-1	TRBJ1-5
TGTGCCAGCAGCTTACCCAGCCGGACGGAGGGAAGTTACAATGAGCAGTTCTTC	CASSLPSRTEGSYNEQFF	TRBV7-2	TRBJ2-1
TGCGCCAGCAGTGAGTTGAGGGACAGCTATTATAGCAATCAGCCCCAGCATTTT	CASSELRDSYYSNQPQHF	TRBV10-1	TRBJ1-5
TGTGCCAGCAGCGGCCCTAGACAGGGAGGGGGCACTGAAGCTTTCTTT	CASSGPRQGGGTEAFF	TRBV7-4	TRBJ1-1
TGTGCCAGCAGTTTAAAGGGGGGGCTCTACGAGCAGTACTTC	CASSLKGGLYEQYF	TRBV28	TRBJ2-7
TGTGCCACCAGTGAGGGTAAAAGCCGTGCCAAAAACATTCAGTACTTC	CATSEGKSRAKNIQYF	TRBV24-1	TRBJ2-4
TGCAGTGCTAATCTCCCGGGACAGCCCAATGAGCAGTTCTTC	CSANLPGQPNEQFF	TRBV20-1	TRBJ2-1
TGTGCCAGCAGTTTCGGGAGGGCTAACGAGCAGTACTTC	CASSFGRANEQYF	TRBV28	TRBJ2-7
TGTGCCAGCAGCAGGGGAATAAAGCCGAACACTGAAGCTTTCTTT	CASSRGIKPNTEAFF	TRBV7-9	TRBJ1-1
TGTGCCAGCAGCTTGGGGACTCAGCCCCAGCATTTT	CASSLGTQPQHF	TRBV5-5	TRBJ1-5
TGTGCCAGCAGCTCCCCACAGGGGGTTGATGAGACCCAGTACTTC	CASSSPQGVDETQYF	TRBV5-6	TRBJ2-5
TGTGCCAGCAGCGACCAGGGGGCCCCGGGCATTCAGTACTTC	CASSDQGAPGIQYF	TRBV7-9	TRBJ2-4
TGTGCCAGCAGCTGGGGCGGCGGAGAGACCCAGTACTTC	CASSWGGGETQYF	TRBV27	TRBJ2-5
TGCGCCAGCAGCGGAGGGGGTGGCGGGAGGGAAGACAATGAGCAGTTCTTC	CASSGGGGGREDNEQFF	TRBV4-3	TRBJ2-1
TGTGCCAGCAGTAAAGGCCGAAACCAAGAGACCCAGTACTTC	CASSKGRNQETQYF	TRBV28	TRBJ2-5
TGCGCCAGCAGCGCGGGGGGGGGGCCCGGGGAGCTGTTTTTT	CASSAGGGPGELFF	TRBV5-1	TRBJ2-2
TGTGCCAGCAGTTGCGGGACATCAGCACCAGAAAAACTGTTTTTT	CASSCGTSAPEKLFF	TRBV6-5	TRBJ1-4
TGTGCCAACCGGCACCCCTACGAGCAGTACTTC	CANRHPYEQYF	TRBV6-4	TRBJ2-7
TGCAGCATGTCCCTCCAGGGAGTCAATCAGCCCCAGCATTTT	CSMSLQGVNQPQHF	TRBV29-1	TRBJ1-5
TGCAGTGCTAGGGAGCAAGACAGGGGGCTAAAGGTTGAAGCTTTCTTT	CSAREQDRGLKVEAFF	TRBV20-1	TRBJ1-1
TGCGCCAGCAGCCAAGGGTTACAGGGCGGGAAGCCCTACGAGCAGTACTTC	CASSQGLQGGKPYEQYF	TRBV4-3	TRBJ2-7
TGTGCCACCAGGAGGGACCATAGCTCCTACGAGCAGTACTTC	CATRRDHSSYEQYF	TRBV24-1	TRBJ2-7
TGTGCCAGCACGAAACGGGAGCAGTACTTC	CASTKREQYF	TRBV6-5	TRBJ2-7
TGTGCCAGCAGGGGACAGGGGGCGTATAATTCACCCCTCCACTTT	CASRGQGAYNSPLHF	TRBV6-6	TRBJ1-6
TGCAGCGTTCGGGAGCAGTTCTTC	CSVREQFF	TRBV29-1	TRBJ2-1
TGTGCCAGCAGCTTATCTTACAGGGGCTCATATAGCAATCAGCCCCAGCATTTT	CASSLSYRGSYSNQPQHF	TRBV7-2	TRBJ1-5
TGCAGTGCTAGAGATAACAGACTCCGGAAAAGCTCTGGGGCCAACGTCCTGACTTTC	CSARDNRLRKSSGANVLTF	TRBV20-1	TRBJ2-6
TGCGCCAGCAGTCCTCCCTGTGGGGGAACGCAGCCCCAGCATTTT	CASSPPCGGTQPQHF	TRBV10-1	TRBJ1-5
TGTGCCAGCAGCCGGTCTGACAGGTCTGGACCTGGCTCTGGGGCCAACGTCCTGACTTTC	CASSRSDRSGPGSGANVLTF	TRBV7-9	TRBJ2-6
TGCGCCAGCAGAGCAGGAATTTCCCCGACGGGGGCGGTATGGTCGCAGTATTTT	CASRAGISPTGAVWSQYF	TRBV10-1	TRBJ2-3
TGTGCCGCGATAGCGGGACACGAGCAGTACTTC	CAAIAGHEQYF	TRBV30	TRBJ2-7
TGTGCCACCAGTGATCACGCCCCCGACAGGGGGCACGAGCAGTACTTC	CATSDHAPDRGHEQYF	TRBV24-1	TRBJ2-7
TGCAGCGTTGAGGCGGACAGCGACGAGACCCAGTACTTC	CSVEADSDETQYF	TRBV29-1	TRBJ2-5
TGTGCTAGTGGTTTGTCGGGGGGACACACATCCTACAATGAGCAGTTCTTC	CASGLSGGHTSYNEQFF	TRBV12-5	TRBJ2-1
TGTGCCAGCTCAAGGCCGGGATACGCGGAGCAGTACTTC	CASSRPGYAEQYF	TRBV18	TRBJ2-7
TGCGCCAGCAGCTTGGATTTCGGGGGCGGCTTGTCACCCCTCCACTTT	CASSLDFGGGLSPLHF	TRBV5-1	TRBJ1-6
TGTGCCTGGACTTATAGACCCGGGACAGGGCACTATGGCTACACCTTC	CAWTYRPGTGHYGYTF	TRBV30	TRBJ1-2
TGTGCCAGCAGTAATCTGACTGGCTACACCTTC	CASSNLTGYTF	TRBV6-1	TRBJ1-2
TGTGCCAGCGAGGGGACGTATCCTGAAGCTTTCTTT	CASEGTYPEAFF	TRBV13	TRBJ1-1
TGTGCCAGCAAGTACAGAGAAAAACTGTTTTTT	CASKYREKLFF	TRBV6-1	TRBJ1-4
TGTGCCTGGCGACGAGAGGGTAGCACAGATACGCAGTATTTT	CAWRREGSTDTQYF	TRBV30	TRBJ2-3
TGTGCCAGCAGCTTGGGGAGGCCCCATGAGCAGTTCTTC	CASSLGRPHEQFF	TRBV5-6	TRBJ2-1
TGTGCCAGCAGTTACTGGCGTGGCTACACCTTC	CASSYWRGYTF	TRBV12-3	TRBJ1-2
TGTGCCAGCAGTCGTAGTAACATTCAGTACTTC	CASSRSNIQYF	TRBV6-8	TRBJ2-4
TGTGCCAGCAGCCCCGGACAGGGGGCAGCAGATACGCAGTATTTT	CASSPGQGAADTQYF	TRBV4-2	TRBJ2-3
TGTGCCAGCACGGGGGGATGGGGTAACTATGGCTACACCTTC	CASTGGWGNYGYTF	TRBV28	TRBJ1-2
TGTGCCAGCAGTGACTCCTGGGGACAGGGGTTGCATCAGCCCCAGCATTTT	CASSDSWGQGLHQPQHF	TRBV6-4	TRBJ1-5
TGTGCCAGCTCACCACGCGAAGAACAGGGTATAGCAGATACGCAGTATTTT	CASSPREEQGIADTQYF	TRBV18	TRBJ2-3
TGTGCCAGCTCCCTTGGACATACGGACGGCTACGAGCAGTACTTC	CASSLGHTDGYEQYF	TRBV7-3	TRBJ2-7
TGTGCCAGCAGCTTTCAGACCCGGGGACGGGGGGGGAACGGGGAGCTGTTTTTT	CASSFQTRGRGGNGELFF	TRBV11-3	TRBJ2-2
TGTGCCAGCTCAGCCTCAGGGGGCACAGGCACAGATACGCAGTATTTT	CASSASGGTGTDTQYF	TRBV18	TRBJ2-3
TGTGCCAGCAGTCGGTACTGCAGGATTCCCTACGAGCAGTACTTC	CASSRYCRIPYEQYF	TRBV2	TRBJ2-7
TGCAGCGTTGTCTATCCAGCTAACTATGGCTACACCTTC	CSVVYPANYGYTF	TRBV29-1	TRBJ1-2
TGTGCCAGCAGCTTGGACAGGGTTCAGTACTTC	CASSLDRVQYF	TRBV11-2	TRBJ2-5
TGCAGCGACACCGGGACTAGCGGGACCCCCTACGAGCAGTACTTC	CSDTGTSGTPYEQYF	TRBV29-1	TRBJ2-7
TGTGCCAACTACCCAGCAGGGGTGGACACTGAAGCTTTCTTT	CANYPAGVDTEAFF	TRBV5-6	TRBJ1-1
TGTGCCAGCAGCTTCCAGGGGAGGGCCGGATACAATGAGCAGTTCTTC	CASSFQGRAGYNEQFF	TRBV7-4	TRBJ2-1
TGCGCCAGCTCCCGGGACATGGAAGCTTTCTTT	CASSRDMEAFF	TRBV5-1	TRBJ1-1
TGTGCCAGCAGCTTAGTAAGAGGACACGGAGGGGGCACCTGCAATCAGCCCCAGCATTTT	CASSLVRGHGGGTCNQPQHF	TRBV7-4	TRBJ1-5
TGTGCCAGCAGCTTCTGTGGGGGGCCAGCCAAAAACATTCAGTACTTC	CASSFCGGPAKNIQYF	TRBV5-6	TRBJ2-4
TGTGCCAGCAGTTTATGCGGGAACACCGGGGAGCTGTTTTTT	CASSLCGNTGELFF	TRBV27	TRBJ2-2
TGTGCCAGCAGTTACCACCTCACCGGGGAGCTGTTTTTT	CASSYHLTGELFF	TRBV6-5	TRBJ2-2
TGTGCCAGCAGTTATGGGTCAAACGAGGCGAACACTGAAGCTTTCTTT	CASSYGSNEANTEAFF	TRBV6-5	TRBJ1-1
TGTGCCAGCAGTTCAAATGGGCTGCAAGAGACCCAGTACTTC	CASSSNGLQETQYF	TRBV28	TRBJ2-5
TGTGCCACGATCGGGATTGAGCAGTTCTTC	CATIGIEQFF	TRBV7-9	TRBJ2-1
TGTGCCAGCAGCTTCGTAAGTTTCAACACCGGGGAGCTGTTTTTT	CASSFVSFNTGELFF	TRBV13	TRBJ2-2
TGTGCCAGCCTACAAAGGAGTAAACGAAACTATGGCTACACCTTC	CASLQRSKRNYGYTF	TRBV6-2	TRBJ1-2
TGTGCCAGCAGCGGACTAAGCTCCTACGAGCAGTACTTC	CASSGLSSYEQYF	TRBV13	TRBJ2-7
TGTGCCAGCATGGTGGAACCCTGGACAGGGGTCCCTGAAGCTTTCTTT	CASMVEPWTGVPEAFF	TRBV28	TRBJ1-1
TGTGCCAGCAGTTCTCCGGGACAGGATCCCGAGCAGTACTTC	CASSSPGQDPEQYF	TRBV28	TRBJ2-7
TGCGCCAGCAGCGTTTCGGGCTCTGGGGCCAACGTCCTGACTTTC	CASSVSGSGANVLTF	TRBV5-1	TRBJ2-6
TGTGCCAGCAGCTGCGGGGATTCCTATAATTCACCCCTCCACTTT	CASSCGDSYNSPLHF	TRBV11-2	TRBJ1-6
