TGTGCCAGCAGCTTACCGCAGGGGACCTATCCTCATGAGACCCAGTACTTC	CASSLPQGTYPHETQYF	TRBV7-3	TRBJ2-5
TGTGCCAGCAGCACCAAGGAAACGCAGTTCTTC	CASSTKETQFF	TRBV13	TRBJ2-1
TGTGCCAGCAGTCAGTCCCCCGGGACAGGGCCTACCTACGAGCAGTACTTC	CASSQSPGTGPTYEQYF	TRBV6-5	TRBJ2-7
TGTGCCAGCAGCATCGGTGCGAGCTCCTATAATTCACCCCTCCACTTT	CASSIGASSYNSPLHF	TRBV7-4	TRBJ1-6
TGTGCCAGCAGTACAAGACAGGGATTCCATTACTATGGCTACACCTTC	CASSTRQGFHYYGYTF	TRBV6-5	TRBJ1-2
TGCGCCAGCAGCCAAGGCTGTCTGGGGGGCCCGAACACCGGGGAGCTGTTTTTT	CASSQGCLGGPNTGELFF	TRBV4-1	TRBJ2-2
TGTGCCAGCAGCTTATGTGGGGTAAGTTCTCTCCGCAGCAATGAAAAACTGTTTTTT	CASSLCGVSSLRSNEKLFF	TRBV11-2	TRBJ1-4
TGTGCCAGCGGTCTAGCGGTCGGCTACAATGAGCAGTTCTTC	CASGLAVGYNEQFF	TRBV9	TRBJ2-1
TGTGCCAGCAGCAGAGGACGACGGGCGGCGGACAATCAGCCCCAGCATTTT	CASSRGRRAADNQPQHF	TRBV7-3	TRBJ1-5
TGTGCCAGCAGCTTAGCCCGGCGACAGAGGAGGGGATTTAACTATGGCTACACCTTC	CASSLARRQRRGFNYGYTF	TRBV11-3	TRBJ1-2
TGTGCCAGTCCGGACCAGTTCAATGAGCAGTTCTTC	CASPDQFNEQFF	TRBV25-1	TRBJ2-1
TGTGCCAGCAGCTCAGTGTTCCCATGGGACTATGGCTACACCTTC	CASSSVFPWDYGYTF	TRBV11-3	TRBJ1-2
TGCAGTGGTATTTATGACAGGGTGGATACGCAGTATTTT	CSGIYDRVDTQYF	TRBV20-1	TRBJ2-3
TGTGCCAGCAAGCTCCAATCAGCTCCGGGCCACGAGCAGTACTTC	CASKLQSAPGHEQYF	TRBV14	TRBJ2-7
TGCGCCAGCCCACACGAGCCTAGCGGGCGTCGTCGTAGCACAGATACGCAGTATTTT	CASPHEPSGRRRSTDTQYF	TRBV10-1	TRBJ2-3
TGTGCCAGCAGCTCTCCTCGCGGTGGAGTGACCTACAATGAGCAGTTCTTC	CASSSPRGGVTYNEQFF	TRBV5-4	TRBJ2-1
TGTGCCAGCAGCCAATCGGCGCCGACTGGCTACACCTTC	CASSQSAPTGYTF	TRBV14	TRBJ1-2
TGTGCCAGTAGTCCGAGACTTTTGGAGACCCAGTACTTC	CASSPRLLETQYF	TRBV19	TRBJ2-5
TGTGCCAGCAGTCCCCTCAGGGGGAATGGTGGAACCTCCGAAAAACTGTTTTTT	CASSPLRGNGGTSEKLFF	TRBV27	TRBJ1-4
TGCGCCAGCAGCCCCATATTTTCGTGTGTTTGGGGAGCAACTAATGAAAAACTGTTTTTT	CASSPIFSCVWGATNEKLFF	TRBV4-1	TRBJ1-4
TGTGCCTGGAGTGTGGTAGTTGGGGGGGCTAGCACAGATACGCAGTATTTT	CAWSVVVGGASTDTQYF	TRBV30	TRBJ2-3
TGTGCCAGCAGCAGGGGTCCCGGGGTCCGCTCTGGAAACACCATATATTTT	CASSRGPGVRSGNTIYF	TRBV7-2	TRBJ1-3
TGCAGTGGGTCCCGCACCGGGGAGCTGTTTTTT	CSGSRTGELFF	TRBV20-1	TRBJ2-2
TGTGCCACCAGTGACATCGCTGCGGGAGACCTCTGTGAAGATGGAAACACCATATATTTT	CATSDIAAGDLCEDGNTIYF	TRBV24-1	TRBJ1-3
TGCGCCAGCAGTGCCCACAGGGAAGAGACCCAGTACTTC	CASSAHREETQYF	TRBV10-1	TRBJ2-5
TGTGCCAGCAGTTCTCGCCGGGACAGGGAGGGTATAACGGAAGAGGGCTACACCTTC	CASSSRRDREGITEEGYTF	TRBV27	TRBJ1-2
TGTGCCAGCAGCACCGTACTGCCGGGACCAGCGCCTAGCACAGATACGCAGTATTTT	CASSTVLPGPAPSTDTQYF	TRBV3-1	TRBJ2-3
TGTGCCAGCCATACAGGGGGCCGCCAATGGTCGGACGAGCAGTACTTC	CASHTGGRQWSDEQYF	TRBV12-4	TRBJ2-7
TGCAGTGCTAGAGGTAAATTTTGGACTAGCGGAGGGTTAGAGACCCAGTACTTC	CSARGKFWTSGGLETQYF	TRBV20-1	TRBJ2-5
TGTGCCAGCAGCAAAACTAGCGGGAGGGCCTGTAACTACGAGCAGTACTTC	CASSKTSGRACNYEQYF	TRBV9	TRBJ2-7
TGTGCCAGCAGTTTGCTGACAGGGAGTGGGACCTACGAGCAGTACTTC	CASSLLTGSGTYEQYF	TRBV27	TRBJ2-7
TGTGCCAGCACGGGCTTGCCTGAAGCTTTCTTT	CASTGLPEAFF	TRBV9	TRBJ1-1
TGTGGGGAGGGGGGACATACGCAGTATTTT	CGEGGHTQYF	TRBV10-3	TRBJ2-3
TGCAGTTCCCCCCTAGGGGGGTGGGGGTATGGCTACACCTTC	CSSPLGGWGYGYTF	TRBV20-1	TRBJ1-2
TGTGCCAGCAGCGACCCGGGACAGTGGTTCCCAGGGTATGGCTACACCTTC	CASSDPGQWFPGYGYTF	TRBV11-2	TRBJ1-2
TGTGCCAGTAGTACGGTTCTGGTGGACCCCACTGAAGCTTTCTTT	CASSTVLVDPTEAFF	TRBV19	TRBJ1-1
TGTGCCAGTAGTATCGCGGGTGGGACAGGTCGGCTGACCGGGGAGCTGTTTTTT	CASSIAGGTGRLTGELFF	TRBV19	TRBJ2-2
TGTGCCAGCAGTATAGAGGACAGGTCTGGAAACACCATATATTTT	CASSIEDRSGNTIYF	TRBV12-4	TRBJ1-3
TGTGCCAGCAGCTCGAGGGACGACTACGAGCAGTACTTC	CASSSRDDYEQYF	TRBV7-2	TRBJ2-7
TGCGCCAGCAGCCAAGACTGTGAAGCAGGGAGCGCCTACGAGCAGTACTTC	CASSQDCEAGSAYEQYF	TRBV4-1	TRBJ2-7
TGCGCCAGCAGCTTGGCCAGGGGGACAGATCCAACTAATGAAAAACTGTTTTTT	CASSLARGTDPTNEKLFF	TRBV5-1	TRBJ1-4
TGCGCCAGCAGCCGTTCAGGGGACCCCCCCGGGGAGCTGTTTTTT	CASSRSGDPPGELFF	TRBV4-1	TRBJ2-2
TGTGCCAGCTCACCACCGATATCAACGAACTCTCGGGACACCGGGGAGCTGTTTTTT	CASSPPISTNSRDTGELFF	TRBV18	TRBJ2-2
TGTGCCAGCAGCTTATTGTGGGGGGGCACAGATACGCAGTATTTT	CASSLLWGGTDTQYF	TRBV7-4	TRBJ2-3
TGCAGTGCTAGAGATCTAGGTGTAAAAACGGTTCACAATGAGCAGTTCTTC	CSARDLGVKTVHNEQFF	TRBV20-1	TRBJ2-1
TGTGCCAGCCGGTCCGCACCCGGGACATGGAACAACACTGAAGCTTTCTTT	CASRSAPGTWNNTEAFF	TRBV6-6	TRBJ1-1
TGTGCCACCAGACAGGGGGGCTCTGGGGCCAACGTCCTGACTTTC	CATRQGGSGANVLTF	TRBV24-1	TRBJ2-6
TGTGCTACAGACGTCAGGGGGGAGTACGAGCAGTACTTC	CATDVRGEYEQYF	TRBV7-3	TRBJ2-7
TGTGCCAGCAGCTTAAGGCCCCAACAGGGGGCAGAAAATGAGCAGTACTTC	CASSLRPQQGAENEQYF	TRBV11-3	TRBJ2-7
TGTGCCAGTAGAGCTGGGACAGCCAGTGTAAGGAACGAGCAGTACTTC	CASRAGTASVRNEQYF	TRBV19	TRBJ2-7
TGTGCCAGCAGTTACGGACACCCGGGGGAATTGAACACTGAAGCTTTCTTT	CASSYGHPGELNTEAFF	TRBV27	TRBJ1-1
TGTGCCAGCACCCCCACAACTAAAAACGAGCAGTACTTC	CASTPTTKNEQYF	TRBV27	TRBJ2-7
TGTGCCAGCAGCTTCGCTCCGGGACGAGGCTCCACAGATACGCAGTATTTT	CASSFAPGRGSTDTQYF	TRBV7-3	TRBJ2-3
TGTGCCAGCAGCTATAGGGGCAACGGGGAGAGTTACTATGGCTACACCTTC	CASSYRGNGESYYGYTF	TRBV7-9	TRBJ1-2
TGCGCCAGCAGACAGGGGGTCTTGATCATGAACACTGAAGCTTTCTTT	CASRQGVLIMNTEAFF	TRBV10-1	TRBJ1-1
TGCGCCAGCAGTTGGACAGGCCCGGACACAGATACGCAGTATTTT	CASSWTGPDTDTQYF	TRBV4-3	TRBJ2-3
TGTGCTAGTGGTTTTCCACCTTGCGGGAGCTACGAGCAGTACTTC	CASGFPPCGSYEQYF	TRBV12-5	TRBJ2-7
TGTGCCAGCAGTTACTCGCACAGGGTGGATAAGCCGGACCTTGAAGCTTTCTTT	CASSYSHRVDKPDLEAFF	TRBV6-3	TRBJ1-1
TGTGCCAGCAGTTTAGGGTGGACAGGGACCAATCAGCCCCAGCATTTT	CASSLGWTGTNQPQHF	TRBV27	TRBJ1-5
TGTGCCAGCAGCTGTGGTGGGAGGCGAGAAAAACTGTTTTTT	CASSCGGRREKLFF	TRBV9	TRBJ1-4
TGTGCCAGCAGTGAACAGGTCACTGAAGCTTTCTTT	CASSEQVTEAFF	TRBV25-1	TRBJ1-1
TGTGCCAGCAGCCTCCAGAGCAATCAGCCCCAGCATTTT	CASSLQSNQPQHF	TRBV11-3	TRBJ1-5
TGTGCCAATTGGCGGGGCGAAGAGACCCAGTACTTC	CANWRGEETQYF	TRBV7-8	TRBJ2-5
TGTGCCAGCAGGCTCAGGGACAGCCAACAGAAAAAACTGTTTTTT	CASRLRDSQQKKLFF	TRBV6-5	TRBJ1-4
TGTGCCAGTAGTAACGGACTGGCTTATGAGCAGTTCTTC	CASSNGLAYEQFF	TRBV19	TRBJ2-1
TGTGCCAGCTCACCACCGATAAAGGGGGCGGCGAATGAGCAGTTCTTC	CASSPPIKGAANEQFF	TRBV18	TRBJ2-1
TGCATTCAGTCCCTTATGAACGAGCAGTACTTC	CIQSLMNEQYF	TRBV20-1	TRBJ2-7
TGCGCCAGCAGCTACCGATATACAGATACGCAGTATTTT	CASSYRYTDTQYF	TRBV5-1	TRBJ2-3
TGTGCCAGCAGTTACTCCATTGGGACACAGACCCGCAATCAGCCCCAGCATTTT	CASSYSIGTQTRNQPQHF	TRBV6-3	TRBJ1-5
TGTGCCACCCAAGGTTCGGGTGAGCAGTACTTC	CATQGSGEQYF	TRBV7-8	TRBJ2-7
TGCAGTGCTAGGTGGGACAAGAGTAGCAATCAGCCCCAGCATTTT	CSARWDKSSNQPQHF	TRBV20-1	TRBJ1-5
TGTGCCAGCAGTTTCCTAGTTCCTACTTTAGCGACTGAAGCTTTCTTT	CASSFLVPTLATEAFF	TRBV27	TRBJ1-1
TGTGCCAGCAGCCAAGGCACTTCACGACCCACAGACGAGAGGGCAGAAAAACTGTTTTTT	CASSQGTSRPTDERAEKLFF	TRBV3-1	TRBJ1-4
TGTGCCTGGAGCAAAGGGCGCTCCTACGAGCAGTACTTC	CAWSKGRSYEQYF	TRBV30	TRBJ2-7
TGTGCCAGCCCTCAAACAGGGTACACCTCTGGGGCCAACGTCCTGACTTTC	CASPQTGYTSGANVLTF	TRBV12-3	TRBJ2-6
TGCAGTGCTCGTGGTAAAAATGCTGGGGGACAGGGACGGTGGAGTCAGCCCCAGCATTTT	CSARGKNAGGQGRWSQPQHF	TRBV20-1	TRBJ1-5
TGTGCCAGCAGCCCGGATGGGACAGGGACCATAGCCAAAAACATTCAGTACTTC	CASSPDGTGTIAKNIQYF	TRBV4-2	TRBJ2-4
TGTGCCAGCAGCATAGAGGGGGCAGGAGGTAAATCCTACAATGAGCAGTTCTTC	CASSIEGAGGKSYNEQFF	TRBV13	TRBJ2-1
TGTGCCAGTAGTATATTGGGGAGACGGGGCTCCTACGAGCAGTACTTC	CASSILGRRGSYEQYF	TRBV19	TRBJ2-7
TGTGCCAGCAGCTTCAGGGGGACATCGCATTTT	CASSFRGTSHF	TRBV7-3	TRBJ1-5
TGTGCCAGCTACGGGGGGGGCCGGGACAAAGAGACCCAGTACTTC	CASYGGGRDKETQYF	TRBV9	TRBJ2-5
TGTGCCAGCAGTTACTCGTGCAGGGGGCGGGCAGTGACTGAAGCTTTCTTT	CASSYSCRGRAVTEAFF	TRBV6-3	TRBJ1-1
TGTGCCAGCAGCTTAGCAGGGAATGGCTACACCTTC	CASSLAGNGYTF	TRBV7-2	TRBJ1-2
TGTGCCAGCAGCAGGCGGGGGGGTACCGGGGAGCTGTTTTTT	CASSRRGGTGELFF	TRBV7-9	TRBJ2-2
TGTGCCAGCAGCATGGGGTTAGGGGGACTATCTGTTTCTGGAAACACCATATATTTT	CASSMGLGGLSVSGNTIYF	TRBV13	TRBJ1-3
TGCGCCAGCAGGGCTAGTCTCTCCTACGAGCAGTACTTC	CASRASLSYEQYF	TRBV10-1	TRBJ2-7
TGTGCCAGCAGCCCCCGCAGGGAGTTAGACGAGCAGTACTTC	CASSPRRELDEQYF	TRBV7-3	TRBJ2-7
TGCGCCAGCAAATGGACTAGCGATTGCCCCTACAATGAGCAGTTCTTC	CASKWTSDCPYNEQFF	TRBV5-1	TRBJ2-1
TGCAGTGCTAGAGTGGGGGTCGTCTATGGCTACACCTTC	CSARVGVVYGYTF	TRBV20-1	TRBJ1-2
TGTGCCAGCAGCTTAGGAGGGGCCGGGACGCGTGCCGGTTGGGAATGGAGCTCCTACAATGAGCAGTTCTTC	CASSLGGAGTRAGWEWSSYNEQFF	TRBV11-2	TRBJ2-1
TGCGCCAGCAGAGCTAGGTACGACAGGGTCTACGAGCAGTACTTC	CASRARYDRVYEQYF	TRBV10-2	TRBJ2-7
TGTGCCAGCAGTGAGTTAAGGGCCCAGCGCGAGAATTTAGAGCAGTACTTC	CASSELRAQRENLEQYF	TRBV6-4	TRBJ2-7
TGTGCCAGCAGCCAATTTTTAACATGGCACCCGGGCTACACCTTC	CASSQFLTWHPGYTF	TRBV14	TRBJ1-2
TGTGCCAGCAGCTTAGACCGGACGGGCCGGACTAATGAAAAACTGTTTTTT	CASSLDRTGRTNEKLFF	TRBV7-6	TRBJ1-4
TGTGCCAGCAGTTTACGCCGGGACAGGGTAGAGCAGTACTTC	CASSLRRDRVEQYF	TRBV27	TRBJ2-7
TGTGCCACCAGCAGAGATGTCAGGGGGCAACTTTACAATGAGCAGTTCTTC	CATSRDVRGQLYNEQFF	TRBV15	TRBJ2-1
TGTGCCAGCAGCTCCCGACAAGGGACAGGGGAGGGGGAGACCCAGTACTTC	CASSSRQGTGEGETQYF	TRBV7-9	TRBJ2-5
TGCGCCAGCAGCTTGGCTACCAAAGCGGCTATCGTTGCCAATGAGCAGTTCTTC	CASSLATKAAIVANEQFF	TRBV5-1	TRBJ2-1
TGTGCCAGCAGCCAACCCTGTAACAGGGGTGGCCGGAACACTGAAGCTTTCTTT	CASSQPCNRGGRNTEAFF	TRBV3-1	TRBJ1-1
TGTGCCAGCAGCGGGGGAACCTACGAGCAGTACTTC	CASSGGTYEQYF	TRBV9	TRBJ2-7
TGTGCCAGCAGCGACACTTGGATCATAGAGACCCAGTACTTC	CASSDTWIIETQYF	TRBV7-4	TRBJ2-5
TGTGCCAGCAGCGTAGGGACCATGAACACTGAAGCTTTCTTT	CASSVGTMNTEAFF	TRBV9	TRBJ1-1
TGTGCCAGCAGCTATTTCCCCCACCCCTGGGATCAGGGGCAGGGGAACACTGAAGCTTTCTTT	CASSYFPHPWDQGQGNTEAFF	TRBV7-8	TRBJ1-1
TGTGCCAGGATGACAGGGGAGGGCTACACCTTC	CARMTGEGYTF	TRBV5-5	TRBJ1-2
TGTGCCAGCAGCTCCCCTCAAGGGGGCGCGTATAACACTGAAGCTTTCTTT	CASSSPQGGAYNTEAFF	TRBV7-3	TRBJ1-1
TGTGCCAGCAGCTTAGGCCTAGCGACAGATACGCAGTATTTT	CASSLGLATDTQYF	TRBV7-4	TRBJ2-3
TGTGCCATTACCCTGCGGGAAGCCTACAATGAGCAGTTCTTC	CAITLREAYNEQFF	TRBV6-1	TRBJ2-1
TGCAGTGCCACTAGCGGGAGAGGCACAGATACGCAGTATTTT	CSATSGRGTDTQYF	TRBV20-1	TRBJ2-3
TGTGCCTGGAGTGGGCGCCGGGACAGGGTCCAGGGAGACTATGGCTACACCTTC	CAWSGRRDRVQGDYGYTF	TRBV30	TRBJ1-2
TGTGCCAGTAGTATAGCCACCTGGGGGGCCCGAGGGACTAGCACAGATACGCAGTATTTT	CASSIATWGARGTSTDTQYF	TRBV19	TRBJ2-3
TGTGCCATCAGTGACTCGGCTCCTGTGACCGGGGCAACAGATACGCAGTATTTT	CAISDSAPVTGATDTQYF	TRBV10-3	TRBJ2-3
TGCAGTGCTATTCCCGGGACAGGGTCCCGGAACACTGAAGCTTTCTTT	CSAIPGTGSRNTEAFF	TRBV20-1	TRBJ1-1
TGTGCCAGCATATCGGGGGGGGGCAATGAGCAGTTCTTC	CASISGGGNEQFF	TRBV27	TRBJ2-1
TGTGCCAGCAGCCACGGGGCCCAGTACTTC	CASSHGAQYF	TRBV6-4	TRBJ2-5
TGTGCCAGCAGGAAGACGCGGGACAGGGGGAAGGGGGTTAACACTGAAGCTTTCTTT	CASRKTRDRGKGVNTEAFF	TRBV27	TRBJ1-1
TGTGCCAGCAAAGCTATGAGGAGCTCCTATAATTCACCCCTCCACTTT	CASKAMRSSYNSPLHF	TRBV6-4	TRBJ1-6
TGTGCCAGCAGTTACAACGGAATCCTCCGGCCCTTC	CASSYNGILRPF	TRBV6-5	TRBJ1-2
TGTGCCAGCAGCGTCCCTACGGAGAATGAGCAGTTCTTC	CASSVPTENEQFF	TRBV13	TRBJ2-1
TGTGCCAGCAGTTGCTTAGGGAACACTGAAGCTTTCTTT	CASSCLGNTEAFF	TRBV6-5	TRBJ1-1
TGTGCCAGCTATGGACTAGCGGGTTGGGCCTCCTACAATGAGCAGTTCTTC	CASYGLAGWASYNEQFF	TRBV28	TRBJ2-1
TGTGCCAGCAGTGTCGACGCAGGGGCAAACGAGCAGTACTTC	CASSVDAGANEQYF	TRBV6-1	TRBJ2-7
TGCAGCGTTGACGAAGCAGGCACCGGGGAGCTGTTTTTT	CSVDEAGTGELFF	TRBV29-1	TRBJ2-2
TGTGCCACCAGCAGCGACAGATATCGGAACACTGAAGCTTTCTTT	CATSSDRYRNTEAFF	TRBV15	TRBJ1-1
TGCGCCAGAGAGGGGGGGTCGCCTGAAGCTTTCTTT	CAREGGSPEAFF	TRBV5-1	TRBJ1-1
TGTGCCAGCAGTCAGGCATATTGGACGCGGCAGGGGCTGCCGAGCTCCTACAATGAGCAGTTCTTC	CASSQAYWTRQGLPSSYNEQFF	TRBV12-4	TRBJ2-1
TGTGCCAGTAGTATTATTAGGGACAGGGGGTTGGCCTACGAGCAGTACTTC	CASSIIRDRGLAYEQYF	TRBV19	TRBJ2-7
TGCAGTGCGTGGGGGGGCACAGATACGCAGTATTTT	CSAWGGTDTQYF	TRBV20-1	TRBJ2-3
TGTGCCAGCAGCTTAAAGAGATACGAGGGGAACACTGAAGCTTTCTTT	CASSLKRYEGNTEAFF	TRBV7-2	TRBJ1-1
TGCAGTGCTCTTCTGATATCAAGCGCCCTCCACTTT	CSALLISSALHF	TRBV20-1	TRBJ1-6
TGTGCCAGCAGCGGTGGGACAGGGGCCAGGTCCGGGGAGCTGTTTTTT	CASSGGTGARSGELFF	TRBV6-1	TRBJ2-2
TGTGCCAGCACTCCACGGACTAGCGGAAGCTCCTACAATGAGCAGTTCTTC	CASTPRTSGSSYNEQFF	TRBV6-4	TRBJ2-1
TGTGCCAGCTCACCACTTCAAATAGCGTCGGACGAGCAGTACTTC	CASSPLQIASDEQYF	TRBV18	TRBJ2-7
TGTGCCAGCAGTCTGAGGGGGTTAGCTAGCACAGATACGCAGTATTTT	CASSLRGLASTDTQYF	TRBV28	TRBJ2-3
TGTGCCAGCAGCCCCGCCCGGGGAGGGCAGTACTTC	CASSPARGGQYF	TRBV5-6	TRBJ2-7
TGCGCCAGCACGGGTCCGGTGCAGGGTTGGGAAAAACTGTTTTTT	CASTGPVQGWEKLFF	TRBV10-1	TRBJ1-4
TGCAGTGCTAGAGGGCCCGGGGCTGCCTACAATGAGCAGTTCTTC	CSARGPGAAYNEQFF	TRBV20-1	TRBJ2-1
TGTGCCAGCAGCCCGCCTCGGACAGGGAAATCCCTCCACTTT	CASSPPRTGKSLHF	TRBV13	TRBJ1-6
TGTGCCAGCAGCCAAACTAGCGGGAGAAGTAATGAAAAACTGTTTTTT	CASSQTSGRSNEKLFF	TRBV14	TRBJ1-4
TGTGCCAGCTCGGGCTGTCAACAGGGAACCCTCAACACTGAAGCTTTCTTT	CASSGCQQGTLNTEAFF	TRBV18	TRBJ1-1
TGTGCCAGCAGTAACGGGGACAGACGGTATAGCAATCAGCCCCAGCATTTT	CASSNGDRRYSNQPQHF	TRBV6-1	TRBJ1-5
TGTGCCAGCGAGGGGACGCAGTATTTT	CASEGTQYF	TRBV14	TRBJ2-3
TGTGCCAGCAGTTACGGGGGACAGGGAGGGGCCGGGGCTTACAATGAGCAGTTCTTC	CASSYGGQGGAGAYNEQFF	TRBV6-5	TRBJ2-1
TGTGCCAGCAGTAAGGGGGCTGGAGAGACCCAGTACTTC	CASSKGAGETQYF	TRBV25-1	TRBJ2-5
TGTGCCACCAATAATCAGGGAAGAGGCTATGGCTACACCTTC	CATNNQGRGYGYTF	TRBV24-1	TRBJ1-2
TGCAGTGCATCGCGGCGGGTTTACGGGGAGCTGTTTTTT	CSASRRVYGELFF	TRBV20-1	TRBJ2-2
TGTGCCAGCAGCCATCCTGAATTAGGGAACACTGAAGCTTTCTTT	CASSHPELGNTEAFF	TRBV28	TRBJ1-1
TGCGCCAGCAGCTTGGCGGGACAGCAGTTGAACACTGAAGCTTTCTTT	CASSLAGQQLNTEAFF	TRBV5-1	TRBJ1-1
TGCAGTGCTAGAAAGCAGGGAGATGCTAACTATGGCTACACCTTC	CSARKQGDANYGYTF	TRBV20-1	TRBJ1-2
TGCAGTGCACCGTCGGGACTAGGGTACAACTCCTACAATGAGCAGTTCTTC	CSAPSGLGYNSYNEQFF	TRBV20-1	TRBJ2-1
TGTGCCAGCAGCTTAGCGGGACCCCCGGGACCCGAATACGAGCAGTACTTC	CASSLAGPPGPEYEQYF	TRBV7-9	TRBJ2-7
TGTGCCAGGAATTCCGGGACAGGCAATGAGCAGTTCTTC	CARNSGTGNEQFF	TRBV5-8	TRBJ2-1
TGCGCCAGCAGACAAGGTAGCTACACCTTC	CASRQGSYTF	TRBV10-1	TRBJ1-2
TGTGCCAGCAGTTTTTTAATCTCAGCAGGCCTGGACGAGCAGTACTTC	CASSFLISAGLDEQYF	TRBV28	TRBJ2-7
TGTGCCAGTAGTATAATCCAAGGCACGGGGCCCCTTGCCAAAAACATTCAGTACTTC	CASSIIQGTGPLAKNIQYF	TRBV19	TRBJ2-4
TGTGCCACCTCCTCCGCCAGCTTTAATTGCATTCCCTCCTACAATGAGCAGTTCTTC	CATSSASFNCIPSYNEQFF	TRBV24-1	TRBJ2-1
TGTGCCAGCAGCATCCTAGGGACTGAGACCCAGTACTTC	CASSILGTETQYF	TRBV11-3	TRBJ2-5
TGTGCCACCAGCAGAGCCTCGAGAGTGGATACGCAGTATTTT	CATSRASRVDTQYF	TRBV15	TRBJ2-3
TGTGCCATCAGTGACGAAGGGGTTGATGGGTACTATGGCTACACCTTC	CAISDEGVDGYYGYTF	TRBV10-3	TRBJ1-2
TGTGCCAGCAGCCTAGGGACTAGCGGTTTCTACGAGCAGTACTTC	CASSLGTSGFYEQYF	TRBV13	TRBJ2-7
TGTGCCACCAGTGATCCAGCCGGGGCTCAGGACTATGGCTACACCTTC	CATSDPAGAQDYGYTF	TRBV24-1	TRBJ1-2
TGTGCCATAATTGAGGTAGGTAATGAAAAACTGTTTTTT	CAIIEVGNEKLFF	TRBV6-1	TRBJ1-4
TGTGCCAGCATTCGGGACAGCTGCATGAACACTGAAGCTTTCTTT	CASIRDSCMNTEAFF	TRBV12-3	TRBJ1-1
TGCAGTGCTCGCCTCAATGAGCAGTTCTTC	CSARLNEQFF	TRBV20-1	TRBJ2-1
TGTGCCAGCAGCTTAGCACCGGGAACAGGACGCAGGGGGACGGATGGCTACACCTTC	CASSLAPGTGRRGTDGYTF	TRBV7-9	TRBJ1-2
TGTGCCAGTGGCCGACAGGGTGGCTACACCTTC	CASGRQGGYTF	TRBV19	TRBJ1-2
TGTGCCAGCAGTTGGGACAAAAAGCAGTACTTC	CASSWDKKQYF	TRBV27	TRBJ2-7
TGTGCCAGCAGCTTGCCCCGGTGGAACGGCGGGAGCGCTGGAAACACCATATATTTT	CASSLPRWNGGSAGNTIYF	TRBV5-4	TRBJ1-3
TGTGCCAGCAGCAACGAGGGTACGGGGGATACGCAGTATTTT	CASSNEGTGDTQYF	TRBV11-2	TRBJ2-3
TGTGCCAGCAGCTCCACAGGAGGGGATAGCTCCTACGAGCAGTACTTC	CASSSTGGDSSYEQYF	TRBV7-9	TRBJ2-7
TGTGCCAGCAGAGGTGGGGGGGCTTGGGAGCAGTTCTTC	CASRGGGAWEQFF	TRBV25-1	TRBJ2-1
TGTGCCTCTACAGGACAAGAGACCCAGTACTTC	CASTGQETQYF	TRBV30	TRBJ2-5
TGTGCCAGCGGAGGGGGGGGAGATGGCTACACCTTC	CASGGGGDGYTF	TRBV6-2	TRBJ1-2
TGTGCCACAAACGGTCAGGGCAACCGGGTAGGGAGCAATCAGCCCCAGCATTTT	CATNGQGNRVGSNQPQHF	TRBV24-1	TRBJ1-5
TGTGCCAGCAGTCTCCCCGCTGGACTAGCGGGGGGGCTCTTC	CASSLPAGLAGGLF	TRBV6-5	TRBJ2-1
TGTGCCAGCAGCCCTCCTCAGCTGATGAAGTATAGCAATCAGCCCCAGCATTTT	CASSPPQLMKYSNQPQHF	TRBV7-3	TRBJ1-5
TGTGCCAGCAGTTTAGCAAGGGACAGATCATCTGAAGCTTTCTTT	CASSLARDRSSEAFF	TRBV12-4	TRBJ1-1
TGTGCCAGCGGGGGGGCGGGAGGGAGGAGGAACACTGAAGCTTTCTTT	CASGGAGGRRNTEAFF	TRBV6-4	TRBJ1-1
TGTGCCAGCAGCTTACGGGGATTGGGCACTGAAGCTTTCTTT	CASSLRGLGTEAFF	TRBV7-2	TRBJ1-1
TGCAGTGCTAGTAGCCCCGGGACAGGGGACACTGAAGCTTTCTTT	CSASSPGTGDTEAFF	TRBV20-1	TRBJ1-1
TGTGCCAGCAGCGCGGGGGGCTTTTTTGCGCAGCCCCAGCATTTT	CASSAGGFFAQPQHF	TRBV13	TRBJ1-5
TGTGCCAGCACAGAAAGGACAGGCCCTAATCAGCCCCAGCATTTT	CASTERTGPNQPQHF	TRBV6-2	TRBJ1-5
TGTGCCACCGTTGAGCAGGGGTGCAATCAGCCCCAGCATTTT	CATVEQGCNQPQHF	TRBV24-1	TRBJ1-5
TGCGCCAGCAGCTGTTCGTTCCGGGGCCCTTCGCGGGAGGGGCGTGGCTACACCTTC	CASSCSFRGPSREGRGYTF	TRBV5-1	TRBJ1-2
TGCGCCAGCAGCGGGTCCGGGACAGGCTACGAGCAGTACTTC	CASSGSGTGYEQYF	TRBV5-1	TRBJ2-7
TGTGCCAGCAGCTTACCCCTGCGGGAGACCCAGTACTTC	CASSLPLRETQYF	TRBV7-8	TRBJ2-5
TGTGCCAGCAGCGTGCCGGGACAGGGTGGGTCCTACGAGCAGTACTTC	CASSVPGQGGSYEQYF	TRBV7-2	TRBJ2-7
TGTGCCAGTAGTATAGGAATATTGGAGCGGCGGTATGGCTACACCTTC	CASSIGILERRYGYTF	TRBV19	TRBJ1-2
TGTGCCAGCACCTCTGGGGTAGAAAAACTGTTTTTT	CASTSGVEKLFF	TRBV6-4	TRBJ1-4
TGTGCCAGCAGTGAAGTCCCCGGAGGTGAACGGGAGACCCAGTACTTC	CASSEVPGGERETQYF	TRBV2	TRBJ2-5
TGTGCCAGCAGCAGGTCTGACGGGAGGATGAACACTGAAGCTTTCTTT	CASSRSDGRMNTEAFF	TRBV7-9	TRBJ1-1
TGTGCCAGCAGCGAAGCCATGACGATCTCACCGAACACTGAAGCTTTCTTT	CASSEAMTISPNTEAFF	TRBV7-3	TRBJ1-1
TGCGCCAGCAGCTTGAATAGACAGCGCTATGGCTACACCTTC	CASSLNRQRYGYTF	TRBV5-1	TRBJ1-2
TGTGCCAGCAGTGCTGAGCATTACAATGAGCAGTTCTTC	CASSAEHYNEQFF	TRBV27	TRBJ2-1
TGTGCCAGCAGTAACAGGGGCGGCGAGTTTGACTATGGCTACACCTTC	CASSNRGGEFDYGYTF	TRBV27	TRBJ1-2
TGTGCCAGCATACGTAATGCACCCCTCCACTTT	CASIRNAPLHF	TRBV6-1	TRBJ1-6
TGTGCCAGCAGCGGAGCGGGGGGCCGAGAAGACTACGAGCAGTACTTC	CASSGAGGREDYEQYF	TRBV7-3	TRBJ2-7
TGCGCCAGCTGTACAGGGGGCGGTCACAATGAGCAGTTCTTC	CASCTGGGHNEQFF	TRBV10-2	TRBJ2-1
TGTGCCAGCAGCTGGCCGGGACTAACCCTAGGTGTTATCGGGGAGCTGTTTTTT	CASSWPGLTLGVIGELFF	TRBV7-9	TRBJ2-2
TGTGCCAGTAGAGTTCAGTTAGGGTATAGCAATCAGCCCCAGCATTTT	CASRVQLGYSNQPQHF	TRBV19	TRBJ1-5
TGTGCCAGCCCCAGAGGGGACCTCTATGGCTACACCTTC	CASPRGDLYGYTF	TRBV5-6	TRBJ1-2
TGTGCCAGCAGCCAAGCCGTAGCGGGCTTTTTCCAAGAGACCCAGTACTTC	CASSQAVAGFFQETQYF	TRBV3-1	TRBJ2-5
TGTGCCACCAGTGATGGAGGGGGACAGGGGGCAACCTACGAGCAGTACTTC	CATSDGGGQGATYEQYF	TRBV24-1	TRBJ2-7
TGTGCCAGCAGTTTAGATAAAACAGGGCACCAGGTGAACACTGAAGCTTTCTTT	CASSLDKTGHQVNTEAFF	TRBV27	TRBJ1-1
TGTGCCAGCAGTTTGAGTAACTTACAGGGGGGGGTCCTATCCTACGAGCAGTACTTC	CASSLSNLQGGVLSYEQYF	TRBV12-4	TRBJ2-7
TGTGCCATCAGTGACGACAGGGCCAACACCGGGGAGCTGTTTTTT	CAISDDRANTGELFF	TRBV10-3	TRBJ2-2
TGTGCCAGCAGCAAGAAAGGGGGGGATACCTACGAGCAGTACTTC	CASSKKGGDTYEQYF	TRBV14	TRBJ2-7
TGTGCCATCAGTGAGGGGGGTGAACTGTTTTTT	CAISEGGELFF	TRBV10-3	TRBJ1-4
TGCGCCAGCAGCCAAGATCTCAGGGGCACCTTC	CASSQDLRGTF	TRBV4-3	TRBJ1-2
TGTGCCAGCAGCCAAGATAGGAGGCTCGAAGCTTTCTTT	CASSQDRRLEAFF	TRBV3-1	TRBJ1-1
TGTGCCACAGGGCCCCGTAACTATGGCTACACCTTC	CATGPRNYGYTF	TRBV6-4	TRBJ1-2
TGTGCCAGTAGTAGTCGGGGCCCCGGGGGCAATCAGCCCCAGCATTTT	CASSSRGPGGNQPQHF	TRBV19	TRBJ1-5
TGTGCCAGTAGTATAGGGGGGGACAGGGGGCTCTTAGCTAACTATGGCTACACCTTC	CASSIGGDRGLLANYGYTF	TRBV19	TRBJ1-2
TGTGCCAGCAGGAAAAGGGTGGGAACTAATGAAAAACTGTTTTTT	CASRKRVGTNEKLFF	TRBV6-2	TRBJ1-4
TGTGCCAGCAGGCCCGTGGAGGGGAAGCCCCTCACCTTC	CASRPVEGKPLTF	TRBV6-2	TRBJ1-2
TGTGCCATCAAGGCCCTTGGGACTTATACGCAGTATTTT	CAIKALGTYTQYF	TRBV10-3	TRBJ2-3
TGTGCCAGTGGGGTGTACGAGCAGTACTTC	CASGVYEQYF	TRBV19	TRBJ2-7
TGTGCCACCAGTGAACGTACCACAGATACGCAGTATTTT	CATSERTTDTQYF	TRBV24-1	TRBJ2-3
TGTGCCTGGACCCGGGGACGCGACTATGGCTACACCTTC	CAWTRGRDYGYTF	TRBV30	TRBJ1-2
TGCAGTGCGGGGGATAACTATGGCTACACCTTC	CSAGDNYGYTF	TRBV20-1	TRBJ1-2
TGCGCCAGCAGGGCCCACGCCCTCTTC	CASRAHALF	TRBV10-1	TRBJ2-1
TGTGCCAGCAGCGGCCCAGGGATATCCTACGAGCAGTACTTC	CASSGPGISYEQYF	TRBV9	TRBJ2-7
TGTGCCATCAGTGAGGGGAATCCACACCCATGGGGAGATGAGTATAGCAATCAGCCCCAGCATTTT	CAISEGNPHPWGDEYSNQPQHF	TRBV10-3	TRBJ1-5
TGTGCCAGCACCCCTGGGGGGAGTACTAACTATGGCTACACCTTC	CASTPGGSTNYGYTF	TRBV25-1	TRBJ1-2
TGTGCCAGCAGCTTAATCCCAATCCGGGACAGTCCGGGAGGGGGCTACACCTTC	CASSLIPIRDSPGGGYTF	TRBV7-3	TRBJ1-2
TGCGCCAGCAGCTTGGAACGAGGGGGGAGGGCTAGGAAAGGGACAGATACGCAGTATTTT	CASSLERGGRARKGTDTQYF	TRBV5-1	TRBJ2-3
TGTGCCAGCAGTAGGGGCCCCGAGCAGTACTTC	CASSRGPEQYF	TRBV6-2	TRBJ2-7
TGCGCCAGCAGCTTGGCTCCCGCCCAGTACTTC	CASSLAPAQYF	TRBV5-1	TRBJ2-5
TGTGCCAGCAGTTACGGGCCTATGAACACTGAAGCTTTCTTT	CASSYGPMNTEAFF	TRBV6-2	TRBJ1-1
TGTGCCAATCCTGCGGGGGCTAGGGAAAAACTGTTTTTT	CANPAGAREKLFF	TRBV7-9	TRBJ1-4
TGTGCCAGCAGCTTGGCTCCTGGACAGGTCAGCTCCTATAATTCACCCCTCCACTTT	CASSLAPGQVSSYNSPLHF	TRBV7-4	TRBJ1-6
TGTGCCAGTACCCCGATGCGGTTTCACGAGCAGTACTTC	CASTPMRFHEQYF	TRBV19	TRBJ2-7
TGTGCCAGCAGACCCGGGACAGCTACAGGAACTGCTTTCTTT	CASRPGTATGTAFF	TRBV6-4	TRBJ1-1
TGTGCCAGCAGTGAACGGACTAGCGGGGAGCAGTTCTTC	CASSERTSGEQFF	TRBV25-1	TRBJ2-1
TGTGCCAGCAGTGACTTCGGAGGTGAGGGGAGATTATACGAGCAGTACTTC	CASSDFGGEGRLYEQYF	TRBV6-4	TRBJ2-7
TGTGCCACCAGTGTGCCGGCGGGGGCGACGGCCAAAAACATTCAGTACTTC	CATSVPAGATAKNIQYF	TRBV24-1	TRBJ2-4
TGTGCCACCAGGGGAAGGGAAGCTTTCTTT	CATRGREAFF	TRBV24-1	TRBJ1-1
TGTGCCAGCACGGCCGACAGGGAGACCAATTCACCCCTCCACTTT	CASTADRETNSPLHF	TRBV6-5	TRBJ1-6
TGTGCCAGCAGCGCCCGGGGGGGCCACATGGGTGACGAGCAGTACTTC	CASSARGGHMGDEQYF	TRBV11-2	TRBJ2-7
TGTGCCAGTAGGTGCGGGACTAGCTACGAGCAGTACTTC	CASRCGTSYEQYF	TRBV19	TRBJ2-7
TGCAGTGCTAGAGCCTACAGGGGACAGGGCGGAGCTTTCTTT	CSARAYRGQGGAFF	TRBV20-1	TRBJ1-1
TGCAGCGTGATCGGGACAGACGAGCAGTACTTC	CSVIGTDEQYF	TRBV29-1	TRBJ2-7
TGCGCCAGCAGCTTGGTAGTTATTCTCCGACAGGGCAATCAGCCCCAGCATTTT	CASSLVVILRQGNQPQHF	TRBV5-1	TRBJ1-5
TGTGCCAGCAGCAATGGGATGGCCTCCTACGAGCAGTACTTC	CASSNGMASYEQYF	TRBV13	TRBJ2-7
TGTGCCAGCAGCTTATTAGCAGGGGTAGGGTCTAACTATGGCTACACCTTC	CASSLLAGVGSNYGYTF	TRBV7-7	TRBJ1-2
TGTGCCAGCAGCCGAGCAAGGACAGGGTACAATGAGCAGTTCTTC	CASSRARTGYNEQFF	TRBV3-1	TRBJ2-1
TGTGCCAGCAGTTCAGGGGGCGATGGCTACACCTTC	CASSSGGDGYTF	TRBV12-4	TRBJ1-2
TGTGCCAGCAAAGGACAGGGGACGCTCGAGATGTGCTCCTACGAGCAGTACTTC	CASKGQGTLEMCSYEQYF	TRBV7-3	TRBJ2-7
TGTGCCACCAGTGATTTGTGCTGCGGGAATACAGATACGCAGTATTTT	CATSDLCCGNTDTQYF	TRBV24-1	TRBJ2-3
TGCAGTGCTCGCGGGAGTTTGATGGCGTCCTACAATGAGCAGTTCTTC	CSARGSLMASYNEQFF	TRBV20-1	TRBJ2-1
TGCAGTGCTAGTCTTTCTACAGGGGAACGTCATAACTATGGCTACACCTTC	CSASLSTGERHNYGYTF	TRBV20-1	TRBJ1-2
TGTGCCAGCCGGGGGGAAGAAGCTTTCTTT	CASRGEEAFF	TRBV12-4	TRBJ1-1
TGCAGTGCTAGGGGGACCGGGACTAGCGGGGGGGGGACCCAGTACTTC	CSARGTGTSGGGTQYF	TRBV20-1	TRBJ2-5
TGTGCCAGCAGCGTCCCAGGGCCGTACCCTGAAGCTTTCTTT	CASSVPGPYPEAFF	TRBV7-4	TRBJ1-1
TGTGCCAGCAGCCAAGGGAGGGCTGAAGCTTTCTTT	CASSQGRAEAFF	TRBV4-2	TRBJ1-1
TGTGCCAGCAGCCCCCCGATTATCAGAATGGACACTGAAGCTTTCTTT	CASSPPIIRMDTEAFF	TRBV7-4	TRBJ1-1
TGTGCCAGCAGCGTCTGGGGTCTAGCGGTACCAGAGACCCAGTACTTC	CASSVWGLAVPETQYF	TRBV9	TRBJ2-5
TGCGCCAGCAGCGAGCTGGACAGGGAGAGGTTCTTT	CASSELDRERFF	TRBV5-1	TRBJ1-1
TGTGCCAGCAGCGTAGCACGACAGGGGGCCCAGTACCAAGAGACCCAGTACTTC	CASSVARQGAQYQETQYF	TRBV9	TRBJ2-5
TGTGCCAGCAGCTTATCCACCCCCCAGGGGAGGCCAGCTTTCTTT	CASSLSTPQGRPAFF	TRBV7-2	TRBJ1-1
TGTGCCAGCAGCCTCAGGGATAGGAACACTGAAGCTTTCTTT	CASSLRDRNTEAFF	TRBV13	TRBJ1-1
TGTGCCAGCAGCGTCACCGGGACAGGGTCCCCGGCCTACGAGCAGTACTTC	CASSVTGTGSPAYEQYF	TRBV9	TRBJ2-7
TGTGCCAGCAGTGAAGGTGGAGCGGAATCTTGGACCCAGTACTTC	CASSEGGAESWTQYF	TRBV6-1	TRBJ2-5
TGTGCCTGGAGAAGGGTAAAAACGCGCAATCAGCCCCAGCATTTT	CAWRRVKTRNQPQHF	TRBV30	TRBJ1-5
TGTGCCAGCAGCGCTGGGTCAAACACCGGGGAGCTGTTTTTT	CASSAGSNTGELFF	TRBV13	TRBJ2-2
TGCGCCAGCAGCACAGGAAGTCGACCTAACGAGCAGTACTTC	CASSTGSRPNEQYF	TRBV5-1	TRBJ2-7
TGCAGTGCTGGGGGACTAGCGGGCTGGGATACGCAGTATTTT	CSAGGLAGWDTQYF	TRBV20-1	TRBJ2-3
TGTGCCAGCAGTCCCCAACAGGGAGGAGAAAAACTGTTTTTT	CASSPQQGGEKLFF	TRBV11-3	TRBJ1-4
TGTGCCAGCAGTTACGTCAGCGGAGAGTACAATGAGCAGTTCTTC	CASSYVSGEYNEQFF	TRBV6-6	TRBJ2-1
TGTGCCAGCAGCGACTTCCGAAGTCAGCCCCAGCATTTT	CASSDFRSQPQHF	TRBV7-6	TRBJ1-5
TGTGCTAGTGGTTTGGTATCTGGGGCATGTTATCAGCCCCAGCATTTT	CASGLVSGACYQPQHF	TRBV12-5	TRBJ1-5
TGTGCCAGCAGTTCCTCCTCAGGGAACACTGAAGCTTTCTTT	CASSSSSGNTEAFF	TRBV6-4	TRBJ1-1
TGTGCCATCAGTGACCAAGGGGGCAGGGGGGGGAAGAACTATGGCTACACCTTC	CAISDQGGRGGKNYGYTF	TRBV10-3	TRBJ1-2
TGTGCCAGCAGCTTAAACCTCGGGGTGGGCACCTTC	CASSLNLGVGTF	TRBV5-6	TRBJ1-2
TGTGCCAGCAGCTGGGGTAGGACTGGGGCCAACGTCCTGACTTTC	CASSWGRTGANVLTF	TRBV7-4	TRBJ2-6
TGTGCCAGCAGTTTTCTCACTGGGACAGGGAGCTGGTCTTCATGGTCTGGAAACACCATATATTTT	CASSFLTGTGSWSSWSGNTIYF	TRBV27	TRBJ1-3
TGTGCCAGCAGTAACGCTAACGAGACATCCTACGAGCAGTACTTC	CASSNANETSYEQYF	TRBV28	TRBJ2-7
TGTGCCAGCAGCTATGGGACAGGGAGTTGCACAGATACGCAGTATTTT	CASSYGTGSCTDTQYF	TRBV7-2	TRBJ2-3
TGTGCCAGCAGCGGTCGACTGCCCCGGGCGGCTGGGGCCAACGTCCTGACTTTC	CASSGRLPRAAGANVLTF	TRBV9	TRBJ2-6
TGTGCCAGCAGCAGAACCCCAGGGAGCAATGCGAACACTGAAGCTTTCTTT	CASSRTPGSNANTEAFF	TRBV7-3	TRBJ1-1
TGTGCCAGCAGCCAAGATGGGACCCAGGCTTACTATGGCTACACCTTC	CASSQDGTQAYYGYTF	TRBV14	TRBJ1-2
TGTGCCCTGAGTATTGACTTACAGGTAGCCAGCTCCTACAATGAGCAGTTCTTC	CALSIDLQVASSYNEQFF	TRBV24-1	TRBJ2-1
TGTGCCAGTAGTATGGAGGAGCGGGGGTGGTCCCGCAATCAGCCCCAGCATTTT	CASSMEERGWSRNQPQHF	TRBV19	TRBJ1-5
TGTGCCAGCAGCTTAATAGATAGCTGGGGGTGCTCCTATAATTCACCCCTCCACTTT	CASSLIDSWGCSYNSPLHF	TRBV7-3	TRBJ1-6
TGTGCCAGCAGCGGAACTAGCGGGAGAGTCCCCGGGGAGCTGTTTTTT	CASSGTSGRVPGELFF	TRBV6-2	TRBJ2-2
TGTGCCACCAGTGATATACAAGAGTCTTGGTTGGCCTTC	CATSDIQESWLAF	TRBV24-1	TRBJ2-5
TGTGCCACTCAGACGGGGAGGTACGAGCAGTACTTC	CATQTGRYEQYF	TRBV6-2	TRBJ2-7
TGTGCCAGCAGTTTAGCTCGGACAGTTAATGCTGGAAACACCATATATTTT	CASSLARTVNAGNTIYF	TRBV12-4	TRBJ1-3
TGTGCCAGCAGCTTAACGGCCAACGACAGGCGGCAGTACTTC	CASSLTANDRRQYF	TRBV7-3	TRBJ2-7
TGTGCCAGCAGCTTTAGGACCGGGGGCATGAACACTGAAGCTTTCTTT	CASSFRTGGMNTEAFF	TRBV9	TRBJ1-1
TGTGCCAGCAGTGCGTGGACAGGGGGCGACTATGGCTACACCTTC	CASSAWTGGDYGYTF	TRBV6-2	TRBJ1-2
TGTGAGCGACAGGAGGCCGGCTCCTATAATTCACCCCTCCACTTT	CERQEAGSYNSPLHF	TRBV7-9	TRBJ1-6
TGTGCCTACAGGAGGACTGAAGCTTTCTTT	CAYRRTEAFF	TRBV5-6	TRBJ1-1
TGCAGTGCTAGAGATGACCTCGGAAGCTGCAATACTGAAGCTTTCTTT	CSARDDLGSCNTEAFF	TRBV20-1	TRBJ1-1
TGTGCCAGCAGCCAATCCGGGACGCCAGGCTCCTACAATGAGCAGTTCTTC	CASSQSGTPGSYNEQFF	TRBV3-1	TRBJ2-1
TGTGCCAGCAGTGTCCGGGACAGGGTAAACGGTGGGGGAGACGAGCAGTACTTC	CASSVRDRVNGGGDEQYF	TRBV27	TRBJ2-7
TGCGCCAGCAGCTTCGTTTTGTATCAGCCCCAGCATTTT	CASSFVLYQPQHF	TRBV5-1	TRBJ1-5
TGTGCGAGGTACGAGCAGTACTTC	CARYEQYF	TRBV6-4	TRBJ2-7
TGTGCCAGTAGTATAAGCGTGATCCGGACAGTTGAGCAGTACTTC	CASSISVIRTVEQYF	TRBV19	TRBJ2-7
TGTGCCAGCAGCTTGGGTGGAGGGGGCGTCAGCTCCTACGAGCAGTACTTC	CASSLGGGGVSSYEQYF	TRBV5-6	TRBJ2-7
TGTGCCAGCAGCTCCAACAGGGGCAGCTCCTATAATTCACCCCTCCACTTT	CASSSNRGSSYNSPLHF	TRBV11-3	TRBJ1-6
TGTGCCAGCAGTAGGGACAGGGAAGATACGCAGTATTTT	CASSRDREDTQYF	TRBV7-9	TRBJ2-3
TGTGCCAGCCCGCCTCCGACCCGGGAGAAATGCACAGATACGCAGTATTTT	CASPPPTREKCTDTQYF	TRBV5-6	TRBJ2-3
TGTGCCAGCAGCCTTAGCAGGGGGCCAAATGAAAAACTGTTTTTT	CASSLSRGPNEKLFF	TRBV4-2	TRBJ1-4
TGTGCCAGCAGTGATCCAGGGACGGTTCTGAACACTGAAGCTTTCTTT	CASSDPGTVLNTEAFF	TRBV6-1	TRBJ1-1
TGTGCCAGCAGTTACTTTAAGAATTCTTCCACTTATGCAACTAATGAAAAACTGTTTTTT	CASSYFKNSSTYATNEKLFF	TRBV6-5	TRBJ1-4
TGTGCCAGCAGCTTGGAGGGACGGGATCAGCCCCAGCATTTT	CASSLEGRDQPQHF	TRBV7-7	TRBJ1-5
TGTGCCAGCAGCGGACTAGCGGGGGGCCGTTCCTTCAATGAGCAGTTCTTC	CASSGLAGGRSFNEQFF	TRBV7-4	TRBJ2-1
TGCGCCAGCAGCAGGACGAATAATGAGCAGTTCTTC	CASSRTNNEQFF	TRBV5-1	TRBJ2-1
TGTGCCTGGAGGGGCGGAACCGGGGAGCTGTTTTTT	CAWRGGTGELFF	TRBV30	TRBJ2-2
TGTGCCAGCAGTTGTCCCGGGGAGGTTGAGGGGGGAATAAGGGGAAGGGTAAGCTCCTATAATTCACCCCTCCACTTT	CASSCPGEVEGGIRGRVSSYNSPLHF	TRBV6-2	TRBJ1-6
TGTGCCATCAGTAGGGGCACTTACGAGCAGTACTTC	CAISRGTYEQYF	TRBV10-3	TRBJ2-7
TGTGCCAGCCTTAGCGGGGCCAATGAGCAGTTCTTC	CASLSGANEQFF	TRBV6-5	TRBJ2-1
TGTGCCAGCATCCAGGGATTGAGCTACGAGCAGTACTTC	CASIQGLSYEQYF	TRBV2	TRBJ2-7
TGTGCCAGCAGTTTAAGCGCCCCGCGGGAAACAGATACGCAGTATTTT	CASSLSAPRETDTQYF	TRBV12-4	TRBJ2-3
TGTGCCAGCAGTTTCTCGACCCCGGTCTTGGCCGGGACCCCGCCCTACGAGCAGTACTTC	CASSFSTPVLAGTPPYEQYF	TRBV12-3	TRBJ2-7
TGTGCCTGGAGTGTACCAAGGACTAGCGATGTCTCCTACAATGAGCAGTTCTTC	CAWSVPRTSDVSYNEQFF	TRBV30	TRBJ2-1
TGTGCCAGCAGTCGAGCTCCCCCAATTCCAAAGTGTGTACAGGGGGCGGAGGGCACAGATACGCAGTATTTT	CASSRAPPIPKCVQGAEGTDTQYF	TRBV6-2	TRBJ2-3
TGTGCCAGATCCCAACCGGGGGTAGCCAAAAACATTCAGTACTTC	CARSQPGVAKNIQYF	TRBV28	TRBJ2-4
TGTGCCAGCAAAAAACTAGCGGGAGTGGCAGTCTCCTACAATGAGCAGTTCTTC	CASKKLAGVAVSYNEQFF	TRBV27	TRBJ2-1
TGTGCTAGCGGGGTTTTAGGCTCTGGGGCCAACGTCCTGACTTTC	CASGVLGSGANVLTF	TRBV12-5	TRBJ2-6
TGTGCCAGCAGTCCAGGGGTGAACTACAATGAGCAGTTCTTC	CASSPGVNYNEQFF	TRBV6-4	TRBJ2-1
TGTGCCACCAGTGCCCGGACTAGCGGTCCAGGCTACGAGCAGTACTTC	CATSARTSGPGYEQYF	TRBV24-1	TRBJ2-7
TGCAGTGCTACATCAGGGAGGGGAAACACCATATATTTT	CSATSGRGNTIYF	TRBV20-1	TRBJ1-3
TGTGCCAGCAGCTTAATCCGGAACTTAGCGGGGGGTGGAAATGAGCAGTTCTTC	CASSLIRNLAGGGNEQFF	TRBV7-3	TRBJ2-1
TGTGCCTGGCTTTGGGGCTGCAACTATGGCTACACCTTC	CAWLWGCNYGYTF	TRBV30	TRBJ1-2
TGCGCCAGCAGAGGGGGGCAAAATGGCTACACCTTC	CASRGGQNGYTF	TRBV10-2	TRBJ1-2
TGCAGTGCTAGATTCGTCGAAGGACCCGAGCAGTACTTC	CSARFVEGPEQYF	TRBV20-1	TRBJ2-7
TGTGCCAGCAGCTCCGAAACAGGGACAGGGTTTGAGCAGTTCTTC	CASSSETGTGFEQFF	TRBV9	TRBJ2-1
TGCGCCAGCAGCCACACCAAAGGGACAGGGAGGAAGGATGATTACTATAATTCACCCCTCCACTTT	CASSHTKGTGRKDDYYNSPLHF	TRBV4-1	TRBJ1-6
TGTGCCAGCAGTGGGGGACTAGTCGAAAGTAACACCGGGGAGCTGTTTTTT	CASSGGLVESNTGELFF	TRBV6-4	TRBJ2-2
TGCAGGACCCTTTACTACGAGCAGTACTTC	CRTLYYEQYF	TRBV20-1	TRBJ2-7
TGTGCCAGCAGCTTGCCAAACGGGGCCAGCTACGAGCAGTACTTC	CASSLPNGASYEQYF	TRBV7-2	TRBJ2-7
TGTGCCATCAGTGCCATGCGAGACCCCTCCTACGAGCAGTACTTC	CAISAMRDPSYEQYF	TRBV10-3	TRBJ2-7
TGTGCCTGGAGTCGCCATACTCGGCCCGGGACTAGCGGCCCGTACAATGAGCAGTTCTTC	CAWSRHTRPGTSGPYNEQFF	TRBV30	TRBJ2-1
TGCAGTGCTAGATGGGGTGTCCCTAGGGGGGGCGCCACGAACACCGGGGAGCTGTTTTTT	CSARWGVPRGGATNTGELFF	TRBV20-1	TRBJ2-2
TGTGCCAGCAGCACAGGGACAGGGATCATCAGCAATCAGCCCCAGCATTTT	CASSTGTGIISNQPQHF	TRBV5-6	TRBJ1-5
TGTGCCAGCAGGTATAAAGACAGGGAGCCGAACACTGAAGCTTTCTTT	CASRYKDREPNTEAFF	TRBV6-2	TRBJ1-1
TGTGCCACCAGTGATTCTTGTTCAAGGACGGACAGGGTCCCAACTGAAGCTTTCTTT	CATSDSCSRTDRVPTEAFF	TRBV24-1	TRBJ1-1
TGCGCCGCATTCCGGGGGGGCCAGTTAAAAGAGACCCAGTACTTC	CAAFRGGQLKETQYF	TRBV10-1	TRBJ2-5
TGTGCCAGTAGTATGCGGACTAGCGGGGGGGCCAGGTGTGAGAGGTACGAGCAGTACTTC	CASSMRTSGGARCERYEQYF	TRBV19	TRBJ2-7
TGTGCCAGCAGCTACAGACTGGACGAGCAGTACTTC	CASSYRLDEQYF	TRBV5-4	TRBJ2-7
TGTGCCAGCAGTATGGAAGATAGCAATCAGCCCCAGCATTTT	CASSMEDSNQPQHF	TRBV6-3	TRBJ1-5
TGTGCCAGCAGCGGACAGTCCTACGAGCAGTACTTC	CASSGQSYEQYF	TRBV13	TRBJ2-7
TGTGCCAGCAGTGTTTATTTCAGGGAACCGGGACGAGCCTACGAGCAGTACTTC	CASSVYFREPGRAYEQYF	TRBV6-4	TRBJ2-7
TGTGCCAGCAGTTACTCGACCACAGGGGACCACGGGAACACTGAAGCTTTCTTT	CASSYSTTGDHGNTEAFF	TRBV6-5	TRBJ1-1
TGTGCCAGCCTGGGGGGGACTAGTTGGGATACGCAGTATTTT	CASLGGTSWDTQYF	TRBV6-1	TRBJ2-3
TGTGCCAGCGGGGGGGCCTTGGGCTCTGGAAACACCATATATTTT	CASGGALGSGNTIYF	TRBV14	TRBJ1-3
TGCGCCAGCAGCCAAGATCAGAGGGGCTTTAAGACCCAGTACTTC	CASSQDQRGFKTQYF	TRBV4-3	TRBJ2-5
TGTGCCAGCAGTAGGTCCGGGACTAGCGGGATCTGGACCCAGTACTTC	CASSRSGTSGIWTQYF	TRBV6-2	TRBJ2-5
TGTGCCAGCAGTTACCTCAGCGGGGAAATGGATTCACCCCTCCACTTT	CASSYLSGEMDSPLHF	TRBV6-5	TRBJ1-6
TGTGCCAGCAGTTGCCCGGGGACAGGTAAGAGCGAGCAGTACTTC	CASSCPGTGKSEQYF	TRBV25-1	TRBJ2-7
TGTGCCAGCACAATTTCGACAGGGGGTAACACTGAAGCTTTCTTT	CASTISTGGNTEAFF	TRBV6-5	TRBJ1-1
TGTGCCAGCACCACCGGCCAAGCGGGTAACGAGTCCTACGAGCAGTACTTC	CASTTGQAGNESYEQYF	TRBV2	TRBJ2-7
TGTGCCAGCAGCGCGGGTTACAATGAGCAGTTCTTC	CASSAGYNEQFF	TRBV9	TRBJ2-1
TGTGCCAGCTCACCACGTAGGGGGGGGCGGTCGAGCAATCAGCCCCAGCATTTT	CASSPRRGGRSSNQPQHF	TRBV18	TRBJ1-5
TGTGCCCCACGGAGCGGGAACACTGAAGCTTTCTTT	CAPRSGNTEAFF	TRBV27	TRBJ1-1
TGTGCCAGCAGCACTAGGGGCCGGTGGGGGACCCACAATGAGCAGTTCTTC	CASSTRGRWGTHNEQFF	TRBV9	TRBJ2-1
TGTGCCAGCAGCTTTGACTTGGTTAAAGAAAATGCCCAGTACTTC	CASSFDLVKENAQYF	TRBV11-3	TRBJ2-5
TGTGCCAGCAGTCCCGACAGGGGGGGAAACACTGAAGCTTTCTTT	CASSPDRGGNTEAFF	TRBV6-5	TRBJ1-1
TGTGCCAGCAGCTTAGAACCAGCTCTGGACTACGAGCAGTACTTC	CASSLEPALDYEQYF	TRBV7-9	TRBJ2-7
TGTGCCAGCAGTCTGCGGGAGATCTACTACGAGCAGTACTTC	CASSLREIYYEQYF	TRBV12-4	TRBJ2-7
TGTGCCAGCAGCGGATGCGACAGGGGTCCCTCTCCCCAGCCCCAGCATTTT	CASSGCDRGPSPQPQHF	TRBV9	TRBJ1-5
TGCACAAGGAGGGGCTCCTACAATGAGCAGTTCTTC	CTRRGSYNEQFF	TRBV10-1	TRBJ2-1
TGTGCCAGCAGCGCGGCCCCAAATGAGGGCAACACTGAAGCTTTCTTT	CASSAAPNEGNTEAFF	TRBV7-2	TRBJ1-1
TGTGCCAGCAGTGACGGTAGAGGGGATAGCAATCAGCCCCAGCATTTT	CASSDGRGDSNQPQHF	TRBV6-4	TRBJ1-5
TGTGCCACCGGAATCAATCAGCCCCAGCATTTT	CATGINQPQHF	TRBV7-6	TRBJ1-5
TGTGCCAGCCCCGAAATCGCCCCGGGACTAGAAGAGACCCAGTACTTC	CASPEIAPGLEETQYF	TRBV13	TRBJ2-5
TGCAGTGCTAGAGTCCGGGACACCTCTGGGGCCAACGTCCTGACTTTC	CSARVRDTSGANVLTF	TRBV20-1	TRBJ2-6
TGTGCCAGTAGTATAATTCAGGGGAGATGGTGCAATCAGCCCCAGCATTTT	CASSIIQGRWCNQPQHF	TRBV19	TRBJ1-5
TGTGCCAGCTCGCCCGGGACTAGCGGGTCCACCGGGGAGCTGTTTTTT	CASSPGTSGSTGELFF	TRBV18	TRBJ2-2
TGTGCCAGCAGCTCCAGTGGGGTTAGTAATGAAAAACTGTTTTTT	CASSSSGVSNEKLFF	TRBV11-2	TRBJ1-4
TGCGCCAGCAGCGGGAGGGGAAGGCAGCCCCAGCATTTT	CASSGRGRQPQHF	TRBV4-1	TRBJ1-5
TGTGCCAGCAGCACAGGGGTCGACGAGCAGTACTTC	CASSTGVDEQYF	TRBV7-3	TRBJ2-7
TGTGCCTGGAGTGTAGGCCCTCCGGGACGGGCCTACGAGCAGTACTTC	CAWSVGPPGRAYEQYF	TRBV30	TRBJ2-7
TGTGCCAGCAGTTTAACGGACCTAGGAGATACGCAGTATTTT	CASSLTDLGDTQYF	TRBV12-4	TRBJ2-3
TGTGCCAGCAGCGGAGGGCAGGGAGAAAATCAGCCCCAGCATTTT	CASSGGQGENQPQHF	TRBV13	TRBJ1-5
TGTGCCACCCTTGGGACTAGCGTTCCCGGCAATGAGCAGTTCTTC	CATLGTSVPGNEQFF	TRBV24-1	TRBJ2-1
TGTGCCAGCAGCCCAGATCCACTAGCGGGAGGAAAAGAGACCCAGTACTTC	CASSPDPLAGGKETQYF	TRBV9	TRBJ2-5
TGTGCCAGCAGTTACCGCCATAGACACGGTCACGAGCAGTACTTC	CASSYRHRHGHEQYF	TRBV6-5	TRBJ2-7
TGTGCCAGTACCGGATTGGCCTCCGGGACAGCTTCTGGCTACACCTTC	CASTGLASGTASGYTF	TRBV19	TRBJ1-2
TGTGCCAGCAGAACGGGAGGGGCATACGAGCAGTACTTC	CASRTGGAYEQYF	TRBV28	TRBJ2-7
TGTGCCAGCATTGCATTCGGCTCACTAGGCAATTCACCCCTCCACTTT	CASIAFGSLGNSPLHF	TRBV6-5	TRBJ1-6
TGTGCCAGCAGCGGGCCGGGACTCACTAATTCATCCCTCCACTTT	CASSGPGLTNSSLHF	TRBV9	TRBJ1-6
TGTGCCACCAGCAGAGCTCTCGTCAGAACATATGATACGCAGTATTTT	CATSRALVRTYDTQYF	TRBV15	TRBJ2-3
TGTGCCAGCAGCGAGGGGAAACTGTTTTTT	CASSEGKLFF	TRBV13	TRBJ1-4
TGTGCCAGCACCCGCTGGGAGGGACCGTCACCCCTCCACTTT	CASTRWEGPSPLHF	TRBV12-3	TRBJ1-6
TGCGCCAGCAGCCTCCCGGGGTGCACAGATACGCAGTATTTT	CASSLPGCTDTQYF	TRBV4-3	TRBJ2-3
TGTGCCAGCAGTTTTAAGTTCGGGCTTAATCAGCCCCAGCATTTT	CASSFKFGLNQPQHF	TRBV28	TRBJ1-5
TGTGCCAGCTCACCCAAGACGGATCCGGAGGGAGGGCGCAATCAGCCCCAGCATTTT	CASSPKTDPEGGRNQPQHF	TRBV18	TRBJ1-5
TGCGCCAGCAGCCCCATACATTATAGCTACGAGCAGTACTTC	CASSPIHYSYEQYF	TRBV5-1	TRBJ2-7
TGCGCCAGCAGCCAAGCAGGGGGGGGGGAGACCCAGTACTTC	CASSQAGGGETQYF	TRBV4-1	TRBJ2-5
TGTGCCAGCAGCCCCCGGGGGGTGATTGATACGCAGTATTTT	CASSPRGVIDTQYF	TRBV4-2	TRBJ2-3
TGTGCCAGCAGCAGGGGGCCGGGACAGGGGGCGATCGCTCGACTAGGTGCCTACGAGCAGTACTTC	CASSRGPGQGAIARLGAYEQYF	TRBV13	TRBJ2-7
TGTGCCAGCAGCTTAGGGCGCACTAGGACAGGGGGCGGATCCGGCAATCAGCCCCAGCATTTT	CASSLGRTRTGGGSGNQPQHF	TRBV7-9	TRBJ1-5
TGTGCCAGCATTAAGTTAGGACAGTTACGGAATGAAAAACTGTTTTTT	CASIKLGQLRNEKLFF	TRBV27	TRBJ1-4
TGTGCCAGTAGCCAGGGTTCCGGGGAGCTGTTTTTT	CASSQGSGELFF	TRBV19	TRBJ2-2
TGCGCCAGCAGTGTTGACCCACTAGCGGTGGGCTCCTACGAGCAGTACTTC	CASSVDPLAVGSYEQYF	TRBV10-1	TRBJ2-7
TGTGCCAGCAGCCAAGGGTCAGGGGAGTGGCCCCAGCATTTT	CASSQGSGEWPQHF	TRBV14	TRBJ1-5
TGTGCCAGCAGAAGGTTAGTTCCCTGCAATCAGCCCCAGCATTTT	CASRRLVPCNQPQHF	TRBV28	TRBJ1-5
TGTGCCAGCAGCCCAGAATCGTATGATACGCAGTATTTT	CASSPESYDTQYF	TRBV13	TRBJ2-3
TGTGCCAGCCACCTAGGGGGGGGCTACACCTTC	CASHLGGGYTF	TRBV9	TRBJ1-2
TGCAGTCAGGGACAGGGTAACGAGCAGTACTTC	CSQGQGNEQYF	TRBV20-1	TRBJ2-7
TGCGCCAGCAGCTTGGGACTAGCGGGCGCTTACACCGGGGAGCTGTTTTTT	CASSLGLAGAYTGELFF	TRBV5-1	TRBJ2-2
TGCGCCAGGAGGGGGGTCCCCTACGAGCAGTACTTC	CARRGVPYEQYF	TRBV10-2	TRBJ2-7
TGTGCCAGCAGCATGCTCGGAGGACGTGGTTACAATGAGCAGTTCTTC	CASSMLGGRGYNEQFF	TRBV11-2	TRBJ2-1
TGTGCCAGCTCGGGGCCGGTTCAGCCCCAGCATTTT	CASSGPVQPQHF	TRBV18	TRBJ1-5
TGCGCCCCTCAGGGTAAAAGGGGAGGGGCCAACGTCCTGACTTTC	CAPQGKRGGANVLTF	TRBV5-1	TRBJ2-6
TGCGCCAGCAGCCGTCCCAAGGGACGAGACCAAGAGACCCAGTACTTC	CASSRPKGRDQETQYF	TRBV4-1	TRBJ2-5
TGCGCCAGCAGCCAAGATGGGGTGGGAGAAGGGCCGAGCAATCAGCCCCAGCATTTT	CASSQDGVGEGPSNQPQHF	TRBV4-1	TRBJ1-5
TGCAGCGCGGGGGGATACGAGCAGTACTTC	CSAGGYEQYF	TRBV29-1	TRBJ2-7
TGTGCCAGCAGCTTGGAGCAGGGGGCGGTTGAGACCCAGTACTTC	CASSLEQGAVETQYF	TRBV5-6	TRBJ2-5
TGTGCCAGCAGCGTCCCAGCGGGGCACAGGGTCTCCTACGAGCAGTACTTC	CASSVPAGHRVSYEQYF	TRBV9	TRBJ2-7
TGTGCCAGCAGAGGGGGGGCCGGGGAGCTGTTTTTT	CASRGGAGELFF	TRBV6-5	TRBJ2-2
TGTGCCAGCAGCTTGGCGACAGCTTGGAACACTGAAGCTTTCTTT	CASSLATAWNTEAFF	TRBV5-6	TRBJ1-1
TGTGCCAGCAGCAGGGGTTGCCGGCATAATTCACCCCTCCACTTT	CASSRGCRHNSPLHF	TRBV9	TRBJ1-6
TGTGCCAGCAGTAGGGGGAACCATAGCACAGATACGCAGTATTTT	CASSRGNHSTDTQYF	TRBV7-9	TRBJ2-3
TGTGCCACCAGTGATTTTGTTGGTCCCTATCCAGGGGGGGGGGGCGAGCAGTACTTC	CATSDFVGPYPGGGGEQYF	TRBV24-1	TRBJ2-7
TGTGCCAGCAGCGGACGAAACCGAGTCATGAACACTGAAGCTTTCTTT	CASSGRNRVMNTEAFF	TRBV7-3	TRBJ1-1
TGTGACAGAAGCTACGAGCAGTACTTC	CDRSYEQYF	TRBV28	TRBJ2-7
TGCAGCAGCGGATTCGGTGAGACCCAGTACTTC	CSSGFGETQYF	TRBV29-1	TRBJ2-5
TGTGCCAGCAGCCCGGACTCCCCTAACTATGGCTACACCTTC	CASSPDSPNYGYTF	TRBV11-3	TRBJ1-2
TGCGCCAGCAGCCAAGATCCAATACTAGCGGCTAGATATGAGCAGTTCTTC	CASSQDPILAARYEQFF	TRBV4-3	TRBJ2-1
TGTGCCAGCAGCCAATGTATCAGGGAGGCAACTAATGAAAAACTGTTTTTT	CASSQCIREATNEKLFF	TRBV14	TRBJ1-4
TGCGCCAGCAGCTTATCATGGCCTGAAGCTTTCTTT	CASSLSWPEAFF	TRBV5-1	TRBJ1-1
TGTGCCAGCAGCGAAGGACTAGCGACCTACGAGCAGTACTTC	CASSEGLATYEQYF	TRBV13	TRBJ2-7
TGTGCCACCAGCAGCCCATCAGGGGGTAACACTGAAGCTTTCTTT	CATSSPSGGNTEAFF	TRBV15	TRBJ1-1
TGTGCCAGCAGCTTAGACTCTAAGCCGGGACAGGACTCCTACGAGCAGTACTTC	CASSLDSKPGQDSYEQYF	TRBV11-2	TRBJ2-7
TGTGCCAGTAGGGGTATTGAGGGGTATAGCAATCAGCCCCAGCATTTT	CASRGIEGYSNQPQHF	TRBV19	TRBJ1-5
TGTGCCAGCAGCGTAGGGGCCGGACAGGGAGGGGACTATGGCTACACCTTC	CASSVGAGQGGDYGYTF	TRBV9	TRBJ1-2
TGTGCCAGCAGCAGGACTAGCGGGAGGGCCCCTGAAGCTTTCTTT	CASSRTSGRAPEAFF	TRBV7-3	TRBJ1-1
TGTGCCACCAGTGATTGGGGGACTAGAAAGGATACGCAGTATTTT	CATSDWGTRKDTQYF	TRBV24-1	TRBJ2-3
TGTGCCAGCAGTTTCTCGTTAGGTCGTGGGGAAGATACGCAGTATTTT	CASSFSLGRGEDTQYF	TRBV28	TRBJ2-3
TGTGCCCCGGCACTGACTGGCTCCGGGACAGGGGGCTTAGACGAGCAGTACTTC	CAPALTGSGTGGLDEQYF	TRBV10-3	TRBJ2-7
TGTGCCAGCAGCTTATGGCCTAGGCCTTACAGGGCCCGCTACGAGCAGTACTTC	CASSLWPRPYRARYEQYF	TRBV11-2	TRBJ2-7
TGTGCCAGCAGCTGTCCCTCCCAGGGGGTCAACGAGAGCTCCTACGAGCAGTACTTC	CASSCPSQGVNESSYEQYF	TRBV7-9	TRBJ2-7
TGTGCCACCAGTGCCCAGTCAGGGTCTTGGGGAAAGAGCAATCAGCCCCAGCATTTT	CATSAQSGSWGKSNQPQHF	TRBV24-1	TRBJ1-5
TGTGCCAGCAGCTTAGTTCGGGGGGGGGGGGCCGGGAAGGCGAACACCGGGGAGCTGTTTTTT	CASSLVRGGGAGKANTGELFF	TRBV7-9	TRBJ2-2
TGTGCCAGCAGAGAGGATGGTTCGGGACCACGATCCTCTGGGGCCAACGTCCTGACTTTC	CASREDGSGPRSSGANVLTF	TRBV4-2	TRBJ2-6
TGTGCCAGCAGTGCCTCGACTAGCGGGCAGCATGAGCAGTTCTTC	CASSASTSGQHEQFF	TRBV25-1	TRBJ2-1
TGCGCCAGCAGCTTAGTCAAGAGCAATCAGCCCCAGCATTTT	CASSLVKSNQPQHF	TRBV5-1	TRBJ1-5
TGTGCCAGCAGCGGCCGGTATGGCTACACCTTC	CASSGRYGYTF	TRBV7-3	TRBJ1-2
TGCAGCGTCTCTGGGGTCGCACCCCTCCACTTT	CSVSGVAPLHF	TRBV29-1	TRBJ1-6
TGTGCCAGCTCACCCAGGAGATCCCGAGAGACCCAGTACTTC	CASSPRRSRETQYF	TRBV18	TRBJ2-5
TGTGCCAGCAGAGTTTTCTGCCACCGGGGGCGTTCTGAGACCCAGTACTTC	CASRVFCHRGRSETQYF	TRBV7-8	TRBJ2-5
TGCGCCAGCAGCTTTGAGCCAGTCAACACTGAAGCTTTCTTT	CASSFEPVNTEAFF	TRBV5-1	TRBJ1-1
TGTGCCAGCAGCCTTTACGGCGAAGTCAATGAGCAGTTCTTC	CASSLYGEVNEQFF	TRBV12-3	TRBJ2-1
TGTGCCAGCAGGGGGAAGATTTGCACAGATACGCAGTATTTT	CASRGKICTDTQYF	TRBV2	TRBJ2-3
TGTGCCAGCAGTCGGGACAGGGGGCGGGGGCCACCTTCACCCCTCCACTTT	CASSRDRGRGPPSPLHF	TRBV6-3	TRBJ1-6
TGTGCCAGCAAAAAGAAAGTAGGGCTTATGAACACTGAAGCTTTCTTT	CASKKKVGLMNTEAFF	TRBV28	TRBJ1-1
TGTGCCAGCAGCGCGGACAGGCTTAGGGATAGCAATCAGCCCCAGCATTTT	CASSADRLRDSNQPQHF	TRBV9	TRBJ1-5
TGTGCCTGGAGTCGTCGTAAGTTCAGCCCAGGCTATAACGAGCAGTACTTC	CAWSRRKFSPGYNEQYF	TRBV30	TRBJ2-7
TGTGCCAGCAGCTTCGCCTCTCCTACCTATGGCTACACCTTC	CASSFASPTYGYTF	TRBV7-2	TRBJ1-2
TGTGCCATCAGTGAGTCGGTAAACAGGGTGGGCGGCAATCAGCCCCAGCATTTT	CAISESVNRVGGNQPQHF	TRBV10-3	TRBJ1-5
TGTGCCAGCAGCAGGTCCCAGGGCGGGGAATGGACTGAAGCTTTCTTT	CASSRSQGGEWTEAFF	TRBV7-3	TRBJ1-1
TGTGCCAGCAGCAGAAAGAACAGGGGGAGCTACGAGCAGTACTTC	CASSRKNRGSYEQYF	TRBV13	TRBJ2-7
TGCAGTGCTGACCCTCAGCTAGCGGGTTGCACAGATACGCAGTATTTT	CSADPQLAGCTDTQYF	TRBV20-1	TRBJ2-3
TGCAGTGCTAGAGGAGCCAGACTTAACTACGAGCAGTACTTC	CSARGARLNYEQYF	TRBV20-1	TRBJ2-7
TGCAGTGCTAGAGAAGTGTTCAGAATGTGGACTAGCGGGTTGACCCCTATCTCCTACGAGCAGTACTTC	CSAREVFRMWTSGLTPISYEQYF	TRBV20-1	TRBJ2-7
TGCGCCAGCAGTGTAGGGGAGTACAATCAGCCCCAGCATTTT	CASSVGEYNQPQHF	TRBV10-1	TRBJ1-5
TGTGCCAGCGAATTCGGGACTAGCAGGAACACAGATACGCAGTATTTT	CASEFGTSRNTDTQYF	TRBV6-1	TRBJ2-3
TGCGCCAGCGAGACAGGGTTGTATGGCTACACCTTC	CASETGLYGYTF	TRBV5-1	TRBJ1-2
TGTGCCAGCTCACCGTGCACAGGGGGAGATGGGTCCTACGAGCAGTACTTC	CASSPCTGGDGSYEQYF	TRBV18	TRBJ2-7
TGCAGCCTAACCTCCCGACTAGATTACGAGCAGTACTTC	CSLTSRLDYEQYF	TRBV29-1	TRBJ2-7
TGTGCCAGCAGCAAAGCCCGGGGCCCAGAGAGCGAGCAGTACTTC	CASSKARGPESEQYF	TRBV11-2	TRBJ2-7
TGTGCCAGCAGTGAGAGGACCCCGGTGACAGCCGATGGCTACACCTTC	CASSERTPVTADGYTF	TRBV6-4	TRBJ1-2
TGTGCCAGCAGCCCGGACAGGGGGGGAGATGGCTACACCTTC	CASSPDRGGDGYTF	TRBV11-3	TRBJ1-2
TGTGCCAGCAGCCTCATCGGAGGGACAGATACGCAGTATTTT	CASSLIGGTDTQYF	TRBV7-2	TRBJ2-3
TGTGCCAGCTCACCACTAACTGTCAATCAGCCCCAGCATTTT	CASSPLTVNQPQHF	TRBV18	TRBJ1-5
TGTGCCAGCAGCCGGGGTTCCCGAGCTTTCTTT	CASSRGSRAFF	TRBV11-3	TRBJ1-1
TGTGCCAGCAGCTCGGGACCTCGCAATCAGCCCCAGCATTTT	CASSSGPRNQPQHF	TRBV7-2	TRBJ1-5
TGTGCCAGCAGTTTACTAGACAGGGGTGGGAGCTTCTACGAGCAGTACTTC	CASSLLDRGGSFYEQYF	TRBV27	TRBJ2-7
TGTGCCAGCAGTGAAGCGAGGCATTCGACAGGGGCGATGAGCAATCAGCCCCAGCATTTT	CASSEARHSTGAMSNQPQHF	TRBV6-1	TRBJ1-5
TGCAGTGCTACCTCAGGTTCCGAGCAGTACTTC	CSATSGSEQYF	TRBV20-1	TRBJ2-7
TGTGCCCACTCCCGGGGGAGAGAGACCCAGTACTTC	CAHSRGRETQYF	TRBV7-2	TRBJ2-5
TGTGCCACCAGTGTAACTAGCGGGGGCAATAGCACAGATACGCAGTATTTT	CATSVTSGGNSTDTQYF	TRBV24-1	TRBJ2-3
TGTGCCACGGGGGGGCAACTCTTT	CATGGQLF	TRBV19	TRBJ1-1
TGTGCCAGCAGCGGGACAGGTAAGTACACAGATACGCAGTATTTT	CASSGTGKYTDTQYF	TRBV6-1	TRBJ2-3
TGTGCCAGCAGCTTAGACTCCCCTGGGGGGGACGAGCAGTACTTC	CASSLDSPGGDEQYF	TRBV7-4	TRBJ2-7
TGTGCCACCAGTGATAGGTATGGCTACACCTTC	CATSDRYGYTF	TRBV24-1	TRBJ1-2
TGTGCCGGGACCGACGACAATGAGCAGTTCTTC	CAGTDDNEQFF	TRBV24-1	TRBJ2-1
TGTGCCAGCAGTCCATATAAGGACACTGAAGCTTTCTTT	CASSPYKDTEAFF	TRBV6-5	TRBJ1-1
TGTGCCAGCAGTTTGACCAGTTCTCGGCGGGACAGGGATCAGCCCCAGCATTTT	CASSLTSSRRDRDQPQHF	TRBV12-3	TRBJ1-5
TGTGCCAGCAGCTTCACCCTAAAGTACAATGAGCAGTTCTTC	CASSFTLKYNEQFF	TRBV7-4	TRBJ2-1
TGTGCCAGCAGCAGGGACAGGGGTCCCTCCTATAATTCACCCCTCCACTTT	CASSRDRGPSYNSPLHF	TRBV13	TRBJ1-6
TGTGCCTGGAGTCACTGGGGGAATGGCTACAATGAGCAGTTCTTC	CAWSHWGNGYNEQFF	TRBV30	TRBJ2-1
TGCAGTGCTAGAGAGAAGCAGGGGGTAAGCGTTTGGGGAGCCTACAATGAGCAGTTCTTC	CSAREKQGVSVWGAYNEQFF	TRBV20-1	TRBJ2-1
TGTGCCAGCAGTGATGGCAGCAGCTGGCAGTATTTT	CASSDGSSWQYF	TRBV6-4	TRBJ2-3
TGTGCCACCACTTTGCCAGGGTCACCCCTCCACTTT	CATTLPGSPLHF	TRBV24-1	TRBJ1-6
TGTGCCAGTAGTTTCACGGACGCCTACGAGCAGTACTTC	CASSFTDAYEQYF	TRBV19	TRBJ2-7
TGTGCCAGCAGTTACTGCCCAGGGCCGGACCTCGCTGATACGCAGTATTTT	CASSYCPGPDLADTQYF	TRBV6-5	TRBJ2-3
TGTGCCAGGTTCAAGTACGGCGACTACAATGAGCAGTTCTTC	CARFKYGDYNEQFF	TRBV19	TRBJ2-1
TGTGCCAGCAGCCAAGCCAGGCCGACAGGGGGATTCCTCTACGAGCAGTACTTC	CASSQARPTGGFLYEQYF	TRBV4-2	TRBJ2-7
TGTGCCAGCAGCGGGTGGGGGGTAGGATATCAGCCCCAGCATTTT	CASSGWGVGYQPQHF	TRBV7-3	TRBJ1-5
TGTGCCAGCAGCGAGGATACAGGGGGCCCCTACGAGCAGTACTTC	CASSEDTGGPYEQYF	TRBV7-2	TRBJ2-7
TGTGCCAGCAGTTTCACAGGGGGCCATAGCAATCAGCCCCAGCATTTT	CASSFTGGHSNQPQHF	TRBV28	TRBJ1-5
TGTGCCAGTAGTATCCGGGGAAACTCCGTCTACGAGCAGTACTTC	CASSIRGNSVYEQYF	TRBV19	TRBJ2-7
TGTGCCACCAGTGATTTTGTTACTAGCGGGAGGCTCGCTTTCTTT	CATSDFVTSGRLAFF	TRBV24-1	TRBJ1-1
TGTGCCAGCAGTTACGTCCAGCAGGAGCAGTTCTTC	CASSYVQQEQFF	TRBV27	TRBJ2-1
TGTGCCAGCAGCGGCACAGACTACGAGCAGTACTTC	CASSGTDYEQYF	TRBV7-2	TRBJ2-7
TGTGCCACCAGACAGGGGGGGGGAGGAAGCGGCTACACCTTC	CATRQGGGGSGYTF	TRBV24-1	TRBJ1-2
TGTGCCAGCAGCTTGGCCGGGGGCATTGAGGGCCAAGAGACCCAGTACTTC	CASSLAGGIEGQETQYF	TRBV5-6	TRBJ2-5
TGTGCCACCAGTGACCCCGCCAACTACGAGCAGTACTTC	CATSDPANYEQYF	TRBV24-1	TRBJ2-7
TGTGCCAGCAGCTATCATACTAGCGGGAGACCCTACGAGCAGTACTTC	CASSYHTSGRPYEQYF	TRBV5-8	TRBJ2-7
TGCATCAGACTAGCGGGAGTTGGCTACACCTTC	CIRLAGVGYTF	TRBV20-1	TRBJ1-2
TGTGCCATCAGTTGGGGCGCTGAAGCTTTCTTT	CAISWGAEAFF	TRBV10-3	TRBJ1-1
TGTGCCAGCAAGCAGGAGGGGGCAAGCTACGAGCAGTACTTC	CASKQEGASYEQYF	TRBV11-2	TRBJ2-7
TGCAGCGTTGCGGCCGCCGGACAGGAAGACGAGCAGTACTTC	CSVAAAGQEDEQYF	TRBV29-1	TRBJ2-7
TGCAGTGCTAGTCCGACAGGGGTGGCGTTTAGGAACTATGGCTACACCTTC	CSASPTGVAFRNYGYTF	TRBV20-1	TRBJ1-2
TGTGCCAGCAGCTGTCTAGCGGCCCCTTACAATGAGCAGTTCTTC	CASSCLAAPYNEQFF	TRBV7-8	TRBJ2-1
TGCGCCAGCAGCCACTCAAGCCCCAACACCGGGGAGCTGTTTTTT	CASSHSSPNTGELFF	TRBV5-1	TRBJ2-2
TGTGCCGACAGGTGGGACAGCTATGGCTACACCTTC	CADRWDSYGYTF	TRBV24-1	TRBJ1-2
TGTGCCAGCTCACCAACTCGGTCTACTCCCTACGAGCAGTACTTC	CASSPTRSTPYEQYF	TRBV18	TRBJ2-7
TGTGCCAGCAGCTTAGTTTCCGGACAGGGGGGGGAAGAGACCCAGTACTTC	CASSLVSGQGGEETQYF	TRBV7-8	TRBJ2-5
TGTGCCAGCAGTTACTCGACTCATGGAAACACCATATATTTT	CASSYSTHGNTIYF	TRBV6-6	TRBJ1-3
TGCGCCAGCAGCGTTATGAGCTCCGACTGGAGCCCCTACGAGCAGTACTTC	CASSVMSSDWSPYEQYF	TRBV5-1	TRBJ2-7
TGCAGTGCTTCCACATCGACAGGGGGCACTAATGAAAAACTGTTTTTT	CSASTSTGGTNEKLFF	TRBV20-1	TRBJ1-4
TGTGCCAGCAGCTATCCAGGGCGGCCAGCTGGCTACACCTTC	CASSYPGRPAGYTF	TRBV5-5	TRBJ1-2
TGTGCCAGCAGTGTGACTAGCGGGGATAGGTTCTTC	CASSVTSGDRFF	TRBV12-3	TRBJ2-1
TGCAGTGCAAGACTAGCGGGCAATGAGCAGTTCTTC	CSARLAGNEQFF	TRBV20-1	TRBJ2-1
TGTGCCAGCAGTTTAGCTACAGGACCGGTGCCCCAGCATTTT	CASSLATGPVPQHF	TRBV12-3	TRBJ1-5
TGCGCCAGCAGTGACTCCTCCAGTAAAGAGGGGACGGCTAGCACAGATACGCAGTATTTT	CASSDSSSKEGTASTDTQYF	TRBV10-1	TRBJ2-3
TGCGCCAGCAGCTTCGGGGGCCTGGGCTCTGGAAACACCATATATTTT	CASSFGGLGSGNTIYF	TRBV5-1	TRBJ1-3
TGTGCCAGCAGCCACGCAGGTCACAATGAGCAGTTCTTC	CASSHAGHNEQFF	TRBV14	TRBJ2-1
TGTGCCAGCAGCTTAGGGGGGGGTAGTAACTTCTACAATGAGCAGTTCTTC	CASSLGGGSNFYNEQFF	TRBV7-2	TRBJ2-1
TGTGCCAGCATAAGGGCACCCTTTGAAAAACTGTTTTTT	CASIRAPFEKLFF	TRBV14	TRBJ1-4
TGTGCCAGCAGTTATAAAGGGGGCCGGGAGGGCTACACCTTC	CASSYKGGREGYTF	TRBV6-3	TRBJ1-2
TGTGCCAGCAGTCCTCGCTCTGGGGCCAACGTCCTGACTTTC	CASSPRSGANVLTF	TRBV6-2	TRBJ2-6
TGTGCCATCAGAGCTTTACAGTCGGAAAAACTGTTTTTT	CAIRALQSEKLFF	TRBV10-3	TRBJ1-4
TGTGCCAGCAGCTCCACAAAAAACGCCTACGAGCAGTACTTC	CASSSTKNAYEQYF	TRBV11-3	TRBJ2-7
TGTGCCAGTAGTATAGTTTGGGAAACCGGATACAATGAGCAGTTCTTC	CASSIVWETGYNEQFF	TRBV19	TRBJ2-1
TGTGCCAGCAGTTTTGGGGACAGGGAGTCTAGCAATCAGCCCCAGCATTTT	CASSFGDRESSNQPQHF	TRBV28	TRBJ1-5
TGCAGTCGGCCCGGTGACAGGGGGGGCACCGGGGAGCTGTTTTTT	CSRPGDRGGTGELFF	TRBV20-1	TRBJ2-2
TGTGCCAGCAGCGTTGTTACGTATGGACAGGGGTTCTCCTACGAGCAGTACTTC	CASSVVTYGQGFSYEQYF	TRBV9	TRBJ2-7
TGCAGTGCTAGTGGTCGACTTGAGGTGGAGCAGTACTTC	CSASGRLEVEQYF	TRBV20-1	TRBJ2-7
TGTGCCAGCAGCGGGGGCCCAGAGACCCAGTACTTC	CASSGGPETQYF	TRBV7-3	TRBJ2-5
TGTGCCAGCAGCAAGGGGGGGCCAGATACGCAGTATTTT	CASSKGGPDTQYF	TRBV6-8	TRBJ2-3
TGTGCCAGCAGACCTACACTGGACGGCTATTCACCCCTCCACTTT	CASRPTLDGYSPLHF	TRBV7-3	TRBJ1-6
TGTGCTAGTGGTTCCCTAGACAGGATACAAGCTAACTATGGCTACACCTTC	CASGSLDRIQANYGYTF	TRBV12-5	TRBJ1-2
TGTGCCTGGACCTCCCGGGACAGGGCCGGGGTAGGCACAGATACGCAGTATTTT	CAWTSRDRAGVGTDTQYF	TRBV30	TRBJ2-3
TGTGCCAGCAGCTGGGGGCCGGACTTAAACACCGGGGAGCTGTTTTTT	CASSWGPDLNTGELFF	TRBV5-6	TRBJ2-2
TGTGCCAGCAGTTACCAAGGGACAGGACCCTACGAGCAGTACTTC	CASSYQGTGPYEQYF	TRBV6-5	TRBJ2-7
TGCGCCAGCAGCTTCACCGAGGGGGCCCAATATAGCAATCAGCCCCAGCATTTT	CASSFTEGAQYSNQPQHF	TRBV5-1	TRBJ1-5
TGCGCAGGGACACCCACTGAAGCTTTCTTT	CAGTPTEAFF	TRBV20-1	TRBJ1-1
TGTGCCACCCCACTAGCGGGAGCTGATACGCAGTATTTT	CATPLAGADTQYF	TRBV24-1	TRBJ2-3
TGTGCCAGCAGTGACGTAGGTCCGATGAACACTGAAGCTTTCTTT	CASSDVGPMNTEAFF	TRBV6-4	TRBJ1-1
TGTGCCAGCAGTTACTCTACAGAGAGGGGGGGCTACACCTTC	CASSYSTERGGYTF	TRBV6-5	TRBJ1-2
TGTGCCAGCAGTGAAAGGAGCGGGACCCCGGTTCAACATCAGCCCCAGCATTTT	CASSERSGTPVQHQPQHF	TRBV25-1	TRBJ1-5
TGCGCCAGCAGCGTGCCCAAAGGCGATTCCCGAGGGCCGGACGAGCAGTACTTC	CASSVPKGDSRGPDEQYF	TRBV5-1	TRBJ2-7
TGCGCCAGCAGCTTGAGGGCCCAGGACAATGAGCAGTTCTTC	CASSLRAQDNEQFF	TRBV5-1	TRBJ2-1
TGTGCCAGCAGTTCCCTGACGCGGGGGGGCCGGTACACAGATACGCAGTATTTT	CASSSLTRGGRYTDTQYF	TRBV27	TRBJ2-3
TGTGCCAGCAGCCATATGTATCGCCCCGGGAGGAGGAACCTTCGCACGGGCTACACCTTC	CASSHMYRPGRRNLRTGYTF	TRBV5-6	TRBJ1-2
TGTGCCAGCAGCCGAGGACCGGGACAGGGAAACAATGAGCAGTTCTTC	CASSRGPGQGNNEQFF	TRBV7-4	TRBJ2-1
TGTGCCAGCAGCTTAGCCTTCCCTGTGTATACGCAGTATTTT	CASSLAFPVYTQYF	TRBV7-6	TRBJ2-3
TGTGCCAGCAGCCACGACAGGGGGAGGGTTGGCTACACCTTC	CASSHDRGRVGYTF	TRBV7-9	TRBJ1-2
TGTGCCAGCATTACTAGCGGGAGAGGTTCGTCTGGGGCCAACGTCCTGACTTTC	CASITSGRGSSGANVLTF	TRBV6-3	TRBJ2-6
TGTGCCAGCAGTTTATCCCGGGAGTCTGACAGAGAATCAAATGAGCAGTTCTTC	CASSLSRESDRESNEQFF	TRBV27	TRBJ2-1
TGTGCCAGCAGCCCCGACAGGTTAAGCACAGATACGCAGTATTTT	CASSPDRLSTDTQYF	TRBV13	TRBJ2-3
TGTGCCAGCAGCCTCGGGGCCGAGACCCAGTACTTC	CASSLGAETQYF	TRBV6-4	TRBJ2-5
TGTGCCAGCAGCTTTGGGGGTTGGCCGCCACTCGAGCAGTACTTC	CASSFGGWPPLEQYF	TRBV7-4	TRBJ2-7
TGTGCCAGCAGCCAAGATCCGGGACAGGGGAGGACCGGGGAGCTGTTTTTT	CASSQDPGQGRTGELFF	TRBV3-1	TRBJ2-2
TGTGCCAGCAGCCTCCCAGACAGTGCGGTCACAGATACGCAGTATTTT	CASSLPDSAVTDTQYF	TRBV7-9	TRBJ2-3
TGTGCCAGCAGCGTTTCCGGGGCACGACGCGCGAACACCGGGGAGCTGTTTTTT	CASSVSGARRANTGELFF	TRBV7-2	TRBJ2-2
TGTGCCAGCAGCGGAGTACAAAGTTCTTCGCTAGCCATAGGCTACACCTTC	CASSGVQSSSLAIGYTF	TRBV11-2	TRBJ1-2
TGTGCCAGCAGCCAAGAGATGGACAGGGGAAACCTGCTTGAGCAGTTCTTC	CASSQEMDRGNLLEQFF	TRBV3-1	TRBJ2-1
TGTGCCAGCACCAAAGGGGGACTAGCGGGTTTAGATCCGAGTGAGCAGTTCTTC	CASTKGGLAGLDPSEQFF	TRBV6-2	TRBJ2-1
TGTGCCAGCAGCCAAGATTCCCGACAGGGGGTATGGTCCTATGGCTACACCTTC	CASSQDSRQGVWSYGYTF	TRBV14	TRBJ1-2
TGTGCCAGCAGCTGGCGGGACAGGGTCTACGAGCAGTACTTC	CASSWRDRVYEQYF	TRBV11-3	TRBJ2-7
TGTGCCAGCATCAGACAGGGGCAGGATGTGCAGTTCTTC	CASIRQGQDVQFF	TRBV5-8	TRBJ2-1
TGCGCCAGCAGCCATGGGGGCAATCAGCCCCAGCATTTT	CASSHGGNQPQHF	TRBV5-1	TRBJ1-5
TGTGCCAGCAGCTTGGACAGCCAGGGGGTGGGGTCTAATCAGCCCCAGCATTTT	CASSLDSQGVGSNQPQHF	TRBV5-4	TRBJ1-5
TGCGCCAGCAGCCTAGGCCCAAACAATGAGCAGTTCTTC	CASSLGPNNEQFF	TRBV10-1	TRBJ2-1
TGTGCCAGGCTTGGGGCAAATCAGCCCCAGCATTTT	CARLGANQPQHF	TRBV2	TRBJ1-5
TGTGCCAGCAGCTTAGCTTCCAGACAGAAACGCTCTGAAGCTTTCTTT	CASSLASRQKRSEAFF	TRBV11-2	TRBJ1-1
TGTGCCAGCAGCACTCCCCCTGGGCCCGAGCAGTACTTC	CASSTPPGPEQYF	TRBV11-2	TRBJ2-7
TGCGCCAGGATCTTCCTGGGACTAGCGGGGAAGGAGACCCAGTACTTC	CARIFLGLAGKETQYF	TRBV10-1	TRBJ2-5
TGTGCCAGCAGCTTGAGGAGGGCCGGCAATACGCAGTATTTT	CASSLRRAGNTQYF	TRBV5-6	TRBJ2-3
TGTGCCAGCAGTTTAGGGGGGCAGGGGACCGAGCAGTACTTC	CASSLGGQGTEQYF	TRBV28	TRBJ2-7
TGTGCCAGCAGCCGAGCCCGGGGGAGGACAGGCTACAATGAGCAGTTCTTC	CASSRARGRTGYNEQFF	TRBV7-3	TRBJ2-1
TGTGCCAGCACCCTGGGACTAGAGGCCTACGAGCAGTACTTC	CASTLGLEAYEQYF	TRBV6-4	TRBJ2-7
TGTGCCAGCAGCTTGGAGAGGACAGGGAGCTCCTATAATTCACCCCTCCACTTT	CASSLERTGSSYNSPLHF	TRBV5-6	TRBJ1-6
TGCGCCAGCAGTGAGGTAGCGGGGGACCCCTACAATGAGCAGTTCTTC	CASSEVAGDPYNEQFF	TRBV10-1	TRBJ2-1
TGTGCCAGCTCACCACCGCCAGGTAGACAGGGGCCTTGTCAGCCCCAGCATTTT	CASSPPPGRQGPCQPQHF	TRBV18	TRBJ1-5
TGTGCCAGCAGCCAAAAGGAGTCTCTGGGGAGCTCTGGAAACACCATATATTTT	CASSQKESLGSSGNTIYF	TRBV13	TRBJ1-3
TGTGCCAGCAGTTTATCGGCTAGCGGGGGCTCCTACGAGCAGTACTTC	CASSLSASGGSYEQYF	TRBV27	TRBJ2-7
TGCGCCAGCAGCCAAGACGAAGGAAGGGGGCTCAGCGGTTCCTACGAGCAGTACTTC	CASSQDEGRGLSGSYEQYF	TRBV4-3	TRBJ2-7
TGTGCCAGCAGTCCGGGTACCTGGGACCAAGAGACCCAGTACTTC	CASSPGTWDQETQYF	TRBV27	TRBJ2-5
TGCAGTGCTAGTGGTAGCGGGGAACAAGAGACCCAGTACTTC	CSASGSGEQETQYF	TRBV20-1	TRBJ2-5
TGCGCCAGCAGCTTGCTCCACCCCAGATACACTGAAGCTTTCTTT	CASSLLHPRYTEAFF	TRBV5-1	TRBJ1-1
TGTGCCAGCACCGGGCGGGGGGTTGTCTCCCCCTATAATTCACCCCTCCACTTT	CASTGRGVVSPYNSPLHF	TRBV6-5	TRBJ1-6
TGCAGTGCTAAAAGTAGCGCTTACGAGCAGTACTTC	CSAKSSAYEQYF	TRBV20-1	TRBJ2-7
TGCGCCAGCAGCCATGTCGGCCAGGGTTATTTAGGCAGGCAGTTCTTC	CASSHVGQGYLGRQFF	TRBV4-1	TRBJ2-1
TGTGCCAGCAGCTTAGGCGGCGGCGGTCTATGTTCCTACGAGCAGTACTTC	CASSLGGGGLCSYEQYF	TRBV11-2	TRBJ2-7
TGTGCCACCCCCGCTGTCAGGTACTTC	CATPAVRYF	TRBV24-1	TRBJ2-4
TGCAGCGTTGGTCCCGTCAGGGACCCTGATCAGCCCCAGCATTTT	CSVGPVRDPDQPQHF	TRBV29-1	TRBJ1-5
TGTGCCAGCAGGTGGACAGGGTTAACTAATGAAAAACTGTTTTTT	CASRWTGLTNEKLFF	TRBV3-1	TRBJ1-4
TGCAGCGTTATTCCGTCTAACGCGTATGGCTACACCTTC	CSVIPSNAYGYTF	TRBV29-1	TRBJ1-2
TGTGCCAGCAGGAGCGGCCTGAGGGCAGATACGCAGTATTTT	CASRSGLRADTQYF	TRBV6-1	TRBJ2-3
TGTGCCATTGAACGACCACAGCCCCAGCATTTT	CAIERPQPQHF	TRBV18	TRBJ1-5
TGTGCCAGCAGAAGGGGGAGTTTCGATCAGCCCCAGCATTTT	CASRRGSFDQPQHF	TRBV28	TRBJ1-5
TGTGCCAGCAGCCAAGGCCCTGGGGCCAACGTCCTGACTTTC	CASSQGPGANVLTF	TRBV14	TRBJ2-6
TGTGCCAGCAGCCCACAGGGTGTTTTTCTTAAGCAAGAGACCCAGTACTTC	CASSPQGVFLKQETQYF	TRBV6-5	TRBJ2-5
TGCGCCAGCAGTGAACTAGCGGGAGGATTCACAGATACGCAGTATTTT	CASSELAGGFTDTQYF	TRBV10-1	TRBJ2-3
TGTGCCATCAGACATGGGGGCGCGGCCGCCTACGAGCAGTACTTC	CAIRHGGAAAYEQYF	TRBV10-3	TRBJ2-7
TGTGCCAGCAGTGAATTTAGGACTAGCACAGATACGCAGTATTTT	CASSEFRTSTDTQYF	TRBV25-1	TRBJ2-3
TGTGCCAGCAGCTCCCCAGGGGGGACTGAAGCTTTCTTT	CASSSPGGTEAFF	TRBV5-6	TRBJ1-1
TGTGCCAGCGAGGGACAGGGGGTTTACCTGAACACTGAAGCTTTCTTT	CASEGQGVYLNTEAFF	TRBV5-4	TRBJ1-1
TGTGCCAGGTCGTCAGACTCCGGGGACAGGAACAATGAGCAGTTCTTC	CARSSDSGDRNNEQFF	TRBV27	TRBJ2-1
TGTGCCAGCAGTTACACGCAAGTGGGGAGAAAGGATAGCAATCAGCCCCAGCATTTT	CASSYTQVGRKDSNQPQHF	TRBV6-5	TRBJ1-5
TGTGCCAGACCTCTAGGGGACAGGGGGGCCAATCAGCCCCAGCATTTT	CARPLGDRGANQPQHF	TRBV2	TRBJ1-5
TGCAGTGACCCTTCCAAGGACAGATCGGACTCCGCAACTAATGAAAAACTGTTTTTT	CSDPSKDRSDSATNEKLFF	TRBV20-1	TRBJ1-4
TGTGCCATCAGTGAGTCGACTGGAGGTTTACTTAACACTGAAGCTTTCTTT	CAISESTGGLLNTEAFF	TRBV10-3	TRBJ1-1
TGTGCCAGCAGTCTGGCAGGGAACTATGGCTACACCTTC	CASSLAGNYGYTF	TRBV27	TRBJ1-2
TGCGCCAGCATCTGCCAGGGTAAAGAAGGAATTGATCAGCCCCAGCATTTT	CASICQGKEGIDQPQHF	TRBV10-1	TRBJ1-5
TGTGCCAGCAGCAGGATCAAAAACATTCAGTACTTC	CASSRIKNIQYF	TRBV9	TRBJ2-4
TGTGCCACCAGCCCCAACAGCCGGGGAAGTGGGGGTACAGATACGCAGTATTTT	CATSPNSRGSGGTDTQYF	TRBV24-1	TRBJ2-3
TGTGCCAGCAGCGTAGGAGGGGGGGGTAGCAATCAGCCCCAGCATTTT	CASSVGGGGSNQPQHF	TRBV9	TRBJ1-5
TGTGCCAGCAGGCCAGCTCTACACGGGACTAGCTCCTACGAGCAGTACTTC	CASRPALHGTSSYEQYF	TRBV7-2	TRBJ2-7
TGTGCCAGCAGCTTAACCATGACAGGGTGTTGTCTCACCGGGGAGCTGTTTTTT	CASSLTMTGCCLTGELFF	TRBV7-3	TRBJ2-2
TGCAGTGCTAGCAAGGGGGCGAACACTGAAGCTTTCTTT	CSASKGANTEAFF	TRBV20-1	TRBJ1-1
TGTGCCAGCAGCTTAGCCGAGTCCGGACCGAGGCCGAACAATGAGCAGTTCTTC	CASSLAESGPRPNNEQFF	TRBV7-9	TRBJ2-1
TGTGCCAGCGGAACAGGACGGTACGAGCAGTACTTC	CASGTGRYEQYF	TRBV7-9	TRBJ2-7
TGTGCCAGCAAGCCACTTGGACAGGGGGGAGACTCTGGGGCCAACGTCCTGACTTTC	CASKPLGQGGDSGANVLTF	TRBV14	TRBJ2-6
TGTGCCAGTTTGACTAGTCGAGCTCCAGAGACCCAGTACTTC	CASLTSRAPETQYF	TRBV19	TRBJ2-5
TGTGCCAGCAGCTTAGATATTGGTCGGTCCTCGGGTCCTGAGCTGAGAGAGACCCAGTACTTC	CASSLDIGRSSGPELRETQYF	TRBV11-3	TRBJ2-5
TGTGCCAGCAGCTTAGGCCCGCTAACCCCGGGGGAGACCCAGTACTTC	CASSLGPLTPGETQYF	TRBV11-3	TRBJ2-5
TGTGCCAGCACCGGGACTGGGAGCTCCTATAATTCACCCCTCCACTTT	CASTGTGSSYNSPLHF	TRBV6-1	TRBJ1-6
TGTGCCAGCAGCGTCCCCAGGGTGCATGAAAAACTGTTTTTT	CASSVPRVHEKLFF	TRBV7-3	TRBJ1-4
TGTGCCAGCAGTTACCCGAGGGGGACAGGGGCTGAAGCTTTCTTT	CASSYPRGTGAEAFF	TRBV6-5	TRBJ1-1
TGTGCCAGCAGCCACCGTGGACGCGGGAGGGAGGGCCCCCCGTATTTT	CASSHRGRGREGPPYF	TRBV14	TRBJ2-3
TGTGCCAGCAGCTTCGATAGTGGGCCCTCGACTAAAAATGAGCAGTTCTTC	CASSFDSGPSTKNEQFF	TRBV7-9	TRBJ2-1
TGCAGTGCTAGAGGGCCCCCTGGCCCCAGCTACGAGCAGTACTTC	CSARGPPGPSYEQYF	TRBV20-1	TRBJ2-7
TGTGCGACCGGGGGGGCCTACCCCGAGCAGTACTTC	CATGGAYPEQYF	TRBV6-2	TRBJ2-7
TGTGCCAGCAGTCGACAGGTTTCCTACTATGGCTACACCTTC	CASSRQVSYYGYTF	TRBV27	TRBJ1-2
TGCGCCAGCGGAATCCGGGACTCTGGGGCCAACGTCCTGACTTTC	CASGIRDSGANVLTF	TRBV10-1	TRBJ2-6
TGTGCCAGCATAAGAGATTTTGAGACCCAGTACTTC	CASIRDFETQYF	TRBV7-3	TRBJ2-5
TGTGCCAGCAGTCCCCCGGACAGGGATCCCTACAATGAGCAGTTCTTC	CASSPPDRDPYNEQFF	TRBV6-3	TRBJ2-1
TGTGCCAGCAGCCTTAGGGGCAGGTCCTACGAGCAGTACTTC	CASSLRGRSYEQYF	TRBV13	TRBJ2-7
TGTGCCAGCAGTGACTCGAACGCGGCCCGCCGGCCAGGGGATCAGCCCCAGCATTTT	CASSDSNAARRPGDQPQHF	TRBV6-4	TRBJ1-5
TGTGCCAGCAGCGTAGCGGTCCTAAGGGTTAACATTCAGTACTTC	CASSVAVLRVNIQYF	TRBV9	TRBJ2-4
TGTGCCAGCGTGGGACAGGACTCTGGAAACACCATATATTTT	CASVGQDSGNTIYF	TRBV7-3	TRBJ1-3
TGTGCCAGCAGTAAGGGCCCTCATAGGAATACGCAGTATTTT	CASSKGPHRNTQYF	TRBV6-8	TRBJ2-3
TGTGCCAGCAGCTTGGCCAAACTCGGTGGGGGGGCCGGAGCCACAGATACGCAGTATTTT	CASSLAKLGGGAGATDTQYF	TRBV5-6	TRBJ2-3
TGCGCCAGCAGTGACGGAACTAGTTACAATGAGCAGTTCTTC	CASSDGTSYNEQFF	TRBV10-1	TRBJ2-1
TGTGCCAGCAGCGCCGGGCGACAGGGGGGGGACTACGAGCAGTACTTC	CASSAGRQGGDYEQYF	TRBV7-3	TRBJ2-7
TGTGCCTGGCGTTCCTACAGGGGGCGAAGGCCCTATGGCTACACCTTC	CAWRSYRGRRPYGYTF	TRBV30	TRBJ1-2
TGTGCCAGCAGCTTCCTTAGCATACGGGGGCTCCAGTGTGCGCCAGAGACCCAGTACTTC	CASSFLSIRGLQCAPETQYF	TRBV5-6	TRBJ2-5
TGTGCCAGCAGTGACCGTGACTCGGTTGGCACTGAAGCTTTCTTT	CASSDRDSVGTEAFF	TRBV6-4	TRBJ1-1
TGTGCTAGTGGTTACTTGGGACTAGTCATGGGCTACGAGCAGTACTTC	CASGYLGLVMGYEQYF	TRBV12-5	TRBJ2-7
TGTGCCTGCGAGATGAATGAGCAGTTCTTC	CACEMNEQFF	TRBV9	TRBJ2-1
TGTGCCAGCCTTCACGGCAGGGGACTTTACGAGCAGTACTTC	CASLHGRGLYEQYF	TRBV11-1	TRBJ2-7
TGCAGTGCTAGAGATCTGTGTCCTAGCGGGGGGGGCGCAGATACGCAGTATTTT	CSARDLCPSGGGADTQYF	TRBV20-1	TRBJ2-3
TGCGCCAGCACCGAACAAGAGACCCAGTACTTC	CASTEQETQYF	TRBV4-3	TRBJ2-5
TGTGCCACCCTCACCCAGGGCGTTACTGAAGCTTTCTTT	CATLTQGVTEAFF	TRBV24-1	TRBJ1-1
TGTATGGGTCAGATTGCTGAAGCTTTCTTT	CMGQIAEAFF	TRBV19	TRBJ1-1
TGTGCCAGCAGCCACCCTAGGTGGTACGAGCAGTACTTC	CASSHPRWYEQYF	TRBV11-1	TRBJ2-7
TGCGCCAGCTCGACAGGGGGCACTGAAGCTTTCTTT	CASSTGGTEAFF	TRBV10-2	TRBJ1-1
TGTGCCAGCAGGACTAGCGGGTGGAGGCGCTACGAGCAGTACTTC	CASRTSGWRRYEQYF	TRBV7-3	TRBJ2-7
TGCAGTGCGGTTGCGGTGACAGGGAATAGCAATCAGCCCCAGCATTTT	CSAVAVTGNSNQPQHF	TRBV20-1	TRBJ1-5
TGTGCCAGCAGTTACCTGGCTACGGGCCAGGGGCCCCACTCCTACGAGCAGTACTTC	CASSYLATGQGPHSYEQYF	TRBV6-6	TRBJ2-7
TGTGCCACCAGTGAGAACCCTCAGGGGGTTACCTCCTACGAGCAGTACTTC	CATSENPQGVTSYEQYF	TRBV24-1	TRBJ2-7
TGTGCCAGCAGCTATAAAGGACCCACCGGGACAGGCAGGCACAATGAGCAGTTCTTC	CASSYKGPTGTGRHNEQFF	TRBV5-4	TRBJ2-1
TGTGCCAGCAGCCGCCCGGGCATCAGTAGCTTTTACGAGCAGTACTTC	CASSRPGISSFYEQYF	TRBV7-4	TRBJ2-7
TGTGCCAGCAGCCAAGACTCCCCGCACTCCTTTCGGACTAGCGGGGGCTACGAGCAGTACTTC	CASSQDSPHSFRTSGGYEQYF	TRBV4-2	TRBJ2-7
TGCAGCGTTCCCACAGGGGGATCTGGAAACACCATATATTTT	CSVPTGGSGNTIYF	TRBV29-1	TRBJ1-3
TGCAGTGCTAGAGACCGGTGGGGGGGGCCTGCGGCCTACGAGCAGTACTTC	CSARDRWGGPAAYEQYF	TRBV20-1	TRBJ2-7
TGCGCCAGCAGCTTGTTCGGAGGAACCAAGCAGTACTTC	CASSLFGGTKQYF	TRBV5-1	TRBJ2-7
TGTCCTGAGACGTCTGGCTACACCTTC	CPETSGYTF	TRBV7-9	TRBJ1-2
TGTGCCAGCAGTTTATTGTACGGGAACACCGGGGAGCTGTTTTTT	CASSLLYGNTGELFF	TRBV28	TRBJ2-2
TGTGCCAGCAGCCTCCAGCGGTCCGGGGAGCAGTTCTTC	CASSLQRSGEQFF	TRBV7-9	TRBJ2-1
TGCAGCGTTGAAGACCCCCGACAGAGGGTTATAATGAACACTGAAGCTTTCTTT	CSVEDPRQRVIMNTEAFF	TRBV29-1	TRBJ1-1
TGTGCCAGCAGTGAGGACAGGTGTTTGGTCGAAGAGACCCAGTACTTC	CASSEDRCLVEETQYF	TRBV6-4	TRBJ2-5
TGTGCCTGGAGTTCAACAGACTCTGCAGATACGCAGTATTTT	CAWSSTDSADTQYF	TRBV30	TRBJ2-3
TGCGCCAGCAGCCTACGACAAAGTCAGCCCCAGCATTTT	CASSLRQSQPQHF	TRBV4-3	TRBJ1-5
TGTGCCAGCAGCTACCGGGCTACGACCTACGAGCAGTACTTC	CASSYRATTYEQYF	TRBV7-6	TRBJ2-7
TGTGCCAGCAGTGAAGCCCACGACAGGACATCGGATGAGCAGTTCTTC	CASSEAHDRTSDEQFF	TRBV2	TRBJ2-1
TGTGCCAGCAGTGAGACTAGCGGGACCGGGCCCTACGAGCAGTACTTC	CASSETSGTGPYEQYF	TRBV25-1	TRBJ2-7
TGTGCTAGTGGTTTGGTAAGTGGGGGTATGACTAACTATGGCTACACCTTC	CASGLVSGGMTNYGYTF	TRBV12-5	TRBJ1-2
TGCAAGTTAGCGGGAGATTCACCGAATAGACCCTACGAGCAGTACTTC	CKLAGDSPNRPYEQYF	TRBV20-1	TRBJ2-7
TGCGCCAGCAGCACGGCTAGCGGGGTAGCCAAAAACATTCAGTACTTC	CASSTASGVAKNIQYF	TRBV5-1	TRBJ2-4
TGTGCCAGCAGCTTAGCGCAGGGGGGAACCTACAATGAGCAGTTCTTC	CASSLAQGGTYNEQFF	TRBV7-6	TRBJ2-1
TGTGCCAGCAGTTACGGGGGGGGTGGTACGCAGTATTTT	CASSYGGGGTQYF	TRBV6-8	TRBJ2-3
TGTGCCACCAGCGTCTCCTTGAACAATGAGCAGTTCTTC	CATSVSLNNEQFF	TRBV24-1	TRBJ2-1
TGTGCTAGCAGCGGGACACGGAGGGGCTACACCTTC	CASSGTRRGYTF	TRBV7-7	TRBJ1-2
TGTGCCAGCAGCTTAGCCAATGTTAGGGGGCATAATTCACCCCTCCACTTT	CASSLANVRGHNSPLHF	TRBV7-9	TRBJ1-6
TGCGCCAGCAGCTTCCTGAGCTGGGGACAGCCCCAGCATTTT	CASSFLSWGQPQHF	TRBV5-1	TRBJ1-5
TGTGCCAGCAGTTTGGACAGTCGCTATGGCTACACCTTC	CASSLDSRYGYTF	TRBV28	TRBJ1-2
TGCGCCAGCAGCCGGGAGGGGGGGGTATATAGCAATCAGCCCCAGCATTTT	CASSREGGVYSNQPQHF	TRBV5-1	TRBJ1-5
TGTGCCACAGGGTCAAGCAATCAGCCCCAGCATTTT	CATGSSNQPQHF	TRBV18	TRBJ1-5
TGTGCCAGCAGCTCCTCCCGGGTTACTAGCACAGATACGCAGTATTTT	CASSSSRVTSTDTQYF	TRBV7-3	TRBJ2-3
TGTGCCAGCAGCTTGGCCGAAGGACAGGGAAGGAACACTGAAGCTTTCTTT	CASSLAEGQGRNTEAFF	TRBV5-5	TRBJ1-1
TGTGCCACCAGTGATTTGCCGACAATGCTCTACGAGCAGTACTTC	CATSDLPTMLYEQYF	TRBV24-1	TRBJ2-7
TGTGCCAGCAGCTTAACCCCTCAGACAGGGGGCAGGGGGAATGAAAAACTGTTTTTT	CASSLTPQTGGRGNEKLFF	TRBV7-3	TRBJ1-4
TGTGCCTGGGGCGACGGCCACACAGATACGCAGTATTTT	CAWGDGHTDTQYF	TRBV30	TRBJ2-3
TGTGCCAGCAGCGTAATTATTTGCGTTAGGCGTGGCTACACCTTC	CASSVIICVRRGYTF	TRBV9	TRBJ1-2
TGTGCCTGCTACGGGACTAGTATGACCCAGTACTTC	CACYGTSMTQYF	TRBV30	TRBJ2-5
TGTGCCAGCCGGAGGGGCATCACCTACAATGAGCAGTTCTTC	CASRRGITYNEQFF	TRBV7-6	TRBJ2-1
TGCGCCAGCTCTTCCGGACAGGGGTCTGAAAAACTGTTTTTT	CASSSGQGSEKLFF	TRBV10-2	TRBJ1-4
TGTGCCAGCACCTCACGGAGCAATCAGCCCCAGCATTTT	CASTSRSNQPQHF	TRBV12-4	TRBJ1-5
TGTGCCAGCAGTTTTACAGGGGACGAGCAGTACTTC	CASSFTGDEQYF	TRBV27	TRBJ2-7
TGTGCCAGCAGTGACTCTCCCCTGGGGGGCCTAGTTCCCGAGCAGTACTTC	CASSDSPLGGLVPEQYF	TRBV6-4	TRBJ2-7
TGCGCCAGCAGTTTGGGACAAGAGAACCGAAACACCATATATTTT	CASSLGQENRNTIYF	TRBV4-1	TRBJ1-3
TGTGCCAGCAGCTGGGAGGGCCGTCTTAATTCACCCCTCCACTTT	CASSWEGRLNSPLHF	TRBV3-1	TRBJ1-6
TGTGCCAGCAGCTTAGCGTCGGCGGACAGGGGGAACACTGAAGCTTTCTTT	CASSLASADRGNTEAFF	TRBV7-9	TRBJ1-1
TGTGCCAGCAGTTACTTTCCTTCGGCAAGAAACGTTGGCCGGGCGAATGATAGCAATCAGCCCCAGCATTTT	CASSYFPSARNVGRANDSNQPQHF	TRBV6-5	TRBJ1-5
TGTGCCAGCGGGGCCCAGGGCCTAGTCGACGCAGATACGCAGTATTTT	CASGAQGLVDADTQYF	TRBV5-6	TRBJ2-3
TGCGCCAGCAGTGAGTTGGAATTAGCCCGCGAAGCTTTCTTT	CASSELELAREAFF	TRBV10-1	TRBJ1-1
TGTGCCAGCAGCTATCCGACAGGGAGAAGCAATCAGCCCCAGCATTTT	CASSYPTGRSNQPQHF	TRBV5-4	TRBJ1-5
TGTGCCAGCAGGTTGCGGGAGCAGCAGTACTTC	CASRLREQQYF	TRBV12-3	TRBJ2-7
TGTGCCAGCAGCCCCCGGACATATAGCAATCAGCCCCAGCATTTT	CASSPRTYSNQPQHF	TRBV13	TRBJ1-5
TGTGCCAGCTCACCACACACAGGCAGCAATCAGCCCCAGCATTTT	CASSPHTGSNQPQHF	TRBV18	TRBJ1-5
TGCGCCAGCAGCTTGGCCCGATTGGGGGGGAATGGCTACACCTTC	CASSLARLGGNGYTF	TRBV5-1	TRBJ1-2
TGCAGCGTTGAAGATCGATGGAACGAGCAGTACTTC	CSVEDRWNEQYF	TRBV29-1	TRBJ2-7
TGTGCCAGCAGCAAGGGGGGCACAGATACGCAGTATTTT	CASSKGGTDTQYF	TRBV7-2	TRBJ2-3
TGTGCCATCAAGCAGCAATACTACGAGCAGTACTTC	CAIKQQYYEQYF	TRBV10-3	TRBJ2-7
TGCAGTGCTAGAAAGGACAGGGGGCCTGATCAAGCTTTCTTT	CSARKDRGPDQAFF	TRBV20-1	TRBJ1-1
TGTGCCAGCAGCTTAAACTCAGCTTCAGGAATTGAAAAACTGTTTTTT	CASSLNSASGIEKLFF	TRBV5-5	TRBJ1-4
TGCGCCAGCAGGGTAGGAACTATCACCGGGGAGCTGTTTTTT	CASRVGTITGELFF	TRBV10-1	TRBJ2-2
TGCGCCAGCAGCTCTCGCCGGACAGTCCGCAATCAGCCCCAGCATTTT	CASSSRRTVRNQPQHF	TRBV5-1	TRBJ1-5
TGTGCCAGCAGCTATCGGGGGGCATCCTACAATGAGCAGTTCTTC	CASSYRGASYNEQFF	TRBV7-2	TRBJ2-1
TGTGCCAGCAGCGACACTAGCACAGATACGCAGTATTTT	CASSDTSTDTQYF	TRBV11-3	TRBJ2-3
TGTGCCAGCGAACCGGGGGGGGGCACAGATACGCAGTATTTT	CASEPGGGTDTQYF	TRBV7-3	TRBJ2-3
TGCGCCAGCAGCTTGGTTAGGGGGACGGAAGTAGCCAAAAACATTCAGTACTTC	CASSLVRGTEVAKNIQYF	TRBV5-1	TRBJ2-4
TGCGCCAGCAGAAGTAGTCCCTGGGAGGGTTACAATGAGCAGTTCTTC	CASRSSPWEGYNEQFF	TRBV10-1	TRBJ2-1
TGTGCCAAAGGGCATCCCAACACTGAAGCTTTCTTT	CAKGHPNTEAFF	TRBV13	TRBJ1-1
TGTGCCACCCCCACTAGCGGGAGACGCACAGATACGCAGTATTTT	CATPTSGRRTDTQYF	TRBV27	TRBJ2-3
TGCGCCAGCAAAGGGGGGAAAACCGGGGAGCTGTTTTTT	CASKGGKTGELFF	TRBV5-1	TRBJ2-2
TGTGCCAGTAGTATTCGTGACGCAAATTCACCCCTCCACTTT	CASSIRDANSPLHF	TRBV19	TRBJ1-6
TGTGCCAGCAGCTCATTGCGGGGACGGGGGATCCCAGATACGCAGTATTTT	CASSSLRGRGIPDTQYF	TRBV7-3	TRBJ2-3
TGTGCCAGCAGTTTGGGACAGGGCTTTGGCTACGAGCAGTACTTC	CASSLGQGFGYEQYF	TRBV12-3	TRBJ2-7
TGTGCCACCAGGACCGGACAGACCTACAATGAGCAGTTCTTC	CATRTGQTYNEQFF	TRBV24-1	TRBJ2-1
TGTGCCACCGGGGGGAATCAGCCCCAGCATTTT	CATGGNQPQHF	TRBV13	TRBJ1-5
TGTGCCAGCAAGGGACTACATAACTATGGCTACACCTTC	CASKGLHNYGYTF	TRBV6-4	TRBJ1-2
TGTGCCAGCAGCCGCCCAGGTCAGGGGGCCTTC	CASSRPGQGAF	TRBV6-6	TRBJ1-2
TGTGCCAGCACAGGGGGGAGACCAACTAATGAAAAACTGTTTTTT	CASTGGRPTNEKLFF	TRBV3-1	TRBJ1-4
TGTGCCAGCAGTTACTCAAACATAGCGGGTGAGGACGAGCAGTACTTC	CASSYSNIAGEDEQYF	TRBV6-6	TRBJ2-7
TGTGCCAGCAAAAGCAGGGGGACAGGTGACTCTGGGGCCAACGTCCTGACTTTC	CASKSRGTGDSGANVLTF	TRBV27	TRBJ2-6
TGCGCCAGCAGCCAGGGACTCTACGAGCAGTACTTC	CASSQGLYEQYF	TRBV4-3	TRBJ2-7
TGTGCCAGCAGCGGTTGCACTAGCGGGTATGAGCAGTTCTTC	CASSGCTSGYEQFF	TRBV13	TRBJ2-1
TGCGCCAGCAGCCAAGCCCCGCGTGGGGAAGGCACAGATACGCAGTATTTT	CASSQAPRGEGTDTQYF	TRBV4-3	TRBJ2-3
TGTGCCAGCAGCCTCGGGGAGACCGGGGAGCTGTTTTTT	CASSLGETGELFF	TRBV13	TRBJ2-2
TGTGCCAGCAGCCCAGGGGCGCGAAGGGTCGAGCAGTACTTC	CASSPGARRVEQYF	TRBV6-1	TRBJ2-7
TGTGACCGCCCTAGGGGGTCCAGTCTGGTTCTGAACACTGAAGCTTTCTTT	CDRPRGSSLVLNTEAFF	TRBV2	TRBJ1-1
TGTGCCAGCAGCTTAGATAATAGGAAGGGCTCCGAGCAGTACTTC	CASSLDNRKGSEQYF	TRBV11-2	TRBJ2-7
TGTGCCAGCAGTGAAGCGCCAGAGCATCAGCCCCAGCATTTT	CASSEAPEHQPQHF	TRBV6-1	TRBJ1-5
TGTGCCAGCGAAAATGGACAGGGGGAGGGCGAGCAGTACTTC	CASENGQGEGEQYF	TRBV9	TRBJ2-7
TGCAGTGCTAGGCCCAGGGGGGGCCAAGAGACCCAGTACTTC	CSARPRGGQETQYF	TRBV20-1	TRBJ2-5
TGTGCCAGCAGCAGGGTTAACGTGGCCCTCCACTTT	CASSRVNVALHF	TRBV13	TRBJ1-6
TGTGCCAGATATCGAGCAGGGCAGACCTTT	CARYRAGQTF	TRBV2	TRBJ1-1
TGTGCCAGCAGCTTGTGGGGGGCCTCGGAGACCCAGTACTTC	CASSLWGASETQYF	TRBV7-2	TRBJ2-5
TGTGCCTGGACCCGGGATGTAGGGCAGTACTTC	CAWTRDVGQYF	TRBV30	TRBJ2-7
TGTGCCAGCGGACCATTCTCTGGAAACACCATATATTTT	CASGPFSGNTIYF	TRBV7-2	TRBJ1-3
TGTGCCACCAGTGATACGTTCAGTTCGTATGGCTACACCTTC	CATSDTFSSYGYTF	TRBV24-1	TRBJ1-2
TGCGCCAGCAGCCAAGGGGTCCTACGGCCGAACACTGAAGCTTTCTTT	CASSQGVLRPNTEAFF	TRBV4-1	TRBJ1-1
TGTGCCAGCAGCTTAGCAGGGATCGAGCAGTACTTC	CASSLAGIEQYF	TRBV7-2	TRBJ2-7
TGCGCCAGCAGCCCGAGACAGTTCCCTGAAGCTTTCTTT	CASSPRQFPEAFF	TRBV4-1	TRBJ1-1
TGCAGTGCTAGAGATCTGGGGGGACATAGCCATGAGCAGTTCTTC	CSARDLGGHSHEQFF	TRBV20-1	TRBJ2-1
TGTGCCACCAGTGAACTCCTGGGGTCGAACACTGAAGCTTTCTTT	CATSELLGSNTEAFF	TRBV24-1	TRBJ1-1
TGCGCCAGCAGCTTGGGGATAAGCGGGACCATAAACATTCAGTACTTC	CASSLGISGTINIQYF	TRBV5-1	TRBJ2-4
TGTGCCATTAGCTTGCATTTCCGGGACAGGGCGAATTCACCCCTCCACTTT	CAISLHFRDRANSPLHF	TRBV13	TRBJ1-6
TGCAGTGCTAGAGATCTCGGACAGGGGACGCTCAATCAGCCCCAGCATTTT	CSARDLGQGTLNQPQHF	TRBV20-1	TRBJ1-5
TGTGCCAGCAGCGCGGGAGCCGCGATGGAGCCGAATGAAAAACTGTTTTTT	CASSAGAAMEPNEKLFF	TRBV7-2	TRBJ1-4
TGCGCCAGCGAGACAGGGCAGTCAGGGGAATGCGCAACTAATGAAAAACTGTTTTTT	CASETGQSGECATNEKLFF	TRBV4-3	TRBJ1-4
TGTGCCAGCAGCTCCACCGGAGCCCGGGACAACAACACTGAAGCTTTCTTT	CASSSTGARDNNTEAFF	TRBV9	TRBJ1-1
TGTGCCAGCAGCCCAAAGGACAACACAGATACGCAGTATTTT	CASSPKDNTDTQYF	TRBV13	TRBJ2-3
TGTGCCAGCAGCTTTCCGGGACAGACTTCGGGCGGGCCCCAGCATTTT	CASSFPGQTSGGPQHF	TRBV13	TRBJ1-5
TGTGCCAGCAGTGATGCGGACAGCTACTACGAGCAGTACTTC	CASSDADSYYEQYF	TRBV12-4	TRBJ2-7
TGTGCCGGAGGGGGCGAGACCCAGTACTTC	CAGGGETQYF	TRBV6-3	TRBJ2-5
TGCGCCAGCAGCCTAACCGTCAGGCCGGCGAGGGGGTCGCGAAACGCTGGGGCCAACGTCCTGACTTTC	CASSLTVRPARGSRNAGANVLTF	TRBV4-1	TRBJ2-6
TGCGCCAGCAGCCAAGCTAGGAGGGTTTACGTGTTTAGCACTGAAGCTTTCTTT	CASSQARRVYVFSTEAFF	TRBV4-1	TRBJ1-1
TGCAGTGCTATAGCGGGACAGACCGGGGAGCTGTTTTTT	CSAIAGQTGELFF	TRBV20-1	TRBJ2-2
TGTGCCAGTCGGTTGACAGACATTCAGTACTTC	CASRLTDIQYF	TRBV19	TRBJ2-4
TGTGCCCAGGGGACTGCGTCTGGAAACACCATATATTTT	CAQGTASGNTIYF	TRBV24-1	TRBJ1-3
TGTGCCAGCAGTCTACTAGCGGGAGGGGATGGCTACACCTTC	CASSLLAGGDGYTF	TRBV6-4	TRBJ1-2
TGTGCCAGACAGGGGTTGGCCTACGAGCAGTACTTC	CARQGLAYEQYF	TRBV6-5	TRBJ2-7
TGCGCCAGCAGCTTGGACCGAGAGGGACAGGTTGGGGCCAACGTCCTGACTTTC	CASSLDREGQVGANVLTF	TRBV5-1	TRBJ2-6
TGCGCCAGCAGTGCCCTGGACGATTCACAGGGTTGGAATGGCTACACCTTC	CASSALDDSQGWNGYTF	TRBV10-1	TRBJ1-2
TGTGCCAGCAGTGGTATGGTAAGGGGGCGTAGCAATCAGCCCCAGCATTTT	CASSGMVRGRSNQPQHF	TRBV6-4	TRBJ1-5
TGTGCCAGCTCACTCGGAGGACAGGGAAAAGAGCAGTACTTC	CASSLGGQGKEQYF	TRBV18	TRBJ2-7
TGTGCCAGCTCACCAAGGAATCCGGTCGAAAAACTGTTTTTT	CASSPRNPVEKLFF	TRBV18	TRBJ1-4
TGTGCCAGCAAGCTAGCGGGGTTTTACACCTACAATGAGCAGTTCTTC	CASKLAGFYTYNEQFF	TRBV7-2	TRBJ2-1
TGCGCCAGCAGCCAAGGTACCGCCGGGACTTTGCATGAGACCCAGTACTTC	CASSQGTAGTLHETQYF	TRBV4-3	TRBJ2-5
TGTGCCACCAGTGGGGACAGTGGGAATTCACCCCTCCACTTT	CATSGDSGNSPLHF	TRBV24-1	TRBJ1-6
TGTGCCAGCAGTTGTGCTTGTCCCGAGCAGTACTTC	CASSCACPEQYF	TRBV27	TRBJ2-7
TGCAGTGCTAGAGCCCCGGGCGAGCAGTACTTC	CSARAPGEQYF	TRBV20-1	TRBJ2-7
TGTGCCAGCAGTGAATATTCAGCAGGGAGAGGCTTT	CASSEYSAGRGF	TRBV25-1	TRBJ1-1
TGTGCCAGCCTGGATCGGGGATCGGAGGATACGCAGTATTTT	CASLDRGSEDTQYF	TRBV2	TRBJ2-3
TGTGCCAGCGGAACGGGTAGGAACTATGGCTACACCTTC	CASGTGRNYGYTF	TRBV6-3	TRBJ1-2
TGTTCGCGCAGTCGGAACACTGAAGCTTTCTTT	CSRSRNTEAFF	TRBV6-5	TRBJ1-1
TGTGCCAGCAGTGGCGGGAGCGGCCATCAGCCCCAGCATTTT	CASSGGSGHQPQHF	TRBV12-4	TRBJ1-5
TGTGCCAGCAGGCGACAGGGGTCGGTGTACTCCTACAATGAGCAGTTCTTC	CASRRQGSVYSYNEQFF	TRBV2	TRBJ2-1
TGTGCCACCACTCCCGGGACTAGCGCGTTTTCCTACGAGCAGTACTTC	CATTPGTSAFSYEQYF	TRBV24-1	TRBJ2-7
TGTGCCAGCAGTTACTCTCGACTAGCGCCGAGGCAGTTCTTC	CASSYSRLAPRQFF	TRBV6-3	TRBJ2-1
TGCGCCAGCAGCCAAGATAGGCCGGGACAGCGGAGCAATCAGCCCCAGCATTTT	CASSQDRPGQRSNQPQHF	TRBV4-1	TRBJ1-5
TGTGCCAGCAGCTTACAGGGCCGGTACCAAGAGACCCAGTACTTC	CASSLQGRYQETQYF	TRBV7-2	TRBJ2-5
TGTGCCAGCAGCTCACGAAGACCCAGTCCCAAGAAAGACAATGAGCAGTTCTTC	CASSSRRPSPKKDNEQFF	TRBV7-4	TRBJ2-1
TGTGCCAGCAGTTTACTGTTGTTAGGTCTGGGACAGGGTGCTTTTGGCAATCAGCCCCAGCATTTT	CASSLLLLGLGQGAFGNQPQHF	TRBV12-3	TRBJ1-5
TGTGCCAGCAGTTTCTTGACAGGCCACTACGAGCAGTACTTC	CASSFLTGHYEQYF	TRBV28	TRBJ2-7
TGCAGTGTGCCGGGACAGGGGGACACTGAAGCTTTCTTT	CSVPGQGDTEAFF	TRBV20-1	TRBJ1-1
TGCGCCAGCAGCCTAGGGGAGGGAGGCTACACCTTC	CASSLGEGGYTF	TRBV5-1	TRBJ1-2
TGTGCCAGCAGTCGGTGGGGGCAAAGGACTGAAGCTTTCTTT	CASSRWGQRTEAFF	TRBV12-3	TRBJ1-1
TGTGCCAGCAGTTTATATGTACTAGCGGGAGGGACGGAAAGATACGAGCAGTACTTC	CASSLYVLAGGTERYEQYF	TRBV27	TRBJ2-7
TGTGCCAGCAGTTACAGCTTGAACGAGCAGTACTTC	CASSYSLNEQYF	TRBV6-2	TRBJ2-7
TGTGCCAGCAGCTTGACGGGTAGCGGGCGTGGCACCTACGAGCAGTACTTC	CASSLTGSGRGTYEQYF	TRBV5-5	TRBJ2-7
TGTGCCACCATACTGGGCTACAGCAATCAGCCCCAGCATTTT	CATILGYSNQPQHF	TRBV24-1	TRBJ1-5
TGTGCCAGCAGTAATTTAATCAATGAAAAACTGTTTTTT	CASSNLINEKLFF	TRBV27	TRBJ1-4
TGTGCCAGCAGCGAACTAACGGGATGGAGTGAGCAGTTCTTC	CASSELTGWSEQFF	TRBV3-1	TRBJ2-1
TGTGCCACCAAGGGGGTTCGGTATAATTCACCCCTCCACTTT	CATKGVRYNSPLHF	TRBV7-9	TRBJ1-6
TGCACATCGGGACTAGTCCGGAACCAAGAGACCCAGTACTTC	CTSGLVRNQETQYF	TRBV20-1	TRBJ2-5
TGTGCCAGCAGCCGGGGGCCTAGTAGCACAGATACGCAGTATTTT	CASSRGPSSTDTQYF	TRBV9	TRBJ2-3
TGTGCCAGTTGCATCGCCAATTTGGGCTCTGGGGCCAACGTCCTGACTTTC	CASCIANLGSGANVLTF	TRBV19	TRBJ2-6
TGTGCCAGCAGCTATTGGGTTCCTGGGACTGTCAACGAGCAGTACTTC	CASSYWVPGTVNEQYF	TRBV13	TRBJ2-7
TGTGCCAGCAGCCACGAGCACCGGCAGCCCCAGCATTTT	CASSHEHRQPQHF	TRBV14	TRBJ1-5
TGTGCCAGCAGTTTTGGAGGGATCCACTATGGCTACACCTTC	CASSFGGIHYGYTF	TRBV28	TRBJ1-2
TGCAGCGCCAACCGAAGACACAGAGATACGCAGTATTTT	CSANRRHRDTQYF	TRBV29-1	TRBJ2-3
TGTGCCAGCAGTTCCGGGACAGAGTCGGACCAAGAGACCCAGTACTTC	CASSSGTESDQETQYF	TRBV27	TRBJ2-5
TGTGCCAGCAGTGCCCGACTAGCGGGATACAATGAGCAGTTCTTC	CASSARLAGYNEQFF	TRBV6-4	TRBJ2-1
TGTGCCATCAGGGTGGGGGGCCGCTCTGGGGCCAACGTCCTGACTTTC	CAIRVGGRSGANVLTF	TRBV10-3	TRBJ2-6
TGTGCCAGCAGTGGTACCGGGGGCCTTATTGAGCCCCAGCATTTT	CASSGTGGLIEPQHF	TRBV6-1	TRBJ1-5
TGTGCCAGCAGTGAAGTTGGAACAGGGGGAGTGAATGACACTGAAGCTTTCTTT	CASSEVGTGGVNDTEAFF	TRBV6-1	TRBJ1-1
TGTGCCAGCAGTGAACGCCCTTTCCATGGCTACACCTTC	CASSERPFHGYTF	TRBV6-1	TRBJ1-2
TGTGCCAGCAGCGTACGCCTTCGGGAGAAAATCCGGGTTTACGAGCAGTACTTC	CASSVRLREKIRVYEQYF	TRBV9	TRBJ2-7
TGTGCCAGCAGGAGTGACCGACCAGGGGAGCAGTTCTTC	CASRSDRPGEQFF	TRBV6-1	TRBJ2-1
TGTGCCAGCTCGTTCCGGGGGGCAACTAACTATGGCTACACCTTC	CASSFRGATNYGYTF	TRBV18	TRBJ1-2
TGTGCCAGCAGTCCTCTCAGGAAGGCGGGCCCGAGCAATCAGCCCCAGCATTTT	CASSPLRKAGPSNQPQHF	TRBV6-4	TRBJ1-5
TGTGCCAGCAGCCAAGGTTCCCAAGTGCAAGGGGGGGGCCACTACGAGCAGTACTTC	CASSQGSQVQGGGHYEQYF	TRBV3-1	TRBJ2-7
TGTGCCACCAGTGATGACTCAAGGGAAAAACTGTTTTTT	CATSDDSREKLFF	TRBV24-1	TRBJ1-4
TGCAGTGCTAGAGGACAGGGACGCAATCAGCCCCAGCATTTT	CSARGQGRNQPQHF	TRBV20-1	TRBJ1-5
TGTGCCAGCAGTTACTCGAGACACCGCAATCAGCCCCAGCATTTT	CASSYSRHRNQPQHF	TRBV6-5	TRBJ1-5
TGTGCCAGCAGCCCGGAGGGTGAAGCTTTCTTT	CASSPEGEAFF	TRBV6-1	TRBJ1-1
TGCGCCAGCAGAGGCGGGAGCCAGGGGCCCAACTACGAGCAGTACTTC	CASRGGSQGPNYEQYF	TRBV10-1	TRBJ2-7
TGTGCCAGCCGACAGGGTAAGAGTAACTATGGCTACACCTTC	CASRQGKSNYGYTF	TRBV5-8	TRBJ1-2
TGTGCCAGCAGTGGGAGCCGGGACAGTCTCTACGAGCAGTACTTC	CASSGSRDSLYEQYF	TRBV27	TRBJ2-7
TGTGCCAGCAGCCCCTCCGGGGGGTGGACAGATACGCAGTATTTT	CASSPSGGWTDTQYF	TRBV9	TRBJ2-3
TGCAGTGCTAGACTTAGCGGGAGATTATACAGGCAAGAGACCCAGTACTTC	CSARLSGRLYRQETQYF	TRBV20-1	TRBJ2-5
TGTGCCAGCAGCTTAGGGACTGGTGGCGGCACCGGGGAGCTGTTTTTT	CASSLGTGGGTGELFF	TRBV7-6	TRBJ2-2
TGTGCCAGCAGCCTCAAAGAAGCAGGAAGGTACGAGCAGTACTTC	CASSLKEAGRYEQYF	TRBV14	TRBJ2-7
TGCGCCAGCAGCTTGAACAGGGCAATTCTAGCCAAAAACATTCAGTACTTC	CASSLNRAILAKNIQYF	TRBV5-1	TRBJ2-4
TGTGCCAGTCCAGGGGGCAGGGTTGAAAAACTGTTTTTT	CASPGGRVEKLFF	TRBV19	TRBJ1-4
TGTGCCAGCAAGAGGACAGGGGGAAATCGCTACGAGCAGTACTTC	CASKRTGGNRYEQYF	TRBV7-2	TRBJ2-7
TGTGCCAGCAGAGGGTGGGACAGGGCGAATTCACCCCTCCACTTT	CASRGWDRANSPLHF	TRBV2	TRBJ1-6
TGTGCCAGCAGCGCCCGTCGAGGGGGTAATGAGCAGTTCTTC	CASSARRGGNEQFF	TRBV11-1	TRBJ2-1
TGTGCCAGCAGTTACCTGCCTAGCGGGCTCGCCTTGAGCTCCTACAATGAGCAGTTCTTC	CASSYLPSGLALSSYNEQFF	TRBV6-5	TRBJ2-1
TGTGCCAGTAGTATGGGGGGGAAGCTACTTGCATACGAGCAGTACTTC	CASSMGGKLLAYEQYF	TRBV19	TRBJ2-7
TGTGCCAGCAGTCGATACTGGGGCACAGATACGCAGTATTTT	CASSRYWGTDTQYF	TRBV6-3	TRBJ2-3
TGTGCCAGCAGCCGTCCGGGACAGGGCCTATCAGCCTACGAGCAGTACTTC	CASSRPGQGLSAYEQYF	TRBV3-1	TRBJ2-7
TGTGCCAGCAGCCAATCCGGTACCGGGGACTTAAACACAGATACGCAGTATTTT	CASSQSGTGDLNTDTQYF	TRBV3-1	TRBJ2-3
TGTGCCAGCAGCCAAGAAGTACCCAGGGGTCCCTACGAGCAGTACTTC	CASSQEVPRGPYEQYF	TRBV3-1	TRBJ2-7
TGCGCCAGCACTCGACAGGTTCGCAATCAGCCCCAGCATTTT	CASTRQVRNQPQHF	TRBV5-1	TRBJ1-5
TGCAGTGCTAGAGGGGCGGGACTTTATGAGACCCAGTACTTC	CSARGAGLYETQYF	TRBV20-1	TRBJ2-5
TGTGCCAGCAGCGTGTTCGGGAGGCGCGGAGAGACCCAGTACTTC	CASSVFGRRGETQYF	TRBV9	TRBJ2-5
TGTGCCAGCAGTATAGTTCAGGGTTCGCCCCGGATGGATGAGCAGTTCTTC	CASSIVQGSPRMDEQFF	TRBV6-5	TRBJ2-1
TGTGCCAGCAGTAACATTCCCCTAGCATACAATGAGCAGTTCTTC	CASSNIPLAYNEQFF	TRBV6-5	TRBJ2-1
TGTGCCAGCCTCCCAAAAGGACAGGGGCCCCAGCATTTT	CASLPKGQGPQHF	TRBV13	TRBJ1-5
TGTGCCAGCTCTGAGGGGGCCGAGACTGAAGCTTTCTTT	CASSEGAETEAFF	TRBV14	TRBJ1-1
TGCAGCGTCCGGTGGGGGAATTCACCCCTCCACTTT	CSVRWGNSPLHF	TRBV29-1	TRBJ1-6
TGTGCCAGCAGTGACACAGGGGCGTGGAATAACGATCAGCCCCAGCATTTT	CASSDTGAWNNDQPQHF	TRBV6-4	TRBJ1-5
TGTGCCAGCAGTTTAAGCGTCTACGAGCAGTACTTC	CASSLSVYEQYF	TRBV6-4	TRBJ2-7
TGCGCCAATGAGGACAGGGACCCCAGCGGGGCCAACGTCCTGACTTTC	CANEDRDPSGANVLTF	TRBV5-1	TRBJ2-6
TGTGCCAGTAGTATGTCAACTCCGAATATCTACGAGCAGTACTTC	CASSMSTPNIYEQYF	TRBV19	TRBJ2-7
TGTGCCAGCCCCGGTAGCTCCTACGAGCAGTACTTC	CASPGSSYEQYF	TRBV6-4	TRBJ2-7
TGTGCCAGCAGCTTTGGAGGGGGCAGGTCTAACGAGCAGTACTTC	CASSFGGGRSNEQYF	TRBV5-4	TRBJ2-7
TGTGCTAGCAGCCCTGAAATAGGAGATACGCAGTATTTT	CASSPEIGDTQYF	TRBV7-7	TRBJ2-3
TGTGCCACCAGTGTGATCAGGGAGTGTAGGGCGTACTTC	CATSVIRECRAYF	TRBV24-1	TRBJ2-7
TGTGCCACCAGTGATTTAGATCACAGGGAGGGCACTGAAGCTTTCTTT	CATSDLDHREGTEAFF	TRBV24-1	TRBJ1-1
TGCAGCGTTAGGGCGAGGCGGGAGTCGGGGGACACCGGGGAGCTGTTTTTT	CSVRARRESGDTGELFF	TRBV29-1	TRBJ2-2
TGTGCCAGCAGCCAAGATGGGTCCTTAGCTCTCGCCCGCACAGATACGCAGTATTTT	CASSQDGSLALARTDTQYF	TRBV3-1	TRBJ2-3
TGCGCCAGCGCCGGGACTAGTGATAGCTCCTACAATGAGCAGTTCTTC	CASAGTSDSSYNEQFF	TRBV10-1	TRBJ2-1
TGCGCCAGCAGCTTGACCCCGAATAGCTCCTACGAGCAGTACTTC	CASSLTPNSSYEQYF	TRBV5-1	TRBJ2-7
TGTGCCAGCAGTGAAGCCATTGATCCCCGGGGGGGGAATGGCTACACCTTC	CASSEAIDPRGGNGYTF	TRBV6-1	TRBJ1-2
TGTGCCAGCAGCTCACAGGGGGCCCTAACGGTAGAGGTGGGGAGAAAACTGTTTTTT	CASSSQGALTVEVGRKLFF	TRBV11-3	TRBJ1-4
TGTGCCAGCAGCCACCCGGGACAGGGGGTAGTTCAAAACATTCAGTACTTC	CASSHPGQGVVQNIQYF	TRBV9	TRBJ2-4
TGTGCCAGCAGCACCTGGGAGGGGGGCGAGCAGTACTTC	CASSTWEGGEQYF	TRBV7-9	TRBJ2-7
TGTGCCAGCAGCCAAGAGCCCGGGACAGGCGGAGAGCAGTACTTC	CASSQEPGTGGEQYF	TRBV3-1	TRBJ2-7
TGTGCCATCAGGTGGGACCGGGTTTATAGCAATCAGCCCCAGCATTTT	CAIRWDRVYSNQPQHF	TRBV10-3	TRBJ1-5
TGTGCCAGCAGCGGCTTGCGTCAGCGGGGCTACACCTTC	CASSGLRQRGYTF	TRBV6-1	TRBJ1-2
TGTGCCAGCGCCTGTAGGAATAATTCACCCCTCCACTTT	CASACRNNSPLHF	TRBV7-2	TRBJ1-6
TGCAGCGTTGAAGATCAACCCGCACACCTGAACACTGAAGCTTTCTTT	CSVEDQPAHLNTEAFF	TRBV29-1	TRBJ1-1
TGCAGTGCGTACAGGGGGCCCCACAATGAGCAGTTCTTC	CSAYRGPHNEQFF	TRBV20-1	TRBJ2-1
TGTGCCAGCAGATCAAGCGAAACTGGGACTAGCGGGTTTGAGCAGTTCTTC	CASRSSETGTSGFEQFF	TRBV3-1	TRBJ2-1
TGTGCCAGCAGTGAATATCGACAGGTCTCCCAGCCCCAGCATTTT	CASSEYRQVSQPQHF	TRBV25-1	TRBJ1-5
TGTGCCAGCAAGCTGGCTTTCCTCATCTCCTACGAGCAGTACTTC	CASKLAFLISYEQYF	TRBV6-1	TRBJ2-7
TGTGCCAGTACCGGACAGAAGATGGAGACCCAGTACTTC	CASTGQKMETQYF	TRBV19	TRBJ2-5
TGTGCCAGCATCCGGGGGGGGGGGCATGAGCAGTTCTTC	CASIRGGGHEQFF	TRBV27	TRBJ2-1
TGTGCCAGCATTATCAACGGGGTTAAGGGGAACACTGAAGCTTTCTTT	CASIINGVKGNTEAFF	TRBV6-5	TRBJ1-1
TGTGCCAGCAGCCAAGTTCTGGAGCGTAACAATGAGCAGTTCTTC	CASSQVLERNNEQFF	TRBV4-2	TRBJ2-1
TGCGCCAGCAGCAAAGGCGAACGACAGGATATCTCACCCCTCCACTTT	CASSKGERQDISPLHF	TRBV5-1	TRBJ1-6
TGTGCCACCGGGACAGGGGCTGCAACTAATGAAAAACTGTTTTTT	CATGTGAATNEKLFF	TRBV10-3	TRBJ1-4
TGTGCCCTACCTCTGGGTGAAGCTTTCTTT	CALPLGEAFF	TRBV7-2	TRBJ1-1
TGTGCCAGCAGCCAATGCCGGACTAGCGGGGATCTGACCGGGGAGCTGTTTTTT	CASSQCRTSGDLTGELFF	TRBV16	TRBJ2-2
TGTGCCACCAGTGATTTTCCTGTCGGACCGGGACAGGGACCGCGCAATGAAAAACTGTTTTTT	CATSDFPVGPGQGPRNEKLFF	TRBV24-1	TRBJ1-4
TGCGCCAGCAATGTCCCGGGGGTCAGGGGGAATGAAAAACTGTTTTTT	CASNVPGVRGNEKLFF	TRBV10-1	TRBJ1-4
TGTGCCAGCAGTGAGGGGACACAGGGGCATTTT	CASSEGTQGHF	TRBV6-4	TRBJ1-5
TGCGCCAGCAGGTCCAGGGGGCGCAATCAGCCCCAGCATTTT	CASRSRGRNQPQHF	TRBV5-1	TRBJ1-5
TGCAGCGTTGAAGAGACAAGTCTCGGGACAGGGATCTACGAGCAGTACTTC	CSVEETSLGTGIYEQYF	TRBV29-1	TRBJ2-7
TGTGCCAGCAGTGACAAGCCCAGGGTTAATGAAAAACTGTTTTTT	CASSDKPRVNEKLFF	TRBV12-4	TRBJ1-4
TGTGCCAGCAGCGTAGTAAAGGGGGCTGGGTTGCAATTGAATCAGCCCCAGCATTTT	CASSVVKGAGLQLNQPQHF	TRBV9	TRBJ1-5
TGTGCCGGAGTTCCCAGGGGCCCCTTC	CAGVPRGPF	TRBV11-2	TRBJ1-2
TGTGCAAAGGGACAGGGGGCGCTCGCTGTTCAGCCCCAGCATTTT	CAKGQGALAVQPQHF	TRBV6-4	TRBJ1-5
TGTGCCACCAGACTACTAGCGGGAGGGCTTTTGAACACTGAAGCTTTCTTT	CATRLLAGGLLNTEAFF	TRBV24-1	TRBJ1-1
TGCAGTGCTAGAGTAAGACCGGCTTCCCAAGAGACCCAGTACTTC	CSARVRPASQETQYF	TRBV20-1	TRBJ2-5
TGTGCCAGCAGTTTGGGGCGCGCGGGTTTAACTGAAGCTTTCTTT	CASSLGRAGLTEAFF	TRBV12-3	TRBJ1-1
TGTGCCAGCAGCTTGAACAGGGACAATGAGCAGTTCTTC	CASSLNRDNEQFF	TRBV7-9	TRBJ2-1
TGTGCCAGCAGTGTGAGGGTGCGAGGGACCCGCTATGGCTACACCTTC	CASSVRVRGTRYGYTF	TRBV6-4	TRBJ1-2
TGTGCCAATTTACGGGACAGGGGGCTCTCCACAGATACGCAGTATTTT	CANLRDRGLSTDTQYF	TRBV15	TRBJ2-3
TGCGCCAGCAGCTTAGGCACTAAAGGACTCTCCCGCTGTAGCAATCAGCCCCAGCATTTT	CASSLGTKGLSRCSNQPQHF	TRBV5-1	TRBJ1-5
TGTGCCACCAGCAGAGATTGGTGGGGAAATACGAGACAGGGGAGCTCCTACGAGCAGTACTTC	CATSRDWWGNTRQGSSYEQYF	TRBV15	TRBJ2-7
TGCGCCAGCAGCGACGGAAGGGACAGGGTCCCGAACACCGGGGAGCTGTTTTTT	CASSDGRDRVPNTGELFF	TRBV5-1	TRBJ2-2
TGTGCCAGCAGCAAAAAAGGGGGGATCTCTGGAAACACCATATATTTT	CASSKKGGISGNTIYF	TRBV6-1	TRBJ1-3
TGTGCCAGCAGCTTCCGCTTTGCACCCGGGACAGGGCCGAGCTGCGAGCAGTACTTC	CASSFRFAPGTGPSCEQYF	TRBV7-9	TRBJ2-7
TGCGCCAGCAGCCAAGTGTTATCAGGGGTATTTTGTTTCTATGGCTACACCTTC	CASSQVLSGVFCFYGYTF	TRBV4-1	TRBJ1-2
TGTGCCAGTAGTATAGTACGGCGGATCTCCTACGAGCAGTACTTC	CASSIVRRISYEQYF	TRBV19	TRBJ2-7
TGCAGTGCGCTAACATACGAGCAGTACTTC	CSALTYEQYF	TRBV20-1	TRBJ2-7
TGTGCCAGCAGCCATCCAGGACTAGGATTATACGAGCAGTACTTC	CASSHPGLGLYEQYF	TRBV7-3	TRBJ2-7
TGTGCCAGCAGTTACTCGCCATGGACGGGACTGACGAGCTCCTACAATGAGCAGTTCTTC	CASSYSPWTGLTSSYNEQFF	TRBV6-3	TRBJ2-1
TGTGCCTGGAGTCCGTTAACCAAAAACATTCAGTACTTC	CAWSPLTKNIQYF	TRBV30	TRBJ2-4
TGTGCCACCAGTGATTTCTGGTTTCACCAGTCTCGTATTAATGAGCAGTTCTTC	CATSDFWFHQSRINEQFF	TRBV24-1	TRBJ2-1
TGTGCCAGCAATCTCCAGGGAGCGGGGTCTTCCTACAATGAGCAGTTCTTC	CASNLQGAGSSYNEQFF	TRBV28	TRBJ2-1
TGTGCCAGCAGCTTAAGGCCGTGGGTAGGACCCGGGGGCAAAGAGGTGGTCGCCGGGGAGCTGTTTTTT	CASSLRPWVGPGGKEVVAGELFF	TRBV11-3	TRBJ2-2
TGTGCCAGCAGCTCAGGGGCGTCTGAAAAACTGTTTTTT	CASSSGASEKLFF	TRBV7-3	TRBJ1-4
TGTGCCAGGTTAGCCTGGACAGGGAAGGAGACCCAGTACTTC	CARLAWTGKETQYF	TRBV27	TRBJ2-5
TGTGCCAGCAGCATAGGGGGGCGACTGTTCACAGATACGCAGTATTTT	CASSIGGRLFTDTQYF	TRBV5-4	TRBJ2-3
TGTGCCAGTAGTATAAGGGAGCACAATGAGCAGTTCTTC	CASSIREHNEQFF	TRBV19	TRBJ2-1
TGTGCCGAACTCAGAATAGCATGCAATCAGCCCCAGCATTTT	CAELRIACNQPQHF	TRBV11-3	TRBJ1-5
TGTGCCAGCAGCTCCAGGTCGAACGGACGAAGACAAGGTGAGGCGTACGGAAGCTACGAGCAGTACTTC	CASSSRSNGRRQGEAYGSYEQYF	TRBV5-6	TRBJ2-7
TGTGCCAGCACATTGAAGGACAGGGAGGATTTCCCTGAAGCTTTCTTT	CASTLKDREDFPEAFF	TRBV27	TRBJ1-1
TGTGCCAGTTTTGGGGCGGTGGGCAATCAGCCCCAGCATTTT	CASFGAVGNQPQHF	TRBV19	TRBJ1-5
TGTGCCAGCAGGGGGCAGGGCTTCCAAGAGACCCAGTACTTC	CASRGQGFQETQYF	TRBV7-6	TRBJ2-5
TGTGCCAGCAGCCTGCTCGCAGGGGGCCTACTAGGGCCCACTAATGAAAAACTGTTTTTT	CASSLLAGGLLGPTNEKLFF	TRBV5-6	TRBJ1-4
TGCAGTGCTAGCTTGGGGGGGGTAAACACCGGGGAGCTGTTTTTT	CSASLGGVNTGELFF	TRBV20-1	TRBJ2-2
TGTGCCAGCAGTAGACAGGGGGGAAAAACCAACACTGAAGCTTTCTTT	CASSRQGGKTNTEAFF	TRBV6-2	TRBJ1-1
TGTGCTAGCAGCTTACTCCTTGGGAGAGGGGACGAGCAGTACTTC	CASSLLLGRGDEQYF	TRBV7-7	TRBJ2-7
TGTGCCAGCAGCTTAGGGGGACAGGGTAAGACCTACTCTGGGGCCAACGTCCTGACTTTC	CASSLGGQGKTYSGANVLTF	TRBV7-2	TRBJ2-6
TGTGCCAGCGAAGTCCAGGGTGGACGGAGCTTC	CASEVQGGRSF	TRBV9	TRBJ2-7
TGTGCCAACCTCGAGCAGTACTTC	CANLEQYF	TRBV19	TRBJ2-7
TGTGCCACCAGTGAGGACGGGACAGGGGTTGCTGAAGCTTTCTTT	CATSEDGTGVAEAFF	TRBV24-1	TRBJ1-1
TGTGCCAGCAAGGGGGAGAACCTGAACACTGAAGCTTTCTTT	CASKGENLNTEAFF	TRBV7-9	TRBJ1-1
TGTGCCAGCAGCTTAGAACGGAGGACATTCTACGAGCAGTACTTC	CASSLERRTFYEQYF	TRBV11-3	TRBJ2-7
TGCGCCAGCAGCTGGAGGACAGGGGAAGAGACCCAGTACTTC	CASSWRTGEETQYF	TRBV5-1	TRBJ2-5
TGTGCCAGCAGTCCCCAAAATGGGGGAACCCCCAACACTGAAGCTTTCTTT	CASSPQNGGTPNTEAFF	TRBV12-3	TRBJ1-1
TGTGCCAGCAGCCATTACTACGGACAGGGAGCCTGCACTGAAGCTTTCTTT	CASSHYYGQGACTEAFF	TRBV14	TRBJ1-1
TGTGCTAGTGGTAAGCAATGGGGACTGGGCACTGAAGCTTTCTTT	CASGKQWGLGTEAFF	TRBV12-5	TRBJ1-1
TGTGCCACCGCTCACAAGGGAGTTAATTCACCCCTCCACTTT	CATAHKGVNSPLHF	TRBV24-1	TRBJ1-6
TGTGCCAGCAGCTTGACCCAGGGGGTTACTCTGAACACTGAAGCTTTCTTT	CASSLTQGVTLNTEAFF	TRBV5-6	TRBJ1-1
TGTGCCAGCAGTTTATCCGGGGATATTGAGATGAACACTGAAGCTTTCTTT	CASSLSGDIEMNTEAFF	TRBV28	TRBJ1-1
TGCGCCAGCACTAACCGGCTGAGGAATGAAAAACTGTTTTTT	CASTNRLRNEKLFF	TRBV10-1	TRBJ1-4
TGCAGTGCTAGGAAATACCCGGGACAGGCCTACGAGCAGTACTTC	CSARKYPGQAYEQYF	TRBV20-1	TRBJ2-7
TGTGCCAGCAGCCACCCCGGAAAGAAGGGCCAAGAGACCCAGTACTTC	CASSHPGKKGQETQYF	TRBV14	TRBJ2-5
TGTGCCAGTACACGGGCGGGGTCGAACACCGGGGAGCTGTTTTTT	CASTRAGSNTGELFF	TRBV19	TRBJ2-2
TGCGCCAGCAAACCGGACCCTATTCATTCACCCCTCCACTTT	CASKPDPIHSPLHF	TRBV10-1	TRBJ1-6
TGTGCCAGCAGCCAAGGGGATGGATACAGGGGCGGAGAGACCCAGTACTTC	CASSQGDGYRGGETQYF	TRBV4-2	TRBJ2-5
TGTGCCACCAGTGATTTGCGGGCAGGCCAAGAGACCCAGTACTTC	CATSDLRAGQETQYF	TRBV24-1	TRBJ2-5
TGTGCCAGCTTCGGGGATGTGAATGAGCAGTTCTTC	CASFGDVNEQFF	TRBV6-5	TRBJ2-1
TGTGCCATCAGACCGGGACAGGGTCGGAACACTGAAGCTTTCTTT	CAIRPGQGRNTEAFF	TRBV10-3	TRBJ1-1
TGTGCCAGCAGTGATGGGAGACCAGCATGGTCAACTGAAGCTTTCTTT	CASSDGRPAWSTEAFF	TRBV6-4	TRBJ1-1
TGTGCCAGCAGCCGGAGGACCTCCTACGAGCAGTACTTC	CASSRRTSYEQYF	TRBV9	TRBJ2-7
TGTGCCAGCAGTTTCCCCCTCCAGACGGGGGGGCCCTACGAGCAGTACTTC	CASSFPLQTGGPYEQYF	TRBV12-4	TRBJ2-7
TGTCCAGGGGTACGGCTAATGAACACTGAAGCTTTCTTT	CPGVRLMNTEAFF	TRBV6-5	TRBJ1-1
TGCAGTGCTAACAGGGACACTGGAAACACCATATATTTT	CSANRDTGNTIYF	TRBV20-1	TRBJ1-3
TGCGCCAGCAACCAGACTTGGGTTAGCGGTTGGTTCAACTACGAGCAGTACTTC	CASNQTWVSGWFNYEQYF	TRBV10-1	TRBJ2-7
TGTGCCACCAGTGAGGCTAGTACCGCGAATGAGCAGTTCTTC	CATSEASTANEQFF	TRBV24-1	TRBJ2-1
TGCAGTGCTAGAAGCAGGGAGGCCAATCAGCCCCAGCATTTT	CSARSREANQPQHF	TRBV20-1	TRBJ1-5
TGTGCCAGCAGTGAAATGCGGGGGGACTACGAGCAGTACTTC	CASSEMRGDYEQYF	TRBV25-1	TRBJ2-7
TGTGCCAGCAGTGAACCCCGGGGGCCACGAGGCTACACCTTC	CASSEPRGPRGYTF	TRBV25-1	TRBJ1-2
TGCGCCAGTACCTTTAGATTGGAAAAACTGTTTTTT	CASTFRLEKLFF	TRBV10-1	TRBJ1-4
TGTGCCAGCAGCTTAGCGTCATCCTGGCGCCTAGGAAATGAGCAGTTCTTC	CASSLASSWRLGNEQFF	TRBV7-2	TRBJ2-1
TGCCTTTCCCTAGCGTTGGATGAGCAGTTCTTC	CLSLALDEQFF	TRBV20-1	TRBJ2-1
TGTGCGATTAAAACAGTAGACAACTATGGCTACACCTTC	CAIKTVDNYGYTF	TRBV6-5	TRBJ1-2
TGTGCCAGCAGTGAGGTGGTACGGTGGCCCGATGGTCACACTGAAGCTTTCTTT	CASSEVVRWPDGHTEAFF	TRBV6-4	TRBJ1-1
TGTGCCACCAGTGATTTGGCACCGGAGAACACTGAAGCTTTCTTT	CATSDLAPENTEAFF	TRBV24-1	TRBJ1-1
TGTGCCAGCAGCCAATCCTCCCGGACAGACATAAGCAATCAGCCCCAGCATTTT	CASSQSSRTDISNQPQHF	TRBV3-1	TRBJ1-5
TGTGCCAGCAGTTACCAAAGGGGTCAAGAGCAGTTCTTC	CASSYQRGQEQFF	TRBV6-3	TRBJ2-1
TGTGCCACCAGTGGAACGGACCAAGGGGATCAAGAGACCCAGTACTTC	CATSGTDQGDQETQYF	TRBV24-1	TRBJ2-5
TGTGCCACCAGTGTCCAGGGGAACCCCCACGAGCAGTACTTC	CATSVQGNPHEQYF	TRBV24-1	TRBJ2-7
TGTGCCAGCACTGTAACTAATCAGCCCCAGCATTTT	CASTVTNQPQHF	TRBV27	TRBJ1-5
TGTGCCTGGCATTCTCACGTGCGGAATCAGCCCCAGCATTTT	CAWHSHVRNQPQHF	TRBV30	TRBJ1-5
TGTGCCAGCAGCTTAGGGGGGCGGGCCAGCAATCAGCCCCAGCATTTT	CASSLGGRASNQPQHF	TRBV7-3	TRBJ1-5
TGTGCCACGCCCAGGACACATACGCAGTATTTT	CATPRTHTQYF	TRBV24-1	TRBJ2-3
TGTGCCAGCAGCCTCGGGGCTCCTAGCAATCAGCCCCAGCATTTT	CASSLGAPSNQPQHF	TRBV13	TRBJ1-5
TGTGCCAGCAGCGTCCTAGGCCAGGGGGAATACGAGCAGTACTTC	CASSVLGQGEYEQYF	TRBV9	TRBJ2-7
TGTGCCAGCAGTTACACCCGGGAGGGGGCAGATACGCAGTATTTT	CASSYTREGADTQYF	TRBV6-6	TRBJ2-3
TGTGCCTGGATAACTCGGGTGAACACTGAAGCTTTCTTT	CAWITRVNTEAFF	TRBV30	TRBJ1-1
TGTGCCAGCAGCGTAGGGGACGTACTAACTGGGGCCAACGTCCTGACTTTC	CASSVGDVLTGANVLTF	TRBV6-5	TRBJ2-6
TGTGCCAGAAGGGGCAAAGAGACCCAGTACTTC	CARRGKETQYF	TRBV7-9	TRBJ2-5
TGCGCCAGCAGCGGGAAGGACAGGGGATATCATAGCAATCAGCCCCAGCATTTT	CASSGKDRGYHSNQPQHF	TRBV5-1	TRBJ1-5
TGCGCCAGCAGCCATAGCACAGGGGGCGCCTACGAGCAGTACTTC	CASSHSTGGAYEQYF	TRBV4-1	TRBJ2-7
TGCGCCAGCAGCCGGACAGGGGATAATCAGCCCCAGCATTTT	CASSRTGDNQPQHF	TRBV5-1	TRBJ1-5
TGTGCTAGTGGTTTGGTAGCTTGTCGGGACAGGGCCGGGGACGAGCAGTACTTC	CASGLVACRDRAGDEQYF	TRBV12-5	TRBJ2-7
TGTGCCAGCAGTTACTCGAGGACGAGGACAATGATGAACACTGAAGCTTTCTTT	CASSYSRTRTMMNTEAFF	TRBV6-5	TRBJ1-1
TGCGCCAGCAGTTTGTGCCAGGGGGCGGAAAAAAACATTCAGTACTTC	CASSLCQGAEKNIQYF	TRBV5-1	TRBJ2-4
TGCGCCAGCAGCCAAGCGTGGGGGGTAGTGGATACGCAGTATTTT	CASSQAWGVVDTQYF	TRBV4-1	TRBJ2-3
TGTGTTGGGCGGGAGACCTACGAGCAGTACTTC	CVGRETYEQYF	TRBV27	TRBJ2-7
TGTGCCAGCAGCTCGGGTGGGACAGAAGTACACAATGAGCAGTTCTTC	CASSSGGTEVHNEQFF	TRBV5-4	TRBJ2-1
TGTGCCAGCAGCTTACCGACAGCCTATGGCTACACCTTC	CASSLPTAYGYTF	TRBV7-2	TRBJ1-2
TGCGCCAGCTTGGACAGGAAAAACACCGGGGAGCTGTTTTTT	CASLDRKNTGELFF	TRBV5-1	TRBJ2-2
TGTGCCAGTCGTGGACTAGCGGGGGGGCCGGGAGGTTGGTTAAACAATGAGCAGTTCTTC	CASRGLAGGPGGWLNNEQFF	TRBV19	TRBJ2-1
TGTGCCAGCAGCGCCCTGGGACTAGCGGGGGGGCCATACAATGAGCAGTTCTTC	CASSALGLAGGPYNEQFF	TRBV7-9	TRBJ2-1
TGTGCCAGCAGCCAAGGAGAGCAAGGCGGGAGCGTTAGACGCACAGATACGCAGTATTTT	CASSQGEQGGSVRRTDTQYF	TRBV14	TRBJ2-3
TGTGCCAGCAGTCAGGGGGGGGAAAAACTGTTTTTT	CASSQGGEKLFF	TRBV6-5	TRBJ1-4
TGTGCCAGCAGTGAAATACTAGGGGGAGTTTGTAACTATGGCTACACCTTC	CASSEILGGVCNYGYTF	TRBV6-4	TRBJ1-2
TGTGCCAGCAGCCAAGGGGGGGGGAATAGCTACGAGCAGTACTTC	CASSQGGGNSYEQYF	TRBV13	TRBJ2-7
