TGTGCCAGTAGTACGGACAGCGACCAAGAGACCCAGTACTTC	CASSTDSDQETQYF	TRBV19	TRBJ2-5
TGCGCCAGCAGTGAGCGACTCGCTGGAGGGCATCAGCCCCAGCATTTT	CASSERLAGGHQPQHF	TRBV10-2	TRBJ1-5
TGCGCCAGCAGCCTACAGGGCGGTCCCTACGAGCAGTACTTC	CASSLQGGPYEQYF	TRBV5-1	TRBJ2-7
TGTGCCAGCAGCTTAAGGGACAACGAGACGAACACTGAAGCTTTCTTT	CASSLRDNETNTEAFF	TRBV7-2	TRBJ1-1
TGCGCCAGCAGCCAAGACCCGGCGGACAGGGGGCATCAGCCCCAGCATTTT	CASSQDPADRGHQPQHF	TRBV4-1	TRBJ1-5
TGTGCCAGCAGCGCGGGCGAATCCAACTATGGCTACACCTTC	CASSAGESNYGYTF	TRBV9	TRBJ1-2
TGTGCCAGCAGCGGGAGGACAGTTTACGAGCAGTACTTC	CASSGRTVYEQYF	TRBV13	TRBJ2-7
TGTGCCAGCAGTTTATACGGGACAGGGAGAGTTTACGAGCAGTACTTC	CASSLYGTGRVYEQYF	TRBV27	TRBJ2-7
TGTGCCAGCAGTTTCGAACTAGGGCAGTACTTC	CASSFELGQYF	TRBV28	TRBJ2-7
TGTCACTTGGCGGACCCCAGCAATCAGCCCCAGCATTTT	CHLADPSNQPQHF	TRBV6-5	TRBJ1-5
TGCGCCAGCAGTAGGCCGCATGCGTGTCGTTGGCCGAACTATGGCTACACCTTC	CASSRPHACRWPNYGYTF	TRBV10-2	TRBJ1-2
TGTGCCAGCAGTTTGCCAAGCGGTCTTGCGGGCTACGAGCAGTACTTC	CASSLPSGLAGYEQYF	TRBV12-3	TRBJ2-7
TGCAGCGTTGTCTTCTTACGGGAAGGCAGTGTTCAAGGGTGCAATGAGCAGTTCTTC	CSVVFLREGSVQGCNEQFF	TRBV29-1	TRBJ2-1
TGTGCCACCAGTGAACATAATAACTATGGCTACACCTTC	CATSEHNNYGYTF	TRBV24-1	TRBJ1-2
TGCAGTGCAGAGACTAGCGGGAATAACAATGAGCAGTTCTTC	CSAETSGNNNEQFF	TRBV20-1	TRBJ2-1
TGCAGCGGGGCCGGTAATTCACCCCTCCACTTT	CSGAGNSPLHF	TRBV29-1	TRBJ1-6
TGCAGCGTTGAACCCGCCAGGAGGCCTAACTATGGCTACACCTTC	CSVEPARRPNYGYTF	TRBV29-1	TRBJ1-2
TGTGCTAGTGGTTGTTCTCCAATGGGTGAAAAACTGTTTTTT	CASGCSPMGEKLFF	TRBV12-5	TRBJ1-4
TGTGCCAGCAGCTTGCTTCAGCTCGGGGGTGTGGGAGGAATCCCTGGAAACACCATATATTTT	CASSLLQLGGVGGIPGNTIYF	TRBV7-9	TRBJ1-3
TGTGCCAGCAGTTTGGGGGGGCGCCGGGCCTCTGGAAACACCATATATTTT	CASSLGGRRASGNTIYF	TRBV27	TRBJ1-3
TGTGCCAGCAGCTTGACTTCAACCATCAATCAGCCCCAGCATTTT	CASSLTSTINQPQHF	TRBV5-4	TRBJ1-5
TGTGCCAGCAGCTTACGAGAACCGGGTACGGGACAGAACACTGAAGCTTTCTTT	CASSLREPGTGQNTEAFF	TRBV7-3	TRBJ1-1
TGTGCCAGCAGCGTCCAGAACACTGAAGCTTTCTTT	CASSVQNTEAFF	TRBV13	TRBJ1-1
TGTGCCAGCAGCTTAGTGGCTGTCTTCTTGTGCCCAATGGGTTGGGCGGTCGTTTTATACGAGCAGTACTTC	CASSLVAVFLCPMGWAVVLYEQYF	TRBV7-8	TRBJ2-7
TGTGCCAGCACGTGTGGGGGGGCTCTTTGTGTTGAGACCCAGTACTTC	CASTCGGALCVETQYF	TRBV6-2	TRBJ2-5
TGTGCCAGCAGCTTACCAGGTCAGCCCCAGCATTTT	CASSLPGQPQHF	TRBV7-9	TRBJ1-5
TGTGCCAGCAGCTTAGCGCCTGGCACTAGCGAATCCTACAATGAGCAGTTCTTC	CASSLAPGTSESYNEQFF	TRBV7-2	TRBJ2-1
TGCGCCAGCAGCCAAGACTATCGACTAGCGGGGGCGGAGACCCAGTACTTC	CASSQDYRLAGAETQYF	TRBV4-1	TRBJ2-5
TGTGCCAGTCACCCGCCCTGGCGCACTAGGGATCAGCCCCAGCATTTT	CASHPPWRTRDQPQHF	TRBV6-5	TRBJ1-5
TGTGCCAGCACTGAGCGGGACATGGAACCAGCTTTCTTT	CASTERDMEPAFF	TRBV5-4	TRBJ1-1
TGCAGTGCTAGTTCAGGGGACACACAAGAGACCCAGTACTTC	CSASSGDTQETQYF	TRBV20-1	TRBJ2-5
TGTGCCAGCAGCTTAGCCCCGACTAGCGGGAGGGCCCGTATTGGGTATTTT	CASSLAPTSGRARIGYF	TRBV7-4	TRBJ2-3
TGTGGAGGGCCCAAGGAGCAGTACTTC	CGGPKEQYF	TRBV24-1	TRBJ2-7
TGCGCCAGCGCAACGGAGACCCAGTACTTC	CASATETQYF	TRBV10-1	TRBJ2-5
TGTGCCAGCTTCACAGGGGCTAACTATGGCTACACCTTC	CASFTGANYGYTF	TRBV6-3	TRBJ1-2
TGTGCCAGCAGCGCCAGCACTGGAGATAGCAATCAGCCCCAGCATTTT	CASSASTGDSNQPQHF	TRBV13	TRBJ1-5
TGTGCCAGCAGCTTAGCCTACAGGGGTAGTAGCAATCAGCCCCAGCATTTT	CASSLAYRGSSNQPQHF	TRBV11-2	TRBJ1-5
TGTGCCACAGGACAGGGGGCTAATTCACCCCTCCACTTT	CATGQGANSPLHF	TRBV15	TRBJ1-6
TGCAGCGTTGAAGATCCTAAATTCTTGGAGGGGTCAGGCTATGGCTACACCTTC	CSVEDPKFLEGSGYGYTF	TRBV29-1	TRBJ1-2
TGTGCCAGCACAGTAGCGGAAGCTAGCACAGATACGCAGTATTTT	CASTVAEASTDTQYF	TRBV6-2	TRBJ2-3
TGTGCCAGCAGCGGTCAGGGGCGAAGACCACATGGTCAGCCCCAGCATTTT	CASSGQGRRPHGQPQHF	TRBV9	TRBJ1-5
TGCGCCAGCAGCTTGGCTTACGAGGGGGACGACTATGGCTACACCTTC	CASSLAYEGDDYGYTF	TRBV5-1	TRBJ1-2
TGTGCCAGCAGTTTATGTGTGGGCCACCAAGAGACCCAGTACTTC	CASSLCVGHQETQYF	TRBV27	TRBJ2-5
TGCAGTGCTAGAGGTACGGGGTTGGGATTATCCTACGAGCAGTACTTC	CSARGTGLGLSYEQYF	TRBV20-1	TRBJ2-7
TGTGCCAGCAGTTACAATGGGGGGCCTCCTTATCCGTGGCTACCTAGCACAGATACGCAGTATTTT	CASSYNGGPPYPWLPSTDTQYF	TRBV6-5	TRBJ2-3
TGTGCCACCAGCATCGGAGCGGGACAGCCTCGAGAGCAGTACTTC	CATSIGAGQPREQYF	TRBV15	TRBJ2-7
TGTGCCTGGAGGAGAGGCAACACCGGGGAGCTGTTTTTT	CAWRRGNTGELFF	TRBV30	TRBJ2-2
TGTGCCCGTATGGACAGGGGGGGCTCCTACGAGCAGTACTTC	CARMDRGGSYEQYF	TRBV27	TRBJ2-7
TGTGCCAGCAGTTTGGGCGGGCCCTCTGGAAACACCATATATTTT	CASSLGGPSGNTIYF	TRBV6-5	TRBJ1-3
TGTGCCAGCAGCTCAAAGGCCGGGGTGGGGGGATCGTTGACTAATGAAAAACTGTTTTTT	CASSSKAGVGGSLTNEKLFF	TRBV5-6	TRBJ1-4
TGTGCCAGCAGCCCCTACCCACCTACTCGTCACAATGAGCAGTTCTTC	CASSPYPPTRHNEQFF	TRBV7-3	TRBJ2-1
TGTGCCATGGGGGGGGGGGTGCCCGGCCAGGCCAAAAACATTCAGTACTTC	CAMGGGVPGQAKNIQYF	TRBV6-5	TRBJ2-4
TGTGCCAGCAGCCCTGACCTAGCTGGGGCCAACGTCCTGACTTTC	CASSPDLAGANVLTF	TRBV3-1	TRBJ2-6
TGTGCCAGCAGTGACCCCCAGGGAATTCCCACCCAAGAGACCCAGTACTTC	CASSDPQGIPTQETQYF	TRBV6-1	TRBJ2-5
TGCAGTGCTAGATTGGGCCGGGGACTATGTGCTGGGGCCAACGTCCTGACTTTC	CSARLGRGLCAGANVLTF	TRBV20-1	TRBJ2-6
TGTGCCAGCAGCGAAGCAGTAACTCCCTCACCGGGACCTGGCTACGAGCAGTACTTC	CASSEAVTPSPGPGYEQYF	TRBV11-3	TRBJ2-7
TGTGCCAGCAGTGAGCGAAAGGGGGCCGGAGAGACCCAGTACTTC	CASSERKGAGETQYF	TRBV6-4	TRBJ2-5
TGCGCCGGGGGCTCCCCTACTAATGAAAAACTGTTTTTT	CAGGSPTNEKLFF	TRBV10-1	TRBJ1-4
TGTGCCAGCATGAACCGGGGGGTCTACGAGCAGTACTTC	CASMNRGVYEQYF	TRBV2	TRBJ2-7
TGTGCCTTCTTTAACAACACTGAAGCTTTCTTT	CAFFNNTEAFF	TRBV30	TRBJ1-1
TGTGCCAGCCCCGGCCGGCCTAGCACAGATACGCAGTATTTT	CASPGRPSTDTQYF	TRBV27	TRBJ2-3
TGTGCCAGCACCGGGACACCCTACGAGCAGTACTTC	CASTGTPYEQYF	TRBV7-3	TRBJ2-7
TGTGCCAGCAGTTTCCCTCCGACTAGCGGGGGGGCCGCGCGCTACAATGAGCAGTTCTTC	CASSFPPTSGGAARYNEQFF	TRBV27	TRBJ2-1
TGTGCCAGCAGCTCCGAGCAGGGGAGGCAAGAGACCCAGTACTTC	CASSSEQGRQETQYF	TRBV7-2	TRBJ2-5
TGTGCCAGCAGCAGCCCAGGGGCCTTCACTGAAGCTTTCTTT	CASSSPGAFTEAFF	TRBV7-3	TRBJ1-1
TGCAGTGCTATAGCTCCTCCTAGATACGAGCAGTACTTC	CSAIAPPRYEQYF	TRBV20-1	TRBJ2-7
TGTGCCAGCATAGCGTCCTCTGGAAACACCATATATTTT	CASIASSGNTIYF	TRBV11-2	TRBJ1-3
TGTGCCAGCAGTTACTTGTGGAGGGACAGGGAGTATCCGGCAACTAATGAAAAACTGTTTTTT	CASSYLWRDREYPATNEKLFF	TRBV6-5	TRBJ1-4
TGTGCCAGCAGCCAGATACGTTATGAAAAACTGTTTTTT	CASSQIRYEKLFF	TRBV9	TRBJ1-4
TGCGCCAGCAACCCCAACACTGACTATGGCTACACCTTC	CASNPNTDYGYTF	TRBV4-3	TRBJ1-2
TGTGCCAGCAGTGTAGTGTTCCTAGCCCAAGCGGGCGGAAACGAGCAGTACTTC	CASSVVFLAQAGGNEQYF	TRBV2	TRBJ2-7
TGTGCCAGCAGCTTGCAGGCAAAGGAGGTGGGCTCTGGAAACACCATATATTTT	CASSLQAKEVGSGNTIYF	TRBV5-8	TRBJ1-3
TGTGCCAGCATTCCCCGGGACAGGGGCCCCGGGGAGCTGTTTTTT	CASIPRDRGPGELFF	TRBV6-4	TRBJ2-2
TGTGCCAGCAGCTCAGCGGGAGCTGAAGCTTTCTTT	CASSSAGAEAFF	TRBV5-6	TRBJ1-1
TGCAGTGCTAGGAGACCCCTACCTCCTGCGAACTATGGCTACACCTTC	CSARRPLPPANYGYTF	TRBV20-1	TRBJ1-2
TGTGCCAGCAGTAGGACTTGGGGATTCGAGCAGTACTTC	CASSRTWGFEQYF	TRBV27	TRBJ2-7
TGTGCCAGCAGCCAGCAGGACAGGCTATATAGCAATCAGCCCCAGCATTTT	CASSQQDRLYSNQPQHF	TRBV14	TRBJ1-5
TGTGCCAGCAGCTTGGGTTACAGCATGAACACTGAAGCTTTCTTT	CASSLGYSMNTEAFF	TRBV7-4	TRBJ1-1
TGCGCCAGCAGCTTGCGACTAGCCTCCCAGTACTTC	CASSLRLASQYF	TRBV5-1	TRBJ2-5
TGTGCCAGCAGCTTACGGGGACCCCCTCGAGCCTCCTACGAGCAGTACTTC	CASSLRGPPRASYEQYF	TRBV7-3	TRBJ2-7
TGTGCCTGTATCGCCATATTGAATGAGCAGTTCTTC	CACIAILNEQFF	TRBV30	TRBJ2-1
TGTGCCAGCAGCCAAGGTGAGAAAGGGTATTGGTTTTCACCCCTCCACTTT	CASSQGEKGYWFSPLHF	TRBV4-2	TRBJ1-6
TGTGCCAGCAGTCCGTCTAGGGGGCGGATTGGCTACACCTTC	CASSPSRGRIGYTF	TRBV6-6	TRBJ1-2
TGTGCCAGCATGTTTAGCGGGAGTGAAACGAACTACGAGCAGTACTTC	CASMFSGSETNYEQYF	TRBV7-6	TRBJ2-7
TGCGCCGGGCACTACGAGCAGTACTTC	CAGHYEQYF	TRBV10-2	TRBJ2-7
TGCAGTGAGGGACAGATGAATCAGCCCCAGCATTTT	CSEGQMNQPQHF	TRBV20-1	TRBJ1-5
TGTGCCAGCAAAAGCTGTGCCGGGACTAGCGGGGTGCAGTTCTTC	CASKSCAGTSGVQFF	TRBV9	TRBJ2-1
TGTGCCAGCAGTTTAGGAATGAACACTGAAGCTTTCTTT	CASSLGMNTEAFF	TRBV27	TRBJ1-1
TGTGCCAGCAGTGATAGAGGCGGGAGGGATCAGCCCCAGCATTTT	CASSDRGGRDQPQHF	TRBV6-4	TRBJ1-5
TGTGCCAGCAGTGAAGTTCACGGCGCGGGACGCGAGCAGTACTTC	CASSEVHGAGREQYF	TRBV6-1	TRBJ2-7
TGTGCCAGTAGCTCCCAGACTGAAGCTTTCTTT	CASSSQTEAFF	TRBV19	TRBJ1-1
TGTGCCAGCAGCTCACCGGACAGGGCTGAAGCTTTCTTT	CASSSPDRAEAFF	TRBV7-2	TRBJ1-1
TGTGCCAGCACCCCACCATCAGGGGGCAGGAGCAATCAGCCCCAGCATTTT	CASTPPSGGRSNQPQHF	TRBV9	TRBJ1-5
TGTGCCATCAGCCAATTCCAGGGATGGTCACCCCTCCACTTT	CAISQFQGWSPLHF	TRBV10-3	TRBJ1-6
TGTGCCAGTACTCGACAGAGCGAGCAGTACTTC	CASTRQSEQYF	TRBV19	TRBJ2-7
TGTGCCAGCAGTTACTCGACCCGCCACAATCAGCCCCAGCATTTT	CASSYSTRHNQPQHF	TRBV6-5	TRBJ1-5
TGTGCCAGCAGCCAAGATCCCAGCGGGAGGACACCCCTCCACTTT	CASSQDPSGRTPLHF	TRBV3-1	TRBJ1-6
TGTGCCAGCAGTGACGAGGGCCCTTTGGAGACCCAGTACTTC	CASSDEGPLETQYF	TRBV6-4	TRBJ2-5
TGTGCCAGCAGTTTCCGGGACAGAAGAGAGACCCAGTACTTC	CASSFRDRRETQYF	TRBV12-4	TRBJ2-5
TGTGCCCCCATTCGACCGAAGTACTTC	CAPIRPKYF	TRBV28	TRBJ2-7
TGCGCCAGCAGCCAAGCCCCCGGAGGACAAGGGCCAGCCAATCAGCCCCAGCATTTT	CASSQAPGGQGPANQPQHF	TRBV4-1	TRBJ1-5
TGTGCCAGCAGCAACTCGTCCCGACTCAATAGCAATCAGCCCCAGCATTTT	CASSNSSRLNSNQPQHF	TRBV5-5	TRBJ1-5
TGTGCCCCCTCGCCACCCTATGGCTACACCTTC	CAPSPPYGYTF	TRBV9	TRBJ1-2
TGTGCCAGCAGTTACTCGGAAGACCTGCCAAGGGCGGCCCCTAATGAAAAACTGTTTTTT	CASSYSEDLPRAAPNEKLFF	TRBV6-5	TRBJ1-4
TGTGCCAGCAGGGGCCCAGCAAGACATCAGCCCCAGCATTTT	CASRGPARHQPQHF	TRBV12-4	TRBJ1-5
TGTGCCTGCAGGAGGGGCTCTGGGGCCAACGTCCTGACTTTC	CACRRGSGANVLTF	TRBV6-5	TRBJ2-6
TGTGCCATCAGTGAGTCGACTAAGGGACAAGCCAAAAACATTCAGTACTTC	CAISESTKGQAKNIQYF	TRBV10-3	TRBJ2-4
TGTGCCAGCAGTTACTCGGCCCGACAACTAGCGGGGGATGGGGAGCAGTACTTC	CASSYSARQLAGDGEQYF	TRBV6-5	TRBJ2-7
TGTGCCAGCAGCTCAGCTCACAGGGGACAGGAGTATCAAAGTGGGCTAGCCCTTAGCAATCAGCCCCAGCATTTT	CASSSAHRGQEYQSGLALSNQPQHF	TRBV7-2	TRBJ1-5
TGTGCCATCAGCATTGGTTCACCCCTCCACTTT	CAISIGSPLHF	TRBV10-3	TRBJ1-6
TGCGCCACCCCGGGGGGAGGATGGTCCACAGATACGCAGTATTTT	CATPGGGWSTDTQYF	TRBV5-1	TRBJ2-3
TGTGCCAGCAGCGTATTTCAAGGCCCGGCAGAAGGTGTCGGGGAGCTGTTTTTT	CASSVFQGPAEGVGELFF	TRBV13	TRBJ2-2
TGCGCCAGCAGCCCGGGCGGGGAGCTGTTTTTT	CASSPGGELFF	TRBV4-1	TRBJ2-2
TGCGCCAGCAGCTTGAGGACAGGGCGGAAAGATACGCAGTATTTT	CASSLRTGRKDTQYF	TRBV5-1	TRBJ2-3
TGTGCTAGCAGCAAAAGGCTCTACGGGGGGTATCGGGAAAAACTGTTTTTT	CASSKRLYGGYREKLFF	TRBV7-7	TRBJ1-4
TGTGCCAGCAGCATGTCGAAGTCTCGGCTGGATCTTCACACTGAAGCTTTCTTT	CASSMSKSRLDLHTEAFF	TRBV11-2	TRBJ1-1
TGTGCCAGCAGCCAAGTGCCAGGGGGAGTAAGTGGCTACACCTTC	CASSQVPGGVSGYTF	TRBV4-2	TRBJ1-2
TGTGCCAGGAGGGGGCCCCACGAGCAGTACTTC	CARRGPHEQYF	TRBV6-6	TRBJ2-7
TGTGCCAGTAGTATGGAGTGGGGGGGTCCAGAGACCCAGTACTTC	CASSMEWGGPETQYF	TRBV19	TRBJ2-5
TGTGCCAGCAGTTACGTTATTTGGGACAGATTGAACACTGAAGCTTTCTTT	CASSYVIWDRLNTEAFF	TRBV6-5	TRBJ1-1
TGTGCCATCAGTTGGGGGCAGGTCTACAATGAGCAGTTCTTC	CAISWGQVYNEQFF	TRBV10-3	TRBJ2-1
TGTGCCAGCAGCGCCGGACAGGGACCTGCTGAAAAACTGTTTTTT	CASSAGQGPAEKLFF	TRBV7-2	TRBJ1-4
TGCGCCAGCAGCGGACAGGGGGTTAAGTACTTC	CASSGQGVKYF	TRBV5-1	TRBJ2-7
TGCAGTGCCTATGGACGGGGCTGTAACTATGGCTACACCTTC	CSAYGRGCNYGYTF	TRBV20-1	TRBJ1-2
TGTGCCAGCAGCGACGGAGGTGGGGGCTATTCGACCGCCAAAAACATTCAGTACTTC	CASSDGGGGYSTAKNIQYF	TRBV7-3	TRBJ2-4
TGCAGCGGGCAGGGGAGATCTACCGGGGAGCTGTTTTTT	CSGQGRSTGELFF	TRBV29-1	TRBJ2-2
TGTGCCAGCAGACTAGCGGGTGGCTACGAGCAGTACTTC	CASRLAGGYEQYF	TRBV6-4	TRBJ2-7
TGTGCCAGCAGTGACTCGATTTATCCAGCGCAGATCGCAAGTCCAGATACGCAGTATTTT	CASSDSIYPAQIASPDTQYF	TRBV6-4	TRBJ2-3
TGTGCCAGTAGTAAGGGGGGGCATGAAGCTTTCTTT	CASSKGGHEAFF	TRBV19	TRBJ1-1
TGTGCCAGCAGTTTATCACCGCGGGAGGTAGGAAACATTCAGTACTTC	CASSLSPREVGNIQYF	TRBV28	TRBJ2-4
TGCACCCCGGGGAAGATCTCTGGAAACACCATATATTTT	CTPGKISGNTIYF	TRBV20-1	TRBJ1-3
TGCGCCAGCAGCCCGGAGAGGTACGAGCAGTACTTC	CASSPERYEQYF	TRBV5-1	TRBJ2-7
TGTGCCAGCAGGTTGTACGGGGGCGACACTACCTACGAGCAGTACTTC	CASRLYGGDTTYEQYF	TRBV7-3	TRBJ2-7
TGCGCCAGCAGTGAGACCGGGACAGGGCAAGAGACCCAGTACTTC	CASSETGTGQETQYF	TRBV10-1	TRBJ2-5
TGTGCCAGCAGCCCGGGACAGGGGGTAGAATCCTATAATTCACCCCTCCACTTT	CASSPGQGVESYNSPLHF	TRBV7-9	TRBJ1-6
TGCGCCAGCAGACTCTTGGACAGGTTGTACAATGAGCAGTTCTTC	CASRLLDRLYNEQFF	TRBV10-1	TRBJ2-1
TGTGCCAGCAGGAGCGGGGTAAGCAATCAGCCCCAGCATTTT	CASRSGVSNQPQHF	TRBV12-4	TRBJ1-5
TGTGCCAGCAGGCTAGACAGAAGGTACGAGCAGTACTTC	CASRLDRRYEQYF	TRBV7-6	TRBJ2-7
TGTGCCAGCAGCAGATCAGGGGGCGGGAATCAGCCCCAGCATTTT	CASSRSGGGNQPQHF	TRBV7-3	TRBJ1-5
TGTGCCAGCAGTTTACCTCTAGCTAAGCGGCCGCTAGGGAAAAACATTCAGTACTTC	CASSLPLAKRPLGKNIQYF	TRBV12-4	TRBJ2-4
TGTGCCAGCAGCCGGTTCCGACAATACACCATATATTTT	CASSRFRQYTIYF	TRBV3-1	TRBJ1-3
TGTGCCAGCAGCGGTCTAGCGGGGGCCCGCACAGATACGCAGTATTTT	CASSGLAGARTDTQYF	TRBV13	TRBJ2-3
TGTGCCAGCAGCAAGGGGGAACTTCATGGCTACACCTTC	CASSKGELHGYTF	TRBV9	TRBJ1-2
TGTGCCAGCAGTTCGCATGGCACCGGGGGCTACACCTTC	CASSSHGTGGYTF	TRBV6-5	TRBJ1-2
TGTGCCAGCAGCCACTCCTCGGACAGGTACCTAAATGGCTACACCTTC	CASSHSSDRYLNGYTF	TRBV3-1	TRBJ1-2
TGCGCCAGCAGCCAGAGGGGCTCTGGAAACACCATATATTTT	CASSQRGSGNTIYF	TRBV10-1	TRBJ1-3
TGTGCCAGCAGCTGCCAGGACAGGGGTGGCTACACCTTC	CASSCQDRGGYTF	TRBV7-2	TRBJ1-2
TGTGCCAGCAGAAGACGGGACAGGGGGGATAATTCACCCCTCCACTTT	CASRRRDRGDNSPLHF	TRBV11-1	TRBJ1-6
TGTGCCATCAGTGAGTCAGTTGGAGATAACAATGAGCAGTTCTTC	CAISESVGDNNEQFF	TRBV10-3	TRBJ2-1
TGCGCCAGCAGCCAAGAAGGAAAGAGGACTAGCGGTGCGGAGACCCAGTACTTC	CASSQEGKRTSGAETQYF	TRBV4-1	TRBJ2-5
TGTGCCAGCAGCCAAGGCAGGAAGCTGGTACTACCCCAAGAGACCCAGTACTTC	CASSQGRKLVLPQETQYF	TRBV14	TRBJ2-5
TGTGCCAGCAGTTATCTAGCGCAGTACTTC	CASSYLAQYF	TRBV6-4	TRBJ2-5
TGTGCCAGCAGCGACAGGGAATACCGGAACACTGAAGCTTTCTTT	CASSDREYRNTEAFF	TRBV13	TRBJ1-1
TGTGCCAGCAGCCAAGATGAATACTACAATGAGCAGTTCTTC	CASSQDEYYNEQFF	TRBV3-1	TRBJ2-1
TGTGCCAGCAGCCCTCGCAGAGAGGGCTATAGTTTCTATGGCTACACCTTC	CASSPRREGYSFYGYTF	TRBV3-1	TRBJ1-2
TGCGCCAGCAGCCAAAACGTAATCTCCGTATTTAACTACGAGCAGTACTTC	CASSQNVISVFNYEQYF	TRBV4-3	TRBJ2-7
TGTGCCAGCAAGGGCGCTAATGAAAAACTGTTTTTT	CASKGANEKLFF	TRBV6-8	TRBJ1-4
TGCGCCAGCAGCTTGACCCGGACAGGGTACGGCACCGGGGAGCTGTTTTTT	CASSLTRTGYGTGELFF	TRBV5-1	TRBJ2-2
TGTGCCAGCAGTTACGACTCTAATGAAAAACTGTTTTTT	CASSYDSNEKLFF	TRBV6-2	TRBJ1-4
TGCGCCAGCAGCGACCCAGGTAACTATGGCTACACCTTC	CASSDPGNYGYTF	TRBV5-1	TRBJ1-2
TGTGCCAGCAGAGAAAACAGCAGGGAGGGGGGTGGCACTGAAGCTTTCTTT	CASRENSREGGGTEAFF	TRBV6-5	TRBJ1-1
TGCAGTGCTAGCCAATTGACCGGGGGGGCCTACAATGAGCAGTTCTTC	CSASQLTGGAYNEQFF	TRBV20-1	TRBJ2-1
TGTGCCAGCAGCTCATTAGGGGGCAATGAGCAGTTCTTC	CASSSLGGNEQFF	TRBV5-6	TRBJ2-1
TGTGCCTATAGCGGTTTAAATGAGCAGTTCTTC	CAYSGLNEQFF	TRBV30	TRBJ2-1
TGTGCCAGCACCCCGGGGGGGCTGGGCTACGAGCAGTACTTC	CASTPGGLGYEQYF	TRBV6-3	TRBJ2-7
TGTGCCAGCATTCCTTACTTCAGGGGAAACACCATATATTTT	CASIPYFRGNTIYF	TRBV28	TRBJ1-3
TGTGCCAGCAGCGTGGGATGGGAGTCGGGGGTGGCAACAGACTACGAGCAGTACTTC	CASSVGWESGVATDYEQYF	TRBV28	TRBJ2-7
TGCGCCAGCAGCCCTCGTGGGGGGGGAACCTACGAGCAGTACTTC	CASSPRGGGTYEQYF	TRBV4-3	TRBJ2-7
TGCAGTGCGGCTGACAGGGGTCGCTCTGGGGCCAACGTCCTGACTTTC	CSAADRGRSGANVLTF	TRBV20-1	TRBJ2-6
TGCAGCGTTGCGTTAGGGGAAGAGACCCAGTACTTC	CSVALGEETQYF	TRBV29-1	TRBJ2-5
TGTGCCAGCAGCTTACGGGACAGGGCCTATTCCTACGAGCAGTACTTC	CASSLRDRAYSYEQYF	TRBV7-2	TRBJ2-7
TGTGCCAGCAGCTTGGCAAGCGGGACTAGGAAGAGCTCCTACGAGCAGTACTTC	CASSLASGTRKSSYEQYF	TRBV5-4	TRBJ2-7
TGTGCCAGCAGCTTCGCCCTCTACGAGCAGTACTTC	CASSFALYEQYF	TRBV5-4	TRBJ2-7
TGTGCCAGCAGCTTAGTTAATATTTATACCAGACAGGCACTCTCTGGAAACACCATATATTTT	CASSLVNIYTRQALSGNTIYF	TRBV7-9	TRBJ1-3
TGTGCCAGCAGTGAAGGCGCTGAAGGACATCAAAATGAGCAGTTCTTC	CASSEGAEGHQNEQFF	TRBV2	TRBJ2-1
TGTGCCAGCAGAGAGGATGCGGGACGAAGGGACTATGGCTACACCTTC	CASREDAGRRDYGYTF	TRBV6-4	TRBJ1-2
TGTGCCAGCAGTGCCCTAGCGGGAACAGATACGCAGTATTTT	CASSALAGTDTQYF	TRBV6-6	TRBJ2-3
TGTGCCAGCAGCTTCGGAACCGCTAGCGGGCTCGGGGAGCTGTTTTTT	CASSFGTASGLGELFF	TRBV7-2	TRBJ2-2
TGCGCCAGCAGCTCTAGAATAGCGGGACCCCGGGAGACCCAGTACTTC	CASSSRIAGPRETQYF	TRBV5-1	TRBJ2-5
TGTGCCAGCAGTTACAAGGACAGCCCCGACATTCAGTACTTC	CASSYKDSPDIQYF	TRBV6-2	TRBJ2-4
TGTGCCAGCAGTAAAGGGGAGGCAGATACGCAGTATTTT	CASSKGEADTQYF	TRBV28	TRBJ2-3
TGTGCCAGCAGGGTACCCGGGTTTGGGGAGGATCGAAAGAACACCGGGGAGCTGTTTTTT	CASRVPGFGEDRKNTGELFF	TRBV6-5	TRBJ2-2
TGTGCCAGCAGCTTCCCGAATTGGCGACAGGGACACACTGAAGCTTTCTTT	CASSFPNWRQGHTEAFF	TRBV7-2	TRBJ1-1
TGCAGTGCTAGAGATTCGGGGGGAGAGACCCAGTACTTC	CSARDSGGETQYF	TRBV20-1	TRBJ2-5
TGCGCCAGCAGTTCGAACAGGCGAGATACGCAGTATTTT	CASSSNRRDTQYF	TRBV4-1	TRBJ2-3
TGCGCCAGCAGTGAGTCGAGGCTGGGGCGGGGGCGAGGGGGCGACACTGAAGCTTTCTTT	CASSESRLGRGRGGDTEAFF	TRBV10-1	TRBJ1-1
TGTGCCAGCAGCGACGGGGGGGTGACAGATACGCAGTATTTT	CASSDGGVTDTQYF	TRBV11-3	TRBJ2-3
TGTGCCAGCAGCGGTTTAAGCTACGAGCAGTACTTC	CASSGLSYEQYF	TRBV11-2	TRBJ2-7
TGCAGTGCCTCAGGGTCCAGGAGCTCTGGGGCCAACGTCCTGACTTTC	CSASGSRSSGANVLTF	TRBV20-1	TRBJ2-6
TGTGCCTGGAGTGTACTAAAGGGGGTTGGGGCTGGGGAGCTGTTTTTT	CAWSVLKGVGAGELFF	TRBV30	TRBJ2-2
TGTGCCAGTAGAAGGCCTGATTATTCCCGTCAGCCCCAGCATTTT	CASRRPDYSRQPQHF	TRBV19	TRBJ1-5
TGTGCCAGCAGTTTAGCAAAGAGGACAGACCTTTATCAGCCCCAGCATTTT	CASSLAKRTDLYQPQHF	TRBV12-4	TRBJ1-5
TGCAGCGTTGAGTCAGTACTACCGACTAGCGGGCCTGGGGCCAACGTCCTGACTTTC	CSVESVLPTSGPGANVLTF	TRBV29-1	TRBJ2-6
TGTGCCAGCAGTAGGCGGAGGTACACCTTC	CASSRRRYTF	TRBV6-4	TRBJ1-2
TGTGCCAGCAGCTTAGAGGACAGGCGTAACACTGAAGCTTTCTTT	CASSLEDRRNTEAFF	TRBV11-2	TRBJ1-1
TGTGCCAGCAGTCACCGGGACAGCCTTCCCAATCAGCCCCAGCATTTT	CASSHRDSLPNQPQHF	TRBV3-1	TRBJ1-5
TGTGCCAGAGCGGAAGACAGACCGTACACTGAAGCTTTCTTT	CARAEDRPYTEAFF	TRBV18	TRBJ1-1
TGTGCCAGCAGCAGTCCGAGCGGGATATTATCCTACGAGCAGTACTTC	CASSSPSGILSYEQYF	TRBV5-8	TRBJ2-7
TGTGCCAGCAGCCAACGGGGTAAGCACACTGAAGCTTTCTTT	CASSQRGKHTEAFF	TRBV13	TRBJ1-1
TGTGCCAGCAGCTTAGAGGAAAAGCCCGGGGGCAATCAGCCCCAGCATTTT	CASSLEEKPGGNQPQHF	TRBV11-3	TRBJ1-5
TGTGCCAGCAGCTGCCCGGGCCCTTCGCAGTACTTC	CASSCPGPSQYF	TRBV5-4	TRBJ2-7
TGTGCCAGCAGGCCCGGGGGGGCGAACACCGGGGAGCTGTTTTTT	CASRPGGANTGELFF	TRBV9	TRBJ2-2
TGTGCCAGCAGGCCCCGGGCCGGCGGCTTGAGCTCTGGAAACACCATATATTTT	CASRPRAGGLSSGNTIYF	TRBV11-2	TRBJ1-3
TGCGCCAGCAGCCCAGGGAGGGTCCCGAACACTGAAGCTTTCTTT	CASSPGRVPNTEAFF	TRBV5-1	TRBJ1-1
TGTGCCAGCAGTTTTGGCGACCGTGCCTACGAGCAGTACTTC	CASSFGDRAYEQYF	TRBV28	TRBJ2-7
TGCAGTATCAGCACCTCTGGAAACACCATATATTTT	CSISTSGNTIYF	TRBV20-1	TRBJ1-3
TGTGCCAGCAGCCCCCTAAGGTACGAGCAGTACTTC	CASSPLRYEQYF	TRBV4-2	TRBJ2-7
TGTGCCTGGATTACGGGTTATAGGTTATACAATGAGCAGTTCTTC	CAWITGYRLYNEQFF	TRBV30	TRBJ2-1
TGTGCCAGCAGGGGCATGTGGGGACATCGGAATTCACCCCTCCACTTT	CASRGMWGHRNSPLHF	TRBV9	TRBJ1-6
TGTGCCAGCAGCGTAGCCCGGAGTCCCAAAAACATTCAGTACTTC	CASSVARSPKNIQYF	TRBV9	TRBJ2-4
TGTGCCAGCTCACCACCGACACCGAAGACGAACTATGGCTACACCTTC	CASSPPTPKTNYGYTF	TRBV18	TRBJ1-2
TGTGCCAGCAGATTGGAACTAGCGGGAAGCGGAGAGACCCAGTACTTC	CASRLELAGSGETQYF	TRBV27	TRBJ2-5
TGCACAATTTCGCAGGGTCCTTTGGGGGGAACTAATGAAAAACTGTTTTTT	CTISQGPLGGTNEKLFF	TRBV20-1	TRBJ1-4
TGTGCCAGCAGTGACTCGGGGCCCACGGACACTGAAGCTTTCTTT	CASSDSGPTDTEAFF	TRBV6-4	TRBJ1-1
TGTGCCAGCAGTCGGCGGGACACCAGGGCCTCGGAAAACATTCAGTACTTC	CASSRRDTRASENIQYF	TRBV6-6	TRBJ2-4
TGTGCCACCAGCAGAGACTGGGCTAGCCCCTACGAGCAGTACTTC	CATSRDWASPYEQYF	TRBV15	TRBJ2-7
TGCAGTGCTCCCCCTGGACTAGAGTCTGGCACAGATACGCAGTATTTT	CSAPPGLESGTDTQYF	TRBV20-1	TRBJ2-3
TGTGCCAGCAGTTATGGAAAGAAGATTGGGTTTAGGAACACTGAAGCTTTCTTT	CASSYGKKIGFRNTEAFF	TRBV9	TRBJ1-1
TGCGCCAGCAGCTTGGGCCGGGAAGTTGGTAACTATGGCTACACCTTC	CASSLGREVGNYGYTF	TRBV5-1	TRBJ1-2
TGTGCCAGCAGCTACGCCGGGACTAGCGGCCACAATGAGCAGTTCTTC	CASSYAGTSGHNEQFF	TRBV7-6	TRBJ2-1
TGTGCCAGCAGCATCCGGGCCTACAATGAGCAGTTCTTC	CASSIRAYNEQFF	TRBV13	TRBJ2-1
TGTGCCAGCAGTCTTGTTCCTAGGGCCAACGTCCTGACTTTC	CASSLVPRANVLTF	TRBV27	TRBJ2-6
TGTGCCAGCAGCACCGTGACTGGGGACACCATATATTTT	CASSTVTGDTIYF	TRBV7-4	TRBJ1-3
TGCAGTGCTAGAGATGGGGCTTACGAGAATAATTCACCCCTCCACTTT	CSARDGAYENNSPLHF	TRBV20-1	TRBJ1-6
TGTGCCAGCAGTCAGCAGGACAGATCCTCTGGGGCCAACGTCCTGACTTTC	CASSQQDRSSGANVLTF	TRBV6-2	TRBJ2-6
TGTGCCAGCAGCGGGTGTCGAAACAGGAGAGTCGACAATCAGCCCCAGCATTTT	CASSGCRNRRVDNQPQHF	TRBV12-3	TRBJ1-5
TGTGCCATCAGTGCTTCTAGGACTAGCTCGCACAATGAGCAGTTCTTC	CAISASRTSSHNEQFF	TRBV10-3	TRBJ2-1
TGTGCCAGCAGCTGCCAGGGAGACGAGCAGTACTTC	CASSCQGDEQYF	TRBV11-1	TRBJ2-7
TGTGCCAGCAGATTTACTGGGGGGGAGCAGTACTTC	CASRFTGGEQYF	TRBV6-5	TRBJ2-7
TGTGCCAGCACCCCGTATTTTGAAGCTTTCTTT	CASTPYFEAFF	TRBV9	TRBJ1-1
TGTGCCACCTGGTTGGGACAGGGCACAATAAACAATGAGCAGTTCTTC	CATWLGQGTINNEQFF	TRBV7-9	TRBJ2-1
TGCCAGCGGGAGTGTCAGCCCCAGCATTTT	CQRECQPQHF	TRBV20-1	TRBJ1-5
TGCGCCAGCAAGGGGTGTCAATACGCAGAAAAACTGTTTTTT	CASKGCQYAEKLFF	TRBV10-1	TRBJ1-4
TGCAGTGCTAGAGATGGCATTCTAGGAGCCTTGCAGTTCTTC	CSARDGILGALQFF	TRBV20-1	TRBJ2-1
TGCAGTGCTATCGTGACAGGTACTGAAGCTTTCTTT	CSAIVTGTEAFF	TRBV20-1	TRBJ1-1
TGTGCCAGCAGCTTGGCAAATGAAAAACTGTTTTTT	CASSLANEKLFF	TRBV9	TRBJ1-4
TGTGCCAGCAGCTTAGAAACTAGCGGGAGGAAATACGAGCAGTACTTC	CASSLETSGRKYEQYF	TRBV7-9	TRBJ2-7
TGTGCCAGCCGAACGAAAGACGTCGCCCAGGGGACAACCCAGCATTTT	CASRTKDVAQGTTQHF	TRBV18	TRBJ1-5
TGTGCCAGCAGCCAAGTCCGTCGTAGGGCGTCGACCGGGACAGATTTTCATTTAGAGACCCAGTACTTC	CASSQVRRRASTGTDFHLETQYF	TRBV14	TRBJ2-5
TGTGCCAGCAGTTCTTTAGACAGGGGGGGGGGCTCCTACGAGCAGTACTTC	CASSSLDRGGGSYEQYF	TRBV25-1	TRBJ2-7
TGTGCCAGCAGCGATGGCTTGGGGGAAGAGACCCAGTACTTC	CASSDGLGEETQYF	TRBV9	TRBJ2-5
TGTGCCAGCAGCTTGGTATCGGACAGGCAGCCCCAGCATTTT	CASSLVSDRQPQHF	TRBV5-6	TRBJ1-5
TGTGCCAGTAGTATGGGACAGGGGGACGTAGAATACAATGAGCAGTTCTTC	CASSMGQGDVEYNEQFF	TRBV19	TRBJ2-1
TGTGCCAGCAGCCAAGAAGTCCGGGACAGGGGGCGAGGAGATACGCAGTATTTT	CASSQEVRDRGRGDTQYF	TRBV3-1	TRBJ2-3
TGTGCCAGCAGCTTAGCACAGCTAGGCTACAATGAGCAGTTCTTC	CASSLAQLGYNEQFF	TRBV7-9	TRBJ2-1
TGTGCCAGCGATTCGGGGGACTCCTATAATTCACCCCTCCACTTT	CASDSGDSYNSPLHF	TRBV7-3	TRBJ1-6
TGTGCCAGCAGCGGGGTGGGCTACGAGCAGTACTTC	CASSGVGYEQYF	TRBV6-2	TRBJ2-7
TGTGCCAGCAGTGTAACCCCGGCTGGGAGCGAGCAGTACTTC	CASSVTPAGSEQYF	TRBV6-4	TRBJ2-7
TGCGCCAGCAGCTCCGCCGGGTACAATGAGCAGTTCTTC	CASSSAGYNEQFF	TRBV5-1	TRBJ2-1
TGTGCCACCAGTGAGGAGCGGTATGGCTACACCTTC	CATSEERYGYTF	TRBV24-1	TRBJ1-2
TGTGCCAGCAGCCAACCAGCCCGGGGGGACAGGGTTCGGGAAACTGAAGCTTTCTTT	CASSQPARGDRVRETEAFF	TRBV3-1	TRBJ1-1
TGTGCCAGCAGCCAAACGTCCGAGCAGCCCCAGCATTTT	CASSQTSEQPQHF	TRBV7-2	TRBJ1-5
TGCGCCAGCAGTATGCTCGATGCGGCCTACGAGCAGTACTTC	CASSMLDAAYEQYF	TRBV10-1	TRBJ2-7
TGTGCCAGCAGTAATGGACCGGCGAACACTGAAGCTTTCTTT	CASSNGPANTEAFF	TRBV27	TRBJ1-1
TGCAGCGTTGCCCACCGGGGGCCACTTAATCAGCCCCAGCATTTT	CSVAHRGPLNQPQHF	TRBV29-1	TRBJ1-5
TGTGCCAGCAGCCAAGGGGCTGGTGGGAGCGGGATGGAACTCCAAATGCAAGAGACCCAGTACTTC	CASSQGAGGSGMELQMQETQYF	TRBV14	TRBJ2-5
TGTGCCAGCAGTGAATACAGGCCCTATGGCTACACCTTC	CASSEYRPYGYTF	TRBV25-1	TRBJ1-2
TGTGCCAGCAGTATCGGCGGGAAGACTCCCTACGAGCAGTACTTC	CASSIGGKTPYEQYF	TRBV12-3	TRBJ2-7
TGTGCCAGCAGCTTAAGAACAGGACAGATCAATCAGCCCCAGCATTTT	CASSLRTGQINQPQHF	TRBV7-9	TRBJ1-5
TGTGCCAGCAGTTTTGGGGCGGGGGTCCCGAACACCGGGGAGCTGTTTTTT	CASSFGAGVPNTGELFF	TRBV6-5	TRBJ2-2
TGTGCCAGCAGCTTACCAAATCGACAGGGACTCCGGAACACTGAAGCTTTCTTT	CASSLPNRQGLRNTEAFF	TRBV7-9	TRBJ1-1
TGTGCCAGCAGTTACTCCAGGGGAGGCTATGGCTACACCTTC	CASSYSRGGYGYTF	TRBV6-5	TRBJ1-2
TGTGCCAGCAGCTGCAAGACAGAGGTGAACTATGGCTACACCTTC	CASSCKTEVNYGYTF	TRBV27	TRBJ1-2
TGTGCCAGCAGCTTGGCCATCATCAGGGGATGGTCTGAAGCTTTCTTT	CASSLAIIRGWSEAFF	TRBV5-4	TRBJ1-1
TGTGCCAGCAGTTTCTTGGAGGGACCCCAGAATGAGCAGTTCTTC	CASSFLEGPQNEQFF	TRBV28	TRBJ2-1
TGTGCCAGCAGATGGACGGCGCAAGTTGAGACTGAAGCTTTCTTT	CASRWTAQVETEAFF	TRBV28	TRBJ1-1
TGTGCTAGTGGTTTGGTAGGGGCAGGGCCCTACGAGCAGTACTTC	CASGLVGAGPYEQYF	TRBV12-5	TRBJ2-7
TGTGCCAGCAGCTTAGCGCCGGGACAAATGAACACTGAAGCTTTCTTT	CASSLAPGQMNTEAFF	TRBV7-6	TRBJ1-1
TGCGCCATCGAAACTAGCGGGGCCGCCACAGATACGCAGTATTTT	CAIETSGAATDTQYF	TRBV5-1	TRBJ2-3
TGTGCCAGCAGTACCACAGGGGCTCAGCCCCAGCATTTT	CASSTTGAQPQHF	TRBV28	TRBJ1-5
TGTGCCAGCAGCCATCCCGGGAGGGTGGGCTGGCCCAATGAGCAGTTCTTC	CASSHPGRVGWPNEQFF	TRBV13	TRBJ2-1
TGTGCCAGCAGCTTAGTAGCCAAAGGGGGGGGCGAGCAGTACTTC	CASSLVAKGGGEQYF	TRBV7-2	TRBJ2-7
TGTGCCAGCACGTGGGCCATCCTTGGCTACACCTTC	CASTWAILGYTF	TRBV7-9	TRBJ1-2
TGTGCCAGCAGTTTCAAACCCGGGACGTATAACACTGAAGCTTTCTTT	CASSFKPGTYNTEAFF	TRBV12-3	TRBJ1-1
TGTGCCAGCAGTTTCCAAGGGGGCCCGGGTCACACTGAAGCTTTCTTT	CASSFQGGPGHTEAFF	TRBV6-2	TRBJ1-1
TGTGCCAGCAGCCGGTTTAAGAGTTACGAGCAGTACTTC	CASSRFKSYEQYF	TRBV11-2	TRBJ2-7
TGCGCCAGCAGTGATAAGGGGGCGGGAGCAGATACGCAGTATTTT	CASSDKGAGADTQYF	TRBV10-1	TRBJ2-3
TGCGCCAGCAGCCACGCGGTCTACGAGCAGTACTTC	CASSHAVYEQYF	TRBV5-1	TRBJ2-7
TGTGCCGTTACACGGAGAGGCATTCAGTACTTC	CAVTRRGIQYF	TRBV10-3	TRBJ2-4
TGTGCCAGCAGCTTGAGAGGAGGGATGGGCTACGAGCAGTACTTC	CASSLRGGMGYEQYF	TRBV11-2	TRBJ2-7
TGTGCCAGCAGCCCTCCTATAGCTACAGCTGAGACCCAGTACTTC	CASSPPIATAETQYF	TRBV4-2	TRBJ2-5
TGTGCCAGACAGGGGTACGAAGCCGGCGGCTACACCTTC	CARQGYEAGGYTF	TRBV28	TRBJ1-2
TGTGCCAGCAGCCAAAAGAGCCTAGCGGGGGGAAATGAGCAGTTCTTC	CASSQKSLAGGNEQFF	TRBV14	TRBJ2-1
TGTGCCAGCAGGGGGGGTATTATAAGTGAAGCTTTCTTT	CASRGGIISEAFF	TRBV6-5	TRBJ1-1
TGTGCCAGGCCGGACGAGATGAACACTGAAGCTTTCTTT	CARPDEMNTEAFF	TRBV6-1	TRBJ1-1
TGTGCCAGCAGCATGGTCCCTAGACAGGCTTCCTCCTACGAGCAGTACTTC	CASSMVPRQASSYEQYF	TRBV7-9	TRBJ2-7
TGTGCCAGCAGTTACCCGCCCTGCACGGGGGCTCAGCCCCAGCATTTT	CASSYPPCTGAQPQHF	TRBV6-5	TRBJ1-5
TGTGCCAGCGGGTCTAGGAAACCCTACGAGCAGTACTTC	CASGSRKPYEQYF	TRBV25-1	TRBJ2-7
TGCAGTGCTAGCCCCACCTTACTTCTAGAGGGTAGCACAGATACGCAGTATTTT	CSASPTLLLEGSTDTQYF	TRBV20-1	TRBJ2-3
TGTGCCAGCAGTTTAGGACTGGGACAGATTGCGGAACGAAAACTGTTTTTT	CASSLGLGQIAERKLFF	TRBV28	TRBJ1-4
TGCGCCAGCAGCCGTAAACGGCGACCGGGGGGACAGGGATTGCAGTTCTTC	CASSRKRRPGGQGLQFF	TRBV4-1	TRBJ2-1
TGTGCCACCATAGACAGGGGGCCGCGTGAGGAGAGCTCCTACGAGCAGTACTTC	CATIDRGPREESSYEQYF	TRBV24-1	TRBJ2-7
TGTGCCAGCAGTGGGGCCGTACATGGCTACACCTTC	CASSGAVHGYTF	TRBV6-3	TRBJ1-2
TGTGCCACGTTTTCAGGGGGAGGGAATCAGCCCCAGCATTTT	CATFSGGGNQPQHF	TRBV19	TRBJ1-5
TGTGCCAGCAGCTATCCTCTAAAAGCGGGAGAACAGAGGGCCTACGAGCAGTACTTC	CASSYPLKAGEQRAYEQYF	TRBV7-2	TRBJ2-7
TGTGCCAGCAGCTCTGAGGCAGGGGGGCGAGCTGAAGCTTTCTTT	CASSSEAGGRAEAFF	TRBV11-3	TRBJ1-1
TGTGCCAGCAGGGGAATGACGGCTGGGACAAGCTACGAGCAGTACTTC	CASRGMTAGTSYEQYF	TRBV6-3	TRBJ2-7
TGTGCCAGCAGCTTAAGGGCTAGAATAGGCACAGATACGCAGTATTTT	CASSLRARIGTDTQYF	TRBV7-3	TRBJ2-3
TGTGCCAGCTCACCACTAGCGGCTTTGGGGCGTGAGACCCAGTACTTC	CASSPLAALGRETQYF	TRBV18	TRBJ2-5
TGTGCCAGCAGTGGGAACGTTTCCATCTCCTACAATGAGCAGTTCTTC	CASSGNVSISYNEQFF	TRBV6-2	TRBJ2-1
TGTGCCAGCAGCCTCCACAGCCCAGAGCAGTACTTC	CASSLHSPEQYF	TRBV7-3	TRBJ2-7
TGTGCCTGGGGGGAAGGTCGGAGCTACAATGAGCAGTTCTTC	CAWGEGRSYNEQFF	TRBV10-3	TRBJ2-1
TGTGCCAGCAGCGGAATCAAAGCGACAGGGCCACTTAACGAGCAGTACTTC	CASSGIKATGPLNEQYF	TRBV7-4	TRBJ2-7
TGTGCCAGCAGCGGAACCCAGGAACAGACAGATACGCAGTATTTT	CASSGTQEQTDTQYF	TRBV7-7	TRBJ2-3
TGTGCCAGCAGTTTCGACGGTGATGGGACTCAAGAGACCCAGTACTTC	CASSFDGDGTQETQYF	TRBV12-3	TRBJ2-5
TGTGCCAGCAGCCAAGTCGGAAAGGGACAGGCCAAAAACATTCAGTACTTC	CASSQVGKGQAKNIQYF	TRBV4-2	TRBJ2-4
TGCGCCAGCACAAACAAGGCAGGGGGCCGAGGAACCGACGGTAAACCACTGTTTTTT	CASTNKAGGRGTDGKPLFF	TRBV10-1	TRBJ1-4
TGTGCCAGCAAGAGGGCGGGAGGCAATCAGCCCCAGCATTTT	CASKRAGGNQPQHF	TRBV6-4	TRBJ1-5
TGTGCCAGCAGCCAAGATGCCACGGGACAGGCCCTGAACCGTAATCAGCCCCAGCATTTT	CASSQDATGQALNRNQPQHF	TRBV4-2	TRBJ1-5
TGCAGCGTTGGAGAGGTCTACGAGCAGTACTTC	CSVGEVYEQYF	TRBV29-1	TRBJ2-7
TGTGCCAGCACCCCTCCGAGGGAACTGTTTTTT	CASTPPRELFF	TRBV6-4	TRBJ1-4
TGTGCCAGCAGGCCTGACTCACCCCTCCACTTT	CASRPDSPLHF	TRBV4-2	TRBJ1-6
TGTGCCAGCAGTTACTCGAAAAACCTAGCGGGAAGTCTAGGAAACATTCAGTACTTC	CASSYSKNLAGSLGNIQYF	TRBV6-6	TRBJ2-4
TGTGCCAGCAGCCAACCAGTCCGGGAACAGGGTGGTCTACTAGGATATGCTTCTGACGAGCAGTACTTC	CASSQPVREQGGLLGYASDEQYF	TRBV3-1	TRBJ2-7
TGCGCCAGCAGCCAAGAAGAGGGCAGGGTTTGGGCAGTTAATATCGGCTACACCTTC	CASSQEEGRVWAVNIGYTF	TRBV4-1	TRBJ1-2
TGTGCCAGCAGCCAAGTCCCCCCAGGAGGAGGGAGTGAAGAGACCCAGTACTTC	CASSQVPPGGGSEETQYF	TRBV14	TRBJ2-5
TGTGCCAGCTCTTATGACAGGGGTTGGGGCTACACCTTC	CASSYDRGWGYTF	TRBV6-5	TRBJ1-2
TGTGCCAGCAGCTTAGGCCAAGGACTAGCGGGTGAGCAGTTCTTC	CASSLGQGLAGEQFF	TRBV11-1	TRBJ2-1
TGTGCCTGGCCAACCAGGGTTAACACTGAAGCTTTCTTT	CAWPTRVNTEAFF	TRBV30	TRBJ1-1
TGCGCCAGCAGCGGGAGGGGCGCTTTCTTT	CASSGRGAFF	TRBV4-3	TRBJ1-1
TGCGCCAGCAGCCAAGACGGTAAAGTTGCTCGTGCACATGGCTACACCTTC	CASSQDGKVARAHGYTF	TRBV4-3	TRBJ1-2
TGTGCCAGCACCCGGGTGCCTAAAAACATTCAGTACTTC	CASTRVPKNIQYF	TRBV28	TRBJ2-4
TGTGCCAGCAGCTTACAGGGTTCACCCCTCCACTTT	CASSLQGSPLHF	TRBV7-6	TRBJ1-6
TGTGCCAGCAGCTTATCACGGAGGATATCTTTGTGTGAGCAGTACTTC	CASSLSRRISLCEQYF	TRBV7-9	TRBJ2-7
TGCGCCAGCAGCTTCTCCTGGGACAGGGGGTACACCTTC	CASSFSWDRGYTF	TRBV5-1	TRBJ1-2
TGTGCCAGCAGCTGGCAGTTTTCCAATCAGCCCCAGCATTTT	CASSWQFSNQPQHF	TRBV7-9	TRBJ1-5
TGTGCCAGATCGGTCAGCGGGAATCAGGACAATGAGCAGTTCTTC	CARSVSGNQDNEQFF	TRBV7-2	TRBJ2-1
TGTGCCAGCAGCGTACCTCCGACAACTGAAGCTTTCTTT	CASSVPPTTEAFF	TRBV9	TRBJ1-1
TGCGCCAGGTCCCCTAGACGGCGCTCTCATGAGCAGTTCTTC	CARSPRRRSHEQFF	TRBV10-2	TRBJ2-1
TGTGCCAGCAGCCTCCAGCCCCAGACGAACTATGGCTACACCTTC	CASSLQPQTNYGYTF	TRBV14	TRBJ1-2
TGTGCCAGCAGCCAAGATGGCGGGAGTCAGCCCCAGCATTTT	CASSQDGGSQPQHF	TRBV14	TRBJ1-5
TGTGCTAGTGGTTTGGTACCCCTGGACAGGGGAGTGGCTCTCAGTTTCGTGAAAGGGAGGCATTTT	CASGLVPLDRGVALSFVKGRHF	TRBV12-5	TRBJ1-5
TGTGCCAGCAGGGGCGAGGGGGCAGATACGCAGTATTTT	CASRGEGADTQYF	TRBV6-5	TRBJ2-3
TGTGCCAGCAGTTACTCCCTGGGACCGGGACGGAGATCCTACGAGCAGTACTTC	CASSYSLGPGRRSYEQYF	TRBV6-5	TRBJ2-7
TGTGCCAGCAGCTTGGCCCCCCTAGCGGGGAACCAGAGGAACGAGCAGTACTTC	CASSLAPLAGNQRNEQYF	TRBV7-9	TRBJ2-7
TGTGCCAGCAGTTACCCCTCTCGGGACAGGACTGAAGCTTTCTTT	CASSYPSRDRTEAFF	TRBV6-3	TRBJ1-1
TGTGCCAGCAGTTGGGGGTGGCAGCCCCAGCATTTT	CASSWGWQPQHF	TRBV7-6	TRBJ1-5
TGTGCCATCACCCCGGACGGACAGGTTCTCGGGGAGCTGTTTTTT	CAITPDGQVLGELFF	TRBV10-3	TRBJ2-2
TGTGCCAGCAGCCCCGTCGGGGCCCATAACTATGGCTACACCTTC	CASSPVGAHNYGYTF	TRBV13	TRBJ1-2
TGTGCCAGCAGCTCTCCACCGCACAGGGTTACTTTTTCCCCTTCTAACTATGGCTACACCTTC	CASSSPPHRVTFSPSNYGYTF	TRBV7-3	TRBJ1-2
TGTGCCAGCAGCTTAGAGGGGGCCTACGAGCAGTACTTC	CASSLEGAYEQYF	TRBV11-1	TRBJ2-7
TGTGCCAGCAGTGGCCCACGAAGGGAAGAGACCATCTACGAGCAGTACTTC	CASSGPRREETIYEQYF	TRBV6-5	TRBJ2-7
TGTGCCAGCAGCTTCGGGAGTTCATACGAGCAGTACTTC	CASSFGSSYEQYF	TRBV5-4	TRBJ2-7
TGTGCCAGCAGCAGTTCCGGGCAGGGGGCGTCCTACGAGCAGTACTTC	CASSSSGQGASYEQYF	TRBV13	TRBJ2-7
TGTGCCAGCAGCCAAGAAAGACAGGTGGAGCTGTTTTTT	CASSQERQVELFF	TRBV3-1	TRBJ2-2
TGTGCCAGCAGTCGGACAAGAAATCAGCCCCAGCATTTT	CASSRTRNQPQHF	TRBV12-3	TRBJ1-5
TGTGCCAGCAGCATACAGGGGAAAAGGAACACTGAAGCTTTCTTT	CASSIQGKRNTEAFF	TRBV13	TRBJ1-1
TGTGCCAGCAGCCAACAGGGGCACGAGCAGTACTTC	CASSQQGHEQYF	TRBV3-1	TRBJ2-7
TGTGCCAGCAGTGAAGCGGAGGGACAGGCCCTTAGTCAGCCCCAGCATTTT	CASSEAEGQALSQPQHF	TRBV2	TRBJ1-5
TGCAGCGGGACATGGACTAGCGGACACGGGGAGCTGTTTTTT	CSGTWTSGHGELFF	TRBV29-1	TRBJ2-2
TGTGCCAGCAGCGAAGGAGACAGGGGGGATGCTAACTATGGCTACACCTTC	CASSEGDRGDANYGYTF	TRBV7-3	TRBJ1-2
TGTGCCAGCAACGCGGGGAGGGGAGCCTACGAGCAGTACTTC	CASNAGRGAYEQYF	TRBV6-4	TRBJ2-7
TGTGCCAGGGACAGGGGAAGGAAGGGACTCTACGAGCAGTACTTC	CARDRGRKGLYEQYF	TRBV28	TRBJ2-7
TGTGCCAGCTCACCATTCACCCAGGACAGGGGGGAGAATGCAACTAATGAAAAACTGTTTTTT	CASSPFTQDRGENATNEKLFF	TRBV18	TRBJ1-4
TGTGCCAGCAGTGTACCCCACAGTCGGATGAACACTGAAGCTTTCTTT	CASSVPHSRMNTEAFF	TRBV25-1	TRBJ1-1
TGTGCCAGCAGTTCCAAGCGGGACAGGGGTAACTATGGCTACACCTTC	CASSSKRDRGNYGYTF	TRBV27	TRBJ1-2
TGTGCCAGCAGTTTGGTATTTGGAGGGAGGGCTGGAAACACCATATATTTT	CASSLVFGGRAGNTIYF	TRBV12-3	TRBJ1-3
TGTGCCAGTCCACGCGGGACTAGCGTGAACACCGGGGAGCTGTTTTTT	CASPRGTSVNTGELFF	TRBV27	TRBJ2-2
TGTGCCAGCAGGGGGCGTTGTTGCCGGGACGCCCCTAGGGCCAAAAACATTCAGTACTTC	CASRGRCCRDAPRAKNIQYF	TRBV6-4	TRBJ2-4
TGTGCCACCAGGAGGTCGCGTGGGACAGGGTACGAGCAGTACTTC	CATRRSRGTGYEQYF	TRBV24-1	TRBJ2-7
TGTGCCTGGAGTGCCCCCAGGGGGGGGAAAGTGTACCAAGAGACCCAGTACTTC	CAWSAPRGGKVYQETQYF	TRBV30	TRBJ2-5
TGTGCCAGCAGCGCCTGTCTTCTTGACAGGGGTGAGAACACTGAAGCTTTCTTT	CASSACLLDRGENTEAFF	TRBV11-3	TRBJ1-1
TGTGCCAGCAGCTTAGACTGGGGCAATCAGCCCCAGCATTTT	CASSLDWGNQPQHF	TRBV7-2	TRBJ1-5
TGTGCCAGCATACGGGGACAGGAAGAAAAACTGTTTTTT	CASIRGQEEKLFF	TRBV11-2	TRBJ1-4
TGCGCCAGCAGCCAAGGGGGGCCCAGGGGCCCCCCCTACAATGAGCAGTTCTTC	CASSQGGPRGPPYNEQFF	TRBV4-1	TRBJ2-1
TGTGCCAGCAGATTCAAAGCGGGATTAGATACGCAGTATTTT	CASRFKAGLDTQYF	TRBV28	TRBJ2-3
TGTGCCAGCAGGGGTTGCCAGATGAACACTGAAGCTTTCTTT	CASRGCQMNTEAFF	TRBV12-3	TRBJ1-1
TGTGCCAGCAGTGAGGACGGCAACTCTGAAGCTTTCTTT	CASSEDGNSEAFF	TRBV6-1	TRBJ1-1
TGTGCCAGCAGTGCTCCCTCCAATCGTGCTCGCAATCAGCCCCAGCATTTT	CASSAPSNRARNQPQHF	TRBV9	TRBJ1-5
TGTGCCAGCAGTTACTGGGGATTAGTGACCTACGAGCAGTACTTC	CASSYWGLVTYEQYF	TRBV27	TRBJ2-7
TGTGCCACCAGCACGAGACTAGCGGGGGGGCTCGGTAACACCGGGGAGCTGTTTTTT	CATSTRLAGGLGNTGELFF	TRBV15	TRBJ2-2
TGTGCCAGCAGTATACCCGCGTCGACTCGGCTTTACGAGCAGTACTTC	CASSIPASTRLYEQYF	TRBV27	TRBJ2-7
TGTGCCAGCAGCTTGGGCGGGGTTTACGAGCAGTACTTC	CASSLGGVYEQYF	TRBV5-5	TRBJ2-7
TGTGCCAGCAGTCGGAAGACTAGCGGGAATGAGCAGTTCTTC	CASSRKTSGNEQFF	TRBV6-8	TRBJ2-1
TGTGCCAGCAGCTTCAGTAACCCGGGACACTTCGGAAACACCATATATTTT	CASSFSNPGHFGNTIYF	TRBV7-6	TRBJ1-3
TGTGCCAGCAGTTATTGGGAGGGAAGGACCGGGGAGCTGTTTTTT	CASSYWEGRTGELFF	TRBV6-3	TRBJ2-2
TGCGCCAGCAGCCAAGAGTTATGGCCGGGACAGGTCTACGAGCAGTACTTC	CASSQELWPGQVYEQYF	TRBV4-1	TRBJ2-7
TGTGCCAGCAGCTGGCAGGAGGTCCGGGGCACCGGGGAGCTGTTTTTT	CASSWQEVRGTGELFF	TRBV5-5	TRBJ2-2
TGTGCCAGCAGCTTAGGGGGGGGAGGGAGCAATGAGCAGTTCTTC	CASSLGGGGSNEQFF	TRBV11-3	TRBJ2-1
TGTGCCAGCAGTGACGGTCCGGGGGTAATAAAAGCCGGGGAGCTGTTTTTT	CASSDGPGVIKAGELFF	TRBV6-4	TRBJ2-2
TGTGCCAGCTCCAGGGACTCCTACGAGCAGTACTTC	CASSRDSYEQYF	TRBV6-4	TRBJ2-7
TGTGCCAGCAGTTTCCCCGGCACCGGAAACACCATATATTTT	CASSFPGTGNTIYF	TRBV27	TRBJ1-3
TGTGCCAGAAGCAGGGTTAACACTGAAGCTTTCTTT	CARSRVNTEAFF	TRBV7-9	TRBJ1-1
TGCAGTGCTAGAGAAGGGGGGACCCCTGTAGATACGCAGTATTTT	CSAREGGTPVDTQYF	TRBV20-1	TRBJ2-3
TGTGCCATCACCGGCCCGGATAGGAATTCACCCCTCCACTTT	CAITGPDRNSPLHF	TRBV10-3	TRBJ1-6
TGCGCCAGCAGTGAGTTACGGTATGGCTACACCTTC	CASSELRYGYTF	TRBV10-2	TRBJ1-2
TGCGCCAGCAGCCTCCTTGGGACAGTTCTGCTCTCCTATGGCTACACCTTC	CASSLLGTVLLSYGYTF	TRBV5-1	TRBJ1-2
TGTGCCAGCAGCGTAGCCGACAGGGCCTACGAGCAGTACTTC	CASSVADRAYEQYF	TRBV9	TRBJ2-7
TGTGCCAGCAGGAGGGGGCCTACCTCGTCTGGAAACACCATATATTTT	CASRRGPTSSGNTIYF	TRBV6-3	TRBJ1-3
TGTGCCAGCAGGGACGGTGAAAAACTGTTTTTT	CASRDGEKLFF	TRBV6-6	TRBJ1-4
TGTGCCACCCCGCTTATAGGCCACTACGAGCAGTACTTC	CATPLIGHYEQYF	TRBV24-1	TRBJ2-7
TGTGCCACCAGTGATTTTCGTACACAGGGGGTCGCGTACGAGCAGTACTTC	CATSDFRTQGVAYEQYF	TRBV24-1	TRBJ2-7
TGTGCCAGGGTTAGGGGGGGGCCCCAGCATTTT	CARVRGGPQHF	TRBV6-5	TRBJ1-5
TGTGCCAGCAGCCCCCCCCGGGACGAGGGTGGCTACACCTTC	CASSPPRDEGGYTF	TRBV6-1	TRBJ1-2
TGTGCCATCCGGACTAGCCATGGGCCCTACAATGAGCAGTTCTTC	CAIRTSHGPYNEQFF	TRBV3-1	TRBJ2-1
TGTGCCAGCAGCTTGTCTTCCTACAATGAGCAGTTCTTC	CASSLSSYNEQFF	TRBV7-9	TRBJ2-1
TGTGCCAGCAGCGTAGTTCGACCTGGCTACACCTTC	CASSVVRPGYTF	TRBV9	TRBJ1-2
TGTGCCAGCTCACCGAAACGAAGGCAGATGTCCCGCAATCAGCCCCAGCATTTT	CASSPKRRQMSRNQPQHF	TRBV18	TRBJ1-5
TGTGCCAGCAGCTTAGGACAGGGGGGATCAGATACGCAGTATTTT	CASSLGQGGSDTQYF	TRBV7-3	TRBJ2-3
TGTGCCACCCGTTATAAGACAATATCGGAGGATAGCAATCAGCCCCAGCATTTT	CATRYKTISEDSNQPQHF	TRBV25-1	TRBJ1-5
TGTGCCAGCAGTTTAGACGTCCAGGGCCAAGAGACCCAGTACTTC	CASSLDVQGQETQYF	TRBV28	TRBJ2-5
TGTGCCAGCAGCCAAGATGCCCCTAGTTTTTCTTACTCTTCGAGTTTCGAGCAGTACTTC	CASSQDAPSFSYSSSFEQYF	TRBV4-2	TRBJ2-7
TGCAGTGCGATCCCAGGGCAGGGCTTAACCGAGCAGTACTTC	CSAIPGQGLTEQYF	TRBV20-1	TRBJ2-7
TGTGCCAGCAGCTCGGGGGTGGTTCAGCCCCAGCATTTT	CASSSGVVQPQHF	TRBV13	TRBJ1-5
TGCGCCGTCGCCCGGGACAGGGCTCCCGGTAGAGATACGCAGTATTTT	CAVARDRAPGRDTQYF	TRBV10-1	TRBJ2-3
TGTGCCAGCAGCCGGGACAGGGGGCAATGCGAGCAGTACTTC	CASSRDRGQCEQYF	TRBV7-8	TRBJ2-7
TGTGCCAGTAGTCACCGGGAATATGGCTACACCTTC	CASSHREYGYTF	TRBV19	TRBJ1-2
TGTGCCACCAGTGATTTAGAACCCGGGTCGCCTGAGCAGTTCTTC	CATSDLEPGSPEQFF	TRBV24-1	TRBJ2-1
TGTGCCAGCACTACTAGCGGGAGGTACTTC	CASTTSGRYF	TRBV6-6	TRBJ2-7
TGTGCCAGCAGAGTGTTCCCGACTAGCGGGTCAGAGACCCAGTACTTC	CASRVFPTSGSETQYF	TRBV13	TRBJ2-5
TGTGCCATCGTACGGCCCCCCAATGAGCAGTTCTTC	CAIVRPPNEQFF	TRBV10-3	TRBJ2-1
TGTGCCAGCAGTTCAGGGGGCCAAGAGACCCAGTACTTC	CASSSGGQETQYF	TRBV6-4	TRBJ2-5
TGTGCCAGCAGCTTTGAAATTAATAGTCTTTTGGACTCCTACGAGCAGTACTTC	CASSFEINSLLDSYEQYF	TRBV11-3	TRBJ2-7
TGTGCCACCAGTGATTTGGTCCAGGGGGGTGGCTACACCTTC	CATSDLVQGGGYTF	TRBV24-1	TRBJ1-2
TGCAGTGCTAGATGGAACGAGCAGTACTTC	CSARWNEQYF	TRBV20-1	TRBJ2-7
TGTGCCATCAGTGAGCTAAGGCAGGGCTCTGGAAACACCATATATTTT	CAISELRQGSGNTIYF	TRBV10-3	TRBJ1-3
TGTGCCACCAGTGATGTACTCTCGTATACCACCGGGGAGCTGTTTTTT	CATSDVLSYTTGELFF	TRBV24-1	TRBJ2-2
TGTGCCAGCAGTTTGTGTCTTGTCCCTCCGGGGTGTAAGGACGAGACCCAGTACTTC	CASSLCLVPPGCKDETQYF	TRBV6-4	TRBJ2-5
TGCGCCAGCAGCTTGGAAGGGGGACAGGTAGGACTATATGGCTACACCTTC	CASSLEGGQVGLYGYTF	TRBV5-1	TRBJ1-2
TGTGCCAGCAGCTTAACGGGACAGGGCCTTTCTACTGAAGCTTTCTTT	CASSLTGQGLSTEAFF	TRBV7-9	TRBJ1-1
TGTGCCAGCAGCCAAGATGGGAATCCGACTAGCGGGGTCGAAGAGACCCAGTACTTC	CASSQDGNPTSGVEETQYF	TRBV14	TRBJ2-5
TGTGCCAGCAGCGGGAGCTACGAGCAGTACTTC	CASSGSYEQYF	TRBV6-1	TRBJ2-7
TGTGCCAGCAGCAAGTACCATGGGACAGGGGAAATTGCAGATACGCAGTATTTT	CASSKYHGTGEIADTQYF	TRBV7-9	TRBJ2-3
TGTGCCATCAGTGAGTCGAGCGGACAGGGGCACGGCTACACCTTC	CAISESSGQGHGYTF	TRBV10-3	TRBJ1-2
TGTGCCTGCAGGGGGGACGAGCAGTACTTC	CACRGDEQYF	TRBV27	TRBJ2-7
TGTGCCAGCAGCTACGGTGGACAGGGAGGGAATTGGGAAGCTTTCTTT	CASSYGGQGGNWEAFF	TRBV25-1	TRBJ1-1
TGCAGCGGAAAGGGGCTTAACTATGGCTACACCTTC	CSGKGLNYGYTF	TRBV29-1	TRBJ1-2
TGCAGCGTTCGCCCCCGGGACAGGGGAGCTGGAAAGGACACTGAAGCTTTCTTT	CSVRPRDRGAGKDTEAFF	TRBV29-1	TRBJ1-1
TGTGCCACCAGTGATTTTACCCAAGGGCCCTGCTCCTACGAGCAGTACTTC	CATSDFTQGPCSYEQYF	TRBV24-1	TRBJ2-7
TGTGCCAGCAGCCAAGTAAAGAACCAGGGGGCTCCATCATGCAATCAGCCCCAGCATTTT	CASSQVKNQGAPSCNQPQHF	TRBV4-2	TRBJ1-5
TGTGCCAGCAGCGCCCCTGAGGGGAATGTAGAGACCCAGTACTTC	CASSAPEGNVETQYF	TRBV9	TRBJ2-5
TGTGCCTGGAGTGAAGGAAGGGGGCTCAATTCACCCCTCCACTTT	CAWSEGRGLNSPLHF	TRBV30	TRBJ1-6
TGTGCCAGCAGCTTAATGTCAGGGGCTGAGCAGCCCCAGCATTTT	CASSLMSGAEQPQHF	TRBV7-3	TRBJ1-5
TGTGCCAGCAGTTTAAACAGGACCGCGGGACCTTACACCTTC	CASSLNRTAGPYTF	TRBV28	TRBJ1-2
TGTGCCAGCAGTTACTCGGACTGGACAGGCTCCTACGAGCAGTACTTC	CASSYSDWTGSYEQYF	TRBV6-5	TRBJ2-7
TGTGCCAGCCACCGGACAGGGTTGACTGGGGCCAACGTCCTGACTTTC	CASHRTGLTGANVLTF	TRBV7-9	TRBJ2-6
TGTGCCAGCAGCCCGGGACGGGGCCAAGAGACCCAGTACTTC	CASSPGRGQETQYF	TRBV2	TRBJ2-5
TGTGCCAGCAGTTTAAGCCGGGACAGGGTACCACACGGCTACACCTTC	CASSLSRDRVPHGYTF	TRBV28	TRBJ1-2
TGTGCCAAGGGGACAGGGAACACTGAAGCTTTCTTT	CAKGTGNTEAFF	TRBV25-1	TRBJ1-1
TGTGCCAGCAGCCATAAGGGGGGCTACGCCTCCTACGAGCAGTACTTC	CASSHKGGYASYEQYF	TRBV14	TRBJ2-7
TGCAGCGTTGCCGGGACAAGAAGAGCTAACTATGGCTACACCTTC	CSVAGTRRANYGYTF	TRBV29-1	TRBJ1-2
TGTGCCAGCAGTTGGCTCATGAGACTAGCCGTGTCCTACGAGCAGTACTTC	CASSWLMRLAVSYEQYF	TRBV6-2	TRBJ2-7
TGTGCCAGCAGCTTAGGTCACAGCGGGGATCAGCCCCAGCATTTT	CASSLGHSGDQPQHF	TRBV7-6	TRBJ1-5
TGCAGCGGGGAAGCGGGAGAGGGAAGCAATCAGCCCCAGCATTTT	CSGEAGEGSNQPQHF	TRBV29-1	TRBJ1-5
TGTGCCAGCAGTACCAAACGCCTAGCGGTCCCTACCGGGGAGCTGTTTTTT	CASSTKRLAVPTGELFF	TRBV6-5	TRBJ2-2
TGCAGTGCTAGAGATCTAGGGGGGACAGGGGGCGTTGAGACCCAGTACTTC	CSARDLGGTGGVETQYF	TRBV20-1	TRBJ2-5
TGTGCCATGAACAGGGGCAATCAGCCCCAGCATTTT	CAMNRGNQPQHF	TRBV3-1	TRBJ1-5
TGTGCCACCAGCAGGCCGACAGGGAGGGATGAGCAGTTCTTC	CATSRPTGRDEQFF	TRBV15	TRBJ2-1
TGTGCCAGTGTTAGCGGGTGGCAAGAGACCCAGTACTTC	CASVSGWQETQYF	TRBV5-6	TRBJ2-5
TGTGCCAGCAGTGACTCGAGTGACATCAGGGGTAGGAACACTGAAGCTTTCTTT	CASSDSSDIRGRNTEAFF	TRBV6-4	TRBJ1-1
TGCGCCAGGTTACGGCTCGGGACTGAAGCTTTCTTT	CARLRLGTEAFF	TRBV4-1	TRBJ1-1
TGTGCCAGCAGCAGGACAGGGGGGAACAATGAGCAGTTCTTC	CASSRTGGNNEQFF	TRBV7-4	TRBJ2-1
TGTGCCACCAGCAGAGATGGCAGCGGGAGCGGGGAGCTGTTTTTT	CATSRDGSGSGELFF	TRBV15	TRBJ2-2
TGTGCCAGCAGTTTGCCCACTAGCGGGAGGGCAGGGGTGACCGACCCCTACGAGCAGTACTTC	CASSLPTSGRAGVTDPYEQYF	TRBV27	TRBJ2-7
TGTGCCACCACGGGGGGGGTGTATAGGGGTGACGAGCAGTACTTC	CATTGGVYRGDEQYF	TRBV24-1	TRBJ2-7
TGTGCCAGCATTGGGTCCTCTAGCGGGGTTCTCGATACGCAGTATTTT	CASIGSSSGVLDTQYF	TRBV27	TRBJ2-3
TGTGCCACCAGTGATTTGCATCATAGACTAGCGGGAAACGGCTACGAGCAGTACTTC	CATSDLHHRLAGNGYEQYF	TRBV24-1	TRBJ2-7
TGTGCCAGCATGGCAGCTTTCTTT	CASMAAFF	TRBV9	TRBJ1-1
TGTGCCAGCGGTCAGGGGATGCTAGCCAAAAACATTCAGTACTTC	CASGQGMLAKNIQYF	TRBV7-3	TRBJ2-4
TGTGCCACCAGCAGACGGAGACGGACTAGCGGAATGAAGAACAATGAGCAGTTCTTC	CATSRRRRTSGMKNNEQFF	TRBV15	TRBJ2-1
TGTGCCAGCAGCGTAGCGAACGGACCCAATCAGCCCCAGCATTTT	CASSVANGPNQPQHF	TRBV9	TRBJ1-5
TGCAGTGCCCCCCAGGGAGAGACCCAGTACTTC	CSAPQGETQYF	TRBV20-1	TRBJ2-5
TGCAGTGCTAGAGATTTAGGGGGAGGTCAGCCCCAGCATTTT	CSARDLGGGQPQHF	TRBV20-1	TRBJ1-5
TGTGCCAGCACGGAGCGGGATTCTGGGGCCAACGTCCTGACTTTC	CASTERDSGANVLTF	TRBV2	TRBJ2-6
TGTGCCAGCAGGACAGGGATAGAACCCTACAATGAGCAGTTCTTC	CASRTGIEPYNEQFF	TRBV27	TRBJ2-1
TGTGCCACCACTAGGGGTTGCGTGCCTGGCAGGAACACTGAAGCTTTCTTT	CATTRGCVPGRNTEAFF	TRBV24-1	TRBJ1-1
TGTGCCAGCCTTCGGGACTGTGACAATGAGCAGTTCTTC	CASLRDCDNEQFF	TRBV6-4	TRBJ2-1
TGTGCCAGCAGCGTAACCCGGCGGGGGAGACATGGCTACACCTTC	CASSVTRRGRHGYTF	TRBV9	TRBJ1-2
TGTGCCAGCAGTTTTACGGACAGGGCTTTAAACTATGGCTACACCTTC	CASSFTDRALNYGYTF	TRBV6-2	TRBJ1-2
TGTGCCCCCAAATTTTGGGGGGCTTACCACAATGAGCAGTTCTTC	CAPKFWGAYHNEQFF	TRBV19	TRBJ2-1
TGTGCCAGCAGTTTACCGGGAACGGAGACCCAGTACTTC	CASSLPGTETQYF	TRBV27	TRBJ2-5
TGTGCCAGCAGTTACTCGATACCCGGCCAGCACCTGTTTTTT	CASSYSIPGQHLFF	TRBV6-5	TRBJ1-4
TGTGCCAGCAGTGCCCTTGTACCACTGGATAACGGGGAGCTGTTTTTT	CASSALVPLDNGELFF	TRBV27	TRBJ2-2
TGTGCCAGCAGCCGGACCCGGGGGGCGACCGCGGGCACAGATACGCAGTATTTT	CASSRTRGATAGTDTQYF	TRBV7-4	TRBJ2-3
TGCGCCAGCAGCTTGGATGACAGAGGCAACACTGAAGCTTTCTTT	CASSLDDRGNTEAFF	TRBV5-1	TRBJ1-1
TGCGCCAGCAGTGAGCCCACAGGGGTTTATGGCTACACCTTC	CASSEPTGVYGYTF	TRBV10-1	TRBJ1-2
TGTGCCAGCAGTGAAATAGAAGGGTCGGGGGCAGAGCAGTACTTC	CASSEIEGSGAEQYF	TRBV6-4	TRBJ2-7
TGTGCCAGCAGCTTAGAGCCGTCCACTAGCGAAGGCATTGAGACCCAGTACTTC	CASSLEPSTSEGIETQYF	TRBV7-9	TRBJ2-5
TGTGCCAGCAGCCACCGGCTCATGGGAGACGGCAATGAGCAGTTCTTC	CASSHRLMGDGNEQFF	TRBV14	TRBJ2-1
TGTGCCAGCTCATTCGACAGAAACACTGAAGCTTTCTTT	CASSFDRNTEAFF	TRBV18	TRBJ1-1
TGCGCCAGACAAACCGCAACTAATGAAAAACTGTTTTTT	CARQTATNEKLFF	TRBV10-1	TRBJ1-4
TGTGCCAGCAGCCAAGACAGGGTTCTTAGCAATCAGCCCCAGCATTTT	CASSQDRVLSNQPQHF	TRBV7-3	TRBJ1-5
TGCGCCAGCAGCGCCTCTCCTGTCGAGGCAACTAATGAAAAACTGTTTTTT	CASSASPVEATNEKLFF	TRBV5-1	TRBJ1-4
TGCGCCAGCAGCCAGACCCGGGACAGGGGCAATCAGCCCCAGCATTTT	CASSQTRDRGNQPQHF	TRBV4-1	TRBJ1-5
TGTGCCAGCATGACAGGGCTGGGAACACGCTATGGCTACACCTTC	CASMTGLGTRYGYTF	TRBV12-4	TRBJ1-2
TGTGCCAGTAGTATACCTCGACAGGGCATAGGATCTGGGGCCAACGTCCTGACTTTC	CASSIPRQGIGSGANVLTF	TRBV19	TRBJ2-6
TGTGCCAGCAGCCCCTACAGGGGGGTCGAGCAGTACTTC	CASSPYRGVEQYF	TRBV11-2	TRBJ2-7
TGTGCCAGCAGCCATCAGGACGGAAGCTATGGCTACACCTTC	CASSHQDGSYGYTF	TRBV3-1	TRBJ1-2
TGCGCCAGCAGCCCAGAGGGAAAAGGGACAGGTAATCAGCCCCAGCATTTT	CASSPEGKGTGNQPQHF	TRBV4-3	TRBJ1-5
TGTGCCAGCAGCAGTCAGCAGTCCACAGATACGCAGTATTTT	CASSSQQSTDTQYF	TRBV5-6	TRBJ2-3
TGCAGCGTTACGTGGGGACGCTACAATGAGCAGTTCTTC	CSVTWGRYNEQFF	TRBV29-1	TRBJ2-1
TGCGCCAGCAGCTTGCTAAGGGCGGGCTGGATAAAGGTGGGGGATTCACCCCTCCACTTT	CASSLLRAGWIKVGDSPLHF	TRBV5-1	TRBJ1-6
TGTGCCAGCAGCCCGTCGATTTTGACAGGGTCCAATCAGCCCCAGCATTTT	CASSPSILTGSNQPQHF	TRBV7-3	TRBJ1-5
TGTGCCAGCTCACCACACGGGAACTACGAGCAGTACTTC	CASSPHGNYEQYF	TRBV18	TRBJ2-7
TGTGCCATGGGGGGTTCTGGGGCCAACGTCCTGACTTTC	CAMGGSGANVLTF	TRBV6-4	TRBJ2-6
TGCAGTGCTAGAGATAGACTAGCGGGTTACACAGATACGCAGTATTTT	CSARDRLAGYTDTQYF	TRBV20-1	TRBJ2-3
TGTGCTAGTGGTTTGGTAGACGTAGCGGGGAACGAGCAGTACTTC	CASGLVDVAGNEQYF	TRBV12-5	TRBJ2-7
TGCAGTGCTAGAGTGGGCATTGCAGCTAACTATGGCTACACCTTC	CSARVGIAANYGYTF	TRBV20-1	TRBJ1-2
TGTGCCAGCAGCTACCCCGGGACTAGCGGGGAGGACGACACAGATACGCAGTATTTT	CASSYPGTSGEDDTDTQYF	TRBV11-3	TRBJ2-3
TGTGCCAGCAGTACAAGGAGAAACCGGTCTGGAAACACCATATATTTT	CASSTRRNRSGNTIYF	TRBV12-3	TRBJ1-3
TGCAGTGCTAGCACCAGACAGGGACGTATATATGGCTACACCTTC	CSASTRQGRIYGYTF	TRBV20-1	TRBJ1-2
TGTGCCAGCAGCGTAGACCGGGGGTCTAAATACAATGAGCAGTTCTTC	CASSVDRGSKYNEQFF	TRBV9	TRBJ2-1
TGTGCAAAAATGACGGCCTTTGAGCAGTTCTTC	CAKMTAFEQFF	TRBV3-1	TRBJ2-1
TGTGCCAGCAGCATCTCGGGGTGGATCTCCTACAATGAGCAGTTCTTC	CASSISGWISYNEQFF	TRBV7-4	TRBJ2-1
TGTGCTAGCAGCTTAGAAGAGGGGTACGATACGCAGTATTTT	CASSLEEGYDTQYF	TRBV7-7	TRBJ2-3
TGTGCCAGCAGGGAAAGGGGGGGGTACGAGCAGTACTTC	CASRERGGYEQYF	TRBV7-3	TRBJ2-7
TGTGCCAGCAGTGAATGGTACGGGGGGAGTCAGCCCCAGCATTTT	CASSEWYGGSQPQHF	TRBV25-1	TRBJ1-5
TGTGCCAGCATTCGGGGGGGCGCCTCAATGAACACTGAAGCTTTCTTT	CASIRGGASMNTEAFF	TRBV6-2	TRBJ1-1
TGTGCCAGCACCCGGGACAGTCTACCTTGCCAGGCCTACGAGCAGTACTTC	CASTRDSLPCQAYEQYF	TRBV6-5	TRBJ2-7
TGCGCCAGCAGCCAAGACCGGGGACATGAGCAGTACTTC	CASSQDRGHEQYF	TRBV4-3	TRBJ2-7
TGTGCCAGCCCAGGGGGGAAATTCCCCTCTGGAAACACCATATATTTT	CASPGGKFPSGNTIYF	TRBV12-3	TRBJ1-3
TGTGCCAGCTCGAGTCGCCAGGGGAATGGCTACACCTTC	CASSSRQGNGYTF	TRBV18	TRBJ1-2
TGTGCCAGCAGCGCCTATGTAGGGCGTCTCTATGGCTACACCTTC	CASSAYVGRLYGYTF	TRBV7-2	TRBJ1-2
TGTGCCAGCAGTTACTCAACAGGGAATGAAAAACTGTTTTTT	CASSYSTGNEKLFF	TRBV6-3	TRBJ1-4
TGCGCCAGCAGCCGGCGGGTGTCACCCCTCCACTTT	CASSRRVSPLHF	TRBV5-1	TRBJ1-6
TGCGCCAGCAGCCAAGATACCAGTAGGACAGGGTTGGCTATACCCTATGGCTACACCTTC	CASSQDTSRTGLAIPYGYTF	TRBV4-3	TRBJ1-2
TGTGCCAGCAGTCACCTCTATGGCTACACCTTC	CASSHLYGYTF	TRBV6-4	TRBJ1-2
TGTGCCAGCAGTTGGCTTAGACAGGGGGATAATCAGCCCCAGCATTTT	CASSWLRQGDNQPQHF	TRBV25-1	TRBJ1-5
TGTGCCAGCAGCCCCAAGATGGCCTTACCCATGAACACTGAAGCTTTCTTT	CASSPKMALPMNTEAFF	TRBV5-6	TRBJ1-1
TGTGCCAGCGAGGGTGGAGGGACTGAAGCTTTCTTT	CASEGGGTEAFF	TRBV6-5	TRBJ1-1
TGTGCCAGCAGTTATCCCGGACAGGGGTACGAGCAGTACTTC	CASSYPGQGYEQYF	TRBV6-5	TRBJ2-7
TGTGCCAGCAGCTTGAAACTAGCGGGCCGTTACACAGATACGCAGTATTTT	CASSLKLAGRYTDTQYF	TRBV7-9	TRBJ2-3
TGTGCCAGCAAAGGGTTTGGGCCCGATGAAAAACTGTTTTTT	CASKGFGPDEKLFF	TRBV2	TRBJ1-4
TGTGCCAGCAGTTTATGGCTTGGACAGGGGGGAAGTTATCAGCCCCAGCATTTT	CASSLWLGQGGSYQPQHF	TRBV27	TRBJ1-5
TGCGCCAGCAAGGGAGAAGCCGGGACGGGCAGCTCTGGAAACACCATATATTTT	CASKGEAGTGSSGNTIYF	TRBV10-2	TRBJ1-3
TGTGCCTGGAGTCAGGGAATGAGCTACGAGCAGTACTTC	CAWSQGMSYEQYF	TRBV30	TRBJ2-7
TGTGCCAGCAGCTTTCGGGGGCGGGGTTACTATGGCTACACCTTC	CASSFRGRGYYGYTF	TRBV7-3	TRBJ1-2
TGTGCCAGCAGCTCGCAAGGCCAGTATGAAGCTTTCTTT	CASSSQGQYEAFF	TRBV5-8	TRBJ1-1
TGTGCCAGCAGTTTAAGCTTATCTCACACTGAAGCTTTCTTT	CASSLSLSHTEAFF	TRBV28	TRBJ1-1
TGTGCCAGCAGCATTCCAGGGGAAAAACTGTTTTTT	CASSIPGEKLFF	TRBV9	TRBJ1-4
TGTGCCAGCAGTGAAGCGCATAGACAGACTAAAAGGGAGACCCAGTACTTC	CASSEAHRQTKRETQYF	TRBV6-1	TRBJ2-5
TGTGCTAGTGGTTTGGTCAGAAGAGGGGACGGCTCCTACGAGCAGTACTTC	CASGLVRRGDGSYEQYF	TRBV12-5	TRBJ2-7
TGTGCCAGCAGCTTTTCAATGGGGGTGGGAAAAAACACTGAAGCTTTCTTT	CASSFSMGVGKNTEAFF	TRBV11-3	TRBJ1-1
TGTGCCAGCAGCACCCCAAACCCACCAGGGCCGGGGACCTGTAACTATGGCTACACCTTC	CASSTPNPPGPGTCNYGYTF	TRBV3-1	TRBJ1-2
TGTGCCAGCAGAGCAGGAGCCGGGGGCATTCACGAGACCCAGTACTTC	CASRAGAGGIHETQYF	TRBV6-1	TRBJ2-5
TGCAGCGTTGATATCCGAGCCTCCTACGAGCAGTACTTC	CSVDIRASYEQYF	TRBV29-1	TRBJ2-7
TGTGCCAGCTCCCAGGACAGGATGCATGAGCAGTTCTTC	CASSQDRMHEQFF	TRBV9	TRBJ2-1
TGTGCCAGCAGCTTAGCCGACAGGGGTAAAGAGACCCAGTACTTC	CASSLADRGKETQYF	TRBV7-2	TRBJ2-5
TGTGCCAGCAGGGCCTCCCTCCAACTACTAGCGGGAGGGCGGGGGAACACTGAAGCTTTCTTT	CASRASLQLLAGGRGNTEAFF	TRBV6-4	TRBJ1-1
TGCGCCACTAAGACTAGCGGGGCGAGCTCCTACAATGAGCAGTTCTTC	CATKTSGASSYNEQFF	TRBV10-1	TRBJ2-1
TGTGCCAGCAGCCAGGGGGGGAATGGCTACACCTTC	CASSQGGNGYTF	TRBV14	TRBJ1-2
TGTCAGTCTGAAAAACTGTTTTTT	CQSEKLFF	TRBV20-1	TRBJ1-4
TGTGCCAGCAGTTTTTCTCAAGGACAGGGGGGGGGGTCCTACGAGCAGTACTTC	CASSFSQGQGGGSYEQYF	TRBV12-3	TRBJ2-7
TGTGCCAGCAGCGCTCCCGTCCCACAGGGGGACGAGCAGTACTTC	CASSAPVPQGDEQYF	TRBV11-2	TRBJ2-7
TGCAGTGCTAGGCCGGCAAGTCACGTGGAGTATGGCTACACCTTC	CSARPASHVEYGYTF	TRBV20-1	TRBJ1-2
TGTGCTAGCAGCTTAACCCTAAACTGTACATTTCAGCCCCAGCATTTT	CASSLTLNCTFQPQHF	TRBV7-7	TRBJ1-5
TGTGCCAGCACCCCGCGGGACAGGTGTAAAACTCATAACTATGGCTACACCTTC	CASTPRDRCKTHNYGYTF	TRBV25-1	TRBJ1-2
TGTGCCAGCAGCTTAACGCGCCGTAGCACGGGATTCACAGATACGCAGTATTTT	CASSLTRRSTGFTDTQYF	TRBV7-3	TRBJ2-3
TGTGCCAGCAGACTAACCTCTTTGTACCAAGAGACCCAGTACTTC	CASRLTSLYQETQYF	TRBV27	TRBJ2-5
TGCGCCAGCAGCAAATTCCAGGGCATGGGGGCGGATGAGCAGTTCTTC	CASSKFQGMGADEQFF	TRBV5-1	TRBJ2-1
TGTGCCAGCAATCCGCCGATAAGAGGCTACGAGCAGTACTTC	CASNPPIRGYEQYF	TRBV6-6	TRBJ2-7
TGTGCCAGCAGCGAACGGATTCAGGGGTTCGAGCAGTACTTC	CASSERIQGFEQYF	TRBV7-9	TRBJ2-7
TGTGCCTGGAGTTGGTTTAGAAGAAACACTGAAGCTTTCTTT	CAWSWFRRNTEAFF	TRBV30	TRBJ1-1
TGTGCCAGCAGCACTAGCGGGAGCGGTCGTTACGAGCAGTACTTC	CASSTSGSGRYEQYF	TRBV3-1	TRBJ2-7
TGTGCCAGCAGCCAAAGTAAAGGCCCAGGTGGGGGGAAGACGTTTTACGAGCAGTACTTC	CASSQSKGPGGGKTFYEQYF	TRBV14	TRBJ2-7
TGCAGCGTTCCCAGGACGGACTATGGCTACACCTTC	CSVPRTDYGYTF	TRBV29-1	TRBJ1-2
TGTGCCAGCCCATATCCAGCCGTGGATAGCAATCAGCCCCAGCATTTT	CASPYPAVDSNQPQHF	TRBV7-9	TRBJ1-5
TGTGCCAGCAGTACAGGGACTAGCATATACGGCTCCTACGAGCAGTACTTC	CASSTGTSIYGSYEQYF	TRBV6-6	TRBJ2-7
TGTGCTAGTGGTTGCCCCCATGAAAAACTGTTTTTT	CASGCPHEKLFF	TRBV12-5	TRBJ1-4
TGTGCCAGCAGCTTGAATGGGTTTAGGGACAGGGGGCGCGACACCGGGGAGCTGTTTTTT	CASSLNGFRDRGRDTGELFF	TRBV5-6	TRBJ2-2
TGTGCCAGCAGTTTTTCCAGGGATTTTAATGAGCAGTTCTTC	CASSFSRDFNEQFF	TRBV12-3	TRBJ2-1
TGTGCCAGCAGCTTACCACAGGGCGTCGGAAACACCATATATTTT	CASSLPQGVGNTIYF	TRBV11-3	TRBJ1-3
TGCAGTGCGTTCAAGCGGTTTAACTATGGCTACACCTTC	CSAFKRFNYGYTF	TRBV20-1	TRBJ1-2
TGTGCCAGCCGGGGCTCACAGGCGGGAGCCCAGCATTTT	CASRGSQAGAQHF	TRBV27	TRBJ1-5
TGTGCCAAGAAAACTAGCAAATTCCATGCGGTGTATTTT	CAKKTSKFHAVYF	TRBV15	TRBJ2-3
TGTGCTAGTGGTAGGAAGAGCGGCAAGTTCGAGCAGTACTTC	CASGRKSGKFEQYF	TRBV12-5	TRBJ2-7
TGTGCCAGCAGCCAAGACGACGGGGAAGGCTACGAGCAGTACTTC	CASSQDDGEGYEQYF	TRBV3-1	TRBJ2-7
TGCAGCGTTGTCGGGCCCGAGGGTGAAGCTTTCTTT	CSVVGPEGEAFF	TRBV29-1	TRBJ1-1
TGTGCCACCTCCCGGAGGGCGGTCCTGAAGCCAGATACGCAGTATTTT	CATSRRAVLKPDTQYF	TRBV15	TRBJ2-3
TGTGCCAGCACTCCCGTCCTGGACAGGGGCGGAGACCTAAGCTCCTATAATTCACCCCTCCACTTT	CASTPVLDRGGDLSSYNSPLHF	TRBV2	TRBJ1-6
TGTGCCAGCAGCGGGAGGTTCGTTTGCTCCTACGAGCAGTACTTC	CASSGRFVCSYEQYF	TRBV5-4	TRBJ2-7
TGTGCCAGCAGTGTGGGGGCGGGTAACTATGGCTACACCTTC	CASSVGAGNYGYTF	TRBV2	TRBJ1-2
TGTGCCAGCAGCTTAGCGGGAGGAAACACTGAAGCTTTCTTT	CASSLAGGNTEAFF	TRBV11-2	TRBJ1-1
TGCAGCGTCCCGGGACAGGGGGCAAACACTGAAGCTTTCTTT	CSVPGQGANTEAFF	TRBV29-1	TRBJ1-1
TGTGCCAGCAGTTGGGGAAAGCCAGATACGCAGTATTTT	CASSWGKPDTQYF	TRBV12-3	TRBJ2-3
TGTGCCTGGAGTGCCAAAGGGGGGAGTCCCCAGCCCCAGCATTTT	CAWSAKGGSPQPQHF	TRBV30	TRBJ1-5
TGCAGCGTTGAAGCCAATCCGAGTAAAGTCATGAACACTGAAGCTTTCTTT	CSVEANPSKVMNTEAFF	TRBV29-1	TRBJ1-1
TGTGCCAGCAGTCCCGGACTAATTGCCTACGAGCAGTACTTC	CASSPGLIAYEQYF	TRBV6-5	TRBJ2-7
TGTGCCAGCAGAAAACCACGGGAGGGAAGGGGCACAGATACGCAGTATTTT	CASRKPREGRGTDTQYF	TRBV27	TRBJ2-3
TGTGCCAGCAGCCAAGGTCGACAGCCCTCCTATAATTCACCCCTCCACTTT	CASSQGRQPSYNSPLHF	TRBV3-1	TRBJ1-6
TGTGCCACCGTGCTAGCGGAAAACAATGAGCAGTTCTTC	CATVLAENNEQFF	TRBV24-1	TRBJ2-1
TGTGCCAGGGGTTTAGCTGTCCGCAATGAGCAGTTCTTC	CARGLAVRNEQFF	TRBV12-4	TRBJ2-1
TGTGCCACCAGTGAATGGGGGACGGGCAATGAGCAGTTCTTC	CATSEWGTGNEQFF	TRBV24-1	TRBJ2-1
TGTGCCTGGCCAGACCGGGGCAATCAGCCCCAGCATTTT	CAWPDRGNQPQHF	TRBV30	TRBJ1-5
TGTGCCAGTAGGGGGGAGAGGAATCAGCCCCAGCATTTT	CASRGERNQPQHF	TRBV19	TRBJ1-5
TGTGCCAGCAGTTACGGCGGGTTCCGGGGGGGGGCCCAGACCCAGTACTTC	CASSYGGFRGGAQTQYF	TRBV27	TRBJ2-5
TGTGCCAGCAGTTACTCGAGGGCCCCCCAGGCGGGCAATCAGCCCCAGCATTTT	CASSYSRAPQAGNQPQHF	TRBV6-2	TRBJ1-5
TGTGCCAGCAGAGCTCAGGCCCGGGACAGGGAAAAGTACGAGCAGTACTTC	CASRAQARDREKYEQYF	TRBV27	TRBJ2-7
TGTGCCAGCAGTACGGCTTTCCCCCCCGGGACAACGTCACCCCTCCACTTT	CASSTAFPPGTTSPLHF	TRBV6-6	TRBJ1-6
TGTGCCAGCAGTTACGTTAGGGACAGGGCGACAGACACTGAAGCTTTCTTT	CASSYVRDRATDTEAFF	TRBV6-5	TRBJ1-1
TGTGCCAGCAGGGGAGCCACGACTAGCGGGGGGACGGGAGAGACCCAGTACTTC	CASRGATTSGGTGETQYF	TRBV6-2	TRBJ2-5
TGTGCCAGCAGCCAACTAGGGATGCCCTACGAGCAGTACTTC	CASSQLGMPYEQYF	TRBV3-1	TRBJ2-7
TGTGCCACCACCCAGCCGCCTCGGTACGAGCAGTACTTC	CATTQPPRYEQYF	TRBV24-1	TRBJ2-7
TGCGCCAGCAGCACCTTGAGACAGGACTCTGGGGCCAACGTCCTGACTTTC	CASSTLRQDSGANVLTF	TRBV5-1	TRBJ2-6
TGTGCCAGCAGCCAAGGAAGACCTAGCTCCTACAATGAGCAGTTCTTC	CASSQGRPSSYNEQFF	TRBV4-2	TRBJ2-1
TGTGCCAGCAGCTTAACCGGCCCCGGTGAAAAACTGTTTTTT	CASSLTGPGEKLFF	TRBV7-3	TRBJ1-4
TGTGCCAGCAGTCGGTGGGGGGGAAGTTACGAGCAGTACTTC	CASSRWGGSYEQYF	TRBV28	TRBJ2-7
TGTGCCAGCAGCCAAGACCCTTGGGAGGGGGGTCCAATTGACTACGAGCAGTACTTC	CASSQDPWEGGPIDYEQYF	TRBV14	TRBJ2-7
TGCAGTGCTAGAGATAAACTTATCGCCGGGGAGCTGTTTTTT	CSARDKLIAGELFF	TRBV20-1	TRBJ2-2
TGTGCCAGCCGACCCGCCGGGGGAGACCCTGAAGCTTTCTTT	CASRPAGGDPEAFF	TRBV6-4	TRBJ1-1
TGTGCCAGCAGGAGACAGGGTCTAGCTTTCTTT	CASRRQGLAFF	TRBV27	TRBJ1-1
TGTGCCAGCAGCTTCCCCCTTTCGGACAGGCCCTACGAGCAGTACTTC	CASSFPLSDRPYEQYF	TRBV7-9	TRBJ2-7
TGTGCCAGCAGCGGGACAGGGAAGACTAAAGCCTACGAGCAGTACTTC	CASSGTGKTKAYEQYF	TRBV5-6	TRBJ2-7
TGTGCCAGCAGGGACAGGGGGCCGCCTCAGCCCCAGCATTTT	CASRDRGPPQPQHF	TRBV7-6	TRBJ1-5
TGTGCCAGCAGTGAGGGGGCGACGGGAAGCTCCTACAATGAGCAGTTCTTC	CASSEGATGSSYNEQFF	TRBV6-4	TRBJ2-1
TGTGCCACCAGTGATCCAATGGGGGCTTACAATGAGCAGTTCTTC	CATSDPMGAYNEQFF	TRBV24-1	TRBJ2-1
TGTGCCACTCTTAAACAGAGTAACACCGGGGAGCTGTTTTTT	CATLKQSNTGELFF	TRBV6-5	TRBJ2-2
TGCGCCAGCAGCATTTGGGGGGCCCGTAGCACAGATACGCAGTATTTT	CASSIWGARSTDTQYF	TRBV5-1	TRBJ2-3
TGTGCCAGCAGCTTGGGGAGGACAGGTAATGGCAATCAGCCCCAGCATTTT	CASSLGRTGNGNQPQHF	TRBV11-2	TRBJ1-5
TGTGCCAGCAGCTACCCGGAGGGCAGGACAGGGGGCTACACCTTC	CASSYPEGRTGGYTF	TRBV7-2	TRBJ1-2
TGTGCCAGCAGCTTAGACCCGGGGGCGCATGTTTTTATCTACGAGCAGTACTTC	CASSLDPGAHVFIYEQYF	TRBV7-6	TRBJ2-7
TGTGCCCAACCTTCAGGGAATCAGCCCCAGCATTTT	CAQPSGNQPQHF	TRBV6-5	TRBJ1-5
TGTGCCAGCAGTGGAAGCGGGAGGACCGGGTCCGGTCTGGGAGAAGTATACATAGCCAAAAACATTCAGTACTTC	CASSGSGRTGSGLGEVYIAKNIQYF	TRBV6-5	TRBJ2-4
TGTGCCAGCAGCTTCCGTACTAGAATTGAGACCCAGTACTTC	CASSFRTRIETQYF	TRBV7-8	TRBJ2-5
TGTGCCAGCTCACCGTTACAATGCGGGGACAGGGAGACAAGGGGATCCTACGAGCAGTACTTC	CASSPLQCGDRETRGSYEQYF	TRBV18	TRBJ2-7
TGTGCTAGCAGCTTTAGCCTAGCGGGGAGTGGTGAGACCCAGTACTTC	CASSFSLAGSGETQYF	TRBV7-7	TRBJ2-5
TGCAGTGCTATACCCGGACAGGAATCCTACGAGCAGTACTTC	CSAIPGQESYEQYF	TRBV20-1	TRBJ2-7
TGTGCCAGCAGCGCACCGGCGAGCTCCTACGAGCAGTACTTC	CASSAPASSYEQYF	TRBV5-8	TRBJ2-7
TGCAGCGTTGAACCGTGTCGAGGGGCCTACAATGAGCAGTTCTTC	CSVEPCRGAYNEQFF	TRBV29-1	TRBJ2-1
TGTGCCAGCAGTTGGCGGGGGGGCCCCACCGGGGAGCTGTTTTTT	CASSWRGGPTGELFF	TRBV27	TRBJ2-2
TGTGCCAGCAGCCGTTTCAGGGCCCTCGGCTACGAGCAGTACTTC	CASSRFRALGYEQYF	TRBV7-4	TRBJ2-7
TGTGCCACCCACGGTATGGGGGGGGGATCCTACAATGAGCAGTTCTTC	CATHGMGGGSYNEQFF	TRBV6-4	TRBJ2-1
TGTGCCAGCAGCTTAAAGACCAGCTCCTACGAGCAGTACTTC	CASSLKTSSYEQYF	TRBV7-3	TRBJ2-7
TGCGCCAGCCTATCAGGGGGTAATCAGCCCCAGCATTTT	CASLSGGNQPQHF	TRBV4-1	TRBJ1-5
TGTGCCAGCATGGGACAGAGATTCTCGGGGCCAACCGGGGAGCTGTTTTTT	CASMGQRFSGPTGELFF	TRBV6-2	TRBJ2-2
TGTGCCAGCAAGGGGGGACCGGACTCTGGAAACACCATATATTTT	CASKGGPDSGNTIYF	TRBV27	TRBJ1-3
TGCGCCAGCAGCCAGCGGGGCAGCACAGAGCAGTACTTC	CASSQRGSTEQYF	TRBV4-3	TRBJ2-7
TGTGCCAGCAGTTTCGGGACAGACACTCCCCGGGGAAATCAGCCCCAGCATTTT	CASSFGTDTPRGNQPQHF	TRBV27	TRBJ1-5
TGTGCCAGCAGTTCAGGGAATGAAGCTTTCTTT	CASSSGNEAFF	TRBV6-2	TRBJ1-1
TGCAGCGTGGAAACAGGGGGCTCGGTGTCACCCCTCCACTTT	CSVETGGSVSPLHF	TRBV29-1	TRBJ1-6
TGTGCCACCAGCAGAGCCCTACCACAGAATCAGCCCCAGCATTTT	CATSRALPQNQPQHF	TRBV15	TRBJ1-5
TGTGCCAGCAGCCACCACTACGAGCAGTACTTC	CASSHHYEQYF	TRBV7-4	TRBJ2-7
TGTGCCAGCAGTCGGGACAGGGGGGGCGAGCAGTACTTC	CASSRDRGGEQYF	TRBV6-1	TRBJ2-7
TGTGCCAGCATTGCCAAGGACTGGAGAAGCTCCTACGAGCAGTACTTC	CASIAKDWRSSYEQYF	TRBV6-3	TRBJ2-7
TGTGCCAGCAGCCCCAGTCCTCCCGGACTAGCTGAAGCTTTCTTT	CASSPSPPGLAEAFF	TRBV14	TRBJ1-1
TGTGCCAGCAGCTTAGCTCGGACAGGGGAGGTATGCAATCAGCCCCAGCATTTT	CASSLARTGEVCNQPQHF	TRBV7-2	TRBJ1-5
TGCAGTGCTAGAGATCAGTGGGACAAGGGAGCTGAAAAACTGTTTTTT	CSARDQWDKGAEKLFF	TRBV20-1	TRBJ1-4
TGCGCCAGCACCTCATTCTCCTACGAGCAGTACTTC	CASTSFSYEQYF	TRBV5-1	TRBJ2-7
TGTGCCAGCAGCTCAGCCGGGACAGGGCGAAGAGCTAACTATGGCTACACCTTC	CASSSAGTGRRANYGYTF	TRBV11-2	TRBJ1-2
TGTGCCAGCAGCATCTCAAATCAGACGCTTCGATACGAGCAGTACTTC	CASSISNQTLRYEQYF	TRBV7-2	TRBJ2-7
TGCAGCGCTTGCGGTTTTGACTACGAGCAGTACTTC	CSACGFDYEQYF	TRBV29-1	TRBJ2-7
TGTGCCAGCAGCTTCGAACATGGAGGGGACCATCAGCCCCAGCATTTT	CASSFEHGGDHQPQHF	TRBV7-8	TRBJ1-5
TGCAGTGCTAGAGATCAGCGAAAGTTGCTAGCGGGAAGGAAGGATACGCAGTATTTT	CSARDQRKLLAGRKDTQYF	TRBV20-1	TRBJ2-3
TGCAGTGCTAGACCCCGGGACAGATCTGAAGCTTTCTTT	CSARPRDRSEAFF	TRBV20-1	TRBJ1-1
TGCGCCAGCAGCTTGGAGGGATTTAGGGACAATGAGCAGTTCTTC	CASSLEGFRDNEQFF	TRBV5-1	TRBJ2-1
TGTGCCACTACCAATAACAGTAACTATGGCTACACCTTC	CATTNNSNYGYTF	TRBV7-6	TRBJ1-2
TGCGCCAGCAGCCAAGACGCGGGCCTTTACCATTCACCCCTCCACTTT	CASSQDAGLYHSPLHF	TRBV4-1	TRBJ1-6
TGTGCCAGCTCACCACTAACCCCCATAGAGCAGTACTTC	CASSPLTPIEQYF	TRBV18	TRBJ2-7
TGTGCCACCAGTGACCACCCAGGGAGGGAGATTCTTGGGTACGAGCAGTACTTC	CATSDHPGREILGYEQYF	TRBV24-1	TRBJ2-7
TGCGCCAGCAGTGACAGGGGCATGAGACTCGGCAATCAGCCCCAGCATTTT	CASSDRGMRLGNQPQHF	TRBV10-1	TRBJ1-5
TGTGCCAGCCAGACCCATCCCGGTCCGACCTACGAGCAGTACTTC	CASQTHPGPTYEQYF	TRBV7-7	TRBJ2-7
TGCAGCGCTTGGGGAGGATTCAGACCCAATGAAAAACTGTTTTTT	CSAWGGFRPNEKLFF	TRBV29-1	TRBJ1-4
TGTGCCAGTAGTATAGGGAGCAGGCCAACTGAAGCTTTCTTT	CASSIGSRPTEAFF	TRBV19	TRBJ1-1
TGTGCCAGCAGCATACCCTCACCGGGACCTGGCAAAAACATTCAGTACTTC	CASSIPSPGPGKNIQYF	TRBV5-6	TRBJ2-4
TGTGCCGTACCAGTAGGGTCCTACGAGCAGTACTTC	CAVPVGSYEQYF	TRBV9	TRBJ2-7
TGTGCCAGCAGGGACGGCGGGACTAGCGGCTACGAGCAGTACTTC	CASRDGGTSGYEQYF	TRBV2	TRBJ2-7
TGCAGTGCTAGAGATAGAGCCGGGACTAGACGGCCTAGCACAGATACGCAGTATTTT	CSARDRAGTRRPSTDTQYF	TRBV20-1	TRBJ2-3
TGTGCCTGGAGGGTCAAAAACATTCAGTACTTC	CAWRVKNIQYF	TRBV30	TRBJ2-4
TGCGCCAGCAGCTTGGGGCGGGAGATTGAGCAGTTCTTC	CASSLGREIEQFF	TRBV5-1	TRBJ2-1
TGTGCCACCACCCGGGACGCCTCCTACAATGAGCAGTTCTTC	CATTRDASYNEQFF	TRBV24-1	TRBJ2-1
TGTGCCAGCAGTTACAAACACCGGGACTGGGAGTACGAGCAGTACTTC	CASSYKHRDWEYEQYF	TRBV6-5	TRBJ2-7
TGTGCCAGTAGTATAGAACCGTCGGGCTCTGGAAACACCATATATTTT	CASSIEPSGSGNTIYF	TRBV19	TRBJ1-3
TGTGCCAGCAGCGCCAATCGCAGGGGTGGCTACACCTTC	CASSANRRGGYTF	TRBV13	TRBJ1-2
TGTGCCAGCAGCTTGGCCCCGTTCCAGGTTTGGAGGGACTATGGCTACACCTTC	CASSLAPFQVWRDYGYTF	TRBV5-4	TRBJ1-2
TGTGCCAGCAGCCATCAGGAGTGGCCCCAGCATTTT	CASSHQEWPQHF	TRBV14	TRBJ1-5
TGTGCCATCGGGATTGAAAAACTGTTTTTT	CAIGIEKLFF	TRBV10-3	TRBJ1-4
TGCGCCAGCACAGGGACAGCTAGGGCAACTAATGAAAAACTGTTTTTT	CASTGTARATNEKLFF	TRBV10-1	TRBJ1-4
TGCAGTGCCCCGACAGGGCGGCAGTTCTTC	CSAPTGRQFF	TRBV20-1	TRBJ2-1
TGTGCCAGCAGGGTCTCTTATGAAAAACTGTTTTTT	CASRVSYEKLFF	TRBV2	TRBJ1-4
TGTGCCAGCACGACAGGGTACGAGCAGTACTTC	CASTTGYEQYF	TRBV9	TRBJ2-7
TGTGCCAGCGGAGACGACATGTACTTC	CASGDDMYF	TRBV12-4	TRBJ2-7
TGTGCCAGCAGCCAAGATGATCTTACAAGTCCTAACTATGGCTACACCTTC	CASSQDDLTSPNYGYTF	TRBV14	TRBJ1-2
TGCAGTGCTCTTAGGGACGAATTAGGAGACGAGCAGTACTTC	CSALRDELGDEQYF	TRBV20-1	TRBJ2-7
TGTGCCAGCAGCTTAGCCGGGGGGGGGGGAGGGTACGAGCAGTACTTC	CASSLAGGGGGYEQYF	TRBV11-3	TRBJ2-7
TGTGCCAGCAGCGAAGGGGGGGTGATAGGGTGCGGGGAGCTGTTTTTT	CASSEGGVIGCGELFF	TRBV11-3	TRBJ2-2
TGTGCCAGCAGCTTAGACACAGGGGGAAGCTCCTACGAGCAGTACTTC	CASSLDTGGSSYEQYF	TRBV7-9	TRBJ2-7
TGTGCCAGCAGCTTGCCCACAGGGAATATGAACACTGAAGCTTTCTTT	CASSLPTGNMNTEAFF	TRBV5-5	TRBJ1-1
TGCAGCTATAGTACAGATACGCAGTATTTT	CSYSTDTQYF	TRBV29-1	TRBJ2-3
TGTGCCAGCAGCTCGACAGGGCGGGAAAAACTGTTTTTT	CASSSTGREKLFF	TRBV13	TRBJ1-4
TGTGCCACCAGTGATAATTCCCCGGGACAAAAGCAGCCCCAGCATTTT	CATSDNSPGQKQPQHF	TRBV24-1	TRBJ1-5
TGTGCCAGCAGTTACTGGTTCATAACCACAGGGGTTCTAGCCAAAAACATTCAGTACTTC	CASSYWFITTGVLAKNIQYF	TRBV6-5	TRBJ2-4
TGTGCCAGCAGCTACACTTGCCTAGGACAGGGTGGCGTCTTC	CASSYTCLGQGGVF	TRBV7-2	TRBJ2-1
TGCGCCAGCAGAGGTCGGTATGGCTACACCTTC	CASRGRYGYTF	TRBV5-1	TRBJ1-2
TGCAGTGCCCTCGGGGATGGCTATGGCTACACCTTC	CSALGDGYGYTF	TRBV20-1	TRBJ1-2
TGTGCCAGCAGCCAAGACGATCGCGGAGGAGGCGAGCAGTACTTC	CASSQDDRGGGEQYF	TRBV14	TRBJ2-7
TGTGCCAGTAGTGGACTAGCGGGTCTTTACGAGCAGTACTTC	CASSGLAGLYEQYF	TRBV19	TRBJ2-7
TGTGCCTCCTGCGGGAGTCCTAAAACCGGGGAGCTGTTTTTT	CASCGSPKTGELFF	TRBV5-6	TRBJ2-2
TGTGCCAGCAGCTCAACCGGGACAGGGGCATGCATGAACACTGAAGCTTTCTTT	CASSSTGTGACMNTEAFF	TRBV13	TRBJ1-1
TGTGCCACCACCTACCCGAGGGATCAGGGAGGCTACGAGCAGTACTTC	CATTYPRDQGGYEQYF	TRBV24-1	TRBJ2-7
TGCGCCAGCAGCCCGGGGGGAGGGGCGCAGTACTTC	CASSPGGGAQYF	TRBV5-1	TRBJ2-7
TGTGCCAGCAGGCGGGAGTCAAGCTCTGGGGCCAACGTCCTGACTTTC	CASRRESSSGANVLTF	TRBV28	TRBJ2-6
TGCAGTGCTAGAGGGTCCAGGGGGATGAACACTGAAGCTTTCTTT	CSARGSRGMNTEAFF	TRBV20-1	TRBJ1-1
TGTGCCAGGCCCACCGACAGGGGAGACACAGATACGCAGTATTTT	CARPTDRGDTDTQYF	TRBV14	TRBJ2-3
TGTGCCAGCAGTGACGGAGAGAAATACCGGCAGGGGCCGCTGAACACTGAAGCTTTCTTT	CASSDGEKYRQGPLNTEAFF	TRBV2	TRBJ1-1
TGTGCCAGCAGCTGGGTACTCACAGATACGCAGTATTTT	CASSWVLTDTQYF	TRBV5-6	TRBJ2-3
TGTGCCAGCAGCCAAGGGGGGGGGCTAAGGACCGGCTACGAGCAGTACTTC	CASSQGGGLRTGYEQYF	TRBV3-1	TRBJ2-7
TGTGCCAGCAGAAACAGGGTTACAGATACGCAGTATTTT	CASRNRVTDTQYF	TRBV28	TRBJ2-3
TGTGCCAGCAACAAGGGGGGGCCCTCGAACACTGAAGCTTTCTTT	CASNKGGPSNTEAFF	TRBV28	TRBJ1-1
TGTGCCAGCAGCGAGCCGAAGGGGCCCATGAACTATGGCTACACCTTC	CASSEPKGPMNYGYTF	TRBV7-3	TRBJ1-2
TGTGCCAGCAGCTTGGGGGGAGGGATTGGGAACACTGAAGCTTTCTTT	CASSLGGGIGNTEAFF	TRBV5-8	TRBJ1-1
TGTGCCAGAGTGAGGGACAGGGTTGGAGAGACCCAGTACTTC	CARVRDRVGETQYF	TRBV9	TRBJ2-5
TGTGCCAGCTCACCAGCCCACAGGGACTATGGCTACACCTTC	CASSPAHRDYGYTF	TRBV18	TRBJ1-2
TGTGCCAGCAATCTGGGGGCCCGGACCTACGAGCAGTACTTC	CASNLGARTYEQYF	TRBV12-4	TRBJ2-7
TGTGCCAGCAGCTTTTTTTCCCTCGACAGGGACCCGGACTACTATGGCTACACCTTC	CASSFFSLDRDPDYYGYTF	TRBV11-2	TRBJ1-2
TGTGCCAGCAGTTACATAGCGGGACCCTACGAGCAGTACTTC	CASSYIAGPYEQYF	TRBV6-5	TRBJ2-7
TGTGCCAGCAGCCGCCTTCGGGAGACCCAGTACTTC	CASSRLRETQYF	TRBV6-1	TRBJ2-5
TGTGCCAGCAGCATTGAGGGACAGCGTGGAAAGGCCGCTTTCTTT	CASSIEGQRGKAAFF	TRBV3-1	TRBJ1-1
TGTGCCAGCAGTACGGGATCCTTTCACGAGCAGTACTTC	CASSTGSFHEQYF	TRBV6-1	TRBJ2-7
TGTGCCAGTAAGCGGGGGGGGGGGGAAGAGACCCAGTACTTC	CASKRGGGEETQYF	TRBV9	TRBJ2-5
TGCAGTGCGGCTCTAGCGAGGCTAGCGCCATCCTACAATGAGCAGTTCTTC	CSAALARLAPSYNEQFF	TRBV20-1	TRBJ2-1
TGTGCCAGCACAATCCGGGACAGGGGCTATGGCTACACCTTC	CASTIRDRGYGYTF	TRBV2	TRBJ1-2
TGTGCCCGCCTGGGTCATGACAGGGGACAAGAGACCCAGTACTTC	CARLGHDRGQETQYF	TRBV9	TRBJ2-5
TGCGCCAGCAGCCCGGACAGGGTTATACATCAGCCCCAGCATTTT	CASSPDRVIHQPQHF	TRBV4-3	TRBJ1-5
TGTGCCCTGAAGGGAGGGGGTTTGAAGCGAAGAAGCTACGAGCAGTACTTC	CALKGGGLKRRSYEQYF	TRBV24-1	TRBJ2-7
TGTGCCAGCAGCACCAAGAGAAGGGCAACTAATGAAAAACTGTTTTTT	CASSTKRRATNEKLFF	TRBV9	TRBJ1-4
TGCAGTCTCGGATTCCCCTCGAGCTACGAGCAGTACTTC	CSLGFPSSYEQYF	TRBV20-1	TRBJ2-7
TGTGCCAGCAGCAGCCGGGACGCAGAGGGGAAAGAGACCCAGTACTTC	CASSSRDAEGKETQYF	TRBV7-2	TRBJ2-5
TGCGCCAGCAGTCCCATGGACAGCAATCAGCCCCAGCATTTT	CASSPMDSNQPQHF	TRBV10-1	TRBJ1-5
TGTGCCAGCTCACATCCGAGCTCGCAAGTGAACTATGGCTACACCTTC	CASSHPSSQVNYGYTF	TRBV18	TRBJ1-2
TGCAGTGCTAGACCCGGGACACTAACCACAGATACGCAGTATTTT	CSARPGTLTTDTQYF	TRBV20-1	TRBJ2-3
TGTGCCAGCAGCTTAGTGGACTACAGGGGGCCCGAGCAGTACTTC	CASSLVDYRGPEQYF	TRBV7-8	TRBJ2-7
TGTGCCACCAGTGATTTGCACGTCAGGGGGGCCAATGAGCAGTTCTTC	CATSDLHVRGANEQFF	TRBV24-1	TRBJ2-1
TGTGCCATGGATCAGGGTTGGTCCCTCCACTTT	CAMDQGWSLHF	TRBV27	TRBJ1-6
TGTGCCACCGCGGGGGGGCGAACCGAGTACTTC	CATAGGRTEYF	TRBV7-6	TRBJ2-7
TGTGCCACACTAGCGGGCGGGTTAAGCGAGCAGTACTTC	CATLAGGLSEQYF	TRBV7-8	TRBJ2-7
TGCGCCAGCAGCGGAGGACAGTCACCCCTCCACTTT	CASSGGQSPLHF	TRBV5-1	TRBJ1-6
TGTGCCAGCCAGAACGACGGGGAGCTGTTTTTT	CASQNDGELFF	TRBV7-9	TRBJ2-2
TGTGCCAGCAGTGACCCCCCGGGACAGGTAACTAATGAAAAACTGTTTTTT	CASSDPPGQVTNEKLFF	TRBV6-4	TRBJ1-4
TGTGCCAGGATTAGGGGGGCCTACAATGAGCAGTTCTTC	CARIRGAYNEQFF	TRBV7-2	TRBJ2-1
TGCAGTGCACAAGACAGGGAGTCCGATCAGCCCCAGCATTTT	CSAQDRESDQPQHF	TRBV20-1	TRBJ1-5
TGTGCCAGCAGTTTACGGTGGGCATCCTACAATGAGCAGTTCTTC	CASSLRWASYNEQFF	TRBV12-3	TRBJ2-1
TGTGCCAGCAGCCCCAACCATACGTTATTAGTTTTTGGGGCCAACGTCCTGACTTTC	CASSPNHTLLVFGANVLTF	TRBV7-3	TRBJ2-6
TGTGGCTCCCGACAGTCAAACACTGAAGCTTTCTTT	CGSRQSNTEAFF	TRBV12-3	TRBJ1-1
TGCGCCAGCAGCTTGGAAAGGGGGCAAATTGGGCCCCAGCATTTT	CASSLERGQIGPQHF	TRBV5-1	TRBJ1-5
TGTGCCAGCAGCTTACGCAGGCCGGTCCACTACGAGCAGTACTTC	CASSLRRPVHYEQYF	TRBV7-4	TRBJ2-7
TGTGCCAGCAGCTTAGTAGGAGAGTACCAAGAGACCCAGTACTTC	CASSLVGEYQETQYF	TRBV7-9	TRBJ2-5
TGTGCCAGCAGCCAAACCAGGAAGTACGAGCAGTACTTC	CASSQTRKYEQYF	TRBV14	TRBJ2-7
TGTGCCTGGAGGCCCCAGGGGGGCGAACCCCCTATGAATGAAAAACTGTTTTTT	CAWRPQGGEPPMNEKLFF	TRBV30	TRBJ1-4
TGTGCCACCAGTGATTGGGGGGACAGGGTAAGGTGCTACGAGCAGTACTTC	CATSDWGDRVRCYEQYF	TRBV24-1	TRBJ2-7
TGTGCCTCCAGCGGTGAAGAGACCCAGTACTTC	CASSGEETQYF	TRBV24-1	TRBJ2-5
TGTGCCAGCAGCATCCACGGGGCTGGTTGCTATGGCTACACCTTC	CASSIHGAGCYGYTF	TRBV5-6	TRBJ1-2
TGCGCCAGCATCACTCACGCAGGTAGCACCGGGGAGCTGTTTTTT	CASITHAGSTGELFF	TRBV4-3	TRBJ2-2
TGTGCCAGCAAAGACGGGGGGAGGCCCAATGAGCAGTTCTTC	CASKDGGRPNEQFF	TRBV9	TRBJ2-1
TGCGCCAGCACTCCGTGTTCTCACAGGGATGAGCAGTTCTTC	CASTPCSHRDEQFF	TRBV5-1	TRBJ2-1
TGCGCCAGCAGCTCGGGGGTAGCGGAAGAGACCCAGTACTTC	CASSSGVAEETQYF	TRBV5-1	TRBJ2-5
TGTGCCAGCAGCATACCCGGGACAGGGAACACTGAAGCTTTCTTT	CASSIPGTGNTEAFF	TRBV5-6	TRBJ1-1
TGTGCCAGCAGTCCACACCCAGGCGAAAAACTGTTTTTT	CASSPHPGEKLFF	TRBV27	TRBJ1-4
TGTGCCATCAGTGACCCTTGTCGAACCAGGGCAGATACGCAGTATTTT	CAISDPCRTRADTQYF	TRBV10-3	TRBJ2-3
TGTGCCAGCAGCTCTGAAGGCGTGCCTAGCGGGTCACCCTACGAGCAGTACTTC	CASSSEGVPSGSPYEQYF	TRBV7-2	TRBJ2-7
TGTGCCAGCAGCCAAGACGGTGGCTACACCTTC	CASSQDGGYTF	TRBV14	TRBJ1-2
TGCGCCAGCAGCTTGCAAAGGGGGGGTTCCTCCTACGAGCAGTACTTC	CASSLQRGGSSYEQYF	TRBV5-1	TRBJ2-7
TGTGCCAGCAGCTTACTAGCGGGAGAGCTCTCCTACAATGAGCAGTTCTTC	CASSLLAGELSYNEQFF	TRBV7-4	TRBJ2-1
TGTGCCAGCAGCTTAGATCAAACTAGCGGGAGAATGGACAATGAGCAGTTCTTC	CASSLDQTSGRMDNEQFF	TRBV7-9	TRBJ2-1
TGTGCCAGCAGTTGGGACAGTCTGAATTCACCCCTCCACTTT	CASSWDSLNSPLHF	TRBV27	TRBJ1-6
TGCGCCAGCAGTTCGGGGGGCCAATACGGGTACTTC	CASSSGGQYGYF	TRBV10-1	TRBJ2-7
TGTGCCAGCAGCGGCCTTGTTGGGCTAAGGAACTCCTACAATGAGCAGTTCTTC	CASSGLVGLRNSYNEQFF	TRBV6-5	TRBJ2-1
TGTGCCTGGGAGCGCCGAGACTATGGCTACACCTTC	CAWERRDYGYTF	TRBV30	TRBJ1-2
TGTGCCAGCAGAGGACAGTCGACCGGGGAGCTGTTTTTT	CASRGQSTGELFF	TRBV7-9	TRBJ2-2
TGTGCCAGCAGGAACGCCCTTAGTTACGAGCAGTACTTC	CASRNALSYEQYF	TRBV6-1	TRBJ2-7
TGTGCCAGCAGCTTGCTTTCTAGAGGCTACGAGCAGTACTTC	CASSLLSRGYEQYF	TRBV7-9	TRBJ2-7
TGTGCCAGCAGCACGGGGGGCGCTAGCGGGGAGGATCTACCAAACACCGGGGAGCTGTTTTTT	CASSTGGASGEDLPNTGELFF	TRBV7-3	TRBJ2-2
TGTGCCAGCAGCTCCTCTGCGACGAACCCAATTGGGTATAATTCACCCCTCCACTTT	CASSSSATNPIGYNSPLHF	TRBV7-3	TRBJ1-6
TGTCCAACGATTCCAGGTCCAGATACGCAGTATTTT	CPTIPGPDTQYF	TRBV20-1	TRBJ2-3
TGCAGTGCTACGAGACGTAACAGGGGCGGAGAGCCCTACGAGCAGTACTTC	CSATRRNRGGEPYEQYF	TRBV20-1	TRBJ2-7
TGTGCCAGCAGCTTACCGGGGTCAGGATGTGAGCCCCAGCATTTT	CASSLPGSGCEPQHF	TRBV7-3	TRBJ1-5
TGTGCCAGCAGCTTAGTTGACAGGGGGATCCGGTACGAGCAGTACTTC	CASSLVDRGIRYEQYF	TRBV11-2	TRBJ2-7
TGTGCCAGCAGCTACGGGACTAGCGGGGGACACTCAACCTACGAGCAGTACTTC	CASSYGTSGGHSTYEQYF	TRBV5-5	TRBJ2-7
TGCGCCAGCAAATTGACTTTACTTGAGCAGTTCTTC	CASKLTLLEQFF	TRBV10-1	TRBJ2-1
TGTGCCAGCAGGACCTATCAGTTTATAGATACAGATACGCAGTATTTT	CASRTYQFIDTDTQYF	TRBV6-1	TRBJ2-3
TGTGCCAGCCAGGGCCAAAATGAGCAGTTCTTC	CASQGQNEQFF	TRBV25-1	TRBJ2-1
TGCAGTGCTAGAGCATTTGGGGGCAGAAGATCCTACGAGCAGTACTTC	CSARAFGGRRSYEQYF	TRBV20-1	TRBJ2-7
TGTGCTAGTGGTTTGGGGACAGGGGGCAATAGAAAAGGCGAGCAGTACTTC	CASGLGTGGNRKGEQYF	TRBV12-5	TRBJ2-7
TGCAGTGCTAGTTTCTCCCCCAGGGGGCAAGAGACCCAGTACTTC	CSASFSPRGQETQYF	TRBV20-1	TRBJ2-5
TGTGCCAGCAGTTACAGGGACAATGAGCAGTTCTTC	CASSYRDNEQFF	TRBV12-4	TRBJ2-1
TGTGCCAGCAGCGAAACTAGCAGTCCCCAGACCCTTGAAAAACTGTTTTTT	CASSETSSPQTLEKLFF	TRBV5-4	TRBJ1-4
TGTGCCAGCAGGTCCGGCAAGCGGGAGTTAAAAGAGACCCAGTACTTC	CASRSGKRELKETQYF	TRBV6-3	TRBJ2-5
TGTGCCAGCTCACCACCGACAGGCTACGAGCAGTACTTC	CASSPPTGYEQYF	TRBV18	TRBJ2-7
TGTGCCAGCAGCGTCGGGCTAGCGGGCCGTGTCGAGCAGTACTTC	CASSVGLAGRVEQYF	TRBV9	TRBJ2-7
TGTGCTAGTGGTTTGGTACGAATTCTGGGCCGGGTGGCTGAAGCTTTCTTT	CASGLVRILGRVAEAFF	TRBV12-5	TRBJ1-1
TGCAATGAGCCTGACAATGAGCAGTTCTTC	CNEPDNEQFF	TRBV20-1	TRBJ2-1
TGTGCTAGTGGTATCCTAGATGGCAACAATGAGCAGTTCTTC	CASGILDGNNEQFF	TRBV12-5	TRBJ2-1
TGTGCCAGCAGCCAACATCCTGACTGTAACACCGGGGAGCTGTTTTTT	CASSQHPDCNTGELFF	TRBV4-2	TRBJ2-2
TGTGCCAGCAGTGAGTCTCCCGGGACTATTTGCCTAGAGACCCAGTACTTC	CASSESPGTICLETQYF	TRBV6-4	TRBJ2-5
TGTGCCAGCAGCGTAGATTCCGGGACTAGAAACCAAAACAAGGATGAGCAGTTCTTC	CASSVDSGTRNQNKDEQFF	TRBV9	TRBJ2-1
TGTGCCAGCAGCTGGCGGTGGGCTAAAGTAGAGACCCAGTACTTC	CASSWRWAKVETQYF	TRBV7-2	TRBJ2-5
TGTGCCAGCAGCTTAGGGGGGGCGCAGGAGACCCAGTACTTC	CASSLGGAQETQYF	TRBV7-2	TRBJ2-5
TGTGCCAGCAGGGATCTAGCAGGGACCAGGAACACTGAAGCTTTCTTT	CASRDLAGTRNTEAFF	TRBV6-3	TRBJ1-1
TGTGCCAGCAGTGTCAATACAGGGCTACTCGACGAGCAGTACTTC	CASSVNTGLLDEQYF	TRBV28	TRBJ2-7
TGTGCCAGCAGAACGGGAGGTCACCTGTCCTACAATGAGCAGTTCTTC	CASRTGGHLSYNEQFF	TRBV11-1	TRBJ2-1
TGTGCCAGCAGCTTGTGGACTAGCGGGAGGGCAACCGGGGAGCTGTTTTTT	CASSLWTSGRATGELFF	TRBV5-6	TRBJ2-2
TGTGCCAGCAGCTTAGCGGGATGCAATCAGCCCCAGCATTTT	CASSLAGCNQPQHF	TRBV7-9	TRBJ1-5
TGCGCCAGCACAGGGGGCCTACTCAATCAGCCCCAGCATTTT	CASTGGLLNQPQHF	TRBV4-3	TRBJ1-5
TGTGCCAGCAGCGTTGGGAGGCTCACGAAACTAGATGAGACCCAGTACTTC	CASSVGRLTKLDETQYF	TRBV7-8	TRBJ2-5
TGTGCCAGTAGTATAGCCCCCCCGACTGGATACAATGAGCAGTTCTTC	CASSIAPPTGYNEQFF	TRBV19	TRBJ2-1
TGTGCCAGCAGCTCTTATTGGGCAAAGATACAGCCCCAGCATTTT	CASSSYWAKIQPQHF	TRBV13	TRBJ1-5
TGTGCCAGCAGCTGGGACAGGACAGTAGCGCGCAACAAGAACTCTGGGGCCAACGTCCTGACTTTC	CASSWDRTVARNKNSGANVLTF	TRBV7-8	TRBJ2-6
TGTGCCACCAGTGATAAGCGCGGGAGATTTACCCTAGCCAAAAACATTCAGTACTTC	CATSDKRGRFTLAKNIQYF	TRBV24-1	TRBJ2-4
TGCGCCAGCAGCCAAGATTCCCCGGGACAGTTTCGGACTGGGGCCAACGTCCTGACTTTC	CASSQDSPGQFRTGANVLTF	TRBV4-1	TRBJ2-6
TGTGCCAGCAGTGCTTCAAACTGGCTGAAGACAGGGCAGGTAAAGGCCTACGAGCAGTACTTC	CASSASNWLKTGQVKAYEQYF	TRBV6-4	TRBJ2-7
TGTGCCAGCAGCCGGAGGGGACAGGGGATAGCTTTCTTT	CASSRRGQGIAFF	TRBV6-5	TRBJ1-1
TGTGCCAGGGGGACGCGGCTTTATGGCTACACCTTC	CARGTRLYGYTF	TRBV27	TRBJ1-2
TGTGCCAGCGCCGGCGGGTATCAGCCCCAGCATTTT	CASAGGYQPQHF	TRBV11-2	TRBJ1-5
TGTGCCAGCAGCGTGACACTATATAATTCACCCCTCCACTTT	CASSVTLYNSPLHF	TRBV13	TRBJ1-6
TGCGCCAGCAGCTTAATCCCTAAGGTGACAAGCAATCAGCCCCAGCATTTT	CASSLIPKVTSNQPQHF	TRBV5-1	TRBJ1-5
TGTGCCAGCCCGGGCTCGGGTCCCGAGACCCAGTACTTC	CASPGSGPETQYF	TRBV7-8	TRBJ2-5
TGCAGTGCCCCTACAGAGCGGGATGTGTGCTCTGGAAACACCATATATTTT	CSAPTERDVCSGNTIYF	TRBV20-1	TRBJ1-3
TGTGCCACCAGTGAAGGGTACAGGGAGGCAAGCAATCAGCCCCAGCATTTT	CATSEGYREASNQPQHF	TRBV24-1	TRBJ1-5
TGTGCCAGCAGCTTACATCCAACCGGGGGTTACCTGTCCTACGAGCAGTACTTC	CASSLHPTGGYLSYEQYF	TRBV11-2	TRBJ2-7
TGTGCCAGCAGCTTACCGAGAGGAGGAAACACAGATACGCAGTATTTT	CASSLPRGGNTDTQYF	TRBV11-3	TRBJ2-3
TGTGCCACCAGAGCTGACAGGGGGGAGTGCGAGCAGTACTTC	CATRADRGECEQYF	TRBV24-1	TRBJ2-7
TGCGCCAGCAGGGAGGGCCGGGACTACCAAGAGACCCAGTACTTC	CASREGRDYQETQYF	TRBV4-1	TRBJ2-5
TGCAGTGCTAGAGTAGGGCCTCGGGGGTATAGCAATCAGCCCCAGCATTTT	CSARVGPRGYSNQPQHF	TRBV20-1	TRBJ1-5
TGTGCCATGCAGGGCCTTGGCTACACCTTC	CAMQGLGYTF	TRBV6-4	TRBJ1-2
TGTGCCAGCAGCCAAGCCATAGGCCTGTGGGGAGAGACCCAGTACTTC	CASSQAIGLWGETQYF	TRBV3-1	TRBJ2-5
TGTGCCAGCAGGACTAGTAATCTGGGCTACGAGCAGTACTTC	CASRTSNLGYEQYF	TRBV3-1	TRBJ2-7
TGCAGTGCTAGAGATTTGAGGCGTCGGACTAGCGAGCCCTACGAGCAGTACTTC	CSARDLRRRTSEPYEQYF	TRBV20-1	TRBJ2-7
TGTGCCAGCAGCCCCAGGGGGTATGGCTACACCTTC	CASSPRGYGYTF	TRBV9	TRBJ1-2
TGTGCCAGCAGCCGGGACGGCCCCATGGCGGACGGCTATGGCTACACCTTC	CASSRDGPMADGYGYTF	TRBV14	TRBJ1-2
TGTGCTAGCAGCTGGAACGCGCGGGAGAGCTCCTATAATTCACCCCTCCACTTT	CASSWNARESSYNSPLHF	TRBV7-7	TRBJ1-6
TGTGCCAGCTCTCAGTATCAGGACAGGGATAGTAGCAATCAGCCCCAGCATTTT	CASSQYQDRDSSNQPQHF	TRBV27	TRBJ1-5
TGTGCCAGCAGCTTAACCCCCTCTGGACTAGCGGGGGGGCGTTGGCCCGGCACAGATACGCAGTATTTT	CASSLTPSGLAGGRWPGTDTQYF	TRBV7-9	TRBJ2-3
TGTGCCAGCAGCTTAGGACGGGGGGAGGGGTGCAATGAGCAGTTCTTC	CASSLGRGEGCNEQFF	TRBV11-3	TRBJ2-1
TGTGCCAGCCACTGCTATGGCTACACCTTC	CASHCYGYTF	TRBV27	TRBJ1-2
TGCGCCAGCAGCTTGGGACGGGCCGGACAGGGGGTGAATCAGCCCCAGCATTTT	CASSLGRAGQGVNQPQHF	TRBV5-1	TRBJ1-5
TGTGCCAGCAGCGGAAATGAAAGCGGGATTCAGCCCCAGCATTTT	CASSGNESGIQPQHF	TRBV28	TRBJ1-5
TGTGCCAGCAGGGGGGGGCAGGGGGAGCTAGCCAAAAACATTCAGTACTTC	CASRGGQGELAKNIQYF	TRBV14	TRBJ2-4
TGTGCCAGCAGCGGGGGCGGGAACACTGAAGCTTTCTTT	CASSGGGNTEAFF	TRBV7-8	TRBJ1-1
TGTGCCAGTACGGACAGGGGGCCTAACTATGGCTACACCTTC	CASTDRGPNYGYTF	TRBV19	TRBJ1-2
TGTGCCAGCAGCGCCCCCGGGGGTACGAATTCACCCCTCCACTTT	CASSAPGGTNSPLHF	TRBV13	TRBJ1-6
TGCGCCAGCAGCACACGGGGGCGGACAGGAAACGAGCAGTACTTC	CASSTRGRTGNEQYF	TRBV5-1	TRBJ2-7
TGTGCCACCAGTGAGCCAAAGACCTCCTACGAGCAGTACTTC	CATSEPKTSYEQYF	TRBV24-1	TRBJ2-7
TGTGCCAGCAGCACAGGGGAATATGGCTACACCTTC	CASSTGEYGYTF	TRBV7-3	TRBJ1-2
TGTGCCAGCAGTTACTCCGACAGGGGGCTTGACTATGGCTACACCTTC	CASSYSDRGLDYGYTF	TRBV6-6	TRBJ1-2
TGTGCCAGCAGCTTACAAGCATCCGGCTCCTACAATGAGCAGTTCTTC	CASSLQASGSYNEQFF	TRBV13	TRBJ2-1
TGTGCCAGCAGCCCGGGGAAGATTTCAGACGAGCAGTACTTC	CASSPGKISDEQYF	TRBV7-8	TRBJ2-7
TGTGCCACAGGGGTAGAAAATGAGCAGTTCTTC	CATGVENEQFF	TRBV19	TRBJ2-1
TGTGCCAGCAGTAGGTCCCGGGACAGGGCTTATGGCTACACCTTC	CASSRSRDRAYGYTF	TRBV27	TRBJ1-2
TGTGCCAGCAGCAACTACACCCGGGGTGAAGCTTTCTTT	CASSNYTRGEAFF	TRBV9	TRBJ1-1
TGTGCCAGCAGCGGGAAGGTTCTGGCAACTAATGAAAAACTGTTTTTT	CASSGKVLATNEKLFF	TRBV5-4	TRBJ1-4
TGTGCCAGCAGCTTACCGAAGGGGGGGGTAAACTATGGCTACACCTTC	CASSLPKGGVNYGYTF	TRBV7-9	TRBJ1-2
TGCAGCGGAACGGACAGGCAGTACTTC	CSGTDRQYF	TRBV29-1	TRBJ2-7
TGTGCCAGCAGAGGCTGGGCCCGGCCGTCCTACAATGAGCAGTTCTTC	CASRGWARPSYNEQFF	TRBV28	TRBJ2-1
TGCGCCATGCACGATAGGAACACCGGGGAGCTGTTTTTT	CAMHDRNTGELFF	TRBV5-1	TRBJ2-2
TGTGCTAGCAGCTTAGCGTGTAGAGGACATTTAAGAAATGAGCAGTTCTTC	CASSLACRGHLRNEQFF	TRBV7-7	TRBJ2-1
TGTGCCAGCAGCCAAGGTTGGGGGGTCTCCTACAATGAGCAGTTCTTC	CASSQGWGVSYNEQFF	TRBV14	TRBJ2-1
TGTGCCAGCTCACCACGATGGACTAGCGGGGACGGGGAGCTGTTTTTT	CASSPRWTSGDGELFF	TRBV18	TRBJ2-2
TGTGCCAGCAGAGCGGCCCCATCTGGAAACACCATATATTTT	CASRAAPSGNTIYF	TRBV13	TRBJ1-3
TGTGCCAGCTCACCATTTACGGACTCCTACGAGCAGTACTTC	CASSPFTDSYEQYF	TRBV18	TRBJ2-7
TGTGCCACCAGTGAGGCACTAGGTTTCAATGAGCAGTTCTTC	CATSEALGFNEQFF	TRBV24-1	TRBJ2-1
TGCGCCAGCAGCCGGACCTACGAGCAGTACTTC	CASSRTYEQYF	TRBV5-1	TRBJ2-7
TGTGCCAGCAGCCGGGACAGGGCCAGCACTGAAGCTTTCTTT	CASSRDRASTEAFF	TRBV28	TRBJ1-1
TGTGCTAGTGGTACCGTCGGGGGTCAGGCGACCGAGACCCAGTACTTC	CASGTVGGQATETQYF	TRBV12-5	TRBJ2-5
TGTGCCAGCTACCGGACAGGGGGTGAAAAACTGTTTTTT	CASYRTGGEKLFF	TRBV27	TRBJ1-4
TGTGCCAGCAGTGGACTCCGAACTAGCACGACGGGGGACTACGAGCAGTACTTC	CASSGLRTSTTGDYEQYF	TRBV6-1	TRBJ2-7
TGTGCCAAGCAGACGCATAACTATGGCTACACCTTC	CAKQTHNYGYTF	TRBV9	TRBJ1-2
TGTGCCAGCAGCCCGCCAGGGGAGATGAACACTGAAGCTTTCTTT	CASSPPGEMNTEAFF	TRBV7-3	TRBJ1-1
TGTGCCAGACAGACAGATACGCAGTATTTT	CARQTDTQYF	TRBV3-1	TRBJ2-3
TGTGCCAGATGGACAGGGGTAGGAGATGTAGATACGCAGTATTTT	CARWTGVGDVDTQYF	TRBV25-1	TRBJ2-3
TGCGCCAGCAGTGCCCAGGGGGTGGTAACCCAGTACTTC	CASSAQGVVTQYF	TRBV10-1	TRBJ2-5
TGTGCCAGCAGGGCTTCCCGACTAGCCCTATCTAGCACAGATACGCAGTATTTT	CASRASRLALSSTDTQYF	TRBV6-2	TRBJ2-3
TGTGCCAGCAGACCGAGGTGGCGGAATTCACCCCTCCACTTT	CASRPRWRNSPLHF	TRBV7-3	TRBJ1-6
TGTGCCAGCAGTTTCCTTTGCGTCGACAGGGGGCACTCCTACGAGCAGTACTTC	CASSFLCVDRGHSYEQYF	TRBV28	TRBJ2-7
TGTGCCAGCAGCAGTTCAGTAACTGAAGCTTTCTTT	CASSSSVTEAFF	TRBV7-9	TRBJ1-1
TGTGCCACCAGTGATTTGGGGGCACCTGGGGGAGGTTTTTCGGGGCAGTTCTTC	CATSDLGAPGGGFSGQFF	TRBV24-1	TRBJ2-1
TGTGCCAATGGGCCGTGGGATCACACTGAAGCTTTCTTT	CANGPWDHTEAFF	TRBV2	TRBJ1-1
TGCGCCAGCAGCTTGCTCACCGCTGCTGAGTCTTTGAACACCGGGGAGCTGTTTTTT	CASSLLTAAESLNTGELFF	TRBV5-1	TRBJ2-2
TGTGCCAGCAGCCCAGTCCTCGGGACAGCGAACACTGAAGCTTTCTTT	CASSPVLGTANTEAFF	TRBV13	TRBJ1-1
TGTGCCAGCAGTTACTGTGGAGGACTAGCGGGAGGTGAGCAGTTCTTC	CASSYCGGLAGGEQFF	TRBV6-5	TRBJ2-1
TGTGCCACCAATACCAGACAGGGCTACGAGCAGTACTTC	CATNTRQGYEQYF	TRBV24-1	TRBJ2-7
TGTGCCAGCACCAGGGCAGATACGCAGTATTTT	CASTRADTQYF	TRBV12-3	TRBJ2-3
TGTGCCATCACCCCAGCCCAATGGCTCGAGCAGTACTTC	CAITPAQWLEQYF	TRBV10-3	TRBJ2-7
TGTGCCAGCAGTTTAATTCCCGACAGAGGAGCTTTCTTT	CASSLIPDRGAFF	TRBV12-3	TRBJ1-1
TGTGCCTGGCTGTCCTTCCACAAGCAGTACTTC	CAWLSFHKQYF	TRBV30	TRBJ2-7
TGCGCCAGCAGGCTAGACCTCATACCGTTGACGGGGCAAGAGACCCAGTACTTC	CASRLDLIPLTGQETQYF	TRBV5-1	TRBJ2-5
TGTGCCAGCAGTGAGACAGGGTGGAGCAATCAGCCCCAGCATTTT	CASSETGWSNQPQHF	TRBV12-3	TRBJ1-5
TGTGCCAGCGGTCTTGGGACAGATGGGCCAGCCGCCACTGAAGCTTTCTTT	CASGLGTDGPAATEAFF	TRBV28	TRBJ1-1
TGCGCCAGCAGCTTGGACAAGGTGCGGGAATCGGGTTGGAGCAATCAGCCCCAGCATTTT	CASSLDKVRESGWSNQPQHF	TRBV5-1	TRBJ1-5
TGTGCCAGCAGTTACCCTTGCCGGGGCGGAGGTCAGCCCCAGCATTTT	CASSYPCRGGGQPQHF	TRBV6-5	TRBJ1-5
TGTGCCAGCAGTTACTCGGTTCGACACCATGGCTACACCTTC	CASSYSVRHHGYTF	TRBV6-5	TRBJ1-2
TGCAGTGCGGGTCCTGGGACATATATCACCGGGGAGCTGTTTTTT	CSAGPGTYITGELFF	TRBV20-1	TRBJ2-2
TGTGCCAGCAGCTCCGGACAGGACTGCTACGAGCAGTACTTC	CASSSGQDCYEQYF	TRBV5-4	TRBJ2-7
TGTGCCAGCAGCTTTAAGTCCGGGGCCGAGCACGAGCAGTACTTC	CASSFKSGAEHEQYF	TRBV5-6	TRBJ2-7
TGTGCCAGCAGTTTATTCAGAAACAGCCCACAGGGACAGGGACGGGGCTACACCTTC	CASSLFRNSPQGQGRGYTF	TRBV28	TRBJ1-2
TGCGCCAGCAGCCAAGACAGTACCGGGACATTGACCTACGAGCAGTACTTC	CASSQDSTGTLTYEQYF	TRBV4-1	TRBJ2-7
TGTGCCAGCAGCCAGGGCCATGGCTACACCTTC	CASSQGHGYTF	TRBV3-1	TRBJ1-2
TGTGCCAGCAGCAAGCCGGGACATGAAAAACTGTTTTTT	CASSKPGHEKLFF	TRBV13	TRBJ1-4
TGCGCCAGCGCGTCTAGCGGGTCGAACACCGGGGAGCTGTTTTTT	CASASSGSNTGELFF	TRBV5-1	TRBJ2-2
TGCGCCAGCAGCTTTACTATCGGGAGGGTGCAGTTCTTC	CASSFTIGRVQFF	TRBV5-1	TRBJ2-1
TGTGCCAGCAGCTGCCCGGGACGTGAAACCTACGAGCAGTACTTC	CASSCPGRETYEQYF	TRBV5-6	TRBJ2-7
TGTGCCAGCAGCTTGCTCAGTGGGGCTTCAAGGTCCCATGGTGAGCAGTTCTTC	CASSLLSGASRSHGEQFF	TRBV5-4	TRBJ2-1
TGTGCCAGCAGTTTAAAATCCCGGGACAGGGACTTGAGATTCTCACATAACACCTTC	CASSLKSRDRDLRFSHNTF	TRBV27	TRBJ1-2
TGTGCCACCATGGCCCGGGACAGTTCCAATCAGCCCCAGCATTTT	CATMARDSSNQPQHF	TRBV24-1	TRBJ1-5
TGTGCCAGCATTCTGCGCTTTGCACCCGGCTACACCTTC	CASILRFAPGYTF	TRBV6-4	TRBJ1-2
TGTGCCAGCAGGCCCCGAAAAGCAGTTTTGGCCGAAGCTTTCTTT	CASRPRKAVLAEAFF	TRBV28	TRBJ1-1
TGCTTGCCGGGACAGGGGAACACTGAAGCTTTCTTT	CLPGQGNTEAFF	TRBV29-1	TRBJ1-1
TGCGCCAGCTCTCGGGGGGTCAGCACAGATACGCAGTATTTT	CASSRGVSTDTQYF	TRBV10-1	TRBJ2-3
TGTGCCAGCAGCTTGCCCTGTAGTTTCTATGGCTACACCTTC	CASSLPCSFYGYTF	TRBV5-4	TRBJ1-2
TGTGCTAGTACGAGACAGGGGGGTCTGAATGAAAAACTGTTTTTT	CASTRQGGLNEKLFF	TRBV12-5	TRBJ1-4
TGTGCCAGCAGCATGACAGGGGTTTCCACAGATACGCAGTATTTT	CASSMTGVSTDTQYF	TRBV6-5	TRBJ2-3
TGTGCCAGCAGCGGACTAGCGGGAGGGGACAATGAGCAGTTCTTC	CASSGLAGGDNEQFF	TRBV7-3	TRBJ2-1
TGTGCCAGCAGCTCAGGGGAATACACTGAAGCTTTCTTT	CASSSGEYTEAFF	TRBV14	TRBJ1-1
TGTGCCAGCAGCGGGAAAACTGGACAGGGCAATGAGCAGTTCTTC	CASSGKTGQGNEQFF	TRBV9	TRBJ2-1
TGTGCCAGCAGTTACCCGCTAGCGGGGAATGAGCAGTTCTTC	CASSYPLAGNEQFF	TRBV6-5	TRBJ2-1
TGCAGTGCTAGAAAGGTAGGGCCTCTTGCCGGGGAGCTGTTTTTT	CSARKVGPLAGELFF	TRBV20-1	TRBJ2-2
TGTGCCAGCAGTAGTTGGGACAGCGAGAATCAGCCCCAGCATTTT	CASSSWDSENQPQHF	TRBV6-5	TRBJ1-5
TGCGCCAGCAGCTTGGACGTCGGACAGAGCTATGGCTACACCTTC	CASSLDVGQSYGYTF	TRBV5-1	TRBJ1-2
TGTGCCAGCAGCTCCGGACTAGCGGGGTCACGACCCCAGGAGACCCAGTACTTC	CASSSGLAGSRPQETQYF	TRBV11-2	TRBJ2-5
TGTGCCAGCAGCCCTACAGGGTGGGCCACAGATACGCAGTATTTT	CASSPTGWATDTQYF	TRBV11-3	TRBJ2-3
TGTGCCAGCAGTGGAAGCTTTGTTGCTAACTATGGCTACACCTTC	CASSGSFVANYGYTF	TRBV25-1	TRBJ1-2
TGTGCCACCAGTGAATCTAACCGGGACAGGGATGCCAAAAACATTCAGTACTTC	CATSESNRDRDAKNIQYF	TRBV24-1	TRBJ2-4
TGCGCCAGCAGCGTGCGGAGGATCCCCACAGATACGCAGTATTTT	CASSVRRIPTDTQYF	TRBV5-1	TRBJ2-3
TGTGCCAGCAGGGTACAGGGGTCCTACGAGCAGTACTTC	CASRVQGSYEQYF	TRBV6-1	TRBJ2-7
TGTGCCAGCAGCTGTGGGGCCCGATGCTATGGCTACACCTTC	CASSCGARCYGYTF	TRBV5-5	TRBJ1-2
TGTGCCCCCCCGACAGGGTACGAGCAGTACTTC	CAPPTGYEQYF	TRBV6-2	TRBJ2-7
TGTGCCAGCAGGCCAAATCAGGACGAGCAGTACTTC	CASRPNQDEQYF	TRBV6-4	TRBJ2-7
TGTGCCAGCAGCTATGGGGCCGCATATAGCAATCAGCCCCAGCATTTT	CASSYGAAYSNQPQHF	TRBV7-9	TRBJ1-5
TGCGCCAGCGGGGTAGGACAGGCTGTCTTAACTGAAGCTTTCTTT	CASGVGQAVLTEAFF	TRBV5-1	TRBJ1-1
TGTGCTAGTGGTTTGGGAACGGGGCGCGAGTCGGGGCAGGACGAGCAGTACTTC	CASGLGTGRESGQDEQYF	TRBV12-5	TRBJ2-7
TGCGCCAGCAGCGCCCTAGGGGGCGAGATTGGAGGGCACTCCGGGCGCTCTGGGGCCAACGTCCTGACTTTC	CASSALGGEIGGHSGRSGANVLTF	TRBV5-1	TRBJ2-6
TGTGCCAGCAGCGATAAAAAGGCCTACAATGAGCAGTTCTTC	CASSDKKAYNEQFF	TRBV7-3	TRBJ2-1
TGCGCCAGCAGCGGACGGGTGGATGGCTACACCTTC	CASSGRVDGYTF	TRBV5-1	TRBJ1-2
TGCAGTGCGGGACGGCTTGACACCGGGGAGCTGTTTTTT	CSAGRLDTGELFF	TRBV20-1	TRBJ2-2
TGTGCCATGTCCACAGGGGAATTTGAGGACGGGGAGCTGTTTTTT	CAMSTGEFEDGELFF	TRBV10-3	TRBJ2-2
TGTGCCAGCAGTTTATTGGACAGGGGGTATAGCAATCAGCCCCAGCATTTT	CASSLLDRGYSNQPQHF	TRBV27	TRBJ1-5
TGCGCCAGCAGGGGGGACAGGGTCATTCTGACGGCGAACACCGGGGAGCTGTTTTTT	CASRGDRVILTANTGELFF	TRBV5-1	TRBJ2-2
TGCGCCAGCAGCTTGGGCTTTAGTGACCTGGAGCAGTTCTTC	CASSLGFSDLEQFF	TRBV5-1	TRBJ2-1
TGTGCCAGCAGCAGGCTGGGGGGAGGTACCGGGGAGCTGTTTTTT	CASSRLGGGTGELFF	TRBV9	TRBJ2-2
TGTGCCAGCAGCTCCCAGAGAATTAGTGGCTACACCTTC	CASSSQRISGYTF	TRBV7-3	TRBJ1-2
TGTGCCAGCAGCGGGGACTCCTATAATTCACCCCTCCACTTT	CASSGDSYNSPLHF	TRBV13	TRBJ1-6
TGTGCCACCAGCAGAGATGCCCGGACAGGCAGCAATCAGCCCCAGCATTTT	CATSRDARTGSNQPQHF	TRBV15	TRBJ1-5
TGTGCCTGGAGACCAAGGACCCCGCCGTCCTTTTTTAAAAGAGACTATGGCTACACCTTC	CAWRPRTPPSFFKRDYGYTF	TRBV30	TRBJ1-2
TGTGCCAGCAGCCAAGTCAGCGGGAGACCCTACGAGCAGTACTTC	CASSQVSGRPYEQYF	TRBV14	TRBJ2-7
TGTGCCAGCAGCTCCACAATGGGGGGATCGACTCTCAAAAACATTCAGTACTTC	CASSSTMGGSTLKNIQYF	TRBV11-2	TRBJ2-4
TGTGCCAGCAGCGGACGGGGGGCCCAAGAGACCCAGTACTTC	CASSGRGAQETQYF	TRBV7-9	TRBJ2-5
TGTGCCAGCAGTTATCTTTCCCCAACTAGCCGGGGGGGCTACGAGCAGTACTTC	CASSYLSPTSRGGYEQYF	TRBV6-5	TRBJ2-7
TGTGCCAGCAGCAAGGCAGAGGGGAACGGGGAGCTGTTTTTT	CASSKAEGNGELFF	TRBV7-2	TRBJ2-2
TGTGCCAGCAGTCCGGTCCCCCGGGGGAGAATTGCACAGCCAGACAGGGATAAGAGGTGGAACACCGGGGAGCTGTTTTTT	CASSPVPRGRIAQPDRDKRWNTGELFF	TRBV28	TRBJ2-2
TGTGCCACCAGCAGAGATAGGGGGGCTAGCAATCAGCCCCAGCATTTT	CATSRDRGASNQPQHF	TRBV15	TRBJ1-5
TGTGCCAGCGAAATTGATTTCCGAGCTTTCTTT	CASEIDFRAFF	TRBV27	TRBJ1-1
TGTGCCAGCTCCCAGATTCAGGGCTCCTCAGATACGCAGTATTTT	CASSQIQGSSDTQYF	TRBV7-9	TRBJ2-3
TGTGCCAGCAGCGCTCCGGGGACTGGGGGGATGGCAGAGACCCAGTACTTC	CASSAPGTGGMAETQYF	TRBV11-2	TRBJ2-5
TGTGCCAGCAACCGCGGACTACATAGATACGTCCTCTTC	CASNRGLHRYVLF	TRBV7-6	TRBJ2-1
TGCAGTGCGGAAAGTGGTTACAATGAGCAGTTCTTC	CSAESGYNEQFF	TRBV20-1	TRBJ2-1
TGTGCCTGGAGAGGGGTACCCTCACAGGGGAGGGACCCCACTGAAGCTTTCTTT	CAWRGVPSQGRDPTEAFF	TRBV30	TRBJ1-1
TGCGCCAGCAGCTTGGCCTCGGACAGGGTAAGGAACACTGAAGCTTTCTTT	CASSLASDRVRNTEAFF	TRBV5-1	TRBJ1-1
TGCGCCAGCAGCCCCCCAGGAAACACCATATATTTT	CASSPPGNTIYF	TRBV5-1	TRBJ1-3
TGCAGTGCTAGCGATTGTGCGGGACAGATCAATCAGCCCCAGCATTTT	CSASDCAGQINQPQHF	TRBV20-1	TRBJ1-5
TGTGCCAGCAGCTCGTTCCGGGGCCCGGCCTACAATGAGCAGTTCTTC	CASSSFRGPAYNEQFF	TRBV7-6	TRBJ2-1
TGTGCCACCAGTGGTGACACGGTGAGGGAAAAACTGTTTTTT	CATSGDTVREKLFF	TRBV24-1	TRBJ1-4
TGTGCCTGGAGTGTACGGAGATACGAGCAGTACTTC	CAWSVRRYEQYF	TRBV30	TRBJ2-7
TGTGCCAGCAGCTTAATATACAAATACTCTGGAAACACCATATATTTT	CASSLIYKYSGNTIYF	TRBV7-7	TRBJ1-3
TGTGCCAGCAGCCAAGTTGATCTTTTAGCGGGTGAGCAGTTCTTC	CASSQVDLLAGEQFF	TRBV14	TRBJ2-1
TGCAGTGACAGCGGGATCACTGAAGCTTTCTTT	CSDSGITEAFF	TRBV20-1	TRBJ1-1
TGTGCCAGTCCCCGGGACACACAAACTAATGAAAAACTGTTTTTT	CASPRDTQTNEKLFF	TRBV3-1	TRBJ1-4
TGTGCCAGCAGTTACCGCCGACAGGAGTACCTGAACACTGAAGCTTTCTTT	CASSYRRQEYLNTEAFF	TRBV6-5	TRBJ1-1
TGTGCCAGCAGGCTACAGGGGGGCGACCATCAGCCCCAGCATTTT	CASRLQGGDHQPQHF	TRBV7-3	TRBJ1-5
TGTGCCAGCAGCATCTCGCCCCGGACGAACACTGAAGCTTTCTTT	CASSISPRTNTEAFF	TRBV13	TRBJ1-1
TGCGCCAGCAGTGAGCAGGCAGGGGGCGATAGCTCCTATAATTCACCCCTCCACTTT	CASSEQAGGDSSYNSPLHF	TRBV10-1	TRBJ1-6
TGTGCCAGCAGTTACACTACAGGGGAAAACACTGAAGCTTTCTTT	CASSYTTGENTEAFF	TRBV6-5	TRBJ1-1
TGTGCCAGCAGCAGACAGCGGGGCGAGCAGTACTTC	CASSRQRGEQYF	TRBV9	TRBJ2-7
TGTGCCAGCAGCTTCCCGGGACTAAGCTGCAATGAGCAGTTCTTC	CASSFPGLSCNEQFF	TRBV6-5	TRBJ2-1
TGTGCCAGTAGTATAGCATCCCAGGCTTTGCAGTACTTC	CASSIASQALQYF	TRBV19	TRBJ2-7
TGTGCCAGTTGGCGGGACAGGGGGCGGGAAAGGAACACTGAAGCTTTCTTT	CASWRDRGRERNTEAFF	TRBV19	TRBJ1-1
TGTGCCAGCACGAAAGCGCCGGGGCGAACCCAGCATTTT	CASTKAPGRTQHF	TRBV6-6	TRBJ1-5
TGTGCCAGCAGCCACGAGGGGACGCTTGGACCCCTCCACTTT	CASSHEGTLGPLHF	TRBV14	TRBJ1-6
TGTGCCAATCCCCCCCCCGTCTGCGAGCAGTACTTC	CANPPPVCEQYF	TRBV19	TRBJ2-7
TGCGCCAGCAGCTTTTACCTACAGACCGCAGAATTTGACAATCAGCCCCAGCATTTT	CASSFYLQTAEFDNQPQHF	TRBV5-1	TRBJ1-5
TGTGCCAGCAGCTTACAAAGAATTCACTATGGCTACACCTTC	CASSLQRIHYGYTF	TRBV11-2	TRBJ1-2
TGTGCCTACCGACTAGCGGGAGGGCCAGTGAACACTGAAGCTTTCTTT	CAYRLAGGPVNTEAFF	TRBV30	TRBJ1-1
TGTGCCAGCAGTCCCCGGGCCCATCATAACTCCTACGAGCAGTACTTC	CASSPRAHHNSYEQYF	TRBV27	TRBJ2-7
TGTGCCAGCAGTGCGGGGGACACCTATGGCTACACCTTC	CASSAGDTYGYTF	TRBV6-4	TRBJ1-2
TGTGCCAGCAGTTACGACAGGGGTTCTAGACGATCTTTTTCTAGCACAGATACGCAGTATTTT	CASSYDRGSRRSFSSTDTQYF	TRBV6-5	TRBJ2-3
TGTGCCAGCAGATGGGACAGACCCCGGGTGAATCAGCCCCAGCATTTT	CASRWDRPRVNQPQHF	TRBV12-3	TRBJ1-5
TGTGCCATTCCCAATCCCCACAGGGCTAGGGGGACCGACACCGGGGAGCTGTTTTTT	CAIPNPHRARGTDTGELFF	TRBV28	TRBJ2-2
TGCGCCAGCAGCTTGAACCTAGTTCATACTTTCCAGAGTAGGGGCTCCTACAATGAGCAGTTCTTC	CASSLNLVHTFQSRGSYNEQFF	TRBV5-1	TRBJ2-1
TGTGCCAGCATTCCCCACACAGGGCTAATGAAGGATGGCTACACCTTC	CASIPHTGLMKDGYTF	TRBV27	TRBJ1-2
TGTGCCAGCAGCTTGGCCCTGAGAAGCTCCTACGAGCAGTACTTC	CASSLALRSSYEQYF	TRBV5-6	TRBJ2-7
TGTGCCAGCAGTGACACCGGGACTAGCGGGGGGTCCTACAATGAGCAGTTCTTC	CASSDTGTSGGSYNEQFF	TRBV6-1	TRBJ2-1
TGTGCCAGCAGTGTCGAGAGACCGGGACAGGGCGACCTGACGAACACCGGGGAGCTGTTTTTT	CASSVERPGQGDLTNTGELFF	TRBV25-1	TRBJ2-2
TGCAGTGCGGGTATCTACGAGCAGTACTTC	CSAGIYEQYF	TRBV20-1	TRBJ2-7
TGCGCCAGCAGTGAGCCCATCGCCCCGGGACTAGCGGGAGGCTCCAAAAACATTCAGTACTTC	CASSEPIAPGLAGGSKNIQYF	TRBV10-2	TRBJ2-4
TGTGCCAGCACAGGGGGCCGCTCTGGGGCCAACGTCCTGACTTTC	CASTGGRSGANVLTF	TRBV13	TRBJ2-6
TGCAGTGCGGTCCAAACGAAAGAGACCCAGTACTTC	CSAVQTKETQYF	TRBV20-1	TRBJ2-5
TGCAGTGCTAGAGATGGAGGACAGGGACAGGGGGATTTTATAGTGCAGTACTTC	CSARDGGQGQGDFIVQYF	TRBV20-1	TRBJ2-7
TGTGCCAGCAGTGAATCTTCCCGGTACAGGGGGAACTACGAGCAGTACTTC	CASSESSRYRGNYEQYF	TRBV25-1	TRBJ2-7
TGTGCCAGCAGTGAAGTACCGGGACGGACAGGTGGCTACACCTTC	CASSEVPGRTGGYTF	TRBV6-1	TRBJ1-2
TGCAGTGCTAGAGAAGGCAGGCATTTGGCAGATACGCAGTATTTT	CSAREGRHLADTQYF	TRBV20-1	TRBJ2-3
TGTGCCAGCGGGGAGTTTAGGGTGAGGCGGTTTAGCAATCAGCCCCAGCATTTT	CASGEFRVRRFSNQPQHF	TRBV7-3	TRBJ1-5
TGTGCCAGCAGCCTGGTAGCGGGTCGTCATACGCAGTATTTT	CASSLVAGRHTQYF	TRBV28	TRBJ2-3
TGCAGCGTTGGATGCAGGGATAATGAAAAACTGTTTTTT	CSVGCRDNEKLFF	TRBV29-1	TRBJ1-4
TGTGCCAGCAGTTTTTGCGGCAACGAGCAGTACTTC	CASSFCGNEQYF	TRBV6-5	TRBJ2-7
TGTGCCAGCAGCCATGCGGGAGACTACAATGAGCAGTTCTTC	CASSHAGDYNEQFF	TRBV14	TRBJ2-1
TGCGCCAGCAGTGAGTCTAGCGGGGTGCAGTTCTTC	CASSESSGVQFF	TRBV10-1	TRBJ2-1
TGTGCCAGCAGCCGACTAGCTGGATCCACCGGGGAGCTGTTTTTT	CASSRLAGSTGELFF	TRBV6-5	TRBJ2-2
TGCAGTGCTAGAGATGGTAGGCGGGGTCCGCCCTACAATGAGCAGTTCTTC	CSARDGRRGPPYNEQFF	TRBV20-1	TRBJ2-1
TGTGCCGTACATAAGACTCGGGGGCGTGGCTACACCTTC	CAVHKTRGRGYTF	TRBV30	TRBJ1-2
TGTGCCAGCACACGGGCCTATAATTCACCCCTCCACTTT	CASTRAYNSPLHF	TRBV6-2	TRBJ1-6
TGCGCCAGCAGCTTGGGCGTGGACAGGTTGCTGAACACCGGGGAGCTGTTTTTT	CASSLGVDRLLNTGELFF	TRBV5-1	TRBJ2-2
TGCAGTGCTAGAGTCGCCCCAGGGTCGGACAATCAGCCCCAGCATTTT	CSARVAPGSDNQPQHF	TRBV20-1	TRBJ1-5
TGTGCCAGCAGCTTCAACGTAGGAGGGGAAGGTAATGAGCAGTTCTTC	CASSFNVGGEGNEQFF	TRBV5-4	TRBJ2-1
