TGTGCCAGCAGCTTTACGGCAACTAACCCTACATGGACTAGCGGTTATACCGGGGAGCTGTTTTTT	CASSFTATNPTWTSGYTGELFF	TRBV11-3	TRBJ2-2
TGTGCCAGCAGCGCGAGCTTAACCGAGCAGTACTTC	CASSASLTEQYF	TRBV6-2	TRBJ2-7
TGTGCCAGCGGGCAGGGGTCAACTAATGAAAAACTGTTTTTT	CASGQGSTNEKLFF	TRBV6-1	TRBJ1-4
TGTGCCAGCAGCACCGGCGGCTCTGGAAACACCATATATTTT	CASSTGGSGNTIYF	TRBV9	TRBJ1-3
TGTGCCAGCAGCTTAGAGAGGGAAAAGCACTATGGCTACACCTTC	CASSLEREKHYGYTF	TRBV11-3	TRBJ1-2
TGTGCCAGCAGTTACGCGGACAATAGGAGGCGCTACGAGCAGTACTTC	CASSYADNRRRYEQYF	TRBV12-3	TRBJ2-7
TGTGCCAGCAGCTTGGTCGCACCGCGGAAGAACAATCAGCCCCAGCATTTT	CASSLVAPRKNNQPQHF	TRBV5-6	TRBJ1-5
TGTGCCAGCAGCGGCGGGACTAGCGGGGGGGCCACTGACACAGATACGCAGTATTTT	CASSGGTSGGATDTDTQYF	TRBV7-3	TRBJ2-3
TGTGCCAGCAGTTCCCTTAACCCAGGGGGCAGTGGCTACACCTTC	CASSSLNPGGSGYTF	TRBV28	TRBJ1-2
TGCAGTGCTAGAAATCCGGGACAACACCACGGGGAGCTGTTTTTT	CSARNPGQHHGELFF	TRBV20-1	TRBJ2-2
TGTGCCACTTGGACCTTGGCCCACGAGCAGTACTTC	CATWTLAHEQYF	TRBV12-4	TRBJ2-7
TGTGCCAGGCTTTCGGCCTCGAACACTGAAGCTTTCTTT	CARLSASNTEAFF	TRBV6-1	TRBJ1-1
TGCAGTGCTAGTGGTCCTCAGGGGGGAGCCTACGAGCAGTACTTC	CSASGPQGGAYEQYF	TRBV20-1	TRBJ2-7
TGTGCCAGGGGGACTAGCGGGCCTACAGATACGCAGTATTTT	CARGTSGPTDTQYF	TRBV27	TRBJ2-3
TGTGCCAGTTGTACAAGCAGGGAGGTTAGCAATCAGCCCCAGCATTTT	CASCTSREVSNQPQHF	TRBV19	TRBJ1-5
TGCAGTGCTAGAGATCATTTCTTCGGGGACAGGGTGTTCCGCAATCAGCCCCAGCATTTT	CSARDHFFGDRVFRNQPQHF	TRBV20-1	TRBJ1-5
TGCTACGGGACAGGGGGCGGGAACACTGAAGCTTTCTTT	CYGTGGGNTEAFF	TRBV20-1	TRBJ1-1
TGTGCCAGTAGTAAGCAATTAGCGGTGTGGACGTTGGAGACCCAGTACTTC	CASSKQLAVWTLETQYF	TRBV19	TRBJ2-5
TGCGCCAGCAGGCGCCAACTCTTCGGGAGCAATCAGCCCCAGCATTTT	CASRRQLFGSNQPQHF	TRBV10-1	TRBJ1-5
TGTGCCAGCTGGGGGGAGTCCTACAATGAGCAGTTCTTC	CASWGESYNEQFF	TRBV9	TRBJ2-1
TGTGCCAGCAGTTTCGACAGGGGGGGAGAGGACTATGGCTACACCTTC	CASSFDRGGEDYGYTF	TRBV28	TRBJ1-2
TGTGCCAGCAGTTTAGTGACACAGGGGCCTAGCTCTGGAAACACCATATATTTT	CASSLVTQGPSSGNTIYF	TRBV12-4	TRBJ1-3
TGTGCCAGCAGCCGTCAGGCAGGCCGAAATGAAAAACTGTTTTTT	CASSRQAGRNEKLFF	TRBV7-3	TRBJ1-4
TGTGCCAGCATAAACCGCAATGAGCAGTTCTTC	CASINRNEQFF	TRBV28	TRBJ2-1
TGCGCCAGCAGTGAAACCGGGGGCGGCCCCTACGAGCAGTACTTC	CASSETGGGPYEQYF	TRBV10-1	TRBJ2-7
TGCAGTGCTAGTTCTCGGGGTATGAACACTGAAGCTTTCTTT	CSASSRGMNTEAFF	TRBV20-1	TRBJ1-1
TGCAGTGCAGTGTTTGTATACTATGGCTACACCTTC	CSAVFVYYGYTF	TRBV20-1	TRBJ1-2
TGCGCCAGCAGCCAAACTTACCACAATGAGCAGTTCTTC	CASSQTYHNEQFF	TRBV4-3	TRBJ2-1
TGTGCCAGCAGTTTAATCCTAGCGGAAGGCCCAATGGAACGCGGGGAGCTGTTTTTT	CASSLILAEGPMERGELFF	TRBV27	TRBJ2-2
TGTGCCAGCAGTTTACGACAGGCTTGGACCTATAATTCACCCCTCCACTTT	CASSLRQAWTYNSPLHF	TRBV27	TRBJ1-6
TGTGCTAGTGGAGGCTGCGGCTGGGAAACCTACAATGAGCAGTTCTTC	CASGGCGWETYNEQFF	TRBV12-5	TRBJ2-1
TGTGCCAGCAGCGGCCCCTTTTTTCGGGACTACCTCGGTGTAGCCAATCAGCCCCAGCATTTT	CASSGPFFRDYLGVANQPQHF	TRBV7-9	TRBJ1-5
TGTGCCATCAGAGGAACAGGGGACAATGAGCAGTTCTTC	CAIRGTGDNEQFF	TRBV10-3	TRBJ2-1
TGTGCCAGCGGGGCGGGAGAGGAGTATAGCAATCAGCCCCAGCATTTT	CASGAGEEYSNQPQHF	TRBV28	TRBJ1-5
TGTGCCAGCAGTTACCAGAAAGGCTTCGAAAAACTGTTTTTT	CASSYQKGFEKLFF	TRBV6-5	TRBJ1-4
TGTGCCTGGAGTGCCTCCCCAGTTGGGCCAGCAAATCAGCCCCAGCATTTT	CAWSASPVGPANQPQHF	TRBV30	TRBJ1-5
TGTGCCAGCAGCCCCCTCCACCGACAGGGAGGCGAGCAGTACTTC	CASSPLHRQGGEQYF	TRBV3-1	TRBJ2-7
TGTGCCAGCAGTTTCCTTACCGGGACAGGGGGGGAGACCCAGTACTTC	CASSFLTGTGGETQYF	TRBV12-3	TRBJ2-5
TGTGCCAGCAGCCAAGACCGGGGGATTGTTAACTATGGCTACACCTTC	CASSQDRGIVNYGYTF	TRBV4-2	TRBJ1-2
TGTGCCAGCATCCCCCGGGACAGCGAGCAGTACTTC	CASIPRDSEQYF	TRBV6-6	TRBJ2-7
TGCGCCAGCTCTATATGGACCCCGGACTGTAGCAATCAGCCCCAGCATTTT	CASSIWTPDCSNQPQHF	TRBV5-1	TRBJ1-5
TGTGCAGTCTTTGCCCAGCGGGACTTTCACAATGAGCAGTTCTTC	CAVFAQRDFHNEQFF	TRBV6-2	TRBJ2-1
TGTGCCAGCGGGAGGACGCACGAGCAGTACTTC	CASGRTHEQYF	TRBV25-1	TRBJ2-7
TGCAGTGCTAGCGGGGGAGCTAATGAAAAACTGTTTTTT	CSASGGANEKLFF	TRBV20-1	TRBJ1-4
TGTGCCAGCAGTTCCCCGGGACAGGGGATTTCTGGGGCCAACGTCCTGACTTTC	CASSSPGQGISGANVLTF	TRBV28	TRBJ2-6
TGTGCCAGCAGTCGCGGTCGCCGGGACAGGGAGGATTCACCCCTCCACTTT	CASSRGRRDREDSPLHF	TRBV27	TRBJ1-6
TGCGCCACCGACAGGCGGTCGCACTATGGCTACACCTTC	CATDRRSHYGYTF	TRBV10-1	TRBJ1-2
TGCGCCAGCAGCCGGGTCACTAGCGGGAGAGGGGGCTACGAGCAGTACTTC	CASSRVTSGRGGYEQYF	TRBV4-1	TRBJ2-7
TGTGCCAGCAGCTTAGTTCAACAGGGTAACTATGGCTACACCTTC	CASSLVQQGNYGYTF	TRBV7-9	TRBJ1-2
TGTGCCAGCTCGGCGGGACAGTTGCCTACCTACGAGCAGTACTTC	CASSAGQLPTYEQYF	TRBV7-9	TRBJ2-7
TGTGCCAGCAGCGTCAAGCGGACAGGCGGGTTTACAGATACGCAGTATTTT	CASSVKRTGGFTDTQYF	TRBV6-2	TRBJ2-3
TGTGCCAGCAGCCCCTCCGGGACAGGGGAACGGGCAACTAATGAAAAACTGTTTTTT	CASSPSGTGERATNEKLFF	TRBV11-3	TRBJ1-4
TGTGCCAGCAGTTACTCGCACAGGGGGCGCTGGGACACAGATACGCAGTATTTT	CASSYSHRGRWDTDTQYF	TRBV6-3	TRBJ2-3
TGTGCCAGCAGCTTGGATGCGAGAGGATACAATGAGCAGTTCTTC	CASSLDARGYNEQFF	TRBV5-4	TRBJ2-1
TGTGCCAGCAGCGAGCACTGCGGGAGGCGACGAAATGAGCAGTTCTTC	CASSEHCGRRRNEQFF	TRBV13	TRBJ2-1
TGTGCCAGCAGTGGGAGAGCGGGAGGCGGAGCCTACAATGAGCAGTTCTTC	CASSGRAGGGAYNEQFF	TRBV12-3	TRBJ2-1
TGTGCCAGCAGTTTACCCAAGTCGGGGCGCCCCTCCTACGAGCAGTACTTC	CASSLPKSGRPSYEQYF	TRBV28	TRBJ2-7
TGTGCCTGGAGCCACGGGACTAGCGGGGCCACCGGGGAGCTGTTTTTT	CAWSHGTSGATGELFF	TRBV30	TRBJ2-2
TGTGCCAGCAGCCCCGGCGACAGGGGGCAAAGTAAGACCCAGTACTTC	CASSPGDRGQSKTQYF	TRBV6-3	TRBJ2-5
TGTGCCATCCCCCATCCCCTTAGGACCTACGAGCAGTACTTC	CAIPHPLRTYEQYF	TRBV19	TRBJ2-7
TGTGCCAGCAGTTACCTGAGGGCTGGTATCTATGGCTACACCTTC	CASSYLRAGIYGYTF	TRBV6-2	TRBJ1-2
TGCGCCAGCATCCGACAGGGAGATAGCAATCAGCCCCAGCATTTT	CASIRQGDSNQPQHF	TRBV10-1	TRBJ1-5
TGTGCCAGGGGGGGGGGCACAGATACGCAGTATTTT	CARGGGTDTQYF	TRBV7-2	TRBJ2-3
TGCGCCAGCAGCCTGGGGGGGGGCCGGAGTACAGATACGCAGTATTTT	CASSLGGGRSTDTQYF	TRBV4-3	TRBJ2-3
TGTGCCACCAGTGACCCCAATCGGGTAAAAGACACCGGGGAGCTGTTTTTT	CATSDPNRVKDTGELFF	TRBV24-1	TRBJ2-2
TGTGCCAGCAGCGCCCGGACAGGGGGCACCCGAGAGACCCAGTACTTC	CASSARTGGTRETQYF	TRBV5-5	TRBJ2-5
TGTGCCAGCAGCTTGATCACTAGCGGGAGTAGGGGGGTTTATGGCTACACCTTC	CASSLITSGSRGVYGYTF	TRBV5-4	TRBJ1-2
TGTGCCAGCTCCACGGCCGGGACGAGAGCTTTCTTT	CASSTAGTRAFF	TRBV5-6	TRBJ1-1
TGTGCCAGCAGCTTCTCGGGGGACAATGAGCAGTTCTTC	CASSFSGDNEQFF	TRBV7-3	TRBJ2-1
TGTGCCTGGCCCCTCTGCCGGACTAGCGAGCAGTACTTC	CAWPLCRTSEQYF	TRBV30	TRBJ2-7
TGTGCCAGCAGTCCCATGTGGGGCACCGTACGGCCCTACGAGCAGTACTTC	CASSPMWGTVRPYEQYF	TRBV27	TRBJ2-7
TGCAGTGCTGTCCGAGGGACCGAAAACACTGAAGCTTTCTTT	CSAVRGTENTEAFF	TRBV20-1	TRBJ1-1
TGTGCCAGCAGTTTAAACCCGGGACAGGGAGCCGCTAACTATGGCTACACCTTC	CASSLNPGQGAANYGYTF	TRBV12-4	TRBJ1-2
TGTGCCAGCAGCTTGTGTTTAGGGACCTACGAGCAGTACTTC	CASSLCLGTYEQYF	TRBV11-2	TRBJ2-7
TGTGCCAGCAGTTTGGAGCACAGGGCGAATCAGCCCCAGCATTTT	CASSLEHRANQPQHF	TRBV12-3	TRBJ1-5
TGTGCCAAGGCAGACAGCCTCAATCCGACCCTTAACTATGGCTACACCTTC	CAKADSLNPTLNYGYTF	TRBV19	TRBJ1-2
TGTGCCAGCAGCTGGGGGACAGGGATGTCGACTGAAGCTTTCTTT	CASSWGTGMSTEAFF	TRBV5-5	TRBJ1-1
TGTGCCAGCAGCCCCTCCGGTGACAGTGGAAGCTACGAGCAGTACTTC	CASSPSGDSGSYEQYF	TRBV3-1	TRBJ2-7
TGTGCCAGCAGCCGGATAACTAGCGGGAGGGCACGCCGATTGGGCTACGAGCAGTACTTC	CASSRITSGRARRLGYEQYF	TRBV6-1	TRBJ2-7
TGCGCCAGCACTCTAATAGCTAAACGGTCGACCTACGAGCAGTACTTC	CASTLIAKRSTYEQYF	TRBV10-1	TRBJ2-7
TGTGCCAGCGGGGACTTTTGTGGTCTTAACAATGAGCAGTTCTTC	CASGDFCGLNNEQFF	TRBV7-2	TRBJ2-1
TGCGCCAGCAGCTTGGCCCCCCGAGCGGGGACCCAGTACTTC	CASSLAPRAGTQYF	TRBV5-1	TRBJ2-5
TGTGCCACCAGCAGTTACCTTAAAATCCGGGACGGTACCAAAAACATTCAGTACTTC	CATSSYLKIRDGTKNIQYF	TRBV15	TRBJ2-4
TGTGCCAGCAGCTTAGGAAATAGGGGTGGACCGTACACTGAAGCTTTCTTT	CASSLGNRGGPYTEAFF	TRBV7-9	TRBJ1-1
TGCAGCGTTGCCGTCCTTCAAGAACCTATCAAGGAGATGGGAAATGAGCAGTTCTTC	CSVAVLQEPIKEMGNEQFF	TRBV29-1	TRBJ2-1
TGTGCCAGCAGTTACCGCCTAGCGGATGGGCCAGATACGCAGTATTTT	CASSYRLADGPDTQYF	TRBV6-3	TRBJ2-3
TGCAGCGATGGGGGCGCAGGAGGTGCCTACAATCAGCCCCAGCATTTT	CSDGGAGGAYNQPQHF	TRBV29-1	TRBJ1-5
TGTGCCAGCAGCTTAGTAGGGGAGCGGACCCAGTACTTC	CASSLVGERTQYF	TRBV11-2	TRBJ2-5
TGTGCCAGCAGTTTCGGGACAGGGGTAAGACAAAGCTCGCAGTTCTTC	CASSFGTGVRQSSQFF	TRBV6-5	TRBJ2-1
TGTGCCAGCGCCGGGGCGCAGACCCAGTACTTC	CASAGAQTQYF	TRBV7-3	TRBJ2-5
TGTGCCCCCTTGCAGGGTACGAACACTGAAGCTTTCTTT	CAPLQGTNTEAFF	TRBV7-2	TRBJ1-1
TGTGCCAGCAGTACTCCTCGAGGTCAGCCCCAGCATTTT	CASSTPRGQPQHF	TRBV12-3	TRBJ1-5
TGTGCCATCATGTTCCTCGACAGCAGTAACTATGGCTACACCTTC	CAIMFLDSSNYGYTF	TRBV10-3	TRBJ1-2
TGTGCCACCAGTGATTTCCCGGGGCGAAATAGAGAACCCTCTGGAAACACCATATATTTT	CATSDFPGRNREPSGNTIYF	TRBV24-1	TRBJ1-3
TGTGCCACAGGGGGGTTCTACGAGCAGTACTTC	CATGGFYEQYF	TRBV10-3	TRBJ2-7
TGCAGTGCTAGAATCGCCGACGCTGGCTACACCTTC	CSARIADAGYTF	TRBV20-1	TRBJ1-2
TGTGCCAGCAGCTCTGATGGGGGGGAATACAATGAGCAGTTCTTC	CASSSDGGEYNEQFF	TRBV7-9	TRBJ2-1
TGTGCCAGCAGTTACTCCCCAGGGGGCGGAAATGCTAACTACGAGCAGTACTTC	CASSYSPGGGNANYEQYF	TRBV6-5	TRBJ2-7
TGCAGCGTTGAGGAGATCGGGCGTCAGCCCCAGCATTTT	CSVEEIGRQPQHF	TRBV29-1	TRBJ1-5
TGTGCCAGCAGTGTGCGTTATAGCAATCAGCCCCAGCATTTT	CASSVRYSNQPQHF	TRBV25-1	TRBJ1-5
TGCAGTGCGGGACAGGGGCTGGCCACTGAAGCTTTCTTT	CSAGQGLATEAFF	TRBV20-1	TRBJ1-1
TGTGCCAGCAGTTATTCCCGGGGGTATGACACCGGGGAGCTGTTTTTT	CASSYSRGYDTGELFF	TRBV6-5	TRBJ2-2
TGTGCCAGCAGTTCGGGACCTGATGAAAAACTGTTTTTT	CASSSGPDEKLFF	TRBV6-8	TRBJ1-4
TGTGCCACCAGCCCCTCAGGTAGGGGCAATCAGCCCCAGCATTTT	CATSPSGRGNQPQHF	TRBV15	TRBJ1-5
TGTGCCAGCAGCTCCGGGACTAGCGGGCTCCCCGGGGGCTACAATGAGCAGTTCTTC	CASSSGTSGLPGGYNEQFF	TRBV13	TRBJ2-1
TGTGCCAGCAGTTACTCCCCTGGGACAGGGCAAATGGCTGGCAATCAGCCCCAGCATTTT	CASSYSPGTGQMAGNQPQHF	TRBV6-5	TRBJ1-5
TGTGCCAGCAGTGAATCCGGGAGGGGGTCTGGAAACACCATATATTTT	CASSESGRGSGNTIYF	TRBV2	TRBJ1-3
TGTGCCAGCAGGGGAAACCAAGAACGTCCGAATGAAAAACTGTTTTTT	CASRGNQERPNEKLFF	TRBV6-5	TRBJ1-4
TGTGCCACCAGGAGCGGGAGCAACTACAATGAGCAGTTCTTC	CATRSGSNYNEQFF	TRBV24-1	TRBJ2-1
TGTGCCAGTAGTTCGGGGACTGGGAGCGAGCAGTACTTC	CASSSGTGSEQYF	TRBV19	TRBJ2-7
TGTGCCACCAGTGACCGACAGGGTAATGGGGGCTATGGCTACACCTTC	CATSDRQGNGGYGYTF	TRBV24-1	TRBJ1-2
TGCGCCAGCAGTGAGTCGCCAATAACGAGCGGGAGTGGTTACGAGCAGTACTTC	CASSESPITSGSGYEQYF	TRBV10-1	TRBJ2-7
TGCAGTGCAAGGGACCCAGCAATGAACACTGAAGCTTTCTTT	CSARDPAMNTEAFF	TRBV20-1	TRBJ1-1
TGTGCCAGCAGCTCCGACCCCAGAACGGTGGACGAGCAGTACTTC	CASSSDPRTVDEQYF	TRBV7-4	TRBJ2-7
TGCAGTGCCCGGGAGAGGGAGACCCAGTACTTC	CSARERETQYF	TRBV20-1	TRBJ2-5
TGTGCCAGCAGCTTGAACAGGGTGGGCTACACCTTC	CASSLNRVGYTF	TRBV5-4	TRBJ1-2
TGTGCCACCAGTCTGGGGGATCCTAGCTACGAGCAGTACTTC	CATSLGDPSYEQYF	TRBV24-1	TRBJ2-7
TGTGCCTGGGGGGATACGCAGTATTTT	CAWGDTQYF	TRBV3-1	TRBJ2-3
TGTGCCAGCAGTGACTGGGGGGGGGAGAACAAAGAGACCCAGTACTTC	CASSDWGGENKETQYF	TRBV6-4	TRBJ2-5
TGTGCCAGAAGCCGGCTCACTAGCGGGAGGGACATTCAGTACTTC	CARSRLTSGRDIQYF	TRBV19	TRBJ2-4
TGTGCCACCAGCAGAGATCGAGGGGCCTCCTGGCTATACGAGCAGTACTTC	CATSRDRGASWLYEQYF	TRBV15	TRBJ2-7
TGTGCCAGCAGTTTGGGGCTGGGTAATGAAAAACTGTTTTTT	CASSLGLGNEKLFF	TRBV28	TRBJ1-4
TGTGCCACGTCTTCGGGGGACGGGGGACACTCCTACGAGCAGTACTTC	CATSSGDGGHSYEQYF	TRBV7-9	TRBJ2-7
TGTGCCAGCAGCTTGGTATCTGATACGCAGTATTTT	CASSLVSDTQYF	TRBV5-4	TRBJ2-3
TGTGCCACCAGCAGAGCACCGGGGGGCCAGGTGGAAGCAAACTACAATGAGCAGTTCTTC	CATSRAPGGQVEANYNEQFF	TRBV15	TRBJ2-1
TGTGCCAGATCATTCCTATTGAGGACAGGGCCGAAGTACGAGCAGTACTTC	CARSFLLRTGPKYEQYF	TRBV6-2	TRBJ2-7
TGTGCCAGCAGCAACCAGGGGGCGACGGACTACGAGCAGTACTTC	CASSNQGATDYEQYF	TRBV9	TRBJ2-7
TGTGCCAGCAGTTTCGGGGGGGCACTTACATACGAGCAGTACTTC	CASSFGGALTYEQYF	TRBV6-3	TRBJ2-7
TGCGCCAGCAGCTCTTGGACAGGGGGCGTCACCCCATCCCCGAACACTGAAGCTTTCTTT	CASSSWTGGVTPSPNTEAFF	TRBV5-1	TRBJ1-1
TGTGCCAGCAGCGCGGGACCCGATCTAAATCAGCCCCAGCATTTT	CASSAGPDLNQPQHF	TRBV9	TRBJ1-5
TGCGCCAGCAGCAAAATCCACCGTTTTCAGCCCCAGCATTTT	CASSKIHRFQPQHF	TRBV5-1	TRBJ1-5
TGTGCCAGCGTCTGGCAAGGGCCGGGCTACACCTTC	CASVWQGPGYTF	TRBV5-6	TRBJ1-2
TGTGCCAGCAGAGCGGGGGGGCCTGGGGACACAGATACGCAGTATTTT	CASRAGGPGDTDTQYF	TRBV2	TRBJ2-3
TGTGCCAGCCACGCGGGGGGGCCATCTTACGAGCAGTACTTC	CASHAGGPSYEQYF	TRBV6-1	TRBJ2-7
TGTGCCAGCAGTAGCCGGGACCGTTCGAATCAGCCCCAGCATTTT	CASSSRDRSNQPQHF	TRBV28	TRBJ1-5
TGCGCCAGCAGCTTGAATACAGGGTGCTCGGACGAGCAGTACTTC	CASSLNTGCSDEQYF	TRBV5-1	TRBJ2-7
TGCAGTGCTAGAGATCGCGGGGGCACAGATACGCAGTATTTT	CSARDRGGTDTQYF	TRBV20-1	TRBJ2-3
TGCAGTGCTAGAGCTACAGGGCGGACTTACAATGAGCAGTTCTTC	CSARATGRTYNEQFF	TRBV20-1	TRBJ2-1
TGTGCTAGCAGCTTACAAAGAGAGCGAACCGGGGAGCTGTTTTTT	CASSLQRERTGELFF	TRBV7-7	TRBJ2-2
TGTGCCAGCAGTTGTGGGGTGCGAGCTTTCTTT	CASSCGVRAFF	TRBV28	TRBJ1-1
TGCGCCAGCAGCTCAAGGGGGATAAATACGCAGTATTTT	CASSSRGINTQYF	TRBV5-1	TRBJ2-3
TGTGCCAGCAGTCGAGTCTATGGCTACACCTTC	CASSRVYGYTF	TRBV7-2	TRBJ1-2
TGTGCCAGCAGCTTAGGGGCTAGCGGGATAATACCCTACGAGCAGTACTTC	CASSLGASGIIPYEQYF	TRBV11-2	TRBJ2-7
TGTGCCAGCAGTTTAGAGACAGGGATATTTGAGCAGTTCTTC	CASSLETGIFEQFF	TRBV27	TRBJ2-1
TGCGCAACCTCAACTAGCCCTGGGAGCTCCTACGAGCAGTACTTC	CATSTSPGSSYEQYF	TRBV5-1	TRBJ2-7
TGTGCCAGTAGTATGGCCTTCACTAAACACGGGGAGCTGTTTTTT	CASSMAFTKHGELFF	TRBV19	TRBJ2-2
TGTGCCAGCAGCCAAGGCGGCACCTCTGAAGCTTTCTTT	CASSQGGTSEAFF	TRBV14	TRBJ1-1
TGCGCCAGCAGCTTGAGGGGTGGGTATAGCAATCAGCCCCAGCATTTT	CASSLRGGYSNQPQHF	TRBV5-1	TRBJ1-5
TGTGCCAGCAGTTTTGGGCTAATTAGGGGAGTTAGGCCCCAGCATTTT	CASSFGLIRGVRPQHF	TRBV27	TRBJ1-5
TGTGCGATCTTGACAGACTCCAGCAATGAGCAGTTCTTC	CAILTDSSNEQFF	TRBV5-6	TRBJ2-1
TGCAGTGCTCCCATGGGACAGGGGAGGGGAGAGACCCAGTACTTC	CSAPMGQGRGETQYF	TRBV20-1	TRBJ2-5
TGCAGTGCTAGCCCCGGAGGGTTGGAGGTGAACACTGAAGCTTTCTTT	CSASPGGLEVNTEAFF	TRBV20-1	TRBJ1-1
TGCGCCAGCAGCGGTAGCGGGTATAGAAGCTCCTACAATGAGCAGTTCTTC	CASSGSGYRSSYNEQFF	TRBV5-1	TRBJ2-1
TGCGCCAGCAGCCAATCTCCTAACCCGGGACAGTTCTACGAGCAGTACTTC	CASSQSPNPGQFYEQYF	TRBV4-1	TRBJ2-7
TGTGATACGGCACATCAGCCCCAGCATTTT	CDTAHQPQHF	TRBV12-3	TRBJ1-5
TGTGCCAGCAGTTTATGGTCCAGATCTAAGGGGATACAAGAGACCCAGTACTTC	CASSLWSRSKGIQETQYF	TRBV27	TRBJ2-5
TGTGCCAGCAGCGTATTATTGAGTGAGCGGCCAGTGGGCTACGAGCAGTACTTC	CASSVLLSERPVGYEQYF	TRBV9	TRBJ2-7
TGTGCCAGCAGTTTAAGACAGGGGGAGATGAACACTGAAGCTTTCTTT	CASSLRQGEMNTEAFF	TRBV28	TRBJ1-1
TGTGCCAGCAGCGTTGGGGGGGCTGTTTCCTACAATGAGCAGTTCTTC	CASSVGGAVSYNEQFF	TRBV13	TRBJ2-1
TGTGCCAGCAGCCAAGATGGCCTACATGACAGGGGGCCCCATCAGCCCCAGCATTTT	CASSQDGLHDRGPHQPQHF	TRBV3-1	TRBJ1-5
TGTGCCAGCAGTGACCCGGAATCTGGGGCCTACAATGGCTACACCTTC	CASSDPESGAYNGYTF	TRBV6-4	TRBJ1-2
TGTGCCAGCAGTCTCCGGGTAGGAAACACCGGGGAGCTGTTTTTT	CASSLRVGNTGELFF	TRBV27	TRBJ2-2
TGTGCCAGCAGCTTAGCCGGGACTAGCGGGAGACGGGTTCCAGATACGCAGTATTTT	CASSLAGTSGRRVPDTQYF	TRBV11-3	TRBJ2-3
TGTGCACTCTGGAGCTCTGGAAACACCATATATTTT	CALWSSGNTIYF	TRBV6-2	TRBJ1-3
TGTGCCACCAGTGATGACAGGGCCAGTCAGCCCCAGCATTTT	CATSDDRASQPQHF	TRBV24-1	TRBJ1-5
TGTGCCAGTAGTATGGTGCCCCTAGCGGGCCACTACGAGCAGTACTTC	CASSMVPLAGHYEQYF	TRBV19	TRBJ2-7
TGCAGCGCGTACCGTCAAAGGGAGGAAAATGAAAAACTGTTTTTT	CSAYRQREENEKLFF	TRBV29-1	TRBJ1-4
TGTGCCAGTAGTGCGTTCCACGGGTCTGGAAACACCATATATTTT	CASSAFHGSGNTIYF	TRBV19	TRBJ1-3
TGTGCCAGCAGCCGGGGGGGGGGCTACACCTTC	CASSRGGGYTF	TRBV2	TRBJ1-2
TGTGCCAGCAGCGTCACAGTAGGCTACGAGCAGTACTTC	CASSVTVGYEQYF	TRBV13	TRBJ2-7
TGTGCCAGTAGTATCGGCACACTGCCCCAAGGCACAGATACGCAGTATTTT	CASSIGTLPQGTDTQYF	TRBV19	TRBJ2-3
TGCAGCGTTGAGCACCCCAGCTACAATGAGCAGTTCTTC	CSVEHPSYNEQFF	TRBV29-1	TRBJ2-1
TGCGCCAGTATCACGAAAGCGTATCCGGGACAGAATGAGCAGTTCTTC	CASITKAYPGQNEQFF	TRBV10-2	TRBJ2-1
TGTGCCAGCAGCTTACGGTCCAATCGGACTAGCGGGGCCAACATTCAGTACTTC	CASSLRSNRTSGANIQYF	TRBV7-9	TRBJ2-4
TGTGCCAGCAGTTACTCCCTGTTCAGGGGAGAAAACATTCAGTACTTC	CASSYSLFRGENIQYF	TRBV6-5	TRBJ2-4
TGTGCCAGCAGCGTACCCCTAACGACAGGGTTTTTGTACTTC	CASSVPLTTGFLYF	TRBV7-3	TRBJ2-5
TGTGCCAGTAGTACTGGCCCGGGACTAGCAGGCAATGAGCAGTTCTTC	CASSTGPGLAGNEQFF	TRBV19	TRBJ2-1
TGTGCCAGCAGTTACTTGGAAGCAGGCACTGCAACTAATGAAAAACTGTTTTTT	CASSYLEAGTATNEKLFF	TRBV6-3	TRBJ1-4
TGTGCCAGCTCACAGAAAACGGTACCGGAACAAGAGACCCAGTACTTC	CASSQKTVPEQETQYF	TRBV18	TRBJ2-5
TGCGCCAGCAGCTTGGCCGGCCCCCCTTTCGACGAGCAGTACTTC	CASSLAGPPFDEQYF	TRBV5-1	TRBJ2-7
TGCGCCAGCAGCCAAGGGGGACGCTATAGCAATCAGCCCCAGCATTTT	CASSQGGRYSNQPQHF	TRBV4-1	TRBJ1-5
TGTGCCAGCATCCGCCTATTCTATGGCTACACCTTC	CASIRLFYGYTF	TRBV9	TRBJ1-2
TGTGCCAGCAGCGGACCAACCCCTGGGGGGGCGAACACTGAAGCTTTCTTT	CASSGPTPGGANTEAFF	TRBV7-3	TRBJ1-1
TGTGCCAGCATGGGGGACAGGGGGGGACGCTCCTACAATGAGCAGTTCTTC	CASMGDRGGRSYNEQFF	TRBV6-1	TRBJ2-1
TGTGCCAGCAGCCTCCGGGACAGGGGAGGATACGAGCAGTACTTC	CASSLRDRGGYEQYF	TRBV13	TRBJ2-7
TGTGCCAGCAGGCCCACCCCGTCCGAAGTGGGACAGGGCACAGATACGCAGTATTTT	CASRPTPSEVGQGTDTQYF	TRBV28	TRBJ2-3
TGTGCCAGCAAGGACAGGGATAGCAATCAGCCCCAGCATTTT	CASKDRDSNQPQHF	TRBV6-5	TRBJ1-5
TGTGCCAGCAGATCCCTTGACTATGGCTACACCTTC	CASRSLDYGYTF	TRBV28	TRBJ1-2
TGTGCCAGCAGTGCGAAAACCCGGACCTACGAGCAGTACTTC	CASSAKTRTYEQYF	TRBV6-2	TRBJ2-7
TGTGCCAGCAGCTGGGACAGTGCGTTCGAGCAGTACTTC	CASSWDSAFEQYF	TRBV13	TRBJ2-7
TGCAGCGTTGCCTTCCCACTGAATGCTAGCTCCTACAATGAGCAGTTCTTC	CSVAFPLNASSYNEQFF	TRBV29-1	TRBJ2-1
TGTGCTAGTGGTTTGGTAAACCGGGACAGGGATGTGGAAAGAGCCGAGCAGTACTTC	CASGLVNRDRDVERAEQYF	TRBV12-5	TRBJ2-7
TGTGCCAGCAGCTTGTCTGCAGGGGGGAACTATGGCTACACCTTC	CASSLSAGGNYGYTF	TRBV11-3	TRBJ1-2
TGTGCCAGCAGCGCTAGCGGACATACCGGGGAGCTGTTTTTT	CASSASGHTGELFF	TRBV9	TRBJ2-2
TGTGCCAGCAGCTACCCCGAGAAAGAGACCCAGTACTTC	CASSYPEKETQYF	TRBV11-2	TRBJ2-5
TGTGCCAGAACCCCGGGGGGGCCGGAAGACGAGCAGTACTTC	CARTPGGPEDEQYF	TRBV12-3	TRBJ2-7
TGTGCCAGCAGCTTACCGAAGGGAGGTCGTCTCGATCCCTACGAGCAGTACTTC	CASSLPKGGRLDPYEQYF	TRBV7-3	TRBJ2-7
TGTGCCAGCACACCGGTGAGAGCGGAAGCTTTCTTT	CASTPVRAEAFF	TRBV6-3	TRBJ1-1
TGCAGTGCTAGCGACAAGAACTATGGCTACACCTTC	CSASDKNYGYTF	TRBV20-1	TRBJ1-2
TGTGCCAGCAAGGGGTTCTTTCAACAGAAGCTTCAGCCCCAGCATTTT	CASKGFFQQKLQPQHF	TRBV6-4	TRBJ1-5
TGTGCCAGCAGCACTTATTCTTCGGGGCCGGTTGCAACTAATGAAAAACTGTTTTTT	CASSTYSSGPVATNEKLFF	TRBV7-8	TRBJ1-4
TGTGCCAGCAGCCCCGTCAGGGGACAACTCGGGTGGAAGACAGATACGCAGTATTTT	CASSPVRGQLGWKTDTQYF	TRBV13	TRBJ2-3
TGTGCCAGCAGCCCCCCGGGACAGGTAACCTCCTACGAGCAGTACTTC	CASSPPGQVTSYEQYF	TRBV7-3	TRBJ2-7
TGTGCCACCCCAGGGACCGATTGGGGCACTGAAGCTTTCTTT	CATPGTDWGTEAFF	TRBV24-1	TRBJ1-1
TGTGCCAGCAGCATGAAAGGGGCGGGCAAGAACACCGGGGAGCTGTTTTTT	CASSMKGAGKNTGELFF	TRBV13	TRBJ2-2
TGTGCCAGCAGCGGGGTCCTCAGGGCTCAAGAGACCCAGTACTTC	CASSGVLRAQETQYF	TRBV13	TRBJ2-5
TGCGCCAGCAGCTTGGCCCACCAGGACAGTGAAGCTTTCTTT	CASSLAHQDSEAFF	TRBV5-1	TRBJ1-1
TGCGCCAGCAGCTTGGTTAGGGGACGGCTATGGGAGATATACGAGCAGTACTTC	CASSLVRGRLWEIYEQYF	TRBV5-1	TRBJ2-7
TGTGCCAGGGGGGGACAGGACACAGATACGCAGTATTTT	CARGGQDTDTQYF	TRBV27	TRBJ2-3
TGTGCCAGCACACGCCGGGACAGGGAAAATCAGCCCCAGCATTTT	CASTRRDRENQPQHF	TRBV9	TRBJ1-5
TGTGCCAGCAGCTCTCCCCAAGGGGGAATTAAGGCAGATACGCAGTATTTT	CASSSPQGGIKADTQYF	TRBV14	TRBJ2-3
TGCGCCAGCAGCTGTACTAATCATCAGCCCCAGCATTTT	CASSCTNHQPQHF	TRBV5-1	TRBJ1-5
TGTGCCAGCAGCCAAGAGGGGCGGGACGTATATGGCGAGCAGTACTTC	CASSQEGRDVYGEQYF	TRBV14	TRBJ2-7
TGTGCCAGCAGCCTTAGCGGGAGCGACTTC	CASSLSGSDF	TRBV11-2	TRBJ2-7
TGCAGTGCTAGAGATACCCTTCAACAGGTTGAGGTCTACGAGCAGTACTTC	CSARDTLQQVEVYEQYF	TRBV20-1	TRBJ2-7
TGTGCCAGCAGCAACCGGGGGGCAGATACGCAGTATTTT	CASSNRGADTQYF	TRBV14	TRBJ2-3
TGTGCCAGCAGCCGGGGAGTGAGGGCCTCCCGCTACGAGCAGTACTTC	CASSRGVRASRYEQYF	TRBV5-6	TRBJ2-7
TGTGCCAGCAGCTTTGTCACACAAGCCCATTACGAGCAGTACTTC	CASSFVTQAHYEQYF	TRBV5-5	TRBJ2-7
TGTGCCAGCAGTGCGTGCGGGAGGGGTGGACCAGATACGCAGTATTTT	CASSACGRGGPDTQYF	TRBV2	TRBJ2-3
TGCGCCAGCAGCCAAGATCCGACAACCCCAACTAGAGCCAATGAGCAGTTCTTC	CASSQDPTTPTRANEQFF	TRBV4-1	TRBJ2-1
TGTGCCAGCAGTGGTAAAACCGGGGAGCTGTTTTTT	CASSGKTGELFF	TRBV6-4	TRBJ2-2
TGTGCCAGCAGCCTATTCCACAGGCTCCAGCCCCAGCATTTT	CASSLFHRLQPQHF	TRBV13	TRBJ1-5
TGTGCCAGCAGCGCAGGGTTCCGAAGGGGGGCTGAAGCTTTCTTT	CASSAGFRRGAEAFF	TRBV4-2	TRBJ1-1
TGTGCCAGCAGCGCCCCCTCAAGGGACTACTACGAGCAGTACTTC	CASSAPSRDYYEQYF	TRBV5-8	TRBJ2-7
TGTGCCTGGAGCAGTGCGAGCTCCTACAATGAGCAGTTCTTC	CAWSSASSYNEQFF	TRBV30	TRBJ2-1
TGCGCCAGCAGCCAAGATTTTCGGGGAAGTAGAGCAGATACGCAGTATTTT	CASSQDFRGSRADTQYF	TRBV4-1	TRBJ2-3
TGTGCCAGGATCTCCGGGTCCGGGACTAGTACCTACAATGAGCAGTTCTTC	CARISGSGTSTYNEQFF	TRBV19	TRBJ2-1
TGTGCCAGCAGTAGGACTAGCGGGATACACGAGCAGTACTTC	CASSRTSGIHEQYF	TRBV12-4	TRBJ2-7
TGTGCCAGCAGCTTAGAAGTGCCGGACATCTGGTTCTGTGAAAAACTGTTTTTT	CASSLEVPDIWFCEKLFF	TRBV11-3	TRBJ1-4
TGCGCCAGCAGCGCGTTCCTAATTTACAATGAGCAGTTCTTC	CASSAFLIYNEQFF	TRBV5-1	TRBJ2-1
TGCGCCAGCAGCTTGCGGGGGGCCTACAATGAGCAGTTCTTC	CASSLRGAYNEQFF	TRBV5-1	TRBJ2-1
TGTGCCAGTAGTAGTCAGACCACAGATACGCAGTATTTT	CASSSQTTDTQYF	TRBV19	TRBJ2-3
TGTGCCACCAGTGGCGCTCCAGAACGCTCCTACAATGAGCAGTTCTTC	CATSGAPERSYNEQFF	TRBV24-1	TRBJ2-1
TGTGCTTGGACAGGGGATCAGCCCCAGCATTTT	CAWTGDQPQHF	TRBV5-4	TRBJ1-5
TGTGCCAGCAGCATGGACAGGGGGGCCACCGGGGAGCTGTTTTTT	CASSMDRGATGELFF	TRBV7-3	TRBJ2-2
TGTGCCAGCAGCCCGCCGAACAATGAAAAACTGTTTTTT	CASSPPNNEKLFF	TRBV13	TRBJ1-4
TGCGCCAGCAGTGAATTGGACATAGACTACGAGCAGTACTTC	CASSELDIDYEQYF	TRBV10-1	TRBJ2-7
TGTGCCAGCAGCGTAGCATGGGACAGGGGGTCGCTAACTGAAGCTTTCTTT	CASSVAWDRGSLTEAFF	TRBV9	TRBJ1-1
TGTGCCAAAGACAGGGGGGATCGAGAAGCTTTCTTT	CAKDRGDREAFF	TRBV2	TRBJ1-1
TGCAGCCCGGGCCCGGCCAACTTC	CSPGPANF	TRBV29-1	TRBJ1-2
TGTGCCAGCAGCTCCACCGTCCAGGGGGCGCTTCACGGGGCCTACGAGCAGTACTTC	CASSSTVQGALHGAYEQYF	TRBV7-6	TRBJ2-7
TGCGCCAGCAGCCAAGATCCCCCACCGGGGCCCTCTGGGGCCAACGTCCTGACTTTC	CASSQDPPPGPSGANVLTF	TRBV4-1	TRBJ2-6
TGTGCCAGCGAATTGTTTGTCGTCACCTGGAATCGGAGTGACGGGCCGGCAGATACGCAGTATTTT	CASELFVVTWNRSDGPADTQYF	TRBV9	TRBJ2-3
TGTGCCAGCAGTCCGGGATCCGGGGATGAGCAGTTCTTC	CASSPGSGDEQFF	TRBV28	TRBJ2-1
TGTGCCAGCAGCTTGGGTAGGGATGATGAGGAGGCCTACGAGCAGTACTTC	CASSLGRDDEEAYEQYF	TRBV5-6	TRBJ2-7
TGTGCCAGCAGCCAAGAGAAGACAGCGTTGGGCTACGAGCAGTACTTC	CASSQEKTALGYEQYF	TRBV14	TRBJ2-7
TGTGCCAGCAGTTACGGCGGGACTATGGCCGGGGAGCTGTTTTTT	CASSYGGTMAGELFF	TRBV6-5	TRBJ2-2
TGTGCCAGCATGCAATTAGGACCACCAGGTGCTGGGGCCAACGTCCTGACTTTC	CASMQLGPPGAGANVLTF	TRBV6-1	TRBJ2-6
TGTGCCACAGGTCAGCCCCAGCATTTT	CATGQPQHF	TRBV25-1	TRBJ1-5
TGTGCCACCAGGGTTCTCTACGAGCAGTACTTC	CATRVLYEQYF	TRBV24-1	TRBJ2-7
TGTGCCAGCAGTTACCTAAGCCCAAAGACAGTTTCCTACGAGCAGTACTTC	CASSYLSPKTVSYEQYF	TRBV6-5	TRBJ2-7
TGTGCCAGCAGCTTGGATAGGACTAGGTGGTTGGGGACCTACGAGCAGTACTTC	CASSLDRTRWLGTYEQYF	TRBV7-8	TRBJ2-7
TGTGCCAGCAGCATCCAGGGGGCTGGCTACACCTTC	CASSIQGAGYTF	TRBV7-2	TRBJ1-2
TGTGCCAGCAGTGAAAGAAAGTCGGACAGTTACGAGCAGTACTTC	CASSERKSDSYEQYF	TRBV6-4	TRBJ2-7
TGTGCCAGCAGTTATCAGACAGGGGGTAATCAGCCCCAGCATTTT	CASSYQTGGNQPQHF	TRBV6-6	TRBJ1-5
TGTGCCAGCACTCCGGGGTGGAATTTATCACCCCTCCACTTT	CASTPGWNLSPLHF	TRBV6-2	TRBJ1-6
TGTGCCAGCAGTCCCCCAGGGACTCCGGTCGCAGGATATGGCTACACCTTC	CASSPPGTPVAGYGYTF	TRBV27	TRBJ1-2
TGTGCCACCAGTGATTGCGCAAACACCGGGGAGCTGTTTTTT	CATSDCANTGELFF	TRBV24-1	TRBJ2-2
TGTGCCACCTCCACATCTCAGGGGAACGGCCGGCGCAATCAGCCCCAGCATTTT	CATSTSQGNGRRNQPQHF	TRBV24-1	TRBJ1-5
TGTGCCACCCGGCTCGGGGACGAGCAGTACTTC	CATRLGDEQYF	TRBV14	TRBJ2-7
TGTGCCAGCAGCTTGCTTCTTAGATGCGGTCAAGAGACCCAGTACTTC	CASSLLLRCGQETQYF	TRBV5-6	TRBJ2-5
TGTGCCACCCCGTCGGGGGGGTACGAGCAGTACTTC	CATPSGGYEQYF	TRBV24-1	TRBJ2-7
TGTGCCAGCAGCGGGGGACGGGCGCCAGTTGCTGAAGCTTTCTTT	CASSGGRAPVAEAFF	TRBV13	TRBJ1-1
TGTGCCAGCAGTGACAGACAGGAACGGCCCTACAATGAGCAGTTCTTC	CASSDRQERPYNEQFF	TRBV6-1	TRBJ2-1
TGCGCCAGCAGCGGACAGCCTGAGACCCAGTACTTC	CASSGQPETQYF	TRBV5-1	TRBJ2-5
TGTGCCAGCAGTTACTCGAATCAAATAGGGCGAGAGCAAGAGACCCAGTACTTC	CASSYSNQIGREQETQYF	TRBV6-5	TRBJ2-5
TGTGCCAGTAACGTGGGGGGGCTCACTGAAGCTTTCTTT	CASNVGGLTEAFF	TRBV19	TRBJ1-1
TGTGCCAGCAGCGGACCCAGCAGGGGAACAGGCCAAGAGACCCAGTACTTC	CASSGPSRGTGQETQYF	TRBV7-3	TRBJ2-5
TGTGCCAGCAGGTCCCCCCCATGGGGGGGCAGGGGCGATGCCTACGAGCAGTACTTC	CASRSPPWGGRGDAYEQYF	TRBV2	TRBJ2-7
TGTGCCAGCTCACTAGACAATGAGCAGTTCTTC	CASSLDNEQFF	TRBV18	TRBJ2-1
TGTGCCAGCAGTTATGACGCCTACGAGCAGTACTTC	CASSYDAYEQYF	TRBV12-3	TRBJ2-7
TGTGCCAGCAGCGTAGGACCCTCCCTAGCGGGCGGATCGGGGTCTGTTTACGAGCAGTACTTC	CASSVGPSLAGGSGSVYEQYF	TRBV9	TRBJ2-7
TGTGCCGGAGGGGGGGGCAATCAGCCCCAGCATTTT	CAGGGGNQPQHF	TRBV7-4	TRBJ1-5
TGTGCCAGCAGCACTAGGGGGACTGAAGCTTTCTTT	CASSTRGTEAFF	TRBV6-4	TRBJ1-1
TGTGCCAGCAGCTTGCCATGGGGGACAGGGGGGCAAGGTCCTGAAGCTTTCTTT	CASSLPWGTGGQGPEAFF	TRBV5-6	TRBJ1-1
TGTGCCATCAGTCCTCAGGCTAGGTACAATGAGCAGTTCTTC	CAISPQARYNEQFF	TRBV10-3	TRBJ2-1
TGTGCCAGTAGTATCCTGGGGGGGCCAAAGAACACCGGGGAGCTGTTTTTT	CASSILGGPKNTGELFF	TRBV19	TRBJ2-2
TGTGCCAGCAGCAGGCAGGGCAACACTGAAGCTTTCTTT	CASSRQGNTEAFF	TRBV7-2	TRBJ1-1
TGTGCCAGCAGCAATGGGGGCCAGGCCGGGGAGCTGTTTTTT	CASSNGGQAGELFF	TRBV7-2	TRBJ2-2
TGTGCCACCAGTGATGGACACTCTAACTACGAGCAGTACTTC	CATSDGHSNYEQYF	TRBV24-1	TRBJ2-7
TGTGCCACGGGTCCTGGGCTTCCCTACCAGGTGAGGAACACTGAAGCTTTCTTT	CATGPGLPYQVRNTEAFF	TRBV6-4	TRBJ1-1
TGTGCCAGCAGGGGGGCGGACAGGGATTGTAACACTGAAGCTTTCTTT	CASRGADRDCNTEAFF	TRBV28	TRBJ1-1
TGTGCCAGCAGCGCCAGAGGCGCTTACAATGAGCAGTTCTTC	CASSARGAYNEQFF	TRBV9	TRBJ2-1
TGCGCCAGCGAGACGTATCCCTATGGCTACACCTTC	CASETYPYGYTF	TRBV5-1	TRBJ1-2
TGTGCTAGTGGTCTCCTTCAGAAGAGTAATTCACCCCTCCACTTT	CASGLLQKSNSPLHF	TRBV12-5	TRBJ1-6
TGCGCCAGCAGCCAAGAAGACCCGGGACAGGGTCACAATGAGCAGTTCTTC	CASSQEDPGQGHNEQFF	TRBV4-3	TRBJ2-1
TGTGCCACCAGCAGAGTCGTCCCAGGAAGGGGCTACACCTTC	CATSRVVPGRGYTF	TRBV15	TRBJ1-2
TGTGCCAGCAGCGGGGGGGGGCCATGGTGCCAAGAGACCCAGTACTTC	CASSGGGPWCQETQYF	TRBV7-3	TRBJ2-5
TGCAGTGCTATGCACCGGGGGGGGAGGGTTTCCTACAATGAGCAGTTCTTC	CSAMHRGGRVSYNEQFF	TRBV20-1	TRBJ2-1
TGTGCCAGCCTAAACCTGGGGATTGTCTCTGGAAACACCATATATTTT	CASLNLGIVSGNTIYF	TRBV27	TRBJ1-3
TGTGCCAGCAGCAGGCCCCACAGGCACGAGCAGTACTTC	CASSRPHRHEQYF	TRBV7-9	TRBJ2-7
TGTGCCAGCTTCCGAAGGCGGGGGTTGCCCCAGCATTTT	CASFRRRGLPQHF	TRBV12-3	TRBJ1-5
TGCGCCAGCAGTGAGCCGGGGACAACGAACACTGAAGCTTTCTTT	CASSEPGTTNTEAFF	TRBV10-1	TRBJ1-1
TGCGCCAGCAGTGAGTGCTTGACAGGGGGGGGCAATCAGCCCCAGCATTTT	CASSECLTGGGNQPQHF	TRBV10-1	TRBJ1-5
TGCAGTGCGAGTCCGCCCGGAGAGACCCAGTACTTC	CSASPPGETQYF	TRBV20-1	TRBJ2-5
TGCAGTGCGACAGAATTCTACGAGCAGTACTTC	CSATEFYEQYF	TRBV20-1	TRBJ2-7
TGTGCCAGCACCAAGGGTGCGGCACCCTACACCTTC	CASTKGAAPYTF	TRBV25-1	TRBJ1-2
TGTGCCAGCAGTTTACCCCACAGGGTCCCAGCTAACTATGGCTACACCTTC	CASSLPHRVPANYGYTF	TRBV6-5	TRBJ1-2
TGTGCCAGCAGCACCCAGGGAGCCCTCACTGAAGCTTTCTTT	CASSTQGALTEAFF	TRBV13	TRBJ1-1
TGTGCCAGCAGCAGACCCGGGACGACCACCTACGAGCAGTACTTC	CASSRPGTTTYEQYF	TRBV7-9	TRBJ2-7
TGTGCCAGCAGTCGGGGGGGGGGGGTCACCGGGGAGCTGTTTTTT	CASSRGGGVTGELFF	TRBV25-1	TRBJ2-2
TGTGCCATCAGTGAGTCCCAGAACATAGGGCCCAGCCGTAACATTCAGTACTTC	CAISESQNIGPSRNIQYF	TRBV10-3	TRBJ2-4
TGTGCCAGCACCCAACAGGGAGTTAATCATGGCTACACCTTC	CASTQQGVNHGYTF	TRBV6-2	TRBJ1-2
TGTGCCAGCAGTTCCCAAAAACGGGACATCCCCGGGTGCCACACCGGGGAGCTGTTTTTT	CASSSQKRDIPGCHTGELFF	TRBV6-3	TRBJ2-2
TGTGCCAGCAGCTTAGTATACCCTAGTCCCGGGGGGGCCCCGACCGGGGAGCTGTTTTTT	CASSLVYPSPGGAPTGELFF	TRBV7-4	TRBJ2-2
TGCGCCAGCAGCCAATTGGTTTACAATGAGCAGTTCTTC	CASSQLVYNEQFF	TRBV4-1	TRBJ2-1
TGTGCCAGCAGTTACTTACCCAGGGGACGCGTGGGTGGCTACACCTTC	CASSYLPRGRVGGYTF	TRBV6-5	TRBJ1-2
TGCGCCAGCAGCCGTTGGGGGCGTCCCAATCAGCCCCAGCATTTT	CASSRWGRPNQPQHF	TRBV4-1	TRBJ1-5
TGTGCCAGCAGTTACTCCCAAAGGGGCCGGAGCAGCAATCAGCCCCAGCATTTT	CASSYSQRGRSSNQPQHF	TRBV6-5	TRBJ1-5
TGCGCCAGCAGCCCCACAACAGCCTATGGCTACACCTTC	CASSPTTAYGYTF	TRBV5-1	TRBJ1-2
TGTGCCAGCAGTTACCGACCTAGCGGGCCCTTGGAGGGGGAGCAGTACTTC	CASSYRPSGPLEGEQYF	TRBV6-2	TRBJ2-7
TGTGCCAGCAGCGATGCCCCCGGGGATAGCGCCTACGAGCAGTACTTC	CASSDAPGDSAYEQYF	TRBV3-1	TRBJ2-7
TGTGCCAGCCGCATCGCTTGGAACACTGAAGCTTTCTTT	CASRIAWNTEAFF	TRBV19	TRBJ1-1
TGTGCCAGCAGTGATGCGGCCGATGGGGGGAAGAAAGAATATAGCAATCAGCCCCAGCATTTT	CASSDAADGGKKEYSNQPQHF	TRBV12-3	TRBJ1-5
TGCAGTGCCCGAGGGGGGGGTGGCTACACCTTC	CSARGGGGYTF	TRBV20-1	TRBJ1-2
TGTGCCAGCAGCTCCCCCCACAGGGCCAATGGCTACACCTTC	CASSSPHRANGYTF	TRBV5-6	TRBJ1-2
TGCGCCAGCAGCCAACCAGCTCTAGGGTGGGAGGGGAGAAGCTCCTACAATGAGCAGTTCTTC	CASSQPALGWEGRSSYNEQFF	TRBV4-1	TRBJ2-1
TGTGCCAGCAGTTTATGGCCGGCGGGAGCCAGCGGCGCCTACAATGAGCAGTTCTTC	CASSLWPAGASGAYNEQFF	TRBV27	TRBJ2-1
TGTGCCAGCAGTTGTCGGGACAGAGTGGATCAGGGGGAGCTGTTTTTT	CASSCRDRVDQGELFF	TRBV12-4	TRBJ2-2
TGTGCCAGCAGATGCCAAGGGGGACAGGGCAATCAGCCCCAGCATTTT	CASRCQGGQGNQPQHF	TRBV28	TRBJ1-5
TGCAGTGCTAGCAAGGACCGCGACATATCGATTGCTGAAGCTTTCTTT	CSASKDRDISIAEAFF	TRBV20-1	TRBJ1-1
TGTGCCACCAGTTCCCAGGCGGGAACCGGGGAGCTGTTTTTT	CATSSQAGTGELFF	TRBV24-1	TRBJ2-2
TGTGCCAGCAGTATACAGAGGAACTATGGCTACACCTTC	CASSIQRNYGYTF	TRBV6-6	TRBJ1-2
TGTGCCAGCAGTGACCGGGGGGGCTTAATTGAGCAGTTCTTC	CASSDRGGLIEQFF	TRBV6-4	TRBJ2-1
TGTGCCAGCAGCTTGTGGGGGGGGAATAGAACTGAAGCTTTCTTT	CASSLWGGNRTEAFF	TRBV5-6	TRBJ1-1
TGTGCCAGCAGCTTACAAACAGGGGAGGACACCGGGGAGCTGTTTTTT	CASSLQTGEDTGELFF	TRBV5-6	TRBJ2-2
TGTGCCACCAGTCTGGATAGCGGGGGAAAGTGGTCATCGAACACTGAAGCTTTCTTT	CATSLDSGGKWSSNTEAFF	TRBV24-1	TRBJ1-1
TGTGCCACGGGGACTAGCGGGGCACAAGATGGCACCGGGGAGCTGTTTTTT	CATGTSGAQDGTGELFF	TRBV13	TRBJ2-2
TGTGCCAGCGTGCTGGGGGGAAACACCATATATTTT	CASVLGGNTIYF	TRBV7-6	TRBJ1-3
TGTGCCAGCAGCCAAGCCACTCCCCTGGACTTCCATCAGCCCCAGCATTTT	CASSQATPLDFHQPQHF	TRBV14	TRBJ1-5
TGCGCCAGCAGTGAGGCGGACCGACAGCGCTGGGCAAAGATTTTAACTGAAGCTTTCTTT	CASSEADRQRWAKILTEAFF	TRBV10-2	TRBJ1-1
TGTGCCAGCAGCCAAGGCACAGATCAGCCCCAGCATTTT	CASSQGTDQPQHF	TRBV3-1	TRBJ1-5
TGTGCCATCAGTATAACCAAATGGAGGATAGAGACCCAGTACTTC	CAISITKWRIETQYF	TRBV10-3	TRBJ2-5
TGCAGTGCTAGAGAAGAGATAGGCTACGAGCAGTACTTC	CSAREEIGYEQYF	TRBV20-1	TRBJ2-7
TGTGCCAGCAGCAATGGGACTAGCGGGGGTAACGAGCAGTACTTC	CASSNGTSGGNEQYF	TRBV6-1	TRBJ2-7
TGTGCGTTGACGTTCTTC	CALTFF	TRBV3-1	TRBJ2-1
TGTGCCAGCAGCTTCAACAAAAGCTACGAGCAGTACTTC	CASSFNKSYEQYF	TRBV7-9	TRBJ2-7
TGTGCCAGCAGAGGGACAGGGACCAGAGGCACTGAAGCTTTCTTT	CASRGTGTRGTEAFF	TRBV13	TRBJ1-1
TGCAGTGCTAGACCTCGGAACACTGAAGCTTTCTTT	CSARPRNTEAFF	TRBV20-1	TRBJ1-1
TGTGCCAGCAGCGTAGAGAGAGCTACCACCTACGAGCAGTACTTC	CASSVERATTYEQYF	TRBV9	TRBJ2-7
TGTGCCACCACTCCGGGACAGGACGGGGAGCTGTTTTTT	CATTPGQDGELFF	TRBV24-1	TRBJ2-2
TGTGCCAGCTCGGGGTGTCCCACTGAAGCTTTCTTT	CASSGCPTEAFF	TRBV18	TRBJ1-1
TGTGCCAGTCGTAAGTGGATCCCGCCCCAGAACGAGCAGTACTTC	CASRKWIPPQNEQYF	TRBV12-4	TRBJ2-7
TGTGCCAGCAGCGACCTACTCCGGGACTACGAGCAGTACTTC	CASSDLLRDYEQYF	TRBV7-3	TRBJ2-7
TGTGCCAGCAGTCCGCCGGGGTACTATGGCTACACCTTC	CASSPPGYYGYTF	TRBV28	TRBJ1-2
TGTGCCAGCAGCCACTGGACCAGCCCCTACGAGCAGTACTTC	CASSHWTSPYEQYF	TRBV4-2	TRBJ2-7
TGCAGTGTCTTGTTTAGCGAGCAGTACTTC	CSVLFSEQYF	TRBV20-1	TRBJ2-7
TGTGCCACCACTAGCGGGGGACAAGAGACCCAGTACTTC	CATTSGGQETQYF	TRBV24-1	TRBJ2-5
TGTGCCCACGCGGGGAGATCCTACAATGAGCAGTTCTTC	CAHAGRSYNEQFF	TRBV30	TRBJ2-1
TGTGCCACCACACCGCGGAGGGATAGCAATCAGCCCCAGCATTTT	CATTPRRDSNQPQHF	TRBV24-1	TRBJ1-5
TGCGCCAGCAGCCAGCTACAGGGCACCAATCAGCCCCAGCATTTT	CASSQLQGTNQPQHF	TRBV5-1	TRBJ1-5
TGTGCCAGCAGGTCCCCGGGACAGGGGAGCTCCTATAATTCACCCCTCCACTTT	CASRSPGQGSSYNSPLHF	TRBV2	TRBJ1-6
TGCGCCAGCAGCCGGTCGAGGGGAGTGGACAGGAACTATGGCTACACCTTC	CASSRSRGVDRNYGYTF	TRBV4-1	TRBJ1-2
TGTGCCAGCAGCTGTGGGGACAGGGGCATTGGGCATCAGCCCCAGCATTTT	CASSCGDRGIGHQPQHF	TRBV11-3	TRBJ1-5
TGCGCCAGCAGCCAACGGCGACCATGGACTGAGCAGTTCTTC	CASSQRRPWTEQFF	TRBV4-1	TRBJ2-1
TGTGCCAGCAGCGGCGAAGACAGGGGTCCGAACACTGAAGCTTTCTTT	CASSGEDRGPNTEAFF	TRBV9	TRBJ1-1
TGTGCTAGTGGTTTGGTACGACTAGCGGTGAGTAGAGATACGCAGTATTTT	CASGLVRLAVSRDTQYF	TRBV12-5	TRBJ2-3
TGTGCCAGCAGCAAGGGGGCTGTTGAAGCTTTCTTT	CASSKGAVEAFF	TRBV13	TRBJ1-1
TGTGCCAGTGGCCCAGACAGTGTGGGCTACACCTTC	CASGPDSVGYTF	TRBV3-1	TRBJ1-2
TGTGCCAGCAGAGCCCAGGGCGGGAACACTGAAGCTTTCTTT	CASRAQGGNTEAFF	TRBV28	TRBJ1-1
TGTGCCAGCAGCTTAGTACGTCGCGGACTAGCGGGAGACTACGAGCAGTACTTC	CASSLVRRGLAGDYEQYF	TRBV11-3	TRBJ2-7
TGTGCCACCAGTGATTTAAGACAGGGGAAAGCTTTCTTT	CATSDLRQGKAFF	TRBV24-1	TRBJ1-1
TGTGCCAGCACTTACAGGCAGTACTTC	CASTYRQYF	TRBV11-3	TRBJ2-7
TGTGCCAGCAGCGTCGACAGGGCTAGGGGATGTCAGCCCCAGCATTTT	CASSVDRARGCQPQHF	TRBV13	TRBJ1-5
TGTGCCAGCGACGAGGCTCAGGGGAACTTAGAGACCCAGTACTTC	CASDEAQGNLETQYF	TRBV7-6	TRBJ2-5
TGCAGTGCCCCCCCGAGACTGTACAATGAGCAGTTCTTC	CSAPPRLYNEQFF	TRBV20-1	TRBJ2-1
TGTGCCAGCAGCATCATAACCCCCGGGACAGGGTTAGGCCCTCTAGTTTATAATGAAAAACTGTTTTTT	CASSIITPGTGLGPLVYNEKLFF	TRBV7-3	TRBJ1-4
TGCGCCAGCAGCCCCCGTGAACAGGGTGAGCAGTTCTTC	CASSPREQGEQFF	TRBV10-1	TRBJ2-1
TGTGCCTCCGGGACAGTAGACTACGAGCAGTACTTC	CASGTVDYEQYF	TRBV24-1	TRBJ2-7
TGCAGCGTTGTAATACCCAACTATGGCTACACCTTC	CSVVIPNYGYTF	TRBV29-1	TRBJ1-2
TGTGCCAGCAGTTGGGTACGGGCTAGCACAGATACGCAGTATTTT	CASSWVRASTDTQYF	TRBV6-1	TRBJ2-3
TGTGCCAGCAGTGACTCGTCTTATCGGGGCTACACCTTC	CASSDSSYRGYTF	TRBV6-4	TRBJ1-2
TGCGCCAGCAGCTTGGTTACTAGCGGGAGAGATACGCAGTATTTT	CASSLVTSGRDTQYF	TRBV5-1	TRBJ2-3
TGTGCCAGCAGCTCCGGTAGCCGAAAGCCCCAGCATTTT	CASSSGSRKPQHF	TRBV7-4	TRBJ1-5
TGTGCCAGCAGCGTAGCTCGGGAGAGCAATGAGCAGTTCTTC	CASSVARESNEQFF	TRBV9	TRBJ2-1
TGTGCCAGCAGTGGTCGGGGACAGTACTCTGGAAACACCATATATTTT	CASSGRGQYSGNTIYF	TRBV6-4	TRBJ1-3
TGCGCCAGCAGGGTAACAAGTCGGGGGGCGGTTTACAATGAGCAGTTCTTC	CASRVTSRGAVYNEQFF	TRBV10-1	TRBJ2-1
TGTGCCAGCTCACTAATGATTCACAGGGAGAAAAACACTGAAGCTTTCTTT	CASSLMIHREKNTEAFF	TRBV18	TRBJ1-1
TGTGCCAGCAGCTTGAACTACCGGGGGCAGGGATACGAGCAGTACTTC	CASSLNYRGQGYEQYF	TRBV5-6	TRBJ2-7
TGTGCCAGCAGCAAAGATGGCGGCGATGAGCAGTTCTTC	CASSKDGGDEQFF	TRBV13	TRBJ2-1
TGCGCCAGCAGCCAGGGGGGAGCTACTTCAGAGACCCAGTACTTC	CASSQGGATSETQYF	TRBV4-1	TRBJ2-5
TGCAGTGCCCGGGGGAAGAATTATCCGAGGTGCAATCAGCCCCAGCATTTT	CSARGKNYPRCNQPQHF	TRBV20-1	TRBJ1-5
TGTGCCAGCAGCGGGTCCCAGTACACTGAAGCTTTCTTT	CASSGSQYTEAFF	TRBV13	TRBJ1-1
TGCTTGGGCTTATCCTACGAGCAGTACTTC	CLGLSYEQYF	TRBV20-1	TRBJ2-7
TGTGCCCGGGGGTTCTCTATTAATTCACCCCTCCACTTT	CARGFSINSPLHF	TRBV28	TRBJ1-6
TGCAGTGCTAGGATCATGATGGTAGGACGAGAGCAGTACTTC	CSARIMMVGREQYF	TRBV20-1	TRBJ2-7
TGTGCCACCTCCACAGGGTCCTATAATTCACCCCTCCACTTT	CATSTGSYNSPLHF	TRBV6-1	TRBJ1-6
TGTGCCATCAGTGAGTGTTGCCGGACAGGGGGGGAGACCCAGTACTTC	CAISECCRTGGETQYF	TRBV10-3	TRBJ2-5
TGTGCCAGCAGCCGATGGACTCCCTACGAGCAGTACTTC	CASSRWTPYEQYF	TRBV3-1	TRBJ2-7
TGCGCCAGCAGCCAAGGGGGGGGACGACGAGACAATGAGCAGTTCTTC	CASSQGGGRRDNEQFF	TRBV4-3	TRBJ2-1
TGTGCCACCAGTGATCGTGCGGAAGACAATGAGCAGTTCTTC	CATSDRAEDNEQFF	TRBV24-1	TRBJ2-1
TGTGCCAGCAGGGGGGAGGGAACAAATCAGCCCCAGCATTTT	CASRGEGTNQPQHF	TRBV27	TRBJ1-5
TGTGCCAGTAGTTCCCGTGGAGGGGGCTACACCTTC	CASSSRGGGYTF	TRBV19	TRBJ1-2
TGCAGCGTTGAAGCTAGGGTCAATCAGCCCCAGCATTTT	CSVEARVNQPQHF	TRBV29-1	TRBJ1-5
TGTGCCAGCCGATCCGGGACTAATAACAATGAGCAGTTCTTC	CASRSGTNNNEQFF	TRBV28	TRBJ2-1
TGTGCCAGCAGTGGCTATACTAGCGGGAGTTATTATTACAATGAGCAGTTCTTC	CASSGYTSGSYYYNEQFF	TRBV11-2	TRBJ2-1
TGTGCTAGTGGTTTGGTCGACTTTCAACATTACAATGAGCAGTTCTTC	CASGLVDFQHYNEQFF	TRBV12-5	TRBJ2-1
TGTGCCAGCAGCACAGGGGGGGAGAACACTGAAGCTTTCTTT	CASSTGGENTEAFF	TRBV13	TRBJ1-1
TGCAGTGCTCCGGAGACGGAGGAGAACTACAATGAGCAGTTCTTC	CSAPETEENYNEQFF	TRBV20-1	TRBJ2-1
TGTGCCAGCAGCTTAGCTGGGACAGGTGAAAAACTGTTTTTT	CASSLAGTGEKLFF	TRBV7-3	TRBJ1-4
TGTGCCAGCAGCCGGAATACTAGGTATAGCAATCAGCCCCAGCATTTT	CASSRNTRYSNQPQHF	TRBV14	TRBJ1-5
TGTGCCAGCAGATCGCCCCTACAGGGGTGGAGGAATCAGCCCCAGCATTTT	CASRSPLQGWRNQPQHF	TRBV6-5	TRBJ1-5
TGCAGTGCTAGAGGTCGGGCTCAAACTGGACAGGGACCTAATGAAAAACTGTTTTTT	CSARGRAQTGQGPNEKLFF	TRBV20-1	TRBJ1-4
TGTGCCAGCAGCTTAAGGTGCTGGGACTCCAAAATACCACCCTCAGATACGCAGTATTTT	CASSLRCWDSKIPPSDTQYF	TRBV7-3	TRBJ2-3
TGTGCCAGCAGCGGTCAGGGGGAGACCCAGTACTTC	CASSGQGETQYF	TRBV7-3	TRBJ2-5
TGTGCCACCAGTGATTGGGCCTTGGGACAGCCGCGCAATCAGCCCCAGCATTTT	CATSDWALGQPRNQPQHF	TRBV24-1	TRBJ1-5
TGTGCCAGCAGTCTCAGTTCGGGAGCCTCCTACGAGCAGTACTTC	CASSLSSGASYEQYF	TRBV25-1	TRBJ2-7
TGTGCCAGCACCGATGGTAGCGGGATTCGAAATGAGCAGTTCTTC	CASTDGSGIRNEQFF	TRBV7-3	TRBJ2-1
TGTGCCAGCAGCTTAGAGACGGGTACTCAGGCGACCCCATTGCTGTTTTTT	CASSLETGTQATPLLFF	TRBV7-9	TRBJ1-4
TGTGCCACCTCCTCGGGACTAGCGGGTGTGGTGAGCCGAAGAGAGACCCAGTACTTC	CATSSGLAGVVSRRETQYF	TRBV24-1	TRBJ2-5
TGTGCCCTGACTACGACCACAGATACGCAGTATTTT	CALTTTTDTQYF	TRBV27	TRBJ2-3
TGTGCCAGCAGCCAAGACGGGGTCGGCTACACCTTC	CASSQDGVGYTF	TRBV3-1	TRBJ1-2
TGTGCCAGCATTTTCCGGACTAGCGATCTAGCCTACGAGCAGTACTTC	CASIFRTSDLAYEQYF	TRBV5-4	TRBJ2-7
TGTGCCAGCAGCTCCTCTCTAGCGTCCTACGAGCAGTACTTC	CASSSSLASYEQYF	TRBV5-6	TRBJ2-7
TGCGCCAGCAGCTCTGTGACGACGATGTTGAGACCCTACGAGCAGTACTTC	CASSSVTTMLRPYEQYF	TRBV5-1	TRBJ2-7
TGCAGTGCGAGACAGGTTTCGGGAAACACCATATATTTT	CSARQVSGNTIYF	TRBV20-1	TRBJ1-3
TGTGCCAGCAGTGATGGGCGGCCCAGGTACTATGGCTACACCTTC	CASSDGRPRYYGYTF	TRBV6-4	TRBJ1-2
TGTGCCAGCAGCTTAACTAGCGATACGCAGTATTTT	CASSLTSDTQYF	TRBV7-3	TRBJ2-3
TGCAGTTATAGCGGGGAAGAGACCCAGTACTTC	CSYSGEETQYF	TRBV20-1	TRBJ2-5
TGTGCCTGGAGTGACTGGGGGAGGGCTCAGCCCCAGCATTTT	CAWSDWGRAQPQHF	TRBV30	TRBJ1-5
TGTGTAGGGGGATTTATGCTAGCCAAAAACATTCAGTACTTC	CVGGFMLAKNIQYF	TRBV30	TRBJ2-4
TGTGCCAGCAGCCTACAAGATGAGCAGTTCTTC	CASSLQDEQFF	TRBV7-3	TRBJ2-1
TGTGCCACCAGGTTCCGAAACTTC	CATRFRNF	TRBV24-1	TRBJ2-7
TGTGCCAGCAGCGTCCTCTCATCAACTAATGAAAAACTGTTTTTT	CASSVLSSTNEKLFF	TRBV7-2	TRBJ1-4
TGTGCCAGCAAATCCCCGTTACTAGCGGGGGGGCAATTATCAGCAAACGAGCAGTACTTC	CASKSPLLAGGQLSANEQYF	TRBV5-5	TRBJ2-7
TGCGCCAGGGGACAGGGACAGCGGCAGCCCCAGCATTTT	CARGQGQRQPQHF	TRBV10-1	TRBJ1-5
TGCAGTGCTAGAGACTCGGCAGCCGCTGAAGCTTTCTTT	CSARDSAAAEAFF	TRBV20-1	TRBJ1-1
TGTGCCAGTAGCCGAAAATTATCGGACCTAGTGGGCGACCCAAACTATGGCTACACCTTC	CASSRKLSDLVGDPNYGYTF	TRBV19	TRBJ1-2
TGTGCCAGCAGTTATCAACCAGGGGAAGGAAGGTGGGGCTATGGCTACACCTTC	CASSYQPGEGRWGYGYTF	TRBV6-2	TRBJ1-2
TGTGCCAGCAGCTCCCCACGGTCTTTAAATGAAAAACTGTTTTTT	CASSSPRSLNEKLFF	TRBV13	TRBJ1-4
TGTGCCAGCAGCTCGCCGGGAGGGCTTGTCGACAATGAGCAGTTCTTC	CASSSPGGLVDNEQFF	TRBV7-9	TRBJ2-1
TGTGCCAGCAATAGTGGGACTAATGAAAAACTGTTTTTT	CASNSGTNEKLFF	TRBV7-2	TRBJ1-4
TGCAGTGCCCCCAGGCATTTAGCCAAAAACATTCAGTACTTC	CSAPRHLAKNIQYF	TRBV20-1	TRBJ2-4
TGTGCCAGCAGGCGGGTTTCGACAGGGCACACAGATACGCAGTATTTT	CASRRVSTGHTDTQYF	TRBV6-1	TRBJ2-3
TGTGCCAGCAGTTCATTCGGGGACCCCCCAGCCTTC	CASSSFGDPPAF	TRBV14	TRBJ1-2
TGTGCCAGCAGGGAGGGGGGTCACTTTTACAATGAGCAGTTCTTC	CASREGGHFYNEQFF	TRBV6-2	TRBJ2-1
TGTGCCAGCAGCTTATATCGTGACAGTCCCTACGAGCAGTACTTC	CASSLYRDSPYEQYF	TRBV7-9	TRBJ2-7
TGTGCCAGCAGGGCAGGGGGGAACACCGGGGAGCTGTTTTTT	CASRAGGNTGELFF	TRBV28	TRBJ2-2
TGTGCCAGCAGTTTACGCAGCCAAGACAGGGCAATTAATTCACCCCTCCACTTT	CASSLRSQDRAINSPLHF	TRBV28	TRBJ1-6
TGTGCCATCAGTGAGTCTCCGGACAGGGCTAACTATGGCTACACCTTC	CAISESPDRANYGYTF	TRBV10-3	TRBJ1-2
TGTGCCAGCAGTGAATTCCCACCGGGACAGTTCACAGATACGCAGTATTTT	CASSEFPPGQFTDTQYF	TRBV25-1	TRBJ2-3
TGCGCCAGCAGTGATTTAAGGGGGGCGCGGGGGTATAGCAATCAGCCCCAGCATTTT	CASSDLRGARGYSNQPQHF	TRBV10-2	TRBJ1-5
TGTGCCAGCAGCGAGGGAGGGGGGGCGCAGTATTTT	CASSEGGGAQYF	TRBV5-4	TRBJ2-3
TGTGCCAGCAGCTCCATGAGAAACACCATATATTTT	CASSSMRNTIYF	TRBV7-3	TRBJ1-3
TGTGCCATCAGTGAGAAGGCACACGAGCAGTACTTC	CAISEKAHEQYF	TRBV10-3	TRBJ2-7
TGTGCCATACGGAGGGAGATTGGATTTAACTATGGCTACACCTTC	CAIRREIGFNYGYTF	TRBV10-3	TRBJ1-2
TGTGCCAGTAACAGGGACCGCACAGATACGCAGTATTTT	CASNRDRTDTQYF	TRBV19	TRBJ2-3
TGTGCTAGTGGTTTGCAGGCCCGACAGGGTTACAACACCGGGGAGCTGTTTTTT	CASGLQARQGYNTGELFF	TRBV12-5	TRBJ2-2
TGTGCCAGCAAGGGGGGGGTGCTTCCCATGAACACTGAAGCTTTCTTT	CASKGGVLPMNTEAFF	TRBV11-3	TRBJ1-1
TGCAGCGTGGCCCCGACAGGGTTAGATAACTATGGCTACACCTTC	CSVAPTGLDNYGYTF	TRBV29-1	TRBJ1-2
TGTGCCAGCAGTTACGGTACGGGCCGTACAGGGGGCCGTGAGAGGGTAGAGACCCAGTACTTC	CASSYGTGRTGGRERVETQYF	TRBV6-5	TRBJ2-5
TGCCTCCGACGGGCCAAAAACATTCAGTACTTC	CLRRAKNIQYF	TRBV6-1	TRBJ2-4
TGTGCCAGTTGGGGGACCAGACCTCGCACAGATACGCAGTATTTT	CASWGTRPRTDTQYF	TRBV19	TRBJ2-3
TGTGCCAGCAGCTTAGAGAAAGTCCGAGGGTGCACAGATACGCAGTATTTT	CASSLEKVRGCTDTQYF	TRBV7-6	TRBJ2-3
TGTGCCAGCAGTTTCGCGACGGGAAGCCAAGAAGAAGCTTTCTTT	CASSFATGSQEEAFF	TRBV27	TRBJ1-1
TGTGCCAGCAGGGAGGCTGGGCCGCTAGGTTGCACAGATACGCAGTATTTT	CASREAGPLGCTDTQYF	TRBV6-5	TRBJ2-3
TGCAGTGCCCGAGGGGGAGGCTGCTACGAGCAGTACTTC	CSARGGGCYEQYF	TRBV20-1	TRBJ2-7
TGTGCCAGCAGCAACAAATATAGGGGGCCGACAGATACGCAGTATTTT	CASSNKYRGPTDTQYF	TRBV11-3	TRBJ2-3
TGCGCCAGCAGTGATTCACCTTCGACCGGGGCTAGCAATCAGCCCCAGCATTTT	CASSDSPSTGASNQPQHF	TRBV10-1	TRBJ1-5
TGTGCCAGCAGCCAAGATGGAATAATAGAAAAACTGTTTTTT	CASSQDGIIEKLFF	TRBV4-2	TRBJ1-4
TGTGCCAGCAGCTTAGCTGGACCGGGACAGGGGGGGGACGACACTGAAGCTTTCTTT	CASSLAGPGQGGDDTEAFF	TRBV7-2	TRBJ1-1
TGTGCCAGTAGTATCCGGGACAGGGGGCTCAGGTACTTC	CASSIRDRGLRYF	TRBV19	TRBJ2-7
TGTGCCAGTAGTCGCCCCCACAGGGATTGGATTTACACCGGGGAGCTGTTTTTT	CASSRPHRDWIYTGELFF	TRBV19	TRBJ2-2
TGTGCCAGCAGCTTAGCGCAATATGAGCAGTTCTTC	CASSLAQYEQFF	TRBV7-9	TRBJ2-1
TGTGCCAGCACTGAGGGGATTAACTACGAGCAGTACTTC	CASTEGINYEQYF	TRBV7-3	TRBJ2-7
TGTGCCAGCAGCACCTATTCAGATACGCAGTATTTT	CASSTYSDTQYF	TRBV7-4	TRBJ2-3
TGTGCCAGCAGACCGACACGATGCACAGATACGCAGTATTTT	CASRPTRCTDTQYF	TRBV6-5	TRBJ2-3
TGTGCCAGCAGCCCGGGACTATGGACCATATATTTT	CASSPGLWTIYF	TRBV7-9	TRBJ1-3
TGCGCCAGCAGCCCGGGGGATGGGATGAGCTCCTACGAGCAGTACTTC	CASSPGDGMSSYEQYF	TRBV5-1	TRBJ2-7
TGTGCCAGCAGCTTGGGGGGCCCTCCCTACGAGCAGTACTTC	CASSLGGPPYEQYF	TRBV9	TRBJ2-7
TGTGCAGTATGTCGGACAGGGCGTTGGGGTCCGAACACCGGGGAGCTGTTTTTT	CAVCRTGRWGPNTGELFF	TRBV7-7	TRBJ2-2
TGCGCCTTGGGGGATAATGGTCCTGAAGCTTTCTTT	CALGDNGPEAFF	TRBV10-1	TRBJ1-1
TGTGCCAGCACGGATGGAGAGCAGTTCTTC	CASTDGEQFF	TRBV11-3	TRBJ2-1
TGTGCCAGGGGGGAAATACAACTGTTTTTT	CARGEIQLFF	TRBV19	TRBJ1-4
TGTGCCAGCAGTGACGGCGGGAGCTGTCCCCAGTACTTC	CASSDGGSCPQYF	TRBV6-4	TRBJ2-5
TGCAGTGCTAGAGTCACAGCGGACTACGAGCAGTACTTC	CSARVTADYEQYF	TRBV20-1	TRBJ2-7
TGTGCCTGGAGTGTACTCGACAAATTAGTCTTC	CAWSVLDKLVF	TRBV30	TRBJ2-1
TGTGCCAGTAGTCTTCCCGGGACTAGCGGCTATGAGCAGTTCTTC	CASSLPGTSGYEQFF	TRBV19	TRBJ2-1
TGTGCCAGCGCAGGGGAGGGTAAGCCGGCCGAGCAGTACTTC	CASAGEGKPAEQYF	TRBV6-4	TRBJ2-7
TGCAGCGGACGGGACAGGGGCGATCAGCCCCAGCATTTT	CSGRDRGDQPQHF	TRBV29-1	TRBJ1-5
TGTGCCAGCAGCGGACCACTTTACGAGCAGTACTTC	CASSGPLYEQYF	TRBV7-9	TRBJ2-7
TGTGCCAGCAGAGGGCGACAGGGCCACACTGAAGCTTTCTTT	CASRGRQGHTEAFF	TRBV6-4	TRBJ1-1
TGTGCCAGCACTTCCAGGGGTAACAATCAGCCCCAGCATTTT	CASTSRGNNQPQHF	TRBV5-6	TRBJ1-5
TGTGCCAGCAGTTACCCCTATTTAATCGACGGGAATGGCACTGAAGCTTTCTTT	CASSYPYLIDGNGTEAFF	TRBV6-3	TRBJ1-1
TGTGCCAGCAGCCACAGGAGCAATCAGCCCCAGCATTTT	CASSHRSNQPQHF	TRBV3-1	TRBJ1-5
TGTGCCAGCAGCTTAGGCTGGGGGCACGAGCAGTACTTC	CASSLGWGHEQYF	TRBV11-2	TRBJ2-7
TGTGCCAGCACGAGGGGTTCACCTTATAGCAATCAGCCCCAGCATTTT	CASTRGSPYSNQPQHF	TRBV6-5	TRBJ1-5
TGTGCCAGCAGCTGTGACAGTAACGAGCAGTACTTC	CASSCDSNEQYF	TRBV7-3	TRBJ2-7
TGTGCCAGCAGCGGGGGCGTCGAAAAACTGTTTTTT	CASSGGVEKLFF	TRBV13	TRBJ1-4
TGTGCCAACAAGGGAAGCTCCTACAATGAGCAGTTCTTC	CANKGSSYNEQFF	TRBV6-2	TRBJ2-1
TGTGCCAGCAGCTTAGCATTCCACGGGACTAGCGGGGCAGTTCGAAACACCGGGGAGCTGTTTTTT	CASSLAFHGTSGAVRNTGELFF	TRBV7-8	TRBJ2-2
TGTGCCAGCAGCTTAGGACCACAGGGCTACGAGCAGTACTTC	CASSLGPQGYEQYF	TRBV7-6	TRBJ2-7
TGTGCCAGCAGCCACCTAGTTAACTCAGATACGCAGTATTTT	CASSHLVNSDTQYF	TRBV5-5	TRBJ2-3
TGTGCTAGTGGTAAGGCGGGGCCCGTTAGACTGGAGCAGTACTTC	CASGKAGPVRLEQYF	TRBV12-5	TRBJ2-7
TGTGCCATCAGTGTCTTGGGGCCAGTTCAGCCCCAGCATTTT	CAISVLGPVQPQHF	TRBV10-3	TRBJ1-5
TGCGCCAGCAGTGAGTACAGGGGAAAAGACAATGAGCAGTTCTTC	CASSEYRGKDNEQFF	TRBV10-1	TRBJ2-1
TGTGCCAGCAGTTTCCGCCCCGCTACCTACGAGCAGTACTTC	CASSFRPATYEQYF	TRBV6-3	TRBJ2-7
TGTGCCAGTAGTAGACCCCCTAGCGGATACGAGCAGTACTTC	CASSRPPSGYEQYF	TRBV19	TRBJ2-7
TGCGCCAGCGCACAGGGGGCCAAGTCACGGAGCTCTGGGGCCAACGTCCTGACTTTC	CASAQGAKSRSSGANVLTF	TRBV4-1	TRBJ2-6
TGTGCCAGCAGCCCACTGCGGGCCGACGGGAACACTGAAGCTTTCTTT	CASSPLRADGNTEAFF	TRBV7-4	TRBJ1-1
TGTGCCAGCAGCTTAATGGACAGGGAATATGGCTACACCTTC	CASSLMDREYGYTF	TRBV7-3	TRBJ1-2
TGTGCCAGCAGCAAATGTTGGGGCGCCAGCACAGATACGCAGTATTTT	CASSKCWGASTDTQYF	TRBV7-2	TRBJ2-3
TGCAGTGGGCAGGCTAATGAAAAACTGTTTTTT	CSGQANEKLFF	TRBV20-1	TRBJ1-4
TGTGCCAGCAGCCAGCGAATATGGGGCACAGATACGCAGTATTTT	CASSQRIWGTDTQYF	TRBV14	TRBJ2-3
TGTGCCAGAAAACATACCACGGGACAGGGCTACGAGCAGTACTTC	CARKHTTGQGYEQYF	TRBV12-4	TRBJ2-7
TGTGCCAGCAGCTTAGATACGACCCCGGTTAGGTGGCATGAGCAGTTCTTC	CASSLDTTPVRWHEQFF	TRBV11-2	TRBJ2-1
TGCAGTGCTAGAGCTGGACAGGGGCTATATGGCTACACCTTC	CSARAGQGLYGYTF	TRBV20-1	TRBJ1-2
TGTGCCCCCCGCACTAGCGGGAGGGCAATATATGAAGCTTTCTTT	CAPRTSGRAIYEAFF	TRBV15	TRBJ1-1
TGTGCCTGGAGTGTACTCTACGGTGAGACCCAGTACTTC	CAWSVLYGETQYF	TRBV30	TRBJ2-5
TGCAGTGCTGAACCAGTAGACACTGAAGCTTTCTTT	CSAEPVDTEAFF	TRBV20-1	TRBJ1-1
TGTGCCAGCATAATGCTAGGAGAGCAGTACTTC	CASIMLGEQYF	TRBV6-5	TRBJ2-7
TGTGCCAGCCAGGGGGGCACAGATACGCAGTATTTT	CASQGGTDTQYF	TRBV27	TRBJ2-3
TGTGCCAGCAGACGCGGGAGAACCTACGAGCAGTACTTC	CASRRGRTYEQYF	TRBV7-9	TRBJ2-7
TGTGCCAGCACCCTCGGGGGCATCACCCGTCGATATAGCAATCAGCCCCAGCATTTT	CASTLGGITRRYSNQPQHF	TRBV9	TRBJ1-5
TGTGCCAGCAGCGCGGGAGGCGAGTGGACTCCCTACAATGAGCAGTTCTTC	CASSAGGEWTPYNEQFF	TRBV13	TRBJ2-1
TGTGCCAGCAGTCGAAAGCCGCGGGAGATCACTGAAGCTTTCTTT	CASSRKPREITEAFF	TRBV6-4	TRBJ1-1
TGCGCCAGCCCCCATCTGAGGGGGCAGACCCAGTACTTC	CASPHLRGQTQYF	TRBV10-1	TRBJ2-5
TGTGCCACCAGTGATTCGCCGCCGGGACAGACAGATACGCAGTATTTT	CATSDSPPGQTDTQYF	TRBV24-1	TRBJ2-3
TGTGCCACCAGCCCCGGGACACAGAATGGCTACACCTTC	CATSPGTQNGYTF	TRBV15	TRBJ1-2
TGTGCCAATCCGTACGGACAGGGGACGGCTGAAGCTTTCTTT	CANPYGQGTAEAFF	TRBV19	TRBJ1-1
TGTGCCAATTCAGACCAGTACTTC	CANSDQYF	TRBV2	TRBJ2-7
TGCAGCGCTCGTCCAGCGGCCCTGATCGCCGAGCAGTACTTC	CSARPAALIAEQYF	TRBV29-1	TRBJ2-7
TGTGCCAGCAGCACGCAGGGGGACACTGAAGCTTTCTTT	CASSTQGDTEAFF	TRBV12-3	TRBJ1-1
TGTGCCAGTAGTATAGACTTCCTGGGCTACACCTTC	CASSIDFLGYTF	TRBV19	TRBJ1-2
TGTGCCAGCAGCGGACACGTGACCCCTTTCTACGAGCAGTACTTC	CASSGHVTPFYEQYF	TRBV7-2	TRBJ2-7
TGCGCCAGCAGCTCCGAACGGTCGATCTACGAGCAGTACTTC	CASSSERSIYEQYF	TRBV5-1	TRBJ2-7
TGCACCCCCTCAAGTGGGGGGGGTAACTATGGCTACACCTTC	CTPSSGGGNYGYTF	TRBV20-1	TRBJ1-2
TGTGCCAGCAGCCAAGCTAGGGGGCGTCAGCCCCAGCATTTT	CASSQARGRQPQHF	TRBV5-6	TRBJ1-5
TGTGCCACTTCCGAGCTAGCTGAAGCTTTCTTT	CATSELAEAFF	TRBV24-1	TRBJ1-1
TGTGCCAAATGTCTAGCTTGGGGCAATGAGCAGTTCTTC	CAKCLAWGNEQFF	TRBV28	TRBJ2-1
TGTGCCAGCAGTGAATCCCCAGGGCTACAAGGCCCTGGTCAGCCCCAGCATTTT	CASSESPGLQGPGQPQHF	TRBV25-1	TRBJ1-5
TGTGCCAGCAGCCCAGGACAGGCCTCTTCGGCAGATACGCAGTATTTT	CASSPGQASSADTQYF	TRBV3-1	TRBJ2-3
TGCGCCAGCAGCTTCTTGACAGGGTCCACTGAAGCTTTCTTT	CASSFLTGSTEAFF	TRBV5-1	TRBJ1-1
TGTGCCAGCAGCCAAGATCACGGAGGGATTCGGTGCTACGAGCAGTACTTC	CASSQDHGGIRCYEQYF	TRBV14	TRBJ2-7
TGTGCCAGCAGCCGTGACTATGGCTACACCTTC	CASSRDYGYTF	TRBV7-3	TRBJ1-2
TGTGCCAGCAGGGACAGGGGGCCACACTATGGCTACACCTTC	CASRDRGPHYGYTF	TRBV3-1	TRBJ1-2
TGTGCCAGCATAAGCCAGGAGGGGTGTCAGCCCCAGCATTTT	CASISQEGCQPQHF	TRBV2	TRBJ1-5
TGTGCCAGTAGTCAGGGACGGGATGGCTACACCTTC	CASSQGRDGYTF	TRBV19	TRBJ1-2
TGTGGCGTGGGGCGGGGCCAGGGGAAAGGACAGCCCCAGCATTTT	CGVGRGQGKGQPQHF	TRBV10-3	TRBJ1-5
TGTGCCAGCAGCACCAACGCTCCGAGCCTCCACTTT	CASSTNAPSLHF	TRBV11-2	TRBJ1-6
TGTGCCAGCAGCTCTCCAGGGAGGGACACTGAAGCTTTCTTT	CASSSPGRDTEAFF	TRBV7-2	TRBJ1-1
TGTGCCAGCAGCTATGAGGCCGTCTTCGGGACTCGGGGCTACTACGAGCAGTACTTC	CASSYEAVFGTRGYYEQYF	TRBV7-3	TRBJ2-7
TGTGCCAGCAGAACCACTAGCGGAAGAGGTAAGTACAATGAGCAGTTCTTC	CASRTTSGRGKYNEQFF	TRBV6-2	TRBJ2-1
TGTGCCAGCAGCTCTCTAAAGGCGGTGGCCTACGAGCAGTACTTC	CASSSLKAVAYEQYF	TRBV7-4	TRBJ2-7
TGTGCCAGTAGTATAGACCGGGACAGGGGACCCTCTGGAAACACCATATATTTT	CASSIDRDRGPSGNTIYF	TRBV19	TRBJ1-3
TGTGCCAGCAGTTACTCGGCCGGGAGCCTTAAAACCTACGAGCAGTACTTC	CASSYSAGSLKTYEQYF	TRBV6-5	TRBJ2-7
TGCAGCCCCGCGTCCTACGAGCAGTACTTC	CSPASYEQYF	TRBV29-1	TRBJ2-7
TGCGCCAGCAGAGAGGGTAGCACAGATACGCAGTATTTT	CASREGSTDTQYF	TRBV5-1	TRBJ2-3
TGTGCTAGTGGTTTGGTACATAGGCGGGAGAATTCACCCCTCCACTTT	CASGLVHRRENSPLHF	TRBV12-5	TRBJ1-6
TGCGCCAGCAGCTTGCATAGGGACAGGGTGAACACTGAAGCTTTCTTT	CASSLHRDRVNTEAFF	TRBV5-1	TRBJ1-1
TGCGCCAGCAGTGAGGTACCGATCGCGGGACTAGAGTACAATGAGCAGTTCTTC	CASSEVPIAGLEYNEQFF	TRBV10-2	TRBJ2-1
TGTGCCACCAACCCCCACTCGAACACCGGGGAGCTGTTTTTT	CATNPHSNTGELFF	TRBV24-1	TRBJ2-2
TGCGCCAGTCCTCGACGGTCCTACAATGAGCAGTTCTTC	CASPRRSYNEQFF	TRBV10-1	TRBJ2-1
TGTGCCAGCAGTCCCCGCTGGACAGGGGAGCCCCAGCATTTT	CASSPRWTGEPQHF	TRBV27	TRBJ1-5
TGCAGTGCTAGAGGCGAAGGGGGTTGGAACACCGGGGAGCTGTTTTTT	CSARGEGGWNTGELFF	TRBV20-1	TRBJ2-2
TGTGCCAGCAGGGACAGGAGTATGAACACTGAAGCTTTCTTT	CASRDRSMNTEAFF	TRBV27	TRBJ1-1
TGTGCCAGCAGCTTAGTGACAGAGGCCGAGCAGTACTTC	CASSLVTEAEQYF	TRBV7-9	TRBJ2-7
TGTGCCAGCAGTAACCTCCGAGGGCGAGGGGAGCTGTTTTTT	CASSNLRGRGELFF	TRBV6-5	TRBJ2-2
TGTGCCACCAGCAGGGTCTGCCCTCAGTTTGGCTACACCTTC	CATSRVCPQFGYTF	TRBV15	TRBJ1-2
TGTGCCAGCAGTTACATCGGCCCGGGGGGCCGGTTCCTCTTCTGCTACGAGCAGTACTTC	CASSYIGPGGRFLFCYEQYF	TRBV6-3	TRBJ2-7
TGTGCCAGCAGCTTGGCCCCTAGCGCGGGAGAGGTTACCGATCAGCCCCAGCATTTT	CASSLAPSAGEVTDQPQHF	TRBV5-6	TRBJ1-5
TGTGCCACCAGTGAGTTCTACATCCGGGACAGAGATACGCAGTATTTT	CATSEFYIRDRDTQYF	TRBV24-1	TRBJ2-3
TGTGCCAGCAGTCAAAGTACGTGGGGGGGCACAGATACGCAGTATTTT	CASSQSTWGGTDTQYF	TRBV6-5	TRBJ2-3
TGTGCCAGTAGCGGACAGGGGCTTGGTAATGAAAAACTGTTTTTT	CASSGQGLGNEKLFF	TRBV19	TRBJ1-4
TGTGCCAGCAGTTTTAGGATCCGGGTGATCTGGAACACTGAAGCTTTCTTT	CASSFRIRVIWNTEAFF	TRBV27	TRBJ1-1
TGCAGCGTTGAGCATCTCTGCAGGGAGGTAAATCTACACACCGGGGAGCTGTTTTTT	CSVEHLCREVNLHTGELFF	TRBV29-1	TRBJ2-2
TGTGCCTGGCGACAGGGGGCCGAGCAGTACTTC	CAWRQGAEQYF	TRBV30	TRBJ2-7
TGTGCCAGCACCCCGAGGGGCACTACCGAGCAGTACTTC	CASTPRGTTEQYF	TRBV6-3	TRBJ2-7
TGTGCCAGCAGCCCGGGACAGGGTCAGCCCCAGCATTTT	CASSPGQGQPQHF	TRBV7-3	TRBJ1-5
TGTGCCAGCGGGGGGGACCGGGGACTTTTTATAGGCAATCAGCCCCAGCATTTT	CASGGDRGLFIGNQPQHF	TRBV6-1	TRBJ1-5
TGTGCCAGCAGTGACTCACAAAAGGACGGGCGAAATCAGCCCCAGCATTTT	CASSDSQKDGRNQPQHF	TRBV6-4	TRBJ1-5
TGTGCCAGCTCACCCCTAGGGGCTTGCCAGGAGACCCAGTACTTC	CASSPLGACQETQYF	TRBV18	TRBJ2-5
TGTGCCAGTAGTATCCCGACCGGGGAGCTGTTTTTT	CASSIPTGELFF	TRBV19	TRBJ2-2
TGTGCCAGCAGTCGCCGCTACCGGGACAGGGGTAGGGGGGAGCCCCAGCATTTT	CASSRRYRDRGRGEPQHF	TRBV27	TRBJ1-5
TGTGCCTTCCTTCCCGAAAGACTAGCGGGGGTCGGGGAGCTGTTTTTT	CAFLPERLAGVGELFF	TRBV2	TRBJ2-2
TGTGCCAGCAGCGGGAACGGGGGGGCCTATGGCTACACCTTC	CASSGNGGAYGYTF	TRBV13	TRBJ1-2
TGTGCCAGCAGCGCGGTGAAAGTTCCACGGGCCGATACGCAGTATTTT	CASSAVKVPRADTQYF	TRBV9	TRBJ2-3
TGTGCCAGCTCACTTCGGACCTGGGGCAATCAGCCCCAGCATTTT	CASSLRTWGNQPQHF	TRBV18	TRBJ1-5
TGCCCCCCCAAAAGGACAAGGTCCTACGAGCAGTACTTC	CPPKRTRSYEQYF	TRBV10-2	TRBJ2-7
TGTGCCAGCAGCTTTAGGGACAGGGTCAACACTGAAGCTTTCTTT	CASSFRDRVNTEAFF	TRBV7-9	TRBJ1-1
TGTGCCAGCAGCAAAGGTAATGACGCACCCGGGGGGGAGCTGTTTTTT	CASSKGNDAPGGELFF	TRBV28	TRBJ2-2
TGTGCCAGCATCCGGGGCGGGAACACTGAAGCTTTCTTT	CASIRGGNTEAFF	TRBV6-4	TRBJ1-1
TGCGCCAGCAGCTTGGACTTCCCAGGCATTAGCTCCTACGAGCAGTACTTC	CASSLDFPGISSYEQYF	TRBV5-1	TRBJ2-7
TGTGCCAGCAGTCGAGCAGCAGGGGTTTGCGGCACTGAAGCTTTCTTT	CASSRAAGVCGTEAFF	TRBV6-5	TRBJ1-1
TGCAGTGCTAGAGTATCAGGATCCAAGAGTGAAAAACTGTTTTTT	CSARVSGSKSEKLFF	TRBV20-1	TRBJ1-4
TGCGCCAGCAGCCAAGATATTAGCGGGACGTCAGCCTACGAGCAGTACTTC	CASSQDISGTSAYEQYF	TRBV4-3	TRBJ2-7
TGCGCCAGCAGCCAAGATCCCGGGACTAGCGGGGGTAAATACAATGAGCAGTTCTTC	CASSQDPGTSGGKYNEQFF	TRBV4-1	TRBJ2-1
TGTGCCAGCAGCGTTCCGGGACAGGGCCGGAGAACCCATGAGCAGTTCTTC	CASSVPGQGRRTHEQFF	TRBV5-8	TRBJ2-1
TGTGCCAGCATGCGTCAGTCCGAGCAGTACTTC	CASMRQSEQYF	TRBV27	TRBJ2-7
TGCGCCAGCGAGGGGGGATCAGGGGTCGCCTGGAACACTGAAGCTTTCTTT	CASEGGSGVAWNTEAFF	TRBV10-1	TRBJ1-1
TGCAGTGCTAGAGACGTAAATGAGCAGTTCTTC	CSARDVNEQFF	TRBV20-1	TRBJ2-1
TGTGTGAAAAGGACAGGATACACCGGGGAGCTGTTTTTT	CVKRTGYTGELFF	TRBV12-3	TRBJ2-2
TGTGCCAGCTCTCATAACAAGACTAGGGCGCACTCCTACAATGAGCAGTTCTTC	CASSHNKTRAHSYNEQFF	TRBV11-2	TRBJ2-1
TGCAGCGTTCGCGGGACGGCCGACATCCAGCCCCAGCATTTT	CSVRGTADIQPQHF	TRBV29-1	TRBJ1-5
TGCGCCAGCAGCCAGCCAGGGTACGAGCAGTACTTC	CASSQPGYEQYF	TRBV4-1	TRBJ2-7
TGTGCCAGTACGCTACAGGGTGCTTCTAATGAAAAACTGTTTTTT	CASTLQGASNEKLFF	TRBV19	TRBJ1-4
TGCAGTGCTGATAAAACGAGAGTCGAGCAGTACTTC	CSADKTRVEQYF	TRBV20-1	TRBJ2-7
TGTGCCAGCAGCGGGGGTTCAAATCAGCCCCAGCATTTT	CASSGGSNQPQHF	TRBV7-8	TRBJ1-5
TGCGCCAGCAGCCAAGATCGACATGGTAAGGGACCTGATGAGCAGTTCTTC	CASSQDRHGKGPDEQFF	TRBV4-1	TRBJ2-1
TGTGCCACCGGGACTAGACCCCACAAAAACATTCAGTACTTC	CATGTRPHKNIQYF	TRBV10-3	TRBJ2-4
TGCAGTGCTAGACTACCGAAGGGTGGCTATGGCTACACCTTC	CSARLPKGGYGYTF	TRBV20-1	TRBJ1-2
TGTGCCAGCAGCTCTGGACAGGCCTACTCTTCACCCCTCCACTTT	CASSSGQAYSSPLHF	TRBV13	TRBJ1-6
TGTGCCAGCAGCAAGGCCCTCAGGGGGTGGACCAGGAATGGCTACACCTTC	CASSKALRGWTRNGYTF	TRBV7-3	TRBJ1-2
TGTGCCAGCAGTGACTCGAGGGGCGCTACACCAGATACGCAGTATTTT	CASSDSRGATPDTQYF	TRBV6-4	TRBJ2-3
TGCGCCAGCAGCCTTCGGGCCGGCTACACCTTC	CASSLRAGYTF	TRBV5-1	TRBJ1-2
TGTGCCAGTAGTATGCCGGGACAGGGGGCCAGTCACACTGAAGCTTTCTTT	CASSMPGQGASHTEAFF	TRBV19	TRBJ1-1
TGTGCCAGCAGTTTGTTTCTAGCGGGCACCGGGGAGCTGTTTTTT	CASSLFLAGTGELFF	TRBV28	TRBJ2-2
TGTGCCCAGGTCAAGGGAGAAGGCTCCTACGAGCAGTACTTC	CAQVKGEGSYEQYF	TRBV7-3	TRBJ2-7
TGTGCCAGTAGGATTGGGACCGGGACAGGGAGCAATCAGCCCCAGCATTTT	CASRIGTGTGSNQPQHF	TRBV19	TRBJ1-5
TGTGCCAGCAGTTTCCCTATACTAGAGACCCAGTACTTC	CASSFPILETQYF	TRBV27	TRBJ2-5
TGCGCCAGCAGCTTGGAATTGTACGGACCAAGCCATTCCTACAATGAGCAGTTCTTC	CASSLELYGPSHSYNEQFF	TRBV5-1	TRBJ2-1
TGTGCCAGCAGGTTCCGGGGATCCGAGACCCAGTACTTC	CASRFRGSETQYF	TRBV6-2	TRBJ2-5
TGTGCCAGCAGCCCCTGGGGGGGGACCACAGATACGCAGTATTTT	CASSPWGGTTDTQYF	TRBV3-1	TRBJ2-3
TGTGCCAGCAGCGAACAGGGACTAGCGGACCAGTATTTT	CASSEQGLADQYF	TRBV7-2	TRBJ2-3
TGTGCCAGCAGCTTAGCGCACTTCGGGACTAGCGGGGGCACCGGGGAGCTGTTTTTT	CASSLAHFGTSGGTGELFF	TRBV7-2	TRBJ2-2
TGTGTCGGGGGGGTGTCCAGCTACGAGCAGTACTTC	CVGGVSSYEQYF	TRBV6-4	TRBJ2-7
TGTGCCAGCAGTGCCAGGACTAGCGGGCCCAATGAGCAGTTCTTC	CASSARTSGPNEQFF	TRBV6-6	TRBJ2-1
TGCGCCAGCAGCTTGGAGACAGGGGCCTATGGCTACACCTTC	CASSLETGAYGYTF	TRBV5-1	TRBJ1-2
TGTGCCAGCAGCTACGCACCGGGACAGGCAAACAACTATGGCTACACCTTC	CASSYAPGQANNYGYTF	TRBV7-3	TRBJ1-2
TGCAGCGTTTGGACGCAAGAGACCCAGTACTTC	CSVWTQETQYF	TRBV29-1	TRBJ2-5
TGTGCCAGCAGTCAGGTCGCGGAGCAGTACTTC	CASSQVAEQYF	TRBV6-4	TRBJ2-7
TGCAGCGTTGTGGGGGGGGACAGGGGAGGTAATGAAAAACTGTTTTTT	CSVVGGDRGGNEKLFF	TRBV29-1	TRBJ1-4
TGTGCCAGCAGTGACAACTTGACAGTGACAAGGCAGTACTTC	CASSDNLTVTRQYF	TRBV6-4	TRBJ2-7
TGTGCCAGCAGTAAGGGAGGGACAGATACGCAGTATTTT	CASSKGGTDTQYF	TRBV6-2	TRBJ2-3
TGTGCCACCTGTCAAAACGCCGGGACAGGGCGATACTCTGGGGCCAACGTCCTGACTTTC	CATCQNAGTGRYSGANVLTF	TRBV24-1	TRBJ2-6
TGTGCCAGCAGCGAGACAGGGTATTACGAGCAGTACTTC	CASSETGYYEQYF	TRBV9	TRBJ2-7
TGTGCCAGCAGCTCCGCTTGGGCCTACGAGCAGTACTTC	CASSSAWAYEQYF	TRBV7-3	TRBJ2-7
TGTGCCAGCAGGGGGGACCGTTGTCGGTGCTCTGGGGCCAACGTCCTGACTTTC	CASRGDRCRCSGANVLTF	TRBV2	TRBJ2-6
TGCAGTGGACTACCTATTGTTAGCTACGAGCAGTACTTC	CSGLPIVSYEQYF	TRBV20-1	TRBJ2-7
TGCGCCAGCAGCAGAGGCATGAACACTGAAGCTTTCTTT	CASSRGMNTEAFF	TRBV4-3	TRBJ1-1
TGTGCCAGCAGCCCAATCGACCGGGACGCTCGGCGATATAGCAATCAGCCCCAGCATTTT	CASSPIDRDARRYSNQPQHF	TRBV7-6	TRBJ1-5
TGTGCCAGCAGCATAAAAGCTAACGAGCAGTACTTC	CASSIKANEQYF	TRBV7-9	TRBJ2-7
TGCGCCAGCAGGGATGGCGAGGCCACTGAAGCTTTCTTT	CASRDGEATEAFF	TRBV5-1	TRBJ1-1
TGCGCCAGCAGCTTGCAACCCAGGGGGCGGGAGTCCAACTATGGCTACACCTTC	CASSLQPRGRESNYGYTF	TRBV5-1	TRBJ1-2
TGTGCCAGCAGACTTTCCAGGGGGGCCCCCTACGAGCAGTACTTC	CASRLSRGAPYEQYF	TRBV6-6	TRBJ2-7
TGTGCCAGCAGAGAGTGGGATACGCAGTATTTT	CASREWDTQYF	TRBV13	TRBJ2-3
TGTGCCAGCAGCTTAGATAAAGGAGGGGATGAAAAACTGTTTTTT	CASSLDKGGDEKLFF	TRBV11-3	TRBJ1-4
TGTGCCATCGTTACCGGGAAACTGTTTTTT	CAIVTGKLFF	TRBV10-3	TRBJ1-4
TGTGCCAGCAGCGGGACCTCCTACGAGCAGTACTTC	CASSGTSYEQYF	TRBV9	TRBJ2-7
TGTGCCAGCAGCATGGACAGGGACGAGTCCATGAACACTGAAGCTTTCTTT	CASSMDRDESMNTEAFF	TRBV13	TRBJ1-1
TGTGCCAGCAGCTCCCGGTACAACAGCTATGGCTACACCTTC	CASSSRYNSYGYTF	TRBV5-6	TRBJ1-2
TGTGCCAGCCCCGGGGGCGGGGTCTACAATGAGCAGTTCTTC	CASPGGGVYNEQFF	TRBV6-1	TRBJ2-1
TGTGCCAGCTGGTTAGGACAGAGGGGAGACACTGAAGCTTTCTTT	CASWLGQRGDTEAFF	TRBV7-2	TRBJ1-1
TGTGCCAGCAGAGAGTCGACGGGGGTGAGGTACAATGAGCAGTTCTTC	CASRESTGVRYNEQFF	TRBV7-4	TRBJ2-1
TGCAGTGGATACAGGGGGGAGGGGATCGGACGCACCGGGGAGCTGTTTTTT	CSGYRGEGIGRTGELFF	TRBV20-1	TRBJ2-2
TGTGCCACCAGCCTACAGGGGTACTGCAATGAGCAGTTCTTC	CATSLQGYCNEQFF	TRBV24-1	TRBJ2-1
TGTGCCAGCAGTGAAGCGCTCACCTCTACATACTACGAGCAGTACTTC	CASSEALTSTYYEQYF	TRBV6-1	TRBJ2-7
TGTGCCAGCAGTGAGGGAAACACCGGGGAGCTGTTTTTT	CASSEGNTGELFF	TRBV6-1	TRBJ2-2
TGTGCCAGCATAGCGGGAGGTGGCACAGATACGCAGTATTTT	CASIAGGGTDTQYF	TRBV7-3	TRBJ2-3
TGTGCCAGCAGCGAAACTAGCGGGGGAGAGACCCAGTACTTC	CASSETSGGETQYF	TRBV9	TRBJ2-5
TGTGCCAGCAGTGACCCCGGGAGGCTGGTTGGCTCCTACAATGAGCAGTTCTTC	CASSDPGRLVGSYNEQFF	TRBV6-4	TRBJ2-1
TGCAGCGTTGACTACCCGGTAGGACAGGGGGTATATAGCAATCAGCCCCAGCATTTT	CSVDYPVGQGVYSNQPQHF	TRBV29-1	TRBJ1-5
TGTGCCACCAGCACCGACCCCTTGCGGGAGGCCACAGATACGCAGTATTTT	CATSTDPLREATDTQYF	TRBV15	TRBJ2-3
TGCGCCAGCAGCTTGTCCCTCGCAGGGTGTAATCAGCCCCAGCATTTT	CASSLSLAGCNQPQHF	TRBV5-1	TRBJ1-5
TGTGCCACCACTAGCGGACCGAGCTCCTACAATGAGCAGTTCTTC	CATTSGPSSYNEQFF	TRBV24-1	TRBJ2-1
TGTGCCAGCAGCAGTCTGCACAGCTCCTACAATGAGCAGTTCTTC	CASSSLHSSYNEQFF	TRBV13	TRBJ2-1
TGCGCCAGCGTATCTGTGACCGGGACTGAAGCTTTCTTT	CASVSVTGTEAFF	TRBV4-1	TRBJ1-1
TGTGCCAAAACCTACCCATCCGGGACCGAGCAAGAGACCCAGTACTTC	CAKTYPSGTEQETQYF	TRBV19	TRBJ2-5
TGTGCCAGCAGTTACTCGATTGGTCGCAGCTCCTACGAGCAGTACTTC	CASSYSIGRSSYEQYF	TRBV6-5	TRBJ2-7
TGCGCCAGCAGGACCCCCCAGGGGCCGGAAGTTCAGGGAGGGTATGGCTACACCTTC	CASRTPQGPEVQGGYGYTF	TRBV10-1	TRBJ1-2
TGTGCCTGGAGTGAAACCGGGACAGGGACTGAAGCTTTCTTT	CAWSETGTGTEAFF	TRBV30	TRBJ1-1
TGTGCCACCAGTGAACGACAGGAGACGAACACTGAAGCTTTCTTT	CATSERQETNTEAFF	TRBV24-1	TRBJ1-1
TGTGCCAGCAACGGGCCCTCCTTGGCTAGCACAGATACGCAGTATTTT	CASNGPSLASTDTQYF	TRBV5-6	TRBJ2-3
TGTGCCAGTTTCATGGGACTGAAGACTGAAGCTTTCTTT	CASFMGLKTEAFF	TRBV2	TRBJ1-1
TGCGCCAGCAGTGAAGTACAGGGGCAGTATTTGAACACTGAAGCTTTCTTT	CASSEVQGQYLNTEAFF	TRBV10-2	TRBJ1-1
TGTGCCAGCCTTACCACGACCCGTTTTCTCGTACTCTATGGCTACACCTTC	CASLTTTRFLVLYGYTF	TRBV27	TRBJ1-2
TGTGCCAAAAGACTAGGCTGGGAGACCCAGTACTTC	CAKRLGWETQYF	TRBV6-5	TRBJ2-5
TGTGCCAGCAGTGCGGGAGACACCGGGGAGCTGTTTTTT	CASSAGDTGELFF	TRBV12-3	TRBJ2-2
TGTGCCAGCAGCCGAACCGCAGCACAGGAGGACAGGGAAAAGGGTTCCTACGAGCAGTACTTC	CASSRTAAQEDREKGSYEQYF	TRBV6-2	TRBJ2-7
TGCGCCAGCCGGTCGGCCCCTATATACGAGCAGTACTTC	CASRSAPIYEQYF	TRBV10-1	TRBJ2-7
TGTGCCAGCACCCGGGACAGGGAGGTTGGCTCCTACAATGAGCAGTTCTTC	CASTRDREVGSYNEQFF	TRBV7-6	TRBJ2-1
TGTGCCACAACTAATCAGCCCCAGCATTTT	CATTNQPQHF	TRBV24-1	TRBJ1-5
TGTGCCAGCCCGGGCGGTGAAGCTTTCTTT	CASPGGEAFF	TRBV25-1	TRBJ1-1
TGTGCCACCAGCAGACAGGGCTCCTACGAGCAGTACTTC	CATSRQGSYEQYF	TRBV24-1	TRBJ2-7
TGCAGTGCCGGGGGGGAGGGGCGTGAGCAGTACTTC	CSAGGEGREQYF	TRBV20-1	TRBJ2-7
TGTGCCACCATTCGGGTGGACCCTGAAGCTTTCTTT	CATIRVDPEAFF	TRBV24-1	TRBJ1-1
TGCAGCGTTAGCATGGGAGCAGATACGCAGTATTTT	CSVSMGADTQYF	TRBV29-1	TRBJ2-3
TGCAGTGCTGAACATCAACTAGAGGCCTACGAGCAGTACTTC	CSAEHQLEAYEQYF	TRBV20-1	TRBJ2-7
TGTGCCAGCAGCCCCCTCTTGACAGGGGTCTTCTATAATTCACCCCTCCACTTT	CASSPLLTGVFYNSPLHF	TRBV13	TRBJ1-6
TGTGCCAGCAGTGAACAGAGACAGAGGAACCGATACGAGCAGTACTTC	CASSEQRQRNRYEQYF	TRBV6-1	TRBJ2-7
TGTGCCAGCAGTGTCCGGGGGCTGGGAAGCAATCAGCCCCAGCATTTT	CASSVRGLGSNQPQHF	TRBV6-4	TRBJ1-5
TGTGCCAGCAGCGGAGGGACTAGCGGGGTTAAAGATACGCAGTATTTT	CASSGGTSGVKDTQYF	TRBV9	TRBJ2-3
TGTGCCAGCAGCGGCCCCCTGGTACCGACAACCCGTCGATTGGAAGAGACCCAGTACTTC	CASSGPLVPTTRRLEETQYF	TRBV3-1	TRBJ2-5
TGTGCCACCAGTGTGGACCCCCTGGGGCTCAACTATGGCTACACCTTC	CATSVDPLGLNYGYTF	TRBV24-1	TRBJ1-2
TGCAGTGCCTACCCAGGGGGGGCTGAAGCTTTCTTT	CSAYPGGAEAFF	TRBV20-1	TRBJ1-1
TGCGCCAGCAGGGACACTGAAGCTTTCTTT	CASRDTEAFF	TRBV4-3	TRBJ1-1
TGTGCCAGCAGCTCGGACCTGCCGCGGTCACCCCTCCACTTT	CASSSDLPRSPLHF	TRBV5-4	TRBJ1-6
TGCGCCAGCAGCCGGAGTGCAAAACGAGGGGATGGGTCTGGTGGGGAGACCCAGTACTTC	CASSRSAKRGDGSGGETQYF	TRBV4-1	TRBJ2-5
TGTGCCAGCAGCTTAGGCAGGACAGATACGCAGTATTTT	CASSLGRTDTQYF	TRBV7-6	TRBJ2-3
TGTGCCAGCAGCGCCTGGGACACTCTTCCCTACGAGCAGTACTTC	CASSAWDTLPYEQYF	TRBV7-6	TRBJ2-7
TGTGCCAGCGTTCACCAGGGACGGGGCAATCAGCCCCAGCATTTT	CASVHQGRGNQPQHF	TRBV18	TRBJ1-5
TGTGCCAGCAGTACTCCCGGACAGGTGTTGTCACCCCTCCACTTT	CASSTPGQVLSPLHF	TRBV6-8	TRBJ1-6
TGTGCCAGCACTTATGAGACGGGGGATTTCTGCAATCAGCCCCAGCATTTT	CASTYETGDFCNQPQHF	TRBV12-3	TRBJ1-5
TGTGCCAGCAGCTTGACAGTGTTTGTCGAGCAGTACTTC	CASSLTVFVEQYF	TRBV7-9	TRBJ2-7
TGTGCCAGCAGCTGGAGCGGGAAAGAGACCCAGTACTTC	CASSWSGKETQYF	TRBV7-3	TRBJ2-5
TGTGCCAGCACCCATAATCGGGTCACAGATACGCAGTATTTT	CASTHNRVTDTQYF	TRBV27	TRBJ2-3
TGTGCCACCAGCAATGGCCAGGGACCCTACAATGAGCAGTTCTTC	CATSNGQGPYNEQFF	TRBV15	TRBJ2-1
TGTGCTAGTGGTTCAGGGAGGAATGAAAAACTGTTTTTT	CASGSGRNEKLFF	TRBV12-5	TRBJ1-4
TGCAGTGCTAGTTTGGACAGGGGGGGGGGATCTAACTATGGCTACACCTTC	CSASLDRGGGSNYGYTF	TRBV20-1	TRBJ1-2
TGTGCCAGCAGTTACACGACAGGGAGCGAGCAGTACTTC	CASSYTTGSEQYF	TRBV12-3	TRBJ2-7
TGCGCCAGCAGTGAGTTCTGGGACAGGGCCCCAGACACTGAAGCTTTCTTT	CASSEFWDRAPDTEAFF	TRBV10-1	TRBJ1-1
TGTGCCAGCAACGAGGGTTGGGAAGGTACCTACAATGAGCAGTTCTTC	CASNEGWEGTYNEQFF	TRBV6-4	TRBJ2-1
TGTGCCAGCATGGGACGGGTAGATGAGCAGTTCTTC	CASMGRVDEQFF	TRBV7-9	TRBJ2-1
TGTGCCAGCAGCTCTAGCACCTACGAGCAGTACTTC	CASSSSTYEQYF	TRBV5-6	TRBJ2-7
TGTGCCAGCATTTTCCAACCACCTACTGAAGCTTTCTTT	CASIFQPPTEAFF	TRBV6-4	TRBJ1-1
TGTGCCAGCAGTGAGTGTCCCTCGGGAGGGTTTTCACCCCTCCACTTT	CASSECPSGGFSPLHF	TRBV6-1	TRBJ1-6
TGTGCCAGCAGTCGGGCAGACGATAATCAGCCCCAGCATTTT	CASSRADDNQPQHF	TRBV2	TRBJ1-5
TGTGCTAGTGGTTTGAGGAATATGCTAGCGCTGGTGGGGGAGCAGTACTTC	CASGLRNMLALVGEQYF	TRBV12-5	TRBJ2-7
TGTGCCTGGAGTGTACTCCTTGGGGACGGGTACGAGCAGTACTTC	CAWSVLLGDGYEQYF	TRBV30	TRBJ2-7
TGTGCCAGTATGATCAGGGACAGGGTGAGCAATCAGCCCCAGCATTTT	CASMIRDRVSNQPQHF	TRBV19	TRBJ1-5
TGTGCCATCAGTGAGTTTCGGTTGGCCTCCTACGAGCAGTACTTC	CAISEFRLASYEQYF	TRBV10-3	TRBJ2-7
TGTGCCAGCAGCCCCAAGCACGAGCAGTACTTC	CASSPKHEQYF	TRBV13	TRBJ2-7
TGTGCCACCAGTCGTCGGGGCAGCAATCAGCCCCAGCATTTT	CATSRRGSNQPQHF	TRBV24-1	TRBJ1-5
TGTGCCACACGCAAGGGGCATTTT	CATRKGHF	TRBV24-1	TRBJ1-5
TGTGCCTGGATGAGGACGCCAAATGAGCAGTTCTTC	CAWMRTPNEQFF	TRBV30	TRBJ2-1
TGTGCCAGCAGGGACTCCTACGAGCAGTACTTC	CASRDSYEQYF	TRBV6-6	TRBJ2-7
TGTGTCACTGAGCACTACAATGAGCAGTTCTTC	CVTEHYNEQFF	TRBV27	TRBJ2-1
TGTGCCAGCAGCAAGGACAGCATGGGACAGCCCCAGCATTTT	CASSKDSMGQPQHF	TRBV7-3	TRBJ1-5
TGCAGCGTTGGCCTTCAGGGCAATCAGCCCCAGCATTTT	CSVGLQGNQPQHF	TRBV29-1	TRBJ1-5
TGTGCCAGTAGTATAGCCCTCGCAACTCCTAGCGACGGGCGCGAGCAGTACTTC	CASSIALATPSDGREQYF	TRBV19	TRBJ2-7
TGTGCCAGCAGCCACTCATCCTGGCCGACAGGGGGCTCCCTTGGCTACACCTTC	CASSHSSWPTGGSLGYTF	TRBV4-2	TRBJ1-2
TGTGCCAGCAGCCGGGTGAACAGGGAAGTTAGCAATCAGCCCCAGCATTTT	CASSRVNREVSNQPQHF	TRBV3-1	TRBJ1-5
TGTGCCAGTAGCGAGCGGGGACGTCCCGGAAACACTGAAGCTTTCTTT	CASSERGRPGNTEAFF	TRBV19	TRBJ1-1
TGTGCCAGCAGTGACGTCAAGGGGGGGCTTCCGGAAAAACTGTTTTTT	CASSDVKGGLPEKLFF	TRBV6-4	TRBJ1-4
TGCGCCACGATCTCAGACGAGCAGTACTTC	CATISDEQYF	TRBV10-1	TRBJ2-7
TGCGCCAGCAGCTGCCCCCCCGGGAGGTGGGGAACGACCCAGTACTTC	CASSCPPGRWGTTQYF	TRBV5-1	TRBJ2-5
TGTGCAGGGGCAAAGAGTAGGCTGCGCATTCAGTACTTC	CAGAKSRLRIQYF	TRBV7-2	TRBJ2-4
TGTGCCAGCAGCTGTGAGGCGGGGATTCCCTACGAGCAGTACTTC	CASSCEAGIPYEQYF	TRBV7-8	TRBJ2-7
TGTGCCAGCAGTGCCGGACAGGAAGATAGCAATCAGCCCCAGCATTTT	CASSAGQEDSNQPQHF	TRBV6-4	TRBJ1-5
TGTGCCAGCTCACCAGACAGGTTCTCCTACAATGAGCAGTTCTTC	CASSPDRFSYNEQFF	TRBV18	TRBJ2-1
TGTGCCAGTAGTATTGGGCCTCCTAAGCCGGGACGCCGCTGCTATGGCTACACCTTC	CASSIGPPKPGRRCYGYTF	TRBV19	TRBJ1-2
TGTGCCAGCAGCGTAGGTCACCCCTTCGGGACTAGAAAAATTCCCTACAATGAGCAGTTCTTC	CASSVGHPFGTRKIPYNEQFF	TRBV9	TRBJ2-1
TGTGCCAGCAGCTTGGGGGGCAAATTGGATACGCAGTATTTT	CASSLGGKLDTQYF	TRBV5-4	TRBJ2-3
TGTGCCAGCAGTTCCCCGGGAGGCGAGCAGTACTTC	CASSSPGGEQYF	TRBV6-6	TRBJ2-7
TGTGCCAGCAGTTACTCGGAAACTGGGGGAACCTTC	CASSYSETGGTF	TRBV6-6	TRBJ1-2
TGTGCCAGCAGAACAGCCTGCTCTGGAAACACCATATATTTT	CASRTACSGNTIYF	TRBV14	TRBJ1-3
TGTGCTAGTGGTTTGGGGCCAGGGCTCAGCTATGGCTACACCTTC	CASGLGPGLSYGYTF	TRBV12-5	TRBJ1-2
TGTGCCAGCAGCTATTGCAGCCCGGGCACCAACAATGAGCAGTTCTTC	CASSYCSPGTNNEQFF	TRBV7-9	TRBJ2-1
TGTGCCAGCAGCTTACAAAGGGGTGAGGCCACAGATACGCAGTATTTT	CASSLQRGEATDTQYF	TRBV7-2	TRBJ2-3
TGTGCCAGCAGTAAACACCCTTTTGAAAAACTGTTTTTT	CASSKHPFEKLFF	TRBV5-5	TRBJ1-4
TGTGCCAGCATCGCGTTCCCCGACAGGCAAATTTTACGGGGCACAGATACGCAGTATTTT	CASIAFPDRQILRGTDTQYF	TRBV6-6	TRBJ2-3
TGCACAATAGAGACCCAGTACTTC	CTIETQYF	TRBV20-1	TRBJ2-5
TGTGCCAGCAGCCAAGATGGTTACCCGGGAGAGGGGACTGGGGCCAACGTCCTGACTTTC	CASSQDGYPGEGTGANVLTF	TRBV14	TRBJ2-6
TGCAGTGCTAAGCCCAGGGGGACCTACGAGCAGTACTTC	CSAKPRGTYEQYF	TRBV20-1	TRBJ2-7
TGTGCCAGCAGCTCGGCGCAGGCAACTAATGAAAAACTGTTTTTT	CASSSAQATNEKLFF	TRBV7-3	TRBJ1-4
TGTGCCAGCAGTTATCGCGGGTCCACTAGGCAGCCCCAGCATTTT	CASSYRGSTRQPQHF	TRBV6-2	TRBJ1-5
TGTGCCAGCACGCAATATGGCTACACCTTC	CASTQYGYTF	TRBV5-4	TRBJ1-2
TGTGCCAGCAGCTTACAACACGGGTCTAGCTCCTACGAGCAGTACTTC	CASSLQHGSSSYEQYF	TRBV7-2	TRBJ2-7
TGTGCCACCAGTGATTCCGGGACAGGCGAGGGTTCAAGCGGGGAGCTGTTTTTT	CATSDSGTGEGSSGELFF	TRBV24-1	TRBJ2-2
TGTGCCAGCCCTAGGGGAGGTGGCTACACCTTC	CASPRGGGYTF	TRBV25-1	TRBJ1-2
TGCAGTGTGCCAGGGACAGAAGCACATGACACTGAAGCTTTCTTT	CSVPGTEAHDTEAFF	TRBV20-1	TRBJ1-1
TGTGCCAGCAGCTTAGTAGTAAGGCCCGGGTGGGCCAACGTCCTGACTTTC	CASSLVVRPGWANVLTF	TRBV7-4	TRBJ2-6
TGCAGTGCTAGAGATCGTCTAATCTGGTATATTAGCTCTGGGGCCAACGTCCTGACTTTC	CSARDRLIWYISSGANVLTF	TRBV20-1	TRBJ2-6
TGTGCCAGCAACCCCCGCAGGGGGGGCTCTGGGGCCAACGTCCTGACTTTC	CASNPRRGGSGANVLTF	TRBV6-4	TRBJ2-6
TGTGCCAGCAGAGTCGGTCCGGACCGGGACAGTCTGTTTTCTAAAAACATTCAGTACTTC	CASRVGPDRDSLFSKNIQYF	TRBV7-3	TRBJ2-4
TGTGCCTCTGACTCCTACGAGCAGTACTTC	CASDSYEQYF	TRBV2	TRBJ2-7
TGCGCCAGCAGCCGACCGGACAGTGTTTACTATGGCTACACCTTC	CASSRPDSVYYGYTF	TRBV4-1	TRBJ1-2
TGCGCCAGCAGCAATGCAGACCTGGGACTAGCGGACAGTCCAGATACGCAGTATTTT	CASSNADLGLADSPDTQYF	TRBV5-1	TRBJ2-3
TGCGCCAGCAGCCTCAACAGGGTTAACTCTGGAAACACCATATATTTT	CASSLNRVNSGNTIYF	TRBV4-1	TRBJ1-3
TGTGCTAGCAGCTTACCGGCGGACAGGGGTCTTAGCTCCTACGAGCAGTACTTC	CASSLPADRGLSSYEQYF	TRBV7-7	TRBJ2-7
TGTGCCACACCGGGACAAGGGAGCCAGCATTTT	CATPGQGSQHF	TRBV19	TRBJ1-5
TGTGCCAGCCAGGCTCAGCCCCAGCATTTT	CASQAQPQHF	TRBV7-2	TRBJ1-5
TGTGCCAGCAAGGGGGGTTTCGACAGGGGCCTAGACTATAATTCACCCCTCCACTTT	CASKGGFDRGLDYNSPLHF	TRBV27	TRBJ1-6
TGTGCCAGCAGCGCTCAAGCCGGGACAGATCAGGTCGTTGCGAACAATGAGCAGTTCTTC	CASSAQAGTDQVVANNEQFF	TRBV9	TRBJ2-1
TGTGCCAGCAGCTACAGCCATCGGAGCTCCTACAATGAGCAGTTCTTC	CASSYSHRSSYNEQFF	TRBV7-2	TRBJ2-1
TGTGCCAGCAGCGACCGCACAGGGGTAGATAATTCACCCCTCCACTTT	CASSDRTGVDNSPLHF	TRBV13	TRBJ1-6
TGCAGTGCTAGGACAGGATCCGGCAACACCGGGGAGCTGTTTTTT	CSARTGSGNTGELFF	TRBV20-1	TRBJ2-2
TGTGCCAGCAGCAGTGCTAGCGGGCGTCTTAATGAGCAGTTCTTC	CASSSASGRLNEQFF	TRBV12-4	TRBJ2-1
TGTGCCAGCAGCTTAGACGAGAGGGGGGGGGCGGACGAGCAGTACTTC	CASSLDERGGADEQYF	TRBV11-2	TRBJ2-7
TGTGCCAGCAGTTACTCGAGCACGGGGAGGGAAGGTCAGCCCCAGCATTTT	CASSYSSTGREGQPQHF	TRBV6-5	TRBJ1-5
TGTGCCTGGAGTGTACCTCCAGGGGCCTACGAGCAGTACTTC	CAWSVPPGAYEQYF	TRBV30	TRBJ2-7
TGTGCCAGCAGTACTAGGGGGCTCTCCTACGAGCAGTACTTC	CASSTRGLSYEQYF	TRBV27	TRBJ2-7
TGTGCCAGCACAGGCTCTAATGGCTACACCTTC	CASTGSNGYTF	TRBV3-1	TRBJ1-2
TGCAGCGTCAGAAGTGTCTGGGAGGGCGACGAGACCCAGTACTTC	CSVRSVWEGDETQYF	TRBV29-1	TRBJ2-5
TGTGCCAGCAGCTTTTTTTGGCCCGGCCCCACTGAAGCTTTCTTT	CASSFFWPGPTEAFF	TRBV5-4	TRBJ1-1
TGTGCCGGGGGCCACTCTCGGCGGGCCTACGAGCAGTACTTC	CAGGHSRRAYEQYF	TRBV6-5	TRBJ2-7
TGTGCCAGCAGCTCAAAGCGGGACCAGCCCCAGCATTTT	CASSSKRDQPQHF	TRBV5-5	TRBJ1-5
TGCAGTGCTAGTTTTGCCACGACAGATGGCTACACCTTC	CSASFATTDGYTF	TRBV20-1	TRBJ1-2
TGTGCCAGTAGTATAGAAGTTCTCCGGGACAGGAAAACTCAGCCCCAGCATTTT	CASSIEVLRDRKTQPQHF	TRBV19	TRBJ1-5
TGCAGTCCCTGTTCCGGGAACGAGACCCAGTACTTC	CSPCSGNETQYF	TRBV20-1	TRBJ2-5
TGTGCCAGCAGCCGGGCAGAGCGGGAGCAGTACTTC	CASSRAEREQYF	TRBV7-2	TRBJ2-7
TGTGCCACCAGTGGAAACGGAGGTTCCTGGGGCATCTACGAGCAGTACTTC	CATSGNGGSWGIYEQYF	TRBV24-1	TRBJ2-7
TGTGCCAGCAGTTTTACCCCGGACAGCATCCGATGGAACGAGCAGTACTTC	CASSFTPDSIRWNEQYF	TRBV6-5	TRBJ2-7
TGTGCCAGCAGCGTCTCGGAGACCCAGTACTTC	CASSVSETQYF	TRBV6-1	TRBJ2-5
TGCAGTGCTCAAAGGTCAGTCAACCTCCCGTACGAGCAGTACTTC	CSAQRSVNLPYEQYF	TRBV20-1	TRBJ2-7
TGTGCCAGCAGCCTGCGGGAGGATTCCTACGAGCAGTACTTC	CASSLREDSYEQYF	TRBV7-6	TRBJ2-7
TGTGCCAGCAGCGTAGCAGGCGGCTCCTACGAGCAGTACTTC	CASSVAGGSYEQYF	TRBV9	TRBJ2-7
TGTGCCAGCAGCTCCCGCGACAGGGGAAGGATCTATGGCTACACCTTC	CASSSRDRGRIYGYTF	TRBV11-3	TRBJ1-2
TGTGCCAGCAGTGAAACTGGACAAGCCGGGGAGCTGTTTTTT	CASSETGQAGELFF	TRBV6-1	TRBJ2-2
TGCGCCAGGGACACCAGCTCCTACGAGCAGTACTTC	CARDTSSYEQYF	TRBV10-1	TRBJ2-7
TGTGCCACCCTGTATGGTCCGGGACTAGCGGGGGCCTACAATGAGCAGTTCTTC	CATLYGPGLAGAYNEQFF	TRBV15	TRBJ2-1
TGTGCCAGCAGCGAGGCTAGCGGCGAAGTTGAGCAGTTCTTC	CASSEASGEVEQFF	TRBV4-2	TRBJ2-1
TGTGCCAGCAGTGACCAGTGGGAGACCCAGTACTTC	CASSDQWETQYF	TRBV2	TRBJ2-5
TGTGCCAGCTCACCACCGGGAAGAAAGGGGGACTACGAGCAGTACTTC	CASSPPGRKGDYEQYF	TRBV18	TRBJ2-7
TGCGCAAATTGGGAGGTCACACGGGGGACTACCACCGGGGAGCTGTTTTTT	CANWEVTRGTTTGELFF	TRBV20-1	TRBJ2-2
TGTGCCAGCAATCTCGGGGGATCAGCTCAGGATACGCAGTATTTT	CASNLGGSAQDTQYF	TRBV28	TRBJ2-3
TGTGCCTGGAGCACCTCGGCGGAGCAGCCCCAGCATTTT	CAWSTSAEQPQHF	TRBV30	TRBJ1-5
TGTGCCAGTAGTATAGGGGACAGGGGGCCGCCCGGGCGACTAGCCAAAAACATTCAGTACTTC	CASSIGDRGPPGRLAKNIQYF	TRBV19	TRBJ2-4
TGCAGTGCATACCGGGACAGGGCTCGCATGTATTTT	CSAYRDRARMYF	TRBV20-1	TRBJ1-3
TGCAGTGCTAGAGATCTACTGAAGACAGGAGATGGCTACACCTTC	CSARDLLKTGDGYTF	TRBV20-1	TRBJ1-2
TGTGCCAGCAGCCGCCTTGACAATGAGCAGTTCTTC	CASSRLDNEQFF	TRBV7-2	TRBJ2-1
TGTGCCAGCAGTTTCCTGGGACTGGGCAGCACAGATACGCAGTATTTT	CASSFLGLGSTDTQYF	TRBV27	TRBJ2-3
TGTGCCAGCAGTTTTTCAAGACAGGGGGCTTATGACGAGCAGTACTTC	CASSFSRQGAYDEQYF	TRBV27	TRBJ2-7
TGTGCCAGCAGTGGCTGCGGACAGGAGGTGCGCACAGATACGCAGTATTTT	CASSGCGQEVRTDTQYF	TRBV2	TRBJ2-3
TGTGCCAGCAGCGGTGGGGGCCGAAATAGCAATCAGCCCCAGCATTTT	CASSGGGRNSNQPQHF	TRBV5-4	TRBJ1-5
TGCAGTGCTAGAGCCCGGGGCACAGATACGCAGTATTTT	CSARARGTDTQYF	TRBV20-1	TRBJ2-3
TGTGCCAGCAGCATTCACCGGGACTGGGGGAAAACAGATACGCAGTATTTT	CASSIHRDWGKTDTQYF	TRBV14	TRBJ2-3
TGCAGCGTTGAAGATCTCACCAGGGAGACCCAGTACTTC	CSVEDLTRETQYF	TRBV29-1	TRBJ2-5
TGTGCCAGCAGCTTCTGGGATAAAAACGAGCAGTACTTC	CASSFWDKNEQYF	TRBV9	TRBJ2-7
TGCAGTGCTAGTACACCCCGGGGTGGCTACACCTTC	CSASTPRGGYTF	TRBV20-1	TRBJ1-2
TGTGCCAGCAGTGGGACCGGGATTCAGCCCCAGCATTTT	CASSGTGIQPQHF	TRBV25-1	TRBJ1-5
TGTGCCAGCAGCTACGTAGTCTGGGATACGCAGTATTTT	CASSYVVWDTQYF	TRBV9	TRBJ2-3
TGTGCCAGCAGCACGGGGGCCGGTTTAGGCAATCAGCCCCAGCATTTT	CASSTGAGLGNQPQHF	TRBV7-3	TRBJ1-5
TGTGCCGGAGACAGGGGACCGGCTTTCTTT	CAGDRGPAFF	TRBV2	TRBJ1-1
TGTGCCAGCAGCGACAGGGTGGGTCGCGAGCAGTACTTC	CASSDRVGREQYF	TRBV6-1	TRBJ2-7
TGCGCCAGCAGCGGTCCGATCAGGCGCAGGGAGGCGCGAGACACCGGGGAGCTGTTTTTT	CASSGPIRRREARDTGELFF	TRBV5-1	TRBJ2-2
TGTGCCAGCAGTAGCCCACAGGGGGGCGCCAACTATGGCTACACCTTC	CASSSPQGGANYGYTF	TRBV13	TRBJ1-2
TGTGCTAGTGGTACCGGAAATGAGCAGTTCTTC	CASGTGNEQFF	TRBV12-5	TRBJ2-1
TGCAGTGCTAATCCAGCCACCTACGAGCAGTACTTC	CSANPATYEQYF	TRBV20-1	TRBJ2-7
TGTGCCAGTAGTTCGGCCAAGTCGGACAGGAGTCAGCCCCAGCATTTT	CASSSAKSDRSQPQHF	TRBV19	TRBJ1-5
TGCGCCAGCAGCATTGCAGCGAATTCAGATACGCAGTATTTT	CASSIAANSDTQYF	TRBV5-1	TRBJ2-3
TGTGCCAGCAGCTTGGGACCCCCAGGGGGTGTTATAGGGGAGGATAGCAATCAGCCCCAGCATTTT	CASSLGPPGGVIGEDSNQPQHF	TRBV7-8	TRBJ1-5
TGTGCCAGCAGCTTAGATCCTCGGGGAGAGCAGTACTTC	CASSLDPRGEQYF	TRBV11-2	TRBJ2-7
TGTGCCAGCAGCTCCCAGCTCGACTCCTACGAGCAGTACTTC	CASSSQLDSYEQYF	TRBV13	TRBJ2-7
TGTGCCAGCAGTGAAACGGCGACAGGGAGCTACGAGCAGTACTTC	CASSETATGSYEQYF	TRBV6-1	TRBJ2-7
TGTGCCAGGGAACCCGGGACAGGGTATTGTTTGGGCGAGCAGTACTTC	CAREPGTGYCLGEQYF	TRBV19	TRBJ2-7
TGCGCCAGCAGCGGCGGACGGGGGGCTAATGAAAAACTGTTTTTT	CASSGGRGANEKLFF	TRBV5-1	TRBJ1-4
TGTGCATCCTGCGGGAGGAGGTCCGGGGAGCTGTTTTTT	CASCGRRSGELFF	TRBV12-5	TRBJ2-2
TGTGCCAGCAGCTTGGTTTGGTGGGGTCCGGGACAGGGCACTGAAGCTTTCTTT	CASSLVWWGPGQGTEAFF	TRBV5-4	TRBJ1-1
TGTGCCATCAGATCTTGGACAGGAGGGGCCTACGAGCAGTACTTC	CAIRSWTGGAYEQYF	TRBV10-3	TRBJ2-7
TGTGCCAGCAGCCAAGTAAGGAGGGGTACGAATCAGCCCCAGCATTTT	CASSQVRRGTNQPQHF	TRBV14	TRBJ1-5
TGTGCCAGCATCCAAGGAATGAGCAATCAGCCCCAGCATTTT	CASIQGMSNQPQHF	TRBV6-2	TRBJ1-5
TGTGCCAGCAGCCCGGGTAGGTCCTACGAGCAGTACTTC	CASSPGRSYEQYF	TRBV13	TRBJ2-7
TGTGCCAGCAAAGGGGCAGCCTCCTACGAGCAGTACTTC	CASKGAASYEQYF	TRBV11-3	TRBJ2-7
TGTGCCTGGAGTGTACCGGATAGGTCCACTAATGAAAAACTGTTTTTT	CAWSVPDRSTNEKLFF	TRBV30	TRBJ1-4
TGTGCCACCAGTGATCGAGAGGGAACGACCCAGTACTTC	CATSDREGTTQYF	TRBV24-1	TRBJ2-5
TGTGCCAGCAGCACTAGCGGGAGTGTATATAATTCACCCCTCCACTTT	CASSTSGSVYNSPLHF	TRBV7-9	TRBJ1-6
TGTGCCTACTCGTGGAGCTTGGTCTGGAGGGACCAAGAGACCCAGTACTTC	CAYSWSLVWRDQETQYF	TRBV9	TRBJ2-5
TGCGCCAGCAGCGAACCGGGACAGGGGGGAACGTCTGGCAATCAGCCCCAGCATTTT	CASSEPGQGGTSGNQPQHF	TRBV5-1	TRBJ1-5
TGCGCCAGCAGCCATAGTGTAAGCACAGATACGCAGTATTTT	CASSHSVSTDTQYF	TRBV4-3	TRBJ2-3
TGCAGTGTCGCGGGAGAATTAGAGACCCAGTACTTC	CSVAGELETQYF	TRBV20-1	TRBJ2-5
TGTGCCAGCAGACTAGACAGGGGGTTAAGCAATCAGCCCCAGCATTTT	CASRLDRGLSNQPQHF	TRBV27	TRBJ1-5
TGTGCCGATAACGGGGGTATTCCCACAGATACGCAGTATTTT	CADNGGIPTDTQYF	TRBV24-1	TRBJ2-3
TGTGCCAGCCGAGACAGGGGGGGAGATCAGCCCCAGCATTTT	CASRDRGGDQPQHF	TRBV6-4	TRBJ1-5
TGCGCCAGCAGCTTGAAGGAGATCAAGTCCTACGAGCAGTACTTC	CASSLKEIKSYEQYF	TRBV5-1	TRBJ2-7
TGTGCCAGTCGTATTTTAGTGGACAGGGCGGAGAGGGACTCCTACGAGCAGTACTTC	CASRILVDRAERDSYEQYF	TRBV19	TRBJ2-7
TGTGCCAGCAGCTTATCTTTCGGACTAGTCGATCACACCGGGGAGCTGTTTTTT	CASSLSFGLVDHTGELFF	TRBV11-3	TRBJ2-2
TGCAGTGCTTGGACAGGGGATACGCAGTATTTT	CSAWTGDTQYF	TRBV20-1	TRBJ2-3
TGTGCCACCAGTGGGAGGAATCAGCCCCAGCATTTT	CATSGRNQPQHF	TRBV24-1	TRBJ1-5
TGTGCCAGCCGTGGACAGACCGCAGACTACACCTTC	CASRGQTADYTF	TRBV7-9	TRBJ1-2
TGTGCCAGCAGTAGGGGGGAAAAGTACGAGCAGTACTTC	CASSRGEKYEQYF	TRBV27	TRBJ2-7
TGTGCCAGCAGCCAAACCCACAGGGCATTGGTATCTGGGGCCAACGTCCTGACTTTC	CASSQTHRALVSGANVLTF	TRBV3-1	TRBJ2-6
TGTGCCACCAGCGGGCTTTGTAGCGGGGCGGCCGATGAGCAGTTCTTC	CATSGLCSGAADEQFF	TRBV15	TRBJ2-1
TGCGCCAGCAGTGAGGGCCTAAGGCGGACCGGGGAGCTGTTTTTT	CASSEGLRRTGELFF	TRBV10-1	TRBJ2-2
TGTGCCAGCAGCTTCATAGGGTCATTCTCCTACGAGCAGTACTTC	CASSFIGSFSYEQYF	TRBV7-2	TRBJ2-7
TGTGCCACCTTGACAGGTCCCAATCAGCCCCAGCATTTT	CATLTGPNQPQHF	TRBV24-1	TRBJ1-5
TGTGCCAGCAGCTTTTGGCGATGGACTGAAGCTTTCTTT	CASSFWRWTEAFF	TRBV11-2	TRBJ1-1
TGTGCCTGGAGTAGGGACAGGGTCCCCCGCAATCAGCCCCAGCATTTT	CAWSRDRVPRNQPQHF	TRBV30	TRBJ1-5
TGTGCCAGCAGCTTCGACAGGGATAAGGGAAACACCATATATTTT	CASSFDRDKGNTIYF	TRBV7-3	TRBJ1-3
TGTGCTAGTGGTTTGTCTAGCGGGAGCCCCCTGAAATACAATGAGCAGTTCTTC	CASGLSSGSPLKYNEQFF	TRBV12-5	TRBJ2-1
TGTGCCAGCAGGAAACAGGGCGGCGACTCTGGGGCCAACGTCCTGACTTTC	CASRKQGGDSGANVLTF	TRBV28	TRBJ2-6
TGTGCCAGGATTCGGGCCTCGGGAGTCTACGAGCAGTACTTC	CARIRASGVYEQYF	TRBV27	TRBJ2-7
TGTGCCAGCAGTTTACAGGAAGGGGGCTTCTATGGCTACACCTTC	CASSLQEGGFYGYTF	TRBV27	TRBJ1-2
TGCGCCAGCAGCGGAAGACCGCCTCGACTTGGGGTCGAGCAGTACTTC	CASSGRPPRLGVEQYF	TRBV5-1	TRBJ2-7
TGTGCCACCAGTCCCGGACTAGACGCAGATACGCAGTATTTT	CATSPGLDADTQYF	TRBV24-1	TRBJ2-3
TGCGCCAGCAGCCAAGATACGGGTCCCTACGAGCAGTACTTC	CASSQDTGPYEQYF	TRBV4-1	TRBJ2-7
TGTGCCAGCAGTGTCCAACAGGCCTATGGCTACACCTTC	CASSVQQAYGYTF	TRBV6-4	TRBJ1-2
TGCGCCAGCCGGGAGCAGTTCTTC	CASREQFF	TRBV10-1	TRBJ2-1
TGTGCCAGCTCACCTCCCGGGGCGGACAATCAGCCCCAGCATTTT	CASSPPGADNQPQHF	TRBV18	TRBJ1-5
TGCAGCAATACACGGATGCCTAGCGGGCACAACCAGTACTTC	CSNTRMPSGHNQYF	TRBV29-1	TRBJ2-7
TGTGCCAGCAGGGATAGGGGCTCTGGAAACACCATATATTTT	CASRDRGSGNTIYF	TRBV6-5	TRBJ1-3
TGTGCCAGCAGCTTAACATTGGTCATCAGGCTTGTTCAAAACAAGGAAGCTTTCTTT	CASSLTLVIRLVQNKEAFF	TRBV7-3	TRBJ1-1
TGCGCCAGCACTACCAGGGGAGAGCAGTACTTC	CASTTRGEQYF	TRBV10-1	TRBJ2-7
TGCGCCAGCAGTGAGGCGCTTCGACAGCGAAGTTGCTACACCTTC	CASSEALRQRSCYTF	TRBV10-1	TRBJ1-2
TGTGCCAGCAGCAGTAATAAGGCGGCCTGCCTTCTCCAAGAGACCCAGTACTTC	CASSSNKAACLLQETQYF	TRBV13	TRBJ2-5
TGTGCCAGTAAATCCGCCCCGGGACTAGCGGGCGCGTCCGATACGCAGTATTTT	CASKSAPGLAGASDTQYF	TRBV19	TRBJ2-3
TGTGCCAGCACCCGACCTAACACCGGGGAGCTGTTTTTT	CASTRPNTGELFF	TRBV2	TRBJ2-2
TGTGCCAGCAGCTGCATCCCCTCCCGGTATGAGCAGTTCTTC	CASSCIPSRYEQFF	TRBV7-9	TRBJ2-1
TGTGCCAGCAGTGGGACTAGACATAAAGCGCGGGGGGAGACCCAGTACTTC	CASSGTRHKARGETQYF	TRBV6-4	TRBJ2-5
TGTGCCAGCAGCCAAGGTGAGCGGGGGGGCAGGGTCAATGAGCAGTTCTTC	CASSQGERGGRVNEQFF	TRBV4-2	TRBJ2-1
TGTGCCATCAGTGTGGACCTAGCGGGAAGCCCCTACGAGCAGTACTTC	CAISVDLAGSPYEQYF	TRBV10-3	TRBJ2-7
TGTGCCAGCAGCCATGGACAGGGGGACAATGAGCAGTTCTTC	CASSHGQGDNEQFF	TRBV5-6	TRBJ2-1
TGCAGTGCTGCTAGTTGCCGGTGCACCGGGGAGCTGTTTTTT	CSAASCRCTGELFF	TRBV20-1	TRBJ2-2
TGTGCCAGCAGCTTGAACTGGGGGAGCTCCTACAATGAGCAGTTCTTC	CASSLNWGSSYNEQFF	TRBV5-5	TRBJ2-1
TGTGCCAGCAGCGCCCCTAACACCATATATTTT	CASSAPNTIYF	TRBV7-4	TRBJ1-3
TGTGCCAGCAGGTCTAAGGGGACCCGGGACAGCTGCTATGGCTACACCTTC	CASRSKGTRDSCYGYTF	TRBV27	TRBJ1-2
TGTGCCAGCATTTTATTGTTTTTCAAAACAACTGAGCAGTACTTC	CASILLFFKTTEQYF	TRBV6-5	TRBJ2-7
TGTGCCAGCAGTGACTCGAAGGGGCTTGGTCACCAGCCCCAGCATTTT	CASSDSKGLGHQPQHF	TRBV6-4	TRBJ1-5
TGTGCCAGCAGTGAAAGACTAGAGCAGTTCTTC	CASSERLEQFF	TRBV2	TRBJ2-1
TGCGCCAGCAGCTTGTTAAGGTACAAACTGCAGGGTATCTACCGACCCGAGCAGTACTTC	CASSLLRYKLQGIYRPEQYF	TRBV5-1	TRBJ2-7
TGTGCCAGCCCAGGGCGGGAGTTCACGTCCTACGAGCAGTACTTC	CASPGREFTSYEQYF	TRBV7-3	TRBJ2-7
TGCGCCAGCACGTGCTGCGGACAGGGGTCTCTCACAGATACGCAGTATTTT	CASTCCGQGSLTDTQYF	TRBV10-1	TRBJ2-3
TGTGCCAAGGGGCCTGATACGCAGTATTTT	CAKGPDTQYF	TRBV7-9	TRBJ2-3
TGCGCCAGCAGCGGGGGGAGATTGGGAAACACTGAAGCTTTCTTT	CASSGGRLGNTEAFF	TRBV5-1	TRBJ1-1
TGTGCCAGCAGTGGCCGAGTAGGGGGGAACACTGAAGCTTTCTTT	CASSGRVGGNTEAFF	TRBV6-3	TRBJ1-1
TGTGCCACCAGTGATCGACTAGCGGGGGGCACAGATACGCAGTATTTT	CATSDRLAGGTDTQYF	TRBV24-1	TRBJ2-3
TGTGCCAGCAGTACGAGCGGCACCCAGGGAGATACGCAGTATTTT	CASSTSGTQGDTQYF	TRBV6-3	TRBJ2-3
TGTGCCAGCAGCTGCCCCAACTGGGGCCCCAAATTACTAGCCCCCAAAGAGACCCAGTACTTC	CASSCPNWGPKLLAPKETQYF	TRBV5-6	TRBJ2-5
TGTGCCAGCAGCTTGGCTGGACAGACAGGGTCCTACGAGCAGTACTTC	CASSLAGQTGSYEQYF	TRBV5-6	TRBJ2-7
TGTGCCAGCAGCCAAGCAGGTAGACAGGGGGGAAGCATAACCCGGCCCCAGCATTTT	CASSQAGRQGGSITRPQHF	TRBV3-1	TRBJ1-5
TGTGCCAGCGTCGGACGTAAGGGCTACACCTTC	CASVGRKGYTF	TRBV7-3	TRBJ1-2
TGTGCCAGCAGCTGGTGGAATGGGACAGCGAGCTACGAGCAGTACTTC	CASSWWNGTASYEQYF	TRBV11-2	TRBJ2-7
TGTGCCAGCAGTTCGGTTTGGACCCGCGAGTCCTACAATGAGCAGTTCTTC	CASSSVWTRESYNEQFF	TRBV6-2	TRBJ2-1
TGCAGCGTTGAGACAGACTATGGCTACACCTTC	CSVETDYGYTF	TRBV29-1	TRBJ1-2
TGTGCCAGCAGGGGAGCTATTATGGGGAGTAGCAATCAGCCCCAGCATTTT	CASRGAIMGSSNQPQHF	TRBV12-3	TRBJ1-5
TGTGCCAGCAGCCCACTAAGACTAGGGGCAGATACGCAGTATTTT	CASSPLRLGADTQYF	TRBV9	TRBJ2-3
TGTGCTAGTGGTTTGGTTAAATGGGGGGCTAGTACGCAGTATTTT	CASGLVKWGASTQYF	TRBV12-5	TRBJ2-3
TGTGCCAGCAGGAAAACAGGGGGGGGGAACACTGAAGCTTTCTTT	CASRKTGGGNTEAFF	TRBV9	TRBJ1-1
TGCAGTGCTAGAGAAACAGGGGGAGTAAGGAATAATTCACCCCTCCACTTT	CSARETGGVRNNSPLHF	TRBV20-1	TRBJ1-6
TGTGCCACCAGTGAGTCCCAGGGAAAAGTCCCGCCTGCTGATTCACCCCTCCACTTT	CATSESQGKVPPADSPLHF	TRBV24-1	TRBJ1-6
TGTGCCAGCCTGCCCTCTAGCAATGAAAAACTGTTTTTT	CASLPSSNEKLFF	TRBV9	TRBJ1-4
TGCGCCAGCAGCGGAGACGTTCTAGCGTATACTCAAGAGACCCAGTACTTC	CASSGDVLAYTQETQYF	TRBV5-1	TRBJ2-5
TGCGCCAGCAGCTTGGGTAGACAGGGCCTGCGTGGCTACACCTTC	CASSLGRQGLRGYTF	TRBV5-1	TRBJ1-2
TGCGCCAGCAGCCGGTATCGGCGCGGGAGCGAGACCCAGTACTTC	CASSRYRRGSETQYF	TRBV4-3	TRBJ2-5
TGTGCCAGCAGCAGGACAGGGGGACGCTGCACTAATGAAAAACTGTTTTTT	CASSRTGGRCTNEKLFF	TRBV7-9	TRBJ1-4
TGTGCCAGCAGTGAAGCGCTTGATGGGTCCCACGTGGGACAGCCCTCTGGAAACACCATATATTTT	CASSEALDGSHVGQPSGNTIYF	TRBV6-1	TRBJ1-3
TGTGCCAGCAGCCAAATCCGACAGGTTCGAAGTCCTCCGTCCGGGGAGCTGTTTTTT	CASSQIRQVRSPPSGELFF	TRBV3-1	TRBJ2-2
TGTGCCAATTCTTCCCGGGACAGGGAGGGATCTGGGGCCAACGTCCTGACTTTC	CANSSRDREGSGANVLTF	TRBV6-5	TRBJ2-6
TGTGCCAGCAGCCAAAAAAGGGGGGGGGCAGGTAACGAGCAGTACTTC	CASSQKRGGAGNEQYF	TRBV6-4	TRBJ2-7
TGTGCCAGCAGCTTTACTGTGGGGGGAGGAAATGAAAAACTGTTTTTT	CASSFTVGGGNEKLFF	TRBV7-2	TRBJ1-4
TGTGCCAGCATCTCGGGGATCCTTAATGAAAAACTGTTTTTT	CASISGILNEKLFF	TRBV27	TRBJ1-4
TGCGCCAGCAGTGACCCGTACGGACTAATAGAGGTTCATCTCTTGCAGTTCTTC	CASSDPYGLIEVHLLQFF	TRBV10-1	TRBJ2-1
TGTGCCAGCAGCGCAGCCCGGGACCCTGACAGTGAGCAGTTCTTC	CASSAARDPDSEQFF	TRBV5-4	TRBJ2-1
TGCGCCAGCAGACCTGGGACCTTTTACAATGAGCAGTTCTTC	CASRPGTFYNEQFF	TRBV5-1	TRBJ2-1
TGTGCCAGCAGGGTACCTGACAGGGGGTTTAACGGTGAGACCCAGTACTTC	CASRVPDRGFNGETQYF	TRBV6-6	TRBJ2-5
TGTGCCAGTAGTACTAGCAGGTCCACAGATACGCAGTATTTT	CASSTSRSTDTQYF	TRBV19	TRBJ2-3
TGTGCCAGCAGCGTCAGGGGAGGGCTCGAGCAGTACTTC	CASSVRGGLEQYF	TRBV9	TRBJ2-7
TGCGCCAGCAGTGTTCCACCCGGCAATACGCAGTATTTT	CASSVPPGNTQYF	TRBV5-1	TRBJ2-3
TGTGCTAGTGGTTTGGTACACGGGGGGATGGACAATGAGCAGTTCTTC	CASGLVHGGMDNEQFF	TRBV12-5	TRBJ2-1
TGTGCCAGCAGGGGCGGGGAGGACTACGAGCAGTACTTC	CASRGGEDYEQYF	TRBV7-2	TRBJ2-7
TGTGCCTGCAGGGACAGGGGAAATAACTATGGCTACACCTTC	CACRDRGNNYGYTF	TRBV30	TRBJ1-2
TGCGCCAGCAAAGGCTCAGGGTTGTGGTATGAAAAACTGTTTTTT	CASKGSGLWYEKLFF	TRBV5-1	TRBJ1-4
TGTGCCCCTCCACATCAGAGGGGGTGCAATGAGCAGTTCTTC	CAPPHQRGCNEQFF	TRBV9	TRBJ2-1
TGTGCCAGCAGTTTACGGGGGGGGCTCCGCACCGGGGAGCTGTTTTTT	CASSLRGGLRTGELFF	TRBV6-3	TRBJ2-2
TGCAGTGCTAGAGATCGGCGGGTTGCCAAAAACATTCAGTACTTC	CSARDRRVAKNIQYF	TRBV20-1	TRBJ2-4
TGTGCCAGCAGCCAAGAAAGGGTAGACTATAATGAAAAACTGTTTTTT	CASSQERVDYNEKLFF	TRBV3-1	TRBJ1-4
TGTGCCAGCGGGGGCGGTGACCCTGAAGCTTTCTTT	CASGGGDPEAFF	TRBV6-5	TRBJ1-1
TGTGCCAGCAGTGATCGACAGAATCGGAATGGCTACACCTTC	CASSDRQNRNGYTF	TRBV2	TRBJ1-2
TGTGCCAGTAGTCTCTCGGGGGGGTGCTACGAGCAGTACTTC	CASSLSGGCYEQYF	TRBV19	TRBJ2-7
TGTGCCAGCAGTTACCTAGCCGGGACAGGAGAACGATATTCACCCCTCCACTTT	CASSYLAGTGERYSPLHF	TRBV6-3	TRBJ1-6
TGCAGTGCTAGAGCTGGTCCACCGTTCAGGGATACGCAGTATTTT	CSARAGPPFRDTQYF	TRBV20-1	TRBJ2-3
TGTGCCCGTATAAAAATCTCTGGAAACACCATATATTTT	CARIKISGNTIYF	TRBV11-2	TRBJ1-3
TGTGCCAGCAGTGTCTTGGTTAGAGGAGAGCAGTACTTC	CASSVLVRGEQYF	TRBV28	TRBJ2-7
TGCGCCAGCAGTGAGGGGGACAGGCCCTACAATGAGCAGTTCTTC	CASSEGDRPYNEQFF	TRBV10-1	TRBJ2-1
TGTGCCAGCAGCTTCTCCCTTTCGGGGGCCGAGACAGATACGCAGTATTTT	CASSFSLSGAETDTQYF	TRBV5-6	TRBJ2-3
TGTGCCACCAGTGGGGCCATTGCCGGGACCGGAGCCAAAAACATTCAGTACTTC	CATSGAIAGTGAKNIQYF	TRBV24-1	TRBJ2-4
TGCAGTGCTTCTACCGGACAGGGCTACGAGCAGTACTTC	CSASTGQGYEQYF	TRBV20-1	TRBJ2-7
TGCGCCAGCAGCTGGGGGACATGTGAAGCTTTCTTT	CASSWGTCEAFF	TRBV5-1	TRBJ1-1
TGTGCCAGCACCATGCTGAAATACCATGAAAAACTGTTTTTT	CASTMLKYHEKLFF	TRBV27	TRBJ1-4
TGTGCCAGCAGTTTACCTACAGGGGGAAAATCTGAGCAGTTCTTC	CASSLPTGGKSEQFF	TRBV27	TRBJ2-1
TGTGCCAGCAGCTTTGGGGTAGGGGGGAGGTACGACGAGCAGTACTTC	CASSFGVGGRYDEQYF	TRBV7-2	TRBJ2-7
TGTGCCAGCAGCAAGGGTTCTAGCGGGTCCGCCCAGTACTTC	CASSKGSSGSAQYF	TRBV5-6	TRBJ2-5
TGCGCCAGCAAACTTGGAGGAAATCAGCCCCAGCATTTT	CASKLGGNQPQHF	TRBV10-2	TRBJ1-5
TGTGCCACCAGTGAACGTCGGGGCAGATCCAATATTGAGACCCAGTACTTC	CATSERRGRSNIETQYF	TRBV24-1	TRBJ2-5
TGTGCCAGCAGTTGTTTAGGCCCTATCACTGAAGCTTTCTTT	CASSCLGPITEAFF	TRBV27	TRBJ1-1
TGTGCCAGCAATGTACTAGCGGGAGGTATGGGGAACACTGAAGCTTTCTTT	CASNVLAGGMGNTEAFF	TRBV6-6	TRBJ1-1
TGTGGTCCCCCTTGGGGTTGGGGAAACACCATATATTTT	CGPPWGWGNTIYF	TRBV28	TRBJ1-3
TGCAGCGTTGGCCAAAGGATCCCGGCGGTAGCCAACGAGCAGTACTTC	CSVGQRIPAVANEQYF	TRBV29-1	TRBJ2-7
TGTGCCAGCAGCTTAGTCAGAGCCGGGACTAGCGGAACGAACACCGGGGAGCTGTTTTTT	CASSLVRAGTSGTNTGELFF	TRBV7-9	TRBJ2-2
TGCGCCAGCAGCTTCATCCTAATACGCTACGAGCAGTACTTC	CASSFILIRYEQYF	TRBV5-1	TRBJ2-7
TGTGCCAGTAGTATCCCAACTTCGGGACATGGGGGAGCGCGAAACACTGAAGCTTTCTTT	CASSIPTSGHGGARNTEAFF	TRBV19	TRBJ1-1
TGTGCCAGCAGTTTAAGAACAGGCGGCGTTGATACGCAGTATTTT	CASSLRTGGVDTQYF	TRBV27	TRBJ2-3
TGTGCCAGCGACCTCCAGAGTTTCACCATATATTTT	CASDLQSFTIYF	TRBV6-1	TRBJ1-3
TGTGCCAGCAGTTACCTAACCCGGGACAGGGGGTACAATGAGCAGTTCTTC	CASSYLTRDRGYNEQFF	TRBV6-5	TRBJ2-1
TGTGCCAGCTCACCATATAGGGTAAGGGACAGTTCACCCCTCCACTTT	CASSPYRVRDSSPLHF	TRBV18	TRBJ1-6
TGTGCCAGCAGCAATCCGTACGGGGCCTACAATGAGCAGTTCTTC	CASSNPYGAYNEQFF	TRBV5-6	TRBJ2-1
TGCAGTGCAGTATCGATAAGTGACAGACGAAACACCATATATTTT	CSAVSISDRRNTIYF	TRBV20-1	TRBJ1-3
TGCGCCAATATAGGACGCACCTACGAGCAGTACTTC	CANIGRTYEQYF	TRBV5-1	TRBJ2-7
TGTGCCAGCAGCTTCCAGCTCAGCAGGGGCAAGAACACCGGGGAGCTGTTTTTT	CASSFQLSRGKNTGELFF	TRBV7-2	TRBJ2-2
TGTGCCAGCAGTTCTGGGGCAGGGGTAAGCAGGGGCCGAGTAATGGGGAATGAGCAGTTCTTC	CASSSGAGVSRGRVMGNEQFF	TRBV27	TRBJ2-1
TGTGCCAGCAGCCTCAAGGGCTCCTACGAGCAGTACTTC	CASSLKGSYEQYF	TRBV14	TRBJ2-7
TGTGCCAGCAGCTTAAAAAAACCGGGACAGAAGGAGCCAACTAATGAAAAACTGTTTTTT	CASSLKKPGQKEPTNEKLFF	TRBV11-3	TRBJ1-4
TGCAGTGCTGGATCAAAAACAGATAAGAGGCAGCCCCAGCATTTT	CSAGSKTDKRQPQHF	TRBV20-1	TRBJ1-5
TGTGCCAGCAGTAACTCGGGGTCGAACACCGGGGAGCTGTTTTTT	CASSNSGSNTGELFF	TRBV6-5	TRBJ2-2
TGTGCCAGCAGCTATCGCGGGAGGGAGCCAGCTGATGAAAAACTGTTTTTT	CASSYRGREPADEKLFF	TRBV7-2	TRBJ1-4
TGTGCCAGCAGTCTCCTTGGGGAGCTCTCTCAGCCCCAGCATTTT	CASSLLGELSQPQHF	TRBV28	TRBJ1-5
TGTGCCAGCAGTTGGTCGGGGCAGAGCTCCTACAATGAGCAGTTCTTC	CASSWSGQSSYNEQFF	TRBV25-1	TRBJ2-1
TGCAGCGTTTTATTGGACATGAACACCGGGGAGCTGTTTTTT	CSVLLDMNTGELFF	TRBV29-1	TRBJ2-2
TGTGGACTAGCGGGAGATACGCAGTATTTT	CGLAGDTQYF	TRBV9	TRBJ2-3
TGTGCCAGCTCACCACTATTCGGGGCTCTAGCGGGGGGGCCGGGCACAGATACGCAGTATTTT	CASSPLFGALAGGPGTDTQYF	TRBV18	TRBJ2-3
TGCAGTGCTAGAGATCGGGGAGTCTGCAGTACTGAAGCTTTCTTT	CSARDRGVCSTEAFF	TRBV20-1	TRBJ1-1
TGTGCCCCTGGTTTAAGGATACTAGCCAAAAACATTCAGTACTTC	CAPGLRILAKNIQYF	TRBV10-3	TRBJ2-4
TGCGCCAGCAGCCCGCTACGTCGTGCCGGGACAGGGGAGACCCAGTACTTC	CASSPLRRAGTGETQYF	TRBV4-1	TRBJ2-5
TGTGCCAGCAGTTTAACAGGGGAAAAAACTGAAGCTTTCTTT	CASSLTGEKTEAFF	TRBV28	TRBJ1-1
TGCAGCGGTTACCGGACTAGCGGGAGATATGAGCAGTTCTTC	CSGYRTSGRYEQFF	TRBV29-1	TRBJ2-1
TGTGCCAGCAGCACGGAGGGGCCGGGACAGGGGCCCCGGAAGGAACCCTCCTACGAGCAGTACTTC	CASSTEGPGQGPRKEPSYEQYF	TRBV5-6	TRBJ2-7
TGTGCCACCAGTTCAGGAGGGGAGACAGATACGCAGTATTTT	CATSSGGETDTQYF	TRBV24-1	TRBJ2-3
TGTGCCACCAGTGTCACCCGGACGAAAGTTAGCTCCTATAATTCACCCCTCCACTTT	CATSVTRTKVSSYNSPLHF	TRBV24-1	TRBJ1-6
TGTGCCAGCAGCAGACCAGAAGGGGCTTCCTACGAGCAGTACTTC	CASSRPEGASYEQYF	TRBV3-1	TRBJ2-7
TGTGCCAGGGTAGCAGTCCTGGGCTACACCTTC	CARVAVLGYTF	TRBV19	TRBJ1-2
TGCGCCAGCAGCGGACTGTGTTGGCCCCAGCATTTT	CASSGLCWPQHF	TRBV5-1	TRBJ1-5
TGTGCCAGCAGCGCCGAGCGGAGCCGCTACACTGAAGCTTTCTTT	CASSAERSRYTEAFF	TRBV7-3	TRBJ1-1
TGCAGTGCTAGAGTACTCGGACCCGATGGTCGGGTGTTTACGGGACAGTCTGGTTCCACTGAAGCTTTCTTT	CSARVLGPDGRVFTGQSGSTEAFF	TRBV20-1	TRBJ1-1
TGTGCCAGCAATACCCCCAGGGTACCAGATACGCAGTATTTT	CASNTPRVPDTQYF	TRBV28	TRBJ2-3
TGTGCCAGCTCACAAACAGGGCGGGGTGGAAACACCATATATTTT	CASSQTGRGGNTIYF	TRBV18	TRBJ1-3
TGTGCCAGCAGCTTGGCGGCCCATGGCTACGAGCAGTACTTC	CASSLAAHGYEQYF	TRBV7-9	TRBJ2-7
TGTGCCAGCAGGGGGGTTGGGCTGAACACTGAAGCTTTCTTT	CASRGVGLNTEAFF	TRBV27	TRBJ1-1
TGTGCCAGCAGGCCATTAGGGGCCGGCTACACCTTC	CASRPLGAGYTF	TRBV28	TRBJ1-2
TGTGCCAGCAGCATTAGCGGGAACAATCAGCCCCAGCATTTT	CASSISGNNQPQHF	TRBV9	TRBJ1-5
TGTGCCAGCAGCCAAGAACAGGGCTTCTACGAGCAGTACTTC	CASSQEQGFYEQYF	TRBV3-1	TRBJ2-7
