TGTGCCAGCACGGGACAGGGGGTAGCAGATACGCAGTATTTT	CASTGQGVADTQYF	TRBV5-4	TRBJ2-3
TGCGCCAGCTTCGGGACAGGGGAGGGAAACACCATATATTTT	CASFGTGEGNTIYF	TRBV10-2	TRBJ1-3
TGTGCCAGCAGTGAACCCTGGCAAAGCCCCGCAGGGACACAGATAGCTTTCTTT	CASSEPWQSPAGTQIAFF	TRBV25-1	TRBJ1-1
TGTGCCAGCAGCAAATACGGTCAAACCTACGAGCAGTACTTC	CASSKYGQTYEQYF	TRBV7-3	TRBJ2-7
TGTGCCACCCCGGGACAGGGAGTTCATGGCTACACCTTC	CATPGQGVHGYTF	TRBV6-2	TRBJ1-2
TGTGCCAGCGGAGCAATTCTAGCGGGATGTAGCTACGAGCAGTACTTC	CASGAILAGCSYEQYF	TRBV7-3	TRBJ2-7
TGTGCCAGCAGAAAGAGGGAAAGGGGCTACACCTTC	CASRKRERGYTF	TRBV11-2	TRBJ1-2
TGCGCCAGCAGTGAGTCGAGACAGGCACCGGATAATTCACCCCTCCACTTT	CASSESRQAPDNSPLHF	TRBV10-1	TRBJ1-6
TGTGCCAGCAGTCGACGGTTTCGGGCCACAGATACGCAGTATTTT	CASSRRFRATDTQYF	TRBV27	TRBJ2-3
TGTGCCAGCAGTGACTCTATTCCCCACTGGGGGGTATTCGGCTACACCTTC	CASSDSIPHWGVFGYTF	TRBV6-4	TRBJ1-2
TGTGCGCCTGTTTGTTTTAATTTCAATCAGCCCCAGCATTTT	CAPVCFNFNQPQHF	TRBV7-3	TRBJ1-5
TGTGCCAGCGTCGGGAGCTCCTACGAGCAGTACTTC	CASVGSSYEQYF	TRBV27	TRBJ2-7
TGTGCCAGCAGTGACTCACTACGGCCTGAACCCCGTTTAGGGTACCAAGAGACCCAGTACTTC	CASSDSLRPEPRLGYQETQYF	TRBV6-4	TRBJ2-5
TGTGCTAGCAGCTCTGCCAGGGGCCCTCAATGCTACGAGCAGTACTTC	CASSSARGPQCYEQYF	TRBV7-7	TRBJ2-7
TGTGCCAGCGGCCCCTATCCGGGACAACTGACCAATCAGCCCCAGCATTTT	CASGPYPGQLTNQPQHF	TRBV12-3	TRBJ1-5
TGTGCCAGCAGAAGACGAAGAACTAGCGGGAGCTACGAGCAGTACTTC	CASRRRRTSGSYEQYF	TRBV6-5	TRBJ2-7
TGTGCCACCAGTGTTCCCGGAGGACCGGACGAGCAGTACTTC	CATSVPGGPDEQYF	TRBV24-1	TRBJ2-7
TGCGCCAGCAGCCAAGATGTGGCGTTCGATAATGGCTACACCTTC	CASSQDVAFDNGYTF	TRBV4-3	TRBJ1-2
TGTGCCAGCAGGATCCCGGGACTCCCCTATGGCTACACCTTC	CASRIPGLPYGYTF	TRBV6-4	TRBJ1-2
TGCAGCGTTGACCCCGAGCACTCCTACGAGCAGTACTTC	CSVDPEHSYEQYF	TRBV29-1	TRBJ2-7
TGTGCCAGCAGTGAAGCAGGGACAGGGGGCTCGCTTGGGGATCAGCCCCAGCATTTT	CASSEAGTGGSLGDQPQHF	TRBV2	TRBJ1-5
TGTGCCAGCAGCGGTATGACTAGCGCGGCCAATGAGCAGTTCTTC	CASSGMTSAANEQFF	TRBV9	TRBJ2-1
TGTGCCAGCAGCTTAAGGTTAGAACTGGATGGGGTCCGGGACATCGGTAGCAATCAGCCCCAGCATTTT	CASSLRLELDGVRDIGSNQPQHF	TRBV7-2	TRBJ1-5
TGCAGTGCTAGAGGCGGGGACGAGCAGTACTTC	CSARGGDEQYF	TRBV20-1	TRBJ2-7
TGCAGTGCTAGAGTTCCGGGACAGGGCTTACGGAAGAAAGCTAACTATGGCTACACCTTC	CSARVPGQGLRKKANYGYTF	TRBV20-1	TRBJ1-2
TGCAGTTATCAGCCCCGGGGGAAAGGGAACTATGGCTACACCTTC	CSYQPRGKGNYGYTF	TRBV20-1	TRBJ1-2
TGCAGTGCTAGGACAAACATCAGGGGAACGGGCTACACCTTC	CSARTNIRGTGYTF	TRBV20-1	TRBJ1-2
TGTGCCAGCAGCGATCGGACTAGCGGGAGAAAAGAGACCCAGTACTTC	CASSDRTSGRKETQYF	TRBV5-4	TRBJ2-5
TGCGCCAGCAGCTCTGGGGCCGGGCATCGTACTTACTCCTATAATTCACCCCTCCACTTT	CASSSGAGHRTYSYNSPLHF	TRBV5-1	TRBJ1-6
TGTGCCAGCAGCGGGGCCCAGGGTACTGGGACCGGCGAGCAGTACTTC	CASSGAQGTGTGEQYF	TRBV7-8	TRBJ2-7
TGTGCCAGCAGCTTAGGGAGGGGGAGTCATGGCTACACCTTC	CASSLGRGSHGYTF	TRBV11-2	TRBJ1-2
TGTGCCAGCAGCCAAGGACAGGGGAGGACAAATCAGCCCCAGCATTTT	CASSQGQGRTNQPQHF	TRBV3-1	TRBJ1-5
TGTGCCAGCAGTTACCCAGGGACAGATCAGCCCCAGCATTTT	CASSYPGTDQPQHF	TRBV6-3	TRBJ1-5
TGTGCCACCTCATTGTATCAGCCCCAGCATTTT	CATSLYQPQHF	TRBV25-1	TRBJ1-5
TGTGCCAGCCCATGGGGACAGGGGGGGTGGTCGGCCCTGAACGAGCAGTACTTC	CASPWGQGGWSALNEQYF	TRBV5-8	TRBJ2-7
TGCAGTGCGAAAGCCAGGGACATATCCGCTGGAAACACCATATATTTT	CSAKARDISAGNTIYF	TRBV20-1	TRBJ1-3
TGCAGTGCTAGAGAAAAACAGGGAACTGAAGCTTTCTTT	CSAREKQGTEAFF	TRBV20-1	TRBJ1-1
TGTGCCACCAGTGATTCAGGGAGGGGGGTCCAAGGACGCTACGAGCAGTACTTC	CATSDSGRGVQGRYEQYF	TRBV24-1	TRBJ2-7
TGTGCCAGTAGCCGTTCTAGGGACTGGGCCTACGAGCAGTACTTC	CASSRSRDWAYEQYF	TRBV19	TRBJ2-7
TGTGCCAGCAGCTCCGCAGGGGAGATCTATCAGCCCCAGCATTTT	CASSSAGEIYQPQHF	TRBV7-4	TRBJ1-5
TGCAGTGCTCCTACCCTTTTGGGCTCGGCCTACGAGCAGTACTTC	CSAPTLLGSAYEQYF	TRBV20-1	TRBJ2-7
TGTGCCAGCGGCTCGGGACCGGGCAAGGGTGGGTCGAACACTGAAGCTTTCTTT	CASGSGPGKGGSNTEAFF	TRBV27	TRBJ1-1
TGCGCCAGCGGGAGGGGGTTGACTAGCGGATTGTACGAGCAGTACTTC	CASGRGLTSGLYEQYF	TRBV5-1	TRBJ2-7
TGTGCCAGCAGCCAAGATCTCGGCGCAGATACGCAGTATTTT	CASSQDLGADTQYF	TRBV14	TRBJ2-3
TGCGCCAGCAGCCAAGACCCGAGGGCGCCAGAGAAACACACCTTC	CASSQDPRAPEKHTF	TRBV4-1	TRBJ1-2
TGTGCCAGCAGTGAATATCGTAAAAGGCCCACAGGGGGCTTGGGCTACACCTTC	CASSEYRKRPTGGLGYTF	TRBV25-1	TRBJ1-2
TGCGCCAGCAGCTCCGGGACGTGGTACGAGCAGTACTTC	CASSSGTWYEQYF	TRBV5-1	TRBJ2-7
TGTGCCAGCAGAGAGTCCCAGGTTAGGATTCAGCCCCAGCATTTT	CASRESQVRIQPQHF	TRBV7-9	TRBJ1-5
TGTGCCAGCAGCTGGAGGGGAATGGTGCAGTACTTC	CASSWRGMVQYF	TRBV13	TRBJ2-7
TGCAGTGCCCCTATAGGGAACTATGGCTACACCTTC	CSAPIGNYGYTF	TRBV20-1	TRBJ1-2
TGTGCCTCGAATGGGACAGGGGGCGGAGCCAAAAACATTCAGTACTTC	CASNGTGGGAKNIQYF	TRBV7-3	TRBJ2-4
TGTGCCAGCAGGAGCCGGATACTAGCGGGAAGTAACTTGACAGATACGCAGTATTTT	CASRSRILAGSNLTDTQYF	TRBV6-4	TRBJ2-3
TGCAGCGTTGCTTCGGATGGGGGGGACCCCAAAACGGAGCAGTACTTC	CSVASDGGDPKTEQYF	TRBV29-1	TRBJ2-7
TGTGCCAGCCCTTGTAGCCGCAGGTATGAGCAGTTCTTC	CASPCSRRYEQFF	TRBV5-6	TRBJ2-1
TGTGCCAGCAGTTACCGGTCAGTACAGCCAACCGGGGAGCTGTTTTTT	CASSYRSVQPTGELFF	TRBV6-2	TRBJ2-2
TGTGCCAGCAGCTTAGTTCGCTACCCCGAAAAACTGTTTTTT	CASSLVRYPEKLFF	TRBV11-3	TRBJ1-4
TGTGCCAGCAGGGAAAAAGAGGGGACAGGGGGAGAGCAGTACTTC	CASREKEGTGGEQYF	TRBV4-2	TRBJ2-7
TGTGCCAGCAGTTTTCGGGGGGGGGCAAATCGAATGCAAGAGACCCAGTACTTC	CASSFRGGANRMQETQYF	TRBV27	TRBJ2-5
TGTGCCATCGGTTCAGTAAGCTACGAGCAGTACTTC	CAIGSVSYEQYF	TRBV19	TRBJ2-7
TGTGCCACCAGCAGAGGGTTACGGGTCGGGAACACCGGGGAGCTGTTTTTT	CATSRGLRVGNTGELFF	TRBV15	TRBJ2-2
TGTGCCAGCAATCGCGGCAGGGCCTCTTCACCCCTCCACTTT	CASNRGRASSPLHF	TRBV3-1	TRBJ1-6
TGTGCCAGCATGTCGGCACAGGGCGGGCAGCCCCAGCATTTT	CASMSAQGGQPQHF	TRBV5-6	TRBJ1-5
TGCCCGTGCCCAGGGGGCTTCCGCCAAGAGACCCAGTACTTC	CPCPGGFRQETQYF	TRBV20-1	TRBJ2-5
TGTGCCAGCAGCATCTGGGGGCGGGGGCGGAAGTACTATGGCTACACCTTC	CASSIWGRGRKYYGYTF	TRBV7-3	TRBJ1-2
TGTGCCAACATCACGACCTTGTATAACGAGCAGTACTTC	CANITTLYNEQYF	TRBV6-5	TRBJ2-7
TGTGCCAGCAGCTTGACTTGGGACAATGAGCAGTTCTTC	CASSLTWDNEQFF	TRBV7-9	TRBJ2-1
TGTGCCAGCAGCCAAGATGACAGCTCAACGGCAGATACGCAGTATTTT	CASSQDDSSTADTQYF	TRBV3-1	TRBJ2-3
TGTGCCAGCAGCCATTGGGTTTCACCCCTCCACTTT	CASSHWVSPLHF	TRBV11-2	TRBJ1-6
TGTGCCGAGGGGTTGGAAAAACTGTTTTTT	CAEGLEKLFF	TRBV24-1	TRBJ1-4
TGTGCCAGCACCCCGACAGGCAGTTTCAGTGAAGCTTTCTTT	CASTPTGSFSEAFF	TRBV6-6	TRBJ1-1
TGTGCCACCCCCCGGGACAGGGATAGCTCCTACGAGCAGTACTTC	CATPRDRDSSYEQYF	TRBV24-1	TRBJ2-7
TGCAGCGTTGAGTCGGGGGGGCCTGAGCAGTTCTTC	CSVESGGPEQFF	TRBV29-1	TRBJ2-1
TGTGCCAGTAGTTTGGAGGGCGTAAGCACAGATACGCAGTATTTT	CASSLEGVSTDTQYF	TRBV19	TRBJ2-3
TGTGCCAGCAGCTTAGTGAGGGGGGCCTACGAGCAGTACTTC	CASSLVRGAYEQYF	TRBV11-2	TRBJ2-7
TGCGCCAGCAGCTTACGCGGGGGAAGCTCCTACAATGAGCAGTTCTTC	CASSLRGGSSYNEQFF	TRBV5-1	TRBJ2-1
TGTGCCTTCCGAGGGTTCATGAACACTGAAGCTTTCTTT	CAFRGFMNTEAFF	TRBV7-9	TRBJ1-1
TGTGCCAGCACCTGGCGCCGGGAAAGCGATGGCTACACCTTC	CASTWRRESDGYTF	TRBV27	TRBJ1-2
TGTGCCACCACGGGACAGGGTAGATACAATGAGCAGTTCTTC	CATTGQGRYNEQFF	TRBV24-1	TRBJ2-1
TGTGCCAGCAGCCCCGTCCCAAAGCGGGATAGCCCAACGAGGACGCAGTATTTT	CASSPVPKRDSPTRTQYF	TRBV3-1	TRBJ2-3
TGTGCCAGCAGTATTGTGGGCCCCCGAGGAGATACGCAGTATTTT	CASSIVGPRGDTQYF	TRBV6-3	TRBJ2-3
TGTGCCAGCAGCGGGAATGGAGGGGACGAGCAGTACTTC	CASSGNGGDEQYF	TRBV7-9	TRBJ2-7
TGTGCCAGCAGCCAGGGGACAGGGGGCCTGGGTGCAACTAATGAAAAACTGTTTTTT	CASSQGTGGLGATNEKLFF	TRBV3-1	TRBJ1-4
TGCGCCAGCAGCCATTCATTGATCGGAAAGAATGAGCAGTTCTTC	CASSHSLIGKNEQFF	TRBV4-1	TRBJ2-1
TGTGCCAGCAGTTGGGACTCCGAGCAGTACTTC	CASSWDSEQYF	TRBV6-6	TRBJ2-7
TGTGCCAGCAGCCTAGGGCGGACTTCCTACGAGCAGTACTTC	CASSLGRTSYEQYF	TRBV13	TRBJ2-7
TGTGCCAGCAGTCCGACCAATGGCGGGAGCTACGAGCAGTACTTC	CASSPTNGGSYEQYF	TRBV11-3	TRBJ2-7
TGTGCCAGCAGCGGATCAGCGCTAAACACTGAAGCTTTCTTT	CASSGSALNTEAFF	TRBV6-1	TRBJ1-1
TGTGCTAGCAGCGGGGGCGCTAACTATGGCTACACCTTC	CASSGGANYGYTF	TRBV7-7	TRBJ1-2
TGTGCTAGTGGTTTGCTTATAGGGGGAACTTATGCTATCATGATGAGCAATCAGCCCCAGCATTTT	CASGLLIGGTYAIMMSNQPQHF	TRBV12-5	TRBJ1-5
TGTGCCAGCAGCCAAGAGAGGGAGGCTGGGAACTATGGCTACACCTTC	CASSQEREAGNYGYTF	TRBV14	TRBJ1-2
TGCGCCAGCAGCCAAGATAAACTCCGGGAGGACACTGAAGCTTTCTTT	CASSQDKLREDTEAFF	TRBV4-1	TRBJ1-1
TGTGCCAGCAGCGACAATCTGGACAGGGGGCGAGACTATGGCTACACCTTC	CASSDNLDRGRDYGYTF	TRBV7-3	TRBJ1-2
TGTGCCATCAGAATCGGACAGGTTCGAGAAGAAAAACTGTTTTTT	CAIRIGQVREEKLFF	TRBV10-3	TRBJ1-4
TGTGCCTGCGAATCACCGGGGGGGAGGCATTTT	CACESPGGRHF	TRBV30	TRBJ1-5
TGCAAATCAGCAGTCCTTGGACTAGCGGGCTACGAGCAGTACTTC	CKSAVLGLAGYEQYF	TRBV20-1	TRBJ2-7
TGTGCCAGCAGTTATAATACTACTGTGGAGCGATATCTGAACACTGAAGCTTTCTTT	CASSYNTTVERYLNTEAFF	TRBV6-5	TRBJ1-1
TGTGCCAGCAGCTTAGCTTCCCCCCTAATAGTCACCGGGGAGCTGTTTTTT	CASSLASPLIVTGELFF	TRBV7-8	TRBJ2-2
TGTGCCATCAGGCAGAAGGACAGCCCTCACGATTCACCCCTCCACTTT	CAIRQKDSPHDSPLHF	TRBV10-3	TRBJ1-6
TGTGCCACCAGTGATTCTTCTAGCGGGGTGCGTGATGAGCAGTTCTTC	CATSDSSSGVRDEQFF	TRBV24-1	TRBJ2-1
TGTGCCAGCATCGGACTAGCGGGAACCGAGCAGTACTTC	CASIGLAGTEQYF	TRBV28	TRBJ2-7
TGCGCCAGCTGGCTCAATCAGCCCCAGCATTTT	CASWLNQPQHF	TRBV10-1	TRBJ1-5
TGTGCCACCAGCAGAGATCCGTCAGGGACCGTCTACGAGCAGTACTTC	CATSRDPSGTVYEQYF	TRBV15	TRBJ2-7
TGTGCCAGCAGCGTGCCAGTCGTAATACTTGCTTTCTATTCACCCCTCCACTTT	CASSVPVVILAFYSPLHF	TRBV5-8	TRBJ1-6
TGTGCCAGCAGCAGGACCGCCCAGCATTTT	CASSRTAQHF	TRBV13	TRBJ1-5
TGTGCCAGCAGTGACTCCGTACAGGGATCACCCCTCCACTTT	CASSDSVQGSPLHF	TRBV6-4	TRBJ1-6
TGTGCCAGCAGCGTTACAGACGAGCAGTACTTC	CASSVTDEQYF	TRBV13	TRBJ2-7
TGTGCCAGCAGTGACAAACACGGAACTCCCAATGAGCAGTTCTTC	CASSDKHGTPNEQFF	TRBV6-4	TRBJ2-1
TGTGCCAGCAGCAAAGGCCGGGACACTGAAGCTTTCTTT	CASSKGRDTEAFF	TRBV14	TRBJ1-1
TGTGCCAGCAGCTCAGATAAAGTTCAGGGTGGTTCTGGGGCCAACGTCCTGACTTTC	CASSSDKVQGGSGANVLTF	TRBV5-6	TRBJ2-6
TGTGCCACCAGCTCGGCCAGCACCGGGGAGCTGTTTTTT	CATSSASTGELFF	TRBV15	TRBJ2-2
TGCAGCGGGGATGAAAAACTGTTTTTT	CSGDEKLFF	TRBV29-1	TRBJ1-4
TGTGCCAGCAGCGTAGCTACTACAGCCTCCGAGAAACCGGGACAGGGCGGGGGGATTCAAGAGACCCAGTACTTC	CASSVATTASEKPGQGGGIQETQYF	TRBV9	TRBJ2-5
TGTGCCAGCAGCGGGTTTATCAACGAGCAGTACTTC	CASSGFINEQYF	TRBV7-9	TRBJ2-7
TGTGCCAGCAGCTCGTCGACCGGACTAAGTCCTGCCTACGAGCAGTACTTC	CASSSSTGLSPAYEQYF	TRBV11-3	TRBJ2-7
TGCGCCAGCAGAGGACTCAATCAGCCCCAGCATTTT	CASRGLNQPQHF	TRBV5-1	TRBJ1-5
TGTGCCAGCGGGCAATACGAGCAGTACTTC	CASGQYEQYF	TRBV6-2	TRBJ2-7
TGCAGTGCTAGTACCTCCCTACCAGGCGGCACTGAAGCTTTCTTT	CSASTSLPGGTEAFF	TRBV20-1	TRBJ1-1
TGTGCCAGCAGTTTAGAGAACAGCCCAGGCCCCGGCGGTTGCACAGATACGCAGTATTTT	CASSLENSPGPGGCTDTQYF	TRBV27	TRBJ2-3
TGTGCCAGCAGTTTAGACTGCTACGAGCAGTACTTC	CASSLDCYEQYF	TRBV28	TRBJ2-7
TGTGCCAGCAGCGTCGGGGGCACAGATACGCAGTATTTT	CASSVGGTDTQYF	TRBV11-3	TRBJ2-3
TGCGCCAGCAGCTTGCCCACCCTTAACACTGAAGCTTTCTTT	CASSLPTLNTEAFF	TRBV5-1	TRBJ1-1
TGTGCCAGCTCACCACAGTGGGGGGGCCCCGGGTATTTT	CASSPQWGGPGYF	TRBV18	TRBJ2-3
TGTGCCAAAGGGGCGGAGCCAAATAACTATGGCTACACCTTC	CAKGAEPNNYGYTF	TRBV10-3	TRBJ1-2
TGCGCCAGCAGCCTGACAGGGTACCCTCACACTGAAGCTTTCTTT	CASSLTGYPHTEAFF	TRBV4-3	TRBJ1-1
TGCGCCAGCAGCCCAACAGCTGGGGGGGGCCGGCCATACAATGAGCAGTTCTTC	CASSPTAGGGRPYNEQFF	TRBV5-1	TRBJ2-1
TGCGCCAGCAGTGAGCGGTCGGGAAGGGGCTACACCTTC	CASSERSGRGYTF	TRBV10-2	TRBJ1-2
TGTGCCAGCAGCCGGTATACCGTCGGGGTATGGAGAAGAAGCTCCTACAATGAGCAGTTCTTC	CASSRYTVGVWRRSSYNEQFF	TRBV3-1	TRBJ2-1
TGTGCCAGCAGTGAACAGCGAAACCGGGACAGTGAAGACACTGAAGCTTTCTTT	CASSEQRNRDSEDTEAFF	TRBV6-1	TRBJ1-1
TGTGCCAGCAGCGTGCCCGCGGGAGTCCGCGGGGAGCTGTTTTTT	CASSVPAGVRGELFF	TRBV11-2	TRBJ2-2
TGCAGTGCTAGCCCGAGGAAAACAGAGCGTAAAGAGACCCAGTACTTC	CSASPRKTERKETQYF	TRBV20-1	TRBJ2-5
TGTGCCTGGAGTGTCCCCGGGACAGGGGGCTTTCCCGAGCAGTACTTC	CAWSVPGTGGFPEQYF	TRBV30	TRBJ2-7
TGTGCCAGCCTACAGGCATATCAGCCCCAGCATTTT	CASLQAYQPQHF	TRBV25-1	TRBJ1-5
TGTGCCAGTAGTATAGCACGGGCCTGGCACGAGCAGTACTTC	CASSIARAWHEQYF	TRBV19	TRBJ2-7
TGTGCCAGCAACGGGACTAAGTTTTACAATGAGCAGTTCTTC	CASNGTKFYNEQFF	TRBV7-3	TRBJ2-1
TGTGCCAGCAGTGACCTCGGACAGGGGGACCCCAATGAGCAGTTCTTC	CASSDLGQGDPNEQFF	TRBV6-4	TRBJ2-1
TGTGCCAGCTATTCCTATGACACTGAAGCTTTCTTT	CASYSYDTEAFF	TRBV6-3	TRBJ1-1
TGCAGTGCTTACAGGGATCTGGACTCCTACGAGCAGTACTTC	CSAYRDLDSYEQYF	TRBV20-1	TRBJ2-7
TGCAGTGCTAGAGATTGCGGCAGGGGGCGTCTCTCTGGAAACACCATATATTTT	CSARDCGRGRLSGNTIYF	TRBV20-1	TRBJ1-3
TGTGCCTGGAGTGTATGGGACAGCACTGAAGCTTTCTTT	CAWSVWDSTEAFF	TRBV30	TRBJ1-1
TGCGCCAGCAGCTTGATTGTGTGGACTAGCGGGGGGGCAGAGACCCAGTACTTC	CASSLIVWTSGGAETQYF	TRBV5-1	TRBJ2-5
TGTGCCAGCAGCCCTGGAAGACAGGCCGGAGATGGCTACACCTTC	CASSPGRQAGDGYTF	TRBV7-3	TRBJ1-2
TGTGCCATGAAGGGTTATGAGCAGTTCTTC	CAMKGYEQFF	TRBV6-5	TRBJ2-1
TGTGCCACCAGCAGACGCGACTTGGGTAGCTCCTACGAGCAGTACTTC	CATSRRDLGSSYEQYF	TRBV15	TRBJ2-7
TGTGCCAGCAGTGCTACTCGAAATGAGCAGTTCTTC	CASSATRNEQFF	TRBV6-4	TRBJ2-1
TGTGCCAGCAGCTGTGGGATAGGGGTGAGCTGGAACACTGAAGCTTTCTTT	CASSCGIGVSWNTEAFF	TRBV5-4	TRBJ1-1
TGCAGTGCTAGTCTGGGGGTTGGGGGGACAGGCGTGCTTGTCGAGCAGTACTTC	CSASLGVGGTGVLVEQYF	TRBV20-1	TRBJ2-7
TGTGCCAGCAGCTCCGGTTCCGGGACTAGCGATGATACGCAGTATTTT	CASSSGSGTSDDTQYF	TRBV5-4	TRBJ2-3
TGCAGTGCTCCCGCAGACTCTAATTCACCCCTCCACTTT	CSAPADSNSPLHF	TRBV20-1	TRBJ1-6
TGTGCCAGCAGCATCACGGGAACCACAGATACGCAGTATTTT	CASSITGTTDTQYF	TRBV7-4	TRBJ2-3
TGCGCCAGCAGTCTGCATACACGAGGGAACACTGAAGCTTTCTTT	CASSLHTRGNTEAFF	TRBV5-1	TRBJ1-1
TGCAGTGCTAGAACAGGGGAGATCTACGAGCAGTACTTC	CSARTGEIYEQYF	TRBV20-1	TRBJ2-7
TGTGCCAGCAGCCAAGATCGCTCACTAGCGGGGAAGCTCTACGAGCAGTACTTC	CASSQDRSLAGKLYEQYF	TRBV4-2	TRBJ2-7
TGCGCCAGGCACTTGGGACAGGGGGTGATTTTACCCGAAAAACTGTTTTTT	CARHLGQGVILPEKLFF	TRBV10-1	TRBJ1-4
TGTGCCAGCAGCTTAAACAGGGTCACTGAAGCTTTCTTT	CASSLNRVTEAFF	TRBV7-2	TRBJ1-1
TGTGCCAGCAGCCTCTTACAGGGGGATGGGAGAAGGAACACTGAAGCTTTCTTT	CASSLLQGDGRRNTEAFF	TRBV7-4	TRBJ1-1
TGTGCCAGCAGTCGCGGGGCCGTAGAAGAGACCCAGTACTTC	CASSRGAVEETQYF	TRBV7-9	TRBJ2-5
TGTGCCAGCAGTTTGGAGAGACTAGCGGGGGGGCCGCCGTACAATGAGCAGTTCTTC	CASSLERLAGGPPYNEQFF	TRBV12-4	TRBJ2-1
TGTGCCAGCAGCTTAGCGCCGGGAGGGGGGGACTCCTACGAGCAGTACTTC	CASSLAPGGGDSYEQYF	TRBV7-9	TRBJ2-7
TGTGCCAGCAGTGACTCCGGAAATTACCTGAGGGGTTGGGCGAACACCGGGGAGCTGTTTTTT	CASSDSGNYLRGWANTGELFF	TRBV6-4	TRBJ2-2
TGCGCCAGCAGCCAAGCCGCGACAGGGGCAGATACGCAGTATTTT	CASSQAATGADTQYF	TRBV4-3	TRBJ2-3
TGCGCCAGCAGGGCTGAAGCTTTCTTT	CASRAEAFF	TRBV10-1	TRBJ1-1
TGTGCCAGCAGTGGCCCTCCGGACCACTACGAGCAGTACTTC	CASSGPPDHYEQYF	TRBV25-1	TRBJ2-7
TGTGCCAGCTCACCACCTACCAGGGCATGGTCGAGCAATCAGCCCCAGCATTTT	CASSPPTRAWSSNQPQHF	TRBV18	TRBJ1-5
TGTGCCAGCAGCCAAGATAGGGGGAACACCGGGGAGCTGTTTTTT	CASSQDRGNTGELFF	TRBV4-2	TRBJ2-2
TGCAGCGTTTGTTGGGGGCCCCATCAGCCCCAGCATTTT	CSVCWGPHQPQHF	TRBV29-1	TRBJ1-5
TGTGCCAGCAGAGAGGTGGGAACAGGGAGGATCCCGATGGGGAACACCGGGGAGCTGTTTTTT	CASREVGTGRIPMGNTGELFF	TRBV6-4	TRBJ2-2
TGTGACCACAGGGGGCCACACTTCACTGAAGCTTTCTTT	CDHRGPHFTEAFF	TRBV6-2	TRBJ1-1
TGTGCCAGCATACTAGCGCTGTACGAGCAGTACTTC	CASILALYEQYF	TRBV27	TRBJ2-7
TGTGCCATCAGCGCCATAGACGGCGGGGACTACGAGCAGTACTTC	CAISAIDGGDYEQYF	TRBV10-3	TRBJ2-7
TGTGCCAGCAGTAGAGCGTCCGAGACCCAGTACTTC	CASSRASETQYF	TRBV6-1	TRBJ2-5
TGTGCCAGCAGCTTAGAGGGGTCAAGGGGGACAGGGGGCAGCTCCTACGAGCAGTACTTC	CASSLEGSRGTGGSSYEQYF	TRBV7-3	TRBJ2-7
TGTGCCAGCAGCACCTGGAGCTTAATAGACAGGGGGCGGAATCAGCCCCAGCATTTT	CASSTWSLIDRGRNQPQHF	TRBV11-2	TRBJ1-5
TGCAGTGCTGGCGTCAGCCAGGGGGCGGGCTATGGCTACACCTTC	CSAGVSQGAGYGYTF	TRBV20-1	TRBJ1-2
TGTGCCACCACGGACAGGACGGAGGATGAGCAGTTCTTC	CATTDRTEDEQFF	TRBV24-1	TRBJ2-1
TGTGCCAGCAGCTTAGACAGGGCGGGGAACACTGAAGCTTTCTTT	CASSLDRAGNTEAFF	TRBV5-8	TRBJ1-1
TGTGCCAGCAGTTACGAGCACGACGAGCAGACCCAGTACTTC	CASSYEHDEQTQYF	TRBV6-5	TRBJ2-5
TGTGCCAGCAGCTTAGATATTAAGGACGCCGGGGGACACGAGCAGTACTTC	CASSLDIKDAGGHEQYF	TRBV11-3	TRBJ2-7
TGCAGTGCTAGGACACCTGGACAGGGGGCACACTCTTCACCCCTCCACTTT	CSARTPGQGAHSSPLHF	TRBV20-1	TRBJ1-6
TGTGCCAGCAGCGAGGGGGGGAAGAACACTGAAGCTTTCTTT	CASSEGGKNTEAFF	TRBV6-8	TRBJ1-1
TGTGCCAGCAGCAAACCGACGTGCGATAATTCACCCCTCCACTTT	CASSKPTCDNSPLHF	TRBV11-3	TRBJ1-6
TGTGCCAGCAGTGAAGGCCGGTGCGGCCTCGTCTTC	CASSEGRCGLVF	TRBV2	TRBJ2-1
TGTGCCAACGAGGAGGGCTATGGAGGTAATGAGCAGTTCTTC	CANEEGYGGNEQFF	TRBV19	TRBJ2-1
TGTGCCCTAGCGGGGTCCTACGAGCAGTACTTC	CALAGSYEQYF	TRBV19	TRBJ2-7
TGTGCCAGCAGTTATAATAAGACTAGCGCTCTCACAGATACGCAGTATTTT	CASSYNKTSALTDTQYF	TRBV6-2	TRBJ2-3
TGTGCCAGCAGAGAGAGGGGGGGGGACTACGAGCAGTACTTC	CASRERGGDYEQYF	TRBV7-2	TRBJ2-7
TGTGCCACCAGTGTGTTGGGGGGGTCCACAGATACGCAGTATTTT	CATSVLGGSTDTQYF	TRBV24-1	TRBJ2-3
TGTGCCACCAGTGATGCCAGGGTTACCTACGAGCAGTACTTC	CATSDARVTYEQYF	TRBV24-1	TRBJ2-7
TGTGCCATGTCAGGGGGCGCCAGGTACAATGAGCAGTTCTTC	CAMSGGARYNEQFF	TRBV18	TRBJ2-1
TGCGCCAGCAGCTCACAGGGAATAAAAAATGAAAAACTGTTTTTT	CASSSQGIKNEKLFF	TRBV5-1	TRBJ1-4
TGCGCCAGCAGTGTTATCAAGCCCCCCTGGGGACGACCCACAGATACGCAGTATTTT	CASSVIKPPWGRPTDTQYF	TRBV10-1	TRBJ2-3
TGCAGTGCTAGAGAGCCGCGATCCAGCCCGAACACTGAAGCTTTCTTT	CSAREPRSSPNTEAFF	TRBV20-1	TRBJ1-1
TGTGCCAGCAGCTTCTTCTTGCTAGCTCTCGGGGATACGCAGTATTTT	CASSFFLLALGDTQYF	TRBV7-7	TRBJ2-3
TGTGCCACTGGACAGGCTCTCGAGCAGTACTTC	CATGQALEQYF	TRBV24-1	TRBJ2-7
TGTGCCAGCAGCTTCGTTCTTTTTCCCCTATTTCAGGTCCCCATCTCGCCTTACAATGAGCAGTTCTTC	CASSFVLFPLFQVPISPYNEQFF	TRBV7-9	TRBJ2-1
TGTGCCAGCACCGAGCGGACACCGAATGAGCAGTTCTTC	CASTERTPNEQFF	TRBV14	TRBJ2-1
TGTGCTAGTGGTTTTGAAACCGGGCGCGAGCAGTACTTC	CASGFETGREQYF	TRBV12-5	TRBJ2-7
TGTGCCAGCAGCGGTCCTGGGGGGCCGGTAAATTCACCCCTCCACTTT	CASSGPGGPVNSPLHF	TRBV7-4	TRBJ1-6
TGTGCCAGCAGCGAAACTCGGGATCATGGCGAGACCCAGTACTTC	CASSETRDHGETQYF	TRBV9	TRBJ2-5
TGTGCCAGCAGGGGTAACACCGGGGAGCTGTTTTTT	CASRGNTGELFF	TRBV6-3	TRBJ2-2
TGTGCCAGCAGCTTAGAGGGGGGAGAATACGAGCAGTACTTC	CASSLEGGEYEQYF	TRBV7-2	TRBJ2-7
TGTGCCACCGAGGTCTTACTCGACGAGCAGTACTTC	CATEVLLDEQYF	TRBV24-1	TRBJ2-7
TGTGCCAGCAGCTTGGGGGGAATGGGACCTATGGCGTACACCGGGGAGCTGTTTTTT	CASSLGGMGPMAYTGELFF	TRBV5-4	TRBJ2-2
TGCGCCAGCAGCCCCTATGCCTACGAGCAGTACTTC	CASSPYAYEQYF	TRBV5-1	TRBJ2-7
TGTGCCAGCAGTTACGATAGAGGTAGTGAGCAGTACTTC	CASSYDRGSEQYF	TRBV6-3	TRBJ2-7
TGTGCCAGCAGCACAGATACGCAGTATTTT	CASSTDTQYF	TRBV6-4	TRBJ2-3
TGTGCCAGCAGAGATAGGGGAGAAGGCTACACCTTC	CASRDRGEGYTF	TRBV14	TRBJ1-2
TGTGCCAGTCCCAGAGGGCCCCAGCATTTT	CASPRGPQHF	TRBV28	TRBJ1-5
TGTGCCAGCAACCGACGCAGCAAGGCGATCTATGGCTACACCTTC	CASNRRSKAIYGYTF	TRBV7-3	TRBJ1-2
TGCGCCAGCAGCCCAGGGTATGAAGCTTTCTTT	CASSPGYEAFF	TRBV5-1	TRBJ1-1
TGTGCCAGCACGTGGGGATATGTTACAGGGGCCACTAATGAAAAACTGTTTTTT	CASTWGYVTGATNEKLFF	TRBV2	TRBJ1-4
TGTGCCAGTAGTACCCAGTGGAAGAAAAGTGGCTACACCTTC	CASSTQWKKSGYTF	TRBV19	TRBJ1-2
TGTGCCAGCAGCCCAAAGGACAGGGGGAAGGTCCAGGATCCCAGATCCTCTGGAAACACCATATATTTT	CASSPKDRGKVQDPRSSGNTIYF	TRBV6-4	TRBJ1-3
TGTGCCAGCAGCTTAGATGCGGGAGCGTTTGATGAGCAGTTCTTC	CASSLDAGAFDEQFF	TRBV7-9	TRBJ2-1
TGTGCCAGCAGTTCCACAGGAAATGAAGCTTTCTTT	CASSSTGNEAFF	TRBV12-3	TRBJ1-1
TGTGCCAGCAGTGATCTCGGACAGGGGAATGGTATCAACTATGGCTACACCTTC	CASSDLGQGNGINYGYTF	TRBV6-4	TRBJ1-2
TGTGCCTGGAGGACAGGGTACCTAAGGAACACTGAAGCTTTCTTT	CAWRTGYLRNTEAFF	TRBV30	TRBJ1-1
TGTGCCAGCAAGAAACACAAACCTTGGGCTGAAGCTTTCTTT	CASKKHKPWAEAFF	TRBV5-5	TRBJ1-1
TGTGCCAGCTCACAACGCGGGACCCGAAACTATGGCTACACCTTC	CASSQRGTRNYGYTF	TRBV18	TRBJ1-2
TGTGCCAGCAGCCAAGAGACGGGCTACGAGCAGTACTTC	CASSQETGYEQYF	TRBV14	TRBJ2-7
TGTGCCAGCAGCGAGGTAGCGGGAACCCTCTTC	CASSEVAGTLF	TRBV9	TRBJ2-1
TGTGCCAGTCAATTGGAGGCCTACAATGAGCAGTTCTTC	CASQLEAYNEQFF	TRBV19	TRBJ2-1
TGTGCCAGCAGCCCTCTACCGTGGGGACGGGACAGCACAGATACGCAGTATTTT	CASSPLPWGRDSTDTQYF	TRBV13	TRBJ2-3
TGTGCCACCAGTGATAATCCTTTCACGACGCTTAACAATCAGCCCCAGCATTTT	CATSDNPFTTLNNQPQHF	TRBV24-1	TRBJ1-5
TGTGCCACCAGTGATTCCAGGACAGGGTGTGCAGGAAACACCATATATTTT	CATSDSRTGCAGNTIYF	TRBV24-1	TRBJ1-3
TGTGCCAGCATAAACAAATGGACAGGGGGGCGAGAAAAACTGTTTTTT	CASINKWTGGREKLFF	TRBV27	TRBJ1-4
TGTGCCAGCAGCCACGAGGAGGAGAACACCGGGGAGCTGTTTTTT	CASSHEEENTGELFF	TRBV14	TRBJ2-2
TGTGCCAGCAGCATCACAGGGGAAGCCTACGAGCAGTACTTC	CASSITGEAYEQYF	TRBV7-3	TRBJ2-7
TGCGCCAGCAGCACACTTCAGCCGGGCGGGACTTACCCCTATGGCTACACCTTC	CASSTLQPGGTYPYGYTF	TRBV5-1	TRBJ1-2
TGTGCCAGCAACCCACTAGCGCCTAGCTCCTACGAGCAGTACTTC	CASNPLAPSSYEQYF	TRBV6-5	TRBJ2-7
TGTGCCAGCAGCAGGGACAAGAGCCTGCCCCAGCATTTT	CASSRDKSLPQHF	TRBV5-4	TRBJ1-5
TGTGCCAGCAGTTTATGGAGGATTAGGACAGCCAGCAATCAGCCCCAGCATTTT	CASSLWRIRTASNQPQHF	TRBV28	TRBJ1-5
TGTGCCAGCAGTTTGAGGGCTCCCGGGATTGGCTACACCTTC	CASSLRAPGIGYTF	TRBV28	TRBJ1-2
TGTGCCAGCATGACAGGGGGCTTTAGGGGCGAAAAACTGTTTTTT	CASMTGGFRGEKLFF	TRBV7-2	TRBJ1-4
TGTGCCAGCAGCTCCGAATGTGGGGGGGCCTCCTACAATGAGCAGTTCTTC	CASSSECGGASYNEQFF	TRBV9	TRBJ2-1
TGTGCCAGCAGTAAACCGGACTGCACGGACCATGGCTACACCTTC	CASSKPDCTDHGYTF	TRBV6-5	TRBJ1-2
TGCGCCAGCAATACTAGCGGGAGGGACGAGCAGTACTTC	CASNTSGRDEQYF	TRBV5-1	TRBJ2-7
TGCGCCAGCAGCCAAGAAGCCGGGACAGGGCGAACAAACATTCAGTACTTC	CASSQEAGTGRTNIQYF	TRBV4-1	TRBJ2-4
TGCGCCAGCAGAAGACAGGGGGCCCGACCGAGCTCCTACGAGCAGTACTTC	CASRRQGARPSSYEQYF	TRBV5-1	TRBJ2-7
TGTGCCAGCAGGGATAACTCCCCGGACGCTCGAGACGAGCAGTACTTC	CASRDNSPDARDEQYF	TRBV27	TRBJ2-7
TGCAGTGCTAGAACTTCCCTACCGGGACAGGCCTTGGTGGATAACACTGAAGCTTTCTTT	CSARTSLPGQALVDNTEAFF	TRBV20-1	TRBJ1-1
TGTGCCAGCAGGGAGGACCGGTCGTATAGCAATCAGCCCCAGCATTTT	CASREDRSYSNQPQHF	TRBV11-1	TRBJ1-5
TGTGCCAGCACAGACAGTGGCGGCGCCTACGAGCAGTACTTC	CASTDSGGAYEQYF	TRBV6-6	TRBJ2-7
TGTGCCAGCAGCTGGGCCCTAATTGAAGAGGCTCGGCCCGAGCAGTACTTC	CASSWALIEEARPEQYF	TRBV6-5	TRBJ2-7
TGTGCCAGCAGGGACCCGGGGCGCAATCAGCCCCAGCATTTT	CASRDPGRNQPQHF	TRBV5-5	TRBJ1-5
TGTGCCAGCCGAACCAAATCAGATACGCAGTATTTT	CASRTKSDTQYF	TRBV6-4	TRBJ2-3
TGTGCCCAGGGCTCCCGGAAAGAGGTTCCTCGTCTGCTTGGGTTACTCCTCGCAACTAATGAAAAACTGTTTTTT	CAQGSRKEVPRLLGLLLATNEKLFF	TRBV6-1	TRBJ1-4
TGTGCCATCAGTGACCGGACAGGAATATTCACTGAAGCTTTCTTT	CAISDRTGIFTEAFF	TRBV10-3	TRBJ1-1
TGTGCCACCAGGGCTCGCCGGCCCGCCAGGATCTACGAGCAGTACTTC	CATRARRPARIYEQYF	TRBV24-1	TRBJ2-7
TGCAGTGCTACCTGCCTTACGGGATGGGGTGGGTCACCCCTCCACTTT	CSATCLTGWGGSPLHF	TRBV20-1	TRBJ1-6
TGTGCCAGCAGCGACTTGGCAGGGACCTCCTACGAGCAGTACTTC	CASSDLAGTSYEQYF	TRBV7-4	TRBJ2-7
TGTGCCAGCAGTGGCCCCAGGGAAGCTTTCTTT	CASSGPREAFF	TRBV6-3	TRBJ1-1
TGCAGTGCTAGAGCGGGGAGGGGGCCAGGAGACACTGAAGCTTTCTTT	CSARAGRGPGDTEAFF	TRBV20-1	TRBJ1-1
TGTGCCAGTAAACCCCTAAGGGGGGGAGGAGTGAACACTGAAGCTTTCTTT	CASKPLRGGGVNTEAFF	TRBV19	TRBJ1-1
TGTGCCAGGGTTTCAGGGGGGGAAAATGAGCAGTTCTTC	CARVSGGENEQFF	TRBV27	TRBJ2-1
TGTGCCAGTAGCCAAAAAACGACAGGGCCTAACTACAATGAGCAGTTCTTC	CASSQKTTGPNYNEQFF	TRBV19	TRBJ2-1
TGTGCCAGCAGTTTAAAACAGAGTCTCAATCAGCCCCAGCATTTT	CASSLKQSLNQPQHF	TRBV27	TRBJ1-5
TGTGCCAGCAGTCACCCCCTGGAGCCAGCCTATCAGCCCCAGCATTTT	CASSHPLEPAYQPQHF	TRBV6-4	TRBJ1-5
TGTGCCAGCAGCTTAGCCGGACAGGCCATGGATACGCAGTATTTT	CASSLAGQAMDTQYF	TRBV13	TRBJ2-3
TGTGCCAGCAACCCCCCGGGACTAGCGGGAGGGGATACGCAGTATTTT	CASNPPGLAGGDTQYF	TRBV5-4	TRBJ2-3
TGTGCCAGTAGTATAGTAAATACAGCGGTATCCTACGAGCAGTACTTC	CASSIVNTAVSYEQYF	TRBV19	TRBJ2-7
TGTGCCAGCAGCTCCGATGAAGCTTTCTTT	CASSSDEAFF	TRBV6-5	TRBJ1-1
TGTGCCACCCACCTAGCCTGGGACACAGATACGCAGTATTTT	CATHLAWDTDTQYF	TRBV24-1	TRBJ2-3
TGTGCCGACAGACTAGCGGGGTTCAGCTCCTACGAGCAGTACTTC	CADRLAGFSSYEQYF	TRBV5-6	TRBJ2-7
TGCGCCAGCAGCCAAGGGGAAAGGGTTGCAGGGGGTAACGAGCAGTACTTC	CASSQGERVAGGNEQYF	TRBV4-3	TRBJ2-7
TGTGCCAGCAGCGGACGAAGTACGGGGGGCTCCTACGAGCAGTACTTC	CASSGRSTGGSYEQYF	TRBV7-3	TRBJ2-7
TGTGCCAGCAGCTTGGGGAGGTGCAATCAGCCCCAGCATTTT	CASSLGRCNQPQHF	TRBV5-4	TRBJ1-5
TGTGCCAGCAGTTTATTTGTGTGTAAAGGGGCAGGGGTCCGGACTTTTCACGGGGAAGCTTTCTTT	CASSLFVCKGAGVRTFHGEAFF	TRBV27	TRBJ1-1
TGTGCCATCGCGAGGGCCGATACGCAGTATTTT	CAIARADTQYF	TRBV6-5	TRBJ2-3
TGTGCTAGTGCTAAACCAGGCCACAATGAGCAGTTCTTC	CASAKPGHNEQFF	TRBV12-5	TRBJ2-1
TGCGCCAGCAGCCAAGAAGGGGGGGTAGCCAAAAACATTCAGTACTTC	CASSQEGGVAKNIQYF	TRBV4-1	TRBJ2-4
TGTGCCAGCAGTGGGGGGGCGTACGAGCAGTACTTC	CASSGGAYEQYF	TRBV6-1	TRBJ2-7
TGTGCCAGCAGTGAAGAAGGGGGCAGGGGGGGTCGGTATAGCAATCAGCCCCAGCATTTT	CASSEEGGRGGRYSNQPQHF	TRBV6-1	TRBJ1-5
TGTGCCAGCACCTCCAGACCTTATAAAGATACGCAGTATTTT	CASTSRPYKDTQYF	TRBV7-9	TRBJ2-3
TGCGCCTACCCCGGACTAGCGGGGTACAATGAGCAGTTCTTC	CAYPGLAGYNEQFF	TRBV10-1	TRBJ2-1
TGTGCCTGGAGTGTACTATTTGGGGTGGATGAAAAACTGTTTTTT	CAWSVLFGVDEKLFF	TRBV30	TRBJ1-4
TGTGCCAGCAGTCAGCACCGGGACAGGGGCAATGAGCAGTTCTTC	CASSQHRDRGNEQFF	TRBV28	TRBJ2-1
TGTGCCAGTAGCTCGGGAAAGACCGGGGAGCTGTTTTTT	CASSSGKTGELFF	TRBV19	TRBJ2-2
TGTGCCAGCAGCTTACGACTAGACGCTAGCACAGATACGCAGTATTTT	CASSLRLDASTDTQYF	TRBV7-2	TRBJ2-3
TGTGCCAGCAGTCCTAGGGGGCAGTTCTTC	CASSPRGQFF	TRBV27	TRBJ2-1
TGTGCCAGCAGCTTCAAAGGTAATAGCTCCTATAATTCACCCCTCCACTTT	CASSFKGNSSYNSPLHF	TRBV5-4	TRBJ1-6
TGTGCCAGCTCACCACTAGCTAGCGGCAATGAGCAGTTCTTC	CASSPLASGNEQFF	TRBV18	TRBJ2-1
TGTGCCAGCAGCCGCCATGTTACCACCCAGGCCGTTTCGTGGACGAACAGGGGCACAGATACGCAGTATTTT	CASSRHVTTQAVSWTNRGTDTQYF	TRBV14	TRBJ2-3
TGTGCCAGCAGCCAAGGGGAAGGCTACACCTTC	CASSQGEGYTF	TRBV5-4	TRBJ1-2
TGTGAGACCAGGGAACACACTGAAGCTTTCTTT	CETREHTEAFF	TRBV14	TRBJ1-1
TGTGCCAGCGATTTCCACAGGGAGTCTCGCAATCAGCCCCAGCATTTT	CASDFHRESRNQPQHF	TRBV28	TRBJ1-5
TGTGCCAGCAACCATAGTCTAACTAACTATGGCTACACCTTC	CASNHSLTNYGYTF	TRBV7-9	TRBJ1-2
TGTGCCAGCAGCAAGAAGATTCCAGTCGACAGTGAGACTGAAGCTTTCTTT	CASSKKIPVDSETEAFF	TRBV11-3	TRBJ1-1
TGTGCCAGCAGTTACCCCAGGACCAGCGTGCAGATTTGCTATGGCTACACCTTC	CASSYPRTSVQICYGYTF	TRBV6-5	TRBJ1-2
TGTGCCACCAGTGCCCGAAGCTGGGGGGGCCCGCCAGAGACCCAGTACTTC	CATSARSWGGPPETQYF	TRBV24-1	TRBJ2-5
TGTGCCAGCAGGACAAGGAACACCGGGGAGCTGTTTTTT	CASRTRNTGELFF	TRBV6-4	TRBJ2-2
TGTGCCAGCAGCAGGGGGCTCTATGGCTACACCTTC	CASSRGLYGYTF	TRBV27	TRBJ1-2
TGCGCCAGCAGCCCTAGGGAGCCCTTCTTATACAATGAGCAGTTCTTC	CASSPREPFLYNEQFF	TRBV4-1	TRBJ2-1
TGTGCCAGTAGTATACACACGGAGGGGGCGGTCACCATATATTTT	CASSIHTEGAVTIYF	TRBV19	TRBJ1-3
TGTGCCAGCAGTGAAGTAAGAAAGGACAGACATAGCAATCAGCCCCAGCATTTT	CASSEVRKDRHSNQPQHF	TRBV2	TRBJ1-5
TGCGCCAGCAGCGGGACAAAGGCTTTCTTT	CASSGTKAFF	TRBV5-1	TRBJ1-1
TGCAGTGCTACCGGTGTTTCCACAGATAGCAATCAGCCCCAGCATTTT	CSATGVSTDSNQPQHF	TRBV20-1	TRBJ1-5
TGTGCCAGCAGCTATGGGGAATTCGAGCAGTACTTC	CASSYGEFEQYF	TRBV13	TRBJ2-7
TGTGCCAGTAGCCAAACCGGACAGGGCACCGGGGAGCTGTTTTTT	CASSQTGQGTGELFF	TRBV19	TRBJ2-2
TGTGCCACCATGCGGGGCACAGATACGCAGTATTTT	CATMRGTDTQYF	TRBV24-1	TRBJ2-3
TGCAGTGCTAGAGTGACAAAGCAGTATTTT	CSARVTKQYF	TRBV20-1	TRBJ2-3
TGTGCCAGCAGTGTTAAGACGGCCTACGAGCAGTACTTC	CASSVKTAYEQYF	TRBV25-1	TRBJ2-7
TGTGCCAGCAGCAGTGGGGAAGGGGGAGCTTTCTTT	CASSSGEGGAFF	TRBV13	TRBJ1-1
TGTGCCACGACGTGCCGACAGGGGGCGAGAGCAGGTAATGAAAAACTGTTTTTT	CATTCRQGARAGNEKLFF	TRBV24-1	TRBJ1-4
TGCGCCAGCAGCTGTTCTAGCGGGGACTACGAGCAGTACTTC	CASSCSSGDYEQYF	TRBV5-1	TRBJ2-7
TGTGCCAGCACTAGCGGGAGGCCTCCCTACGAGCAGTACTTC	CASTSGRPPYEQYF	TRBV6-5	TRBJ2-7
TGTGCCAGCAGCGTAGGCCCGGGGGTGAATTCACCCCTCCACTTT	CASSVGPGVNSPLHF	TRBV9	TRBJ1-6
TGTGCCAATGAATTGACAGCGGGTAGCTACGAGCAGTACTTC	CANELTAGSYEQYF	TRBV10-3	TRBJ2-7
TGTGCCACCAGTGCTAACAGTCAGCCCCAGCATTTT	CATSANSQPQHF	TRBV24-1	TRBJ1-5
TGTGCCAGCAGCCAAGAATGGCCAATTTTAAAGCCATACAATGAGCAGTTCTTC	CASSQEWPILKPYNEQFF	TRBV4-2	TRBJ2-1
TGTGCCAGCTCACCACCCACGATCAGGGGGCACAAGGTCAGAAACACCATATATTTT	CASSPPTIRGHKVRNTIYF	TRBV18	TRBJ1-3
TGTGCCAGCAGCTTGGACAGGGGAACTGAAGCTTTCTTT	CASSLDRGTEAFF	TRBV13	TRBJ1-1
TGTGCCAGCAGCCCCCGAGCACTATACACCGGGGAGCTGTTTTTT	CASSPRALYTGELFF	TRBV13	TRBJ2-2
TGCGCCAGCAGCCGCAGGACGGCAACTAATGAAAAACTGTTTTTT	CASSRRTATNEKLFF	TRBV4-3	TRBJ1-4
TGTGCCAGCAGTAATGATGTCAACACTGAAGCTTTCTTT	CASSNDVNTEAFF	TRBV6-1	TRBJ1-1
TGCAGCGTCGAACGAGGTAGAATGACTAGGACCGTGCATGAGCAGTTCTTC	CSVERGRMTRTVHEQFF	TRBV29-1	TRBJ2-1
TGTGCCAGCAGCCAAGCTTACCGGGACAGGGCTCCTCAGCCCCAGCATTTT	CASSQAYRDRAPQPQHF	TRBV3-1	TRBJ1-5
TGTGCCAGCAGCCATAGGGGGCCACCAGATACGCAGTATTTT	CASSHRGPPDTQYF	TRBV4-2	TRBJ2-3
TGTGCCAGCAGCGCGGGGCCCGAGTGGAATGAAAAACTGTTTTTT	CASSAGPEWNEKLFF	TRBV13	TRBJ1-4
TGTGCCAGCAGTTACTGGACAGGGGTAAGGCACACAGATACGCAGTATTTT	CASSYWTGVRHTDTQYF	TRBV6-2	TRBJ2-3
TGTGCCTGGAGTTGTTGCACAGGGATTGTCCTGGATACGCAGTATTTT	CAWSCCTGIVLDTQYF	TRBV30	TRBJ2-3
TGTGCCAGCAGTAAAACTGTGAGTGAAAAACTGTTTTTT	CASSKTVSEKLFF	TRBV27	TRBJ1-4
TGCGCCAGCAGCTCCCGGACCGGAAGTCGGGACAGGGTCCGGCCTTCCGAGACCCAGTACTTC	CASSSRTGSRDRVRPSETQYF	TRBV5-1	TRBJ2-5
TGTGCCAGCAGCCAAGATACGAAGACAGGCATATTAGACCTAGAAAAACTGTTTTTT	CASSQDTKTGILDLEKLFF	TRBV3-1	TRBJ1-4
TGCGCCAGCAGTACGACCTTCCCATCCGGGGAGCTGTTTTTT	CASSTTFPSGELFF	TRBV10-1	TRBJ2-2
TGTGCCAGCAGCTCCGACAGGCGTCTATTTCCTAACTATGGCTACACCTTC	CASSSDRRLFPNYGYTF	TRBV7-9	TRBJ1-2
TGTGCCAGCAGCTATAGGGCCGGAGGGGTACGGAACTATGGCTACACCTTC	CASSYRAGGVRNYGYTF	TRBV13	TRBJ1-2
TGCGCCAGCAGCCAACAGGGGGCGCGGACTGCCAAAAACATTCAGTACTTC	CASSQQGARTAKNIQYF	TRBV4-1	TRBJ2-4
TGTGCCAGCAGCTGTGGGAGTAGCGGGTACTTCGCCTACGAGCAGTACTTC	CASSCGSSGYFAYEQYF	TRBV9	TRBJ2-7
TGTGCCATCACGTCAGAACACGAGACCCAGTACTTC	CAITSEHETQYF	TRBV10-3	TRBJ2-5
TGTGCCAGTAGAAACCGAAGAAGGGGAGAGACCCAGTACTTC	CASRNRRRGETQYF	TRBV19	TRBJ2-5
TGTGCCACCCCGGACAGGGAAGCAAGCTACGAGCAGTACTTC	CATPDREASYEQYF	TRBV14	TRBJ2-7
TGTGCCAGCAGCAGAAAAGGGGGGGCTAGCAATCAGCCCCAGCATTTT	CASSRKGGASNQPQHF	TRBV9	TRBJ1-5
TGTGCCAGCAGCCGACAGGCCACCATGGGGGGCTCTGGGGCCAACGTCCTGACTTTC	CASSRQATMGGSGANVLTF	TRBV6-6	TRBJ2-6
TGTGCCAGCACCCGGACAGGGCCAAGGGGGGCTGTCCAAGAGACCCAGTACTTC	CASTRTGPRGAVQETQYF	TRBV6-4	TRBJ2-5
TGCAGCGTTGAAGGATGCGGGAAGTACGAGCAGTACTTC	CSVEGCGKYEQYF	TRBV29-1	TRBJ2-7
TGTGCCAGCAGTCGACAGGACCCCTATGGCTACACCTTC	CASSRQDPYGYTF	TRBV6-4	TRBJ1-2
TGTGCCAGCCAGTTGCCTGGAGGGTCGCTGGTAGCTCCCTATCGCTACGAGCAGTACTTC	CASQLPGGSLVAPYRYEQYF	TRBV7-9	TRBJ2-7
TGTGCCAGCAGCCTACCCGACAGGTTTCTCACTGAAGCTTTCTTT	CASSLPDRFLTEAFF	TRBV14	TRBJ1-1
TGTGCCAGCAGTTACATGCTACGCCAGATCGGGGAGCTGTTTTTT	CASSYMLRQIGELFF	TRBV6-5	TRBJ2-2
TGTGCCAGCAGCTGGCGTGCCAAGAAGGACAGGGGAGGAGGGGGCAAAAACATTCAGTACTTC	CASSWRAKKDRGGGGKNIQYF	TRBV7-8	TRBJ2-4
TGTGCCAGCAGCCACCTTCTCACTGAAGCTTTCTTT	CASSHLLTEAFF	TRBV6-4	TRBJ1-1
TGTGCCATCAGTGCAGGGGGAAGGTCCTACGAGCAGTACTTC	CAISAGGRSYEQYF	TRBV10-3	TRBJ2-7
TGTGCCAGCAGCTTAGGTGGGCCAGAAGGTGAGCAGTTCTTC	CASSLGGPEGEQFF	TRBV7-4	TRBJ2-1
TGTGCCACCAGTGATTTGAGAGGAAACTTAAACACTGAAGCTTTCTTT	CATSDLRGNLNTEAFF	TRBV24-1	TRBJ1-1
TGCAGTGCTAGAGCAGCGTCCTCTGGTCTGCCCCAGCATTTT	CSARAASSGLPQHF	TRBV20-1	TRBJ1-5
TGTGCCAGGGCGGACAGCTCCTACGAGCAGTACTTC	CARADSSYEQYF	TRBV19	TRBJ2-7
TGTGCCAGCAGCTTAGCGAGAATGGCGTACGAGCAGTACTTC	CASSLARMAYEQYF	TRBV7-2	TRBJ2-7
TGCAGTGCTTGGGACAGGGGGCGTTACACTGAAGCTTTCTTT	CSAWDRGRYTEAFF	TRBV20-1	TRBJ1-1
TGTGCCAGCCTGGTGAGTGGGGGCTACGAGCAGTACTTC	CASLVSGGYEQYF	TRBV7-9	TRBJ2-7
TGTGCCAGCCGGGAGGGGGGACTTTCCTACGAGCAGTACTTC	CASREGGLSYEQYF	TRBV25-1	TRBJ2-7
TGTGCCAGCAGCACGGGACTAGCGGGAGGACCCGGGGAGCTGTTTTTT	CASSTGLAGGPGELFF	TRBV13	TRBJ2-2
TGTGCCAGCAGCGTAGCCTTCCCGGTGGAGGGGGCGGCGGAGACCCAGTACTTC	CASSVAFPVEGAAETQYF	TRBV9	TRBJ2-5
TGTGCCAGCAGCTTACCCAACTGTAACAGTGAGCAGTTCTTC	CASSLPNCNSEQFF	TRBV7-9	TRBJ2-1
TGTGCCAGCAGTAACCCCTCGGGAGAGACCCAGTACTTC	CASSNPSGETQYF	TRBV27	TRBJ2-5
TGTGCCAGCAGCTTAGCGAATGGACGACGGGGGGATACGCAGTATTTT	CASSLANGRRGDTQYF	TRBV7-4	TRBJ2-3
TGTGCCAGCAGCTTAGCGGCCTTTAAAGCCAAAAACATTCAGTACTTC	CASSLAAFKAKNIQYF	TRBV7-6	TRBJ2-4
TGTGCCAGCAGTTCCGGGAACAGGGCGGGCTACACCTTC	CASSSGNRAGYTF	TRBV28	TRBJ1-2
TGTGCCAGCAGCGGGGGACAGATCGGGGGAAACACCATATATTTT	CASSGGQIGGNTIYF	TRBV5-6	TRBJ1-3
TGTGCCAGCAGACAGAAATCTGGAAACACCATATATTTT	CASRQKSGNTIYF	TRBV12-3	TRBJ1-3
TGTGCCAGCAGTGACACAGGGATTTGGGGGTGTGGATACGAGCAGTACTTC	CASSDTGIWGCGYEQYF	TRBV6-4	TRBJ2-7
TGTGCCACCAGCAGAGATGTGAGAGACGCCACTGAAGCTTTCTTT	CATSRDVRDATEAFF	TRBV15	TRBJ1-1
TGTGCCAGCTCACCAGTGCAGACGGGACAGGACACCGGGGAGCTGTTTTTT	CASSPVQTGQDTGELFF	TRBV18	TRBJ2-2
TGTGCCAGCAGTTACGGGACTAGGGGCAATGAGCAGTTCTTC	CASSYGTRGNEQFF	TRBV6-5	TRBJ2-1
TGTGCCAGCAGCTTGATCCACCGGGACACCGGAGAGACCCAGTACTTC	CASSLIHRDTGETQYF	TRBV9	TRBJ2-5
TGTGCCACCATAACAGGGAATGAGCAGTTCTTC	CATITGNEQFF	TRBV24-1	TRBJ2-1
TGTGCCAGCAGCTTCCTTACTAGCGGGAGGGCCTCTGGAAACACCATATATTTT	CASSFLTSGRASGNTIYF	TRBV7-4	TRBJ1-3
TGTGCCAGCAGCGGACTAGCGGGGGGGGGGCAGTACAATGAGCAGTTCTTC	CASSGLAGGGQYNEQFF	TRBV9	TRBJ2-1
TGTGCCACAATGGGACTAGCGGGGGGGCGACCCTACGAGCAGTACTTC	CATMGLAGGRPYEQYF	TRBV24-1	TRBJ2-7
TGTGCCAGTAGTAACCTAGACGCCGATGAGCAGTTCTTC	CASSNLDADEQFF	TRBV19	TRBJ2-1
TGTGCCAGCAGCAGCCCAGGGATAAACGAGCAGTACTTC	CASSSPGINEQYF	TRBV7-3	TRBJ2-7
TGTGCCAGCAGTGAAAAGCCCCATGGGGGGGCCCGCACAGATACGCAGTATTTT	CASSEKPHGGARTDTQYF	TRBV2	TRBJ2-3
TGTGCCAGCGTCTTCGGGGGGTTTCAGCCCCAGCATTTT	CASVFGGFQPQHF	TRBV14	TRBJ1-5
TGTGCCAGCAGTTACGGACGGAGTTTTAACTATGGCTACACCTTC	CASSYGRSFNYGYTF	TRBV6-9	TRBJ1-2
TGTGCCAGCAGCTCGCTACCCGATACGCAGTATTTT	CASSSLPDTQYF	TRBV11-2	TRBJ2-3
TGTGCCAGCAGCAGTACAGGACAAGCCCACACCATATATTTT	CASSSTGQAHTIYF	TRBV7-6	TRBJ1-3
TGCAGTGCTCTCAGACAGGGTAGGGGTCTTGGAAACACCATATATTTT	CSALRQGRGLGNTIYF	TRBV20-1	TRBJ1-3
TGTGCCAGCAGGCCCCAGGGCAAGGGACAGAACACTGAAGCTTTCTTT	CASRPQGKGQNTEAFF	TRBV6-1	TRBJ1-1
TGTGCCAGCAGCAAAGGGGGGGGACACGGGCGTGGGGACTATGGCTACACCTTC	CASSKGGGHGRGDYGYTF	TRBV7-2	TRBJ1-2
TGCGCCAGCAGCAATGGACAGGGCGCCCAGCATTTT	CASSNGQGAQHF	TRBV5-1	TRBJ1-5
TGTGCCATCACCAGACAGGGGCCCTACGAGCAGTACTTC	CAITRQGPYEQYF	TRBV10-3	TRBJ2-7
TGTGCCAGCCTCTCGGGAGCTACTGGAAACACCATATATTTT	CASLSGATGNTIYF	TRBV6-5	TRBJ1-3
TGTGCCAGCAAAAAGTCCTCCGCGGGTGAGCAGTTCTTC	CASKKSSAGEQFF	TRBV25-1	TRBJ2-1
TGTGCCAGCAGTTTAGGTGGAAAGAGACATTCACCCCTCCACTTT	CASSLGGKRHSPLHF	TRBV27	TRBJ1-6
TGCAGTGCTAGAGGTTTAGATACCTACGAGCAGTACTTC	CSARGLDTYEQYF	TRBV20-1	TRBJ2-7
TGTGCCAGCAACAAACCCAACAAAACCTACGAGCAGTACTTC	CASNKPNKTYEQYF	TRBV6-2	TRBJ2-7
TGTGCCAGCAGCCGGGACTATAGGACCGGGGAGCTGTTTTTT	CASSRDYRTGELFF	TRBV28	TRBJ2-2
TGTGCCAGCAGCTTATCCATTGGGTCCTACGAGCAGTACTTC	CASSLSIGSYEQYF	TRBV5-6	TRBJ2-7
TGCAGTGCCACACTATCTAGCGGGGGGAATGAGCAGTTCTTC	CSATLSSGGNEQFF	TRBV20-1	TRBJ2-1
TGTGCCAGCGGAAACGTCGGCTATGAGCAGTTCTTC	CASGNVGYEQFF	TRBV6-1	TRBJ2-1
TGTGCCAGCAGTGGTGCAGGTGCTGGCTACACCTTC	CASSGAGAGYTF	TRBV27	TRBJ1-2
TGTGCCAGCAGCAGGAGGGTGACTCAGACCCAGTACTTC	CASSRRVTQTQYF	TRBV6-2	TRBJ2-5
TGTTCCGGGGCCCAAGTAGATACGCAGTATTTT	CSGAQVDTQYF	TRBV6-6	TRBJ2-3
TGTGCCAGCAGCTTAGCGCGGGGGAGTCGGGGGGGCACCGAGCAGTACTTC	CASSLARGSRGGTEQYF	TRBV7-2	TRBJ2-7
TGTGCCAGCAGTCCACCGGGACTAGGCTCCTACGAGCAGTACTTC	CASSPPGLGSYEQYF	TRBV27	TRBJ2-7
TGCGCCAGCAGCAACCCACGGGGAGAGACCCAGTACTTC	CASSNPRGETQYF	TRBV5-1	TRBJ2-5
TGCGCCAGCAGAGTGGTGGAGAGGGCCCCCGGGGAGCTGTTTTTT	CASRVVERAPGELFF	TRBV10-1	TRBJ2-2
TGTGCCTGGAGAACCTTCATATATCAACAGGGGGCGGGGGACGAGCAGTACTTC	CAWRTFIYQQGAGDEQYF	TRBV30	TRBJ2-7
TGCAGTGCTCCTGACAGGCCCTTTACTGGCCAAGAGACCCAGTACTTC	CSAPDRPFTGQETQYF	TRBV20-1	TRBJ2-5
TGTGCCAGCAGTTACTCGAGGGACCGGGACAGGGAATACTCCTACGAGCAGTACTTC	CASSYSRDRDREYSYEQYF	TRBV6-5	TRBJ2-7
TGTGCCAGCAGCGATCGACGGGATTACGAGCAGTACTTC	CASSDRRDYEQYF	TRBV13	TRBJ2-7
TGTGCCAGCAGTTACTCGGAGAGCACACCCCAAGGCGAGGAGAATGGCTACACCTTC	CASSYSESTPQGEENGYTF	TRBV6-8	TRBJ1-2
TGTGCCATTGTCCACCCTGTGCCAGGAGACACTGAAGCTTTCTTT	CAIVHPVPGDTEAFF	TRBV6-5	TRBJ1-1
TGTGCCAGCAGGGCTAGCGGGGGCTACACAGATACGCAGTATTTT	CASRASGGYTDTQYF	TRBV6-5	TRBJ2-3
TGTGCCACCAGGCCGGGACAGGGGGACACTATGACCCAGTACTTC	CATRPGQGDTMTQYF	TRBV24-1	TRBJ2-5
TGTGCCAGCAGCAAGCGGACAGGAAGAAGGGGCACCGGGGAGCTGTTTTTT	CASSKRTGRRGTGELFF	TRBV12-3	TRBJ2-2
TGCAGTGCTAGTTCAGCGCAAAACTCAGATACGCAGTATTTT	CSASSAQNSDTQYF	TRBV20-1	TRBJ2-3
TGTGCCAGCAGTTTATGCCCCGGGGCTCAAGAGACCCAGTACTTC	CASSLCPGAQETQYF	TRBV27	TRBJ2-5
TGCAGTGCTAGAGCGTACAGGAAGGACGGGTATGGCTACACCTTC	CSARAYRKDGYGYTF	TRBV20-1	TRBJ1-2
TGTGCCACCAGCAGAGATATTCCGGCGCAGGACCAAGAGACCCAGTACTTC	CATSRDIPAQDQETQYF	TRBV15	TRBJ2-5
TGTGCCACCAGTGATTTTTCCGGACAGGGGGGAGCCCGGGTACCTCTTTCACCCCTCCACTTT	CATSDFSGQGGARVPLSPLHF	TRBV24-1	TRBJ1-6
TGTGCCAGCAGCTTAGGGAAAAGGGACAGTCCGCTTTCTAACCAGCCCCAGCATTTT	CASSLGKRDSPLSNQPQHF	TRBV7-4	TRBJ1-5
TGTGCCAGCAGCCCCCCGGATCGGGAGAGGGGGGCAATGGCCAACGTCCTGACTTTC	CASSPPDRERGAMANVLTF	TRBV27	TRBJ2-6
TGTGCCAGCAGCCCCCCTCTAGCGGGCGGTTATGAGCAGTTCTTC	CASSPPLAGGYEQFF	TRBV4-2	TRBJ2-1
TGTGCCAGTAGTGTTTTCCGGGACATGGGGAGCAATCAGCCCCAGCATTTT	CASSVFRDMGSNQPQHF	TRBV19	TRBJ1-5
TGTGCCAGCAAAAAACGACAGCAGGTGACCAGGGGACGGGCTTTCTTT	CASKKRQQVTRGRAFF	TRBV5-6	TRBJ1-1
TGCAGTGCCTGCCGTGCCGGGAACACCTACGAGCAGTACTTC	CSACRAGNTYEQYF	TRBV20-1	TRBJ2-7
TGCAGTGCTATAGAGCTATCACTAGCCAAAAACATTCAGTACTTC	CSAIELSLAKNIQYF	TRBV20-1	TRBJ2-4
TGTGCCAGCAGCTTAGTTGGGGGAGATGAGCAGTTCTTC	CASSLVGGDEQFF	TRBV7-4	TRBJ2-1
TGTGCCAGCAGGAACAGGGGGCTAGTGGGGGGTGAAGCTTTCTTT	CASRNRGLVGGEAFF	TRBV5-5	TRBJ1-1
TGCGCCAGCAGTCTCTACATTGTGGGGGGCAACGAGCAGTACTTC	CASSLYIVGGNEQYF	TRBV10-1	TRBJ2-7
TGTGCCAGCAGCTACCCGGAGGGCCACTCCTATAATTCACCCCTCCACTTT	CASSYPEGHSYNSPLHF	TRBV11-3	TRBJ1-6
TGTGCCAGCTGGGGGGGGATGAGAGGAGACAATGAGCAGTTCTTC	CASWGGMRGDNEQFF	TRBV6-1	TRBJ2-1
TGTGCCTGGAGGGCAGGGGGTCGCACAGATACGCAGTATTTT	CAWRAGGRTDTQYF	TRBV30	TRBJ2-3
TGTGCCAGGGAGCGAACGAAAACCTCCTACGAGCAGTACTTC	CARERTKTSYEQYF	TRBV19	TRBJ2-7
TGTGCCAGCAGCCTGATACAGGGAGAGACCCAGTACTTC	CASSLIQGETQYF	TRBV3-1	TRBJ2-5
TGTGCCAGCAGTGGGGGGGTATTCGAGCAGTACTTC	CASSGGVFEQYF	TRBV27	TRBJ2-7
TGTGCCAGCAGTTTAAGCTTCTTCCGCGGGAGATTCTTATACTCCTACAATGAGCAGTTCTTC	CASSLSFFRGRFLYSYNEQFF	TRBV27	TRBJ2-1
TGCGCCAGCAGCGAGGCGGGGGCTTTCTACTATGGCTACACCTTC	CASSEAGAFYYGYTF	TRBV5-1	TRBJ1-2
TGCGCCAGCAGTTTTCTACTTGACGTGTTTCAGCCCCAGCATTTT	CASSFLLDVFQPQHF	TRBV10-2	TRBJ1-5
TGTGCCCATAATCGACAGCCCCAGCATTTT	CAHNRQPQHF	TRBV10-3	TRBJ1-5
TGTGCCAGCAGCGAAGTTCTCAGCAGACACCTGAACACTGAAGCTTTCTTT	CASSEVLSRHLNTEAFF	TRBV5-5	TRBJ1-1
TGTGCCAGCAGCGTAAGACCACAGGGGGCCTTACCTGAAGCTTTCTTT	CASSVRPQGALPEAFF	TRBV9	TRBJ1-1
TGTGCCAGCAGGGCGGGAGATATTACTGAAGCTTTCTTT	CASRAGDITEAFF	TRBV6-4	TRBJ1-1
TGTGCCAGCAGCTCCGGGACAGACGGGTGTGGCTACACCTTC	CASSSGTDGCGYTF	TRBV11-3	TRBJ1-2
TGTGCCAGCAGCCCGCAGGACCTAGCGGGCCCCCCAAACACCGGGGAGCTGTTTTTT	CASSPQDLAGPPNTGELFF	TRBV3-1	TRBJ2-2
TGCAGTGCTAGACGGGAGTGGGAGGGGAGAGCTAATGAAAAACTGTTTTTT	CSARREWEGRANEKLFF	TRBV20-1	TRBJ1-4
TGCGCCAGCAGCTTCAACAGGGGCGAGCAGTACTTC	CASSFNRGEQYF	TRBV5-1	TRBJ2-7
TGCAGTGCTTGCCCAAGTATTGCCACTGAAGCTTTCTTT	CSACPSIATEAFF	TRBV20-1	TRBJ1-1
TGTGCCAGCAGCAGGGGTGCGGGTTATGAAGCTTTCTTT	CASSRGAGYEAFF	TRBV6-4	TRBJ1-1
TGTGCCAGCAGCTTCTACGGACAGGGGCCGTCCGGGAGCAATCAGCCCCAGCATTTT	CASSFYGQGPSGSNQPQHF	TRBV7-3	TRBJ1-5
TGTGCCAGCAGCTTAGAGGGAGGAACCTGGGAGCAAGGGCTTGCCTATAATTCACCCCTCCACTTT	CASSLEGGTWEQGLAYNSPLHF	TRBV11-2	TRBJ1-6
TGTGCCAGCAGCTTAACGGACAGGGGGTCAAGCAATCAGCCCCAGCATTTT	CASSLTDRGSSNQPQHF	TRBV11-2	TRBJ1-5
TGTGCCAGCAGCTTCGGGGGAGAAGCGGCTATTTTGAATGAGCAGTTCTTC	CASSFGGEAAILNEQFF	TRBV5-5	TRBJ2-1
TGTGCCTGGAGCAAGGACAGGAGCCTGAGTTCACTGTTTTTT	CAWSKDRSLSSLFF	TRBV30	TRBJ1-4
TGTGCCTGGAGTGTACAGACTAAGGACGATAATTCACCCCTCCACTTT	CAWSVQTKDDNSPLHF	TRBV30	TRBJ1-6
TGTGCCAGCTCACCCGAGGTCGAGCAGTACTTC	CASSPEVEQYF	TRBV18	TRBJ2-7
TGCAGTGCCCACCGGGAGGGTGTTTATTCCGGTTCATCGGGAACTCGCACAGATACGCAGTATTTT	CSAHREGVYSGSSGTRTDTQYF	TRBV20-1	TRBJ2-3
TGTGCCACCAGTGACAAGGACAGGGGGGTGGCGGCTTTCTTT	CATSDKDRGVAAFF	TRBV24-1	TRBJ1-1
TGTGCCAGCAGTAACTCCCCCGACAGGGGGCACGGTTACAATGAGCAGTTCTTC	CASSNSPDRGHGYNEQFF	TRBV28	TRBJ2-1
TGCAGCGTGGACGCGAGTCTCGCGATTGGAAACACCATATATTTT	CSVDASLAIGNTIYF	TRBV29-1	TRBJ1-3
TGTGCCAGCAGCTACACAGGGCCCCATGCGAACACCGGGGAGCTGTTTTTT	CASSYTGPHANTGELFF	TRBV9	TRBJ2-2
TGTGCCATCAGTGACCAGGATATTAGCTCCTACAATGAGCAGTTCTTC	CAISDQDISSYNEQFF	TRBV10-3	TRBJ2-1
TGTGCCACCCGGCAGGCCTACGAGCAGTACTTC	CATRQAYEQYF	TRBV24-1	TRBJ2-7
TGTGCCAGCGAAGGACAGGGGTCGGGCTCCTACAATGAGCAGTTCTTC	CASEGQGSGSYNEQFF	TRBV11-3	TRBJ2-1
TGTGCCAGCAGCTTAGATATGATCAGGGAGGGGACCTACGAGCAGTACTTC	CASSLDMIREGTYEQYF	TRBV11-3	TRBJ2-7
TGTGCCAGCAGCCAAGAGGGGGCATATAGCAATCAGCCCCAGCATTTT	CASSQEGAYSNQPQHF	TRBV3-1	TRBJ1-5
TGTGCCAGCGCCCACAGGGAGATGGGGAATACCTCTTCCACCATATATTTT	CASAHREMGNTSSTIYF	TRBV6-4	TRBJ1-3
TGTGCCAGCAGTCTAGCGGGGGAGGGCACAGATACGCAGTATTTT	CASSLAGEGTDTQYF	TRBV3-1	TRBJ2-3
TGCGCCAGCAGCGAGGTCCGCGGGGAGACTGAAGCTTTCTTT	CASSEVRGETEAFF	TRBV5-1	TRBJ1-1
TGTGCCAGCAGCCAAGAGACAAGGGGGGATAATGAAAAACTGTTTTTT	CASSQETRGDNEKLFF	TRBV14	TRBJ1-4
TGCAGTGCTAGCATATCTACCACTAGCGGGAGGGCAATGTCCTTAACCGGGGAGCTGTTTTTT	CSASISTTSGRAMSLTGELFF	TRBV20-1	TRBJ2-2
TGTGCCAGCAGTTACTCGCAGTCCCCGACAGGGACCCGAACTAATGAAAAACTGTTTTTT	CASSYSQSPTGTRTNEKLFF	TRBV6-5	TRBJ1-4
TGTGCCAGCAGCTTAGCGAGCTCCTACAATGAGCAGTTCTTC	CASSLASSYNEQFF	TRBV7-9	TRBJ2-1
TGTGCCAGCAGCCAATTTGGAAACAGGGCTCGGTCAGATACGCAGTATTTT	CASSQFGNRARSDTQYF	TRBV3-1	TRBJ2-3
TGCAGGCGGGCTAACAATGAGCAGTTCTTC	CRRANNEQFF	TRBV29-1	TRBJ2-1
TGCAGTGCAAGTTACTGTCAGCCCCAGCATTTT	CSASYCQPQHF	TRBV20-1	TRBJ1-5
TGTGCCAGCACGGACTTCCGAGCCGGGGAGCTGTTTTTT	CASTDFRAGELFF	TRBV9	TRBJ2-2
TGTGCCAGCAGCTCCCATCGAGCTACTAATGAAAAACTGTTTTTT	CASSSHRATNEKLFF	TRBV13	TRBJ1-4
TGTGCCAGCAGCCATCTAATCCGGGACAGGGGTAGGAATGAAAAACTGTTTTTT	CASSHLIRDRGRNEKLFF	TRBV11-3	TRBJ1-4
TGTGCCAGCAGTGCCCCTCGGTCGGGCGAGCAGTACTTC	CASSAPRSGEQYF	TRBV6-5	TRBJ2-7
TGTGCCTTCGGGCGAGGGAACACTGAAGCTTTCTTT	CAFGRGNTEAFF	TRBV27	TRBJ1-1
TGTGCCAGCAGTTCCAACACTAGCGGGAGGCAGGCCAATGAGCAGTTCTTC	CASSSNTSGRQANEQFF	TRBV6-4	TRBJ2-1
TGTGCCAGCAGTGAATCTGACGACAGGGGCTCACCCCTCCACTTT	CASSESDDRGSPLHF	TRBV25-1	TRBJ1-6
TGTGCCAGCAGCGGTTACACATACCAAGAGACCCAGTACTTC	CASSGYTYQETQYF	TRBV11-2	TRBJ2-5
TGTGCCAGCAGTGAAGGCACAGGGGGAGATACGCAGTATTTT	CASSEGTGGDTQYF	TRBV6-1	TRBJ2-3
TGTGCCAGCATCCCTGAGGAGACCCAGTACTTC	CASIPEETQYF	TRBV12-3	TRBJ2-5
TGTGCCATCAGTGAGTCTAGGGAAGGAGGGTACGAGCAGTACTTC	CAISESREGGYEQYF	TRBV10-3	TRBJ2-7
TGCAGTGCTAATACCCAGAGAGGGCTCTATGAGCAGTTCTTC	CSANTQRGLYEQFF	TRBV20-1	TRBJ2-1
TGTGCCAGCAGCTGGCAGGGGAAAGAGACCCAGTACTTC	CASSWQGKETQYF	TRBV9	TRBJ2-5
TGTGCCAGCAGAAAGTTTGCGGGAGAGGAACACTCCTACAATGAGCAGTTCTTC	CASRKFAGEEHSYNEQFF	TRBV27	TRBJ2-1
TGTGCCAGCAGCCAAGGTGGACGTCTCTACGAGCAGTACTTC	CASSQGGRLYEQYF	TRBV3-1	TRBJ2-7
TGTGCCATCAGGACGGCCAATCAGCCCCAGCATTTT	CAIRTANQPQHF	TRBV10-3	TRBJ1-5
TGTGCCGTCCTGTCGACAGGCGAGCAGTACTTC	CAVLSTGEQYF	TRBV11-2	TRBJ2-7
TGTGCCACCAGTGATTTGTTAGACAGGGGCACCTACGAGCAGTACTTC	CATSDLLDRGTYEQYF	TRBV24-1	TRBJ2-7
TGTGCCAGTAGTATAACGGAGGACCGAAATCAGCCCCAGCATTTT	CASSITEDRNQPQHF	TRBV19	TRBJ1-5
TGTGCCAGCTCTCTGACCGATACGCAGTATTTT	CASSLTDTQYF	TRBV18	TRBJ2-3
TGTGCTAGCAGCTTAAAAGGACAGGGAGATGGCTACACCTTC	CASSLKGQGDGYTF	TRBV7-7	TRBJ1-2
TGTGCCAGCAGCGTGAAGGGACAGGGGCTAAGCAATCAGCCCCAGCATTTT	CASSVKGQGLSNQPQHF	TRBV13	TRBJ1-5
TGTGCCTGGAAGAAGGAGGGCGGACGGGTTCAGGTACCCCAGCATTTT	CAWKKEGGRVQVPQHF	TRBV30	TRBJ1-5
TGCAGCGTAAAGCTCAACCCCAAAGGGCGGGAGGACACAGATACGCAGTATTTT	CSVKLNPKGREDTDTQYF	TRBV29-1	TRBJ2-3
TGTGCCAGTAGTATAGAGAAACTATCCGAGGGGGACTATGGCTACACCTTC	CASSIEKLSEGDYGYTF	TRBV19	TRBJ1-2
TGTGCCAGCAGCCCAGGGGGCGCTGAGGGCTACACCTTC	CASSPGGAEGYTF	TRBV6-6	TRBJ1-2
TGTGCCAGCAGGGAGGTATCAGGCACAGATACGCAGTATTTT	CASREVSGTDTQYF	TRBV28	TRBJ2-3
TGTGCCAGCAGCCCCTCCCCGGGGTACTTC	CASSPSPGYF	TRBV4-2	TRBJ2-5
TGTGCCATCATGACAGGAAAGTATGGCTACACCTTC	CAIMTGKYGYTF	TRBV10-3	TRBJ1-2
TGTGCCAGCAGCGTCGACCGGCACTCCTACGAGCAGTACTTC	CASSVDRHSYEQYF	TRBV9	TRBJ2-7
TGTGCCAGCAGCCAAGATTCCCCCGCGTGGGACGAGCAGTACTTC	CASSQDSPAWDEQYF	TRBV4-2	TRBJ2-7
TGTGCCAGCAATCCCCCGGGTTCCAAAAACATTCAGTACTTC	CASNPPGSKNIQYF	TRBV6-2	TRBJ2-4
TGTGCCAGCAGCTCCGGCCAGGGACAGGGGGAGGATACCGGGGAGCTGTTTTTT	CASSSGQGQGEDTGELFF	TRBV9	TRBJ2-2
TGTGCCAGCAGCTTAGATGTAGAGGTTAGCAATCAGCCCCAGCATTTT	CASSLDVEVSNQPQHF	TRBV11-2	TRBJ1-5
TGTGCCAGCAGCTGGGGACTAGCGGGCCCAGAGACCCAGTACTTC	CASSWGLAGPETQYF	TRBV7-7	TRBJ2-5
TGTGCCAGCAGCTTAGAAACGGGCAAGGAGAATGAAAAACTGTTTTTT	CASSLETGKENEKLFF	TRBV11-2	TRBJ1-4
TGTGCCAGCAGCTCACGGCCCCCCTGTTCCCGGGGAGGGGGCGAGCAGTACTTC	CASSSRPPCSRGGGEQYF	TRBV7-2	TRBJ2-7
TGTGCCAGCAGCTTCCACCTAGGAGGGGGATCCCCGAAGACCCAGTACTTC	CASSFHLGGGSPKTQYF	TRBV7-2	TRBJ2-5
TGTGCCAGCAGCAGCGGGAGGGGCAACTATGGCTACACCTTC	CASSSGRGNYGYTF	TRBV13	TRBJ1-2
TGTGCCAGTAGCAAAGCAGGGGGCGAAGGACACCAGAAGACCCAGTACTTC	CASSKAGGEGHQKTQYF	TRBV19	TRBJ2-5
TGTGCCAGCAGTTGGGAAGGGACCTGTGGGGTTGGCTACACCTTC	CASSWEGTCGVGYTF	TRBV27	TRBJ1-2
TGTGCCAGCAGCGTAGTTCGCGGTTATCCAGATACGCAGTATTTT	CASSVVRGYPDTQYF	TRBV9	TRBJ2-3
TGTGCCTGGAGTGTAGCCTGGACAGCGGGTGATAGCAATCAGCCCCAGCATTTT	CAWSVAWTAGDSNQPQHF	TRBV30	TRBJ1-5
TGTGCCAGCAGTTACACTTACTCAGGGGATTCTGAAGCTTTCTTT	CASSYTYSGDSEAFF	TRBV6-3	TRBJ1-1
TGTGCCAGCAGCTACCCGGGACAGGGGGGTCAGCCCCAGCATTTT	CASSYPGQGGQPQHF	TRBV7-4	TRBJ1-5
TGTGCCAGGTCAATTCCTCCAGAGGAACCCGCCGGGGGTGAAAAACTGTTTTTT	CARSIPPEEPAGGEKLFF	TRBV2	TRBJ1-4
TGTGCCAGCAGTTACGACGCAAAACTAGCGGGCGACACAGATACGCAGTATTTT	CASSYDAKLAGDTDTQYF	TRBV27	TRBJ2-3
TGTGCCACCAGCAGAGTCTCCGGTAGGGGGGTACTAAACTATGGCTACACCTTC	CATSRVSGRGVLNYGYTF	TRBV15	TRBJ1-2
TGTGCCAGTATGGGGGGGGGTTTCTGCACAGATACGCAGTATTTT	CASMGGGFCTDTQYF	TRBV27	TRBJ2-3
TGTGCCACCAGTGATGGTGGCCCCTTCAGGGGGCGAGAGACCCAGTACTTC	CATSDGGPFRGRETQYF	TRBV24-1	TRBJ2-5
TGTGCCAGCAGCTCCGCCAGGTATAATTCACCCCTCCACTTT	CASSSARYNSPLHF	TRBV11-3	TRBJ1-6
TGTGCCAGCAGCTTACGACCCATGGTCAGCCTACTGCAGTACTTC	CASSLRPMVSLLQYF	TRBV7-9	TRBJ2-7
TGTGCCAGCAGTTACTCGGTGAAAGGATGGACAGCTAAGAATAACTATGGCTACACCTTC	CASSYSVKGWTAKNNYGYTF	TRBV6-6	TRBJ1-2
TGCAGTGATACCGGGACAACGATTTGTCAGTACTTC	CSDTGTTICQYF	TRBV20-1	TRBJ2-5
TGTGCCAGCCCGGATGCGTTGACGGCTTTCTTT	CASPDALTAFF	TRBV27	TRBJ1-1
TGCGCCAGAACGCGGACTTATAGCAATCAGCCCCAGCATTTT	CARTRTYSNQPQHF	TRBV5-1	TRBJ1-5
TGTGCCAGCAGCTCAAAGGGACAGGGGGCCTACAATGAGCAGTTCTTC	CASSSKGQGAYNEQFF	TRBV5-4	TRBJ2-1
TGTGCCAGCACAGGTGGGGTAGCGGCGGCCTACGAGCAGTACTTC	CASTGGVAAAYEQYF	TRBV28	TRBJ2-7
TGTGCCAGCAGCGCTCCTAGAGAGACCCAGTACTTC	CASSAPRETQYF	TRBV7-4	TRBJ2-5
TGTGCCAGCAGCCCAAAGGGGCTTCCGGGGGGGGGGACCTACAATGAGCAGTTCTTC	CASSPKGLPGGGTYNEQFF	TRBV7-2	TRBJ2-1
TGTGCCAGCAGCCACCTCGGGCACAGGGTGGGTGGCTACACCTTC	CASSHLGHRVGGYTF	TRBV6-2	TRBJ1-2
TGTGCCAGCAGCGTAGCCCGGGAGGGTGATGAGACCCAGTACTTC	CASSVAREGDETQYF	TRBV9	TRBJ2-5
TGCATCTTTAACGGACTCTATGGCTACACCTTC	CIFNGLYGYTF	TRBV29-1	TRBJ1-2
TGCAGTGCTACCCGCTCGTGGGACAGGGGGCCTAGGAGGGAGCGGGAAAAACTGTTTTTT	CSATRSWDRGPRREREKLFF	TRBV20-1	TRBJ1-4
TGCGCCAGCAGCCAAGCCGACAGGGGCGGACGATACGAGCAGTACTTC	CASSQADRGGRYEQYF	TRBV4-3	TRBJ2-7
TGTGCCATCAGTGAAAAGGGGTACTACAATGAGCAGTTCTTC	CAISEKGYYNEQFF	TRBV10-3	TRBJ2-1
TGTGCCAGTAGGAGGGGTAAGGGCTCCACTGAAGCTTTCTTT	CASRRGKGSTEAFF	TRBV19	TRBJ1-1
TGTGCCAGCAGTTTGGCCCCCACCCCGGACAGCCGAAACTCCGGGGAGCTGTTTTTT	CASSLAPTPDSRNSGELFF	TRBV27	TRBJ2-2
TGCGCCAGCAGCTCCGTTGTTAGACAGCTGGGGGTTACCGTTGGCCCTGAAGCTTTCTTT	CASSSVVRQLGVTVGPEAFF	TRBV5-1	TRBJ1-1
TGTGCCAGCAGTTGCCAGGGTCAGGGGGCACCTAGCAATCAGCCCCAGCATTTT	CASSCQGQGAPSNQPQHF	TRBV6-5	TRBJ1-5
TGTGCCAGCAAACTGAAGATAAGTAACTATGGCTACACCTTC	CASKLKISNYGYTF	TRBV7-6	TRBJ1-2
TGCGCCAGCTTGACAGTTTCGAGCTCCTACAATGAGCAGTTCTTC	CASLTVSSSYNEQFF	TRBV10-1	TRBJ2-1
TGCGCCAGCAGCTTGCCCGGGACTAGCGGGCCTGGAGGGGCCTACAATGAGCAGTTCTTC	CASSLPGTSGPGGAYNEQFF	TRBV5-1	TRBJ2-1
TGTGCCAGCAGTGACGGACTAGCGGGGGGGGGGGTGCCCTACAATGAGCAGTTCTTC	CASSDGLAGGGVPYNEQFF	TRBV6-4	TRBJ2-1
TGTGCCAGCAGCTTGGGGACAGGGAGGAGAAACACCATATATTTT	CASSLGTGRRNTIYF	TRBV5-4	TRBJ1-3
TGTGCCAGTAGGACGGGGGCGGAGCCCCAGCATTTT	CASRTGAEPQHF	TRBV19	TRBJ1-5
TGTGCCAGCAGCCAACATTCTAGAGGGGATACGCAGTATTTT	CASSQHSRGDTQYF	TRBV14	TRBJ2-3
TGTGCCAGCTCTCCTCTAGCGGGGAGCTACGAGCAGTACTTC	CASSPLAGSYEQYF	TRBV6-5	TRBJ2-7
TGTGCCAGCAGCCCTGGACAGGGGGCGAAGCAGCCCCAGCATTTT	CASSPGQGAKQPQHF	TRBV9	TRBJ1-5
TGCAGTGCTCCCACCAAGAGGCGGGACAGTCCTTTGGGCTACACCTTC	CSAPTKRRDSPLGYTF	TRBV20-1	TRBJ1-2
TGTGCCAGCAGTTACGTCTATAGTGCTAGCTCCTACGAGCAGTACTTC	CASSYVYSASSYEQYF	TRBV6-5	TRBJ2-7
TGTGCCAGTAGTATGACTGAGCCTGAAGCTTTCTTT	CASSMTEPEAFF	TRBV19	TRBJ1-1
TGTGCCAGCAGAGGGACAGGGGAAAGGAGGGACGGGAATCAGCCCCAGCATTTT	CASRGTGERRDGNQPQHF	TRBV3-1	TRBJ1-5
TGTGCCAGCAGCTTAAGGGTCACGGGGATTCAGCCCCAGCATTTT	CASSLRVTGIQPQHF	TRBV13	TRBJ1-5
TGTGCCAGCAGCCAAGGGGGGCCCAGAAAAGCGAACACTGAAGCTTTCTTT	CASSQGGPRKANTEAFF	TRBV3-1	TRBJ1-1
TGTGCCAGCATGTGGCGGGAGGTGAGTTACGATACCCACTCCTATAATTCACCCCTCCACTTT	CASMWREVSYDTHSYNSPLHF	TRBV6-5	TRBJ1-6
TGTGCCAGCAGCAGGGAGAACGAGCAGTACTTC	CASSRENEQYF	TRBV7-6	TRBJ2-7
TGCGCCAGCAGCTGCGGGAGGGCCGAAGCTGGGGCCAACGTCCTGACTTTC	CASSCGRAEAGANVLTF	TRBV5-1	TRBJ2-6
TGTGCTAGTGGTTTTCCCCTCAGGTATTTT	CASGFPLRYF	TRBV12-5	TRBJ2-3
TGTGCCAGCTGTGTGGGTAGCGGGAGATCCTCAGGCTCTGAGAAGGCCAAAAACATTCAGTACTTC	CASCVGSGRSSGSEKAKNIQYF	TRBV6-6	TRBJ2-4
TGTGCCAGCAGCTTAAATAATCTGTCGCTGGAGTACTTC	CASSLNNLSLEYF	TRBV7-9	TRBJ2-7
TGTGCCAGCAGCTTATCCACCGGGGAGCTGTTTTTT	CASSLSTGELFF	TRBV7-9	TRBJ2-2
TGTGCCAGCAGCTGGAGCGGGAGGTCATACAATGAGCAGTTCTTC	CASSWSGRSYNEQFF	TRBV5-5	TRBJ2-1
TGTGCCAGCAGCTTGAATAGGGGGGAGAGGACCACCGGGGAGCTGTTTTTT	CASSLNRGERTTGELFF	TRBV7-4	TRBJ2-2
TGCGCCAGCAATAGGGGACTAGCGGGACCAATTTCCGCGAATGAGCAGTTCTTC	CASNRGLAGPISANEQFF	TRBV5-1	TRBJ2-1
TGTGCCAGCAGGATAAGCGGGATGGAGAACTATGGCTACACCTTC	CASRISGMENYGYTF	TRBV11-2	TRBJ1-2
TGTGCCAGCAGCCAAGATGGGAAATTGTTACGGACAGGGGGCGGCAATCAGCCCCAGCATTTT	CASSQDGKLLRTGGGNQPQHF	TRBV3-1	TRBJ1-5
TGTGCCAGCAGTGAATTTGCCCTTCGATCGAACACTGAAGCTTTCTTT	CASSEFALRSNTEAFF	TRBV25-1	TRBJ1-1
TGTGCTAGTGGTGAGGGACAGAAGGGCTACACCTTC	CASGEGQKGYTF	TRBV12-5	TRBJ1-2
TGTGCCAGCAGCCGGGAACCCGGCTACCGTAAACTGGGGACCGGGGAGCTGTTTTTT	CASSREPGYRKLGTGELFF	TRBV4-2	TRBJ2-2
TGTGCCTGGCAACAGGGAAGTTTCACAGATACGCAGTATTTT	CAWQQGSFTDTQYF	TRBV30	TRBJ2-3
TGTGCCAGCAGCTTAAATCGCTCGACTCACGAGCAGTACTTC	CASSLNRSTHEQYF	TRBV7-9	TRBJ2-7
TGTGCCAGCAATCACGATGATACGCAGTATTTT	CASNHDDTQYF	TRBV7-3	TRBJ2-3
TGTGCAGCGGGGGGGGACAGGGCTAGGGCTTCCTATCAGCCCCAGCATTTT	CAAGGDRARASYQPQHF	TRBV12-5	TRBJ1-5
TGTGCCAGCACCAGGGACAGGAAGTTCAATCAGCCCCAGCATTTT	CASTRDRKFNQPQHF	TRBV7-9	TRBJ1-5
TGTGCCAGCGCCGCCATCGGGGGTGCCCGAACAGATACGCAGTATTTT	CASAAIGGARTDTQYF	TRBV6-1	TRBJ2-3
TGTGCCAGCAGTTACCCTAACGAACTAGCGGCGGGGAACGACAATGAGCAGTTCTTC	CASSYPNELAAGNDNEQFF	TRBV6-2	TRBJ2-1
TGTGCCAGCAGCTTGATACTAGCGGGAGTACCTTTTACAGATACGCAGTATTTT	CASSLILAGVPFTDTQYF	TRBV5-4	TRBJ2-3
TGTGCCAGCAGCTTGGCCCAGTTCCATCCGACAGGGACGATAGCTGATCAGCCCCAGCATTTT	CASSLAQFHPTGTIADQPQHF	TRBV5-4	TRBJ1-5
TGTGCCAGCAGGGGTGGACAGGGGGGAAAGGACAATCAGCCCCAGCATTTT	CASRGGQGGKDNQPQHF	TRBV28	TRBJ1-5
TGTGCCAGCGTCCCCTGCTTGAACACCGGGGAGCTGTTTTTT	CASVPCLNTGELFF	TRBV27	TRBJ2-2
TGTGCCAGCAGCTTCCTTCAGGCGTTCAAAAACATTCAGTACTTC	CASSFLQAFKNIQYF	TRBV11-3	TRBJ2-4
TGTGCCAGCAGGACACAGGCAGGGGGGGGCACCGGGGAGCTGTTTTTT	CASRTQAGGGTGELFF	TRBV7-8	TRBJ2-2
TGTGCCACCGGGACAGGCCGGACGAACACTGAAGCTTTCTTT	CATGTGRTNTEAFF	TRBV24-1	TRBJ1-1
TGTGCCATAATGACGGTATTAGATAGCAATCAGCCCCAGCATTTT	CAIMTVLDSNQPQHF	TRBV6-5	TRBJ1-5
TGTGCCAGCAGTTATCGAGGGCCCTATTCACCCCTCCACTTT	CASSYRGPYSPLHF	TRBV11-3	TRBJ1-6
TGTGCCAGCAGCTTACCCGATAGCGAGCAGTACTTC	CASSLPDSEQYF	TRBV7-9	TRBJ2-7
TGCGCCAGCTCTGGGTGGGGGAGGGCCTATGGCTACACCTTC	CASSGWGRAYGYTF	TRBV10-1	TRBJ1-2
TGTGCCAGCAGCTTAGCTACTAGCGGGAGCCTAACGGAGACCCAGTACTTC	CASSLATSGSLTETQYF	TRBV7-8	TRBJ2-5
TGCAGTGCTAGAGGGGACAGGGCGTTAAGAGAGATGAACACTGAAGCTTTCTTT	CSARGDRALREMNTEAFF	TRBV20-1	TRBJ1-1
TGTGCCAGCAGTCCGGGACAGGGTGGGGGCGGCTACACCTTC	CASSPGQGGGGYTF	TRBV6-5	TRBJ1-2
TGTGTCCAGGGGGAGAGCACCGGGGAGCTGTTTTTT	CVQGESTGELFF	TRBV11-3	TRBJ2-2
TGTGCCACCAGCAGGGGCCCAGGGGGGGGTCTCCCAGTCGGGGTCTATGGCTACACCTTC	CATSRGPGGGLPVGVYGYTF	TRBV15	TRBJ1-2
TGTGCCAGCAGTTACCCCCCCAATAGGAGTACGGGGGAGCCTAACTATGGCTACACCTTC	CASSYPPNRSTGEPNYGYTF	TRBV6-6	TRBJ1-2
TGCGCCAGCAGCCTCGTACAGGGACCCTTATTTAATGAAAAACTGTTTTTT	CASSLVQGPLFNEKLFF	TRBV4-3	TRBJ1-4
TGCGCCAGCATTGGGGCCCCTGAAGCTTTCTTT	CASIGAPEAFF	TRBV10-1	TRBJ1-1
TGTGCGTACTGTCCCGGGGGCGCCGGAAACTATGGCTACACCTTC	CAYCPGGAGNYGYTF	TRBV6-2	TRBJ1-2
TGTGCTAGCAGCTTAAGAATCAGCCGGGACAGGAACTCTGGAAACACCATATATTTT	CASSLRISRDRNSGNTIYF	TRBV7-7	TRBJ1-3
TGTGCCAGCAAAAATTCCGGGACAGGGGGCGGTCGGGGGAACACCGGGGAGCTGTTTTTT	CASKNSGTGGGRGNTGELFF	TRBV6-3	TRBJ2-2
TGTGCCAGCAGCTGGGACAGGGGGGAGCCCCAGCATTTT	CASSWDRGEPQHF	TRBV7-4	TRBJ1-5
TGTGCCAGCTCACCGGTTTTCGCCAGGACAGGTGGGCCCCAGCATTTT	CASSPVFARTGGPQHF	TRBV18	TRBJ1-5
TGTGCTAGTGGTTTGGTCCCCGTTACTTGGGTTTGGTCTAATTCACCCCTCCACTTT	CASGLVPVTWVWSNSPLHF	TRBV12-5	TRBJ1-6
TGTGCCAGTAGTCTAGTAAGGACAACTGAAGCTTTCTTT	CASSLVRTTEAFF	TRBV19	TRBJ1-1
TGTGCCACCAGCAGTACCAATAAAATACGACAGGACGCCGGTGACGAGCAGTACTTC	CATSSTNKIRQDAGDEQYF	TRBV15	TRBJ2-7
TGTGCCAGCAGCCGTGACAGGGTAAATTCACCCCTCCACTTT	CASSRDRVNSPLHF	TRBV3-1	TRBJ1-6
TGTGCCACCAGTCCGGGGGTAGGACCGGGCTACACCTTC	CATSPGVGPGYTF	TRBV24-1	TRBJ1-2
TGTGCCAGCAAGAGCGGGAAGCGTAATGAAAAACTGTTTTTT	CASKSGKRNEKLFF	TRBV27	TRBJ1-4
TGTGCCAGCAGCCGGCTAAGGGACAGCTCTAACTATGGCTACACCTTC	CASSRLRDSSNYGYTF	TRBV3-1	TRBJ1-2
TGTGCCACCAGTGATTTAGGGAGGAACAATGAGCAGTTCTTC	CATSDLGRNNEQFF	TRBV24-1	TRBJ2-1
TGCAGTGCTAGTCATTGGGGGGACCGCGAGCAGTACTTC	CSASHWGDREQYF	TRBV20-1	TRBJ2-7
TGTGCCAGCAGACCGGACTACAGGGTATACGGGGTCACCGGGGAGCTGTTTTTT	CASRPDYRVYGVTGELFF	TRBV14	TRBJ2-2
TGTGCCACCAGTGATTTCTTCGGGACGAACTTC	CATSDFFGTNF	TRBV24-1	TRBJ2-7
TGTGCCAGACCCTGGCTGCCTCCCTACGAGCAGTACTTC	CARPWLPPYEQYF	TRBV11-2	TRBJ2-7
TGTGCCAGCAGTCACAAGTCGGTGAATGAGCAGTTCTTC	CASSHKSVNEQFF	TRBV27	TRBJ2-1
TGTGCCAGCAGCTCGGCCGACTCCTACGAGCAGTACTTC	CASSSADSYEQYF	TRBV5-6	TRBJ2-7
TGCAGCGTTCCCCCGGGACAGGGGGGCTACACCTTC	CSVPPGQGGYTF	TRBV29-1	TRBJ1-2
TGTGCCAGAAGGAGGACAGGGGGCGCATATGCCGATCAGCCCCAGCATTTT	CARRRTGGAYADQPQHF	TRBV19	TRBJ1-5
TGTGCCACCAGTGATGTCTGTGCCGGTTACAATGAGCAGTTCTTC	CATSDVCAGYNEQFF	TRBV24-1	TRBJ2-1
TGTGACCAGGGCCAGGGGGAGACCCAGTACTTC	CDQGQGETQYF	TRBV12-3	TRBJ2-5
TGTGCCACCAGCAGAGATCATCAGGGACATGTCAACACTGAAGCTTTCTTT	CATSRDHQGHVNTEAFF	TRBV15	TRBJ1-1
TGTGCCAGCAGCCAAGCCCCCGCTAGGGGCAAGTACGAGCAGTACTTC	CASSQAPARGKYEQYF	TRBV14	TRBJ2-7
TGTGCCAGCAGACAGGGGGCTGTTCGGTGCTCCTACGAGCAGTACTTC	CASRQGAVRCSYEQYF	TRBV7-9	TRBJ2-7
TGTGCCAGCAGTGAGTACAGATGCGGGAGAACTGAAGCTTTCTTT	CASSEYRCGRTEAFF	TRBV12-3	TRBJ1-1
TGTGCCAGCAGCCCGGACCCTAGCGGGGCTGAGCAGTTCTTC	CASSPDPSGAEQFF	TRBV9	TRBJ2-1
TGCAGTGCTAGAGATCTCCGGCCATACCTCTATGGCTACACCTTC	CSARDLRPYLYGYTF	TRBV20-1	TRBJ1-2
TGTGCCAGCAGCAAGCCGCCAGGGGTAGAGACCCAGTACTTC	CASSKPPGVETQYF	TRBV13	TRBJ2-5
TGCGCCAGCAGCAACAGTAATAGACGGGACGAGCAGTACTTC	CASSNSNRRDEQYF	TRBV5-1	TRBJ2-7
TGTGCCAGCAGTTATGACAGGGGCTTCGGGGCCAACGTCCTGACTTTC	CASSYDRGFGANVLTF	TRBV27	TRBJ2-6
TGTGCCAGCAGCCGGGGGATGGATGGCTACACCTTC	CASSRGMDGYTF	TRBV13	TRBJ1-2
TGTGCCAGCAGTTTATGGCAGGGTCAGCCCCAGCATTTT	CASSLWQGQPQHF	TRBV27	TRBJ1-5
TGTGCCAGTCTGACAGGGGATGGGCACTCTAATGAAAAACTGTTTTTT	CASLTGDGHSNEKLFF	TRBV25-1	TRBJ1-4
TGCAAAGGGACTAGCGGGGGGGCCACCGGGGAGCTGTTTTTT	CKGTSGGATGELFF	TRBV20-1	TRBJ2-2
TGCGCCAGCAGCCGAAAAGGGGGGGCGAGGGCCTACAATGAGCAGTTCTTC	CASSRKGGARAYNEQFF	TRBV5-1	TRBJ2-1
TGTGCCAGCAGGGCGAGCCAGTACTTC	CASRASQYF	TRBV5-4	TRBJ2-5
TGTGCCAGCATAGAGGGAACCGGGGAGCTGTTTTTT	CASIEGTGELFF	TRBV6-4	TRBJ2-2
TGCAGTGCCCGCGACAAACGAGGGACCCAGCATTTT	CSARDKRGTQHF	TRBV20-1	TRBJ1-5
TGTGCCTGGACGTATCCCGGTTCAGATACGCAGTATTTT	CAWTYPGSDTQYF	TRBV30	TRBJ2-3
TGCAGTGCTAGAGACCATGGACTAGCGGGCCGAAGATACAATGAGCAGTTCTTC	CSARDHGLAGRRYNEQFF	TRBV20-1	TRBJ2-1
TGTGCCAGCAGCCTGGCTCCCCGGCCTCCTAATGAAAAACTGTTTTTT	CASSLAPRPPNEKLFF	TRBV14	TRBJ1-4
TGTGCCATACCCCGAGGTCCTCGGCGAATCAATCAGCCCCAGCATTTT	CAIPRGPRRINQPQHF	TRBV19	TRBJ1-5
TGTGCCAGCAGCCGGGGCCCCCTGAGAGAGACCCAGTACTTC	CASSRGPLRETQYF	TRBV7-2	TRBJ2-5
TGTGCCAGCTCACCACCGGCTGGAGACCCGGGACTAGCGGACTTGACAGATACGCAGTATTTT	CASSPPAGDPGLADLTDTQYF	TRBV18	TRBJ2-3
TGTGCCAGCAGTTTTCGGAGGGACGGGGAGCTGTTTTTT	CASSFRRDGELFF	TRBV6-1	TRBJ2-2
TGTGCCAGCAGTGACTCCTGGCGACAGGGGGCACCCCCTAACTATGGCTACACCTTC	CASSDSWRQGAPPNYGYTF	TRBV6-4	TRBJ1-2
TGTGCCACCAGCTTAGGGGCCCCTGGGGAGGACGAGCAGTACTTC	CATSLGAPGEDEQYF	TRBV24-1	TRBJ2-7
TGTGCCAGCAGCCCGCGGGAGGTAACCAATGAGCAGTTCTTC	CASSPREVTNEQFF	TRBV6-5	TRBJ2-1
TGTGCCAGCACGACTAGCGGGGGGCCCTACGAGCAGTACTTC	CASTTSGGPYEQYF	TRBV12-3	TRBJ2-7
TGTGCCAGCAGCCACCTAGCCCAGGGGTATGCACGTTTCGGGCCCCAGCATTTT	CASSHLAQGYARFGPQHF	TRBV9	TRBJ1-5
TGTCCATGGGGTAGGACAGGGGGCACTGCCTATGGCTACACCTTC	CPWGRTGGTAYGYTF	TRBV30	TRBJ1-2
TGTGCCAGCAGCTTTGAATTCCTGGGACATAAGGAGCAGTATTTT	CASSFEFLGHKEQYF	TRBV5-4	TRBJ2-3
TGCGCCAGCAGCCCCACAGGTAGAAACACCATATATTTT	CASSPTGRNTIYF	TRBV4-1	TRBJ1-3
TGTGCCAGCAGCGGGCTACCTACCGGTGGGTCCTACGAGCAGTACTTC	CASSGLPTGGSYEQYF	TRBV7-9	TRBJ2-7
TGTGCCAGCAGCAAGGGGACGGGATATCAGCCCCAGCATTTT	CASSKGTGYQPQHF	TRBV7-9	TRBJ1-5
TGTGCCAGCAGCGGCAATACTAGCGGGCGAGATACGCAGTATTTT	CASSGNTSGRDTQYF	TRBV7-9	TRBJ2-3
TGTGCGCGAAGCCGGCTAGCCAAAAACATTCAGTACTTC	CARSRLAKNIQYF	TRBV6-5	TRBJ2-4
TGTGCCAGCTCACCAAAAACAGGGGGGGGCCCCAGCAGCCCCTACGAGCAGTACTTC	CASSPKTGGGPSSPYEQYF	TRBV18	TRBJ2-7
TGCGCCAGCAGGTGGAGGTTCGGGGGGCCCAAGTACAATGAGCAGTTCTTC	CASRWRFGGPKYNEQFF	TRBV4-1	TRBJ2-1
TGTGCCGACCTCGGTCCCGGGACTAGCGGGGGGGAACCAGATACGCAGTATTTT	CADLGPGTSGGEPDTQYF	TRBV6-5	TRBJ2-3
TGCGCCAGCAGCCAAGACCCCTATCAGCCCCAGCATTTT	CASSQDPYQPQHF	TRBV4-1	TRBJ1-5
TGTGCCAGCACCGACAGGGAGTATGAGGGAAACACCATATATTTT	CASTDREYEGNTIYF	TRBV28	TRBJ1-3
TGTGCCAGCCAAGACAGTACAACTAATGAAAAACTGTTTTTT	CASQDSTTNEKLFF	TRBV6-6	TRBJ1-4
TGTGCCAGCAGCGACGGTAACTATGGCTACACCTTC	CASSDGNYGYTF	TRBV7-9	TRBJ1-2
TGTGCCAGCAAGACAGGGGTAAACACTGAAGCTTTCTTT	CASKTGVNTEAFF	TRBV2	TRBJ1-1
TGTGCCAGCAGTCGAATCGGCTACACCTTC	CASSRIGYTF	TRBV9	TRBJ1-2
TGTGCCAGCAGTTTATGGGCTGTTGAAAAACTGTTTTTT	CASSLWAVEKLFF	TRBV27	TRBJ1-4
TGCAGTGCTAGAGAGGGGAGGGGGGAGATTCAGTACTTC	CSAREGRGEIQYF	TRBV20-1	TRBJ2-4
TGTGCCAGCAGCCAAGAGGAGCAGTTCTTC	CASSQEEQFF	TRBV13	TRBJ2-1
TGCAGTGCTGACAGGGTATTTGAGACCCAGTACTTC	CSADRVFETQYF	TRBV20-1	TRBJ2-5
TGTGCCAGCAGCCAAGCGGGAGTGGGACCAGATACGCAGTATTTT	CASSQAGVGPDTQYF	TRBV4-2	TRBJ2-3
TGTGCCAGCAGGGGGGTAACACAGGGAGGGTGTTCATTGAACACTGAAGCTTTCTTT	CASRGVTQGGCSLNTEAFF	TRBV9	TRBJ1-1
TGCGCCAGCAGTGAGATACTCATGGGGGGGGAGCAGTACTTC	CASSEILMGGEQYF	TRBV10-1	TRBJ2-7
TGCGCCAGTAAACGTCCGGGACAGGTAGCAGATACGCAGTATTTT	CASKRPGQVADTQYF	TRBV5-1	TRBJ2-3
TGCGCCAGCAGCTTGGACCGGGGGCTCTCTGGGGCCAACGTCCTGACTTTC	CASSLDRGLSGANVLTF	TRBV5-1	TRBJ2-6
TGCGCCAGCGGAACTCGGGCTGCTCGTCGCCTGGGAAACACCATATATTTT	CASGTRAARRLGNTIYF	TRBV5-1	TRBJ1-3
TGTGCCAGCAGTTACACCACCTCAAGGCCGACGTACGAGCAGTACTTC	CASSYTTSRPTYEQYF	TRBV6-5	TRBJ2-7
TGTGCCAGCAGCCAATGCGGCCAAGAGACCCAGTACTTC	CASSQCGQETQYF	TRBV13	TRBJ2-5
TGCAGTGCTAAGAGGTCTGGAAGGAACACTGAAGCTTTCTTT	CSAKRSGRNTEAFF	TRBV20-1	TRBJ1-1
TGCAGCGTTTGTCCCAACCCTAGACTAGCGGGCTCCTACAATGAGCAGTTCTTC	CSVCPNPRLAGSYNEQFF	TRBV29-1	TRBJ2-1
TGTGCCAGCAGCTCCTCGCAAAGGGTGCTTGAGACCCAGTACTTC	CASSSSQRVLETQYF	TRBV13	TRBJ2-5
TGTGCCTTTCTTAGCTGGGGGAAGGGGACAGATACGCAGTATTTT	CAFLSWGKGTDTQYF	TRBV6-2	TRBJ2-3
TGCAGTGCTAGAGAAGGTGATTCCCCGGACGGTTCTGAAGCTTTCTTT	CSAREGDSPDGSEAFF	TRBV20-1	TRBJ1-1
TGTGCCAGCAGCTTATGGGCGTCTGGCTACACCTTC	CASSLWASGYTF	TRBV7-2	TRBJ1-2
TGTGCCAGCAGCCTCCCAGGGACCTACAATGAGCAGTTCTTC	CASSLPGTYNEQFF	TRBV13	TRBJ2-1
TGTGCCAGCAGCCTGGACAGGGATGGGGTTGAGCAGTACTTC	CASSLDRDGVEQYF	TRBV7-3	TRBJ2-7
TGTGCCAGCAGTGTACAGGGGACTGAAGCTTTCTTT	CASSVQGTEAFF	TRBV6-1	TRBJ1-1
TGTGCCATCAGTGACACCTGGGACAGGGGGTACGCCTCTGGGGCCAACGTCCTGACTTTC	CAISDTWDRGYASGANVLTF	TRBV10-3	TRBJ2-6
TGTGCCAGCAGCCCAATGGGGCGACTGTTTTTT	CASSPMGRLFF	TRBV13	TRBJ1-4
TGTGCCAGCAGCTTAGCCCCCGGACAGGAGACCCAGTACTTC	CASSLAPGQETQYF	TRBV7-9	TRBJ2-5
TGTGCCAGCGCTGGACAATTTGGGACAGCCTTGGGATCCTACAATGAGCAGTTCTTC	CASAGQFGTALGSYNEQFF	TRBV9	TRBJ2-1
TGTGCCAGCAGTTTAAGAATCGATTATAATGAAAAACTGTTTTTT	CASSLRIDYNEKLFF	TRBV27	TRBJ1-4
TGTGCCACCAGCCCAATTGACAGAATTCAGTACTATGGCTACACCTTC	CATSPIDRIQYYGYTF	TRBV24-1	TRBJ1-2
TGTGCCAGCAGCCCCATTACAGGGCGGGGTAATGAAAAACTGTTTTTT	CASSPITGRGNEKLFF	TRBV3-1	TRBJ1-4
TGTGCCAGCATCGTAACTAAACCTCAGCCCCAGCATTTT	CASIVTKPQPQHF	TRBV27	TRBJ1-5
TGTGCCAGCAGCTACCAAGTAGCCCGCCGGGACAGGGCATATAACTATGGCTACACCTTC	CASSYQVARRDRAYNYGYTF	TRBV5-4	TRBJ1-2
TGTGCCAGCAGCCAAGAGCGGGGGGGCTCCCTCTCCTACGAGCAGTACTTC	CASSQERGGSLSYEQYF	TRBV14	TRBJ2-7
TGTGCCAGCAGTTCAAGCCCGCGACTAGCGGGTATTAGCACAGATACGCAGTATTTT	CASSSSPRLAGISTDTQYF	TRBV27	TRBJ2-3
TGTGCCTGGATTTGCCAGGGCAGCCAAGAGACCCAGTACTTC	CAWICQGSQETQYF	TRBV30	TRBJ2-5
TGTGCCAGCAGTCGCAGGGAACCGGGTACCGGGGAGCTGTTTTTT	CASSRREPGTGELFF	TRBV9	TRBJ2-2
TGTGCTAGTGATACGGGCAACTACGAGCAGTACTTC	CASDTGNYEQYF	TRBV12-5	TRBJ2-7
TGTGCCAGCAGTACCAATCCTAGCGGGGGCAATGAGCAGTTCTTC	CASSTNPSGGNEQFF	TRBV6-2	TRBJ2-1
TGTGCCACCAGTGTTCGGGAGTATGGCTACACCTTC	CATSVREYGYTF	TRBV24-1	TRBJ1-2
TGTGCTAGTGGTTTACTTTCCCCGCTTACCCGAGGCTATGGCTACACCTTC	CASGLLSPLTRGYGYTF	TRBV12-5	TRBJ1-2
TGCGCCAGCAGACGTCTGACTTACCCAGATACGCAGTATTTT	CASRRLTYPDTQYF	TRBV10-1	TRBJ2-3
TGTGCCAGCAGCTTTCCCTCTATGGCCTACGAGCAGTACTTC	CASSFPSMAYEQYF	TRBV7-2	TRBJ2-7
TGTGCCAGCATTCCGGGACTTGGTAAATACGAGCAGTACTTC	CASIPGLGKYEQYF	TRBV7-4	TRBJ2-7
TGTGCCACCAGAGGGGACAGCAATGAGCAGTTCTTC	CATRGDSNEQFF	TRBV24-1	TRBJ2-1
TGTGCCAGCCGCCCTTTTATTCAGGGAAAGTACGAGCAGTACTTC	CASRPFIQGKYEQYF	TRBV28	TRBJ2-7
TGTGCCAGCAGTTTGACAGGGGCTCCGGACGCGGACACTGAAGCTTTCTTT	CASSLTGAPDADTEAFF	TRBV27	TRBJ1-1
TGTGCCAGCAGCCCCCGAACAAGGGGGCCCGGACAGCCCCAGCATTTT	CASSPRTRGPGQPQHF	TRBV7-3	TRBJ1-5
TGTGCCAGCAGCTTTAAGGGGAGTACATTCTATGGCTACACCTTC	CASSFKGSTFYGYTF	TRBV11-2	TRBJ1-2
TGTGCCAGCAGAACGACAAGGAGGAACTATGGCTACACCTTC	CASRTTRRNYGYTF	TRBV7-9	TRBJ1-2
TGTGCCAGCAGAAGGCCGGCAGTGTATTTT	CASRRPAVYF	TRBV6-4	TRBJ2-3
TGTGCCAGCGGGGGGGGGACAGGGTCGGCTGAAGCTTTCTTT	CASGGGTGSAEAFF	TRBV2	TRBJ1-1
TGTGCCAGCAGCCCAGGGAATGGCTACACCTTC	CASSPGNGYTF	TRBV7-2	TRBJ1-2
TGCGCCAGCGGGATACCCAGACAGCGTGCAACTAATGAAAAACTGTTTTTT	CASGIPRQRATNEKLFF	TRBV4-1	TRBJ1-4
TGTGCCAGCAGCCACGTGGGGGGGTCGGATTTTGGAACAAGCTCCTACAATGAGCAGTTCTTC	CASSHVGGSDFGTSSYNEQFF	TRBV11-3	TRBJ2-1
TGTGCCACCAGCAGCCGCAGGGGAGCTCTCACAGATACGCAGTATTTT	CATSSRRGALTDTQYF	TRBV15	TRBJ2-3
TGTGCCACCAGTGCCCCTGGGGACTACGAGCAGTACTTC	CATSAPGDYEQYF	TRBV24-1	TRBJ2-7
TGTGCCAGCAGCCGTCCGGGACAGGGCTATGGCTACACCTTC	CASSRPGQGYGYTF	TRBV6-1	TRBJ1-2
TGTGCCAGCAGCACAGGGGCGGGGGACGAGCAGTACTTC	CASSTGAGDEQYF	TRBV6-4	TRBJ2-7
TGCAGTGCGGCAGGGACTAGCGGGGCTTATACCAGCTCCTACAATGAGCAGTTCTTC	CSAAGTSGAYTSSYNEQFF	TRBV20-1	TRBJ2-1
TGTGCCACCAGTGGGGGGCTTGCTAATGAAAAACTGTTTTTT	CATSGGLANEKLFF	TRBV24-1	TRBJ1-4
TGTGCCGGGGGATTGGCGACCGGCTCCTACGAGCAGTACTTC	CAGGLATGSYEQYF	TRBV10-3	TRBJ2-7
TGTGCCAGCAGCCGTCAGGGGAGGCGTTCCGCTCAGCCCCAGCATTTT	CASSRQGRRSAQPQHF	TRBV3-1	TRBJ1-5
TGTGCCAGCAGGTTGGTGACAGGGGGCGGATACAATGAGCAGTTCTTC	CASRLVTGGGYNEQFF	TRBV28	TRBJ2-1
TGCCGACAGGGTTCGGCTGCCTACGAGCAGTACTTC	CRQGSAAYEQYF	TRBV20-1	TRBJ2-7
TGTGCCAGCAGCCTAGCGGGGGAAGAGACCCAGTACTTC	CASSLAGEETQYF	TRBV7-2	TRBJ2-5
TGTGCCACCAGCAGAAGGACAGCAACCCGCTACGAGCAGTACTTC	CATSRRTATRYEQYF	TRBV15	TRBJ2-7
TGTGCCACCAGTGATCGCGTGACAGAAGAAGATCAGCCCCAGCATTTT	CATSDRVTEEDQPQHF	TRBV24-1	TRBJ1-5
TGTGCCAGCAGCCGGGGCACCCCTAACTATGGCTACACCTTC	CASSRGTPNYGYTF	TRBV14	TRBJ1-2
TGTGCCAGCAGCTTGGCCGGCTTGACTAGCGGGGGGGCGCCCTACAATGAGCAGTTCTTC	CASSLAGLTSGGAPYNEQFF	TRBV5-5	TRBJ2-1
TGTGCCAGCAGCCAAGCCTCAGCTCAAGTCACCGGGGAGCTGTTTTTT	CASSQASAQVTGELFF	TRBV14	TRBJ2-2
TGTGCCAGCAGCTTGGCTGGACAGGATAAGTTACCCGAGCAGTACTTC	CASSLAGQDKLPEQYF	TRBV5-6	TRBJ2-7
TGTGCCAGCAGCCATGAAACCCGAACAGGGACGAACACTGAAGCTTTCTTT	CASSHETRTGTNTEAFF	TRBV7-9	TRBJ1-1
TGTGCCAGCAGCACCCCGAGGGGTCCGTACAATCAGCCCCAGCATTTT	CASSTPRGPYNQPQHF	TRBV7-3	TRBJ1-5
TGTGCCAGGGGCAGATATCAGCCCCAGCATTTT	CARGRYQPQHF	TRBV19	TRBJ1-5
TGTGCCACCAGTGATAGCATAGCGGGAAAATACAATGAGCAGTTCTTC	CATSDSIAGKYNEQFF	TRBV24-1	TRBJ2-1
TGTGCCAGCAGCTTGTTTAGACAGTGCACAGATACGCAGTATTTT	CASSLFRQCTDTQYF	TRBV5-4	TRBJ2-3
TGCGCCAGCAGCTGGGGACAAGGCTACACCTTC	CASSWGQGYTF	TRBV10-1	TRBJ1-2
TGTGCCACCAGTGATTTGTCTTCAGTGGCCAACAATGAGCAGTTCTTC	CATSDLSSVANNEQFF	TRBV24-1	TRBJ2-1
TGTGCCAGCCCATCGTCCTCGTATCAGCCCCAGCATTTT	CASPSSSYQPQHF	TRBV25-1	TRBJ1-5
TGCGCCAGCAGTGGGACAGGGGGGGTAGAGACCCAGTACTTC	CASSGTGGVETQYF	TRBV10-1	TRBJ2-5
TGTGCCACCAGTGATCACTCAAGGGGATCACCCCTCCACTTT	CATSDHSRGSPLHF	TRBV24-1	TRBJ1-6
TGTGCCTGGAGGTTGGGGGGAGGGATTTATTTCACCTACAATGAGCAGTTCTTC	CAWRLGGGIYFTYNEQFF	TRBV30	TRBJ2-1
TGCAGCGTTATAATTGAAATGGGTAAGGGGGGGACTAGCCCGACAGATACGCAGTATTTT	CSVIIEMGKGGTSPTDTQYF	TRBV29-1	TRBJ2-3
TGTGCCAGCAGTTTACCAGGGGGCGAGCAGTACTTC	CASSLPGGEQYF	TRBV28	TRBJ2-7
TGTGCCAGCAGCGCCTCTGAGACAGGGAATCCATATGGCTACACCTTC	CASSASETGNPYGYTF	TRBV2	TRBJ1-2
TGTGCCAGCAGCTTAGTTTTGTCGGAGACCTACAATGAGCAGTTCTTC	CASSLVLSETYNEQFF	TRBV11-3	TRBJ2-1
TGCGCCAGCAGCTTCAAAAGGGCGGGGGGGAATTCACCCCTCCACTTT	CASSFKRAGGNSPLHF	TRBV5-1	TRBJ1-6
TGTGCTAGCAGCCCCACTAGCGGGAGGACCTACGAGCAGTACTTC	CASSPTSGRTYEQYF	TRBV7-7	TRBJ2-7
TGCGCCAGAGCCGAGCGGGACACCTATAATTCACCCCTCCACTTT	CARAERDTYNSPLHF	TRBV10-1	TRBJ1-6
TGCGCCACCAGGCCTACGGCGCTAAACACTGAAGCTTTCTTT	CATRPTALNTEAFF	TRBV10-1	TRBJ1-1
TGTGCCAGTAGTCGACGGACTAGCGGGAACGGGTACAATGAGCAGTTCTTC	CASSRRTSGNGYNEQFF	TRBV19	TRBJ2-1
TGCGCCAGCAGCGGTTTTGGGACTAATCAGCCCCAGCATTTT	CASSGFGTNQPQHF	TRBV5-1	TRBJ1-5
TGTGCCAGCAGCCAAGGGACAGGACAAGTGTACGAGCAGTACTTC	CASSQGTGQVYEQYF	TRBV14	TRBJ2-7
TGTGCCAGCCCCGCGAATACCTACGAGCAGTACTTC	CASPANTYEQYF	TRBV7-6	TRBJ2-7
TGTGCCAGCAGTTACTCGTTAGTTGGCCGTCCCGGGGCTACTAGCGGGAGCGGAGGTAATGAAAAACTGTTTTTT	CASSYSLVGRPGATSGSGGNEKLFF	TRBV6-5	TRBJ1-4
TGTGCCAGCCAGCACCGGGACAGGGGAGGGAATGAGCAGTTCTTC	CASQHRDRGGNEQFF	TRBV27	TRBJ2-1
TGTGCCAGCAGTCCAACAGAGGAACAGGGGGAGGGTTCACCCCTCCACTTT	CASSPTEEQGEGSPLHF	TRBV27	TRBJ1-6
TGTGCCAGCAGCTTTCAGGGGGGCTACACCTTC	CASSFQGGYTF	TRBV7-9	TRBJ1-2
TGTGCCAGCAGTGGGTACAGGGTGAGGCTCTACGAGCAGTACTTC	CASSGYRVRLYEQYF	TRBV6-5	TRBJ2-7
TGTGCCAGCTTTAACGACAGGGAAAAACTGTTTTTT	CASFNDREKLFF	TRBV19	TRBJ1-4
TGTGCCAGCAGACCCAGGGTCGAATACACAGATACGCAGTATTTT	CASRPRVEYTDTQYF	TRBV5-6	TRBJ2-3
TGCGCCAGCAGCCCCGGTTCCCCCCAGGCGCAGCCCCAGCATTTT	CASSPGSPQAQPQHF	TRBV4-3	TRBJ1-5
TGCGCCAGCAGCTTTAACGAGGGTACCAATGAAAAACTGTTTTTT	CASSFNEGTNEKLFF	TRBV5-1	TRBJ1-4
TGTGCCAGCAGCGTCCTCCGGGACGGCACAGATACGCAGTATTTT	CASSVLRDGTDTQYF	TRBV13	TRBJ2-3
TGCGCCAGCATCCCCCAGGGATACGGCAAAAACATTCAGTACTTC	CASIPQGYGKNIQYF	TRBV10-1	TRBJ2-4
TGTGCCAGCACTCCCAGGGGGGGACGGGGCGCGAACACCGGGGAGCTGTTTTTT	CASTPRGGRGANTGELFF	TRBV9	TRBJ2-2
TGCAGCGTTGTTGTGACATCTCCGAGGGATTCACCCCTCCACTTT	CSVVVTSPRDSPLHF	TRBV29-1	TRBJ1-6
TGTGCCAGCAGGGCAAGATGGCTCGCCGGAAACACCATATATTTT	CASRARWLAGNTIYF	TRBV11-2	TRBJ1-3
TGTGCCACCAGCGTCCGGGGATCCTACGAGCAGTACTTC	CATSVRGSYEQYF	TRBV15	TRBJ2-7
TGCGCCAGCAGTGACCCCGGGACTAGTGCGGACGAGCAGTACTTC	CASSDPGTSADEQYF	TRBV10-2	TRBJ2-7
TGTGCCGTGAACAGGGAAATAGGGGGCACAGATACGCAGTATTTT	CAVNREIGGTDTQYF	TRBV19	TRBJ2-3
TGTGCCAGCAGCCACACGGATCGCACCGGGGAGCTGTTTTTT	CASSHTDRTGELFF	TRBV5-4	TRBJ2-2
TGTGCCAGCAGCCCCAGATATGGCTACACCTTC	CASSPRYGYTF	TRBV7-9	TRBJ1-2
TGTGCCACCAGTGATTCTCCCGGGGTAACTTGGGACACAGATACGCAGTATTTT	CATSDSPGVTWDTDTQYF	TRBV24-1	TRBJ2-3
TGTGCCAGCATCTCGGGGAATACCGGAAACACCATATATTTT	CASISGNTGNTIYF	TRBV13	TRBJ1-3
TGTGCCAGGCTAGCCGGGGAGCTGTTTTTT	CARLAGELFF	TRBV28	TRBJ2-2
TGTGCCAGCACCCCGGGACAGGGGGCAGTCAACACTGAAGCTTTCTTT	CASTPGQGAVNTEAFF	TRBV6-4	TRBJ1-1
TGTGCCAGCAGCCAGATAGCGGAAGGCACAGATACGCAGTATTTT	CASSQIAEGTDTQYF	TRBV7-3	TRBJ2-3
TGCAGTGCTTCATCCACGTCCCGCCCAGTCCAAGCGCGGCGCACCGGGGAGCTGTTTTTT	CSASSTSRPVQARRTGELFF	TRBV20-1	TRBJ2-2
TGTGCCAGCAGCTTGGTCACAGGGAGGGACCCCCAGTACTTC	CASSLVTGRDPQYF	TRBV11-3	TRBJ2-5
TGTGCCAGCAGTTTGGCGGAGCCGAACGAGCAGTACTTC	CASSLAEPNEQYF	TRBV6-5	TRBJ2-7
TGTGCCAGCAGGGCCACAGGTCAGCCCCAGCATTTT	CASRATGQPQHF	TRBV28	TRBJ1-5
TGTGCCTGCGACAGATACTCCTACGAGCAGTACTTC	CACDRYSYEQYF	TRBV30	TRBJ2-7
TGTGCCAGCAGTGGTCCGGGGGGACATAACTATGGCTACACCTTC	CASSGPGGHNYGYTF	TRBV6-1	TRBJ1-2
TGTGCCACCAGTGATCGGGCTCCTCTGCAGGGTGGAGGCTACGAGCAGTACTTC	CATSDRAPLQGGGYEQYF	TRBV24-1	TRBJ2-7
TGTGCCAGCAGCTGCTGGCCGGGACAGGGAGGCATGGAGACCCAGTACTTC	CASSCWPGQGGMETQYF	TRBV5-6	TRBJ2-5
TGCGCCACAGGGACTAATGAGCAGTTCTTC	CATGTNEQFF	TRBV5-1	TRBJ2-1
TGTGCCAGCAGCCATGAACAGGGTGAGTACGAGCAGTACTTC	CASSHEQGEYEQYF	TRBV13	TRBJ2-7
TGTGCCAGCAGCCCGGACCGGGGGATCCCAGTCACCGGGGAGCTGTTTTTT	CASSPDRGIPVTGELFF	TRBV7-4	TRBJ2-2
TGTGCCAGCAGCTTCGGACTTCCATCGTATGGCTACACCTTC	CASSFGLPSYGYTF	TRBV9	TRBJ1-2
TGTGCCAGCAGAAAGGGGGGGTTGTCCTACGAGCAGTACTTC	CASRKGGLSYEQYF	TRBV7-2	TRBJ2-7
TGTGCCCTACGGTATGGCTACACCTTC	CALRYGYTF	TRBV27	TRBJ1-2
TGCGCCAGCAGCCAAGATATTCGGATTCCGACAGATACGCAGTATTTT	CASSQDIRIPTDTQYF	TRBV4-1	TRBJ2-3
TGTGCCAGCAGTTATGCAAGGACCAAGTACAATGAGCAGTTCTTC	CASSYARTKYNEQFF	TRBV6-2	TRBJ2-1
TGTGCCAGTACACTCAGACACCGGGACAGAACCACTGAAGCTTTCTTT	CASTLRHRDRTTEAFF	TRBV19	TRBJ1-1
TGTGCCAGCAGTTACCCGCTTGGGGCGTACTCTGGGGCCAACGTCCTGACTTTC	CASSYPLGAYSGANVLTF	TRBV6-5	TRBJ2-6
TGTGCCAGTAGTTTGCGGGGCTACGAGCAGTACTTC	CASSLRGYEQYF	TRBV19	TRBJ2-7
TGTGCTAGTGGTTGCAACTCTCTGGGAGTCCACAATGAGCAGTTCTTC	CASGCNSLGVHNEQFF	TRBV12-5	TRBJ2-1
TGCCTTCGAGGGAGACCAGAGACCCAGTACTTC	CLRGRPETQYF	TRBV20-1	TRBJ2-5
TGTGCCAGCATAGGGACAGGGCACTCTGGAAACACCATATATTTT	CASIGTGHSGNTIYF	TRBV12-4	TRBJ1-3
TGCAGCGTCCCAGGAAGGGTAGGCCAGCCCCAGCATTTT	CSVPGRVGQPQHF	TRBV29-1	TRBJ1-5
TGTGCCAGCCTTTTAGGGGGGGAATTGCAAGAGACCCAGTACTTC	CASLLGGELQETQYF	TRBV5-8	TRBJ2-5
TGTGCCAGCAGCATTACCAGGGGGGGGAGGACGCCCCAGCATTTT	CASSITRGGRTPQHF	TRBV13	TRBJ1-5
TGCGCCAGCAGCCCCCCCCTCGGACAGGAAGGGGGATACGAGCAGTACTTC	CASSPPLGQEGGYEQYF	TRBV4-1	TRBJ2-7
TGTGCCAGTCTTGGACAGGGCCTGGTCGGCAATCAGCCCCAGCATTTT	CASLGQGLVGNQPQHF	TRBV19	TRBJ1-5
TGTGCCACCAGTGATTTCGGCAGGGGTTACTATGGCTACACCTTC	CATSDFGRGYYGYTF	TRBV24-1	TRBJ1-2
TGTGCCAGCAGCATACAGGGGGCGGGGCGGGTAAACAACTATGGCTACACCTTC	CASSIQGAGRVNNYGYTF	TRBV7-2	TRBJ1-2
TGCGCCAGCAGGTACGATGGCTACACCTTC	CASRYDGYTF	TRBV4-3	TRBJ1-2
TGTGCCAGCAGTTCAGGGACAGGGATTAATGGCTACACCTTC	CASSSGTGINGYTF	TRBV6-5	TRBJ1-2
TGTGCCAGCAGCTTCCAGGTCCCGCTCACAGATACGCAGTATTTT	CASSFQVPLTDTQYF	TRBV7-4	TRBJ2-3
TGTGCCAGCAGCCCCAGGCACCCGGGACAGGGGCCTAAAGGGGAGCTGTTTTTT	CASSPRHPGQGPKGELFF	TRBV7-3	TRBJ2-2
TGTGCCAGCAGCTGGTCCGGGGCCTACGAGCAGTACTTC	CASSWSGAYEQYF	TRBV5-4	TRBJ2-7
TGTGCCAGCAGTTACATTCAATTGAACACTGAAGCTTTCTTT	CASSYIQLNTEAFF	TRBV6-5	TRBJ1-1
TGCGCCAGCAGCTTGGTTGCACGGGACAGGGCTGGGGCCAACGTCCTGACTTTC	CASSLVARDRAGANVLTF	TRBV5-1	TRBJ2-6
TGTGCCAGCAGTTGCTCCCAGGGGGGAGAGACCCAGTACTTC	CASSCSQGGETQYF	TRBV6-8	TRBJ2-5
TGTGCCAGTAGGACCCCCGACAGGGGGCAAAAAGAGCAGTACTTC	CASRTPDRGQKEQYF	TRBV19	TRBJ2-7
TGTGCCAGCACCCTGCAAGACAGGACTCACACTGAAGCTTTCTTT	CASTLQDRTHTEAFF	TRBV13	TRBJ1-1
TGTACCGACGGGACTAGCGGTGCAATGGACACAGATACGCAGTATTTT	CTDGTSGAMDTDTQYF	TRBV10-3	TRBJ2-3
TGTGCCAGCAGCAGGGGACAGCTCGTCTCTGAAAAACTGTTTTTT	CASSRGQLVSEKLFF	TRBV7-9	TRBJ1-4
TGTGCTAGTGGTTTCCGTCTGGGACAGATAAAGGTCTCCTATAATTCACCCCTCCACTTT	CASGFRLGQIKVSYNSPLHF	TRBV12-5	TRBJ1-6
TGTGCCAGCTCGGACCAATATAGCTACGAGCAGTACTTC	CASSDQYSYEQYF	TRBV18	TRBJ2-7
TGTGCCATCAGTCAGGGTGTTGGTGGAAACACCATATATTTT	CAISQGVGGNTIYF	TRBV10-3	TRBJ1-3
TGTGCCAGAAAGGATATTGAAAAACTGTTTTTT	CARKDIEKLFF	TRBV19	TRBJ1-4
TGTGCCAGCACCGGAGATACGAACAACGTCCTGACTTTC	CASTGDTNNVLTF	TRBV7-6	TRBJ2-6
TGTGCCAGCAAGTGGGAGAACACCGGGGAGCTGTTTTTT	CASKWENTGELFF	TRBV6-4	TRBJ2-2
TGTGCCAGCAGTTACGGAAGGGACAGGGATTCCTACGAGCAGTACTTC	CASSYGRDRDSYEQYF	TRBV6-5	TRBJ2-7
TGTGCCAGCAGCGCGGGACAGGCCTACGAGCAGTACTTC	CASSAGQAYEQYF	TRBV7-4	TRBJ2-7
TGCGCCAGCACTTTCAGGGGGGTTAATTCACCCCTCCACTTT	CASTFRGVNSPLHF	TRBV10-1	TRBJ1-6
TGCGCCAGCAGCCAAGATGGTATAGCTAGCCCCCAAGAGACCCAGTACTTC	CASSQDGIASPQETQYF	TRBV4-1	TRBJ2-5
TGTGCCAGCAGCCCTCCTAGTCCGGGACAGGGGGATTGGAACACTGAAGCTTTCTTT	CASSPPSPGQGDWNTEAFF	TRBV7-9	TRBJ1-1
TGTGCCAGCAGCGTAGTACTCCTTTTCAGTGAGACACAGGGGCGTGAAGCTTTCTTT	CASSVVLLFSETQGREAFF	TRBV9	TRBJ1-1
TGTGCCAGCAGTCTAGAACACCCAGATACGCAGTATTTT	CASSLEHPDTQYF	TRBV6-2	TRBJ2-3
TGTGCCAGCAGTTTAGAACCAACAGGGGAGGTCGGGGAGCTGTTTTTT	CASSLEPTGEVGELFF	TRBV28	TRBJ2-2
TGTGCCAGGAGGGGTTTCCCGCCGGGACTCAGCAACGTCCTGACTTTC	CARRGFPPGLSNVLTF	TRBV10-3	TRBJ2-6
TGTGCCAGCAGCTTAGTAGCGGGACGCGGGGACGAGCAGTACTTC	CASSLVAGRGDEQYF	TRBV7-2	TRBJ2-7
TGCAGTATTGGGAGGGAGACCCAGTACTTC	CSIGRETQYF	TRBV20-1	TRBJ2-5
TGTGCCACCAGCTCGGATACGACAGGGTGGAACACTGAAGCTTTCTTT	CATSSDTTGWNTEAFF	TRBV24-1	TRBJ1-1
TGTGCCAGCAGCTTGGAGCGAAAACGGGTGACAGGGGGTGCCTACGAGCAGTACTTC	CASSLERKRVTGGAYEQYF	TRBV7-9	TRBJ2-7
TGTGCCAGCAGTTACATCAGCCTCACAGATACGCAGTATTTT	CASSYISLTDTQYF	TRBV6-2	TRBJ2-3
TGTGCCAGCAGCGATCTCCCGGACTACACCGGGACAGGGGTCCCGGCGAACACCGGGGAGCTGTTTTTT	CASSDLPDYTGTGVPANTGELFF	TRBV4-2	TRBJ2-2
TGCAGCGTTCAGGACCATTCTGAGCAGTACTTC	CSVQDHSEQYF	TRBV29-1	TRBJ2-7
TGTGCCAGCAGCAACCAGGGACAGCGGGTCTATCAGCCCCAGCATTTT	CASSNQGQRVYQPQHF	TRBV9	TRBJ1-5
TGTGCCGGACAGGGGGCACGGAAGAACACTGAAGCTTTCTTT	CAGQGARKNTEAFF	TRBV9	TRBJ1-1
TGTGCCAGAGGGGGCAATCAGCCCCAGCATTTT	CARGGNQPQHF	TRBV5-6	TRBJ1-5
TGTGCCAGCAGCCAAGAGAGGCCGGGGACAGGGGGCGGGGCCAACGTCCTGACTTTC	CASSQERPGTGGGANVLTF	TRBV14	TRBJ2-6
TGTGCCAGCAGCGGAGACCTGACAGGAGGTGAGCAGTTCTTC	CASSGDLTGGEQFF	TRBV11-2	TRBJ2-1
TGTGCCAAGGACGGGTGGTACAATGAGCAGTTCTTC	CAKDGWYNEQFF	TRBV2	TRBJ2-1
TGTGCCAGCAGCTTATCCCCGAAAGCTGAGTACTTC	CASSLSPKAEYF	TRBV7-2	TRBJ2-7
TGCGCCAGCAGCCCCGGAAGTCTAGCGGGGTTCAGCACAGATACGCAGTATTTT	CASSPGSLAGFSTDTQYF	TRBV4-3	TRBJ2-3
TGTGCCAGCACTTTTCCTAGCGGACTTCACACCGGGGAGCTGTTTTTT	CASTFPSGLHTGELFF	TRBV28	TRBJ2-2
TGTGCCACCGTCTTTTGGCACTACGAGCAGTACTTC	CATVFWHYEQYF	TRBV24-1	TRBJ2-7
TGTGCCAGCAGCTTAGCGGCGGCTGGCTCCTATAATTCACCCCTCCACTTT	CASSLAAAGSYNSPLHF	TRBV7-3	TRBJ1-6
TGTGCCAGCAGCAGGGGGGGGGCTAATGAGCAGTTCTTC	CASSRGGANEQFF	TRBV7-9	TRBJ2-1
TGTGCCAGCAGCTTACCCAGGGGCTACACGCAGTATTTT	CASSLPRGYTQYF	TRBV11-2	TRBJ2-3
TGTGCCAGCAGCACACCCTGCGGGAACTTC	CASSTPCGNF	TRBV13	TRBJ2-5
TGTGCCAGCAGTTTTCGCGCCAGGGACCCAGATACGCAGTATTTT	CASSFRARDPDTQYF	TRBV12-3	TRBJ2-3
TGCAGTGCTTTGTGGGGGGGCTTCGGGGAGCTGTTTTTT	CSALWGGFGELFF	TRBV20-1	TRBJ2-2
TGCGCCAGCAGTGAGATCAACGATAATGAAAAACTGTTTTTT	CASSEINDNEKLFF	TRBV10-1	TRBJ1-4
TGCGCCAGCAGTGGCGGGGACGGGGTGGAGGTGTTAACCGGGGAGCTGTTTTTT	CASSGGDGVEVLTGELFF	TRBV10-1	TRBJ2-2
TGTGCCAGCAGCTTAGCGCCTTGGCCGGGCGAGCAGTACTTC	CASSLAPWPGEQYF	TRBV7-2	TRBJ2-7
TGCGCCAGCAGTGCCTGTTCGGCCGGGGGCGGGCCTTTTTTCGAGCAGTACTTC	CASSACSAGGGPFFEQYF	TRBV10-1	TRBJ2-7
TGTGCCAGCAGCGCGTCGGAGGGTCCCTTATATCGGAACTATGGCTACACCTTC	CASSASEGPLYRNYGYTF	TRBV9	TRBJ1-2
TGTGCCAGCAGTTTGCAGCCCAAACGGGGGTCAGGAAATTCACCCCTCCACTTT	CASSLQPKRGSGNSPLHF	TRBV6-4	TRBJ1-6
TGTGCCAGTAGTAAGGGGGTAGCGGGGGTGATCGAGCAGTACTTC	CASSKGVAGVIEQYF	TRBV19	TRBJ2-7
TGTGCCAGCAGTATTCGGACTAGCACTGAGCAGTTCTTC	CASSIRTSTEQFF	TRBV6-6	TRBJ2-1
TGTGCCAGCAGTTACTTTTTCTCCTACAATGAGCAGTTCTTC	CASSYFFSYNEQFF	TRBV6-2	TRBJ2-1
TGTGCGGACAGGACTGAAGCTTTCTTT	CADRTEAFF	TRBV27	TRBJ1-1
TGTGCCAGCAGGGCCCGGGTCCCTAGCTCTGGAAACACCATATATTTT	CASRARVPSSGNTIYF	TRBV9	TRBJ1-3
TGTGCCAGCAGCCAAGATAACCTTAGGACAGGAGATAGCAATCAGCCCCAGCATTTT	CASSQDNLRTGDSNQPQHF	TRBV14	TRBJ1-5
TGCAGTGCTAGAGATACACCAGCTGAATGGACCGGGGAGCTGTTTTTT	CSARDTPAEWTGELFF	TRBV20-1	TRBJ2-2
TGCAGTGCTAGTTGTAGCGGGCCCCCCCCCCGGACCGGGGAGCTGTTTTTT	CSASCSGPPPRTGELFF	TRBV20-1	TRBJ2-2
TGTGCCAATGAGCAAACCCCTTATGAGCAGTTCTTC	CANEQTPYEQFF	TRBV6-1	TRBJ2-1
TGTGCCAGCAGTGAAGCGGGACATATCACCCTGAACACTGAAGCTTTCTTT	CASSEAGHITLNTEAFF	TRBV2	TRBJ1-1
TGTGCCAGCAGCTGTCTTTTAACGGGACAGTTGGGGGGAGGGGGCCCAAAGAATGAAAAACTGTTTTTT	CASSCLLTGQLGGGGPKNEKLFF	TRBV5-4	TRBJ1-4
TGCAGTGCCCCCGGACGAGAGGATAGCAATCAGCCCCAGCATTTT	CSAPGREDSNQPQHF	TRBV20-1	TRBJ1-5
TGTGCCAGCTCACCCCGGGACAGGGACGAGGATGCCGAGCAGTTCTTC	CASSPRDRDEDAEQFF	TRBV18	TRBJ2-1
TGTGCCAGCGGTGGGGTTCGTAGCTCCTACGAGCAGTACTTC	CASGGVRSSYEQYF	TRBV6-2	TRBJ2-7
TGTGCCAGCAGCGTCCCCGGAGGGCGGGGGGTTGAGTGCAATCAGCCCCAGCATTTT	CASSVPGGRGVECNQPQHF	TRBV7-7	TRBJ1-5
TGTGCCACCAGTGATTGTCTGGGGGGGCGGACCCAGTACTTC	CATSDCLGGRTQYF	TRBV24-1	TRBJ2-5
TGTGCCAGTCCCCCGGGACAGGACGAGCAGTACTTC	CASPPGQDEQYF	TRBV11-3	TRBJ2-7
TGTGCCAGCATAGGAGGGGAGCTGTTTTTT	CASIGGELFF	TRBV9	TRBJ2-2
TGTGCCAGCAGGGTGACAGGGCTCTCTGGAAACACCATATATTTT	CASRVTGLSGNTIYF	TRBV2	TRBJ1-3
TGTGCCAGCAGGGCACTCGTTTGGACTAGCGAGGACGAGCAGTACTTC	CASRALVWTSEDEQYF	TRBV2	TRBJ2-7
TGCAGCGTTGTTACATGGAGGGTGAGGTATAATTCACCCCTCCACTTT	CSVVTWRVRYNSPLHF	TRBV29-1	TRBJ1-6
TGTGCCACCAGCAGAGTCCGGGACAGTGAAGCTTTCTTT	CATSRVRDSEAFF	TRBV15	TRBJ1-1
TGTGCCAGCAGTCGAAGGCAGTCACCCCTCCACTTT	CASSRRQSPLHF	TRBV6-4	TRBJ1-6
TGTGCCAGCACTTCAAGCCATCATGGCTACACCTTC	CASTSSHHGYTF	TRBV27	TRBJ1-2
TGTGCCAGCAGCTGTAGTGGGGGGTTCAGCTACACCTTC	CASSCSGGFSYTF	TRBV6-4	TRBJ1-2
TGTGCCAGCAGCTTAACTCCAGGGAGGGACACAGATACGCAGTATTTT	CASSLTPGRDTDTQYF	TRBV7-4	TRBJ2-3
TGTGCCAGCAGCGGGACACGGCAGCCCCAGCATTTT	CASSGTRQPQHF	TRBV28	TRBJ1-5
TGTGCCAGCAGTGACTCGATTGAACAGTCATCACCCCTCCACTTT	CASSDSIEQSSPLHF	TRBV6-4	TRBJ1-6
TGCGCCAGCAGCCAAGAAAGACAACTACTAACTGAAGCTTTCTTT	CASSQERQLLTEAFF	TRBV4-1	TRBJ1-1
TGTGCCAGTAGTAGTTCCGGGACAGATAAGTTGGACGAGCAGTACTTC	CASSSSGTDKLDEQYF	TRBV19	TRBJ2-7
TGTGCCAGCAGTTACCGTCCCTATCCGCTAGGACAGGGGTGGAGCAATCAGCCCCAGCATTTT	CASSYRPYPLGQGWSNQPQHF	TRBV6-5	TRBJ1-5
TGTGCCAGCAGCCCGGTTCGTGGACCTGGGGCCAACGTCCTGACTTTC	CASSPVRGPGANVLTF	TRBV7-3	TRBJ2-6
TGTGCCAGCAGCTCCCCTGGCGGCCCAGCAACTAATGAAAAACTGTTTTTT	CASSSPGGPATNEKLFF	TRBV7-9	TRBJ1-4
TGTGCCACCGTCCGGACGGGCCATGAGCAGTTCTTC	CATVRTGHEQFF	TRBV24-1	TRBJ2-1
TGTGCCAGCAGCTTAGAAGAACAGGGGGCCAGAAACATTCAGTACTTC	CASSLEEQGARNIQYF	TRBV11-2	TRBJ2-4
TGTGCCAGCTCCTCGAACCGGGCAGATACGCAGTATTTT	CASSSNRADTQYF	TRBV25-1	TRBJ2-3
TGTGCCAGCAGCGTAGACCCTATGGGACTAGCTTGCACCGGGGAGCTGTTTTTT	CASSVDPMGLACTGELFF	TRBV9	TRBJ2-2
TGTGCCAGCAGACAGGGGGGGCGTGAAAAACTGTTTTTT	CASRQGGREKLFF	TRBV6-1	TRBJ1-4
TGTGCCAGCGATAGGGGGCGAATGTGGGGACATGATACGCAGTATTTT	CASDRGRMWGHDTQYF	TRBV12-4	TRBJ2-3
TGTGCCAGCAGCGGGGGGGGACAGGGCTCTGGAAACACCATATATTTT	CASSGGGQGSGNTIYF	TRBV9	TRBJ1-3
TGTGCCGGATTGGGGGACAGGGTACACTCAGAGACCCAGTACTTC	CAGLGDRVHSETQYF	TRBV27	TRBJ2-5
TGTGCCAGCAGCCGGAGGGGGGGCTCCTACGAGCAGTACTTC	CASSRRGGSYEQYF	TRBV7-3	TRBJ2-7
TGCGCCAGCAGGGTTGACAGGGGACACTACACCTTC	CASRVDRGHYTF	TRBV5-1	TRBJ1-2
TGCAGTGCACAAAGTGGCCCTCCGACAAGGGACACCATATATTTT	CSAQSGPPTRDTIYF	TRBV20-1	TRBJ1-3
TGTGCCAGCAGCCGGCATACCTACAATGAGCAGTTCTTC	CASSRHTYNEQFF	TRBV7-3	TRBJ2-1
TGTGCCACGGCAGGGGGCTGCCAATACAGCTATGGCTACACCTTC	CATAGGCQYSYGYTF	TRBV24-1	TRBJ1-2
TGTGCCATCAGTGAGTCAGGCAGGGTATCACCCCTCCACTTT	CAISESGRVSPLHF	TRBV10-3	TRBJ1-6
TGTGCCAGCAGACCTCCATATCGGGGGGCAGCTGAAGCTTTCTTT	CASRPPYRGAAEAFF	TRBV6-5	TRBJ1-1
TGTGCCACCAGTGCCAGACAGGGGGCTGGCTACACCTTC	CATSARQGAGYTF	TRBV24-1	TRBJ1-2
TGTGCCAGCAGTTACCTAACAGGGGTGCAAGAGACCCAGTACTTC	CASSYLTGVQETQYF	TRBV6-2	TRBJ2-5
TGTGCCAGCAGCTTAGATAGGTCGGGACAGGGTAGGGGCCTTGAAGCTTTCTTT	CASSLDRSGQGRGLEAFF	TRBV11-2	TRBJ1-1
TGTGCCAGCAGTTACAGCAAGATCCTCTCTGGAAACACCATATATTTT	CASSYSKILSGNTIYF	TRBV6-2	TRBJ1-3
TGTGCCAACTTTGACAGGGGATGGCGGTCACCCCTCCACTTT	CANFDRGWRSPLHF	TRBV6-6	TRBJ1-6
TGTGCCAGCAGTGAATCCAAGGTCAGGGTGCGCGCAACTAATGAAAAACTGTTTTTT	CASSESKVRVRATNEKLFF	TRBV25-1	TRBJ1-4
TGCGCCAGCAGTGACCCCCGGGATACGCAGTATTTT	CASSDPRDTQYF	TRBV10-1	TRBJ2-3
TGCGCCAGCAGCTTGCTGAAGCAGTATTTT	CASSLLKQYF	TRBV5-1	TRBJ2-3
TGTGCCAGCAGCTTAGCGCGACAGGGGGCGCAACCTTATGCAACTAATGAAAAACTGTTTTTT	CASSLARQGAQPYATNEKLFF	TRBV7-6	TRBJ1-4
TGTGCCAGCAGCCAAGATCCGTGGGGGCAGGGGGGGGTGAACACTGAAGCTTTCTTT	CASSQDPWGQGGVNTEAFF	TRBV4-2	TRBJ1-1
TGCAGTGCTAGGGCCAACTTGACAGGGGGATACAATGAGCAGTTCTTC	CSARANLTGGYNEQFF	TRBV20-1	TRBJ2-1
TGTGCCACCAGGGACCCAGGGCTCTGTGGCTACACCTTC	CATRDPGLCGYTF	TRBV15	TRBJ1-2
TGTGCCAGCAGTTTGTTAGCGGGTGTACAGACCGGGGAGCTGTTTTTT	CASSLLAGVQTGELFF	TRBV5-4	TRBJ2-2
TGTGCCAGCCCTTGGACTAGCGGGGACGCTGGTGAGCAGTTCTTC	CASPWTSGDAGEQFF	TRBV7-3	TRBJ2-1
TGTGCCAGCAGCTTGGTCACTAACCTACTAGAAACCGGGGAGCTGTTTTTT	CASSLVTNLLETGELFF	TRBV5-4	TRBJ2-2
TGTGCCAGCAGTTACGGGGCGCCTACCGGGACAGCCGTAGATGGCTACACCTTC	CASSYGAPTGTAVDGYTF	TRBV6-6	TRBJ1-2
TGTGCCAGCAGCCTTCGGGACAGGGGTGGAATTGGAAACACCATATATTTT	CASSLRDRGGIGNTIYF	TRBV13	TRBJ1-3
TGTGCCAGCAGTGACGTGGGCAGCCGCAGGGACCCGGAATACACTGAAGCTTTCTTT	CASSDVGSRRDPEYTEAFF	TRBV6-4	TRBJ1-1
TGCAGTGCTATCTCGGGGACAGGAGTGGAGACCCAGTACTTC	CSAISGTGVETQYF	TRBV20-1	TRBJ2-5
TGTGCCAGCAGCTTTTCCAGGGGGCCGGCGCCTGGGCAAGAGACCCAGTACTTC	CASSFSRGPAPGQETQYF	TRBV13	TRBJ2-5
TGTGCCCCTCAGACGGACGAAAAACTGTTTTTT	CAPQTDEKLFF	TRBV6-1	TRBJ1-4
TGCAGTGCTAGCAGGCGCTCCTACAATGAGCAGTTCTTC	CSASRRSYNEQFF	TRBV20-1	TRBJ2-1
TGTGCCACCAGCAGTAAGGGCAACACCGGGGAGCTGTTTTTT	CATSSKGNTGELFF	TRBV15	TRBJ2-2
TGTGCCAGCATTTCGACTCTTGAGAACACTGAAGCTTTCTTT	CASISTLENTEAFF	TRBV6-8	TRBJ1-1
TGTGCCAGCAGTTACTCTGGGGAGCCCAGGGCTAGCACAGATACGCAGTATTTT	CASSYSGEPRASTDTQYF	TRBV6-3	TRBJ2-3
TGTGCCAGCAGCGAGGCAAGTTCCGGGGCCCTCAGCACAGATACGCAGTATTTT	CASSEASSGALSTDTQYF	TRBV7-4	TRBJ2-3
TGTGCCAGCAGTGACCCGGGACAGGGGCCGAACTATGGCTACACCTTC	CASSDPGQGPNYGYTF	TRBV6-4	TRBJ1-2
TGTGCCACCAGGCATGGGGGGAACAATGAGCAGTTCTTC	CATRHGGNNEQFF	TRBV24-1	TRBJ2-1
TGTGCCGTAAGGGACACTGAAGCTTTCTTT	CAVRDTEAFF	TRBV28	TRBJ1-1
TGTGCCAGCAGCGCACCAGGCGAAGGCCCGGCCAAAAACATTCAGTACTTC	CASSAPGEGPAKNIQYF	TRBV7-2	TRBJ2-4
TGTGCCAGCAGTTTTGGATCGGCCACCGGGGGGCGAGAGCAGTTCTTC	CASSFGSATGGREQFF	TRBV12-4	TRBJ2-1
TGTGCCAGTTCAATACAGGGGGCGATCGAAAAACTGTTTTTT	CASSIQGAIEKLFF	TRBV19	TRBJ1-4
TGCGCCAGCAGCCCCTCTGGCTACGAGCAGTACTTC	CASSPSGYEQYF	TRBV4-3	TRBJ2-7
TGTGCCAGCAAAGGGCGGACAGGTTTGGACGAGCAGTACTTC	CASKGRTGLDEQYF	TRBV6-5	TRBJ2-7
TGCGCCAAACGCGGGGAACGCGGGTCCTACAATGAGCAGTTCTTC	CAKRGERGSYNEQFF	TRBV4-1	TRBJ2-1
TGTGCCAGCAGCGGCCCACGCAGAACCTACGAGCAGTACTTC	CASSGPRRTYEQYF	TRBV11-2	TRBJ2-7
TGTGCTAGTGGTTCGACAGGCCAGGGCTTAGGAAACACCATATATTTT	CASGSTGQGLGNTIYF	TRBV12-5	TRBJ1-3
TGTGCCAGCAGTGAATGCGGAAACGACAGGGCCCCAAGGGGCACTGAAGCTTTCTTT	CASSECGNDRAPRGTEAFF	TRBV25-1	TRBJ1-1
TGTGCCAGCTCCACCCGGCGGGTTCAAGAGACCCAGTACTTC	CASSTRRVQETQYF	TRBV6-5	TRBJ2-5
TGTGCCAGCTCTACAGGGAGCTCCTACGAGCAGTACTTC	CASSTGSSYEQYF	TRBV18	TRBJ2-7
TGTGCCAGCAGCCACTCCGGGAGGGCCCTGTGGGAGTTCCCCTCCTACAATGAGCAGTTCTTC	CASSHSGRALWEFPSYNEQFF	TRBV3-1	TRBJ2-1
TGCGCCAGCAGCTATCTAGGGACCCTGAATCCCTATAATTCACCCCTCCACTTT	CASSYLGTLNPYNSPLHF	TRBV5-1	TRBJ1-6
TGTGCCATCAGTGAAACCGGGACAGGGGACTTGTATAGCAATCAGCCCCAGCATTTT	CAISETGTGDLYSNQPQHF	TRBV10-3	TRBJ1-5
TGTGCCAGCAGCAAGGGACAGGGGAAGAACAATGAGCAGTTCTTC	CASSKGQGKNNEQFF	TRBV13	TRBJ2-1
TGTGCCAGCAGCTGCCGAGGGGGGAACCCGATAGGCGAGACCCAGTACTTC	CASSCRGGNPIGETQYF	TRBV7-9	TRBJ2-5
TGCAGCGTTGACCGAGGGAGGATTGATGGCTACACCTTC	CSVDRGRIDGYTF	TRBV29-1	TRBJ1-2
TGTGCCACCAGACTAGCGGGAGGTGACTACGAGCAGTACTTC	CATRLAGGDYEQYF	TRBV15	TRBJ2-7
TGCGCCAGCAGTTACCCCGGAACAGGGCATGGTGAAAAACTGTTTTTT	CASSYPGTGHGEKLFF	TRBV5-1	TRBJ1-4
TGTGCCAGCAGTTTCCCGGGCCCCCGAAGGTGTAATGAAAAACTGTTTTTT	CASSFPGPRRCNEKLFF	TRBV27	TRBJ1-4
TGTGCCACAGGGACTAGCGTCCGAAATGAGCAGTTCTTC	CATGTSVRNEQFF	TRBV28	TRBJ2-1
TGTGCCAGCAGTTACAACCTCAGCACGGGACGACGTTTCAATGAGCAGTTCTTC	CASSYNLSTGRRFNEQFF	TRBV6-2	TRBJ2-1
TGTGCCATCAGTGAGTCAGGAGGACAGGGTAGGGTGGGGTCGACTTACGGAAGGGGCGAGCAGTACTTC	CAISESGGQGRVGSTYGRGEQYF	TRBV10-3	TRBJ2-7
TGCGCCAGCAGCTTGAGTGGGAGGATGAGAAAACTGTTTTTT	CASSLSGRMRKLFF	TRBV5-1	TRBJ1-4
TGTGCCACCGGTCGAGTTGGCTCCTACGAGCAGTACTTC	CATGRVGSYEQYF	TRBV24-1	TRBJ2-7
TGCAGTGCTAGCAGACCAGGACAGGGAGACTATACGCAGTATTTT	CSASRPGQGDYTQYF	TRBV20-1	TRBJ2-3
TGTGCCAGCAGCGCTAATGACCCCTATGGCTACACCTTC	CASSANDPYGYTF	TRBV9	TRBJ1-2
TGTGCCAGCAGTGAATCTAGGGCGGGATCCAATGAGCAGTTCTTC	CASSESRAGSNEQFF	TRBV25-1	TRBJ2-1
TGTGCCTGGTTGTCCACAGGGCAATCCGTCCAAGAGACCCAGTACTTC	CAWLSTGQSVQETQYF	TRBV30	TRBJ2-5
TGTGCCAGCAGCGCCGGACAGAACGTCCTGACTTTC	CASSAGQNVLTF	TRBV5-8	TRBJ2-6
TGTGCCCCCGTAGACAGGGGTCCTACAACTAATGAAAAACTGTTTTTT	CAPVDRGPTTNEKLFF	TRBV6-4	TRBJ1-4
TGCGCCAGCAGCCACCGGGACAACCTCTACACTGAAGCTTTCTTT	CASSHRDNLYTEAFF	TRBV4-1	TRBJ1-1
TGCAGTGCTAGAGATGGAAGGAGGGGCGGCATTGAGACCCAGTACTTC	CSARDGRRGGIETQYF	TRBV20-1	TRBJ2-5
TGTGCCAGCAGCCATGGGCAGCCCCAGCATTTT	CASSHGQPQHF	TRBV3-1	TRBJ1-5
TGTGCCAGCAGCCTACTAGCGGGAGGGCTGCAGCCCCAGCATTTT	CASSLLAGGLQPQHF	TRBV9	TRBJ1-5
TGTGCCTGGAGTGAACTAGCGGGGCTGGGGGATGAGCAGTTCTTC	CAWSELAGLGDEQFF	TRBV30	TRBJ2-1
TGTGCCAGCAGTCCGATCCACCAAGTCAGAGAGACCCAGTACTTC	CASSPIHQVRETQYF	TRBV6-4	TRBJ2-5
TGTGCCAGCGTCCCCGGGACTAGCGGGCCCGGTTTCACCGGGGAGCTGTTTTTT	CASVPGTSGPGFTGELFF	TRBV9	TRBJ2-2
TGTGCCAGCAGTGGAGGGGGCTCATTTCTCTACGAGCAGTACTTC	CASSGGGSFLYEQYF	TRBV25-1	TRBJ2-7
TGTGCCAGCAGCCATCTACACGGGAGGTCCCCCTCTGGAAACACCATATATTTT	CASSHLHGRSPSGNTIYF	TRBV14	TRBJ1-3
TGCGCCAGCAGCTACGGGTCACTAGGAAGGGGTCAAGTATTCCAAGAGACCCAGTACTTC	CASSYGSLGRGQVFQETQYF	TRBV5-1	TRBJ2-5
TGTGCCAGCAGCCGGTCGGGGACCTTCGGAGACACTGAAGCTTTCTTT	CASSRSGTFGDTEAFF	TRBV28	TRBJ1-1
TGTGCCGATGTCCCGGGGCGGGGTTCGTTTAATGAGCAGTTCTTC	CADVPGRGSFNEQFF	TRBV7-9	TRBJ2-1
TGTGCCAGCAGTGGCGCTAGCGGGCTCTACAATGAGCAGTTCTTC	CASSGASGLYNEQFF	TRBV2	TRBJ2-1
TGTGCCAGCAGCCAGTTCTATTGGCTACGGACTGGACTAGCGGAACAGGGTACCTACGAGCAGTACTTC	CASSQFYWLRTGLAEQGTYEQYF	TRBV3-1	TRBJ2-7
TGTGCCAGCAGTGATCCTCAGGGCGACTTC	CASSDPQGDF	TRBV6-4	TRBJ1-2
TGTGCCAGCAGCGTCGACAGGGGAGCAACTAATGAAAAACTGTTTTTT	CASSVDRGATNEKLFF	TRBV9	TRBJ1-4
TGTGCCAGCAGTTTCGTGCACCATGCCGGGACTAGCGGGCCTAACAATGAGCAGTTCTTC	CASSFVHHAGTSGPNNEQFF	TRBV28	TRBJ2-1
TGCAGTGCTAGACCGCGATTCCAGCCGAACACTGAAGCTTTCTTT	CSARPRFQPNTEAFF	TRBV20-1	TRBJ1-1
TGCAGTGCTAGAGATAGGACTTCCACAGATACGCAGTATTTT	CSARDRTSTDTQYF	TRBV20-1	TRBJ2-3
TGTGCCAGCAGCGTAGTGTTGGGGGGCCTCTATGAGCAGTTCTTC	CASSVVLGGLYEQFF	TRBV3-1	TRBJ2-1
TGTGCCTGGAAAATCAGGACAGGGGGGGATAACACTGAAGCTTTCTTT	CAWKIRTGGDNTEAFF	TRBV30	TRBJ1-1
TGTGCCACCAGTGAAAACAGGGTGCGGAGTGGGAACAATGAGCAGTTCTTC	CATSENRVRSGNNEQFF	TRBV24-1	TRBJ2-1
TGTGCCAGCAGCCACTTCACTGAAGCTTTCTTT	CASSHFTEAFF	TRBV9	TRBJ1-1
TGTGCCAGCAGCCGGGACAGGGTCCGGAGATACAATGAGCAGTTCTTC	CASSRDRVRRYNEQFF	TRBV9	TRBJ2-1
TGTGCCAGCATCCGAGGGAACGCGGCTGAGCAGTTCTTC	CASIRGNAAEQFF	TRBV6-1	TRBJ2-1
TGTGCCAGCAGTAGCACCTCCTACGAGCAGTACTTC	CASSSTSYEQYF	TRBV27	TRBJ2-7
TGTGCCAGCAGCTTGGGGGGGGGCAGCCAGGGGCTGGACTACGAGCAGTACTTC	CASSLGGGSQGLDYEQYF	TRBV5-4	TRBJ2-7
TGCGCCAGCAGCAGGTTATTCTGGGCCGGGACTAGCGGCAATGAGCAGTTCTTC	CASSRLFWAGTSGNEQFF	TRBV5-1	TRBJ2-1
TGTGCCAGCAGCTTAACTCAGGACAGGCAGCCCCAGCATTTT	CASSLTQDRQPQHF	TRBV11-3	TRBJ1-5
TGCGCCAGCAGCCGCTCGAACACCTGGAGGGACGGCTACGAGCAGTACTTC	CASSRSNTWRDGYEQYF	TRBV5-1	TRBJ2-7
TGTGCCACCAGTGATCTCCGCACCGGAGGACAGGGTCTAGGTAATTCACCCCTCCACTTT	CATSDLRTGGQGLGNSPLHF	TRBV24-1	TRBJ1-6
