TGCGCCAGCAGTGAGGCCCGGGGGGTTCGCTACGAGCAGTACTTC	CASSEARGVRYEQYF	TRBV10-1	TRBJ2-7
TGCGCCAGCGGAACCGCCGGGACAAAGAGCAATGAGCAGTTCTTC	CASGTAGTKSNEQFF	TRBV5-1	TRBJ2-1
TGCAGTGCTGGGGCCCACAGGGGTCATGGCTACACCTTC	CSAGAHRGHGYTF	TRBV20-1	TRBJ1-2
TGCAGTGCTAGAATTGGACGACCCCCAGATACGCAGTATTTT	CSARIGRPPDTQYF	TRBV20-1	TRBJ2-3
TGTGCCAGCACCGCGAACCAGGGCTTCAAGGGGCTTGCCTTGGCTGGAAACACCATATATTTT	CASTANQGFKGLALAGNTIYF	TRBV6-2	TRBJ1-3
TGTGCCAGCAGTGGGCTGACGGACAGGGCCGGAGGTAACTATGGCTACACCTTC	CASSGLTDRAGGNYGYTF	TRBV6-4	TRBJ1-2
TGTGCCAGCAGCTTAAGTCCGGTCTCGACAGGGGAGGTCATCTACGAGCAGTACTTC	CASSLSPVSTGEVIYEQYF	TRBV7-9	TRBJ2-7
TGCGCCAGCAGTAAGGGAGAGCAGGTTGATGCAACTAATGAAAAACTGTTTTTT	CASSKGEQVDATNEKLFF	TRBV10-1	TRBJ1-4
TGCGCCAGCAGCCAGCCGAACAGGGCGGGTAGCAATCAGCCCCAGCATTTT	CASSQPNRAGSNQPQHF	TRBV4-1	TRBJ1-5
TGTGCCAGTAGTATCCGGGGGCGGATGGGTAACTATGGCTACACCTTC	CASSIRGRMGNYGYTF	TRBV19	TRBJ1-2
TGTGCCACCAGTGAAAGGTCGGGGGGAGTTCAAGGCAATCAGCCCCAGCATTTT	CATSERSGGVQGNQPQHF	TRBV24-1	TRBJ1-5
TGCGCCAGCGGATTGGACAGGGAGATTGAATATGGCTACACCTTC	CASGLDREIEYGYTF	TRBV5-1	TRBJ1-2
TGTGCCAGCGTTCCTTGGACAGAAAGCAATCAGCCCCAGCATTTT	CASVPWTESNQPQHF	TRBV6-3	TRBJ1-5
TGTGCCAGCAGCTTTCCAAGGGTGCCGGGACAAGGCCTATCGAACACCGGGGAGCTGTTTTTT	CASSFPRVPGQGLSNTGELFF	TRBV11-2	TRBJ2-2
TGTGCCACCCGAGACAGGGCTTTAACTGAAGCTTTCTTT	CATRDRALTEAFF	TRBV15	TRBJ1-1
TGCGCCAGCAGCCAAGATTGGAGGGCCCGGTGCAGCACAGATACGCAGTATTTT	CASSQDWRARCSTDTQYF	TRBV4-1	TRBJ2-3
TGTGCCAGCAGCCAAGATCCCGCGTCGGGCACAAATCAGCCCCAGCATTTT	CASSQDPASGTNQPQHF	TRBV3-1	TRBJ1-5
TGTGCCAGCAATGCATTGCGGGACAGGGATTATACGAAAAATCAGCCCCAGCATTTT	CASNALRDRDYTKNQPQHF	TRBV6-4	TRBJ1-5
TGTGCCAGCAGCTTGCCAGGGGAGCTAAGCACAGATACGCAGTATTTT	CASSLPGELSTDTQYF	TRBV5-4	TRBJ2-3
TGTGCCAGCAGAAAGCCATTCTGGGCCGGCCCAACTAATGAAAAACTGTTTTTT	CASRKPFWAGPTNEKLFF	TRBV6-5	TRBJ1-4
TGTGCCAGCAGCTTGTTCCTCCCAGGAGAGGGACAGGGTCAGAGGCCGTTTCCTAATGAAAAACTGTTTTTT	CASSLFLPGEGQGQRPFPNEKLFF	TRBV5-5	TRBJ1-4
TGTGCCAGCAGCGATAGGGGGTTTCAGCCCCAGCATTTT	CASSDRGFQPQHF	TRBV9	TRBJ1-5
TGTGCCAGCAGCATTAACGGAGGGGGGTACAGACGGATCACCGGGGAGCTGTTTTTT	CASSINGGGYRRITGELFF	TRBV13	TRBJ2-2
TGTGCCAGCAGTTTTGGCGGACAGGGTGAAAACTATGGCTACACCTTC	CASSFGGQGENYGYTF	TRBV27	TRBJ1-2
TGTGCCAGCAGCTTAGAGGAGGGGGCAGAAGGTGAAGCTTTCTTT	CASSLEEGAEGEAFF	TRBV7-6	TRBJ1-1
TGTGCCAGCAGCTTAAGATTAAAAGATAGCAATCAGCCCCAGCATTTT	CASSLRLKDSNQPQHF	TRBV7-2	TRBJ1-5
TGTGCCAGCAAATGCTCTCAACCGGTACACTACGAGCAGTACTTC	CASKCSQPVHYEQYF	TRBV6-5	TRBJ2-7
TGTGCCAGCAGCCTCCGGCTGACTGAAGCTTTCTTT	CASSLRLTEAFF	TRBV6-6	TRBJ1-1
TGTGCCAGCAGCGGGGCCTGGGGGCTGGGGTACGAGCAGTACTTC	CASSGAWGLGYEQYF	TRBV11-1	TRBJ2-7
TGCAGCGTTGGGGAGGGACTCTGGGTGAGGGACTATGGCTACACCTTC	CSVGEGLWVRDYGYTF	TRBV29-1	TRBJ1-2
TGCAGTGCTAGAGAGACACATCAAAACGGGATCCATTTCTCTGGGGCCAACGTCCTGACTTTC	CSARETHQNGIHFSGANVLTF	TRBV20-1	TRBJ2-6
TGTGCCATCAGTACCCTAAGGGTCTACGAGCAGTACTTC	CAISTLRVYEQYF	TRBV10-3	TRBJ2-7
TGCGCCAGCAGCGGGGGGGGCTCCTCACCTGGAAACACCATATATTTT	CASSGGGSSPGNTIYF	TRBV10-1	TRBJ1-3
TGTGCCACCATAAGGAGCAATGAGCAGTTCTTC	CATIRSNEQFF	TRBV24-1	TRBJ2-1
TGTGCCAGCAGGGACAACACTGAAGCTTTCTTT	CASRDNTEAFF	TRBV6-4	TRBJ1-1
TGTGCCAGCGTTGCGGGCCCCAGCGGGAGGGGCGGGGGCTACACCTTC	CASVAGPSGRGGGYTF	TRBV18	TRBJ1-2
TGTGCCAGCATAGCTTACCCAGTCGAAAAACTGTTTTTT	CASIAYPVEKLFF	TRBV7-4	TRBJ1-4
TGTGCCACCAGTGATTTGGGACAGGGGAACAATGAGCAGTTCTTC	CATSDLGQGNNEQFF	TRBV24-1	TRBJ2-1
TGTGCCAGCTCACTAGGGAATGAGCAGTTCTTC	CASSLGNEQFF	TRBV18	TRBJ2-1
TGTGCCAGCAGCAGCCATAAAGGGGGGCGTTGGGCCAACGTCCTGACTTTC	CASSSHKGGRWANVLTF	TRBV13	TRBJ2-6
TGTGCCAGCAGCCCCTTCCGGGACAGGGGGGCCTGCACCGGGGAGCTGTTTTTT	CASSPFRDRGACTGELFF	TRBV14	TRBJ2-2
TGCAGTGCCGGACAGGTTAAACATAGCAATCAGCCCCAGCATTTT	CSAGQVKHSNQPQHF	TRBV20-1	TRBJ1-5
TGTGCCAGCAGTTTATCAATAGGGACACCACAGACGCAGTATTTT	CASSLSIGTPQTQYF	TRBV27	TRBJ2-3
TGTGCCAGCAGTGGGTACAGGGGGAGGCGCACTGAAGCTTTCTTT	CASSGYRGRRTEAFF	TRBV6-4	TRBJ1-1
TGTGCCAGCAGCCCAAAAACGTCCTACAATGAGCAGTTCTTC	CASSPKTSYNEQFF	TRBV7-3	TRBJ2-1
TGTGCCTGGAAGTATGACGCCAAGGACAGGGGTTCCTACAATGAGCAGTTCTTC	CAWKYDAKDRGSYNEQFF	TRBV30	TRBJ2-1
TGTGCCAGCAGCCCTCTCCGCAACACAGATACGCAGTATTTT	CASSPLRNTDTQYF	TRBV5-6	TRBJ2-3
TGTGCCAGCACCAGGGCTGAGACCCAGTACTTC	CASTRAETQYF	TRBV6-8	TRBJ2-5
TGCAGTGCTAGAGCTAGGACAGGGTTAGGCTACGAGCAGTACTTC	CSARARTGLGYEQYF	TRBV20-1	TRBJ2-7
TGCAGTGCACCGGGACAGGGCTACGAGCAGTACTTC	CSAPGQGYEQYF	TRBV20-1	TRBJ2-7
TGTGCCAGCGCCGCTTATATTGAGCAGTTCTTC	CASAAYIEQFF	TRBV6-4	TRBJ2-1
TGCGCCAGCGGACGGAGCTCCTACAATGAGCAGTTCTTC	CASGRSSYNEQFF	TRBV10-1	TRBJ2-1
TGTGCCAGCAAGACGGCCGGCGGCCCCTACGAGCAGTACTTC	CASKTAGGPYEQYF	TRBV6-5	TRBJ2-7
TGTGCCAGCAGTACCCGGGACAGGACGATGAACACTGAAGCTTTCTTT	CASSTRDRTMNTEAFF	TRBV2	TRBJ1-1
TGTGCCAGCAGCTTATTCGACAGGGGTCTAACCCTCCACTTT	CASSLFDRGLTLHF	TRBV7-6	TRBJ1-6
TGCAGAGACAGGGACACTGAAGCTTTCTTT	CRDRDTEAFF	TRBV10-1	TRBJ1-1
TGTGCCAGCACGAGGGACGAGTACGAGCAGTACTTC	CASTRDEYEQYF	TRBV5-4	TRBJ2-7
TGCAGTGCGTCCGGGACAAATCTTAATTCACCCCTCCACTTT	CSASGTNLNSPLHF	TRBV20-1	TRBJ1-6
TGTGCCAGCAGCGTCAGGGGGGAAAAACTGTTTTTT	CASSVRGEKLFF	TRBV7-3	TRBJ1-4
TGCGCCAGCAGCTGGACCCCGGGACAGGGTTATTTAAGTCAGGATGGCTACACCTTC	CASSWTPGQGYLSQDGYTF	TRBV5-1	TRBJ1-2
TGTGCCAAGGCGGATGAGGGGACAAACACCATATATTTT	CAKADEGTNTIYF	TRBV11-3	TRBJ1-3
TGCGCCAGCAGCCAAGATGGGATCGAGGATCATAACTATGGCTACACCTTC	CASSQDGIEDHNYGYTF	TRBV4-3	TRBJ1-2
TGTCAGGGAAAAACGAACACCGGGGAGCTGTTTTTT	CQGKTNTGELFF	TRBV27	TRBJ2-2
TGTGCCAGCAGCCACGAGGGGGAGGGGTGGGCCCGTGAAGCTTTCTTT	CASSHEGEGWAREAFF	TRBV13	TRBJ1-1
TGTGCCAGCAGTTTCCCCCTACTAGCGGGGGGGCGGATGCACAATGAGCAGTTCTTC	CASSFPLLAGGRMHNEQFF	TRBV28	TRBJ2-1
TGTGCCAGCAGCAATGGGGTCAGCCGAGTTTACACTGAAGCTTTCTTT	CASSNGVSRVYTEAFF	TRBV5-5	TRBJ1-1
TGTGCCACCAGTGATATGGGACAGGGCTCTATCTCTGGGGCCAACGTCCTGACTTTC	CATSDMGQGSISGANVLTF	TRBV24-1	TRBJ2-6
TGCAGTGCTAGAGGGACTAGCGGGCTGGTAGAGACCCAGTACTTC	CSARGTSGLVETQYF	TRBV20-1	TRBJ2-5
TGTGCCAGCAGCTTGCCGGCAGGGGGCGTGAGGGCTAACTATGGCTACACCTTC	CASSLPAGGVRANYGYTF	TRBV5-4	TRBJ1-2
TGTGCCAGCAGCTTAGTCCCGGGGGTGGGGGCATTCACTGAAGCTTTCTTT	CASSLVPGVGAFTEAFF	TRBV7-6	TRBJ1-1
TGTGCCAGCAGTTACCCCGGGACTAGCGGGAGACGGGGTCGCTCTGGGGCCAACGTCCTGACTTTC	CASSYPGTSGRRGRSGANVLTF	TRBV7-3	TRBJ2-6
TGTGCCAGCAGTCTATCGGACAGAAGAAAACGCAATCAGCCCCAGCATTTT	CASSLSDRRKRNQPQHF	TRBV6-1	TRBJ1-5
TGTGCCAGCCTAAAGGAAGGGGCGACAGAGACCCAGTACTTC	CASLKEGATETQYF	TRBV2	TRBJ2-5
TGCAGCATTGGAGTCTACGAGCAGTACTTC	CSIGVYEQYF	TRBV29-1	TRBJ2-7
TGTGCCAGCAGTACGGTTTCCAATATGGGGGCCGTACTAGCCAAAAACATTCAGTACTTC	CASSTVSNMGAVLAKNIQYF	TRBV27	TRBJ2-4
TGCGCCAGCAGCCAAGACAAGATAGACGGCGGCGGCTATGGCTACACCTTC	CASSQDKIDGGGYGYTF	TRBV4-3	TRBJ1-2
TGCAGTGCTAGAGTCCGCGGGCAAGAGACCCAGTACTTC	CSARVRGQETQYF	TRBV20-1	TRBJ2-5
TGTGCCAGCAGTGCCGAAAAATCCCTCACAGATACGCAGTATTTT	CASSAEKSLTDTQYF	TRBV6-5	TRBJ2-3
TGTGCCAGTAGTCGGGCCCCCCGCTACGAGCAGTACTTC	CASSRAPRYEQYF	TRBV19	TRBJ2-7
TGTGCCAGCAGCTTAGATCATTTCGGGACACCTACTGGGGCCAACGTCCTGACTTTC	CASSLDHFGTPTGANVLTF	TRBV11-3	TRBJ2-6
TGTGCCAGCACCGTCAGGGTATCGCACGCCTACGAGCAGTACTTC	CASTVRVSHAYEQYF	TRBV6-5	TRBJ2-7
TGTGCCAGCAGCTTAGACAGTGGAGGCTCCTACGAGCAGTACTTC	CASSLDSGGSYEQYF	TRBV7-2	TRBJ2-7
TGTGCCAGCAGCCAAGAGCATTTAGGGGGGCAGGATGAGCAGTTCTTC	CASSQEHLGGQDEQFF	TRBV3-1	TRBJ2-1
TGTGCCAGCAGCTGTTATAGGCCGGGACGGTCCGGCTACACCTTC	CASSCYRPGRSGYTF	TRBV7-9	TRBJ1-2
TGTGCCAGCAAAGCCTATGTCGGGGGGCAAAATGAGCAGTTCTTC	CASKAYVGGQNEQFF	TRBV2	TRBJ2-1
TGTGCCAGCAGCCAAGGGTCCCGGACAGGGGTTGCGGTCTACGAGCAGTACTTC	CASSQGSRTGVAVYEQYF	TRBV14	TRBJ2-7
TGTGCCAGCTCACCAGGGGCCTATCAGTACTTC	CASSPGAYQYF	TRBV18	TRBJ2-5
TGTGCCAGCAGCCGTCATCTTATGACAGGGGAGGGAAGGAACACTGAAGCTTTCTTT	CASSRHLMTGEGRNTEAFF	TRBV11-2	TRBJ1-1
TGTGCCACCAGCAGAGATGGACAGGGGGCCGTACCAACTAATGAAAAACTGTTTTTT	CATSRDGQGAVPTNEKLFF	TRBV15	TRBJ1-4
TGTGCCAGCACAGGGGTGAACACTGAAGCTTTCTTT	CASTGVNTEAFF	TRBV6-4	TRBJ1-1
TGCGCCAGCAGCTTGAGCCCATTACAGGGGCAGTATCAGCCCCAGCATTTT	CASSLSPLQGQYQPQHF	TRBV5-1	TRBJ1-5
TGTGCCAGCAGCGTCACAGGGGGATATAGACCCGGGGAGCTGTTTTTT	CASSVTGGYRPGELFF	TRBV5-6	TRBJ2-2
TGTGCCAGTAGTATCCATAGGGGCCATTATGGCTACACCTTC	CASSIHRGHYGYTF	TRBV19	TRBJ1-2
TGTGCTAGCCCCCAGGCTTCGGAAGCTTTCTTT	CASPQASEAFF	TRBV12-5	TRBJ1-1
TGTGCCAGCACTTGTTCAGGGTGGGGGCTAGCCAAAAACATTCAGTACTTC	CASTCSGWGLAKNIQYF	TRBV28	TRBJ2-4
TGCAGTGCTCAGAGTATAAGGGGGCGAACCTACGAGCAGTACTTC	CSAQSIRGRTYEQYF	TRBV20-1	TRBJ2-7
TGTGCTAGTGGAAGTCTAGCGGGCACAGATACGCAGTATTTT	CASGSLAGTDTQYF	TRBV12-5	TRBJ2-3
TGTGCCAGCAGTGACTCGGGCGGGAGGGGCCACTATGGCTACACCTTC	CASSDSGGRGHYGYTF	TRBV6-4	TRBJ1-2
TGCGCCAGCACCCCGACAGGGGGGCCGGAGAACACTGAAGCTTTCTTT	CASTPTGGPENTEAFF	TRBV10-1	TRBJ1-1
TGTGCCAGCAGTCCCACTGCGGGACAGGGTAGCTCTGGGGCCAACGTCCTGACTTTC	CASSPTAGQGSSGANVLTF	TRBV6-6	TRBJ2-6
TGTGCCAGCAGCGCCCCATCCTTAACTAGCGGGGGCGAGCAGTACTTC	CASSAPSLTSGGEQYF	TRBV3-1	TRBJ2-7
TGTGCCAGCAGCAGATTCGTGGTGCGTAATTCACCCCTCCACTTT	CASSRFVVRNSPLHF	TRBV7-3	TRBJ1-6
TGTGCTAGTGGTTTGCTAGGGGGACCTGAAGCTTTCTTT	CASGLLGGPEAFF	TRBV12-5	TRBJ1-1
TGTGCCAGTTGCAGGACAGACTCCTACGAGCAGTACTTC	CASCRTDSYEQYF	TRBV19	TRBJ2-7
TGTGCCAGCAGTTTACCCAGGGGCTCGGCCGGCTACACCTTC	CASSLPRGSAGYTF	TRBV27	TRBJ1-2
TGTGCCAGCCCCCACAGGGGTTGTTATTTTTCCTATGGCTACACCTTC	CASPHRGCYFSYGYTF	TRBV7-3	TRBJ1-2
TGTGCCAGCAGCCCCGGGACAGGGGACTCACCCCTCCACTTT	CASSPGTGDSPLHF	TRBV13	TRBJ1-6
TGTGCCAGCAGTCGTGGGGAGAGCACAGATACGCAGTATTTT	CASSRGESTDTQYF	TRBV6-6	TRBJ2-3
TGTGCCAGCAGCCAAGTCCCCCCCAGGACTAATGAAAAACTGTTTTTT	CASSQVPPRTNEKLFF	TRBV3-1	TRBJ1-4
TGTGCCAGCAGTTTGGGACTAGCGGGCAGTGAAAGCACAGATACGCAGTATTTT	CASSLGLAGSESTDTQYF	TRBV28	TRBJ2-3
TGTGCCAGCAGCTTAACCAAGAAGCCTGAAGCTTTCTTT	CASSLTKKPEAFF	TRBV5-4	TRBJ1-1
TGTGCCATGGAGGTATGGCTAGCGGTGTTCTTC	CAMEVWLAVFF	TRBV10-3	TRBJ2-7
TGTGCCAGCAGTGAAGCGCTTTTTGGCTACACCTTC	CASSEALFGYTF	TRBV6-1	TRBJ1-2
TGTGCCAGCAGCCAAGAAGGACAGGCAGGGGATGAGCAGTTCTTC	CASSQEGQAGDEQFF	TRBV4-2	TRBJ2-1
TGCGCCAGCAGCCAAGACGTAAGGCTACTCACCGGGGAGCTGTTTTTT	CASSQDVRLLTGELFF	TRBV4-3	TRBJ2-2
TGTGCCAGCAAGGGCAGGTGGCAGTTCTTC	CASKGRWQFF	TRBV25-1	TRBJ2-1
TGTGCCACGCTAGAAGGGCACACTGAAGCTTTCTTT	CATLEGHTEAFF	TRBV28	TRBJ1-1
TGCAGTGCTGTGACAGCGGTTGGCTATGGCTACACCTTC	CSAVTAVGYGYTF	TRBV20-1	TRBJ1-2
TGTGCCAGTAGTATACGCAGGGGCAATCAGCCCCAGCATTTT	CASSIRRGNQPQHF	TRBV19	TRBJ1-5
TGTGCCAGCAGCTCCAGGGCTAGCAATCAGCCCCAGCATTTT	CASSSRASNQPQHF	TRBV11-2	TRBJ1-5
TGTGCCAGTACGGGGATTCCCTCCTACAATGAGCAGTTCTTC	CASTGIPSYNEQFF	TRBV19	TRBJ2-1
TGTGCCAGCAGCCTGACAGTCCCCTACGAGCAGTACTTC	CASSLTVPYEQYF	TRBV13	TRBJ2-7
TGTGCCAGCAGTTTGGTTGCTAGCATATACAATGAGCAGTTCTTC	CASSLVASIYNEQFF	TRBV28	TRBJ2-1
TGTGCCAGCAGCCATTTAGCGGGACAGGGTGGTTACTCTGGGGCCAACGTCCTGACTTTC	CASSHLAGQGGYSGANVLTF	TRBV14	TRBJ2-6
TGTGCCAGCAGCTTACACTTAGACAGGGCAACTAATGAAAAACTGTTTTTT	CASSLHLDRATNEKLFF	TRBV7-6	TRBJ1-4
TGTGCCAGTAGTATCCCCACTAATACGGGATATGGCTACACCTTC	CASSIPTNTGYGYTF	TRBV19	TRBJ1-2
TGTGCCATCGGGCATCGGGGGCACTCCTACGAGCAGTACTTC	CAIGHRGHSYEQYF	TRBV10-3	TRBJ2-7
TGTGCCATATCGGCCCTCCACTTT	CAISALHF	TRBV28	TRBJ1-6
TGCGCCAGCAGTGCACAGGAGGGGGGATCGTCCAATCAGCCCCAGCATTTT	CASSAQEGGSSNQPQHF	TRBV10-1	TRBJ1-5
TGTGCCAGCACTGGCATGCCTGAGCAGTTCTTC	CASTGMPEQFF	TRBV6-4	TRBJ2-1
TGTGCTAGTGGTTTGCGAGGGTTATTCGCGAAGAGCTCCTACGAGCAGTACTTC	CASGLRGLFAKSSYEQYF	TRBV12-5	TRBJ2-7
TGCGCCAGCAGCTTGGCGGCGCGGGTTGCTGGGCCCTACGAGCAGTACTTC	CASSLAARVAGPYEQYF	TRBV5-1	TRBJ2-7
TGTGCCAGCATCTCGCTAGCGGGATCCGAAGAGACCCAGTACTTC	CASISLAGSEETQYF	TRBV9	TRBJ2-5
TGTGCCAGCAGCGGATCACAGTGGTATAGCAATCAGCCCCAGCATTTT	CASSGSQWYSNQPQHF	TRBV13	TRBJ1-5
TGTGCCAGCATTTTAGGGACAGGGTTTAGCTCTGGGGCCAACGTCCTGACTTTC	CASILGTGFSSGANVLTF	TRBV6-1	TRBJ2-6
TGTGCCAGCACGTCTGACAGGGGCGAGCAGTACTTC	CASTSDRGEQYF	TRBV9	TRBJ2-7
TGTGCCAGCAGCTTGCCACAGGGCCTCGGCTACACCTTC	CASSLPQGLGYTF	TRBV7-3	TRBJ1-2
TGTGCCACCAGTGGGGGGGAAGAAAGGTCCGAAGCTTTCTTT	CATSGGEERSEAFF	TRBV24-1	TRBJ1-1
TGTGCCAGCAGTTTATCGAGGGGACTAGGCGAAGAGACCCAGTACTTC	CASSLSRGLGEETQYF	TRBV27	TRBJ2-5
TGTGCCAGCAGCCAAGATTCATTCCCAGGGGACCGTCAGCCCCAGCATTTT	CASSQDSFPGDRQPQHF	TRBV3-1	TRBJ1-5
TGTGCCAGCATTAGCGGCACCGGGGAGCTGTTTTTT	CASISGTGELFF	TRBV7-4	TRBJ2-2
TGTGCAACAGCCGGCTACACCTTC	CATAGYTF	TRBV6-4	TRBJ1-2
TGTGCCAGCAGCGTATTTCGTCAGGGGGGCTACACCTTC	CASSVFRQGGYTF	TRBV11-3	TRBJ1-2
TGTGCCACCAGGGGGCGGGACAGGTATAGCAATCAGCCCCAGCATTTT	CATRGRDRYSNQPQHF	TRBV24-1	TRBJ1-5
TGCGCCAGCAGCCAACCCTTAGGGACAGGAAACAATGAGCAGTTCTTC	CASSQPLGTGNNEQFF	TRBV4-1	TRBJ2-1
TGTGCCAGCTCACCAGTACTAGCGGGGAGGGGGAGTCGCACAGATACGCAGTATTTT	CASSPVLAGRGSRTDTQYF	TRBV18	TRBJ2-3
TGTGCCAGCATAGCCGGACAGTTTAACACTGAAGCTTTCTTT	CASIAGQFNTEAFF	TRBV7-6	TRBJ1-1
TGTGCCAGCAGGCCGGGACAGGGGGAAAGCTCCTATAATTCACCCCTCCACTTT	CASRPGQGESSYNSPLHF	TRBV6-3	TRBJ1-6
TGTGCCAGCCCCACGGAGAACACTGAAGCTTTCTTT	CASPTENTEAFF	TRBV7-6	TRBJ1-1
TGCGCCAGCAGCTTGCCGGGGGACAGGGGTAACGAAAAACTGTTTTTT	CASSLPGDRGNEKLFF	TRBV5-1	TRBJ1-4
TGTGCCAGCAGTCGGTTGGGGACAGGGGCCCCATTAGACGAAAAACTGTTTTTT	CASSRLGTGAPLDEKLFF	TRBV28	TRBJ1-4
TGTGCCAGCAGCGGACTAGGCGGACAGAACAGAAGGCATTTT	CASSGLGGQNRRHF	TRBV13	TRBJ1-5
TGTGCCACCAGCGCCCCTATAGACTACGAGCAGTACTTC	CATSAPIDYEQYF	TRBV15	TRBJ2-7
TGCAGTGCTAGAGTTCCAGCGGGAGCCCCGATCGAGCAGTACTTC	CSARVPAGAPIEQYF	TRBV20-1	TRBJ2-7
TGTGCCAGCAGCCCCCAAGAGACACTTGAAGCTTTCTTT	CASSPQETLEAFF	TRBV7-9	TRBJ1-1
TGTGCCAGCAACCCAGGGGGACAGCCCCAGCATTTT	CASNPGGQPQHF	TRBV6-4	TRBJ1-5
TGTGCCAGCTCCCAGGCCCTGCAGCACGAGCAGTACTTC	CASSQALQHEQYF	TRBV7-3	TRBJ2-7
TGTGCCAGCAGTTTCCCCGGAGGTCCCACCCCCAACTCCTACAATGAGCAGTTCTTC	CASSFPGGPTPNSYNEQFF	TRBV27	TRBJ2-1
TGTGCCAGCAGTTACGCCCGTTGGGGACAGGCCACCGGCAATGAGCAGTTCTTC	CASSYARWGQATGNEQFF	TRBV6-5	TRBJ2-1
TGCGCCAGCTACAGGGACAACCCGTACGAGCAGTACTTC	CASYRDNPYEQYF	TRBV5-1	TRBJ2-7
TGTGCCAGCAGTTTCGGAATACACAGGGTAAATCCTAACTATGGCTACACCTTC	CASSFGIHRVNPNYGYTF	TRBV28	TRBJ1-2
TGTGCCAGCAGCACTCGACGGGAAAGCTCCTACGAGCAGTACTTC	CASSTRRESSYEQYF	TRBV7-9	TRBJ2-7
TGCGCCAGCAGCCAAGAGGTCCCAGGGGAGGGCAGGGCCAAAAACATTCAGTACTTC	CASSQEVPGEGRAKNIQYF	TRBV4-3	TRBJ2-4
TGTGCCAGAACTGAAGCGGGGGGTAATCAGCCCCAGCATTTT	CARTEAGGNQPQHF	TRBV7-9	TRBJ1-5
TGTGCCACCAGTGATTTGCCCGACGGCTACACCTTC	CATSDLPDGYTF	TRBV24-1	TRBJ1-2
TGTGCCAGCAGTGACTCGACAAACAGGTTGTTTGGGACCGAGCAGTACTTC	CASSDSTNRLFGTEQYF	TRBV6-4	TRBJ2-7
TGTGCCAGCACAACTAATCGGGGAAGGGGTGCTTATCCCCCTGAGACCCAGTACTTC	CASTTNRGRGAYPPETQYF	TRBV27	TRBJ2-5
TGTGCCACCAGCGCTGACCAAGGGGGGTCCTACGAGCAGTACTTC	CATSADQGGSYEQYF	TRBV15	TRBJ2-7
TGCGCCAGCAGTGATCGTCTGACAGGCCCGGAGACCCAGTACTTC	CASSDRLTGPETQYF	TRBV10-1	TRBJ2-5
TGCGCCAGCCCGCGGGCCGGAGACTACGAGCAGTACTTC	CASPRAGDYEQYF	TRBV10-2	TRBJ2-7
TGTGCCAGCAGTGAGGAAGCCGAAACCAAAAACATTCAGTACTTC	CASSEEAETKNIQYF	TRBV6-4	TRBJ2-4
TGTGCCACCAGCGTCGGGTCAGGACATCCTCGGGATTCACCCCTCCACTTT	CATSVGSGHPRDSPLHF	TRBV15	TRBJ1-6
TGCAGCGTTGGGGGCGGCTTTAACACTGAAGCTTTCTTT	CSVGGGFNTEAFF	TRBV29-1	TRBJ1-1
TGTGCCAGCAGCTCGAGGGTTGGGTGCCCCGAGAATCATAATGAAAAACTGTTTTTT	CASSSRVGCPENHNEKLFF	TRBV5-4	TRBJ1-4
TGTGCCAGCAGCGCTAGAACGGACAGAGGCTCCTACAATGAGCAGTTCTTC	CASSARTDRGSYNEQFF	TRBV4-2	TRBJ2-1
TGTGCCAGCAGCGGTAGAAACAGGATTCACGAGCAGTACTTC	CASSGRNRIHEQYF	TRBV9	TRBJ2-7
TGTGCCAGCAGCCCGGGTGAACGATCCTACAATGAGCAGTTCTTC	CASSPGERSYNEQFF	TRBV4-2	TRBJ2-1
TGTGCCAGCAGCTCTCGTCCGTTGGACTACGAGCAGTACTTC	CASSSRPLDYEQYF	TRBV5-6	TRBJ2-7
TGTGCCAGCAGTTTGAACATTTCACCTTCTGAAAAACTGTTTTTT	CASSLNISPSEKLFF	TRBV27	TRBJ1-4
TGTGCCACAGACAGGTGGCCCTGTTTCCGGAGCACAGATACGCAGTATTTT	CATDRWPCFRSTDTQYF	TRBV18	TRBJ2-3
TGTGCCACCAAGGCAGGGGATGCCCACGAGCAGTACTTC	CATKAGDAHEQYF	TRBV24-1	TRBJ2-7
TGTGCCAGCTCACTTAAATACCCAGGGACGCAGTTAACCTACGAGCAGTACTTC	CASSLKYPGTQLTYEQYF	TRBV18	TRBJ2-7
TGTGCCAGCAGCCAAGATCCTAGGTGGGGCTCCTATAATTCACCCCTCCACTTT	CASSQDPRWGSYNSPLHF	TRBV14	TRBJ1-6
TGTGCCATCAGTGAGTCGAACAGATTTTATGAGCAGTTCTTC	CAISESNRFYEQFF	TRBV10-3	TRBJ2-1
TGTGCCAGCAGCTTAGCCTATGGGGTAAGCAGCGGGACGAACGTGGTGGGGCGGCCCTACGAGCAGTACTTC	CASSLAYGVSSGTNVVGRPYEQYF	TRBV11-3	TRBJ2-7
TGTGCCATCAGTGAGTCGGACTCAGCAGAGGTGAGAATAAATGAGCAGTTCTTC	CAISESDSAEVRINEQFF	TRBV10-3	TRBJ2-1
TGTGCCACCAAGGATCAACACAGGGGGCGCCCCAGGGTGCATTTT	CATKDQHRGRPRVHF	TRBV24-1	TRBJ1-5
TGTGCCAGCCAGCTCGACAAATGGGGTAATGAAAAACTGTTTTTT	CASQLDKWGNEKLFF	TRBV6-3	TRBJ1-4
TGTGCCAGCAGCGCGGACAGGGTGAATGAGACCCAGTACTTC	CASSADRVNETQYF	TRBV7-3	TRBJ2-5
TGTGCCAGCAGCAAAGTTACCATGGAGAGCAATCAGCCCCAGCATTTT	CASSKVTMESNQPQHF	TRBV13	TRBJ1-5
TGTGCCAGCAGCTTCCCACGAATGGCCGGGGAGCTGTTTTTT	CASSFPRMAGELFF	TRBV9	TRBJ2-2
TGTGCCAGCCGTGGACGGGACTCCTACAATGAGCAGTTCTTC	CASRGRDSYNEQFF	TRBV25-1	TRBJ2-1
TGTGCCAGCAAAGGGGACAGGAAGCAAAGCAATCAGCCCCAGCATTTT	CASKGDRKQSNQPQHF	TRBV6-4	TRBJ1-5
TGTGCCTGGAGTTTCAGGGGGGACCAAGAGACCCAGTACTTC	CAWSFRGDQETQYF	TRBV30	TRBJ2-5
TGCAGTGCTAGAGATCAACTGAGAAAGAACGACTATGGCTACACCTTC	CSARDQLRKNDYGYTF	TRBV20-1	TRBJ1-2
TGCGCGGCGGAGGCTTTCTTT	CAAEAFF	TRBV10-1	TRBJ1-1
TGTGCCAGCAGCCACAGGGGATGGGGGGGGACTAATGAAAAACTGTTTTTT	CASSHRGWGGTNEKLFF	TRBV7-9	TRBJ1-4
TGTGCCAGTAAGAGCTCCTACGAGCAGTACTTC	CASKSSYEQYF	TRBV19	TRBJ2-7
TGCGCCAGCAGCCAAGACAACGGACAGGGAGAGACCCAGTACTTC	CASSQDNGQGETQYF	TRBV4-1	TRBJ2-5
TGCGCCAGCAGCCAAGTTGCTCTGGGCCGCCTCACCGGGGAGCTGTTTTTT	CASSQVALGRLTGELFF	TRBV4-1	TRBJ2-2
TGTGCCAGCAGCTTAGGGAAGCCATTTGAAACTAATGAAAAACTGTTTTTT	CASSLGKPFETNEKLFF	TRBV7-9	TRBJ1-4
TGTGCCAATACTAGGGACAATGAGCAGTTCTTC	CANTRDNEQFF	TRBV19	TRBJ2-1
TGTGCCAGCCCCGAAGGAGCGGGAGGGGGTCAGCCCCAGCATTTT	CASPEGAGGGQPQHF	TRBV27	TRBJ1-5
TGTGCCAGCAGTTTAAAATCTAGCAGCTACGAGCAGTACTTC	CASSLKSSSYEQYF	TRBV27	TRBJ2-7
TGTGCCAGCAGCTTGGAGGAGACAGGGGGCACTGAAGCTTTCTTT	CASSLEETGGTEAFF	TRBV5-6	TRBJ1-1
TGCGCCAGCAGCTTGGGACTGGTCTCCTACGAGCAGTACTTC	CASSLGLVSYEQYF	TRBV5-1	TRBJ2-7
TGTGCCAGCAGTGGACAGGCCTACGAGCAGTACTTC	CASSGQAYEQYF	TRBV7-9	TRBJ2-7
TGCGCCAGCAGCTTGCAATCTGCAAACACCATATATTTT	CASSLQSANTIYF	TRBV5-1	TRBJ1-3
TGTGCCAGCAGTGACGGACTAGCGGAGATAACAGATACGCAGTATTTT	CASSDGLAEITDTQYF	TRBV6-4	TRBJ2-3
TGCAGTGCTAGAGATCAACGCAAAGACAGGGGACATGGCATCTATGGCTACACCTTC	CSARDQRKDRGHGIYGYTF	TRBV20-1	TRBJ1-2
TGCGCCAGCAGCTTGCCTGGACTAGCGGAACCACACAATGAGCAGTTCTTC	CASSLPGLAEPHNEQFF	TRBV5-1	TRBJ2-1
TGTGCCAGCAGCTCGGAAGGCGGGGAGACCCAGTACTTC	CASSSEGGETQYF	TRBV4-2	TRBJ2-5
TGTGCCAGCAGCGTACGGAACCAAGGCGGGGGCGGCACTGAAGCTTTCTTT	CASSVRNQGGGGTEAFF	TRBV9	TRBJ1-1
TGTGCCAGCAGTGGAGGACAGGGGCGGGACGAGCAGTACTTC	CASSGGQGRDEQYF	TRBV27	TRBJ2-7
TGTGCCAGCAGTGATATTCAGAAAGCTTTCTTT	CASSDIQKAFF	TRBV25-1	TRBJ1-1
TGTGCCAGCAGTGAAGTAGCGGCCTACAATGAGCAGTTCTTC	CASSEVAAYNEQFF	TRBV6-1	TRBJ2-1
TGCGCCAGCAGACACTGGGGGGCCTCCCTGTTTTTT	CASRHWGASLFF	TRBV4-3	TRBJ1-4
TGCGCCAGCAGCCCCCGTGGGCCACGGAGCTCCTACAATGAGCAGTTCTTC	CASSPRGPRSSYNEQFF	TRBV5-1	TRBJ2-1
TGTGCCAGCAGTGGGACAGAAAATGAGCAGTTCTTC	CASSGTENEQFF	TRBV28	TRBJ2-1
TGCAGTGCTATGCCCCAAGCCGGAAGCTCCTACAATGAGCAGTTCTTC	CSAMPQAGSSYNEQFF	TRBV20-1	TRBJ2-1
TGTGCCAGCAGCCCACCTTGTTCCGATCAGCCCCAGCATTTT	CASSPPCSDQPQHF	TRBV28	TRBJ1-5
TGCAGCGTTGAAGAGTTCCTGAACTTTTGTAACTATGGCTACACCTTC	CSVEEFLNFCNYGYTF	TRBV29-1	TRBJ1-2
TGTGCCAGGACTAGGGGCCCTGAGCAGCCCCAGCATTTT	CARTRGPEQPQHF	TRBV19	TRBJ1-5
TGTGCCAGCTCACGGGGCCAGATCAGGTTCCGTGACCGTACCTACGAGCAGTACTTC	CASSRGQIRFRDRTYEQYF	TRBV18	TRBJ2-7
TGCAGTGCTACCCCGGGACGGGGAAACACCATATATTTT	CSATPGRGNTIYF	TRBV20-1	TRBJ1-3
TGCAGCGTTGACACACTAGCGGGGACGGCAGAGACCCAGTACTTC	CSVDTLAGTAETQYF	TRBV29-1	TRBJ2-5
TGCGCCAGCAGCCGCCCGAGTAGCCCAGGTAACAATGAGCAGTTCTTC	CASSRPSSPGNNEQFF	TRBV5-1	TRBJ2-1
TGTGCCAGCAGCCAGGGAAAGGTGACTAGGGGCGAGACCCAGTACTTC	CASSQGKVTRGETQYF	TRBV3-1	TRBJ2-5
TGCGCCAGCACGGACATTGGATCCAAAAACATTCAGTACTTC	CASTDIGSKNIQYF	TRBV10-1	TRBJ2-4
TGCGCCAGCAGCGCCATTAAACACCCCGAGTACCACTCCTACGAGCAGTACTTC	CASSAIKHPEYHSYEQYF	TRBV5-1	TRBJ2-7
TGCGCCACCTTAACCGCCGCGGGACTAGTCCAGTACGAGCAGTACTTC	CATLTAAGLVQYEQYF	TRBV5-1	TRBJ2-7
TGCGCCAGCAGTGCAGGCCTCCATAGCAATCAGCCCCAGCATTTT	CASSAGLHSNQPQHF	TRBV10-1	TRBJ1-5
TGTGCCAGCCCCGCAGCACGGGCTGTAAAGGGGAACACTGAAGCTTTCTTT	CASPAARAVKGNTEAFF	TRBV6-6	TRBJ1-1
TGTGCCAGTAAGTTATCGGGCGGAGCCTTGGGGCCCAGCCGGTCCTACAATGAGCAGTTCTTC	CASKLSGGALGPSRSYNEQFF	TRBV19	TRBJ2-1
TGTGCCATCAAAACGGACAGGGGGGGCGTTAGCACAGATACGCAGTATTTT	CAIKTDRGGVSTDTQYF	TRBV10-3	TRBJ2-3
TGTGCCAGCAGCCACCGCCTTACTTACGACGAGCAGTACTTC	CASSHRLTYDEQYF	TRBV7-4	TRBJ2-7
TGTGCCAGCAGCTTAGAGGTCAACCAGGGACGGGGTTCAGAGACCCAGTACTTC	CASSLEVNQGRGSETQYF	TRBV11-2	TRBJ2-5
TGTGCCAGCAGTGTCGAAAGGACAGGGGTAGCATCGATGAACACTGAAGCTTTCTTT	CASSVERTGVASMNTEAFF	TRBV6-4	TRBJ1-1
TGTGCCAGCAGCTTAGGCCCGGGACTAGCGGGAGGGCATTGGCACACTGAAGCTTTCTTT	CASSLGPGLAGGHWHTEAFF	TRBV7-4	TRBJ1-1
TGCAGCGACGGAGGAGGCTATGGCTACACCTTC	CSDGGGYGYTF	TRBV29-1	TRBJ1-2
TGCAGCGTCAACGTCGGGAAATTAAAGCGGCGGAAATATGGCTACACCTTC	CSVNVGKLKRRKYGYTF	TRBV29-1	TRBJ1-2
TGTGCCAGCAGACCCGGGACAGGGGGCACTGGGGCCAACGTCCTGACTTTC	CASRPGTGGTGANVLTF	TRBV14	TRBJ2-6
TGTGCCAGCAGTTGCCAACTGACAGGACCTCCCTATGGCTACACCTTC	CASSCQLTGPPYGYTF	TRBV12-4	TRBJ1-2
TGTGCCAGCAGCTTGGGCTCCGACAGGGCTAATGAAAAACTGTTTTTT	CASSLGSDRANEKLFF	TRBV5-5	TRBJ1-4
TGTGCCAGCAGTTTAAGACGCAGGATCAAAATATTAGGTGGCTACACCTTC	CASSLRRRIKILGGYTF	TRBV12-3	TRBJ1-2
TGTGCCAGCGTGTCCATTAGACCTAGCACAGATACGCAGTATTTT	CASVSIRPSTDTQYF	TRBV7-9	TRBJ2-3
TGCAGTGCCCCGAAGGGAGTGAACACTGAAGCTTTCTTT	CSAPKGVNTEAFF	TRBV20-1	TRBJ1-1
TGTGCCATCAGTGAGTCGTTGGCGGGCACAGATACGCAGTATTTT	CAISESLAGTDTQYF	TRBV10-3	TRBJ2-3
TGTGCCACCGGGGTCCAGGAGGGCTATGGCTACACCTTC	CATGVQEGYGYTF	TRBV24-1	TRBJ1-2
TGTGCCAGCAGTCCGTTAGGGGGCCACGAGCAGTACTTC	CASSPLGGHEQYF	TRBV6-3	TRBJ2-7
TGTGCCAGCAGTTTCCCCCGACAGGGGTTTTCACCCCTCCACTTT	CASSFPRQGFSPLHF	TRBV12-3	TRBJ1-6
TGTGCCAGCAGTTTGCTTTCCATGGCCACCCCGGGGACTGGAAACACCATATATTTT	CASSLLSMATPGTGNTIYF	TRBV27	TRBJ1-3
TGTGCCATCAAAAGGGGGCACGATAGCAATCAGCCCCAGCATTTT	CAIKRGHDSNQPQHF	TRBV10-3	TRBJ1-5
TGTGCCAGCAGTTTTAAGAGCCGGGAAAACACCATATATTTT	CASSFKSRENTIYF	TRBV27	TRBJ1-3
TGCGCCAGCAGTGAGCGGGACAGTTGTTATAGCAATCAGCCCCAGCATTTT	CASSERDSCYSNQPQHF	TRBV10-1	TRBJ1-5
TGCAGCGTTGAGCACGCGGGAGATCAGCCCCAGCATTTT	CSVEHAGDQPQHF	TRBV29-1	TRBJ1-5
TGTGCCACCCGAGGGGCAGGATGTACTGAAGCTTTCTTT	CATRGAGCTEAFF	TRBV24-1	TRBJ1-1
TGCGCCAGCAGCCAAACCGGGGGCGATTCCTACGAGCAGTACTTC	CASSQTGGDSYEQYF	TRBV4-1	TRBJ2-7
TGTGCCAGCAGTGACTCGACGAGGGACGAGGGAAACACCGGGGAGCTGTTTTTT	CASSDSTRDEGNTGELFF	TRBV6-4	TRBJ2-2
TGTGCCAGCAGAGACTGGGCAGGGAGAGGTGACAGAACTGAAGCTTTCTTT	CASRDWAGRGDRTEAFF	TRBV12-3	TRBJ1-1
TGTGCCAGCCACAGGGCCCCTCAAGAGCAGTACTTC	CASHRAPQEQYF	TRBV7-3	TRBJ2-7
TGTGCCAGCAGGGGACCTAGCGGCGCCTACGAGCAGTACTTC	CASRGPSGAYEQYF	TRBV27	TRBJ2-7
TGCAGCGCCCTAACCAGGGGGACGAACACCGGGGAGCTGTTTTTT	CSALTRGTNTGELFF	TRBV29-1	TRBJ2-2
TGTGCCAGCAGCGTAGGCTCCACGCGGGAGTTATATAGCACAGATACGCAGTATTTT	CASSVGSTRELYSTDTQYF	TRBV9	TRBJ2-3
TGCAGTGCAACCGCCGGTTTGGGACAGCGGTACAATGAGCAGTTCTTC	CSATAGLGQRYNEQFF	TRBV20-1	TRBJ2-1
TGTGCCACGGAGAATTCACCCCTCCACTTT	CATENSPLHF	TRBV7-2	TRBJ1-6
TGTGCCAGCAGCCACCGGGTGCCTAATGGCTACACCTTC	CASSHRVPNGYTF	TRBV7-9	TRBJ1-2
TGCAGTGCTACCCACGATAGGTCCGCCTACGAGCAGTACTTC	CSATHDRSAYEQYF	TRBV20-1	TRBJ2-7
TGTGCCAGCAGGGGGTTTCAGCCCCAGCATTTT	CASRGFQPQHF	TRBV27	TRBJ1-5
TGTGCCATCAGTGAGCGCATCACTGAAGCTTTCTTT	CAISERITEAFF	TRBV10-3	TRBJ1-1
TGTGCCACCACAGCATGTGAAAAACTGTTTTTT	CATTACEKLFF	TRBV24-1	TRBJ1-4
TGTGCCAGCAGCCCCGGGGGGTATGGGACTAGCGGGGTCACAGATACGCAGTATTTT	CASSPGGYGTSGVTDTQYF	TRBV3-1	TRBJ2-3
TGTGCCACCAGTGACGTAGCGGGGGAGACCCAGTACTTC	CATSDVAGETQYF	TRBV24-1	TRBJ2-5
TGTGCCTGGACCAGACAGTGGGGAATTCAAGTCTTGACCTACGAGCAGTACTTC	CAWTRQWGIQVLTYEQYF	TRBV30	TRBJ2-7
TGCAGTGCTAGGAAATATCCGGGATATGAGCAGTACTTC	CSARKYPGYEQYF	TRBV20-1	TRBJ2-7
TGCAGTGCTAGAATGCAGTTATCGAACACCGGGGAGCTGTTTTTT	CSARMQLSNTGELFF	TRBV20-1	TRBJ2-2
TGCGCCAGCATGCTTAATCAGCCCCAGCATTTT	CASMLNQPQHF	TRBV4-3	TRBJ1-5
TGTGCCACCAGCAGACAGGAAATGACAGGGCAGGATACGCAGTATTTT	CATSRQEMTGQDTQYF	TRBV15	TRBJ2-3
TGTGCCAGCAGTGTCGACAACGGAAACACCATATATTTT	CASSVDNGNTIYF	TRBV2	TRBJ1-3
TGTGCCAGCAGCTACGGGACAGCGTACAATGAGCAGTTCTTC	CASSYGTAYNEQFF	TRBV11-1	TRBJ2-1
TGTGCTAGTGGTTTGGACACCGTCGTACTAGCGGGCCGGCAAGAGACCCAGTACTTC	CASGLDTVVLAGRQETQYF	TRBV12-5	TRBJ2-5
TGTGCCAGCGGGGGGAACACAGATACGCAGTATTTT	CASGGNTDTQYF	TRBV6-1	TRBJ2-3
TGCAGGGCTAGCGGGGGGGCCGCGGGGGATGAGCAGTTCTTC	CRASGGAAGDEQFF	TRBV20-1	TRBJ2-1
TGCAGCGTAGAAAATCCGGGACAGCCCGCTAATTCACCCCTCCACTTT	CSVENPGQPANSPLHF	TRBV29-1	TRBJ1-6
TGTGCCAGCAGCCGTCCCCAAGGGGGGGGGTTACTGTACTTC	CASSRPQGGGLLYF	TRBV14	TRBJ2-5
TGTGCCAGCAGTGAATACGAACCTAGCGGGGGGGCTGAGGTGACCGGGGAGCTGTTTTTT	CASSEYEPSGGAEVTGELFF	TRBV6-1	TRBJ2-2
TGTGCCAGCAGCCACGGGAGACACCGGGGCCGCTACAATGAGCAGTTCTTC	CASSHGRHRGRYNEQFF	TRBV12-4	TRBJ2-1
TGTGCCAGCAGCTGGAGCCCACTAGCGGGAGATGACGGCACTGAAGCTTTCTTT	CASSWSPLAGDDGTEAFF	TRBV5-5	TRBJ1-1
TGTGCCAGTAGCGCGGACAGGGGGGCCTACGAGCAGTACTTC	CASSADRGAYEQYF	TRBV19	TRBJ2-7
TGCGCCAGCAGCGCCCCCCACCGGGGCGAGAGTATGAACACTGAAGCTTTCTTT	CASSAPHRGESMNTEAFF	TRBV5-1	TRBJ1-1
TGCGCCAGCAGCCAAGATCCCAAGGAGACAGGGGGATACGAGCAGTACTTC	CASSQDPKETGGYEQYF	TRBV4-1	TRBJ2-7
TGTGCCAGCAGCATGACATCTGATTCACCCCTCCACTTT	CASSMTSDSPLHF	TRBV11-2	TRBJ1-6
TGTGACTCGACTAATGAGACCCAGTACTTC	CDSTNETQYF	TRBV2	TRBJ2-5
TGTGCCAGCAGGACGGACGGGCTGTACGAGCAGTACTTC	CASRTDGLYEQYF	TRBV6-5	TRBJ2-7
TGTGCCAGCAGTTTACCGGGACCGAAAAACATTCAGTACTTC	CASSLPGPKNIQYF	TRBV7-9	TRBJ2-4
TGTGCCAGCAGGCCAACTGGACAGGGGTTAGGAAACACCATATATTTT	CASRPTGQGLGNTIYF	TRBV7-2	TRBJ1-3
TGTGCCAGCAGCCGGCTGCTGGTCTCCTACGAGCAGTACTTC	CASSRLLVSYEQYF	TRBV28	TRBJ2-7
TGTGCCAGCGGCCTGGGACCCCACTGGGTTGCCTACGAGCAGTACTTC	CASGLGPHWVAYEQYF	TRBV6-4	TRBJ2-7
TGCGCCAGCAGTGGGGTGACTAGCGGGGGGGTCTCCTACGAGCAGTACTTC	CASSGVTSGGVSYEQYF	TRBV10-1	TRBJ2-7
TGTGCCAGCAGCTTCAACATTAAGGCGAACACTGAAGCTTTCTTT	CASSFNIKANTEAFF	TRBV5-4	TRBJ1-1
TGTGCCAGCAGCTCGGGACAGGGGGGGGCTTTCTTT	CASSSGQGGAFF	TRBV7-6	TRBJ1-1
TGTGCCAGCAGCGCAGTTGGCTACACCTTC	CASSAVGYTF	TRBV7-3	TRBJ1-2
TGCGCCAGCAGCCAAGATAGTATCGCGAATAACGAGACCCAGTACTTC	CASSQDSIANNETQYF	TRBV4-3	TRBJ2-5
TGTGCCAGCAGTTTATTAGGACAGGGGAAACATGGCTACACCTTC	CASSLLGQGKHGYTF	TRBV27	TRBJ1-2
TGCAGTGCTAGTTCCCCCCACGGGGTCCACTCCTACGAGCAGTACTTC	CSASSPHGVHSYEQYF	TRBV20-1	TRBJ2-7
TGTGCCAGCAGCCGACAGGGGGTAAATTCACCCCTCCACTTT	CASSRQGVNSPLHF	TRBV28	TRBJ1-6
TGTGCCAGCAGCACGGCTGCGCACCCCTACAATGAGCAGTTCTTC	CASSTAAHPYNEQFF	TRBV5-6	TRBJ2-1
TGTGCCAGCAGTCTCGATACAGGGGGCGCGTTCACAGATACGCAGTATTTT	CASSLDTGGAFTDTQYF	TRBV7-9	TRBJ2-3
TGCGCCAGCAGCTGCCGCGAGACTAGCATGGCCTACGAGCAGTACTTC	CASSCRETSMAYEQYF	TRBV5-1	TRBJ2-7
TGTGCCACCAGCAGAGTCCGGAGCTCAGACAGTATAAAAACCGAGCAGTACTTC	CATSRVRSSDSIKTEQYF	TRBV15	TRBJ2-7
TGTGCCAGCAGCCGACAGGGGGGGAGGGATGAGACCCAGTACTTC	CASSRQGGRDETQYF	TRBV13	TRBJ2-5
TGTGCCAGCAGGGAAATGTCCGGGACAGGGGGCAGTTTAGGGCCAGATACGCAGTATTTT	CASREMSGTGGSLGPDTQYF	TRBV6-2	TRBJ2-3
TGTGCCAGCTACGGATCACAGGGGGGGCCCTACGAGCAGTACTTC	CASYGSQGGPYEQYF	TRBV6-2	TRBJ2-7
TGCGCCAGGGGGGCAGGGGGCTGCTATGGCTACACCTTC	CARGAGGCYGYTF	TRBV10-1	TRBJ1-2
TGTGCCAGCAGCAAGGGGCACGAGCAGTACTTC	CASSKGHEQYF	TRBV13	TRBJ2-7
TGTGCCAGCAGGTTCCCCGGGATGCTCGAGCAGTACTTC	CASRFPGMLEQYF	TRBV27	TRBJ2-7
TGCGCCAGCAGCATGGACAGGACCGGGGAGCTGTTTTTT	CASSMDRTGELFF	TRBV5-1	TRBJ2-2
TGCGCCAGCAATACTAGCGGGAGGGAGAGCTCTGGAAACACCATATATTTT	CASNTSGRESSGNTIYF	TRBV5-1	TRBJ1-3
TGTGCCAGCAGCTTTTTAGCTAGCGGGCTCTCCTACGAGCAGTACTTC	CASSFLASGLSYEQYF	TRBV7-4	TRBJ2-7
TGTGCCAGCAACCCCGGCGGTGGCTACACCTTC	CASNPGGGYTF	TRBV6-6	TRBJ1-2
TGTGCTAGTGGTTTCCGGGACAGGGGGGAGAATCAGCCCCAGCATTTT	CASGFRDRGENQPQHF	TRBV12-5	TRBJ1-5
TGTGCCAGCAGTTATGGTTGGGACAGGCAGAACTATGGCTACACCTTC	CASSYGWDRQNYGYTF	TRBV6-9	TRBJ1-2
TGTGCCACGGGGACAGAAGCCTCTAGCAATCAGCCCCAGCATTTT	CATGTEASSNQPQHF	TRBV19	TRBJ1-5
TGCAGTGCTAGAGGCTTTCGGCTAAGGGGTACCGGGGAGCTGTTTTTT	CSARGFRLRGTGELFF	TRBV20-1	TRBJ2-2
TGTGCCTGGCCGAGTATAGGGACTAGCGGGTGGCAAGAGACCCAGTACTTC	CAWPSIGTSGWQETQYF	TRBV30	TRBJ2-5
TGTGCCAGCAGCTTACCTCTAGCGGGAGACAATGAGCAGTTCTTC	CASSLPLAGDNEQFF	TRBV7-9	TRBJ2-1
TGTGCCAGCAGTCCTTGGGGGGAAGCCTATAATTCACCCCTCCACTTT	CASSPWGEAYNSPLHF	TRBV28	TRBJ1-6
TGTGCCAGCAGGGGGTACGGACAGGGATCCTATGGCTACACCTTC	CASRGYGQGSYGYTF	TRBV6-2	TRBJ1-2
TGCAGCGTTGGGTGGCCCGGGGCCAGCAATCAGCCCCAGCATTTT	CSVGWPGASNQPQHF	TRBV29-1	TRBJ1-5
TGCAGTGCCCGGACAGGCAAGGACAATCAGCCCCAGCATTTT	CSARTGKDNQPQHF	TRBV20-1	TRBJ1-5
TGTGCCAGCAGCCAAGATTACGGCCCAATCTATGGTAAAAAAAACCTAGTCCTTTATAGATACGAGCAGTACTTC	CASSQDYGPIYGKKNLVLYRYEQYF	TRBV4-2	TRBJ2-7
TGTGCCAGCAGCCCCGATGGGGAGCAGAGCGGCTACACCTTC	CASSPDGEQSGYTF	TRBV6-6	TRBJ1-2
TGCAGTGCTAGATCCGGAGGGGATGAAAAACTGTTTTTT	CSARSGGDEKLFF	TRBV20-1	TRBJ1-4
TGTGCCAGCAGCTTCCCTGGCAAAAACATTCAGTACTTC	CASSFPGKNIQYF	TRBV5-6	TRBJ2-4
TGCACAGCCACTAGCGGGGCGTACGGGAGCACAGATACGCAGTATTTT	CTATSGAYGSTDTQYF	TRBV29-1	TRBJ2-3
TGTGCCAGCAGCAGTTGGGGACTAGCGGGTCGAGACCTGGAGCAGTACTTC	CASSSWGLAGRDLEQYF	TRBV5-6	TRBJ2-7
TGTGCCAGTAGTATTTTGACAGGGGTAACCACCGACGAGAATCAGCCCCAGCATTTT	CASSILTGVTTDENQPQHF	TRBV19	TRBJ1-5
TGTGCCAGCAGTAGAGAACCTGAAGCTTTCTTT	CASSREPEAFF	TRBV12-3	TRBJ1-1
TGTGCCAGCAGCTCCCAGGGGGCGGGGACCTATGGCTACACCTTC	CASSSQGAGTYGYTF	TRBV5-4	TRBJ1-2
TGCGCCAGCAGCTTGGCCGGACAGGGAAAAGGTGAAGCTTTCTTT	CASSLAGQGKGEAFF	TRBV5-1	TRBJ1-1
TGTGCCAGCAGTTTACCGGCCGGGACTAGCGGGGGGGCTCGCAATGAGCAGTTCTTC	CASSLPAGTSGGARNEQFF	TRBV12-3	TRBJ2-1
TGTGCCAGCAGCCAACCCAAGGATAACACAGATACGCAGTATTTT	CASSQPKDNTDTQYF	TRBV7-3	TRBJ2-3
TGTGCCAGTAATCTCCGGGACTATCGTAGCTCCTACGAGCAGTACTTC	CASNLRDYRSSYEQYF	TRBV19	TRBJ2-7
TGCAGCGTTGAAGATCTTCCGGGAAGAGGATTTGGAAACACCATATATTTT	CSVEDLPGRGFGNTIYF	TRBV29-1	TRBJ1-3
TGTGCCAGTAGGGCTGCGGGCGATCAATTATTGTACGAGCAGTACTTC	CASRAAGDQLLYEQYF	TRBV19	TRBJ2-7
TGTGCCAGCAGTTACAAGGGACAGTTTGGGCTTACCTCCTACAATGAGCAGTTCTTC	CASSYKGQFGLTSYNEQFF	TRBV6-6	TRBJ2-1
TGTGCCAGCAGTAAAAACCCGCTGGTGCAGTTCTTC	CASSKNPLVQFF	TRBV12-4	TRBJ2-1
TGTGCCAGTTGGCTTCCTTACAATGAGCAGTTCTTC	CASWLPYNEQFF	TRBV19	TRBJ2-1
TGTGCCAGCAGTGAAGCTGAGGGAGAGTATTACGAGCAGTACTTC	CASSEAEGEYYEQYF	TRBV6-4	TRBJ2-7
TGTGCCAGCAGCCAAGCCCCGCCAGGGGACTACAATGAGCAGTTCTTC	CASSQAPPGDYNEQFF	TRBV3-1	TRBJ2-1
TGCGCCAGCAGCTTGGCCCTGCGTCGGCAAATCTACGAGCAGTACTTC	CASSLALRRQIYEQYF	TRBV5-1	TRBJ2-7
TGTGCCAGCAGCGAGAGAACCCCCGGAGTCGATGGCTACACCTTC	CASSERTPGVDGYTF	TRBV6-5	TRBJ1-2
TGTGCCAGCAGCTTAGGAAGGACTAGGATATACAATGAGCAGTTCTTC	CASSLGRTRIYNEQFF	TRBV11-2	TRBJ2-1
TGTGCCAGCAGGGTAGGGGCGACACTTAACTATGGCTACACCTTC	CASRVGATLNYGYTF	TRBV28	TRBJ1-2
TGTGCCAGCAGCTTAGGTCAGGGTACTGGGGCCAACGTCCTGACTTTC	CASSLGQGTGANVLTF	TRBV7-9	TRBJ2-6
TGTGCCAGCAGCAATACACGATATAATTCACCCCTCCACTTT	CASSNTRYNSPLHF	TRBV7-3	TRBJ1-6
TGTGCCAGCAGGCCCGTAGATAGCGGGAGATCCTACGAGCAGTACTTC	CASRPVDSGRSYEQYF	TRBV25-1	TRBJ2-7
TGTGCCTCAGGGGGCAGCGAGCAGTACTTC	CASGGSEQYF	TRBV30	TRBJ2-7
TGTGCTAGTGGTTTGGCAGGGGGGGGGAGGACAGATACGCAGTATTTT	CASGLAGGGRTDTQYF	TRBV12-5	TRBJ2-3
TGCAGTGCGCGGACAAGGTACGAGCAGTACTTC	CSARTRYEQYF	TRBV20-1	TRBJ2-7
TGTGCCAGCAGCTTGGCAGGGGGTTGCTCCTACGAGCAGTACTTC	CASSLAGGCSYEQYF	TRBV5-6	TRBJ2-7
TGTGCCAGCAGAACCAGGGGGTGGGACACTGAAGCTTTCTTT	CASRTRGWDTEAFF	TRBV5-5	TRBJ1-1
TGTGCCAGTATGGGGGGCACCCGCCGCAATCAGCCCCAGCATTTT	CASMGGTRRNQPQHF	TRBV19	TRBJ1-5
TGTGCCATCACTCTATCTCTGACAGATACGCAGTATTTT	CAITLSLTDTQYF	TRBV10-3	TRBJ2-3
TGTGCCACCAGTGACCTCGGGGACAGGGAGCCTGGAAACACCATATATTTT	CATSDLGDREPGNTIYF	TRBV24-1	TRBJ1-3
TGTGCCAGCAGCTTCGAGGACAGGACAGATACGCAGTATTTT	CASSFEDRTDTQYF	TRBV7-9	TRBJ2-3
TGTGCCAGCAGCCTTACACGGCGGGAGCTACGGGGGTCCTACGAGCAGTACTTC	CASSLTRRELRGSYEQYF	TRBV14	TRBJ2-7
TGTGCCAGCAGTGAATTCAATACAGGGGGAAAGTCTCGGCCCCACCGCAATCAGCCCCAGCATTTT	CASSEFNTGGKSRPHRNQPQHF	TRBV25-1	TRBJ1-5
TGTGCCAGCAGCTTAGATGCCCCGGGACTAGCGGGCGCTAATACCACCCAAGAGACCCAGTACTTC	CASSLDAPGLAGANTTQETQYF	TRBV11-3	TRBJ2-5
TGTGCCAGCAGTGTCGCAGGGCGGCAGCCCCAGCATTTT	CASSVAGRQPQHF	TRBV6-1	TRBJ1-5
TGTGCCAGCAGCCCGGCTAAAACCCAGGGTAAGGGGTTGCGGGATTCACCCCTCCACTTT	CASSPAKTQGKGLRDSPLHF	TRBV13	TRBJ1-6
TGTGCCAGCAGTTACAACGAAGGACACCCGCCCGGGGAGCTGTTTTTT	CASSYNEGHPPGELFF	TRBV6-5	TRBJ2-2
TGTGCCAGCAGGAGGACTAGCGGGACGGGGGCCTACGAGCAGTACTTC	CASRRTSGTGAYEQYF	TRBV6-2	TRBJ2-7
TGCGCCAGCAGCCATGTGCTACCGACCTATAATTCACCCCTCCACTTT	CASSHVLPTYNSPLHF	TRBV4-3	TRBJ1-6
TGTGCCAGCAGCCAAGTGGGGGCGTACACAGATACGCAGTATTTT	CASSQVGAYTDTQYF	TRBV3-1	TRBJ2-3
TGTGCCATCAGTGGGAAGAAACTAGCGGGAGGGCCGGGAGTCTCTGGGGCCAACGTCCTGACTTTC	CAISGKKLAGGPGVSGANVLTF	TRBV10-3	TRBJ2-6
TGTGCCAGCAGCGTAACGGTTCAGCGGGACACTGAAGCTTTCTTT	CASSVTVQRDTEAFF	TRBV9	TRBJ1-1
TGTGCCAGGCCGGAAGGGGGAACCAATCAGCCCCAGCATTTT	CARPEGGTNQPQHF	TRBV19	TRBJ1-5
TGCAGTGCTAGAGATTACGGGGAGCCGTGGGAGCAGTACTTC	CSARDYGEPWEQYF	TRBV20-1	TRBJ2-7
TGTGCCAGCAGCGTATTCAATCTCCCAGGAGGGGCATACCACCACGGGAGAGAGACCCAGTACTTC	CASSVFNLPGGAYHHGRETQYF	TRBV9	TRBJ2-5
TGTGCCACCTTGAGGGTGGGGGAAGAGACCCAGTACTTC	CATLRVGEETQYF	TRBV6-5	TRBJ2-5
TGTGCCAGCAGCCGGGGGGGGACAGCAAATCAGCCCCAGCATTTT	CASSRGGTANQPQHF	TRBV7-9	TRBJ1-5
TGTGCCAGCAGTGAAGGCCGGGTAGAGGGGAATGAGCAGTTCTTC	CASSEGRVEGNEQFF	TRBV6-1	TRBJ2-1
TGTGCCAGCAGCCTAGCGGGAGTGCGCTACGAGCAGTACTTC	CASSLAGVRYEQYF	TRBV9	TRBJ2-7
TGTGCCAGTAGTAGGGACATCCAAGAGTACTTC	CASSRDIQEYF	TRBV19	TRBJ2-5
TGTGCCAGCAGCTTAGAGGAGAGGTCTAGCACAGATACGCAGTATTTT	CASSLEERSSTDTQYF	TRBV11-2	TRBJ2-3
TGTGCCAGCAGTGAGGACCAAGAGACCCAGTACTTC	CASSEDQETQYF	TRBV2	TRBJ2-5
TGTGCCAGCAGTTATTTTCCCCTAGGGGGCTACGTGGGCTCTGGAAACACCATATATTTT	CASSYFPLGGYVGSGNTIYF	TRBV6-3	TRBJ1-3
TGTGCCAGCAGCGTCGCAGCAGCAACTAATGAAAAACTGTTTTTT	CASSVAAATNEKLFF	TRBV7-3	TRBJ1-4
TGTGCCTGGAGTACGGGGGGCTATGGCTACACCTTC	CAWSTGGYGYTF	TRBV30	TRBJ1-2
TGTGCAATGGAAGGGGGCGGGGGTGATACGCAGTATTTT	CAMEGGGGDTQYF	TRBV3-1	TRBJ2-3
TGTGCCAGCAGCGTAGCTAGTCACCTCAGGGAAGGGATACCTAGCACAGATACGCAGTATTTT	CASSVASHLREGIPSTDTQYF	TRBV9	TRBJ2-3
TGTGCCAGCAGCCAAGATGAAGGACTAGCTGAGACCCAGTACTTC	CASSQDEGLAETQYF	TRBV3-1	TRBJ2-5
TGTGCCAGCAGTTATCAATGCCGGGACACTGAAGCTTTCTTT	CASSYQCRDTEAFF	TRBV6-3	TRBJ1-1
TGTGCCTGGCCCTGGACTAGCGGCCACCGAAATGAGCAGTTCTTC	CAWPWTSGHRNEQFF	TRBV30	TRBJ2-1
TGTGCCAGCAGCCACGCGAACACGCAGCCCCAGCATTTT	CASSHANTQPQHF	TRBV4-2	TRBJ1-5
TGTGCCAGCAGGACGTTGCGGGGCCCAGATACGCAGTATTTT	CASRTLRGPDTQYF	TRBV2	TRBJ2-3
TGTGCCAGCAGCTTGGAAGCTCAGGGTACTGGGGCCAACGTCCTGACTTTC	CASSLEAQGTGANVLTF	TRBV7-3	TRBJ2-6
TGCAGTGCCGTGTCTACAGAGTGCAGCAATCAGCCCCAGCATTTT	CSAVSTECSNQPQHF	TRBV20-1	TRBJ1-5
TGTGCCAGCAGTTCCCGAGCCGGGACACTCTCAGATACGCAGTATTTT	CASSSRAGTLSDTQYF	TRBV6-5	TRBJ2-3
TGTGCCAGCAGCTTTTCACCCGGGAGAGACTCTGGGGCCAACGTCCTGACTTTC	CASSFSPGRDSGANVLTF	TRBV7-3	TRBJ2-6
TGTGCCAGCAGCTACATGGACAGGGACTCCTACGAGCAGTACTTC	CASSYMDRDSYEQYF	TRBV7-9	TRBJ2-7
TGTGCCACCGAAAAGGCTCCGACAGGGGGCCGAAGCGAGCAGTACTTC	CATEKAPTGGRSEQYF	TRBV24-1	TRBJ2-7
TGCAGCGCGGGGGACACTGAAGCTTTCTTT	CSAGDTEAFF	TRBV29-1	TRBJ1-1
TGTGCCAGCAGCGTACCGCCCCCGCCGATGCACGAGCAGTACTTC	CASSVPPPPMHEQYF	TRBV13	TRBJ2-7
TGCGCCAGCAGCCAAGCGACTAGCGGGAGGGCCCCCCGCACAGATACGCAGTATTTT	CASSQATSGRAPRTDTQYF	TRBV4-1	TRBJ2-3
TGTGCCAGCATACCCAGGGATCAGCCCCAGCATTTT	CASIPRDQPQHF	TRBV6-1	TRBJ1-5
TGTGCCAGCAGCTCCGTTTACAGCTGGGAGGGGGGGAATTTCCGATTTGGAACAGATACGCAGTATTTT	CASSSVYSWEGGNFRFGTDTQYF	TRBV7-9	TRBJ2-3
TGTGCCAGCAGCGGCAAAAAAACCGGGGACATAGGGATTGGCAATCAGCCCCAGCATTTT	CASSGKKTGDIGIGNQPQHF	TRBV9	TRBJ1-5
TGTGCCAGCAGCTTAACGACTGCCATCCTCATAGGGACCGAGGGTAGAACCGGGGAGCTGTTTTTT	CASSLTTAILIGTEGRTGELFF	TRBV7-3	TRBJ2-2
TGTGCCAGCAGCTCCCCTTTATACAGGGTTAACGAGCAGTACTTC	CASSSPLYRVNEQYF	TRBV11-3	TRBJ2-7
TGTGCCAGCAGCTTTAAGAGGACAGGGTTACCTTTCTTGAACACTGAAGCTTTCTTT	CASSFKRTGLPFLNTEAFF	TRBV11-2	TRBJ1-1
TGTGCCTGGAGTGTAGCGGTGGGCGACAGGGTTAGGGACCCTCCTAATGAAAAACTGTTTTTT	CAWSVAVGDRVRDPPNEKLFF	TRBV30	TRBJ1-4
TGCAGTGCTAGAGATTCCCGCGTCTCCTACGAGCAGTACTTC	CSARDSRVSYEQYF	TRBV20-1	TRBJ2-7
TGCGCCAGCATAGGCCCCGACAGGGGTAGTCGCACAGATACGCAGTATTTT	CASIGPDRGSRTDTQYF	TRBV10-1	TRBJ2-3
TGTGCCAGCAGCCAAGACGCAGGGGGGGCCCCGGGGGAGCAGTACTTC	CASSQDAGGAPGEQYF	TRBV3-1	TRBJ2-7
TGTGCCAGCAGCTTACTCAAGGCAGGGGTGAGGGGAGCCAAAAACATTCAGTACTTC	CASSLLKAGVRGAKNIQYF	TRBV7-8	TRBJ2-4
TGTGCCAGCAGCTTGGCAGGTAGGGGCTACACTGAAGCTTTCTTT	CASSLAGRGYTEAFF	TRBV5-6	TRBJ1-1
TGTGCCAGCAGTGTAGGGGGGGCGAGCTACGAGCAGTACTTC	CASSVGGASYEQYF	TRBV12-3	TRBJ2-7
TGTGCCGGACCCGCATACAATGAGCAGTTCTTC	CAGPAYNEQFF	TRBV7-7	TRBJ2-1
TGTGCCAGCAAGTACGTCGGACAGGGTAGTGGCTACACCTTC	CASKYVGQGSGYTF	TRBV6-5	TRBJ1-2
TGTGCCAGCACCCGCCGGGACAGGAATAGCAATCAGCCCCAGCATTTT	CASTRRDRNSNQPQHF	TRBV2	TRBJ1-5
TGTGCCAGCAGCAGTGCGGACAGAAAGGGAGGGGTCCTTAACTATGGCTACACCTTC	CASSSADRKGGVLNYGYTF	TRBV13	TRBJ1-2
TGTGCCAGCAGCTTAGCCGTCATCGCGGGAGGGGATAAAGAGACCCAGTACTTC	CASSLAVIAGGDKETQYF	TRBV11-1	TRBJ2-5
TGTGCCAGTTTGCACGAAAGTGACACAGGGAATCAGCCCCAGCATTTT	CASLHESDTGNQPQHF	TRBV6-1	TRBJ1-5
TGTGCCAGCGCGCTAGCGGGGTACCGGAATGAGCAGTTCTTC	CASALAGYRNEQFF	TRBV5-6	TRBJ2-1
TGTGCCAGCAGTTACGGTTACAGGGACTATGGCTACACCTTC	CASSYGYRDYGYTF	TRBV6-5	TRBJ1-2
TGTGCCAGCAGCGTAGGCCAATTTGGGGGTGACACTGAAGCTTTCTTT	CASSVGQFGGDTEAFF	TRBV9	TRBJ1-1
TGTGCCACCAGTGATAAACAGGGGGCTACCACCACTGAAGCTTTCTTT	CATSDKQGATTTEAFF	TRBV24-1	TRBJ1-1
TGTGCCAGCATCCCCCAGTCCTATAATTCACCCCTCCACTTT	CASIPQSYNSPLHF	TRBV6-4	TRBJ1-6
TGTGCCAGCAGCCGGCGGCCCATCGACAGGGGCTACGAGCAGTACTTC	CASSRRPIDRGYEQYF	TRBV9	TRBJ2-7
TGTGCCAGCAGCAACCCATACAATGAGCAGTTCTTC	CASSNPYNEQFF	TRBV5-5	TRBJ2-1
TGTGCCAGCAGGTCCCGGGACAGCCGCTACGAGCAGTACTTC	CASRSRDSRYEQYF	TRBV27	TRBJ2-7
TGTGCCCCGGACAGGATGAACACTGAAGCTTTCTTT	CAPDRMNTEAFF	TRBV14	TRBJ1-1
TGTGCCAGTAGGGACGCCTTATCACAGGGGGTCGCTGAAGCTTTCTTT	CASRDALSQGVAEAFF	TRBV19	TRBJ1-1
TGTGCCTCCCCGGGCGTAATTTCTAATTCACCCCTCCACTTT	CASPGVISNSPLHF	TRBV30	TRBJ1-6
TGTGCCAGCAGCCTGGGGAGAAACCTGAATGAGCAGTTCTTC	CASSLGRNLNEQFF	TRBV13	TRBJ2-1
TGTGCCAGCAGCCGTTGGGAAGGACTAGCGGAGTGCTTTGACGAGCAGTACTTC	CASSRWEGLAECFDEQYF	TRBV14	TRBJ2-7
TGTGCCAGCATTTTAAGCTCTGGGGCCAACGTCCTGACTTTC	CASILSSGANVLTF	TRBV6-3	TRBJ2-6
TGTGCCACCAGCTTCTGGGACGGTTCACCCCTCCACTTT	CATSFWDGSPLHF	TRBV15	TRBJ1-6
TGTGCCGGAGGCAGGGGGGGAAATCAGCCCCAGCATTTT	CAGGRGGNQPQHF	TRBV14	TRBJ1-5
TGCGGTTGCCGTAGGGGCGGGGAGCTGTTTTTT	CGCRRGGELFF	TRBV10-1	TRBJ2-2
TGTGCCAGCAGCTACCGACTAGCGGACATTAGCACAGATACGCAGTATTTT	CASSYRLADISTDTQYF	TRBV7-7	TRBJ2-3
TGCAGTGCTAGAGAAGTGAGGGTCCAGAAGGGGATCTATGGCTACACCTTC	CSAREVRVQKGIYGYTF	TRBV20-1	TRBJ1-2
TGTGCCAGCAGCCAAGTAAGGTTCTCAGCCGAGCAGTACTTC	CASSQVRFSAEQYF	TRBV14	TRBJ2-7
TGCGCCAGCAGCCGTAAAAGGGCCTTTTTCACTGAAGCTTTCTTT	CASSRKRAFFTEAFF	TRBV4-3	TRBJ1-1
TGTGCCAGCAGTGCCCCAGGGGTTCACACCTGCTCCTATAATTCACCCCTCCACTTT	CASSAPGVHTCSYNSPLHF	TRBV2	TRBJ1-6
TGTGCCACCAGTGATGGATGGGAGGGAAGGACGCAGCCCCAGCATTTT	CATSDGWEGRTQPQHF	TRBV24-1	TRBJ1-5
TGTGGGTTCTGCCGCCAGCAGCCCCAGCATTTT	CGFCRQQPQHF	TRBV12-3	TRBJ1-5
TGTGCCAACTGGGGGGCGGCCATTCCAGCTTTCTTT	CANWGAAIPAFF	TRBV6-5	TRBJ1-1
TGTGCCATCAGTGAGCCGCGAGAGGGCTATGGCTACACCTTC	CAISEPREGYGYTF	TRBV10-3	TRBJ1-2
TGTGCCAGCAGCTTAGCGCGGGGACACAGGTTTGGGGATCAGCCCCAGCATTTT	CASSLARGHRFGDQPQHF	TRBV7-9	TRBJ1-5
TGCAGTCCGACTCTCTACGAGCAGTACTTC	CSPTLYEQYF	TRBV20-1	TRBJ2-7
TGCAGTGCTCTTGACAGCTCTAGCAATCAGCCCCAGCATTTT	CSALDSSSNQPQHF	TRBV20-1	TRBJ1-5
TGTGCCAGCGTGGGGGGAAACAGCTCCTACAATGAGCAGTTCTTC	CASVGGNSSYNEQFF	TRBV6-1	TRBJ2-1
TGTGCCATCAGTTCGACGCTGCATGGCTACACCTTC	CAISSTLHGYTF	TRBV10-3	TRBJ1-2
TGTGCCAGCACCGGGACTTATAGCAATCAGCCCCAGCATTTT	CASTGTYSNQPQHF	TRBV11-2	TRBJ1-5
TGTGCCACCAGCCTGGAGGACAGGAGGAGCAATCAGCCCCAGCATTTT	CATSLEDRRSNQPQHF	TRBV24-1	TRBJ1-5
TGTGCCAGCAGCTTAACTAGCGGGGGGGAGACCCAGTACTTC	CASSLTSGGETQYF	TRBV11-3	TRBJ2-5
TGCGCCAGCAGCGTAGGGGGGCCCCACAGAAGGGGTGAGACCCAGTACTTC	CASSVGGPHRRGETQYF	TRBV5-1	TRBJ2-5
TGCGCCAGCAGCTTGGCCGGGAATGCAACTAATGAAAAACTGTTTTTT	CASSLAGNATNEKLFF	TRBV5-1	TRBJ1-4
TGCAGTGCTCTCTCGTTTCCGGGACAGCCGGCCTCTGGGGCCAACGTCCTGACTTTC	CSALSFPGQPASGANVLTF	TRBV20-1	TRBJ2-6
TGTGCCAGCTCACCGTCGCTGGACAGCTTGGACAATGAGCAGTTCTTC	CASSPSLDSLDNEQFF	TRBV18	TRBJ2-1
TGTGCCAGCAGGAAGACAGGCCCGAACACTGAAGCTTTCTTT	CASRKTGPNTEAFF	TRBV9	TRBJ1-1
TGTGCCAGCAGTTTCCGCAGACAGGGACCTTCCTATGGCTACACCTTC	CASSFRRQGPSYGYTF	TRBV12-3	TRBJ1-2
TGCGCCAGCAGCCCACAGGGGCCCCATAATTCACCCCTCCACTTT	CASSPQGPHNSPLHF	TRBV4-1	TRBJ1-6
TGTGCCAGCAGCTTGGAGCTTGAGCAGTTCTTC	CASSLELEQFF	TRBV7-3	TRBJ2-1
TGTGCCAGCAGCTTAGAGCCCGGGGGGGGCCGAAACACCGGGGAGCTGTTTTTT	CASSLEPGGGRNTGELFF	TRBV11-2	TRBJ2-2
TGTGCCAGCAAGCCGGGGGGGGATGAGCAGTTCTTC	CASKPGGDEQFF	TRBV6-6	TRBJ2-1
TGCGCCAGCAGTATAGGACGCTACGAGCAGTACTTC	CASSIGRYEQYF	TRBV10-1	TRBJ2-7
TGTGCCAGCAGTGGAGGGGGGGGAGATTTCTACGAGCAGTACTTC	CASSGGGGDFYEQYF	TRBV28	TRBJ2-7
TGTGCCACCGGGGGGGGTAGTTATGAGCAGTTCTTC	CATGGGSYEQFF	TRBV11-2	TRBJ2-1
TGTGCCAGCCCCACAGGGGGAAACCGACGTACTGAAGCTTTCTTT	CASPTGGNRRTEAFF	TRBV28	TRBJ1-1
TGTGCCAGCAGGAGAGCAAAGTGCGGTGAAGCTTTCTTT	CASRRAKCGEAFF	TRBV12-3	TRBJ1-1
TGTGCCAGCTCACCACCAGGAAGCGGGATGGCCGGCTACACCTTC	CASSPPGSGMAGYTF	TRBV18	TRBJ1-2
TGTGCCAGCAGATTTCGAACCGGGACATTAGAGACCCAGTACTTC	CASRFRTGTLETQYF	TRBV6-5	TRBJ2-5
TGTGCCAGCAGCCAAGTAGGGTCCGGACAGCCCCCGGGAAACACCATATATTTT	CASSQVGSGQPPGNTIYF	TRBV3-1	TRBJ1-3
TGTGCCAGCAGGGGCTACAGGGTAAATGGTAGGAACGAGCAGTACTTC	CASRGYRVNGRNEQYF	TRBV7-3	TRBJ2-7
TGTGCCAGTACACCGGGACAGGAGGAGGTGAGACGGAGCAGCAGCAATCAGCCCCAGCATTTT	CASTPGQEEVRRSSSNQPQHF	TRBV19	TRBJ1-5
TGTGCCAGCAGCATGGCAGCTGGGTCTGCTTTCTTT	CASSMAAGSAFF	TRBV9	TRBJ1-1
TGTGCCAGCAGCTTCCCAGGGTTACGCTATGGCTACACCTTC	CASSFPGLRYGYTF	TRBV7-9	TRBJ1-2
TGCAGCGTTGGGATTTTCGGGGGCAGGGGGAACACCGGGGAGCTGTTTTTT	CSVGIFGGRGNTGELFF	TRBV29-1	TRBJ2-2
TGTGCCACCAGTGATTTGGTCCACGGATTCGCTAGATTGGAGACCCAGTACTTC	CATSDLVHGFARLETQYF	TRBV24-1	TRBJ2-5
TGTGCCAGCAGTTTCCAAAATCGGGGGGGGATCTACGAGCAGTACTTC	CASSFQNRGGIYEQYF	TRBV6-5	TRBJ2-7
TGTGCCAGCAGCGGGGGAGCCTACGAGCAGTACTTC	CASSGGAYEQYF	TRBV7-3	TRBJ2-7
TGTGCCAGCGCAGCCCGGGAAGAGACCCAGTACTTC	CASAAREETQYF	TRBV7-3	TRBJ2-5
TGTGCCAGCAGCCGACCTCATAATGAAAAACTGTTTTTT	CASSRPHNEKLFF	TRBV11-2	TRBJ1-4
TGTGCCAGCAGCTCCCCCGCCATGGGACACCGAATGATCCAAGAGACCCAGTACTTC	CASSSPAMGHRMIQETQYF	TRBV5-6	TRBJ2-5
TGTGCCAGCAGTCGGCGAAAACTCCCTTGCGGGAGGCTTAGCCCAAAAAACATTCAGTACTTC	CASSRRKLPCGRLSPKNIQYF	TRBV6-5	TRBJ2-4
TGCGCCAGCAGCTCCTGTCCGACTAGCGGCTACGAGCAGTACTTC	CASSSCPTSGYEQYF	TRBV4-1	TRBJ2-7
TGTGCCAGCAGTGACAGGGGTACAACTAATGAAAAACTGTTTTTT	CASSDRGTTNEKLFF	TRBV12-4	TRBJ1-4
TGTGCCTGGAGACTTCTTGACAGGGATACGCAGTATTTT	CAWRLLDRDTQYF	TRBV30	TRBJ2-3
TGTGTTCTAGGGGCCCGTCGGAATCAGCCCCAGCATTTT	CVLGARRNQPQHF	TRBV12-3	TRBJ1-5
TGTGCCAGCAGGAATCGGGACAGGGGCAATCAGCCCCAGCATTTT	CASRNRDRGNQPQHF	TRBV6-1	TRBJ1-5
TGTGCCAGCAGTGAAGCCCCGGTAGGGGGGAGCAATGAGCAGTTCTTC	CASSEAPVGGSNEQFF	TRBV6-1	TRBJ2-1
TGCGCCAGCAGCCAGGTCGGGCAGGGTCGAATATACGAGCAGTACTTC	CASSQVGQGRIYEQYF	TRBV4-1	TRBJ2-7
TGTGCCAGCAATACTTGCAGCGACGGGAACACTGAAGCTTTCTTT	CASNTCSDGNTEAFF	TRBV27	TRBJ1-1
TGTGCCAGCAGCGTGACAGGGACCGGGGAGCTGTTTTTT	CASSVTGTGELFF	TRBV7-3	TRBJ2-2
TGTGCCAGCTCCACGCGGGAGGGCGGGGAGCTGTTTTTT	CASSTREGGELFF	TRBV6-4	TRBJ2-2
TGCGCCAGCAGCCAAGAACAGGCCCAGGGACCAGGGGAGACCCAGTACTTC	CASSQEQAQGPGETQYF	TRBV4-1	TRBJ2-5
TGTGCCAGCAGCAGTGACAGGGGACCGAACTATAGCAATCAGCCCCAGCATTTT	CASSSDRGPNYSNQPQHF	TRBV7-3	TRBJ1-5
TGTGCCAGCAGTGAAAGGGACAGGGTGGAATGTGCGCACCGGGACACCGGGGAGCTGTTTTTT	CASSERDRVECAHRDTGELFF	TRBV25-1	TRBJ2-2
TGTGCCAGTCCAGCAGCGGGCTGCACAGATACGCAGTATTTT	CASPAAGCTDTQYF	TRBV19	TRBJ2-3
TGTGCCAGCAGCCAATCCGCGGTCGAGCAGTACTTC	CASSQSAVEQYF	TRBV3-1	TRBJ2-7
TGTGCCAGCAGTCGAGACAGGGAACTCGAGCAGTACTTC	CASSRDRELEQYF	TRBV7-3	TRBJ2-7
TGCAGTGCTAGTCACGGACAGGGGATGTCGGCCTACGAGCAGTACTTC	CSASHGQGMSAYEQYF	TRBV20-1	TRBJ2-7
TGTGCCAGCAGTGCAGCCCTGGGCTCCTACGAGCAGTACTTC	CASSAALGSYEQYF	TRBV6-4	TRBJ2-7
TGTGCCAGCAGCGCCTCCGGGGGGCCGAGGGATGAGCAGTTCTTC	CASSASGGPRDEQFF	TRBV7-3	TRBJ2-1
TGTGCCAGCAGCTTAACTATCCCCGGACAGGGAAAGTTAGTCGAGCAGTACTTC	CASSLTIPGQGKLVEQYF	TRBV7-4	TRBJ2-7
TGCGCCAGCAGTGGGGGGGATGTATGGGTAAGCTCCTACAATGAGCAGTTCTTC	CASSGGDVWVSSYNEQFF	TRBV10-1	TRBJ2-1
TGTGCCAGCAGTTATTGCCGGGACAGGGCCATGGACGAGCAGTACTTC	CASSYCRDRAMDEQYF	TRBV6-5	TRBJ2-7
TGTGCTAGTGGCCAAGCTACGACAGATACGCAGTATTTT	CASGQATTDTQYF	TRBV12-5	TRBJ2-3
TGTGCCAGCAGTCGTCCGGGTTACGAAGAGACCCAGTACTTC	CASSRPGYEETQYF	TRBV6-1	TRBJ2-5
TGTGCCAGCAGCCCCCCCCAGCTCAATCAGCCCCAGCATTTT	CASSPPQLNQPQHF	TRBV13	TRBJ1-5
TGTGCCAGCAGTTACCAATCCCTCAGGGGGCGCCCCAAAGCCTCCTACAATGAGCAGTTCTTC	CASSYQSLRGRPKASYNEQFF	TRBV6-5	TRBJ2-1
TGTGCCCTTTCTAGCGGGCGATACGAGCAGTACTTC	CALSSGRYEQYF	TRBV7-6	TRBJ2-7
TGTGCCAGCAGTCGGCTAGCGGGCGGAGCCAAAAACATTCAGTACTTC	CASSRLAGGAKNIQYF	TRBV12-4	TRBJ2-4
TGTGCCTCCCGGGTTGGGGGGGCGCTCGTTAGGCAGTTCTTC	CASRVGGALVRQFF	TRBV6-5	TRBJ2-1
TGTGCCATCAGTGAGGGGGTCGGGTCCGGCACAGATACGCAGTATTTT	CAISEGVGSGTDTQYF	TRBV10-3	TRBJ2-3
TGTGCCAGCAGCTTAGGATGGGAGGGTGGTACCGGGGAGCTGTTTTTT	CASSLGWEGGTGELFF	TRBV7-2	TRBJ2-2
TGCGCCAGCAGCTTGGAAGGAAGTCAGCCCCAGCATTTT	CASSLEGSQPQHF	TRBV5-1	TRBJ1-5
TGTGCCAGCAGTTACCCACGGCCGGGGGGTTACCACTACGAGCAGTACTTC	CASSYPRPGGYHYEQYF	TRBV6-5	TRBJ2-7
TGTGCCAGCAGCTTAAGAGGTTCAACTAATGAAAAACTGTTTTTT	CASSLRGSTNEKLFF	TRBV7-9	TRBJ1-4
TGTGCCAGCAGCTTATCACAGGGGCATCTGAACACTGAAGCTTTCTTT	CASSLSQGHLNTEAFF	TRBV7-9	TRBJ1-1
TGTGCCATAGAGCGGGACAATCGCACAGATACGCAGTATTTT	CAIERDNRTDTQYF	TRBV10-3	TRBJ2-3
TGTGCCTGCCGAAGGGTACTAGCGGGAGCCTTCACTGAAGCTTTCTTT	CACRRVLAGAFTEAFF	TRBV30	TRBJ1-1
TGTGCCAGCAGCCAGGAACCGTTTAGCGGGGTGGGGATACCTAGAAGGGCCGATACGAACACCGGGGAGCTGTTTTTT	CASSQEPFSGVGIPRRADTNTGELFF	TRBV7-3	TRBJ2-2
TGCAGTGCTAGAGATCTACTTATTAACAATTCACCCCTCCACTTT	CSARDLLINNSPLHF	TRBV20-1	TRBJ1-6
TGTGCCAGCAGCCTCCTAGTATATAGCGGTCCAACTGAGCAGTACTTC	CASSLLVYSGPTEQYF	TRBV3-1	TRBJ2-7
TGTGCCCAGGGGGAAGGAAGCAATGAGCAGTTCTTC	CAQGEGSNEQFF	TRBV11-2	TRBJ2-1
TGTGCCAGCAGCCGGGAGCCGGACACCGGGGAGCTGTTTTTT	CASSREPDTGELFF	TRBV7-4	TRBJ2-2
TGTGCCAGCCCGACAGGGGGCGAGGGCAACACCGGGGAGCTGTTTTTT	CASPTGGEGNTGELFF	TRBV27	TRBJ2-2
TGCGCCAGCAGCTTGGGCTGGGGGGCAGAGTCCTACGAGCAGTACTTC	CASSLGWGAESYEQYF	TRBV5-1	TRBJ2-7
TGTGCCAGCAGTAAAGGGGGCAATCAGCCCCAGCATTTT	CASSKGGNQPQHF	TRBV27	TRBJ1-5
TGTGTCGCCTTAGGGGACAGCTCCTACGAGCAGTACTTC	CVALGDSSYEQYF	TRBV7-9	TRBJ2-7
TGTGCCAGCAGCCCGCCAAATACTAACTATGGCTACACCTTC	CASSPPNTNYGYTF	TRBV6-5	TRBJ1-2
TGTGCCAGCAGCTTAGTCGGGAGCTCCTATAATTCACCCCTCCACTTT	CASSLVGSSYNSPLHF	TRBV11-1	TRBJ1-6
TGCGCCAGCAGCCAAGAAAAAGGGGGGGGAGAAATAAGCTCCTACGAGCAGTACTTC	CASSQEKGGGEISSYEQYF	TRBV4-1	TRBJ2-7
TGCGCCAGCAGTGAGGCTCCGAACAGGGTCGGAGACGAGCAGTTCTTC	CASSEAPNRVGDEQFF	TRBV10-1	TRBJ2-1
TGCGCCAGCAGCCGGGGGGGACGCGGCCAAGAGACCCAGTACTTC	CASSRGGRGQETQYF	TRBV4-1	TRBJ2-5
TGTGCCAGCAGCGTGACATCTCCGATTTCCTACGAGCAGTACTTC	CASSVTSPISYEQYF	TRBV9	TRBJ2-7
TGTGCCAGCAGGGAACGACTAGCGGGGGATAATAGGGACAATGAGCAGTTCTTC	CASRERLAGDNRDNEQFF	TRBV28	TRBJ2-1
TGTGCCAGCAGCTCGGGAGGGGGGGGGCCATATGAGCAGTACTTC	CASSSGGGGPYEQYF	TRBV11-2	TRBJ2-7
TGTGCCAGCAGTTTAAATCGTCGGCGCTTC	CASSLNRRRF	TRBV6-3	TRBJ1-2
TGTGCCAGCAGCAAGACAGTTTCTTTTAATGCTGGGGCCAACGTCCTGACTTTC	CASSKTVSFNAGANVLTF	TRBV6-4	TRBJ2-6
TGTGCCAGCAGCTCCTATCCACTAGCGGGAGGGGGGATGAACACTGAAGCTTTCTTT	CASSSYPLAGGGMNTEAFF	TRBV11-3	TRBJ1-1
TGTGCCAGCAGCATAATGATCCTACTACAGGGGAGCGGAGATACGCAGTATTTT	CASSIMILLQGSGDTQYF	TRBV11-3	TRBJ2-3
TGTGCCTGGCTATTCCCTCCCGAGGGGCAGGGACTAGCGGGTCCAAATGAGCAGTACTTC	CAWLFPPEGQGLAGPNEQYF	TRBV30	TRBJ2-7
TGTGCCAGCAGCCAAGTATCAAGGACAGGGGGAAGGGGTTGGGGCAATCAGCCCCAGCATTTT	CASSQVSRTGGRGWGNQPQHF	TRBV3-1	TRBJ1-5
TGTGCCAGCAGTTCAAAGGGGCGGGTGGCGGACTATGGCTACACCTTC	CASSSKGRVADYGYTF	TRBV6-6	TRBJ1-2
TGTGCCAGCAGTTTACGACCGGGACAGGGAACCTCCTACGAGCAGTACTTC	CASSLRPGQGTSYEQYF	TRBV28	TRBJ2-7
TGCTTGACAGATCAGCCCCAGCATTTT	CLTDQPQHF	TRBV20-1	TRBJ1-5
TGTGCCAGCAGCTTAGCGCATCGGCCAAGGACTAGCGGGATAGGGGGGTCCTACAATGAGCAGTTCTTC	CASSLAHRPRTSGIGGSYNEQFF	TRBV7-2	TRBJ2-1
TGTGCCAGCAGCGCGGCGGGAGATCAGCCCCAGCATTTT	CASSAAGDQPQHF	TRBV5-6	TRBJ1-5
TGCGCCAGCTTTCCTCAATCTAGCGGGGACAATGAGCAGTTCTTC	CASFPQSSGDNEQFF	TRBV10-1	TRBJ2-1
TGTGCCAGCAGCCAAGTTTCGGAGGGTTGCAATCAGCCCCAGCATTTT	CASSQVSEGCNQPQHF	TRBV14	TRBJ1-5
TGCAGCGTTGACCGCCCTAGCGAGAACACCGGGGAGCTGTTTTTT	CSVDRPSENTGELFF	TRBV29-1	TRBJ2-2
TGCGCCAGCAGCCAATTAGTCGAGCAGTACTTC	CASSQLVEQYF	TRBV5-1	TRBJ2-7
TGTGCCAGCGGGGACACCGGGGAGCTGTTTTTT	CASGDTGELFF	TRBV9	TRBJ2-2
TGCAGTGCGCCAGGCGCACATGGCTACACCTTC	CSAPGAHGYTF	TRBV20-1	TRBJ1-2
TGCGCCAGCAGCCGGTCCCCGTGCTGCTGGGAGACCAACGTCCTGACTTTC	CASSRSPCCWETNVLTF	TRBV5-1	TRBJ2-6
TGTGCCAGCACAGGACTTGAAAAACTGTTTTTT	CASTGLEKLFF	TRBV25-1	TRBJ1-4
TGTGCCAGCAGCTTAGCGGAACCGGACAGGCTCCCAATTACCTACGAGCAGTACTTC	CASSLAEPDRLPITYEQYF	TRBV7-9	TRBJ2-7
TGTGCCAGCAGCTTGAGTAAGGTACGTACCTACGAGCAGTACTTC	CASSLSKVRTYEQYF	TRBV5-6	TRBJ2-7
TGTGCCAGCAGCTTCCGATTGGGATTCCCGGCTGAGCAGTACTTC	CASSFRLGFPAEQYF	TRBV5-6	TRBJ2-7
TGTGCCAGCCTCACTCCCCAGGGGGCGCGGAACGAGGCCCAGCATTTT	CASLTPQGARNEAQHF	TRBV7-3	TRBJ1-5
TGTGCCAGCAGTGACTCATCTAAGAGAGCGGAGACCCAGTACTTC	CASSDSSKRAETQYF	TRBV6-4	TRBJ2-5
TGTGCCAGCAGCGTAGAACGGGGGGATGGCTACACCTTC	CASSVERGDGYTF	TRBV9	TRBJ1-2
TGCGCCAGCAGTGACGACATTCAGTACTTC	CASSDDIQYF	TRBV10-1	TRBJ2-4
TGTGCCAGCAGAAAAATTCCGGGACAGGGGAGGTACAACGGCTACACCTTC	CASRKIPGQGRYNGYTF	TRBV4-2	TRBJ1-2
TGCAGTGCTAGGGGTCTCTGTGCCAAAAACATTCAGTACTTC	CSARGLCAKNIQYF	TRBV20-1	TRBJ2-4
TGTGCCAGCAGCCATAGAGACAGGGGGGAGTGGGACAGCTCCTACAATGAGCAGTTCTTC	CASSHRDRGEWDSSYNEQFF	TRBV3-1	TRBJ2-1
TGTGCCAGGCCCGAGTTGGACGAGCAGTACTTC	CARPELDEQYF	TRBV2	TRBJ2-7
TGTGCCAGCAGCTTCGGGGACAGGAATGAAAAACTGTTTTTT	CASSFGDRNEKLFF	TRBV7-4	TRBJ1-4
TGTGCCAGCAGTGAAGAGATGAAGGGGGGGGAAAAACTGTTTTTT	CASSEEMKGGEKLFF	TRBV2	TRBJ1-4
TGCAGTGCACACAGGGATGGCTACACCTTC	CSAHRDGYTF	TRBV20-1	TRBJ1-2
TGTGACGGGGACAGTATTTTCTATGGCTACACCTTC	CDGDSIFYGYTF	TRBV3-1	TRBJ1-2
TGTGCCAGCAGTTTATTCTTCACGGGACAGGGGTCGTGGGGTAATTCACCCCTCCACTTT	CASSLFFTGQGSWGNSPLHF	TRBV12-4	TRBJ1-6
TGTGCCAGCAGACTCCCTCGCCGTCGGGACAGACGCGAGCAGTACTTC	CASRLPRRRDRREQYF	TRBV6-2	TRBJ2-7
TGTGCCAGCTCACCACGAGATCCCATCCTGGTGGGGGGCTACACCTTC	CASSPRDPILVGGYTF	TRBV18	TRBJ1-2
TGTGCCAGCAGTATTACCCACAATGGGACAGGGAAAAGGACTGAAGCTTTCTTT	CASSITHNGTGKRTEAFF	TRBV6-4	TRBJ1-1
TGTGCCAGCAGCTCAACGGGGGCGGGGTACAATGAGCAGTTCTTC	CASSSTGAGYNEQFF	TRBV5-6	TRBJ2-1
TGTGCCAGCAGCATTCGGGTAGTTAATTCACCCCTCCACTTT	CASSIRVVNSPLHF	TRBV9	TRBJ1-6
TGTGCCAGCAGTGACGCAGGGGGAGTATTCCGCTCCTACGAGCAGTACTTC	CASSDAGGVFRSYEQYF	TRBV25-1	TRBJ2-7
TGTGCCACGATCGACAGGATCTCCTACGAGCAGTACTTC	CATIDRISYEQYF	TRBV6-1	TRBJ2-7
TGTGCCAGCAGCCAAGACCCCAACCCGGGACTAGCGGGGCCGTCCTACGAGCAGTACTTC	CASSQDPNPGLAGPSYEQYF	TRBV3-1	TRBJ2-7
TGTGCCAGCAGCGGGTCAGAAGGGGGGACTTTTGTCGAGCAGTACTTC	CASSGSEGGTFVEQYF	TRBV7-9	TRBJ2-7
TGTGCCAGCACAGGACAGGGGAACGAAAAACTGTTTTTT	CASTGQGNEKLFF	TRBV6-2	TRBJ1-4
TGTGCCAGCAGCTCCAGGGGTAAGGGCTACACCTTC	CASSSRGKGYTF	TRBV7-4	TRBJ1-2
TGTGCCACCGAAAACCGGGACAGGGGCGGGTGGAATGGCTACACCTTC	CATENRDRGGWNGYTF	TRBV12-3	TRBJ1-2
TGTGCCAGCAGCAACCTAGCGGGTTACTACGAGCAGTACTTC	CASSNLAGYYEQYF	TRBV7-6	TRBJ2-7
TGCGCCAGCAGCCAAGGCCTCCTGGGGCGGACCTACGAGCAGTACTTC	CASSQGLLGRTYEQYF	TRBV4-1	TRBJ2-7
TGTGCCAGCAGCACCAGGGCTAGAGGGGAGCAGTTCTTC	CASSTRARGEQFF	TRBV6-1	TRBJ2-1
TGCAGCGTTGATGTATTGGGGACTGAAGCTTTCTTT	CSVDVLGTEAFF	TRBV29-1	TRBJ1-1
TGCGCCAGCAGCCGTCCCATCCCCGACGGTGAAAGACAACCCGACACTGAAGCTTTCTTT	CASSRPIPDGERQPDTEAFF	TRBV5-1	TRBJ1-1
TGCAGTGCTACCCGGGGGGGCCCCGAGCAGTACTTC	CSATRGGPEQYF	TRBV20-1	TRBJ2-7
TGCAGTGCTAGAGCGCGATCCACTAGCAAGACCCAGTACTTC	CSARARSTSKTQYF	TRBV20-1	TRBJ2-5
TGTGCCTGGCCCGGATGGACGGTCATTCAGTACTTC	CAWPGWTVIQYF	TRBV30	TRBJ2-4
TGTGCCTGGAGTGCAGGGGGCCTCCATGGCTACACCTTC	CAWSAGGLHGYTF	TRBV30	TRBJ1-2
TGTGCCAGCAGTGGGACTAGCGGGAGGCCAGAGACCCAGTACTTC	CASSGTSGRPETQYF	TRBV7-9	TRBJ2-5
TGCAGCGTTGAGGCCGCGGGGGAGGGGGACCAAGAGACCCAGTACTTC	CSVEAAGEGDQETQYF	TRBV29-1	TRBJ2-5
TGTGCCAGCAGTTACCCCAGGGGGCAGTCCTACGAGCAGTACTTC	CASSYPRGQSYEQYF	TRBV6-5	TRBJ2-7
TGTGCCAGCAGTTACCACGGACAGCAGGTGGGGGCCTACGAGCAGTACTTC	CASSYHGQQVGAYEQYF	TRBV6-5	TRBJ2-7
TGTGCCAGCAGCCAGTTTGGACTAGTCCCGCTGGACACAGATACGCAGTATTTT	CASSQFGLVPLDTDTQYF	TRBV7-3	TRBJ2-3
TGCGCCAGCAGCCAAGCGAATTTCGGACAGGAGGATCAGCCCCAGCATTTT	CASSQANFGQEDQPQHF	TRBV4-3	TRBJ1-5
TGTGCCAGCTCACCCCCGGAAAGGCGGGGAAACACCGGGGAGCTGTTTTTT	CASSPPERRGNTGELFF	TRBV18	TRBJ2-2
TGTGCCAGCTCCCCTCAACCGGGACAGGGGAAGTTATTTGAGACCCAGTACTTC	CASSPQPGQGKLFETQYF	TRBV13	TRBJ2-5
TGTGCCAGCAGCTCAAAGGGACAGGTGAACTTGAACACTGAAGCTTTCTTT	CASSSKGQVNLNTEAFF	TRBV13	TRBJ1-1
TGCAGTGCTAGTGAATGGACATTCCCAAATGGCTACACCTTC	CSASEWTFPNGYTF	TRBV20-1	TRBJ1-2
TGTGCCAGCAGCCACCGACAGGAGAATCCAGATACGCAGTATTTT	CASSHRQENPDTQYF	TRBV13	TRBJ2-3
TGCGCCAGCAGCTTGAGTGGGAGGTACAATGAGCAGTTCTTC	CASSLSGRYNEQFF	TRBV5-1	TRBJ2-1
TGTGCCAGCCTTTCCAGGGGGACCTATGGCTACACCTTC	CASLSRGTYGYTF	TRBV4-2	TRBJ1-2
TGTGCCAGCAGGGGACGGGGCGCTGAAGCTTTCTTT	CASRGRGAEAFF	TRBV6-4	TRBJ1-1
TGTGCCAGTAGCCATCGGACTAAAATCCAAGAGACCCAGTACTTC	CASSHRTKIQETQYF	TRBV19	TRBJ2-5
TGTGCCAGCAGCTTTACTGGGGGGGGCGCCTACGAGCAGTACTTC	CASSFTGGGAYEQYF	TRBV7-2	TRBJ2-7
TGTGCCAGCAGTGACGCATTTGAAGCTTTCTTT	CASSDAFEAFF	TRBV2	TRBJ1-1
TGTGCCACCAGTGACACAACGGCGGGACAGGATTACTACGAGCAGTACTTC	CATSDTTAGQDYYEQYF	TRBV24-1	TRBJ2-7
TGTGCTAGTGGTTTGGGAAGGGGCGGGCTAGTGTGGTTGAACACTGAAGCTTTCTTT	CASGLGRGGLVWLNTEAFF	TRBV12-5	TRBJ1-1
TGCGCCAGCAGCTTGGTAGCGGGAAGGGATGGGGACACAGATACGCAGTATTTT	CASSLVAGRDGDTDTQYF	TRBV5-1	TRBJ2-3
TGTGCCAGCAGTTCGCGAAGACCCAGGGGGCAGAACGAGCAGTACTTC	CASSSRRPRGQNEQYF	TRBV27	TRBJ2-7
TGTGCCAGCAGCTGTATCGCGGGGACCGGGGGAGGGGCCAACGTCCTGACTTTC	CASSCIAGTGGGANVLTF	TRBV13	TRBJ2-6
TGCGCCAGCAGCTCGAAGGACAGGAGATGTGCCAAAAACATTCAGTACTTC	CASSSKDRRCAKNIQYF	TRBV5-1	TRBJ2-4
TGTGCCAGCAGCGGCCTTCGAGGGCTACGGGAGCTGTTTTTT	CASSGLRGLRELFF	TRBV9	TRBJ2-2
TGCGCCAGCAAAGGGACAGGGAGTCGAGCCGCGGGGGGGGGGGAGACCCAGTACTTC	CASKGTGSRAAGGGETQYF	TRBV10-2	TRBJ2-5
TGTGCCAGCAGCCAAGAGCACCCCCAGGGGCTTATGAACACTGAAGCTTTCTTT	CASSQEHPQGLMNTEAFF	TRBV14	TRBJ1-1
TGTGCCAGCAGCTGGCCGGGACTAGCGGGGGCAGAGACCCAGTACTTC	CASSWPGLAGAETQYF	TRBV7-2	TRBJ2-5
TGTGCCAGCAGCAGGGGTGTAAATCCTGAAGCTTTCTTT	CASSRGVNPEAFF	TRBV6-3	TRBJ1-1
TGTGCCAGCAGTTACTGGCTAGCGGGCACCTACAATGAGCAGTTCTTC	CASSYWLAGTYNEQFF	TRBV6-5	TRBJ2-1
TGCGCCAGCAGCTTGGCCCAATCCATGACAGGGACGAGCAATCAGCCCCAGCATTTT	CASSLAQSMTGTSNQPQHF	TRBV5-1	TRBJ1-5
TGTGCCAGCAGCCAAGATAGCGGGGGCGGGGTGTCCCACTACGAGCAGTACTTC	CASSQDSGGGVSHYEQYF	TRBV3-1	TRBJ2-7
TGCGCCAGCAGAGAGCGGGGGCACACTGAAGCTTTCTTT	CASRERGHTEAFF	TRBV5-1	TRBJ1-1
TGTGCCAGCTCACCCAAAGCGGGATTGAAATCACTCAATCAGCCCCAGCATTTT	CASSPKAGLKSLNQPQHF	TRBV18	TRBJ1-5
TGTGCCAGCACCCCGGGACTTTTAAATTATGAGCAGTTCTTC	CASTPGLLNYEQFF	TRBV6-5	TRBJ2-1
TGCGCCAGCAGCCAAGGCCAGCCGGGACTAGCGGGAGTAGGGTCCTACGAGCAGTACTTC	CASSQGQPGLAGVGSYEQYF	TRBV4-1	TRBJ2-7
TGCGCCAGCAGTGAGGGCGGACAGGCTTTAGGGGTAGAGACCCAGTACTTC	CASSEGGQALGVETQYF	TRBV10-1	TRBJ2-5
TGTGCCAGCAGTTGGGAAAGCCGGGACAGGGGGTATAAATACGAGCAGTACTTC	CASSWESRDRGYKYEQYF	TRBV27	TRBJ2-7
TGCGCCAGCAGCTGCCCGGGGAGGGAAGGGGCCAAAAACATTCAGTACTTC	CASSCPGREGAKNIQYF	TRBV5-1	TRBJ2-4
TGTGCCAGCAGCCAAGCGGGGGGTCGGTTACTCGGGGGCTTCTCCTACGAGCAGTACTTC	CASSQAGGRLLGGFSYEQYF	TRBV4-2	TRBJ2-7
TGTGCCAGCAGCGGTATGGGTTTCAGGGTTGGAAATTCCTATAATTCACCCCTCCACTTT	CASSGMGFRVGNSYNSPLHF	TRBV13	TRBJ1-6
TGTGCCAGCAGCTTGAAACAGGGTAACTATGGCTACACCTTC	CASSLKQGNYGYTF	TRBV7-4	TRBJ1-2
TGCAGTGCCCCGCGACTAAACTATGGCTACACCTTC	CSAPRLNYGYTF	TRBV20-1	TRBJ1-2
TGTGCCAGCAGCTTAGGGGGAACACTAGCGGGAGGGGCTTTCTTT	CASSLGGTLAGGAFF	TRBV7-9	TRBJ1-1
TGTGCCAGCACGGCGCCGGGACAGGGGGGCTACACCTTC	CASTAPGQGGYTF	TRBV6-1	TRBJ1-2
TGCAGTGCTAGAGCACAAGCGGGGGTGGCAGATACGCAGTATTTT	CSARAQAGVADTQYF	TRBV20-1	TRBJ2-3
TGTTCGAGGGACAGGTACCGCTATGGCTACACCTTC	CSRDRYRYGYTF	TRBV11-1	TRBJ1-2
TGTGCCACTGACAGGGGGCACTTTGAAGCTTTCTTT	CATDRGHFEAFF	TRBV6-1	TRBJ1-1
TGTGCCAAGCTAGCGGGCCCTGGAGTTGAGACCCAGTACTTC	CAKLAGPGVETQYF	TRBV19	TRBJ2-5
TGTGCCAGCAGTGAACGTCTAGCGGGTAGAGAGACCCAGTACTTC	CASSERLAGRETQYF	TRBV6-1	TRBJ2-5
TGCAGTGCTAGAGATTCGGGTAGCATGAACACTGAAGCTTTCTTT	CSARDSGSMNTEAFF	TRBV20-1	TRBJ1-1
TGTGCCGGCGGGAGAAGCTCTGGAAACACCATATATTTT	CAGGRSSGNTIYF	TRBV10-3	TRBJ1-3
TGCGCCAGCAGCTTAGACCGAGCGGGTAAGCGCACAGATACGCAGTATTTT	CASSLDRAGKRTDTQYF	TRBV5-1	TRBJ2-3
TGTGCCAGCAGTTTAAACGGGGGGAAATCCTACAATGAGCAGTTCTTC	CASSLNGGKSYNEQFF	TRBV27	TRBJ2-1
TGTGCCAGCAGTATACGGGAGGGGTTAAACTATGGCTACACCTTC	CASSIREGLNYGYTF	TRBV28	TRBJ1-2
TGCGCCAGCAGCAGATTGGGGGCGGGTTTCCAAGAGACCCAGTACTTC	CASSRLGAGFQETQYF	TRBV5-1	TRBJ2-5
TGTGCCAGCAGTACAGGGGCCGGGGAGCTGTTTTTT	CASSTGAGELFF	TRBV12-3	TRBJ2-2
TGTGCCAGCAGACGAGGGGGTTATGGCTACACCTTC	CASRRGGYGYTF	TRBV6-2	TRBJ1-2
TGTGCCAGCAGTGAATTGCAAGGGGCTTGGTATATCTATGGCTACACCTTC	CASSELQGAWYIYGYTF	TRBV6-1	TRBJ1-2
TGTGCCAGCACTAGCGGGATCAAGACCCAGTACTTC	CASTSGIKTQYF	TRBV7-2	TRBJ2-5
TGTGCCAGCAGCCCGGGACAGGGGCGTTTCTCTGGAAACACCATATATTTT	CASSPGQGRFSGNTIYF	TRBV3-1	TRBJ1-3
TGTGCCAGCAGCAAGGTACGGGGGGGGTCGGACAATGAGCAGTTCTTC	CASSKVRGGSDNEQFF	TRBV7-2	TRBJ2-1
TGTGCCAGCAGCTTAGCGCTCCTGCGGGACAGGGGGCCTGGAAACACCATATATTTT	CASSLALLRDRGPGNTIYF	TRBV7-9	TRBJ1-3
TGCGCCAGCAGCTTGGTCCTCTGTGGCAGTGGGGACACTGAAGCTTTCTTT	CASSLVLCGSGDTEAFF	TRBV5-1	TRBJ1-1
TGCGCCCATCGACCCCGGGCCATGTACTTC	CAHRPRAMYF	TRBV5-1	TRBJ2-7
TGTGCCAGCAGCCAAACTGGTGACGAGCAGTACTTC	CASSQTGDEQYF	TRBV11-2	TRBJ2-7
TGTGCCAGCAGCTTCCCTAATGAGCAGTTCTTC	CASSFPNEQFF	TRBV11-2	TRBJ2-1
TGTGCCACCAGTGACCAGCTAGCGGTTGGCCGCTACGAGCAGTACTTC	CATSDQLAVGRYEQYF	TRBV24-1	TRBJ2-7
TGTGCCAGCAGCAGACGAGGGGACACTGGGCTGTTTTTT	CASSRRGDTGLFF	TRBV11-2	TRBJ1-4
TGTGCCAGCAGCGAGGGGACAGGGGAAAACACTGAAGCTTTCTTT	CASSEGTGENTEAFF	TRBV16	TRBJ1-1
TGCGTTTTTAAGGTTTGGGGCCAGACCCAGTACTTC	CVFKVWGQTQYF	TRBV10-1	TRBJ2-5
TGTGCCAGCAGTGACTCGAGTAGCGACAGGGGGCGCGAGCAGTACTTC	CASSDSSSDRGREQYF	TRBV6-4	TRBJ2-7
TGTGCCAGCAGCTTACAGGGACCCATCACAGATACGCAGTATTTT	CASSLQGPITDTQYF	TRBV6-6	TRBJ2-3
TGCAGTGATTTGAGGGGGATGAACACTGAAGCTTTCTTT	CSDLRGMNTEAFF	TRBV20-1	TRBJ1-1
TGTGCCAGCAGTCCCCCAGGGCACTCCTACGAGCAGTACTTC	CASSPPGHSYEQYF	TRBV27	TRBJ2-7
TGTGCCACCAGTGATTATATTTGCCCCGGGTGGGTAGAGACCCAGTACTTC	CATSDYICPGWVETQYF	TRBV24-1	TRBJ2-5
TGTGCCAGCAGTTTCTCCGGGGCCGAACCTGAAGCTTTCTTT	CASSFSGAEPEAFF	TRBV12-4	TRBJ1-1
TGTGCCAGCAGCCACGTGGTCCGAAAGGGAACCTACGAGCAGTACTTC	CASSHVVRKGTYEQYF	TRBV14	TRBJ2-7
TGTGCCACCACGGGGTATTTGCGCTACACCTTC	CATTGYLRYTF	TRBV6-4	TRBJ1-2
TGTGCCAGCACCCCGGGACAGCACCCCCAGTACTTC	CASTPGQHPQYF	TRBV27	TRBJ2-5
TGTGCCAGCAGTACCGGACAGGGACGATCTGGAAACACCATATATTTT	CASSTGQGRSGNTIYF	TRBV27	TRBJ1-3
TGTGCCATCCCCCCAACCGGGCCCAGAGTAAAAGAGACCCAGTACTTC	CAIPPTGPRVKETQYF	TRBV10-3	TRBJ2-5
TGTGCCAGCAGCTTGGCCACGATAGGTGGGGGGGATGAGCAGTTCTTC	CASSLATIGGGDEQFF	TRBV5-4	TRBJ2-1
TGCAGTGCTAATTTGACAGGGGTCAACTATGGCTACACCTTC	CSANLTGVNYGYTF	TRBV20-1	TRBJ1-2
TGTGCCAGTAGGGGGCAAGCAGTAGCCTACACCTTC	CASRGQAVAYTF	TRBV19	TRBJ1-2
TGTGCCACCAGGGGCTTAGGGGGCCAAGGCAATGAGCAGTTCTTC	CATRGLGGQGNEQFF	TRBV7-9	TRBJ2-1
TGCAGTGCTAGCAACAGGCCATATGGCTACACCTTC	CSASNRPYGYTF	TRBV20-1	TRBJ1-2
TGCAGTGCTAGGACTAGCGGCGGCTCCTACGAGCAGTACTTC	CSARTSGGSYEQYF	TRBV20-1	TRBJ2-7
TGTGCCAGCAGCGGTCTCGGGAGAGATAGTAGGGGCTACACCTTC	CASSGLGRDSRGYTF	TRBV7-4	TRBJ1-2
TGTGCCAGCAGTTCCACTCAGCCCCAGCATTTT	CASSSTQPQHF	TRBV6-5	TRBJ1-5
TGTGCCAGCAGCTCAACAGGCTACACCTTC	CASSSTGYTF	TRBV11-3	TRBJ1-2
TGTGCCAGCAGTTCTACCCTGGTCTACGAGCAGTACTTC	CASSSTLVYEQYF	TRBV2	TRBJ2-7
TGTGCCAGCAGCGACAGGCCCTACGAGCAGTACTTC	CASSDRPYEQYF	TRBV7-3	TRBJ2-7
TGTGCCAGCAGCTTAGATTGGCTTACTAGCGCCACCTACAATGAGCAGTTCTTC	CASSLDWLTSATYNEQFF	TRBV11-3	TRBJ2-1
TGTGCCAGCAGCTTAGTCGCCGCTGAGGATACGCAGTATTTT	CASSLVAAEDTQYF	TRBV11-2	TRBJ2-3
TGTGCCAGTAGTAATCCACCGCGGCAGCACGCGGGCATTGCAACTAATGAAAAACTGTTTTTT	CASSNPPRQHAGIATNEKLFF	TRBV19	TRBJ1-4
TGCGCCAGCAGTACTTGGGGGGCTCAATATGGCTACACCTTC	CASSTWGAQYGYTF	TRBV10-1	TRBJ1-2
TGCGCCAGCAGCTTGAGAGGAGTCTCTTGGGAGCAGTACTTC	CASSLRGVSWEQYF	TRBV5-1	TRBJ2-7
TGTGCCAGCAGCTTGGCCCAGAAGGGGTCGGAAGAGACCCAGTACTTC	CASSLAQKGSEETQYF	TRBV5-6	TRBJ2-5
TGTGCCAGCAGCCCGGGGGCCGGGGAGCTGTTTTTT	CASSPGAGELFF	TRBV9	TRBJ2-2
TGTGCCAGCAGAGGGACAGGGAGGAAGTCTGGGGCCAACGTCCTGACTTTC	CASRGTGRKSGANVLTF	TRBV12-4	TRBJ2-6
TGTGCCACGTCCGGGACAATGAACACTGAAGCTTTCTTT	CATSGTMNTEAFF	TRBV24-1	TRBJ1-1
TGTGCCAGCAGCACTAGACAGGGCCTCACAGATACGCAGTATTTT	CASSTRQGLTDTQYF	TRBV7-3	TRBJ2-3
TGCGCCAGCATGGCCCGCAATCAGCCCCAGCATTTT	CASMARNQPQHF	TRBV10-1	TRBJ1-5
TGTGCCAGTTGTTATCCGGGACAGGGTCCACTGATAGCCAAAAACATTCAGTACTTC	CASCYPGQGPLIAKNIQYF	TRBV6-2	TRBJ2-4
TGTGCCAGCAGCGTAGCAAGTCTACGGTCTGGAAACACCATATATTTT	CASSVASLRSGNTIYF	TRBV9	TRBJ1-3
TGTGCCATATATCGGGACAGGGTGTTTCAGCCCCAGCATTTT	CAIYRDRVFQPQHF	TRBV6-5	TRBJ1-5
TGCAGTGCTAGAGCTTGGACAGGGGGCGCAAAACTGTTTTTT	CSARAWTGGAKLFF	TRBV20-1	TRBJ1-4
TGTGCTATCGTCGGAATGGGAGGGCTTAGCACTGAAGCTTTCTTT	CAIVGMGGLSTEAFF	TRBV27	TRBJ1-1
TGTGCCAGCAGAGCCCAATCAGGGGGAGAGGAGGAACAGCCCCAGCATTTT	CASRAQSGGEEEQPQHF	TRBV11-3	TRBJ1-5
TGTGCCAGCAGCGGTCTACGTGGGACTAATGAGCAGTTCTTC	CASSGLRGTNEQFF	TRBV7-2	TRBJ2-1
TGTGCCAGCAGTGTTCTAAGGCTTGAGCAGTTCTTC	CASSVLRLEQFF	TRBV2	TRBJ2-1
TGTGCCAGCAGCGCCGGGGGCGCCTCAAGCTCCTACGAGCAGTACTTC	CASSAGGASSSYEQYF	TRBV13	TRBJ2-7
TGCGCCAGCAGCACCTGGCCCAGGCTTTGTGAAAAACTGTTTTTT	CASSTWPRLCEKLFF	TRBV5-1	TRBJ1-4
TGTGCCAGCAGCAGGACAGGCGCTGGGCTGAACACTGAAGCTTTCTTT	CASSRTGAGLNTEAFF	TRBV7-2	TRBJ1-1
TGTGCCAGCAGTTTCCGAGGGACGCCGACTAGCGGGCCATTAACCTACGAGCAGTACTTC	CASSFRGTPTSGPLTYEQYF	TRBV27	TRBJ2-7
TGTGCCAGCGTCCAGCATGGCTACACCTTC	CASVQHGYTF	TRBV27	TRBJ1-2
TGTGCCAGCAGTCGTGAGATTCAGTCCTACGAGCAGTACTTC	CASSREIQSYEQYF	TRBV27	TRBJ2-7
TGCGCCAGCAGCTCCTTGGGGAGGGATGGCTACACCTTC	CASSSLGRDGYTF	TRBV5-1	TRBJ1-2
TGCAGTGCTAGAGACAAGTTGACGGGAGCTAGGGGAAGAGGGAACACCGGGGAGCTGTTTTTT	CSARDKLTGARGRGNTGELFF	TRBV20-1	TRBJ2-2
TGCGCCAGCAGCCAAGCAGAAGTTCGACAGGGGGCGCTCGTGAGCAACTATGGCTACACCTTC	CASSQAEVRQGALVSNYGYTF	TRBV4-1	TRBJ1-2
TGTGCCAGCAGCGGAGACACCGGTACTGCGGACACCATATATTTT	CASSGDTGTADTIYF	TRBV7-3	TRBJ1-3
TGTGCCAGCAGCCCGGGACAGGGAAGAGACTATGGCTACACCTTC	CASSPGQGRDYGYTF	TRBV7-9	TRBJ1-2
TGTGCCAGCAGTTTACGCCCCTTCCGGGGGATGAACACTGAAGCTTTCTTT	CASSLRPFRGMNTEAFF	TRBV28	TRBJ1-1
TGTGCCAGCTTTAGTTGCCTCGGGGGGGTTGACAATGAGCAGTTCTTC	CASFSCLGGVDNEQFF	TRBV27	TRBJ2-1
TGTGCCAGCAGTCCTATAAGGGGGGCAGGGAGCTCCTACGAGCAGTACTTC	CASSPIRGAGSSYEQYF	TRBV27	TRBJ2-7
TGTGCCAGCAGCTCCTGTGCCTCCCCCCCGGGACAGGGCCCTACTTGCATTCAGTACTTC	CASSSCASPPGQGPTCIQYF	TRBV5-6	TRBJ2-4
TGTGCCAGCAGCGACGGTCGACTTTTAGCTTTCTTT	CASSDGRLLAFF	TRBV13	TRBJ1-1
TGTGCCAGCAAGCCGGGCCAAGGGCGGGATGAAAAACTGTTTTTT	CASKPGQGRDEKLFF	TRBV11-3	TRBJ1-4
TGTGCCAGCAGCAGGGCGGCAGCCAAAAACATTCAGTACTTC	CASSRAAAKNIQYF	TRBV28	TRBJ2-4
TGTGCCAGCAGTTCAATACTAACTGAGACCCAGTACTTC	CASSSILTETQYF	TRBV6-1	TRBJ2-5
TGTGCCAGCAGTCCCGTAATGGACGCTGCCTACGAGCAGTACTTC	CASSPVMDAAYEQYF	TRBV6-8	TRBJ2-7
TGTGCCAGCAGAGGACTAGCGGGATATAGACAGCTAGAGACCCAGTACTTC	CASRGLAGYRQLETQYF	TRBV27	TRBJ2-5
TGTGCCAGCAGCTTTAGCGGGCGGAGCACCGGGGAGCTGTTTTTT	CASSFSGRSTGELFF	TRBV7-8	TRBJ2-2
TGTGCCAGCAGTGACTCACACCGGTTACCAGGACTAGCGGGGGGGATGGGCGCGAACACCGGGGAGCTGTTTTTT	CASSDSHRLPGLAGGMGANTGELFF	TRBV6-4	TRBJ2-2
TGCAGTGCTAACCAGTACAGGGACGAGCAGTACTTC	CSANQYRDEQYF	TRBV20-1	TRBJ2-7
TGCGCCAGCAGATGGGGGAGTCGCTACGAGCAGTACTTC	CASRWGSRYEQYF	TRBV10-1	TRBJ2-7
TGCGCCAGCAGCCACTCGTTAGAGGGGGCAGAAGCTTTCTTT	CASSHSLEGAEAFF	TRBV4-1	TRBJ1-1
TGTGCCAGCAGTTCCGGGGGGGCCAAATTCGAGCAGTACTTC	CASSSGGAKFEQYF	TRBV12-4	TRBJ2-7
TGTGCCAGCAGCCCGGGACAGGGGAGCTCCTACGAGCAGTACTTC	CASSPGQGSSYEQYF	TRBV7-2	TRBJ2-7
TGTGCCAGCAGTTATCGACAGGGGTACAGGGCCAACGTCCTGACTTTC	CASSYRQGYRANVLTF	TRBV6-6	TRBJ2-6
TGTGCCAGCAGCTTAGATGGACCAACGGCACAGGGGTTAGGCTACACCTTC	CASSLDGPTAQGLGYTF	TRBV11-3	TRBJ1-2
TGTGCCAGCAGTGTAGCGGGGTCAAAGACCCAGTACTTC	CASSVAGSKTQYF	TRBV12-3	TRBJ2-5
TGTGCCACCAGTTTTTCAGAAGCACACGAGCAGTACTTC	CATSFSEAHEQYF	TRBV24-1	TRBJ2-7
TGTGCCAGCAGCTTGGGACTAGCGGGAGGGCCCTCTAACTATGGCTACACCTTC	CASSLGLAGGPSNYGYTF	TRBV5-4	TRBJ1-2
TGTGCCACCACCACCGAAACCGAAAGGATACCGAACACTGAAGCTTTCTTT	CATTTETERIPNTEAFF	TRBV24-1	TRBJ1-1
TGTGCCAGCAGCTTACTACCGGACAGGGCAGGCTCCTACAATGAGCAGTTCTTC	CASSLLPDRAGSYNEQFF	TRBV7-2	TRBJ2-1
TGTGCCAGCAGTGACTCTCCTTTATTCCTGGTTCACTACAATGAGCAGTTCTTC	CASSDSPLFLVHYNEQFF	TRBV6-4	TRBJ2-1
TGTGCCAGCAGTTTATTCAGGGGGGGTGCTACTAGCACAGATACGCAGTATTTT	CASSLFRGGATSTDTQYF	TRBV27	TRBJ2-3
TGTGCCAGCAGTTTATCCTGGGTTGGGGGGTGGTCCTACAATGAGCAGTTCTTC	CASSLSWVGGWSYNEQFF	TRBV28	TRBJ2-1
TGTGCCAGCAGTACCAAACCGACTCTAGCGAACAATGAGCAGTTCTTC	CASSTKPTLANNEQFF	TRBV27	TRBJ2-1
TGTGCCAGTCGCCTGGACGTACGCAATCAGCCCCAGCATTTT	CASRLDVRNQPQHF	TRBV19	TRBJ1-5
TGCGCCAGCCACGCGACAGGGAACGACAATGAGCAGTTCTTC	CASHATGNDNEQFF	TRBV10-1	TRBJ2-1
TGCAGTGCTCGCAGGGCCCAGTGCACCGGGGAGCTGTTTTTT	CSARRAQCTGELFF	TRBV20-1	TRBJ2-2
TGTGCCAGTAGACGCGGACAGGGGCCCACTGGCTACACCTTC	CASRRGQGPTGYTF	TRBV19	TRBJ1-2
TGTGCCAGCAGCTTGAGTCCGACAGGTGCTTTCTTT	CASSLSPTGAFF	TRBV5-4	TRBJ1-1
TGTGCCAGCAGGAGAGAACCCGGACCGGGACAGGGTAAAGAAGCTTTCTTT	CASRREPGPGQGKEAFF	TRBV27	TRBJ1-1
TGCAGGCCGCTGCGGGGAAGAGAGACCCAGTACTTC	CRPLRGRETQYF	TRBV29-1	TRBJ2-5
TGTGCCAGCAGTGAAGCAAACAGACCCCAGTACTTC	CASSEANRPQYF	TRBV6-1	TRBJ2-5
TGTGCCAGCTCCTCTTCCGGGGCCGGAGGCTACACCTTC	CASSSSGAGGYTF	TRBV19	TRBJ1-2
TGTGCCAGCTCACCACGGTCCCAGGGTTCTGAAGCTTTCTTT	CASSPRSQGSEAFF	TRBV18	TRBJ1-1
TGCAGTGCGGGCGGACAGGGTTGGCGGAGCTCCTACGAGCAGTACTTC	CSAGGQGWRSSYEQYF	TRBV20-1	TRBJ2-7
TGTGCCAGCAGTAAGTGGCATGGTAGGACCTACGAGCAGTACTTC	CASSKWHGRTYEQYF	TRBV6-4	TRBJ2-7
TGCAGTGCTAGAGCGACCCCGGGACAGGGTGGTCCTAGCTCCTATAATTCACCCCTCCACTTT	CSARATPGQGGPSSYNSPLHF	TRBV20-1	TRBJ1-6
TGTGCCACCCGAGAAGGGGCGTACGAGCAGTACTTC	CATREGAYEQYF	TRBV24-1	TRBJ2-7
TGTGCCAGCAGTTTATGGGCCGAGCGGTTCCTCGGGGAAGAGCAGTACTTC	CASSLWAERFLGEEQYF	TRBV28	TRBJ2-7
TGTGCCAGCAGCCTGATGTTTACGAACACTGAAGCTTTCTTT	CASSLMFTNTEAFF	TRBV4-2	TRBJ1-1
TGTGCCAGCATCCTGCCCGACCCAGAGGTGCCCAATCAGCCCCAGCATTTT	CASILPDPEVPNQPQHF	TRBV25-1	TRBJ1-5
TGTGCCACCAGCCCCGACAGGACCGAAAAACTGTTTTTT	CATSPDRTEKLFF	TRBV15	TRBJ1-4
TGTGCCAGCACGAAACGGGGGGCGCTTTATGAGCAGTACTTC	CASTKRGALYEQYF	TRBV6-4	TRBJ2-7
TGTGCCAGCAGTCGGACCTACGAGCAGTACTTC	CASSRTYEQYF	TRBV14	TRBJ2-7
TGTGCCAGCAGCCAGGGACCTGCTAGCACAGATACGCAGTATTTT	CASSQGPASTDTQYF	TRBV7-3	TRBJ2-3
TGTGCCAGCAGTGAAACCCTATTAGCGTCCGGGGAAAGATACGAGCAGTACTTC	CASSETLLASGERYEQYF	TRBV6-1	TRBJ2-7
TGTGCCAGCAGCTTTTTGGGACAATGCTGGCGCTACGAGCAGTACTTC	CASSFLGQCWRYEQYF	TRBV9	TRBJ2-7
TGTGCTAGTGGTTTGGTATTCATCTCGTGGTATGGCTACACCTTC	CASGLVFISWYGYTF	TRBV12-5	TRBJ1-2
TGCGCCAGCAGCTTCACCCGCAACAGCTTCCGGGGGACTAGGAAACAAGGGCGGAATGAGCAGTTCTTC	CASSFTRNSFRGTRKQGRNEQFF	TRBV5-1	TRBJ2-1
TGCAGTGCTAGCTCCCGGGACAGGGGCCCAACTAATGAAAAACTGTTTTTT	CSASSRDRGPTNEKLFF	TRBV20-1	TRBJ1-4
TGTGCCAGCAGCGTCCAAGACCGGCCAAGGACGGCGAGGGATTGGGCGGTCTACGAGCAGTACTTC	CASSVQDRPRTARDWAVYEQYF	TRBV7-3	TRBJ2-7
TGCGCCAGCAGTGGGGGGTTTAGCAATCAGCCCCAGCATTTT	CASSGGFSNQPQHF	TRBV10-1	TRBJ1-5
TGTGCCAGCAGTGGGGGGTACGGAGGCACAGATACGCAGTATTTT	CASSGGYGGTDTQYF	TRBV6-1	TRBJ2-3
TGTGCCACCAGTGAGGTAAGCCGGGACAGGGACACTGAAGCTTTCTTT	CATSEVSRDRDTEAFF	TRBV24-1	TRBJ1-1
TGTGCCAGTAGTATAAAAGCTAGCGCCCTCACAGATACGCAGTATTTT	CASSIKASALTDTQYF	TRBV19	TRBJ2-3
TGTGCCAGCAGGGGACAAGATCAGCCCCAGCATTTT	CASRGQDQPQHF	TRBV6-4	TRBJ1-5
TGTGCCAGCAGCTTAGTGCTGTACGAGCAGTACTTC	CASSLVLYEQYF	TRBV7-3	TRBJ2-7
TGCGCCATACTTAGGGAGACCCAGTACTTC	CAILRETQYF	TRBV5-1	TRBJ2-5
TGTGCCAGCAGCAAACGAGGGGCGTTTGAGAACACTGAAGCTTTCTTT	CASSKRGAFENTEAFF	TRBV7-2	TRBJ1-1
TGTGCCAGCAGCGTAGGAACAGGGCCTTTTGGTAGCAATCAGCCCCAGCATTTT	CASSVGTGPFGSNQPQHF	TRBV9	TRBJ1-5
TGTGCCAGCAGTTTCTCGGTGCCCGCGACAGGGAGGAGTGAGCAGTTCTTC	CASSFSVPATGRSEQFF	TRBV27	TRBJ2-1
TGTGCCCGTACGAATGGGACAGGGGGAAGGTCACCCCTCCACTTT	CARTNGTGGRSPLHF	TRBV6-1	TRBJ1-6
TGTGCCAGTATAGGGGAAATTCGCTACGAGCAGTACTTC	CASIGEIRYEQYF	TRBV19	TRBJ2-7
TGTGCCAGCAGTTACTCGAGAGGACTAGCGGGCGAGCAGTACTTC	CASSYSRGLAGEQYF	TRBV6-5	TRBJ2-7
TGCAGCGTCTTTCCCAGGGCCGGGGAGCTGTTTTTT	CSVFPRAGELFF	TRBV29-1	TRBJ2-2
TGTGCCAGCAGTGTCCTGACAGGGGGTAGGGTCACCGGGGAGCTGTTTTTT	CASSVLTGGRVTGELFF	TRBV25-1	TRBJ2-2
TGTGCCAGCAGCAGGCGTGGGAGTTACTATGGCTACACCTTC	CASSRRGSYYGYTF	TRBV13	TRBJ1-2
TGTGCCACCAGTGCTACGGGACTAGCGGGGGGGCCGTCGTGTCGGGGGTCAGATACGCAGTATTTT	CATSATGLAGGPSCRGSDTQYF	TRBV24-1	TRBJ2-3
TGTGCCAGCAGCTGCTGGCGACAGAGGGGGAACTACGAGCAGTACTTC	CASSCWRQRGNYEQYF	TRBV11-2	TRBJ2-7
TGTGCCAGCGGGACTAGCGGGAGGGCCCATGGGAATCAGCCCCAGCATTTT	CASGTSGRAHGNQPQHF	TRBV9	TRBJ1-5
TGTGCCATCACTCCACTAGCCAAGAATGAGCAGTTCTTC	CAITPLAKNEQFF	TRBV10-3	TRBJ2-1
TGTGCCAGCAGCCCTAGGGGGAGTGGGGCTTTCTTT	CASSPRGSGAFF	TRBV9	TRBJ1-1
TGTGCCAGCAGCCCTTGGCAGGAACGCGGGGGCCTACTCGAAAAACTGTTTTTT	CASSPWQERGGLLEKLFF	TRBV9	TRBJ1-4
TGTGCCACCAGTATAAGTGGGACAGGGTTTACTAATGAAAAACTGTTTTTT	CATSISGTGFTNEKLFF	TRBV24-1	TRBJ1-4
TGTGCCAGCAGAACTAGCGGGAGCCCTCGATACGAGCAGTACTTC	CASRTSGSPRYEQYF	TRBV6-4	TRBJ2-7
TGCAGTGCTAGAGGGAGGGAGAGCTCTGGGGCCAACGTCCTGACTTTC	CSARGRESSGANVLTF	TRBV20-1	TRBJ2-6
TGTGCCACCCTCATACTGGGCAATCAGCCCCAGCATTTT	CATLILGNQPQHF	TRBV19	TRBJ1-5
TGTGCTAGCAGCCCATACTTTGAGAATTGCCAGAGGTCCTACAATGAGCAGTTCTTC	CASSPYFENCQRSYNEQFF	TRBV7-7	TRBJ2-1
TGTGCCACCTATTCGGAAACACCCCATGAAAAACTGTTTTTT	CATYSETPHEKLFF	TRBV24-1	TRBJ1-4
TGCAGTGCTAGACTCCCAAACCGGGCGAGCGAGCAGTACTTC	CSARLPNRASEQYF	TRBV20-1	TRBJ2-7
TGCAGTGCTGAAGGCGGGACAGGGCTACGTAACGGGGTTTCTCGCTCTGGGGCCAACGTCCTGACTTTC	CSAEGGTGLRNGVSRSGANVLTF	TRBV20-1	TRBJ2-6
TGCAACCCGGGGGGACAGGCTTCGGGTATTGAAGCTTTCTTT	CNPGGQASGIEAFF	TRBV20-1	TRBJ1-1
TGCAGCGTTGAAGCGCACCGGGACAGACCGAACAATCAGCCCCAGCATTTT	CSVEAHRDRPNNQPQHF	TRBV29-1	TRBJ1-5
TGTGCCAGCAGCTCGGGACAGGGGAATAGCAATCAGCCCCAGCATTTT	CASSSGQGNSNQPQHF	TRBV5-6	TRBJ1-5
TGTGCCATCAGGCGCGTAATCGACAGGGTCTACAATGAGCAGTTCTTC	CAIRRVIDRVYNEQFF	TRBV10-3	TRBJ2-1
TGTGCCAGCAGTTTTAGGCCTGCAGGGGTGGAGCCCCAGCATTTT	CASSFRPAGVEPQHF	TRBV27	TRBJ1-5
TGTGCCAGCAGCTTAAGGCAGGACAGGGCGGGAGGAGGCCGTGAAAAACTGTTTTTT	CASSLRQDRAGGGREKLFF	TRBV11-1	TRBJ1-4
TGTGCCAGCAGCGGCGACTACGAGCAGTACTTC	CASSGDYEQYF	TRBV7-9	TRBJ2-7
TGTGCTAGTGGTTGGTTTCAGGGCACCGGGGAGCTGTTTTTT	CASGWFQGTGELFF	TRBV12-5	TRBJ2-2
TGTGCCAGCAGTTACGTTCGTCAAGGACCTCCTGAAGCTTTCTTT	CASSYVRQGPPEAFF	TRBV6-5	TRBJ1-1
TGTGCCGGGTGTGATCCAGGACCCCGCTACGAGCAGTACTTC	CAGCDPGPRYEQYF	TRBV10-3	TRBJ2-7
TGTGCCAGCAGCCAGGGACTAGCGGGGAGAGGGGAGGCCCTCTCGATAGAGCAGTTCTTC	CASSQGLAGRGEALSIEQFF	TRBV3-1	TRBJ2-1
TGTGCCAGCCCCACTCGCAGGGAATACAATGAGCAGTTCTTC	CASPTRREYNEQFF	TRBV7-3	TRBJ2-1
TGTGGGGCTGCCGACTATGGCTACACCTTC	CGAADYGYTF	TRBV6-1	TRBJ1-2
TGTGCCAGCAGCCTTTCGGGGGTCGATACGCAGTATTTT	CASSLSGVDTQYF	TRBV6-5	TRBJ2-3
TGCGCCAGCAACCTAGCGACGGTGGTCAGGGTTGGAAAGGGCACAGATACGCAGTATTTT	CASNLATVVRVGKGTDTQYF	TRBV5-1	TRBJ2-3
TGTGCCAGCAGTTTTCATACTAAGCTAGGGGTTATATACAATGAGCAGTTCTTC	CASSFHTKLGVIYNEQFF	TRBV27	TRBJ2-1
TGTGCCAGCAGCAGGGCGGGGAAAGGAGGCTCCTACGAGCAGTACTTC	CASSRAGKGGSYEQYF	TRBV6-1	TRBJ2-7
TGCGCCAGCAGCTTGGCGACAGGGGTCACAGATACGCAGTATTTT	CASSLATGVTDTQYF	TRBV5-1	TRBJ2-3
TGCGCCAGCAGTGAGTTCCTAGGGGGCGCGGCCTACGAGCAGTACTTC	CASSEFLGGAAYEQYF	TRBV10-1	TRBJ2-7
TGCGCCAGCAGCTTACCGTTACCTGGGGAGCAGTACTTC	CASSLPLPGEQYF	TRBV5-1	TRBJ2-7
TGTGCCAGCAGCAAGAACAGGGGAAGGGGCTACACCTTC	CASSKNRGRGYTF	TRBV3-1	TRBJ1-2
TGTGCCCGACTAGCGGGCTTCGAGCAGTACTTC	CARLAGFEQYF	TRBV12-5	TRBJ2-7
TGTGCCAGCAGCGGGTCAGGGGGCATCGCCCAGGACACCATATATTTT	CASSGSGGIAQDTIYF	TRBV5-8	TRBJ1-3
TGTGCCAGCAGTTACGCGGGCCGGGGGGCGGCTGAGCAGTACTTC	CASSYAGRGAAEQYF	TRBV6-6	TRBJ2-7
TGTGCCAGCAGCCACGGACAGGAGGCTCTAAGAGATACGCAGTATTTT	CASSHGQEALRDTQYF	TRBV7-2	TRBJ2-3
TGTGCCAAGGACCCGGGACAATATGTGGAAGCTTTCTTT	CAKDPGQYVEAFF	TRBV6-3	TRBJ1-1
TGCGCCAGCAGCCGCCTGGCCCGGGACCGTCCTACCGGGGAGCTGTTTTTT	CASSRLARDRPTGELFF	TRBV4-1	TRBJ2-2
TGTGCCTGGAGGGCATCCTACACCACAGATACGCAGTATTTT	CAWRASYTTDTQYF	TRBV30	TRBJ2-3
TGTGCCCCTCCTAGCACAGATACGCAGTATTTT	CAPPSTDTQYF	TRBV9	TRBJ2-3
TGCAGCAGGTATGAGACCCAGTACTTC	CSRYETQYF	TRBV29-1	TRBJ2-5
TGTGCCTCCTGGCAGATAGCCAAAAACATTCAGTACTTC	CASWQIAKNIQYF	TRBV19	TRBJ2-4
TGTGCCAGCAGCTTAGATACTGGGCATAAGACCAAACACTATGGCTACACCTTC	CASSLDTGHKTKHYGYTF	TRBV11-3	TRBJ1-2
TGCGCCAAGAAAAGGGGGGCGGTTGATACGCAGTATTTT	CAKKRGAVDTQYF	TRBV10-1	TRBJ2-3
TGTGCCAGCAGCAGTGGGACTAGCTCCTACGAGCAGTACTTC	CASSSGTSSYEQYF	TRBV7-3	TRBJ2-7
TGTGCCATGGGCAGGGATTATGCCTATAATTCACCCCTCCACTTT	CAMGRDYAYNSPLHF	TRBV10-3	TRBJ1-6
TGTGCCAGCAGTTCTACCAGGTACTGCTCTGGAAACACCATATATTTT	CASSSTRYCSGNTIYF	TRBV6-4	TRBJ1-3
TGTGCCGAACGTGGTAGGGGGTATACAGATACGCAGTATTTT	CAERGRGYTDTQYF	TRBV30	TRBJ2-3
TGTGCCAGCAGTCAAGGGGGGAGCGAGCAGTACTTC	CASSQGGSEQYF	TRBV27	TRBJ2-7
TGCGCCAGCAGTGATCCCCGGGGGAGTCACGAGCAGTACTTC	CASSDPRGSHEQYF	TRBV10-1	TRBJ2-7
TGCGCCAGCATCTCGTCAGGGGGGGGGGAGAGATGGGGGAGGGTGGCAACTAATGAAAAACTGTTTTTT	CASISSGGGERWGRVATNEKLFF	TRBV10-1	TRBJ1-4
TGTGCCAGCAGCCCTGGACTAGTGTTTCCCTACAATGAGCAGTTCTTC	CASSPGLVFPYNEQFF	TRBV7-3	TRBJ2-1
TGTGCCAGCAGCGGTCCGGCCCGAGATCAGCCCCAGCATTTT	CASSGPARDQPQHF	TRBV7-3	TRBJ1-5
TGTGCCAGCAGGATTCAGGGAGCGCCAGGCCATGGCTACACCTTC	CASRIQGAPGHGYTF	TRBV28	TRBJ1-2
TGTGCCATCCCACAGGACAGGGGACCCTATGGCTACACCTTC	CAIPQDRGPYGYTF	TRBV6-1	TRBJ1-2
TGTGCCAGCAGGCTTGGGGGGGGGTCGGTAGCAGGCACCGGGGAGCTGTTTTTT	CASRLGGGSVAGTGELFF	TRBV6-4	TRBJ2-2
TGTGCCAGCAGCTTAGTGGGGGACCAGGGGTTTAGAAACACCATATATTTT	CASSLVGDQGFRNTIYF	TRBV13	TRBJ1-3
TGTGCCAGCAGTGTCGACTCAGGGAACAATCAGCCCCAGCATTTT	CASSVDSGNNQPQHF	TRBV6-1	TRBJ1-5
TGCGCCAGCAGCTTGGGGACAGGGAGAGGAGAGAGACCAGTGGACGAGCAGTACTTC	CASSLGTGRGERPVDEQYF	TRBV5-1	TRBJ2-7
TGTGCCAGCAGTGAAGTTGAGTGGACGGGGTATGGCTACACCTTC	CASSEVEWTGYGYTF	TRBV2	TRBJ1-2
TGCGCCAGCAGCTTGGCTTCTCTGTGCAATTCACCCCTCCACTTT	CASSLASLCNSPLHF	TRBV5-1	TRBJ1-6
TGTGCCAGCAGCTGCGGGACCCAGAGATCCTACGAGCAGTACTTC	CASSCGTQRSYEQYF	TRBV7-9	TRBJ2-7
TGCAGCGTAGGGAGGTCCGGGGGCTACACCTTC	CSVGRSGGYTF	TRBV29-1	TRBJ1-2
TGTGCCAGCTCACCACATTCTATGAGCACTGAAGCTTTCTTT	CASSPHSMSTEAFF	TRBV18	TRBJ1-1
TGTGCCAGCCGCGGAGGGGGGTCAGATACGCAGTATTTT	CASRGGGSDTQYF	TRBV2	TRBJ2-3
TGTGCCAGCAGAAGCCGGACAGGGGGTAGGGCTGGTGGGGAGACCCAGTACTTC	CASRSRTGGRAGGETQYF	TRBV6-5	TRBJ2-5
TGTGCCAGCAGTTGGCAACCAGGGACCAGCTATGGCTACACCTTC	CASSWQPGTSYGYTF	TRBV27	TRBJ1-2
TGTGCCTGTAGTCCTAGCGGCCCTTACAATGAGCAGTTCTTC	CACSPSGPYNEQFF	TRBV30	TRBJ2-1
TGCAGTGCTCGTCAGGGGGCTGAAGCTTTCTTT	CSARQGAEAFF	TRBV20-1	TRBJ1-1
TGTGCCAGCGGGACCGCGGGAGGGGTCCAAGAGACCCAGTACTTC	CASGTAGGVQETQYF	TRBV27	TRBJ2-5
TGTGCCAGTGTAGTCCGGGACAACAAGTGGAACACTGAAGCTTTCTTT	CASVVRDNKWNTEAFF	TRBV25-1	TRBJ1-1
TGTGCCATCAGTGAGTCGGGATGGACACAGGGCCGTTCACCCCTCCACTTT	CAISESGWTQGRSPLHF	TRBV10-3	TRBJ1-6
TGTGCCAGCAGTCACCCACCGTCAGGACAGGGAAGGGCCTACGAGCAGTACTTC	CASSHPPSGQGRAYEQYF	TRBV6-5	TRBJ2-7
TGTGCCAGCACCGGGCCCTGCTACGAGCAGTACTTC	CASTGPCYEQYF	TRBV6-5	TRBJ2-7
TGTGCCAGTAGTCCGGGGTCAGGCCGCGGGGACCCTTACGAGCAGTACTTC	CASSPGSGRGDPYEQYF	TRBV19	TRBJ2-7
TGTGCCAGCAGCTTTAGTGGCGAACCCCCAGCAGATACGCAGTATTTT	CASSFSGEPPADTQYF	TRBV5-4	TRBJ2-3
TGTGCCAGCGTCGGGAACTATCTTATGCTTAGAGGGGGCTACACCTTC	CASVGNYLMLRGGYTF	TRBV27	TRBJ1-2
TGTGCCAGCAGTTCCGGGGGCGAGACCCAGTACTTC	CASSSGGETQYF	TRBV6-5	TRBJ2-5
TGTGCCAGCAGTGATCGTGTCCACGGACAGGGGGCTATTTTCGGGGCCAACGTCCTGACTTTC	CASSDRVHGQGAIFGANVLTF	TRBV6-4	TRBJ2-6
TGTGCCAGCAGTTTACCCCTACCCCCGGGCCGAGGGAGCAATCAGCCCCAGCATTTT	CASSLPLPPGRGSNQPQHF	TRBV12-4	TRBJ1-5
TGTGCCACCAGTGATGAACTAGTGACAGAATACAATGAGCAGTTCTTC	CATSDELVTEYNEQFF	TRBV24-1	TRBJ2-1
TGTGCCAGCAGCTTAGTATCACTAGCGGGAGTGAACACTGAAGCTTTCTTT	CASSLVSLAGVNTEAFF	TRBV11-2	TRBJ1-1
TGCGCCAGCAGCCAAGATGTGCAGGGGGCGAATAGCAATCAGCCCCAGCATTTT	CASSQDVQGANSNQPQHF	TRBV4-3	TRBJ1-5
TGTGCCAGCAGTGAACCGGGGTATGGGGGGGCCGAAAAACTGTTTTTT	CASSEPGYGGAEKLFF	TRBV6-1	TRBJ1-4
TGTGCCACCAGTGAGCGGGACTTTAAGAACACCGGGGAGCTGTTTTTT	CATSERDFKNTGELFF	TRBV24-1	TRBJ2-2
TGTGCCAGCAGCTCCCCTGTGACAGGCTCCTACGAGCAGTACTTC	CASSSPVTGSYEQYF	TRBV11-3	TRBJ2-7
TGTGCCAGCAGTTACGGTGACAGATACACTGAAGCTTTCTTT	CASSYGDRYTEAFF	TRBV6-5	TRBJ1-1
TGTGCCAGCAGCCGGGGACAGGTGGAAACCGGGGAGCTGTTTTTT	CASSRGQVETGELFF	TRBV14	TRBJ2-2
TGCAGTGCTAGAGATGGAAGGGAGGACTATGGCTACACCTTC	CSARDGREDYGYTF	TRBV20-1	TRBJ1-2
TGCATGTTCGGACTGTCTGAGCAGTTCTTC	CMFGLSEQFF	TRBV20-1	TRBJ2-1
TGTGCCAGCAGCGTCCGGGACAGAAACATTAACTATGGCTACACCTTC	CASSVRDRNINYGYTF	TRBV7-3	TRBJ1-2
TGCGCCAGCAGCCACACGCATAGATATCGCAATCAGCCCCAGCATTTT	CASSHTHRYRNQPQHF	TRBV4-1	TRBJ1-5
TGTGCCAGCAGCTTTTATCATACCAGGGGGATCAATCAGCCCCAGCATTTT	CASSFYHTRGINQPQHF	TRBV5-4	TRBJ1-5
TGTGCCAGCAGTGAAGCCGAGTCCGACAAGGCACCCTACGAGCAGTACTTC	CASSEAESDKAPYEQYF	TRBV2	TRBJ2-7
TGCGCCAGCCATTACATCATGAATGAGCAGTTCTTC	CASHYIMNEQFF	TRBV10-1	TRBJ2-1
TGTGCCAGCAGCCTCCCCACAGGGCACAGTGGGATGAACACTGAAGCTTTCTTT	CASSLPTGHSGMNTEAFF	TRBV11-3	TRBJ1-1
TGTGCCAGCTCACCACCCCGGGACAGAACCGGAAACACCATATATTTT	CASSPPRDRTGNTIYF	TRBV18	TRBJ1-3
TGTGCCAGCAGACAGGGGTGCTATGGCTACACCTTC	CASRQGCYGYTF	TRBV28	TRBJ1-2
TGTGCCAGCAGCGGTTTGGACAGGGGCCCCTGGGCCAAAACCGGGGAGCTGTTTTTT	CASSGLDRGPWAKTGELFF	TRBV13	TRBJ2-2
TGTGCCACCAGTGATATGGGACAGGGTGGGGGGTCCACAGATACGCAGTATTTT	CATSDMGQGGGSTDTQYF	TRBV24-1	TRBJ2-3
TGCGCCAGCAGCCAAGCCCCGGCGAACTCTAATGAAAAACTGTTTTTT	CASSQAPANSNEKLFF	TRBV4-1	TRBJ1-4
TGTGCCACCAGTGATCAGCTTCGGGTTAGCGAGCAGTACTTC	CATSDQLRVSEQYF	TRBV24-1	TRBJ2-7
TGTGCCAGCAGCTACCTTCCTTCGGGCCTACCCTCCTACGAGCAGTACTTC	CASSYLPSGLPSYEQYF	TRBV11-2	TRBJ2-7
TGTGCCAGCCCCGCGCAAGGGCTCAGACAGGAGCAAGAGACCCAGTACTTC	CASPAQGLRQEQETQYF	TRBV28	TRBJ2-5
TGTGCCAGCAGCGCAGCGGGAGGGGAAAAACTGTTTTTT	CASSAAGGEKLFF	TRBV7-4	TRBJ1-4
TGTGCCAGCAGCCGGAGGGGTTCTAGGCAGCCCCAGCATTTT	CASSRRGSRQPQHF	TRBV13	TRBJ1-5
TGTGCCAGCAGTTACTCCGAGACAGGGTGGGGGGCCAACGTCCTGACTTTC	CASSYSETGWGANVLTF	TRBV6-5	TRBJ2-6
TGTGCCAGCAGCCTCCTGACTCCCGGGGAAGGGGAGCTGTTTTTT	CASSLLTPGEGELFF	TRBV3-1	TRBJ2-2
TGTGCCAGCAGCCACCATGGGCGGGACAGGGAACCCAATCAGCCCCAGCATTTT	CASSHHGRDREPNQPQHF	TRBV7-6	TRBJ1-5
TGTGCCAGTAGACAGGGGTTAGAGAACACTGAAGCTTTCTTT	CASRQGLENTEAFF	TRBV19	TRBJ1-1
TGCGCCAGCAGTCAGGGTTTCCCCCACACTGAAGCTTTCTTT	CASSQGFPHTEAFF	TRBV10-1	TRBJ1-1
TGTGCCAGCAGCAAAATTAAGAGTTCGGACACTGAAGCTTTCTTT	CASSKIKSSDTEAFF	TRBV7-3	TRBJ1-1
TGTGCCAGCAGTTCCCCGATAGACTCTGTAAACACCATATATTTT	CASSSPIDSVNTIYF	TRBV28	TRBJ1-3
TGTGCCATCAGCGAGAGCAGATGCCAGCCCCAGCATTTT	CAISESRCQPQHF	TRBV10-3	TRBJ1-5
TGTGCCAGCAGGACACCTCCAGGGGGCCGGAACTATGGCTACACCTTC	CASRTPPGGRNYGYTF	TRBV6-4	TRBJ1-2
TGTGCCAGCAGTTGGGGGGGGGGGGCGTGCACAGATACGCAGTATTTT	CASSWGGGACTDTQYF	TRBV12-4	TRBJ2-3
TGTGCCAGCAGCGTAAGGGGTGCCGTGAGGGAACAAGAGACCCAGTACTTC	CASSVRGAVREQETQYF	TRBV9	TRBJ2-5
TGTGCCAGCAGCTACACAGGGGTGAGGAGCCCTGAAAAACTGTTTTTT	CASSYTGVRSPEKLFF	TRBV13	TRBJ1-4
TGCACCGGGACAGGGTCTAATGAAAAACTGTTTTTT	CTGTGSNEKLFF	TRBV29-1	TRBJ1-4
TGTGCCAGCAGCCGGCTAGCGGGCCCCCACAATGAGCAGTTCTTC	CASSRLAGPHNEQFF	TRBV27	TRBJ2-1
TGCGCCAGCAGCTTGCCGGCGGACGACACTGAAGCTTTCTTT	CASSLPADDTEAFF	TRBV5-1	TRBJ1-1
TGCGCCAGCACTGCCCTAGGGGGGAATCAGTACTTC	CASTALGGNQYF	TRBV10-1	TRBJ2-5
TGTGCCAGCAGCCAAGACGACGCTAGCGGGTGGATATATGAGCAGTTCTTC	CASSQDDASGWIYEQFF	TRBV14	TRBJ2-1
TGCAGTGCTAGAGACAGGAAACAGGGTCCAAGCACAGATACGCAGTATTTT	CSARDRKQGPSTDTQYF	TRBV20-1	TRBJ2-3
TGTGCCAGCAGTGAAGGGTACGGCCCTCAGGGTTGCCCTAATGAAAAACTGTTTTTT	CASSEGYGPQGCPNEKLFF	TRBV2	TRBJ1-4
TGTGCCAGCAGCTTGTTAAGAAGTAACTATGGCTACACCTTC	CASSLLRSNYGYTF	TRBV5-4	TRBJ1-2
TGTGCCAGCAGTGACGTGGAGAGGGTCGGGGGGTGTCACAATGAGCAGTTCTTC	CASSDVERVGGCHNEQFF	TRBV6-1	TRBJ2-1
TGCGCCAGCAGTGAAACCGGCCCAGGGACTAGCGGGGGAGACTCCTACGAGCAGTACTTC	CASSETGPGTSGGDSYEQYF	TRBV10-1	TRBJ2-7
TGTGCCAGCAGCTTAGTCAGGGGGGACTATGGCTACACCTTC	CASSLVRGDYGYTF	TRBV7-9	TRBJ1-2
TGCGCCAGCAGCTTGATCCCACTAGCGGGATACGAGCAGTACTTC	CASSLIPLAGYEQYF	TRBV5-1	TRBJ2-7
TGCAGTGCTAGAGATCACTACCTGGGGGGCGGGCAACCCCCACCGAACACCGGGGAGCTGTTTTTT	CSARDHYLGGGQPPPNTGELFF	TRBV20-1	TRBJ2-2
TGTGCCAGCAGTGACCCGGGGAAGTCCTACGAGCAGTACTTC	CASSDPGKSYEQYF	TRBV2	TRBJ2-7
TGCGCCAGCAGTGTCGGCCCAAAGGGCTCCTACGAGCAGTACTTC	CASSVGPKGSYEQYF	TRBV5-1	TRBJ2-7
TGTGCCAGTATACCGGGACAGGGGGCGAGAAGCTCCTACAATGAGCAGTTCTTC	CASIPGQGARSSYNEQFF	TRBV19	TRBJ2-1
TGTGCCAGCAGTGAAGGTGGACTACTAGCGGAAAATGAGCAGTTCTTC	CASSEGGLLAENEQFF	TRBV6-1	TRBJ2-1
TGTGCCAGCAGTGGATGGGGGGGACGTGCCAATGAGCAGTTCTTC	CASSGWGGRANEQFF	TRBV12-3	TRBJ2-1
TGTGCCAGCAGATTGGACAGGGCAGGCTATAGCAATCAGCCCCAGCATTTT	CASRLDRAGYSNQPQHF	TRBV12-4	TRBJ1-5
TGTGCCACCCCGTTCCTTTACGAGCAGTACTTC	CATPFLYEQYF	TRBV15	TRBJ2-7
TGTGCCAGCAGCCAGAGGTGGGAGAAATACGAGCAGTACTTC	CASSQRWEKYEQYF	TRBV7-4	TRBJ2-7
TGTGCTAGTGGCCTGTGGGGGACAGGGGCCTTTTCACCCCTCCACTTT	CASGLWGTGAFSPLHF	TRBV12-5	TRBJ1-6
TGCGCCAGCAGTGGGCCCGGTCGACAGTGTAACACTGAAGCTTTCTTT	CASSGPGRQCNTEAFF	TRBV10-1	TRBJ1-1
TGTGCCAGCAGCATCATACCGGGGCAGCCCCAGCATTTT	CASSIIPGQPQHF	TRBV7-4	TRBJ1-5
TGTGCCAGCAGCTTAGATAGGGGAGCCAGGGAAGGAAGGGCAGACACTGAAGCTTTCTTT	CASSLDRGAREGRADTEAFF	TRBV11-2	TRBJ1-1
TGTGCCAGTAGTATCCCCTGTGGACTAGCGGGATGCACAGATACGCAGTATTTT	CASSIPCGLAGCTDTQYF	TRBV19	TRBJ2-3
TGTGCCCTGACAGACCTCAACTATGGCTACACCTTC	CALTDLNYGYTF	TRBV6-1	TRBJ1-2
TGTGCCAGCAGCTTCCCGCTTCAGCCCCGCTGCACAGATACGCAGTATTTT	CASSFPLQPRCTDTQYF	TRBV14	TRBJ2-3
TGTGCCACCAGTGGACAGGGACGACGGTCCATGGACGAGCAGTACTTC	CATSGQGRRSMDEQYF	TRBV24-1	TRBJ2-7
TGCAGTGCTCCGGGGGGGCTCAACACTGAAGCTTTCTTT	CSAPGGLNTEAFF	TRBV20-1	TRBJ1-1
TGTGCGTCCAGCGGGCACACTGAAGCTTTCTTT	CASSGHTEAFF	TRBV28	TRBJ1-1
TGTGCCAGCAGCCCCCACCGGGACACAACCCCCTCTGGGGCCAACGTCCTGACTTTC	CASSPHRDTTPSGANVLTF	TRBV7-3	TRBJ2-6
TGTGCCAGCAGTTTAGGGACGGTAGTAATGGTGGAGCAGTACTTC	CASSLGTVVMVEQYF	TRBV28	TRBJ2-7
TGTGCCAGCAGTTCCCTCAGCTACGCCTACGAGCAGTACTTC	CASSSLSYAYEQYF	TRBV27	TRBJ2-7
TGTGCCAGCAGTTGGCCAGAAGGATCAGGTGAGCAGTTCTTC	CASSWPEGSGEQFF	TRBV28	TRBJ2-1
TGTGCCAGCAGCTTAAGGCGGCCCCGCTACAATGAGCAGTTCTTC	CASSLRRPRYNEQFF	TRBV7-9	TRBJ2-1
TGCGCCAGCGTACAAGGGACAGCTGTTTCCTTCTATCAGCCCCAGCATTTT	CASVQGTAVSFYQPQHF	TRBV5-1	TRBJ1-5
TGTGCCAGCAGCCCCGGGACTGCCAATGAGCAGTTCTTC	CASSPGTANEQFF	TRBV11-3	TRBJ2-1
TGTGCCTGGAGGACGGGACCAAACACTGAAGCTTTCTTT	CAWRTGPNTEAFF	TRBV30	TRBJ1-1
TGTGCCAGCAGCTTGGCCCATTGGACAGGGGGGTTAGAGACCCAGTACTTC	CASSLAHWTGGLETQYF	TRBV5-6	TRBJ2-5
TGTGCCAGCAGCTTGACGAATTGTCCTCGAAGGGCCCCAGATACGCAGTATTTT	CASSLTNCPRRAPDTQYF	TRBV5-4	TRBJ2-3
TGCGCCAGCAGCCAAGATCTTACTAGCGGGAGTACGAGTGGTAATGAAAAACTGTTTTTT	CASSQDLTSGSTSGNEKLFF	TRBV4-3	TRBJ1-4
TGTGCCAGCAGCCCCCAGGGATGGCACTCTGGAAACACCATATATTTT	CASSPQGWHSGNTIYF	TRBV9	TRBJ1-3
TGTGCCAGCAGCGGGGGGTTTGCGGGAGAGGGGTTAAACACTGAAGCTTTCTTT	CASSGGFAGEGLNTEAFF	TRBV11-3	TRBJ1-1
TGTGCCAGCAGCCCCCCGACAGGGGTGGTCTCCTACAATGAGCAGTTCTTC	CASSPPTGVVSYNEQFF	TRBV7-9	TRBJ2-1
TGTGCCAGCAGCGGACAGGGCTACACCTTC	CASSGQGYTF	TRBV7-3	TRBJ1-2
TGTGCCAGCATGAAATGGACTACCCCCAGGTACAATGAGCAGTTCTTC	CASMKWTTPRYNEQFF	TRBV6-5	TRBJ2-1
TGTGCCACCAGCAGAGGGGGGGCCAACGTCCTGACTTTC	CATSRGGANVLTF	TRBV15	TRBJ2-6
TGTGCCAGCAGCAGCCTGCCCCGAAATGAGCAGTTCTTC	CASSSLPRNEQFF	TRBV11-2	TRBJ2-1
TGTGCCTGGAGCGGGGAGGAAGGGGCCTGGTCCTACGAGCAGTACTTC	CAWSGEEGAWSYEQYF	TRBV30	TRBJ2-7
TGTGCCAGCAGTGACAAGGTTTGGACTAGCGGGGGCGGGGAGCAGTTCTTC	CASSDKVWTSGGGEQFF	TRBV2	TRBJ2-1
TGTGCCAGCAGTCCGGACAGGGGGCGGTATGAAAAACTGTTTTTT	CASSPDRGRYEKLFF	TRBV6-1	TRBJ1-4
TGTGCCAGCTCAGTGGACGTGGGCGGACTACCCCTCCACTTT	CASSVDVGGLPLHF	TRBV18	TRBJ1-6
TGTGCCTGGCAATTTCTAGGGGGCGGGGATGGCTACACCTTC	CAWQFLGGGDGYTF	TRBV30	TRBJ1-2
TGTGCCAGTAGTTCCCTAGCGGGTCCTCCAGGCACAGATACGCAGTATTTT	CASSSLAGPPGTDTQYF	TRBV19	TRBJ2-3
TGCGCCAGCAGCCAAGAAGTCCCACGGAAGAACACCGGGGAGCTGTTTTTT	CASSQEVPRKNTGELFF	TRBV4-3	TRBJ2-2
TGTGCCAGCAGCCGTAACAGGGGGCCCCCCTACGAGCAGTACTTC	CASSRNRGPPYEQYF	TRBV3-1	TRBJ2-7
TGTGCCAGCAGAATGCAGGGGGCACCGCCGGGGGCCAAAAACATTCAGTACTTC	CASRMQGAPPGAKNIQYF	TRBV12-4	TRBJ2-4
TGTGCTAGTGGTCCGGACAGGGTCGGCAATCAGCCCCAGCATTTT	CASGPDRVGNQPQHF	TRBV12-5	TRBJ1-5
TGTGCCAGCAGCTTGGAGAATACGGAGAGGAGGCGCTACGAGCAGTACTTC	CASSLENTERRRYEQYF	TRBV5-8	TRBJ2-7
TGTGCCAGCAGCTCCGGCGACGATACGCAGTATTTT	CASSSGDDTQYF	TRBV9	TRBJ2-3
TGTGCCAGCAGCCAAAAGGAGTCTACCAGGGGTGAAGCAGATACGCAGTATTTT	CASSQKESTRGEADTQYF	TRBV14	TRBJ2-3
TGTGCCAGCAGCTTCGGACAGGCGGCCTACGAGCAGTACTTC	CASSFGQAAYEQYF	TRBV7-9	TRBJ2-7
TGCAGTAAGGACAGGGGTTGGGAGGAAAGGGGAAAAGCGGACACCGGGGAGCTGTTTTTT	CSKDRGWEERGKADTGELFF	TRBV20-1	TRBJ2-2
TGTGCCAGCAGACTCAGGAGTCCAGGTTTGAGCTACGAGCAGTACTTC	CASRLRSPGLSYEQYF	TRBV6-4	TRBJ2-7
TGCGCCAGCAGCTTGAGGGAGGGGGCCTCCTACGAGCAGTACTTC	CASSLREGASYEQYF	TRBV5-1	TRBJ2-7
TGTGCCAGCAGCAGGAGGGCCACTGAAGCTTTCTTT	CASSRRATEAFF	TRBV7-3	TRBJ1-1
TGCGCCAGCAAGTATGCAGAGACCCAGTACTTC	CASKYAETQYF	TRBV5-1	TRBJ2-5
TGCAACGCCCGGGACGACGAGCAGTACTTC	CNARDDEQYF	TRBV20-1	TRBJ2-7
TGCAGTGCTCCAACAGGGGGACACAATCAGCCCCAGCATTTT	CSAPTGGHNQPQHF	TRBV20-1	TRBJ1-5
TGTGCCACCACGGGGGACAGGAACAATGAGCAGTTCTTC	CATTGDRNNEQFF	TRBV24-1	TRBJ2-1
TGTGCCAGCAGCAGAAAGGGGGGGCCGAGAAGGTACTTC	CASSRKGGPRRYF	TRBV7-6	TRBJ2-5
TGCAGTGCTATCCTGGGCTCCGGGACTAGCGGAAGCGAGCAGTACTTC	CSAILGSGTSGSEQYF	TRBV20-1	TRBJ2-7
TGCAGCGTTGTCTCCACCTACGAGCAGTACTTC	CSVVSTYEQYF	TRBV29-1	TRBJ2-7
TGTGCCAGCAGTGACAATGCTAGGCAAGAGACCCAGTACTTC	CASSDNARQETQYF	TRBV6-4	TRBJ2-5
TGTGCCAGCAGCTTCGCGGGACGGTTGGGCTACAATGAGCAGTTCTTC	CASSFAGRLGYNEQFF	TRBV7-8	TRBJ2-1
TGTGCCACCAGTGTGAGGCCGGGACAGGGGCGAACGAACACTGAAGCTTTCTTT	CATSVRPGQGRTNTEAFF	TRBV24-1	TRBJ1-1
TGTGCCAGCGAGAAGACAGGGGCGCACTATGGCTACACCTTC	CASEKTGAHYGYTF	TRBV6-1	TRBJ1-2
TGCGCCAGCAGCTTGGCCGCCTACAATAGCAATCAGCCCCAGCATTTT	CASSLAAYNSNQPQHF	TRBV5-1	TRBJ1-5
TGTGCCAGCAGGGGGGGCACCACTGAAGCTTTCTTT	CASRGGTTEAFF	TRBV6-6	TRBJ1-1
TGTGCCAGCAGCGACAGGAGAGTTGAAAAGACAGGGCGGGCCATCCAGAACACTGAAGCTTTCTTT	CASSDRRVEKTGRAIQNTEAFF	TRBV9	TRBJ1-1
TGCAGTGCTAGAGATCGGGGCGGGGGAGGTCAAGAGACCCAGTACTTC	CSARDRGGGGQETQYF	TRBV20-1	TRBJ2-5
TGTGCCAGCAGCAAGCCGGGACAGTTCGGTAACTATGGCTACACCTTC	CASSKPGQFGNYGYTF	TRBV6-4	TRBJ1-2
TGCGCCAGCAGCTTGGGGCAGCCGGGACAGGGCTATAATTCACCCCTCCACTTT	CASSLGQPGQGYNSPLHF	TRBV5-1	TRBJ1-6
TGTGCCAGCAGTTTATCCTTTATAGTTGAGACCCAGTACTTC	CASSLSFIVETQYF	TRBV12-3	TRBJ2-5
TGTGCTGGGGCCAGGGTCATGGGGTATACTAATGAAAAACTGTTTTTT	CAGARVMGYTNEKLFF	TRBV6-4	TRBJ1-4
TGTGCCACCAGTCGGCCGAGGGGTAGCGTCCTGACTTTC	CATSRPRGSVLTF	TRBV24-1	TRBJ2-6
