TGTGCCAGCAGTGAAGCGGCGGGGAGGCCCGTGAGTGACACCGGGGAGCTGTTTTTT	CASSEAAGRPVSDTGELFF	TRBV6-1	TRBJ2-2
TGTGCCAGCAGCTTAAGGGTGGGACAGCATGGCTACACCTTC	CASSLRVGQHGYTF	TRBV7-3	TRBJ1-2
TGTGCCAGCAGCGAATCTGTCGTAAGTAGCGAGCAGTACTTC	CASSESVVSSEQYF	TRBV28	TRBJ2-7
TGTGCCAGTAGTATTAGCCGGGACAGCGGAGTCATGAACACTGAAGCTTTCTTT	CASSISRDSGVMNTEAFF	TRBV19	TRBJ1-1
TGCAGTGCTAGAGTCGTACTTCGACCGACAGGCTACACCTTC	CSARVVLRPTGYTF	TRBV20-1	TRBJ1-2
TGTGCCAGCAGCGCCCACCAACCCGGGGGGCGGAACTATGGCTACACCTTC	CASSAHQPGGRNYGYTF	TRBV7-9	TRBJ1-2
TGTGCCAGCAGTTACGTGGCCAGGCAGGGAGGAGCTTTCTTT	CASSYVARQGGAFF	TRBV6-5	TRBJ1-1
TGTGCCAGGCCTACAGAGACCCAGTACTTC	CARPTETQYF	TRBV18	TRBJ2-5
TGTGCCAGCAGCTTGGGCACTAGCGGGAGTCTCGAGGTCGAGCAGTACTTC	CASSLGTSGSLEVEQYF	TRBV5-6	TRBJ2-7
TGTGCCAGCAGAAGCCTAATACGGGATGAGCAGTTCTTC	CASRSLIRDEQFF	TRBV9	TRBJ2-1
TGTGCCAGCAGCTTGGGACCGGACACCGACAATGAGCAGTTCTTC	CASSLGPDTDNEQFF	TRBV5-4	TRBJ2-1
TGTGCCAGCAGCGCTAGCGGGGATTCCCGCTCCTACAATGAGCAGTTCTTC	CASSASGDSRSYNEQFF	TRBV7-3	TRBJ2-1
TGTGCCAGCAGCTTAGAGACTGACCTCGGGGGGGCACCTGAGCAGTTCTTC	CASSLETDLGGAPEQFF	TRBV11-3	TRBJ2-1
TGTGCCACAAGACCGACCATGAACACTGAAGCTTTCTTT	CATRPTMNTEAFF	TRBV9	TRBJ1-1
TGTGCCAGCAGCTTAGCTTTGGGGGGGCGCTCGGACAATGAGCAGTTCTTC	CASSLALGGRSDNEQFF	TRBV7-3	TRBJ2-1
TGTGCCAGCAGCGGGCCCACCAACACCGGGGAGCTGTTTTTT	CASSGPTNTGELFF	TRBV5-4	TRBJ2-2
TGTGCCAGCAGGACGCCATCCTCCTACGAGCAGTACTTC	CASRTPSSYEQYF	TRBV9	TRBJ2-7
TGTGCCAGCAGCGTCGTAGAAGGCAACACCGGGGAGCTGTTTTTT	CASSVVEGNTGELFF	TRBV9	TRBJ2-2
TGTGCCAGCAGTGAAATCGGGGGACTAGATACGCAGTATTTT	CASSEIGGLDTQYF	TRBV6-1	TRBJ2-3
TGCGCCAGCAGCTTGAGACCAGGCTACGAGCAGTACTTC	CASSLRPGYEQYF	TRBV5-1	TRBJ2-7
TGTGCCAGCAGCGGGGTGAGGGAGGGGCGCAATCAGCCCCAGCATTTT	CASSGVREGRNQPQHF	TRBV13	TRBJ1-5
TGTGCCAGCAGTTACTTCATCGTGTGGAGGGAAAAACTGTTTTTT	CASSYFIVWREKLFF	TRBV6-6	TRBJ1-4
TGTCAGTCGGGGGAATGGAATGAGCAGTTCTTC	CQSGEWNEQFF	TRBV29-1	TRBJ2-1
TGTGCCAGCAGTGAAAGGGTGACACAGCGGGAGACCCTGAACACTGAAGCTTTCTTT	CASSERVTQRETLNTEAFF	TRBV6-1	TRBJ1-1
TGCGCCAGCCCTCGCCAGGGGCACCAAGAACCAAGAGAGGCAAACACTGAAGCTTTCTTT	CASPRQGHQEPREANTEAFF	TRBV5-1	TRBJ1-1
TGCAGTGCTAGGTCCCTAGCGCCTGAGACCCAGTACTTC	CSARSLAPETQYF	TRBV20-1	TRBJ2-5
TGTGCCACCAGTGATTTGACAGGGGAGGTGCAAGAGACCCAGTACTTC	CATSDLTGEVQETQYF	TRBV24-1	TRBJ2-5
TGTGCCAGCAGAAGAGACAGCGGGGATAGAATTAATAATTCACCCCTCCACTTT	CASRRDSGDRINNSPLHF	TRBV2	TRBJ1-6
TGTGCTAGTGGTTTGGTAAGAGGTCTGGCCGAGCAGTACTTC	CASGLVRGLAEQYF	TRBV12-5	TRBJ2-7
TGTGCCAGCATCACCAGAAGGGGCTTGCCTAGCTCCTACAATGAGCAGTTCTTC	CASITRRGLPSSYNEQFF	TRBV6-1	TRBJ2-1
TGTGCCAGCAGCTTGGAAGAGCCTAGTGGCTACACCTTC	CASSLEEPSGYTF	TRBV5-8	TRBJ1-2
TGTGCCACCAGTGATTTATGGCAGGGGCGCTACTACGAGCAGTACTTC	CATSDLWQGRYYEQYF	TRBV24-1	TRBJ2-7
TGCGCCAGCAGCGACGGACTAGCGGGGTTGGCCAAAAACATTCAGTACTTC	CASSDGLAGLAKNIQYF	TRBV4-1	TRBJ2-4
TGTGCCAGCAGGGGACAGGCGCATAACTATGGCTACACCTTC	CASRGQAHNYGYTF	TRBV6-3	TRBJ1-2
TGCAGCCCGAGGACAGGAGCCTACGAGCAGTACTTC	CSPRTGAYEQYF	TRBV29-1	TRBJ2-7
TGTGCCAGCAGCAAGTTTAACGGGAACCTTTGCTCTGGGGCCAACGTCCTGACTTTC	CASSKFNGNLCSGANVLTF	TRBV7-4	TRBJ2-6
TGTGCCAGCAGTGGGGGGGGGAGGAATGAAAAACTGTTTTTT	CASSGGGRNEKLFF	TRBV6-5	TRBJ1-4
TGTGCCAGGGAGGGGGCGGAACATGAAGCTTTCTTT	CAREGAEHEAFF	TRBV19	TRBJ1-1
TGTGCCAGCAGCCCGACGCAGTATTTT	CASSPTQYF	TRBV2	TRBJ2-3
TGTGCCAGCAGCTCCGCCACAGAGGGGGGCCGGGATGAGCAGTTCTTC	CASSSATEGGRDEQFF	TRBV7-3	TRBJ2-1
TGTGCCAGCAGCAACTCGGGACGCGATGTAGAGACCCAGTACTTC	CASSNSGRDVETQYF	TRBV7-3	TRBJ2-5
TGCGCCAGCAGCCAAGACACAGACCTTAAAGATAACTATGGCTACACCTTC	CASSQDTDLKDNYGYTF	TRBV4-1	TRBJ1-2
TGCGCCAGCAGCCCCAGGGGTCTCCATCAGCCCCAGCATTTT	CASSPRGLHQPQHF	TRBV4-1	TRBJ1-5
TGTGCCAGCAAAACCCCGGGACAGGGGGCGGTGGGCCAGCCCCAGCATTTT	CASKTPGQGAVGQPQHF	TRBV7-3	TRBJ1-5
TGTGCCAGCAGCTTGGGGGGGCGGAAAGACTGGACCCAGTACTTC	CASSLGGRKDWTQYF	TRBV11-3	TRBJ2-5
TGCAGTGCTAACGGGACAGCCGACGAGCAGTACTTC	CSANGTADEQYF	TRBV20-1	TRBJ2-7
TGTGCCAGCAGCAATCCGTCACTCTGGGGAGCTAACTATGGCTACACCTTC	CASSNPSLWGANYGYTF	TRBV13	TRBJ1-2
TGTGCCAGCAGTGGTTGGGTGGCGGTCAATGAGCAGTTCTTC	CASSGWVAVNEQFF	TRBV6-1	TRBJ2-1
TGTGCTAGTGGGCTGTCTGGGGCGAGGGGTAATAGCAATCAGCCCCAGCATTTT	CASGLSGARGNSNQPQHF	TRBV12-5	TRBJ1-5
TGTGCCAGCAGTGACAATTCCGGCAAAAACAAAGGGGGAGTTCCAGGGGGCGAGCAGTACTTC	CASSDNSGKNKGGVPGGEQYF	TRBV6-4	TRBJ2-7
TGCAGTGCTAGAGATGCGGCTCCGGACAGCGCAGAAAAACTGTTTTTT	CSARDAAPDSAEKLFF	TRBV20-1	TRBJ1-4
TGTGCCAGCAGTTTAAGTTACAGGGGGGGGCCAGCTGGAAACACCATATATTTT	CASSLSYRGGPAGNTIYF	TRBV12-4	TRBJ1-3
TGTGCCAGCAGCCCGGGTAAGTATGAGATAGAGACCCAGTACTTC	CASSPGKYEIETQYF	TRBV14	TRBJ2-5
TGTGCCACCCCCTGGGGCCTGGGGGAGACCCAGTACTTC	CATPWGLGETQYF	TRBV19	TRBJ2-5
TGTGCCAGCAGTGAGACTGGGGAACCCACCGGGGAGCTGTTTTTT	CASSETGEPTGELFF	TRBV2	TRBJ2-2
TGTGCCAGCAGCCCTGCAACAGGGTACCCCTACAATGAGCAGTTCTTC	CASSPATGYPYNEQFF	TRBV7-2	TRBJ2-1
TGTGCCAGCGAAGCGGGTCCGGGGCATCTCACTGAAGCTTTCTTT	CASEAGPGHLTEAFF	TRBV11-3	TRBJ1-1
TGTGCCATCAGTGCACGGGTCCCCCAGTACTTC	CAISARVPQYF	TRBV10-3	TRBJ2-5
TGCGCCAGCAAGTCGGGGGCTGACTACGAGCAGTACTTC	CASKSGADYEQYF	TRBV10-1	TRBJ2-7
TGTGCCAGCAGCGTAGAGGCTCCAGACAGGGAACCCCGACTAGGCAATCAGCCCCAGCATTTT	CASSVEAPDREPRLGNQPQHF	TRBV9	TRBJ1-5
TGTGCCAGCAGTTCATATACTAAAGAGACCCAGTACTTC	CASSSYTKETQYF	TRBV3-1	TRBJ2-5
TGTGCCATCAGTAACAGGGGGCGCCTCTACTATGGCTACACCTTC	CAISNRGRLYYGYTF	TRBV10-3	TRBJ1-2
TGTGCCAGTAGTCTTAGGAACATTCAGTACTTC	CASSLRNIQYF	TRBV19	TRBJ2-4
TGTGCCAGCAGTGGCCCCGGACAGGGGAACTACGAGCAGTACTTC	CASSGPGQGNYEQYF	TRBV6-1	TRBJ2-7
TGTGCCAGCAGTTTTGCCGTAGTCGGGACAGGGATGGGGGATCAGCCCCAGCATTTT	CASSFAVVGTGMGDQPQHF	TRBV27	TRBJ1-5
TGCAGTGCTAGAGGCAGGACAGGCACTTTATTAGGATCCTATAATTCACCCCTCCACTTT	CSARGRTGTLLGSYNSPLHF	TRBV20-1	TRBJ1-6
TGTGCCACCAGTGATCGACGGAATCAGCCCCAGCATTTT	CATSDRRNQPQHF	TRBV24-1	TRBJ1-5
TGCGCCAGCAGCTTGGCCGGTCCTCCTAGCGGCTCCTACGAGCAGTACTTC	CASSLAGPPSGSYEQYF	TRBV5-1	TRBJ2-7
TGTGCCAGCAACGGACAGGGTGGAGGGAGTTCACCCCTCCACTTT	CASNGQGGGSSPLHF	TRBV27	TRBJ1-6
TGTGCCAGCAGCGGGACAGGGGTTTGCAAAAACATTCAGTACTTC	CASSGTGVCKNIQYF	TRBV3-1	TRBJ2-4
TGTGCCAGCAGCTTAGAAAGTATAGCGGGAGATACGCAGTATTTT	CASSLESIAGDTQYF	TRBV7-2	TRBJ2-3
TGCGCCAGCAGCTCTGGGGACAGGGGCTACGAGCAGTACTTC	CASSSGDRGYEQYF	TRBV5-1	TRBJ2-7
TGTGCCAGCAGTTACTCCCGCCAGGGCGGAAACACCATATATTTT	CASSYSRQGGNTIYF	TRBV6-5	TRBJ1-3
TGCGCCAGCAGCCCGGGGTCGGGCTCTGGAAACACCATATATTTT	CASSPGSGSGNTIYF	TRBV5-1	TRBJ1-3
TGTGCCAGCACACCAAACTCTCGATTAAGGGCAGAGTCCTACAATGAGCAGTTCTTC	CASTPNSRLRAESYNEQFF	TRBV27	TRBJ2-1
TGTGCCACCAGTGAATTAGCAACTGAAGCTTTCTTT	CATSELATEAFF	TRBV24-1	TRBJ1-1
TGTGCTAGCAGCCGGGGACGGTACTCCTACGAGCAGTACTTC	CASSRGRYSYEQYF	TRBV7-7	TRBJ2-7
TGTGCCAGCAGTTATTTCCCTGGGGGAAGCTATGGCTACACCTTC	CASSYFPGGSYGYTF	TRBV6-5	TRBJ1-2
TGTGCCACCAGTGATTTCCGGCAGGGTTACTATGGCTACACCTTC	CATSDFRQGYYGYTF	TRBV24-1	TRBJ1-2
TGTGCCAGTAGTACGGCAGGCCATGCTAACTATGGCTACACCTTC	CASSTAGHANYGYTF	TRBV19	TRBJ1-2
TGTGCCAGCGGCTATGCCAAGCACGGGTACGAGCAGTACTTC	CASGYAKHGYEQYF	TRBV6-1	TRBJ2-7
TGCAGTGCGAGACTAGCGGGGGGGCGGACCTACGAGCAGTACTTC	CSARLAGGRTYEQYF	TRBV20-1	TRBJ2-7
TGCGCCAGCAGCCGGGAGGACGAGCAGTACTTC	CASSREDEQYF	TRBV4-1	TRBJ2-7
TGTGCCAGCAGCTACGATGCCTTTACCTACAATGAGCAGTTCTTC	CASSYDAFTYNEQFF	TRBV7-3	TRBJ2-1
TGTGCCAGCAGTAAGTGGTTAGCTTTCTTT	CASSKWLAFF	TRBV6-2	TRBJ1-1
TGCAGTGCTTCCCTTCCAGGGGGCAGCTCCTATAATTCACCCCTCCACTTT	CSASLPGGSSYNSPLHF	TRBV20-1	TRBJ1-6
TGTGCCATCAAGAGGGGAGCCTCCTACAATGAGCAGTTCTTC	CAIKRGASYNEQFF	TRBV10-3	TRBJ2-1
TGTGCCAGCAGCTTTTTGAAATCAGAGGGGAAATACACTGAAGCTTTCTTT	CASSFLKSEGKYTEAFF	TRBV5-8	TRBJ1-1
TGTGCCAGCAGCTTCGGGGGAGCCCTAGCGTGTGTTTACACCGGGGAGCTGTTTTTT	CASSFGGALACVYTGELFF	TRBV7-3	TRBJ2-2
TGTGCCTGGAGTGTCCTTATTTCGGGCAACACTGAAGCTTTCTTT	CAWSVLISGNTEAFF	TRBV30	TRBJ1-1
TGTGCCAGCAGCTTACGGACTAGCGGGGGGGGGAGCTCCTACAATGAGCAGTTCTTC	CASSLRTSGGGSSYNEQFF	TRBV7-9	TRBJ2-1
TGTGCCAGCAGCCTAAGCACTGAAGCTTTCTTT	CASSLSTEAFF	TRBV6-2	TRBJ1-1
TGTGCCAGCAGTGAATCAGCCAGCGGCTACACCTTC	CASSESASGYTF	TRBV25-1	TRBJ1-2
TGTGCCAGTAGCAGCCTTCCCTACGAGCAGTACTTC	CASSSLPYEQYF	TRBV19	TRBJ2-7
TGTGCCACGCAAGGGGACAGGCGGGACACCGGGGAGCTGTTTTTT	CATQGDRRDTGELFF	TRBV6-1	TRBJ2-2
TGTGCCCCATCGGGGGGCTACACCTTC	CAPSGGYTF	TRBV6-1	TRBJ1-2
TGTGCCACCCGGACAGGGTCACGCAATCAGCCCCAGCATTTT	CATRTGSRNQPQHF	TRBV5-5	TRBJ1-5
TGCGCCAGCCCCAGGGCTCCAAAATATTCACCCCTCCACTTT	CASPRAPKYSPLHF	TRBV4-1	TRBJ1-6
TGTGCCAGCAGTTTAAGGGGGGGGAACAATGAGCAGTTCTTC	CASSLRGGNNEQFF	TRBV12-3	TRBJ2-1
TGTGCCAGTAGTACTCAGCAAGGTGTCACTGAAGCTTTCTTT	CASSTQQGVTEAFF	TRBV19	TRBJ1-1
TGTGCCAGCAGTTTAAAAACGAGCGGCCCCCTCTCGAACACCGGGGAGCTGTTTTTT	CASSLKTSGPLSNTGELFF	TRBV12-4	TRBJ2-2
TGTGCCAGCAGTTACTTCGCCCGACAGGGGCGAGAGACCCAGTACTTC	CASSYFARQGRETQYF	TRBV6-6	TRBJ2-5
TGTGCCAGCAGCCCTAGCGGGGGGGCGGACGAGCAGTACTTC	CASSPSGGADEQYF	TRBV3-1	TRBJ2-7
TGCGCCAGGGACCCCACTAGCACCGGGGAGCTGTTTTTT	CARDPTSTGELFF	TRBV10-1	TRBJ2-2
TGCAGCGTTGGCCCTGGGAGGGACCGCCGACCAGAGCAGTACTTC	CSVGPGRDRRPEQYF	TRBV29-1	TRBJ2-7
TGTGCCAGCAGTCGGGGCCGGGACAGGGGGGGGATGAACACTGAAGCTTTCTTT	CASSRGRDRGGMNTEAFF	TRBV6-1	TRBJ1-1
TGCGCCAGCAGTCAGCGAGGGAATCAGCCCCAGCATTTT	CASSQRGNQPQHF	TRBV10-1	TRBJ1-5
TGTGCCAGCAGTAGTAATTCCTGGGGGACACGTGCCCGTCGGGGGAATTCCTACGAGCAGTACTTC	CASSSNSWGTRARRGNSYEQYF	TRBV2	TRBJ2-7
TGTGCCAGCAGCTTGCGGCCGGGACTAGCGGGAGTTTTGTCCACCGGGGAGCTGTTTTTT	CASSLRPGLAGVLSTGELFF	TRBV5-6	TRBJ2-2
TGTGCCAGGGCCCCCCAGGTCGCGCCTAGCAATCAGCCCCAGCATTTT	CARAPQVAPSNQPQHF	TRBV19	TRBJ1-5
TGTGCCAGCAGCCAGGGTTCCTTC	CASSQGSF	TRBV7-3	TRBJ1-2
TGTGCCAGCAGTGAATCACTGAAGCGGGATACGTACGAGCAGTACTTC	CASSESLKRDTYEQYF	TRBV25-1	TRBJ2-7
TGTGCCAGCAGCCAGACGGACTATGGCTACACCTTC	CASSQTDYGYTF	TRBV4-2	TRBJ1-2
TGCGCCAGCAGCTTGCGCGGGAGGGGTACCTCTGGGGCCAACGTCCTGACTTTC	CASSLRGRGTSGANVLTF	TRBV5-1	TRBJ2-6
TGTGCCAGCAGTTACAGGAAGATATATGACTATGGCTACACCTTC	CASSYRKIYDYGYTF	TRBV6-3	TRBJ1-2
TGTGCCAGTAGTATAGAATTGACACATCGTAAAGCCGGGGAGCTGTTTTTT	CASSIELTHRKAGELFF	TRBV19	TRBJ2-2
TGCAGTGCTAGACCTAAATGTCGTATTCTGAACACCGGGGAGCTGTTTTTT	CSARPKCRILNTGELFF	TRBV20-1	TRBJ2-2
TGTGCCAGCAGCTGTCCAGGGGGCGACTATGGCTACACCTTC	CASSCPGGDYGYTF	TRBV7-3	TRBJ1-2
TGTGCCAGCAGTTTACCCGGCGGGGGACCCCCAGATACGCAGTATTTT	CASSLPGGGPPDTQYF	TRBV12-3	TRBJ2-3
TGTGCCAGCAGTGAAGCGAAACTAGCGGGGGGGCCTGGATTCAATGAGCAGTTCTTC	CASSEAKLAGGPGFNEQFF	TRBV6-1	TRBJ2-1
TGCGCCAGCAAAGTCAATCAGCCCCAGCATTTT	CASKVNQPQHF	TRBV10-1	TRBJ1-5
TGCGCCAGCAGCCACCTAGCGGAAGGAACAGATACGCAGTATTTT	CASSHLAEGTDTQYF	TRBV4-3	TRBJ2-3
TGTGCCAGCAGTTACAAGAGTGAGGGGACGGAGAAGGTCTCCTACGAGCAGTACTTC	CASSYKSEGTEKVSYEQYF	TRBV6-5	TRBJ2-7
TGTGCCAGCTCACCACCCCCGGACTGGGGGAGCAATCAGCCCCAGCATTTT	CASSPPPDWGSNQPQHF	TRBV18	TRBJ1-5
TGCAGCGCGCCGGACCGTGACTACGAGCAGTACTTC	CSAPDRDYEQYF	TRBV29-1	TRBJ2-7
TGTGCCAGCAGCCGTATAGGGCCCCTATCAGATACGCAGTATTTT	CASSRIGPLSDTQYF	TRBV7-3	TRBJ2-3
TGTGCCAGCAGCTTGTGGGGGGCCCGGGTAGAGCAGTACTTC	CASSLWGARVEQYF	TRBV5-4	TRBJ2-7
TGTGCTAGTGGTTTGGACCTGGCGGGCAAAGAGACCCAGTACTTC	CASGLDLAGKETQYF	TRBV12-5	TRBJ2-5
TGTGCCAGCAGCCGCCCGGGACAGGGGCAAGAGACCCAGTACTTC	CASSRPGQGQETQYF	TRBV27	TRBJ2-5
TGCGCCAGCAGCCCCCGACAGGAAGATACGAACACTGAAGCTTTCTTT	CASSPRQEDTNTEAFF	TRBV4-1	TRBJ1-1
TGTGCCAGCAGCGGAGGAAACGGGGGCGAGACCCAGTACTTC	CASSGGNGGETQYF	TRBV7-9	TRBJ2-5
TGTGCCGGACGGACGATACCGGGAGGATGCCCCTCTGGAAACACCATATATTTT	CAGRTIPGGCPSGNTIYF	TRBV24-1	TRBJ1-3
TGCAGTGCTCCCAACGGAGGGGGGGAGTCGGGTCAGCCCCAGCATTTT	CSAPNGGGESGQPQHF	TRBV20-1	TRBJ1-5
TGTGCCAGCAGCTTAGGGGACGCATACAATGAGCAGTTCTTC	CASSLGDAYNEQFF	TRBV11-2	TRBJ2-1
TGTGCCAGCACCTACGGTCGCGGACTAGCGGGGGGCACAGATACGCAGTATTTT	CASTYGRGLAGGTDTQYF	TRBV9	TRBJ2-3
TGCGCCAGCAGCTGTCCTCCCAACAGGGGTTATCAGCCCCAGCATTTT	CASSCPPNRGYQPQHF	TRBV5-1	TRBJ1-5
TGCGCCAGCAGCTTGGTGACCCGCGACAGAGTTCGGAGCAATCAGCCCCAGCATTTT	CASSLVTRDRVRSNQPQHF	TRBV5-1	TRBJ1-5
TGTGCCAGCAGTGACAACAGGGGGCTGAACTCCTACAATGAGCAGTTCTTC	CASSDNRGLNSYNEQFF	TRBV6-4	TRBJ2-1
TGCAGCGTACAGGGTTTAGGCTACACCTTC	CSVQGLGYTF	TRBV29-1	TRBJ1-2
TGTGCCAGCAGCCAAGGCAGCGGGGGTATTTCGGGTCATCCTGACGAGCAGTACTTC	CASSQGSGGISGHPDEQYF	TRBV3-1	TRBJ2-7
TGCAGTGCTAGAGATGAGTCAGGGTATAGACTAGCGATCACAGATACGCAGTATTTT	CSARDESGYRLAITDTQYF	TRBV20-1	TRBJ2-3
TGTGCCACCAGGGAGCCGGGGCACCTATTCATGAACACTGAAGCTTTCTTT	CATREPGHLFMNTEAFF	TRBV24-1	TRBJ1-1
TGTGCCAGCAGCTTAGAGAGACAGGGGACTGAAGCTTTCTTT	CASSLERQGTEAFF	TRBV11-3	TRBJ1-1
TGTGCCAGCAGCTTAGGAACTTCTGGGTCGCTAGCGGGAGTCTACAATGAGCAGTTCTTC	CASSLGTSGSLAGVYNEQFF	TRBV11-3	TRBJ2-1
TGTGCCAGCAGTGACCCCTCTATCAATCAGCCCCAGCATTTT	CASSDPSINQPQHF	TRBV6-1	TRBJ1-5
TGCAGTGCTCAACCGGGACTAGCGGGAGAGTACTTC	CSAQPGLAGEYF	TRBV20-1	TRBJ2-7
TGTGCCAGCAGCGGGCGGAGGACAGGCTCTGGGGCCAACGTCCTGACTTTC	CASSGRRTGSGANVLTF	TRBV11-2	TRBJ2-6
TGTGCCAGCAGCTTCCCAACAACACTATATGGCTACACCTTC	CASSFPTTLYGYTF	TRBV5-4	TRBJ1-2
TGTGCCGCGGGATTAGAGGTCGCCGAGCAGTACTTC	CAAGLEVAEQYF	TRBV28	TRBJ2-7
TGCATATTCTGGAAGAGCGGTAGCACAGATACGCAGTATTTT	CIFWKSGSTDTQYF	TRBV20-1	TRBJ2-3
TGCAGCGTTGCCGTTAAGTCCTTTCAAGAGACCCAGTACTTC	CSVAVKSFQETQYF	TRBV29-1	TRBJ2-5
TGTGCCAGCAGCTTCACAGGGACAAGATTGTCTGAAGCTTTCTTT	CASSFTGTRLSEAFF	TRBV7-9	TRBJ1-1
TGTGCCACCAGTGATTTGTCCTTCCCCAGGGACAGGGGCGAAGAGACCCAGTACTTC	CATSDLSFPRDRGEETQYF	TRBV24-1	TRBJ2-5
TGTGCCTCGGGACAGGGTGGCTACACCTTC	CASGQGGYTF	TRBV6-2	TRBJ1-2
TGTGCCCGAATCAACCTAATCGGAGGTTCACCCTACGAGCAGTACTTC	CARINLIGGSPYEQYF	TRBV11-2	TRBJ2-7
TGCGCCAGCAGCTTAAAGGGACGGAGATACGAGCAGTACTTC	CASSLKGRRYEQYF	TRBV5-1	TRBJ2-7
TGCAGCGTTTTGGGTAGTTGTATCACAGATACGCAGTATTTT	CSVLGSCITDTQYF	TRBV29-1	TRBJ2-3
TGTGCCAGCAACCCCGGACATGAGCAGTTCTTC	CASNPGHEQFF	TRBV7-9	TRBJ2-1
TGCAGTGCCTTAGAAGAGAATACCGGGGAGCTGTTTTTT	CSALEENTGELFF	TRBV20-1	TRBJ2-2
TGTGCCACCAGTGATTTTGGATACCTCACAGAGAACACTGAAGCTTTCTTT	CATSDFGYLTENTEAFF	TRBV24-1	TRBJ1-1
TGTGCCAGCAGTTTAAGCGGCAGCGGGCACGAGCAGTACTTC	CASSLSGSGHEQYF	TRBV28	TRBJ2-7
TGTGCCAGCAGCTTACGGGATGGGGGCCACGATACGCAGTATTTT	CASSLRDGGHDTQYF	TRBV7-6	TRBJ2-3
TGTGCCAGCAGCTGGGTGCAGGGGCAGCAAGAGACCCAGTACTTC	CASSWVQGQQETQYF	TRBV7-2	TRBJ2-5
TGTGCCGGACCAGATACGCAGTATTTT	CAGPDTQYF	TRBV7-8	TRBJ2-3
TGTGCCAGCCCCACAGTTCCCGGGGCCTACGAGCAGTACTTC	CASPTVPGAYEQYF	TRBV12-4	TRBJ2-7
TGTGCCAGCAGCTTTTCATACAGGGCGGAACTCACCGGGGAGCTGTTTTTT	CASSFSYRAELTGELFF	TRBV7-3	TRBJ2-2
TGTGCCAGCAGTTTATATCCCGTGACCCAGTACTTC	CASSLYPVTQYF	TRBV28	TRBJ2-5
TGCGCCAGCAGCGATGCCCGAAGGCGACGGCGACAGCCCCAGCATTTT	CASSDARRRRRQPQHF	TRBV5-1	TRBJ1-5
TGCGCCAGCAGCCGACAAGGGGACAGGGGGAATGAGCAGTTCTTC	CASSRQGDRGNEQFF	TRBV5-1	TRBJ2-1
TGTGCCAGCAGCTTAGATTGCGGAGGTCTAGGACACTACGAGCAGTACTTC	CASSLDCGGLGHYEQYF	TRBV11-3	TRBJ2-7
TGTGCCAGTAGTATGGACGGGACGAATTCTGGAAACACCATATATTTT	CASSMDGTNSGNTIYF	TRBV19	TRBJ1-3
TGTGCCAGCAGCCAGGCGTTAGCTCCCTCATTAGGGCCTGGCTACGAGCAGTACTTC	CASSQALAPSLGPGYEQYF	TRBV7-8	TRBJ2-7
TGTGCCAGCAGCCACCCACTAGCGGGAGGCTCCTACAATGAGCAGTTCTTC	CASSHPLAGGSYNEQFF	TRBV9	TRBJ2-1
TGTGCCACCAGTGATTGGGCCTCAGGGTATGTACTGTACTTC	CATSDWASGYVLYF	TRBV24-1	TRBJ2-7
TGTGCCAGCAGCTTACAGCCGGGGGGGGGAGTTCTCAATGAGCAGTTCTTC	CASSLQPGGGVLNEQFF	TRBV7-3	TRBJ2-1
TGTGCTAGTGGTTTTCTCTCTTCCTACGAGCAGTACTTC	CASGFLSSYEQYF	TRBV12-5	TRBJ2-7
TGCAGTGCTCGGAAAAAGCCGGGGACCGGGGAGCTGTTTTTT	CSARKKPGTGELFF	TRBV20-1	TRBJ2-2
TGTGCCAGCAGCTTTTCTGTAGAGTCGTCCGAGCAGTACTTC	CASSFSVESSEQYF	TRBV5-4	TRBJ2-7
TGTGCCATCAGTCAAGAACTATCTCGATACACTGAAGCTTTCTTT	CAISQELSRYTEAFF	TRBV10-3	TRBJ1-1
TGTGCCAGCAGTTTCCGGACTAGCGGGACTTCCCACAATGAGCAGTTCTTC	CASSFRTSGTSHNEQFF	TRBV6-6	TRBJ2-1
TGCGCCAGCAGTGAAGGGGGGGGCGGGGGGAGCTCTGGAAACACCATATATTTT	CASSEGGGGGSSGNTIYF	TRBV10-1	TRBJ1-3
TGCGCCAGCAGCTGGGGACAGGGGTCACGGGGATATGGCTACACCTTC	CASSWGQGSRGYGYTF	TRBV5-1	TRBJ1-2
TGTGCCACCAGTTTTGGGACAGGGTCAAACGAGCAGTACTTC	CATSFGTGSNEQYF	TRBV24-1	TRBJ2-7
TGTGCCAGCAGGCGACCAGCAAATGAAAAACTGTTTTTT	CASRRPANEKLFF	TRBV6-5	TRBJ1-4
TGTGCCAGCAGCATATTCGGGGTCGGTGCCCCCGGGGAGACCCAGTACTTC	CASSIFGVGAPGETQYF	TRBV13	TRBJ2-5
TGCGCCAGTCCGGGACAGACCAAAAACATTCAGTACTTC	CASPGQTKNIQYF	TRBV10-1	TRBJ2-4
TGTGCCAGCAGCTTATTATTACGCCCCCTAGCGACAGGCGCCAACGTCCTGACTTTC	CASSLLLRPLATGANVLTF	TRBV7-2	TRBJ2-6
TGCGCCAGCAGCTTGCCCCCGGGACAGGGGGCATGCCCGAACACTGAAGCTTTCTTT	CASSLPPGQGACPNTEAFF	TRBV5-1	TRBJ1-1
TGTGCCAGCAGCCCCACAGGGCCTCAGCCCCAGCATTTT	CASSPTGPQPQHF	TRBV5-6	TRBJ1-5
TGCGCCAGCAGCTATAGTCTTCCGACAGGCCTTACCGGGGAGCTGTTTTTT	CASSYSLPTGLTGELFF	TRBV5-1	TRBJ2-2
TGTGCCAGCAGCGGGGATCCCCCATCCACTAGCGGGAGTGTGAAAGAGACCCAGTACTTC	CASSGDPPSTSGSVKETQYF	TRBV7-3	TRBJ2-5
TGTGCCAGCAGCCCCCGAATACAGGGGGGGCGCTCCTATAATTCACCCCTCCACTTT	CASSPRIQGGRSYNSPLHF	TRBV7-2	TRBJ1-6
TGTGCCAGCAGTTACTCGACGAGTCCGGGACAGGGGGTAGGGAACACTGAAGCTTTCTTT	CASSYSTSPGQGVGNTEAFF	TRBV6-6	TRBJ1-1
TGCGCCAGCAGCCAAGGTGGGGTCCTCTCCTACGAGCAGTACTTC	CASSQGGVLSYEQYF	TRBV4-3	TRBJ2-7
TGTGCCAGCAGCTTAGATGAAACGGTCCAGACCCAGTACTTC	CASSLDETVQTQYF	TRBV11-3	TRBJ2-5
TGTGCCAGCAGTTCTTCGGGACAGCCCTACAATGAGCAGTTCTTC	CASSSSGQPYNEQFF	TRBV12-3	TRBJ2-1
TGTGCCAGCAGCCAGCGGGGACAGGGTCGGTATGGCTACACCTTC	CASSQRGQGRYGYTF	TRBV14	TRBJ1-2
TGTGCCAGCAGGGACAGCAACAACACTGAAGCTTTCTTT	CASRDSNNTEAFF	TRBV6-4	TRBJ1-1
TGTGCCAGCTCACCCCTCACCAGGAATGAGCAGTTCTTC	CASSPLTRNEQFF	TRBV18	TRBJ2-1
TGTGCCAGCAGTTACCCCCCAGGGCGTAACTATGGCTACACCTTC	CASSYPPGRNYGYTF	TRBV6-6	TRBJ1-2
TGTGCCAGCAGTGATTTCGGGGGGGCAGACAATGAGCAGTTCTTC	CASSDFGGADNEQFF	TRBV2	TRBJ2-1
TGTGCCATCATTGTCACCCCAGTCCGGGACAGGGGATTGTACGAGCAGTACTTC	CAIIVTPVRDRGLYEQYF	TRBV10-3	TRBJ2-7
TGTGCCAGCAGCGAGCGTACAGATACGCAGTATTTT	CASSERTDTQYF	TRBV7-3	TRBJ2-3
TGCGCCAGCAGCAGGGGTCCGGGGAACACTGAAGCTTTCTTT	CASSRGPGNTEAFF	TRBV5-1	TRBJ1-1
TGTGCCAGCAGTAGACCGCCTAGGTTGACTAGCGGCAATGCCTACAATGAGCAGTTCTTC	CASSRPPRLTSGNAYNEQFF	TRBV28	TRBJ2-1
TGTGCCAGCAGCGGAGGGCCAGGGGGCGCCTACTACGAGCAGTACTTC	CASSGGPGGAYYEQYF	TRBV13	TRBJ2-7
TGTGCCAGCAGCCTAGGGAGGGGAATCAATGAGCAGTTCTTC	CASSLGRGINEQFF	TRBV5-6	TRBJ2-1
TGTGCCAGCAGCTCAAACAGGAGCTACGAGCAGTACTTC	CASSSNRSYEQYF	TRBV7-3	TRBJ2-7
TGTGCCAGCAGCTTACCGGAGGAGTACGAGCAGTACTTC	CASSLPEEYEQYF	TRBV7-2	TRBJ2-7
TGCAGTGCTTGCCTAGGACAGGACGAGCAGTACTTC	CSACLGQDEQYF	TRBV20-1	TRBJ2-7
TGTGCCAGCAGTGGCACACCCAGGGAGTTAGCTTACTATGGCTACACCTTC	CASSGTPRELAYYGYTF	TRBV6-1	TRBJ1-2
TGTGCCAGCAGCTGGGGAGTGAGGGTTATCGGAAACACCATATATTTT	CASSWGVRVIGNTIYF	TRBV7-9	TRBJ1-3
TGTGCCAGCAGCCAGGGACAGGGACTCAATCAGCCCCAGCATTTT	CASSQGQGLNQPQHF	TRBV14	TRBJ1-5
TGTGCCAGTAGTATGGATAAAGGGGCGAACACTGAAGCTTTCTTT	CASSMDKGANTEAFF	TRBV19	TRBJ1-1
TGTGCCAGCAGCCAAGCCAGGGCCTTGGCTTTTGCCTACGAGCAGTACTTC	CASSQARALAFAYEQYF	TRBV7-9	TRBJ2-7
TGTGCCAGCAGTTTCTCCGGGACGCAGACCATTCAGTACTTC	CASSFSGTQTIQYF	TRBV28	TRBJ2-4
TGTGCCAGCAGCCCCTACACTGAAGCTTTCTTT	CASSPYTEAFF	TRBV9	TRBJ1-1
TGCGCCAGCCGGGGGGGACCCAACACCGGGGAGCTGTTTTTT	CASRGGPNTGELFF	TRBV10-1	TRBJ2-2
TGTGCCAGCAGCCAAGAGGGGATTGAGGTAGAGACCCAGTACTTC	CASSQEGIEVETQYF	TRBV3-1	TRBJ2-5
TGTGCCAAGTACCTAGCGGGGGTGTATTTT	CAKYLAGVYF	TRBV24-1	TRBJ2-3
TGTGCCAGCAGGAGACATAGCAATCAGCCCCAGCATTTT	CASRRHSNQPQHF	TRBV7-3	TRBJ1-5
TGTGCCAGCAGCTTGGTCGAGGACGATGAGCAGTTCTTC	CASSLVEDDEQFF	TRBV5-4	TRBJ2-1
TGTGCCACCAGTGCCCTAAGGGACCGGTCCAAAAACATTCAGTACTTC	CATSALRDRSKNIQYF	TRBV24-1	TRBJ2-4
TGCGCCAGCAGCCAGCGTTGGTCCACAGGACAGGGACTGGGTGAAGGCCCCTACGAGCAGTACTTC	CASSQRWSTGQGLGEGPYEQYF	TRBV4-1	TRBJ2-7
TGTGCCACCAGTGATTTTAAGCGGGAGGGCTATGGCTACACCTTC	CATSDFKREGYGYTF	TRBV24-1	TRBJ1-2
TGCGCCAGCAGTGCAGGGGTGGAAGGCTCGACAGATACGCAGTATTTT	CASSAGVEGSTDTQYF	TRBV10-1	TRBJ2-3
TGCCTATGCGCCCAGCGGGTTTCCCGCTCCTACGAGCAGTACTTC	CLCAQRVSRSYEQYF	TRBV20-1	TRBJ2-7
TGTGCTAGCAAACCGACCATCGAATATGGAAACACCATATATTTT	CASKPTIEYGNTIYF	TRBV7-7	TRBJ1-3
TGTGCCAGCAGGGGTGGGGAAGGGATGAACACTGAAGCTTTCTTT	CASRGGEGMNTEAFF	TRBV6-1	TRBJ1-1
TGTGCCAGCAGCGCTGGGAGGGAATCCGCCGGGGAGCTGTTTTTT	CASSAGRESAGELFF	TRBV5-6	TRBJ2-2
TGTGCCAGCAGCTTAACCCTTCCCCTAGCGGGGTTCGAGACCCAGTACTTC	CASSLTLPLAGFETQYF	TRBV11-1	TRBJ2-5
TGTGCCAGCAGCTTAGCGTTTCAGGGGGCATACGGCGAGCAGTACTTC	CASSLAFQGAYGEQYF	TRBV11-2	TRBJ2-7
TGCAGCGTTGAAGCCCCTAAACTCCTCAAACATGACAGCGGCAATCAGCCCCAGCATTTT	CSVEAPKLLKHDSGNQPQHF	TRBV29-1	TRBJ1-5
TGTGCCACTGGGCCAGAACCACCGTGGGACTATAATTCACCCCTCCACTTT	CATGPEPPWDYNSPLHF	TRBV19	TRBJ1-6
TGTGCCAGCAGCTCAGGCGGGAGAGTACAGGAGGGAGGGGAGTACTTC	CASSSGGRVQEGGEYF	TRBV11-2	TRBJ2-7
TGTGCCAGCAGCTTACAGGCCGAGTTCAAACAAGGGGGTGAAGCTTTCTTT	CASSLQAEFKQGGEAFF	TRBV5-4	TRBJ1-1
TGCAGTGCTAAAAAGTGGGGGGAGCAGTACTTC	CSAKKWGEQYF	TRBV20-1	TRBJ2-7
TGTGCCAGCAGACAAATTAGTAAGCGGGACCCCTACAATGAGCAGTTCTTC	CASRQISKRDPYNEQFF	TRBV7-3	TRBJ2-1
TGTGCCACCGGGGGGGCGGCCGATGGCTACACCTTC	CATGGAADGYTF	TRBV24-1	TRBJ1-2
TGTGCCAGCAGTTTATTGGCGGGAGAGAGGGGGGAGCAGTACTTC	CASSLLAGERGEQYF	TRBV27	TRBJ2-7
TGCGCCAGCAGCGGGGGCGCCCGGGCTGAAGCTTTCTTT	CASSGGARAEAFF	TRBV5-1	TRBJ1-1
TGTGCCAGCAGTCGCCGGGAGGGAGGCCCTGGACTGTCTCAGCCCCAGCATTTT	CASSRREGGPGLSQPQHF	TRBV6-2	TRBJ1-5
TGTGCCAGCAGCTGGTGGCAGGGCGCCTCCTACGAGCAGTACTTC	CASSWWQGASYEQYF	TRBV5-4	TRBJ2-7
TGTGCCAGCCAGATATACAATGAGCAGTTCTTC	CASQIYNEQFF	TRBV6-1	TRBJ2-1
TGTGCCAGCAGCTTGTCAGGGCTAGGGGGACTAGCGGGGAATCCAGATACGCAGTATTTT	CASSLSGLGGLAGNPDTQYF	TRBV7-9	TRBJ2-3
TGTGCCATCAGTGAGTGCCTAAGGGAGCAGTACTTC	CAISECLREQYF	TRBV10-3	TRBJ2-7
TGTGCCACGGGCGGCGACACTGAAGCTTTCTTT	CATGGDTEAFF	TRBV6-4	TRBJ1-1
TGTGCCAGCAGGGGCAATCCGCCTGGCAGGGGGGTTCTGCCCCAGCATTTT	CASRGNPPGRGVLPQHF	TRBV9	TRBJ1-5
TGCAGTGACGGGACTCCCATCAGCTACGAGCAGTACTTC	CSDGTPISYEQYF	TRBV20-1	TRBJ2-7
TGTGCCATCAGTGGGCTGGACGGGGTACTGAGCTACACCTTC	CAISGLDGVLSYTF	TRBV10-3	TRBJ1-2
TGTGCCAGCAGCGTAGACCCTTTAGATGGCTACACCTTC	CASSVDPLDGYTF	TRBV9	TRBJ1-2
TGTGCCAGCAGCTTACAGTACGACGACACAGGGGGCGTAGGGATATCCGAAAGCTCCTACGAGCAGTACTTC	CASSLQYDDTGGVGISESSYEQYF	TRBV7-3	TRBJ2-7
TGTGCCAGCAGCGGTAGGGGGGCCGGTAATAGGAATGAGCAGTTCTTC	CASSGRGAGNRNEQFF	TRBV5-6	TRBJ2-1
TGTGCCAGCAGCTTAGTTACCTACGAGCAGTACTTC	CASSLVTYEQYF	TRBV7-4	TRBJ2-7
TGTGCCAGCAGTTATACGATATTTAGCTGGGGCGTAGGGGAGTATAGCAATCAGCCCCAGCATTTT	CASSYTIFSWGVGEYSNQPQHF	TRBV6-5	TRBJ1-5
TGTGCCAGCAGCCCTGTGGGGGGCCCCGAGCAGTACTTC	CASSPVGGPEQYF	TRBV11-2	TRBJ2-7
TGTGCCAGCAGCAAAATACTAGTTACGAATGAGCAGTTCTTC	CASSKILVTNEQFF	TRBV5-5	TRBJ2-1
TGTGCCAGCAGCGTAGGCTCCCACCTAATTTACAATGAGCAGTTCTTC	CASSVGSHLIYNEQFF	TRBV9	TRBJ2-1
TGTGCCAGCAGTTACGGAGAACCGGGACAGGCGAACACTGAAGCTTTCTTT	CASSYGEPGQANTEAFF	TRBV6-2	TRBJ1-1
TGTGCCAGCAGTGGGGGGGTACAGGGCCTAACTAACTATGGCTACACCTTC	CASSGGVQGLTNYGYTF	TRBV5-6	TRBJ1-2
TGTGCCAGCAGCGGGGAGGGGAGTGGCTACACCTTC	CASSGEGSGYTF	TRBV11-3	TRBJ1-2
TGCAGTGCTAGATCCCCGGAGGCTCAGCCCCAGCATTTT	CSARSPEAQPQHF	TRBV20-1	TRBJ1-5
TGCAGCGTTGTCTTCTCCAGTGTTTATGGCTACACCTTC	CSVVFSSVYGYTF	TRBV29-1	TRBJ1-2
TGTGCCAGCAGTCCATGGGGTTCAGGCCGTGGCAATCAGCCCCAGCATTTT	CASSPWGSGRGNQPQHF	TRBV6-4	TRBJ1-5
TGCAGCGTTGCTGCCATATGGAGTGAAGCTTTCTTT	CSVAAIWSEAFF	TRBV29-1	TRBJ1-1
TGCGCCAGCAGCCAAGATAATGAAAGTCGGGAAGGCGAATTGGGTGCCTATGGCTACACCTTC	CASSQDNESREGELGAYGYTF	TRBV4-3	TRBJ1-2
TGTGCCAGCAGCAGCGGACTCTCCCTGCGGGACGACAGTGAAGCTTTCTTT	CASSSGLSLRDDSEAFF	TRBV7-3	TRBJ1-1
TGTGCCAGCAGTTGGCGACGCCGGGGTTCTCAGGAAAAACTGTTTTTT	CASSWRRRGSQEKLFF	TRBV6-9	TRBJ1-4
TGTGCCAGCAGTCCAGGGCGGCGACCACAGGGGGATGGGGCCAACGTCCTGACTTTC	CASSPGRRPQGDGANVLTF	TRBV2	TRBJ2-6
TGCGCCAGCAGCAAGGACGAGGGGGCTGGCTACGAGCAGTACTTC	CASSKDEGAGYEQYF	TRBV5-1	TRBJ2-7
TGCGCCAGCAGCAAAAACAGGGGAAGTTCCTACGAGCAGTACTTC	CASSKNRGSSYEQYF	TRBV5-1	TRBJ2-7
TGTGCCAGCATCACGGGGGCCCACCGGGGCACAGATACGCAGTATTTT	CASITGAHRGTDTQYF	TRBV7-6	TRBJ2-3
TGTGCCAGTAGTATGGAGCCCTGGAGGGAAACTTCCGGGGAGCTGTTTTTT	CASSMEPWRETSGELFF	TRBV19	TRBJ2-2
TGTGCCAGCAGCGGGCGCGACAGGGTTGAAGACTATGGCTACACCTTC	CASSGRDRVEDYGYTF	TRBV13	TRBJ1-2
TGTGCCAGCAGCCAAACTGGGGGACAGGACTTGGTCACAGATACGCAGTATTTT	CASSQTGGQDLVTDTQYF	TRBV4-2	TRBJ2-3
TGCGCCAGCAGCCGACAGGGGCTCACCTACGAGCAGTACTTC	CASSRQGLTYEQYF	TRBV5-1	TRBJ2-7
TGTGCCAGCAGTACCACGTACGAGCAGTACTTC	CASSTTYEQYF	TRBV12-3	TRBJ2-7
TGTGCCAGCAGTTCGGGACTAGCGTGGAACACCGGGGAGCTGTTTTTT	CASSSGLAWNTGELFF	TRBV12-4	TRBJ2-2
TGTGCCACCAGTGATGGGACAGGTATAGAGGTGACGAAGAAGACCGGGGAGCTGTTTTTT	CATSDGTGIEVTKKTGELFF	TRBV24-1	TRBJ2-2
TGCGCCAGCAGGTGGGACAGTCCGAACACCGGGGAGCTGTTTTTT	CASRWDSPNTGELFF	TRBV5-1	TRBJ2-2
TGTGCCAGCAGCTTACTAAACAGGGGGCGGGGGGGTTATCAGCCCCAGCATTTT	CASSLLNRGRGGYQPQHF	TRBV7-2	TRBJ1-5
TGTGCCAGCAGCTTATTCCGACAGTGTGAGCAGTTCTTC	CASSLFRQCEQFF	TRBV7-9	TRBJ2-1
TGTGCCAGCAGCGACAGGTCACCCCTCCACTTT	CASSDRSPLHF	TRBV9	TRBJ1-6
TGTGCCATCAGTGAGTCGGGGCCCGGGACAGGGGCCCCCCGAAACACCATATATTTT	CAISESGPGTGAPRNTIYF	TRBV10-3	TRBJ1-3
TGCAGTGCTAGGAAGGGGAGGCACTCCTACGAGCAGTACTTC	CSARKGRHSYEQYF	TRBV20-1	TRBJ2-7
TGTGCCACCAGCAGAGAAAAGGACCACGACACTGAAGCTTTCTTT	CATSREKDHDTEAFF	TRBV15	TRBJ1-1
TGTGCCAGCAGCTTTCTGGGGGCCATGGCTAGCAATCAGCCCCAGCATTTT	CASSFLGAMASNQPQHF	TRBV13	TRBJ1-5
TGTGCCAGCAGTTACCGGGGGGGGCCCGATCAGCCCCAGCATTTT	CASSYRGGPDQPQHF	TRBV6-5	TRBJ1-5
TGTGCCAGCAGCCGACCGTTTGGACTAGCGGGTTGGTACTCACAAGAGACCCAGTACTTC	CASSRPFGLAGWYSQETQYF	TRBV9	TRBJ2-5
TGTGCCAGCAGTTTACGGGGAGCGGGGGGGGGCTACAATGAGCAGTTCTTC	CASSLRGAGGGYNEQFF	TRBV27	TRBJ2-1
TGTGCCAGCAGTTCCCTTTCCTCGACAGGGCCGATTTACGAGCAGTACTTC	CASSSLSSTGPIYEQYF	TRBV27	TRBJ2-7
TGTGCCAGCAGCCAAGATCCGTGGGGGACGTATGAGTACGAGCAGTACTTC	CASSQDPWGTYEYEQYF	TRBV3-1	TRBJ2-7
TGTGCCTGGAGGGGAGGGAAAAACCTAGGAATGGCTAGGTTCACTGAAGCTTTCTTT	CAWRGGKNLGMARFTEAFF	TRBV30	TRBJ1-1
TGTGCCAGCAGCTTATCCAGGGACAGACACGAGCAGTACTTC	CASSLSRDRHEQYF	TRBV7-3	TRBJ2-7
TGTGCCAGCAGTGTAGTCCTGGGACAGGGGGTGGCAATCACAGATACGCAGTATTTT	CASSVVLGQGVAITDTQYF	TRBV6-1	TRBJ2-3
TGTGCCAGCAGCGATCTGGAGGCGAGGGGGTATGGCTACACCTTC	CASSDLEARGYGYTF	TRBV9	TRBJ1-2
TGCGCCAGCAGCTTGGGTAGCGGGGAACCATCTGGGGCCAACGTCCTGACTTTC	CASSLGSGEPSGANVLTF	TRBV5-1	TRBJ2-6
TGTGCCAGCAGCACCGGGACCTCCTACAATGAGCAGTTCTTC	CASSTGTSYNEQFF	TRBV7-9	TRBJ2-1
TGTGCCAAGGCGGAGCAGTACTTC	CAKAEQYF	TRBV6-6	TRBJ2-7
TGCGCCAGCACTTGTTGCTACGAGCAGTACTTC	CASTCCYEQYF	TRBV4-1	TRBJ2-7
TGCGCCAGCAGCTTTACCAAATGGACAGGGAGCTCCTACAATGAGCAGTTCTTC	CASSFTKWTGSSYNEQFF	TRBV5-1	TRBJ2-1
TGCGCCAGCAGCCAGTGGCCCGGGACAACCTACGAGCAGTACTTC	CASSQWPGTTYEQYF	TRBV4-1	TRBJ2-7
TGTGCCAGCAGCCAAGAGAAAGGCACAGATACGCAGTATTTT	CASSQEKGTDTQYF	TRBV4-2	TRBJ2-3
TGTGCCAGCAGGGGGGACAGGAAGGACGGTAATGAAAAACTGTTTTTT	CASRGDRKDGNEKLFF	TRBV6-5	TRBJ1-4
TGTGCCATCAGTGGAGCATCTCGCACTCACTATAGCAATCAGCCCCAGCATTTT	CAISGASRTHYSNQPQHF	TRBV10-3	TRBJ1-5
TGTGCCAGCTTTGGGCTGGAGAACACTGAAGCTTTCTTT	CASFGLENTEAFF	TRBV27	TRBJ1-1
TGTGCCAGCAGCACCGGACAGGGGGCGCCTCAGAGCTCCTACGAGCAGTACTTC	CASSTGQGAPQSSYEQYF	TRBV6-2	TRBJ2-7
TGTGCCACCATCCACGAGGGGACCGAGCAGTACTTC	CATIHEGTEQYF	TRBV24-1	TRBJ2-7
TGTGCCAGCAGCTTAAAGGTAGGTATCGAACCCCCCCAGCCCCAGCATTTT	CASSLKVGIEPPQPQHF	TRBV7-3	TRBJ1-5
TGTGCCAGTAGTAAGGAGGGGGAAGAGACCCAGTACTTC	CASSKEGEETQYF	TRBV19	TRBJ2-5
TGTGCCAGCAGCTTACTGAGGGCCCTTAACGCCTACGAGCAGTACTTC	CASSLLRALNAYEQYF	TRBV7-3	TRBJ2-7
TGTGCCAGCAGTTTAGCCGACAGGTTTCTCTCCTACGAGCAGTACTTC	CASSLADRFLSYEQYF	TRBV27	TRBJ2-7
TGTGCCAGCAGTTACTCGACGGGGGGGTCCTACAATGAGCAGTTCTTC	CASSYSTGGSYNEQFF	TRBV6-5	TRBJ2-1
TGTGCCAGCAGCCAAGCTAGCCCAAACCAACAGGAGAATTCACCCCTCCACTTT	CASSQASPNQQENSPLHF	TRBV14	TRBJ1-6
TGTGCCAGCAGTTACTCGACGTTTTTAGGGGGGCTCGAGCAGTACTTC	CASSYSTFLGGLEQYF	TRBV6-5	TRBJ2-7
TGTGCCAGCAGCTTATCCCAGGGACGAAGGAACTATGGCTACACCTTC	CASSLSQGRRNYGYTF	TRBV5-6	TRBJ1-2
TGTGCCAGCAGCCAAACCCGTAGACAGGGGGACAATGAGCAGTTCTTC	CASSQTRRQGDNEQFF	TRBV14	TRBJ2-1
TGCGCCAGCAGCTTGGCCCCGGGACTAGCGGGGAGCTACAATGAGCAGTTCTTC	CASSLAPGLAGSYNEQFF	TRBV5-1	TRBJ2-1
TGTGCTAGTGGTTTAGTTCCGGGACCTGAAGCTTTCTTT	CASGLVPGPEAFF	TRBV12-5	TRBJ1-1
TGTGCCACCAGTGCCGTAGCGGGGGACAATGAGCAGTTCTTC	CATSAVAGDNEQFF	TRBV24-1	TRBJ2-1
TGTGCCAGCAGTTACCTTCCTCAGGGAGAGGCCAGACTAGCAGGTTATAGCAATCAGCCCCAGCATTTT	CASSYLPQGEARLAGYSNQPQHF	TRBV6-5	TRBJ1-5
TGTGCCAGCAGCTTAAGACCACAGGGTAATGAGCAGTTCTTC	CASSLRPQGNEQFF	TRBV7-9	TRBJ2-1
TGTGCCACCAGTGACGGGGACAACTGGACCAATGAGCAGTTCTTC	CATSDGDNWTNEQFF	TRBV24-1	TRBJ2-1
TGTGCCCTCGACGCGCGGGGGAATGAGCAGTTCTTC	CALDARGNEQFF	TRBV6-5	TRBJ2-1
TGTGCCAGCAGCCAGACTAGCGGGGGGGAGCAGGACTGGTACAATGAGCAGTTCTTC	CASSQTSGGEQDWYNEQFF	TRBV14	TRBJ2-1
TGTGCCAGCAGTCTCTGGCGCACAGATACGCAGTATTTT	CASSLWRTDTQYF	TRBV27	TRBJ2-3
TGCGCCAGCAGCTTGTCTAATGGGACAGGGGGCTGTGACCGGAGGCAGCCCCAGCATTTT	CASSLSNGTGGCDRRQPQHF	TRBV5-1	TRBJ1-5
TGTGCCAGCAGCGGCCAGCTCTATGGCTACACCTTC	CASSGQLYGYTF	TRBV7-3	TRBJ1-2
TGTGCCAGCAGTTTACAGGGGGAGTCCTACGAGCAGTACTTC	CASSLQGESYEQYF	TRBV12-3	TRBJ2-7
TGTGCCAGCAGTTACCCACACTTCCATGGCTACACCTTC	CASSYPHFHGYTF	TRBV5-4	TRBJ1-2
TGTGCCAGCAGCGGACTAGCGGGGTCTTACGAGCAGTACTTC	CASSGLAGSYEQYF	TRBV27	TRBJ2-7
TGTGCCAGCAGCACAGGAGATAGCAATCAGCCCCAGCATTTT	CASSTGDSNQPQHF	TRBV7-4	TRBJ1-5
TGTGCCAGCAGGGGCTCGGGCAGCTCTGGAAACACCATATATTTT	CASRGSGSSGNTIYF	TRBV9	TRBJ1-3
TGTGCCACCAGCAGAGTTGGGGGGGGACAGAGGAGAAACACCATATATTTT	CATSRVGGGQRRNTIYF	TRBV15	TRBJ1-3
TGTGCCAGCAGCTTAGGTCCCACAGGGCGGTACTCCTACGAGCAGTACTTC	CASSLGPTGRYSYEQYF	TRBV11-3	TRBJ2-7
TGTGCCAGCAGCTTGATGATCGCGAACACCGGGGAGCTGTTTTTT	CASSLMIANTGELFF	TRBV7-2	TRBJ2-2
TGTGCCAGCAGCGTAGGGGGACCAGGAGGCTATACCTATGGCTACACCTTC	CASSVGGPGGYTYGYTF	TRBV7-9	TRBJ1-2
TGCAGCGTTGGCGTGACAGCTTATGGCTACACCTTC	CSVGVTAYGYTF	TRBV29-1	TRBJ1-2
TGTGCCAGCAGCACCCCCAGGGGGAGCTGGTGGCAATACGAGCAGTACTTC	CASSTPRGSWWQYEQYF	TRBV5-4	TRBJ2-7
TGCGCCAGCGACCCATCAGGGACCATATACTCCTACAATGAGCAGTTCTTC	CASDPSGTIYSYNEQFF	TRBV5-1	TRBJ2-1
TGTGCCAGCAGCTTAGGGACAGGGGTATGCTTTCCCCCCCAGATGCAGTACTTC	CASSLGTGVCFPPQMQYF	TRBV7-2	TRBJ2-7
TGTGCCAGCAGCGGGGATCCTGCAGGATCCATTTCCTACGAGCAGTACTTC	CASSGDPAGSISYEQYF	TRBV7-4	TRBJ2-7
TGTGCCAGCAGTTTAAGAAGACCGGGACTCGGGGAGCTGTTTTTT	CASSLRRPGLGELFF	TRBV12-3	TRBJ2-2
TGCAGCGTTGAAGCTCTGGACAGGGAAACAGATACGCAGTATTTT	CSVEALDRETDTQYF	TRBV29-1	TRBJ2-3
TGTGCCAGCAGCTTAACTCCTATTGGGGTTTACAATGAGCAGTTCTTC	CASSLTPIGVYNEQFF	TRBV7-9	TRBJ2-1
TGTGCCAGCAGCTTAGCGAAGACCTCGGACAGGGTGTTTCAGCCCCAGCATTTT	CASSLAKTSDRVFQPQHF	TRBV11-1	TRBJ1-5
TGTGCCAGCAGCTACGCTAAATTATTAACAGATACGCAGTATTTT	CASSYAKLLTDTQYF	TRBV5-6	TRBJ2-3
TGTGCCAGCTCACCAAACCATACCTTGGACCCCGAGCAGTTCTTC	CASSPNHTLDPEQFF	TRBV18	TRBJ2-1
TGTGCCAGGGTGAGGGGGGTCATGAACACTGAAGCTTTCTTT	CARVRGVMNTEAFF	TRBV28	TRBJ1-1
TGCGCCAGCAGCCACTACGAGCAGTACTTC	CASSHYEQYF	TRBV4-3	TRBJ2-7
TGTGCCAGCAAGGCCCTCAGACCTAATGAGCAGTTCTTC	CASKALRPNEQFF	TRBV27	TRBJ2-1
TGCAGCGGTCCCCCAGCGGGAGCCGAGCAGTACTTC	CSGPPAGAEQYF	TRBV29-1	TRBJ2-7
TGTGCCAGCAGTTTCGGTACGAATACAGGGGTAGCCGCTAAAGCTTTCTTT	CASSFGTNTGVAAKAFF	TRBV27	TRBJ1-1
TGTGCCAGCAGCCTTTGGGGCAACACCGGGGAGCTGTTTTTT	CASSLWGNTGELFF	TRBV11-3	TRBJ2-2
TGCAGTGCTAAACGGGATGAGGTCTATGGCTACACCTTC	CSAKRDEVYGYTF	TRBV20-1	TRBJ1-2
TGTGCCAGCAGCCGGTTCCAGGGACACGGCAATCAGCCCCAGCATTTT	CASSRFQGHGNQPQHF	TRBV14	TRBJ1-5
TGCAGTGCGGGGACTAGCGGGGGGGGTGAGCAGTTCTTC	CSAGTSGGGEQFF	TRBV20-1	TRBJ2-1
TGTGCCACCAGTGATCCTTCCCGGGACATATTGAACACTGAAGCTTTCTTT	CATSDPSRDILNTEAFF	TRBV24-1	TRBJ1-1
TGTGCCAGCAGTGATGGGACAGGGGGGGGATTACCTTTCCCCTGGAACACCGGGGAGCTGTTTTTT	CASSDGTGGGLPFPWNTGELFF	TRBV6-4	TRBJ2-2
TGTGCCAGCAGCTTATCCCTGGCCAGAGGGAGTTTTTTCTCTGGAAACACCATATATTTT	CASSLSLARGSFFSGNTIYF	TRBV11-2	TRBJ1-3
TGCAGCGCCTTCAGGGGACGCGAAGTTTCCAATGAGCAGTTCTTC	CSAFRGREVSNEQFF	TRBV29-1	TRBJ2-1
TGTGCCAGCAGCTTGGCCCCCCTAACCTACAATGAGCAGTTCTTC	CASSLAPLTYNEQFF	TRBV5-4	TRBJ2-1
TGTGCCAGCAGCCTGACAGGGATCAATCAGCCCCAGCATTTT	CASSLTGINQPQHF	TRBV6-4	TRBJ1-5
TGTGCCAGCAGTTACGGACAGGGACAGGGAAAGAATTCACCCCTCCACTTT	CASSYGQGQGKNSPLHF	TRBV6-6	TRBJ1-6
TGCGCCAGCAGCTGGACAGTCACTGAAGCTTTCTTT	CASSWTVTEAFF	TRBV5-1	TRBJ1-1
TGTGCCACGCCAGGGCATAGAACAGATAACGACACTGAAGCTTTCTTT	CATPGHRTDNDTEAFF	TRBV24-1	TRBJ1-1
TGCAGTGCTAGAGAGGCCCAAGGCAGGGAACCCTACGAGCAGTACTTC	CSAREAQGREPYEQYF	TRBV20-1	TRBJ2-7
TGTGCCATCCGGGGAGGGGAGCTGTTTTTT	CAIRGGELFF	TRBV6-2	TRBJ2-2
TGCGCCAGCAGCCAAGACCCGGAGGAGCAGTTCTTC	CASSQDPEEQFF	TRBV4-1	TRBJ2-1
TGCAGTGCTAGTCGGGTCTTTGGCTCCAGGAACGAGCAGTACTTC	CSASRVFGSRNEQYF	TRBV20-1	TRBJ2-7
TGTGCCAGCAGCTTGGGACAGGGGAGTGGAAACACCATATATTTT	CASSLGQGSGNTIYF	TRBV11-2	TRBJ1-3
TGTGCCAGCAGCATAAGACCCACAAGGGGACACTACGAGCAGTACTTC	CASSIRPTRGHYEQYF	TRBV7-9	TRBJ2-7
TGTGCCAGCAGCCCCCCTACCCCCCGGACTAGCTCCTACGAGCAGTACTTC	CASSPPTPRTSSYEQYF	TRBV7-9	TRBJ2-7
TGTGCCAGCAGCCAACCCGGGACCCGCAATCAGCCCCAGCATTTT	CASSQPGTRNQPQHF	TRBV9	TRBJ1-5
TGTGCCAGCAGCTCTACCCTTTTACCGGTGGGCCGGGATAACTATGGCTACACCTTC	CASSSTLLPVGRDNYGYTF	TRBV5-6	TRBJ1-2
TGTGCCAGCAGCTTAGTTTGGTCCCTCGGACTAGCGGGAAGACACGAGACCCAGTACTTC	CASSLVWSLGLAGRHETQYF	TRBV13	TRBJ2-5
TGTGCCAGCAGCGTCCGGGCCACCGGGGAGCTGTTTTTT	CASSVRATGELFF	TRBV13	TRBJ2-2
TGCGCCAGCAGCTTGGGGCAGGGGGATCAAGAGACCCAGTACTTC	CASSLGQGDQETQYF	TRBV5-1	TRBJ2-5
TGTGCCAGCCGAGGCAGGGGCCCCACTGAAGCTTTCTTT	CASRGRGPTEAFF	TRBV6-4	TRBJ1-1
TGTGCCTGGAGTGTAACCAGCCCGAACACTGAAGCTTTCTTT	CAWSVTSPNTEAFF	TRBV30	TRBJ1-1
TGTGCCAGCGGGGCACGGGGGCTCTCTGGAAACACCATATATTTT	CASGARGLSGNTIYF	TRBV2	TRBJ1-3
TGTGCCAGCAGTTCCCCCACGGACAGGGTAACTAATGAAAAACTGTTTTTT	CASSSPTDRVTNEKLFF	TRBV28	TRBJ1-4
TGTGCCAGCAGTCCTGGACTAGGGAATATAGGAGACGAGCAGTACTTC	CASSPGLGNIGDEQYF	TRBV12-3	TRBJ2-7
TGTGCCTGGAGTGTCCGGGACAGGGGAGATGGGGCCAACGTCCTGACTTTC	CAWSVRDRGDGANVLTF	TRBV30	TRBJ2-6
TGTGCCAGCAGCCAAGATCCCTGCCAAAAGGATGGCTACACCTTC	CASSQDPCQKDGYTF	TRBV14	TRBJ1-2
TGTGCCAGCAGCCCGAGGGTTAGCGGGGAAGTTAAATACGAGCAGTACTTC	CASSPRVSGEVKYEQYF	TRBV5-6	TRBJ2-7
TGCAGTGCTATGACGTCAGGACAGGCTGAGCAGTTCTTC	CSAMTSGQAEQFF	TRBV20-1	TRBJ2-1
TGCGCCACGCGACAGGACAATCAGCCCCAGCATTTT	CATRQDNQPQHF	TRBV10-1	TRBJ1-5
TGTGCCAGCAGCTATCGGGGGGGGGCCCGGTACAATGAGCAGTTCTTC	CASSYRGGARYNEQFF	TRBV13	TRBJ2-1
TGCAGCGTTGGAGGGGCCTTGGACGGCAATCAGCCCCAGCATTTT	CSVGGALDGNQPQHF	TRBV29-1	TRBJ1-5
TGTGCCAGCAGTGGGAACAATGGCTACACCTTC	CASSGNNGYTF	TRBV12-3	TRBJ1-2
TGTGCCAGCTCACCAGCCTTAATGGACTATAGCACAGATACGCAGTATTTT	CASSPALMDYSTDTQYF	TRBV18	TRBJ2-3
TGCAGTGCCCGGGACAGGGCAAGGGACGAGCAGTACTTC	CSARDRARDEQYF	TRBV20-1	TRBJ2-7
TGTGCTAGCAGCTTAGCGACCCGATGGGACAGCGATGGCTACACCTTC	CASSLATRWDSDGYTF	TRBV7-7	TRBJ1-2
TGTGCCAGCAGCTGGGGTGGGGGCATGGACAGCTCCTACGAGCAGTACTTC	CASSWGGGMDSSYEQYF	TRBV7-4	TRBJ2-7
TGTGCCAGCAGCCTGGGGGGCACGACTCGGGGGATTGAGACCCAGTACTTC	CASSLGGTTRGIETQYF	TRBV9	TRBJ2-5
TGTCAGAACCGGGACAGGTCTGGGGCCAACGTCCTGACTTTC	CQNRDRSGANVLTF	TRBV30	TRBJ2-6
TGTGCCACCAGACCTCGGACTGGTCCCTCACAGTACAATGAGCAGTTCTTC	CATRPRTGPSQYNEQFF	TRBV24-1	TRBJ2-1
TGTGCCAGCAGGGTTAGACCAGGAGGGTGGACCTACAATGAGCAGTTCTTC	CASRVRPGGWTYNEQFF	TRBV27	TRBJ2-1
TGCGCCAGCAGCCTCTACGGGACAGGGGAGAATGGCTACACCTTC	CASSLYGTGENGYTF	TRBV4-3	TRBJ1-2
TGTGCCAGTAGTATAGATTGGCCGTGGACAGTTTCTGAGACCCAGTACTTC	CASSIDWPWTVSETQYF	TRBV19	TRBJ2-5
TGTGCCAGCGGGGGGGGTCTCTCCTACGAGCAGTACTTC	CASGGGLSYEQYF	TRBV6-1	TRBJ2-7
TGTGCCAGCAGTGCGTTCAGGGGTCCCGGAAGCAATCAGCCCCAGCATTTT	CASSAFRGPGSNQPQHF	TRBV25-1	TRBJ1-5
TGTGCCAGCAGTGGTGGCGAGGGTAACGATGAAAAACTGTTTTTT	CASSGGEGNDEKLFF	TRBV6-1	TRBJ1-4
TGTGCCAGTAGTATGCACGGGGAAAATCCGAACACCGGGGAGCTGTTTTTT	CASSMHGENPNTGELFF	TRBV19	TRBJ2-2
TGTGCCAGCAGTTTTCCCGCAGGGGGCGAACAAGAGACCCAGTACTTC	CASSFPAGGEQETQYF	TRBV28	TRBJ2-5
TGTGCCTCTGCGAGAGGGGTTGTCCCTGACACTGAAGCTTTCTTT	CASARGVVPDTEAFF	TRBV6-6	TRBJ1-1
TGCAGCGTGGTGTCAGGCCCCTACTATGGCTACACCTTC	CSVVSGPYYGYTF	TRBV29-1	TRBJ1-2
TGTGCCAGGGAGCCCTACGAGCAGTACTTC	CAREPYEQYF	TRBV28	TRBJ2-7
TGTGCCAGCATCTACGGAGGGGTGGGTTATAGGTACCAAGAGACCCAGTACTTC	CASIYGGVGYRYQETQYF	TRBV28	TRBJ2-5
TGTGCCAGCACTAGGGGGGACTATGGCTACACCTTC	CASTRGDYGYTF	TRBV6-5	TRBJ1-2
TGTGCCAGCAGCGTCTGGGCCTACCCTACGGACTTGGAGGATTGCAATCAGCCCCAGCATTTT	CASSVWAYPTDLEDCNQPQHF	TRBV11-2	TRBJ1-5
TGTGCCAGCGCGGGATACGAGCAGTACTTC	CASAGYEQYF	TRBV9	TRBJ2-7
TGTGCCATCAGTGCGGTCGTCAGTGGTTATAATTCACCCCTCCACTTT	CAISAVVSGYNSPLHF	TRBV10-3	TRBJ1-6
TGTGCCAGCAGCTGGGAGGGACGTGGCGATTACGAGCAGTACTTC	CASSWEGRGDYEQYF	TRBV7-9	TRBJ2-7
TGTGCAAAGGCTATCCGGGACAGGGGCCCTCTTCAGCCCCAGCATTTT	CAKAIRDRGPLQPQHF	TRBV2	TRBJ1-5
TGTGCCAGCAGTTTTTTGGAGGCAATTCCCACTGAAGCTTTCTTT	CASSFLEAIPTEAFF	TRBV28	TRBJ1-1
TGTGCCAGCCCAACTAGCGGGTATGAGCAGTTCTTC	CASPTSGYEQFF	TRBV5-6	TRBJ2-1
TGTGCCAGCAGTATGGGGGGTGACGAGCAGTACTTC	CASSMGGDEQYF	TRBV6-1	TRBJ2-7
TGTGCCACCAGTGATTACCGGGGTAGGAATGAGCAGTTCTTC	CATSDYRGRNEQFF	TRBV24-1	TRBJ2-1
TGTGCCAGCAGTGGGGGTGGACAGGCCAATTCACCCCTCCACTTT	CASSGGGQANSPLHF	TRBV6-4	TRBJ1-6
TGTGCCAGCAGCCGAGTCCAATCGGACAGACTGCGGAGGATAGACCACACCGGGGAGCTGTTTTTT	CASSRVQSDRLRRIDHTGELFF	TRBV13	TRBJ2-2
TGTGCCAGCAGCAGGGTCAGGGGATTCTCCCAGTACTTC	CASSRVRGFSQYF	TRBV14	TRBJ2-5
TGTGCCAGCAGTTTATCACAAGAAAACATTCAGTACTTC	CASSLSQENIQYF	TRBV27	TRBJ2-4
TGCAGCGTACGGGGCGAGCAGTACTTC	CSVRGEQYF	TRBV29-1	TRBJ2-7
TGTGCCAGCCGGGACAGGGGGGAGGCGGCCTACGAGCAGTACTTC	CASRDRGEAAYEQYF	TRBV12-3	TRBJ2-7
TGTGCCAGCAGCTCAGGTCCGGGAGGGTACCGCAATCAGCCCCAGCATTTT	CASSSGPGGYRNQPQHF	TRBV11-2	TRBJ1-5
TGTGCCTGGAGCTCCCTTCGGACAGCAACTAATGAAAAACTGTTTTTT	CAWSSLRTATNEKLFF	TRBV30	TRBJ1-4
TGCAGTGCGCCGGGACAGGGCACAGATACGCAGTATTTT	CSAPGQGTDTQYF	TRBV20-1	TRBJ2-3
TGTGCCAGGGCCACCAGCTGCTACGAGCAGTACTTC	CARATSCYEQYF	TRBV9	TRBJ2-7
TGTGCCAGCAGCCGGGGGGGACAGGGGATGCCCTACGAGCAGTACTTC	CASSRGGQGMPYEQYF	TRBV14	TRBJ2-7
TGTGCCAGCAGTTACCCAGGGAGGGTCAGAGGTGTCTACGAGCAGTACTTC	CASSYPGRVRGVYEQYF	TRBV6-5	TRBJ2-7
TGTGCCAGCAGCTTAGGGGGGTACAATGAGCAGTTCTTC	CASSLGGYNEQFF	TRBV7-4	TRBJ2-1
TGCAGCGTTGAAGCGGGACACTCTGGAAACACCATATATTTT	CSVEAGHSGNTIYF	TRBV29-1	TRBJ1-3
TGTGCCAGTAGTACGGCGGCCAGAGCCAAAAACATTCAGTACTTC	CASSTAARAKNIQYF	TRBV19	TRBJ2-4
TGCAGTGCGGCGTCCAAGCGGGACACGCTTGACACTGAAGCTTTCTTT	CSAASKRDTLDTEAFF	TRBV20-1	TRBJ1-1
TGTGCCTGTGGGGGAGGGGGTGGCCTACAAGAGAACACTGAAGCTTTCTTT	CACGGGGGLQENTEAFF	TRBV28	TRBJ1-1
TGTGCCAGCCCGTGGGCCCGGTACAATCAGCCCCAGCATTTT	CASPWARYNQPQHF	TRBV5-6	TRBJ1-5
TGTGCCAGCAGTGAACCCCGGGGGGGCCGCTATGGCTACACCTTC	CASSEPRGGRYGYTF	TRBV25-1	TRBJ1-2
TGTGCCAGCAGTGACTCAAGGGACAGGTATCGGTCTGGAAACACCATATATTTT	CASSDSRDRYRSGNTIYF	TRBV2	TRBJ1-3
TGTGCCAGCAGCGTGGACTGGGGCGTTTACGAGCAGTACTTC	CASSVDWGVYEQYF	TRBV5-4	TRBJ2-7
TGCAGCAGGGGGCCCCACACCGGGGAGCTGTTTTTT	CSRGPHTGELFF	TRBV20-1	TRBJ2-2
TGTGCCAGCAACAGAAAGCGGGAGGGGACCTATAATTCACCCCTCCACTTT	CASNRKREGTYNSPLHF	TRBV11-3	TRBJ1-6
TGTGCCAGCACCGGGACAGATAAGAACACTGAAGCTTTCTTT	CASTGTDKNTEAFF	TRBV7-4	TRBJ1-1
TGTGCCAGCAGTACACCGTGGGGGCCCAGTGGCTACACCTTC	CASSTPWGPSGYTF	TRBV2	TRBJ1-2
TGTGCCAGTAGGACAGGGCCCCGCTATGGCTACACCTTC	CASRTGPRYGYTF	TRBV19	TRBJ1-2
TGTGCTAGTGGACCCCTAGGGGGGGCATGGGACACCGGGGAGCTGTTTTTT	CASGPLGGAWDTGELFF	TRBV12-5	TRBJ2-2
TGTGCCAGCAGTTTACAGGGAATCTACGAGCAGTACTTC	CASSLQGIYEQYF	TRBV28	TRBJ2-7
TGCGCCAGCAGCCCGGGGGGCCCACGCACCGGGGAGCTGTTTTTT	CASSPGGPRTGELFF	TRBV4-1	TRBJ2-2
TGTGCCAGCCCCCGGAACAGCGTACTCTCGCAGTACTTC	CASPRNSVLSQYF	TRBV28	TRBJ2-7
TGTGCCAGCAGCCTAGGTATCGCCTCTGGAAACACCATATATTTT	CASSLGIASGNTIYF	TRBV3-1	TRBJ1-3
TGTGCCGGACAGTTCCCCTATGGCTACACCTTC	CAGQFPYGYTF	TRBV28	TRBJ1-2
TGTGCCAGCAGTTTACGGCGGGAGCTGGGTGGATTGAAGAGCAATCAGCCCCAGCATTTT	CASSLRRELGGLKSNQPQHF	TRBV27	TRBJ1-5
TGTGCCAGCAGCGGGGGCGATGGTTCCTATAATTCACCCCTCCACTTT	CASSGGDGSYNSPLHF	TRBV9	TRBJ1-6
TGTGCCAGCAGTGAAAACTCCACTGAAGCTTTCTTT	CASSENSTEAFF	TRBV6-1	TRBJ1-1
TGTGCCACTTTCAGACCTACTAGCGGGAGAACAGATACGCAGTATTTT	CATFRPTSGRTDTQYF	TRBV11-2	TRBJ2-3
TGTGCCACCAGTGATACCACACCGTTAGGGGGGGCGGGCTACAATGAGCAGTTCTTC	CATSDTTPLGGAGYNEQFF	TRBV24-1	TRBJ2-1
TGCGCCAGCAGCTTGTTGGCTAGCGGGTTCTGTGAGCAGTTCTTC	CASSLLASGFCEQFF	TRBV5-1	TRBJ2-1
TGTGCCAGCAGTGCACGACAGCCATTAGGCTGGTCACCCCTCCACTTT	CASSARQPLGWSPLHF	TRBV2	TRBJ1-6
TGTGCCAGCAGTTACTCGAGGGCTCGTCTCCTGGCGGAAGGGGGAGAGCAGTACTTC	CASSYSRARLLAEGGEQYF	TRBV6-5	TRBJ2-7
TGTGCTAGTGGTTTGTGCAGGCTAGCCGGACAGGTGGATCTGGGAAATACTGAAGCTTTCTTT	CASGLCRLAGQVDLGNTEAFF	TRBV12-5	TRBJ1-1
TGTGCCAGCATAACTAGAGGGCTGGGGCACGAGCAGTACTTC	CASITRGLGHEQYF	TRBV6-4	TRBJ2-7
TGTGCCAGCAGCCAAGGGGGGCAGTACTTC	CASSQGGQYF	TRBV7-3	TRBJ2-7
TGTGCCAGCAGCTTAACTTTTTTGACTAAGCCGGTGGGGAGCTCCTACGAGCAGTACTTC	CASSLTFLTKPVGSSYEQYF	TRBV5-6	TRBJ2-7
TGTGCCAGACTAACAGACACTGAAGCTTTCTTT	CARLTDTEAFF	TRBV12-3	TRBJ1-1
TGTGCCAGCAGCTTGGTCGTATTGGGACAGGGGATAGAGACCCAGTACTTC	CASSLVVLGQGIETQYF	TRBV7-2	TRBJ2-5
TGTGCCAGCAGCCTATCGTACCTTATTCACAATGAGCAGTTCTTC	CASSLSYLIHNEQFF	TRBV7-9	TRBJ2-1
TGTGCCAGTAGTATAGCCAGGGGAGCCTCCTACAATGAGCAGTTCTTC	CASSIARGASYNEQFF	TRBV19	TRBJ2-1
TGTGCCAGCAGCCAAGATCCCCTCCTATACTATAACACCGGGGAGCTGTTTTTT	CASSQDPLLYYNTGELFF	TRBV4-2	TRBJ2-2
TGTGCCATCAGGTCATACGGGCAGTACTTC	CAIRSYGQYF	TRBV10-3	TRBJ2-7
TGCAGCGTGCTAACACTTGCCGGGACAGGGGGGGGCAATCAGCCCCAGCATTTT	CSVLTLAGTGGGNQPQHF	TRBV29-1	TRBJ1-5
TGCGCCAGCAGCCAAAAATCGGCAATACAGCCCCAGCATTTT	CASSQKSAIQPQHF	TRBV4-1	TRBJ1-5
TGTGCCAGCTACGAACGCTCGACCTTGAGGATGTGGAACACCGGGGAGCTGTTTTTT	CASYERSTLRMWNTGELFF	TRBV2	TRBJ2-2
TGTGCCAGCAGCACATATACTGGAGGTGGCTCCTACGAGCAGTACTTC	CASSTYTGGGSYEQYF	TRBV7-3	TRBJ2-7
TGCGCCAGCAGCTTGCCCCCCCTAACGAGCCGAGGGGGACGAAGCTCCTATAATTCACCCCTCCACTTT	CASSLPPLTSRGGRSSYNSPLHF	TRBV5-1	TRBJ1-6
TGTGCCAGCAGTTGGGGAACTGGCCTGCAAGAGACCCAGTACTTC	CASSWGTGLQETQYF	TRBV7-6	TRBJ2-5
TGTGCCAGCAGTCCAGGTGGGAGGGAGTCTTACACCGGGGAGCTGTTTTTT	CASSPGGRESYTGELFF	TRBV6-2	TRBJ2-2
TGTGCCACCAGTGGTCTCAATTTTGGACTAGCGGGAACAGATACGCAGTATTTT	CATSGLNFGLAGTDTQYF	TRBV24-1	TRBJ2-3
TGTGCCAGCAGCTACTCTAGTCCAGGGGGTATCACTGAAGCTTTCTTT	CASSYSSPGGITEAFF	TRBV5-6	TRBJ1-1
TGTGCCAGCAGCTTAGGGGGAAGCGGAAGCACAGATACGCAGTATTTT	CASSLGGSGSTDTQYF	TRBV7-7	TRBJ2-3
TGTGCCAGCAGCGTCTTGTCACAGGTCGGCCGGAGAACCGGGGAGCTGTTTTTT	CASSVLSQVGRRTGELFF	TRBV9	TRBJ2-2
TGTGCCAGCAGCAGGGGAGCAGGCTACACCTTC	CASSRGAGYTF	TRBV5-4	TRBJ1-2
TGTGCCATCAGTGAGAGGACTAGCCTCCAAGAGACCCAGTACTTC	CAISERTSLQETQYF	TRBV10-3	TRBJ2-5
TGTGCCAGCAGCTTAGTCTCCGGGAATGGACAGAATGAGCAGTTCTTC	CASSLVSGNGQNEQFF	TRBV7-9	TRBJ2-1
TGTGCCATCGCAAACGGTGGACACGAGGACTACGAGCAGTACTTC	CAIANGGHEDYEQYF	TRBV10-3	TRBJ2-7
TGTGCCAGCAGCCAAGAGGCAGAAGGGAACACTGAAGCTTTCTTT	CASSQEAEGNTEAFF	TRBV14	TRBJ1-1
TGTGCCAGCAGCCGCCGGGGGGGGCCCGGAGGGGTTTCGAGCACAGATACGCAGTATTTT	CASSRRGGPGGVSSTDTQYF	TRBV14	TRBJ2-3
TGTGCTAGTGGTTTCGGTCGGGGTCTTATAGTAGAGCAGTACTTC	CASGFGRGLIVEQYF	TRBV12-5	TRBJ2-7
TGTGCCAGCAGCCCTAACCAGCCAGGATTAGAGACCCAGTACTTC	CASSPNQPGLETQYF	TRBV4-2	TRBJ2-5
TGTGCCAGCAGCGGGGGGGGACAGGGCGTCTACGCCACAGATACGCAGTATTTT	CASSGGGQGVYATDTQYF	TRBV7-9	TRBJ2-3
TGTGCCAGCATTACGGGGGGGGGTAACTATGGCTACACCTTC	CASITGGGNYGYTF	TRBV2	TRBJ1-2
TGTGCCAGCAGCCCGGGGGTGGGTTGTCAGCCCCAGCATTTT	CASSPGVGCQPQHF	TRBV12-3	TRBJ1-5
TGTGCCAGCAGTTACGGAAGTGGAGCGGGAGGGTGCCGAGACACCTTC	CASSYGSGAGGCRDTF	TRBV6-5	TRBJ1-2
TGTGCCAGCAGCCTACGGGACAGGGAGCCCCATTGGAATAGCAATCAGCCCCAGCATTTT	CASSLRDREPHWNSNQPQHF	TRBV7-2	TRBJ1-5
TGTGCCACCACCGAGGACAGACCCAACTATGGCTACACCTTC	CATTEDRPNYGYTF	TRBV24-1	TRBJ1-2
TGTGCCAGCTCACCGGGGAGGGGGCCGAGCACTGAAGCTTTCTTT	CASSPGRGPSTEAFF	TRBV18	TRBJ1-1
TGTGCCAGCAGTGGGGGTGTGCGTGATACGCAGTATTTT	CASSGGVRDTQYF	TRBV2	TRBJ2-3
TGTGCCAGTAGTCTGAGGTTCCCGGCGGCAGGGGGTGACACTGAAGCTTTCTTT	CASSLRFPAAGGDTEAFF	TRBV19	TRBJ1-1
TGTGCCAGCAGGAGACAGGGGAGGAAACACTATGGCTACACCTTC	CASRRQGRKHYGYTF	TRBV9	TRBJ1-2
TGTGCCAGCAGCCTCATACAGGGTGGAAACACCATATATTTT	CASSLIQGGNTIYF	TRBV6-1	TRBJ1-3
TGTGCCAGCAGCATTATCAGGACTAGCGGCACTTCCTACGAGCAGTACTTC	CASSIIRTSGTSYEQYF	TRBV7-4	TRBJ2-7
TGTGCCAGCAGGCCGCTAGCGGGAAAGACCCAGTACTTC	CASRPLAGKTQYF	TRBV6-5	TRBJ2-5
TGTGCCAGCCACGAGGGAGGCTACGAGCAGTACTTC	CASHEGGYEQYF	TRBV6-5	TRBJ2-7
TGTGCCAGCAGCATGCCACGGGACAGGGAAAAACTGTTTTTT	CASSMPRDREKLFF	TRBV11-2	TRBJ1-4
TGTGCCAGCAGTGACTCGAAACAGGGGCATTTTGTTGGAAACACCATATATTTT	CASSDSKQGHFVGNTIYF	TRBV6-4	TRBJ1-3
TGCGCCAGCAGCTTGGCTTTACCGGGACTAGTTGTACCGTACGAGCAGTACTTC	CASSLALPGLVVPYEQYF	TRBV5-1	TRBJ2-7
TGTGCCAGCAGCTTAAACCCCCGGACAGCTTTCTTT	CASSLNPRTAFF	TRBV7-9	TRBJ1-1
TGTGCCAGCAGCTTATTCACCGGGACTAGCGTGGACCTGACCCAGTACTTC	CASSLFTGTSVDLTQYF	TRBV11-2	TRBJ2-5
TGCAGCGTTGAAAAGAACCGGGACCGTTTGGATGAGCAGTTCTTC	CSVEKNRDRLDEQFF	TRBV29-1	TRBJ2-1
TGTGCCATCTCCTTCAGGCGCGAATTTGAGCAGTTCTTC	CAISFRREFEQFF	TRBV10-3	TRBJ2-1
TGTGCCAGCAGCCCTAATGGGGGGGGAGAGTCAGATACGCAGTATTTT	CASSPNGGGESDTQYF	TRBV28	TRBJ2-3
TGTGCCATCAGTGCGTTACAGGGTCGCACAGATACGCAGTATTTT	CAISALQGRTDTQYF	TRBV10-3	TRBJ2-3
TGTGCCAGCATAATACCCGAAGAGGACAGGGGTTTGGGCACTGAAGCTTTCTTT	CASIIPEEDRGLGTEAFF	TRBV27	TRBJ1-1
TGTGCCAGCAGCTTAGTGGTGGGGGGGGGCGGAACCGGGGAGCTGTTTTTT	CASSLVVGGGGTGELFF	TRBV7-9	TRBJ2-2
TGTGCCAGCAGCAATAAACGCAAGTCCTACGAGCAGTACTTC	CASSNKRKSYEQYF	TRBV7-4	TRBJ2-7
TGTGCCAGCAGTCACGGGGTAGCGGGAGTTGCTGAGACCCAGTACTTC	CASSHGVAGVAETQYF	TRBV25-1	TRBJ2-5
TGCAGTGCTAGAGCACAGGGCAGCACAGATACGCAGTATTTT	CSARAQGSTDTQYF	TRBV20-1	TRBJ2-3
TGTGCCAGCAGTTACAGGGACAGGTCCTACGAGCAGTACTTC	CASSYRDRSYEQYF	TRBV6-5	TRBJ2-7
TGCGCCAGCAGCTTGGGACTAGATGGAGGCTACGAGCAGTACTTC	CASSLGLDGGYEQYF	TRBV5-1	TRBJ2-7
TGTGCCAGCAGCTTAGAACAGGGAGGGTACTTC	CASSLEQGGYF	TRBV7-8	TRBJ2-7
TGTGCCAGCCGGCGGGCCGGAAACACCATATATTTT	CASRRAGNTIYF	TRBV27	TRBJ1-3
TGTGCCAGCAGTCCCGAGTTGGACAAAAGAGAGAACACTGAAGCTTTCTTT	CASSPELDKRENTEAFF	TRBV6-4	TRBJ1-1
TGTGCCACCAGTGACTTGAACGAGCAGTACTTC	CATSDLNEQYF	TRBV24-1	TRBJ2-7
TGCGCCAGCAGCTTCCCGAGCGGGCAATGCACAGATACGCAGTATTTT	CASSFPSGQCTDTQYF	TRBV5-1	TRBJ2-3
TGCGCCAGCAGCTTCCCGGCCCACCGGGGGGATGAGCAGTTCTTC	CASSFPAHRGDEQFF	TRBV5-1	TRBJ2-1
TGTGCCATCAGTCCCCTGAAGGGCCGCCTTCATGAGCAGTTCTTC	CAISPLKGRLHEQFF	TRBV10-3	TRBJ2-1
TGTGCCATCAGTGAGACCAACCGGGACAGGGTGCGGCAAGAGACCCAGTACTTC	CAISETNRDRVRQETQYF	TRBV10-3	TRBJ2-5
TGTGCTAACGCCGCGGGAGCGTTCTCTGGAAACACCATATATTTT	CANAAGAFSGNTIYF	TRBV12-5	TRBJ1-3
TGTGCCAGCAGCGGAGGGGAGGAGGACAATGAGCAGTTCTTC	CASSGGEEDNEQFF	TRBV7-3	TRBJ2-1
TGTGCCAGCAGTGAAGTATCCACATGGGAGCTGTTTTTT	CASSEVSTWELFF	TRBV6-1	TRBJ2-2
TGTGCCAGCAGCTTAGAAAGGGGGGCCAGCAATCAGCCCCAGCATTTT	CASSLERGASNQPQHF	TRBV13	TRBJ1-5
TGTGCCAGCAGTTCACCCCCGGGACACTCTGGGGCCAACGTCCTGACTTTC	CASSSPPGHSGANVLTF	TRBV6-2	TRBJ2-6
TGTGCCAGCAGTTTCGACGAGCAGTACTTC	CASSFDEQYF	TRBV12-3	TRBJ2-7
TGTGCCAGCAGTTACGGGACTTCTGAAGCTTTCTTT	CASSYGTSEAFF	TRBV6-5	TRBJ1-1
TGTGCCACCAGTGATGTCCATAGGTTTTATGAGACCCAGTACTTC	CATSDVHRFYETQYF	TRBV24-1	TRBJ2-5
TGCGCCAGCGGGGGGGGGGGCCCTTTCTCTGGGGCCAACGTCCTGACTTTC	CASGGGGPFSGANVLTF	TRBV10-2	TRBJ2-6
TGTGCCAGCACCAACCCAACAGAGGGACCGCGCGCTTTCTTT	CASTNPTEGPRAFF	TRBV5-4	TRBJ1-1
TGCGCCAGCAGCTTGGCGGGAAGGCAGTACTTC	CASSLAGRQYF	TRBV5-1	TRBJ2-7
TGTGGGGCATCTGAAAAACTGTTTTTT	CGASEKLFF	TRBV20-1	TRBJ1-4
TGTGCCAGCGCATCTGACTCCCCCAGCACAGATACGCAGTATTTT	CASASDSPSTDTQYF	TRBV28	TRBJ2-3
TGTGCCAGCAGCTTAGCACCTGCAGGGGCCCCTTGCCACTTC	CASSLAPAGAPCHF	TRBV7-9	TRBJ2-7
TGTGCCAGCAGTTCTGGGGGCACGAGCTATGGCTACACCTTC	CASSSGGTSYGYTF	TRBV6-5	TRBJ1-2
TGTGCCAGCATCCCTGCAATGTCGGTTGGGACGCGAGAGACCCAGTACTTC	CASIPAMSVGTRETQYF	TRBV6-1	TRBJ2-5
TGTGCCAGCAGCCATCGGGCCCTGATTATGAACACTGAAGCTTTCTTT	CASSHRALIMNTEAFF	TRBV4-2	TRBJ1-1
TGTGCTAGTGGCGGACTCTTCTATGGCTACACCTTC	CASGGLFYGYTF	TRBV12-5	TRBJ1-2
TGCAGTGCTAGACCCGAGCCGGGACTAGCGGGAGGGTCCTACGAGCAGTACTTC	CSARPEPGLAGGSYEQYF	TRBV20-1	TRBJ2-7
TGCGCCAGCAAGAGGCCGGGGACAGGGATCCCCCAAGACTATGGCTACACCTTC	CASKRPGTGIPQDYGYTF	TRBV10-1	TRBJ1-2
TGTGCCAGCAGCTTAGCCGGGGGACAGGGTGGTTCCGATGGCTACACCTTC	CASSLAGGQGGSDGYTF	TRBV7-6	TRBJ1-2
TGTGCCAGCAGTTATATAGCGGGGGTCACAGATACGCAGTATTTT	CASSYIAGVTDTQYF	TRBV27	TRBJ2-3
TGTGCCAGCAGCTTTACTAGCGGGAGTATGGAGCAGTACTTC	CASSFTSGSMEQYF	TRBV11-1	TRBJ2-7
TGTGCCAGCAGCGCCGGGACAGGGTGGCTAGATACGCAGTATTTT	CASSAGTGWLDTQYF	TRBV13	TRBJ2-3
TGCGCCAGCAGCCAAGTGGGGCCCCCCACACGTAGGAACACTGAAGCTTTCTTT	CASSQVGPPTRRNTEAFF	TRBV4-3	TRBJ1-1
TGCAGTGCTATGCCCACTAGCGATGAGCAGTTCTTC	CSAMPTSDEQFF	TRBV20-1	TRBJ2-1
TGTGCCAGCAGCTTAGCCCAGGGAGGCAATCAGCCCCAGCATTTT	CASSLAQGGNQPQHF	TRBV11-3	TRBJ1-5
TGTGCCAGCAGCTGGGAGTGTTATGTCGTAGAAGAAGACAGGGGGGGGGAGATAACGACTAACTATGGCTACACCTTC	CASSWECYVVEEDRGGEITTNYGYTF	TRBV5-4	TRBJ1-2
TGTGCCAGCAGCGCCCCAGGAGCGTTTTACAATGAGCAGTTCTTC	CASSAPGAFYNEQFF	TRBV9	TRBJ2-1
TGTGCCAGCAGCTATCCTTCTCCCCTTCAGACAGGACGGAGCTCCTACAATGAGCAGTTCTTC	CASSYPSPLQTGRSSYNEQFF	TRBV11-2	TRBJ2-1
TGCGCCAGCAGCTCCCCCACGGGGGGCTACACCTTC	CASSSPTGGYTF	TRBV5-1	TRBJ1-2
TGCGCCAGCAGCCCATGGAAGGACACCGGGGAGCTGTTTTTT	CASSPWKDTGELFF	TRBV4-3	TRBJ2-2
TGTGCCAGCCCCGAGGTCGGGACAGGGGGCTCCCCAGGCTACACCTTC	CASPEVGTGGSPGYTF	TRBV6-4	TRBJ1-2
TGTGCCAGCAGCCACATGGGGGGGGGCACTGAAGCTTTCTTT	CASSHMGGGTEAFF	TRBV14	TRBJ1-1
TGCGCCAGCAGCTACGCAGGGGACCTCTACACCGGGGAGCTGTTTTTT	CASSYAGDLYTGELFF	TRBV5-1	TRBJ2-2
TGTGCCAGGATTGCGGGGGCCGGGACGCACGAGCAGTACTTC	CARIAGAGTHEQYF	TRBV9	TRBJ2-7
TGTGCCAGCAGCACCCGTTCGGGGGGGCCACAGTGCTACAATGAGCAGTTCTTC	CASSTRSGGPQCYNEQFF	TRBV7-3	TRBJ2-1
TGTGCCAGCAGTTTTTACGGGGGCGGGACCCAGTACTTC	CASSFYGGGTQYF	TRBV12-3	TRBJ2-5
TGTGCCGCTCGGGGAACGAACACCGGGGAGCTGTTTTTT	CAARGTNTGELFF	TRBV7-3	TRBJ2-2
TGTGCCAGCAGTTTATCGAAGGGACAGGTTCAAGAGACCCAGTACTTC	CASSLSKGQVQETQYF	TRBV27	TRBJ2-5
TGCAACCAGTGTGAGCAGTTCTTC	CNQCEQFF	TRBV20-1	TRBJ2-1
TGTGCCACCAGTGACATCCTCGGACTAGCGGGAGATACGCAGTATTTT	CATSDILGLAGDTQYF	TRBV24-1	TRBJ2-3
TGTGCCAGCAGTGACTCTGTTGAGGACAGGGGAAAATCCTACGAGCAGTACTTC	CASSDSVEDRGKSYEQYF	TRBV6-4	TRBJ2-7
TGTGCCAGCAGCGAAGGGCTCGATGAGCAGTTCTTC	CASSEGLDEQFF	TRBV13	TRBJ2-1
TGTGCCACCAATCTAAAACACGAGCAGTACTTC	CATNLKHEQYF	TRBV24-1	TRBJ2-7
TGTGCCTGGAGTGTACCGGGACTCGGTGGCGAGCAGTACTTC	CAWSVPGLGGEQYF	TRBV30	TRBJ2-7
TGTGCCAGCAGTTATCCGGAGGGGTTTCGACAGCCCCAGCATTTT	CASSYPEGFRQPQHF	TRBV6-5	TRBJ1-5
TGTGCCAGCAGCTCAGTCATTAGCTATGGCTACACCTTC	CASSSVISYGYTF	TRBV7-4	TRBJ1-2
TGTGCTAGTGGTTTGAAACAGGGTTACCTTTGGGAGAGCTCTGGAAACACCATATATTTT	CASGLKQGYLWESSGNTIYF	TRBV12-5	TRBJ1-3
TGTGCCAGCAGGTTCCGTACCCCAGGGAGGCACTATGGCTACACCTTC	CASRFRTPGRHYGYTF	TRBV6-5	TRBJ1-2
TGTGCCAGCAGCCTCCCCGGGGGGCCAAATTTTTCGCCGCGGGAGACCCAGTACTTC	CASSLPGGPNFSPRETQYF	TRBV7-9	TRBJ2-5
TGTGCCTGGGGCTCGGAGATGACCCAGTACTTC	CAWGSEMTQYF	TRBV30	TRBJ2-5
TGTGCCAGCAGCGTCCCCACCAATGAAAAACTGTTTTTT	CASSVPTNEKLFF	TRBV14	TRBJ1-4
TGCGCCAGCAGCACCAGGGAGGACTACGAGCAGTACTTC	CASSTREDYEQYF	TRBV10-2	TRBJ2-7
TGTGCCAGCAGCGACACAACGCAGCGTAACGCCTACGAGCAGTACTTC	CASSDTTQRNAYEQYF	TRBV13	TRBJ2-7
TGCGCCAGCAGTGGGATATCCTGGTCAGGGACAGCCTCCTACAATGAGCAGTTCTTC	CASSGISWSGTASYNEQFF	TRBV10-1	TRBJ2-1
TGTGCCAGCAGCCAAGGGATTCGGGACTACCCCCCTAATCAGCCCCAGCATTTT	CASSQGIRDYPPNQPQHF	TRBV4-2	TRBJ1-5
TGTGCCAGCAACCGGTTATTCTGCACAGATACGCAGTATTTT	CASNRLFCTDTQYF	TRBV2	TRBJ2-3
TGCGCCAGCAGCTGCTTTTTCATGGGGCCCAATGAGCAGTTCTTC	CASSCFFMGPNEQFF	TRBV5-1	TRBJ2-1
TGTGCCAGTAGTGGGGGGGCCTTGACTAATGAAAAACTGTTTTTT	CASSGGALTNEKLFF	TRBV19	TRBJ1-4
TGTGCCATCAGTGCCCAAGTACAGGGAATAGGGAAGCGGAGCAATCAGCCCCAGCATTTT	CAISAQVQGIGKRSNQPQHF	TRBV10-3	TRBJ1-5
TGTGCCAGCAGTTTAAGTGACAGCAGTAGCAATCAGCCCCAGCATTTT	CASSLSDSSSNQPQHF	TRBV28	TRBJ1-5
TGCAGTGCAGCCGCGGGAGAAGCCAAAAACATTCAGTACTTC	CSAAAGEAKNIQYF	TRBV20-1	TRBJ2-4
TGTGCCAGAACAGGGGCCAGTCACACCGGGGAGCTGTTTTTT	CARTGASHTGELFF	TRBV9	TRBJ2-2
TGCGCCAGCAGAAAACAGTCGGGGCCACCCCAGAGCTCTGGAAACACCATATATTTT	CASRKQSGPPQSSGNTIYF	TRBV10-1	TRBJ1-3
TGCGCCAGCAGCTGGAGATCTAGCGGGCGTTCCTACGAGCAGTACTTC	CASSWRSSGRSYEQYF	TRBV5-1	TRBJ2-7
TGTGCCAGCAGCCGGGCGTTGGCCTACGAGCAGTACTTC	CASSRALAYEQYF	TRBV7-3	TRBJ2-7
TGTGCCAGCAGCTTAGAGGGGCGGGAAGAGGAAACCAATCAGCCCCAGCATTTT	CASSLEGREEETNQPQHF	TRBV7-2	TRBJ1-5
TGCAGTGCAATCACCCCGTGTGGGACTAGCGGCCGACAACTCAATGAGCAGTTCTTC	CSAITPCGTSGRQLNEQFF	TRBV20-1	TRBJ2-1
TGCGCCAGCAGCTTGGTGGAGAGTCCAGGACGGGCCCGCAATCAGCCCCAGCATTTT	CASSLVESPGRARNQPQHF	TRBV5-1	TRBJ1-5
TGTGCCAGCCAAAACTTTGACAGGAGTCGATGCCCCGATAATTCACCCCTCCACTTT	CASQNFDRSRCPDNSPLHF	TRBV7-2	TRBJ1-6
TGTGCCAGCAGGGGTTATTCGGGGGGCTACGTATTCTCCCCGAACACTGAAGCTTTCTTT	CASRGYSGGYVFSPNTEAFF	TRBV7-3	TRBJ1-1
TGCAGTGCTAGAGACAGGAAATCCTACGAGCAGTACTTC	CSARDRKSYEQYF	TRBV20-1	TRBJ2-7
TGCGCCAGCTGGGTCCGTCGGGGACAGCCGTGCTCACCCCTCCACTTT	CASWVRRGQPCSPLHF	TRBV5-1	TRBJ1-6
TGTGCCTGGGGGGCGGGGGACTACGAGCAGTACTTC	CAWGAGDYEQYF	TRBV30	TRBJ2-7
TGTGCCAGCACCCCCCCGAGCGGGAGCGATCACACCGGGGAGCTGTTTTTT	CASTPPSGSDHTGELFF	TRBV7-4	TRBJ2-2
TGCGCCAGCAGCCTGGGGTGGGGACCCTATGGCTACACCTTC	CASSLGWGPYGYTF	TRBV4-1	TRBJ1-2
TGTGCCAGCAGTTACTCGGGAGGGATAGCCAAAAACATTCAGTACTTC	CASSYSGGIAKNIQYF	TRBV6-5	TRBJ2-4
TGTGCCAGCAGCTCTGAGGGACAATTGGTCGAAAACACCATATATTTT	CASSSEGQLVENTIYF	TRBV5-8	TRBJ1-3
TGTGCCAGCAGCGGGACAGGGGGAGGGAACTATGGCTACACCTTC	CASSGTGGGNYGYTF	TRBV9	TRBJ1-2
TGCGCCAGCAACGAGCGGGGGGGAGAGACCCAGTACTTC	CASNERGGETQYF	TRBV10-1	TRBJ2-5
TGTGCCAGCCCCCCCAGGACCCGCACAGATACGCAGTATTTT	CASPPRTRTDTQYF	TRBV2	TRBJ2-3
TGTGCCAGCAGTTACTCTGGACAGTCTGGAGAGACCCAGTACTTC	CASSYSGQSGETQYF	TRBV6-5	TRBJ2-5
TGCAGCGTCCGGGGGGGGGGGCGCTTCAGAGAAAAACTGTTTTTT	CSVRGGGRFREKLFF	TRBV29-1	TRBJ1-4
TGTGCCACCGCTACGAAAGCCAAAAACATTCAGTACTTC	CATATKAKNIQYF	TRBV24-1	TRBJ2-4
TGTGCCGAGTGGAATCGTACTTGGTCTGGAAACACCATATATTTT	CAEWNRTWSGNTIYF	TRBV6-4	TRBJ1-3
TGTGCCAGCAGCTCACCGTCAGTTCACTATGGCTACACCTTC	CASSSPSVHYGYTF	TRBV11-2	TRBJ1-2
TGCGCCAGCATGTGTTCCAAGGGTATAAGGCAGTTCTTC	CASMCSKGIRQFF	TRBV10-2	TRBJ2-1
TGTGCCAGCCACCCGGGACAGGGAAGGATGAACACTGAAGCTTTCTTT	CASHPGQGRMNTEAFF	TRBV19	TRBJ1-1
TGTGCCACCAGGCCCGAGTGGTATGGCTACACCTTC	CATRPEWYGYTF	TRBV24-1	TRBJ1-2
TGTGCCAGCAGCCGGTCCGGGGGGGTCGGGGATGAGCAGTTCTTC	CASSRSGGVGDEQFF	TRBV14	TRBJ2-1
TGTGCCAGCAGTTATCCGAACGACAGGGGGTTGGAAGAGACCCAGTACTTC	CASSYPNDRGLEETQYF	TRBV6-2	TRBJ2-5
TGCAGTGCTAGAGAGAGGCGCGGCATTAGCAATCAGCCCCAGCATTTT	CSARERRGISNQPQHF	TRBV20-1	TRBJ1-5
TGTGCCAGCAGCTTAGAATTGGACAGGGCCCAGCATTTT	CASSLELDRAQHF	TRBV7-2	TRBJ1-5
TGTGCCGGCGGTAAGTGGGCCGGGGAGCTGTTTTTT	CAGGKWAGELFF	TRBV28	TRBJ2-2
TGTGCCTGTTCTCTAAGGCTCACCGGGGAGCTGTTTTTT	CACSLRLTGELFF	TRBV30	TRBJ2-2
TGTGCCAGCAGACCCGGGACAGGCGAGCAGTACTTC	CASRPGTGEQYF	TRBV12-3	TRBJ2-7
TGTGCCAGCAGCCAAGAAGGGGGGGGAGGGGCTTTCTTT	CASSQEGGGGAFF	TRBV3-1	TRBJ1-1
TGCAGCGTTGCCCGGACAGGAGCTTTCTTT	CSVARTGAFF	TRBV29-1	TRBJ1-1
TGTGCCAGCAGCCAAGCCGGGACAGGGAAAGAAAAACTGTTTTTT	CASSQAGTGKEKLFF	TRBV14	TRBJ1-4
TGCGCCAGCAAACAGGGGGGCCGGGTGGAGGGAAAGCTCGGCTCCTACGAGCAGTACTTC	CASKQGGRVEGKLGSYEQYF	TRBV5-1	TRBJ2-7
TGCGCCAGCAGTGAGACAGGGGGCTATGGCTACACCTTC	CASSETGGYGYTF	TRBV10-1	TRBJ1-2
TGTGCCACCTTAGGGTTAGCAGGGTTTCGCAGACGCTACGAGCAGTACTTC	CATLGLAGFRRRYEQYF	TRBV7-2	TRBJ2-7
TGTGCCAGCAGCTTGGTGCGGGGACTACCATCCGGGGAGCTGTTTTTT	CASSLVRGLPSGELFF	TRBV5-5	TRBJ2-2
TGTGCCAGCAGCGGAAATACTAGCGGGGGGGGGATTATCTCCTACAATGAGCAGTTCTTC	CASSGNTSGGGIISYNEQFF	TRBV13	TRBJ2-1
TGCGCCAGCAGCCAGGGGGGTTACCCCAGCAATCAGCCCCAGCATTTT	CASSQGGYPSNQPQHF	TRBV4-1	TRBJ1-5
TGTGCCAGCAGCTCCCCAGGGACTCCCAACACTGAGCAGTTCTTC	CASSSPGTPNTEQFF	TRBV9	TRBJ2-1
TGTGCCAGCAGCGCCAGAGACACTGAAGCTTTCTTT	CASSARDTEAFF	TRBV13	TRBJ1-1
TGTGCCAGCAGCACAATTCCCGGAAACATTCAGTACTTC	CASSTIPGNIQYF	TRBV7-8	TRBJ2-4
TGTGCCAGCAGTTCGAACCACAGGAAGACTGAAGCTTTCTTT	CASSSNHRKTEAFF	TRBV27	TRBJ1-1
TGCGCCAGCAGTGCGACAGTCCAAGAGACCCAGTACTTC	CASSATVQETQYF	TRBV10-2	TRBJ2-5
TGTGCCAGCAGGAGTTCGAGGGGGGGCACAGATACGCAGTATTTT	CASRSSRGGTDTQYF	TRBV6-5	TRBJ2-3
TGCGCCAGCAGCCAAAGGGGGACTAGCGAGAAGACCTACGAGCAGTACTTC	CASSQRGTSEKTYEQYF	TRBV4-1	TRBJ2-7
TGTGCCAGCAGCATGGGTCTAAACATCACAGATACGCAGTATTTT	CASSMGLNITDTQYF	TRBV13	TRBJ2-3
TGCGTAGGGGGTTTAGAAAAACTGTTTTTT	CVGGLEKLFF	TRBV20-1	TRBJ1-4
TGTGCCAGCAGCCTGGTTCACAGGGACAAGGCGTTCTTGGGCGAGTTGAACGAGCAGTACTTC	CASSLVHRDKAFLGELNEQYF	TRBV14	TRBJ2-7
TGTGCCAGCAGCACGTCCCGTCGGCCCGGGACTAGCGGAACAATTGAAGCAGAGACCCAGTACTTC	CASSTSRRPGTSGTIEAETQYF	TRBV9	TRBJ2-5
TGTGCCAGCAGCTATCTGCCAAACCCCCCCCAGCAGGACTATGGCTACACCTTC	CASSYLPNPPQQDYGYTF	TRBV7-6	TRBJ1-2
TGCAGTGCTAGAGGGGGGGAGGGGGGAAAGACCCAGTACTTC	CSARGGEGGKTQYF	TRBV20-1	TRBJ2-5
TGCAGTGCTAGGAACCCTCAGGGGGGGCCCACAGATACGCAGTATTTT	CSARNPQGGPTDTQYF	TRBV20-1	TRBJ2-3
TGTGCCATCAGTGTATCGACAGGTGGAAACACCATATATTTT	CAISVSTGGNTIYF	TRBV10-3	TRBJ1-3
TGTGCCAGCAGCGCCAGAGGGACAGGGGGCGTGGTGAACACTGAAGCTTTCTTT	CASSARGTGGVVNTEAFF	TRBV9	TRBJ1-1
TGCAGCGAATCCAGGCTCCACTATGGCTACACCTTC	CSESRLHYGYTF	TRBV29-1	TRBJ1-2
TGTGCCAGCAGCAACGTGGGTGACAGGGGTTATAGCAATCAGCCCCAGCATTTT	CASSNVGDRGYSNQPQHF	TRBV5-6	TRBJ1-5
TGTGCCACCCCATACAGGAAAGATCAGCCCCAGCATTTT	CATPYRKDQPQHF	TRBV24-1	TRBJ1-5
TGTGCCAGCAGCCAAGGGCTCAGGGGATGGGGGAATGAGCAGTTCTTC	CASSQGLRGWGNEQFF	TRBV3-1	TRBJ2-1
TGTGCCAGCAGCTGGGCTGGACAGGGGGCATGGTACGAGCAGTACTTC	CASSWAGQGAWYEQYF	TRBV7-2	TRBJ2-7
TGTGCCAGCAGTTTAGAAGCTTCGACAGGGGGGGCGGCCAACGTCCTGACTTTC	CASSLEASTGGAANVLTF	TRBV12-4	TRBJ2-6
TGTGCCAGCAGCAGATTCTCTGGAAACACCATATATTTT	CASSRFSGNTIYF	TRBV6-2	TRBJ1-3
TGTGCCAGCAGCCCGGGACAGGCCTTGACTGAAGCTTTCTTT	CASSPGQALTEAFF	TRBV11-3	TRBJ1-1
TGTGCCACCAGTGCGACAGAACGGGACATGACCGGGGAGCAGTACTTC	CATSATERDMTGEQYF	TRBV24-1	TRBJ2-7
TGTGCCAGCAAGGACACGACAGTACACCAAGGGAGCAATCAGCCCCAGCATTTT	CASKDTTVHQGSNQPQHF	TRBV12-3	TRBJ1-5
TGTGCCAGCAGTGAAGGACCTAGCGGGGAGACCCAGTACTTC	CASSEGPSGETQYF	TRBV6-1	TRBJ2-5
TGCGCCAGCAGTGCAGCGGCGAGGGGGGAGGAATCCTACAATGAGCAGTTCTTC	CASSAAARGEESYNEQFF	TRBV10-1	TRBJ2-1
TGTGCCAGCCCGATCCCGGGGAGGAACTCTTGCAATCAGCCCCAGCATTTT	CASPIPGRNSCNQPQHF	TRBV5-4	TRBJ1-5
TGCAGTGCTAGAGCCGCCGGAAGTAATTGGACCCAAGAGACCCAGTACTTC	CSARAAGSNWTQETQYF	TRBV20-1	TRBJ2-5
TGTGCCAGAGTCCCAGACGAATACAATGAGCAGTTCTTC	CARVPDEYNEQFF	TRBV19	TRBJ2-1
TGTGCCAGCAGTTTAAGGCCCTTTAATAACTATGGCTACACCTTC	CASSLRPFNNYGYTF	TRBV5-6	TRBJ1-2
TGTGCCAGCAGCTTCCCCTCCGGGACCACAGATACGCAGTATTTT	CASSFPSGTTDTQYF	TRBV11-3	TRBJ2-3
TGCAGTGCTAAAGACGGATGCTCCTACGAGCAGTACTTC	CSAKDGCSYEQYF	TRBV20-1	TRBJ2-7
TGTGCCAGCAGCCTACGAAATAGCAATCAGCCCCAGCATTTT	CASSLRNSNQPQHF	TRBV7-3	TRBJ1-5
TGCAGTGCTCGACAGGGGTTGCAGTTCTTC	CSARQGLQFF	TRBV20-1	TRBJ2-1
TGTGCCAGCAGCTCTGAAATCGGCCGGAGGGGATCCAAAGCACCCACAGATACGCAGTATTTT	CASSSEIGRRGSKAPTDTQYF	TRBV7-9	TRBJ2-3
TGTGCCAGTAGGGATCAGGGGGCTTACTCCTATAATTCACCCCTCCACTTT	CASRDQGAYSYNSPLHF	TRBV19	TRBJ1-6
TGTGCCAGCAGTGAAAGGGGAAAACCTAACACTGAAGCTTTCTTT	CASSERGKPNTEAFF	TRBV6-4	TRBJ1-1
TGTGCCAGCAGCCACCAGGTTCTAAGGGTGGGAGCCAGCTCCTACAATGAGCAGTTCTTC	CASSHQVLRVGASSYNEQFF	TRBV7-3	TRBJ2-1
TGTGCCAGTAGCCTCAACAGGGCGGGCCTGGTGGGGTACTATGGCTACACCTTC	CASSLNRAGLVGYYGYTF	TRBV19	TRBJ1-2
TGTGCCACCAGTGATTCTGATTCAACCTACGAGCAGTACTTC	CATSDSDSTYEQYF	TRBV24-1	TRBJ2-7
TGTGCCAAGTCTACGGGAGAGACCCAGTACTTC	CAKSTGETQYF	TRBV19	TRBJ2-5
TGTGCCAGTAGTATAGAGCACAGCGCTGGCTACACCTTC	CASSIEHSAGYTF	TRBV19	TRBJ1-2
TGTGCCAGCAGTAATGGGACAGGGAGCAATCAGCCCCAGCATTTT	CASSNGTGSNQPQHF	TRBV12-3	TRBJ1-5
TGCAGTGTTTGTCCGGGACAGGGGGGAGATGGCTACACCTTC	CSVCPGQGGDGYTF	TRBV20-1	TRBJ1-2
TGCAGTGGGCCCGGGGGATCTGGAAACACCATATATTTT	CSGPGGSGNTIYF	TRBV20-1	TRBJ1-3
TGTGCCAGCACCCTATACCAGCGGGATCTTCTAGAAGATACGCAGTATTTT	CASTLYQRDLLEDTQYF	TRBV6-5	TRBJ2-3
TGTGCCAGCAGTCGGAGCAGCATGGAGCAGTACTTC	CASSRSSMEQYF	TRBV12-3	TRBJ2-7
TGTGCCAGCAGTTGGTGCGGGGAAGAGACCCAGTACTTC	CASSWCGEETQYF	TRBV27	TRBJ2-5
TGCAAGACAGTACCCTACGAGCAGTACTTC	CKTVPYEQYF	TRBV10-1	TRBJ2-7
TGTGCCAGCAGTGGCGGGAGTGGGTACACTGAAGCTTTCTTT	CASSGGSGYTEAFF	TRBV6-4	TRBJ1-1
TGTGCCAGCAGCCCCCTAAAGTCCTCCGGGACAGGGGGCTATGGCTACACCTTC	CASSPLKSSGTGGYGYTF	TRBV11-3	TRBJ1-2
TGTGCCAGCAGCGCGGTGGGGAACACTGAAGCTTTCTTT	CASSAVGNTEAFF	TRBV13	TRBJ1-1
TGTGCCAGCAGCTTGGCCGACGGACAGGGGGCGGGGAACACTGAAGCTTTCTTT	CASSLADGQGAGNTEAFF	TRBV5-4	TRBJ1-1
TGCGCCAGCACCCCACAGGAGACCTACGAGCAGTACTTC	CASTPQETYEQYF	TRBV10-2	TRBJ2-7
TGTGCCAAGAAGCGGGAGGGCTACGAGCAGTACTTC	CAKKREGYEQYF	TRBV7-2	TRBJ2-7
TGTGCCACCAGTGAGCCCGGGGGGATTTGCCAACTGTTTTTT	CATSEPGGICQLFF	TRBV24-1	TRBJ1-4
TGTGCCAGCACGGATCGGGACAAGTATCTAGAGACCCAGTACTTC	CASTDRDKYLETQYF	TRBV12-3	TRBJ2-5
TGTGCCAGCAGTTACTCCCAGGAAAGGGCCTACGAGCAGTACTTC	CASSYSQERAYEQYF	TRBV6-5	TRBJ2-7
TGTGCCAGCAGTTATTCCCGGCAGGGGGGGGGCCTGGGTGGGACTGAAGCTTTCTTT	CASSYSRQGGGLGGTEAFF	TRBV6-2	TRBJ1-1
TGTGCCAGCTCACTTCGGACTGTTAAACAGCCCCAGCATTTT	CASSLRTVKQPQHF	TRBV18	TRBJ1-5
TGCGCCAGCAGCGGTAGGACAGTCAGGTTAGCTAACTATGGCTACACCTTC	CASSGRTVRLANYGYTF	TRBV5-1	TRBJ1-2
TGTGCCTGGAGACCGGGGGGGCCTTTCACAGATACGCAGTATTTT	CAWRPGGPFTDTQYF	TRBV30	TRBJ2-3
TGTGCCAGCAGTGTCAGGGGGGGGTCAACCGGGGAGCTGTTTTTT	CASSVRGGSTGELFF	TRBV27	TRBJ2-2
TGTGCCAGCAGCCCCCTACAGGGGACGGCGGCTTCGGGCTACACCTTC	CASSPLQGTAASGYTF	TRBV13	TRBJ1-2
TGTGCCATCAGTTCTAACTGCAATCAGCCCCAGCATTTT	CAISSNCNQPQHF	TRBV10-3	TRBJ1-5
TGTGCCACCAACCGGGACAGTGGGGGACGGTACACTGAAGCTTTCTTT	CATNRDSGGRYTEAFF	TRBV24-1	TRBJ1-1
TGCAGCGACGGTGGACCGGTGGACAATCAGCCCCAGCATTTT	CSDGGPVDNQPQHF	TRBV29-1	TRBJ1-5
TGTGCCAGCAGCCTGGGGGGGCCTGACTTGAATGGCTACAATGAGCAGTTCTTC	CASSLGGPDLNGYNEQFF	TRBV4-2	TRBJ2-1
TGTGCCAGCAGCGTTAGTTCCGAGGGAATAAAAGAGACCCAGTACTTC	CASSVSSEGIKETQYF	TRBV9	TRBJ2-5
TGTGCCAGCAGTGACTCGACCCGACAGGGGGGGGCCTACGAGCAGTACTTC	CASSDSTRQGGAYEQYF	TRBV6-4	TRBJ2-7
TGTGCCAGCAGCAGCGGGATCTCCCGGCAAGAGACCCAGTACTTC	CASSSGISRQETQYF	TRBV13	TRBJ2-5
TGCGCCAGCTGCCTAGCGGGCTTGGGGGACGAGCAGTACTTC	CASCLAGLGDEQYF	TRBV10-1	TRBJ2-7
TGTGCCAGCAGCTTAGCAGGGGGTTATAGCAATCAGCCCCAGCATTTT	CASSLAGGYSNQPQHF	TRBV7-8	TRBJ1-5
TGTGCCACCGTTAGGGGGACTAGTCGGGACTACGAGCAGTACTTC	CATVRGTSRDYEQYF	TRBV24-1	TRBJ2-7
TGTGCCAGCAGTCCTCTGGGGGGTTCACCCCTCCACTTT	CASSPLGGSPLHF	TRBV6-5	TRBJ1-6
TGTGCCACATACCGCCCCGGTGAAGCTTTCTTT	CATYRPGEAFF	TRBV24-1	TRBJ1-1
TGTGCCAGCAGCTTGGGGGTCTATGTCACTAGATCCTACGAGCAGTACTTC	CASSLGVYVTRSYEQYF	TRBV7-9	TRBJ2-7
TGTGCCAAGGCTCTTTTCTACAATGAGCAGTTCTTC	CAKALFYNEQFF	TRBV6-5	TRBJ2-1
TGCAGTGCTAGTCTGGACAGGGAGAGCTCCTACGAGCAGTACTTC	CSASLDRESSYEQYF	TRBV20-1	TRBJ2-7
TGCGCCAGCAGCTGCACCAGATCAGATACGCAGTATTTT	CASSCTRSDTQYF	TRBV5-1	TRBJ2-3
TGTGCCAGCAGCTTAGGCCCACAGGGCCAATGTGGGACAGATACGCAGTATTTT	CASSLGPQGQCGTDTQYF	TRBV11-2	TRBJ2-3
TGTGCCAGCAGCATCCCGGGACAGGGGTGTGATGGAGAGACCCAGTACTTC	CASSIPGQGCDGETQYF	TRBV5-4	TRBJ2-5
TGTGCCAGAGGCGATTTAAGGACAGGGAGGGGGGGTACGCAGTATTTT	CARGDLRTGRGGTQYF	TRBV13	TRBJ2-3
TGTGCCAGCGGGAAGGAGGGTAACTATGGCTACACCTTC	CASGKEGNYGYTF	TRBV2	TRBJ1-2
TGCGCCAGAACCATGCAGGGAAAGAATATGAACACTGAAGCTTTCTTT	CARTMQGKNMNTEAFF	TRBV10-1	TRBJ1-1
TGTGCCAGCAGCTGCCCCCCAGGCACCCGGTACACTGAAGCTTTCTTT	CASSCPPGTRYTEAFF	TRBV7-9	TRBJ1-1
TGTGCCAGCAGCTTGCCAGGTCCGGGCCGGGACAGGGATAATGAAAAACTGTTTTTT	CASSLPGPGRDRDNEKLFF	TRBV5-4	TRBJ1-4
TGTGCCAGCAGCTCGGGGGACTGTGACAGTGGCTCCTACGAGCAGTACTTC	CASSSGDCDSGSYEQYF	TRBV13	TRBJ2-7
TGTGCCAGCAGTAGGAAAGCGGCCCACTCTAGTAGAGAGACCCAGTACTTC	CASSRKAAHSSRETQYF	TRBV12-3	TRBJ2-5
TGCGCCAGCAGTGCGAGACAGAACACCGGGGAGCTGTTTTTT	CASSARQNTGELFF	TRBV10-1	TRBJ2-2
TGTGCCTGGATAGCAGGGGGTGGTTCCTACAATGAGCAGTTCTTC	CAWIAGGGSYNEQFF	TRBV30	TRBJ2-1
TGTGCCAGCAGCCGGGGTTCAGATACGCAGTATTTT	CASSRGSDTQYF	TRBV7-3	TRBJ2-3
TGTGCCAGCAGCTTAGGCAGATTAGTAGGGGGGGCCCACGAGACCCAGTACTTC	CASSLGRLVGGAHETQYF	TRBV7-9	TRBJ2-5
TGTGCCAGCAGCCGCCCCCCGGGTCCCTACGAGCAGTACTTC	CASSRPPGPYEQYF	TRBV7-8	TRBJ2-7
TGTGCCAGCAGTTACTGTCCCGTCGAACAGGGGGTGCTAGGCTACACCTTC	CASSYCPVEQGVLGYTF	TRBV6-5	TRBJ1-2
TGTGCCAGCAGACTACAGGGGCAAGAGACCCAGTACTTC	CASRLQGQETQYF	TRBV7-3	TRBJ2-5
TGTGCCAGCAGCCAAGATTGCGGACTAGCGGCTAGTCTCACAGATACGCAGTATTTT	CASSQDCGLAASLTDTQYF	TRBV14	TRBJ2-3
TGTGCCAGCAGCCCGTCTAGAGGGGCACCTGTTCTCTACGAGCAGTACTTC	CASSPSRGAPVLYEQYF	TRBV7-2	TRBJ2-7
TGTGCCAGCAGGCCGACACTAGCGGGAGGGATTTCCTACAATGAGCAGTTCTTC	CASRPTLAGGISYNEQFF	TRBV6-1	TRBJ2-1
TGTGCCAGCAGCATGTGGACTAGCGTCGCTTACAATGAGCAGTTCTTC	CASSMWTSVAYNEQFF	TRBV5-6	TRBJ2-1
TGTGCCAGCAGCGACGAAACTAACACTGAAGCTTTCTTT	CASSDETNTEAFF	TRBV9	TRBJ1-1
TGTGCCAGCAGCCGACTAGTCGACAACATTCAGTACTTC	CASSRLVDNIQYF	TRBV3-1	TRBJ2-4
TGTGCCAGCAAAGGGACAGGGTCCTATCAGCCCCAGCATTTT	CASKGTGSYQPQHF	TRBV7-8	TRBJ1-5
TGTGCCAGCAGCCTTAGCGGGGGTGACCAAGAGACCCAGTACTTC	CASSLSGGDQETQYF	TRBV12-4	TRBJ2-5
TGTGCCACCAGTGTAGTTGGGGTAAAGACTGAAGCTTTCTTT	CATSVVGVKTEAFF	TRBV24-1	TRBJ1-1
TGTGCTAGTGGTAAGGGGGCGGCGACTAATGAAAAACTGTTTTTT	CASGKGAATNEKLFF	TRBV12-5	TRBJ1-4
TGCGCCAGGTTGGGACACGGCAATCAGCCCCAGCATTTT	CARLGHGNQPQHF	TRBV10-1	TRBJ1-5
TGCGCCAGCATTGTAGGGTTGGGGATGTCCTATAGCAATCAGCCCCAGCATTTT	CASIVGLGMSYSNQPQHF	TRBV4-1	TRBJ1-5
TGTGCCAGCACCCCGGGGCCTTCTCTGCAGTTCTTC	CASTPGPSLQFF	TRBV6-5	TRBJ2-1
TGTGCTAGTGGTCCGGATAGCGGGCGGAGCTACGAGCAGTACTTC	CASGPDSGRSYEQYF	TRBV12-5	TRBJ2-7
TGTGCCAGCAGCTTGGCCGGGACAGGGGCTCGCTCCTACGAGCAGTACTTC	CASSLAGTGARSYEQYF	TRBV5-6	TRBJ2-7
TGTGCCATCTATTCACCCCTCCACTTT	CAIYSPLHF	TRBV27	TRBJ1-6
TGCGCCAGCAGTGAGCAGGGGAACCGGGAACGAGAGACCCAGTACTTC	CASSEQGNRERETQYF	TRBV10-2	TRBJ2-5
TGTGCCAGCAGCTGGGAAGGTGGCACAGATACGCAGTATTTT	CASSWEGGTDTQYF	TRBV7-3	TRBJ2-3
TGTGCCAGCAGCGCAGGGGGTGAAGCTTTCTTT	CASSAGGEAFF	TRBV11-3	TRBJ1-1
TGCGCCAGCAGTGAGCAGGGTATTTTAGAAAACACTGAAGCTTTCTTT	CASSEQGILENTEAFF	TRBV10-1	TRBJ1-1
TGTGCCGGCTACTACAGGGTGTTTGAGACCCAGTACTTC	CAGYYRVFETQYF	TRBV30	TRBJ2-5
TGTGCCACCAGCAGAGATGACTACGAAGAGACCCAGTACTTC	CATSRDDYEETQYF	TRBV15	TRBJ2-5
TGTGCCAGCAGTCCCATTCCCGCAGCATTTGGGACACCCGGTGCGCCTGAAGCTTTCTTT	CASSPIPAAFGTPGAPEAFF	TRBV6-3	TRBJ1-1
TGTGCCAGCAGTTTAACGGGGGGGTACAATGAGCAGTTCTTC	CASSLTGGYNEQFF	TRBV27	TRBJ2-1
TGTGCCAGCAGCCTTAACGGACAGGGTCGGTCGGGCTACACCTTC	CASSLNGQGRSGYTF	TRBV7-3	TRBJ1-2
TGTGCCAGCAGTTTGTTGACCCCCCCAACTGGATTTGAGAGGGCTCACGAGCAGTACTTC	CASSLLTPPTGFERAHEQYF	TRBV28	TRBJ2-7
TGTGCCAGCAGTCCTGGGGGGCTTACTCGGAACACTGAAGCTTTCTTT	CASSPGGLTRNTEAFF	TRBV6-5	TRBJ1-1
TGTGCCAGCAGATTGGGGTCCCCGTCTACCGACAGTGCTAATGAAAAACTGTTTTTT	CASRLGSPSTDSANEKLFF	TRBV6-5	TRBJ1-4
TGTGCCAGCAGCCAAGGAGAAGTGGGGAGCCCTAGCGGGTGCTTCGAGACCCAGTACTTC	CASSQGEVGSPSGCFETQYF	TRBV3-1	TRBJ2-5
TGTGCCAGCAGTTACTGGGGACTAGCGGGTCATAAAGTGGAGAATGAGCAGTTCTTC	CASSYWGLAGHKVENEQFF	TRBV6-9	TRBJ2-1
TGTGCCAGCAGCGGGGGGACGGGGAAATATTTT	CASSGGTGKYF	TRBV5-4	TRBJ1-3
TGCGCCAGCAGCTTAGACGCCGATAATTTTACTGGGCGATATACGCATTTT	CASSLDADNFTGRYTHF	TRBV5-1	TRBJ1-5
TGTGCCATCAGTGAGTCGTTAGCTCTCGAGTTTTACTATGGCTACACCTTC	CAISESLALEFYYGYTF	TRBV10-3	TRBJ1-2
TGCAGTGCTACTAAGCCGCAGGAAAAGCTATACGAGCAGTACTTC	CSATKPQEKLYEQYF	TRBV20-1	TRBJ2-7
TGTGCCACCAGTGATTTTGTCCACTCGCGGGAGGTTCCCCCCGAAAAACTGTTTTTT	CATSDFVHSREVPPEKLFF	TRBV24-1	TRBJ1-4
TGCAGTGCTAGAGCCGGAGGGTTCACAGGGGTAGCCGGGGCCAACGTCCTGACTTTC	CSARAGGFTGVAGANVLTF	TRBV20-1	TRBJ2-6
TGCAGTGCTAGAGGCCACGACAGCGTTCAAGAGACCCAGTACTTC	CSARGHDSVQETQYF	TRBV20-1	TRBJ2-5
TGTGCCAGCAGCAGCGGAGCCCCCAATCAGCCCCAGCATTTT	CASSSGAPNQPQHF	TRBV6-4	TRBJ1-5
TGTGCCAGCAGCATCGTCAAGACTGGCTACACCTTC	CASSIVKTGYTF	TRBV13	TRBJ1-2
TGTGCCAGCAGATCGCGGGAGGTGGCTTTACATGAGCAGTTCTTC	CASRSREVALHEQFF	TRBV6-5	TRBJ2-1
TGTGCCAGCAGCTTGGACGTGGCGGGGGGAAGCTCCTACAATGAGCAGTTCTTC	CASSLDVAGGSSYNEQFF	TRBV5-6	TRBJ2-1
TGTGCCTGGAGAGGGGGGGGGCGGGCCGTACAAGAGACCCAGTACTTC	CAWRGGGRAVQETQYF	TRBV30	TRBJ2-5
TGCGCCAGCAGTGGGGGAGAACGAACTGAGCAGTTCTTC	CASSGGERTEQFF	TRBV10-1	TRBJ2-1
TGTGCCAGCAGTGGAGGTGCGGGGTCCTACAATGAGCAGTTCTTC	CASSGGAGSYNEQFF	TRBV2	TRBJ2-1
TGCAGTGCTAGAATCAGGGCACTACCCTACGAGCAGTACTTC	CSARIRALPYEQYF	TRBV20-1	TRBJ2-7
TGCAGTGCATTTCCGGGCTACAATGAGCAGTTCTTC	CSAFPGYNEQFF	TRBV20-1	TRBJ2-1
TGTGCCACCAGGGGGGGGAGAAACACCATATATTTT	CATRGGRNTIYF	TRBV24-1	TRBJ1-3
TGTGCCAGCACTAAGACAGGGGGGCGGTACGGGGAGCTGTTTTTT	CASTKTGGRYGELFF	TRBV27	TRBJ2-2
TGTGCCAGCAGCTCGGGACGTCTAGAGACCCAGTACTTC	CASSSGRLETQYF	TRBV13	TRBJ2-5
TGTGCCAGCAGCCTATGTCCCCACTACGAGCAGTACTTC	CASSLCPHYEQYF	TRBV6-4	TRBJ2-7
TGTGCCAGCAGAAACTCGGATTTTTGCCGGGACAGGGAGGTGATGAACACTGAAGCTTTCTTT	CASRNSDFCRDREVMNTEAFF	TRBV27	TRBJ1-1
TGTGCCAGCAGCGCCAGCTCCTACGAGCAGTACTTC	CASSASSYEQYF	TRBV6-3	TRBJ2-7
TGCAGTGCTAGATGGGAGGATTGTGAAGCTTTCTTT	CSARWEDCEAFF	TRBV20-1	TRBJ1-1
TGTGCCAGCAGTTTATCGGCGGAGGACGAGCAGTACTTC	CASSLSAEDEQYF	TRBV28	TRBJ2-7
TGTGCCAGCAGCTTAGTGAGAACCTTGAGGGCGGTCGAGAACACTGAAGCTTTCTTT	CASSLVRTLRAVENTEAFF	TRBV7-4	TRBJ1-1
TGCAGCGCCCAGGGGACAGCTGAGCAGTTCTTC	CSAQGTAEQFF	TRBV29-1	TRBJ2-1
TGTGCCAGCAGCCAGCACCCCGCCAGACAGGGAAATTCCTATGGCTACACCTTC	CASSQHPARQGNSYGYTF	TRBV3-1	TRBJ1-2
TGTGCCAGCAGCCAGTTGGGACATAGCTCCTATAATTCACCCCTCCACTTT	CASSQLGHSSYNSPLHF	TRBV14	TRBJ1-6
TGTGCCAGCAGCCCGGTCTCCTTAGAGCAGTTCTTC	CASSPVSLEQFF	TRBV7-6	TRBJ2-1
TGTCCGGGACAGAACTCTTGGTACGAGCAGTACTTC	CPGQNSWYEQYF	TRBV30	TRBJ2-7
TGTGCCCGGTTGAGAAACACCGGGGAGCTGTTTTTT	CARLRNTGELFF	TRBV11-2	TRBJ2-2
TGTGCCAGCAGCATTAATATCCGGGGGGGAGGAACAGATACGCAGTATTTT	CASSINIRGGGTDTQYF	TRBV7-3	TRBJ2-3
TGTGCCAGCAGTCCGCGGACAGCCTATGAAGCTTTCTTT	CASSPRTAYEAFF	TRBV28	TRBJ1-1
TGTGCCATCAGTGATCTAAGGGGGGCGCGCGAGCAGTACTTC	CAISDLRGAREQYF	TRBV10-3	TRBJ2-7
TGTGCCAGCAAGGGTTTCTGGGGATCCTCTTATCAGCCCCAGCATTTT	CASKGFWGSSYQPQHF	TRBV14	TRBJ1-5
TGCGCCAGCAGCTTAAAGACAGGGGTGCGGGACTATTTAACCTACGAGCAGTACTTC	CASSLKTGVRDYLTYEQYF	TRBV5-1	TRBJ2-7
TGTGCCAGACCTGTGACAGGTCGCAATCAGCCCCAGCATTTT	CARPVTGRNQPQHF	TRBV6-4	TRBJ1-5
TGTGCCAGCAGCACAGCCGGGACTAGGGGCTGGTACGAGCAGTACTTC	CASSTAGTRGWYEQYF	TRBV7-2	TRBJ2-7
TGTGCCAGCAGCCTGACCTCAGGGGGCAGATATCAGCCCCAGCATTTT	CASSLTSGGRYQPQHF	TRBV5-6	TRBJ1-5
TGTGCCAGCAGCCGTCAAACTTCCAAGGGGGGGGGGCATGAGCAGTTCTTC	CASSRQTSKGGGHEQFF	TRBV13	TRBJ2-1
TGTGCCAGCAGCTTAGATTTTAGCGGGTCCGAGACCCAGTACTTC	CASSLDFSGSETQYF	TRBV7-9	TRBJ2-5
TGTGCTAGTGGTTTGGCAAATATGGGCCGGGGGGTGAACACTGAAGCTTTCTTT	CASGLANMGRGVNTEAFF	TRBV12-5	TRBJ1-1
TGTGCCAGCAGAGGACAGATAGGGAGGCTCGATAGCAATCAGCCCCAGCATTTT	CASRGQIGRLDSNQPQHF	TRBV2	TRBJ1-5
TGTGCCAGCAGCTCAGGGGTAAGAAACACCATATATTTT	CASSSGVRNTIYF	TRBV11-2	TRBJ1-3
TGTGCCAGCAGCAGGCACGGCAGGGACAGGGCGGAAAGGGAGCAGTACTTC	CASSRHGRDRAEREQYF	TRBV11-1	TRBJ2-7
TGTGCCATCAGTGAGTTGGGGCTCGGAGAGACCCAGTACTTC	CAISELGLGETQYF	TRBV10-3	TRBJ2-5
TGCGCCAGCATTTACCGGGACGAACAGCCCCAGCATTTT	CASIYRDEQPQHF	TRBV5-1	TRBJ1-5
TGTGCCAGTGGAAGACAGGGATACGGAACTGGAAACACCATATATTTT	CASGRQGYGTGNTIYF	TRBV25-1	TRBJ1-3
TGTGCCAGTTGGACAGAAAAAAACACTGAAGCTTTCTTT	CASWTEKNTEAFF	TRBV6-1	TRBJ1-1
TGTGCCACCAGTGATTTGTGTCAACAGGGTCCCTGGTCACCCCTCCACTTT	CATSDLCQQGPWSPLHF	TRBV24-1	TRBJ1-6
TGTGCCAGCAGCTCACCGCGACAGGGCACCGGGGAGCTGTTTTTT	CASSSPRQGTGELFF	TRBV7-6	TRBJ2-2
TGTGCCAGCAGCACGTTCTGTTACTACGAGCAGTACTTC	CASSTFCYYEQYF	TRBV13	TRBJ2-7
TGTGCCGTCTTCCGCCATTCCGCAGACGAGCAGTACTTC	CAVFRHSADEQYF	TRBV6-5	TRBJ2-7
TGTGCCATCCTCAGGGGTCATTTGTGCTACGAGCAGTACTTC	CAILRGHLCYEQYF	TRBV7-9	TRBJ2-7
TGCAGTGCCCTAGCGGGGGAAGCAACGAACACCGGGGAGCTGTTTTTT	CSALAGEATNTGELFF	TRBV20-1	TRBJ2-2
TGTGCCAGCAAGGGCCAGGGCAATGAGCAGTTCTTC	CASKGQGNEQFF	TRBV5-4	TRBJ2-1
TGCGCCAGCAGCCTAGCCCCGGGGGGCCCAGTGGACTACAATGAGCAGTTCTTC	CASSLAPGGPVDYNEQFF	TRBV4-1	TRBJ2-1
TGTGCCAGCTTTAGGGAGGACAGGGGTGTCTACGAGCAGTACTTC	CASFREDRGVYEQYF	TRBV6-4	TRBJ2-7
TGTGCCAGCAGTCTTTATACACTAGCGGGAGGGCGAGCCTACGAGCAGTACTTC	CASSLYTLAGGRAYEQYF	TRBV27	TRBJ2-7
TGTGCCAGCAGCCCGTCCTTAAAACGGTACGAGCAGTACTTC	CASSPSLKRYEQYF	TRBV7-3	TRBJ2-7
TGTGCCAGCAGGACAGCCGGGGCCAACGTCCTGACTTTC	CASRTAGANVLTF	TRBV7-6	TRBJ2-6
TGTGCCAGCAGTTTACACAGGGTCGGGGACACTGAAGCTTTCTTT	CASSLHRVGDTEAFF	TRBV27	TRBJ1-1
TGTGCCAGCAGTCAGGGCGGGAGGTGGGCGAAGGGAGTGGCCGGCTATGGCTACACCTTC	CASSQGGRWAKGVAGYGYTF	TRBV28	TRBJ1-2
TGTGCCAGCAGCGAGGGGGGGGGGGATCCCTTGCACTATGGCTACACCTTC	CASSEGGGDPLHYGYTF	TRBV9	TRBJ1-2
TGTGCCAGCAGCGTAGGGGGCCAGGTAAAAGAGCAGTACTTC	CASSVGGQVKEQYF	TRBV9	TRBJ2-7
TGTGCCAGTAGTATAGAAGGGCAAGGTAGTGGAAACACCATATATTTT	CASSIEGQGSGNTIYF	TRBV19	TRBJ1-3
TGTGCCAGCAGCGCCGGGACAGGGGGGAACACCATATATTTT	CASSAGTGGNTIYF	TRBV11-3	TRBJ1-3
TGCAGTGCAATCACGCCCGATACGCAGTATTTT	CSAITPDTQYF	TRBV20-1	TRBJ2-3
TGCAGCGTTGAAGATAGGACTAGCGGGGGGGCCAGGCGCACCGGGGAGCTGTTTTTT	CSVEDRTSGGARRTGELFF	TRBV29-1	TRBJ2-2
TGTGCCAGCTCACCAGTGTACCGGACAGGGGGGCACTACGAGCAGTACTTC	CASSPVYRTGGHYEQYF	TRBV18	TRBJ2-7
TGTGCCAGCAGCCAGGGACCTAATCAGCCCCAGCATTTT	CASSQGPNQPQHF	TRBV3-1	TRBJ1-5
TGCAGTGCGACCGCAACAGGGCAGAATAGCAATCAGCCCCAGCATTTT	CSATATGQNSNQPQHF	TRBV20-1	TRBJ1-5
TGTGCCAGCAGTGAAGCGGTTCGGGGGAGCTCCTACGAGCAGTACTTC	CASSEAVRGSSYEQYF	TRBV6-1	TRBJ2-7
TGTGCCAGCAGCCAAGCGGGGGACAGCCGGAAACTAGGAAACACCATATATTTT	CASSQAGDSRKLGNTIYF	TRBV3-1	TRBJ1-3
TGCGCCAGCCCTTTTGCCGGGACAGGGAAAGGCTCCTACAATGAGCAGTTCTTC	CASPFAGTGKGSYNEQFF	TRBV10-1	TRBJ2-1
TGCAGTGCTAGAGACTCAATTTCTACCCAAGAGACCCAGTACTTC	CSARDSISTQETQYF	TRBV20-1	TRBJ2-5
TGTGCCAGCACGGGGTTCCACAGGGGGCATCCTATGAACACTGAAGCTTTCTTT	CASTGFHRGHPMNTEAFF	TRBV5-4	TRBJ1-1
TGTGCCAGCAGCGGGCGGGGGACTGCGCACACTGAAGCTTTCTTT	CASSGRGTAHTEAFF	TRBV5-8	TRBJ1-1
TGTGCCAGCAGTTTGTTTACTGTTAGAGGCAATCAGCCCCAGCATTTT	CASSLFTVRGNQPQHF	TRBV27	TRBJ1-5
TGTGCCAGCAGCTCCGGTCCTCCCGATACGCAGTATTTT	CASSSGPPDTQYF	TRBV7-8	TRBJ2-3
TGTGCCAGCAGCTTAACGCGGGGGACAGGGGGCGCTTCTCACAATGAGCAGTTCTTC	CASSLTRGTGGASHNEQFF	TRBV7-3	TRBJ2-1
TGCGCCAGCAGAGTGAAAGCCGGGACAGGGTACGAGCCAACTAATGAAAAACTGTTTTTT	CASRVKAGTGYEPTNEKLFF	TRBV10-1	TRBJ1-4
TGTGCCAGCAGTGTCGAGACCAGGGTTTATAACTATGGCTACACCTTC	CASSVETRVYNYGYTF	TRBV6-4	TRBJ1-2
TGTGCCAGTACGCGGACACAGCCCCAGCATTTT	CASTRTQPQHF	TRBV19	TRBJ1-5
TGTGCCAGCTTCCTGTGGGGGAGGGACTACGAGCAGTACTTC	CASFLWGRDYEQYF	TRBV11-3	TRBJ2-7
TGTGCCAGCAGCGTTTCTGTCCGGGACTTGGCCTACGAGCAGTACTTC	CASSVSVRDLAYEQYF	TRBV7-2	TRBJ2-7
TGTGCCAGCATCTTAAGCGGGGGGGCAGGCTACGAGCAGTACTTC	CASILSGGAGYEQYF	TRBV6-8	TRBJ2-7
TGTTCCTACGTTTTTCTGCGGGACTCAAACTCCTACGAGCAGTACTTC	CSYVFLRDSNSYEQYF	TRBV6-6	TRBJ2-7
TGTGCCAGCAGCTCCGGGGACACTGAAGCTTTCTTT	CASSSGDTEAFF	TRBV7-2	TRBJ1-1
TGTGCCAGCAGCGCGGACAGGGGAGACTTC	CASSADRGDF	TRBV7-3	TRBJ2-7
TGTGCCAGCAGCGTACGGGACTACGAGCAGTACTTC	CASSVRDYEQYF	TRBV7-3	TRBJ2-7
TGTGCCAGCCAAAACCAGGGGTACGAGCAGTACTTC	CASQNQGYEQYF	TRBV6-1	TRBJ2-7
TGTGCCAGCAGTTCCCATGGGGGGGTTAGGACGCCTCCCTACAATGAGCAGTTCTTC	CASSSHGGVRTPPYNEQFF	TRBV6-9	TRBJ2-1
TGTGCCAGTAGAACTAGCGGGAGCAATGAGCAGTTCTTC	CASRTSGSNEQFF	TRBV5-6	TRBJ2-1
TGTGCCAGCGCTGGCAAGGGATACCATCAGCCCCAGCATTTT	CASAGKGYHQPQHF	TRBV2	TRBJ1-5
TGCGCCAGCAGCATCGTATCGTTTTTGGGGGGAAGCAATCAGCCCCAGCATTTT	CASSIVSFLGGSNQPQHF	TRBV5-1	TRBJ1-5
TGCAGTGCTAGAGATACACCCTGGGGGGGCCTAGATGAGACCCAGTACTTC	CSARDTPWGGLDETQYF	TRBV20-1	TRBJ2-5
TGTGCCACCAGTGATCAGAGGGAAGTATGGGGGGAGGGCACAGATACGCAGTATTTT	CATSDQREVWGEGTDTQYF	TRBV24-1	TRBJ2-3
TGTGCCTGGACGAAGTTATGGCAATCAGAAAGCAGGCGGACTAGCGGGGAGGCCCAGTACTTC	CAWTKLWQSESRRTSGEAQYF	TRBV30	TRBJ2-5
TGTGCCAGCAGCCGGCACCGGGACAGAGGGAATGAAAAACTGTTTTTT	CASSRHRDRGNEKLFF	TRBV11-2	TRBJ1-4
TGCAAACAGGGATCTGTTAATGAAAAACTGTTTTTT	CKQGSVNEKLFF	TRBV20-1	TRBJ1-4
TGTGCCAGCAGAGGGCAAAGAAGCAATCAGCCCCAGCATTTT	CASRGQRSNQPQHF	TRBV7-3	TRBJ1-5
TGCGCCAGCAGCTCTGACCCCCGGGACAGGGACCGCCTCTCTGGAAACACCATATATTTT	CASSSDPRDRDRLSGNTIYF	TRBV5-1	TRBJ1-3
TGCGCCAGCGGGGGGGGGGGACAAGAGACCCAGTACTTC	CASGGGGQETQYF	TRBV5-1	TRBJ2-5
TGTGCCAGCACCGGCGGAAACGAGCAGTACTTC	CASTGGNEQYF	TRBV28	TRBJ2-7
TGCGCCAGCAGCTCCTCGCGTGGGACAGCCTACGAGCAGTACTTC	CASSSSRGTAYEQYF	TRBV5-1	TRBJ2-7
TGTGCCAGTACACGTGGTTCAGGGGAAAAACTGTTTTTT	CASTRGSGEKLFF	TRBV19	TRBJ1-4
TGTGCCAGCAGCGGTTACGGACCGAACACCGGGGAGCTGTTTTTT	CASSGYGPNTGELFF	TRBV9	TRBJ2-2
TGTGCCACCAGGAAAGCGGGAGTCCTGGGAAATCAGCCCCAGCATTTT	CATRKAGVLGNQPQHF	TRBV24-1	TRBJ1-5
TGTGCCAGCAGTTACCGGACGCTAGCCAAAAACATTCAGTACTTC	CASSYRTLAKNIQYF	TRBV6-6	TRBJ2-4
TGTGCCAGCAGCCCCCCGGGACACGGTCAGCCCCAGCATTTT	CASSPPGHGQPQHF	TRBV7-3	TRBJ1-5
TGTGCCAGTCTTGACAGGGTGTCCATTCCAGCCAAAAACATTCAGTACTTC	CASLDRVSIPAKNIQYF	TRBV19	TRBJ2-4
TGTGCCAGCTCGGGGGAAAAACTGTTTTTT	CASSGEKLFF	TRBV18	TRBJ1-4
TGTGCCAGCAGTTACACAGGGCGGGCCTACGAGCAGTACTTC	CASSYTGRAYEQYF	TRBV6-5	TRBJ2-7
TGTGCCAGCAGCAGTCCTTCCGGACGTAGCACAGATACGCAGTATTTT	CASSSPSGRSTDTQYF	TRBV5-6	TRBJ2-3
TGTGCCAGCTCCCGGACCATCTATCAGCCCCAGCATTTT	CASSRTIYQPQHF	TRBV27	TRBJ1-5
TGTGCCTGGAGTGTGAATTCTAATCAAGCTTTCTTT	CAWSVNSNQAFF	TRBV30	TRBJ1-1
TGCGCCAGCAGCTCTCGGGGTCGGGATGAAGCTTTCTTT	CASSSRGRDEAFF	TRBV5-1	TRBJ1-1
TGTGCCAGCAGCATATCCGTAGCGGGGCAGGAGCTGTTTTTT	CASSISVAGQELFF	TRBV13	TRBJ2-2
TGCGCCAGTGGGGAGGTGGGTGCGGGAGATACAGATACGCAGTATTTT	CASGEVGAGDTDTQYF	TRBV5-1	TRBJ2-3
TGTGCCAGCGAAGAATTGGGGAAAATCCACTATGGCTACACCTTC	CASEELGKIHYGYTF	TRBV27	TRBJ1-2
TGCGCCAGCAGTCCTCAGCGGGAGAATGAGCAGTTCTTC	CASSPQRENEQFF	TRBV10-1	TRBJ2-1
TGTGCCAGCAGTTTGTCCAGGGGTAACTATGGCTACACCTTC	CASSLSRGNYGYTF	TRBV27	TRBJ1-2
TGTGCCAGCCATCCAGAGCCGACACAGGGAAGCTATGGCTACACCTTC	CASHPEPTQGSYGYTF	TRBV28	TRBJ1-2
TGTGCCAGCAGGTCAAGGGCGAGGACTGAAGCTTTCTTT	CASRSRARTEAFF	TRBV2	TRBJ1-1
TGTGCCAGCAGTTATTGGGGCTACGAGCAGTACTTC	CASSYWGYEQYF	TRBV6-9	TRBJ2-7
TGTGCCAGCGTCTATGATGTTTGTGTTGAAGCTTTCTTT	CASVYDVCVEAFF	TRBV27	TRBJ1-1
TGTGCCTGGGAGACTAGCGGGAGGGCCCGGTCTTATCCACGGAACTATGGCTACACCTTC	CAWETSGRARSYPRNYGYTF	TRBV30	TRBJ1-2
TGTGCCAGCAGCCGGGACAGAACTTACAGCTCCTACGAGCAGTACTTC	CASSRDRTYSSYEQYF	TRBV11-2	TRBJ2-7
TGTGCCAGCGCACAATTTAGGAGGTCCTACGAGCAGTACTTC	CASAQFRRSYEQYF	TRBV6-1	TRBJ2-7
TGTGCCAGCAGCCAAGTTCGGACAGGGCGGGCACAGCCCCAGCATTTT	CASSQVRTGRAQPQHF	TRBV3-1	TRBJ1-5
TGTGCCAGCAACCGGCAGTTCTACGCAGGGGGCGAAGTTCATGGCTACACCTTC	CASNRQFYAGGEVHGYTF	TRBV7-2	TRBJ1-2
TGTGCCAGTAGTATGGCCGAGGGACAGGGGGTGGGACCCTTAGCCACAGATACGCAGTATTTT	CASSMAEGQGVGPLATDTQYF	TRBV19	TRBJ2-3
TGTGCCAGCAAGGCCGACGAGCAGTACTTC	CASKADEQYF	TRBV6-5	TRBJ2-7
TGTGCCAGCAGCGTCAAGAAGAACCGTAATCAGCCCCAGCATTTT	CASSVKKNRNQPQHF	TRBV6-2	TRBJ1-5
TGCAGTGCCTTTAGCGGGAAGATTTCTGGGGCCAACGTCCTGACTTTC	CSAFSGKISGANVLTF	TRBV20-1	TRBJ2-6
TGCAGTGACCGTGGGGATGGGGAAGGTCATAGCAATCAGCCCCAGCATTTT	CSDRGDGEGHSNQPQHF	TRBV20-1	TRBJ1-5
TGCGCCAGCAGCCAAGAGGTGCAGAGGGGGGCGGGGAACACTGAAGCTTTCTTT	CASSQEVQRGAGNTEAFF	TRBV4-3	TRBJ1-1
TGTGCCAGCAGGCTCTCAGCGGACAGGTACCAAGAGACCCAGTACTTC	CASRLSADRYQETQYF	TRBV28	TRBJ2-5
TGTGCCAGCAGAGAGGGGGCGCTCTCAAGCACAGATACGCAGTATTTT	CASREGALSSTDTQYF	TRBV6-6	TRBJ2-3
TGTGCCAGCAGTTTATCAGGCAGCTACGAGCAGTACTTC	CASSLSGSYEQYF	TRBV12-3	TRBJ2-7
TGCGCCAGCAGGGTTCCGGAGGATGAAAAACTGTTTTTT	CASRVPEDEKLFF	TRBV10-1	TRBJ1-4
TGTGCCACCAGTGATTACGACGGGGACAGTGTGAACACTGAAGCTTTCTTT	CATSDYDGDSVNTEAFF	TRBV24-1	TRBJ1-1
TGTGCCACCAGCCATTCACCCGGTAAGTCCGCGAACACCGGGGAGCTGTTTTTT	CATSHSPGKSANTGELFF	TRBV24-1	TRBJ2-2
TGTGCCAGCAGCTTACCGGGACAGGGGATAAGGCCCAACTATGGCTACACCTTC	CASSLPGQGIRPNYGYTF	TRBV7-9	TRBJ1-2
TGTGCCAGCAGCCAAGAGCGACGTCGGTGCGAAAAACTGTTTTTT	CASSQERRRCEKLFF	TRBV3-1	TRBJ1-4
TGTGCCAGCAGTCATCCGGGACTAGGGTCCGGGGAGCTGTTTTTT	CASSHPGLGSGELFF	TRBV6-4	TRBJ2-2
TGTGCCACCACCCAGGCTATAGGGGGCTATAGCAATCAGCCCCAGCATTTT	CATTQAIGGYSNQPQHF	TRBV6-2	TRBJ1-5
TGTGCCAGCAGTTTAACACGTTTTGCGGGAGGTCTTAGCAATCAGCCCCAGCATTTT	CASSLTRFAGGLSNQPQHF	TRBV12-4	TRBJ1-5
TGTGCCAGCAGGGTTGGCAGGGAGGGCAATCAGCCCCAGCATTTT	CASRVGREGNQPQHF	TRBV27	TRBJ1-5
TGTGCCAGCAGCCAGGGGGCAAAACTGTTTTTT	CASSQGAKLFF	TRBV7-2	TRBJ1-4
TGCAGTGCTAGAGATCTCGACCAGGGGAACACTGAAGCTTTCTTT	CSARDLDQGNTEAFF	TRBV20-1	TRBJ1-1
TGTGCCCCGGGGCTGTATCAGCCCCAGCATTTT	CAPGLYQPQHF	TRBV9	TRBJ1-5
TGCGCCAGCAGCCAAGTAGGTGGGACAGGGGGCCCTGCTGGCTACACCTTC	CASSQVGGTGGPAGYTF	TRBV4-1	TRBJ1-2
TGTGCCATCAGCCCCCGGACTAGCGGGGGGGGCACAGATACGCAGTATTTT	CAISPRTSGGGTDTQYF	TRBV10-3	TRBJ2-3
TGTGCCAGCAGTCCCCACGGGGATCGGAGGGGCTACAATGAGCAGTTCTTC	CASSPHGDRRGYNEQFF	TRBV28	TRBJ2-1
TGTGCCAGCAGCTTGGCCCCAGCGTACTGGAATCAGCCCCAGCATTTT	CASSLAPAYWNQPQHF	TRBV5-8	TRBJ1-5
TGTGCCAGCCCATACACCCCCACAGGGGGCGCGGGGAATGAGCAGTTCTTC	CASPYTPTGGAGNEQFF	TRBV7-8	TRBJ2-1
TGTGCCAGCGAAGGGGGCACAGATACGCAGTATTTT	CASEGGTDTQYF	TRBV14	TRBJ2-3
TGTGCCTGGAGTGTACTCAGGGCGGCAGTGGGGGAGGTTGAAACAACTAATGAAAAACTGTTTTTT	CAWSVLRAAVGEVETTNEKLFF	TRBV30	TRBJ1-4
TGTGCCAGCAGCCCCAGGAGGGGCCCTTCAGCCAAAAACATTCAGTACTTC	CASSPRRGPSAKNIQYF	TRBV14	TRBJ2-4
TGTGCCATCAGGCCTTTGGGGGCACATCAGCCCCAGCATTTT	CAIRPLGAHQPQHF	TRBV10-3	TRBJ1-5
TGTGCCAGCGTCAGGGGGTTGAAGGAGGGCGGGTGGATGGTGAACACTGAAGCTTTCTTT	CASVRGLKEGGWMVNTEAFF	TRBV7-9	TRBJ1-1
TGTGCCCAACAGGGGAACACTGAAGCTTTCTTT	CAQQGNTEAFF	TRBV12-5	TRBJ1-1
TGTGCCAGCAGTGCCTTGGGTAATCATGGCTACACCTTC	CASSALGNHGYTF	TRBV6-4	TRBJ1-2
TGTGCCCATGGGACTAGTCCTTTCTTC	CAHGTSPFF	TRBV7-9	TRBJ2-1
TGTGCCAGCGGGGGCGATACCAATTCACCCCTCCACTTT	CASGGDTNSPLHF	TRBV6-5	TRBJ1-6
TGTGCCAGCACCATAGCAGTAGGAACAGATACGCAGTATTTT	CASTIAVGTDTQYF	TRBV6-2	TRBJ2-3
TGTGCTAGTGGGAGAAACCTAGAGACCCAGTACTTC	CASGRNLETQYF	TRBV12-5	TRBJ2-5
TGCGCCAGCACCGGGACAGGGCCCTACGAGCAGTACTTC	CASTGTGPYEQYF	TRBV10-1	TRBJ2-7
TGTGCCAGCAACAGGGTAACCCTCCACTTT	CASNRVTLHF	TRBV7-9	TRBJ1-6
TGTGCCAGCAGCGTCAGGTCTGGAAACACTGAAGCTTTCTTT	CASSVRSGNTEAFF	TRBV5-4	TRBJ1-1
TGCAGTGAGCCCCGGGACAGGGGGCATAATTCACCCCTCCACTTT	CSEPRDRGHNSPLHF	TRBV20-1	TRBJ1-6
TGCGCCAGCAGCTTAGGTGTCCGGACGTTCACTGAAGCTTTCTTT	CASSLGVRTFTEAFF	TRBV5-1	TRBJ1-1
TGTGCCAGCAGCCAAGAGGTGGGAGGTAATAGCACAGATACGCAGTATTTT	CASSQEVGGNSTDTQYF	TRBV14	TRBJ2-3
TGTGCCAGCAGGGCGGGATCGGTATATGGCTACACCTTC	CASRAGSVYGYTF	TRBV6-4	TRBJ1-2
TGTGCCCTCCTGCTAGCGGGCCGAGGAGGCCGAAGTTCCCAAGAGACCCAGTACTTC	CALLLAGRGGRSSQETQYF	TRBV6-5	TRBJ2-5
TGTGCCAGCAGTTTGGCCCAGGCAGGGGGCGAGCCCCAGCATTTT	CASSLAQAGGEPQHF	TRBV28	TRBJ1-5
TGTGCCAGCAGCCGAGGCCATACTGAAGCTTTCTTT	CASSRGHTEAFF	TRBV7-2	TRBJ1-1
TGTGCCAGCAGTCATAAGTCAGCTAATGAAAAACTGTTTTTT	CASSHKSANEKLFF	TRBV27	TRBJ1-4
TGCAGTGCTAGCCTTAGGGGTGGGGCCAAAAACATTCAGTACTTC	CSASLRGGAKNIQYF	TRBV20-1	TRBJ2-4
TGTGCCAGCAGACGTGTGTCGGGACTGGGGTTGGGATACGAGCAGTACTTC	CASRRVSGLGLGYEQYF	TRBV6-5	TRBJ2-7
TGTGCCAGCAGTGGGGGTGCCGAGCAGTACTTC	CASSGGAEQYF	TRBV27	TRBJ2-7
TGTGCCAGCAGCTTGCCTTATCTAGCGGGGCAAAACTACGAGCAGTACTTC	CASSLPYLAGQNYEQYF	TRBV5-4	TRBJ2-7
TGCAGTGCTAGGGGCCAGGGGTTTAGCAATCAGCCCCAGCATTTT	CSARGQGFSNQPQHF	TRBV20-1	TRBJ1-5
TGCGCCAGCAGCTTGGAATTGACAGGGGATGATGGCTACACCTTC	CASSLELTGDDGYTF	TRBV5-1	TRBJ1-2
TGCGCCAGCAGCTTGCCGAGGGACCCCCAATACAATGAGCAGTTCTTC	CASSLPRDPQYNEQFF	TRBV5-1	TRBJ2-1
TGTGCCAGCAGCGCCGGGCGGAGGGATCAGCCCCAGCATTTT	CASSAGRRDQPQHF	TRBV9	TRBJ1-5
TGTGCCAGCAGTGAAGACGTGGGACTAGCGGCAAAACAAGAGACCCAGTACTTC	CASSEDVGLAAKQETQYF	TRBV6-1	TRBJ2-5
TGCAGTGCCCCCTTAGTCCGGGGGCACACAGATACGCAGTATTTT	CSAPLVRGHTDTQYF	TRBV20-1	TRBJ2-3
TGTGCCAGCAGCAGTTATGCGGGCGGAGATACGCAGTATTTT	CASSSYAGGDTQYF	TRBV9	TRBJ2-3
TGTGCCAGCAGCTTAGGGGTGATTTCGATGGGACAGCCGGGAGGACCGCATTGCACAGATACGCAGTATTTT	CASSLGVISMGQPGGPHCTDTQYF	TRBV7-9	TRBJ2-3
TGTGCCAGCAGCTTAAGGATAGCGGGTAGAGTTAAGGGCTCCTACGAGCAGTACTTC	CASSLRIAGRVKGSYEQYF	TRBV7-8	TRBJ2-7
TGTGCCAGCACTGGACCTACAGGGGTCTTCTCTGGAAACACCATATATTTT	CASTGPTGVFSGNTIYF	TRBV2	TRBJ1-3
TGCAGTGCTAGTCCGCAGGGTACCGGGCAAGAGACCCAGTACTTC	CSASPQGTGQETQYF	TRBV20-1	TRBJ2-5
TGTGCCAGCAGTTTCGAGGGGGGGATTGGGAATGAGCAGTTCTTC	CASSFEGGIGNEQFF	TRBV27	TRBJ2-1
TGTGCCAGTATTGTATATCACAGGGGGGGCTCCTACGAGCAGTACTTC	CASIVYHRGGSYEQYF	TRBV19	TRBJ2-7
TGTGCCAGCAGCCAAGCAGTCGCCTCTGGAAACACCATATATTTT	CASSQAVASGNTIYF	TRBV4-2	TRBJ1-3
TGCGCCAGCAGCGAGGGAAACACTGAAGCTTTCTTT	CASSEGNTEAFF	TRBV5-1	TRBJ1-1
TGCGCCAGCACCCCCAGGGAGGGCTCTGGAAACACCATATATTTT	CASTPREGSGNTIYF	TRBV5-1	TRBJ1-3
TGTGCCAGCAGCTTACGGCCCAGCTCCTACAATGAGCAGTTCTTC	CASSLRPSSYNEQFF	TRBV11-2	TRBJ2-1
TGTGCCAGCAGCAAAAGACAGGTTAAGGGTTCTAACTATGGCTACACCTTC	CASSKRQVKGSNYGYTF	TRBV7-3	TRBJ1-2
TGCGCCAGCAGCTTTGAGTCGCACTCCTACGAGCAGTACTTC	CASSFESHSYEQYF	TRBV5-1	TRBJ2-7
TGCGCCAGCAGCTTGAAGTTTCCCGGGACTAGGGCTAGCACAGATACGCAGTATTTT	CASSLKFPGTRASTDTQYF	TRBV5-1	TRBJ2-3
TGCAGTGCTCCACCGTGGACCGGTTTATATCAGCCCCAGCATTTT	CSAPPWTGLYQPQHF	TRBV20-1	TRBJ1-5
TGTGCCAGCAGCCACAGGGCGAATGAGCAGTTCTTC	CASSHRANEQFF	TRBV7-3	TRBJ2-1
TGTGCCAGCAGCGGCATGCCTCGTAGACAGGGGGCGGGGGTGCCTCACTATGGCTACACCTTC	CASSGMPRRQGAGVPHYGYTF	TRBV7-9	TRBJ1-2
TGTGCCAGCAGCTTAGACGATATAGCGGGAGGCAATGAGCAGTTCTTC	CASSLDDIAGGNEQFF	TRBV11-1	TRBJ2-1
TGTGCCATCAGTGAGACGCTGACGGCTGTCGAAGACTTCAATGAAAAACTGTTTTTT	CAISETLTAVEDFNEKLFF	TRBV10-3	TRBJ1-4
TGCGCCAGCAGCCAAGCCGCGACAGGGATCCGGGTCTGCGAGCAGTACTTC	CASSQAATGIRVCEQYF	TRBV4-3	TRBJ2-7
TGTGCCAGCAGTATCCAATCACAGGGGGCAGCTAACTATGGCTACACCTTC	CASSIQSQGAANYGYTF	TRBV6-1	TRBJ1-2
TGTGCCAGCAGCTTAGAGTCTGACGCGCCCAGGGGTACAGATACGCAGTATTTT	CASSLESDAPRGTDTQYF	TRBV7-8	TRBJ2-3
TGTGCCTGGAGTGTGTTAGTGGGACAGGGGAGAATGAACACTGAAGCTTTCTTT	CAWSVLVGQGRMNTEAFF	TRBV30	TRBJ1-1
TGTGCCAGGAAAACTAGCGGGCACTACGAGCAGTACTTC	CARKTSGHYEQYF	TRBV6-2	TRBJ2-7
TGCAGTGCTCTTGGAAAACCGCCACGGGCTGAAGCTTTCTTT	CSALGKPPRAEAFF	TRBV20-1	TRBJ1-1
TGCAGTGCTAGCCGGGACAGCCACGACTATGGCTACACCTTC	CSASRDSHDYGYTF	TRBV20-1	TRBJ1-2
TGTGCCAGCACCGAGCTCGGGTGTAACTATGGCTACACCTTC	CASTELGCNYGYTF	TRBV6-2	TRBJ1-2
TGTGCCAGCAGTACACAGGGGGACAACACTGAAGCTTTCTTT	CASSTQGDNTEAFF	TRBV28	TRBJ1-1
TGTGCTAGTGGTTTGGGGTTTGGGGGGGGGGGACACAATGAGCAGTTCTTC	CASGLGFGGGGHNEQFF	TRBV12-5	TRBJ2-1
TGTGCCAGCAGCTTACCCCCGGGACACCGGGACTACGAGCAGTACTTC	CASSLPPGHRDYEQYF	TRBV11-3	TRBJ2-7
TGCAGTGCCCTCCTGATAGTCGAGGGCCGATACACTGAAGCTTTCTTT	CSALLIVEGRYTEAFF	TRBV20-1	TRBJ1-1
TGTGCCAGCTCACTCCGGGACAGGGGGGGGAAGTCACCCCTCCACTTT	CASSLRDRGGKSPLHF	TRBV18	TRBJ1-6
TGTGCCAGCAGCTGTCCGGTGGGAGGGAGCGTATACGAGCAGTACTTC	CASSCPVGGSVYEQYF	TRBV5-4	TRBJ2-7
TGTGCCAGCAGTTACGCGGCTGAAGCGAGGGGGGGGTACGAGCAGTACTTC	CASSYAAEARGGYEQYF	TRBV6-5	TRBJ2-7
TGTGCCAGCAGCGTTCCGGGGGGGCGTTCGAGGAATGAGCAGTTCTTC	CASSVPGGRSRNEQFF	TRBV13	TRBJ2-1
TGTGCCAGCAGCTTAAATGTAAGGGAGGGTACGCAGTATTTT	CASSLNVREGTQYF	TRBV7-3	TRBJ2-3
TGTGCCAGCAGCACAAGCGGGAGAAAACAAGAGACCCAGTACTTC	CASSTSGRKQETQYF	TRBV5-6	TRBJ2-5
TGTGCCAGCAGTGGTCAGGGGTCTGAAAAACTGTTTTTT	CASSGQGSEKLFF	TRBV27	TRBJ1-4
TGCAGTGCTAGAGTAGATCAATCCTATGGCTACACCTTC	CSARVDQSYGYTF	TRBV20-1	TRBJ1-2
TGTGCTAGTGGTTTCCACAACGGGGAGGGGTACGAGCAGTACTTC	CASGFHNGEGYEQYF	TRBV12-5	TRBJ2-7
TGTGCCACCAACCAGGACAGCGAGCAGTACTTC	CATNQDSEQYF	TRBV24-1	TRBJ2-7
TGTGCCAGCAGTTTATCCAAACCAAGGCACGGCTACACCTTC	CASSLSKPRHGYTF	TRBV28	TRBJ1-2
TGTGCCAGCAGCGGTCGTCCAGGGATGCAAGAGACCCAGTACTTC	CASSGRPGMQETQYF	TRBV13	TRBJ2-5
TGTGCCAGTAGTATAACCGGGCCTTGGACCGGGGAGCTGTTTTTT	CASSITGPWTGELFF	TRBV19	TRBJ2-2
TGCAGTGCTAACGGACAGGAAGAGACCCAGTACTTC	CSANGQEETQYF	TRBV20-1	TRBJ2-5
TGTGCCAGCTCACCACTAAAGACCCAGCATTTT	CASSPLKTQHF	TRBV18	TRBJ1-5
TGCGCCAGCAAAGACAGCCGCACAGATACGCAGTATTTT	CASKDSRTDTQYF	TRBV10-2	TRBJ2-3
TGCGCCAGCAGCGAGAAGGGGGGGAAAGACTCCTACAATGAGCAGTTCTTC	CASSEKGGKDSYNEQFF	TRBV5-1	TRBJ2-1
TGTGCCAGCAGCCTATTATACCCGCGACAGAACTCAGATCAGCCCCAGCATTTT	CASSLLYPRQNSDQPQHF	TRBV5-6	TRBJ1-5
