TGCGCCAGCAGCGGAGGGAACCCGGTTGAAGCTTTCTTT	CASSGGNPVEAFF	TRBV5-1	TRBJ1-1
TGTGCCAGCAGCGTAGCTGGGGGACAGGGTAGCAATCAGCCCCAGCATTTT	CASSVAGGQGSNQPQHF	TRBV9	TRBJ1-5
TGTGCCTGGAGTGTTCCCCCTTTCTGGGACAGGGGAAGCGAGCAGTACTTC	CAWSVPPFWDRGSEQYF	TRBV30	TRBJ2-7
TGTGCCAGCAGCCAAGAAGACAGAAAACTGTTTTTT	CASSQEDRKLFF	TRBV14	TRBJ1-4
TGTGCCAGCAGTTTAGAGGGGACTTACAATGAGCAGTTCTTC	CASSLEGTYNEQFF	TRBV12-3	TRBJ2-1
TGTGCCAGCAGCGGACTAGCGGGTGGGACCCAGTACTTC	CASSGLAGGTQYF	TRBV11-2	TRBJ2-5
TGTGCCAGCAGCTTGAAGACAGGGGGAATTTCCCGCTACGAGCAGTACTTC	CASSLKTGGISRYEQYF	TRBV5-6	TRBJ2-7
TGTGCCACCAGGGCGGAGGGGGGTAATTCACCCCTCCACTTT	CATRAEGGNSPLHF	TRBV24-1	TRBJ1-6
TGCAGTGCTCCTGGCTTTGGGGGAAAGCAAGAGACCCAGTACTTC	CSAPGFGGKQETQYF	TRBV20-1	TRBJ2-5
TGTGCCAGCAGTAAACCCCGACAGGTGGAGCAGTACTTC	CASSKPRQVEQYF	TRBV6-1	TRBJ2-7
TGTGCCTGGAGTAGAAGGGGAAGGGACTATGGCTACACCTTC	CAWSRRGRDYGYTF	TRBV30	TRBJ1-2
TGTGCCAGCAGCCAGGACACTGAAGCTTTCTTT	CASSQDTEAFF	TRBV13	TRBJ1-1
TGTGCCAGCAGCCCGAGGACCTACAATGAGCAGTTCTTC	CASSPRTYNEQFF	TRBV5-6	TRBJ2-1
TGCACAGGGAGGTGCAATCAGCCCCAGCATTTT	CTGRCNQPQHF	TRBV29-1	TRBJ1-5
TGTGCCAGCAGCAGTGAGGCACTGCGGGACATCTTTGGCACAGATACGCAGTATTTT	CASSSEALRDIFGTDTQYF	TRBV6-3	TRBJ2-3
TGTGCCAGCAGTGACTACACAGGTAAGCAGTACTTC	CASSDYTGKQYF	TRBV6-4	TRBJ2-7
TGTGCCAGCAGGGGGGCTCTTGCCAAAAACATTCAGTACTTC	CASRGALAKNIQYF	TRBV27	TRBJ2-4
TGCAGTGCTAGTTTCAGGGACCTTAAAGAGAGGCAAGAGACCCAGTACTTC	CSASFRDLKERQETQYF	TRBV20-1	TRBJ2-5
TGTGCCAGCGAGACAGGGATGAGGGTGTCAACCACCTACGAGCAGTACTTC	CASETGMRVSTTYEQYF	TRBV6-4	TRBJ2-7
TGTGCCAGCAGCCAAGAGGTAAATTGGCACGAGCAGTACTTC	CASSQEVNWHEQYF	TRBV3-1	TRBJ2-7
TGTGCCAGCAGCGAAGGGGCTAGCACAGATACGCAGTATTTT	CASSEGASTDTQYF	TRBV7-9	TRBJ2-3
TGTGCCTTACCGAGCACAGATACGCAGTATTTT	CALPSTDTQYF	TRBV28	TRBJ2-3
TGTGCCAGCGGACGACTGTTTAACAATCAGCCCCAGCATTTT	CASGRLFNNQPQHF	TRBV25-1	TRBJ1-5
TGTGCCAGCAGGTGGGCAGGGACTGAAAAACTGTTTTTT	CASRWAGTEKLFF	TRBV12-3	TRBJ1-4
TGTGCCAGCAGTCGCCCGTACAATGAGCAGTTCTTC	CASSRPYNEQFF	TRBV27	TRBJ2-1
TGTGCCAGCCTGCCCTTGGGGGGAGAGACCCAGTACTTC	CASLPLGGETQYF	TRBV6-4	TRBJ2-5
TGTGCCAGCAGCCAAGGAGCAGGGGTCCGCTTCTCCTACGAGCAGTACTTC	CASSQGAGVRFSYEQYF	TRBV3-1	TRBJ2-7
TGTGCCAGCAGTTACTCGGTCCAGGTTCTCAGGGGGCTTGGTGCTTATAGCAATCAGCCCCAGCATTTT	CASSYSVQVLRGLGAYSNQPQHF	TRBV6-3	TRBJ1-5
TGTGCCAGCAGCTTAGGGGCATCGGGGAAGGGGATGAACACTGAAGCTTTCTTT	CASSLGASGKGMNTEAFF	TRBV7-4	TRBJ1-1
TGTGCTAGTGGTTTGGTAACTAGCGGGAGATACTACGAGCAGTACTTC	CASGLVTSGRYYEQYF	TRBV12-5	TRBJ2-7
TGCGCCAGCAGTGGGTACGGAGCTCGGGAATATGAAGCTTTCTTT	CASSGYGAREYEAFF	TRBV10-1	TRBJ1-1
TGTGCCAGAGAGCGAGCTTTCACAGATACGCAGTATTTT	CARERAFTDTQYF	TRBV9	TRBJ2-3
TGTGCCAGCCCCCCGGGACGAACCTACGAGCAGTACTTC	CASPPGRTYEQYF	TRBV28	TRBJ2-7
TGTGCCAGCTCACCACTTAGCCCCCTGGGACAGGACTCTGGAAACACCATATATTTT	CASSPLSPLGQDSGNTIYF	TRBV18	TRBJ1-3
TGTGCCAGCAGCTTAAATTCAAGGGGAAGACAGCCCCTCCACTTT	CASSLNSRGRQPLHF	TRBV7-3	TRBJ1-6
TGTGCCAGCAGCCGTTGGGGACAGGGGGCAACGAACTATGGCTACACCTTC	CASSRWGQGATNYGYTF	TRBV7-3	TRBJ1-2
TGTGCCAGCAGTGACGGGTCGGACGGATACGAGCAGTACTTC	CASSDGSDGYEQYF	TRBV6-4	TRBJ2-7
TGCGCCAGCAGCTTGCCGAGACCTAGGGGGGGCTTTAGGACAGAGACCCAGTACTTC	CASSLPRPRGGFRTETQYF	TRBV5-1	TRBJ2-5
TGTGCCATCACTAGCGGATTTCCGAGGGCCCTAGATACGCAGTATTTT	CAITSGFPRALDTQYF	TRBV10-3	TRBJ2-3
TGCGCCAGCAGTGGGACTTACAGCCCGAGGGCTGGGGCCAACGTCCTGACTTTC	CASSGTYSPRAGANVLTF	TRBV5-1	TRBJ2-6
TGCGCCAGCAGATCTTTACAGGGGGCGACCGGTGAGCACGCCGATACGCAGTATTTT	CASRSLQGATGEHADTQYF	TRBV4-1	TRBJ2-3
TGTGCCAGCATTCTGGGGGCGCAGCCCCAGCATTTT	CASILGAQPQHF	TRBV7-6	TRBJ1-5
TGTGCCAGCAGTAAAAGGACTGAAAAACTGTTTTTT	CASSKRTEKLFF	TRBV25-1	TRBJ1-4
TGTGCCAGCAGCGTAACCGGACAGGTAATGAACACCGGGGAGCTGTTTTTT	CASSVTGQVMNTGELFF	TRBV7-3	TRBJ2-2
TGCGCCAGCAGTGAAATCCGCAGGGGGCGTAAATATAACACTGAAGCTTTCTTT	CASSEIRRGRKYNTEAFF	TRBV10-1	TRBJ1-1
TGTGCCAGCAGCTTGGCCGGGACAGAATGCAATCAGCCCCAGCATTTT	CASSLAGTECNQPQHF	TRBV5-6	TRBJ1-5
TGTGCCAGCAGCCAAGTGCAGTACGAAAAACTGTTTTTT	CASSQVQYEKLFF	TRBV3-1	TRBJ1-4
TGTGCCAGCAGTGACTCGAAACTAGCGGGGGAAGAGACCCAGTACTTC	CASSDSKLAGEETQYF	TRBV6-4	TRBJ2-5
TGTGCTCGAAAGGGCGTCTCCTACAATGAGCAGTTCTTC	CARKGVSYNEQFF	TRBV2	TRBJ2-1
TGCGCCAGCAGCTTGGTCAGGGGGGGCCATATGAACACTGAAGCTTTCTTT	CASSLVRGGHMNTEAFF	TRBV5-1	TRBJ1-1
TGTGCCAGCAGTCCAACGGACAGAACTACTAATGAAAAACTGTTTTTT	CASSPTDRTTNEKLFF	TRBV6-5	TRBJ1-4
TGTGCCAGCAGCAGAGGGCGGGCTTTCTTT	CASSRGRAFF	TRBV13	TRBJ1-1
TGCGCCAGCAGCCAAGATACGGGGGGCGTCACCGGGGAGCTGTTTTTT	CASSQDTGGVTGELFF	TRBV4-3	TRBJ2-2
TGTGCCAGCAGCATACAGGGGGCTTTTCGGGGTACTGAAGCTTTCTTT	CASSIQGAFRGTEAFF	TRBV6-1	TRBJ1-1
TGTGCCACCGTCGAGGGAGGGCAAGAGACCCAGTACTTC	CATVEGGQETQYF	TRBV15	TRBJ2-5
TGCGCCAGCAGATTTACGGGTGGGGCGCACGCTGAACTGTTTTTT	CASRFTGGAHAELFF	TRBV5-1	TRBJ1-4
TGTGCTCGACAGGGGCCTTATAGCAATCAGCCCCAGCATTTT	CARQGPYSNQPQHF	TRBV6-2	TRBJ1-5
TGTGCCAGCAGTGACTCGAAAGGACAGAAATATACGCAGTATTTT	CASSDSKGQKYTQYF	TRBV6-4	TRBJ2-3
TGTGCCAGCAGCGTAAAGGGGAGGGCCCTCTTC	CASSVKGRALF	TRBV7-9	TRBJ2-1
TGCGCCAGGGGACAGGTGGATGAAAAACTGTTTTTT	CARGQVDEKLFF	TRBV4-1	TRBJ1-4
TGTGCCAGCAGCCGGCGATACGGGACAGGGGCCCTGAACACTGAAGCTTTCTTT	CASSRRYGTGALNTEAFF	TRBV3-1	TRBJ1-1
TGTGCCAGCAGCCGAAGGGGTTTAGCGCAGCCCCAGCATTTT	CASSRRGLAQPQHF	TRBV7-3	TRBJ1-5
TGCAGTGCTAACCCGGGACTGCCTCCAGATACGCAGTATTTT	CSANPGLPPDTQYF	TRBV20-1	TRBJ2-3
TGTGCCAGCAGCTCCACCGAGAACGAGCAGTACTTC	CASSSTENEQYF	TRBV5-6	TRBJ2-7
TGTGCCAGCAGCTTCAGACAGGATACCTACGAGCAGTACTTC	CASSFRQDTYEQYF	TRBV7-8	TRBJ2-7
TGTGCCAGCAGCCCATGGGGAACGGATGAAAAACTGTTTTTT	CASSPWGTDEKLFF	TRBV11-3	TRBJ1-4
TGTGCCAGCAGTCCGAAGGGGACAGGATCGGATCTAAGCTATGGCTACACCTTC	CASSPKGTGSDLSYGYTF	TRBV28	TRBJ1-2
TGTGCCAGCAGCGTATGTCTATATGCCGACTACGAGCAGTACTTC	CASSVCLYADYEQYF	TRBV9	TRBJ2-7
TGTGCCAGCATCACGGGGCGGAGGTCGGGACAGCCCCAGCATTTT	CASITGRRSGQPQHF	TRBV28	TRBJ1-5
TGTGTTCCAGGGGGCCGAGAGACCGGGGAGCTGTTTTTT	CVPGGRETGELFF	TRBV5-6	TRBJ2-2
TGTGCCAGCAGTTTATCCCTCGTGAGGTACAATGAGCAGTTCTTC	CASSLSLVRYNEQFF	TRBV27	TRBJ2-1
TGTGCCAGCAGCGGACGAGGTCCCGACAGCCCTAATTCACCCCTCCACTTT	CASSGRGPDSPNSPLHF	TRBV5-4	TRBJ1-6
TGTGCCAGCAGCATAGGGTACGAGCAGTACTTC	CASSIGYEQYF	TRBV7-9	TRBJ2-7
TGTGCCAGCAGCCCGGGACTAGCGGGCCGCACAGATACGCAGTATTTT	CASSPGLAGRTDTQYF	TRBV7-9	TRBJ2-3
TGCGCCAGCAGGACATGCCGGACTAGCGGGTCCAAAAACATTCAGTACTTC	CASRTCRTSGSKNIQYF	TRBV10-1	TRBJ2-4
TGCAGTGCTAGCAGGCGGAAAGCACTTGCTAACTATGGCTACACCTTC	CSASRRKALANYGYTF	TRBV20-1	TRBJ1-2
TGTGCCGGCCTGGGACGGGTGGTAGAGACCCAGTACTTC	CAGLGRVVETQYF	TRBV3-1	TRBJ2-5
TGTGCCAGCAGCTTAGCGCCCAACGTCTACACTGAAGCTTTCTTT	CASSLAPNVYTEAFF	TRBV7-9	TRBJ1-1
TGTGCCAGCAGCCTCTGGGAAAGCACAGATACGCAGTATTTT	CASSLWESTDTQYF	TRBV3-1	TRBJ2-3
TGTGCCAGCAGTGAAGAGCCGGGACAGATTCCTTTACGCTGGAACACTGAAGCTTTCTTT	CASSEEPGQIPLRWNTEAFF	TRBV6-1	TRBJ1-1
TGCAGTGCCCCGGGACCTGAGACCCAGTACTTC	CSAPGPETQYF	TRBV20-1	TRBJ2-5
TGCAGTGCTAGAGAGAGCGGGAGCTCTTCCTATAATTCACCCCTCCACTTT	CSARESGSSSYNSPLHF	TRBV20-1	TRBJ1-6
TGCGCCAGCAGCCTACGGGGTAATGAGCAGTTCTTC	CASSLRGNEQFF	TRBV4-1	TRBJ2-1
TGTGCCACCAGAGTCTCCGGGGGGGTAACGCATGAGCAGTTCTTC	CATRVSGGVTHEQFF	TRBV24-1	TRBJ2-1
TGTGCCTGGAGTGTATGGGGGCTCTTGGACACTGAAGCTTTCTTT	CAWSVWGLLDTEAFF	TRBV30	TRBJ1-1
TGTGCCAGCTCAGGGCCAGAGGACTATGGCTACACCTTC	CASSGPEDYGYTF	TRBV2	TRBJ1-2
TGCGCCAGCGGGTCGACAGCCCCAGAGACCCAGTACTTC	CASGSTAPETQYF	TRBV10-1	TRBJ2-5
TGTGCCAGCAAAATTAGGGGGGGCCGGTCGAGGGAGACCCAGTACTTC	CASKIRGGRSRETQYF	TRBV7-3	TRBJ2-5
TGTGCCTGGAAGACGGGGTTATCGTCTCATCAGTTGAGTTCTCAGCCCCAGCATTTT	CAWKTGLSSHQLSSQPQHF	TRBV30	TRBJ1-5
TGTGCCACCACCTGGGACAGGGGGATCAACACTGAAGCTTTCTTT	CATTWDRGINTEAFF	TRBV24-1	TRBJ1-1
TGTGCCAGCAGTTACACGGGACTAGCGGGAGATCTGAATACGCAGTATTTT	CASSYTGLAGDLNTQYF	TRBV6-6	TRBJ2-3
TGCAGAACCACCCAATCGGTACTAGCGGGAGTGGCCATCTACGAGCAGTACTTC	CRTTQSVLAGVAIYEQYF	TRBV20-1	TRBJ2-7
TGTGCCAGCAGCTTGGCGCTCACGGGCTTTTCCTACAATGAGCAGTTCTTC	CASSLALTGFSYNEQFF	TRBV5-6	TRBJ2-1
TGTGCCAGCAGCGGGGGGCGAAGGGGAAAGAGCTCCTACAATGAGCAGTTCTTC	CASSGGRRGKSSYNEQFF	TRBV7-4	TRBJ2-1
TGTGCCAGCAGTTACCCGGGGGGGGAGATTAGCACAGATACGCAGTATTTT	CASSYPGGEISTDTQYF	TRBV6-8	TRBJ2-3
TGTGCCAGCAGCGTAAAAGCGGGCTTGGGAGGCACAGATACGCAGTATTTT	CASSVKAGLGGTDTQYF	TRBV9	TRBJ2-3
TGTGCTAGTGGTTTGCCCGGACCCGTCGCGAACACCGGGGAGCTGTTTTTT	CASGLPGPVANTGELFF	TRBV12-5	TRBJ2-2
TGTGCCACCTCATTCGAGCAGTACTTC	CATSFEQYF	TRBV24-1	TRBJ2-7
TGCAGTGCTATTTCTTCTGGGGCGGGCTATGGCTACACCTTC	CSAISSGAGYGYTF	TRBV20-1	TRBJ1-2
TGTGCCAGCAGGGTAGCGGCCCAGTACTTC	CASRVAAQYF	TRBV6-5	TRBJ2-5
TGTGCCAGCAGCAAATTGGCCCCCGGGACTAGCGGGAGCTTTCGGCACACTGAAGCTTTCTTT	CASSKLAPGTSGSFRHTEAFF	TRBV13	TRBJ1-1
TGTGCCACCAGTGATTTCGGACTAGCGGGTGGCTCCTACAATGAGCAGTTCTTC	CATSDFGLAGGSYNEQFF	TRBV24-1	TRBJ2-1
TGCAGCGTTGATAGTATCGCTAAAGCTGAAGCTTTCTTT	CSVDSIAKAEAFF	TRBV29-1	TRBJ1-1
TGTGCGTCATCAATAACAGGGGGCAACCAGCCCCAGCATTTT	CASSITGGNQPQHF	TRBV28	TRBJ1-5
TGTGCCAGCCACTCGAGAGCGGGAAGGAAGTACGAGCAGTACTTC	CASHSRAGRKYEQYF	TRBV7-3	TRBJ2-7
TGTGCCAGCAGCTTGCCTAGCGGGGGGCTGTACGAGCAGTACTTC	CASSLPSGGLYEQYF	TRBV7-9	TRBJ2-7
TGTGCCAGCAGCCTGGGGGTTCCCTACGAGCAGTACTTC	CASSLGVPYEQYF	TRBV11-1	TRBJ2-7
TGCGCCAGCAGCCAGGGAGCAGGCTCCTACGAGCAGTACTTC	CASSQGAGSYEQYF	TRBV4-1	TRBJ2-7
TGTGCCAGCAGCTTAGGACGTGGAACCGGGGGGGGCTATGGCTACACCTTC	CASSLGRGTGGGYGYTF	TRBV11-2	TRBJ1-2
TGTGCCAGCAGCCCCGGAGAGGGGGCCTACGAGCAGTACTTC	CASSPGEGAYEQYF	TRBV4-2	TRBJ2-7
TGTGCCAGCAGCGACAGGGGTGTAACAACTAATGAAAAACTGTTTTTT	CASSDRGVTTNEKLFF	TRBV11-2	TRBJ1-4
TGTGCCAGCAGCTTGGCTATTCGACTAGTACGCTCCTACAATGAGCAGTTCTTC	CASSLAIRLVRSYNEQFF	TRBV5-4	TRBJ2-1
TGTGCCAGCAGGACGGGAGAGAAGACAGATACGCAGTATTTT	CASRTGEKTDTQYF	TRBV5-4	TRBJ2-3
TGCGCCAGCAGCCACCCTAGGGGGCATACGGACCAAGAGACCCAGTACTTC	CASSHPRGHTDQETQYF	TRBV4-3	TRBJ2-5
TGTGCCAGCAGCTTAGCACTAGCGGCAATGCAAGAGACCCAGTACTTC	CASSLALAAMQETQYF	TRBV7-9	TRBJ2-5
TGTGCCAGCAGCGAAAGCACGGTATCAAGGGGAGTAGGTCAGCCCCAGCATTTT	CASSESTVSRGVGQPQHF	TRBV7-2	TRBJ1-5
TGTGCCAGCAGTGCCGGGACTAATGAGCAGTTCTTC	CASSAGTNEQFF	TRBV2	TRBJ2-1
TGTGCCAGCTCAAAGGCCCGACTAGCGGGGGAAGCCTACGAGCAGTACTTC	CASSKARLAGEAYEQYF	TRBV18	TRBJ2-7
TGTGCCAGCAGTTTCGAGGCACTAACTGGAAACACCATATATTTT	CASSFEALTGNTIYF	TRBV27	TRBJ1-3
TGTGCCTCCCCAACCCGGCGGGGGGGCGACTACGAGCAGTACTTC	CASPTRRGGDYEQYF	TRBV30	TRBJ2-7
TGTGCCACCATCGGGTCGGCAGGGCCCTCACCACGCAATCAGCCCCAGCATTTT	CATIGSAGPSPRNQPQHF	TRBV24-1	TRBJ1-5
TGTGCCAGCAGCAGACGCGGGACAGGGGGGGGCGGCTTTGGGAGGCAAGAGACCCAGTACTTC	CASSRRGTGGGGFGRQETQYF	TRBV13	TRBJ2-5
TGTGCCAGCAGCCGAGGGGAGTCAGGGCTAGCGGGCTCGAACACCGGGGAGCTGTTTTTT	CASSRGESGLAGSNTGELFF	TRBV7-9	TRBJ2-2
TGTGCCAGCAGCCACAAACTCTTCTGGGGGGGTAACTGGAACACCGGGGAGCTGTTTTTT	CASSHKLFWGGNWNTGELFF	TRBV14	TRBJ2-2
TGTGCCAGCAGCGGGACTAGATGTGAGCAGTTCTTC	CASSGTRCEQFF	TRBV13	TRBJ2-1
TGCAGCCCGGGGGGACACACTGAAGCTTTCTTT	CSPGGHTEAFF	TRBV29-1	TRBJ1-1
TGTGCCAGCAGTTTTATGGGGTGCCCGACAGGGGGATATGGCTACACCTTC	CASSFMGCPTGGYGYTF	TRBV28	TRBJ1-2
TGTGCCAGCAAGCAGGGCGATTTAGCTTTCTTT	CASKQGDLAFF	TRBV6-3	TRBJ1-1
TGCGCCAGCAGCTCCCCGATGGACAGGGGTTTTCCCGGGGAGCTGTTTTTT	CASSSPMDRGFPGELFF	TRBV5-1	TRBJ2-2
TGTGCCAGCAGTGAAGCCGGAGCGAACCGGCTGCGATCCTACGAGCAGTACTTC	CASSEAGANRLRSYEQYF	TRBV25-1	TRBJ2-7
TGTGCCACGACTAGCGGGAAGAGCTCCTACAATGAGCAGTTCTTC	CATTSGKSSYNEQFF	TRBV6-4	TRBJ2-1
TGTGCCAGCAGTCCCTGGCAATTGGGGGGGAGGTACGGGAACGAGCAGTACTTC	CASSPWQLGGRYGNEQYF	TRBV6-2	TRBJ2-7
TGCAGTGCTAGGTTACGGTACGAGCAGTACTTC	CSARLRYEQYF	TRBV20-1	TRBJ2-7
TGTGCCAGCAGCCAAGGGAAAAGGGACTTACTCAGCTCCTACAATGAGCAGTTCTTC	CASSQGKRDLLSSYNEQFF	TRBV14	TRBJ2-1
TGCAGTGCGCGGGGCTCCTACGAGCAGTACTTC	CSARGSYEQYF	TRBV20-1	TRBJ2-7
TGTGCCAGCCAGCCAGAGGGGGGAGGGCCTTACAATGAGCAGTTCTTC	CASQPEGGGPYNEQFF	TRBV6-5	TRBJ2-1
TGTGCCAGCAGTTCCATTGGAGGGGAGAGGGATGAAGCTTTCTTT	CASSSIGGERDEAFF	TRBV6-3	TRBJ1-1
TGTGCCAGCAGTTTCCGCCCGGGACAGCAGAACTTT	CASSFRPGQQNF	TRBV27	TRBJ1-1
TGCGCCAGCAGCCCCAATTTCGGCCTAGACGTTGGCTACACCTTC	CASSPNFGLDVGYTF	TRBV5-1	TRBJ1-2
TGTGCCTGGAGTGTACGGTCTCAGGGGGCCAGCTATGGCTACACCTTC	CAWSVRSQGASYGYTF	TRBV30	TRBJ1-2
TGTGCCAGCAGCATAGACAGGGATGAGACCCAGTACTTC	CASSIDRDETQYF	TRBV5-4	TRBJ2-5
TGTGCCAGCAGCTTAGGTAGGACTAGCGGGTTGAACTCCCGGGGTCAAGGAGCCAAAAACATTCAGTACTTC	CASSLGRTSGLNSRGQGAKNIQYF	TRBV7-2	TRBJ2-4
TGTGCCAGCAGCCGGAGAAAGACAGGGGGCTCCTACGAGCAGTACTTC	CASSRRKTGGSYEQYF	TRBV7-3	TRBJ2-7
TGTGCCAGCAGCGGCCAGGGACGGAAGAATGAGCAGTTCTTC	CASSGQGRKNEQFF	TRBV9	TRBJ2-1
TGTGCCAGCAGCCGGGACAGGGAAGACATGAACACTGAAGCTTTCTTT	CASSRDREDMNTEAFF	TRBV27	TRBJ1-1
TGCAGCGTTAACACCGGGGAGCTGTTTTTT	CSVNTGELFF	TRBV29-1	TRBJ2-2
TGCGCCAGCAGCCCCCGGAATGGAGGGACGACCAAAAACATTCAGTACTTC	CASSPRNGGTTKNIQYF	TRBV5-1	TRBJ2-4
TGTGCCACCAGTGATTTAAAGGGGGCGAGCTACAATGAGCAGTTCTTC	CATSDLKGASYNEQFF	TRBV24-1	TRBJ2-1
TGTGCCAGCAGCTTAGTCTGGACTAGAGGTCTCACAGATACGCAGTATTTT	CASSLVWTRGLTDTQYF	TRBV7-2	TRBJ2-3
TGTGCCAGCAGCCGGGACCGGGACAGGGTCACCGGGGAGCTGTTTTTT	CASSRDRDRVTGELFF	TRBV6-5	TRBJ2-2
TGCGCCAGCAGTGAGCGACAGGACAGGTACGGGCGCTATGGCTACACCTTC	CASSERQDRYGRYGYTF	TRBV10-2	TRBJ1-2
TGCAGTGCTGTAGGAACAGGGATACCAGATACGCAGTATTTT	CSAVGTGIPDTQYF	TRBV20-1	TRBJ2-3
TGTGCCAGCAGCTGCCTAAACAGAATATTCAGTCCCACTGAAGCTTTCTTT	CASSCLNRIFSPTEAFF	TRBV13	TRBJ1-1
TGTGCCATCAGCAGCCAGGGGGCCGGGTACTCTGGGGCCAACGTCCTGACTTTC	CAISSQGAGYSGANVLTF	TRBV10-3	TRBJ2-6
TGTGCCAGCTTAATGGGGGGATCCTACAATGAGCAGTTCTTC	CASLMGGSYNEQFF	TRBV7-2	TRBJ2-1
TGTGCCAGCAGTGAAGGTGAAGTCATTAGAAAAGGCTACGAGCAGTACTTC	CASSEGEVIRKGYEQYF	TRBV6-4	TRBJ2-7
TGTGCCAGCAGTGTCCGTGTGGGGGAGCCCAGCTCCTACGAGCAGTACTTC	CASSVRVGEPSSYEQYF	TRBV6-4	TRBJ2-7
TGTGCCAGCAGCCAAAGAGGGAGCAATCAGCCCCAGCATTTT	CASSQRGSNQPQHF	TRBV14	TRBJ1-5
TGTGCCAGCAGTTTGAGGACAGGGCTAGCTGAAGAGACCCAGTACTTC	CASSLRTGLAEETQYF	TRBV6-9	TRBJ2-5
TGTGCCAGCAGCAGGAGGGGGCCACATGAAAAACTGTTTTTT	CASSRRGPHEKLFF	TRBV7-9	TRBJ1-4
TGTGCCAGCAGTGACTCGACCGGGACATTCGGGGAGCTGTTTTTT	CASSDSTGTFGELFF	TRBV6-4	TRBJ2-2
TGTGCCAGCAGTTCGGACAGGGGAATCGGCTACACCTTC	CASSSDRGIGYTF	TRBV28	TRBJ1-2
TGCGCCAGCAGGGGAGTTCTCCAGGCCGAGCAGTACTTC	CASRGVLQAEQYF	TRBV10-1	TRBJ2-7
TGTGCCAGCACGGAGAGACTAGTGAATGAGCAGTTCTTC	CASTERLVNEQFF	TRBV7-9	TRBJ2-1
TGTGCTAGTGGTTTAGTGCCTAATCAGCCCCAGCATTTT	CASGLVPNQPQHF	TRBV12-5	TRBJ1-5
TGTGCCAGTAGTGCAGAGGGGGGGGGGGGGTACTACGAGCAGTACTTC	CASSAEGGGGYYEQYF	TRBV19	TRBJ2-7
TGTGCCAGCAGCTTGACGGGGGGGAATCAGCCCCAGCATTTT	CASSLTGGNQPQHF	TRBV7-3	TRBJ1-5
TGTGCCAGCAGCATTTCAAGGACAGTACACGAGCAGTACTTC	CASSISRTVHEQYF	TRBV13	TRBJ2-7
TGTGCCAGCATGCCAGGGGACAGGAACACTGAAGCTTTCTTT	CASMPGDRNTEAFF	TRBV12-3	TRBJ1-1
TGTGCCAGCAGCAGGGGGGGTCGAGGTAATGAAAAACTGTTTTTT	CASSRGGRGNEKLFF	TRBV7-3	TRBJ1-4
TGTGCCACCAGTGATTTTTCCGGGGACCCTCAGCCCCAGCATTTT	CATSDFSGDPQPQHF	TRBV24-1	TRBJ1-5
TGCGCCAGCAGCAGGGCGAAGACTAACTATGGCTACACCTTC	CASSRAKTNYGYTF	TRBV5-1	TRBJ1-2
TGTGCCAGCAGCCAATCGTTTACTACAGGGGCGGGCTACACCTTC	CASSQSFTTGAGYTF	TRBV7-4	TRBJ1-2
TGTGCCAGCAGCCAAGATCACCCGGGGGAGACCCAATCGGCGGAAGCTTTCTTT	CASSQDHPGETQSAEAFF	TRBV3-1	TRBJ1-1
TGTGCCAGCAGCCGGCGGGAGTCCTACAATGAGCAGTTCTTC	CASSRRESYNEQFF	TRBV9	TRBJ2-1
TGTGCCACCAGTGATTTGCTAGGCTCCTACGAGCAGTACTTC	CATSDLLGSYEQYF	TRBV24-1	TRBJ2-7
TGTGCCAGCAGTTACTCGTCAGTCGGGGGGGATCGGACAGTGAATTCACCCCTCCACTTT	CASSYSSVGGDRTVNSPLHF	TRBV6-5	TRBJ1-6
TGCAGTGCTAGGGAGGGTTTGGGGGACAGGTTCGGGGAGCTGTTTTTT	CSAREGLGDRFGELFF	TRBV20-1	TRBJ2-2
TGCAGTGCTTCCAGGGTCTCCAGGCGGGAGCAGTTCTTC	CSASRVSRREQFF	TRBV20-1	TRBJ2-1
TGTGCCAGTAGTATTACTGGACCTTTGGATACGCAGTATTTT	CASSITGPLDTQYF	TRBV19	TRBJ2-3
TGTGCCAGCAGGGACTCCTCCTATATAGTGACAGATACGCAGTATTTT	CASRDSSYIVTDTQYF	TRBV5-6	TRBJ2-3
TGTGCCAAAAGTCTGGGGCCCAACTATGGCTACACCTTC	CAKSLGPNYGYTF	TRBV6-5	TRBJ1-2
TGTGCCACTACTAGCGGGAGATCCGCCAAAAACATTCAGTACTTC	CATTSGRSAKNIQYF	TRBV24-1	TRBJ2-4
TGTGCCAGCACGAGAAAACCACGACCTTACCTAAGACAGGGCTACACCTTC	CASTRKPRPYLRQGYTF	TRBV5-4	TRBJ1-2
TGTGCCAGCAGCGGACAGAGGTCTGGAAACACCATATATTTT	CASSGQRSGNTIYF	TRBV13	TRBJ1-3
TGTGCCAGCTCTAGCGGGCAGCATGAGCAGTTCTTC	CASSSGQHEQFF	TRBV25-1	TRBJ2-1
TGTGCCAGCAGCGAGGGTAAGGCCTATTTAGGAGTAGGGGACGAGCAGTACTTC	CASSEGKAYLGVGDEQYF	TRBV5-6	TRBJ2-7
TGTGCCAGCAGCTTACTCCTGTTTCACACCGGGGAGCTGTTTTTT	CASSLLLFHTGELFF	TRBV7-9	TRBJ2-2
TGTGCCAGCAGCTTGGCTGGGACAGGGAACTGGTATTCTGGAAACACCATATATTTT	CASSLAGTGNWYSGNTIYF	TRBV5-6	TRBJ1-3
TGTGCCAGCAGCGGACCTAATTTAGGGAGAAATGGCTACACCTTC	CASSGPNLGRNGYTF	TRBV28	TRBJ1-2
TGTGCCAGCAGCGTAACTAACGAAGTGGACTATGGCTACACCTTC	CASSVTNEVDYGYTF	TRBV7-3	TRBJ1-2
TGTGCCAGCAGAGCGGGGGAAAAACTGTTTTTT	CASRAGEKLFF	TRBV6-4	TRBJ1-4
TGTGCCAGCAGCGGACTAGCGGGAGAGACCCAGTACTTC	CASSGLAGETQYF	TRBV13	TRBJ2-5
TGTGCCAGCAGCTTAGGGGGCGAATCGTGGGGAGCCCAGGGGGAGTACGAGCAGTACTTC	CASSLGGESWGAQGEYEQYF	TRBV7-6	TRBJ2-7
TGTGCCACCACACTAGAGGGGGTAAAGGGCTACACCTTC	CATTLEGVKGYTF	TRBV24-1	TRBJ1-2
TGTGCCAGCACGGACGCTCAGCCCCAGCATTTT	CASTDAQPQHF	TRBV7-6	TRBJ1-5
TGTGCCACCAGGTGTAAGGGGGGAACATCTGGAAACACCATATATTTT	CATRCKGGTSGNTIYF	TRBV24-1	TRBJ1-3
TGTGCCAGCGAACACAGGGACTCCTACGAGCAGTACTTC	CASEHRDSYEQYF	TRBV6-3	TRBJ2-7
TGCGCCAGCAGCCAAGATCTGGTAGGGGTAGGGAACACTGAAGCTTTCTTT	CASSQDLVGVGNTEAFF	TRBV4-3	TRBJ1-1
TGCGCCAGCGTGGACAGGGGTGATGGGCCTGGAAACACCATATATTTT	CASVDRGDGPGNTIYF	TRBV5-1	TRBJ1-3
TGTGCCAGTAGAAACTGTCATGTCGGGGACAACCAAGAGACCCAGTACTTC	CASRNCHVGDNQETQYF	TRBV19	TRBJ2-5
TGTGCCAGCAGCTACTCTCCTGAACTGAGGGGGGTTAGACGGTACGAGCAGTACTTC	CASSYSPELRGVRRYEQYF	TRBV5-8	TRBJ2-7
TGTGCCAAAGCCAGGGACAGGGCGAATGAGCAGTTCTTC	CAKARDRANEQFF	TRBV10-3	TRBJ2-1
TGTGCCAGCAAAGGTGGCTGGGACACCCACTATGGCTACACCTTC	CASKGGWDTHYGYTF	TRBV12-3	TRBJ1-2
TGTGCCAGCACCCGGAGGAATTACAATGAGCAGTTCTTC	CASTRRNYNEQFF	TRBV28	TRBJ2-1
TGCGCCAGCAGTGAGCGGGCCGTGAGGGAGCAGTACTTC	CASSERAVREQYF	TRBV10-2	TRBJ2-7
TGTGCCAGCAGTTACTCGGGACAGCTTTCCCAGCCTAGCACAGATACGCAGTATTTT	CASSYSGQLSQPSTDTQYF	TRBV6-2	TRBJ2-3
TGTGCCAGTAGTCTCCAACGGGGTAGGGATGATGAGCAGTTCTTC	CASSLQRGRDDEQFF	TRBV19	TRBJ2-1
TGTGCCAGCAGCGCCTGGACAGGAGTAAGTGAAGCTTTCTTT	CASSAWTGVSEAFF	TRBV9	TRBJ1-1
TGTGCCAGCTCACCACCTGGGACGGGAGAAGAGACCCAGTACTTC	CASSPPGTGEETQYF	TRBV18	TRBJ2-5
TGTGCCAGCAAGGACAGCTTAGGCGGGGAGCTGTTTTTT	CASKDSLGGELFF	TRBV11-3	TRBJ2-2
TGTGCCATCATGTACAGACCGGCCGACTCTGGGGCCAACGTCCTGACTTTC	CAIMYRPADSGANVLTF	TRBV10-3	TRBJ2-6
TGTGCCAGCAGCCTAGGGGTATACAATGAGCAGTTCTTC	CASSLGVYNEQFF	TRBV13	TRBJ2-1
TGTGCCAGCAGTGACTCGATTGCAGGGCGCCTGTTCTTT	CASSDSIAGRLFF	TRBV6-4	TRBJ1-1
TGTGCCAGCAGTGACTCGCCGGACAGGGACACCATATATTTT	CASSDSPDRDTIYF	TRBV6-4	TRBJ1-3
TGTGCCAGCAGTTCCACGTCTAAGCTTGGACACTCCGAGCAGTACTTC	CASSSTSKLGHSEQYF	TRBV6-3	TRBJ2-7
TGTGCCAGCAGCTGCCGTCCGGGTGACGGCACAGATACGCAGTATTTT	CASSCRPGDGTDTQYF	TRBV7-9	TRBJ2-3
TGTGCCAGCAGCTTAGCGGGAGGGGGGGGCGGGGGGAACACCGGGGAGCTGTTTTTT	CASSLAGGGGGGNTGELFF	TRBV7-8	TRBJ2-2
TGTGCCAGCAGTGACAAGCAGACAGGGGAAAAACTGTTTTTT	CASSDKQTGEKLFF	TRBV6-4	TRBJ1-4
TGTGCCAGCAGTGCGACAGGGCCGTGCCGCTACACCTTC	CASSATGPCRYTF	TRBV2	TRBJ1-2
TGCGCCAGCAGCTTCACCCAGGGAACCACTAATGAAAAACTGTTTTTT	CASSFTQGTTNEKLFF	TRBV5-1	TRBJ1-4
TGCAGTGCGCCCCGGGACAGGGGCAATCAGCCCCAGCATTTT	CSAPRDRGNQPQHF	TRBV20-1	TRBJ1-5
TGTGCCAGCCGGGACAGGGTGAAAGCCAGCAATCAGCCCCAGCATTTT	CASRDRVKASNQPQHF	TRBV19	TRBJ1-5
TGTGCCAGCACCCGGGACAGGAAGAGCAATCAGCCCCAGCATTTT	CASTRDRKSNQPQHF	TRBV4-2	TRBJ1-5
TGTGCCTTCTGGGGGCGATCTAGCACAGATACGCAGTATTTT	CAFWGRSSTDTQYF	TRBV15	TRBJ2-3
TGTGCCTGGAGCGGGACGCGGGAGGATAATGAAAAACTGTTTTTT	CAWSGTREDNEKLFF	TRBV30	TRBJ1-4
TGTGCCAGCAGCTCCAAGAGGGCCCCGCAGTACTTC	CASSSKRAPQYF	TRBV7-6	TRBJ2-7
TGTGCCAGCACCTGTCGGACGTCCGGGACAGGGGCTGATCCCTACGAGCAGTACTTC	CASTCRTSGTGADPYEQYF	TRBV9	TRBJ2-7
TGCCCTTTTACCATACAGTACGCCCAGCATTTT	CPFTIQYAQHF	TRBV20-1	TRBJ1-5
TGTGCCAGCAGTTCTGGGCTAATCACCGGGGAGCTGTTTTTT	CASSSGLITGELFF	TRBV28	TRBJ2-2
TGTGCCAGCAGAACAACTGAAGCTTTCTTT	CASRTTEAFF	TRBV25-1	TRBJ1-1
TGTGCCAGCAGTGGGGGGGACCCGAGCTATGGCTACACCTTC	CASSGGDPSYGYTF	TRBV25-1	TRBJ1-2
TGTGCCAGCAGCGCGGGGAGGTGGGACACTGAAGCTTTCTTT	CASSAGRWDTEAFF	TRBV7-9	TRBJ1-1
TGTGCCAGCAGTGAATATCGGACAGGGTCAGATACGCAGTATTTT	CASSEYRTGSDTQYF	TRBV25-1	TRBJ2-3
TGCAGTGCTAGAGATCTGACTAGCGGGGGGGCGACTAGGGCGGGTGCCTACGAGCAGTACTTC	CSARDLTSGGATRAGAYEQYF	TRBV20-1	TRBJ2-7
TGTGCCCGTCCTTTTAATTCACCCCTCCACTTT	CARPFNSPLHF	TRBV28	TRBJ1-6
TGTGCCAGCAGTGAGGATCGGGGGTTAAGCGAGCAGTACTTC	CASSEDRGLSEQYF	TRBV6-1	TRBJ2-7
TGTGCCAGTACAGGGGAGGGCCCAGCCAAAAACATTCAGTACTTC	CASTGEGPAKNIQYF	TRBV19	TRBJ2-4
TGTGCCAGCATCCCAGCGGGAGGATCAGCAACTAATGAAAAACTGTTTTTT	CASIPAGGSATNEKLFF	TRBV3-1	TRBJ1-4
TGTGCCAGCAGCTTAACAGGCACTGAAGCTTTCTTT	CASSLTGTEAFF	TRBV7-9	TRBJ1-1
TGTGCCAGCAGCCGCCCGTCTGACAGGGTGAGGCCCCAGCATTTT	CASSRPSDRVRPQHF	TRBV5-4	TRBJ1-5
TGTGCCAGCAGCACAGACAGGGAGAATGAAAAACTGTTTTTT	CASSTDRENEKLFF	TRBV11-3	TRBJ1-4
TGCGCCAGCAGTGGGGCTGGGGAAGAGACCCAGTACTTC	CASSGAGEETQYF	TRBV10-1	TRBJ2-5
TGTGCCAGCAGCGGAGGGGCTCTCTTAGTTGAAAAACTGTTTTTT	CASSGGALLVEKLFF	TRBV6-4	TRBJ1-4
TGTGCCAGCAGTAGGTCCGGACAGGGCTTATCCTACGAGCAGTACTTC	CASSRSGQGLSYEQYF	TRBV6-1	TRBJ2-7
TGTGCCAGCAGCGCAGGGGTTTCACAGCGACGCCAAGAGACCCAGTACTTC	CASSAGVSQRRQETQYF	TRBV9	TRBJ2-5
TGTGCCACCAGCGGACCGGACGACGGGTTAGAGACCCAGTACTTC	CATSGPDDGLETQYF	TRBV24-1	TRBJ2-5
TGTGCCAGCAGTTACATCCCCCGGGGGCCCTACGAGCAGTACTTC	CASSYIPRGPYEQYF	TRBV6-5	TRBJ2-7
TGTGCCACCAGTGAACGTCCCCCGGGACAGTATGGCTACACCTTC	CATSERPPGQYGYTF	TRBV24-1	TRBJ1-2
TGCAGACCTTCGCCAGGGCTTGACAAAAACATTCAGTACTTC	CRPSPGLDKNIQYF	TRBV20-1	TRBJ2-4
TGCAGCGTTGAACCTAGCCGGGACAGGGGCTACACCTTC	CSVEPSRDRGYTF	TRBV29-1	TRBJ1-2
TGCAGTGCTAGTTCCCCCTCGGCCTACGAGCAGTACTTC	CSASSPSAYEQYF	TRBV20-1	TRBJ2-7
TGTGCCAGCAGGGACAGAGGAGCGGATAGCAATCAGCCCCAGCATTTT	CASRDRGADSNQPQHF	TRBV9	TRBJ1-5
TGTGCCAGCAGTGGGACTAGCGGGGAGACCCAGTACTTC	CASSGTSGETQYF	TRBV27	TRBJ2-5
TGCGCCAGCAGTGAGTCGCAGGGGAGAGACGAGCAGTACTTC	CASSESQGRDEQYF	TRBV10-1	TRBJ2-7
TGTGCCAGCAGGGCCCCCAGGTACGAGCAGTACTTC	CASRAPRYEQYF	TRBV7-3	TRBJ2-7
TGTGCCAGCAGCCAATATAATCTTCTAAATCAAACCTCCACTGAAGCTTTCTTT	CASSQYNLLNQTSTEAFF	TRBV3-1	TRBJ1-1
TGTGCCAGCACAGCGCGGCTGCGGAACACTGAAGCTTTCTTT	CASTARLRNTEAFF	TRBV27	TRBJ1-1
TGTGCCAGCAGCGATGCCCAGGGGGCGGTGTGCTCCTACGAGCAGTACTTC	CASSDAQGAVCSYEQYF	TRBV5-4	TRBJ2-7
TGTGCCAGCACATTACAGGGGATAAGCTCCTACGAGCAGTACTTC	CASTLQGISSYEQYF	TRBV6-2	TRBJ2-7
TGCGCCAGCAGACTAGCGGGAGCCGGATACGAGCAGTACTTC	CASRLAGAGYEQYF	TRBV4-1	TRBJ2-7
TGTGCCAGCAGCTACATTCCGGACAGGGGTTTAGAGGGGAAGAACAATGAGCAGTTCTTC	CASSYIPDRGLEGKNNEQFF	TRBV5-5	TRBJ2-1
TGCAGTGCTAGAGCGGGGGGAGATACGCAGTATTTT	CSARAGGDTQYF	TRBV20-1	TRBJ2-3
TGTGCCAAGATGGGGGGGGCCTACAATGAGCAGTTCTTC	CAKMGGAYNEQFF	TRBV10-3	TRBJ2-1
TGTGCCGGGAACGCCCAACGGGGTACTGAAGCTTTCTTT	CAGNAQRGTEAFF	TRBV5-4	TRBJ1-1
TGTGCCAGCAGTTACCCTTGGGACAGGGCCAGCGAGCAGTACTTC	CASSYPWDRASEQYF	TRBV6-6	TRBJ2-7
TGCGCCAGCAGCCTGGGGAGCAATCAGCCCCAGCATTTT	CASSLGSNQPQHF	TRBV5-1	TRBJ1-5
TGTGCCATCAGAAAGCGGAAAAAGAATGAGCAGTTCTTC	CAIRKRKKNEQFF	TRBV10-3	TRBJ2-1
TGCAGTGCCCCTGGGGACAGGGGTTGGGTAGAGCAGTACTTC	CSAPGDRGWVEQYF	TRBV20-1	TRBJ2-7
TGTGCCAGCAGCCCGAAGTCGGTAGGCTACAATGAGCAGTTCTTC	CASSPKSVGYNEQFF	TRBV11-3	TRBJ2-1
TGTGCCAGCTCACCAGCGGCTCAGACTAGTGAGGGAGACTCCTACAATGAGCAGTTCTTC	CASSPAAQTSEGDSYNEQFF	TRBV18	TRBJ2-1
TGTGCCAGCAGTGAAGCACCCGGGGATCCGGGGAATGAGCAGTTCTTC	CASSEAPGDPGNEQFF	TRBV6-1	TRBJ2-1
TGTGCCAGTAGTTTCAGGGGCCTCAAATCGAAAGTGAGCAATCAGCCCCAGCATTTT	CASSFRGLKSKVSNQPQHF	TRBV19	TRBJ1-5
TGTGCCAGCAGTTCTAGCGGGACGCAGTACTTC	CASSSSGTQYF	TRBV6-1	TRBJ2-7
TGTGCCACGAACGTAGGGGTGGAGACAACCGAGGGGCAGTTCTTC	CATNVGVETTEGQFF	TRBV24-1	TRBJ2-1
TGTGCCAGCAGTTTCAGGGCGCGGAATGGACCGGGGGGCTACACCTTC	CASSFRARNGPGGYTF	TRBV6-3	TRBJ1-2
TGTGCCAGCAGCCGTTGGGTCCTAGGCGGCAATCAGCCCCAGCATTTT	CASSRWVLGGNQPQHF	TRBV14	TRBJ1-5
TGCGCCAGCAGCCGTACTCAAGGCAGGGGCCTCAATGAGCAGTTCTTC	CASSRTQGRGLNEQFF	TRBV4-1	TRBJ2-1
TGTGCCACCCTTGACCCCGCCGGGACTAGCGGGACCCGGGTTTCGAGCACAGATACGCAGTATTTT	CATLDPAGTSGTRVSSTDTQYF	TRBV24-1	TRBJ2-3
TGTGCCAGCAGTGGAGGCATTAGGAGAGGGGGAAACACCATATATTTT	CASSGGIRRGGNTIYF	TRBV27	TRBJ1-3
TGTGCCAGTAGTAACCGGCCGGGCTCTTGGGAAACTGAAGCTTTCTTT	CASSNRPGSWETEAFF	TRBV19	TRBJ1-1
TGTGCCAGCAGCTCCGCACAAGAGACCCAGTACTTC	CASSSAQETQYF	TRBV28	TRBJ2-5
TGTGCCTGGAGTGGACAGTGGTATAGCAATCAGCCCCAGCATTTT	CAWSGQWYSNQPQHF	TRBV30	TRBJ1-5
TGTGCCAGCAGCCCATGGGTGACAGGGGCATGGGGTAACTATGGCTACACCTTC	CASSPWVTGAWGNYGYTF	TRBV13	TRBJ1-2
TGTGCCAGCAGTGTTCCTGGGGGGCTGAAAAGCTCCTACAATGAGCAGTTCTTC	CASSVPGGLKSSYNEQFF	TRBV27	TRBJ2-1
TGTGCCAGCAGCGCGGTTAGTCGACACACCGGGGAGCTGTTTTTT	CASSAVSRHTGELFF	TRBV13	TRBJ2-2
TGCAGTGCGGGGGGGGCCTCCCAAGAGACCCAGTACTTC	CSAGGASQETQYF	TRBV20-1	TRBJ2-5
TGTGCCAAAGTCCCCGGGACAGGGTTGAACACTGAAGCTTTCTTT	CAKVPGTGLNTEAFF	TRBV6-5	TRBJ1-1
TGTGCCAGCAGCGCCACCGGGAATCTGGTAAACACTGAAGCTTTCTTT	CASSATGNLVNTEAFF	TRBV7-9	TRBJ1-1
TGTGCCACCAGTGATCCTAGGTCCTACGAGCAGTACTTC	CATSDPRSYEQYF	TRBV24-1	TRBJ2-7
TGTGCCAGCAGAAAAAAACAGGGCTCTAACTATGGCTACACCTTC	CASRKKQGSNYGYTF	TRBV27	TRBJ1-2
TGTGCCAGCAGACCGTGGGGGCGCTATGGCTACACCTTC	CASRPWGRYGYTF	TRBV5-5	TRBJ1-2
TGCAGTGCCAACAGGGGGCAAGAGACCCAGTACTTC	CSANRGQETQYF	TRBV20-1	TRBJ2-5
TGTGCCACCAGCAGCCCCGCGGGACAGGGTTTCTCTCGGGAGCTGTTTTTT	CATSSPAGQGFSRELFF	TRBV15	TRBJ2-2
TGTGCCAGCAGTTACAGGGGGGGAAGCTACGAGCAGTACTTC	CASSYRGGSYEQYF	TRBV6-6	TRBJ2-7
TGTGCCAGCAGTTCCCCCCCCTTAAAACAAAGGTACGAGCAGTACTTC	CASSSPPLKQRYEQYF	TRBV12-4	TRBJ2-7
TGTGCCAGCAGCCTGGTTCCCCTGACCTATCACGAGCAGTACTTC	CASSLVPLTYHEQYF	TRBV14	TRBJ2-7
TGTGCCCCCGACGAGTGGAGCGTGCCCACTGAAGCTTTCTTT	CAPDEWSVPTEAFF	TRBV30	TRBJ1-1
TGCAGTAGGTCTAGGAATGAAAAACTGTTTTTT	CSRSRNEKLFF	TRBV20-1	TRBJ1-4
TGCAGCGTTGCTGCACCGACTAACTATGGCTACACCTTC	CSVAAPTNYGYTF	TRBV29-1	TRBJ1-2
TGTGCCAGCAGCATAGCGGGCTTGGAAGATACGCAGTATTTT	CASSIAGLEDTQYF	TRBV7-4	TRBJ2-3
TGCAGTCTTCGATCGCCGTGCAATCAGCCCCAGCATTTT	CSLRSPCNQPQHF	TRBV20-1	TRBJ1-5
TGTGCCAGCGGGGGCATCAACACCGGGGAGCTGTTTTTT	CASGGINTGELFF	TRBV6-5	TRBJ2-2
TGTGCCACCAGTGGGGTCAGTCAGCCCCAGCATTTT	CATSGVSQPQHF	TRBV24-1	TRBJ1-5
TGTGCCACCAGTGATCTAGTGGGAACCGGGGAGCTGTTTTTT	CATSDLVGTGELFF	TRBV24-1	TRBJ2-2
TGTGCCCCATCCAGAGAGTCATCTGAGGAGACCCAGTACTTC	CAPSRESSEETQYF	TRBV19	TRBJ2-5
TGTGCCAGCAGTTTACTAACGAGGGGCTACGAGCAGTACTTC	CASSLLTRGYEQYF	TRBV28	TRBJ2-7
TGTGCCAGCAGTGTCAAGGACAGAAGGGACACTGAAGCTTTCTTT	CASSVKDRRDTEAFF	TRBV2	TRBJ1-1
TGTGCCAGCAGTTACTCGAAGGGGCTCTACGAGCAGTACTTC	CASSYSKGLYEQYF	TRBV6-2	TRBJ2-7
TGTGCCAGCAGCCAAGGGTCCTTAACTGGGGACGCCTACAATGAGCAGTTCTTC	CASSQGSLTGDAYNEQFF	TRBV3-1	TRBJ2-1
TGTGCTAGTGGTTTGAATGGACGCGGATTAACTGAAGCTTTCTTT	CASGLNGRGLTEAFF	TRBV12-5	TRBJ1-1
TGTGCCAGCAGCCCTAGCGGCGATATCTCCTACAATGAGCAGTTCTTC	CASSPSGDISYNEQFF	TRBV14	TRBJ2-1
TGTGCCAGCAGTTATACCGCTAAGGGCACAGATACGCAGTATTTT	CASSYTAKGTDTQYF	TRBV12-4	TRBJ2-3
TGTGCCAGCACTCCCCATGGTCTCACTGAAGCTTTCTTT	CASTPHGLTEAFF	TRBV5-5	TRBJ1-1
TGTGCCTGGAGTACACAGGGAACAGATACGCAGTATTTT	CAWSTQGTDTQYF	TRBV30	TRBJ2-3
TGTGCCAGCAGCTTAGATAAGGACAGTCCTTTTATGGTTCGGCAGTACTTC	CASSLDKDSPFMVRQYF	TRBV7-9	TRBJ2-5
TGTGCCAGCAGCACAGATGGTAAGACAGATGATCACGGCTACACCTTC	CASSTDGKTDDHGYTF	TRBV13	TRBJ1-2
TGCGCCAGCAAGCCCCCCGGTTACCGGGACAGAGATAGCAATCAGCCCCAGCATTTT	CASKPPGYRDRDSNQPQHF	TRBV5-1	TRBJ1-5
TGTGAAACGGACTCCTACAATGAGCAGTTCTTC	CETDSYNEQFF	TRBV2	TRBJ2-1
TGTGCCAGTATAGAAACAGATACGCAGTATTTT	CASIETDTQYF	TRBV19	TRBJ2-3
TGCAGTGCTAGAGATGTAACAGGGGGCAGTAACACTGAAGCTTTCTTT	CSARDVTGGSNTEAFF	TRBV20-1	TRBJ1-1
TGTGCCAGCAGCCAAAGGGACAGTTCTTGCTACGAGCAGTACTTC	CASSQRDSSCYEQYF	TRBV3-1	TRBJ2-7
TGTGCCAGCATACCTCAGGGGCGTGAGGTGACAGATACGCAGTATTTT	CASIPQGREVTDTQYF	TRBV7-9	TRBJ2-3
TGTGCCAGCAGCGAGGGTGGGACTAGCGGGGGGACAGATACGCAGTATTTT	CASSEGGTSGGTDTQYF	TRBV11-3	TRBJ2-3
TGTGCCAGCAGTCGGGACAGAGAGACTGAAGCTTTCTTT	CASSRDRETEAFF	TRBV12-3	TRBJ1-1
TGTGCCAGCAGCTTAGATGTCAGGGCTAATGAAAAACTGTTTTTT	CASSLDVRANEKLFF	TRBV11-2	TRBJ1-4
TGTGCCATCAGTGAGGTTACCCACCGGACCGGACAGGGTTTCTTT	CAISEVTHRTGQGFF	TRBV10-3	TRBJ1-1
TGTGCCAGCAGCCAACCGACAGCGGGCTACGAGCAGTACTTC	CASSQPTAGYEQYF	TRBV3-1	TRBJ2-7
TGTGCCATCGAAGGAAATACACGGAGCTCCTACGAGCAGTACTTC	CAIEGNTRSSYEQYF	TRBV10-3	TRBJ2-7
TGCAGGGGCACTGAAGCTTTCTTT	CRGTEAFF	TRBV20-1	TRBJ1-1
TGTGCCAGCAGCCAAGATAGGGGCCGGCCTACTCAGCCCCAGCATTTT	CASSQDRGRPTQPQHF	TRBV14	TRBJ1-5
TGTGCCAGCCTGGGGCAAGGCTACACCTTC	CASLGQGYTF	TRBV2	TRBJ1-2
TGCAGTGCTAGAGATTCGGGGGGGACTAGCGGGGCTTGCGGAAACGCGGACGACGAATTTCGGGAGACCCAGTACTTC	CSARDSGGTSGACGNADDEFRETQYF	TRBV20-1	TRBJ2-5
TGCGCCAGCATTCGCCCCCGACAGGGCACCGGGGAGCTGTTTTTT	CASIRPRQGTGELFF	TRBV4-3	TRBJ2-2
TGTGCCAGCAGCTTAGCCCCTGGATTACACTACACTGAAGCTTTCTTT	CASSLAPGLHYTEAFF	TRBV7-9	TRBJ1-1
TGTGCCAGCAGCCTTTCTAATAGGGGATCTAACTATGGCTACACCTTC	CASSLSNRGSNYGYTF	TRBV7-9	TRBJ1-2
TGTGCCAGCAGCCTGACAGGGGATGAAAAACTGTTTTTT	CASSLTGDEKLFF	TRBV7-3	TRBJ1-4
TGTGCCAGCAGTGTAAAACCCCGGGACAGGGGGCCGCGAAACACTGAAGCTTTCTTT	CASSVKPRDRGPRNTEAFF	TRBV6-5	TRBJ1-1
TGCAGTGCTAGTCAACGGGACAGGGGGATGAGGTATGGCTACACCTTC	CSASQRDRGMRYGYTF	TRBV20-1	TRBJ1-2
TGTGCCAGCAGTTACCCCCCGGGACAGGGTATTAGCAATCAGCCCCAGCATTTT	CASSYPPGQGISNQPQHF	TRBV6-5	TRBJ1-5
TGCAGTGCTAGACCGCCAAAAGGTAGCTTGGCTCTAGAGAGGACTAGCACAGATACGCAGTATTTT	CSARPPKGSLALERTSTDTQYF	TRBV20-1	TRBJ2-3
TGCGCCAGCAGCTCCGGGGACAGGGATAATGAAAAACTGTTTTTT	CASSSGDRDNEKLFF	TRBV5-1	TRBJ1-4
TGTGCCAGCAGTGCCTCGACAGGGTACGAGCAGTACTTC	CASSASTGYEQYF	TRBV12-4	TRBJ2-7
TGTGCCAGCAGCTTAGACAAAGAACGACAGGGGGCAGCTAACTATGGCTACACCTTC	CASSLDKERQGAANYGYTF	TRBV7-9	TRBJ1-2
TGTGCCAGCATCCGGACGCCCGTCTTC	CASIRTPVF	TRBV6-4	TRBJ2-1
TGTGCCAGCAGAAGACCCCATAGGGAGAGAGCTAACTATGGCTACACCTTC	CASRRPHRERANYGYTF	TRBV11-2	TRBJ1-2
TGTGCCTTTGGGGGGGCTTCACCCCTCCACTTT	CAFGGASPLHF	TRBV30	TRBJ1-6
TGCAGTGCTAGAGTGGGGCCAAGAACTCCCTACGAGCAGTACTTC	CSARVGPRTPYEQYF	TRBV20-1	TRBJ2-7
TGTGCCAGCAGCCATCTAGCGGGAGGGTTAGAGACCCAGTACTTC	CASSHLAGGLETQYF	TRBV9	TRBJ2-5
TGTGCCAGCAGTTTCGTAGGGGACAGGATTTACGAGCAGTACTTC	CASSFVGDRIYEQYF	TRBV12-3	TRBJ2-7
TGTGCCAGTAGTATAGACAAAGGGTTTTCACCCCTCCACTTT	CASSIDKGFSPLHF	TRBV19	TRBJ1-6
TGCAGAAACCCGACAGGGCTATTTTCATTCATGAACACTGAAGCTTTCTTT	CRNPTGLFSFMNTEAFF	TRBV20-1	TRBJ1-1
TGTGCCAGCAGCCAAGATCCGTACCGGGGACACCAGTATAATGAAAAACTGTTTTTT	CASSQDPYRGHQYNEKLFF	TRBV4-2	TRBJ1-4
TGTGCCAGCAGAACGGGGGATACCGAGCAGTACTTC	CASRTGDTEQYF	TRBV9	TRBJ2-7
TGTGCCAGCAGGTTCCCCTACCACACCCCCAGAGGGCAGAACTACGAGCAGTACTTC	CASRFPYHTPRGQNYEQYF	TRBV25-1	TRBJ2-7
TGTGCCAGCAGCAGGGGGGGGGGGAGGGAGACCACAGATACGCAGTATTTT	CASSRGGGRETTDTQYF	TRBV13	TRBJ2-3
TGTGCTAGTGGTTTGGTACGGAACACTGAAGCTTTCTTT	CASGLVRNTEAFF	TRBV12-5	TRBJ1-1
TGTGCCAGCAGCGTAGACAGGCTAGGCACTGAAGCTTTCTTT	CASSVDRLGTEAFF	TRBV7-3	TRBJ1-1
TGTGCCCCCCTACATATAACTAATGAAAAACTGTTTTTT	CAPLHITNEKLFF	TRBV11-2	TRBJ1-4
TGTGCCAGCAGTGAAAACCCTTCCAAGCCAAGACAGGGTACCGGGGCCAACGTCCTGACTTTC	CASSENPSKPRQGTGANVLTF	TRBV6-1	TRBJ2-6
TGTGCCAGCGCAGGACTAGCCGGGGTGCAGTATTTT	CASAGLAGVQYF	TRBV28	TRBJ2-3
TGTGCCAGCAATTTAAGAGCGGCCAAAAATAGCACAGATACGCAGTATTTT	CASNLRAAKNSTDTQYF	TRBV6-4	TRBJ2-3
TGTGCCAGCAGCCGGACTAGCAACGAGCAGTACTTC	CASSRTSNEQYF	TRBV4-2	TRBJ2-7
TGCAGTGCTACGAACAGGGGGAGTGGCTACACCTTC	CSATNRGSGYTF	TRBV20-1	TRBJ1-2
TGTGCCAGCAGCCATCGACAGGGGTTTCAGCCCCAGCATTTT	CASSHRQGFQPQHF	TRBV7-3	TRBJ1-5
TGTGCCAGCAGTTTCGCAGGCTCCTATAATTCACCCCTCCACTTT	CASSFAGSYNSPLHF	TRBV27	TRBJ1-6
TGCGCCAGCACAACTAAGGGACCCGTGGAAAAACTGTTTTTT	CASTTKGPVEKLFF	TRBV10-1	TRBJ1-4
TGTGCCACCAGTGATTGGAGACAGGAGGCTCTCTATGGCTACACCTTC	CATSDWRQEALYGYTF	TRBV24-1	TRBJ1-2
TGTGCCAGCAGATCGGGTATGCCTAATGAAAAACTGTTTTTT	CASRSGMPNEKLFF	TRBV6-2	TRBJ1-4
TGTGCCAGCAGCAAGTCCCTGACAGCCGATGGAAACACCATATATTTT	CASSKSLTADGNTIYF	TRBV11-3	TRBJ1-3
TGTGCCAGTTCCCTTAGGGACAGGGGGTACGAGCAGTACTTC	CASSLRDRGYEQYF	TRBV19	TRBJ2-7
TGTGCCAGCAGCGGACCCTTCGGGGGCTTCGGGAACACTGAAGCTTTCTTT	CASSGPFGGFGNTEAFF	TRBV13	TRBJ1-1
TGTGCCAGCAATAGGGGGGGGGGGTATACAGATACGCAGTATTTT	CASNRGGGYTDTQYF	TRBV7-2	TRBJ2-3
TGCAGCGGCTCTCCCGGGACTAGCACGCCTAGCACAGATACGCAGTATTTT	CSGSPGTSTPSTDTQYF	TRBV29-1	TRBJ2-3
TGTGCCAGCAACCCACCGGGACAGGTGGCGGACAATGAGCAGTTCTTC	CASNPPGQVADNEQFF	TRBV9	TRBJ2-1
TGTGCCAGCAGTAGGTTAGACAGGGGCCGTAACTATGGCTACACCTTC	CASSRLDRGRNYGYTF	TRBV12-3	TRBJ1-2
TGTGCCAGCTCTCGGGGATGCCAGGACAGGGCGACCAACACTGAAGCTTTCTTT	CASSRGCQDRATNTEAFF	TRBV18	TRBJ1-1
TGCGCCAGCAGCCCTACGCATACCTACGAGCAGTACTTC	CASSPTHTYEQYF	TRBV4-1	TRBJ2-7
TGTGCCAGCAGCCTGACATGGGACAGAAGTCGAAACACCATATATTTT	CASSLTWDRSRNTIYF	TRBV3-1	TRBJ1-3
TGTGCCAGTAGTAAGTGGACTAGCGGGGGGGCCAACCGATCGGAGCTGTTTTTT	CASSKWTSGGANRSELFF	TRBV19	TRBJ2-2
TGTGCCAGCAGCACCCCCGGGGGGGGCAATCAGCCCCAGCATTTT	CASSTPGGGNQPQHF	TRBV5-6	TRBJ1-5
TGTGCCAGCAGTGAACAGGGGAGAGATCAGCCCCAGCATTTT	CASSEQGRDQPQHF	TRBV2	TRBJ1-5
TGTGCCAGCAGTTACTATAGGACCAATGAGCAGTTCTTC	CASSYYRTNEQFF	TRBV6-9	TRBJ2-1
TGTGCCAGCAGTTTATTCGTGGGGGGGTCCCTTAGGGCCACAGATACGCAGTATTTT	CASSLFVGGSLRATDTQYF	TRBV27	TRBJ2-3
TGTGACATCGGATCGCAGCAGTACTTC	CDIGSQQYF	TRBV2	TRBJ2-7
TGTGCCAGTAGTATTCTAGCGGGGCAGACGCAGTATTTT	CASSILAGQTQYF	TRBV19	TRBJ2-3
TGTAGGGGACAGGGACCGTGGGCCAAAAACATTCAGTACTTC	CRGQGPWAKNIQYF	TRBV6-5	TRBJ2-4
TGTGCCAGCAGTGACTCGGCAAGAGTCGAGGATACGCAGTATTTT	CASSDSARVEDTQYF	TRBV6-4	TRBJ2-3
TGTGCCAGCAGCATAAAGGGACGACTAGAGACCCAGTACTTC	CASSIKGRLETQYF	TRBV13	TRBJ2-5
TGTGCCAGCAGTTTATTAGCAGGGCCTGGGAGGCAGCCCCAGCATTTT	CASSLLAGPGRQPQHF	TRBV27	TRBJ1-5
TGCAGTGCAGGGGACAAGGCCAGACAGGATACCAATCAGCCCCAGCATTTT	CSAGDKARQDTNQPQHF	TRBV20-1	TRBJ1-5
TGTGCCAGCAGCTACGACAGGGGATCCTACGAGCAGTACTTC	CASSYDRGSYEQYF	TRBV6-1	TRBJ2-7
TGTGCCAGCAGGGGATGGCCGGGACTAGGGGGAGCCCCCCCAGATACGCAGTATTTT	CASRGWPGLGGAPPDTQYF	TRBV28	TRBJ2-3
TGTGCCAGCAGCTCCCTCCGGGACATTATTTACTATGGCTACACCTTC	CASSSLRDIIYYGYTF	TRBV7-3	TRBJ1-2
TGTGCCAGCAGTTCTTCCGGGGACTACCACTACGAGCAGTACTTC	CASSSSGDYHYEQYF	TRBV6-6	TRBJ2-7
TGTGCCAGCAGCTTCCAGGACAGGTGCCACTCACCCCTCCACTTT	CASSFQDRCHSPLHF	TRBV16	TRBJ1-6
TGTGCCAGCAGTTTCACCCTTAAGGTCGAGCAGTACTTC	CASSFTLKVEQYF	TRBV12-4	TRBJ2-7
TGTGCCAGCAGCCAAGAACCGCCGTTAGCGGGTGGCACAGATACGCAGTATTTT	CASSQEPPLAGGTDTQYF	TRBV3-1	TRBJ2-3
TGTGCCAGCAGTTTTACAGGGGGTCAAGAGACCCAGTACTTC	CASSFTGGQETQYF	TRBV12-4	TRBJ2-5
TGTGCCAGTAGCGGGACTCGGCGGTTATATAGCAATCAGCCCCAGCATTTT	CASSGTRRLYSNQPQHF	TRBV19	TRBJ1-5
TGCGCCAGCAGCCAAGACTTCGGGAGCGCCACGAGCAATCAGCCCCAGCATTTT	CASSQDFGSATSNQPQHF	TRBV4-3	TRBJ1-5
TGTGCCAGCAGTGACAAAGACACAGGGGCGCACACTGAAGCTTTCTTT	CASSDKDTGAHTEAFF	TRBV6-4	TRBJ1-1
TGCGCCAGCAGCTACAGTCCTCGGGCCGTGAACACTGAAGCTTTCTTT	CASSYSPRAVNTEAFF	TRBV5-1	TRBJ1-1
TGTGCCAGCAGCCAATTAGATGGATACGTCTACTCCTACGAGCAGTACTTC	CASSQLDGYVYSYEQYF	TRBV7-4	TRBJ2-7
TGTGCCAGCGACAGGGTTGACAATGAGCAGTTCTTC	CASDRVDNEQFF	TRBV28	TRBJ2-1
TGTGCCAGCAGCTGGGGACTAGCGGGAGCCCGCCAAGAGACCCAGTACTTC	CASSWGLAGARQETQYF	TRBV7-6	TRBJ2-5
TGTGCCAGCAGTTACTTCGGACAGGGTTTGGGCTACACCTTC	CASSYFGQGLGYTF	TRBV6-2	TRBJ1-2
TGCAGTGCTTACGGGCGGCAATCTGGGGCCAACGTCCTGACTTTC	CSAYGRQSGANVLTF	TRBV20-1	TRBJ2-6
TGTGCCAGCAGCCCGGATAGCCGACAAGAGACCCAGTACTTC	CASSPDSRQETQYF	TRBV6-5	TRBJ2-5
TGTGCCAGCAGCCTTACAGTGTCCTACGAGCAGTACTTC	CASSLTVSYEQYF	TRBV13	TRBJ2-7
TGTGCCAGCAGCCTTCCGCAGGAGTACGAGCAGTACTTC	CASSLPQEYEQYF	TRBV7-4	TRBJ2-7
TGCAGTGCGGGTATTAGGCGCGGGACTAGCGGGCCAGATACGCAGTATTTT	CSAGIRRGTSGPDTQYF	TRBV20-1	TRBJ2-3
TGCGCCAGCAGCGGCTTAGGGAACGGAAACACCATATATTTT	CASSGLGNGNTIYF	TRBV4-1	TRBJ1-3
TGTGCCAGCAGTTACGCCAGGGCTCGCGGGGAGCTGTTTTTT	CASSYARARGELFF	TRBV6-5	TRBJ2-2
TGCAGTGCTCTTTTATCGGACAGCGGCTACGAGCAGTACTTC	CSALLSDSGYEQYF	TRBV20-1	TRBJ2-7
TGTGCCAGCAGCTTAGGGAAACTGGGAGGTACTGAAGCTTTCTTT	CASSLGKLGGTEAFF	TRBV7-9	TRBJ1-1
TGCAGTGCTAATAAAATAGTAATGGCTAGCGCGAGGGTCGCTAAAAACATTCAGTACTTC	CSANKIVMASARVAKNIQYF	TRBV20-1	TRBJ2-4
TGTGCCAGCAGCCCAAGGGGCCAATCCACCGGGGAGCTGTTTTTT	CASSPRGQSTGELFF	TRBV7-4	TRBJ2-2
TGTGCCACCAGTGTTCGCGACAGGGGGGGCTACACCTTC	CATSVRDRGGYTF	TRBV24-1	TRBJ1-2
TGTGCCAGCAGCTGGGGCCGACGCTCTGGAAACACCATATATTTT	CASSWGRRSGNTIYF	TRBV9	TRBJ1-3
TGTGCCAGCAGTTTATCCGAGACTGCAACTAATGAAAAACTGTTTTTT	CASSLSETATNEKLFF	TRBV28	TRBJ1-4
TGTGCCAGCAGCTTAGGGACAGTCTCCTACGAGCAGTACTTC	CASSLGTVSYEQYF	TRBV7-2	TRBJ2-7
TGTGCCAGCAGTTTAGCCCCCGGGGGAAACACCATATATTTT	CASSLAPGGNTIYF	TRBV27	TRBJ1-3
TGTGCCAGCAGCTGGTCGGGCCCTGGGAGTTGCGGTCAGCCCCAGCATTTT	CASSWSGPGSCGQPQHF	TRBV5-4	TRBJ1-5
TGTGCCAGCATCCGACAGAGGTTACCCCAAGGGAGGCCCCAGCATTTT	CASIRQRLPQGRPQHF	TRBV28	TRBJ1-5
TGTGCCTCAATCGGGGGAGGCCCGAATTCACCCCTCCACTTT	CASIGGGPNSPLHF	TRBV30	TRBJ1-6
TGTGCCAGCATGCGGGGACAGGGCTCATCACCCGAGCAGTACTTC	CASMRGQGSSPEQYF	TRBV2	TRBJ2-7
TGCGCCAGCAGTGCCGGCACTAGCGGGAATGCCAAAAACATTCAGTACTTC	CASSAGTSGNAKNIQYF	TRBV10-1	TRBJ2-4
TGTGCCAGCATCGGAAGTATGCGGGAGAATCAGCCCCAGCATTTT	CASIGSMRENQPQHF	TRBV27	TRBJ1-5
TGTGCCAGCAGCCAAGATGTTAGCGGGATCCCCAATGAGCAGTTCTTC	CASSQDVSGIPNEQFF	TRBV3-1	TRBJ2-1
TGCGCCATCACTATGGGGAACAGGAACACTGAAGCTTTCTTT	CAITMGNRNTEAFF	TRBV10-1	TRBJ1-1
TGCAGTGCAGTGGGACAGGGGGGTCATCAGCCCCAGCATTTT	CSAVGQGGHQPQHF	TRBV20-1	TRBJ1-5
TGTGCCAGCAGTTTAGGACTGGAGACCGAGCAGTACTTC	CASSLGLETEQYF	TRBV12-4	TRBJ2-7
TGCGCCAGCAGCTTTGACAGGACAGAAGCTTTCTTT	CASSFDRTEAFF	TRBV5-1	TRBJ1-1
TGTGCCATCAGTGCCCGGTTATCCGGACAGGGGATTGGCTACACCTTC	CAISARLSGQGIGYTF	TRBV10-3	TRBJ1-2
TGTGCCTGGCCCGACAGCAATGGGGAAGGGACCCAGTACTTC	CAWPDSNGEGTQYF	TRBV30	TRBJ2-5
TGTGCCAGCAGCTGCGACAGGGTCCAGAACACTGAAGCTTTCTTT	CASSCDRVQNTEAFF	TRBV5-6	TRBJ1-1
TGCGCCAGCGAGGGTCGGACAGCCTATAATGAAAAACTGTTTTTT	CASEGRTAYNEKLFF	TRBV10-2	TRBJ1-4
TGTGCCAGTAGTCCCACAGGGGGATCCGATAACACCATATATTTT	CASSPTGGSDNTIYF	TRBV19	TRBJ1-3
TGTGCCAGCAGTCTTGGACCCCAGGACATTCAGTACTTC	CASSLGPQDIQYF	TRBV27	TRBJ2-4
TGTGCCAGCAGTTGCTTACAGGGGGACTCACCCCTCCACTTT	CASSCLQGDSPLHF	TRBV27	TRBJ1-6
TGTGCCAGCAGTTTAGAGGACTTGGCTAGCAATCAGCCCCAGCATTTT	CASSLEDLASNQPQHF	TRBV6-5	TRBJ1-5
TGCAGTGCTAAGCCGGGGACAGCTCTGAGCGAGCAGTACTTC	CSAKPGTALSEQYF	TRBV20-1	TRBJ2-7
TGTGCCAGCAGATTTGCGGGAGACCATGGCTACACCTTC	CASRFAGDHGYTF	TRBV9	TRBJ1-2
TGTGCCAGCAGCGGCGGGGAAGGTGGCTACACCTTC	CASSGGEGGYTF	TRBV11-1	TRBJ1-2
TGTGCCAGCAGCTTAGCGCCGGGGGATCGCACAGATACGCAGTATTTT	CASSLAPGDRTDTQYF	TRBV7-2	TRBJ2-3
TGCGCCAGCAGCCTTAAAACCCGGGACGGGTACGAGCAGTACTTC	CASSLKTRDGYEQYF	TRBV4-1	TRBJ2-7
TGTGCCAGCAGCTCTGGTCCACGGATGACAGATACGCAGTATTTT	CASSSGPRMTDTQYF	TRBV7-2	TRBJ2-3
TGCAGTGCTAGAGATCCCCCCCGCTCCCCCCCATATCCAAATTCACCCCTCCACTTT	CSARDPPRSPPYPNSPLHF	TRBV20-1	TRBJ1-6
TGCGCCAGGGGGACAGGGAGTTGTGGCTCCGCCTACGAGCAGTACTTC	CARGTGSCGSAYEQYF	TRBV10-1	TRBJ2-7
TGTGCCAGCAGCCGCGATACAGGGGACTACAATGAGCAGTTCTTC	CASSRDTGDYNEQFF	TRBV13	TRBJ2-1
TGTGCCAGCAGCTTAGGAGTCGGGGACAGGGGCCTGTACGAGCAGTACTTC	CASSLGVGDRGLYEQYF	TRBV7-6	TRBJ2-7
TGTGCCAGCAGAACTAGCGTGCTTGGAGACACCGGGGAGCTGTTTTTT	CASRTSVLGDTGELFF	TRBV12-4	TRBJ2-2
TGTGCCAGCAGTGAATCGGAGGGGGCGTTCTATGGCTACACCTTC	CASSESEGAFYGYTF	TRBV25-1	TRBJ1-2
TGTGCCAGCAGCTTAGTAAGTCTGTACGAGCAGTACTTC	CASSLVSLYEQYF	TRBV7-9	TRBJ2-7
TGTGCCAGCAGCTTAGAACAACGGGGACTAGCATCTAATGAGCAGTTCTTC	CASSLEQRGLASNEQFF	TRBV7-4	TRBJ2-1
TGTGCCAACGGGGGGTCCCCCTACGAGCAGTACTTC	CANGGSPYEQYF	TRBV6-1	TRBJ2-7
TGTGCCAGCAGCGAGGGAAGGGGACAACCCTACAATGAGCAGTTCTTC	CASSEGRGQPYNEQFF	TRBV7-9	TRBJ2-1
TGTGCCAGCAGCCGGTCTACAGGGGAGAGGGTTACCGACAATCAGCCCCAGCATTTT	CASSRSTGERVTDNQPQHF	TRBV7-8	TRBJ1-5
TGTGCCAGCAGTTTCACAGGGGCCACGGCTAGCACAGATACGCAGTATTTT	CASSFTGATASTDTQYF	TRBV6-5	TRBJ2-3
TGTGCTAGTGGTAAGGGGAGGGCCTCTGGAAACACCATATATTTT	CASGKGRASGNTIYF	TRBV12-5	TRBJ1-3
TGTGCCAGCTGGGGTGACTATGGCTACACCTTC	CASWGDYGYTF	TRBV6-5	TRBJ1-2
TGTGCCAGCAGCTGTACAGGGTGGAACACTGAAGCTTTCTTT	CASSCTGWNTEAFF	TRBV5-4	TRBJ1-1
TGTGCCACCAGGGGGCATTTCTACGAGCAGTACTTC	CATRGHFYEQYF	TRBV24-1	TRBJ2-7
TGCAGCGTTGACAATACATCTAGCGGGTGGCCGTACAATGAGCAGTTCTTC	CSVDNTSSGWPYNEQFF	TRBV29-1	TRBJ2-1
TGTGCCAGCAGTGTAGTATGGACTAGCGGGTGGATGCAGTTCTTC	CASSVVWTSGWMQFF	TRBV6-4	TRBJ2-1
TGTGCCAGCAGTACCGGGACAGGGGTGCATTTT	CASSTGTGVHF	TRBV28	TRBJ1-5
TGTGCCAGCAGTTTAGTGACTATCGGGAGTTCGTACAATGAGCAGTTCTTC	CASSLVTIGSSYNEQFF	TRBV12-3	TRBJ2-1
TGTGCCAGCAGCGTAGCTGTACGTCAGGGTAACTATGGCTACACCTTC	CASSVAVRQGNYGYTF	TRBV9	TRBJ1-2
TGTGCCTGGAGCGACCTGATCAATGAGCAGTTCTTC	CAWSDLINEQFF	TRBV30	TRBJ2-1
TGCGCCAGCAGCTTGGCTAGGGACAGTTACAACGCACCCCTCCACTTT	CASSLARDSYNAPLHF	TRBV5-1	TRBJ1-6
TGCAGCGTTGAGTCCTGGGACTCCGTCTATGGCTACACCTTC	CSVESWDSVYGYTF	TRBV29-1	TRBJ1-2
TGTGCCATCAGACTGGCAGGGATTCGCAATCAGCCCCAGCATTTT	CAIRLAGIRNQPQHF	TRBV10-3	TRBJ1-5
TGTGCCAGCAGCGGGACGGAAAACATTCAGTACTTC	CASSGTENIQYF	TRBV7-9	TRBJ2-4
TGTGCCAGCAGCTTACAGACCTCGAGGGTTCAAGAGACCCAGTACTTC	CASSLQTSRVQETQYF	TRBV7-3	TRBJ2-5
TGTGCCAGTAGTATACTCGGGACCCTCTGCGAGCAGTACTTC	CASSILGTLCEQYF	TRBV19	TRBJ2-7
TGTGCCACGCCGGCAGCTGAAGCTTTCTTT	CATPAAEAFF	TRBV3-1	TRBJ1-1
TGCGCCAGTTGGGTTCAGCAGTCCTACGAGCAGTACTTC	CASWVQQSYEQYF	TRBV5-1	TRBJ2-7
TGTGCCAGCAGCCAAGGCCTTACAGGAGGCTTC	CASSQGLTGGF	TRBV4-2	TRBJ2-7
TGTGCCAGCAGCCGAGGAGGGAGAAACATGAACACTGAAGCTTTCTTT	CASSRGGRNMNTEAFF	TRBV13	TRBJ1-1
TGCAGTGCTAGAGACCCCCCTGGGGAAAAACTGTTTTTT	CSARDPPGEKLFF	TRBV20-1	TRBJ1-4
TGTGCCAGGCGGGGGGCCTACGAGCAGTACTTC	CARRGAYEQYF	TRBV25-1	TRBJ2-7
TGTGCCAGCTGGACAGGGGGGACCCTTGCAGGGGCCGCCAAAAACATTCAGTACTTC	CASWTGGTLAGAAKNIQYF	TRBV3-1	TRBJ2-4
TGCAGCGTTGACTTCAGCAAAAACATTCAGTACTTC	CSVDFSKNIQYF	TRBV29-1	TRBJ2-4
TGTGCCAGCCTGGGGGGGCGATGTGAATCTTCTGGAAACACCATATATTTT	CASLGGRCESSGNTIYF	TRBV6-1	TRBJ1-3
TGTGCCAGCAGCTTAACTAGCCTAAGGTCGGGACTAGCGGTAAATCCGAGCTCCTACAATGAGCAGTTCTTC	CASSLTSLRSGLAVNPSSYNEQFF	TRBV7-2	TRBJ2-1
TGTGCCAGCAGCGGGTCTAGCAGAATGACTCTGTGCCCGGCCAAAAACATTCAGTACTTC	CASSGSSRMTLCPAKNIQYF	TRBV13	TRBJ2-4
TGCAGTGCTACGACTGGTGGATCCGGGGAGCTGTTTTTT	CSATTGGSGELFF	TRBV20-1	TRBJ2-2
TGTGCCAGCAGTTACCCGGGCCTAGCGGGCGAGCAGTACTTC	CASSYPGLAGEQYF	TRBV6-5	TRBJ2-7
TGTGCCAGCAGTCGCCGGGACAGGGGAGCTGAAAAACTGTTTTTT	CASSRRDRGAEKLFF	TRBV6-5	TRBJ1-4
TGTGCCAGCATTCGACTAGCGGGAGGCAGCCTGTTTTTT	CASIRLAGGSLFF	TRBV5-6	TRBJ1-4
TGTGCCAGCAGTTTCCGCAGTGGACAGGGTATAGGCTACGAGCAGTACTTC	CASSFRSGQGIGYEQYF	TRBV27	TRBJ2-7
TGTGCCAGCAGCTTTTACTCTAGGGATCCCAAAAACATTCAGTACTTC	CASSFYSRDPKNIQYF	TRBV7-9	TRBJ2-4
TGTGCCAGCAGCAGCGTAAAGAGGGGACTAGCGGGGGGGCAGGGCACAGATACGCAGTATTTT	CASSSVKRGLAGGQGTDTQYF	TRBV7-3	TRBJ2-3
TGCAGCGTTGAAGAGCGGCCGGGACAGGGCACCGGGGAGCTGTTTTTT	CSVEERPGQGTGELFF	TRBV29-1	TRBJ2-2
TGTGCCAGCAGTCCGGGCTACGAGCAGTACTTC	CASSPGYEQYF	TRBV12-4	TRBJ2-7
TGTGCCAGCAGAGAGGGGGGGAATCAGCCCCAGCATTTT	CASREGGNQPQHF	TRBV2	TRBJ1-5
TGTGCCAGCAGCGCCGGGACAGCTCAGCCCCAGCATTTT	CASSAGTAQPQHF	TRBV3-1	TRBJ1-5
TGTGCTAGTGGTTTGGTGGCGCAAGATACGCAGTATTTT	CASGLVAQDTQYF	TRBV12-5	TRBJ2-3
TGCGCCAGCCAAAGCCTGAGAAAAGGAACGACAGGGGGCCTGTCCCAAGAGACCCAGTACTTC	CASQSLRKGTTGGLSQETQYF	TRBV10-2	TRBJ2-5
TGTGCCAGCAGTCCGTTCTCAAGGGGCAGGGGGCGCGCTCGCTCCGACTATGGCTACACCTTC	CASSPFSRGRGRARSDYGYTF	TRBV28	TRBJ1-2
TGCGCCAGCAGCTTGCTAAATTCACCCCTCCACTTT	CASSLLNSPLHF	TRBV5-1	TRBJ1-6
TGCAGCGTTGAAGATCCGGGAACTAGCGGGGACGAGCAGTACTTC	CSVEDPGTSGDEQYF	TRBV29-1	TRBJ2-7
TGTGCCAGCAGTTACGGGACAGGGGCCTACGAGCAGTACTTC	CASSYGTGAYEQYF	TRBV6-5	TRBJ2-7
TGTGCCAGCAGCGTAGCTCCAGGCGGGAGACAGAGGGATGAGCAGTTCTTC	CASSVAPGGRQRDEQFF	TRBV6-4	TRBJ2-1
TGCAGCGAGCCGTCTGGTGGGCGGTGGACACTTGCAGATACGCAGTATTTT	CSEPSGGRWTLADTQYF	TRBV29-1	TRBJ2-3
TGCAGTGCTAGCCAAGGGCACTGTACCCGATACGTC	CSASQGHCTRYV	TRBV20-1	TRBJ2-7
TGTGCCAGCAGTAGGGACAGGGTGTCCTACGAGCAGTACTTC	CASSRDRVSYEQYF	TRBV6-4	TRBJ2-7
TGTGCCAGCAGTGACAGGGCGCCCTACGAGCAGTACTTC	CASSDRAPYEQYF	TRBV28	TRBJ2-7
TGTGCCACCATTCTCAGGGGGGTTAATCAGCCCCAGCATTTT	CATILRGVNQPQHF	TRBV24-1	TRBJ1-5
TGTGCCAGCTCATCTCCGGGACGAGCCCTACCGCAGTATTTT	CASSSPGRALPQYF	TRBV18	TRBJ2-3
TGTGCTAGTGGTTCCCTTAGGGACCATAACTACGAGCAGTACTTC	CASGSLRDHNYEQYF	TRBV12-5	TRBJ2-7
TGCGCCAGCCATAAGGACGGGCGCAATCAGCCCCAGCATTTT	CASHKDGRNQPQHF	TRBV5-1	TRBJ1-5
TGTGCCAGCAGCTTCAGTCACAGGTTTTATGGCTACACCTTC	CASSFSHRFYGYTF	TRBV7-2	TRBJ1-2
TGTGCCAGCAGACCTACCCATCTGGTCTCCTACAATGAGCAGTTCTTC	CASRPTHLVSYNEQFF	TRBV11-2	TRBJ2-1
TGTGCCAGCAGCTCTACGCAGTATTTT	CASSSTQYF	TRBV7-3	TRBJ2-3
TGTGCCAGCAGTGAACTCCAGACAGGGGATCGGTGCTACGAGCAGTACTTC	CASSELQTGDRCYEQYF	TRBV6-1	TRBJ2-7
TGCGCCAGCAGCCACCGGGGGGGGCCCGGGGCAACCGGGGAGCTGTTTTTT	CASSHRGGPGATGELFF	TRBV4-3	TRBJ2-2
TGTGCCAGCAGCCAGGACCAGCCCCAGCATTTT	CASSQDQPQHF	TRBV25-1	TRBJ1-5
TGTGCCAGCAGCTTAGAAGGACAGATAATCTATGGCTACACCTTC	CASSLEGQIIYGYTF	TRBV11-2	TRBJ1-2
TGCAGTGCTGTGGACAGGAATGCAACTAATGAAAAACTGTTTTTT	CSAVDRNATNEKLFF	TRBV20-1	TRBJ1-4
TGTGCCAGCAGTTTACTAGTCACAGATACGCAGTATTTT	CASSLLVTDTQYF	TRBV28	TRBJ2-3
TGTGCCAGCAGTTTGCAGGAATTCAAAAGAAACACCATATATTTT	CASSLQEFKRNTIYF	TRBV6-5	TRBJ1-3
TGTGCCAGCAGCCAAGCGTTAACTAGACTAGCGGGCCATCAAGAGACCCAGTACTTC	CASSQALTRLAGHQETQYF	TRBV14	TRBJ2-5
TGCGCCAGCAGCCAAGAGTGGGGACAGGCTGGAAACACCATATATTTT	CASSQEWGQAGNTIYF	TRBV4-3	TRBJ1-3
TGTGCCAGCAGCGACACTAGCGGGAGGGGGGCAGCCTACGAGCAGTACTTC	CASSDTSGRGAAYEQYF	TRBV16	TRBJ2-7
TGTGCCAGCAGCTTAGAGTGGGACTACTTCATGAACACTGAAGCTTTCTTT	CASSLEWDYFMNTEAFF	TRBV7-2	TRBJ1-1
TGTGCCAGCAGCAGGGGGGTACATTCACCCCTCCACTTT	CASSRGVHSPLHF	TRBV7-2	TRBJ1-6
TGCAGCGAGGGGGACATGGAGATGGAGACCCAGTACTTC	CSEGDMEMETQYF	TRBV29-1	TRBJ2-5
TGTGCCAGCAGTTACGTTTTATGCGGGACAGATTACACCATATATTTT	CASSYVLCGTDYTIYF	TRBV6-3	TRBJ1-3
TGTGCCAGCAGTCAAGGGGCTGGCAATCAGCCCCAGCATTTT	CASSQGAGNQPQHF	TRBV27	TRBJ1-5
TGTGCCAGCAGCGACCCGGGACAGGAGAACTACGAGCAGTACTTC	CASSDPGQENYEQYF	TRBV7-8	TRBJ2-7
TGCGCCAGCAGCCTAGGCAGCCCATCTGGGGCCAACGTCCTGACTTTC	CASSLGSPSGANVLTF	TRBV5-1	TRBJ2-6
TGTGCCAGCAGTTTATCCCCACTAGCGGGAGCAGGCACAGATACGCAGTATTTT	CASSLSPLAGAGTDTQYF	TRBV27	TRBJ2-3
TGTGCCAGCAGCCCCGGTAGCAATCAGCCCCAGCATTTT	CASSPGSNQPQHF	TRBV6-4	TRBJ1-5
TGTGCCAGTAGTATCTCCAGACAGGGGTCCACCGGGGAGCTGTTTTTT	CASSISRQGSTGELFF	TRBV19	TRBJ2-2
TGCAGTGCTAGAGATAATACTCGGGGATGGAATGAGCAGTTCTTC	CSARDNTRGWNEQFF	TRBV20-1	TRBJ2-1
TGTGCCAGGACAGGCCACCAAGAGACCCAGTACTTC	CARTGHQETQYF	TRBV13	TRBJ2-5
TGCAGCGTTGAAGGACAGGGCGTGGACACTGAAGCTTTCTTT	CSVEGQGVDTEAFF	TRBV29-1	TRBJ1-1
TGTGCCAGCAGAACAGGTCCTAGGACCCAGCATTTT	CASRTGPRTQHF	TRBV27	TRBJ1-5
TGCGCCAGCAGGTTTCGAGCGACCAAAAGGGGACAGTTGTGGTACACCTTC	CASRFRATKRGQLWYTF	TRBV5-1	TRBJ1-2
TGTGCCAGCAGTAAGCAAACACTCACTGAAGCTTTCTTT	CASSKQTLTEAFF	TRBV28	TRBJ1-1
TGTGCCAGTAGTATGGGTGGGACAGGGGGCACTAATCAGCCCCAGCATTTT	CASSMGGTGGTNQPQHF	TRBV19	TRBJ1-5
TGTGCCAGCAGCCAAGCCAGACTAGCGGGGGAGACAAACAATGAGCAGTTCTTC	CASSQARLAGETNNEQFF	TRBV14	TRBJ2-1
TGCGCCAGCGGCCATTGCCTTAGCGGGCTGTCCTACGAGCAGTACTTC	CASGHCLSGLSYEQYF	TRBV10-1	TRBJ2-7
TGTGCCAGTACCATGGGACAGGGGGTACTGGTTAATCAGCCCCAGCATTTT	CASTMGQGVLVNQPQHF	TRBV19	TRBJ1-5
TGCGCCAGCTATGGTAAGGACAGGGGGAACACTGAAGCTTTCTTT	CASYGKDRGNTEAFF	TRBV10-1	TRBJ1-1
TGCGCCAGCAGCCACCCGGGGAGCGATAAGGTGAACACTGAAGCTTTCTTT	CASSHPGSDKVNTEAFF	TRBV4-1	TRBJ1-1
TGTGCCAGCAGCGCCCAGGGGTACGAGCAGTACTTC	CASSAQGYEQYF	TRBV6-2	TRBJ2-7
TGTGCCAGCAGCACAAAAACCGTTGGACAGCCCCAGCATTTT	CASSTKTVGQPQHF	TRBV5-4	TRBJ1-5
TGCAGTGCACCCCACACAGAAGTGACTAACTATGGCTACACCTTC	CSAPHTEVTNYGYTF	TRBV20-1	TRBJ1-2
TGTGCCAAAGGAAGGGGCTCCTCCTATAATTCACCCCTCCACTTT	CAKGRGSSYNSPLHF	TRBV10-3	TRBJ1-6
TGTGCCAGCAAATGCTGGGCAGGGGGCCTAGAAGGGACACTCAACACTGAAGCTTTCTTT	CASKCWAGGLEGTLNTEAFF	TRBV7-3	TRBJ1-1
TGCAGTGCTAGCCCACGGACAGGGACTGAAGCTTTCTTT	CSASPRTGTEAFF	TRBV20-1	TRBJ1-1
TGCGCCAGCAGCTTGAGTGAAATTACAGGGAGCTCCTACGAGCAGTACTTC	CASSLSEITGSSYEQYF	TRBV5-1	TRBJ2-7
TGTGCCAGCAGCTTAGTGGGGCCCCTGACCCACGAGCAGTACTTC	CASSLVGPLTHEQYF	TRBV7-8	TRBJ2-7
TGTGCCAGCAGTGGACAGGGGTGCTGGGTAATCGAAAACTATGAAAAACTGTTTTTT	CASSGQGCWVIENYEKLFF	TRBV6-4	TRBJ1-4
TGCGCCAGCAGAACCCTCGGGGGCCCCCGGGGACTCCTTCTGGAGACCCAGTACTTC	CASRTLGGPRGLLLETQYF	TRBV10-1	TRBJ2-5
TGTGCCAGTCCGCTAGAGTACAATGAGCAGTTCTTC	CASPLEYNEQFF	TRBV7-2	TRBJ2-1
TGTGCCAGCAGCGAGCGACACTTC	CASSERHF	TRBV9	TRBJ2-7
TGTGCCAGCAGTTCTTTGGGACAGGGCGGGGTTCCAGCTTTCTTT	CASSSLGQGGVPAFF	TRBV12-4	TRBJ1-1
TGCGCCAGCAGCTCGGGGGGGCCCACAGATACGCAGTATTTT	CASSSGGPTDTQYF	TRBV5-1	TRBJ2-3
TGTGCCAGCAGCACCACCTTAGATTATGAGCAGTTCTTC	CASSTTLDYEQFF	TRBV13	TRBJ2-1
TGTGCCAGCAGAGCCCTTGAGATACGCACAGATACGCAGTATTTT	CASRALEIRTDTQYF	TRBV6-2	TRBJ2-3
TGTGCCAGTAGTCAGCAGGAGACCTATAATTCACCCCTCCACTTT	CASSQQETYNSPLHF	TRBV19	TRBJ1-6
TGTGCCAGCAGTAAACATCACAGGGCTTGCTATAGCAATCAGCCCCAGCATTTT	CASSKHHRACYSNQPQHF	TRBV6-1	TRBJ1-5
TGTGCCAGCCTTACAGGGGGCGCTGGAAGCAGCTCTGGAAACACCATATATTTT	CASLTGGAGSSSGNTIYF	TRBV7-9	TRBJ1-3
TGTGCCTCCGCCCCCCGGGGACAGGACTGCCGCTGGAACGAGCAGTACTTC	CASAPRGQDCRWNEQYF	TRBV30	TRBJ2-7
TGCAGTGCGGACAGGGCAGCTAATTCACCCCTCCACTTT	CSADRAANSPLHF	TRBV20-1	TRBJ1-6
TGTGCCAGCAGTAACCCCGGGACAGGGGGGGGCTCTGGAAACACCATATATTTT	CASSNPGTGGGSGNTIYF	TRBV6-5	TRBJ1-3
TGCGCCAGCAGCCAAGGGGGGGGCCCCTACGAGCAGTACTTC	CASSQGGGPYEQYF	TRBV4-3	TRBJ2-7
TGCGCCAGCAGCTTGGAGTTTTGCGTTTACTCGGAAAAACCTTTCTCCTACGAGCAGTACTTC	CASSLEFCVYSEKPFSYEQYF	TRBV5-1	TRBJ2-7
TGCGCCAGCAGCTTGGGTTCAATATCTAACCTACATACGCAGTATTTT	CASSLGSISNLHTQYF	TRBV5-1	TRBJ2-3
TGTGCCAGCAGCCAAGAGGGAGATACGCAGTATTTT	CASSQEGDTQYF	TRBV3-1	TRBJ2-3
TGCGCCAGCAGCCCGAGGGGGACTAGCGGGCCCTACAATGAGCAGTTCTTC	CASSPRGTSGPYNEQFF	TRBV4-1	TRBJ2-1
TGCGCCAGCAGCCAAGTTCCTACTAGCGGGAGACTCGATCAGCCCCAGCATTTT	CASSQVPTSGRLDQPQHF	TRBV4-1	TRBJ1-5
TGTGCCAGCAGTCCACTAGCGGGAGCCAAATGCTCCTACGAGCAGTACTTC	CASSPLAGAKCSYEQYF	TRBV3-1	TRBJ2-7
TGTGCTAGGTACGTAGGGACTAGCGGGGCCTACAATGAGCAGTTCTTC	CARYVGTSGAYNEQFF	TRBV12-5	TRBJ2-1
TGTGCCACCAGTGCGGGAAACATACATTACGAGCAGTACTTC	CATSAGNIHYEQYF	TRBV24-1	TRBJ2-7
TGTGCCAGCAGCCACCCGGGAATAGGCTACACCTTC	CASSHPGIGYTF	TRBV14	TRBJ1-2
TGTGCCAAAAAGCCACTAGAAAAACTGTTTTTT	CAKKPLEKLFF	TRBV12-5	TRBJ1-4
TGTGCCAGCAGCTCCAATACTAGCGGGAGGACCAGGGACCAAACCTACGAGCAGTACTTC	CASSSNTSGRTRDQTYEQYF	TRBV5-6	TRBJ2-7
TGTGCCAGCAGCGGCAGGGTGGGGGGCTACACCTTC	CASSGRVGGYTF	TRBV7-3	TRBJ1-2
TGCAGTGCTAGATCCCCCGATCAAAACACCGGGGAGCTGTTTTTT	CSARSPDQNTGELFF	TRBV20-1	TRBJ2-2
TGTGCCAGCAGTGGAGACAGGGGGCGATACGAGCAGTACTTC	CASSGDRGRYEQYF	TRBV6-5	TRBJ2-7
TGTGCCAGCAGTTTACACACGGGGGCGGAAGACTACAATGAGCAGTTCTTC	CASSLHTGAEDYNEQFF	TRBV12-3	TRBJ2-1
TGTGCCAGCAGTTCTCAGCAAAGGCAGACCTACGAGCAGTACTTC	CASSSQQRQTYEQYF	TRBV28	TRBJ2-7
TGTGCCAGCAGTTACTCGAGCCAGGGGTCCAATGAGCAGTTCTTC	CASSYSSQGSNEQFF	TRBV6-5	TRBJ2-1
TGTGCCAGCAGCTTAGATAAGTCAAGGCCGGGCGGTGAGCAGTACTTC	CASSLDKSRPGGEQYF	TRBV11-3	TRBJ2-7
TGCGCCAGCAGCTCATATATAGCTAACTATGGCTACACCTTC	CASSSYIANYGYTF	TRBV5-1	TRBJ1-2
TGCAGTGCTAGAGTAAACAGGAGGAGCTCCTATAATTCACCCCTCCACTTT	CSARVNRRSSYNSPLHF	TRBV20-1	TRBJ1-6
TGCAGCGTTGAAGATGGAGGGGGGGGCAGCTATGGCTACACCTTC	CSVEDGGGGSYGYTF	TRBV29-1	TRBJ1-2
TGTGCCCGGGTGACTAGCGGTGGGGCAGACTACGAGCAGTACTTC	CARVTSGGADYEQYF	TRBV10-3	TRBJ2-7
TGTGCCAGCAGTTTCGCGAGGGGTTACGAGCAGTACTTC	CASSFARGYEQYF	TRBV27	TRBJ2-7
TGCGCCAGCAGCTTCCAACAGGGGCAAGCGAATGAGCAGTTCTTC	CASSFQQGQANEQFF	TRBV5-1	TRBJ2-1
TGTGCCAGAACGGGGACAGAAGTCCTTTGGCCTGAAGCTTTCTTT	CARTGTEVLWPEAFF	TRBV27	TRBJ1-1
TGTGCCAGCTCACTCACCGACAGGGCGAACACCGGGGAGCTGTTTTTT	CASSLTDRANTGELFF	TRBV18	TRBJ2-2
TGTGCCAGCAGTAACCCTCAGGATAGGGGCTACACCTTC	CASSNPQDRGYTF	TRBV7-6	TRBJ1-2
TGTAAGGAGACAGGACAAGCTTATAGCAATCAGCCCCAGCATTTT	CKETGQAYSNQPQHF	TRBV30	TRBJ1-5
TGTGCCAGCAGCCCGTGGCCCTGCGGGAGGGAGTCCTCTGGAAACACCATATATTTT	CASSPWPCGRESSGNTIYF	TRBV9	TRBJ1-3
TGTGCCAGCAGCTATATCAGGGATAGCGGACATGAGCAGTTCTTC	CASSYIRDSGHEQFF	TRBV7-9	TRBJ2-1
TGTGCCAGCAGTGCCCCCCCCACGGAGCAAGAGACCCAGTACTTC	CASSAPPTEQETQYF	TRBV6-1	TRBJ2-5
TGTGCCAGCAGCAGGAGCGGGAGGTCCGTGTCCTACAATGAGCAGTTCTTC	CASSRSGRSVSYNEQFF	TRBV9	TRBJ2-1
TGTGCCAGTAGTATAGTGTGGCAGGGAAACTTTTTATGTAGCAATCAGCCCCAGCATTTT	CASSIVWQGNFLCSNQPQHF	TRBV19	TRBJ1-5
TGTGCCAGCAGTGAAGGGGACAGTGACTACATGAACCGCACAGATACGCAGTATTTT	CASSEGDSDYMNRTDTQYF	TRBV7-9	TRBJ2-3
TGTGCCAGCAGCTTAGGGGGAGGGATCCCCGACACTGAAGCTTTCTTT	CASSLGGGIPDTEAFF	TRBV11-2	TRBJ1-1
TGTGCCAGCAGTGAACGGGAGGACAGCGGGGAGAAAAATTCACCCCTCCACTTT	CASSEREDSGEKNSPLHF	TRBV25-1	TRBJ1-6
TGTGCCAGCAGTTTCAGCGGGGGGTATAGCAATCAGCCCCAGCATTTT	CASSFSGGYSNQPQHF	TRBV28	TRBJ1-5
TGTGCCAGCAGCTTAAATAGGGGACAGGTCCATGGGGCCAACGTCCTGACTTTC	CASSLNRGQVHGANVLTF	TRBV11-3	TRBJ2-6
TGTGCCATCAGTGAGGATAACAGAAGGTACAGGGGGGCATGTAGCTCCTACAATGAGCAGTTCTTC	CAISEDNRRYRGACSSYNEQFF	TRBV10-3	TRBJ2-1
TGCAGTGCTAGAGAATTTCATTCCCTCCACAGGGGGCCTGAAGCTTTCTTT	CSAREFHSLHRGPEAFF	TRBV20-1	TRBJ1-1
TGTACCAGACTGGGGCATAATGAGCAGTTCTTC	CTRLGHNEQFF	TRBV20-1	TRBJ2-1
TGTGCCATTGGTACAGGGTCGAACACTGAAGCTTTCTTT	CAIGTGSNTEAFF	TRBV28	TRBJ1-1
TGTGCCAGCAGAAGTGGACAGGGCGTTAACACTGAAGCTTTCTTT	CASRSGQGVNTEAFF	TRBV11-3	TRBJ1-1
TGTGCCAGCTCGGTGGGATCCTACGAGCAGTACTTC	CASSVGSYEQYF	TRBV18	TRBJ2-7
TGTGCCTGGAGTAAGGGTGGGATGGGGGATCAGCCCCAGCATTTT	CAWSKGGMGDQPQHF	TRBV30	TRBJ1-5
TGTGCCAGCAGTTACGGCGGTAGGTCTTGCACAGATACGCAGTATTTT	CASSYGGRSCTDTQYF	TRBV6-5	TRBJ2-3
TGTGCCAGCAGCTCCTTGAACCAGACTAGCGGGGGACAGGAGCAGTACTTC	CASSSLNQTSGGQEQYF	TRBV7-2	TRBJ2-7
TGTGCCAGCAGGCCCCCCCCCGGGTACGAGCAGTACTTC	CASRPPPGYEQYF	TRBV6-6	TRBJ2-7
TGTGCCAGTAGATCAGGGCGGGAGAACACTGAAGCTTTCTTT	CASRSGRENTEAFF	TRBV19	TRBJ1-1
TGTGCCAGCACGAGGACAGGACGTAGCAATCAGCCCCAGCATTTT	CASTRTGRSNQPQHF	TRBV7-2	TRBJ1-5
TGTGCCAGCAGTTCAAATAGCCAGGGGGCAGATACGCAGTATTTT	CASSSNSQGADTQYF	TRBV27	TRBJ2-3
TGTGCCAGCAGTTTATTCGGACCTAAAGGGCTGTTTTTT	CASSLFGPKGLFF	TRBV27	TRBJ1-4
TGTGCCAGCACAGGGGGGGGTAACATTCAGTACTTC	CASTGGGNIQYF	TRBV9	TRBJ2-4
TGTGCCAGTAGTATGACAGGGCGTAGGCGGAGCTCCTATAATTCACCCCTCCACTTT	CASSMTGRRRSSYNSPLHF	TRBV19	TRBJ1-6
TGTGCCAGCAGCCAAGTGCCAGGGGGCGGGCATTTT	CASSQVPGGGHF	TRBV14	TRBJ1-5
TGTGCCAGCAGCTCACTGAACAACGAGCAGTACTTC	CASSSLNNEQYF	TRBV11-2	TRBJ2-7
TGTGCCAGCAGACCCAAGGAATCGAAATCTGGGGCCAACGTCCTGACTTTC	CASRPKESKSGANVLTF	TRBV6-5	TRBJ2-6
TGCAGTGCTTCGGGGGGCGAGCAGTACTTC	CSASGGEQYF	TRBV20-1	TRBJ2-7
TGTGCCAGCAGCCAAGAAGGACAGGGCGCTGAAGCTTTCTTT	CASSQEGQGAEAFF	TRBV3-1	TRBJ1-1
TGTGCCAGCAGCGGAAGGCATCACGCAAACATTCAGTACTTC	CASSGRHHANIQYF	TRBV5-6	TRBJ2-4
TGTGCCAGCAGCCCGGAGGGGGCAGCCCTCCACTTT	CASSPEGAALHF	TRBV9	TRBJ1-6
TGTGCCAGCAGCCAGGGGACAAGAGAAAAACTGTTTTTT	CASSQGTREKLFF	TRBV13	TRBJ1-4
TGCAGCGTTCCGGACGGCCATCCCTACGAGCAGTACTTC	CSVPDGHPYEQYF	TRBV29-1	TRBJ2-7
TGCAGTGCTCTGAGGGGATGTAGAGAGGACCTCTCCTACAATGAGCAGTTCTTC	CSALRGCREDLSYNEQFF	TRBV20-1	TRBJ2-1
TGTGCCAGCAGCAATATTGGGGCCGAGAAACCACGTAAACTGTTTTTT	CASSNIGAEKPRKLFF	TRBV5-4	TRBJ1-4
TGCAGTGCTATGGACAGGGGGCTAAACTATGGCTACACCTTC	CSAMDRGLNYGYTF	TRBV20-1	TRBJ1-2
TGCGCCAGACCCTCTAGAGTTGGTGCGAATCAAGAGACCCAGTACTTC	CARPSRVGANQETQYF	TRBV5-1	TRBJ2-5
TGTGCCAGCAGTTGGTTAGCGGGGTTGAGCACAGATACGCAGTATTTT	CASSWLAGLSTDTQYF	TRBV6-3	TRBJ2-3
TGTGCCAGCAGCCCCCTCCGGGGGCACGGTAATCAGCCCCAGCATTTT	CASSPLRGHGNQPQHF	TRBV3-1	TRBJ1-5
TGTGCCAGCCCACGAAGCTCCTATAATTCACCCCTCCACTTT	CASPRSSYNSPLHF	TRBV9	TRBJ1-6
TGTGCCAGCAGCCGAGGGAGGACAGGAAATTATGGCTACACCTTC	CASSRGRTGNYGYTF	TRBV7-9	TRBJ1-2
TGCGCCAGCACCCGTAGGGGGGCCCGGGGGGCCTACAATGAGCAGTTCTTC	CASTRRGARGAYNEQFF	TRBV10-2	TRBJ2-1
TGTGCCAGCAGCTGGGGGGCTAACACTGAAGCTTTCTTT	CASSWGANTEAFF	TRBV7-3	TRBJ1-1
TGTGCCAGCAGTGACTCGAGGGTCCAGGACAATGAGCAGTTCTTC	CASSDSRVQDNEQFF	TRBV6-4	TRBJ2-1
TGCAGTGCTAGAGCAGACAGGGTTGACTCCTACAATGAGCAGTTCTTC	CSARADRVDSYNEQFF	TRBV20-1	TRBJ2-1
TGTGCCAGCAGCTCCGGGGGAGGCACTGAAGCTTTCTTT	CASSSGGGTEAFF	TRBV13	TRBJ1-1
TGTGCCAGTAGTATTTGGGGGACACGAGGCAATCAGCCCCAGCATTTT	CASSIWGTRGNQPQHF	TRBV19	TRBJ1-5
TGTGCCAGCAGTGACTCCCAAAGTAGCGGGCGGTATTTT	CASSDSQSSGRYF	TRBV6-4	TRBJ2-3
TGCAGTGCTCCCACTAGCCACCACGGCTGCGAGCAGTACTTC	CSAPTSHHGCEQYF	TRBV20-1	TRBJ2-7
TGTGCCAGCAGCGATCGGGCACCCTACGAGCAGTACTTC	CASSDRAPYEQYF	TRBV7-6	TRBJ2-7
TGTGCCAGCAGCTTGATCCCAGGTCAGCCCCAGCATTTT	CASSLIPGQPQHF	TRBV5-4	TRBJ1-5
TGCAGTGCTAGAGATCTGTCGGAGGGACGGCAGGAACTTAAACGGCCCTACAATGAGCAGTTCTTC	CSARDLSEGRQELKRPYNEQFF	TRBV20-1	TRBJ2-1
TGTGCCAGCAGCTTACGGCGGCACCAGCCCCAGCATTTT	CASSLRRHQPQHF	TRBV7-6	TRBJ1-5
TGTGCCAGCAGCTTAGGGGGGGACGACGGAGAGACCCAGTACTTC	CASSLGGDDGETQYF	TRBV11-2	TRBJ2-5
TGCGCCAGCAGTGAGATACCGGACAGGGGGGACACTGAAGCTTTCTTT	CASSEIPDRGDTEAFF	TRBV10-1	TRBJ1-1
TGTGCCAGCAAATTTGACAGGGGGGGGCAGTACTTC	CASKFDRGGQYF	TRBV2	TRBJ2-7
TGTGCCAGCAGCTTAGTTACTAGCTGGACCACTGAAGCTTTCTTT	CASSLVTSWTTEAFF	TRBV7-9	TRBJ1-1
TGTGCCAGCAGTTGGACAGGGGGCCGGGGCGAGCAGTACTTC	CASSWTGGRGEQYF	TRBV6-5	TRBJ2-7
TGTGCCAGCCGTGACAGGGCCGACTCTGGAAACACCATATATTTT	CASRDRADSGNTIYF	TRBV28	TRBJ1-3
TGTGCCAGCCGACAGGGAGTCTATGGCTACACCTTC	CASRQGVYGYTF	TRBV6-5	TRBJ1-2
TGTGCCAGCTGGGACAGGGGTTCGAGGGGACGGTGGGGTCAGCCCCAGCATTTT	CASWDRGSRGRWGQPQHF	TRBV9	TRBJ1-5
TGTGCCAGCAGCTTAGAAATCAGGGACAGGACTAAGTATAGCAATCAGCCCCAGCATTTT	CASSLEIRDRTKYSNQPQHF	TRBV7-4	TRBJ1-5
TGCGCCAGCGCGGCCTCTTCACCCCTCCACTTT	CASAASSPLHF	TRBV5-1	TRBJ1-6
TGCGCCAGCAGCCCCCTTGGCCGGGACAACCCCCCGTACGAGCAGTACTTC	CASSPLGRDNPPYEQYF	TRBV4-1	TRBJ2-7
TGCGCCAGCCCCACAGGGTACGGGGGGTCACCCCTCCACTTT	CASPTGYGGSPLHF	TRBV10-1	TRBJ1-6
TGTGCCAGCAGTGATGGACAGGGCCCAGATTGTAATCAGCCCCAGCATTTT	CASSDGQGPDCNQPQHF	TRBV6-1	TRBJ1-5
TGTGCCAGCAGCTCGACAGGGGCTTACGAGCAGTACTTC	CASSSTGAYEQYF	TRBV7-3	TRBJ2-7
TGTGCCAGCAGCCAGTGGAGAGTCGTCCCTGGCGGGATGCAGTTCTTC	CASSQWRVVPGGMQFF	TRBV3-1	TRBJ2-1
TGCGCCAGCAGCCAAGATAGTCAGCGGGATAACGAGCAGTACTTC	CASSQDSQRDNEQYF	TRBV4-1	TRBJ2-7
TGCGCCAGCAGCTTACAGGGGGCAGGGATATACGAGCAGTACTTC	CASSLQGAGIYEQYF	TRBV5-1	TRBJ2-7
TGTGCCAGCAGCAAATCAGGGTGGGGGACCGGGGAGCTGTTTTTT	CASSKSGWGTGELFF	TRBV7-3	TRBJ2-2
TGTGCCAGCAGCTCTACGTGCTTTCTGTACGAGCAGTACTTC	CASSSTCFLYEQYF	TRBV11-2	TRBJ2-7
TGTGCCAGCAGTTACTCGACCCAGGTGGGACAGGGGCATGAAAAACTGTTTTTT	CASSYSTQVGQGHEKLFF	TRBV6-5	TRBJ1-4
TGCGCCAGCAGCCACGAGGGGAAGGGGAACACTGAAGCTTTCTTT	CASSHEGKGNTEAFF	TRBV4-1	TRBJ1-1
TGTGCCAGCAGCTTCAAAAGTTCACCCCTCCACTTT	CASSFKSSPLHF	TRBV27	TRBJ1-6
TGTGCCAGCAGTTTAAGGGGGACCGGGACAAAAGATGAGCAGTTCTTC	CASSLRGTGTKDEQFF	TRBV12-3	TRBJ2-1
TGTGCCAGCAGGACCCCCTACAGGGAGCCCCGGCCCTACGAGCAGTACTTC	CASRTPYREPRPYEQYF	TRBV3-1	TRBJ2-7
TGCAGTGCTAGACTTCCCTTCCCGCTACCGTGCCCGGGACTATACGAGCAGTACTTC	CSARLPFPLPCPGLYEQYF	TRBV20-1	TRBJ2-7
TGTGCCAGCAGTCCTCCTAGAGCGGGTGGCTACACCTTC	CASSPPRAGGYTF	TRBV27	TRBJ1-2
TGTGCCAGCAGCGTCCCACACTACCCCGGGGAGCTGTTTTTT	CASSVPHYPGELFF	TRBV9	TRBJ2-2
TGCAGTGCTACCCTTTTCAGGGGGACCTATGGCTACACCTTC	CSATLFRGTYGYTF	TRBV20-1	TRBJ1-2
TGTGCCAGCAGCAAGGTCGAGGACAGGTTTACCTACGAGCAGTACTTC	CASSKVEDRFTYEQYF	TRBV13	TRBJ2-7
TGTGCCAGCAGCGGCCGGCGGACGGATGGCTACACCTTC	CASSGRRTDGYTF	TRBV11-2	TRBJ1-2
TGTGCCAGCCCTCAGGGGGGGTTGAGCACTGAAGCTTTCTTT	CASPQGGLSTEAFF	TRBV27	TRBJ1-1
TGTGCCAGCAGCCAAGCAGCCCCCCTGAGGAAGGAAACCTACGAGCAGTACTTC	CASSQAAPLRKETYEQYF	TRBV14	TRBJ2-7
TGTGCCAGCAGTGACTCGGACGGGACAGAAAGTGAGCAGTTCTTC	CASSDSDGTESEQFF	TRBV6-4	TRBJ2-1
TGTGCCAGCTCACCAGTAACCGGTACCGGACAGGGGGCCGGTGAGCAGTTCTTC	CASSPVTGTGQGAGEQFF	TRBV18	TRBJ2-1
TGTGCCAGCAGTGGACTCTTCCGGACGGGGGGCTACGAGCAGTACTTC	CASSGLFRTGGYEQYF	TRBV2	TRBJ2-7
TGTGCCAGCAGCGGGGACAGGGTCAAGTATGAGCAGTTCTTC	CASSGDRVKYEQFF	TRBV9	TRBJ2-1
TGCGCCAGCAGCGGGACAGGCACAGATACGCAGTATTTT	CASSGTGTDTQYF	TRBV5-1	TRBJ2-3
TGTGCCAGCAGACCGGGACAGGGTCATCAGCCCCAGCATTTT	CASRPGQGHQPQHF	TRBV5-5	TRBJ1-5
TGTGCCTGGAGTGTACCTACCGCCGGGCGCCCGGCTGGCTCCTATAATTCACCCCTCCACTTT	CAWSVPTAGRPAGSYNSPLHF	TRBV30	TRBJ1-6
TGTGCCGAAGGGCCAGGACAGGGATGGGAAAAACTGTTTTTT	CAEGPGQGWEKLFF	TRBV6-2	TRBJ1-4
TGCAGTGCTGAAAGTCGGACTAGCGGGCAAGAGACCCAGTACTTC	CSAESRTSGQETQYF	TRBV20-1	TRBJ2-5
TGTGCCAGCAGCCAAGGGACACGCCTAAGCTCCTACGAGCAGTACTTC	CASSQGTRLSSYEQYF	TRBV3-1	TRBJ2-7
TGTGCCACCAGTACGCGAGTGGCACCAGAAGGCTATGGCTACACCTTC	CATSTRVAPEGYGYTF	TRBV24-1	TRBJ1-2
TGCGCCAGCAGACCCGCAGGCGAGGGTTCCCATGAGCAGTTCTTC	CASRPAGEGSHEQFF	TRBV10-1	TRBJ2-1
TGTGCCACGAGAGACTACGAGCAGTACTTC	CATRDYEQYF	TRBV7-4	TRBJ2-7
TGTGCCAGCAGCGGGGGGGCGGTTTATGGCTACACCTTC	CASSGGAVYGYTF	TRBV11-2	TRBJ1-2
TGTGCCTGGAGGGAGGTGGGAAACCAGTACTTC	CAWREVGNQYF	TRBV30	TRBJ2-5
TGTGCCAGCAGCTTGAGCAGGGCCCAGCATTTT	CASSLSRAQHF	TRBV5-5	TRBJ1-5
TGTGCTAGTGGTTTGCTCGGGCGGGAGCAGTTCTTC	CASGLLGREQFF	TRBV12-5	TRBJ2-1
TGTGCCAATCCCCACAGCTCCAGCTATGGCTACACCTTC	CANPHSSSYGYTF	TRBV19	TRBJ1-2
TGTGCCAGCAGCTTGGGGGCCGACACCATATATTTT	CASSLGADTIYF	TRBV5-5	TRBJ1-3
TGCGCCACACTTCGTCAGCCCCAGCATTTT	CATLRQPQHF	TRBV10-1	TRBJ1-5
TGCAGTGCTAGGTTGGGGGGGAATCCCAATGAGCAGTTCTTC	CSARLGGNPNEQFF	TRBV20-1	TRBJ2-1
TGTGCTAGCAGCATACAGGGGGAATATGAAAAACTGTTTTTT	CASSIQGEYEKLFF	TRBV7-7	TRBJ1-4
TGCGCCAGCAGCTTGGGTAAAGGCGAGCAGTACTTC	CASSLGKGEQYF	TRBV5-1	TRBJ2-7
TGTGCCAGCAGCTCGTTGACCCATGCAGATGGGGGAGAAGCTTTCTTT	CASSSLTHADGGEAFF	TRBV7-2	TRBJ1-1
TGTGCCAGCAGCGAACCCGGGACGCACGAGCAGTACTTC	CASSEPGTHEQYF	TRBV5-6	TRBJ2-7
TGTGCCACCAGTGATTTAACTTTACCCCAGGGTCCGGGGTACGAGCAGTACTTC	CATSDLTLPQGPGYEQYF	TRBV24-1	TRBJ2-7
TGTGCCAGCAGCCGTATGGGACCACTCACTGAAGCTTTCTTT	CASSRMGPLTEAFF	TRBV7-4	TRBJ1-1
TGTGCCAGCAGCCAAGTACGAGACCTAGGGTGTTCCAATGAGCAGTTCTTC	CASSQVRDLGCSNEQFF	TRBV4-2	TRBJ2-1
TGTGCCAGCAGTGTTGGGGGAGGACGCTACGAGCAGTACTTC	CASSVGGGRYEQYF	TRBV6-4	TRBJ2-7
TGTGCCAGCAGTCCCTCGGCCGGGACAGGGGATGAGCAGTTCTTC	CASSPSAGTGDEQFF	TRBV6-2	TRBJ2-1
TGTGCCAGCACCAGTCTGGACAGCCTTGAGCAGTTCTTC	CASTSLDSLEQFF	TRBV7-9	TRBJ2-1
TGTGCCAGCAGCTTAGACAGTACAACGGATGGCTACACCTTC	CASSLDSTTDGYTF	TRBV7-6	TRBJ1-2
TGTGCCAGCAGTGACTGGGGAACGACCCTGTTTTTT	CASSDWGTTLFF	TRBV25-1	TRBJ1-4
TGTGCCAGCAGCCAACCGCCGGGACAGATTAGCTCCTATAATTCACCCCTCCACTTT	CASSQPPGQISSYNSPLHF	TRBV9	TRBJ1-6
TGTGCCAGCAGAGTCGGGACGCTCGGGGAGCTGTTTTTT	CASRVGTLGELFF	TRBV28	TRBJ2-2
TGTGCCAGATGGACAGGGGGAGGTGAAAAACTGTTTTTT	CARWTGGGEKLFF	TRBV28	TRBJ1-4
TGCGCCAGCAGCGTTTACCCTCCAGGGGGCGGGAGCTACGAGCAGTACTTC	CASSVYPPGGGSYEQYF	TRBV5-1	TRBJ2-7
TGTGCCAGCAGCCAGGACAGACAGGAGAACACTGAAGCTTTCTTT	CASSQDRQENTEAFF	TRBV4-2	TRBJ1-1
TGTGCCAGCAGCTTACAAAATTGGGGGGTTAGAAACAGCAATCAGCCCCAGCATTTT	CASSLQNWGVRNSNQPQHF	TRBV7-9	TRBJ1-5
TGTGCCAGCAGCGACTGGACAGGGGGCACCGGGGAGCTGTTTTTT	CASSDWTGGTGELFF	TRBV13	TRBJ2-2
TGTGCCAGCAGCGACCCAGAGGACGGGGAGCTGTTTTTT	CASSDPEDGELFF	TRBV13	TRBJ2-2
TGTGCCAGCAGCTTAGCGAGATGGCGTCGGGGACAGATCAATGAGCAGTTCTTC	CASSLARWRRGQINEQFF	TRBV7-6	TRBJ2-1
TGTGCCAGCAGGGACAGGGACCGGAACCCCTACGAGCAGTACTTC	CASRDRDRNPYEQYF	TRBV7-3	TRBJ2-7
TGTGCCAGCAGTGAACTGCCTCAGTTGGATCAGCCCCAGCATTTT	CASSELPQLDQPQHF	TRBV6-4	TRBJ1-5
TGTGCCAGCAGTAGGGGAAAACAGGGGGGGTATTCACCCCTCCACTTT	CASSRGKQGGYSPLHF	TRBV27	TRBJ1-6
TGTGCCAGCAGCTTAGTCGTCCACCTCCGACAGGGCTACGAGCAGTACTTC	CASSLVVHLRQGYEQYF	TRBV7-2	TRBJ2-7
TGTGCCAGTGGCAAAAAAGCCTCCTACGAGCAGTACTTC	CASGKKASYEQYF	TRBV19	TRBJ2-7
TGTGCCAGCAGACCCAACAGAAGCGGGATGCACAATGAGCAGTTCTTC	CASRPNRSGMHNEQFF	TRBV6-2	TRBJ2-1
TGTGCCACCAGTAACAACAGGGGGCAACCTGGAAACACCATATATTTT	CATSNNRGQPGNTIYF	TRBV24-1	TRBJ1-3
TGTGCCAGCAGCTTGTACTTTTCTGGTCCTTACTATGGCTACACCTTC	CASSLYFSGPYYGYTF	TRBV7-9	TRBJ1-2
TGCGCCAGCAGCTTGAGAGAGGAGGGACTAAACTATGGCTACACCTTC	CASSLREEGLNYGYTF	TRBV5-1	TRBJ1-2
TGCAGTGCTAGAGATTTTACTTTGGACAGGGAGGTTCAGCCCCAGCATTTT	CSARDFTLDREVQPQHF	TRBV20-1	TRBJ1-5
TGTGCCAGCAGCAGGCGGGACAGCGACTATGGCTACACCTTC	CASSRRDSDYGYTF	TRBV7-9	TRBJ1-2
TGTGCCAGTCCCGGGACTAGCCTGGTGGGACTGGAGGGAGAGACCCAGTACTTC	CASPGTSLVGLEGETQYF	TRBV6-5	TRBJ2-5
TGTGCCAGCCGGACTTTAGATTCACCCCTCCACTTT	CASRTLDSPLHF	TRBV7-3	TRBJ1-6
TGTGCCAGCAGCCCGCGGGATAGGGGCTCCGAATACCAAGAGACCCAGTACTTC	CASSPRDRGSEYQETQYF	TRBV13	TRBJ2-5
TGTGCCAGCAGCGTATTTCTTGGACAAGGAGCCGAAAAACTGTTTTTT	CASSVFLGQGAEKLFF	TRBV9	TRBJ1-4
TGTGCCAGCAGCGACCCCGGGAACACTGAAGCTTTCTTT	CASSDPGNTEAFF	TRBV5-8	TRBJ1-1
TGTGCCAGCAGCCATGCGGAGGGAGATACGCAGTATTTT	CASSHAEGDTQYF	TRBV14	TRBJ2-3
TGCAGTGCTAGAGATCAAGTCCCGTGCCCCAGGGGGCCGGGGAACACTGAAGCTTTCTTT	CSARDQVPCPRGPGNTEAFF	TRBV20-1	TRBJ1-1
TGTGCTAGCAGCTTAGTTAGAGAACCTAACTATGGCTACACCTTC	CASSLVREPNYGYTF	TRBV7-7	TRBJ1-2
TGTGCCAGTAAGAGAGTACTAGGTGCCAGGGACACTGAAGCTTTCTTT	CASKRVLGARDTEAFF	TRBV9	TRBJ1-1
TGTGCCTGGAGTGTCAACAGGGGAGATACGCAGTATTTT	CAWSVNRGDTQYF	TRBV30	TRBJ2-3
TGTGCCAGCTCACTTACGACAGGGGCTGAGGGGGGAAATGAGCAGTTCTTC	CASSLTTGAEGGNEQFF	TRBV18	TRBJ2-1
TGTGCCAACGGCAGACGGGAGCCCCAGCATTTT	CANGRREPQHF	TRBV10-3	TRBJ1-5
TGTGCCAGCAGCTTATCCAACCCAGGAGTGGTTAGCTCTGGGGCCAACGTCCTGACTTTC	CASSLSNPGVVSSGANVLTF	TRBV7-6	TRBJ2-6
TGTGCCAGCAGCACAGGGGGTAACTATGGCTACACCTTC	CASSTGGNYGYTF	TRBV7-3	TRBJ1-2
TGTGCCAGGGATAGAGGCTACACCTTC	CARDRGYTF	TRBV6-2	TRBJ1-2
TGCAGTGCTAGGACTAGCGGGGCGACCGGGGAGCTGTTTTTT	CSARTSGATGELFF	TRBV20-1	TRBJ2-2
TGTGCCACCAGTGAAGTAGGCAACAGGGAAGACGAGCAGTACTTC	CATSEVGNREDEQYF	TRBV24-1	TRBJ2-7
TGTGCCAGTAGTATATCCGGGACAGGGCCCCCTAGCAATCAGCCCCAGCATTTT	CASSISGTGPPSNQPQHF	TRBV19	TRBJ1-5
TGTGCCAGCAGCTCTACAGGGGACCCGTCTGAAAAACTGTTTTTT	CASSSTGDPSEKLFF	TRBV6-5	TRBJ1-4
TGCGCCAGCAGCTTAAGGGGTCAGGGCTACACCTTC	CASSLRGQGYTF	TRBV5-1	TRBJ1-2
TGTGCTAGTGGCCCAGGCGGGAGTTTAGGTAGCTCCTACAATGAGCAGTTCTTC	CASGPGGSLGSSYNEQFF	TRBV12-5	TRBJ2-1
TGTGCCAGCAGTGCATGGACAGGGTGCACCGGGGAGCTGTTTTTT	CASSAWTGCTGELFF	TRBV12-4	TRBJ2-2
TGCGCCAGCAGCTACCCGGGGCCCGCCAAAAACATTCAGTACTTC	CASSYPGPAKNIQYF	TRBV5-1	TRBJ2-4
TGTGCTAGTGGCATTAAGGCATATTTT	CASGIKAYF	TRBV12-5	TRBJ2-3
TGCAGTGCGTGTGGGGCCGGGGAGCTGTTTTTT	CSACGAGELFF	TRBV20-1	TRBJ2-2
TGTGCCTGGTCGTGGACAGGGGGCAAATACTATGGCTACACCTTC	CAWSWTGGKYYGYTF	TRBV30	TRBJ1-2
TGCAGTGCAGTCGTTAGCGGGGGGGCCCATACAGATACGCAGTATTTT	CSAVVSGGAHTDTQYF	TRBV20-1	TRBJ2-3
TGCAGTGCACTAGCGGGGGGCAAAAACATTCAGTACTTC	CSALAGGKNIQYF	TRBV20-1	TRBJ2-4
TGTGCCAGCAGTTACACGATTTTAGGGGGGCAGTACTTC	CASSYTILGGQYF	TRBV6-3	TRBJ2-5
TGTGCCAGCAGAATTGGGACAGGGGAAAAACTGTTTTTT	CASRIGTGEKLFF	TRBV6-6	TRBJ1-4
TGTGCCAGCAGAAGGACCCAGAGATCGGACGATACGCAGTATTTT	CASRRTQRSDDTQYF	TRBV6-1	TRBJ2-3
TGCGCCAGCAGCCAAGCCCAACGGACTGGGAGGGAGGGATATAATGAAAAACTGTTTTTT	CASSQAQRTGREGYNEKLFF	TRBV4-1	TRBJ1-4
TGTGCCAGCACCCCCAGAGGACCCGAAGCTTTCTTT	CASTPRGPEAFF	TRBV6-3	TRBJ1-1
TGTGCCAGCAGTCAAACACAGGGCTGGTCTACCTACGAGCAGTACTTC	CASSQTQGWSTYEQYF	TRBV27	TRBJ2-7
TGTGCCAGCAGCTTAGGACCACAGGGGGTAACTGAAGCTTTCTTT	CASSLGPQGVTEAFF	TRBV11-2	TRBJ1-1
TGTGCCAGCAGTTACGTAAGGCGTAAAGGGAGGGGGGACGAGCAGTACTTC	CASSYVRRKGRGDEQYF	TRBV6-6	TRBJ2-7
TGTGCCAGCAGCCAAGTCCACCAACTGAGTGGGTTCCTAGGGTACGCCAAAAACATTCAGTACTTC	CASSQVHQLSGFLGYAKNIQYF	TRBV14	TRBJ2-4
TGTGCCAGCAGCTTACAAACTCCCGGATACACTGAAGCTTTCTTT	CASSLQTPGYTEAFF	TRBV11-3	TRBJ1-1
TGCGCCAGCAGAGGGGGGGGGAAACCACGGGTGAACTCAATTAACATTCAGTACTTC	CASRGGGKPRVNSINIQYF	TRBV10-1	TRBJ2-4
TGTGCCAGCAGCTTAAGGCGGCGGCCAGGTACAGATACGCAGTATTTT	CASSLRRRPGTDTQYF	TRBV5-6	TRBJ2-3
TGTGCCAGCAGCTTAGCGGACCACGCCTCCTACAATGAGCAGTTCTTC	CASSLADHASYNEQFF	TRBV7-2	TRBJ2-1
TGCGCCAGCAGCCGGCTAATTATCGGGGGATGGGGCCAAGAGACCCAGTACTTC	CASSRLIIGGWGQETQYF	TRBV10-1	TRBJ2-5
TGTGCCAGCAGCGGCGACAGAATTGCAGATACGCAGTATTTT	CASSGDRIADTQYF	TRBV7-4	TRBJ2-3
TGTGCTAGTGGAAACAGACGGGGTAGTCACGAGCAGTACTTC	CASGNRRGSHEQYF	TRBV12-5	TRBJ2-7
TGTGCCAGTAGTGCCTCCCCCGCGGCGGACAATGAGCAGTTCTTC	CASSASPAADNEQFF	TRBV19	TRBJ2-1
TGCGCCAGCAGCCAAGCACAGCGACTAGCAGGTCACGAGCAGTACTTC	CASSQAQRLAGHEQYF	TRBV4-1	TRBJ2-7
TGTGCCAGCAGAGTCGATCAGGGGGGGAATCAGCCCCAGCATTTT	CASRVDQGGNQPQHF	TRBV6-4	TRBJ1-5
TGTGCCAGCAGCTTCTGCACGCCAGGGTCAGACGCCTACAATGAGCAGTTCTTC	CASSFCTPGSDAYNEQFF	TRBV7-4	TRBJ2-1
TGTGCCATCAGTGACTATTGGCCCCCGGGACTAGCGGGAGGCCTTAATCAGCCCCAGCATTTT	CAISDYWPPGLAGGLNQPQHF	TRBV10-3	TRBJ1-5
TGTGCCAGCAGCTTAGGACAGACTAATGAAAAACTGTTTTTT	CASSLGQTNEKLFF	TRBV7-9	TRBJ1-4
TGTGCCAGCAGGGCCCTGACCGGGACGAAGACTGAAGCTTTCTTT	CASRALTGTKTEAFF	TRBV12-3	TRBJ1-1
TGTGCCAGCAGGTGGGACAGGCGGGGGTTCGAGCAGTACTTC	CASRWDRRGFEQYF	TRBV12-4	TRBJ2-7
TGTGCCAGCAGCGCTAACAGGGGGCATGAGCAGTTCTTC	CASSANRGHEQFF	TRBV7-9	TRBJ2-1
TGTGCCAGCAGCACAGGGGGGGGGTACAATGAGCAGTTCTTC	CASSTGGGYNEQFF	TRBV11-2	TRBJ2-1
TGTGCCAGCAACAGGGAGCTTTACTATGGCTACACCTTC	CASNRELYYGYTF	TRBV27	TRBJ1-2
TGTGCCGCCCCCCAGATGACAGTGGATGAGCAGTTCTTC	CAAPQMTVDEQFF	TRBV24-1	TRBJ2-1
TGTGCCAGCAGCCCGATGGACAGGGGACTGCGAGGAGACACCGGGGAGCTGTTTTTT	CASSPMDRGLRGDTGELFF	TRBV28	TRBJ2-2
TGTGCCAGCAGCAACACGGGGGTGCTGAACTATGGCTACACCTTC	CASSNTGVLNYGYTF	TRBV11-1	TRBJ1-2
TGTGCCAGCAGTTACGTGGAGTTAGTACGATGGACCATAGCCAAAAACATTCAGTACTTC	CASSYVELVRWTIAKNIQYF	TRBV6-6	TRBJ2-4
TGTGCCAGCAGCCACCCCTTCCTTTTCTTGAACACAGATACGCAGTATTTT	CASSHPFLFLNTDTQYF	TRBV6-2	TRBJ2-3
TGTGCCAGCAGTGAACAGAATCGAGAGACCCAGTACTTC	CASSEQNRETQYF	TRBV6-1	TRBJ2-5
TGCAGCGGAACTACAGGCTTAAGCAATCAGCCCCAGCATTTT	CSGTTGLSNQPQHF	TRBV29-1	TRBJ1-5
TGTGCCACCAGTGATTTCAGCATAGACAGGGATAATTCACCCCTCCACTTT	CATSDFSIDRDNSPLHF	TRBV24-1	TRBJ1-6
TGTGCCAGCAGCGAAGGGACAGGGCCCGGCTACACCTTC	CASSEGTGPGYTF	TRBV13	TRBJ1-2
TGTGCCAGCAGCCGCCCACGGGACCGTACCGGGCTGCCGTACGAGCAGTACTTC	CASSRPRDRTGLPYEQYF	TRBV14	TRBJ2-7
TGCGCCAGCAGTGAGAGTTCGACCTCCTATGGCTACACCTTC	CASSESSTSYGYTF	TRBV10-1	TRBJ1-2
TGTGCCAGCAGCAGGCTAGACTATGCTTTCTTT	CASSRLDYAFF	TRBV11-2	TRBJ1-1
TGTGCCAGCAGTGATGTCCCCATATTTCAGGGGGCAATTGGCTATGGCTACACCTTC	CASSDVPIFQGAIGYGYTF	TRBV25-1	TRBJ1-2
TGTGCCAGCAGCCTATCGGGGGGATGGAGCAATCAGCCCCAGCATTTT	CASSLSGGWSNQPQHF	TRBV14	TRBJ1-5
TGTGCCAGCAGCTTCCCTAGCGGGAGTTTCAGGAACACCGGGGAGCTGTTTTTT	CASSFPSGSFRNTGELFF	TRBV7-4	TRBJ2-2
TGTGCCAGCAGCCGGAGGGTAAGTGAGCAGTTCTTC	CASSRRVSEQFF	TRBV13	TRBJ2-1
TGTGCCAGCAGCAACCCAGACGAGCAGTACTTC	CASSNPDEQYF	TRBV7-3	TRBJ2-7
TGTGCCACCAGCAGACTCGATAGCGAGCAGTACTTC	CATSRLDSEQYF	TRBV15	TRBJ2-7
TGTGCCACCAGTGAGGGAGAGAATCAGCCCCAGCATTTT	CATSEGENQPQHF	TRBV24-1	TRBJ1-5
TGCGCCAGCAGAACGGGGCGGACGCAGTATTTT	CASRTGRTQYF	TRBV5-1	TRBJ2-3
TGTGCCAGCAGCCCCCAGGGTTTGGGAAACACCATATATTTT	CASSPQGLGNTIYF	TRBV5-6	TRBJ1-3
TGTGCTAGTGGTTTGGTACAAGGACCGAGGGAAGGCGGTAGCAATCAGCCCCAGCATTTT	CASGLVQGPREGGSNQPQHF	TRBV12-5	TRBJ1-5
TGTGCCAGCAGGGCCGGAGAAGAGTGGGCAACCTCTGGAAACACCATATATTTT	CASRAGEEWATSGNTIYF	TRBV6-6	TRBJ1-3
TGCAGCGTTGAAGAAGGGGCCAGCTATGGCTACACCTTC	CSVEEGASYGYTF	TRBV29-1	TRBJ1-2
TGCAGTGCTAGACGAAACGGATGGACGTGCGAAGCTTTCTTT	CSARRNGWTCEAFF	TRBV20-1	TRBJ1-1
TGTGCCAGCGGGACCGGACTAGCGGGGGGCTTCGGGGAGCTGTTTTTT	CASGTGLAGGFGELFF	TRBV7-9	TRBJ2-2
TGCGCCAGCAGCCCCGGGAAAGGGGGATCAGCTTTCTTT	CASSPGKGGSAFF	TRBV4-3	TRBJ1-1
TGTGCCAGCACGACTAGGAACGGGCGTGAGACCCAGTACTTC	CASTTRNGRETQYF	TRBV7-9	TRBJ2-5
TGCAGTGCAGCTCAGGGGGCAAACGGGGCCAACGTCCTGACTTTC	CSAAQGANGANVLTF	TRBV20-1	TRBJ2-6
TGTGCCAGCTCACCACCAGTGGGGGGGAGTTCCACCGGGGAGCTGTTTTTT	CASSPPVGGSSTGELFF	TRBV18	TRBJ2-2
TGCAGTGCTAAATGGGGGACGGCCTACGAGCAGTACTTC	CSAKWGTAYEQYF	TRBV20-1	TRBJ2-7
TGTGCCTTCATCAGCCCCGGGACGTGCAATGAGCAGTTCTTC	CAFISPGTCNEQFF	TRBV30	TRBJ2-1
TGTGCCAGCAGCAAAAATATCAAACATGGCTCCTATAATTCACCCCTCCACTTT	CASSKNIKHGSYNSPLHF	TRBV11-2	TRBJ1-6
TGTGCCAGCAGTTACCCCGAGACCGCCTACGAGCAGTACTTC	CASSYPETAYEQYF	TRBV6-3	TRBJ2-7
TGTGCCAGTAAACCGAGACAGGGGGTGGACAATGAGCAGTTCTTC	CASKPRQGVDNEQFF	TRBV19	TRBJ2-1
TGTGCCAGCAGTTACTCCTCCTGGAGCTCCTACGAGCAGTACTTC	CASSYSSWSSYEQYF	TRBV6-6	TRBJ2-7
TGTACATATCCCAGGGACAATGAGCAGTTCTTC	CTYPRDNEQFF	TRBV6-1	TRBJ2-1
TGTGCTAGCAGCTTAAAGGGAAGGCGGTTCCGGGCCAAAAACATTCAGTACTTC	CASSLKGRRFRAKNIQYF	TRBV7-7	TRBJ2-4
TGCAGCAATATCGACAGAGGACGGACTGAGCAGTTCTTC	CSNIDRGRTEQFF	TRBV29-1	TRBJ2-1
TGTGCCAGCACCGTCAGGGCTACCCAATCTAACTATGGCTACACCTTC	CASTVRATQSNYGYTF	TRBV9	TRBJ1-2
TGTGCCAGCAGCCTGAGAGCCGGGTTCGCTGAAGCTTTCTTT	CASSLRAGFAEAFF	TRBV5-6	TRBJ1-1
TGTGCCAGTGGGGAGACCCAGCATTTT	CASGETQHF	TRBV19	TRBJ1-5
TGTGCCAGTAGTATAAGTTGCGGGACAGGGGAGAAGACCCAGTACTTC	CASSISCGTGEKTQYF	TRBV19	TRBJ2-5
TGTGCCAGATGTCGCGGGGACAATCAGCCCCAGCATTTT	CARCRGDNQPQHF	TRBV6-4	TRBJ1-5
TGTGCCAGCAGGGCGGACAGGGGGGATTACAATGAGCAGTTCTTC	CASRADRGDYNEQFF	TRBV6-6	TRBJ2-1
TGTGCCAGCAGGCGACTGGATCGGGACGGGAGGGAGACCCAGTACTTC	CASRRLDRDGRETQYF	TRBV7-3	TRBJ2-5
TGTGCCAGCAGCTTGACGGGACGGGACCACAACGAGCAGTACTTC	CASSLTGRDHNEQYF	TRBV5-6	TRBJ2-7
TGCGCCAGCAGCCATCCCGTGACTAGAGCCACAGATACGCAGTATTTT	CASSHPVTRATDTQYF	TRBV4-1	TRBJ2-3
TGTGCCAGCAGCTTACGACAGGGGAGCTCCTACGAGCAGTACTTC	CASSLRQGSSYEQYF	TRBV5-4	TRBJ2-7
TGTGCCAGCAATCCCCGGCAGCGATACGAGCAGTACTTC	CASNPRQRYEQYF	TRBV6-1	TRBJ2-7
TGTGCCTGGAGTGGCCCGGACATATCTGGAAACACCATATATTTT	CAWSGPDISGNTIYF	TRBV30	TRBJ1-3
TGTGCCAGCAGTGGGACTAGCGCGTGGGCTGGGGCCAACGTCCTGACTTTC	CASSGTSAWAGANVLTF	TRBV6-8	TRBJ2-6
TGTGCCAGCAGTTTACCGCAACGCCCCAGTTGGAGGCGAACTGAAGCTTTCTTT	CASSLPQRPSWRRTEAFF	TRBV12-4	TRBJ1-1
TGTGCCAGCAGTTACTCGACGGGTGTAGGCCTAGCGGGCTACATCGAGACCCAGTACTTC	CASSYSTGVGLAGYIETQYF	TRBV6-5	TRBJ2-5
TGTGCCAGCAGCGTAGGGGCGGGGCCAGGTTCAGATACGCAGTATTTT	CASSVGAGPGSDTQYF	TRBV9	TRBJ2-3
TGTGCCAGCTCACCCCGCCTTGCGGGAGCCTACGAGCAGTACTTC	CASSPRLAGAYEQYF	TRBV18	TRBJ2-7
TGTGCCACCAGTCCTTTGGACTGCCATCAGCCCCAGCATTTT	CATSPLDCHQPQHF	TRBV24-1	TRBJ1-5
TGTGCCAGCAGATACGGAGTTTCCCAGTACTTC	CASRYGVSQYF	TRBV6-5	TRBJ2-5
TGCGCCAGCAGCCGACAGGGGGCTTTTGCAACTAATGAAAAACTGTTTTTT	CASSRQGAFATNEKLFF	TRBV4-1	TRBJ1-4
TGTGCCAGCAGTTTATGCCTACAGCCCAGCCTGGCACGATTGGACAATGAGCAGTTCTTC	CASSLCLQPSLARLDNEQFF	TRBV27	TRBJ2-1
TGTGCCAGCAGCGGTGAGGACCGCTCCTACGAGCAGTACTTC	CASSGEDRSYEQYF	TRBV7-3	TRBJ2-7
TGTGCCAGTCACGGGGACAGCAACTACGAGCAGTACTTC	CASHGDSNYEQYF	TRBV7-3	TRBJ2-7
TGTGCCAGTAGTAGAGCTCCCGTCTACGAGCAGTACTTC	CASSRAPVYEQYF	TRBV19	TRBJ2-7
TGTGCCAGCAGCACCCGATGGAGGGGATGGCTAAGCTCCTACAATGAGCAGTTCTTC	CASSTRWRGWLSSYNEQFF	TRBV13	TRBJ2-1
TGTGCCAGCAGCTTAGCCTGGGGGAGCTATGGCTACACCTTC	CASSLAWGSYGYTF	TRBV7-2	TRBJ1-2
TGTGCCAGCAGACGGGACTTCGAGTCCTATAATTCACCCCTCCACTTT	CASRRDFESYNSPLHF	TRBV6-1	TRBJ1-6
TGTGCCAGCAGCTACCACAGGGGGCCAGGGGTAGGCGAGCAGTACTTC	CASSYHRGPGVGEQYF	TRBV7-9	TRBJ2-7
TGTGCCAGCAGCTCGGGGGTTCATGGGTGGGGACCTGGCTACACCTTC	CASSSGVHGWGPGYTF	TRBV13	TRBJ1-2
TGCAACCCGGGACTAGTGACCGGGGAGCTGTTTTTT	CNPGLVTGELFF	TRBV20-1	TRBJ2-2
TGCAGTGCGCGGACAGGTGAGCAGTTCTTC	CSARTGEQFF	TRBV20-1	TRBJ2-1
TGTGCCCGACAGGATCAGCCCCAGCATTTT	CARQDQPQHF	TRBV9	TRBJ1-5
TGCAGGACCCGGTACCCAAGGATGGAGTATTTT	CRTRYPRMEYF	TRBV20-1	TRBJ2-3
TGTGCCAGCAGTTACCCTAAATACAATGAGCAGTTCTTC	CASSYPKYNEQFF	TRBV6-2	TRBJ2-1
TGTGCCAGCAGCCCCGCGCGGTCGGATACGCAGTATTTT	CASSPARSDTQYF	TRBV13	TRBJ2-3
TGTGCCAGCAGTAGGTGCGGGACAGGAGGTGGAAACACCATATATTTT	CASSRCGTGGGNTIYF	TRBV27	TRBJ1-3
TGTGCCAGCATTCCGGACAGGCGAGATTTTAGCAATCAGCCCCAGCATTTT	CASIPDRRDFSNQPQHF	TRBV7-4	TRBJ1-5
TGTGCCAGCAGCTTAGGGGCATATGAAAAACTGTTTTTT	CASSLGAYEKLFF	TRBV11-2	TRBJ1-4
TGTGCCAGCAGTTCTAGCGGGCTATCTACCTGGAATGAGCAGTTCTTC	CASSSSGLSTWNEQFF	TRBV27	TRBJ2-1
TGTGCCAGCAGTTTAGGGTCGACAGACGTTGCCTACGAGCAGTACTTC	CASSLGSTDVAYEQYF	TRBV12-4	TRBJ2-7
TGTGCCAGCAGCAAAGCCTGCGGGCCCTACGAGCAGTACTTC	CASSKACGPYEQYF	TRBV7-9	TRBJ2-7
TGTGCCACCAGTGACCCGGGACATGAGGAGAATGAAAAACTGTTTTTT	CATSDPGHEENEKLFF	TRBV24-1	TRBJ1-4
TGTGCCAGCAGCTTGGAACCCAAAAGATACTACGAGCAGTACTTC	CASSLEPKRYYEQYF	TRBV5-6	TRBJ2-7
TGTGCCAGCAGAGACAGGGTAAGCAACTCCTACGAGCAGTACTTC	CASRDRVSNSYEQYF	TRBV12-4	TRBJ2-7
TGTGCCAGCAGCCGACAGCGGGGGCACGAGCAGTACTTC	CASSRQRGHEQYF	TRBV7-3	TRBJ2-7
TGTGCCAGCAGCTTAATCCGGGGCGGCCTTCGGCCTGCTGAAGCTTTCTTT	CASSLIRGGLRPAEAFF	TRBV7-9	TRBJ1-1
TGTGCCAGCAGTCGGACCTTCAATCAGCCCCAGCATTTT	CASSRTFNQPQHF	TRBV6-6	TRBJ1-5
TGTGCCAGCAGCTCTAACAGGGTGTACGAGCAGTACTTC	CASSSNRVYEQYF	TRBV7-9	TRBJ2-7
TGTGCCAGTAGTAGGCTGACAGAAGTAACTAATGAAAAACTGTTTTTT	CASSRLTEVTNEKLFF	TRBV19	TRBJ1-4
TGTGCCAGCAGTTACTCGCCCGTACAGGGAGGAACCTCAGATACGCAGTATTTT	CASSYSPVQGGTSDTQYF	TRBV6-5	TRBJ2-3
TGCGCCAGCAGCTTGGATTCCGGGACTAGCGGGGAAAGCGAGCAGTACTTC	CASSLDSGTSGESEQYF	TRBV5-1	TRBJ2-7
TGTGCCAGCAGCGTAGGTGTAGCGGGCACTTTCGAGCAGTACTTC	CASSVGVAGTFEQYF	TRBV9	TRBJ2-7
TGTGCCACCCCCTCGCCGGCGGGAGGGAAAGAGACCCAGTACTTC	CATPSPAGGKETQYF	TRBV24-1	TRBJ2-5
TGTGCCAGCCACCCAGGAGGGACGAATGACTGTGAGACCCAGTACTTC	CASHPGGTNDCETQYF	TRBV7-9	TRBJ2-5
TGTGCCTGGAGACCCGGGGGCGATGAGCAGTTCTTC	CAWRPGGDEQFF	TRBV30	TRBJ2-1
TGTGCCAGCAGCCACCGCCCCTTAGGGAAATGGGGTAATGAGCAGTTCTTC	CASSHRPLGKWGNEQFF	TRBV7-9	TRBJ2-1
TGTGCCAGCAGCCCTAAACCCCGGGGGGGCTACGAGCAGTACTTC	CASSPKPRGGYEQYF	TRBV3-1	TRBJ2-7
TGTGCCAGCAGCCTTACAGGGAACAGGTGGTGGAATCAGCCCCAGCATTTT	CASSLTGNRWWNQPQHF	TRBV13	TRBJ1-5
TGTGCCAGCAGGCAATATCAGGGGTTGACCTACGAGCAGTACTTC	CASRQYQGLTYEQYF	TRBV6-5	TRBJ2-7
TGTGCCACGACGGGACAGAGGGGGAACACTGAAGCTTTCTTT	CATTGQRGNTEAFF	TRBV24-1	TRBJ1-1
TGTGCCAGTAGTATAGCTTCCACTAGCGGGGGGCGGGCGACGGTCGACGAGCAGTACTTC	CASSIASTSGGRATVDEQYF	TRBV19	TRBJ2-7
TGTGCCAGCAGTCCCCAGGCGACAGGGGATGAAGCTTTCTTT	CASSPQATGDEAFF	TRBV28	TRBJ1-1
TGTGCCAGCAGTAAACTATCAAAAGGGGACTGTCGTAACACCATATATTTT	CASSKLSKGDCRNTIYF	TRBV11-2	TRBJ1-3
TGTGCCACCAGTGATGGGGTGAAGGCTTTCTTT	CATSDGVKAFF	TRBV24-1	TRBJ1-1
TGTGCCACGTTCAGGGGGAGCCCTGAAGATGGGGAGCTGTTTTTT	CATFRGSPEDGELFF	TRBV6-2	TRBJ2-2
TGTGCCAGCAGCCCTTGGGGTTTCGATGGCTACACCTTC	CASSPWGFDGYTF	TRBV5-6	TRBJ1-2
TGTGCCAGCAGCTCCAGACGTACTAATGAAAAACTGTTTTTT	CASSSRRTNEKLFF	TRBV7-3	TRBJ1-4
TGTGCCAGCAGGTATCGCGGATTCCTACGGGAGACCCAGTACTTC	CASRYRGFLRETQYF	TRBV4-2	TRBJ2-5
TGTGCCAGCAGTGAAGCCGCGAGAGGGCCAAACGTGATGAACACTGAAGCTTTCTTT	CASSEAARGPNVMNTEAFF	TRBV2	TRBJ1-1
TGTGCCTGGAGTGTAAGGCTTACTTTCTTCAGCAATCAGCCCCAGCATTTT	CAWSVRLTFFSNQPQHF	TRBV30	TRBJ1-5
TGTGCTAGCAGCCGTAGGGTCTTCGGAACCTACGAGCAGTACTTC	CASSRRVFGTYEQYF	TRBV7-7	TRBJ2-7
TGTGCCAGCAGCTTAGTGCCCCGAGCAGAAGATACGCAGTATTTT	CASSLVPRAEDTQYF	TRBV7-4	TRBJ2-3
TGTGCCAGCAGTGAGACCGGTCACCCCAGGGCCTATGGCTACACCTTC	CASSETGHPRAYGYTF	TRBV6-1	TRBJ1-2
TGTGCCAGTATTCTTCGACAGGGGGCAGGAGAGACCCAGTACTTC	CASILRQGAGETQYF	TRBV19	TRBJ2-5
TGTGCCAGCAGCCAATCACTAGCGGGAGGGGAGGTGGATCAGCCCCAGCATTTT	CASSQSLAGGEVDQPQHF	TRBV14	TRBJ1-5
TGTGCCAGCAGTTACAGGAAAGAGCCTTTTAGCTCCTATAATTCACCCCTCCACTTT	CASSYRKEPFSSYNSPLHF	TRBV6-6	TRBJ1-6
TGTGCCTGGCCCATCCGGCAAAAGACTGTTGAGCATGGGGCCAACGTCCTGACTTTC	CAWPIRQKTVEHGANVLTF	TRBV30	TRBJ2-6
TGTGCCAGCAGTTACTGGGGCCGGATGAACACTGAAGCTTTCTTT	CASSYWGRMNTEAFF	TRBV6-6	TRBJ1-1
TGTGCCAGCCCGGGGGGGAGGGTCACCGGGGAGCTGTTTTTT	CASPGGRVTGELFF	TRBV19	TRBJ2-2
TGTGCCACCGACAGGTCTTGCTACACCTTC	CATDRSCYTF	TRBV19	TRBJ1-2
TGTGCTAGCAGCCTAGGACCAGATACGCAGTATTTT	CASSLGPDTQYF	TRBV7-7	TRBJ2-3
TGTGCCAGCAGCCAGTTTAGATCACGCGGGAGCTCGGCTAACTATGGCTACACCTTC	CASSQFRSRGSSANYGYTF	TRBV14	TRBJ1-2
TGTGCCAGCAGCTCCCTCTTTGAGGATTTCTACGAGCAGTACTTC	CASSSLFEDFYEQYF	TRBV5-5	TRBJ2-7
TGTGCCAGCAGGGAGCGAGGAATAAGGGGAAACACCATATATTTT	CASRERGIRGNTIYF	TRBV6-8	TRBJ1-3
TGTGCCAGCAGTTTATGGACGGACAACGAGCAGTACTTC	CASSLWTDNEQYF	TRBV28	TRBJ2-7
TGTGCCAGTAGACAGGGTAACACTGAAGCTTTCTTT	CASRQGNTEAFF	TRBV7-9	TRBJ1-1
TGCAGTGCCCCATCAACGGGGGGGTATAACACTGAAGCTTTCTTT	CSAPSTGGYNTEAFF	TRBV20-1	TRBJ1-1
TGCGCCAGCAGCTTGGAGGTTGGTCCCCACAGGGGTTGGGGAGTTGATGGCTACACCTTC	CASSLEVGPHRGWGVDGYTF	TRBV5-1	TRBJ1-2
TGTGCCACCAGTGATTTAATACAGCGCGGCTACACCTTC	CATSDLIQRGYTF	TRBV24-1	TRBJ1-2
TGTGCCACCAGCACAACCGGGATTGATACGCAGTATTTT	CATSTTGIDTQYF	TRBV15	TRBJ2-3
TGTGCCCCCCCCCAGGAATCGGACAGGGGGCGTTCACCCCTCCACTTT	CAPPQESDRGRSPLHF	TRBV12-4	TRBJ1-6
TGTGCTAGTGGAGGTCAGACAGGGCGCCTCACTGAAGCTTTCTTT	CASGGQTGRLTEAFF	TRBV12-5	TRBJ1-1
TGTGCCAGCAGCGCCCCTCGGGACAATGAGCAGTTCTTC	CASSAPRDNEQFF	TRBV7-3	TRBJ2-1
TGTGCCAGCCTCCAAGGACAGGGAGCGGGGGTCAAAAACGGCTACACCTTC	CASLQGQGAGVKNGYTF	TRBV12-3	TRBJ1-2
TGTGCCAGCAGTGCTTGGGGGGGCACAGATACGCAGTATTTT	CASSAWGGTDTQYF	TRBV25-1	TRBJ2-3
TGTGCCAGCAGTGAAGTTACAGGCCGGGACAGGTTCAATCAGCCCCAGCATTTT	CASSEVTGRDRFNQPQHF	TRBV6-1	TRBJ1-5
TGTGCCAGCAGTCAAAATGACAGGAGGAACACTGAAGCTTTCTTT	CASSQNDRRNTEAFF	TRBV7-9	TRBJ1-1
TGTGCCAGTATCAGACAGGGGGCTCGCACAGATACGCAGTATTTT	CASIRQGARTDTQYF	TRBV19	TRBJ2-3
TGCAGTGCTAGGCGGACAGGGTTCACCGGGGAGCTGTTTTTT	CSARRTGFTGELFF	TRBV20-1	TRBJ2-2
TGTGCCAGCAGCCCTAAGGGGGTCAATGAAAAACTGTTTTTT	CASSPKGVNEKLFF	TRBV4-2	TRBJ1-4
TGTGCCAGCAGTTACTCACCCTGCGGGAGGGGGTATGGCTACACCTTC	CASSYSPCGRGYGYTF	TRBV6-5	TRBJ1-2
TGTGCCAGTAGTATGACCCCCCCGGACGGGAACACTGAAGCTTTCTTT	CASSMTPPDGNTEAFF	TRBV19	TRBJ1-1
TGTGCCAGCAGCTTCGATGGGGGCGGGGACGAGCAGTACTTC	CASSFDGGGDEQYF	TRBV7-6	TRBJ2-7
TGCGCCAGCAGCTTGGCGTGTTTCTGGCTGATTGTGAACACCGGGGAGCTGTTTTTT	CASSLACFWLIVNTGELFF	TRBV5-1	TRBJ2-2
TGTGCCAGCAGCAAGTTTGGGGGCCAAGAGACCCAGTACTTC	CASSKFGGQETQYF	TRBV5-6	TRBJ2-5
TGTGCCAGCAGCGTACCACAGAGTTCTCCTGAAGCTTTCTTT	CASSVPQSSPEAFF	TRBV9	TRBJ1-1
TGTGCCAGCGAGTCTAGCGGCTGCACAGATACGCAGTATTTT	CASESSGCTDTQYF	TRBV6-5	TRBJ2-3
TGCAGTGCCCTCTTACACTACGAGCAGTACTTC	CSALLHYEQYF	TRBV20-1	TRBJ2-7
TGTGCCAGCAGTTACGGGGGGTCCACAGATACGCAGTATTTT	CASSYGGSTDTQYF	TRBV6-3	TRBJ2-3
TGTGCCAGCAGTGTGGGGGGGGCTTCCCAAGAGACCCAGTACTTC	CASSVGGASQETQYF	TRBV6-5	TRBJ2-5
TGTGCCACCGAGCAGAATGGGTGTTACAATGAGCAGTTCTTC	CATEQNGCYNEQFF	TRBV15	TRBJ2-1
TGTGCCAGCAGCCCTGTCGGGCACTCTGGAAACACCATATATTTT	CASSPVGHSGNTIYF	TRBV7-3	TRBJ1-3
TGCGCCAGCAGCGCCGAACTAGCGGGCCAAGGGTGGCAGTATTTT	CASSAELAGQGWQYF	TRBV5-1	TRBJ2-3
TGTGCCAGCAGCAAAAGTTCCGGACAGGGGAACACTGAAGCTTTCTTT	CASSKSSGQGNTEAFF	TRBV6-3	TRBJ1-1
TGTGCTCCTTTCTCCCGGGACGGGAAGGGCTATGGCTACACCTTC	CAPFSRDGKGYGYTF	TRBV30	TRBJ1-2
TGTGCCAGCAGCTTAGACCATCCCAGGGGAGCCGGGGAAGCTTTCTTT	CASSLDHPRGAGEAFF	TRBV7-9	TRBJ1-1
TGCAGTGTGGGACTAGCGGGTAACACCGGGGAGCTGTTTTTT	CSVGLAGNTGELFF	TRBV20-1	TRBJ2-2
TGTGCCAGCAGCCTCGACAGGGCCTACGAGCAGTACTTC	CASSLDRAYEQYF	TRBV7-8	TRBJ2-7
TGTGCCACCCAGATAGACGAATTTTTTGAGCAGTTCTTC	CATQIDEFFEQFF	TRBV24-1	TRBJ2-1
TGTGCCTGGAGTGTCTGGGGTACCCCGGAAACTGAAGCTTTCTTT	CAWSVWGTPETEAFF	TRBV30	TRBJ1-1
TGTGCCAGCAGCTCCGGGACAGGGGCCTCTCCTGTTCACACTGAAGCTTTCTTT	CASSSGTGASPVHTEAFF	TRBV5-4	TRBJ1-1
TGCGCTAGGTGGAGTTACGAGCAGTACTTC	CARWSYEQYF	TRBV10-2	TRBJ2-7
TGTGCCAGCAGTGAAGCGCCGAGAGGGTCGACTAGCGGGAGAATAAACATTCAGTACTTC	CASSEAPRGSTSGRINIQYF	TRBV6-1	TRBJ2-4
TGTGCCAGCAGCTTAGATAAGTCACCCTACAATGAGCAGTTCTTC	CASSLDKSPYNEQFF	TRBV11-2	TRBJ2-1
TGTGCCAGCAGTATATCGACTGAGCAGTACTTC	CASSISTEQYF	TRBV27	TRBJ2-7
TGTGCCAGCAGTTACAACCTCACGACAGGGGGGAGGGGGATAGCTGGGGCCAACGTCCTGACTTTC	CASSYNLTTGGRGIAGANVLTF	TRBV6-5	TRBJ2-6
TGTGCCAGCAGCGTCTGGACCGGGGGCACAGATACGCAGTATTTT	CASSVWTGGTDTQYF	TRBV9	TRBJ2-3
TGTGCCACCAGTGTCCGGGGGACAGCGCCTAATGAGCAGTTCTTC	CATSVRGTAPNEQFF	TRBV24-1	TRBJ2-1
TGCGCCAGCAGCAAAGGAGGATCCACACTCCTCTCTGGAAACACCATATATTTT	CASSKGGSTLLSGNTIYF	TRBV5-1	TRBJ1-3
TGTGCCAGCAGCCCCTCGGGAACCCGGGGGCCCTCTGGAAACACCATATATTTT	CASSPSGTRGPSGNTIYF	TRBV7-4	TRBJ1-3
TGTGCCTCATCCAGCCGGGATAGCAATCAGCCCCAGCATTTT	CASSSRDSNQPQHF	TRBV6-5	TRBJ1-5
TGCAGCGGGACGAATCAGCCCCAGCATTTT	CSGTNQPQHF	TRBV29-1	TRBJ1-5
TGCGCCAGCAGCATTCAACTCGCCAGGACAGCAGATACGCAGTATTTT	CASSIQLARTADTQYF	TRBV5-1	TRBJ2-3
TGTGCCAGCAGCCGAGTTCCGGACAGGGGGCCCTACGAGCAGTACTTC	CASSRVPDRGPYEQYF	TRBV7-4	TRBJ2-7
TGTGCCAGCAGCTCGGGACAGCTCTTC	CASSSGQLF	TRBV9	TRBJ2-1
TGTGCCAGCAGCTTAGGGGGACATTCACCCCTCCACTTT	CASSLGGHSPLHF	TRBV7-6	TRBJ1-6
TGTGCCAGCACCACTTACGAGCAGTACTTC	CASTTYEQYF	TRBV5-5	TRBJ2-7
TGTGCCAGCAGAAGACAGGGTGCCGTGATTAGAAGCAATCAGCCCCAGCATTTT	CASRRQGAVIRSNQPQHF	TRBV6-5	TRBJ1-5
TGCGCCAGCGGGGGGGGTAGAAATGAGCAGTTCTTC	CASGGGRNEQFF	TRBV10-1	TRBJ2-1
TGCAGTGCTTTCCCCTCTAGCGGGAACATCTTC	CSAFPSSGNIF	TRBV20-1	TRBJ2-1
TGTGCCAGCAGCATAGCCCCGGGACAAAGGTTGCAGCCCCAGCATTTT	CASSIAPGQRLQPQHF	TRBV7-9	TRBJ1-5
TGTGCCTGGAGTGTAGTACGGGACAGGCTGCCAGACTACGAGCAGTACTTC	CAWSVVRDRLPDYEQYF	TRBV30	TRBJ2-7
TGTGCCACGCGTCTAGCGGGCCCATTCTGGAGTATAGATACGCAGTATTTT	CATRLAGPFWSIDTQYF	TRBV11-3	TRBJ2-3
TGTGCCAGCAGCTTGGTTTGGACAGATGAAAAACTGTTTTTT	CASSLVWTDEKLFF	TRBV5-6	TRBJ1-4
TGTGCCTGGAGTGTCGCAGGTCCCGGGGAGCTGTTTTTT	CAWSVAGPGELFF	TRBV30	TRBJ2-2
TGTGCCAGCAGCTTGGGACGACCAGGGGCCGGGAACACTGAAGCTTTCTTT	CASSLGRPGAGNTEAFF	TRBV5-4	TRBJ1-1
TGTGCCACCAGCAGTAAGACACTGGAGACCCAGTACTTC	CATSSKTLETQYF	TRBV15	TRBJ2-5
TGTGCCACCTACCAGGTTCACAATGAGCAGTTCTTC	CATYQVHNEQFF	TRBV24-1	TRBJ2-1
TGTGCCAGCTCCCCAAGCGGGAGGGACCGGCCTAGGGGAATCAATCAGCCCCAGCATTTT	CASSPSGRDRPRGINQPQHF	TRBV18	TRBJ1-5
TGTGCCAGCAGCGGACGGGGGCGTATAGAGACCCAGTACTTC	CASSGRGRIETQYF	TRBV7-3	TRBJ2-5
TGCAGCGGTGGGCTCAGGGACAGGGCGTTGGATCAGCCCCAGCATTTT	CSGGLRDRALDQPQHF	TRBV29-1	TRBJ1-5
TGTGCCAGCATTGGGACTAGCGGGATCACAGATACGCAGTATTTT	CASIGTSGITDTQYF	TRBV11-3	TRBJ2-3
TGTGCCAGCAGCAAACAGGGTGGGAACACCGGGGAGCTGTTTTTT	CASSKQGGNTGELFF	TRBV9	TRBJ2-2
TGTGCCAGCAGTGCCCGGGACCTTCGGAATGTCCAGGGCCGTAAAGAGACCCAGTACTTC	CASSARDLRNVQGRKETQYF	TRBV27	TRBJ2-5
TGTGCCAGCAGCGGAACTAGCGGGAGAGATACGCAGTATTTT	CASSGTSGRDTQYF	TRBV5-5	TRBJ2-3
TGTGCCAGCAGTGCTCCCTACTTTAGGAGCTCCTACAATGAGCAGTTCTTC	CASSAPYFRSSYNEQFF	TRBV6-4	TRBJ2-1
TGTGCCAGCCTTAGTACGGCCTACGAGCAGTACTTC	CASLSTAYEQYF	TRBV6-4	TRBJ2-7
TGTGCCGTCCCCGCAGGGACTAGCGGCTCCAAGAACAATGAGCAGTTCTTC	CAVPAGTSGSKNNEQFF	TRBV6-1	TRBJ2-1
TGTGCCAGCAGCTTACGGCGGCCGGCAGAGACCCAGTACTTC	CASSLRRPAETQYF	TRBV7-9	TRBJ2-5
TGTGCCAGCAGTGGTCACAGGGGGCAGATGGACTCTGGAAACACCATATATTTT	CASSGHRGQMDSGNTIYF	TRBV2	TRBJ1-3
TGTGCCAGCAGCGATGAACCGGGGGGGAGCGGGGAGCTGTTTTTT	CASSDEPGGSGELFF	TRBV9	TRBJ2-2
TGTGCCATCAGTGAGTCCCCTAGAGTCCAAGAGACCCAGTACTTC	CAISESPRVQETQYF	TRBV10-3	TRBJ2-5
TGTGCCAGCAGCGGGGGGGGGGGGGCGCAGTATTTT	CASSGGGGAQYF	TRBV13	TRBJ2-3
TGTGCCACCAGCAGAGAATTTTTCGGCTTATCCAAGACCCAGTACTTC	CATSREFFGLSKTQYF	TRBV15	TRBJ2-5
TGTGCCTGGCTCATACCAGACCGGGACGGCAATGAGCAGTTCTTC	CAWLIPDRDGNEQFF	TRBV30	TRBJ2-1
TGTGCCAGCAGCCACCGGGACGTGGGCGCAGATACGCAGTATTTT	CASSHRDVGADTQYF	TRBV13	TRBJ2-3
TGTGCCAGCAGGACGACCAGGGGGGATACTAATGAAAAACTGTTTTTT	CASRTTRGDTNEKLFF	TRBV12-4	TRBJ1-4
