TGTGCCACCAGTGTTTCGATCTATGAGAACACTGAAGCTTTCTTT	CATSVSIYENTEAFF	TRBV24-1	TRBJ1-1
TGTGCCAGCAGTCCTAGGGTTATCCCAGATACGCAGTATTTT	CASSPRVIPDTQYF	TRBV13	TRBJ2-3
TGTGCCAGCAGCTTAGCCGCCGTTCGACAGGGCAAAAACATTCAGTACTTC	CASSLAAVRQGKNIQYF	TRBV11-2	TRBJ2-4
TGCGCCAGCACAGGGGTGATCTCCTACGAGCAGTACTTC	CASTGVISYEQYF	TRBV10-1	TRBJ2-7
TGTGCCAGCAGCTCACCGGGACAGGGAAGGGGCACTAACTATGGCTACACCTTC	CASSSPGQGRGTNYGYTF	TRBV7-2	TRBJ1-2
TGCAGTGCTCTGAGGGTGGGTTTCACCCGCAATCAGCCCCAGCATTTT	CSALRVGFTRNQPQHF	TRBV20-1	TRBJ1-5
TGCAGTGATATCATAGCGGGGAACTACGAGCAGTACTTC	CSDIIAGNYEQYF	TRBV20-1	TRBJ2-7
TGTGCCAGCAGTGATCCGAGGGAGGGGTCACAGGGGTTCTATGGCTACACCTTC	CASSDPREGSQGFYGYTF	TRBV6-1	TRBJ1-2
TGTGCCACCAGGTCGGGCGGGTGGGAAAAACTGTTTTTT	CATRSGGWEKLFF	TRBV24-1	TRBJ1-4
TGTGCCACCCGGACTAGCGGAGAGACCCAGTACTTC	CATRTSGETQYF	TRBV19	TRBJ2-5
TGTGCCAGCAGTGAATTAGGGGGTCCACGAGACACTGAAGCTTTCTTT	CASSELGGPRDTEAFF	TRBV25-1	TRBJ1-1
TGTGCCAGCAGCTGCCTCCTTCCATCTACAGGCAACACTGAAGCTTTCTTT	CASSCLLPSTGNTEAFF	TRBV7-8	TRBJ1-1
TGCAGTGAAAGGCGGGGCACAGATACGCAGTATTTT	CSERRGTDTQYF	TRBV20-1	TRBJ2-3
TGTGCCAGCAGATCGGGGGAAGCTTCAGATACGCAGTATTTT	CASRSGEASDTQYF	TRBV27	TRBJ2-3
TGTGCCATGCCGGGATCAGGGGTCGCTTTCTTT	CAMPGSGVAFF	TRBV10-3	TRBJ1-1
TGCAGCGTTGCCCCCGGGGGTTGGTCTTCTGAGCAGTTCTTC	CSVAPGGWSSEQFF	TRBV29-1	TRBJ2-1
TGCGCCAGTACCGGGACTAGCGGGGGGGCGATCTACGAGCAGTACTTC	CASTGTSGGAIYEQYF	TRBV10-1	TRBJ2-7
TGTGCCAGCAGCTTGACGGGGATGGAAAAACTGTTTTTT	CASSLTGMEKLFF	TRBV7-4	TRBJ1-4
TGTGCCAGCATACTAGTCCGAACCGGGGAGCTGTTTTTT	CASILVRTGELFF	TRBV27	TRBJ2-2
TGCGCCAACGGCGGGACACCTACCGAAGAGACCCAGTACTTC	CANGGTPTEETQYF	TRBV10-2	TRBJ2-5
TGTGCCAGCAGTGGACAAGGGACAGGGGCAGTCGATCAGCCCCAGCATTTT	CASSGQGTGAVDQPQHF	TRBV6-4	TRBJ1-5
TGTGCCACCCGGGGCCGCGGGACAGGGTTAAAACTGTTTTTT	CATRGRGTGLKLFF	TRBV24-1	TRBJ1-4
TGTGCGGGGGGGGGGGAGACCCAGTACTTC	CAGGGETQYF	TRBV29-1	TRBJ2-5
TGTGCCAGCAGCTCCGTTTTGGGACTAGGTGACGGCCATGAGCAGTTCTTC	CASSSVLGLGDGHEQFF	TRBV13	TRBJ2-1
TGCGCCAGCAGCTTGGAACGGCGAAGTCATGACACTGAAGCTTTCTTT	CASSLERRSHDTEAFF	TRBV5-1	TRBJ1-1
TGTGCCTGGAGTCCCTATGGAGTCTCTTCGGACAGGGGCTCTGGGGCCAACGTCCTGACTTTC	CAWSPYGVSSDRGSGANVLTF	TRBV30	TRBJ2-6
TGTGCCAGCAGCTGGGGACAGGGCTTAATTAATGAAAAACTGTTTTTT	CASSWGQGLINEKLFF	TRBV7-9	TRBJ1-4
TGTGCCAGGGCACTAGCGGGCATAGAGACCCAGTACTTC	CARALAGIETQYF	TRBV28	TRBJ2-5
TGTGCCACCCAGGACTACGAGCAGTACTTC	CATQDYEQYF	TRBV15	TRBJ2-7
TGTGCCAGCACTGGCGCGGATCAGCCCCAGCATTTT	CASTGADQPQHF	TRBV5-4	TRBJ1-5
TGTGCCAGCAGCTCTGACCGGGGGCCGAGAAGGGCCAGAGGCACGAACACTGAAGCTTTCTTT	CASSSDRGPRRARGTNTEAFF	TRBV5-6	TRBJ1-1
TGTGCCTCCGGGCAGAACACTGAAGCTTTCTTT	CASGQNTEAFF	TRBV2	TRBJ1-1
TGTGCCAGCCTGGCACGCGGGAGCCGGGAGCAGTTCTTC	CASLARGSREQFF	TRBV2	TRBJ2-1
TGCGCCAGCAGCCAAGAACTAGCGGGCTTCTACAATGAGCAGTTCTTC	CASSQELAGFYNEQFF	TRBV4-1	TRBJ2-1
TGCGCCAGCAGCGGACAGGGGGCTGTTCCCACCGGGGAGCTGTTTTTT	CASSGQGAVPTGELFF	TRBV5-1	TRBJ2-2
TGTGCCAGCAGCTCCTTCGGCGGTATGACGGAGCCCCAGCATTTT	CASSSFGGMTEPQHF	TRBV7-3	TRBJ1-5
TGTGCCATCCTCGGGGCGGGAGCTAATGAAAAACTGTTTTTT	CAILGAGANEKLFF	TRBV10-3	TRBJ1-4
TGTGCTAGTGGTTTGAGCGGGAGGGCCTACGAGCAGTACTTC	CASGLSGRAYEQYF	TRBV12-5	TRBJ2-7
TGTGCCTGGAGCCAGAGTACCTACAATGAGCAGTTCTTC	CAWSQSTYNEQFF	TRBV30	TRBJ2-1
TGTGCCAGTAGTAGGGCATCTCCCTACGAGCAGTACTTC	CASSRASPYEQYF	TRBV19	TRBJ2-7
TGTGGCGTTCGGGACAGGGTACAGCCCCAGCATTTT	CGVRDRVQPQHF	TRBV9	TRBJ1-5
TGCGCCAGCAGCTTGGGGGCTTGGGACAGGGAGCATGGCTACACCTTC	CASSLGAWDREHGYTF	TRBV5-1	TRBJ1-2
TGTGCCAGCAGCCACCCTCCCTTAACTAGCGAACGGGCCGGGGAGCTGTTTTTT	CASSHPPLTSERAGELFF	TRBV3-1	TRBJ2-2
TGTGCCAGCAGCCAAGCATCTTTTTTGGGACAGGGACGGGAGCCCATCCCTATACACGAGCAGTACTTC	CASSQASFLGQGREPIPIHEQYF	TRBV3-1	TRBJ2-7
TGTGCCACGCGGACAAATGAGCAGTTCTTC	CATRTNEQFF	TRBV24-1	TRBJ2-1
TGTGCCAGCAGCCAAGAGTCAGGGGGCGCGGAGACCCAGTACTTC	CASSQESGGAETQYF	TRBV3-1	TRBJ2-5
TGTGCCAGCAGCCCGGGGTCCAGTACCTACGAGCAGTACTTC	CASSPGSSTYEQYF	TRBV9	TRBJ2-7
TGCGCCAGCAGCCAAGTATCAGGGAGTGGTGAAAAACTGTTTTTT	CASSQVSGSGEKLFF	TRBV4-1	TRBJ1-4
TGTGCCAGCAGCCGTTCTAGCGGGATCTCGGCAGATACGCAGTATTTT	CASSRSSGISADTQYF	TRBV5-4	TRBJ2-3
TGTGCCAGCAGCTTAGGTTACATAGCGGGCGCCGAGCAGTTCTTC	CASSLGYIAGAEQFF	TRBV7-9	TRBJ2-1
TGTGCCAGCAGTGCCCAGGGCGGGCATGAGCAGTTCTTC	CASSAQGGHEQFF	TRBV25-1	TRBJ2-1
TGTGCCAGCAGCTTAAACTATCAGCCCCAGCATTTT	CASSLNYQPQHF	TRBV5-4	TRBJ1-5
TGTGCCAGCACCGACAGGGTGGGACAAAAGACGCAGTATTTT	CASTDRVGQKTQYF	TRBV6-4	TRBJ2-3
TGTGCCTGGACTCTAGGAGGGGGGGCCAGGCTAGAGCAGTTCTTC	CAWTLGGGARLEQFF	TRBV30	TRBJ2-1
TGCAGTGCTAGAGTTCGAATCTACATCGTAGCTTTCTTT	CSARVRIYIVAFF	TRBV20-1	TRBJ1-1
TGTGCCGGGGGAGTCTTTAACACCATATATTTT	CAGGVFNTIYF	TRBV19	TRBJ1-3
TGTGCCAGCAGCCGCGGGACAGAACGTGAGTACTTC	CASSRGTEREYF	TRBV13	TRBJ2-7
TGTGCCAGCAGAATCCGGGTACGAGCTTTCTTT	CASRIRVRAFF	TRBV27	TRBJ1-1
TGCGCCAGCAGTGAGGGGGACAGGAATCAGCCCCAGCATTTT	CASSEGDRNQPQHF	TRBV10-1	TRBJ1-5
TGCGCCAGCAGCTTGGCCCCTGGGACCTGGGGCGAGCAGTACTTC	CASSLAPGTWGEQYF	TRBV5-1	TRBJ2-7
TGCAGTGCTAGATTCAAATCCGTAGGGGGTCAGCCCCAGCATTTT	CSARFKSVGGQPQHF	TRBV20-1	TRBJ1-5
TGTGCCAGCAGCTCTAAGGGCCAAATGCAGGTAGTGGGGTTGAACACTGAAGCTTTCTTT	CASSSKGQMQVVGLNTEAFF	TRBV7-4	TRBJ1-1
TGTGCCAGCAGCCAAGATCCGGGGACCATCAGCTCCTACGAGCAGTACTTC	CASSQDPGTISSYEQYF	TRBV3-1	TRBJ2-7
TGTGCTAGTGGTTTGGTACTGCCAGCCAGGGGGGCCAACGTCCTGACTTTC	CASGLVLPARGANVLTF	TRBV12-5	TRBJ2-6
TGTGCCAGCAGCAAGAAACGGGACAACCACTATGGCTACACCTTC	CASSKKRDNHYGYTF	TRBV9	TRBJ1-2
TGTGCCAGCAGCCTAGGAGGGCAGGGTGAGCAGTTCTTC	CASSLGGQGEQFF	TRBV14	TRBJ2-1
TGTGCCAGCAGCTTAGAAGGACAGGTCTTGGAGGGGGGAAATCAGCCCCAGCATTTT	CASSLEGQVLEGGNQPQHF	TRBV7-6	TRBJ1-5
TGCAGCGTTCCGGGCCTTACCTACGAGCAGTACTTC	CSVPGLTYEQYF	TRBV29-1	TRBJ2-7
TGTGCCATGGTCAGCCGGGGGGAGGGCAATCAGCCCCAGCATTTT	CAMVSRGEGNQPQHF	TRBV10-3	TRBJ1-5
TGTGCCAGCAGTTGCGGATCTAGCGGGATCACAGATACGCAGTATTTT	CASSCGSSGITDTQYF	TRBV12-3	TRBJ2-3
TGTGCCAGCAGCTTGCATCAAGGGGGCGGGTGCTATAATTCACCCCTCCACTTT	CASSLHQGGGCYNSPLHF	TRBV7-7	TRBJ1-6
TGTGCCAGCAGCACCGGGGGGGAGGGTAGGATCATGGCTTCCACTGAAGCTTTCTTT	CASSTGGEGRIMASTEAFF	TRBV5-4	TRBJ1-1
TGTGCCAGCAGTGAAGGGACTAGCGGGCGAGATGAGCAGTTCTTC	CASSEGTSGRDEQFF	TRBV6-1	TRBJ2-1
TGTGCCAGCAGCCTCCGCCGGGACATTTCAACGAACACTGAAGCTTTCTTT	CASSLRRDISTNTEAFF	TRBV13	TRBJ1-1
TGTGCCAGCATCGTGCAGCAGGGATGGGGGTATAGCAATCAGCCCCAGCATTTT	CASIVQQGWGYSNQPQHF	TRBV27	TRBJ1-5
TGTGCCACCAGCAGACGTATAGCATTGGTTATTGTAGGTGCCTACGAGCAGTACTTC	CATSRRIALVIVGAYEQYF	TRBV15	TRBJ2-7
TGTGCCAGCTCACCACCCGCGCGGGGGTCTGAGCAGTACTTC	CASSPPARGSEQYF	TRBV18	TRBJ2-7
TGTGCCAGCAGCTCTCCGGCGACTGAGCAGTTCTTC	CASSSPATEQFF	TRBV11-2	TRBJ2-1
TGTGCCAGTAGTAGGTCCTCGATCAGTAACTATGGCTACACCTTC	CASSRSSISNYGYTF	TRBV19	TRBJ1-2
TGTGCCAGCAGCGGGGGGGCAAAAACGCAGTATTTT	CASSGGAKTQYF	TRBV7-3	TRBJ2-3
TGCAGTGCTAGAGATCCTGGACCCGGGCGTTTAGACTATGGCTACACCTTC	CSARDPGPGRLDYGYTF	TRBV20-1	TRBJ1-2
TGCAGTGCTGCTAGGGAGAATGAAAAACTGTTTTTT	CSAARENEKLFF	TRBV20-1	TRBJ1-4
TGCGCCAGCAGCCTATACTGTCCCAGGGCTTACAATGAGCAGTTCTTC	CASSLYCPRAYNEQFF	TRBV5-1	TRBJ2-1
TGTGCCAGCTCACCAGTGGGTCGCAAGTCTGGGGCCAACGTCCTGACTTTC	CASSPVGRKSGANVLTF	TRBV18	TRBJ2-6
TGTGCCAGCAGTGCGGGGGGACTGGGCCAAGATACGCAGTATTTT	CASSAGGLGQDTQYF	TRBV2	TRBJ2-3
TGTGATACTTACAGGGAAGGGGGTAATTCACCCCTCCACTTT	CDTYREGGNSPLHF	TRBV4-2	TRBJ1-6
TGCAGTGCTGTCCGTAGGGGGGCGAGTGAGCAGTTCTTC	CSAVRRGASEQFF	TRBV20-1	TRBJ2-1
TGTGCCAGCAGCAGTCGGGGTAGTTTCACCGGGGAGCTGTTTTTT	CASSSRGSFTGELFF	TRBV7-3	TRBJ2-2
TGTGCCAGCAGTGCGCTCCGGGACAGGGGAGGGAGCTCCTATAATTCACCCCTCCACTTT	CASSALRDRGGSSYNSPLHF	TRBV28	TRBJ1-6
TGTGCCAGCAGTCCTCTCAGGCTGACAACTAATGAAAAACTGTTTTTT	CASSPLRLTTNEKLFF	TRBV6-6	TRBJ1-4
TGTGCCAGCAGTCCGGCCGGGACAGGGGGCAATCAGCCCCAGCATTTT	CASSPAGTGGNQPQHF	TRBV6-3	TRBJ1-5
TGCGCCTTTGCGGCCAGGGTTAAAGGAAACACCATATATTTT	CAFAARVKGNTIYF	TRBV10-1	TRBJ1-3
TGCGCCAGCAGCCAAGACTTCCACGAGAGGATAGGCTACGAGCAGTACTTC	CASSQDFHERIGYEQYF	TRBV4-1	TRBJ2-7
TGTGCCAGCAGCTCCCCGGGTAATTACAATGAGCAGTTCTTC	CASSSPGNYNEQFF	TRBV7-6	TRBJ2-1
TGCGCCAGCAGCTTGAGCCTCTTCGGGGGGGGACGTAGGCAAGAGACCCAGTACTTC	CASSLSLFGGGRRQETQYF	TRBV5-1	TRBJ2-5
TGCGCCCCCGAGTCGCGAAATTCACCCCTCCACTTT	CAPESRNSPLHF	TRBV5-1	TRBJ1-6
TGTGCCAGCAGCCCGTGGGGAGATACGCAGTATTTT	CASSPWGDTQYF	TRBV11-3	TRBJ2-3
TGTGCCAGCACTCCCTGCCTGGGCGGAAGGGGCTCCTATAATTCACCCCTCCACTTT	CASTPCLGGRGSYNSPLHF	TRBV6-2	TRBJ1-6
TGTGCCAGCAGCACCGCAGGGGCGTCCTACGAGCAGTACTTC	CASSTAGASYEQYF	TRBV7-2	TRBJ2-7
TGCGCCAGCAGCCAGGCAACTGCCTACTGGTCCCCGCAGGGTCGCGGAAACACCATATATTTT	CASSQATAYWSPQGRGNTIYF	TRBV4-3	TRBJ1-3
TGTGCCACCACAACCGGGGCCGACGAGCAGTACTTC	CATTTGADEQYF	TRBV24-1	TRBJ2-7
TGTGCCAGCAGCTTAGAAGCCACAGGGGGAGGTTCGCCCAATCAGCCCCAGCATTTT	CASSLEATGGGSPNQPQHF	TRBV7-4	TRBJ1-5
TGTGCCAGCAGCCACGAGGGGGGCTCCTATAATTCACCCCTCCACTTT	CASSHEGGSYNSPLHF	TRBV14	TRBJ1-6
TGTGCCAGCAGTGAAGGGAAAGGAGCGGGAAGTAAGCATGAGCAGTTCTTC	CASSEGKGAGSKHEQFF	TRBV6-1	TRBJ2-1
TGTGCCAGCAGCGTGGGAACAGGGGCCTACGAGCAGTACTTC	CASSVGTGAYEQYF	TRBV9	TRBJ2-7
TGTGCCAGCAGCGTAGGCTACGGGACCAACTACGAGCAGTACTTC	CASSVGYGTNYEQYF	TRBV9	TRBJ2-7
TGTGCCACCAGTGAGGGAGGGGGCAGCAATCAGCCCCAGCATTTT	CATSEGGGSNQPQHF	TRBV24-1	TRBJ1-5
TGCAGTGTTCCTCTTCCTACCCGGACAGGATACGAGCAGTACTTC	CSVPLPTRTGYEQYF	TRBV20-1	TRBJ2-7
TGTGCCAGCAGTTACTCGGCCGGGGCAGGGCCTAACTATGGCTACACCTTC	CASSYSAGAGPNYGYTF	TRBV6-5	TRBJ1-2
TGTGCCAGCAGCGGCCCAAACCGGACAGGGGGGGGAGGTAGCTCTGGAAACACCATATATTTT	CASSGPNRTGGGGSSGNTIYF	TRBV13	TRBJ1-3
TGTGCCAGCAGCGTAGAGGGTTCCTACGAGCAGTACTTC	CASSVEGSYEQYF	TRBV9	TRBJ2-7
TGTGCCAGCAGCTTAGGCCCTGGGGACGAATCTGGAAACACCATATATTTT	CASSLGPGDESGNTIYF	TRBV7-2	TRBJ1-3
TGCAGCGTTGCTCTGGGCAGGGAACCGGGAAAAGAGACCCAGTACTTC	CSVALGREPGKETQYF	TRBV29-1	TRBJ2-5
TGTGCCAGCAGTGGGGGACAGGGCGAGCAGTACTTC	CASSGGQGEQYF	TRBV6-4	TRBJ2-7
TGCAGTGCGGGGTACGATGGGAAAGATACGCAGTATTTT	CSAGYDGKDTQYF	TRBV20-1	TRBJ2-3
TGTGACAAACCCCGACAGTTCTCCTACGAGCAGTACTTC	CDKPRQFSYEQYF	TRBV6-2	TRBJ2-7
TGTGCCAGCAGCCAAGCCCGGGGGCTTGGCTACACCTTC	CASSQARGLGYTF	TRBV14	TRBJ1-2
TGTGCCAGCAGACCCGTCAAAGGGGAGGAAGCTTTCTTT	CASRPVKGEEAFF	TRBV7-3	TRBJ1-1
TGTGCCAGCAGCATGGGCAGGGGAGTCCAGTCCTATAATTCACCCCTCCACTTT	CASSMGRGVQSYNSPLHF	TRBV5-4	TRBJ1-6
TGTGCCAAAGATCCAGGGCGGATTTGCACAGATACGCAGTATTTT	CAKDPGRICTDTQYF	TRBV6-2	TRBJ2-3
TGTGCCAGCAGCCCGCGGGGACAACGGGTGTCAGATACGCAGTATTTT	CASSPRGQRVSDTQYF	TRBV5-4	TRBJ2-3
TGCAGTGCTGAGTTATCCCCAGGGGGTCCACCTAGGTGGTGGAGCTCCTATAATTCACCCCTCCACTTT	CSAELSPGGPPRWWSSYNSPLHF	TRBV20-1	TRBJ1-6
TGTGCCAGCAGCGGAGGGCGGGGGAACGCCAACTATGGCTACACCTTC	CASSGGRGNANYGYTF	TRBV13	TRBJ1-2
TGTGCCAGCAGCCAAGATCATTGTCAGGCCGTACCAGGGGGCAGGGGGGGCTCCTACGAGCAGTACTTC	CASSQDHCQAVPGGRGGSYEQYF	TRBV14	TRBJ2-7
TGTGCCAGCAGTGCGGGACTAGCGGGGGAGACCCAGTACTTC	CASSAGLAGETQYF	TRBV6-4	TRBJ2-5
TGTGCCAGCAGCGTAGCCACGGGACAGAACACAGATACGCAGTATTTT	CASSVATGQNTDTQYF	TRBV9	TRBJ2-3
TGTGCCAGCAGCTCCCCGCGGGACAGTCAAAAAAAAGGTGTTGGAAACACCATATATTTT	CASSSPRDSQKKGVGNTIYF	TRBV7-9	TRBJ1-3
TGTGCCAGTAGTTGCCACGCATCACATGAGCAGTTCTTC	CASSCHASHEQFF	TRBV19	TRBJ2-1
TGCAGTGCTAGCCCGGTGGGACGGCGGGCTCAAGAGACCCAGTACTTC	CSASPVGRRAQETQYF	TRBV20-1	TRBJ2-5
TGTGCCAGCAGCGCGACAGGGGGGCCCCTAGAAAAACTGTTTTTT	CASSATGGPLEKLFF	TRBV13	TRBJ1-4
TGCGCCAGCAGTGGGTACCGGGACGTTATGTCGAGAACTGAAGCTTTCTTT	CASSGYRDVMSRTEAFF	TRBV10-1	TRBJ1-1
TGCGCCAGCAGCTTGCATCAAGGACAGGGGCACCACTACGAGCAGTACTTC	CASSLHQGQGHHYEQYF	TRBV5-1	TRBJ2-7
TGTGCCACCAGCAGAGACCAAAAGGGGGTATCAATGAACACCGGGGAGCTGTTTTTT	CATSRDQKGVSMNTGELFF	TRBV15	TRBJ2-2
TGTGCCATCAGTGATCGGGGGGGCAGTTACGAGCAGTACTTC	CAISDRGGSYEQYF	TRBV10-3	TRBJ2-7
TGTGCCAGCAGGGCCTGCCAGGGCAATCAGCCCCAGCATTTT	CASRACQGNQPQHF	TRBV11-2	TRBJ1-5
TGTGCCAGCAGTTACACGCAAGGGGGGGTCCAAGAGACCCAGTACTTC	CASSYTQGGVQETQYF	TRBV6-5	TRBJ2-5
TGTGCCAGTAGCCCAAACGGGAGGGGCTACACCTTC	CASSPNGRGYTF	TRBV19	TRBJ1-2
TGTGCCAGAAAGGGGACAGTGACGAACACCGGGGAGCTGTTTTTT	CARKGTVTNTGELFF	TRBV2	TRBJ2-2
TGTGCCAGCAGCGGAGGGGGGGATGACCCCTGCTACGAGCAGTACTTC	CASSGGGDDPCYEQYF	TRBV9	TRBJ2-7
TGCGCCAGCCGCCCGGGCGTCTCCGGGGAGCTGTTTTTT	CASRPGVSGELFF	TRBV5-1	TRBJ2-2
TGTGCCAGTGGAGAGGGGGCGCCTTTTGAAGCTTTCTTT	CASGEGAPFEAFF	TRBV19	TRBJ1-1
TGTGCCAGCAGCCCCAGGGATCATGGCTACACCTTC	CASSPRDHGYTF	TRBV28	TRBJ1-2
TGTGCCAGCAGCTGGAGGTTGAAACAGGGGACGAACACCGGGGAGCTGTTTTTT	CASSWRLKQGTNTGELFF	TRBV7-6	TRBJ2-2
TGTGCCAGCAGCAGGCCTCTTGGCCAGTACAATGAGCAGTTCTTC	CASSRPLGQYNEQFF	TRBV11-3	TRBJ2-1
TGCGCCAGCAGCTTGGGGTGGGTCCACAGGGGATATAACTATGGCTACACCTTC	CASSLGWVHRGYNYGYTF	TRBV5-1	TRBJ1-2
TGCAGCGTTAAGGGGACGGGGTCCTATGGCTACACCTTC	CSVKGTGSYGYTF	TRBV29-1	TRBJ1-2
TGTGCCAGCAACGGTCCGGGACAGGGCGTCGATGGCTACACCTTC	CASNGPGQGVDGYTF	TRBV12-3	TRBJ1-2
TGCAGTGCTACCCCTGTAGCGGGACAGAGTGGGAACACCGGGGAGCTGTTTTTT	CSATPVAGQSGNTGELFF	TRBV20-1	TRBJ2-2
TGTGCCAGCAGTTACACACGCTCGGCTGACACCTTC	CASSYTRSADTF	TRBV6-3	TRBJ1-2
TGTGCCAGCAGCGTTGTTCGGTTCCCACTGGACTACGAGCAGTACTTC	CASSVVRFPLDYEQYF	TRBV9	TRBJ2-7
TGCGCCAGCAGCCATATTGGCCCCGGGGGTTCTTCCAATGAGCAGTTCTTC	CASSHIGPGGSSNEQFF	TRBV4-1	TRBJ2-1
TGTGCCAGCAAGAAATCGGGACTAGGGAGGAATGAGCAGTTCTTC	CASKKSGLGRNEQFF	TRBV7-9	TRBJ2-1
TGTGCCAGCAGCTTAGATAGGAGGGACAGGGGGGAGATGAACACTGAAGCTTTCTTT	CASSLDRRDRGEMNTEAFF	TRBV11-3	TRBJ1-1
TGCAGTGTGATAGGGGGTCACAGCACAGATACGCAGTATTTT	CSVIGGHSTDTQYF	TRBV20-1	TRBJ2-3
TGTGCCAGCAGCCTCCCATGTAAGGTCAATCAGCCCCAGCATTTT	CASSLPCKVNQPQHF	TRBV13	TRBJ1-5
TGTGCCAGCTCACCATCCCTCTATCCCGGGACAGGCGGGGAGACCCAGTACTTC	CASSPSLYPGTGGETQYF	TRBV18	TRBJ2-5
TGTGCCAGCCTAGGGGCGGAGGCCAACCCCTACGAGCAGTACTTC	CASLGAEANPYEQYF	TRBV28	TRBJ2-7
TGCGCCAGCAGCAAGCTCGGGGGCAATCAGCCCCAGCATTTT	CASSKLGGNQPQHF	TRBV4-1	TRBJ1-5
TGTGCCAGTAGTATTGGGGTATATTGGGGACAGGGGCCTCAGCCCCAGCATTTT	CASSIGVYWGQGPQPQHF	TRBV19	TRBJ1-5
TGTGCCAGCAGTGGCGGGACAGGGGTCTACGAGCAGTACTTC	CASSGGTGVYEQYF	TRBV6-4	TRBJ2-7
TGTGCCAGCAGCAGGGGGGTATGTAACACCGGGGAGCTGTTTTTT	CASSRGVCNTGELFF	TRBV11-1	TRBJ2-2
TGTGCCAGCAGCCCCGGGAAATGCACAGATACGCAGTATTTT	CASSPGKCTDTQYF	TRBV13	TRBJ2-3
TGCCTGCCAGGGGGCTACACCTTC	CLPGGYTF	TRBV5-1	TRBJ1-2
TGTGCCAGCAGCTGTTCAGGGGAACAAGAGACCCAGTACTTC	CASSCSGEQETQYF	TRBV6-5	TRBJ2-5
TGTGCCAGCAGCAGGGGGGGGAGGGGAGACAATGAGCAGTTCTTC	CASSRGGRGDNEQFF	TRBV5-6	TRBJ2-1
TGTGCCTGGAGGGCGTGCCTAGGGACAGGGGAGCCCCAGCATTTT	CAWRACLGTGEPQHF	TRBV30	TRBJ1-5
TGTGCCACCCCTGACACGGGTTGGCCCTATGGCTACACCTTC	CATPDTGWPYGYTF	TRBV6-4	TRBJ1-2
TGTGCCAGCAGCCAAGATCGCGGGGAGCTGTTTTTT	CASSQDRGELFF	TRBV14	TRBJ2-2
TGTGCCAGCCGACTAGCGGGAACCCAGTACTTC	CASRLAGTQYF	TRBV27	TRBJ2-5
TGTGCCAGCAGTTTGCGCCCAGATACGCAGTATTTT	CASSLRPDTQYF	TRBV28	TRBJ2-3
TGTGCCAGCAGCCCCCTAGGTCTGGCGGGATTCAAACGCTACGAGCAGTACTTC	CASSPLGLAGFKRYEQYF	TRBV13	TRBJ2-7
TGTGCCAGCAGCTACGGTATGATAGAATTAACTAGCACAGATACGCAGTATTTT	CASSYGMIELTSTDTQYF	TRBV7-9	TRBJ2-3
TGTGCCTGCGGCCATTCACCCCTCCACTTT	CACGHSPLHF	TRBV28	TRBJ1-6
TGTGCCAGCAGCCAATGGGCTTTGGGGGGCCTTAGGAGCTACGAGCAGTACTTC	CASSQWALGGLRSYEQYF	TRBV3-1	TRBJ2-7
TGTGCCAGGAGTGTCTCCCGTACGGGCTACGAGCAGTACTTC	CARSVSRTGYEQYF	TRBV6-5	TRBJ2-7
TGTGCCACCAGTGGGAATCCCCGGGACAGGTGCAACATTAGAAACACTGAAGCTTTCTTT	CATSGNPRDRCNIRNTEAFF	TRBV24-1	TRBJ1-1
TGCGCCAGCAGCTTGGCATGCCGGGACAGGGAGCTTGCCACGTATCAGCCCCAGCATTTT	CASSLACRDRELATYQPQHF	TRBV5-1	TRBJ1-5
TGTGCCAGCAGTGAAGCGGACCGCAGTGGGCCTCGCACTTCACCCCTCCACTTT	CASSEADRSGPRTSPLHF	TRBV2	TRBJ1-6
TGTGCCAGCAGTGTTGCCAGTCCGGGGACAAAAGGGGAGACCCAGTACTTC	CASSVASPGTKGETQYF	TRBV6-5	TRBJ2-5
TGTGCTAGTGGTTTGGTAGTATGGAGGGGTTTCAATCAGCCCCAGCATTTT	CASGLVVWRGFNQPQHF	TRBV12-5	TRBJ1-5
TGTGCCAGCAGCTTCCTCCGGAGGGGGGGAAGGGGCTACGAGCAGTACTTC	CASSFLRRGGRGYEQYF	TRBV11-3	TRBJ2-7
TGTGCCAGCAGCTTAGTTGGACAGGGTCCAGGTCCGAACACTGAAGCTTTCTTT	CASSLVGQGPGPNTEAFF	TRBV7-9	TRBJ1-1
TGTGCCAACGGGGGCGCGGGGGCCTACGAGCAGTACTTC	CANGGAGAYEQYF	TRBV6-5	TRBJ2-7
TGCAGTGCTAGAGCCGACAGAGACAATGAGCAGTTCTTC	CSARADRDNEQFF	TRBV20-1	TRBJ2-1
TGTGCCAGCAGGGGGGCGGACACCGGGGAGCTGTTTTTT	CASRGADTGELFF	TRBV7-3	TRBJ2-2
TGCAGCGTTGTGGGGGGACACGCTGAAGCTTTCTTT	CSVVGGHAEAFF	TRBV29-1	TRBJ1-1
TGTGCCACCAGTGATTCCTCGGGGACGGCAACTAATGAAAAACTGTTTTTT	CATSDSSGTATNEKLFF	TRBV24-1	TRBJ1-4
TGTGCCAGCAGTTGGTTAACCCAGGCCGGGACTAGTGCCGATGGCGGGTCAGATACGCAGTATTTT	CASSWLTQAGTSADGGSDTQYF	TRBV6-9	TRBJ2-3
TGTGCCAGCGTTTTTGACAGGGGGGGGAACACTGAAGCTTTCTTT	CASVFDRGGNTEAFF	TRBV6-8	TRBJ1-1
TGTGCCAGCAGCTTAGACGTAAGACAGGTTCTCAGCAATCAGCCCCAGCATTTT	CASSLDVRQVLSNQPQHF	TRBV7-9	TRBJ1-5
TGTGCCAGCAGCTTAGTCAGGGGTTTCCAAGAGACCCAGTACTTC	CASSLVRGFQETQYF	TRBV7-3	TRBJ2-5
TGTGCCACCAGCAGAGCGCATTTAATGGCCCGGGAAGATGGCTACACCTTC	CATSRAHLMAREDGYTF	TRBV15	TRBJ1-2
TGTGCCACCCTACATCGGCGGACCGGTACCACTGAAGCTTTCTTT	CATLHRRTGTTEAFF	TRBV10-3	TRBJ1-1
TGCACGATCCCGGGACAGTCCGGGCAGTACTTC	CTIPGQSGQYF	TRBV20-1	TRBJ2-7
TGTGCCAGCAGTGAAGCGCTTCGACGACTTTTGAACACTGAAGCTTTCTTT	CASSEALRRLLNTEAFF	TRBV2	TRBJ1-1
TGTGCCAGCAGTGACTCGAACTCGCGGGAGCCAACATACGAGCAGTACTTC	CASSDSNSREPTYEQYF	TRBV6-4	TRBJ2-7
TGCAGTGCTAGAGATTGCCGGGACAGGGCGGGCTACGAGCAGTACTTC	CSARDCRDRAGYEQYF	TRBV20-1	TRBJ2-7
TGTGCCAGCAGCCAAGATCACCACAGGGGAAGAGTTCCCCAGCATTTT	CASSQDHHRGRVPQHF	TRBV14	TRBJ1-5
TGTGCCAGCAGGGCCGAAGTATCGGCGGGACAGGGCCCGGGCAGTGTCTACATTCAGTACTTC	CASRAEVSAGQGPGSVYIQYF	TRBV5-4	TRBJ2-4
TGTGCCAGCAGTTTACGGTCGGGGGGAACGGATAACACAGATACGCAGTATTTT	CASSLRSGGTDNTDTQYF	TRBV27	TRBJ2-3
TGTGCCAGCAGCAAATCTACAATGGACGGGATGAACACTGAAGCTTTCTTT	CASSKSTMDGMNTEAFF	TRBV7-3	TRBJ1-1
TGTGCCAGCAGTTGGGGTACGGAGGGCTATGGCTACACCTTC	CASSWGTEGYGYTF	TRBV6-9	TRBJ1-2
TGTGCCAGCAGCTTTAGCCCCGACAGGGGAACTACCTACGAGCAGTACTTC	CASSFSPDRGTTYEQYF	TRBV7-2	TRBJ2-7
TGCAGTGCTAGAGGACCCATTGCAGGGTATGGCTACACCTTC	CSARGPIAGYGYTF	TRBV20-1	TRBJ1-2
TGTGCCAGCAGCATCGGACAGTTTTACTACTCTGGGGCCAACGTCCTGACTTTC	CASSIGQFYYSGANVLTF	TRBV5-4	TRBJ2-6
TGTGCCAGCAGTGCTAGCGGGAGTGAGCAGTTCTTC	CASSASGSEQFF	TRBV2	TRBJ2-1
TGTGCCAGCAGCGGGGGGAAATACACTGAAGCTTTCTTT	CASSGGKYTEAFF	TRBV7-4	TRBJ1-1
TGTGCCACCAGTGAAAAACTAGCGGGGGGGCGATTGTACAATGAGCAGTTCTTC	CATSEKLAGGRLYNEQFF	TRBV24-1	TRBJ2-1
TGTGCCAGCAGCTTGCCACAGGGTAACCAGACTAACGACACAGATACGCAGTATTTT	CASSLPQGNQTNDTDTQYF	TRBV5-5	TRBJ2-3
TGTGCCAGCAGCCTACACCAAAGCGGGACCGGGGAGCTGTTTTTT	CASSLHQSGTGELFF	TRBV5-8	TRBJ2-2
TGTGCCAGCAGCTTAGAAACGGGGGGGAGGTACAATGAGCAGTTCTTC	CASSLETGGRYNEQFF	TRBV11-2	TRBJ2-1
TGTGCCAGCAGTTCCGGACTAGCGGAAAATGAGCAGTTCTTC	CASSSGLAENEQFF	TRBV6-6	TRBJ2-1
TGTGCCTCCCCACCTATTAGCTATGGCTACACCTTC	CASPPISYGYTF	TRBV30	TRBJ1-2
TGTGCCAGTAGTCCAATTGAACCTGGCTACACCTTC	CASSPIEPGYTF	TRBV19	TRBJ1-2
TGCGCCAGCACCCGCACAGGGCATAGCAATCAGCCCCAGCATTTT	CASTRTGHSNQPQHF	TRBV10-1	TRBJ1-5
TGTGCCAGCAGTTTCCCCGGACAGGGGGCGGTGGTCGAGACGCATCAGCCCCAGCATTTT	CASSFPGQGAVVETHQPQHF	TRBV28	TRBJ1-5
TGTGCCAGCAGTAAACAGTCAGGCTCCCCCTACGAGCAGTACTTC	CASSKQSGSPYEQYF	TRBV12-4	TRBJ2-7
TGTGCCACCAGCAGCGGGGTTCTGAACACTGAAGCTTTCTTT	CATSSGVLNTEAFF	TRBV15	TRBJ1-1
TGCAGTGCTAGAGCAGCTCGGGCTGAGTACACAGATACGCAGTATTTT	CSARAARAEYTDTQYF	TRBV20-1	TRBJ2-3
TGTGCTAGTGGTAAGCCCCCGGGACAGGGTGCCACTGGGGCCAACGTCCTGACTTTC	CASGKPPGQGATGANVLTF	TRBV12-5	TRBJ2-6
TGTGCCAGACCACCGGGACAGATCTACGAGCAGTACTTC	CARPPGQIYEQYF	TRBV9	TRBJ2-7
TGTGCCAGCTCACCACCACAGACCTGGGGCCCGGGGACCTACAATGAGCAGTTCTTC	CASSPPQTWGPGTYNEQFF	TRBV18	TRBJ2-1
TGTGCCAGCAGCAGAGAAGAAGTTGGGAAGACGGGCTTC	CASSREEVGKTGF	TRBV3-1	TRBJ1-2
TGTGCCACCAGCAGAGAGGGAACAGGGATGCCGAGGTGTGAAGCTTTCTTT	CATSREGTGMPRCEAFF	TRBV15	TRBJ1-1
TGTGCCAGCAGCTTCCCGGACAGGGCTAGTGAAGGGATGAACACTGAAGCTTTCTTT	CASSFPDRASEGMNTEAFF	TRBV11-2	TRBJ1-1
TGTGCCAGCAAGAGGGACAGGGGCAGCTCCTATAATTCACCCCTCCACTTT	CASKRDRGSSYNSPLHF	TRBV27	TRBJ1-6
TGTGCTAGTGGTGAGTTCCCGGTAGGGCGAGGCTCCTACGAGCAGTACTTC	CASGEFPVGRGSYEQYF	TRBV12-5	TRBJ2-7
TGTGCCAGTAGAGCGGCCACGGGGAACACTGAAGCTTTCTTT	CASRAATGNTEAFF	TRBV19	TRBJ1-1
TGTGCCAGCAGCGCCGCGGGAGACGAGCAGTACTTC	CASSAAGDEQYF	TRBV11-2	TRBJ2-7
TGTGCCAGCAGTTGGGGGGGCAGGGCAGGTCGATGCGAGCAGTACTTC	CASSWGGRAGRCEQYF	TRBV5-5	TRBJ2-7
TGTGCCAGCAGGACAGGTAGCAATCAGCCCCAGCATTTT	CASRTGSNQPQHF	TRBV2	TRBJ1-5
TGTGCCAGCTCACCACCGAGACAGGGCTATGGCTACACCTTC	CASSPPRQGYGYTF	TRBV18	TRBJ1-2
TGTGCCAGCAGCCCGCGGCAACCCTTAGGAAGGTTCACAGATACGCAGTATTTT	CASSPRQPLGRFTDTQYF	TRBV7-2	TRBJ2-3
TGTGCCAGCAGCCAAGGGACAAGCAATCAGCCCCAGCATTTT	CASSQGTSNQPQHF	TRBV14	TRBJ1-5
TGTGCCAGCAGCACTCCCCACGGCCCCTCATACAATGAGCAGTTCTTC	CASSTPHGPSYNEQFF	TRBV11-3	TRBJ2-1
TGTGCCAGCAGGGCTAGAAGGGGGCTGATGACAAACAATGAGCAGTTCTTC	CASRARRGLMTNNEQFF	TRBV3-1	TRBJ2-1
TGTGCCACCAGAGCCGAGCGGGACTGTCAAGAGACCCAGTACTTC	CATRAERDCQETQYF	TRBV24-1	TRBJ2-5
TGCGCCAGCGGCTGGAGGGGGACAGGGGTGATGGATTCACCCCTCCACTTT	CASGWRGTGVMDSPLHF	TRBV5-1	TRBJ1-6
TGTGCCAGCAGCGATTTCGACAGTAAAGCTTTCTTT	CASSDFDSKAFF	TRBV2	TRBJ1-1
TGCAGTGCTAGAGACATCGGGGGGGCTGCCGGAAGCACAGATACGCAGTATTTT	CSARDIGGAAGSTDTQYF	TRBV20-1	TRBJ2-3
TGCGCCAGCAGCTTGGCCCAGGGGGGGCCCTCCTACGAGCAGTACTTC	CASSLAQGGPSYEQYF	TRBV5-1	TRBJ2-7
TGCAGTGCTATGCTGGGGCAAGAGACCCAGTACTTC	CSAMLGQETQYF	TRBV20-1	TRBJ2-5
TGTGCCAGCAGCGCGGGACCCTACGAGCAGTACTTC	CASSAGPYEQYF	TRBV9	TRBJ2-7
TGTGCCAGCAGCTTCACTAGCGGGAGGCCGTTCGGAGGCTACGAGCAGTACTTC	CASSFTSGRPFGGYEQYF	TRBV5-8	TRBJ2-7
TGTGCCAGCAGTGAACCCGGGACTAGCGGGAGCAACTCCTACGAGCAGTACTTC	CASSEPGTSGSNSYEQYF	TRBV2	TRBJ2-7
TGCGCCAGCCTAGGACCTAACGCCAAAAACATTCAGTACTTC	CASLGPNAKNIQYF	TRBV10-1	TRBJ2-4
TGTGCCAGCAGTGGAGGGGGGAGTATCTACGAGCAGTACTTC	CASSGGGSIYEQYF	TRBV6-2	TRBJ2-7
TGTGCCACTCCACTAGCGGGAGATACCGGTAACAATGAGCAGTTCTTC	CATPLAGDTGNNEQFF	TRBV27	TRBJ2-1
TGTGCCAGCAGTGAAAGGGACAGGCCCTGCTCCAGGACCTTC	CASSERDRPCSRTF	TRBV6-1	TRBJ1-2
TGTGCCAGCAGTGAAGCGTCCTCCGGGACAGGGGGCGAAGGGGACACTGAAGCTTTCTTT	CASSEASSGTGGEGDTEAFF	TRBV6-1	TRBJ1-1
TGCGCCAGCAGTGAGTCGACCAGGGTTAGGTCGAACACTGAAGCTTTCTTT	CASSESTRVRSNTEAFF	TRBV10-1	TRBJ1-1
TGCAGCGTTGCCGGTGGTAGCGGGACGAACACCGGGGAGCTGTTTTTT	CSVAGGSGTNTGELFF	TRBV29-1	TRBJ2-2
TGTGCCAGCAGTTTAAGCGGGAGCCAAGCTTTCTTT	CASSLSGSQAFF	TRBV28	TRBJ1-1
TGTGCCAGTAGTATAGTCTTCCGTTGGACCCGCTCCTACGAGCAGTACTTC	CASSIVFRWTRSYEQYF	TRBV19	TRBJ2-7
TGTGCCAGTCTGGGGGTCGAGGCTTTCTTT	CASLGVEAFF	TRBV27	TRBJ1-1
TGTGCCAGCAGCTTAGGATCAGGGACAGGGTTGAACACTGAAGCTTTCTTT	CASSLGSGTGLNTEAFF	TRBV13	TRBJ1-1
TGTGCCAGCACGGGGGGAGATACGCAGTATTTT	CASTGGDTQYF	TRBV6-1	TRBJ2-3
TGCAGTGCTAGCTCTTGTGGGATTAGAGAGCAGTACTTC	CSASSCGIREQYF	TRBV20-1	TRBJ2-7
TGTGCCAGCAGCTTGGAGAGGAGGACAGGCAATCAGCCCCAGCATTTT	CASSLERRTGNQPQHF	TRBV5-8	TRBJ1-5
TGTGCCAGCAAGCCGGGGGGGTTGAAAGAGACCCAGTACTTC	CASKPGGLKETQYF	TRBV6-2	TRBJ2-5
TGTGCCAGCAGTTATCGTCATAGAGGGTCTTGGGGGTCCCTTGGACTCCAGTACTTC	CASSYRHRGSWGSLGLQYF	TRBV6-9	TRBJ2-5
TGTGCCAGCAGCGACAGGGGCGAAACGCAGTATTTT	CASSDRGETQYF	TRBV5-5	TRBJ2-3
TGCAACCCCGGTCCAACTAATGAAAAACTGTTTTTT	CNPGPTNEKLFF	TRBV20-1	TRBJ1-4
TGTGCCATTTCGACGCATAAGCCCGGGATAGAAGAGACCCAGTACTTC	CAISTHKPGIEETQYF	TRBV12-3	TRBJ2-5
TGTGCCAGCACCGACAAGCCCCAGCATTTT	CASTDKPQHF	TRBV27	TRBJ1-5
TGTGCCAGCAGTGACTCGACGGGGAGATCCTACAATGAGCAGTTCTTC	CASSDSTGRSYNEQFF	TRBV6-4	TRBJ2-1
TGCGCCAGCAGCTCCGCAGGGGAAGAGAACACTGAAGCTTTCTTT	CASSSAGEENTEAFF	TRBV5-1	TRBJ1-1
TGTGCCAGCAGCGGGCTCGGCAGGTTAACTAATGAAAAACTGTTTTTT	CASSGLGRLTNEKLFF	TRBV9	TRBJ1-4
TGTGCCAGCAGTTTAACCGACCAATTCGAAGAAAAACTGTTTTTT	CASSLTDQFEEKLFF	TRBV27	TRBJ1-4
TGTGCCCCGCGCATCAACTTGCTGGTATCCTACAATGAGCAGTTCTTC	CAPRINLLVSYNEQFF	TRBV24-1	TRBJ2-1
TGTGCCAGCAGTTTAAGGTCTAGTCGTTTGTTTAGCAATCAGCCCCAGCATTTT	CASSLRSSRLFSNQPQHF	TRBV12-4	TRBJ1-5
TGCGCCAGCAGCTCGGGGGGGTACAATGAGCAGTTCTTC	CASSSGGYNEQFF	TRBV5-1	TRBJ2-1
TGTGCCAGCAGTTCCCGGACAGGGAAGAAAGGGTCCTCGAAGTTCACCGGGGAGCTGTTTTTT	CASSSRTGKKGSSKFTGELFF	TRBV27	TRBJ2-2
TGTGCCAGCCTTCCCGAGCCACAGCCTCGAACAAACACTGAAGCTTTCTTT	CASLPEPQPRTNTEAFF	TRBV11-2	TRBJ1-1
TGTGCCAGCAGCGCGGGGGGTGACTACGAGCAGTACTTC	CASSAGGDYEQYF	TRBV11-2	TRBJ2-7
TGTGCCAGTCCGACAGGGGGATGTAACTTGAACACTGAAGCTTTCTTT	CASPTGGCNLNTEAFF	TRBV6-4	TRBJ1-1
TGTGCCAGCAGTGAAGGCCGGGACAGCATAGCCCAGCATTTT	CASSEGRDSIAQHF	TRBV6-2	TRBJ1-5
TGTGCCAGCAGTTTAAGAGAGACTAGCGGGAGAGCGGCCGGGGAGCTGTTTTTT	CASSLRETSGRAAGELFF	TRBV28	TRBJ2-2
TGTGCCACCAGCAGCATACTAGCGGGAGGGCGCCACTACGAGCAGTACTTC	CATSSILAGGRHYEQYF	TRBV15	TRBJ2-7
TGTGCCAGCAGTTCCCGTCCCGCGGGAGGGCGGATGAGCACCGAGCAGTACTTC	CASSSRPAGGRMSTEQYF	TRBV6-1	TRBJ2-7
TGTGCCAGTAGTATACGGGTTCTACTGACAGGAACGTGGTATGGCTACACCTTC	CASSIRVLLTGTWYGYTF	TRBV19	TRBJ1-2
TGTGCCAGCAGCCAAGCCGGGACAGGCAATGGCTACACCTTC	CASSQAGTGNGYTF	TRBV14	TRBJ1-2
TGTGCCAGCAGCCTAAGGGAAACTCAGGGGTATAGCAATCAGCCCCAGCATTTT	CASSLRETQGYSNQPQHF	TRBV13	TRBJ1-5
TGTGCCAGCAGCAGATCGGAAGAGTTTGAGCAGTTCTTC	CASSRSEEFEQFF	TRBV7-9	TRBJ2-1
TGTGCCAGCAGTACCGGAGAGAGGTCGGGGGGGGCGCCTAATGAGCAGTTCTTC	CASSTGERSGGAPNEQFF	TRBV6-5	TRBJ2-1
TGCAGTGCGTCACAGGACGGCTACACCTTC	CSASQDGYTF	TRBV20-1	TRBJ1-2
TGTGCCAGCCCCGAGCATCGGACAGGTGACCCCTATGGCTACACCTTC	CASPEHRTGDPYGYTF	TRBV2	TRBJ1-2
TGTGCCAGACCCCGAGTAGCGGGAGATACGCAGTATTTT	CARPRVAGDTQYF	TRBV27	TRBJ2-3
TGTGCCAGCAGCCAAGATCAAGGGGGCAAAAATAGCAATCAGCCCCAGCATTTT	CASSQDQGGKNSNQPQHF	TRBV14	TRBJ1-5
TGTGCCATCAGGAGGGGGGGCCGGTCTGAGCAGTTCTTC	CAIRRGGRSEQFF	TRBV10-3	TRBJ2-1
TGCGCCCAAATCTGGTACGGGACAGAGCGCTCCTATAATTCACCCCTCCACTTT	CAQIWYGTERSYNSPLHF	TRBV10-2	TRBJ1-6
TGTGCCAGCAGCCACAAAAACAGGGGCATCGCTTACGAGCAGTACTTC	CASSHKNRGIAYEQYF	TRBV13	TRBJ2-7
TGTGCCAGCAGCTTCCCCCGGAGTCAGTGGTTCAACACCGGGGAGCTGTTTTTT	CASSFPRSQWFNTGELFF	TRBV11-3	TRBJ2-2
TGTGCCAGCAGCCAAGATCCCTACTTGACCGGGGAGCTGTTTTTT	CASSQDPYLTGELFF	TRBV3-1	TRBJ2-2
TGTGCCAGCAGGAGTAGGACGATGAACACTGAAGCTTTCTTT	CASRSRTMNTEAFF	TRBV6-6	TRBJ1-1
TGTGCCAGCAGCCTACCCCCGGGGCCAGAGCAGTACTTC	CASSLPPGPEQYF	TRBV11-3	TRBJ2-7
TGTGCCAGCACGGCCCCCACTGAAGCTTTCTTT	CASTAPTEAFF	TRBV5-4	TRBJ1-1
TGCAGTGATTCGAACGACAGGAAAGTAGAGACCCAGTACTTC	CSDSNDRKVETQYF	TRBV20-1	TRBJ2-5
TGTGCCAGCAGCTTGGCCCCTAGCGGGGCCGAAGAGACCCAGTACTTC	CASSLAPSGAEETQYF	TRBV5-6	TRBJ2-5
TGTGCCAGGTCTAATCCATACAACAATGAGCAGTTCTTC	CARSNPYNNEQFF	TRBV2	TRBJ2-1
TGCAGCGTTGCCACCCGTGGGACAGGGGGAACTGAAGCTTTCTTT	CSVATRGTGGTEAFF	TRBV29-1	TRBJ1-1
TGTGCCAGCAGGGGGAAGTTTTGCACAGATACGCAGTATTTT	CASRGKFCTDTQYF	TRBV6-5	TRBJ2-3
TGTGCCAGTAGTAAGGGGTGCTCTGGAAACACCATATATTTT	CASSKGCSGNTIYF	TRBV19	TRBJ1-3
TGTGCCACCAGTGATTTCCGAGGGGACGACACCATATATTTT	CATSDFRGDDTIYF	TRBV24-1	TRBJ1-3
TGTGCCAGCCTTAGCGGGACATGGGACACCGGGGAGCTGTTTTTT	CASLSGTWDTGELFF	TRBV6-6	TRBJ2-2
TGTGCCAGTAGTATAGATGGTTGGTGGGGAGGGCAGGACTACGAGCAGTACTTC	CASSIDGWWGGQDYEQYF	TRBV19	TRBJ2-7
TGTGCCATCAGCTGTGGCAGGTCCCGGGGAGGGTTGGACAATGAGCAGTTCTTC	CAISCGRSRGGLDNEQFF	TRBV10-3	TRBJ2-1
TGTGCCAGCAGCCTCGAGAGGGGTTTAACCCTCTCCTACGAGCAGTACTTC	CASSLERGLTLSYEQYF	TRBV5-4	TRBJ2-7
TGTGCCAGCCTCGGGACTAGCGGGCCGGGATACACCGGGGAGCTGTTTTTT	CASLGTSGPGYTGELFF	TRBV6-5	TRBJ2-2
TGCAGTGCTAGAGATGGGCGAAACTACGAGCAGTACTTC	CSARDGRNYEQYF	TRBV20-1	TRBJ2-7
TGTGCCAGCAGCTTGGTCCTTCGACAGGGCACAGATACGCAGTATTTT	CASSLVLRQGTDTQYF	TRBV5-6	TRBJ2-3
TGTGCCAGCAGCTATTGCAATGAGCAGTTCTTC	CASSYCNEQFF	TRBV7-9	TRBJ2-1
TGCAGTGCTAGTGGGGGAATCGGATGGTATAATTCACCCCTCCACTTT	CSASGGIGWYNSPLHF	TRBV20-1	TRBJ1-6
TGTGCCAGCAGCTTAGGAGACCTAGCGGGGGGTGAGCAGTTCTTC	CASSLGDLAGGEQFF	TRBV7-9	TRBJ2-1
TGTGCCAGCAGCTCGAATATAGTCCGTAATGAAAAACTGTTTTTT	CASSSNIVRNEKLFF	TRBV5-6	TRBJ1-4
TGTGCCACCATCGGACACCACACTGAAGCTTTCTTT	CATIGHHTEAFF	TRBV24-1	TRBJ1-1
TGTGCCAGCAGCCAAGAGGAAGACGGGGGGGACACAGATACGCAGTATTTT	CASSQEEDGGDTDTQYF	TRBV14	TRBJ2-3
TGTGCCAGCAGCCAAGCGATTAAACGGGGGGATTTCTACGAGCAGTACTTC	CASSQAIKRGDFYEQYF	TRBV3-1	TRBJ2-7
TGCAGTGCTAGAGCCGGGGGCTCATCGGATAATTCACCCCTCCACTTT	CSARAGGSSDNSPLHF	TRBV20-1	TRBJ1-6
TGTGCCAGTAGTATTAACAGGGGGCGGATAGACACTGAAGCTTTCTTT	CASSINRGRIDTEAFF	TRBV19	TRBJ1-1
TGTGCCAGCAGTGCACCGCCGGTCCTAATGAATTACTACGAGCAGTACTTC	CASSAPPVLMNYYEQYF	TRBV6-5	TRBJ2-7
TGTGCCAGCAGCCAAAAAATCTTACGGACAGGGGGGGCCGGGGAGCTGTTTTTT	CASSQKILRTGGAGELFF	TRBV14	TRBJ2-2
TGTGCCAGCAGCAAAAAGGACAATGGGAATGAAAAACTGTTTTTT	CASSKKDNGNEKLFF	TRBV13	TRBJ1-4
TGTGCCTCTAGCGGGCCGACCTACGAGCAGTACTTC	CASSGPTYEQYF	TRBV6-4	TRBJ2-7
TGCGCCAGCAGCCCCGGTCGTCACTCTAGCGGGCCGAACGAGCAGTACTTC	CASSPGRHSSGPNEQYF	TRBV5-1	TRBJ2-7
TGCAGCGTTGTCTTGGCAACAAGGCTAAATGAGCAGTTCTTC	CSVVLATRLNEQFF	TRBV29-1	TRBJ2-1
TGTGCCACCAGCAGAGATCTTAGACACACTGAAGCTTTCTTT	CATSRDLRHTEAFF	TRBV15	TRBJ1-1
TGTGTCCCAAATATGGCGGACGAGCAGTACTTC	CVPNMADEQYF	TRBV6-2	TRBJ2-7
TGCGCCAGCAGCCAAGGGGGGTCCAACTCTCAGCCCCAGCATTTT	CASSQGGSNSQPQHF	TRBV4-1	TRBJ1-5
TGTGCCACCTCGGGGGAACGCCAGTACTTC	CATSGERQYF	TRBV24-1	TRBJ2-4
TGTGCCTGGAGTGTAACCTCACGATACGGGGACAATGAGCAGTTCTTC	CAWSVTSRYGDNEQFF	TRBV30	TRBJ2-1
TGTGCCAGCAGTCAGGCTGCTTTCTTT	CASSQAAFF	TRBV6-1	TRBJ1-1
TGTGCCATTTGCGGCTCAGATACGCAGTATTTT	CAICGSDTQYF	TRBV13	TRBJ2-3
TGTGCCAGCAGTTATGGCAGGGAAAAGAGAAATGGTCCTGAGACCCAGTACTTC	CASSYGREKRNGPETQYF	TRBV6-5	TRBJ2-5
TGTGCCAGCAGCTCACCGACCGAAGGGGAAAAACTGTTTTTT	CASSSPTEGEKLFF	TRBV11-3	TRBJ1-4
TGCAGTGCTATACCAGAGCGGGAATCCGGTCCCGGGGAGCTGTTTTTT	CSAIPERESGPGELFF	TRBV20-1	TRBJ2-2
TGTGCCAGCAGCAACCCCCCCGGGGAGAGCAATCAGCCCCAGCATTTT	CASSNPPGESNQPQHF	TRBV9	TRBJ1-5
TGTGCCAGCTCACCACCACCGGGCTGTAATTCACCCCTCCACTTT	CASSPPPGCNSPLHF	TRBV18	TRBJ1-6
TGTGCCAGTAGTATAATTGGACAGGGGCCTATGTACTCCTACGAGCAGTACTTC	CASSIIGQGPMYSYEQYF	TRBV19	TRBJ2-7
TGTGCCAGCAGCGTCGGTGACAAATATACGCAGTATTTT	CASSVGDKYTQYF	TRBV9	TRBJ2-3
TGTGCCAAGCAGCGTTCACCCCTCCACTTT	CAKQRSPLHF	TRBV6-6	TRBJ1-6
TGTGCCAGCACGCGGGCCAGGGTCTATGGCTACACCTTC	CASTRARVYGYTF	TRBV6-2	TRBJ1-2
TGTGCCAGCTCACCACTACCCCTGGGGGATCGATGGACAGGTAGCTCCTACGAGCAGTACTTC	CASSPLPLGDRWTGSSYEQYF	TRBV18	TRBJ2-7
TGTGCCAGCAGCGCTACAGGGGACTATGGCTACACCTTC	CASSATGDYGYTF	TRBV11-3	TRBJ1-2
TGTGCCATCAGGACCGGGAGACCCCACAATGAGCAGTTCTTC	CAIRTGRPHNEQFF	TRBV10-3	TRBJ2-1
TGTGCCAGCAGCCCCATCCGGGACAGCGGCAATCAGCCCCAGCATTTT	CASSPIRDSGNQPQHF	TRBV7-9	TRBJ1-5
TGTGCCAGCAGTTACTCGACCCGGGTGCCCAGCCAAGATACGCAGTATTTT	CASSYSTRVPSQDTQYF	TRBV6-6	TRBJ2-3
TGTGCCAGCCAGGACGCACGAGGGTCTGGGCGCATACGCTACGAGCAGTACTTC	CASQDARGSGRIRYEQYF	TRBV27	TRBJ2-7
TGTGCCAGCAGCTATCGTAAATGGGGGGGGGACACTGAAGCTTTCTTT	CASSYRKWGGDTEAFF	TRBV7-3	TRBJ1-1
TGCGCCAGCAGTGAATCGGGGGGGCTGGCCTACGAGCAGTACTTC	CASSESGGLAYEQYF	TRBV10-1	TRBJ2-7
TGTGCTAGTGGTGGACAGGGCCCGGGCTATGGCTACACCTTC	CASGGQGPGYGYTF	TRBV12-5	TRBJ1-2
TGTGCCAAGCTGAGGGGTTGGGAGCAGTACTTC	CAKLRGWEQYF	TRBV6-2	TRBJ2-7
TGTGCCAGCAGCAGGGAGCAGGGCTTTTCTAACTATGGCTACACCTTC	CASSREQGFSNYGYTF	TRBV7-3	TRBJ1-2
TGCAGTGCTAGTCCCAGGGACAGGGGAAGGGAAAGCACTGAAGCTTTCTTT	CSASPRDRGRESTEAFF	TRBV20-1	TRBJ1-1
TGTGCCAGCAGCTTCTGTTTGGGACTTGTCGCTGAAGCTTTCTTT	CASSFCLGLVAEAFF	TRBV13	TRBJ1-1
TGTGCCAGCACCGGTGGGGGACTGCCCGGGGAGCTGTTTTTT	CASTGGGLPGELFF	TRBV6-4	TRBJ2-2
TGCAGCGTCACAGGGAACACTGAAGCTTTCTTT	CSVTGNTEAFF	TRBV29-1	TRBJ1-1
TGTGCCAGCAGCTTAGGCCACAGAGAGCCCTCTGGGGCCAACGTCCTGACTTTC	CASSLGHREPSGANVLTF	TRBV7-4	TRBJ2-6
TGTGCCAGCTCACCAGCCACCGAGTTCGAAACCTACGAGCAGTACTTC	CASSPATEFETYEQYF	TRBV18	TRBJ2-7
TGCGCCAGCAGCAACCAAGCAGAAACCTACGAGCAGTACTTC	CASSNQAETYEQYF	TRBV5-1	TRBJ2-7
TGTGCCAGTAGTACCCGACCTGGGGGGGTAGAGTACTACGAGCAGTACTTC	CASSTRPGGVEYYEQYF	TRBV19	TRBJ2-7
TGTGCCAGCTCACCACACACAGGGGGCCGAGGACCTAACTATGGCTACACCTTC	CASSPHTGGRGPNYGYTF	TRBV18	TRBJ1-2
TGCGCCAGCAGCTTGACCCACAGGGGGGAGACCCAGTACTTC	CASSLTHRGETQYF	TRBV5-1	TRBJ2-5
TGTGCCAGTAGTATTTTGGGACAGGCAATGTACTCCTACGAGCAGTACTTC	CASSILGQAMYSYEQYF	TRBV19	TRBJ2-7
TGTGCCAGCAGGAAGGGGGGCCCCTACGAGCAGTACTTC	CASRKGGPYEQYF	TRBV28	TRBJ2-7
TGTGCCAGCAGCCAAGGACGGGACAGGGGGGCCTGTGGCTACACCTTC	CASSQGRDRGACGYTF	TRBV4-2	TRBJ1-2
TGTGCCACAACTTCGGGACTAGCGACCACTAACACCGGGGAGCTGTTTTTT	CATTSGLATTNTGELFF	TRBV24-1	TRBJ2-2
TGTGCCAGCACGTGCGACAGGGAGGTTAATGAAAAACTGTTTTTT	CASTCDREVNEKLFF	TRBV7-9	TRBJ1-4
TGTGCCAGGTCCCACTTAAAGCGGACTGAAGCTTTCTTT	CARSHLKRTEAFF	TRBV6-5	TRBJ1-1
TGCGCCACTGTATATGGCTATAATTCACCCCTCCACTTT	CATVYGYNSPLHF	TRBV10-2	TRBJ1-6
TGTGCCAGCAGCTGGGGGACGTCCTACGAGCAGTACTTC	CASSWGTSYEQYF	TRBV7-9	TRBJ2-7
TGTGCCAGCAGTTTTAGGACAGGGAACGAGCAGTACTTC	CASSFRTGNEQYF	TRBV27	TRBJ2-7
TGTGCCAGCACCCTAGCGGGCCAAGGGAATGAGCAGTTCTTC	CASTLAGQGNEQFF	TRBV6-5	TRBJ2-1
TGTGCTAGTGGTTTGGTAGTTGTGGGGGGGTCTGCGGGGGAGTACAATGAGCAGTTCTTC	CASGLVVVGGSAGEYNEQFF	TRBV12-5	TRBJ2-1
TGTGCCAGCAGCTTTGGGGGGGGCACGCATACGCAGTATTTT	CASSFGGGTHTQYF	TRBV9	TRBJ2-3
TGTGCCAGCAGTTTATCTCTCCTCGGAGGACGCACCGGGGAGCTGTTTTTT	CASSLSLLGGRTGELFF	TRBV27	TRBJ2-2
TGTGCCTGGAATGCCCCTAGTGTTTTCCACTCCTACGAGCAGTACTTC	CAWNAPSVFHSYEQYF	TRBV30	TRBJ2-7
TGTGCCAGCAGTTGGACGGGTCGTCCCACGAACACCGGGGAGCTGTTTTTT	CASSWTGRPTNTGELFF	TRBV27	TRBJ2-2
TGCGCCAGCAGCCACCGTCCGGGCCGTCTCAGTGCCAAAAACATTCAGTACTTC	CASSHRPGRLSAKNIQYF	TRBV4-1	TRBJ2-4
TGTGCCGCTAGCGATAACAATGAGCAGTTCTTC	CAASDNNEQFF	TRBV10-3	TRBJ2-1
TGCGCCAGCAGCTTGGGGCTATCGGAGATGAACACCGGGGAGCTGTTTTTT	CASSLGLSEMNTGELFF	TRBV5-1	TRBJ2-2
TGTGCCAGCAGTTTAGCGCCGAGGGGCGCGACCTCCTACGAGCAGTACTTC	CASSLAPRGATSYEQYF	TRBV12-4	TRBJ2-7
TGTGCCAGCAGAACCAAAATGGTCCTGGGCATAGGGCACTATGGCTACACCTTC	CASRTKMVLGIGHYGYTF	TRBV28	TRBJ1-2
TGTGCCAGCAGCCAGCGCGCGGGACAGGAGAATAATTCACCCCTCCACTTT	CASSQRAGQENNSPLHF	TRBV14	TRBJ1-6
TGTGCCAGCAGTGTAGGAGGTGTCTTGTGCTTTAGCTCCTATAATTCACCCCTCCACTTT	CASSVGGVLCFSSYNSPLHF	TRBV6-6	TRBJ1-6
TGTGCCTGGAAAGTCAGGGGCCAGGGCGGACGAAGAGCCGGAAACACCATATATTTT	CAWKVRGQGGRRAGNTIYF	TRBV30	TRBJ1-3
TGTGCCAGTAGTAGACAACCGGACCTCAGCACAGATACGCAGTATTTT	CASSRQPDLSTDTQYF	TRBV19	TRBJ2-3
TGTGTATCGTTGGGCCAAGAGACCCAGTACTTC	CVSLGQETQYF	TRBV6-4	TRBJ2-5
TGTGCCAGCAGCCGACGTATTAGCTCCTACGAGCAGTACTTC	CASSRRISSYEQYF	TRBV11-2	TRBJ2-7
TGTGCCAGCAGCTTGCCCGGGACTAGCGGCATGAGCTCCTACAATGAGCAGTTCTTC	CASSLPGTSGMSSYNEQFF	TRBV7-9	TRBJ2-1
TGTGCCAATCCGGGACAGTTTCAGCCCCAGCATTTT	CANPGQFQPQHF	TRBV14	TRBJ1-5
TGTGCCAGCAGTCACCTCCCCAGGGGGCGCTCCTACGAGCAGTACTTC	CASSHLPRGRSYEQYF	TRBV3-1	TRBJ2-7
TGTGCCAGCAGCTTTCGCGGCCTACAGCAACCCATTGACTACGAGCAGTACTTC	CASSFRGLQQPIDYEQYF	TRBV7-3	TRBJ2-7
TGTGCCAGCACCGGGACTCATAGCACAGATACGCAGTATTTT	CASTGTHSTDTQYF	TRBV2	TRBJ2-3
TGTGCCAGCAGCTTGGTCGGACGGGGCACAGATACGCAGTATTTT	CASSLVGRGTDTQYF	TRBV5-6	TRBJ2-3
TGTGCCAGCAGCAATATGAATGGGGACGAGCAGTACTTC	CASSNMNGDEQYF	TRBV13	TRBJ2-7
TGTGCCAGCCAAACAGCGCGTAACTATGGCTACACCTTC	CASQTARNYGYTF	TRBV6-4	TRBJ1-2
TGTGCCAGCAAGGGTAGCTCCAACGCGATCTCGGGCAATCAGCCCCAGCATTTT	CASKGSSNAISGNQPQHF	TRBV6-5	TRBJ1-5
TGTGCCAGCACCCCAGACTACGAGCAGTACTTC	CASTPDYEQYF	TRBV6-2	TRBJ2-7
TGCAGTGCTAGCCGGACCGACCTTGGCGACACCGGGGAGCTGTTTTTT	CSASRTDLGDTGELFF	TRBV20-1	TRBJ2-2
TGCGCCAGCAGCTTGCCCACGGGGGAGGGAGAGGTCTACGAGCAGTACTTC	CASSLPTGEGEVYEQYF	TRBV5-1	TRBJ2-7
TGTGCCATCAGTGCGTCAAAACAGGTGGGAAAGGAGGAGCAGTTCTTC	CAISASKQVGKEEQFF	TRBV10-3	TRBJ2-1
TGTGCCAGCAGTGTCGTAGACAGGGGGGGCCCTAATGAAAAACTGTTTTTT	CASSVVDRGGPNEKLFF	TRBV27	TRBJ1-4
TGTGCCAGCAGCCGGCTGACTAGCGGGGTCTACGAGCAGTACTTC	CASSRLTSGVYEQYF	TRBV7-9	TRBJ2-7
TGCGCCAGCGAAATGCGGGGATATGGCTACACCTTC	CASEMRGYGYTF	TRBV5-1	TRBJ1-2
TGTGCCAGCAGTTGCAGGGATATAGCCAAAAACATTCAGTACTTC	CASSCRDIAKNIQYF	TRBV27	TRBJ2-4
TGTGCCAGCAGCCAAGATCTTCCGGCGGGACCTCCCACTGAAGCTTTCTTT	CASSQDLPAGPPTEAFF	TRBV14	TRBJ1-1
TGCAGCGACCGCCCTAGCGACCGTGAGCAGTTCTTC	CSDRPSDREQFF	TRBV29-1	TRBJ2-1
TGTGCCAGCAGTTACTCGCCGGTGCGTACTGGAAACACCATATATTTT	CASSYSPVRTGNTIYF	TRBV6-5	TRBJ1-3
TGTGCCACCAGTGCCCCCTTCGGAGAGCTTGGCTACACCTTC	CATSAPFGELGYTF	TRBV24-1	TRBJ1-2
TGTGCCAGCAGCAGGGGGCTGGGGCAAAATTCACCCCTCCACTTT	CASSRGLGQNSPLHF	TRBV25-1	TRBJ1-6
TGTGCCAGCCAAAGGGCCGGGACCCGTGGCTACACCTTC	CASQRAGTRGYTF	TRBV13	TRBJ1-2
TGCGCCAGCAGTGGGAAAAGGACAGGAGGGAAGAACACTGAAGCTTTCTTT	CASSGKRTGGKNTEAFF	TRBV10-1	TRBJ1-1
TGTGCCACCAGCAGAGCCGGGACAGGGTATGAGGGGGCACATGGCTACACCTTC	CATSRAGTGYEGAHGYTF	TRBV15	TRBJ1-2
TGTGCCAGCAGTGGCCCTAGACAGAAAAGCTCTGGAAACACCATATATTTT	CASSGPRQKSSGNTIYF	TRBV12-4	TRBJ1-3
TGTGCCAGTCGGGACTTAGATACGCAGTATTTT	CASRDLDTQYF	TRBV7-8	TRBJ2-3
TGTGCCAGCAGCATCCCTCCTTTGGCTCCCCAGACAATCAGCTCCTACAATGAGCAGTTCTTC	CASSIPPLAPQTISSYNEQFF	TRBV28	TRBJ2-1
TGTGCCAGCAGTATGGGGATGAACACTGAAGCTTTCTTT	CASSMGMNTEAFF	TRBV25-1	TRBJ1-1
TGTGCCAGCAGGAAGCGGAATAACGAGCAGTACTTC	CASRKRNNEQYF	TRBV6-2	TRBJ2-7
TGTGCAAACGCCGGGACAGGGGGACAGCCCCAGCATTTT	CANAGTGGQPQHF	TRBV30	TRBJ1-5
TGTGCCAGCAGTTTTCGGGGGGACGAGCAGTACTTC	CASSFRGDEQYF	TRBV12-4	TRBJ2-7
TGCAGTGCTACTTTTCCGGTCCCGACAAGGGGTGGGGGGGACACTGAAGCTTTCTTT	CSATFPVPTRGGGDTEAFF	TRBV20-1	TRBJ1-1
TGTGCCAGGGAACAGGCGGAAAAACTGTTTTTT	CAREQAEKLFF	TRBV6-6	TRBJ1-4
TGTGCCACCAGTGTGCCGACAGGGGGCTACTACGAGCAGTACTTC	CATSVPTGGYYEQYF	TRBV24-1	TRBJ2-7
TGCGCCAGCAGTTTAGTACGCGGGTTGAACACTGAAGCTTTCTTT	CASSLVRGLNTEAFF	TRBV10-1	TRBJ1-1
TGTGCCAGCAGCTCCTTCAGGCGTACCTACGAGCAGTACTTC	CASSSFRRTYEQYF	TRBV5-6	TRBJ2-7
TGCAGTGCAATGCCGGGACAGATTTCACCCCTCCACTTT	CSAMPGQISPLHF	TRBV20-1	TRBJ1-6
TGCGCCAGCAGTGAGTGTCCGTACAAAGACAGGCTTTGTACAGATACGCAGTATTTT	CASSECPYKDRLCTDTQYF	TRBV10-2	TRBJ2-3
TGTGCCAGCAACAAAAAGGGGACGAACACTGAAGCTTTCTTT	CASNKKGTNTEAFF	TRBV27	TRBJ1-1
TGTGCCAGCAGCGCTTTAGCCACTTGCGCGAACACCGGGGAGCTGTTTTTT	CASSALATCANTGELFF	TRBV5-4	TRBJ2-2
TGTGCCAGCAGCGCCGGGACAGGGCCCAATGAGCAGTTCTTC	CASSAGTGPNEQFF	TRBV5-4	TRBJ2-1
TGTGCAGGACGGGACAGGGGGCCCTCCTACGAGCAGTACTTC	CAGRDRGPSYEQYF	TRBV7-6	TRBJ2-7
TGTGCCAGCTATGAAGGACGCATCGGGGAGCTGTTTTTT	CASYEGRIGELFF	TRBV9	TRBJ2-2
TGTGCCAGCAGTGACTCTCGCAGAGGGAAAGTGATCAGGAACACTGAAGCTTTCTTT	CASSDSRRGKVIRNTEAFF	TRBV6-4	TRBJ1-1
TGTGCCAGCAGTTTCATCCCCTGCGGGGATGAGCAGTTCTTC	CASSFIPCGDEQFF	TRBV12-3	TRBJ2-1
TGTGCCAGTAGTATGTCCCGTCAGGCCAGACAGGGTGCTAACTATGGCTACACCTTC	CASSMSRQARQGANYGYTF	TRBV19	TRBJ1-2
TGTGCCAGCAGCTTAGATGCAATAAAATCCCAAGTCGAGACCCAGTACTTC	CASSLDAIKSQVETQYF	TRBV7-2	TRBJ2-5
TGTGCCAGCAGCGTAAGGGGGGAATCTTTGCCGAACACCGGGGAGCTGTTTTTT	CASSVRGESLPNTGELFF	TRBV7-9	TRBJ2-2
TGTGCCAGCAGTTCGAATCGCCGGGACAGGGCGGTACTCGACCTAAGTATCATGAACACTGAAGCTTTCTTT	CASSSNRRDRAVLDLSIMNTEAFF	TRBV6-4	TRBJ1-1
TGTGCCAGCAGCACTTTCCTCTTTGCGGACTACAATGAGCAGTTCTTC	CASSTFLFADYNEQFF	TRBV7-6	TRBJ2-1
TGTGCCAGCAGCTTCCAACTAGCGGGAGAAGAGACCCAGTACTTC	CASSFQLAGEETQYF	TRBV3-1	TRBJ2-5
TGTGCCAGCAGCCAAGGAGGGACGGGTGGGAAGCAGTATGAAAAACTGTTTTTT	CASSQGGTGGKQYEKLFF	TRBV3-1	TRBJ1-4
TGTGCTAGCAGCTTAAGCTCGGAGACCCAGTACTTC	CASSLSSETQYF	TRBV7-7	TRBJ2-5
TGTGCCAGCAGCTTGGCAGGGGACCCCCAGTACTTC	CASSLAGDPQYF	TRBV7-8	TRBJ2-5
TGTGCCAGCAGTGGAATTTCCGGGACATACGAGCAGTACTTC	CASSGISGTYEQYF	TRBV6-4	TRBJ2-7
TGTGCCAGCAGCCAAGTTAGGAGCGGGACTGCTCAGCCCCAGCATTTT	CASSQVRSGTAQPQHF	TRBV3-1	TRBJ1-5
TGTGCCAGCAGTGACCGCCGTGCCCAGACAGGTTTCCCGCCCCAGCATTTT	CASSDRRAQTGFPPQHF	TRBV6-4	TRBJ1-5
TGTGCCACCAGTGAAGGAACCGACAGGGGAAGGGATAGCAATCAGCCCCAGCATTTT	CATSEGTDRGRDSNQPQHF	TRBV24-1	TRBJ1-5
TGTGCCAGCAGCGCCGTAGCGGGCTACGTCCTCTTC	CASSAVAGYVLF	TRBV14	TRBJ2-1
TGTGCCAGCAGCTTAGTCGGCCCATCAGGCTACACCTTC	CASSLVGPSGYTF	TRBV7-2	TRBJ1-2
TGTGCCAGCAGGGGGGGCCGCGGCAAACGGCTCACAGATACGCAGTATTTT	CASRGGRGKRLTDTQYF	TRBV6-4	TRBJ2-3
TGTGCCAGCCCTCTGGGACGAGGCTTCCCGAACACTGAAGCTTTCTTT	CASPLGRGFPNTEAFF	TRBV25-1	TRBJ1-1
TGTGCCAGCAGCCAAGGCCTCTTACCGGGACGTCGGGAGCAGTACTTC	CASSQGLLPGRREQYF	TRBV14	TRBJ2-7
TGTGCCAGCAGCGAACCGGGGGCCCCAGTCTACAATGAGCAGTTCTTC	CASSEPGAPVYNEQFF	TRBV13	TRBJ2-1
TGTGCCAGCAGTTTATCCAGGGCCACTAACTATGGCTACACCTTC	CASSLSRATNYGYTF	TRBV28	TRBJ1-2
TGCAGTGCTAGAGGGAGAGGGGACCGCTACGAGCAGTACTTC	CSARGRGDRYEQYF	TRBV20-1	TRBJ2-7
TGTGCCAGCAGCCCGCCAGGGTTCGAGCAGTACTTC	CASSPPGFEQYF	TRBV13	TRBJ2-7
TGTGCCATGTCGGGCAAACAGGGAGGGGATACGCAGTATTTT	CAMSGKQGGDTQYF	TRBV7-6	TRBJ2-3
TGCAATACTAGAGGATCCTACGAGCAGTACTTC	CNTRGSYEQYF	TRBV29-1	TRBJ2-7
TGTGCCAGCAGCTTAGGAGGAGGGGGGACTGGGGCCAACGTCCTGACTTTC	CASSLGGGGTGANVLTF	TRBV11-1	TRBJ2-6
TGTGCCTGGAGATCCCCGGGACTTCCGTTCCAGGAGAGGCCCTCCTACAATGAGCAGTTCTTC	CAWRSPGLPFQERPSYNEQFF	TRBV30	TRBJ2-1
TGTGCCAGCAGCCCCCAGGATGAAAAACTGTTTTTT	CASSPQDEKLFF	TRBV11-3	TRBJ1-4
TGTGCCAGCAGCTTAGGTCAGGGACAGTTCAATGAGCAGTTCTTC	CASSLGQGQFNEQFF	TRBV11-2	TRBJ2-1
TGTGCCACCAGCAGAGTTTCCGCCCATGGACAGGGGGGCAATCAGCCCCAGCATTTT	CATSRVSAHGQGGNQPQHF	TRBV15	TRBJ1-5
TGCGCCAGCAGCCAAGAGGAGGGTGGTACTGAAGCTTTCTTT	CASSQEEGGTEAFF	TRBV4-3	TRBJ1-1
TGTGCCAGCAGAACGACAGGGGATCAGCCCCAGCATTTT	CASRTTGDQPQHF	TRBV28	TRBJ1-5
TGCAGTGCTAGAATTTCCGTTCTAGGGGATACAGATACGCAGTATTTT	CSARISVLGDTDTQYF	TRBV20-1	TRBJ2-3
TGTGCCTGGAGTAGAAAGACTAGCGGGGGAAAGGACACAGATACGCAGTATTTT	CAWSRKTSGGKDTDTQYF	TRBV30	TRBJ2-3
TGTGCCAGCAGCTTACCGTCCCCCAGGGCCGGGATTGCAACTAATGAAAAACTGTTTTTT	CASSLPSPRAGIATNEKLFF	TRBV7-3	TRBJ1-4
TGTGCCAGCAGCCGACACCCCCAGGGGACAGGGAAGAGAACCTCTGGGGCCAACGTCCTGACTTTC	CASSRHPQGTGKRTSGANVLTF	TRBV11-3	TRBJ2-6
TGTGCCAGCAGTGGGACAGAGGAAATGAACACTGAAGCTTTCTTT	CASSGTEEMNTEAFF	TRBV6-5	TRBJ1-1
TGTGCCAGCAGTGAACGGGTACCTGGGAGAACATTCCAAGAGACCCAGTACTTC	CASSERVPGRTFQETQYF	TRBV6-1	TRBJ2-5
TGTGCCAGCAGCTTAGGGACTAGCTGTCTGATAGGAGACTACGAGCAGTACTTC	CASSLGTSCLIGDYEQYF	TRBV11-2	TRBJ2-7
TGTGCCAGCAGCCAAGATACCGCCGGAAGGGAAGGCCGGAGCAATCAGCCCCAGCATTTT	CASSQDTAGREGRSNQPQHF	TRBV14	TRBJ1-5
TGTGCCACCAGTAAAGAGCGGGGGGGGGCACGAGAGACCCAGTACTTC	CATSKERGGARETQYF	TRBV24-1	TRBJ2-5
TGTGCCAGCAACAGACTGGGATCCTATACGCAGTATTTT	CASNRLGSYTQYF	TRBV27	TRBJ2-3
TGTGCCAGCAGCCAAGATGTGTCGGGGGCGAACACTGAAGCTTTCTTT	CASSQDVSGANTEAFF	TRBV3-1	TRBJ1-1
TGTGCCAGCAGCTTAGTGAGCCCGGACAGGCTCCGCTACGAGCAGTACTTC	CASSLVSPDRLRYEQYF	TRBV7-2	TRBJ2-7
TGTGCCAGCAGCAACAGAAAGTACTTC	CASSNRKYF	TRBV5-4	TRBJ2-7
TGTGCCAGCAGTTTAGGAGACGGTCTTCAAAGCAATCAGCCCCAGCATTTT	CASSLGDGLQSNQPQHF	TRBV27	TRBJ1-5
TGTGCCAGCAGTGGACTGCATATTCAGGGGGTACTCGCCTACGAGCAGTACTTC	CASSGLHIQGVLAYEQYF	TRBV2	TRBJ2-7
TGTGCCAGCAGTGAATATACCGAGGGACATGCCTATGGCTACACCTTC	CASSEYTEGHAYGYTF	TRBV25-1	TRBJ1-2
TGTGCCAGCAGCCCAGGACACCTTGTTGGAAACACCATATATTTT	CASSPGHLVGNTIYF	TRBV13	TRBJ1-3
TGTGCCAGCAGTTCCCATATGGACGAGCAGTACTTC	CASSSHMDEQYF	TRBV6-9	TRBJ2-7
TGTGCCAGCGGAGGGCCTCCGTATGAGCAGTTCTTC	CASGGPPYEQFF	TRBV9	TRBJ2-1
TGTGCCAGCAGCTTCCGGGACAGCGATGAAGCTTTCTTT	CASSFRDSDEAFF	TRBV7-6	TRBJ1-1
TGTGCCAGCAGTTTCGCCGCCTTACTAGTCCACCGGAACACTGAAGCTTTCTTT	CASSFAALLVHRNTEAFF	TRBV28	TRBJ1-1
TGTGCCAGTAGTCGACTAGCGGGAGGGCCGCTTAGCAATCAGCCCCAGCATTTT	CASSRLAGGPLSNQPQHF	TRBV19	TRBJ1-5
TGTGCCAGCACGGGTTCACGGGACAGTCCAACCGGGGAGCTGTTTTTT	CASTGSRDSPTGELFF	TRBV6-1	TRBJ2-2
TGCAGTGCTAGAGACGACAGGGTTAGGGTCTCTGGGGCCAACGTCCTGACTTTC	CSARDDRVRVSGANVLTF	TRBV20-1	TRBJ2-6
TGTGCCAGCAAGATAGCTGGATTAGAGACCCAGTACTTC	CASKIAGLETQYF	TRBV2	TRBJ2-5
TGTGCCAGCAGTTGTCTGGCCGACAGGCTGTTGACTGAAGCTTTCTTT	CASSCLADRLLTEAFF	TRBV12-4	TRBJ1-1
TGTGCCAGCAGCCAGGGTTATCGGGGAATACTTAACGAGCAGTACTTC	CASSQGYRGILNEQYF	TRBV7-8	TRBJ2-7
TGTGCCAGCTCCGGGACAGGGGTCTTC	CASSGTGVF	TRBV7-8	TRBJ2-1
TGCGCCAGCAGTGAGCCCGCGGTCGCGAACACCGGGGAGCTGTTTTTT	CASSEPAVANTGELFF	TRBV10-2	TRBJ2-2
TGTGCCAGCAGCACGTCGGGACAGGGAGGTCGCTACGAGCAGTACTTC	CASSTSGQGGRYEQYF	TRBV7-9	TRBJ2-7
TGCGCCAGCAGCAGGAGTACCCGGGACAGGGGAGGGCGGCAGTTCTTC	CASSRSTRDRGGRQFF	TRBV4-1	TRBJ2-1
TGCAGTGCTAGGACTAAGAAGCAAGAGACCCAGTACTTC	CSARTKKQETQYF	TRBV20-1	TRBJ2-5
TGCAGTGCTAGAGCCAACCGGGACAGGGAACCTTACGAGCAGTACTTC	CSARANRDREPYEQYF	TRBV20-1	TRBJ2-7
TGTGCCACCAGCAGAGATGCCCTAGCGGGTCGCGAGCAGTTCTTC	CATSRDALAGREQFF	TRBV15	TRBJ2-1
TGTGCCAGCAGTCCTAGGGCCCCCAAAGCTTTCTTT	CASSPRAPKAFF	TRBV28	TRBJ1-1
TGTGCCAGGGGACAGCTGTACGAGCAGTACTTC	CARGQLYEQYF	TRBV10-3	TRBJ2-7
TGTGCCTGGAGTGGGCCCTACGAGCAGTACTTC	CAWSGPYEQYF	TRBV30	TRBJ2-7
TGTGCCAGCAGCTTGTCCTCCGGGACTAGCGGGAGTTACACAGATACGCAGTATTTT	CASSLSSGTSGSYTDTQYF	TRBV5-5	TRBJ2-3
TGTGCCAGCCCAGTAGCTAGGAACACTGAAGCTTTCTTT	CASPVARNTEAFF	TRBV12-3	TRBJ1-1
TGTGCCTATGTGATTGGACTAGCGGGAAGCCAAGAGACCCAGTACTTC	CAYVIGLAGSQETQYF	TRBV30	TRBJ2-5
TGTGCCACCAGGACCCTGGGGGGACATACAAACATTCAGTACTTC	CATRTLGGHTNIQYF	TRBV24-1	TRBJ2-4
TGTGCCAGCAGTGAAGGACACTTCGACAGGGGGCAAGGCGGATACTCCTACGAGCAGTACTTC	CASSEGHFDRGQGGYSYEQYF	TRBV6-1	TRBJ2-7
TGTGCCAGCAGCACACGTCCAGGGGAAGAGTTCTTCCAAGAGACCCAGTACTTC	CASSTRPGEEFFQETQYF	TRBV11-2	TRBJ2-5
TGTGCCAGCAGCGTAGGTCCGCGACAGGGGGCTTCACCGCCGGACACAGATACGCAGTATTTT	CASSVGPRQGASPPDTDTQYF	TRBV9	TRBJ2-3
TGCGCCAGCAGCTTGGGGGGGAGACGAGGGAAGATACGGCGAACCAGGACCGGGGAGCTGTTTTTT	CASSLGGRRGKIRRTRTGELFF	TRBV5-1	TRBJ2-2
TGTGCCAGCAGCCTCGCCTGTCCTGACAGGGGCGCCAACACTGAAGCTTTCTTT	CASSLACPDRGANTEAFF	TRBV13	TRBJ1-1
TGTGCCAGCAGGACCCGTCATGAGCAGTTCTTC	CASRTRHEQFF	TRBV6-5	TRBJ2-1
TGCGCCAGCAGCCAAGATCTCGTCGGTAACCAACTCAGGAGTTTCTACGAGCAGTACTTC	CASSQDLVGNQLRSFYEQYF	TRBV4-3	TRBJ2-7
TGTGCCAGCACGACGAACAATGAGCAGTTCTTC	CASTTNNEQFF	TRBV6-2	TRBJ2-1
TGTGCCAGCAGCCTAATAGTTTGCGAGCAGTACTTC	CASSLIVCEQYF	TRBV6-5	TRBJ2-7
TGCGCCAGCAGCCTCGGGACTAGCGTGGCCAAAAACATTCAGTACTTC	CASSLGTSVAKNIQYF	TRBV4-3	TRBJ2-4
TGTGCCACCAGCAGAAGTTCCACTAGCGGGAGGGTGGCTTTCTTT	CATSRSSTSGRVAFF	TRBV15	TRBJ1-1
TGTGCCAGCAGTAGAAAAGAGGACAGGTTACCGCCCTCTGGAAACACCATATATTTT	CASSRKEDRLPPSGNTIYF	TRBV25-1	TRBJ1-3
TGTGCCAGCAGTGTTAGGGACCCGGGGGGCCGGTACACCGGGGAGCTGTTTTTT	CASSVRDPGGRYTGELFF	TRBV2	TRBJ2-2
TGCGCCACCCCGCATCCCCCGGCTCCCGCACGGTGTGAAGCTTTCTTT	CATPHPPAPARCEAFF	TRBV5-1	TRBJ1-1
TGTGCCAGCGGGGGACATTGTAGCTCCTACGAGCAGTACTTC	CASGGHCSSYEQYF	TRBV27	TRBJ2-7
TGTGCCAGCAGCGGGGGGAACTACGAGCAGTACTTC	CASSGGNYEQYF	TRBV7-4	TRBJ2-7
TGTGCCATCAGTGCACCTCACCTGGAGTGGACCCAGTACTTC	CAISAPHLEWTQYF	TRBV10-3	TRBJ2-5
TGTGCCAGCAGCCTCCTGGACAGGGTCGCGCAGTATTTT	CASSLLDRVAQYF	TRBV7-9	TRBJ2-3
TGTGCCAGCAGTAAAGGGGATGCGGACACTGAAGCTTTCTTT	CASSKGDADTEAFF	TRBV12-3	TRBJ1-1
TGCGCCAGCCCCACAGGGGACAGTCAGCCCCAGCATTTT	CASPTGDSQPQHF	TRBV10-1	TRBJ1-5
TGCGCCAGCAGCCAAACCGACCGGGACAGTAGCTCCTATAATTCACCCCTCCACTTT	CASSQTDRDSSSYNSPLHF	TRBV4-1	TRBJ1-6
TGTGCCATCAGTGAACGTCAGGAAGAGAACACCGGGGAGCTGTTTTTT	CAISERQEENTGELFF	TRBV10-3	TRBJ2-2
TGTGCCAGCAGTACCTGTCGTTGTTGGACAGAAGCCGCCTATAATTCACCCCTCCACTTT	CASSTCRCWTEAAYNSPLHF	TRBV6-1	TRBJ1-6
TGCAGTGCTAGCCAGCGGGAGAGGAGGTCCTACAATGAGCAGTTCTTC	CSASQRERRSYNEQFF	TRBV20-1	TRBJ2-1
TGTGCCAGCAGCTCGTTGGGACAGGAAAAACTGTTTTTT	CASSSLGQEKLFF	TRBV11-3	TRBJ1-4
TGTGCCATCAGGCAGGGGGTTGAGACCCAGTACTTC	CAIRQGVETQYF	TRBV10-3	TRBJ2-5
TGCGCCAGCAGCCGAGGACAGGCGGTTCTCGGATGCAATCAGCCCCAGCATTTT	CASSRGQAVLGCNQPQHF	TRBV4-1	TRBJ1-5
TGTGCCAGCAGCTTAATCTTTGGGACTTTCAGCTCCTACGAGCAGTACTTC	CASSLIFGTFSSYEQYF	TRBV7-2	TRBJ2-7
TGTGCCAGCAGCTTTAACCCATCCGGGGACACCGGCTACACCTTC	CASSFNPSGDTGYTF	TRBV5-4	TRBJ1-2
TGTGCTAGCAGCTTATCCACCCCGTGCAGGGGGGAACGCAATCAGCCCCAGCATTTT	CASSLSTPCRGERNQPQHF	TRBV7-7	TRBJ1-5
TGTGCCAGCAGCGAAGGCCTGGAGGGACAGGGCCTACTGTTTTTT	CASSEGLEGQGLLFF	TRBV9	TRBJ1-4
TGTGCCAGCGCAGGGAATCAGCCCCAGCATTTT	CASAGNQPQHF	TRBV28	TRBJ1-5
TGTGCCAGCTCCCGTGATAGCACAGATACGCAGTATTTT	CASSRDSTDTQYF	TRBV5-8	TRBJ2-3
TGTGCCAGCAGCGCGACAGGGGTAGAATATAATTCACCCCTCCACTTT	CASSATGVEYNSPLHF	TRBV5-6	TRBJ1-6
TGTGCCAGCAGCTTAAACTCCTCTGGGACAAGGTTTAGCAATCAGCCCCAGCATTTT	CASSLNSSGTRFSNQPQHF	TRBV11-3	TRBJ1-5
TGTCTGTACGAGGAGACCCAGTACTTC	CLYEETQYF	TRBV6-6	TRBJ2-5
TGTGCCAGCCCCCGCGGGACTAGCGGGAGGGGGGGGGGTGACAATGAGCAGTTCTTC	CASPRGTSGRGGGDNEQFF	TRBV6-1	TRBJ2-1
TGTGCCAGCAGAGCAGGACTCTACGAGCAGTACTTC	CASRAGLYEQYF	TRBV2	TRBJ2-7
TGCGCCAGCAGTGAGGACCTTGGCTACGAGCAGTACTTC	CASSEDLGYEQYF	TRBV10-2	TRBJ2-7
TGTGCCAAGGGGGACCGGGTCACCGGGGAGCTGTTTTTT	CAKGDRVTGELFF	TRBV12-4	TRBJ2-2
TGTGCCAGCAGCATAAGAGGACGGAACAATGAGCAGTTCTTC	CASSIRGRNNEQFF	TRBV7-4	TRBJ2-1
TGTGCCAGCAGCTTTGGTAGACAGGGGGGGGTGAACACTGAAGCTTTCTTT	CASSFGRQGGVNTEAFF	TRBV7-9	TRBJ1-1
TGTGCCATCACAGCCCCTAGAGCGGGAACCAGCAATCAGCCCCAGCATTTT	CAITAPRAGTSNQPQHF	TRBV10-3	TRBJ1-5
TGTGCCAGCAGCAACCAAGGGCTAGCGGGCGAGGAGACCCAGTACTTC	CASSNQGLAGEETQYF	TRBV7-3	TRBJ2-5
TGTGCCAGCAGCGACAGGGGGCATTCCTATAATTCACCCCTCCACTTT	CASSDRGHSYNSPLHF	TRBV7-6	TRBJ1-6
TGTGCCAGCAGCGCCGGGAACACCATATATTTT	CASSAGNTIYF	TRBV7-3	TRBJ1-3
TGTGCCAGCAAGCAAAAGGCTTCCCAGCCCCAGCATTTT	CASKQKASQPQHF	TRBV7-3	TRBJ1-5
TGCGCCAGCAGACCTTTAACAGGTACTAGGGAGTATGGCTACACCTTC	CASRPLTGTREYGYTF	TRBV5-1	TRBJ1-2
TGTGCCAGCAGCGTAGGGACAGCCTCGCATGAAAAACTGTTTTTT	CASSVGTASHEKLFF	TRBV9	TRBJ1-4
TGTGCCAGGGGATGCAATGGCTACACCTTC	CARGCNGYTF	TRBV27	TRBJ1-2
TGTGCCAGCAGTTACTCGAGTACCGGGACAGGGGGCCCTAACTATGGCTACACCTTC	CASSYSSTGTGGPNYGYTF	TRBV6-5	TRBJ1-2
TGTGCCAGCAGCTTAGCCTCCTCTTCCCAAGAGACCCAGTACTTC	CASSLASSSQETQYF	TRBV7-6	TRBJ2-5
TGTGCCAGCAGTAAATTGTATCTGGGAAGCTACGAGCAGTACTTC	CASSKLYLGSYEQYF	TRBV27	TRBJ2-7
TGTGCCAGCAGCTTCCAATTAACCGGGACTAGCGGGGCTTACGAGCAGTACTTC	CASSFQLTGTSGAYEQYF	TRBV14	TRBJ2-7
TGTGCCACCAGTGATTCATGCCGGGGGAGTGAATGGGCTTTCTTT	CATSDSCRGSEWAFF	TRBV24-1	TRBJ1-1
TGTGCCAGCAGCTTGCCAGGGGGGGGGGGGAACACTGAAGCTTTCTTT	CASSLPGGGGNTEAFF	TRBV5-4	TRBJ1-1
TGCAGTGCTTGTGGGAGGGGTGAGCAGTTCTTC	CSACGRGEQFF	TRBV20-1	TRBJ2-1
TGTGCCAGCAGCTTAGTAGGGACAGGGGATACGCAGTATTTT	CASSLVGTGDTQYF	TRBV7-2	TRBJ2-3
TGTGCCACCAGTGAAAGACTCCGGGGTCAAACGGATACGCAGTATTTT	CATSERLRGQTDTQYF	TRBV24-1	TRBJ2-3
TGTGCCAGCAGTCGCAGGGGGTGTATCTATAATTCACCCCTCCACTTT	CASSRRGCIYNSPLHF	TRBV6-4	TRBJ1-6
TGCGCCAGCAGCCATTGGACTAGCATAAATGAGCAGTTCTTC	CASSHWTSINEQFF	TRBV5-1	TRBJ2-1
TGTGCCAGCAGCCAGGGAACAGGGAAGCCTAGCACAGATACGCAGTATTTT	CASSQGTGKPSTDTQYF	TRBV14	TRBJ2-3
TGTGCCAGCAGGGAGCACCGGGACAGGAACACTGAAGCTTTCTTT	CASREHRDRNTEAFF	TRBV9	TRBJ1-1
TGTGCCAGCAGTTTAGGTCCACAGGGGGCTGGGCAGTTCTTC	CASSLGPQGAGQFF	TRBV12-4	TRBJ2-1
TGTGCCAGCAGCCCGGCGGGGGACAGGAATGGCTACACCTTC	CASSPAGDRNGYTF	TRBV5-4	TRBJ1-2
TGCGCCAGCAGCGACAGGTGGATCCCGAAGAACACCGGGGAGCTGTTTTTT	CASSDRWIPKNTGELFF	TRBV5-1	TRBJ2-2
TGTGCCAGCAGCCAAAATGGCCTAGTAGGCACCGGGGAGCTGTTTTTT	CASSQNGLVGTGELFF	TRBV14	TRBJ2-2
TGCGCCAGCAGCCAAGATTCCCTGTACGGGACAGGGGCTTGGAACACTGAAGCTTTCTTT	CASSQDSLYGTGAWNTEAFF	TRBV4-3	TRBJ1-1
TGTGCCAGCAGCGATACTAGCGGGTCGACAGATACGCAGTATTTT	CASSDTSGSTDTQYF	TRBV9	TRBJ2-3
TGCGCCAGCAGCTTGCACCCGGGGGGCAGGGAAGAGACCCAGTACTTC	CASSLHPGGREETQYF	TRBV5-1	TRBJ2-5
TGTGCCAGCAGCCCCGTGGGGGGTCAAACCGGGGAGCTGTTTTTT	CASSPVGGQTGELFF	TRBV13	TRBJ2-2
TGTGCCAGCAGTCCACAGGGGGACACTGAAGCTTTCTTT	CASSPQGDTEAFF	TRBV6-4	TRBJ1-1
TGTGCCAGCAGTTACTATTCCGAGTGGAGTGAGCAGTTCTTC	CASSYYSEWSEQFF	TRBV6-5	TRBJ2-1
TGTGCCAGCAGCCAAATTATCTGTCGCGGGGCAGATACGCAGTATTTT	CASSQIICRGADTQYF	TRBV3-1	TRBJ2-3
TGTGCCAGCAGCGGCCGGGGGGGCCCGGGTAACAATGAGCAGTTCTTC	CASSGRGGPGNNEQFF	TRBV7-3	TRBJ2-1
TGTGCCAGCAGCCAAGTAAGGGGGGAGTACGAGCAGTACTTC	CASSQVRGEYEQYF	TRBV14	TRBJ2-7
TGCAGTGCTAGTGGGGCCACCAACACCGGGGAGCTGTTTTTT	CSASGATNTGELFF	TRBV20-1	TRBJ2-2
TGTGCCAGCAGCCATGCAGGCCGATATAGCAATCAGCCCCAGCATTTT	CASSHAGRYSNQPQHF	TRBV9	TRBJ1-5
TGCAGTGCATCCCGGTTCCTACCCCACGAGCAGTACTTC	CSASRFLPHEQYF	TRBV20-1	TRBJ2-7
TGTGCCAGTAGTAAGCCCTTCTCTGGAAACACCATATATTTT	CASSKPFSGNTIYF	TRBV19	TRBJ1-3
TGCAGTGCTAGAGGGACAGGGTCCAATAATGAAAAACTGTTTTTT	CSARGTGSNNEKLFF	TRBV20-1	TRBJ1-4
TGTGCCAGCAGCTACACCACTGAAGCTTTCTTT	CASSYTTEAFF	TRBV5-5	TRBJ1-1
TGTGCCAGCAGCCATCTCCTAGCGGGTGTTGAGCAGTTCTTC	CASSHLLAGVEQFF	TRBV3-1	TRBJ2-1
TGTGCCAGCAGTGCCCCCCGAAGGGCCGGACTGTTCAATGAGCAGTTCTTC	CASSAPRRAGLFNEQFF	TRBV27	TRBJ2-1
TGCAGTGCCAACAACCCGGGACAGGGGCATCAGTATGGCTACACCTTC	CSANNPGQGHQYGYTF	TRBV20-1	TRBJ1-2
TGTGCCAGCAGGCGGGAGGCTGAAGCTTTCTTT	CASRREAEAFF	TRBV6-4	TRBJ1-1
TGTGCCAGTAGTACAGGCCAGGGCGGTTCTAACTATGGCTACACCTTC	CASSTGQGGSNYGYTF	TRBV19	TRBJ1-2
TGTGCCAGCAGTGCTCTGGGGGGGGGATTGAATAAAAACATTCAGTACTTC	CASSALGGGLNKNIQYF	TRBV2	TRBJ2-4
TGCAGTGCACAGTCCGGAAACACCATATATTTT	CSAQSGNTIYF	TRBV20-1	TRBJ1-3
TGTGCCAGCTCACTTAACCAGACAGGGAAGTGCTCCTACGAGCAGTACTTC	CASSLNQTGKCSYEQYF	TRBV18	TRBJ2-7
TGTGCCACCAGCAGAGGTAGCTCACCGAGCTTTGGCTACACCTTC	CATSRGSSPSFGYTF	TRBV15	TRBJ1-2
TGTGCCAGCAGTGACAGGGATCCGCACGAGCAGTACTTC	CASSDRDPHEQYF	TRBV6-2	TRBJ2-7
TGTGCCAGCAGCCTGATCTGCGGGACTATCCTCTACGAGCAGTACTTC	CASSLICGTILYEQYF	TRBV9	TRBJ2-7
TGTGCCATCAGGGCCTATGGCTACACCTTC	CAIRAYGYTF	TRBV10-3	TRBJ1-2
TGTGCCAGCAGTAAAGTAGAGGTCTACAATGAGCAGTTCTTC	CASSKVEVYNEQFF	TRBV6-1	TRBJ2-1
TGTGCCAGCAGAAAGACAAGGTCCAATGAGCAGTTCTTC	CASRKTRSNEQFF	TRBV6-4	TRBJ2-1
TGTGCCACCAGTGCCGCGGGATCCTACGAGCAGTACTTC	CATSAAGSYEQYF	TRBV24-1	TRBJ2-7
TGTGCCAGCAGTTACGTCGCGGGAGTCCGGAACACTGAAGCTTTCTTT	CASSYVAGVRNTEAFF	TRBV6-2	TRBJ1-1
TGTGCCAGCAGTTTATTTCGGGGGGAGGGATGGGGCAACACCGGGGAGCTGTTTTTT	CASSLFRGEGWGNTGELFF	TRBV27	TRBJ2-2
TGTGCCAGCAGTGATGTGAACACTGAAGCTTTCTTT	CASSDVNTEAFF	TRBV2	TRBJ1-1
TGCAGTGCTAACAGGGGTCCTGGGGGGTTCGGTCCGGTAAGGGGGCACTACGAGCAGTACTTC	CSANRGPGGFGPVRGHYEQYF	TRBV20-1	TRBJ2-7
TGTGCCAGCAGCTGGTCAGGAGAGGCCCGAGCTTTCTTT	CASSWSGEARAFF	TRBV7-2	TRBJ1-1
TGTGCCATCAGTGAGTCCTTCGGTAGGGGACTAGCGGGACGGGATACGCAGTATTTT	CAISESFGRGLAGRDTQYF	TRBV10-3	TRBJ2-3
TGTGCCAGCAGCCGACCTACAGGTGAGGTGAACACTGAAGCTTTCTTT	CASSRPTGEVNTEAFF	TRBV5-8	TRBJ1-1
TGTGCCCCCTCCTCCTCTATTCGGACTAGCGGGGGGGCCAGGGACTACGAGCAGTACTTC	CAPSSSIRTSGGARDYEQYF	TRBV27	TRBJ2-7
TGTGCCATCAGCCCGAGCGGGACAGGGGGCAGCTACACCGGGGAGCTGTTTTTT	CAISPSGTGGSYTGELFF	TRBV10-3	TRBJ2-2
TGTGCCAGCAGATTCTTACGTGGGGATGAGCAGTTCTTC	CASRFLRGDEQFF	TRBV12-3	TRBJ2-1
TGTGCCATCGCAATGCACAGGATCCTCTACTATGGCTACACCTTC	CAIAMHRILYYGYTF	TRBV7-9	TRBJ1-2
TGCAGTGCTAGAGTTTCGGCTCTTGCCTACGAGCAGTACTTC	CSARVSALAYEQYF	TRBV20-1	TRBJ2-7
TGTGCCAGCAGCAGACGCTCTGGGGCCAACGTCCTGACTTTC	CASSRRSGANVLTF	TRBV5-5	TRBJ2-6
TGTGCCAGCAGTTGCGGGACAGACATGAGCTCCTACGAGCAGTACTTC	CASSCGTDMSSYEQYF	TRBV6-4	TRBJ2-7
TGTGCCAGCAGTTACCCGGGACTAGGGGGTCGGGCGAGCACAGATACGCAGTATTTT	CASSYPGLGGRASTDTQYF	TRBV6-5	TRBJ2-3
TGTGCCAGCAGCCTAACGAGGGGGCCCGAGCTAGCCAAAAACATTCAGTACTTC	CASSLTRGPELAKNIQYF	TRBV7-2	TRBJ2-4
TGTGCCAGCAGGGTAAGGAGGGGGGGGCACGAGCAGTACTTC	CASRVRRGGHEQYF	TRBV6-2	TRBJ2-7
TGTGCCACCAGTGAGGGGGGGCGCTATGGCTACACCTTC	CATSEGGRYGYTF	TRBV24-1	TRBJ1-2
TGTGCCAGCATCAGAATTCCTAATCAGCCCCAGCATTTT	CASIRIPNQPQHF	TRBV6-2	TRBJ1-5
TGTGCCAGCAGTGAACTTGGGAGGAACAATCAGCCCCAGCATTTT	CASSELGRNNQPQHF	TRBV25-1	TRBJ1-5
TGTGCCAGCAGCCGACCGGTCCCAACCCGGCTTTCCAGGATCAATGAGCAGTTCTTC	CASSRPVPTRLSRINEQFF	TRBV7-3	TRBJ2-1
TGTGCCAGCAGCTTCAGAGAACCCACCGGAGACAGGTATTCGTCCCATGAGCAGTTCTTC	CASSFREPTGDRYSSHEQFF	TRBV11-3	TRBJ2-1
TGTGCCAGCAGCTTAAGGGTAGACCGGGACAGAAAAGTGACCGGGGAGCTGTTTTTT	CASSLRVDRDRKVTGELFF	TRBV7-3	TRBJ2-2
TGTGCCAGCAGTTTGGGGGGCAGGCGCTCTGGGGCCAACGTCCTGACTTTC	CASSLGGRRSGANVLTF	TRBV27	TRBJ2-6
TGTGCCAGCAGGACATATGAGCAGTTCTTC	CASRTYEQFF	TRBV7-3	TRBJ2-1
TGCAGTGCTGTTGCCCACCAGGGACATCCAGATACGCAGTATTTT	CSAVAHQGHPDTQYF	TRBV20-1	TRBJ2-3
TGTGCCAGTCCAGGGGAAGAAGTGGGAAGTGAAGCTTTCTTT	CASPGEEVGSEAFF	TRBV19	TRBJ1-1
TGTGCCAGCAGCAGACTACCAGTTTACACTGAAGCTTTCTTT	CASSRLPVYTEAFF	TRBV7-3	TRBJ1-1
TGTGCCAGCAGCCAAGATTCAAGGAGTAGGGGCTACACCTTC	CASSQDSRSRGYTF	TRBV4-2	TRBJ1-2
TGTGCCAGCAGCTTGTCTAACAGCGGGACCGTGCAATGGAGCTCCTACAATGAGCAGTTCTTC	CASSLSNSGTVQWSSYNEQFF	TRBV7-2	TRBJ2-1
TGTGCCTGGAGTGCCGGACAGCAGCCCCAGCATTTT	CAWSAGQQPQHF	TRBV30	TRBJ1-5
TGTGCCAGCACGTGTATCCTAGCGGGGAACAATGAGCAGTTCTTC	CASTCILAGNNEQFF	TRBV7-3	TRBJ2-1
TGTGCCAGCAGCTTGGCACCCTGGGACAGGGGGAGGCTTAGCTCCTACGAGCAGTACTTC	CASSLAPWDRGRLSSYEQYF	TRBV5-6	TRBJ2-7
TGTGCCAGCAGGAGGGGTTTGCCCTACGAGCAGTACTTC	CASRRGLPYEQYF	TRBV28	TRBJ2-7
TGTGCCAGCAGCCAGACTGGGGGGGAGGGGAATAGGCACACCGGGGAGCTGTTTTTT	CASSQTGGEGNRHTGELFF	TRBV4-2	TRBJ2-2
TGTGCCAGCAGTTTATCGCCTAAGACAGGCCTTGAGACCCAGTACTTC	CASSLSPKTGLETQYF	TRBV27	TRBJ2-5
TGTGCCAGCAGTTTGTGCTCCGATAAGGGACTAGCGTTCGAGGAGACCCAGTACTTC	CASSLCSDKGLAFEETQYF	TRBV28	TRBJ2-5
TGCGCCAGCAGCTACCCGGGACAGGAAATGTCCCCACAGGAAGCTTTCTTT	CASSYPGQEMSPQEAFF	TRBV5-1	TRBJ1-1
TGCAGTGCTGCAGCAGGGACACAGGGCTCCTACAATGAGCAGTTCTTC	CSAAAGTQGSYNEQFF	TRBV20-1	TRBJ2-1
TGTGCCAGCAGCCACTTACGACCTACCTACGAGCAGTACTTC	CASSHLRPTYEQYF	TRBV11-3	TRBJ2-7
TGCGCCAGCAGCTTGGGGCGTCGCACAGGGGCCTACGAGCAGTACTTC	CASSLGRRTGAYEQYF	TRBV5-1	TRBJ2-7
TGCGCCAGCAGCTTCCCAGTAGGACAGGGCTCCTACAATGAGCAGTTCTTC	CASSFPVGQGSYNEQFF	TRBV5-1	TRBJ2-1
TGTGCCAGCAGTGATTGGGACAGACCAAGCAATCAGCCCCAGCATTTT	CASSDWDRPSNQPQHF	TRBV6-5	TRBJ1-5
TGTGCCAGTAGTGGCAAGACAGAGGAGCAGTACTTC	CASSGKTEEQYF	TRBV19	TRBJ2-7
TGCGCCAGCAGGCCTAGAACAAATGGTTCCGAGCAGTTCTTC	CASRPRTNGSEQFF	TRBV5-1	TRBJ2-1
TGTGCCAGCAGCGCATCTGACCCGGGCAGACGCCGCGGGGAGCTGTTTTTT	CASSASDPGRRRGELFF	TRBV9	TRBJ2-2
TGTGCCACCAAGCGGCGGACCAAGACCCAGTACTTC	CATKRRTKTQYF	TRBV12-3	TRBJ2-5
TGTGCCAGCATCTCGGGACAGTGGCCCACAGATACGCAGTATTTT	CASISGQWPTDTQYF	TRBV11-1	TRBJ2-3
TGTGCCAGCAGTGAGGCCGGCGGGACGAAAAGCTCCTACGAGCAGTACTTC	CASSEAGGTKSSYEQYF	TRBV25-1	TRBJ2-7
TGTGCCAGCAGTTACGCCGGACAGCTAGAGACCCAGTACTTC	CASSYAGQLETQYF	TRBV6-3	TRBJ2-5
TGTGCCAGCAGTTTACCCGGGGACAGGACTGAAGCTTTCTTT	CASSLPGDRTEAFF	TRBV27	TRBJ1-1
TGCAGCGTTGTGGGACAGGCCCGCTATGGCTACACCTTC	CSVVGQARYGYTF	TRBV29-1	TRBJ1-2
TGTGCCAGCAGCTCGACAGGGGGAAGGCGACATGGCTACACCTTC	CASSSTGGRRHGYTF	TRBV7-3	TRBJ1-2
TGCGCCAGCAGTGACCGGGGGGGCGGAGCAAACATTCAGTACTTC	CASSDRGGGANIQYF	TRBV10-1	TRBJ2-4
TGTGCCTGGAGTGTAATACATCCCGGCAATCAGCCCCAGCATTTT	CAWSVIHPGNQPQHF	TRBV30	TRBJ1-5
TGTGCCACCAGCAGAAGGGTCCGGGACAGGGGTGTTAGAGCTGAAGCTTTCTTT	CATSRRVRDRGVRAEAFF	TRBV15	TRBJ1-1
TGTGCCAGCAGTGAACGGGAGAGAGAGACCCAGTACTTC	CASSERERETQYF	TRBV6-1	TRBJ2-5
TGTGCCAGCAGCCAAGATGGCACCGGAACGGGGCGGTTACACAATCAGCCCCAGCATTTT	CASSQDGTGTGRLHNQPQHF	TRBV14	TRBJ1-5
TGCGCCAGCAGCGGGAGGGCTCCAACCTATAATTCACCCCTCCACTTT	CASSGRAPTYNSPLHF	TRBV5-1	TRBJ1-6
TGTGCCAGCAGCCAAGAGACGGGGGTACAGTACTTC	CASSQETGVQYF	TRBV3-1	TRBJ2-5
TGTGCCAGCAGTACGGCCAAAAGCGGGAGGAACACTGAAGCTTTCTTT	CASSTAKSGRNTEAFF	TRBV27	TRBJ1-1
TGCGCCAGCAGCCAAGAAGGTCAGGGGTCCCAGCATTTT	CASSQEGQGSQHF	TRBV4-3	TRBJ1-5
TGTGCCAGCAGCTGTTCCTACACAAGGTTCACGGGCAATCAGCCCCAGCATTTT	CASSCSYTRFTGNQPQHF	TRBV13	TRBJ1-5
TGTGCCTGGCGTCGGAGGGTTCACACTGAAGCTTTCTTT	CAWRRRVHTEAFF	TRBV30	TRBJ1-1
TGCAGTGCCAGTCTAGCGGGGGGGCCGTATGAGACCCAGTACTTC	CSASLAGGPYETQYF	TRBV20-1	TRBJ2-5
TGTGCCAGCAGCTTAGGGGACAGGGGAGGAGTACGTAGTTCCTTC	CASSLGDRGGVRSSF	TRBV5-8	TRBJ2-7
TGTGCCAGCAGTATCTATAGCCTATCAATGGGGTCTGAAAAACTGTTTTTT	CASSIYSLSMGSEKLFF	TRBV27	TRBJ1-4
TGTGCCAGCAGCTCAGGGCGGGGGTCGCAGTACTTC	CASSSGRGSQYF	TRBV6-2	TRBJ2-4
TGCGCCAGCAGTGACCCGAAGGGGTACCAAGAGACCCAGTACTTC	CASSDPKGYQETQYF	TRBV10-2	TRBJ2-5
TGTGCCAGCTCACCACCAAAGGGGACAGACACTGAAGCTTTCTTT	CASSPPKGTDTEAFF	TRBV18	TRBJ1-1
TGTGCCAGCAGTGAGCCCAGGGGAATAGGTGACACTGAAGCTTTCTTT	CASSEPRGIGDTEAFF	TRBV6-4	TRBJ1-1
TGTGCCAGCAGTTACTCGAACTCGGGACAGGCTCGTTCGGTCTCCTACGAGCAGTACTTC	CASSYSNSGQARSVSYEQYF	TRBV6-5	TRBJ2-7
TGCGCCACTCCCGGGGTTTACACTGAAGCTTTCTTT	CATPGVYTEAFF	TRBV10-1	TRBJ1-1
TGTGCCAGCAGCTTGGGCACTGAGAGGCTAGCCAAAAACATTCAGTACTTC	CASSLGTERLAKNIQYF	TRBV11-2	TRBJ2-4
TGTGCCAGCAGCTTAACAGGGGGGGGCCGGTTCCAAGAGACCCAGTACTTC	CASSLTGGGRFQETQYF	TRBV7-8	TRBJ2-5
TGCGCCAGCAGTGACCAGGGGGGGCAGTTCTATTTT	CASSDQGGQFYF	TRBV10-1	TRBJ2-3
TGTGCCAGCAGCCCCTTTTGGTCCTACAATGAGCAGTTCTTC	CASSPFWSYNEQFF	TRBV7-6	TRBJ2-1
TGTGCCATCAGAAGGGACAGACCCTCCTATAATTCACCCCTCCACTTT	CAIRRDRPSYNSPLHF	TRBV10-3	TRBJ1-6
TGTGCCAGCAGTGGGACAGGGGATGGAGCAACTAATGAAAAACTGTTTTTT	CASSGTGDGATNEKLFF	TRBV12-3	TRBJ1-4
TGTGCCAGCTCACCAAGGAATATACACTATGGCTACACCTTC	CASSPRNIHYGYTF	TRBV18	TRBJ1-2
TGTGCCAGCAGGGGGGAACTCACTGAAGCTTTCTTT	CASRGELTEAFF	TRBV6-4	TRBJ1-1
TGCAGCGACAGGGGGGCCAACACCGGGGAGCTGTTTTTT	CSDRGANTGELFF	TRBV29-1	TRBJ2-2
TGTGCCAGCAGCTTTGACCTAGCGGGGCAAGAGACCCAGTACTTC	CASSFDLAGQETQYF	TRBV5-6	TRBJ2-5
TGTGCCAGCAGACCCCTTCTCCCGGGACATGAAAAACTGTTTTTT	CASRPLLPGHEKLFF	TRBV6-1	TRBJ1-4
TGTGCCAGCAGAGTTCAGTTTAACACTGAAGCTTTCTTT	CASRVQFNTEAFF	TRBV6-4	TRBJ1-1
TGCAGTGCTAGAGATGTAAACAGGGTGGTCTACGAGCAGTACTTC	CSARDVNRVVYEQYF	TRBV20-1	TRBJ2-7
TGTGCCAGCAGGGGCCTTGGGGGGGGCAATGAGCAGTTCTTC	CASRGLGGGNEQFF	TRBV6-3	TRBJ2-1
TGTGCCAGCAAGCCCCCCGCCGGGACAGGGTGTGCAACGTTCAGCAATCAGCCCCAGCATTTT	CASKPPAGTGCATFSNQPQHF	TRBV27	TRBJ1-5
TGTGCCACCACCGGTAACAAACCTCACGATTGGACAGGGCGGTTTGAAGCTTTCTTT	CATTGNKPHDWTGRFEAFF	TRBV24-1	TRBJ1-1
TGCGCCAGCAGCTGTTCAACTGGGGAGAACACCGGGGAGCTGTTTTTT	CASSCSTGENTGELFF	TRBV5-1	TRBJ2-2
TGCGCCAGCAGCCCTAGGGCCCGACTAGCGGGTTTAACATTGGTTGAGCAGTTCTTC	CASSPRARLAGLTLVEQFF	TRBV4-1	TRBJ2-1
TGTGCCAGCAGCTTAGACCTAGGCTCTGGGGCCAACGTCCTGACTTTC	CASSLDLGSGANVLTF	TRBV7-2	TRBJ2-6
TGTGCCAGCAGCCAAGAACTTAGCCAGAGGGCCTACGAGCAGTACTTC	CASSQELSQRAYEQYF	TRBV14	TRBJ2-7
TGTGGTTGGGACAGGGGGGGCTACACCTTC	CGWDRGGYTF	TRBV12-3	TRBJ1-2
TGTGCCTGCCTTCACCCCCCGGGACCCGGGGCCTCCTACGAGCAGTACTTC	CACLHPPGPGASYEQYF	TRBV30	TRBJ2-7
TGTGCCAGCAGCGTAGTTAACAGGGCATCTGGAAACACCATATATTTT	CASSVVNRASGNTIYF	TRBV9	TRBJ1-3
TGTGCCAGCAGTCGGCTATCAGACAGGGAGCAGGGCCCGATCAATGAGCAGTTCTTC	CASSRLSDREQGPINEQFF	TRBV27	TRBJ2-1
TGTGCCAGCACAGTCAGGGGCCGGAATGAAAAACTGTTTTTT	CASTVRGRNEKLFF	TRBV6-1	TRBJ1-4
TGTGCCAGCAGCAGAACAGGGGGGAAGATCAACATTCAGTACTTC	CASSRTGGKINIQYF	TRBV9	TRBJ2-4
TGCAGTGCTACTGACAGGGGGCCCGGGCACCCCAAGTACGAGCAGTACTTC	CSATDRGPGHPKYEQYF	TRBV20-1	TRBJ2-7
TGTGCCAGCAGCCGGGGGGGGACCAATCAGCCCCAGCATTTT	CASSRGGTNQPQHF	TRBV7-4	TRBJ1-5
TGCAGTGCTAGCCAAGACAGGATGAGGATGTGGTACAATGAGCAGTTCTTC	CSASQDRMRMWYNEQFF	TRBV20-1	TRBJ2-1
TGTGCCAGCATGCAGAGGGGATCCAGCACAGATACGCAGTATTTT	CASMQRGSSTDTQYF	TRBV12-4	TRBJ2-3
TGTGCCAGCAGTTGGCTACCCCGGGGGGGAAGGTTGGCCTCCTACGAGCAGTACTTC	CASSWLPRGGRLASYEQYF	TRBV6-6	TRBJ2-7
TGTGCCAGCCCCGAGGTTTGCACCAGGTCTAACACCGGGGAGCTGTTTTTT	CASPEVCTRSNTGELFF	TRBV19	TRBJ2-2
TGTGCCAGCAGACGGCCGGATAATGAAAAACTGTTTTTT	CASRRPDNEKLFF	TRBV6-4	TRBJ1-4
TGTGCCAGCAGCTTGATCCTCCGGGGTACCAGGCCCTCTGGGGCCAACGTCCTGACTTTC	CASSLILRGTRPSGANVLTF	TRBV5-6	TRBJ2-6
TGTGCCAGCAGCCTCCTGGGAGAGGGTGGAAACACCATATATTTT	CASSLLGEGGNTIYF	TRBV7-3	TRBJ1-3
TGTGCCAGCAGCTTGGTCCTCAGGCTAAGGGTGCTTAGGAACACTGAAGCTTTCTTT	CASSLVLRLRVLRNTEAFF	TRBV5-4	TRBJ1-1
TGCAGTCCGGGACATGAAAAACTGTTTTTT	CSPGHEKLFF	TRBV20-1	TRBJ1-4
TGTGCCAGCAGCTTCTTTTTTAAATTAGCGGACGAGCAGTACTTC	CASSFFFKLADEQYF	TRBV7-4	TRBJ2-7
TGTGCCAGCAGAACCCGGGACGCCGAGCAGTACTTC	CASRTRDAEQYF	TRBV11-2	TRBJ2-7
TGTGCCAGCAGCGCGGTGGACAGCTCTTCCGCCTTC	CASSAVDSSSAF	TRBV13	TRBJ1-2
TGTGAACCGCTCTGCTACAATGAGCAGTTCTTC	CEPLCYNEQFF	TRBV12-3	TRBJ2-1
TGTGCCAGCAGTGACACCACCCTTGGGGACGAGCAGTACTTC	CASSDTTLGDEQYF	TRBV6-4	TRBJ2-7
TGCAGTGGCTTACGGCCTGGACGAGGCTACGAGCAGTACTTC	CSGLRPGRGYEQYF	TRBV20-1	TRBJ2-7
TGTGCCATCAAGACGGGGAGAAAGGCACCCCTCCACTTT	CAIKTGRKAPLHF	TRBV10-3	TRBJ1-6
TGCAGCGTTGAAGGGCAGCAGGGATCGAGGGGGTACACTGAAGCTTTCTTT	CSVEGQQGSRGYTEAFF	TRBV29-1	TRBJ1-1
TGTGCCAGCAGCGTCCGGGGGGAATACTATGGCTACACCTTC	CASSVRGEYYGYTF	TRBV13	TRBJ1-2
TGTGCCAGAGAAGGACAGGGTACCTACGAGCAGTACTTC	CAREGQGTYEQYF	TRBV19	TRBJ2-7
TGTGCCATACTTACGAACGGAAACACCATATATTTT	CAILTNGNTIYF	TRBV10-3	TRBJ1-3
TGTGCCAGCAGTGAGCACGCCCACGAGCAGTACTTC	CASSEHAHEQYF	TRBV6-1	TRBJ2-7
TGCGCCAGCAGCTTGGGTACCACAGGTGCTGAAAAACTGTTTTTT	CASSLGTTGAEKLFF	TRBV5-1	TRBJ1-4
TGTGCCACCAGTGAGGAGGAGGGGGTGACTGAAGCTTTCTTT	CATSEEEGVTEAFF	TRBV24-1	TRBJ1-1
TGTGCCAGCAGGTCTTCCATAAGGGGGCCCAGTGAGAACTATGGCTACACCTTC	CASRSSIRGPSENYGYTF	TRBV6-6	TRBJ1-2
TGTGCCAGCAGCTTCCGGACAGGGGTCTATGAGAGGGCCAACGTCCTGACTTTC	CASSFRTGVYERANVLTF	TRBV7-9	TRBJ2-6
TGTGCCAGCAGCCCCTACAAGCGGCAAGCCGGAGCGTCCCCCGGAAACACCATATATTTT	CASSPYKRQAGASPGNTIYF	TRBV25-1	TRBJ1-3
TGCGCCAGCACTCCCCACTGGAGCTATGGCTACACCTTC	CASTPHWSYGYTF	TRBV10-1	TRBJ1-2
TGTGCCAGCAAGGGTTCCCCTGAAGCTTTCTTT	CASKGSPEAFF	TRBV5-6	TRBJ1-1
TGTGCCAGCAGCGACCACGGCTATGGCTACACCTTC	CASSDHGYGYTF	TRBV28	TRBJ1-2
TGTGCCAGCAGAGGGGGAATCGTGAACACTGAAGCTTTCTTT	CASRGGIVNTEAFF	TRBV28	TRBJ1-1
TGTGCCAGCAGTTTCTGGTGGGGGGACAGTGGCTACACCTTC	CASSFWWGDSGYTF	TRBV12-4	TRBJ1-2
TGTGCCAGCAGCGTCAGCCCCAGCGGGATGAACACTGAAGCTTTCTTT	CASSVSPSGMNTEAFF	TRBV9	TRBJ1-1
TGTGCCAGCAGCCAAGCTGGCCGGGGCTACGAGCAGTACTTC	CASSQAGRGYEQYF	TRBV3-1	TRBJ2-7
TGTGCCAGCAGCTCATCTACAGGGGGATCGCCCCAGCATTTT	CASSSSTGGSPQHF	TRBV7-9	TRBJ1-5
TGTGCCAGCAGTAAGGGTAAAAGGAACACTGAAGCTTTCTTT	CASSKGKRNTEAFF	TRBV6-3	TRBJ1-1
TGTGCCAGCAGCCAAGATAGGTTGCCTAGGGAGGAGCTGTTTTTT	CASSQDRLPREELFF	TRBV14	TRBJ2-2
TGCGCCAGCAGCTTGAGGCTGGGGGGGCAGAATCCCAGCAATCAGCCCCAGCATTTT	CASSLRLGGQNPSNQPQHF	TRBV5-1	TRBJ1-5
TGTGCCAGCTCACCACAATCGGGTGTGAACACTGAAGCTTTCTTT	CASSPQSGVNTEAFF	TRBV18	TRBJ1-1
TGTGCCAGCAGACTTCGCGGGACAGGGAATTCGGGAGAAGCTTTCTTT	CASRLRGTGNSGEAFF	TRBV27	TRBJ1-1
TGCGCCAGCACGTCCCCGGCAAGGCCTGGGGCCAACGTCCTGACTTTC	CASTSPARPGANVLTF	TRBV10-1	TRBJ2-6
TGTGCCAGCAGCTTACGACCTCAAGGGGGGGCGTTCTCCTACGAGCAGTACTTC	CASSLRPQGGAFSYEQYF	TRBV7-9	TRBJ2-7
TGCAGTGCTCAACACAGGGGCTACAATGAGCAGTTCTTC	CSAQHRGYNEQFF	TRBV20-1	TRBJ2-1
TGTGCCAGCAGCTTACTGGGGGCTACTGAAGCTTTCTTT	CASSLLGATEAFF	TRBV11-2	TRBJ1-1
TGTGCCAGCAGCCAAGCCTCTCCGGGGAGATTAAGGGTGGACATTCAGTACTTC	CASSQASPGRLRVDIQYF	TRBV3-1	TRBJ2-4
TGTGCCAGCAGTTTATTGCAGGGTACTAACTATGGCTACACCTTC	CASSLLQGTNYGYTF	TRBV12-4	TRBJ1-2
TGTGCCAGCAGGGACAGGGGCTACGAGCAGTACTTC	CASRDRGYEQYF	TRBV6-4	TRBJ2-7
TGTGCCATCACCGTGTTAACTAGCGGGAGACAGGTAGAGAACACCGGGGAGCTGTTTTTT	CAITVLTSGRQVENTGELFF	TRBV10-3	TRBJ2-2
TGTGCCAGCAATTCGGACAGGGGCAATCAGCCCCAGCATTTT	CASNSDRGNQPQHF	TRBV9	TRBJ1-5
TGTGCCTCTCGAGGGGACAATCAGCCCCAGCATTTT	CASRGDNQPQHF	TRBV7-2	TRBJ1-5
TGTGCCAGCAGCGGGGGGGGGACCGGGGAGCTGTTTTTT	CASSGGGTGELFF	TRBV13	TRBJ2-2
TGTGCCAGCAGCACTTCGGAACAATACAATGAGCAGTTCTTC	CASSTSEQYNEQFF	TRBV11-2	TRBJ2-1
TGTGCCAGCAGTATTCTCCGTTTATTAATGGGCCAGGGCAATCAGCCCCAGCATTTT	CASSILRLLMGQGNQPQHF	TRBV6-6	TRBJ1-5
TGTGCCAGCAGCGTAGTGACTGCATTGCACCCATTCTTC	CASSVVTALHPFF	TRBV9	TRBJ2-1
TGCGCCAGACGGGGGACTGAAGCTTTCTTT	CARRGTEAFF	TRBV5-1	TRBJ1-1
TGTGCTAGTGGTTTGGTCAGGGTCCGGCAAGGGCCGTATAGCAATCAGCCCCAGCATTTT	CASGLVRVRQGPYSNQPQHF	TRBV12-5	TRBJ1-5
TGTGCCATCAGTGAAAAAGACCAATCTGCAGATACGCAGTATTTT	CAISEKDQSADTQYF	TRBV10-3	TRBJ2-3
TGTGCCAGCAGTCCTACCGGCCTCCCAGGGCTGTATGGCTACACCTTC	CASSPTGLPGLYGYTF	TRBV12-4	TRBJ1-2
TGTGCCACCAGTGACCGGACAGGAGCTTTCTTT	CATSDRTGAFF	TRBV24-1	TRBJ1-1
TGTGCCAGCACCCCTTCGGGGCGCGCCTACGAGCAGTACTTC	CASTPSGRAYEQYF	TRBV6-2	TRBJ2-7
TGTGCCAGCAGTTACCTGAAAACAGATACGCAGTATTTT	CASSYLKTDTQYF	TRBV5-4	TRBJ2-3
TGCGCCAGCAGCTTGTTACAGGGGGCCAACTACGAGCAGTACTTC	CASSLLQGANYEQYF	TRBV5-1	TRBJ2-7
TGTGCCAGCAGCGACACAGACAGGGGTAAGTACTTCCCTAATGAAAAACTGTTTTTT	CASSDTDRGKYFPNEKLFF	TRBV9	TRBJ1-4
TGCAGTGCTAGAGATGAGCGGACAGGGCGGTACGAGCAGTACTTC	CSARDERTGRYEQYF	TRBV20-1	TRBJ2-7
TGTGCCATTAGGGCCCCCTCCTACAATGAGCAGTTCTTC	CAIRAPSYNEQFF	TRBV12-4	TRBJ2-1
TGTGCCAGCAGTGGAGAAGACAGGGGGAACACTGAAGCTTTCTTT	CASSGEDRGNTEAFF	TRBV25-1	TRBJ1-1
TGTGCCAGCAGCCGACCGGGACAGGGCTTAAGAGGGACGAGGGGATACACCATATATTTT	CASSRPGQGLRGTRGYTIYF	TRBV7-6	TRBJ1-3
TGTGCCAGCAGCCAACCTTGGACAGGTGGGGACTATGGCTACACCTTC	CASSQPWTGGDYGYTF	TRBV14	TRBJ1-2
TGTGCCAGCAGTTACACCCCGGACTACAATGAGCAGTTCTTC	CASSYTPDYNEQFF	TRBV6-5	TRBJ2-1
TGTGCCAGCAGTCACGACCGTCATAGCAATCAGCCCCAGCATTTT	CASSHDRHSNQPQHF	TRBV12-4	TRBJ1-5
TGTGCCAGCAGCCTAAGTCCGACAGGGTTCAATGAGCAGTTCTTC	CASSLSPTGFNEQFF	TRBV11-3	TRBJ2-1
TGTGCTAGTGGTTCCGAGGCGGGGGGCTACGAGCAGTACTTC	CASGSEAGGYEQYF	TRBV12-5	TRBJ2-7
TGCGCCAGCAGCCAACGACGTTTCTACGAGCAGTACTTC	CASSQRRFYEQYF	TRBV4-3	TRBJ2-7
TGTCTCGGGCGCGGGACAAAGGAGACCCAGTACTTC	CLGRGTKETQYF	TRBV7-9	TRBJ2-5
TGTGCCAGCAGCGTAAGTCACGCCCTTAAGATGAACACTGAAGCTTTCTTT	CASSVSHALKMNTEAFF	TRBV13	TRBJ1-1
TGTGCCAGCTCACGGTTTATAATGAGCTCCTACGAGCAGTACTTC	CASSRFIMSSYEQYF	TRBV18	TRBJ2-7
TGTGCCAGCACCTCGGGCGACCAAGATAGCAATCAGCCCCAGCATTTT	CASTSGDQDSNQPQHF	TRBV28	TRBJ1-5
TGTGCCAGCAGCCACCAGTGGGACCAAGTAAGGATCCTTGGCTACACCTTC	CASSHQWDQVRILGYTF	TRBV7-2	TRBJ1-2
TGTGCCAGCAGCTTACCCCAGGGGGGGGGGTGGCGGGGGTTCTTC	CASSLPQGGGWRGFF	TRBV11-3	TRBJ2-1
TGCGCCAGCAGCTTGGTTGTCCGCCGGCGACCCCCCTTC	CASSLVVRRRPPF	TRBV5-1	TRBJ2-5
TGTGCCAGCAGCGTAGCTAGGGGGACAGGCGGCTACACCTTC	CASSVARGTGGYTF	TRBV9	TRBJ1-2
TGCAGCGTTGCCAGTGAGCGAGCACAGGGGTGTCACGAGCAGTACTTC	CSVASERAQGCHEQYF	TRBV29-1	TRBJ2-7
TGTGCCAGCAGCCAGTCCGAGGTCACTGAAGCTTTCTTT	CASSQSEVTEAFF	TRBV3-1	TRBJ1-1
TGTGCCAGCAGCAGGATTAGGCCTGGGTGCACCACTGAAGCTTTCTTT	CASSRIRPGCTTEAFF	TRBV7-3	TRBJ1-1
TGTGCCAGCAGCTTAGCGATTGCCGGGACAGGGCCAATTTATGGCTACACCTTC	CASSLAIAGTGPIYGYTF	TRBV7-9	TRBJ1-2
TGTGCCAGCAGCGCCAAGACAGGGGCGTGTTTGGAAGAGACCCAGTACTTC	CASSAKTGACLEETQYF	TRBV5-6	TRBJ2-5
TGTGCCAGCTCACCATCGCAGGGGGGAGTAAACGAGCAGTACTTC	CASSPSQGGVNEQYF	TRBV18	TRBJ2-7
TGTGCCAGCAGTGGTTTTCGACTGCCGTACCCCAACTATGGCTACACCTTC	CASSGFRLPYPNYGYTF	TRBV27	TRBJ1-2
TGTGCCAGCAGCTTCCCCCCTCTCGGCTACGAGCAGTACTTC	CASSFPPLGYEQYF	TRBV7-9	TRBJ2-7
TGCGCCATGGGGGAACTGTGGCAAGAGACCCAGTACTTC	CAMGELWQETQYF	TRBV5-1	TRBJ2-5
TGTGCCAGCAAAGGGACCTCCTCGATAACTAGCACAGATACGCAGTATTTT	CASKGTSSITSTDTQYF	TRBV14	TRBJ2-3
TGTGCCAGCAGTATCGGTAGGAACACTGAAGCTTTCTTT	CASSIGRNTEAFF	TRBV28	TRBJ1-1
TGTGCCAGCAGCACCGCAGGCGACACCATATATTTT	CASSTAGDTIYF	TRBV7-4	TRBJ1-3
TGTGCCTGTTGTGGTAATAGTCGGGACACTATCGAGCAGTACTTC	CACCGNSRDTIEQYF	TRBV30	TRBJ2-7
TGTGCCAGCAGTGAACCGGGACAGAACTACGAGCAGTACTTC	CASSEPGQNYEQYF	TRBV6-1	TRBJ2-7
TGTGCCAGCTCACCTCTGGAGGTGTACGAGCAGTACTTC	CASSPLEVYEQYF	TRBV18	TRBJ2-7
TGTGCCAGCAGCAGTCACAACGGGTCCTACGAGCAGTACTTC	CASSSHNGSYEQYF	TRBV7-4	TRBJ2-7
TGTGCCAGCAGTTACTGGTGGCAAGATACGCAGTATTTT	CASSYWWQDTQYF	TRBV6-2	TRBJ2-3
TGTGCCAGCAGTGAAAGCCCCATTAACTACGAGCAGTACTTC	CASSESPINYEQYF	TRBV25-1	TRBJ2-7
TGTGCCAGCAGTTTAGCCCCGCGGGGGGGGGGGGTCACCGGGGAGCTGTTTTTT	CASSLAPRGGGVTGELFF	TRBV12-4	TRBJ2-2
TGTGCCTGGAGTGTAAACGTCGGAACTAATGAAAAACTGTTTTTT	CAWSVNVGTNEKLFF	TRBV30	TRBJ1-4
TGTGCCAGCAGTACCACCCCGCCAACGCCGTCACCCCTCCACTTT	CASSTTPPTPSPLHF	TRBV6-1	TRBJ1-6
TGTGCCAGCAGCTTAGGCCAGTTTGCGCCCCAGGGAGTTGAGCAGTTCTTC	CASSLGQFAPQGVEQFF	TRBV7-9	TRBJ2-1
TGTGCCAGCAGCGTAGACCCACCTCTGACAGATACGCAGTATTTT	CASSVDPPLTDTQYF	TRBV7-3	TRBJ2-3
TGTGCCAGCAGCTCGCGAATGACTCACAGGGTGGGCCTTGGCTACGAGCAGTACTTC	CASSSRMTHRVGLGYEQYF	TRBV11-3	TRBJ2-7
TGTGCCAACGACAAAATAGAGCAGTACTTC	CANDKIEQYF	TRBV27	TRBJ2-7
TGTGCCAGCAGCCGGGACCGGACCACTGAAGCTTTCTTT	CASSRDRTTEAFF	TRBV13	TRBJ1-1
TGTGCCAGCTCAGGACTAACCGGGGAGCTGTTTTTT	CASSGLTGELFF	TRBV18	TRBJ2-2
TGCGCCAGCAGCCTCATCACTATGTACCAAGAGACCCAGTACTTC	CASSLITMYQETQYF	TRBV10-1	TRBJ2-5
TGTGCCATCAGTAGGCCTGACTACAATGAGCAGTTCTTC	CAISRPDYNEQFF	TRBV10-3	TRBJ2-1
TGTGCCAGCACCCAGGATCAGCCCCAGCATTTT	CASTQDQPQHF	TRBV2	TRBJ1-5
TGTGCCAGCAGCTCATCACCCCCGCAATCACTAAGGTATAGCAATCAGCCCCAGCATTTT	CASSSSPPQSLRYSNQPQHF	TRBV9	TRBJ1-5
TGCAGCCCGTTCAGGTTTCAAGATGAGCAGTTCTTC	CSPFRFQDEQFF	TRBV20-1	TRBJ2-1
TGTGCGACAGGCCCCTCTGGGGCCAACGTCCTGACTTTC	CATGPSGANVLTF	TRBV15	TRBJ2-6
TGCGCCAGCAGTGAAGCCGGGACTAGCGGGGGGGCAGATACGCAGTATTTT	CASSEAGTSGGADTQYF	TRBV10-2	TRBJ2-3
TGTGCCAGCGGGGAGTCAGATACGCAGTATTTT	CASGESDTQYF	TRBV7-3	TRBJ2-3
TGCGCCAGCAGCTTGGGAGAGTCCAGACAGGATGCTGAAAAACTGTTTTTT	CASSLGESRQDAEKLFF	TRBV5-1	TRBJ1-4
TGCAGTGCGTGGATTGTTCAGGGCGACGAGCAGTACTTC	CSAWIVQGDEQYF	TRBV20-1	TRBJ2-7
TGTGCCAGCAGCAAGGGACAGGGCGATATTTCCTACGAGCAGTACTTC	CASSKGQGDISYEQYF	TRBV7-9	TRBJ2-7
TGTGCCAGCTCACCCTTCAACTTACAGGCTAACTATGGCTACACCTTC	CASSPFNLQANYGYTF	TRBV18	TRBJ1-2
TGTGCCAGCAGCTTAGTTCCAGGACTAGCGGGCGAGCAGTACTTC	CASSLVPGLAGEQYF	TRBV7-8	TRBJ2-7
TGTGCCAGCAGCTTAGCAATCGTCTTGATAAAACTAACCTTCATGAACACTGAAGCTTTCTTT	CASSLAIVLIKLTFMNTEAFF	TRBV7-4	TRBJ1-1
TGCAGTGCTCGTTACCGCCCAGGCCGGGCTCGGAATTGTACCCCCTACAATGAGCAGTTCTTC	CSARYRPGRARNCTPYNEQFF	TRBV20-1	TRBJ2-1
TGTGCCAGCAGTGACACTAGCGGGCGCGCGAACACCGGGGAGCTGTTTTTT	CASSDTSGRANTGELFF	TRBV6-4	TRBJ2-2
TGTGCCTGGAGTGTATCGGCCAACAGGGGGCGTGAAGAGACCCAGTACTTC	CAWSVSANRGREETQYF	TRBV30	TRBJ2-5
TGTGCCAGCAGCCCCGGCCGGACAGGAGGGAGCTCCTATAATTCACCCCTCCACTTT	CASSPGRTGGSSYNSPLHF	TRBV28	TRBJ1-6
TGTGCCACCAGTGATCGTGAGGGGAGCGGGCCCCAGCATTTT	CATSDREGSGPQHF	TRBV24-1	TRBJ1-5
TGTGCCAGCAATGGAGTCCCGGCGACTAGCGGGTTGGGCGGGCGCTCCTACAATGAGCAGTTCTTC	CASNGVPATSGLGGRSYNEQFF	TRBV6-4	TRBJ2-1
TGTGCCAGCAGGACCAGGGGCACTGAGCAGTTCTTC	CASRTRGTEQFF	TRBV6-5	TRBJ2-1
TGTGCCAGCAGCTTCCGAGGGGTACAAAACATTCAGTACTTC	CASSFRGVQNIQYF	TRBV13	TRBJ2-4
TGTGCCACCATTGACTATGAGCAGTACTTC	CATIDYEQYF	TRBV15	TRBJ2-7
TGTGCCAGCAGCAGAAAGGCCAGGGGACCAGGGGCCCGCACTGAAGCTTTCTTT	CASSRKARGPGARTEAFF	TRBV7-3	TRBJ1-1
TGTGCCAGCACCCCCTCCGGACAGAGTCTCACCGGGGAGCTGTTTTTT	CASTPSGQSLTGELFF	TRBV6-6	TRBJ2-2
TGCAGTGCTGCTAGCCCACCCTACGAGCAGTACTTC	CSAASPPYEQYF	TRBV20-1	TRBJ2-7
TGTGCCAGCAGCCAAGGGAACCGGACAGGGATCGAGACCCAGTACTTC	CASSQGNRTGIETQYF	TRBV3-1	TRBJ2-5
TGTGCTCACTTGACTAGCGCCGGGGAGCTGTTTTTT	CAHLTSAGELFF	TRBV27	TRBJ2-2
TGTGCCAGCAGAATAACCGTTGACAGGGTTTATGGCCAGACCTACGAGCAGTACTTC	CASRITVDRVYGQTYEQYF	TRBV7-7	TRBJ2-7
TGTGCCAGCAGCCCCTCCGAAGGTTGGGCAAACACCATATATTTT	CASSPSEGWANTIYF	TRBV14	TRBJ1-3
TGTGCCAGCAGCGTCAACGCTCCTAGTTTACGGGACTCCCGAGGCGGGGAGCTGTTTTTT	CASSVNAPSLRDSRGGELFF	TRBV7-3	TRBJ2-2
TGTGCCACCAGCAGAGTGAAAGGAATGAGGAGGAGGGGAGGCTACACCTTC	CATSRVKGMRRRGGYTF	TRBV15	TRBJ1-2
TGTGCCTGGAGTGTACAAGAGGCGGGGGTCTACGAGCAGTACTTC	CAWSVQEAGVYEQYF	TRBV30	TRBJ2-7
TGTGCCAGCAGCACAGAGTTAGCGGGCGGGTCCGGGGAGCTGTTTTTT	CASSTELAGGSGELFF	TRBV13	TRBJ2-2
TGTGCCAGCAGCCAAGATTGCTCGGCGGACACTGAAGCTTTCTTT	CASSQDCSADTEAFF	TRBV3-1	TRBJ1-1
TGCAGTGCTGAGTCAGCAGGCGACAGGGGGGCCTACAATGAGCAGTTCTTC	CSAESAGDRGAYNEQFF	TRBV20-1	TRBJ2-1
TGCGCCAGCAGCCAAGGGGGTTGGGGAGTCAACTATGGCTACACCTTC	CASSQGGWGVNYGYTF	TRBV4-1	TRBJ1-2
TGTGCCAGCAGCCGGAACCTTGCACTAGCGGAGGGTTTCGGACCAGAGACCCAGTACTTC	CASSRNLALAEGFGPETQYF	TRBV9	TRBJ2-5
TGTGCCAGCAGCCCGCAACGGACTAGCGGGGATGGGGAGCTGTTTTTT	CASSPQRTSGDGELFF	TRBV11-3	TRBJ2-2
TGTGCCAGTAGGGGCCGATGGGGGAATAACTATGGCTACACCTTC	CASRGRWGNNYGYTF	TRBV19	TRBJ1-2
TGCGCCAGCAGCCTTTATCGGTCCGGGGAGCTGTTTTTT	CASSLYRSGELFF	TRBV5-1	TRBJ2-2
TGTGCCAGCAGCCAAGAGTTGGGTTTGCTTGAGCAGTTCTTC	CASSQELGLLEQFF	TRBV3-1	TRBJ2-1
TGCGCCAGCATAAACGGGTTACTAGCGGGAGGGTTTTTTAACTATTTT	CASINGLLAGGFFNYF	TRBV10-1	TRBJ2-3
TGTGCCACAGGGAGGAAGAATGAGCAGTTCTTC	CATGRKNEQFF	TRBV9	TRBJ2-1
TGCGCCATAAGACAGTTGAACACTGAAGCTTTCTTT	CAIRQLNTEAFF	TRBV5-1	TRBJ1-1
TGTGCCAGCAGTGAATACGGTCGACGCCACTATGGCTACACCTTC	CASSEYGRRHYGYTF	TRBV25-1	TRBJ1-2
TGTGCCAGCAGTTACTCGGGGGGGGACTCCTACGAGCAGTACTTC	CASSYSGGDSYEQYF	TRBV6-5	TRBJ2-7
TGTGCCAGCAGTGAACAGTGGGGCTACGAGCAGTACTTC	CASSEQWGYEQYF	TRBV2	TRBJ2-7
TGCAGTGCTGATAGTCTCTGGTCGCAAGAGACCCAGTACTTC	CSADSLWSQETQYF	TRBV20-1	TRBJ2-5
TGTGCCAGCAGCTTAGTGGCGACAGGGGCGGAGTCCCAGCATTTT	CASSLVATGAESQHF	TRBV7-9	TRBJ1-5
TGTGCCAGCAGACCCCGGGGTTCTGGTGAAAAACTGTTTTTT	CASRPRGSGEKLFF	TRBV28	TRBJ1-4
TGTGCCAGCAGTTGGGAGGCCCGCTATGGCTACACCTTC	CASSWEARYGYTF	TRBV11-2	TRBJ1-2
TGCGCCAGCAAAAAGACTAGCGGCCACTACGAGCAGTACTTC	CASKKTSGHYEQYF	TRBV5-1	TRBJ2-7
TGTGCCAGCAGTTTGGCGCGGGGCGAAGCTTTCTTT	CASSLARGEAFF	TRBV12-3	TRBJ1-1
TGTGCCAGCCGCACGGACCGAATCAGGGGGCGTGGTCTTCAGCCCCAGCATTTT	CASRTDRIRGRGLQPQHF	TRBV11-3	TRBJ1-5
TGTGCCAGCAGCGCACCCCGGCGCTACACCTTC	CASSAPRRYTF	TRBV13	TRBJ1-2
TGTGCCACCTCTTATGCCGAGCAGTACTTC	CATSYAEQYF	TRBV24-1	TRBJ2-7
TGTGCCAGCAGCAGACCGAGGGGACAGGGCGTGGGGCCCTCCTACGAGCAGTACTTC	CASSRPRGQGVGPSYEQYF	TRBV7-4	TRBJ2-7
TGTGCCAGCAGCTTAGATCCCGAGAGTAGGGGACAGAACACTGAAGCTTTCTTT	CASSLDPESRGQNTEAFF	TRBV11-2	TRBJ1-1
TGTGCCAGCAGCTTCGTAGGAGGGGGGCCAAAGCCCCAGCATTTT	CASSFVGGGPKPQHF	TRBV7-3	TRBJ1-5
TGCGCCAGCAGTGAGTCAGGACAGGGAGAGACCCAGTACTTC	CASSESGQGETQYF	TRBV10-1	TRBJ2-5
TGTGCCAGCCTGTACTACAATGAGCAGTTCTTC	CASLYYNEQFF	TRBV18	TRBJ2-1
TGTGCCTGGACCCAGTTTTTCTGGTATGGCTACACCTTC	CAWTQFFWYGYTF	TRBV30	TRBJ1-2
TGTGCCAGCAGCACAATTCTCTGGGACAGATTCTTGGGAGGCTACACCTTC	CASSTILWDRFLGGYTF	TRBV7-8	TRBJ1-2
TGTGCCAGCAGCTTACGACTAGCGGGAAGCAATGAGCAGTTCTTC	CASSLRLAGSNEQFF	TRBV13	TRBJ2-1
TGTGCCAGCAGCTTTTATCCGGGTGGGGGAGGAACAACTAATGAAAAACTGTTTTTT	CASSFYPGGGGTTNEKLFF	TRBV7-2	TRBJ1-4
TGTGCCAGCAGCTTAGGAGGGCCTGCCCAGGGGGCGCATGATCATGAAGCTTTCTTT	CASSLGGPAQGAHDHEAFF	TRBV7-4	TRBJ1-1
TGTGCCAGCAGTTACTCGCTACCGGGGGCCGAGTACTTC	CASSYSLPGAEYF	TRBV6-8	TRBJ2-7
TGCAGTGCTTCCCCCGGACTATTGATTGGCGATCAGCCCCAGCATTTT	CSASPGLLIGDQPQHF	TRBV20-1	TRBJ1-5
TGTGCCAGCAGCGTGCAGGTTAAACTGTTTTTT	CASSVQVKLFF	TRBV9	TRBJ1-4
TGCGCCAGCAGCCAAGATATTCACAACCCCGACGTCACAGATACGCAGTATTTT	CASSQDIHNPDVTDTQYF	TRBV4-3	TRBJ2-3
TGTGCCAGCACTAGCTCCAGCTCCTACAATGAGCAGTTCTTC	CASTSSSSYNEQFF	TRBV2	TRBJ2-1
TGTGCCACCAGCAGAGTCTGGGACGGAAGGGGTCCCTACGAGCAGTACTTC	CATSRVWDGRGPYEQYF	TRBV15	TRBJ2-7
TGTGCCAGCAGTCATAGGGCGGGAGGTTCACCCCTCCACTTT	CASSHRAGGSPLHF	TRBV28	TRBJ1-6
TGCAGTGCGATCCGACAGGGCACCGGGGAGCTGTTTTTT	CSAIRQGTGELFF	TRBV20-1	TRBJ2-2
TGTGCCAGTACGGACAGGATCGAGCAGTACTTC	CASTDRIEQYF	TRBV6-1	TRBJ2-7
TGTGCCAGCAGCTTTAACTCCCAATGTAGACCGCCCCAGCATTTT	CASSFNSQCRPPQHF	TRBV7-9	TRBJ1-5
TGTGCCAGCAGGGGGAGCCTGGGGTGCATTCAGTACTTC	CASRGSLGCIQYF	TRBV28	TRBJ2-4
TGCGCCAGCAGCTTGGGGTTCGTGGGGTATAATTCACCCCTCCACTTT	CASSLGFVGYNSPLHF	TRBV5-1	TRBJ1-6
TGTGCCAGCAGCCATCAGGGGTCATACGAGCAGTACTTC	CASSHQGSYEQYF	TRBV14	TRBJ2-7
TGTGCCGAAGGGGGGACAGGCGGGAGTAACTATGGCTACACCTTC	CAEGGTGGSNYGYTF	TRBV27	TRBJ1-2
TGTGCCAGCAGCGCCTCCGGGAAGTCCGACGAGCAGTACTTC	CASSASGKSDEQYF	TRBV3-1	TRBJ2-7
TGTGCCAGCAGCGGTTTCCGGAAGCCCCAGCATTTT	CASSGFRKPQHF	TRBV13	TRBJ1-5
TGTGCCAGCAGTGAGGGGGGGGCGCAGTTCTTC	CASSEGGAQFF	TRBV25-1	TRBJ2-1
TGTGCCAGCGTCCCCTCGCCTGAATTCCAGGGAGATACGCAGTATTTT	CASVPSPEFQGDTQYF	TRBV27	TRBJ2-3
TGTGCCAGCTCCCCACAGGGCACTTATAGCAATCAGCCCCAGCATTTT	CASSPQGTYSNQPQHF	TRBV18	TRBJ1-5
TGCAGCGTTAGGATTTGGGGGGGCAACAGGGACACCGGGGAGCTGTTTTTT	CSVRIWGGNRDTGELFF	TRBV29-1	TRBJ2-2
TGTGCCAGCAAATGGGAGACAGCATTATTGAACACTGAAGCTTTCTTT	CASKWETALLNTEAFF	TRBV27	TRBJ1-1
TGTGCCAGCAGTCCCGACTGGGACAGAGCTAACTATGGCTACACCTTC	CASSPDWDRANYGYTF	TRBV6-1	TRBJ1-2
TGCGCCAGCAGCCAGACCCGACAGGAACGCAGGAATGGCTACACCTTC	CASSQTRQERRNGYTF	TRBV4-3	TRBJ1-2
TGTGCCAGCACCGGCCCCAGGGGCCTAGAAGCTTTCTTT	CASTGPRGLEAFF	TRBV7-9	TRBJ1-1
TGCAGTGCTCGGGAGACAGGGGATTACGAGCAGTACTTC	CSARETGDYEQYF	TRBV20-1	TRBJ2-7
TGTGCTAGTGGTTTAAGACGCCTGGCCCTGAGGAACACCGGGGAGCTGTTTTTT	CASGLRRLALRNTGELFF	TRBV12-5	TRBJ2-2
TGTGCCTGGAGTGTTTCCCGTTACAGGCCGGGGAATCTAGCTTTCTTT	CAWSVSRYRPGNLAFF	TRBV30	TRBJ1-1
TGCGCCAGCAGAGCAGGACAAAGGTATGGCTACACCTTC	CASRAGQRYGYTF	TRBV5-1	TRBJ1-2
TGCGCCAGCAGTGACGGTCCGAGATGGGGTCCTACGGCCTACGAGCAGTACTTC	CASSDGPRWGPTAYEQYF	TRBV10-1	TRBJ2-7
TGTGCCAGCACGGGGGCTCTATGGGCAGATACGCAGTATTTT	CASTGALWADTQYF	TRBV11-3	TRBJ2-3
TGCAGTGCTACATTGGGGGGGGTGCCCGATCAGCCCCAGCATTTT	CSATLGGVPDQPQHF	TRBV20-1	TRBJ1-5
TGTGCCAGCAGCGATCCCGGACAGGGGAACACTGAAGCTTTCTTT	CASSDPGQGNTEAFF	TRBV7-3	TRBJ1-1
TGTGCCAGCAGTAATCTGGGCCCGGGCTTAGACGAGCAGTACTTC	CASSNLGPGLDEQYF	TRBV27	TRBJ2-7
TGTGCCAGCAGCTTAAATTCCATGACAGGAAAAGAGACCCAGTACTTC	CASSLNSMTGKETQYF	TRBV7-3	TRBJ2-5
TGTGCCAGCAGTTTCTACAGGAAAACCTCTGGAAACACCATATATTTT	CASSFYRKTSGNTIYF	TRBV6-5	TRBJ1-3
TGTGCCAGTAGTATCATAGGGGGGGGGGAGATGAGCTCCTACAATGAGCAGTTCTTC	CASSIIGGGEMSSYNEQFF	TRBV19	TRBJ2-1
TGTGCCAGCAGTGCCATCCTAAGACACGAGCAGTACTTC	CASSAILRHEQYF	TRBV6-4	TRBJ2-7
TGTGCCAGCACCCCAGGGACTAGCGGGGTTGTCGAGCAGTTCTTC	CASTPGTSGVVEQFF	TRBV6-5	TRBJ2-1
TGTGCCAGCAGCTTGGTAAAGGGGAACTATGGCTACACCTTC	CASSLVKGNYGYTF	TRBV11-2	TRBJ1-2
TGTGCCAGCAGTGAAAACTTAGGGGGGGGAGGATATAGCAATCAGCCCCAGCATTTT	CASSENLGGGGYSNQPQHF	TRBV6-1	TRBJ1-5
TGCGCCAGCAGTTGGTCGGGGACAGACGAGACCCAGTACTTC	CASSWSGTDETQYF	TRBV10-1	TRBJ2-5
TGTGCCAGCAGCCAGGGGATTGAAAACATTCAGTACTTC	CASSQGIENIQYF	TRBV13	TRBJ2-4
TGTGCCAGCAGCCCCGATAAACGGCCGGAAGAGACCCAGTACTTC	CASSPDKRPEETQYF	TRBV5-4	TRBJ2-5
TGCGCCAGCAGCCAAGACCTTCCGCTCGCGGACAGGGCAGATTCACCCCTCCACTTT	CASSQDLPLADRADSPLHF	TRBV4-1	TRBJ1-6
TGTGCCAGCAGTGCCCGGGTACCCGGCACAGATACGCAGTATTTT	CASSARVPGTDTQYF	TRBV6-5	TRBJ2-3
TGTGCCAGCAGCTTGAAGTCCCATTGTGGGGGCGGGTCTAAAGAGACCCAGTACTTC	CASSLKSHCGGGSKETQYF	TRBV5-5	TRBJ2-5
TGTGCCAGCAGTTTAGCAGTACCGCCGGGACTAGGGGACAATGAGCAGTTCTTC	CASSLAVPPGLGDNEQFF	TRBV27	TRBJ2-1
TGTGCCAGCAGTGAATCCAGTTGTCTCTATGGCTACACCTTC	CASSESSCLYGYTF	TRBV6-1	TRBJ1-2
TGCAGCGTTGAAGCCCACAAACTAGCGGGAGGGCGACCCACAGATACGCAGTATTTT	CSVEAHKLAGGRPTDTQYF	TRBV29-1	TRBJ2-3
TGTGCCAGCAGCTCGGGATATCACTGCAGGGGGCGGGGGGCCAACGTCCTGACTTTC	CASSSGYHCRGRGANVLTF	TRBV11-2	TRBJ2-6
TGTGCCAGCAGCTTAGGCCGGGGTCCCACCACCGGGGAGCTGTTTTTT	CASSLGRGPTTGELFF	TRBV11-2	TRBJ2-2
TGTGCCAGCAGATCTGGACAGGGGGGGGGCAATGAAAAACTGTTTTTT	CASRSGQGGGNEKLFF	TRBV28	TRBJ1-4
TGCAGTGCTAGGGTTGGGGACAGGGGCAGAGAGACCCAGTACTTC	CSARVGDRGRETQYF	TRBV20-1	TRBJ2-5
TGTGCCAGCAGCCAAGATCTTTTGACCGGGACAGGGCTCAGCTCCTATAATTCACCCCTCCACTTT	CASSQDLLTGTGLSSYNSPLHF	TRBV4-2	TRBJ1-6
TGTGCCAGCAGCTGGGCCGGACAGGGGGCAACCGGCGGCACAGATACGCAGTATTTT	CASSWAGQGATGGTDTQYF	TRBV11-2	TRBJ2-3
TGTGCCAGTAATCGCGACAGGGGCCAGAGCAATCAGCCCCAGCATTTT	CASNRDRGQSNQPQHF	TRBV6-1	TRBJ1-5
TGTGCCAGCTCACCAAGCCGGGAATACTATGGCTACACCTTC	CASSPSREYYGYTF	TRBV18	TRBJ1-2
TGTGCCACCAGCAGAGGCTTCGTGCTTCAGGACAAGTATAATTCACCCCTCCACTTT	CATSRGFVLQDKYNSPLHF	TRBV15	TRBJ1-6
TGTGCCAGCAGTGTACCCCCCATAAAGGCATCTTTGTCACCCCTCCACTTT	CASSVPPIKASLSPLHF	TRBV2	TRBJ1-6
TGTGCCAGCAGCTTAATCGACATAAGGGAGAGGAAGACTGAAGCTTTCTTT	CASSLIDIRERKTEAFF	TRBV7-9	TRBJ1-1
TGTGCCAGCCGGCCAAGACCCATTAATGAGCAGTTCTTC	CASRPRPINEQFF	TRBV13	TRBJ2-1
TGTGCCACCAGTGGCTTCGGAGCCTTACTAGCCAAAAACATTCAGTACTTC	CATSGFGALLAKNIQYF	TRBV24-1	TRBJ2-4
TGTGCCAGCAGATTTAGGGGGCGGCCCCAGCATTTT	CASRFRGRPQHF	TRBV7-9	TRBJ1-5
TGCGCCAGCAGCTCAATAGATCGGGGAAGCTCCTACAATGAGCAGTTCTTC	CASSSIDRGSSYNEQFF	TRBV5-1	TRBJ2-1
TGTGCCAGCAGTGCCGGACTAGCGCCCGTCTACAATGAGCAGTTCTTC	CASSAGLAPVYNEQFF	TRBV6-5	TRBJ2-1
TGCAGTGCTAGGCGGACAGGGGGGGGTTATAATTCACCCCTCCACTTT	CSARRTGGGYNSPLHF	TRBV20-1	TRBJ1-6
TGTGCCATCACGGGTGGGGGATTGAGGTATAGCAATCAGCCCCAGCATTTT	CAITGGGLRYSNQPQHF	TRBV10-3	TRBJ1-5
TGTGCCTGGAGCGACAGGGAAGGGACTGAAGCTTTCTTT	CAWSDREGTEAFF	TRBV30	TRBJ1-1
TGTGCCAGCAGCTCAACCCGCCGTTGGGCTGAGCAGTACTTC	CASSSTRRWAEQYF	TRBV7-9	TRBJ2-7
TGCGCCAGCAGCTTGGGTAGGCTCGGACAGGGCTCCTATAATTCACCCCTCCACTTT	CASSLGRLGQGSYNSPLHF	TRBV5-1	TRBJ1-6
TGTGCCAGCAGCCCCCCCACCCGGGAATACGACACTGAAGCTTTCTTT	CASSPPTREYDTEAFF	TRBV9	TRBJ1-1
TGCGCCAGCAATTCGCTAGCGGGTGTTGAGACCCAGTACTTC	CASNSLAGVETQYF	TRBV5-1	TRBJ2-5
TGTGCCACCAGCAGATACGAAGGTAGCAATCAGCCCCAGCATTTT	CATSRYEGSNQPQHF	TRBV15	TRBJ1-5
TGTGCCAGCAGACCCTGCATCTACGAGCAGTACTTC	CASRPCIYEQYF	TRBV6-6	TRBJ2-7
TGTGCCAGCAGCCGGACGACCTTCAGGCAGCCCCAGCATTTT	CASSRTTFRQPQHF	TRBV7-7	TRBJ1-5
TGTGCCAGCAAGCCAGGGCGGTCCTATAATTCACCCCTCCACTTT	CASKPGRSYNSPLHF	TRBV27	TRBJ1-6
TGTGCCAGCAGTTGGACTACAGGGGTATGGTATACGCAGTATTTT	CASSWTTGVWYTQYF	TRBV27	TRBJ2-3
TGCGCCAGCAGCTGGTTACCCACAGGGACTAACTATGGCTACACCTTC	CASSWLPTGTNYGYTF	TRBV5-1	TRBJ1-2
TGCAGTGCTAGAGGTGGTTTGTCCAGGGGAACCTACGAGCAGTACTTC	CSARGGLSRGTYEQYF	TRBV20-1	TRBJ2-7
TGTGCCAGCAGAAGCGGGGGGACAGTTTACACTGAAGCTTTCTTT	CASRSGGTVYTEAFF	TRBV25-1	TRBJ1-1
TGTGCCAGCAAGCCCGGACAGTCTCCCTACGAGCAGTACTTC	CASKPGQSPYEQYF	TRBV27	TRBJ2-7
TGTGCCAGCAGCTTAGGCCGGCCCACTCTTATTACAGATACGCAGTATTTT	CASSLGRPTLITDTQYF	TRBV7-8	TRBJ2-3
TGTGCCAGCAGCCGGATGTCGGGGGCTAGCTCGCATGGTGATTCACCCCTCCACTTT	CASSRMSGASSHGDSPLHF	TRBV3-1	TRBJ1-6
TGTGCCAGCGACAGGTATAGCAATCAGCCCCAGCATTTT	CASDRYSNQPQHF	TRBV11-2	TRBJ1-5
TGTGCCAGCAGCCAAGATTTTGGAGTAGGCTACACCTTC	CASSQDFGVGYTF	TRBV3-1	TRBJ1-2
TGTGCCAGCAATGTCGTTAGGGGTGAAAAACTGTTTTTT	CASNVVRGEKLFF	TRBV25-1	TRBJ1-4
TGCGCCAGCAGCCAAGTCCCACCCGGGACAGGGATACCCTACGAGCAGTACTTC	CASSQVPPGTGIPYEQYF	TRBV4-3	TRBJ2-7
TGCGCCAGCAGCTTGGGGCAACCACAGGGGATACCCCTCCACTTT	CASSLGQPQGIPLHF	TRBV5-1	TRBJ1-6
TGTGCCAGCAGTTACTCGAAGGCGGGGGGCGAGCAGTACTTC	CASSYSKAGGEQYF	TRBV6-2	TRBJ2-7
TGTGCCAGCAGTGAAGCTGGGACAGCCGTCTACCTCAATGAGCAGTTCTTC	CASSEAGTAVYLNEQFF	TRBV2	TRBJ2-1
TGCGCCAGCCGGGGAGGGGGGGGAAAAAGGACGAACACCGGGGAGCTGTTTTTT	CASRGGGGKRTNTGELFF	TRBV5-1	TRBJ2-2
TGTGCCAGCAGCTTTGCCTACAGGGGCGCGCATTTT	CASSFAYRGAHF	TRBV11-2	TRBJ1-5
TGTGCCAGCACGACCTCTGGGAACACTGAAGCTTTCTTT	CASTTSGNTEAFF	TRBV2	TRBJ1-1
TGTGCCAGCAGCCGACAGGGGAATGCTGGAAACACCATATATTTT	CASSRQGNAGNTIYF	TRBV6-6	TRBJ1-3
TGTGCCAGCACACCGGACAGGACTCTCCACTCTGGAAACACCATATATTTT	CASTPDRTLHSGNTIYF	TRBV7-9	TRBJ1-3
TGTGCCAGCAGTTACCCTAGGCCCACAGATACGCAGTATTTT	CASSYPRPTDTQYF	TRBV6-6	TRBJ2-3
TGTGCCATACAGGGGGCTTTGGTTCATGAAAAACTGTTTTTT	CAIQGALVHEKLFF	TRBV6-4	TRBJ1-4
TGTGCCAGCAAACCACTGGACGAGTCTAACTATGGCTACACCTTC	CASKPLDESNYGYTF	TRBV6-5	TRBJ1-2
TGTGCCAGCAGTGGAAAGAAGGCGCCAGGGAATGAGCAGTTCTTC	CASSGKKAPGNEQFF	TRBV6-1	TRBJ2-1
TGCGCCAGCAGGCGGGAGTTACTGCAAGAGACCCAGTACTTC	CASRRELLQETQYF	TRBV10-1	TRBJ2-5
TGTGCCAGCAGTTTAGAAAGGGGAGCGGGGCTTCAGCCCCAGCATTTT	CASSLERGAGLQPQHF	TRBV28	TRBJ1-5
TGTGCCAGCAATCTCTCATGCTACGAGCAGTACTTC	CASNLSCYEQYF	TRBV9	TRBJ2-7
TGTGCCAGCAGCTTTGAACCCCATAGCGGGAAAGAGACCCAGTACTTC	CASSFEPHSGKETQYF	TRBV5-6	TRBJ2-5
TGCAGCAAGGTTCCAGGGGGGTACGAGCAGTACTTC	CSKVPGGYEQYF	TRBV29-1	TRBJ2-7
TGTGCCAGCAGCAGGGGACAGTTTTTAGGGGCTTTCTTT	CASSRGQFLGAFF	TRBV7-8	TRBJ1-1
TGTGCCAGCAGTTTAGACCCCAAGGAAGAGACCCAGTACTTC	CASSLDPKEETQYF	TRBV27	TRBJ2-5
TGTGCCAGCAGTTTTCGCGGGGATGAGGGAAAAGAGACCCAGTACTTC	CASSFRGDEGKETQYF	TRBV28	TRBJ2-5
TGTGCCAGCAGGGGTGTCCCGTCAGGGCGAGTCGGGTACACAGATACGCAGTATTTT	CASRGVPSGRVGYTDTQYF	TRBV27	TRBJ2-3
TGTGCCAGCAGGATGTTCCTAGCGGGCACAGATACGCAGTATTTT	CASRMFLAGTDTQYF	TRBV6-6	TRBJ2-3
TGTGCCAGCAGTTCCGCGACCCGGGACAGTTACGAGCAGTACTTC	CASSSATRDSYEQYF	TRBV6-5	TRBJ2-7
TGTGCCACCAGTGATAGGGGACACCCTAACTATGGCTACACCTTC	CATSDRGHPNYGYTF	TRBV24-1	TRBJ1-2
TGTGCCAGCAGCCCCAGAACAGGACAGGCGGCCAGCACCGGGGAGCTGTTTTTT	CASSPRTGQAASTGELFF	TRBV7-3	TRBJ2-2
TGTGCCAGCAGCCCGGTACGGTACGAGCAGTACTTC	CASSPVRYEQYF	TRBV13	TRBJ2-7
TGTGCCACCAGGGATCAGTACACTGAAGCTTTCTTT	CATRDQYTEAFF	TRBV24-1	TRBJ1-1
TGTGCCAGCAGCTTAGGAAGCCCTGGGGCCAACGTCCTGACTTTC	CASSLGSPGANVLTF	TRBV11-3	TRBJ2-6
TGTGCCAGCAGTTACTCCAGGGACTGGACAGGCGTCTATGGCTACACCTTC	CASSYSRDWTGVYGYTF	TRBV6-5	TRBJ1-2
TGTGCCAGCAGCTTCAAGGGGGTAAGGGGGCTTACTGGCTACGAGCAGTACTTC	CASSFKGVRGLTGYEQYF	TRBV5-6	TRBJ2-7
TGTGCCACCAGCAGAGATCCGGGAGGGGGTAGGGATGGCTACACCTTC	CATSRDPGGGRDGYTF	TRBV15	TRBJ1-2
TGTGCCAGCAGTTTTTATCGGCGCGGAAGATTTACTGAAGCTTTCTTT	CASSFYRRGRFTEAFF	TRBV28	TRBJ1-1
TGTGCCAGCAGCGGGGAAGCCTGCCGGGGGGTACTGATAGGGAACTATGGCTACACCTTC	CASSGEACRGVLIGNYGYTF	TRBV13	TRBJ1-2
TGTGCCAGCAGCGGGACAGGGTCCCCACCCCTCCACTTT	CASSGTGSPPLHF	TRBV7-8	TRBJ1-6
