TGTGCCTGCCTGGATCTCTTC	CACLDLF	TRBV30	TRBJ2-1
TGTGCCAGCAGCGACCTCTACAGGGGCCCGAATGAAAAACTGTTTTTT	CASSDLYRGPNEKLFF	TRBV7-3	TRBJ1-4
TGCAGCGTTGTCGCCCCGATTCTCCCAGATACGCAGTATTTT	CSVVAPILPDTQYF	TRBV29-1	TRBJ2-3
TGCAGTGCTTTGACAGGGTTCACCTTC	CSALTGFTF	TRBV20-1	TRBJ1-2
TGTGCCAGCGTCGGGGAGGTAAATGAAGCTTTCTTT	CASVGEVNEAFF	TRBV6-5	TRBJ1-1
TGTGCCAGCAGCTTGGGTTCAGGGGGGGATGAGCAGTACTTC	CASSLGSGGDEQYF	TRBV5-6	TRBJ2-7
TGTGCCAGCATCCTGTGGGGGGGGGGTGAGCAGTTCTTC	CASILWGGGEQFF	TRBV12-3	TRBJ2-1
TGTGCCAGCAGCTTAATTCGGGACAGGGGAGATAGCAATCAGCCCCAGCATTTT	CASSLIRDRGDSNQPQHF	TRBV7-3	TRBJ1-5
TGCGCCAGGGGCAGGGAATCCCACCATGAGCAGTTCTTC	CARGRESHHEQFF	TRBV4-1	TRBJ2-1
TGTGCCAGCAGCTTGGGCCCAGGGGGCTCCGGGGAGCTGTTTTTT	CASSLGPGGSGELFF	TRBV5-4	TRBJ2-2
TGTGCCAGCAGCTTGGCGAAGGGGGCCCCTAACGAGCAGTACTTC	CASSLAKGAPNEQYF	TRBV5-4	TRBJ2-7
TGTGCCAGCAGTTACTGTTGTCAGCCCCAGCATTTT	CASSYCCQPQHF	TRBV6-9	TRBJ1-5
TGTGCCAGCAGTAGAGGGGCCTTGAACACTGAAGCTTTCTTT	CASSRGALNTEAFF	TRBV27	TRBJ1-1
TGTGCCACCAGCAGAGATGGCCACAACCCCCAGGGGAAGTGGAGTGGCTACACCTTC	CATSRDGHNPQGKWSGYTF	TRBV15	TRBJ1-2
TGTGCCACCATAGGTCCCGCTCAAGAGACCCAGTACTTC	CATIGPAQETQYF	TRBV24-1	TRBJ2-5
TGTGCCAGGGGACAGGAGTGCGGCTACACCTTC	CARGQECGYTF	TRBV6-4	TRBJ1-2
TGTGCCAGCGGGCGATTCTGGCGGGGGTACTCACCCCTCCACTTT	CASGRFWRGYSPLHF	TRBV27	TRBJ1-6
TGCGCCAGCAGCGGCGCGGGAGTGGAGAATGAAAAACTGTTTTTT	CASSGAGVENEKLFF	TRBV5-1	TRBJ1-4
TGTGCCAGCAGACAGGGAGGGGGGACCAAAAACATTCAGTACTTC	CASRQGGGTKNIQYF	TRBV27	TRBJ2-4
TGTGCCAGCAGCTTCTCCCCGGGACCCGGCCACAATGAAAAACTGTTTTTT	CASSFSPGPGHNEKLFF	TRBV11-3	TRBJ1-4
TGCGCCAGCAGTCACTGCGGGAGGAGCTCCTATAATTCACCCCTCCACTTT	CASSHCGRSSYNSPLHF	TRBV10-1	TRBJ1-6
TGCGCCAGCAGCTCAGGACAGGGCGGAGTAGGATCCGCGAAGGATCAGCCCCAGCATTTT	CASSSGQGGVGSAKDQPQHF	TRBV5-1	TRBJ1-5
TGTGCCAGCAGCTTATTACCGCACGATTCCCACACTGAAGCTTTCTTT	CASSLLPHDSHTEAFF	TRBV7-9	TRBJ1-1
TGTGCGGCACAGGGGAGTATGGGGGAGACCCAGTACTTC	CAAQGSMGETQYF	TRBV6-5	TRBJ2-5
TGTGCCAGCAGTCCGCCCTCAGGGAAGTCAGATACGCAGTATTTT	CASSPPSGKSDTQYF	TRBV6-5	TRBJ2-3
TGTGCCCCTCATAAGGGGGCCTTCCGGAACACTGAAGCTTTCTTT	CAPHKGAFRNTEAFF	TRBV15	TRBJ1-1
TGTGCCAGCAGTGGTCAGACAGGGACTGAAGCTTTCTTT	CASSGQTGTEAFF	TRBV6-6	TRBJ1-1
TGTGCCAGCAGCGTCGACCAGAGGTTCGAGCAGTACTTC	CASSVDQRFEQYF	TRBV7-2	TRBJ2-7
TGTGCCAGCAGTTACCCCCAGGGGGTGTCAGATACGCAGTATTTT	CASSYPQGVSDTQYF	TRBV6-6	TRBJ2-3
TGTGCCAGCAGCTCCGGGAAAGGCCGGAAGTATGGCTACACCTTC	CASSSGKGRKYGYTF	TRBV5-4	TRBJ1-2
TGTGCCAGCAGGGCAGGGATTCACTACGAGCAGTACTTC	CASRAGIHYEQYF	TRBV6-3	TRBJ2-7
TGTGCCACGGTAGCGGACCTGAACACTGAAGCTTTCTTT	CATVADLNTEAFF	TRBV6-1	TRBJ1-1
TGTGCCAGCAGTTACCAGTACACAGCACGGGGCGAGCAGTACTTC	CASSYQYTARGEQYF	TRBV6-5	TRBJ2-7
TGTGCCAGCAGTGGACCCATCGGGACTGACAGGGAAGAGCAGTACTTC	CASSGPIGTDREEQYF	TRBV27	TRBJ2-7
TGTGCCAGCAGTTACGTACGGCAGACAGGGACAAACCATAGCAATCAGCCCCAGCATTTT	CASSYVRQTGTNHSNQPQHF	TRBV6-5	TRBJ1-5
TGTGCCACCAGAGGGGGGGGGGGCTACACCTTC	CATRGGGGYTF	TRBV24-1	TRBJ1-2
TGTGCCACCAGCAGAACGTCCAGGACTAGCGGGGGGATCGCCACCGGGGAGCTGTTTTTT	CATSRTSRTSGGIATGELFF	TRBV15	TRBJ2-2
TGTGCCATCAGTGAGTTGGACAATGAAAAACTGTTTTTT	CAISELDNEKLFF	TRBV10-3	TRBJ1-4
TGTGCCAGCAGCTGGGACAGGGGTTGGGAGACCCAGTACTTC	CASSWDRGWETQYF	TRBV7-3	TRBJ2-5
TGTGCCAGCAGCCAAGACAGCGATAGCAATCAGCCCCAGCATTTT	CASSQDSDSNQPQHF	TRBV3-1	TRBJ1-5
TGTGCCAGCAGCTCAGACAGATCACCCCTCCACTTT	CASSSDRSPLHF	TRBV5-6	TRBJ1-6
TGTGCCAGCAGTAAGGCCCCCCTCTTAGATGAGCAGTTCTTC	CASSKAPLLDEQFF	TRBV28	TRBJ2-1
TGTGCCAGCCGGGACAGGGGCTTCTACGAGCAGTACTTC	CASRDRGFYEQYF	TRBV6-1	TRBJ2-7
TGTGCCAGCAGCTTCCCCCCGGATCAGCCCCAGCATTTT	CASSFPPDQPQHF	TRBV7-9	TRBJ1-5
TGTGCCAGTAGTAAGACAGGGGACCCAGCTGGGGCCAACGTCCTGACTTTC	CASSKTGDPAGANVLTF	TRBV19	TRBJ2-6
TGTGCCAGCAGCTTAGGCGCAAAGTGCGGACAGCCTCTGACAAAGACTGAAGCTTTCTTT	CASSLGAKCGQPLTKTEAFF	TRBV7-9	TRBJ1-1
TGCGCCAGCAGCCCGGGGAAGGAAGGTCACGAGCAGTACTTC	CASSPGKEGHEQYF	TRBV10-1	TRBJ2-7
TGTGCCAGCAGCCAACTGGGGACTTACTACGAGCAGTACTTC	CASSQLGTYYEQYF	TRBV3-1	TRBJ2-7
TGTGCCAGCAGGCCACGAGGCACCGGACATGGCTACACCTTC	CASRPRGTGHGYTF	TRBV6-4	TRBJ1-2
TGCCCAGAGGGGTTCAATTCACCCCTCCACTTT	CPEGFNSPLHF	TRBV5-1	TRBJ1-6
TGTGCCAGTAGCCGGGCGGACGAGCAGTACTTC	CASSRADEQYF	TRBV19	TRBJ2-7
TGCAGCGTTGGACAAAAGTCGGGGGGGCTCTCGGATGCCGGGGAGCTGTTTTTT	CSVGQKSGGLSDAGELFF	TRBV29-1	TRBJ2-2
TGTGCCAGCAGTTCGGGCAGGAAAGATACGCAGTATTTT	CASSSGRKDTQYF	TRBV27	TRBJ2-3
TGTGCCACGACGGACGGTGAGACCCAGTACTTC	CATTDGETQYF	TRBV6-5	TRBJ2-5
TGCAGTGCGCAGCCCACCTACGAGCAGTACTTC	CSAQPTYEQYF	TRBV20-1	TRBJ2-7
TGTGCCAGCAGTTCCTACAGGCCTGGTATCTCCTACGAGCAGTACTTC	CASSSYRPGISYEQYF	TRBV6-2	TRBJ2-7
TGTGCCAGCAGAAGACACGCCTTACAGGTAAGCTCCTATAATTCACCCCTCCACTTT	CASRRHALQVSSYNSPLHF	TRBV27	TRBJ1-6
TGTGCCAGCAGTTATAAAAGGGCCGATGATGAGCAGTTCTTC	CASSYKRADDEQFF	TRBV6-5	TRBJ2-1
TGTGCCAGCAGCCGCTTTCAGGACAGAGGCCAGTACTTC	CASSRFQDRGQYF	TRBV13	TRBJ2-5
TGTGCCAGCAGCCATCTTAGCAAGACCCAGTACTTC	CASSHLSKTQYF	TRBV5-8	TRBJ2-5
TGCGCCAGCAGCATGGGGGGGGGCGCGGAATGCAATCAGCCCCAGCATTTT	CASSMGGGAECNQPQHF	TRBV5-1	TRBJ1-5
TGTGCCAGCACCCTCGCGGGGGGCTACACCTTC	CASTLAGGYTF	TRBV7-7	TRBJ1-2
TGTGCCAGCAGTCGGCGGGACCTGGGGAATCAGCCCCAGCATTTT	CASSRRDLGNQPQHF	TRBV6-6	TRBJ1-5
TGTGCCAGCAGTGACTCTAGGGGGCAGTACAATGAGCAGTTCTTC	CASSDSRGQYNEQFF	TRBV6-4	TRBJ2-1
TGCAGTGCTCGGGGGGGATCTTCGGGGAAAGCTTTCTTT	CSARGGSSGKAFF	TRBV20-1	TRBJ1-1
TGTGCCAGCAGCCAACCCGGGATGTCATACGAGCAGTACTTC	CASSQPGMSYEQYF	TRBV6-1	TRBJ2-7
TGTGCCAGCAGTTACAACCCGGGACAGGGTTATAGCATGAACACTGAAGCTTTCTTT	CASSYNPGQGYSMNTEAFF	TRBV6-5	TRBJ1-1
TGTGCCAGCAGCTTATCTCTGGGGGGCAATCAGCCCCAGCATTTT	CASSLSLGGNQPQHF	TRBV7-8	TRBJ1-5
TGTGCCAGCAGCGTAGAGGGACTAGCGGGCCAGGGTGATACGCAGTATTTT	CASSVEGLAGQGDTQYF	TRBV9	TRBJ2-3
TGTGCCAGCAGCTTAAAAGAAGACAGGGACTCTGGGGCCAACGTCCTGACTTTC	CASSLKEDRDSGANVLTF	TRBV7-3	TRBJ2-6
TGTGCCAGCACACGTTCGACTAGGATTCAGACCCAGTACTTC	CASTRSTRIQTQYF	TRBV6-3	TRBJ2-5
TGTGCCAGCAGCTTAGAACTTAGCGGGCTGGATACGCAGTATTTT	CASSLELSGLDTQYF	TRBV11-3	TRBJ2-3
TGTGCCAGCAGGAGTCCGGCACAGACCAGCTCTGGGGCCAACGTCCTGACTTTC	CASRSPAQTSSGANVLTF	TRBV27	TRBJ2-6
TGTGCCAGCAGTTTTGGAGGCGGACAGGAAGCGAACACCGGGGAGCTGTTTTTT	CASSFGGGQEANTGELFF	TRBV27	TRBJ2-2
TGTGCCAGCACGAAGCAGGATAATTCACCCCTCCACTTT	CASTKQDNSPLHF	TRBV4-2	TRBJ1-6
TGCGCCAGAGGTGGCTACACCTTC	CARGGYTF	TRBV10-1	TRBJ1-2
TGTGCCAGCAGTTTATTGAGTTCTAGCGGGACCTCCGAGACCCAGTACTTC	CASSLLSSSGTSETQYF	TRBV27	TRBJ2-5
TGCGCCAGCACCGGGGGGCATTCTACGCAGTATTTT	CASTGGHSTQYF	TRBV10-2	TRBJ2-3
TGTGCCATCAGATCCGGACGCACAGATACGCAGTATTTT	CAIRSGRTDTQYF	TRBV10-3	TRBJ2-3
TGCGCCAGCCAGGGTCCCTACGAGCAGTACTTC	CASQGPYEQYF	TRBV10-1	TRBJ2-7
TGCGCCAGCACTGTTCGGCCCCTAGCGGGGGGGCAATCTGGAAACACCATATATTTT	CASTVRPLAGGQSGNTIYF	TRBV10-1	TRBJ1-3
TGTGCCAGCAGCCGACCCCTAGCGGGTACCTACGAGCAGTACTTC	CASSRPLAGTYEQYF	TRBV4-2	TRBJ2-7
TGTGCCTGGACTAAGGACAGGGAAACAAAAGGTGGTAAATACAATGAGCAGTTCTTC	CAWTKDRETKGGKYNEQFF	TRBV30	TRBJ2-1
TGTGCCAGCAGTGACGTGAGCCGGACTTTCGAAAAACTGTTTTTT	CASSDVSRTFEKLFF	TRBV6-4	TRBJ1-4
TGTGCCAGCAGCAGGGCCCACCCACATGAGCAGTTCTTC	CASSRAHPHEQFF	TRBV9	TRBJ2-1
TGCAGTGCGAGGGCCGTTGATGAGCAGTTCTTC	CSARAVDEQFF	TRBV20-1	TRBJ2-1
TGTGCCGATGTGGTGACTAGCGGGGTCCCGAACACCGGGGAGCTGTTTTTT	CADVVTSGVPNTGELFF	TRBV6-5	TRBJ2-2
TGTGCCAGCAGCCCACATTTTCAGGGCGGGGATGGCTACACCTTC	CASSPHFQGGDGYTF	TRBV3-1	TRBJ1-2
TGTGCCTGGACTCGGATGGCCGTCAATCAGCCCCAGCATTTT	CAWTRMAVNQPQHF	TRBV30	TRBJ1-5
TGTGCCAGCATTCAGGTGGGCAATCAGCCCCAGCATTTT	CASIQVGNQPQHF	TRBV2	TRBJ1-5
TGTGCCAGCAGCTTGAACGGGGGCCCGGAGACCCAGTACTTC	CASSLNGGPETQYF	TRBV11-3	TRBJ2-5
TGTGCCAGCAGTTTAGAGGACAGAGAGACCCAGTACTTC	CASSLEDRETQYF	TRBV12-4	TRBJ2-5
TGTGCCAGTAGTATAGCGGTGAGGGGGCGGCAGAGCAATGAAAAACTGTTTTTT	CASSIAVRGRQSNEKLFF	TRBV19	TRBJ1-4
TGTGCCAGCAGCCCAGGGGGCCCCTCCTACGAGCAGTACTTC	CASSPGGPSYEQYF	TRBV5-6	TRBJ2-7
TGTGCCAGCAGCTTAGGGCGGAGGCAAGAGACCCAGTACTTC	CASSLGRRQETQYF	TRBV7-3	TRBJ2-5
TGCGCCAGCAGTTCTTATGCCTACAATGAGCAGTTCTTC	CASSSYAYNEQFF	TRBV10-1	TRBJ2-1
TGCGCCAGCAGCCGGAGACAGGGTAGGATTCATAAAGAGTCAACTTCCTACGAGCAGTACTTC	CASSRRQGRIHKESTSYEQYF	TRBV4-1	TRBJ2-7
TGTGCCAGCAGCACCGTCCTTTTAAGATGGGGGGCATACGAGCAGTACTTC	CASSTVLLRWGAYEQYF	TRBV5-6	TRBJ2-7
TGTGCCACCAGTGATAGACTCCGAATGAGGGACTCCTACGAGCAGTACTTC	CATSDRLRMRDSYEQYF	TRBV24-1	TRBJ2-7
TGTGCCAGCAGCTTAAGTAGGAAGCATTTT	CASSLSRKHF	TRBV11-3	TRBJ1-5
TGTGCCAGCAGGGGGGGCCCCTACGAGCAGTACTTC	CASRGGPYEQYF	TRBV3-1	TRBJ2-7
TGTGCCAGCAGCTTATTAAGCGCTAGCGGGTCCGAGCAGTACTTC	CASSLLSASGSEQYF	TRBV7-9	TRBJ2-7
TGCAGTGCAGTACTTCATGTCTACGAGCAGTACTTC	CSAVLHVYEQYF	TRBV20-1	TRBJ2-7
TGTGCCAGCAGCACCAACAGAGAGACCCAGTACTTC	CASSTNRETQYF	TRBV11-3	TRBJ2-5
TGCAGCGTCCCCCCCTTGTCCGGCTTGATGCAGCCCCAGCATTTT	CSVPPLSGLMQPQHF	TRBV29-1	TRBJ1-5
TGTGCCAGCACTTGGCTAGCAGGGGAAATAACCGGGGAGCTGTTTTTT	CASTWLAGEITGELFF	TRBV7-9	TRBJ2-2
TGCAGTGCTCCCCGCGAGCAGGAGAGGATCTTC	CSAPREQERIF	TRBV20-1	TRBJ2-1
TGTGCCAGCAGCCGTGGGGGGATTGTAGCCGGGGAGCTGTTTTTT	CASSRGGIVAGELFF	TRBV7-9	TRBJ2-2
TGTGCCATCAGCAGTCCGGGACGTTCGAACCGGTATAATTCACCCCTCCACTTT	CAISSPGRSNRYNSPLHF	TRBV10-3	TRBJ1-6
TGTGCCAGCAGCCAAGTCCCCGGGACAGGGCCTATTCAGTACTTC	CASSQVPGTGPIQYF	TRBV14	TRBJ2-4
TGTGCCAGCAGCACAGGGAGCTCCTACGAGCAGTACTTC	CASSTGSSYEQYF	TRBV28	TRBJ2-7
TGTCCCGTGATACAGCAGGGGGGGGATAACTATGGCTACACCTTC	CPVIQQGGDNYGYTF	TRBV10-3	TRBJ1-2
TGTGCCAGCAGCGTCAGGGGGGCTTTTAGACTAGGATACGAGCAGTACTTC	CASSVRGAFRLGYEQYF	TRBV7-6	TRBJ2-7
TGTGCCAGCAGCCCGGACAGGAATCAGCCCCAGCATTTT	CASSPDRNQPQHF	TRBV13	TRBJ1-5
TGTGCTAGCAGCTTACAACCCGGACAGATTGACACTGAAGCTTTCTTT	CASSLQPGQIDTEAFF	TRBV7-7	TRBJ1-1
TGTGCCAGCACATGGCGTGAGCAGTACTTC	CASTWREQYF	TRBV27	TRBJ2-7
TGTGCCAGCAGCGCCCTCCTCCAACAGGGCGGGCAAGGAAATCAGCCCCAGCATTTT	CASSALLQQGGQGNQPQHF	TRBV13	TRBJ1-5
TGTGCCAGCAGCCGGACGGTTTCAGCCGGCGACTATGGCTACACCTTC	CASSRTVSAGDYGYTF	TRBV7-2	TRBJ1-2
TGTGCCAGCAGAACTATCACGACGACGGAAGAGACCCAGTACTTC	CASRTITTTEETQYF	TRBV28	TRBJ2-5
TGTGCCAGCTGCCAGACCCTATACGGGGAGCTGTTTTTT	CASCQTLYGELFF	TRBV6-4	TRBJ2-2
TGTGCCAGCAGTTTACGACTAGCGGGAAGTTTGCAAGAGACCCAGTACTTC	CASSLRLAGSLQETQYF	TRBV28	TRBJ2-5
TGCAGCGTTGAAATGCCAAGGCAATTCTGTCCGGGACTAGCGGGGGGGGGGGTTGAGTCCTACGAGCAGTACTTC	CSVEMPRQFCPGLAGGGVESYEQYF	TRBV29-1	TRBJ2-7
TGTGCCAGCAGGAGTCCATTCGCCAAGGGTGAAGCTTTCTTT	CASRSPFAKGEAFF	TRBV12-4	TRBJ1-1
TGCGCCAGCAGCCAAGATGATCTTAGCGGGCTTATCTTC	CASSQDDLSGLIF	TRBV4-3	TRBJ2-1
TGTGCCAGCAGCTTATGGGGCTTAGTTTACAATGAGCAGTTCTTC	CASSLWGLVYNEQFF	TRBV7-6	TRBJ2-1
TGTGCCAGCAGTCAGGGAGGAGAAAAACTGTTTTTT	CASSQGGEKLFF	TRBV6-5	TRBJ1-4
TGCGCCAGCAGTGATGGGGGGGCGTCAGGTTCCTACAATGAGCAGTTCTTC	CASSDGGASGSYNEQFF	TRBV10-2	TRBJ2-1
TGTGCCAGCAGTTTGGATACTGGTCAACCCGGGGACCGTGAAAAACTGTTTTTT	CASSLDTGQPGDREKLFF	TRBV12-4	TRBJ1-4
TGCAGCGTGGGCGTTAATGAAAAACTGTTTTTT	CSVGVNEKLFF	TRBV29-1	TRBJ1-4
TGTGCCAGCAGCGTCGATCCGGGTCGGGGACAGGGGTGGTGTTTGTCGGCGTACAATGAGCAGTTCTTC	CASSVDPGRGQGWCLSAYNEQFF	TRBV9	TRBJ2-1
TGTGCCAGCAGCGTAACCCTGGGGGCGCCGTACACCTTC	CASSVTLGAPYTF	TRBV9	TRBJ1-2
TGTGCCAGCAGCTTAGACAGCCATACACAGGGGGCATCTGAAGCTTTCTTT	CASSLDSHTQGASEAFF	TRBV7-2	TRBJ1-1
TGCAGCGGGGGACAGACGCATGAAAAACTGTTTTTT	CSGGQTHEKLFF	TRBV29-1	TRBJ1-4
TGTGCCAGCAGCCTTGAAGGGACTAGAACCTACGAGCAGTACTTC	CASSLEGTRTYEQYF	TRBV3-1	TRBJ2-7
TGTGCCAGCAGTGAAGGAAGGGTAGGGAGGGCGATGCTTGAGACCCAGTACTTC	CASSEGRVGRAMLETQYF	TRBV25-1	TRBJ2-5
TGTGCCAGCAGTTGGATACTCGTACTTCCCTACGAGCAGTACTTC	CASSWILVLPYEQYF	TRBV27	TRBJ2-7
TGTGCCAGCAGCAGTTCCACTGCGAAAGACACCGGGGAGCTGTTTTTT	CASSSSTAKDTGELFF	TRBV7-3	TRBJ2-2
TGTGCCAGCAGCTTAGGATCGGGGGACAACAAAGAGACCCAGTACTTC	CASSLGSGDNKETQYF	TRBV7-2	TRBJ2-5
TGTGCCACCAGCTGGCGGACGTGCTGGAATAGCAATCAGCCCCAGCATTTT	CATSWRTCWNSNQPQHF	TRBV15	TRBJ1-5
TGTGCCAGTAGTATAGCCCCGGGGACAGATACGCAGTATTTT	CASSIAPGTDTQYF	TRBV19	TRBJ2-3
TGTGCCAGCAGTGTGGGGGGACTGATCTACAATGAGCAGTTCTTC	CASSVGGLIYNEQFF	TRBV6-6	TRBJ2-1
TGCGCCAGCAGCTTTAAGCTCAACTACGAGCAGTACTTC	CASSFKLNYEQYF	TRBV5-1	TRBJ2-7
TGTGCCAGCAGCCAGTCAGGGTACCAAGAGACCCAGTACTTC	CASSQSGYQETQYF	TRBV13	TRBJ2-5
TGCGCCAGCAGTTCCGGAGGTACCACCAGGGTCTACAATGAGCAGTTCTTC	CASSSGGTTRVYNEQFF	TRBV10-1	TRBJ2-1
TGTGCCAGCAGCAAGGTCCAGGGGGACGCCTTC	CASSKVQGDAF	TRBV7-3	TRBJ1-2
TGTGCCAGCAGTTGTGCTAGGGCCTCGGGGAGCTCCTACAATGAGCAGTTCTTC	CASSCARASGSSYNEQFF	TRBV6-5	TRBJ2-1
TGTGCTAGTCGGGACAAGGGCACGAACACTGAAGCTTTCTTT	CASRDKGTNTEAFF	TRBV12-5	TRBJ1-1
TGTGCCACCAGTGACACAGGGACTAATACGCAGTATTTT	CATSDTGTNTQYF	TRBV24-1	TRBJ2-3
TGTGCCAGCAGCTTAAGCGGGGTTTACGAGCAGTACTTC	CASSLSGVYEQYF	TRBV13	TRBJ2-7
TGTGCCAGCAGGGTGGTAGATCCCCGGGAAAAACTGTTTTTT	CASRVVDPREKLFF	TRBV7-9	TRBJ1-4
TGTGCCAGCAGCCAGGGGACGGTCTACAATGAGCAGTTCTTC	CASSQGTVYNEQFF	TRBV4-2	TRBJ2-1
TGTGCCAGCAGCCAAGATCTCCCGCAGCAGGACTACGAGCAGTACTTC	CASSQDLPQQDYEQYF	TRBV3-1	TRBJ2-7
TGTGCCATACGGGGCTACAATGAGCAGTTCTTC	CAIRGYNEQFF	TRBV6-1	TRBJ2-1
TGTGCCAGCAGCTTGGGTCCGGCCTCCCACACTGAAGCTTTCTTT	CASSLGPASHTEAFF	TRBV5-6	TRBJ1-1
TGCGCCAGCGTAGACAGGGGGCCGGCGGGGAATCAGCCCCAGCATTTT	CASVDRGPAGNQPQHF	TRBV5-1	TRBJ1-5
TGTGCCAGCAGCACACGCGGTTACGAGCAGTACTTC	CASSTRGYEQYF	TRBV7-3	TRBJ2-7
TGTGCCACCAGTGACGGGCTGAGAACCACAGATACGCAGTATTTT	CATSDGLRTTDTQYF	TRBV24-1	TRBJ2-3
TGTGCCAGTCCCTACAGGGGCCAGGACTACAATGAGCAGTTCTTC	CASPYRGQDYNEQFF	TRBV6-1	TRBJ2-1
TGCAGTGCTAGAGATCAACCCCTAATTATGAGAGTGAACACTGAAGCTTTCTTT	CSARDQPLIMRVNTEAFF	TRBV20-1	TRBJ1-1
TGTGCCATAGGGGGTGACCCCATGAACACTGAAGCTTTCTTT	CAIGGDPMNTEAFF	TRBV28	TRBJ1-1
TGTGCCAGCAGCCCCTGCCCAGCTAAAGGCTACGAGCAGTACTTC	CASSPCPAKGYEQYF	TRBV7-3	TRBJ2-7
TGTGCCACCGTACAGGGGGGCACCGCCTACGAGCAGTACTTC	CATVQGGTAYEQYF	TRBV24-1	TRBJ2-7
TGTGCCAGCAGCGACATCTCCGGGGTAATTGCCCACGAGCAGTACTTC	CASSDISGVIAHEQYF	TRBV13	TRBJ2-7
TGTGCCAGCAGTTACTCGAATTGTGGACTAGGAGGGGAGTTAGATACGCAGTATTTT	CASSYSNCGLGGELDTQYF	TRBV6-5	TRBJ2-3
TGTGCCAGCGAGGGCATTGGGGTGTCAACCTCCTACGAGCAGTACTTC	CASEGIGVSTSYEQYF	TRBV7-3	TRBJ2-7
TGTGCCAGCAGCAAGTGGGAAGGGGACGGGCAGTACTTC	CASSKWEGDGQYF	TRBV7-9	TRBJ2-7
TGCAGTGCTGCCCGGAGAGACAGGGCATTTCTTGAAGCTTTCTTT	CSAARRDRAFLEAFF	TRBV20-1	TRBJ1-1
TGCAACAGGACTAGGTTCGTAGGCGTTAACGAGCAGTACTTC	CNRTRFVGVNEQYF	TRBV20-1	TRBJ2-7
TGCGCCAGCAGCGCATGCGTCACTAGCGGGAGTGAAGGCTCTGGAAACACCATATATTTT	CASSACVTSGSEGSGNTIYF	TRBV5-1	TRBJ1-3
TGCGCCAGCGGAAGGGGGACGGTCCCTCCTAACGGGGAGCTGTTTTTT	CASGRGTVPPNGELFF	TRBV4-1	TRBJ2-2
TGTGCCAGCAGCTTAAAGCGGACGGTATCCTACAATGAGCAGTTCTTC	CASSLKRTVSYNEQFF	TRBV7-3	TRBJ2-1
TGTGCCAGCAGTTTACCGGGGGGTTTGGACAGGGGGGTTGGAGATACGCAGTATTTT	CASSLPGGLDRGVGDTQYF	TRBV27	TRBJ2-3
TGTGCCAGCAGCTTTAATCAGGGGGATTATAACTATGGCTACACCTTC	CASSFNQGDYNYGYTF	TRBV7-6	TRBJ1-2
TGTGCCAGCAGTGATGTTCGGGGGGGCCACAATGAGCAGTTCTTC	CASSDVRGGHNEQFF	TRBV6-1	TRBJ2-1
TGTGCCAGCAGCTTACCCCCTCCCGGACAGGCGGATGGCTACACCTTC	CASSLPPPGQADGYTF	TRBV7-3	TRBJ1-2
TGCAGTGCTAGGGGGACCATTAAAGGGGGGACCGGGGAGCTGTTTTTT	CSARGTIKGGTGELFF	TRBV20-1	TRBJ2-2
TGTGCCAGGGACCAGGGTCGCGAGCAGTACTTC	CARDQGREQYF	TRBV5-4	TRBJ2-7
TGTGCCAGCAGCGCTTTCCTTCCCGGGACAGGGACAGAGACCCAGTACTTC	CASSAFLPGTGTETQYF	TRBV9	TRBJ2-5
TGTGCCAGGGACAGGGGTCGCAGGTCGGTAGACGAGCAGTACTTC	CARDRGRRSVDEQYF	TRBV6-4	TRBJ2-7
TGCGCCAGCAGCTTGGCACTACACCCTGTGACAGGAGCCAGGGAAAAACTGTTTTTT	CASSLALHPVTGAREKLFF	TRBV5-1	TRBJ1-4
TGTGCCAGCAGTTTATTTCCCAGGGGGGCTTTCTTT	CASSLFPRGAFF	TRBV12-3	TRBJ1-1
TGTGCCAGCAGTTCCTATTTCGGGACCCGGAGCTCCTACAATGAGCAGTTCTTC	CASSSYFGTRSSYNEQFF	TRBV27	TRBJ2-1
TGTGCCAGTAGTATGTCTATGAAATGGACAGGGACTGCCAACACTGAAGCTTTCTTT	CASSMSMKWTGTANTEAFF	TRBV19	TRBJ1-1
TGTGCCAGCAGCTTAAATAGACGGGACAGGGGGCGAAATTACGAGCAGTACTTC	CASSLNRRDRGRNYEQYF	TRBV7-9	TRBJ2-7
TGCGCCAGCTACACTTCCGGGGAGCTGTTTTTT	CASYTSGELFF	TRBV10-1	TRBJ2-2
TGCGCCAGCGGGGGGGAACCAGATACGCAGTATTTT	CASGGEPDTQYF	TRBV5-1	TRBJ2-3
TGTGCCGTTTGTCGGAGGACGAACACCATATATTTT	CAVCRRTNTIYF	TRBV12-3	TRBJ1-3
TGTGCCACCAGTGAGAGGCGACAGGGGCTTCTTGGCTACACCTTC	CATSERRQGLLGYTF	TRBV24-1	TRBJ1-2
TGTGCCAGTAACAGGGGAATGCAGTTCTTC	CASNRGMQFF	TRBV28	TRBJ2-1
TGTGCCAGCAGCTTGGGACTGAGCTCCTACGAGCAGTACTTC	CASSLGLSSYEQYF	TRBV7-9	TRBJ2-7
TGTGCCAGCAGCCATCGAGTCGGGGATGAGCAGTTCTTC	CASSHRVGDEQFF	TRBV3-1	TRBJ2-1
TGTGCCAGCAGCAGTGGGGAGAGGGGGTACGAGCAGTACTTC	CASSSGERGYEQYF	TRBV6-1	TRBJ2-7
TGTGGGGCTTACAGGGGGCGAGGGATGACCTCCACTGAAGCTTTCTTT	CGAYRGRGMTSTEAFF	TRBV2	TRBJ1-1
TGTGCCGTATTCCTAGCGGCTGAGACCCAGTACTTC	CAVFLAAETQYF	TRBV10-3	TRBJ2-5
TGTGCCAGCAGCCAAGGTTGGTCACACGGCTACACCTTC	CASSQGWSHGYTF	TRBV11-3	TRBJ1-2
TGTGCCAGCAGGAAGGTCCGGGCAACTAATGAAAAACTGTTTTTT	CASRKVRATNEKLFF	TRBV11-3	TRBJ1-4
TGTGCCAGCAGCGGGGCAATACCAGAGTACGAGCAGTACTTC	CASSGAIPEYEQYF	TRBV7-3	TRBJ2-7
TGTGCCAGCAGCCCGTCCGGATCCTACGAGCAGTACTTC	CASSPSGSYEQYF	TRBV7-2	TRBJ2-7
TGCGCCAGCAGCTTGGGGGGCCGGGACAGGGGCACCGGGGAGCTGTTTTTT	CASSLGGRDRGTGELFF	TRBV5-1	TRBJ2-2
TGTGCCAGCAGCTCGGGGACTAGCGGGAAAGAGACCCAGTACTTC	CASSSGTSGKETQYF	TRBV7-9	TRBJ2-5
TGCGCCAGCAGCTTGGCCCCCAGGGGGGGGAACACTGAAGCTTTCTTT	CASSLAPRGGNTEAFF	TRBV5-1	TRBJ1-1
TGTGCCAGCAGGGGTGTGAGGGGCTCTACCCTGAACACTGAAGCTTTCTTT	CASRGVRGSTLNTEAFF	TRBV6-5	TRBJ1-1
TGTGCCAGCAGTTCCTCTGGGTGCGGGAGCCCTGGAAACACCATATATTTT	CASSSSGCGSPGNTIYF	TRBV28	TRBJ1-3
TGTGCCAGCAGTGAATATCCCCCCGGGACAGGGGTAATCCATTCCTACGAGCAGTACTTC	CASSEYPPGTGVIHSYEQYF	TRBV25-1	TRBJ2-7
TGTGCCAACCAAATAAGGGATGAGGCTTTCTTT	CANQIRDEAFF	TRBV5-4	TRBJ1-1
TGTGCCAGCAGCCCCTTGCATTCACCCCTCCACTTT	CASSPLHSPLHF	TRBV13	TRBJ1-6
TGTGCCAGCAGTTTGAGGGGGGCGAATGAGCAGTTCTTC	CASSLRGANEQFF	TRBV27	TRBJ2-1
TGCAGTGCTAGAGATCCACTGGGGATTCAGTACTTC	CSARDPLGIQYF	TRBV20-1	TRBJ2-4
TGTGCCTGGAGTGGGACAGCTCCTGAATCCTACGAGCAGTACTTC	CAWSGTAPESYEQYF	TRBV30	TRBJ2-7
TGTGCCAGTAGTATTGCCTGGGCTACATCGCCCAACACTGAAGCTTTCTTT	CASSIAWATSPNTEAFF	TRBV19	TRBJ1-1
TGTGCCAGCAGCCAAGTGGCCCGTTTCAGGGGGCTCTATGGCTACACCTTC	CASSQVARFRGLYGYTF	TRBV4-2	TRBJ1-2
TGTGCCAGCAGCCCCCACGACGGATCCAAAAACATTCAGTACTTC	CASSPHDGSKNIQYF	TRBV7-3	TRBJ2-4
TGTGCCAGCAGTTACTCGATGGCGGCGACCGAGCAGTACTTC	CASSYSMAATEQYF	TRBV6-2	TRBJ2-7
TGTGCCAGCAGCGCAGGGTCACCCCTCCACTTT	CASSAGSPLHF	TRBV13	TRBJ1-6
TGTGCCACATCAGGGGGAAGCAATCAGCCCCAGCATTTT	CATSGGSNQPQHF	TRBV6-1	TRBJ1-5
TGCGCCAGCAGCTCCAATTCCTGGGGGGGGGGTAGCTCCTACAATGAGCAGTTCTTC	CASSSNSWGGGSSYNEQFF	TRBV5-1	TRBJ2-1
TGTGCCAGCAGCCAAGCGCCAGGGACAGGCAAGAGGTCGGAGCAGTTCTTC	CASSQAPGTGKRSEQFF	TRBV4-2	TRBJ2-1
TGTGCCACGGTAGTAAGGCGGGAGGAATTTTCAGAGACCCAGTACTTC	CATVVRREEFSETQYF	TRBV6-2	TRBJ2-5
TGTGCCAGCAGTGAATTTCGGGGACACCGGTCATGGAGAAATCAGCCCCAGCATTTT	CASSEFRGHRSWRNQPQHF	TRBV6-1	TRBJ1-5
TGTGCCAGCAGTGAATCCAAGAGGGGGAATTACAATGAGCAGTTCTTC	CASSESKRGNYNEQFF	TRBV25-1	TRBJ2-1
TGTGCCAGCAGGGATCGGCGGGGACCCTACGAGCAGTACTTC	CASRDRRGPYEQYF	TRBV7-3	TRBJ2-7
TGCGCCAGCAGCAGGGTTCTGGGGGGGGGCTACGAGCAGTACTTC	CASSRVLGGGYEQYF	TRBV5-1	TRBJ2-7
TGTGCCAGCAGCTTAGATGAAAGGGGGCGAGTGAACACTGAAGCTTTCTTT	CASSLDERGRVNTEAFF	TRBV11-3	TRBJ1-1
TGTGCCAGCAGCTTAACAGGACAGGGGGGTTATAATCAGCCCCAGCATTTT	CASSLTGQGGYNQPQHF	TRBV11-2	TRBJ1-5
TGTGCCAGCTCACCCTCGGGGCAGAGCAATCAGCCCCAGCATTTT	CASSPSGQSNQPQHF	TRBV18	TRBJ1-5
TGCGCCAGCAGTATACCATGTCCGCCCCGGAGAGACAATGAGCAGTTCTTC	CASSIPCPPRRDNEQFF	TRBV10-1	TRBJ2-1
TGTGCCAGCAGCAACGTTCTTTACAGTCTGTGCTACGAGCAGTACTTC	CASSNVLYSLCYEQYF	TRBV13	TRBJ2-7
TGTGCCAGCAGCGGGTTGGGGACTGGCGGAAGGAACACTGAAGCTTTCTTT	CASSGLGTGGRNTEAFF	TRBV7-3	TRBJ1-1
TGCAGTGCTAGACGTGGCGGACAGGGTCCTAGAGAAGCGTATGGCTACACCTTC	CSARRGGQGPREAYGYTF	TRBV20-1	TRBJ1-2
TGTGCCAGCAGCTTAGTCAGCCCGGGACAGTATCAAAGATACACCGGGGAGCTGTTTTTT	CASSLVSPGQYQRYTGELFF	TRBV11-3	TRBJ2-2
TGTGCCAGCAGCTTGATTGGCAGGGGGCTTCGTGATGAAAAACTGTTTTTT	CASSLIGRGLRDEKLFF	TRBV7-9	TRBJ1-4
TGTGCCAGCAGTTCCCCCTGGACGAACACTGAAGCTTTCTTT	CASSSPWTNTEAFF	TRBV12-3	TRBJ1-1
TGTGCCAGCGGGAGACAGGAAGGAGAAGCTTTCTTT	CASGRQEGEAFF	TRBV6-5	TRBJ1-1
TGTGCCAGCAGCGGGCCCCCCTATAATTCACCCCTCCACTTT	CASSGPPYNSPLHF	TRBV13	TRBJ1-6
TGTGCCAGCAGCCAAGAGGAGGACAGCAACACTGAAGCTTTCTTT	CASSQEEDSNTEAFF	TRBV14	TRBJ1-1
TGCAGTGCTAGAGTTGGGGAGGGGAAGAACACTGAAGCTTTCTTT	CSARVGEGKNTEAFF	TRBV20-1	TRBJ1-1
TGTGCCACCAGTGATTTCAAAGACAGGGGTAGCTCCTACAATGAGCAGTTCTTC	CATSDFKDRGSSYNEQFF	TRBV24-1	TRBJ2-1
TGTGCCTGGAGTTCTGTGCAAGATAACCAATCCCCGGGACTAGACACCGGGGAGCTGTTTTTT	CAWSSVQDNQSPGLDTGELFF	TRBV30	TRBJ2-2
TGTGCCAGCAGTTCCGGGACAGCGCCCCAGCATTTT	CASSSGTAPQHF	TRBV6-2	TRBJ1-5
TGTGCCATTATGGGACAGGGGGCGGGGGCGGCCAAAAACATTCAGTACTTC	CAIMGQGAGAAKNIQYF	TRBV10-3	TRBJ2-4
TGTGCCAGCAGGGGCAGACGTCGGACAGGGGGCGCGGGTATCCCTTCTGAGACCCAGTACTTC	CASRGRRRTGGAGIPSETQYF	TRBV2	TRBJ2-5
TGTGCCAGCAGTTGGTTCAGTAACAGTGGGGAGAATTGCGGGCCCCAGCATTTT	CASSWFSNSGENCGPQHF	TRBV6-8	TRBJ1-5
TGTGCCATCACGCACAGGGTCCACACTGAAGCTTTCTTT	CAITHRVHTEAFF	TRBV10-3	TRBJ1-1
TGTGCCAGCAGTTACTCGCGGTCGGTCGGTGAAAAACTGTTTTTT	CASSYSRSVGEKLFF	TRBV6-5	TRBJ1-4
TGTGCTAGTGGGGGATCTCGGGGGAGGAGCACCTACAATGAGCAGTTCTTC	CASGGSRGRSTYNEQFF	TRBV12-5	TRBJ2-1
TGTGCCAGGGTGGACTATCCGTGTTTCTCTGGAAACACCATATATTTT	CARVDYPCFSGNTIYF	TRBV25-1	TRBJ1-3
TGCGCCAGCAGAGACGGACAGGCCCTCACCGGGGAGCTGTTTTTT	CASRDGQALTGELFF	TRBV10-1	TRBJ2-2
TGTGCCAGCAGCCCCGAGACAGGGGGACTGAACACTGAAGCTTTCTTT	CASSPETGGLNTEAFF	TRBV28	TRBJ1-1
TGTGCCAGCAGCTTGGGGCTCGGGACCAAAGGGGCCTACAATGAGCAGTTCTTC	CASSLGLGTKGAYNEQFF	TRBV5-6	TRBJ2-1
TGTGCCACCAGTGATTTCGGGGGTGCGGGAGGGGGTGGGAGCAATCAGCCCCAGCATTTT	CATSDFGGAGGGGSNQPQHF	TRBV24-1	TRBJ1-5
TGTGCCAGCAGTGAGAGGGGGAACTCTGGGGCCAACGTCCTGACTTTC	CASSERGNSGANVLTF	TRBV25-1	TRBJ2-6
TGCGCCAGCAACTTTCAAGGGCAGTCGGGCTATGGCTACACCTTC	CASNFQGQSGYGYTF	TRBV10-1	TRBJ1-2
TGTGCCAGCAGTTTAAGGACGGGCTGGAGAACAGCTAATGAGCAGTTCTTC	CASSLRTGWRTANEQFF	TRBV12-3	TRBJ2-1
TGTGCCACCAGCAATGACACGGCCTTCAATGAGCAGTTCTTC	CATSNDTAFNEQFF	TRBV15	TRBJ2-1
TGTGCCAGTACTCATGAGCAGTTCTTC	CASTHEQFF	TRBV19	TRBJ2-1
TGTGCCAGCAGGCCTAGCAAGAACACTGAAGCTTTCTTT	CASRPSKNTEAFF	TRBV6-1	TRBJ1-1
TGTGCCAGCAGCTCCCAGTTGACCCAGTACTTC	CASSSQLTQYF	TRBV11-3	TRBJ2-5
TGTGCCAGCATCACCCGGGCAGCAGATACGCAGTATTTT	CASITRAADTQYF	TRBV27	TRBJ2-3
TGCGCCAGCAGCTTGGTAGCGACAGGGGCGGGCTACACCTTC	CASSLVATGAGYTF	TRBV5-1	TRBJ1-2
TGTGCCAGCAGCTTACTACCTAGAGGGTACGAGCAGTACTTC	CASSLLPRGYEQYF	TRBV5-6	TRBJ2-7
TGCAGTGCTAGGTTTCCGGGACAGTGTGACGAGCAGTACTTC	CSARFPGQCDEQYF	TRBV20-1	TRBJ2-7
TGTGCCAGCAGCTTAGCGCCCCTCCTGCGGAGGATCTATGGCTACACCTTC	CASSLAPLLRRIYGYTF	TRBV7-9	TRBJ1-2
TGTGCCAGCAGACTATCCACCGGGACTCATCAGCCCCAGCATTTT	CASRLSTGTHQPQHF	TRBV6-1	TRBJ1-5
TGTGCCACCACAGCTAATGAAAAACTGTTTTTT	CATTANEKLFF	TRBV24-1	TRBJ1-4
TGTGCCGGAGTAGGGGTCGACGAGCAGTACTTC	CAGVGVDEQYF	TRBV27	TRBJ2-7
TGCGCCAGCAGCAGACAGAGAGGGAATAATGAAAAACTGTTTTTT	CASSRQRGNNEKLFF	TRBV5-1	TRBJ1-4
TGCAGTGCTAGACCGACTGAAGCTTTCTTT	CSARPTEAFF	TRBV20-1	TRBJ1-1
TGTGCCAGATTTGCAAAAAGTTTGGGACAGGGTCTTAGCACAGATACGCAGTATTTT	CARFAKSLGQGLSTDTQYF	TRBV19	TRBJ2-3
TGTGCCAGCAGCCAAGATTCCGGGACAGATGAGCGCAATCAGCCCCAGCATTTT	CASSQDSGTDERNQPQHF	TRBV3-1	TRBJ1-5
TGTGCCAGCAGAGTAGAACGACTAGCGGGAGGGGGGGGGAGCTCCTACAATGAGCAGTTCTTC	CASRVERLAGGGGSSYNEQFF	TRBV27	TRBJ2-1
TGTGCCAGCAGGGACCGGGGGGCTGGGGGGGATACGCAGTATTTT	CASRDRGAGGDTQYF	TRBV14	TRBJ2-3
TGTGCCTGGAGTGCGGCGTTTTCCGGGACAGTCCCATATAGCAATCAGCCCCAGCATTTT	CAWSAAFSGTVPYSNQPQHF	TRBV30	TRBJ1-5
TGCGCCAGCAGCCAGACAGGCAATGAGCAGTTCTTC	CASSQTGNEQFF	TRBV5-1	TRBJ2-1
TGTGCCACCAGTGATTCCGGGGCGGGACTAGCGATAAGCACAGATACGCAGTATTTT	CATSDSGAGLAISTDTQYF	TRBV24-1	TRBJ2-3
TGCGCCAGCAGCTTGAGGACAGTGCACTATGGCTACACCTTC	CASSLRTVHYGYTF	TRBV5-1	TRBJ1-2
TGTGCCAGCAGCTTCCCACCGGGACAGGGGTTGGTCTCTGGAAACACCATATATTTT	CASSFPPGQGLVSGNTIYF	TRBV7-9	TRBJ1-3
TGTGCCACCCCAGGAGAGACCCAGTACTTC	CATPGETQYF	TRBV24-1	TRBJ2-5
TGTGCCAGCAGTACCACGCAGCTCCATCTGAACACTGAAGCTTTCTTT	CASSTTQLHLNTEAFF	TRBV6-1	TRBJ1-1
TGTGCCAGTAGTATAGGACAGGGTAACTATGGCTACACCTTC	CASSIGQGNYGYTF	TRBV19	TRBJ1-2
TGTGCCAGCAGCAATCCCCCGGGAGGGTACAATGAGCAGTTCTTC	CASSNPPGGYNEQFF	TRBV13	TRBJ2-1
TGTGCCAGCAGTTGGGGGGTTACGGGGAGACACAGGTACGAGCAGTACTTC	CASSWGVTGRHRYEQYF	TRBV28	TRBJ2-7
TGTGCCAGCAGCTATGGTCCTGCGCCACTAGGATGCTATACCTACAATGAGCAGTTCTTC	CASSYGPAPLGCYTYNEQFF	TRBV7-2	TRBJ2-1
TGTGCCAGCAGCTGTAGGGTAACCTATGGCTACACCTTC	CASSCRVTYGYTF	TRBV7-9	TRBJ1-2
TGCAGCGTTGACCATGGGGCGATGAACCCGGTCACAGATACGCAGTATTTT	CSVDHGAMNPVTDTQYF	TRBV29-1	TRBJ2-3
TGTGCCAGCTCACCGACCACAGCAGCTTTCTTT	CASSPTTAAFF	TRBV18	TRBJ1-1
TGTGCCAGCAGTTACTCGATCCCAGCCCGAGACCGGAGAGAGACCCAGTACTTC	CASSYSIPARDRRETQYF	TRBV6-5	TRBJ2-5
TGCGCCAGCAGCCAGAAACCGGGACAGGGGGTACCGGAAGCCTACGAGCAGTACTTC	CASSQKPGQGVPEAYEQYF	TRBV4-3	TRBJ2-7
TGTGCCAGCAGCGGACTAGCGGACCTACCGACAGATACGCAGTATTTT	CASSGLADLPTDTQYF	TRBV11-1	TRBJ2-3
TGTGCCATCAGCTCCGGGACAGGGGGTAAGACAGATACGCAGTATTTT	CAISSGTGGKTDTQYF	TRBV10-3	TRBJ2-3
TGCGCCAGCAGTGGGTGCGGACAGGGCTCCAACTATGGCTACACCTTC	CASSGCGQGSNYGYTF	TRBV10-1	TRBJ1-2
TGTGCCAGCAGTCTCGGGAGGAGGAACACTGAAGCTTTCTTT	CASSLGRRNTEAFF	TRBV12-4	TRBJ1-1
TGCGCCAGCAGCCAAGAGGAAACCGCGACTAGCGGGGGAATCTACGAGCAGTACTTC	CASSQEETATSGGIYEQYF	TRBV4-1	TRBJ2-7
TGTGCCAGCAGTCCGCGGAGTCCCTGGACGACGAAAGATTACAATGAGCAGTTCTTC	CASSPRSPWTTKDYNEQFF	TRBV27	TRBJ2-1
TGCGCCAGCAGCTTGCCGCCGGACAGGGCGGCTCCCCATTACGAGCAGTACTTC	CASSLPPDRAAPHYEQYF	TRBV5-1	TRBJ2-7
TGTGCTAGTGTAACTAGCGGATTGAAAAACATTCAGTACTTC	CASVTSGLKNIQYF	TRBV12-5	TRBJ2-4
TGTGCCATCAGTGCGCCTCCCGGGAGGAGCACAGATACGCAGTATTTT	CAISAPPGRSTDTQYF	TRBV10-3	TRBJ2-3
TGTGCCAGCAGCTTAGAGGGCAGCTCTGGAAACACCATATATTTT	CASSLEGSSGNTIYF	TRBV7-9	TRBJ1-3
TGTGCCAGCAGTTACACAGGGGGTAACACTGAAGCTTTCTTT	CASSYTGGNTEAFF	TRBV28	TRBJ1-1
TGTGCCAGCGAGTACTACGAGCAGTACTTC	CASEYYEQYF	TRBV7-2	TRBJ2-7
TGTGCCAGCAGCCACCTTGGCCGCTATGGCTACACCTTC	CASSHLGRYGYTF	TRBV14	TRBJ1-2
TGTGCCAGCAGCTTCGAACCCCCGCCTCTAAAGGGGGACAATGAGCAGTTCTTC	CASSFEPPPLKGDNEQFF	TRBV5-5	TRBJ2-1
TGTGCCAGCAAAATGACTAGCGGGGATCGCCTGAACACCGGGGAGCTGTTTTTT	CASKMTSGDRLNTGELFF	TRBV12-4	TRBJ2-2
TGTGCCAGCAGCTTGCTAATCAGGGGGGCCCAGGTAAACATTCAGTACTTC	CASSLLIRGAQVNIQYF	TRBV5-6	TRBJ2-4
TGCGCCAGCACCGGGTTAGGGGGCGTGAATCAGCCCCAGCATTTT	CASTGLGGVNQPQHF	TRBV5-1	TRBJ1-5
TGTGCCAGCAGCGCTAGCCCATGGGGCGGGGGCTCTGGAAACACCATATATTTT	CASSASPWGGGSGNTIYF	TRBV13	TRBJ1-3
TGCGCCAGCAGCCCGAGAAGAGGCCGGGGGGAAGTCGGCTACACCTTC	CASSPRRGRGEVGYTF	TRBV4-1	TRBJ1-2
TGTGCCAGCAGCGTAAACCACGGGACAGGGGCCGGTTTGGGGGACTACGAGCAGTACTTC	CASSVNHGTGAGLGDYEQYF	TRBV9	TRBJ2-7
TGTGCCAGCAACCTTCAGGATCGCTTGAGCACAGATACGCAGTATTTT	CASNLQDRLSTDTQYF	TRBV25-1	TRBJ2-3
TGTGCCACCCCGGCAGGGGAGCAGTTCTTC	CATPAGEQFF	TRBV24-1	TRBJ2-1
TGTGCCATCAGTGCTACAGGTACTTGTAACTATGGCTACACCTTC	CAISATGTCNYGYTF	TRBV10-3	TRBJ1-2
TGTGCCAGCAGCGGAAGGGACAGGGGTTGGCGCAATCAGCCCCAGCATTTT	CASSGRDRGWRNQPQHF	TRBV6-4	TRBJ1-5
TGTGCCAGCAGCCAACCTTCAACCACAGGAAACACCATATATTTT	CASSQPSTTGNTIYF	TRBV3-1	TRBJ1-3
TGTGCCAGCAGCTACAGGGATCTCACAGATACGCAGTATTTT	CASSYRDLTDTQYF	TRBV11-3	TRBJ2-3
TGTGCCAGCAGCTGTTTAGGGGGGCCAACAATCACTGAAGCTTTCTTT	CASSCLGGPTITEAFF	TRBV7-9	TRBJ1-1
TGTGCCAGCAGTGACTCGTTACTGGACTGCTACTACGAGCAGTACTTC	CASSDSLLDCYYEQYF	TRBV6-4	TRBJ2-7
TGTGCCAGCTCTCCGGGACAGGAAGCTTTCTTT	CASSPGQEAFF	TRBV18	TRBJ1-1
TGTGCCAGCAGGCCAGGGGTCCAAGAGACCCAGTACTTC	CASRPGVQETQYF	TRBV2	TRBJ2-5
TGTGCCAGCAGTCGGAGCCAGGAAAAGGGAAACGGGGAGCTGTTTTTT	CASSRSQEKGNGELFF	TRBV27	TRBJ2-2
TGCAGTGCTGGGGGGAAACCTAAGGCATATGGCTACACCTTC	CSAGGKPKAYGYTF	TRBV20-1	TRBJ1-2
TGCGCCAGCAGCCAAGATCCCGGGGCAGCGTGTCAGCCCCAGCATTTT	CASSQDPGAACQPQHF	TRBV4-1	TRBJ1-5
TGTGCCAGCAGGGGGGCTGCCGTCTACGAGCAGTACTTC	CASRGAAVYEQYF	TRBV27	TRBJ2-7
TGCGCCAGCAGAGGACAGGGCGGAAACACCATATATTTT	CASRGQGGNTIYF	TRBV4-1	TRBJ1-3
TGTGCCAGCAGCGAGGAGGCACCGGGACCGGAGGCCTACGAGCAGTACTTC	CASSEEAPGPEAYEQYF	TRBV7-9	TRBJ2-7
TGTGCCACCGGGGGGACAGCTCCGCCCCAGCATTTT	CATGGTAPPQHF	TRBV24-1	TRBJ1-5
TGTGCCAGCAGCTTGCTAGCGGGTGTAAGTTGGCCAAGTCCCATAGCCTACGAGCAGTACTTC	CASSLLAGVSWPSPIAYEQYF	TRBV7-3	TRBJ2-7
TGTGCCAGCACGAGGGGCAATCAGCCCCAGCATTTT	CASTRGNQPQHF	TRBV11-3	TRBJ1-5
TGCGCCAGCAGCCAAAGAAACCCCCGGGACAACCGAGCCTACGAGCAGTACTTC	CASSQRNPRDNRAYEQYF	TRBV4-1	TRBJ2-7
TGCGCCAGCAGCATTACGACAGGGGGCGGGAACACTGAAGCTTTCTTT	CASSITTGGGNTEAFF	TRBV5-1	TRBJ1-1
TGCAGTGCTAGAGATCAGGGGCTATATAATTCACCCCTCCACTTT	CSARDQGLYNSPLHF	TRBV20-1	TRBJ1-6
TGTGAAACCGGGACAGGGAGCGGAAACACCATATATTTT	CETGTGSGNTIYF	TRBV9	TRBJ1-3
TGCAGTGCTAGAGATCGGAGCGGGAGGGCTCAGCCCCAGCATTTT	CSARDRSGRAQPQHF	TRBV20-1	TRBJ1-5
TGTGCCAGCACGGGACTAGCGGGGGGGTCGGTAACCACAGATACGCAGTATTTT	CASTGLAGGSVTTDTQYF	TRBV6-4	TRBJ2-3
TGTGCCAGCACCGGGTACTTTCTGAACATTCAGTACTTC	CASTGYFLNIQYF	TRBV6-5	TRBJ2-4
TGTGCCAGCAGTGAGGCAGGGCGGCTGGACACCATATATTTT	CASSEAGRLDTIYF	TRBV2	TRBJ1-3
TGTGCCAGCAAAACCGGGACTAGCGGGAGTTTCCAAGAGACCCAGTACTTC	CASKTGTSGSFQETQYF	TRBV2	TRBJ2-5
TGTGCCAGCAGTTACTCGCCACTGAATATTTCTAGCTCCTACAATGAGCAGTTCTTC	CASSYSPLNISSSYNEQFF	TRBV6-3	TRBJ2-1
TGTGCCAGTGGGGAGGGGAGGGACAATGAGCAGTTCTTC	CASGEGRDNEQFF	TRBV5-4	TRBJ2-1
TGTGCCAGCACCATCGGACAGCCGGCCTACGAGCAGTACTTC	CASTIGQPAYEQYF	TRBV7-4	TRBJ2-7
TGTGCCAGCAGTAATAGGGGAGAGACCCAGTACTTC	CASSNRGETQYF	TRBV27	TRBJ2-5
TGTGCCAGCAGTGGGACAGGGGAAAACATTCAGTACTTC	CASSGTGENIQYF	TRBV2	TRBJ2-4
TGTGCCAGCAGCTCGCTGGCCGGGACAGGGGGTTCTGAAGCTTTCTTT	CASSSLAGTGGSEAFF	TRBV11-3	TRBJ1-1
TGTGCCAGCAGCTTGGACAGGGCAGGGAACTACGAGCAGTACTTC	CASSLDRAGNYEQYF	TRBV7-9	TRBJ2-7
TGTGCCAGCACGAGCAGGGGAACCAACTTC	CASTSRGTNF	TRBV6-4	TRBJ1-2
TGTGCCAGCAGCTTGGCAATCGAGGCAGGGGGTGGCAATCAGCCCCAGCATTTT	CASSLAIEAGGGNQPQHF	TRBV11-2	TRBJ1-5
TGCGCCAGCAGCCAGGAAATCGGTCTCTACGAGCAGTACTTC	CASSQEIGLYEQYF	TRBV4-3	TRBJ2-7
TGTGCGGGACTAGTATGTGGGCCGGATACGCAGTATTTT	CAGLVCGPDTQYF	TRBV15	TRBJ2-3
TGTGCCAGCAGAAGGCAGGGGACGCCGAGCAATCAGCCCCAGCATTTT	CASRRQGTPSNQPQHF	TRBV12-4	TRBJ1-5
TGTGCCAGCAGCTTATACGCGCAAGGGACAGAGGTAACCACTGAAGCTTTCTTT	CASSLYAQGTEVTTEAFF	TRBV7-3	TRBJ1-1
TGTGCCAGCAGTGGGCTGCTGGGGACTAGTAGTGGCGAGACCCAGTACTTC	CASSGLLGTSSGETQYF	TRBV5-4	TRBJ2-5
TGTGCTAGCAGCCCCCCGGGACAGGGGGCGAATCAGCCCCAGCATTTT	CASSPPGQGANQPQHF	TRBV7-7	TRBJ1-5
TGTGCCAGCAGTAAATCGACTAGCGGAGAGACCCAGTACTTC	CASSKSTSGETQYF	TRBV28	TRBJ2-5
TGTGCCAGCAGTGGCGCTTCGAGGGCTGAAGCTTTCTTT	CASSGASRAEAFF	TRBV6-1	TRBJ1-1
TGTGCCAGCAGACAGGGGCCCCACTCTGGAAACACCATATATTTT	CASRQGPHSGNTIYF	TRBV28	TRBJ1-3
TGTGCCAGCAGCCGAAACAGGGGCCACGACGAGCAGTACTTC	CASSRNRGHDEQYF	TRBV7-6	TRBJ2-7
TGTGCCAGCAGCGAGGACGCACTAAGCTCCTACAATGAGCAGTTCTTC	CASSEDALSSYNEQFF	TRBV7-9	TRBJ2-1
TGTGCCAGCAGCCAAGAAGCTAGAACGGCCTTGGATACGCAGTATTTT	CASSQEARTALDTQYF	TRBV3-1	TRBJ2-3
TGTGCCAGCAGCTGGGGAGTAACCACGAGTGGCTACACCTTC	CASSWGVTTSGYTF	TRBV14	TRBJ1-2
TGCAGTGCTAGAGAGCCCCGACAGGGCTGTGGCAACTATGGCTACACCTTC	CSAREPRQGCGNYGYTF	TRBV20-1	TRBJ1-2
TGTGCCAGCAGCGTGGGGGGGGAGCTGTTTTTT	CASSVGGELFF	TRBV5-5	TRBJ2-2
TGCAGTGCAGGACAGAGCCGAAACCAGCCCCAGCATTTT	CSAGQSRNQPQHF	TRBV20-1	TRBJ1-5
TGTGCCTGGTCCCCGAACGACTATGGCTACACCTTC	CAWSPNDYGYTF	TRBV30	TRBJ1-2
TGCAGTGCTTTAGCCAGGGACCAGGAAAATCAGCCCCAGCATTTT	CSALARDQENQPQHF	TRBV20-1	TRBJ1-5
TGTGCCAGCAGCTTTCGGGGGGGCTTAGGGGAGCTGTTTTTT	CASSFRGGLGELFF	TRBV5-5	TRBJ2-2
TGTGCCAGCAGCGATGGGTGGGGTGGGGGGAAAGCCTACAATGAGCAGTTCTTC	CASSDGWGGGKAYNEQFF	TRBV7-9	TRBJ2-1
TGCGCCACCCCCGTAGTGGGGACAGGTGATAGTCAGCCCCAGCATTTT	CATPVVGTGDSQPQHF	TRBV5-1	TRBJ1-5
TGTGCCAGCAGCCAAGATCAGACAGTGAAGCCCGGCTACACCTTC	CASSQDQTVKPGYTF	TRBV3-1	TRBJ1-2
TGTGCCACCAGTGAAACGCAGGGGGCTTCTGCGTACGAGCAGTACTTC	CATSETQGASAYEQYF	TRBV24-1	TRBJ2-7
TGTGCCAGCAGTCCGGATAAGGGGGGGTGGGATGAGCAGTTCTTC	CASSPDKGGWDEQFF	TRBV6-6	TRBJ2-1
TGTGCCATCAGTGAGTTAGTCCCGCGGGAGTTTTGCACAGATACGCAGTATTTT	CAISELVPREFCTDTQYF	TRBV10-3	TRBJ2-3
TGTGCCAGCAGCCCTCCCCGAGCTTCGGATAGCAATCAGCCCCAGCATTTT	CASSPPRASDSNQPQHF	TRBV13	TRBJ1-5
TGTGCCACCAGAACTAGGATGCCGGGACAGGGGGCCCGCTACGAGCAGTACTTC	CATRTRMPGQGARYEQYF	TRBV15	TRBJ2-7
TGTGCCAGCAGTTGCGACCGCAATCAGCCCCAGCATTTT	CASSCDRNQPQHF	TRBV27	TRBJ1-5
TGTGCCAGCAGTGACTCTCCCACCGGATCTAACTATGGCTACACCTTC	CASSDSPTGSNYGYTF	TRBV6-4	TRBJ1-2
TGTGCCAGTAGTATAGCCGCAGTAGACATGAACAATCAGCCCCAGCATTTT	CASSIAAVDMNNQPQHF	TRBV19	TRBJ1-5
TGTGCCAGCAGTTTCTACGACAGGGGTACACAGGTTTCCTACGAGCAGTACTTC	CASSFYDRGTQVSYEQYF	TRBV28	TRBJ2-7
TGTGCCAGCAGCTTGACCCGTCTGTCTGGAAACACCATATATTTT	CASSLTRLSGNTIYF	TRBV6-5	TRBJ1-3
TGTGCCAGCAGTTTAGGGGGGGGGCCCTTCGAGACCCAGTACTTC	CASSLGGGPFETQYF	TRBV12-4	TRBJ2-5
TGTGCCAGCAGCTCGAGCGGGGGGACCACAGATACGCAGTATTTT	CASSSSGGTTDTQYF	TRBV13	TRBJ2-3
TGTGCCAGCAGCTTCCCTAAGGACAGGTCGCAAGAGACCCAGTACTTC	CASSFPKDRSQETQYF	TRBV11-2	TRBJ2-5
TGTGCCAGCAGTGCAAAAGGGGGACAGGGTCTGGGTAACACCGGGGAGCTGTTTTTT	CASSAKGGQGLGNTGELFF	TRBV2	TRBJ2-2
TGCGCCAGCAGGTACATAAGGGGGGGACAGATTCAAGAGACCCAGTACTTC	CASRYIRGGQIQETQYF	TRBV10-2	TRBJ2-5
TGTGCCAGCTCACCACCGTCAAGCGGGGGCGGGTTAAAGCCCCAGCATTTT	CASSPPSSGGGLKPQHF	TRBV18	TRBJ1-5
TGTGCCAGCAGTTACTCAAGGGACTGGTACTTC	CASSYSRDWYF	TRBV6-5	TRBJ2-5
TGTGCCAGCAGATCTCCCTTCTTGGGGCACGAGCAGTACTTC	CASRSPFLGHEQYF	TRBV6-5	TRBJ2-7
TGTGCCAGTAGTAACAGGGCCTACCTCTATGGCTACACCTTC	CASSNRAYLYGYTF	TRBV19	TRBJ1-2
TGTGCCAGCAGTGATATTCCCCTCGACAGGGGTTTGGAGAGAGCCTCTGGGGCCAACGTCCTGACTTTC	CASSDIPLDRGLERASGANVLTF	TRBV6-4	TRBJ2-6
TGCAGCGTTGCTCGGTTATCATCCTACGAGCAGTACTTC	CSVARLSSYEQYF	TRBV29-1	TRBJ2-7
TGTGCCACCAGTGGTTGCAGGGAGGAGTACACCGGGGAGCTGTTTTTT	CATSGCREEYTGELFF	TRBV24-1	TRBJ2-2
TGCAGTGCTAGACGGGGGGACATAGCAACTAATGAAAAACTGTTTTTT	CSARRGDIATNEKLFF	TRBV20-1	TRBJ1-4
TGTGCCAGCAGTTTAGCGGACGGGCGGAATGGCTACACCTTC	CASSLADGRNGYTF	TRBV12-4	TRBJ1-2
TGTGCCAGCAGTGAAGAGCCTCGAGGGCCTTCTGAAAAACTGTTTTTT	CASSEEPRGPSEKLFF	TRBV2	TRBJ1-4
TGTGCCAGCAGTCAGGGCCAGTGTATAACATATGGCTACACCTTC	CASSQGQCITYGYTF	TRBV6-1	TRBJ1-2
TGTGCCAGTGGCCGGGACAAGGACACTGAAGCTTTCTTT	CASGRDKDTEAFF	TRBV6-1	TRBJ1-1
TGTGCCAGCGGGGGCAAGGCTACAGGGACTGATGGCTACACCTTC	CASGGKATGTDGYTF	TRBV6-4	TRBJ1-2
TGTGCCACCAGTGAGAGAGGACAGGGGGCCAGCAAAAACATTCAGTACTTC	CATSERGQGASKNIQYF	TRBV24-1	TRBJ2-4
TGTGCCAGCAGCTTCGGCGGGAGTCAGAGAGAGCAGTTCTTC	CASSFGGSQREQFF	TRBV11-3	TRBJ2-1
TGCGCCAGCCGGACGCCCAGGGACACTGAAGCTTTCTTT	CASRTPRDTEAFF	TRBV10-2	TRBJ1-1
TGTGCCAGCAGTGAACGCCGCAACCAGGGGAGAGAAAAACTGTTTTTT	CASSERRNQGREKLFF	TRBV6-4	TRBJ1-4
TGTGCCAGCGAGGACAGGGCCACAGAGACCCAGTACTTC	CASEDRATETQYF	TRBV6-4	TRBJ2-5
TGTGCCAGGACAGGGTATAGCAATCAGCCCCAGCATTTT	CARTGYSNQPQHF	TRBV7-9	TRBJ1-5
TGTGCCATCACCGCAGGGGTTTCAGATACGCAGTATTTT	CAITAGVSDTQYF	TRBV10-3	TRBJ2-3
TGTGCCAGCAGTGAATTCCGTTTGGGGGCGGGAAGCAATCAGCCCCAGCATTTT	CASSEFRLGAGSNQPQHF	TRBV25-1	TRBJ1-5
TGTGCCTGGACTAGTCAGGGGGAGCCGGATACGCAGTATTTT	CAWTSQGEPDTQYF	TRBV30	TRBJ2-3
TGTGCCTGGACTGCCAGGGGGCGTCACACCGGGGAGCTGTTTTTT	CAWTARGRHTGELFF	TRBV30	TRBJ2-2
TGTGCCAGCAGCCAGGGGGGGGAAGTGTCCTACAATGAGCAGTTCTTC	CASSQGGEVSYNEQFF	TRBV13	TRBJ2-1
TGTGCCAGCAGCCGCCCTGCGACAGAGGCTGGAAACACCATATATTTT	CASSRPATEAGNTIYF	TRBV7-9	TRBJ1-3
TGCGCCAGCAGTGAATCCCGGGACAGGGGTCCCAGCTCTGGAAACACCATATATTTT	CASSESRDRGPSSGNTIYF	TRBV10-1	TRBJ1-3
TGTGCCAGCACCCCCAGGTGCACCGGGGAGCTGTTTTTT	CASTPRCTGELFF	TRBV5-4	TRBJ2-2
TGCAGTGCTAGATTACGGACAGGCCCAAACAATCAGCCCCAGCATTTT	CSARLRTGPNNQPQHF	TRBV20-1	TRBJ1-5
TGTGCCAGCAGCCAGTTCGACAGGGAGGGGCGCCGGATCCACTATGGCTACACCTTC	CASSQFDREGRRIHYGYTF	TRBV3-1	TRBJ1-2
TGCGCCAGCAGCTTTGAGGGGGGGCGGGACAGGCAGACCTCCTACGAGCAGTACTTC	CASSFEGGRDRQTSYEQYF	TRBV5-1	TRBJ2-7
TGTGCCAGCAGCTGGTGCAGGGGGCTAAACGTTTATGGTGAGGCGGCTAACTATGGCTACACCTTC	CASSWCRGLNVYGEAANYGYTF	TRBV5-6	TRBJ1-2
TGTGCCAGCAGTTTAGGCCGGATGCCTGGACAGCCAGAGACCCAGTACTTC	CASSLGRMPGQPETQYF	TRBV27	TRBJ2-5
TGTGCCAGCAGCATGGGGGCCGGGGAGCAGTACTTC	CASSMGAGEQYF	TRBV5-4	TRBJ2-7
TGTGCAATCGACAGGCCCAACAACAATGAGCAGTTCTTC	CAIDRPNNNEQFF	TRBV11-3	TRBJ2-1
TGTGCCACCAGTGATTTGAAAGGGCTTGGAAACACCATATATTTT	CATSDLKGLGNTIYF	TRBV24-1	TRBJ1-3
TGTGCCAGCGGTCCCGACAGGGGTGGCGAGGCCTACGAGCAGTACTTC	CASGPDRGGEAYEQYF	TRBV5-8	TRBJ2-7
TGCAGTGCTAGGGTCGGGGAGGAGATGGTCACAGATACGCAGTATTTT	CSARVGEEMVTDTQYF	TRBV20-1	TRBJ2-3
TGCAGCGTTGAAGAGGGAAACACGATAGCGGGTGGATATTTT	CSVEEGNTIAGGYF	TRBV29-1	TRBJ2-3
TGTGCCAGCAGCCAAGATGGACAGGGCGGGTCTAGCAATCAGCCCCAGCATTTT	CASSQDGQGGSSNQPQHF	TRBV3-1	TRBJ1-5
TGTGCCAGCAGCAACGGAGGGTCTGGCTCCTATAATTCACCCCTCCACTTT	CASSNGGSGSYNSPLHF	TRBV11-2	TRBJ1-6
TGTGCCAGCAGGTGCAGGGGACAGGACGATCAGCCCCAGCATTTT	CASRCRGQDDQPQHF	TRBV3-1	TRBJ1-5
TGTGCCAGCAGTGAAGCGCTTGGGGCCTCCTATAATTCACCCCTCCACTTT	CASSEALGASYNSPLHF	TRBV2	TRBJ1-6
TGTGCCAGCAGCTCTTCGAGGCGCGGTATATACGGCAGCTCCTACAATGAGCAGTTCTTC	CASSSSRRGIYGSSYNEQFF	TRBV5-4	TRBJ2-1
TGTGCCAGCCTTGGACCATCTGAAGCTTTCTTT	CASLGPSEAFF	TRBV7-9	TRBJ1-1
TGTGCCAGCAGCGTAGCTCCCGGGAATCAGCCCCAGCATTTT	CASSVAPGNQPQHF	TRBV9	TRBJ1-5
TGCGCCCCCGACGGTGAGACCCAGTACTTC	CAPDGETQYF	TRBV10-2	TRBJ2-5
TGCAGTGCTAGGGGGCCGATGAACACTGAAGCTTTCTTT	CSARGPMNTEAFF	TRBV20-1	TRBJ1-1
TGTGCCAGCTCACCACCTAAACCCGGCGAAAGCACTGAAGCTTTCTTT	CASSPPKPGESTEAFF	TRBV18	TRBJ1-1
TGCGCCAGCAGCCTTCCAGCGAACACCGGGGAGCTGTTTTTT	CASSLPANTGELFF	TRBV4-3	TRBJ2-2
TGTGCCAGCAGTGATTGGGACAGATCCACAGATACGCAGTATTTT	CASSDWDRSTDTQYF	TRBV25-1	TRBJ2-3
TGTGCCACCTGCGTATGGGAGGCCTTCTTAGCCAAAAACATTCAGTACTTC	CATCVWEAFLAKNIQYF	TRBV24-1	TRBJ2-4
TGTGCCACCAGTGATACAGGGGGGCGGATCCAAGAGACCCAGTACTTC	CATSDTGGRIQETQYF	TRBV24-1	TRBJ2-5
TGTGCCAGCAGCTTAGATGGATTTCAGGGGGCAGATACGCAGTATTTT	CASSLDGFQGADTQYF	TRBV11-3	TRBJ2-3
TGCGCCAGCAGCGGGGGTCAGCCCCAGCATTTT	CASSGGQPQHF	TRBV4-1	TRBJ1-5
TGTGCCAGCAACGGACGGGACAGGGTAAATAGGGACGAGCAGTACTTC	CASNGRDRVNRDEQYF	TRBV27	TRBJ2-7
TGTGCCAGCAGCTTGGGGGACGGGGCCACAGATACGCAGTATTTT	CASSLGDGATDTQYF	TRBV5-8	TRBJ2-3
TGTGCCAGCAGCGACACAGGGCGCAATGAGCAGTTCTTC	CASSDTGRNEQFF	TRBV9	TRBJ2-1
TGTGCCAGCTTGGGTCGGAGACAGGGGTGGACTAATGAAAAACTGTTTTTT	CASLGRRQGWTNEKLFF	TRBV5-8	TRBJ1-4
TGTGCCAGCAGCCAAGATTTACCGAATAGCTACGAGCAGTACTTC	CASSQDLPNSYEQYF	TRBV14	TRBJ2-7
TGTGCCAGCAGCCCCTGGGGACCTGAATACGAGCAGTACTTC	CASSPWGPEYEQYF	TRBV7-3	TRBJ2-7
TGTGCCAGCAGCTTAGAACTCACCAAAAACATTCAGTACTTC	CASSLELTKNIQYF	TRBV7-2	TRBJ2-4
TGTGCCACCAGTGACCCTTGTGACATAGGTGAAAAACTGTTTTTT	CATSDPCDIGEKLFF	TRBV24-1	TRBJ1-4
TGCGCCAGCCGTCCCAGGGGCCGTTCAGCCAAAAACATTCAGTACTTC	CASRPRGRSAKNIQYF	TRBV10-2	TRBJ2-4
TGTGCCAGCAGCCTGGGGGGTAGTACAGACCTTTCTGGCATAGGGACAGGGATTCATAGGTGCAATCAGCCCCAGCATTTT	CASSLGGSTDLSGIGTGIHRCNQPQHF	TRBV13	TRBJ1-5
TGCAGTGCTAGGAGTCGAGGGAGTAACGAGCAGTACTTC	CSARSRGSNEQYF	TRBV20-1	TRBJ2-7
TGTGCCAGCAGCAAACAGGGTCAGCCCCAGCATTTT	CASSKQGQPQHF	TRBV14	TRBJ1-5
TGCAGTGCTAGACTTATACTACCCGGGGGAAAGCACTATGGCTACACCTTC	CSARLILPGGKHYGYTF	TRBV20-1	TRBJ1-2
TGTGCCAGCAGCTTAGTGTCCCGGGGTGATGACGGGGAGCTGTTTTTT	CASSLVSRGDDGELFF	TRBV7-4	TRBJ2-2
TGCAGCGTTAGGGGGAACATTCAGTACTTC	CSVRGNIQYF	TRBV29-1	TRBJ2-4
TGTGCCAGCAGCGAGGCGGGCTATGGCTACACCTTC	CASSEAGYGYTF	TRBV13	TRBJ1-2
TGTGCCAGCAGGACAGGGGAGTGTAACTATGGCTACACCTTC	CASRTGECNYGYTF	TRBV27	TRBJ1-2
TGTGCCACCATCAGGACGACAGGGGGCTACACCTTC	CATIRTTGGYTF	TRBV24-1	TRBJ1-2
TGTGCCAGCAGCCAAGACACAGGGGGGACGACCGGGGAGCTGTTTTTT	CASSQDTGGTTGELFF	TRBV14	TRBJ2-2
TGTGCCTGGGGATCCCGAAACTTTCTTTCAGAAACCGGGGAGCTGTTTTTT	CAWGSRNFLSETGELFF	TRBV30	TRBJ2-2
TGTGCCAGCAGTACGACAGGGTTGAACTATGGCTACACCTTC	CASSTTGLNYGYTF	TRBV28	TRBJ1-2
TGTGCCAGCAGCGTAGTACCTAGCGGGAGCTCCTACAATGAGCAGTTCTTC	CASSVVPSGSSYNEQFF	TRBV9	TRBJ2-1
TGTGCCAGAGACAGATTCCTGAACACTGAAGCTTTCTTT	CARDRFLNTEAFF	TRBV7-9	TRBJ1-1
TGTGCCAGCAGTACCCTCAAAGGGCTTCAGAGCTCCTACGAGCAGTACTTC	CASSTLKGLQSSYEQYF	TRBV2	TRBJ2-7
TGTGCCAGCAGCTTAACCCCCATAATCGCAGGGAATGAGGATTCACCCCTCCACTTT	CASSLTPIIAGNEDSPLHF	TRBV7-2	TRBJ1-6
TGCAGTGCTCGGTGGCCAGCGGCGCGTGGGGCCTACGAGCAGTACTTC	CSARWPAARGAYEQYF	TRBV20-1	TRBJ2-7
TGCAGTGCTAGAGGGTCGGACAGGGGGCCATCTAGCAATCAGCCCCAGCATTTT	CSARGSDRGPSSNQPQHF	TRBV20-1	TRBJ1-5
TGTGCCAGCAGCGACCACAGACACCAGCCCCAGCATTTT	CASSDHRHQPQHF	TRBV13	TRBJ1-5
TGTGCCAGTAGTATAGACGGAACCCAGGACTGCGGGGTTTCAGATACGCAGTATTTT	CASSIDGTQDCGVSDTQYF	TRBV19	TRBJ2-3
TGTGCCAGCAGAGAGGGCCGGAGAGCCTACGAGCAGTACTTC	CASREGRRAYEQYF	TRBV13	TRBJ2-7
TGTGCCAGCAGCTTGGTCCGGTCTCTGACAGGGATTTTCTGGGACGAAGGAAACACCATATATTTT	CASSLVRSLTGIFWDEGNTIYF	TRBV5-8	TRBJ1-3
TGTGCCAGCAGTGACCTCCAGGGCAATCAGCCCCAGCATTTT	CASSDLQGNQPQHF	TRBV25-1	TRBJ1-5
TGTGCCAGCAGCCAATTGGGGGCAAAGGAGCAGTACTTC	CASSQLGAKEQYF	TRBV4-2	TRBJ2-7
TGTGCCATCAGTGAGGCAACGACCCCGGGACGGGGGCACTATGGCTACACCTTC	CAISEATTPGRGHYGYTF	TRBV10-3	TRBJ1-2
TGTGCCAGCAGCTTATCGTCCGGGGGGAATTGGCAGCCCCAGCATTTT	CASSLSSGGNWQPQHF	TRBV11-1	TRBJ1-5
TGTGCCAGCAGCCATAATCCTGGGACAAAGAACAGACGCTCCTACAATGAGCAGTTCTTC	CASSHNPGTKNRRSYNEQFF	TRBV5-5	TRBJ2-1
TGTGCCAGCAGCTTACCGAGGGGTTGGGAGCAGTTCTTC	CASSLPRGWEQFF	TRBV13	TRBJ2-1
TGTGCCAGCAGCTGCCGACCCCCGACGGGACAGACGTGTGGCTACACCTTC	CASSCRPPTGQTCGYTF	TRBV13	TRBJ1-2
TGTGCCAGCAGCATCGTAGCGGGTGGCCAAGAGACCCAGTACTTC	CASSIVAGGQETQYF	TRBV7-3	TRBJ2-5
TGTGCCAGCAGCGGCTTCAACGGGGCACACCCCAACAGATGGGAAGCTTTCTTT	CASSGFNGAHPNRWEAFF	TRBV7-2	TRBJ1-1
TGTGCCAGCAGACCCTTATGGAGTGGCTACACCTTC	CASRPLWSGYTF	TRBV3-1	TRBJ1-2
TGTGCCAGCAGTTGCCTTTTCCAGGGGTCGTTCTATGGCTACACCTTC	CASSCLFQGSFYGYTF	TRBV27	TRBJ1-2
TGCGCCAGGAACCATACCGTCTATTTT	CARNHTVYF	TRBV10-1	TRBJ1-3
TGTGCCAATGTCAGGAGGGAGCCCCAGCATTTT	CANVRREPQHF	TRBV6-1	TRBJ1-5
TGTGCCAGCCCGACAGGTTCACCCCTCCACTTT	CASPTGSPLHF	TRBV6-5	TRBJ1-6
TGTGCCAGCAGTTCCGGGACGCCAACGACGAACACCGGGGAGCTGTTTTTT	CASSSGTPTTNTGELFF	TRBV6-9	TRBJ2-2
TGTGCCAGCAGGGGGGGGGGGGCCTACGAGCAGTACTTC	CASRGGGAYEQYF	TRBV6-1	TRBJ2-7
TGTGCCAGCAGCCACCGGGACAGGGTGGGGGAACCGAGCTCCTATAATTCACCCCTCCACTTT	CASSHRDRVGEPSSYNSPLHF	TRBV5-4	TRBJ1-6
TGTGCCAGCTCACGGGAGTACAGGGGGAGGGGGGGGAGCAATCAGCCCCAGCATTTT	CASSREYRGRGGSNQPQHF	TRBV18	TRBJ1-5
TGTGCCAGCAGCCCTCTCGTCAGTCAGTACTTC	CASSPLVSQYF	TRBV11-3	TRBJ2-5
TGTGCCAGCCCGTATCAGGGCAATCAGCCCCAGCATTTT	CASPYQGNQPQHF	TRBV9	TRBJ1-5
TGTGCCAGCATTGCTAGGGGAGATACGCAGTATTTT	CASIARGDTQYF	TRBV12-3	TRBJ2-3
TGTGCCAAATTGTGGGTTACACTGGGAAACTATGGCTACACCTTC	CAKLWVTLGNYGYTF	TRBV6-3	TRBJ1-2
TGTGCCAGCAGCCGATCTTATAGCAATCAGCCCCAGCATTTT	CASSRSYSNQPQHF	TRBV13	TRBJ1-5
TGTGCCAGCAGCCGGACAGTGGCTGGAAACACCATATATTTT	CASSRTVAGNTIYF	TRBV6-5	TRBJ1-3
TGTGCCAGCAGGGAGGGTACAGATACGCAGTATTTT	CASREGTDTQYF	TRBV6-5	TRBJ2-3
TGTGCCAGCAGCTTGGGCCGACCAGGCACAGATACGCAGTATTTT	CASSLGRPGTDTQYF	TRBV5-6	TRBJ2-3
TGTGCCAGCAGTTGGACAGGGGGAGGTAATTCACCCCTCCACTTT	CASSWTGGGNSPLHF	TRBV28	TRBJ1-6
TGCAGTGCTCTCCCGAAGCGGGGAGACACTGAAGCTTTCTTT	CSALPKRGDTEAFF	TRBV20-1	TRBJ1-1
TGTGCTAGTGGTGTCTTTGACAGGGAAACTATGGACATTCAGTACTTC	CASGVFDRETMDIQYF	TRBV12-5	TRBJ2-4
TGTGCCAGACCCAAGGGGGCGCAAAGATCCTACGAGCAGTACTTC	CARPKGAQRSYEQYF	TRBV6-2	TRBJ2-7
TGTGCCAGCAGTTACTCCCAGGACTGGGAGATGGCCCGGATCTTACTGCCCCAGCATTTT	CASSYSQDWEMARILLPQHF	TRBV6-2	TRBJ1-5
TGCAGTGCTAGAGGAAAAAGGACAGGGGCCAAAAACATTCAGTACTTC	CSARGKRTGAKNIQYF	TRBV20-1	TRBJ2-4
TGTGCCAGCAGTGGTCAAGGGACGAGTTCCTACAATGAGCAGTTCTTC	CASSGQGTSSYNEQFF	TRBV28	TRBJ2-1
TGTGCCAGCAGTGATCGAGACAGCGGGGAGCTGTTTTTT	CASSDRDSGELFF	TRBV27	TRBJ2-2
TGTGCCAGCAGCTGGGGGGAAGAGTACAATGAGCAGTTCTTC	CASSWGEEYNEQFF	TRBV7-3	TRBJ2-1
TGCGCCAGCAGCTTGAATACAGATACGCAGTATTTT	CASSLNTDTQYF	TRBV5-1	TRBJ2-3
TGTGCTAGTGGTTTGGGTATCCCCGGGGAGCTGTTTTTT	CASGLGIPGELFF	TRBV12-5	TRBJ2-2
TGCAGTGCTAGAGTAGGGGGTGGCTACACCTTC	CSARVGGGYTF	TRBV20-1	TRBJ1-2
TGTGCCAGCGATCGGCGTATGAGCTCCTACAATGAGCAGTTCTTC	CASDRRMSSYNEQFF	TRBV25-1	TRBJ2-1
TGTGCCAGCTCACAGTGCCGGCGACAGGCTGACTACGAGCAGTACTTC	CASSQCRRQADYEQYF	TRBV18	TRBJ2-7
TGTGCCAGTAGTAAATTCGAGACGAGTCTCCCTCTGGGGGCCCCAATATACTATGGCTACACCTTC	CASSKFETSLPLGAPIYYGYTF	TRBV19	TRBJ1-2
TGTGCCAGCAGCACTACAGCTTTCTTT	CASSTTAFF	TRBV11-3	TRBJ1-1
TGTGCCAGCAGTAAGGGGGCGATTCCGAGCTCCTACGAGCAGTACTTC	CASSKGAIPSSYEQYF	TRBV6-4	TRBJ2-7
TGTGCCAGCAGCACCAGGGTCAGCAAAAACATTCAGTACTTC	CASSTRVSKNIQYF	TRBV9	TRBJ2-4
TGTGCTAGTGGCGCCGGGCCTCCCCATGGCTACACCTTC	CASGAGPPHGYTF	TRBV12-5	TRBJ1-2
TGTGCCAGCAAAACTAGAGGGAGAGAGACCCAGTACTTC	CASKTRGRETQYF	TRBV12-4	TRBJ2-5
TGTGCCAGCAGCTTGAAAGGGGGGATACGGGGCGTCGGCTACACCTTC	CASSLKGGIRGVGYTF	TRBV5-4	TRBJ1-2
TGTGCCAGTAGTATAGAAGGCAGGGGGATAGAGACCCAGTACTTC	CASSIEGRGIETQYF	TRBV19	TRBJ2-5
TGTGCCACCTTAATAAGGGGGTTGGGATATGGCTACACCTTC	CATLIRGLGYGYTF	TRBV24-1	TRBJ1-2
TGTGCCATCCTCGGGCCATTGTTGTCCTACGAGCAGTACTTC	CAILGPLLSYEQYF	TRBV6-4	TRBJ2-7
TGTGCCTGGACGACTAGATGCAAGTTAAAGGATACGCAGTATTTT	CAWTTRCKLKDTQYF	TRBV30	TRBJ2-3
TGTGCCAGCAGCCACGGTGACAGGGGAAGGAACACTGAAGCTTTCTTT	CASSHGDRGRNTEAFF	TRBV14	TRBJ1-1
TGTGCCAAAGCGGGAGAAAATGAGCAGTTCTTC	CAKAGENEQFF	TRBV19	TRBJ2-1
TGTGCCACCTCCACAGGGGTTAAGGACGAGCAGTACTTC	CATSTGVKDEQYF	TRBV15	TRBJ2-7
TGTGCCAGTAGAGGACGGGGACGCTATGGCTACACCTTC	CASRGRGRYGYTF	TRBV19	TRBJ1-2
TGTGCCAGCACCCCGGTGGTGCAGTTCTTC	CASTPVVQFF	TRBV3-1	TRBJ2-1
TGTGCCAGCCGGAACGAACAGAGAGGGTTAACTGAAGCTTTCTTT	CASRNEQRGLTEAFF	TRBV6-4	TRBJ1-1
TGCGCCAGCAGCTTGGCCACTGGACAGGTCACCGGGGAGCTGTTTTTT	CASSLATGQVTGELFF	TRBV5-1	TRBJ2-2
TGTGCCAGCAGTTGGAAAAGCAGGAGATTGGAACCGGGGCGCTACACCTTC	CASSWKSRRLEPGRYTF	TRBV27	TRBJ1-2
TGTGCCTGGACCTTCAGAGCTATTACTCCCTCCTACGAGCAGTACTTC	CAWTFRAITPSYEQYF	TRBV30	TRBJ2-7
TGCGCCAGCAGGGGGACGGGGGAGATGTCCCATGGCTACACCTTC	CASRGTGEMSHGYTF	TRBV10-2	TRBJ1-2
TGTGCCAGCAGCTTAGCTGGACAGGGAGGTTCCTCCTACGAGCAGTACTTC	CASSLAGQGGSSYEQYF	TRBV7-9	TRBJ2-7
TGTGCCAGCAGCTGGACCGGAGCGGGACCCTACGAGCAGTACTTC	CASSWTGAGPYEQYF	TRBV13	TRBJ2-7
TGTGCCAGCAGCGTAGAGGGGGGGGGGGACATTAGGGACTACGAGCAGTACTTC	CASSVEGGGDIRDYEQYF	TRBV9	TRBJ2-7
TGCAATAGCCTGAATCAGGGTCCCAATGAGCAGTTCTTC	CNSLNQGPNEQFF	TRBV20-1	TRBJ2-1
TGTGCCAGCAGCGACTATCAGGCGAGTAATGAAAAACTGTTTTTT	CASSDYQASNEKLFF	TRBV13	TRBJ1-4
TGTGCCAGCAGCTTATGCGGGGGGGGCCAGGAGACCCAGTACTTC	CASSLCGGGQETQYF	TRBV7-3	TRBJ2-5
TGTGCCAGCAGTGAAGTAGCATACAGGGGCAACTATGGCTACACCTTC	CASSEVAYRGNYGYTF	TRBV6-1	TRBJ1-2
TGTGCCAGCAGCTTATGCTCCCCAACCGGGGGATTGGCTGTCCCCTCAGATACGCAGTATTTT	CASSLCSPTGGLAVPSDTQYF	TRBV11-3	TRBJ2-3
TGTGCCAGCAGGCAAAAGGGGAACAGGGCACAGAACACCGGGGAGCTGTTTTTT	CASRQKGNRAQNTGELFF	TRBV6-2	TRBJ2-2
TGCAGTGCTCGACGCTTAGACAATGAAAAACTGTTTTTT	CSARRLDNEKLFF	TRBV20-1	TRBJ1-4
TGTGCCAGCAGCCAGTGGGACTTCCCAAAACTGTTTTTT	CASSQWDFPKLFF	TRBV13	TRBJ1-4
TGTGCCAGCAGGGGTCCAGGACTAGCGGGGGGGGACACCGGGGAGCTGTTTTTT	CASRGPGLAGGDTGELFF	TRBV6-3	TRBJ2-2
TGCAGTGCTAGTACCCCGGGACTAGCGGGAAATAATGAGCAGTTCTTC	CSASTPGLAGNNEQFF	TRBV20-1	TRBJ2-1
TGCAGTGCTAGGGGGTTGAGGGATGTTCGGCGACAGGGCTACGAGCAGTACTTC	CSARGLRDVRRQGYEQYF	TRBV20-1	TRBJ2-7
TGTGCCAGCAGCGGGGCATGTGAACGGAACGAAAAACTGTTTTTT	CASSGACERNEKLFF	TRBV27	TRBJ1-4
TGTGCCAGCAGCGCACGGGACAGGGGGAATGCAACTAATGAAAAACTGTTTTTT	CASSARDRGNATNEKLFF	TRBV9	TRBJ1-4
TGTGCCAGCAGGCCCTCAGCCATGGGCTATGGCTACACCTTC	CASRPSAMGYGYTF	TRBV12-4	TRBJ1-2
TGCAGTGCTGGAAAGGGGAACACCGGGGAGCTGTTTTTT	CSAGKGNTGELFF	TRBV20-1	TRBJ2-2
TGCAGTGCTTGGGACTCCTCCTACGAGCAGTACTTC	CSAWDSSYEQYF	TRBV20-1	TRBJ2-7
TGTGCCAGCAGCTTAGAGAATTGGAGTGTCCGACACGGGGAGCTGTTTTTT	CASSLENWSVRHGELFF	TRBV7-2	TRBJ2-2
TGCAGTGCCTTAGGACGGACGGAGACCCAGTACTTC	CSALGRTETQYF	TRBV20-1	TRBJ2-5
TGTGCCAGCGGTGGGAATGCGGGAGGCTACGAGCAGTACTTC	CASGGNAGGYEQYF	TRBV9	TRBJ2-7
TGTGCCAGCAGCTACACACTTGAATCGGGCGTGAACACTGAAGCTTTCTTT	CASSYTLESGVNTEAFF	TRBV14	TRBJ1-1
TGTGCCAGGACACAAAGCGAAATGGGGGGGTTCTGTCCTGAGCAGTTCTTC	CARTQSEMGGFCPEQFF	TRBV28	TRBJ2-1
TGTGCTAGTCCGAACTATGACAGAAGATTGAACACTGAAGCTTTCTTT	CASPNYDRRLNTEAFF	TRBV12-5	TRBJ1-1
TGCGCCAGCAGGGGTTGCGGGAGCCGGCGCCGTGTAGAGCAGTACTTC	CASRGCGSRRRVEQYF	TRBV10-1	TRBJ2-7
TGTGCCAGCAGCCTGGGAGTGGGGGGAGAGTACTTC	CASSLGVGGEYF	TRBV11-3	TRBJ2-4
TGTGCCAGCAGCTTAATCGCGGGAGGGCAGTACTTC	CASSLIAGGQYF	TRBV7-4	TRBJ2-7
TGTGCCAGCAGCTTTCGTTTGGGGGTCGTGGGGCTACCTAACTATGGCTACACCTTC	CASSFRLGVVGLPNYGYTF	TRBV11-3	TRBJ1-2
TGCAGTGCTAAGACAAACCGTGTACGACACAATGAGCAGTTCTTC	CSAKTNRVRHNEQFF	TRBV20-1	TRBJ2-1
TGCGCCAGCAGCCAAGATTTCTCCCACCACGGTCGGTACGAGCAGTACTTC	CASSQDFSHHGRYEQYF	TRBV4-3	TRBJ2-7
TGTGCCAGCAGCTTAGGTAGCGGGTCTGGGGAGGAGACCCAGTACTTC	CASSLGSGSGEETQYF	TRBV7-9	TRBJ2-5
TGTGCCACCAGCAGATGTCTGGGACGGTTGGGGGGCTACACTGAAGCTTTCTTT	CATSRCLGRLGGYTEAFF	TRBV15	TRBJ1-1
TGTGCCAGCAGCCCAGGGAAGAAGAGCTCCTACGAGCAGTACTTC	CASSPGKKSSYEQYF	TRBV9	TRBJ2-7
TGTGCCAGCAGCGTGACGGAGCGGATCCTGGCAACTAATGAAAAACTGTTTTTT	CASSVTERILATNEKLFF	TRBV7-9	TRBJ1-4
TGTGCCAGTAGTTCCCGCAGGGAACACTATGGCTACACCTTC	CASSSRREHYGYTF	TRBV19	TRBJ1-2
TGTGCCTCCGTAACACTAGCGGGAGGGCGGGCCCAAGAGACCCAGTACTTC	CASVTLAGGRAQETQYF	TRBV19	TRBJ2-5
TGTGCCAGCAGAGGCCTTACACGGGGGGGCGACTACAATGAGCAGTTCTTC	CASRGLTRGGDYNEQFF	TRBV6-3	TRBJ2-1
TGCAGTGCTACGGACAGGGCTGGAGGCTACACCTTC	CSATDRAGGYTF	TRBV20-1	TRBJ1-2
TGTGCCAGCAGCTTACGCACGGTCGAGCAGTACTTC	CASSLRTVEQYF	TRBV11-2	TRBJ2-7
TGTGCCAGCAGCACAGGGACTGAAGCTTTCTTT	CASSTGTEAFF	TRBV7-3	TRBJ1-1
TGTGCCAGCAGCTTAGTTGACAGGAGAATCGAATCCTACGAGCAGTACTTC	CASSLVDRRIESYEQYF	TRBV7-2	TRBJ2-7
TGTGCCAGCTCACCACCGTCAAGGGTGCCGAACACCGGGGAGCTGTTTTTT	CASSPPSRVPNTGELFF	TRBV18	TRBJ2-2
TGTGCCAATAAACTCTTAATGTCAGGGGGCGAGGTAGGGAATCAGCCCCAGCATTTT	CANKLLMSGGEVGNQPQHF	TRBV6-5	TRBJ1-5
TGTGCCAGCAGTTACCAAGCGCCCGAGGGGGCAGGGGGCAATCAGCCCCAGCATTTT	CASSYQAPEGAGGNQPQHF	TRBV6-5	TRBJ1-5
TGCGCCGCCCTTGCCCCAAGTGAGGCTGAGCAGTTCTTC	CAALAPSEAEQFF	TRBV10-1	TRBJ2-1
TGTGCCAGCAGCCTCACGATGGCTTCCTCTTTCTTC	CASSLTMASSFF	TRBV3-1	TRBJ2-7
TGTGCCAGCAGTTTATCCCAGGGGAGAGCCTACGAGCAGTACTTC	CASSLSQGRAYEQYF	TRBV28	TRBJ2-7
TGTGCCAGCAGCTGCCTCCAAGGGACTAGCGGGGGGTACGAGCAGTACTTC	CASSCLQGTSGGYEQYF	TRBV7-9	TRBJ2-7
TGTGCCAGCAGTATCGCGACTGAAGCTTTCTTT	CASSIATEAFF	TRBV2	TRBJ1-1
TGTGCCAGCAGCTTACTATCCAGGGGATATTCCAAAAACATTCAGTACTTC	CASSLLSRGYSKNIQYF	TRBV7-4	TRBJ2-4
TGTGCCACGCATTGGACAGGCCCCCATGAAAAACTGTTTTTT	CATHWTGPHEKLFF	TRBV6-1	TRBJ1-4
TGTGCCAGCAGCAATGGGACTGCCCAGGCCTACGAGCAGTACTTC	CASSNGTAQAYEQYF	TRBV7-9	TRBJ2-7
TGTGCCAGCAGCCAAGGGGACAGGGAAGAGACCTACGAGCAGTACTTC	CASSQGDREETYEQYF	TRBV14	TRBJ2-7
TGTGCCAGCAGTTTAGCCGCGGACAGGGGTTCGGTGTCGCAGTATTTT	CASSLAADRGSVSQYF	TRBV12-3	TRBJ2-3
TGTGCCAGCACGGGTCCTAGCGGGGCCTACGAGCAGTACTTC	CASTGPSGAYEQYF	TRBV6-4	TRBJ2-7
TGTGCCAGCCTGCTGATTAGACAGGGGGAAGCCGGGGAGCTGTTTTTT	CASLLIRQGEAGELFF	TRBV6-4	TRBJ2-2
TGCGCCAGCAGTGCAGGGACAGCGCGGAAGGGATCCTACGAGCAGTACTTC	CASSAGTARKGSYEQYF	TRBV10-1	TRBJ2-7
TGTGCCACCAGTGATTTGCCAGGGGGCTATTACTACCAGAACACTGAAGCTTTCTTT	CATSDLPGGYYYQNTEAFF	TRBV24-1	TRBJ1-1
TGTGCCAGTACTGCAGGGCTCCCCTTACCGCTGCTAGCCAAAAACATTCAGTACTTC	CASTAGLPLPLLAKNIQYF	TRBV19	TRBJ2-4
TGCGCCAGCAGCTTACAGGGGCAAATCTCCTACGAGCAGTACTTC	CASSLQGQISYEQYF	TRBV5-1	TRBJ2-7
TGCAGTGCTAGGAGGACAGGGAGAGGGAATGAAAAACTGTTTTTT	CSARRTGRGNEKLFF	TRBV20-1	TRBJ1-4
TGTGCCAGCAGCTTTTTCGAGGGAAACACCATATATTTT	CASSFFEGNTIYF	TRBV7-9	TRBJ1-3
TGTGCCAGCAGCTTACAACTAGCCTACGAGCAGTACTTC	CASSLQLAYEQYF	TRBV7-4	TRBJ2-7
TGTGCCAGCAGCTTATTGACAGGGTTCTACGAGCAGTACTTC	CASSLLTGFYEQYF	TRBV11-2	TRBJ2-7
TGTGCCAGCAGCTTTACCGGGACAGGGCCGTATAGCAATCAGCCCCAGCATTTT	CASSFTGTGPYSNQPQHF	TRBV5-4	TRBJ1-5
TGTGCCAGCAGCTTAAGGGGGACTTTTGACTATGGCTACACCTTC	CASSLRGTFDYGYTF	TRBV7-3	TRBJ1-2
TGTGCCAGCAGCTTATCCCTAAGAGTCCATGAGCAGTTCTTC	CASSLSLRVHEQFF	TRBV7-2	TRBJ2-1
TGTGCCACCAGTGATTCGAGGAATGTCCACTCCTACAATGAGCAGTTCTTC	CATSDSRNVHSYNEQFF	TRBV24-1	TRBJ2-1
TGTGCCACCAGCGACAAAAGACTATTAGATACGCAGTATTTT	CATSDKRLLDTQYF	TRBV15	TRBJ2-3
TGTGCCAGCAGCCACCGATCGAGATGGGACAACGCCGGGGAGCTGTTTTTT	CASSHRSRWDNAGELFF	TRBV3-1	TRBJ2-2
TGTGCCATCAGTGCGTGGAAGAGTGACAGGGCAGTGGAGACCCAGTACTTC	CAISAWKSDRAVETQYF	TRBV10-3	TRBJ2-5
TGTGCCTGGATGTGGTTGGGACGTGCTGCAACTAATGAAAAACTGTTTTTT	CAWMWLGRAATNEKLFF	TRBV30	TRBJ1-4
TGTGCCAGCAGGGACAGGGCTAAAGACAGAGTGGCCCAGTACTTC	CASRDRAKDRVAQYF	TRBV27	TRBJ2-5
TGTGCCAGCAGTCGGCGGGACAGAGGGTCCTACGAGCAGTACTTC	CASSRRDRGSYEQYF	TRBV27	TRBJ2-7
TGTGCCAGCAGCATCCGGGGGCGCACAGATACGCAGTATTTT	CASSIRGRTDTQYF	TRBV28	TRBJ2-3
TGTGCCAGCAGCGGGCGAAATGATGGCTACACCTTC	CASSGRNDGYTF	TRBV5-4	TRBJ1-2
TGTGCCAGCAAAAAAAAAACAGGGGGCGCACCCGGGGAGCTGTTTTTT	CASKKKTGGAPGELFF	TRBV27	TRBJ2-2
TGTGCCAGCAGCTTGGTTCCCACCGGAGCCGGGGTAGTCGAGCAGTACTTC	CASSLVPTGAGVVEQYF	TRBV5-6	TRBJ2-7
TGTGCCAGCAGTGACAGGAAGCCGGGACAGGGCCGGCAGGAAAAACTGTTTTTT	CASSDRKPGQGRQEKLFF	TRBV2	TRBJ1-4
TGCGCCAGCAGCGACGGGAGCAATCAGCCCCAGCATTTT	CASSDGSNQPQHF	TRBV5-1	TRBJ1-5
TGTGCCCGTGGGGACAGGGGGGTGCATTCGCAAGAGACCCAGTACTTC	CARGDRGVHSQETQYF	TRBV27	TRBJ2-5
TGTGCCAGCAGCTTAGCAGGAGGGGCCCCTAAAGAGACCCAGTACTTC	CASSLAGGAPKETQYF	TRBV7-4	TRBJ2-5
TGCAGTGCTCTGCGGGGCCGCAAAAACGAGCAGTACTTC	CSALRGRKNEQYF	TRBV20-1	TRBJ2-7
TGCGCCAGCCGGGACAGGACTTTATATGGCTACACCTTC	CASRDRTLYGYTF	TRBV10-1	TRBJ1-2
TGTGCCACCAAAATGGAAGGGGCCGACTATGGCTACACCTTC	CATKMEGADYGYTF	TRBV6-5	TRBJ1-2
TGTGCCAGCAGCTTCGGGGCCTATGAGCAGTTCTTC	CASSFGAYEQFF	TRBV5-5	TRBJ2-1
TGTGCCAGCAGTTTATCGTTAAGGGAGGGCAATGAGCAGTTCTTC	CASSLSLREGNEQFF	TRBV27	TRBJ2-1
TGTGCCAGCAGCTTAGGGGGGGCGCCTATGCCCCAGCATTTT	CASSLGGAPMPQHF	TRBV7-9	TRBJ1-5
TGTGCCAGCAGCCTTTGGGGGGCGTCTCTCTACGAGCAGTACTTC	CASSLWGASLYEQYF	TRBV3-1	TRBJ2-7
TGTGCCAGCAGAGCCCCCGGACAGGCGGACCTGAACACTGAAGCTTTCTTT	CASRAPGQADLNTEAFF	TRBV6-5	TRBJ1-1
TGTGCCAGCAGCATGAACCGCAGCGACACAGATACGCAGTATTTT	CASSMNRSDTDTQYF	TRBV11-2	TRBJ2-3
TGTGCCACCAGTGATCGGGGGGGCGCGTCCAACACCGGGGAGCTGTTTTTT	CATSDRGGASNTGELFF	TRBV24-1	TRBJ2-2
TGTGCCAGCAGCCAAGATCCTTCCCGGTTGTCCTACGAGCAGTACTTC	CASSQDPSRLSYEQYF	TRBV3-1	TRBJ2-7
TGTGCCAGCTCACCCTCCCCCGGGACTAGGGTGACCTACGAGCAGTACTTC	CASSPSPGTRVTYEQYF	TRBV18	TRBJ2-7
TGTGCCAGCATTCTTGACGGGAACACCGGGGAGCTGTTTTTT	CASILDGNTGELFF	TRBV6-6	TRBJ2-2
TGCGCCAGCAGCTTGACGGATAGCAATCAGCCCCAGCATTTT	CASSLTDSNQPQHF	TRBV5-1	TRBJ1-5
TGTGCCAGCAGCCAAGCCGGGACAGGGCGGGGGGATCAGCCCCAGCATTTT	CASSQAGTGRGDQPQHF	TRBV4-2	TRBJ1-5
TGTGCCAGCAGTCAGGGGGTACGTGGAAACACCATATATTTT	CASSQGVRGNTIYF	TRBV6-5	TRBJ1-3
TGTGCCAGCAGCCAAGACGCCACGACTTGGTATGGCTACACCTTC	CASSQDATTWYGYTF	TRBV14	TRBJ1-2
TGTGCCAGCAGCAGGGACAGTGGTATGAACACTGAAGCTTTCTTT	CASSRDSGMNTEAFF	TRBV3-1	TRBJ1-1
TGTGCCAGCAGTGGGGTTGAGGGCCGGAGTAACTATGGCTACACCTTC	CASSGVEGRSNYGYTF	TRBV2	TRBJ1-2
TGCGCCAGCAGCCAACCGCAGGGCAGGGCAGATACGCAGTATTTT	CASSQPQGRADTQYF	TRBV4-1	TRBJ2-3
TGCAGTGCGGCTGGGGCCACCGGGGAGCTGTTTTTT	CSAAGATGELFF	TRBV20-1	TRBJ2-2
TGTGCCAGCAGCTTAGTTCGGGGAAGGGGGGCCTTCATCAACTCTTATGAGCAGTTCTTC	CASSLVRGRGAFINSYEQFF	TRBV7-9	TRBJ2-1
TGTGCCAGCTCACCGGAGGGACCGGATACCTACAATGAGCAGTTCTTC	CASSPEGPDTYNEQFF	TRBV18	TRBJ2-1
TGCGCCAGCAGTGAGGTCGTTTGTCGGGACCCTATGGATACGCAGTATTTT	CASSEVVCRDPMDTQYF	TRBV10-1	TRBJ2-3
TGTGCCACCCAATCCGGGACAGGGCAAAGCTCTGGGGCCAACGTCCTGACTTTC	CATQSGTGQSSGANVLTF	TRBV24-1	TRBJ2-6
TGCAGTGCTTCCTCACCGGGACGTGGACGAGAGACCCAGTACTTC	CSASSPGRGRETQYF	TRBV20-1	TRBJ2-5
TGTGCCAGCAGACACGCAAACTATGGCTACACCTTC	CASRHANYGYTF	TRBV25-1	TRBJ1-2
TGTGCCAGCAGCCCACCTGACAGGGGGTATTCACCCCTCCACTTT	CASSPPDRGYSPLHF	TRBV7-4	TRBJ1-6
TGTGCCAGCAGTTACTCGGTAAGTTGGGGGGGTAAAGACAATGAGCAGTTCTTC	CASSYSVSWGGKDNEQFF	TRBV6-8	TRBJ2-1
TGTGCCAGCAGCCACGTAGGGAGGTCCTCTGGAAACACCATATATTTT	CASSHVGRSSGNTIYF	TRBV14	TRBJ1-3
TGTGCCAGCAGTTACCGATTACCCCAGGCGTTCAGCGAGCAGTACTTC	CASSYRLPQAFSEQYF	TRBV6-2	TRBJ2-7
TGTGCCTGGGAACTAGCGGGAGGGCGGGGGGGGGCCTACGAGCAGTACTTC	CAWELAGGRGGAYEQYF	TRBV30	TRBJ2-7
TGTGCCAGCTCCGTCCAGGGGGGCACCGAGCAGTTCTTC	CASSVQGGTEQFF	TRBV13	TRBJ2-1
TGTGCCAGCAGTGAACACGGCGGTAGCACAGATACGCAGTATTTT	CASSEHGGSTDTQYF	TRBV25-1	TRBJ2-3
TGCGCCAGCAGTGCAGGGAGGGTCCGCAAGTATCATAGCAATCAGCCCCAGCATTTT	CASSAGRVRKYHSNQPQHF	TRBV10-1	TRBJ1-5
TGTGCCAGCTGGGTTGCATATAGCAATCAGCCCCAGCATTTT	CASWVAYSNQPQHF	TRBV27	TRBJ1-5
TGTGCCAGCAGCCAACGGGGGAATGAGCAGTTCTTC	CASSQRGNEQFF	TRBV9	TRBJ2-1
TGTGCCAGCAGTTACGCACAGGGTAGCAATCAGCCCCAGCATTTT	CASSYAQGSNQPQHF	TRBV6-5	TRBJ1-5
TGCAGCGGTAGCGGGAAGGGCACCGGGGAGCTGTTTTTT	CSGSGKGTGELFF	TRBV29-1	TRBJ2-2
TGTGCCAGCAGCCGGCCCCGGGACAGAAGGATTGATCAGCCCCAGCATTTT	CASSRPRDRRIDQPQHF	TRBV13	TRBJ1-5
TGCGCCAGCAGCTACTCGGGACAGGGGGGGAGCTCCTATAATTCACCCCTCCACTTT	CASSYSGQGGSSYNSPLHF	TRBV5-1	TRBJ1-6
TGTGCCAAGGGCGAGTCCAGACGGAATCAGCCCCAGCATTTT	CAKGESRRNQPQHF	TRBV6-4	TRBJ1-5
TGTGCCAGCAGCCAAGATGAGACACTGGTAGAAAAACTGTTTTTT	CASSQDETLVEKLFF	TRBV4-2	TRBJ1-4
TGCGCCAGCAGGATAGGGACAGGGGGGTATGAAAAACTGTTTTTT	CASRIGTGGYEKLFF	TRBV5-1	TRBJ1-4
TGTGCTACCTTCATCAGAACGGGACAGGGGGACGGTTATCAGCCCCAGCATTTT	CATFIRTGQGDGYQPQHF	TRBV12-5	TRBJ1-5
TGTGCCAGCAGTGACTGCAAAGCGGTACCGAAGACCCAGTACTTC	CASSDCKAVPKTQYF	TRBV6-4	TRBJ2-5
TGTGCCAGCAGCCAAGGTTCAAGGCCCTTTGGGTCGGGGGAGCTGTTTTTT	CASSQGSRPFGSGELFF	TRBV3-1	TRBJ2-2
TGCGCCAGCAGCTTGGACGTGGACAGCACTGAAGCTTTCTTT	CASSLDVDSTEAFF	TRBV5-1	TRBJ1-1
TGTGCCAGCGGACCTAGCGGGAAGCCCTACAATGAGCAGTTCTTC	CASGPSGKPYNEQFF	TRBV7-9	TRBJ2-1
TGCGCCAGCAGCTGTCCCTTCCCTAACTATGGCTACACCTTC	CASSCPFPNYGYTF	TRBV5-1	TRBJ1-2
TGTGCCATCGGACAGGGGAGTCACTATGGCTACACCTTC	CAIGQGSHYGYTF	TRBV10-3	TRBJ1-2
TGTGCCATCAGGGGTTTCAGAACTGAAGCTTTCTTT	CAIRGFRTEAFF	TRBV27	TRBJ1-1
TGTGGGACTAGCGGGGGGTCATTGGCAGATACGCAGTATTTT	CGTSGGSLADTQYF	TRBV24-1	TRBJ2-3
TGTGCCAGCAGCGCCGTTCCCGGGACAAATCGAATTCCAGACACCGGGGAGCTGTTTTTT	CASSAVPGTNRIPDTGELFF	TRBV9	TRBJ2-2
TGTGCCAGCAGCCCAGACAGGGTAAACCCTGGATATGGCTACACCTTC	CASSPDRVNPGYGYTF	TRBV7-9	TRBJ1-2
TGTGCCATCAGTGAGTCCGACAGGAAGCAAGAGACCCAGTACTTC	CAISESDRKQETQYF	TRBV10-3	TRBJ2-5
TGTGCAGATCCAGATACGCAGTATTTT	CADPDTQYF	TRBV28	TRBJ2-3
TGTGCCAGCAGCCCCCCCGACCCAGATACGCAGTATTTT	CASSPPDPDTQYF	TRBV7-3	TRBJ2-3
TGTGCCACCAGTGGAATTACCAGTGGACATGCCTTGGGGCAGGCGAACACTGAAGCTTTCTTT	CATSGITSGHALGQANTEAFF	TRBV24-1	TRBJ1-1
TGTGCCAGCAGTTCGGGACAGGGAGAGCAGTACTTC	CASSSGQGEQYF	TRBV27	TRBJ2-7
TGTGCCAGCACCGGCAGGCAACTCTACGAGCAGTACTTC	CASTGRQLYEQYF	TRBV6-1	TRBJ2-7
TGCAGCGTTGAATCGTCCGATGGCTACACCTTC	CSVESSDGYTF	TRBV29-1	TRBJ1-2
TGCGCCAGCAGCCAAGATAGGTTCAGGATTCGAGAGTATGGCTACACCTTC	CASSQDRFRIREYGYTF	TRBV4-1	TRBJ1-2
TGCAGTGCTAGAGATAACCGACATGAGCAGTTCTTC	CSARDNRHEQFF	TRBV20-1	TRBJ2-1
TGTGCCAGCTCAAGGGAGAGGGTCTGTGAGCAGTTCTTC	CASSRERVCEQFF	TRBV18	TRBJ2-1
TGTGCCAGCAGTTGCCTCGTCCGGGGGGGTCCGCAGTACTTC	CASSCLVRGGPQYF	TRBV6-1	TRBJ2-7
TGTGCCACCAGCAGAGATGAAAAAGGGTACTTCCCCCCGTGTGGTCAAACAGGGGCTTTCTTT	CATSRDEKGYFPPCGQTGAFF	TRBV15	TRBJ1-1
TGTGCCAGCAGCCTCCCCGCGGGGGGGTACAATGAGCAGTTCTTC	CASSLPAGGYNEQFF	TRBV13	TRBJ2-1
TGTGCCAGCCCCTCTTTGGACAGGGAGCGGTCTCGTGGTGAGCAGTTCTTC	CASPSLDRERSRGEQFF	TRBV7-2	TRBJ2-1
TGCATTTTCCGGGACAGGGGTAAAATGAGCACTGAAGCTTTCTTT	CIFRDRGKMSTEAFF	TRBV20-1	TRBJ1-1
TGTGCCAGCAGCTCTCCGGACAGGGGAAACATTCAGTACTTC	CASSSPDRGNIQYF	TRBV7-2	TRBJ2-4
TGTGCCAGCAGTTTGGGCAAGGGGACAGGGGGCAGCGAGCAGTACTTC	CASSLGKGTGGSEQYF	TRBV6-5	TRBJ2-7
TGTGCCAGCAGTTTTCGCGTATTTAGGTGGGAAAAACTGTTTTTT	CASSFRVFRWEKLFF	TRBV12-4	TRBJ1-4
TGTGCCAGCAGGTCTGGCTACACCTTC	CASRSGYTF	TRBV6-4	TRBJ1-2
TGTGCCAGCAGTTCTGTAGGAGGGTTCGGGGAGCAGTACTTC	CASSSVGGFGEQYF	TRBV12-4	TRBJ2-7
TGTGCCAGCACCAAACGCCAGGGTAGCTACAATGAGCAGTTCTTC	CASTKRQGSYNEQFF	TRBV6-2	TRBJ2-1
TGTGCCAGCAGCTCATTAGCGGGGGTCTACGAGCAGTACTTC	CASSSLAGVYEQYF	TRBV7-9	TRBJ2-7
TGCAGCGTTGAAGCTGTTACAGGGAGGGAACCCTACGAGCAGTACTTC	CSVEAVTGREPYEQYF	TRBV29-1	TRBJ2-7
TGCGCCAGCAGCCCGACTAGCGGGGCACAACGCGGGGAGCTGTTTTTT	CASSPTSGAQRGELFF	TRBV10-1	TRBJ2-2
TGTGCCAGCAGCTTAGGATCCCCACAGAAGGGCAATCAGCCCCAGCATTTT	CASSLGSPQKGNQPQHF	TRBV11-3	TRBJ1-5
TGTGCCAGCAGAAGGACAGTTATGCGAAGCTCCTACGAGCAGTACTTC	CASRRTVMRSSYEQYF	TRBV6-2	TRBJ2-7
TGTGCCAGCAGTTACTTAGGTGTCCCCACTGAAGCTTTCTTT	CASSYLGVPTEAFF	TRBV6-5	TRBJ1-1
TGTGCCAGCAATCGACAGGCTGGCCCGGGCACTGAAGCTTTCTTT	CASNRQAGPGTEAFF	TRBV25-1	TRBJ1-1
TGCAGTGCGATGAGAAACGAGGGCGGGGGGACAGGCTACACCTTC	CSAMRNEGGGTGYTF	TRBV20-1	TRBJ1-2
TGTGCCAGCAGCCCGTCGGATTTCCAAGAGACCCAGTACTTC	CASSPSDFQETQYF	TRBV9	TRBJ2-5
TGTGCAGAGCTCGTCGCGGGGGTCACAGATACGCAGTATTTT	CAELVAGVTDTQYF	TRBV30	TRBJ2-3
TGCGCCAGCAGCCCCCCAATGGTCGGACAGGGGGCGAGGACAGATACGCAGTATTTT	CASSPPMVGQGARTDTQYF	TRBV10-1	TRBJ2-3
TGTGCCAACGAGACAGGGGTTCTCGGGGCCTACGAGCAGTACTTC	CANETGVLGAYEQYF	TRBV11-2	TRBJ2-7
TGTGCCAGCTCACAAACAGGGGGGGAAGAGCAGTACTTC	CASSQTGGEEQYF	TRBV18	TRBJ2-7
TGTGCCAGCAGCGAAACCGTCCCGGACAGGTGGGGCAATCAGCCCCAGCATTTT	CASSETVPDRWGNQPQHF	TRBV13	TRBJ1-5
TGCAGTGCTAGAGATGACGAAACAGATACGCAGTATTTT	CSARDDETDTQYF	TRBV20-1	TRBJ2-3
TGTGCCAGCAGTTTGCCTGGTGTTGAAAAACTGTTTTTT	CASSLPGVEKLFF	TRBV27	TRBJ1-4
TGTGCCAGCAGTGAACCCCCTAGCGGGAAAAGCTCCTACAATGAGCAGTTCTTC	CASSEPPSGKSSYNEQFF	TRBV25-1	TRBJ2-1
TGTGCCAGCTCACCCGACAGGGGGCCCCACGTGGGCACAGATACGCAGTATTTT	CASSPDRGPHVGTDTQYF	TRBV18	TRBJ2-3
TGCGCCAGCACGTCTAGGTGGGGCACAGATACGCAGTATTTT	CASTSRWGTDTQYF	TRBV10-1	TRBJ2-3
TGCGCCAGCAGTGGACGAACTAGCGGGAGGTTGGCTAATGAAAAACTGTTTTTT	CASSGRTSGRLANEKLFF	TRBV10-1	TRBJ1-4
TGCGCCAGCAGCTTGGTAGCTAGTCCAGATACGCAGTATTTT	CASSLVASPDTQYF	TRBV5-1	TRBJ2-3
TGCAGTGCTAGAGATGACTCTGGAGGGAGCTACAATGAGCAGTTCTTC	CSARDDSGGSYNEQFF	TRBV20-1	TRBJ2-1
TGTGCCAGCAGCCCCGCAGGGAAGAATGAGCAGTTCTTC	CASSPAGKNEQFF	TRBV7-7	TRBJ2-1
TGTGCCAGCAGTTACATTTCCCTCGAAAGTGGGGTCGGCAAAGAGACCCAGTACTTC	CASSYISLESGVGKETQYF	TRBV6-6	TRBJ2-5
TGTGCCAGCAGAGGCCGAGGACAGGGAGGGCATCAGCCCCAGCATTTT	CASRGRGQGGHQPQHF	TRBV6-5	TRBJ1-5
TGTGCCAGCAGCTGTGGAAATCAGGGGGCGGTAAATGAAAAACTGTTTTTT	CASSCGNQGAVNEKLFF	TRBV5-6	TRBJ1-4
TGTGCCAGCTCACCTCAGGACAGGGGATTAATGTATCAGCCCCAGCATTTT	CASSPQDRGLMYQPQHF	TRBV18	TRBJ1-5
TGCAGTGCTCTATCGACAGGAATAGATGAGCAGTTCTTC	CSALSTGIDEQFF	TRBV20-1	TRBJ2-1
TGTGCCGGGGGGATCAGGGGGCGGCCCAATCAGCCCCAGCATTTT	CAGGIRGRPNQPQHF	TRBV19	TRBJ1-5
TGTGCCAGCAGTTTATGTACAGGGGGGGCCAGATATGCCTCCTACGAGCAGTACTTC	CASSLCTGGARYASYEQYF	TRBV27	TRBJ2-7
TGTGCCAGCAGCTCCCCAGAGGGGGCGATTTATGAGCAGTTCTTC	CASSSPEGAIYEQFF	TRBV7-8	TRBJ2-1
TGTGCCAGCAGTTTAGTGGGTCCCCCGGTTTGTTTGAACACTGAAGCTTTCTTT	CASSLVGPPVCLNTEAFF	TRBV12-4	TRBJ1-1
TGTGCCAGTAGTATATCGGGCAATGAGCAGTTCTTC	CASSISGNEQFF	TRBV19	TRBJ2-1
TGTGCCAGCAGTTTCCCGGACAGGCCCGGGGATTCACCCCTCCACTTT	CASSFPDRPGDSPLHF	TRBV27	TRBJ1-6
TGTGCCAGCAGCCCCCATGCACCGGGACAGGGGGAGAGCTCCTACAATGAGCAGTTCTTC	CASSPHAPGQGESSYNEQFF	TRBV6-4	TRBJ2-1
TGTGCCAGCAGCTTCGGGAAAAGGGGTACTGAAGCTTTCTTT	CASSFGKRGTEAFF	TRBV9	TRBJ1-1
TGTGCCACCAGTCTGGTGGGCAAGGTTAGTTGCTATGGCTACACCTTC	CATSLVGKVSCYGYTF	TRBV24-1	TRBJ1-2
TGCGCCAGCAGTGAGTCTTTATCGATACAAGAGACCCAGTACTTC	CASSESLSIQETQYF	TRBV10-1	TRBJ2-5
TGTGCCAGCAGGCGGGGACAGGGTTCAATCCTCAAAAACACTGAAGCTTTCTTT	CASRRGQGSILKNTEAFF	TRBV11-3	TRBJ1-1
TGCAGTGCTAGACTAGCGGGCCTCACAGATACGCAGTATTTT	CSARLAGLTDTQYF	TRBV20-1	TRBJ2-3
TGTGCCAGCAAGACACGAGGAAGGATCCTAGCCAAAAACATTCAGTACTTC	CASKTRGRILAKNIQYF	TRBV9	TRBJ2-4
TGTGCCTGGAGTCCTGCTAGCGGAGGTTACGAGCAGTACTTC	CAWSPASGGYEQYF	TRBV30	TRBJ2-7
TGTGCCTGGCAAACAGGGAGGAAAAATCAGCCCCAGCATTTT	CAWQTGRKNQPQHF	TRBV30	TRBJ1-5
TGTGCCAGCAGCTTACCACGGGAGACCCAGTACTTC	CASSLPRETQYF	TRBV7-6	TRBJ2-5
TGTGCCAGCAGAACTCGAGAGCAGTACTTC	CASRTREQYF	TRBV6-4	TRBJ2-7
TGTGCCAGCAGCTTGGGGACAGGGGTAGATGCTTTCTTT	CASSLGTGVDAFF	TRBV7-9	TRBJ1-1
TGCAGCTCGAGAATTGGCGGGCAGTACTTC	CSSRIGGQYF	TRBV29-1	TRBJ2-7
TGTGCCACCAGTACAACCGACTCGGCCTCAACAGATACGCAGTATTTT	CATSTTDSASTDTQYF	TRBV24-1	TRBJ2-3
TGCAGCGTTGACCGCTGGGGATGCACCGGGGAGCTGTTTTTT	CSVDRWGCTGELFF	TRBV29-1	TRBJ2-2
TGTGCCAGCAGCCCGCGGGTAGGGGAGCAGTTCTTC	CASSPRVGEQFF	TRBV5-6	TRBJ2-1
TGCGCCAGCAGCTTGCAATGCCTCCGGGGGAGAATTGTGGGGCTTAGCAATCAGCCCCAGCATTTT	CASSLQCLRGRIVGLSNQPQHF	TRBV5-1	TRBJ1-5
TGTGCCAGCAGCTCCGGGGCCGGCACAGATACGCAGTATTTT	CASSSGAGTDTQYF	TRBV7-3	TRBJ2-3
TGTGCCAGCAGCATGGTCTTTAGACACAGGGGGAGCACTGAAGCTTTCTTT	CASSMVFRHRGSTEAFF	TRBV6-4	TRBJ1-1
TGTGCCAGCAGTGACTCTTCTGGCCGGGATGAGCAGTTCTTC	CASSDSSGRDEQFF	TRBV6-4	TRBJ2-1
TGCGCCAGCAGCCAGGGGGAGTACAATGAGCAGTTCTTC	CASSQGEYNEQFF	TRBV5-1	TRBJ2-1
TGCGCCAGCAGCCAGTCTGAGAGCAACACTGAAGCTTTCTTT	CASSQSESNTEAFF	TRBV4-3	TRBJ1-1
TGTGCCAGCAGTTACTCGAGAAGGGGGCGCAATCAGCCCCAGCATTTT	CASSYSRRGRNQPQHF	TRBV6-6	TRBJ1-5
TGTGCCAGCAGTGACGGAGTATTAAGGCCAGAGACCCAGTACTTC	CASSDGVLRPETQYF	TRBV6-4	TRBJ2-5
TGTGCCAGTAGTGGACAGGGGTGGCTTGGCTACACCTTC	CASSGQGWLGYTF	TRBV19	TRBJ1-2
TGTGCCAGCAGCCGGGAGGACCAGAAGAATGGCTACACCTTC	CASSREDQKNGYTF	TRBV7-3	TRBJ1-2
TGTGCCAGCTCAAGCACTAGCGGGAGGGCGGACACCGGGGAGCTGTTTTTT	CASSSTSGRADTGELFF	TRBV9	TRBJ2-2
TGTGCCAGCAGCCACTCAGAACAAGAGACCCAGTACTTC	CASSHSEQETQYF	TRBV3-1	TRBJ2-5
TGTGCCAGCAGTTTTCGGACAGGCGTCACCAATGAGCAGTTCTTC	CASSFRTGVTNEQFF	TRBV12-4	TRBJ2-1
TGCGCCAGCAGTGACTGGGGCCCGGGGCCAGATACGCAGTATTTT	CASSDWGPGPDTQYF	TRBV10-1	TRBJ2-3
TGTGCCAGCAGCTTGCACCGTAGGGAGGGAAAGTCTGAAGCTTTCTTT	CASSLHRREGKSEAFF	TRBV11-2	TRBJ1-1
TGTGCCAGCAGCAAGACCGGCAGGTACCAAGAGACCCAGTACTTC	CASSKTGRYQETQYF	TRBV5-4	TRBJ2-5
TGTGCCAGCAGCCAAGACGGGGTAAGCTACGAGCAGTACTTC	CASSQDGVSYEQYF	TRBV14	TRBJ2-7
TGTGCCAGCAGTGACGTCTGGGACTACAATGAGCAGTTCTTC	CASSDVWDYNEQFF	TRBV6-4	TRBJ2-1
TGCGCCAGCAGCAATCGGACGGCCCCGCAAGAGACCCAGTACTTC	CASSNRTAPQETQYF	TRBV5-1	TRBJ2-5
TGCGCCATGGGTGCAGAGCTGGGGGTGCAAGAGACCCAGTACTTC	CAMGAELGVQETQYF	TRBV10-1	TRBJ2-5
TGCAGTGCTAGATGCCCAGGGAGTAGCTACGAGCAGTACTTC	CSARCPGSSYEQYF	TRBV20-1	TRBJ2-7
TGTGCCAGCAGTTTATCGCTCCCGGGACACTCCGGAATTACGCAGTATTTT	CASSLSLPGHSGITQYF	TRBV27	TRBJ2-3
TGTGCTAGTGTTGGTTGTGCGGGACAGGGTCCTCGTCTCTACAATGAGCAGTTCTTC	CASVGCAGQGPRLYNEQFF	TRBV12-5	TRBJ2-1
TGTGCCAGCAGTTTACTTCACCCAAAGAACAGGGCAGCCACTGAAGCTTTCTTT	CASSLLHPKNRAATEAFF	TRBV27	TRBJ1-1
TGTGCCAGCAGGTCCAGTCCGGGACTCAGTCCGCCCCAGCATTTT	CASRSSPGLSPPQHF	TRBV28	TRBJ1-5
TGTGCCAGCAGCTTACCCGGGACAGGGCAGGACCAGTACTTC	CASSLPGTGQDQYF	TRBV11-2	TRBJ2-5
TGTGCCACCAGGCTATCTTACACAGATACGCAGTATTTT	CATRLSYTDTQYF	TRBV24-1	TRBJ2-3
TGTGCCAGCAGCGCACCCCTGTACCGGGACAGGGGAGAGATAGGCTACACCTTC	CASSAPLYRDRGEIGYTF	TRBV9	TRBJ1-2
TGCGCCAGCTCGACAGGGGGCAATCAGCCCCAGCATTTT	CASSTGGNQPQHF	TRBV5-1	TRBJ1-5
TGTGCCAGCAGCCACACTGAAGCTTTCTTT	CASSHTEAFF	TRBV7-3	TRBJ1-1
TGTGCCAGCTCACCCAAACCCGGACGTAAACGTAGCAATCAGCCCCAGCATTTT	CASSPKPGRKRSNQPQHF	TRBV18	TRBJ1-5
TGTGCCACCAGCAGGGGACAGGGGGATGTCTACGAGCAGTACTTC	CATSRGQGDVYEQYF	TRBV15	TRBJ2-7
TGCGCCAGCAGCTTGGCATACAGGGAGCGGCATGGCTACACCTTC	CASSLAYRERHGYTF	TRBV5-1	TRBJ1-2
TGCGCCAGCTTAGGGCAACCTAGCACAGATACGCAGTATTTT	CASLGQPSTDTQYF	TRBV5-1	TRBJ2-3
TGTGCCAGCAGCAGGACAGGGGGAAACGAGCAGTACTTC	CASSRTGGNEQYF	TRBV7-3	TRBJ2-7
TGCAGTGCTAGAGCCCGAAGGGGGGCGACCTACGAGCAGTACTTC	CSARARRGATYEQYF	TRBV20-1	TRBJ2-7
TGTGCCAGCAGTGGAGGGGGGGGCGTCTACAATGAGCAGTTCTTC	CASSGGGGVYNEQFF	TRBV27	TRBJ2-1
TGTGCCAGCAGACGCGAAGAGGCAGGCTACACCTTC	CASRREEAGYTF	TRBV2	TRBJ1-2
TGTGCCAGCAGTGACTCGACCAGGGGCCTGGGACACAACAATCAGCCCCAGCATTTT	CASSDSTRGLGHNNQPQHF	TRBV6-4	TRBJ1-5
TGTGCCAGCAGCGGCGGGCCAGGGATGAACACCGGGGAGCTGTTTTTT	CASSGGPGMNTGELFF	TRBV5-5	TRBJ2-2
TGCGCCAGCAGCCAGAAGATGACCGCTTCAACTAATGAAAAACTGTTTTTT	CASSQKMTASTNEKLFF	TRBV10-1	TRBJ1-4
TGTGCCAGCACACCGGGACTGTTCAACACTGAAGCTTTCTTT	CASTPGLFNTEAFF	TRBV9	TRBJ1-1
TGTGCCAGCAGCGCGACTAGGGAGGTAGAGTACAATGAGCAGTTCTTC	CASSATREVEYNEQFF	TRBV7-3	TRBJ2-1
TGCGCCAGCAGCAACAGGGGCAATGGCTACACCTTC	CASSNRGNGYTF	TRBV5-1	TRBJ1-2
TGTGCCAGCATTCGTAAGAGGGACTCTGTTAACAATGAGCAGTTCTTC	CASIRKRDSVNNEQFF	TRBV27	TRBJ2-1
TGCGCCAGCAGTGGCCGGGGGGGGAACTATGGCTACACCTTC	CASSGRGGNYGYTF	TRBV10-1	TRBJ1-2
TGCGCCAGCAAAGGGGTTTCCTCCTACGAGCAGTACTTC	CASKGVSSYEQYF	TRBV10-1	TRBJ2-7
TGTGCCAGCAGTTACCCGACAGGGGGGGAGTGGACCCAGTACTTC	CASSYPTGGEWTQYF	TRBV6-5	TRBJ2-5
TGTGCCAGGAACACAACAGGGGGGACGCCCCAGCATTTT	CARNTTGGTPQHF	TRBV6-5	TRBJ1-5
TGTGCCAGCAGCTTGGTCCGTCTTGGGAGGACAGGGGGGAACACTGAAGCTTTCTTT	CASSLVRLGRTGGNTEAFF	TRBV5-6	TRBJ1-1
TGTGCCAGCAGTATCGTGACTAGCGGGAGCCCCAGCTCCTACAATGAGCAGTTCTTC	CASSIVTSGSPSSYNEQFF	TRBV6-5	TRBJ2-1
TGTGCCAGCAGCCCCAGTCTTCGCGGGCAGACCCTCTACGAGCAGTACTTC	CASSPSLRGQTLYEQYF	TRBV14	TRBJ2-7
TGTGCCAGCAGTTCCAAGCGGAGGCTATCAAGGGCATACAATGAGCAGTTCTTC	CASSSKRRLSRAYNEQFF	TRBV6-5	TRBJ2-1
TGCGCCAGCAGCCAAGTAGGGGACAGGTTAGAGACCCAGTACTTC	CASSQVGDRLETQYF	TRBV4-1	TRBJ2-5
TGTGCCAGCAGCGTAGGGGTTAGCTCCTATAATTCACCCCTCCACTTT	CASSVGVSSYNSPLHF	TRBV13	TRBJ1-6
TGTGCCAGCAGCAGGGACAGGATCGCTGGCTACACCTTC	CASSRDRIAGYTF	TRBV13	TRBJ1-2
TGTGCCAGCAAATACAATATGCCACAGTACTTC	CASKYNMPQYF	TRBV6-2	TRBJ2-7
TGTGCCAGCAGCTTAGCCCATTCCTTCCGGGGGCAAGAGACCCAGTACTTC	CASSLAHSFRGQETQYF	TRBV7-8	TRBJ2-5
TGTGCCAGCAGCAGTCAAGAGGGATTCTATGGCTACACCTTC	CASSSQEGFYGYTF	TRBV7-9	TRBJ1-2
TGCGCCAGCAGCTTGGGAGGGAGCTACGAGCAGTACTTC	CASSLGGSYEQYF	TRBV5-1	TRBJ2-7
TGCAGTGCTAGAGTTAATTTGGTGGGACAGAACACTGAAGCTTTCTTT	CSARVNLVGQNTEAFF	TRBV20-1	TRBJ1-1
TGTGCCAGCAGCTTAGATTCGGGACTAGCGATATTCTACGAGCAGTACTTC	CASSLDSGLAIFYEQYF	TRBV7-4	TRBJ2-7
TGCAGGTGGGTCAAAGCTATGTGGCAGTACTTC	CRWVKAMWQYF	TRBV20-1	TRBJ2-7
TGTGCCAGCAGCATAAATGGGGATGACGGCTCTTATAGCAATCAGCCCCAGCATTTT	CASSINGDDGSYSNQPQHF	TRBV7-3	TRBJ1-5
TGTGCCACCGACTTACAGGGGGCAATGAATCAGCCCCAGCATTTT	CATDLQGAMNQPQHF	TRBV24-1	TRBJ1-5
TGTGCCAGCAGCTGTGACAATGGATACTACGAGCAGTACTTC	CASSCDNGYYEQYF	TRBV13	TRBJ2-7
TGTGCCAGCAGCTTCCTCTGCGACATCACGAACACTGAAGCTTTCTTT	CASSFLCDITNTEAFF	TRBV7-3	TRBJ1-1
TGTGCCACCAGTGATTTGCTGGCAGGACAGGGGGCCCTCTACGAGCAGTACTTC	CATSDLLAGQGALYEQYF	TRBV24-1	TRBJ2-7
TGTGCCAGCACCCAGGGTATCTACACCGGGGAGCTGTTTTTT	CASTQGIYTGELFF	TRBV6-3	TRBJ2-2
TGTGCCAGCAGTTACTCAAGGGGGAGATCAACTGGGGCCAACGTCCTGACTTTC	CASSYSRGRSTGANVLTF	TRBV6-3	TRBJ2-6
TGTGCCAGTAGTATGACCGAAACGGGGGGGCGCGGGTACGAGCAGTACTTC	CASSMTETGGRGYEQYF	TRBV19	TRBJ2-7
TGTGCCAGCAGCGTAGCAGGGGTTCCAGACTATGGCTACACCTTC	CASSVAGVPDYGYTF	TRBV9	TRBJ1-2
TGTGCCAGCACCTATAAGGGAGCGGGAGTACTTGTCTCTGGAAACACCATATATTTT	CASTYKGAGVLVSGNTIYF	TRBV7-9	TRBJ1-3
TGTGCCAGCAGTGAGGGGAGAGGGACGGCCAATGAGCAGTTCTTC	CASSEGRGTANEQFF	TRBV6-4	TRBJ2-1
TGTGCCAGCAGCCAAGGATCGCCCGGGGGTCCGGCCAACGTCCTGACTTTC	CASSQGSPGGPANVLTF	TRBV3-1	TRBJ2-6
TGTGCCAGCAGGCCCCCGAACAGGGTCGATAAAGGTGAAAAACTGTTTTTT	CASRPPNRVDKGEKLFF	TRBV27	TRBJ1-4
TGTGCCAGCAGTCCCACTAGCGGGAGACGCTACGAGCAGTACTTC	CASSPTSGRRYEQYF	TRBV27	TRBJ2-7
TGCGCCAGGGCCACGTCCAATCAGCCCCAGCATTTT	CARATSNQPQHF	TRBV10-1	TRBJ1-5
TGTGCCTGGAGTGAGAAGCTGCAGGGGGAAGAGACCCAGTACTTC	CAWSEKLQGEETQYF	TRBV30	TRBJ2-5
TGTGCCAGCAGTTTATGGGGGACTAGGGCGGGGGACACCGGGGAGCTGTTTTTT	CASSLWGTRAGDTGELFF	TRBV28	TRBJ2-2
TGTGCCAGCAGCCAAGTCAAGGGGGATTATAGCAATCAGCCCCAGCATTTT	CASSQVKGDYSNQPQHF	TRBV3-1	TRBJ1-5
TGTGCCAGCAGCGCCAGCTATCGCACTGAAGCTTTCTTT	CASSASYRTEAFF	TRBV13	TRBJ1-1
TGTGCCAGCAGTTCGGGAAGCGGGAGGAAAGCGACAGATACGCAGTATTTT	CASSSGSGRKATDTQYF	TRBV6-5	TRBJ2-3
TGTGCCTGGAGGGGCTGTCAGCCCCAGCATTTT	CAWRGCQPQHF	TRBV30	TRBJ1-5
TGTGCCAGCAGCTTAGCAGAAAGGGGGGGGTCTAGCCAGACCTACAATGAGCAGTTCTTC	CASSLAERGGSSQTYNEQFF	TRBV7-2	TRBJ2-1
TGTGCCAGCTCACCACCTGCCGCCGGGACTAGGGTCAGGTTGCAGTTCTTC	CASSPPAAGTRVRLQFF	TRBV18	TRBJ2-1
TGTGCCCACCGAGTACAAGAGACCCAGTACTTC	CAHRVQETQYF	TRBV6-5	TRBJ2-5
TGTGCCAGCCTCCGGGACCGGTCCTACGAGCAGTACTTC	CASLRDRSYEQYF	TRBV12-4	TRBJ2-7
TGTGCCACCATCATCCGGACTAGCGGGAGACGCTACAATGAGCAGTTCTTC	CATIIRTSGRRYNEQFF	TRBV24-1	TRBJ2-1
TGTGCCAGCACATGTAACGGCGGGGACTACGAGCAGTACTTC	CASTCNGGDYEQYF	TRBV9	TRBJ2-7
TGCAGCGTTAAAATGGCCACTAGCGGGAGAAGGTCTGGGGCCAACGTCCTGACTTTC	CSVKMATSGRRSGANVLTF	TRBV29-1	TRBJ2-6
TGCAGTGCGACCGGAAACACCATATATTTT	CSATGNTIYF	TRBV20-1	TRBJ1-3
TGTGCCACCAGCAACGGCCCCCGACAGGACAGGGATGGGAACACTGAAGCTTTCTTT	CATSNGPRQDRDGNTEAFF	TRBV24-1	TRBJ1-1
TGTGCCACCAGCAGAGATGGCACCCGGGACAGGGGAGATGAGCAGTTCTTC	CATSRDGTRDRGDEQFF	TRBV15	TRBJ2-1
TGTGCCAGCCTTGGGACTAGGTCAACCTACGAGCAGTACTTC	CASLGTRSTYEQYF	TRBV6-4	TRBJ2-7
TGTGCCAGCAGGGGGCTCCCTCTCCCCCCACAGGGACTTAGCACCGGGGAGCTGTTTTTT	CASRGLPLPPQGLSTGELFF	TRBV6-6	TRBJ2-2
TGTGCCATCAGTGAGGGTCCCCTGGACAGGGCAGGTTTTTGGACTGAAGCTTTCTTT	CAISEGPLDRAGFWTEAFF	TRBV10-3	TRBJ1-1
TGTGCCAGCAGCTTGGATGGGGGGGCCTACGAGCAGTACTTC	CASSLDGGAYEQYF	TRBV5-4	TRBJ2-7
TGTGCCACCTTGGGGCGCCAAGAGACCCAGTACTTC	CATLGRQETQYF	TRBV24-1	TRBJ2-5
TGTCTTAGCGGCACCTACGAGCAGTACTTC	CLSGTYEQYF	TRBV10-3	TRBJ2-7
TGTGCCAGCAGTTTAGCCGTCGTGGCCCATCAGCCCCAGCATTTT	CASSLAVVAHQPQHF	TRBV28	TRBJ1-5
TGTGCCCGCCGACTAGGGGGCGAGGACAATGAGCAGTTCTTC	CARRLGGEDNEQFF	TRBV27	TRBJ2-1
TGTGCCAGCAACCCCGGGACAAGGAATGGCTACACCTTC	CASNPGTRNGYTF	TRBV27	TRBJ1-2
TGTGCCAGCAGCCAAGATCTAATAAATTCACCCCTCCACTTT	CASSQDLINSPLHF	TRBV3-1	TRBJ1-6
TGCAGTGCTAGAGATTACAGGGGGACCTACGAGCAGTACTTC	CSARDYRGTYEQYF	TRBV20-1	TRBJ2-7
TGCAGTGCCGTGCTGCCCTCATGGCGCCCCAAGGGGTACGAGCAGTACTTC	CSAVLPSWRPKGYEQYF	TRBV20-1	TRBJ2-7
TGTGCCAGCAGTGAGGGGGGCTACACCTTC	CASSEGGYTF	TRBV6-4	TRBJ1-2
TGCAGCGTTGAAGATATACTTGGAACCAACGTCCTGACTTTC	CSVEDILGTNVLTF	TRBV29-1	TRBJ2-6
TGCGCCAGCAGTGACAATGGGGTTATGGGCACTGAAGCTTTCTTT	CASSDNGVMGTEAFF	TRBV10-1	TRBJ1-1
TGTGCCAGCAGTCGGGGCTTCGATAGCAATCAGCCCCAGCATTTT	CASSRGFDSNQPQHF	TRBV6-2	TRBJ1-5
TGTGCCAGCGTGCAAGACGACAGCCCGACCAATGAGCAGTTCTTC	CASVQDDSPTNEQFF	TRBV7-3	TRBJ2-1
TGTGCCAGCAGTTACTTCATTAGGGACTGGAAGGATGAGCAGTTCTTC	CASSYFIRDWKDEQFF	TRBV6-3	TRBJ2-1
TGTGCCAGCAGTTATTCTTGCCAGGAGTCCCCAGGGACAGGGAATCAGCCCCAGCATTTT	CASSYSCQESPGTGNQPQHF	TRBV6-9	TRBJ1-5
TGTGCCAGCAGTAGCCGACAGGGGGGCCGAAGCTCCTATAATTCACCCCTCCACTTT	CASSSRQGGRSSYNSPLHF	TRBV28	TRBJ1-6
TGCGCCAGCAGCCAAGGACCACGTTACAATGAGCAGTTCTTC	CASSQGPRYNEQFF	TRBV4-3	TRBJ2-1
TGTGCCAGCAGCGGAACAGGGTCGTCACCCCTCCACTTT	CASSGTGSSPLHF	TRBV9	TRBJ1-6
TGCGCCAGCAGCCGCTTACTAGCGGGGGGGCCCGAGCAGTACTTC	CASSRLLAGGPEQYF	TRBV4-3	TRBJ2-7
TGTGCCAGCAGCACTAGCGGGAGGCTGCTGACCGCTTTCTTT	CASSTSGRLLTAFF	TRBV13	TRBJ1-1
TGTGCCAGTAGTATTCCTGGGGGCAGGGGGGGGGACATTCAGTACTTC	CASSIPGGRGGDIQYF	TRBV19	TRBJ2-4
TGTGCCAGCAGCTTTTTAAGTAGATGGAAAGGACAGGGAACGAGGAACACCGGGGAGCTGTTTTTT	CASSFLSRWKGQGTRNTGELFF	TRBV7-3	TRBJ2-2
TGTGCCAGCAACACAGGGGACTATGGCTACACCTTC	CASNTGDYGYTF	TRBV6-5	TRBJ1-2
TGTGCCAGCTCACCTCTAGCGGGGTTTCCAGAGACCCAGTACTTC	CASSPLAGFPETQYF	TRBV18	TRBJ2-5
TGTGCCAGCAGCTTGTCTAGGCCCTACCCGGGGGCGCGGCAGTCTGGAAACACCATATATTTT	CASSLSRPYPGARQSGNTIYF	TRBV7-2	TRBJ1-3
TGCGCCAGCAGGTTGACGGGGGGGAATCATGAGCAGTTCTTC	CASRLTGGNHEQFF	TRBV10-1	TRBJ2-1
TGTGCCAGCCCCTCCGTTTTCGCCGGGACATTGGAGCAGTACTTC	CASPSVFAGTLEQYF	TRBV7-9	TRBJ2-7
TGCAGCGTTGCCGTCCCACCGACTAGCGGGGGGACCAGCTCCTACAATGAGCAGTTCTTC	CSVAVPPTSGGTSSYNEQFF	TRBV29-1	TRBJ2-1
TGTGCCAGCAGCTTACCTGGATATGAGCAGTTCTTC	CASSLPGYEQFF	TRBV11-2	TRBJ2-1
TGTGCCAGCACCCCGGGCAAGTCTGGCTACACCTTC	CASTPGKSGYTF	TRBV6-5	TRBJ1-2
TGTGCCAGCAGCAAAGCAGGGAGTTCCGGAATAGGATACGAGCAGTACTTC	CASSKAGSSGIGYEQYF	TRBV7-3	TRBJ2-7
TGTGCCAGCAGTTCTCAGGGGAGAAATCAGCCCCAGCATTTT	CASSSQGRNQPQHF	TRBV27	TRBJ1-5
TGTGCCAGCAGCCCCCCAAGCTGCGGAATATACGAGCAGTACTTC	CASSPPSCGIYEQYF	TRBV7-9	TRBJ2-7
TGTGCCAGCAGCTTTCCGGCCACTCGGAACACTGAAGCTTTCTTT	CASSFPATRNTEAFF	TRBV11-3	TRBJ1-1
TGCATGGTGGGGCCCTACGAGCAGTACTTC	CMVGPYEQYF	TRBV20-1	TRBJ2-7
TGTGCCACCAGTGCCTCGACTAGCCGGGACCCTGAGACCCAGTACTTC	CATSASTSRDPETQYF	TRBV24-1	TRBJ2-5
TGCGCCAGCAGCTTTCAATTCGGGTACTACGAGCAGTACTTC	CASSFQFGYYEQYF	TRBV10-1	TRBJ2-7
TGTGCCAGCGGGGGACCATGGAGATCCTACGAGCAGTACTTC	CASGGPWRSYEQYF	TRBV6-4	TRBJ2-7
TGCAGTGCTAGTAGGGGTGTAGTGAACACTGAAGCTTTCTTT	CSASRGVVNTEAFF	TRBV20-1	TRBJ1-1
TGTGCCAGCAGCAGAGAGTTTACTGAAGCTTTCTTT	CASSREFTEAFF	TRBV11-3	TRBJ1-1
TGTGCCAGCAGCGTGACGATGAAGCCCCAGCATTTT	CASSVTMKPQHF	TRBV7-3	TRBJ1-5
TGTGCCACCAGTGAGAGGTCGGGGCTCGGCTCCTACAATGAGCAGTTCTTC	CATSERSGLGSYNEQFF	TRBV24-1	TRBJ2-1
TGTGCCAGCAGCTGGAAAGGGGGCAGGGGTAATGGCTACACCTTC	CASSWKGGRGNGYTF	TRBV7-3	TRBJ1-2
TGTGCCAGCAGCTATCCCCAGATGTCTGCTGAAAAACTGTTTTTT	CASSYPQMSAEKLFF	TRBV5-6	TRBJ1-4
TGTGCCAGCAGACAGTTAAACCCGAGACAGCAAGCCGGGGAGCTGTTTTTT	CASRQLNPRQQAGELFF	TRBV6-5	TRBJ2-2
TGTGCCAGCAGTGCACGGGACAGGGGTAAGCCTGAGACCCAGTACTTC	CASSARDRGKPETQYF	TRBV6-4	TRBJ2-5
TGTGCCAGCAGCTTACGAGATGTGCAGCCCCAGCATTTT	CASSLRDVQPQHF	TRBV13	TRBJ1-5
TGCGCCAGCAGTGAGCATAGACGAGAGCAGTACTTC	CASSEHRREQYF	TRBV10-1	TRBJ2-7
TGCGCCAGCAGAATGGACAGGGCAAAAAAACTGTTTTTT	CASRMDRAKKLFF	TRBV5-1	TRBJ1-4
TGTGCCAGCAGCGATCCGGGACAGGGGGGAGACGTGACCTACGAGCAGTACTTC	CASSDPGQGGDVTYEQYF	TRBV6-6	TRBJ2-7
TGTGCCAGCAGCTTAGCCTCCCTAATGAGGACAGGGCCCAGCACCGGGGAGCTGTTTTTT	CASSLASLMRTGPSTGELFF	TRBV7-7	TRBJ2-2
TGTGCCAGCAGTGACTCAAAATCAAGGTGCAAAGGCTTGGGGGTGCCCTACGAGCAGTACTTC	CASSDSKSRCKGLGVPYEQYF	TRBV6-4	TRBJ2-7
TGTGCCAGCAGTTTACTTCAGCTCTACAATGAGCAGTTCTTC	CASSLLQLYNEQFF	TRBV12-4	TRBJ2-1
TGCGCCAGCAGCTTGGACCATTACCGGGACAGGGATTCACCCCTCCACTTT	CASSLDHYRDRDSPLHF	TRBV5-1	TRBJ1-6
TGTGCCAGCAGTTTAGAAACTAGCGGGAGTCTACAGGGGTACGAGCAGTACTTC	CASSLETSGSLQGYEQYF	TRBV28	TRBJ2-7
TGTGCCAAGAGCCTGCAGAACACCGGGGAGCTGTTTTTT	CAKSLQNTGELFF	TRBV6-1	TRBJ2-2
TGTGCCAGCAGTTGCGGGCGTTACAATGAGCAGTTCTTC	CASSCGRYNEQFF	TRBV27	TRBJ2-1
TGCGCCAGCAGGGAATGGGGGGTTAACACTGAAGCTTTCTTT	CASREWGVNTEAFF	TRBV4-1	TRBJ1-1
TGTGCCAGCAGCCCAGTGTCCACAGGAGGTTACGAGCAGTACTTC	CASSPVSTGGYEQYF	TRBV13	TRBJ2-7
TGTGCCAGCAGCTTGGACACTGGTCAGCCCCAGCATTTT	CASSLDTGQPQHF	TRBV5-4	TRBJ1-5
TGTGCCAGCAGTTTATCTCCCCAACTAGCGGGCTACGAGCAGTACTTC	CASSLSPQLAGYEQYF	TRBV28	TRBJ2-7
TGCAGTGCCGACAGGGGGCAGGGAAACACCATATATTTT	CSADRGQGNTIYF	TRBV20-1	TRBJ1-3
TGTGCCAGCATAGATATCCGAAGGGGTGAGCAGTTCTTC	CASIDIRRGEQFF	TRBV27	TRBJ2-1
TGTGCCAGCCCCCAGCGCCAGGGGGCGGAGAGAAGGAACACTGAAGCTTTCTTT	CASPQRQGAERRNTEAFF	TRBV6-1	TRBJ1-1
TGTGCCAGCCGGACAGGCACCGGGGAGCTGTTTTTT	CASRTGTGELFF	TRBV25-1	TRBJ2-2
TGTGCCAGCAGTTTACTACCGGCATCAGGACAGAGGTTAGCCAAAAACATTCAGTACTTC	CASSLLPASGQRLAKNIQYF	TRBV12-3	TRBJ2-4
TGTGCCAGCAGTTTCAGCCAACAGGCCCTCAGGGACGAGCAGTACTTC	CASSFSQQALRDEQYF	TRBV28	TRBJ2-7
TGTGCCAGCAGCCCCAGAGCGGGAGGAGACGAGCAGTACTTC	CASSPRAGGDEQYF	TRBV7-4	TRBJ2-7
TGTGCCAGGAACCGCAGGAATAAGGAGGGAGCCAAAAACATTCAGTACTTC	CARNRRNKEGAKNIQYF	TRBV6-4	TRBJ2-4
TGTGCCAGCAGCTTGGTACCACAGGGAAGGAGCGCGGGGGGGCAGTATTTT	CASSLVPQGRSAGGQYF	TRBV5-6	TRBJ2-3
TGCGCCAGCAGCCAAGAGAGCCGTCGGGGGGGCGGACCCTACACCTTC	CASSQESRRGGGPYTF	TRBV4-3	TRBJ1-2
TGTGCCAGCAGTTGGAGAGGGACTTACCAAGAGACCCAGTACTTC	CASSWRGTYQETQYF	TRBV27	TRBJ2-5
TGTGCCAGCAGCCACGGGGGGCGGTACAATGAGCAGTTCTTC	CASSHGGRYNEQFF	TRBV13	TRBJ2-1
TGTGCCAGGGGAGTGAATGAGCAGTTCTTC	CARGVNEQFF	TRBV7-2	TRBJ2-1
TGTGCCAGCAGCAATGCTCTAGGGGACAGTGCAAATCAGCCCCAGCATTTT	CASSNALGDSANQPQHF	TRBV7-6	TRBJ1-5
TGTGCCAGCAGGGATCTAGCGGGTAAGGGTATCAGCTCCTACGAGCAGTACTTC	CASRDLAGKGISSYEQYF	TRBV7-3	TRBJ2-7
TGTGCCAGCAGCACGGCGGCGTACGAGCAGTACTTC	CASSTAAYEQYF	TRBV5-6	TRBJ2-7
TGTGCCAGACGGGGGGGGGGCTCCTACGAGCAGTACTTC	CARRGGGSYEQYF	TRBV6-1	TRBJ2-7
TGTGCCAGCAGGAGGGACAGGGAATTCGGGTGTCGCGACACTGAAGCTTTCTTT	CASRRDREFGCRDTEAFF	TRBV12-4	TRBJ1-1
TGTGCCAGCAGACCTAGCGGGGGATGGGGGGGGGCAGGAGGCAACTCCCAAGAGACCCAGTACTTC	CASRPSGGWGGAGGNSQETQYF	TRBV6-1	TRBJ2-5
TGCGCCAGCAGCTTGTCCTTGGCCTACAGGGGAGGATGTGGCTACACCTTC	CASSLSLAYRGGCGYTF	TRBV5-1	TRBJ1-2
TGTGCCACCGAAAGGACAGCGGACAGGGTCTTAAATAACTATGGCTACACCTTC	CATERTADRVLNNYGYTF	TRBV24-1	TRBJ1-2
TGTGCCAGTAGCAAAGGGGAGACGGGGAGCTCCTACGAGCAGTACTTC	CASSKGETGSSYEQYF	TRBV19	TRBJ2-7
TGTGCCAGCAGTGAAGCTCAGGGAAGGATCGCGAACACCGGGGAGCTGTTTTTT	CASSEAQGRIANTGELFF	TRBV6-1	TRBJ2-2
TGTGCCATCATAGAACAAGGGAGGGGGGAGACCCAGTACTTC	CAIIEQGRGETQYF	TRBV10-3	TRBJ2-5
TGTGCCAGCAGTTTAAACAACCGGGAGGGCTCTAATGAAAAACTGTTTTTT	CASSLNNREGSNEKLFF	TRBV28	TRBJ1-4
TGTGCCATCAGTGCCTGGGTTAGTATGAACACTGAAGCTTTCTTT	CAISAWVSMNTEAFF	TRBV10-3	TRBJ1-1
TGCGCCAGCAGCCAAGGGGACAGGGACTATGGCTACACCTTC	CASSQGDRDYGYTF	TRBV4-1	TRBJ1-2
TGTGCCAGCAGCGGCCCAGGGGTGTGCTACACCTTC	CASSGPGVCYTF	TRBV28	TRBJ1-2
TGTGCCAGCAGTTTACCGCGTGACTCGGGACCAGATACGCAGTATTTT	CASSLPRDSGPDTQYF	TRBV28	TRBJ2-3
TGTGCCAGCAGCTTCAGAGCCCAGCCCCAGCATTTT	CASSFRAQPQHF	TRBV11-2	TRBJ1-5
TGCGCCAAGTCCCAGGTACATGGGGCCAACGTCCTGACTTTC	CAKSQVHGANVLTF	TRBV10-1	TRBJ2-6
TGCGCCCTCGTCCGGGACTATTCCCACGAGCAGTACTTC	CALVRDYSHEQYF	TRBV10-1	TRBJ2-7
TGTGCCAGCAGTGAGTTTCGCAAGAACACTGAAGCTTTCTTT	CASSEFRKNTEAFF	TRBV6-6	TRBJ1-1
TGTGCCAGCAGCGGACAGGGGGCGCACGAGCAGTACTTC	CASSGQGAHEQYF	TRBV7-6	TRBJ2-7
TGTGCCAGCAGCCAAGAGAAGCTAACGAATTATGCTAACGAGCAGTACTTC	CASSQEKLTNYANEQYF	TRBV3-1	TRBJ2-7
TGCGCCAGCAGCCACTGGTCCGGACAGGATAACGTCTATGGCTACACCTTC	CASSHWSGQDNVYGYTF	TRBV4-1	TRBJ1-2
TGTAGCAGCAGGGCGAGTATATACACTGAAGCTTTCTTT	CSSRASIYTEAFF	TRBV19	TRBJ1-1
TGTGCCAGCATGAGGTCAACAGGGGGGGCTAACTATGGCTACACCTTC	CASMRSTGGANYGYTF	TRBV7-6	TRBJ1-2
TGCGCCAGCAGCACAGGAGGGGTGGCCTCTACTAATGAAAAACTGTTTTTT	CASSTGGVASTNEKLFF	TRBV5-1	TRBJ1-4
TGTGCCAGCAGCTTACAATTGGTCCCGATCAATTCCAGAGAGACCCAGTACTTC	CASSLQLVPINSRETQYF	TRBV7-8	TRBJ2-5
TGTGCCAGCAGCCTTCCAGGCACAGATACGCAGTATTTT	CASSLPGTDTQYF	TRBV7-6	TRBJ2-3
TGTGCCAGCAGCGGAGGGGAGCGAGCAGATACGCAGTATTTT	CASSGGERADTQYF	TRBV9	TRBJ2-3
TGTGCCTGGAGTGTCCCTAGGGGTTTTTCCAATGAGCAGTTCTTC	CAWSVPRGFSNEQFF	TRBV30	TRBJ2-1
TGTGCCAAGGACAGGGTATGCAAAGGCTACACCTTC	CAKDRVCKGYTF	TRBV6-5	TRBJ1-2
TGTGCTAGTGGTTTGGGAGACAGGGTAGGAAACACCATATATTTT	CASGLGDRVGNTIYF	TRBV12-5	TRBJ1-3
TGCAGCGTTGGGCTAGCGGGCCCCTCCTACGAGCAGTACTTC	CSVGLAGPSYEQYF	TRBV29-1	TRBJ2-7
TGTGCCATATTCCAGGGATCTAATAACTATGGCTACACCTTC	CAIFQGSNNYGYTF	TRBV6-4	TRBJ1-2
TGTGCCAGCAGCCAATCCTCCCTAGCGGGCACAGATACGCAGTATTTT	CASSQSSLAGTDTQYF	TRBV3-1	TRBJ2-3
TGTGCCCCTCACTCAGGGAGTCTCTTCCAAGAGACCCAGTACTTC	CAPHSGSLFQETQYF	TRBV30	TRBJ2-5
TGTGCCAGCAGACTGACTAAAATACTGTACGAGCAGTACTTC	CASRLTKILYEQYF	TRBV6-1	TRBJ2-7
TGTGCCAGCAAGAGTGGCCACTACGAGCAGTACTTC	CASKSGHYEQYF	TRBV7-3	TRBJ2-7
TGTGCCAGCAGCTTCGCCGGGACCGAGAGCTCCTACGAGCAGTACTTC	CASSFAGTESSYEQYF	TRBV11-3	TRBJ2-7
TGTGCCAGAGCCGGGGTCCAAGAGACCCAGTACTTC	CARAGVQETQYF	TRBV19	TRBJ2-5
TGTGCCAGCAGTTGGGGGGGGGGATGCTACGAGCAGTACTTC	CASSWGGGCYEQYF	TRBV7-9	TRBJ2-7
TGTGCCAGCCTATGGGCCTCGGGCGAGCAGTACTTC	CASLWASGEQYF	TRBV6-4	TRBJ2-7
TGTGCCAGCAGCGTGGGGGGGCCAGTATTCTACGAGCAGTACTTC	CASSVGGPVFYEQYF	TRBV5-4	TRBJ2-7
TGCAGTGCTCCTTCAAGAGGGGGACTAGCGGGAGAGGATACGCAGTATTTT	CSAPSRGGLAGEDTQYF	TRBV20-1	TRBJ2-3
TGTGCCAGCAGTTCAGGGGGAAACACCGGGGAGCTGTTTTTT	CASSSGGNTGELFF	TRBV6-1	TRBJ2-2
TGTGCCAGCAGGGGGTCGGGGCAGTACGAGCAGTACTTC	CASRGSGQYEQYF	TRBV12-3	TRBJ2-7
TGTGCCAGCAGCTTAGATAAGTCGGGTTTTGGCTACAATGAGCAGTTCTTC	CASSLDKSGFGYNEQFF	TRBV7-2	TRBJ2-1
TGTGCCAGCAGCCGGGACAGGGCCCGAAGCTCCTACGAGCAGTACTTC	CASSRDRARSSYEQYF	TRBV5-4	TRBJ2-7
TGTGCTAGTGGTTCTTTTCTACGCTCTAACTATGGCTACACCTTC	CASGSFLRSNYGYTF	TRBV12-5	TRBJ1-2
TGTGCCAGCAGCGGGGGGGGACCCATTTTTGGTGATGGCTACACCTTC	CASSGGGPIFGDGYTF	TRBV13	TRBJ1-2
TGCGCCAGCAGGCCGGGGGGCGTCTCCTACGAGCAGTACTTC	CASRPGGVSYEQYF	TRBV5-1	TRBJ2-7
TGCGCCAGCAGCCAATCCCCGGGACAGACGCAGTATTTT	CASSQSPGQTQYF	TRBV5-1	TRBJ2-3
TGTGCCAGCAGCGCATGCGGAACTAACAATGAGCAGTTCTTC	CASSACGTNNEQFF	TRBV6-5	TRBJ2-1
TGTGCCAGCACTCAGAGGGGTCCTGGAGATACGCAGTATTTT	CASTQRGPGDTQYF	TRBV6-4	TRBJ2-3
TGTACCTCCGGTACATTCTATGGCTACACCTTC	CTSGTFYGYTF	TRBV19	TRBJ1-2
TGCGCCAGCAGGACTGGTGAAGCTTTCTTT	CASRTGEAFF	TRBV5-1	TRBJ1-1
TGTGCCTGGAGCCCCCTGGTTTTCTCCCCCAATCAGCCCCAGCATTTT	CAWSPLVFSPNQPQHF	TRBV30	TRBJ1-5
TGCAGTGCTAGGGATTCCTATTATAGCGGGAGAAAGGGCTCCTACGAGCAGTACTTC	CSARDSYYSGRKGSYEQYF	TRBV20-1	TRBJ2-7
TGTGCCAGCTATGACAGAGACAACACCGGGGAGCTGTTTTTT	CASYDRDNTGELFF	TRBV6-4	TRBJ2-2
TGTGCCAGCTCACCACGCCAGTGGGGGGGCCAAGAGACCCAGTACTTC	CASSPRQWGGQETQYF	TRBV18	TRBJ2-5
TGTGCCAGCAGCTTTCATCGGGAGTTTGCCAGCTCTGGAAACACCATATATTTT	CASSFHREFASSGNTIYF	TRBV5-5	TRBJ1-3
TGTGCCAGCAGCCAAGATCAACAGGGCCGAAGGCAGCCCCAGCATTTT	CASSQDQQGRRQPQHF	TRBV3-1	TRBJ1-5
TGCAGTGCTAGCGGGGGACAGAGGGTCTCTGGAAACACCATATATTTT	CSASGGQRVSGNTIYF	TRBV20-1	TRBJ1-3
TGTGCCAGCAGTTGGCCGCATAGCGGACCTTCCTACAATGAGCAGTTCTTC	CASSWPHSGPSYNEQFF	TRBV6-8	TRBJ2-1
TGTGCCAGCAGCTTGGGCGCCGGGCGGTTGACTAATGAAAAACTGTTTTTT	CASSLGAGRLTNEKLFF	TRBV5-4	TRBJ1-4
TGTGCCAGCAGTCTCTACCATCGGGATGTAGAGACCCAGTACTTC	CASSLYHRDVETQYF	TRBV27	TRBJ2-5
TGTGCCAGCAGCCCGGGGAGCCGGACCTACGAGCAGTACTTC	CASSPGSRTYEQYF	TRBV6-6	TRBJ2-7
TGTGCCAGCATATTCCGAGGCGGACCCGGAAATAGCAATCAGCCCCAGCATTTT	CASIFRGGPGNSNQPQHF	TRBV12-3	TRBJ1-5
TGTGCCACCAGCCGACAGGATCAGCCCCAGCATTTT	CATSRQDQPQHF	TRBV24-1	TRBJ1-5
TGTGCCAGCAGCGTGGACACCGACTGTGAAAAACTGTTTTTT	CASSVDTDCEKLFF	TRBV9	TRBJ1-4
TGTGCCAGCAGCCGAGGCAAAAACATTCAGTACTTC	CASSRGKNIQYF	TRBV7-3	TRBJ2-4
TGTGCCAGCAGCGCGGGACAGGGTGATACGCAGTATTTT	CASSAGQGDTQYF	TRBV7-2	TRBJ2-3
TGCGCCAGCAGCTCCCCTCGGGACAGGGGGGTATTCACTGAAGCTTTCTTT	CASSSPRDRGVFTEAFF	TRBV5-1	TRBJ1-1
TGTGCCAGCAGTTACTCGAAGGGACAGGGGCAGGATGTGGAAAAACTGTTTTTT	CASSYSKGQGQDVEKLFF	TRBV6-5	TRBJ1-4
TGTGCCAGCAGCTGCTGGACTAGCGGCCGGACGCATGGGGCCAACGTCCTGACTTTC	CASSCWTSGRTHGANVLTF	TRBV5-4	TRBJ2-6
TGTGCCAGCAGCTCTGAATTGCACCTTCCGGACACTGAAGCTTTCTTT	CASSSELHLPDTEAFF	TRBV7-9	TRBJ1-1
TGTGCCTGGAGTGAGGCGGGACAGGACCCCCACTATGGCTACACCTTC	CAWSEAGQDPHYGYTF	TRBV30	TRBJ1-2
TGTGCCAGCAGGCCCTGGGCCTCTGGAAACACCATATATTTT	CASRPWASGNTIYF	TRBV11-2	TRBJ1-3
TGCGCCAGCAAGAGGTCCAACCATAGCAATCAGCCCCAGCATTTT	CASKRSNHSNQPQHF	TRBV5-1	TRBJ1-5
TGTGCCAGCAGTGAGTGGGATAGGTCGGGATCTTTTAATGAAAAACTGTTTTTT	CASSEWDRSGSFNEKLFF	TRBV27	TRBJ1-4
TGTGCCTGGTTCGGTTACTTCTCCTACGAGCAGTACTTC	CAWFGYFSYEQYF	TRBV30	TRBJ2-7
TGTGCCAGCAGCGGACCTAGCAATCAGCCCCAGCATTTT	CASSGPSNQPQHF	TRBV7-4	TRBJ1-5
TGTGCCAGCGATAAGCGGATCTATGGCTACACCTTC	CASDKRIYGYTF	TRBV18	TRBJ1-2
TGTGCCAGCAGTGACTCTAGCAGGCATAATTCACCCCTCCACTTT	CASSDSSRHNSPLHF	TRBV6-4	TRBJ1-6
TGCGCCAGCAGTGTAGGGTCGCTTTCCCAAGAGACCCAGTACTTC	CASSVGSLSQETQYF	TRBV10-1	TRBJ2-5
TGCGCCAGCAGTCCCGGGACAGGGCGGAATTCACCCCTCCACTTT	CASSPGTGRNSPLHF	TRBV10-1	TRBJ1-6
TGCAGCGTTGGCCGTCCCGGGGGAGACGAGCAGTACTTC	CSVGRPGGDEQYF	TRBV29-1	TRBJ2-7
TGTGCCAGCAGGGGACAGGGGAGGCCCTACGAGCAGTACTTC	CASRGQGRPYEQYF	TRBV28	TRBJ2-7
TGTGCCAGCAGTTTGAAAGAGGGGCCCTACAATGAGCAGTTCTTC	CASSLKEGPYNEQFF	TRBV11-2	TRBJ2-1
TGTGCCAGCAGCTTCCGGAATTGGGCGGGGATGAACACTGAAGCTTTCTTT	CASSFRNWAGMNTEAFF	TRBV7-9	TRBJ1-1
TGCGCCAGCAGTGAGTTAAAGCTAGCGGGGGGCACAGATACGCAGTATTTT	CASSELKLAGGTDTQYF	TRBV10-1	TRBJ2-3
TGCAGTGCTAGAGCCCGGTGGCGGGACAGGGACTATGGCTACACCTTC	CSARARWRDRDYGYTF	TRBV20-1	TRBJ1-2
