TGTGCCAGCAGCCATAACGGGGGGGCTGACCCTCGGACGTCTGAAGCTTTCTTT	CASSHNGGADPRTSEAFF	TRBV7-3	TRBJ1-1
TGTGCCAGTAGTATAGGGGGGCGGGACAATGAGCAGTTCTTC	CASSIGGRDNEQFF	TRBV19	TRBJ2-1
TGCAGTGCTAGAGAACGGGGAAATCACAGAAACACCGGGGAGCTGTTTTTT	CSARERGNHRNTGELFF	TRBV20-1	TRBJ2-2
TGTGCCAGCAAAAACGGACAGGGGCAGCCCCAGCATTTT	CASKNGQGQPQHF	TRBV27	TRBJ1-5
TGTGCCACCAGTGATGCAGACAGGGACGGCACCGGGGAGCTGTTTTTT	CATSDADRDGTGELFF	TRBV24-1	TRBJ2-2
TGTGCCAGCAGTTACAGGCGGGAGCAGCCCTGCAATCAGCCCCAGCATTTT	CASSYRREQPCNQPQHF	TRBV6-6	TRBJ1-5
TGCGCCAGTTGGGACTTCATGAACACTGAAGCTTTCTTT	CASWDFMNTEAFF	TRBV10-2	TRBJ1-1
TGTGCCAGCAGCCCCCCGTCACATTGGGACGTCGGCACTTACGAGCAGTACTTC	CASSPPSHWDVGTYEQYF	TRBV5-8	TRBJ2-7
TGTGCCAGCAGTTACCACCCTCAGGGGAGGAACAGAAGCTCCTACAATGAGCAGTTCTTC	CASSYHPQGRNRSSYNEQFF	TRBV6-6	TRBJ2-1
TGCAGCGTTACCGGCGGGAGGCCTGGAGCTTTCTTT	CSVTGGRPGAFF	TRBV29-1	TRBJ1-1
TGTGCCAGCAGCTGGCAGGACGTCCAACAGGGTCCCTGGAATCAGCCCCAGCATTTT	CASSWQDVQQGPWNQPQHF	TRBV5-6	TRBJ1-5
TGTGCCAGCAGTTTAAAGGACAGGGCTGAGCAGTTCTTC	CASSLKDRAEQFF	TRBV28	TRBJ2-1
TGCGCCAGCACACTTGAAGACTATGGCTACACCTTC	CASTLEDYGYTF	TRBV10-1	TRBJ1-2
TGTGCCAGCACCTGCCGGAGGGGGACCTACGAGCAGTACTTC	CASTCRRGTYEQYF	TRBV7-6	TRBJ2-7
TGTGCCAGCAGCTCCTCCAGCCCTCCCTACGAGCAGTACTTC	CASSSSSPPYEQYF	TRBV7-9	TRBJ2-7
TGTGCCAGCAGCGTCCATCCGGGACTCTCGTACGATACGCAGTATTTT	CASSVHPGLSYDTQYF	TRBV9	TRBJ2-3
TGTGCCAGCAGCTTGGGGGGGCGGGAGTTAGAGCAGTTCTTC	CASSLGGRELEQFF	TRBV5-4	TRBJ2-1
TGCGCCAGCAGCCAAGAGGACCACAGGGGAGACTATGGCTACACCTTC	CASSQEDHRGDYGYTF	TRBV4-3	TRBJ1-2
TGCGCCAGCAGCATACGAAGGGAGGGGATAAACATTCAGTACTTC	CASSIRREGINIQYF	TRBV5-1	TRBJ2-4
TGTGCCAGCAGCCGACCGGTAGGACAGCAGAATTATTCACCCCTCCACTTT	CASSRPVGQQNYSPLHF	TRBV9	TRBJ1-6
TGTGCCAGCAGTCCAAAGGACAGGGGTTCGTATGGCTACACCTTC	CASSPKDRGSYGYTF	TRBV27	TRBJ1-2
TGTGCCAGCAGCCAAAAAGCAGGGAACACCATATATTTT	CASSQKAGNTIYF	TRBV14	TRBJ1-3
TGTGCCAGCAGCGATGAGGGGGGTCTGTTTTTT	CASSDEGGLFF	TRBV9	TRBJ1-4
TGTGTGGGGACGAGTGGCTACACCTTC	CVGTSGYTF	TRBV7-9	TRBJ1-2
TGCAGTGCGGGGGAACGGGGAATGACGTATGGCTACACCTTC	CSAGERGMTYGYTF	TRBV20-1	TRBJ1-2
TGTGCCAAAGAAATGGGACGAAGCCGAGGCGAGCAGTACTTC	CAKEMGRSRGEQYF	TRBV27	TRBJ2-7
TGTGCCAGCAGCCCTAGGAGGAGGGCCCTCCACTTT	CASSPRRRALHF	TRBV11-3	TRBJ1-6
TGTGCCAGCAGCCAAGCTTGCCCAAGGACCGGACTATCAACAGATACGCAGTATTTT	CASSQACPRTGLSTDTQYF	TRBV14	TRBJ2-3
TGTGCCAGCGTGACAGGTGTCACTGAAGCTTTCTTT	CASVTGVTEAFF	TRBV6-1	TRBJ1-1
TGTGCCAGCAGCGGGAACGTGAAGAACACTGAAGCTTTCTTT	CASSGNVKNTEAFF	TRBV13	TRBJ1-1
TGTGCCAGCAGCCAAGGCCCAGGGCCAGAGGGGCAAGAGACCCAGTACTTC	CASSQGPGPEGQETQYF	TRBV14	TRBJ2-5
TGCGCCAGCAGCTTAAAGGTCAGGGCAAACCGATGGTCCTACAATGAGCAGTTCTTC	CASSLKVRANRWSYNEQFF	TRBV5-1	TRBJ2-1
TGTGCCAGCAAATCCAGACCGGAGACCCAAGGCTACGAGCAGTACTTC	CASKSRPETQGYEQYF	TRBV27	TRBJ2-7
TGTGCCAGCAGCCGCACTAAAACCCGGACAGGGGTCGTGAACACTGAAGCTTTCTTT	CASSRTKTRTGVVNTEAFF	TRBV5-6	TRBJ1-1
TGCAGTGCGCGGGGGGATCAGCCCCAGCATTTT	CSARGDQPQHF	TRBV20-1	TRBJ1-5
TGCGCCAGCAGCTTGTGTCCGAAGATATGTTCTTTGAATGAGCAGTTCTTC	CASSLCPKICSLNEQFF	TRBV5-1	TRBJ2-1
TGTGCCAGCAGCTTCATTAATAACCACAACAGGGAAGGAAATCAAGAGACCCAGTACTTC	CASSFINNHNREGNQETQYF	TRBV5-4	TRBJ2-5
TGCGCCAGCAGCTTGCGTGACAGATTCTTC	CASSLRDRFF	TRBV5-1	TRBJ2-1
TGTGCCAGCAGGCACAGGGGGATGGTGTACTTC	CASRHRGMVYF	TRBV9	TRBJ2-5
TGTGCCAGCATCCTCGAACGAGGGGAGCTGTTTTTT	CASILERGELFF	TRBV6-1	TRBJ2-2
TGCAGTGCTAGCCTAGGGGGGGGGGACGAGCAGTACTTC	CSASLGGGDEQYF	TRBV20-1	TRBJ2-7
TGTGCCAGCAGCTTTTCGACCGTACTCAACCAGCCCCAGCATTTT	CASSFSTVLNQPQHF	TRBV9	TRBJ1-5
TGTGCCACCAGTCTAAAGACAGCAAGGTACACGCGCTCCTACAATGAGCAGTTCTTC	CATSLKTARYTRSYNEQFF	TRBV24-1	TRBJ2-1
TGTGCCAGCAGCTTAGCAGGGGGTTCGGACAGTGGCAATCAGCCCCAGCATTTT	CASSLAGGSDSGNQPQHF	TRBV11-3	TRBJ1-5
TGCGCCAGCAGGTGGGGGGGCGGGACTACCGCGAACACCGGGGAGCTGTTTTTT	CASRWGGGTTANTGELFF	TRBV10-1	TRBJ2-2
TGTGCCAGCAGCGGGATTGAGCAGTACTTC	CASSGIEQYF	TRBV6-5	TRBJ2-7
TGCGCCAGCGCACCGAGCCAAGGCTACGAGCAGTACTTC	CASAPSQGYEQYF	TRBV5-1	TRBJ2-7
TGTGCCAGCAGTGACTTACCTGGGACAGCTTGTTTGGGGGATAATTCACCCCTCCACTTT	CASSDLPGTACLGDNSPLHF	TRBV25-1	TRBJ1-6
TGTGCCAGCACGGAGGGGACCAGGGGTGAGCAGTACTTC	CASTEGTRGEQYF	TRBV6-4	TRBJ2-7
TGTGCCAGCAGCCCCCCGGGACTAGCGGTTTTGTGCCTCACAGATACGCAGTATTTT	CASSPPGLAVLCLTDTQYF	TRBV5-6	TRBJ2-3
TGCAGCGTTGCCCGCATTTCAGATACGCAGTATTTT	CSVARISDTQYF	TRBV29-1	TRBJ2-3
TGTGCCACCAAACGGCAGGAGAGCTCCTACAATGAGCAGTTCTTC	CATKRQESSYNEQFF	TRBV24-1	TRBJ2-1
TGCGCCAGCAGCTGTGACGACAGGGGGGGGTGCTACACCTTC	CASSCDDRGGCYTF	TRBV5-1	TRBJ1-2
TGTGCCTGGACTGGACTACACGACGGGGTGAACACTGAAGCTTTCTTT	CAWTGLHDGVNTEAFF	TRBV30	TRBJ1-1
TGTGCCAGCAGCGCAGGGACGTACTGGAATGAAAAACTGTTTTTT	CASSAGTYWNEKLFF	TRBV13	TRBJ1-4
TGCGCCAGCAGCGGACTCCGTGAGCAGTTCTTC	CASSGLREQFF	TRBV5-1	TRBJ2-1
TGTGCCAGCAGCTTGAATTTCTTACGCAACCGGAGCAATCAGCCCCAGCATTTT	CASSLNFLRNRSNQPQHF	TRBV7-3	TRBJ1-5
TGTGCCAGCAGCTGGGGGGCGCAGGACAATGAGCAGTTCTTC	CASSWGAQDNEQFF	TRBV7-3	TRBJ2-1
TGTGCCAGTAGTGTCGGGGGGGGATATGAGCAGTTCTTC	CASSVGGGYEQFF	TRBV19	TRBJ2-1
TGTGCCAGCAGCTTTATTGCTGAAGCTTTCTTT	CASSFIAEAFF	TRBV5-4	TRBJ1-1
TGTGCCAGCAGCTTAGGACAGGGGGCCAGCAATCAGCCCCAGCATTTT	CASSLGQGASNQPQHF	TRBV11-2	TRBJ1-5
TGTGCCAGCAGTTACTCGATTTGTAAGCTAGCGGGCAATGAGCAGTTCTTC	CASSYSICKLAGNEQFF	TRBV6-3	TRBJ2-1
TGTGCCAGCAGCTGGAAACCGGGACAGGGTGGCTACGAGCAGTACTTC	CASSWKPGQGGYEQYF	TRBV7-3	TRBJ2-7
TGCAGCGTTTTCCAGCAGGGCACCGAGGCGAACACCGGGGAGCTGTTTTTT	CSVFQQGTEANTGELFF	TRBV29-1	TRBJ2-2
TGTGCCACCAGGACTAGGCAGGGGGGGGGTGAGAACAAACCCCTCCACTTT	CATRTRQGGGENKPLHF	TRBV24-1	TRBJ1-6
TGTGCCACCAGTGATGTTCGGCGCTACGAGCAGTACTTC	CATSDVRRYEQYF	TRBV24-1	TRBJ2-7
TGCGCCAGCAGTGAGTTGATCTACGAGCAGTACTTC	CASSELIYEQYF	TRBV10-1	TRBJ2-7
TGTGCCAGCAGCGGACTAGCGGGAGGCGCAGATACGCAGTATTTT	CASSGLAGGADTQYF	TRBV9	TRBJ2-3
TGTGCCGGACTAGCGGGGGGCGTTCCCCATTCAGATACGCAGTATTTT	CAGLAGGVPHSDTQYF	TRBV19	TRBJ2-3
TGTGCCACCAGTAGTACACCAAGGGCCGGGAGCACTGAAGCTTTCTTT	CATSSTPRAGSTEAFF	TRBV24-1	TRBJ1-1
TGTGCCAGCAGCGGGGTACCGGGACAGGGGAGAGGCTACACCTTC	CASSGVPGQGRGYTF	TRBV7-4	TRBJ1-2
TGTGCCACCGGAGGGACAGTCACCGGGGAGCTGTTTTTT	CATGGTVTGELFF	TRBV24-1	TRBJ2-2
TGTGCCACCCCGACTAGCGGGGGAGAGCAGTTCTTC	CATPTSGGEQFF	TRBV14	TRBJ2-1
TGTGCCAGCAGTTATGTTTACTCGGGAAACACCATATATTTT	CASSYVYSGNTIYF	TRBV6-6	TRBJ1-3
TGCGCCAGCGTGGACCAACACAACGAGCAGTACTTC	CASVDQHNEQYF	TRBV5-1	TRBJ2-7
TGTGCCAGCAGTGATATGGGGACAGGGGACTCTGGAAACACCATATATTTT	CASSDMGTGDSGNTIYF	TRBV6-4	TRBJ1-3
TGTGCCAGCAGCGTATCCGGAACACGAGCGGGAAACATCTATGGCTACACCTTC	CASSVSGTRAGNIYGYTF	TRBV9	TRBJ1-2
TGTGCCAGGGAGGGGCAAGAACTTGCTTGCCCGGGCGAGACCCAGTACTTC	CAREGQELACPGETQYF	TRBV27	TRBJ2-5
TGTGCCAGCAGTTTACTTGACAGGGGATCCCGCCAAGTAGTCCCCACTGAAGCTTTCTTT	CASSLLDRGSRQVVPTEAFF	TRBV12-3	TRBJ1-1
TGTGCCAGCAGTGGATGGGGGCGACTTTCGAACACTGAAGCTTTCTTT	CASSGWGRLSNTEAFF	TRBV6-1	TRBJ1-1
TGTGCCAGCAGTTGCAGGGGTTTTGGCTACACCTTC	CASSCRGFGYTF	TRBV28	TRBJ1-2
TGTGCCAGCAGCGGGTTCCCCTACGAGCAGTACTTC	CASSGFPYEQYF	TRBV7-4	TRBJ2-7
TGTGCCAGCAGCTTAACGCTCCGGCGGCGGCAGGATAACACTGAAGCTTTCTTT	CASSLTLRRRQDNTEAFF	TRBV7-3	TRBJ1-1
TGTGCCAGCATGACGCTTATAGGAGGCTGTGAAGCTTTCTTT	CASMTLIGGCEAFF	TRBV13	TRBJ1-1
TGCGCCAGCAGCCAAGACTATCGGATTACGGCCAATCAGCCCCAGCATTTT	CASSQDYRITANQPQHF	TRBV4-1	TRBJ1-5
TGTGCCAGCAGCCTAGGACCCGTGGTCGAGCAGTACTTC	CASSLGPVVEQYF	TRBV13	TRBJ2-7
TGTGCCAGTAGTCAGGACAGGGCTCTTTCCAAGAACACTGAAGCTTTCTTT	CASSQDRALSKNTEAFF	TRBV19	TRBJ1-1
TGTGCCAGCAGCCCAGGGGGTCGACAAGAGACCCAGTACTTC	CASSPGGRQETQYF	TRBV7-9	TRBJ2-5
TGTGCCAGCGGGACAGGGGGCGTTCCTCAGCCCCAGCATTTT	CASGTGGVPQPQHF	TRBV7-3	TRBJ1-5
TGTGCCAGCAGTCAGTCGGAGCCCCCCTACGAGCAGTACTTC	CASSQSEPPYEQYF	TRBV3-1	TRBJ2-7
TGTGCCAGCAGCTTAGCGCTACTCCGAGGGGGTGAAGCTTTCTTT	CASSLALLRGGEAFF	TRBV7-2	TRBJ1-1
TGTGCCAGCAGTTACGGTAGGAGCCGGGATAATGAGCAGTTCTTC	CASSYGRSRDNEQFF	TRBV6-3	TRBJ2-1
TGTGCCAGCAGCCAAGGGACAGGGAGGAGGCTAGCCAAAAACATTCAGTACTTC	CASSQGTGRRLAKNIQYF	TRBV14	TRBJ2-4
TGTGCTAGTGGTTACCCGCGACTAGCCGCCGGGGAGCTGTTTTTT	CASGYPRLAAGELFF	TRBV12-5	TRBJ2-2
TGTGCCAGCAGCGGGAACCGAGGGTCTGGAAACACCATATATTTT	CASSGNRGSGNTIYF	TRBV7-4	TRBJ1-3
TGTGCCAGCAACAATGGACAGAGCTCCTACGAGCAGTACTTC	CASNNGQSSYEQYF	TRBV28	TRBJ2-7
TGTGCCACCAGTGATCGGGGTCGGGGGGGGCTCAGCCCTGAGCAGTTCTTC	CATSDRGRGGLSPEQFF	TRBV24-1	TRBJ2-1
TGTGCCAGCAGCGTAGCGGCAGCTGTCACTGAAGCTTTCTTT	CASSVAAAVTEAFF	TRBV9	TRBJ1-1
TGTGCCAGCAGCCCTTTCCTTAGACAGTACTTC	CASSPFLRQYF	TRBV7-2	TRBJ2-5
TGTGCCAGCAGCGCAACACCACGGGCCCGGGACAGTTTGGAGCCCGATTACGAGCAGTACTTC	CASSATPRARDSLEPDYEQYF	TRBV7-2	TRBJ2-7
TGTGCCAGCAGCTTAGCCGCCTTCTACGAGCAGTACTTC	CASSLAAFYEQYF	TRBV7-9	TRBJ2-7
TGTGCCAGCAGCGGGGTCGATAGCTCTGGGGCCAACGTCCTGACTTTC	CASSGVDSSGANVLTF	TRBV7-2	TRBJ2-6
TGCAGTGCGCTAGCCGGGCCGTTGAACACTGAAGCTTTCTTT	CSALAGPLNTEAFF	TRBV20-1	TRBJ1-1
TGCGCCAGCAGCCCCGGACTAGCGGCCCTCACATACGAGCAGTACTTC	CASSPGLAALTYEQYF	TRBV5-1	TRBJ2-7
TGTGCCAGCAGCTGCGTGGCCGACAGGGCCCCGGCAGACACTGAAGCTTTCTTT	CASSCVADRAPADTEAFF	TRBV7-8	TRBJ1-1
TGCGCCAGCAGCTTCCCCGGGAGGGCCCTCTCTGGGGCCAACGTCCTGACTTTC	CASSFPGRALSGANVLTF	TRBV5-1	TRBJ2-6
TGCAGCGTTGACCCCATCGCGGATTACGAGCAGTACTTC	CSVDPIADYEQYF	TRBV29-1	TRBJ2-7
TGTGCCAGCAGCTTAGTGAGGCCGGGGACCTATGGCTACACCTTC	CASSLVRPGTYGYTF	TRBV7-9	TRBJ1-2
TGTGCCAGCAGCGTACTAGCGGGAGGAGCCATGCCGGGGCAGCCCCAGCATTTT	CASSVLAGGAMPGQPQHF	TRBV7-9	TRBJ1-5
TGCAGTGCTAGATTTGGGGGCGACCACTACGAGCAGTACTTC	CSARFGGDHYEQYF	TRBV20-1	TRBJ2-7
TGTGCCAGTACCGAGTCTCGAATTCGCAACGGGGGCACCGGGGAGCTGTTTTTT	CASTESRIRNGGTGELFF	TRBV19	TRBJ2-2
TGCAGTGCTAGGTCCGCTTTGGGGGGGGCTGCTGGGGCCAACGTCCTGACTTTC	CSARSALGGAAGANVLTF	TRBV20-1	TRBJ2-6
TGTGCCAGCAGTGAGGGTTGTAATGAAAAACTGTTTTTT	CASSEGCNEKLFF	TRBV6-1	TRBJ1-4
TGTGCCAGCAGCCAAAACAGGCAGGCAGATACGCAGTATTTT	CASSQNRQADTQYF	TRBV3-1	TRBJ2-3
TGTGCCACCAGCTCAGCGGGAGTACACAATGAGCAGTTCTTC	CATSSAGVHNEQFF	TRBV15	TRBJ2-1
TGTGCCAGCAGTGAGATTTCACGTAATCAGCCCCAGCATTTT	CASSEISRNQPQHF	TRBV25-1	TRBJ1-5
TGCACTAACTTTGAATATGGCTACACCTTC	CTNFEYGYTF	TRBV20-1	TRBJ1-2
TGTGCCAGCAGCCTCCCCGACAGGGGATATATTAACTATGGCTACACCTTC	CASSLPDRGYINYGYTF	TRBV6-4	TRBJ1-2
TGTGCCTGGAGTCTAGCGGGCCAAGAGACCCAGTACTTC	CAWSLAGQETQYF	TRBV30	TRBJ2-5
TGTGCCCGGGACAGGGGGCCCTACGAGCAGTACTTC	CARDRGPYEQYF	TRBV20-1	TRBJ2-7
TGTGCCAGCAGTTTAAGCCGGGGGGGAAATCAGCCCCAGCATTTT	CASSLSRGGNQPQHF	TRBV6-9	TRBJ1-5
TGTGCCAGTAGTTGGGGGAGGGTCCGGATACACACTGAAGCTTTCTTT	CASSWGRVRIHTEAFF	TRBV19	TRBJ1-1
TGTGCCAGCAGTGATTTTGTGGGGGAGGGGGGCATTTGCAATGAGCAGTTCTTC	CASSDFVGEGGICNEQFF	TRBV2	TRBJ2-1
TGTGCCAGCTCACCAACCCCTAAACGGACAGGGGGCCCCGGGAGTTTTGCGGAGCAGTACTTC	CASSPTPKRTGGPGSFAEQYF	TRBV18	TRBJ2-7
TGTGCCAGCAGTTACAAACCCCAGACAGGGGGTGGTAACTACGAGCAGTACTTC	CASSYKPQTGGGNYEQYF	TRBV6-5	TRBJ2-7
TGTGCCAGCAGGCGGCGGCAAGAGACCCAGTACTTC	CASRRRQETQYF	TRBV4-2	TRBJ2-5
TGTGCCAGCAGCTTAGGGGGACGGGGGCGCAACACCGGGGAGCTGTTTTTT	CASSLGGRGRNTGELFF	TRBV7-9	TRBJ2-2
TGTGCCAGCAGCGGAGGGGACAGGTGGAACTATGGCTACACCTTC	CASSGGDRWNYGYTF	TRBV7-9	TRBJ1-2
TGTGCCAGCAGTGTTTTAGGACAGGGAAGAACTGAAAAACTGTTTTTT	CASSVLGQGRTEKLFF	TRBV6-1	TRBJ1-4
TGTGCCAGCAGTTTTTTTTTTTTCTCTGGGGGGGCGGAAGGAAGTTCCACCGGGGAGCTGTTTTTT	CASSFFFFSGGAEGSSTGELFF	TRBV6-3	TRBJ2-2
TGTGCCAGCAGTCCCGGGGGGGCACCTCTTTACGAGCAGTACTTC	CASSPGGAPLYEQYF	TRBV6-1	TRBJ2-7
TGTGCCAGCACAGCCGCCGGGACGGGCTCCTACAATGAGCAGTTCTTC	CASTAAGTGSYNEQFF	TRBV5-6	TRBJ2-1
TGCAGTGCTAGAGAAGTGGGGGCAAGCAATCAGCCCCAGCATTTT	CSAREVGASNQPQHF	TRBV20-1	TRBJ1-5
TGTGCCAGCAGCTTGGGTAAAAAGGGCAATTCACCCCTCCACTTT	CASSLGKKGNSPLHF	TRBV7-6	TRBJ1-6
TGCAGTGCTAGAACGGGACTTGAAAAACTGTTTTTT	CSARTGLEKLFF	TRBV20-1	TRBJ1-4
TGTGCCAGCAGCGACACAGGTTCTGAAGCTTTCTTT	CASSDTGSEAFF	TRBV7-3	TRBJ1-1
TGTGCCAGCAGCCGCGTAGTGAGTGGAAACACCATATATTTT	CASSRVVSGNTIYF	TRBV7-3	TRBJ1-3
TGCGCCAGCAGCTTGGCGATAGGGGAAGACACTGAAGCTTTCTTT	CASSLAIGEDTEAFF	TRBV5-1	TRBJ1-1
TGTGCCAGCAGCTTAGGTCCGGGAACGGACAATGAGCAGTTCTTC	CASSLGPGTDNEQFF	TRBV11-3	TRBJ2-1
TGTGCCAGCAGTTGGGGGGGAAACACCATATATTTT	CASSWGGNTIYF	TRBV6-2	TRBJ1-3
TGTGCCAGCAGTCGAAGGCAGCGGACCGGGGAGCTGTTTTTT	CASSRRQRTGELFF	TRBV27	TRBJ2-2
TGTGCCAGCAGCCTAGCGGGTGAGCAGTTCTTC	CASSLAGEQFF	TRBV7-4	TRBJ2-1
TGTGCCAGCAGCCAAGGTTGGTCCCTATATGACAGGGGAGGATATAGCAATCAGCCCCAGCATTTT	CASSQGWSLYDRGGYSNQPQHF	TRBV14	TRBJ1-5
TGTGCCAGCAGTTTAACAGGGAGCGAGCAGTACTTC	CASSLTGSEQYF	TRBV27	TRBJ2-7
TGCGCCAGCAGCCAAGCTAGACTAGTAACGAACACCGGGGAGCTGTTTTTT	CASSQARLVTNTGELFF	TRBV4-3	TRBJ2-2
TGCGCCAGCAGCCAGGGAAGTAACAGGGGGCTATACTCCTACGAGCAGTACTTC	CASSQGSNRGLYSYEQYF	TRBV4-1	TRBJ2-7
TGCGCCAGCAGGATAAAGATCCCCAGGGCCCATGAGCAGTTCTTC	CASRIKIPRAHEQFF	TRBV5-1	TRBJ2-1
TGCGCCAGCAGCTTAGGGGGGGGGAATGAGCAGTTCTTC	CASSLGGGNEQFF	TRBV5-1	TRBJ2-1
TGCGCCAGCAGCTTAAAACTTGGGGGGCAGGGTGGCGAGCAGTACTTC	CASSLKLGGQGGEQYF	TRBV5-1	TRBJ2-7
TGTGCCAGCAGCGTAGATAAGTTCGGGACCTGGGGGCCCCAGCATTTT	CASSVDKFGTWGPQHF	TRBV9	TRBJ1-5
TGTGCCACCCATCTGGGGGACCATGGCTACACCTTC	CATHLGDHGYTF	TRBV10-3	TRBJ1-2
TGCAGTGCTAACGGTAGACTAGCGGAGCCCGATACGCAGTATTTT	CSANGRLAEPDTQYF	TRBV20-1	TRBJ2-3
TGCAGTGCTAGGTATCGACAGTTGATAGCTTTCTTT	CSARYRQLIAFF	TRBV20-1	TRBJ1-1
TGTGCCAGCAGCTACCTAGCGGGCGGCGATGAGCAGTTCTTC	CASSYLAGGDEQFF	TRBV7-3	TRBJ2-1
TGTGCCAGCTCACCGACAGCTTACTATGGCTACACCTTC	CASSPTAYYGYTF	TRBV18	TRBJ1-2
TGTGCCAGCGAATGGAAGTACGAGCAGTACTTC	CASEWKYEQYF	TRBV5-6	TRBJ2-7
TGTGCCAGCAGCTGTGTTGGGGGCAGCACTGAAGCTTTCTTT	CASSCVGGSTEAFF	TRBV7-2	TRBJ1-1
TGTGCCAGCAGCGACTCAGGGACCTATGGCTACACCTTC	CASSDSGTYGYTF	TRBV11-2	TRBJ1-2
TGCAGCGTTGAAGGCGACAGGATGACCTCCTATAATTCACCCCTCCACTTT	CSVEGDRMTSYNSPLHF	TRBV29-1	TRBJ1-6
TGTGCCAGCAGCCAAGCCACGCGGACAGGGGGTACCAATCAGCCCCAGCATTTT	CASSQATRTGGTNQPQHF	TRBV3-1	TRBJ1-5
TGTGCCAGCAGTGATAATCAACAGGGGTTCCGCTATGGCTACACCTTC	CASSDNQQGFRYGYTF	TRBV6-4	TRBJ1-2
TGCAGTGCCAGGGACGCGGCCTATGGCTACACCTTC	CSARDAAYGYTF	TRBV20-1	TRBJ1-2
TGTGCCAGCAGTGATAGCGGCCGGAGGCAGTTCTTC	CASSDSGRRQFF	TRBV28	TRBJ2-1
TGCAGTGCAGCGGTTAATTCACCCCTCCACTTT	CSAAVNSPLHF	TRBV20-1	TRBJ1-6
TGTGCCATCAGTGAGCCAGGTGAGACGATGAACACTGAAGCTTTCTTT	CAISEPGETMNTEAFF	TRBV10-3	TRBJ1-1
TGCAGCGTTGAAACATTCCCCAAACCCAAGGACTGTTACGAGCAGTACTTC	CSVETFPKPKDCYEQYF	TRBV29-1	TRBJ2-7
TGTGCCTGGAGTGTGGCCACCGGGACAGGGGTGAACACTGAAGCTTTCTTT	CAWSVATGTGVNTEAFF	TRBV30	TRBJ1-1
TGTGCCAGCAGCGACGGGGACCTCACAGATACGCAGTATTTT	CASSDGDLTDTQYF	TRBV9	TRBJ2-3
TGTGCCAGCAGGCCGGGACAGGGGGCCTTTTCACCCCTCCACTTT	CASRPGQGAFSPLHF	TRBV6-4	TRBJ1-6
TGTGCCAGCAGTGCCTTGGGGGTGTCAGGGGTGCAGTTCTTC	CASSALGVSGVQFF	TRBV6-4	TRBJ2-1
TGTGCCAGCAGCTCGGACTACGAGCAGTACTTC	CASSSDYEQYF	TRBV5-5	TRBJ2-7
TGCAGTGCTGGACGCAGGTTTTTCGGACAGGCCTCCTACGAGCAGTACTTC	CSAGRRFFGQASYEQYF	TRBV20-1	TRBJ2-7
TGTGCCAGCAGTCAAGGGGGTAACAATCAGCCCCAGCATTTT	CASSQGGNNQPQHF	TRBV6-1	TRBJ1-5
TGTGCCAGCAGCTCCGCGGGACAGGGGGGAACCGGCTACGAGCAGTACTTC	CASSSAGQGGTGYEQYF	TRBV7-2	TRBJ2-7
TGTGCCAGCAGTGACATCGGGGGGGCGGAGGACACCGGGGAGCTGTTTTTT	CASSDIGGAEDTGELFF	TRBV6-4	TRBJ2-2
TGCGCCAGCAGCCCGGGACAGGGCGGAAACACCATATATTTT	CASSPGQGGNTIYF	TRBV5-1	TRBJ1-3
TGTGCCAGCAGTTTATTACCGCGAATTCGGCCACTAGAGACCCAGTACTTC	CASSLLPRIRPLETQYF	TRBV28	TRBJ2-5
TGTGCCAGCAGCTTAGATCCCCTCTCGAGTGGACAGTGGAACTATGGCTACACCTTC	CASSLDPLSSGQWNYGYTF	TRBV11-3	TRBJ1-2
TGTGCCAGCAACGGGCTCTACGAGCAGTACTTC	CASNGLYEQYF	TRBV6-6	TRBJ2-7
TGTGCCAGCAGTGACTCTCCCATCCCCGGGGGGGCACACAACACCGGGGAGCTGTTTTTT	CASSDSPIPGGAHNTGELFF	TRBV6-4	TRBJ2-2
TGTGCCAGCAGGCGGACAGGGGGGAACTATGGCTACACCTTC	CASRRTGGNYGYTF	TRBV6-6	TRBJ1-2
TGTGCCAGCAGAAACGAACAATACGGTTCTCCTAGCAATGAGCAGTTCTTC	CASRNEQYGSPSNEQFF	TRBV7-8	TRBJ2-1
TGTGCCAGCAGCGTTAACAGGGACAGGGGCATAATCTACGAGCAGTACTTC	CASSVNRDRGIIYEQYF	TRBV9	TRBJ2-7
TGTGCCAGCATGAAATTTGAGGGGAGCAGAGGCCTAGAGACCCAGTACTTC	CASMKFEGSRGLETQYF	TRBV6-2	TRBJ2-5
TGTGCCAGCAGTGCCACGGTCCAGCACAGGGTCCAACCTAATGAAAAACTGTTTTTT	CASSATVQHRVQPNEKLFF	TRBV6-4	TRBJ1-4
TGTGCCAGCAGCTTTCAAGGGGGGTTATACGAGCAGTACTTC	CASSFQGGLYEQYF	TRBV7-2	TRBJ2-7
TGTGCTGGGGCTAGCGGGGAGTATGTAAATAACGAGCAGTACTTC	CAGASGEYVNNEQYF	TRBV12-5	TRBJ2-7
TGCAGCGTACTAAGGTGGGGGATGCAGAACTATGGCTACACCTTC	CSVLRWGMQNYGYTF	TRBV29-1	TRBJ1-2
TGTGCCACCAGAGTAACCCACAGGGGGCGGGTCTACGAGCAGTACTTC	CATRVTHRGRVYEQYF	TRBV24-1	TRBJ2-7
TGCGCCAGCAGCTTGTCCTCCACCAAGACTAGCGGCGGGATCACAGATACGCAGTATTTT	CASSLSSTKTSGGITDTQYF	TRBV5-1	TRBJ2-3
TGTGCCTGGAGGTATATCTTCCAAGAGACCCAGTACTTC	CAWRYIFQETQYF	TRBV30	TRBJ2-5
TGTGCCGAAGGACAGGGGAAGTCCTACGAGCAGTACTTC	CAEGQGKSYEQYF	TRBV2	TRBJ2-7
TGCAGTGCTAGAGGGGGGGCAGACGCCAGGCTAGCCAAAAACATTCAGTACTTC	CSARGGADARLAKNIQYF	TRBV20-1	TRBJ2-4
TGCGCCAGCAGGTTCCCCGGCCGTCCCACAGATACGCAGTATTTT	CASRFPGRPTDTQYF	TRBV10-2	TRBJ2-3
TGTGCCAGCCCACCAGACCCCAGGGGGCCAAGCTATAATTCACCCCTCCACTTT	CASPPDPRGPSYNSPLHF	TRBV7-9	TRBJ1-6
TGTGCCAGCAGCGTACCGGTAGCGGGAAGTCGCGAGCAGTACTTC	CASSVPVAGSREQYF	TRBV9	TRBJ2-7
TGCAGTGCTAGAGATCTCGGACAGGGGGAAGGTCAGCCCCAGCATTTT	CSARDLGQGEGQPQHF	TRBV20-1	TRBJ1-5
TGTGCCAGCAGTGCTTCAGGGGGCAACTATGGCTACACCTTC	CASSASGGNYGYTF	TRBV6-3	TRBJ1-2
TGTGCCAGCAGCAAGGTAACGCCAACCGCTAGCGGGTTGGGACGCACAGATACGCAGTATTTT	CASSKVTPTASGLGRTDTQYF	TRBV13	TRBJ2-3
TGTGCCAGCAGCGACAGGAACGAGCAGTACTTC	CASSDRNEQYF	TRBV11-2	TRBJ2-7
TGTGCCACAAGGGGGGATGGCTACACCTTC	CATRGDGYTF	TRBV7-9	TRBJ1-2
TGTGCCAGCAGCCGGACAGCCGGGGAGCTGTTTTTT	CASSRTAGELFF	TRBV6-4	TRBJ2-2
TGTGCTAGCAGCTCCGGACTAGCGCCCTCCTACAATGAGCAGTTCTTC	CASSSGLAPSYNEQFF	TRBV7-7	TRBJ2-1
TGTGCTAGTGGTTCCCCGGACGGGGAGACCCAGTACTTC	CASGSPDGETQYF	TRBV12-5	TRBJ2-5
TGTGCCTGGAGTGTACGGAGACGGAGGACGGGCAGCACAGATACGCAGTATTTT	CAWSVRRRRTGSTDTQYF	TRBV30	TRBJ2-3
TGTGCCATCACGAAGGGGCGGGGGACTAGCGGGGGGGCTAGAACAGATACGCAGTATTTT	CAITKGRGTSGGARTDTQYF	TRBV10-3	TRBJ2-3
TGTGCCAGCAGCCTAGCGGGTGTTGGTAATGAGCAGTTCTTC	CASSLAGVGNEQFF	TRBV5-6	TRBJ2-1
TGTGCCAGCAGCTTAGCGTCCCCCTGTTCACAGGATGATCGCTATGGCTACACCTTC	CASSLASPCSQDDRYGYTF	TRBV7-9	TRBJ1-2
TGTGCCAGCAGCTTAGAAGGGCTATCTGAAGCTTTCTTT	CASSLEGLSEAFF	TRBV7-9	TRBJ1-1
TGCAGTGCTAGCCGAGAGGGCGATAGCAATCAGCCCCAGCATTTT	CSASREGDSNQPQHF	TRBV20-1	TRBJ1-5
TGCGCCAGCAGCACCTATGAAGCGGGAGGATATGAGCAGTTCTTC	CASSTYEAGGYEQFF	TRBV5-1	TRBJ2-1
TGTGCCAGCAGTGAAGAAAGCGGGAGCGGGCACGAGCAGTACTTC	CASSEESGSGHEQYF	TRBV12-3	TRBJ2-7
TGTGCCAGCAGCCGCCCGGACGGAGGCAATCAGCCCCAGCATTTT	CASSRPDGGNQPQHF	TRBV7-9	TRBJ1-5
TGTGCCAGCAGTTACTCAGACCGGGGACAGGGGGCGGTCAACGGGGAGCTGTTTTTT	CASSYSDRGQGAVNGELFF	TRBV6-3	TRBJ2-2
TGTGCCAGCACGTACAGGGGGGAGCAAGAGACCCAGTACTTC	CASTYRGEQETQYF	TRBV6-6	TRBJ2-5
TGTGCCAGCAGCTTGACCCCTGAAGGACAGGGGTATGGCTACACCTTC	CASSLTPEGQGYGYTF	TRBV7-3	TRBJ1-2
TGTGCCAGCAGCCTCTTTGGGGCGAACTATGGCTACACCTTC	CASSLFGANYGYTF	TRBV5-6	TRBJ1-2
TGTGCCAGCAGTTTGGACAGGGTTCGGGAAGCTTTCTTT	CASSLDRVREAFF	TRBV12-4	TRBJ1-1
TGTGCCAGCAGCCGAAGGGCGGGACGGGCTTACGAGCAGTACTTC	CASSRRAGRAYEQYF	TRBV4-2	TRBJ2-7
TGTGCCACCAGCAGAGATACGGGACAAACTGAAGCTTTCTTT	CATSRDTGQTEAFF	TRBV15	TRBJ1-1
TGCGCCAGCAGCGGGACTAGCGGGCGTGTGTACGTC	CASSGTSGRVYV	TRBV5-1	TRBJ2-7
TGTGCCAGTAGCATTCTCGCCGTAGGCCGGTCCTCGAATCAGCCCCAGCATTTT	CASSILAVGRSSNQPQHF	TRBV19	TRBJ1-5
TGTGCCAGCAGCAGTCCCGGGGGGCCCCGACCCAACTTC	CASSSPGGPRPNF	TRBV9	TRBJ2-5
TGCGCCAGCAGCTTGTTGACTAGCGATGAAGATACGCAGTATTTT	CASSLLTSDEDTQYF	TRBV5-1	TRBJ2-3
TGTGCCAGCAGCACCGCAGGGCTAACCTACGAGCAGTACTTC	CASSTAGLTYEQYF	TRBV7-4	TRBJ2-7
TGCGCCAGCAGCCTCTGTGGCTACGAGCAGTACTTC	CASSLCGYEQYF	TRBV5-1	TRBJ2-7
TGTGCCATCAGTGTCAACAGGGCAGGCAGCAATCAGCCCCAGCATTTT	CAISVNRAGSNQPQHF	TRBV10-3	TRBJ1-5
TGTGCCAGCAGTTATTCAAGATGGACTAGCGGGGGGTGCAATGAGCAGTTCTTC	CASSYSRWTSGGCNEQFF	TRBV6-6	TRBJ2-1
TGTGCTAGTGGGGAAGGAAGAGGGGGTAACACTGAAGCTTTCTTT	CASGEGRGGNTEAFF	TRBV12-5	TRBJ1-1
TGCAGTGCGGGGGGCGAAGGGGCCTTCTTC	CSAGGEGAFF	TRBV20-1	TRBJ2-5
TGTGCCAGCAGCCCGGAGGGGCTAGGATACATCTGCCTAGAGGGGGTGAATCAGCCCCAGCATTTT	CASSPEGLGYICLEGVNQPQHF	TRBV7-7	TRBJ1-5
TGCGCCAGCACAGGAGGGGAGGGGCTAGCCAAAAACATTCAGTACTTC	CASTGGEGLAKNIQYF	TRBV5-1	TRBJ2-4
TGCAGTGCTAAAAGAGGGACAGGGCGATACTATAATTCACCCCTCCACTTT	CSAKRGTGRYYNSPLHF	TRBV20-1	TRBJ1-6
TGTGCCAGCAGTCCTGAGGGGACAGGGGAAGACACAGATACGCAGTATTTT	CASSPEGTGEDTDTQYF	TRBV3-1	TRBJ2-3
TGTGCCAGCAGTTTCGGATGGGACTTAATTCTCACAGATACGCAGTATTTT	CASSFGWDLILTDTQYF	TRBV12-4	TRBJ2-3
TGTGCCAGCAGCGTAGGCAGGCTAGGGGGTGGCTACACCTTC	CASSVGRLGGGYTF	TRBV9	TRBJ1-2
TGTGCCAGCAGCCAACAGGGGGCGCCGGGGCACGGGGCCAACGTCCTGACTTTC	CASSQQGAPGHGANVLTF	TRBV13	TRBJ2-6
TGTGCCAGCAACCTAGCGGTGGCAGATACGCAGTATTTT	CASNLAVADTQYF	TRBV9	TRBJ2-3
TGTGCCAGCAGCTCTCGGACAGGAACCCCTGGGGCCAACGTCCTGACTTTC	CASSSRTGTPGANVLTF	TRBV13	TRBJ2-6
TGCGCCAGACCGGGGGGCGGCTATGGCTACACCTTC	CARPGGGYGYTF	TRBV10-2	TRBJ1-2
TGCAGCGGTAGGTCCGACAATGAGCAGTTCTTC	CSGRSDNEQFF	TRBV29-1	TRBJ2-1
TGTGCCAGCGGTCCCCCAGGGGATAACACCGGGGAGCTGTTTTTT	CASGPPGDNTGELFF	TRBV12-4	TRBJ2-2
TGCAGTGCAGGGGGGCTTAGCACTGAAGCTTTCTTT	CSAGGLSTEAFF	TRBV20-1	TRBJ1-1
TGCGCCAGCCTCCCGGGCAATGAGCAGTTCTTC	CASLPGNEQFF	TRBV10-1	TRBJ2-1
TGTGCCAGCAGGCCCTCGGGACAGCATCGGAGCAATCAGCCCCAGCATTTT	CASRPSGQHRSNQPQHF	TRBV5-6	TRBJ1-5
TGCGCCAGCAACTTCCCCAGGGGGAACACTGAAGCTTTCTTT	CASNFPRGNTEAFF	TRBV10-1	TRBJ1-1
TGCAGTGCTAGAGATCCTCCACCAGGCATCCCGAGCGGGAGCCCTGTGGCTGAAGCTTTCTTT	CSARDPPPGIPSGSPVAEAFF	TRBV20-1	TRBJ1-1
TGTGCCTATCGGACAGGGGGCTATGGCTACACCTTC	CAYRTGGYGYTF	TRBV30	TRBJ1-2
TGTGCCAGCAGTGAAGGGGTTATGCCATCGTCGCACTACGAGCAGTACTTC	CASSEGVMPSSHYEQYF	TRBV2	TRBJ2-7
TGTGCCAGCAGTGCACTTTACCCGGGACTAGCGGGAGCCGGCTTCGAGCAGTACTTC	CASSALYPGLAGAGFEQYF	TRBV12-3	TRBJ2-7
TGTGCCAGCAGCGATATACGGGGAAATTCACCCCTCCACTTT	CASSDIRGNSPLHF	TRBV13	TRBJ1-6
TGCGCCAGAACGTTCGGGCCCCAAGGCACAGATACGCAGTATTTT	CARTFGPQGTDTQYF	TRBV4-1	TRBJ2-3
TGCAGTGCTGAGCGGGAGGACTGCACAGATACGCAGTATTTT	CSAEREDCTDTQYF	TRBV20-1	TRBJ2-3
TGTGCCAGCAGTGAAAGGGGGGTTCAGCCCCAGCATTTT	CASSERGVQPQHF	TRBV6-4	TRBJ1-5
TGTGCCAGCAGCCAAGGTCAATCCAACGTGACACGGGTAGCGCACGAGCAGTACTTC	CASSQGQSNVTRVAHEQYF	TRBV4-2	TRBJ2-7
TGTGCCAGCAGTAGGGACAAGATCGGCAATCAGCCCCAGCATTTT	CASSRDKIGNQPQHF	TRBV6-4	TRBJ1-5
TGTGCCAGCAGTGACCAACGGACAGGGTGGGGCAACATTCAGTACTTC	CASSDQRTGWGNIQYF	TRBV6-4	TRBJ2-4
TGTGCCAGCAGCTTTCTTACCGGGCCCTTGGAGCACATTCAGTACTTC	CASSFLTGPLEHIQYF	TRBV11-3	TRBJ2-4
TGTGCCAGCAGTTACTCCACTAGCGGGAGGACGGCCAAAAACATTCAGTACTTC	CASSYSTSGRTAKNIQYF	TRBV6-2	TRBJ2-4
TGTGCCAGCAGCCAAGACAGTGGAGGGATGAACACTGAAGCTTTCTTT	CASSQDSGGMNTEAFF	TRBV14	TRBJ1-1
TGTGCCAGCTGGTGCCCAACCGGCTACACCTTC	CASWCPTGYTF	TRBV6-1	TRBJ1-2
TGTGCCAGCAGCAGCAGGGGGGGGCGGTGCTATGGCTACACCTTC	CASSSRGGRCYGYTF	TRBV13	TRBJ1-2
TGTGCCAGCAGTCGTGACAGGTCCTACGAGCAGTACTTC	CASSRDRSYEQYF	TRBV27	TRBJ2-7
TGTGCCAGCAGTACTACAAGGCTAGCGGGTCCAGATACGCAGTATTTT	CASSTTRLAGPDTQYF	TRBV28	TRBJ2-3
TGTGCCAGGGTAAAACGCGGGCCCAAGAACACTGAAGCTTTCTTT	CARVKRGPKNTEAFF	TRBV6-4	TRBJ1-1
TGTGCCAGCAGACAGATGCCCGGAGCGGGGCTAAATGAAGCTTTCTTT	CASRQMPGAGLNEAFF	TRBV27	TRBJ1-1
TGCAGTGCTCAAAGGCCAAACGAGCAGTACTTC	CSAQRPNEQYF	TRBV20-1	TRBJ2-7
TGTGCCAGTTCTAACGGGACAGGGGCTGAAGCTTTCTTT	CASSNGTGAEAFF	TRBV27	TRBJ1-1
TGTGCCAGCAGCTTGGGACAGGGGGAAACCGATCAGCCCCAGCATTTT	CASSLGQGETDQPQHF	TRBV7-3	TRBJ1-5
TGCGCCAGCAGCCGAGGGCTCACCCGGCGGCCTTGCACTGAAGCTTTCTTT	CASSRGLTRRPCTEAFF	TRBV4-3	TRBJ1-1
TGTGCCAGCAGCGAGTGGGGCTTAAAGTCTAACTATGGCTACACCTTC	CASSEWGLKSNYGYTF	TRBV7-8	TRBJ1-2
TGTGCCAGTAGGAGGAAATTTCCCACTGAAGCTTTCTTT	CASRRKFPTEAFF	TRBV19	TRBJ1-1
TGTGCCAGCAGTTTCCCACCTGGGGGCGACCGGGACGGCAATGAGCAGTTCTTC	CASSFPPGGDRDGNEQFF	TRBV28	TRBJ2-1
TGTGCCATCAACGCACTAGCGGGAGGGCTATGGGAGGACCAAGAGACCCAGTACTTC	CAINALAGGLWEDQETQYF	TRBV10-3	TRBJ2-5
TGTGCCAGCAGAAATCGCTCCAACCGGGACAGAAAGCAGTACTTC	CASRNRSNRDRKQYF	TRBV28	TRBJ2-7
TGTGCCAGCACTAAAACAGGGATCTATGGCTACACCTTC	CASTKTGIYGYTF	TRBV27	TRBJ1-2
TGTGCCAGCAGCGTAGAGCCGATTGGTCCCCGACAGGGGGCAGGAAGCTCCTATAATTCACCCCTCCACTTT	CASSVEPIGPRQGAGSSYNSPLHF	TRBV9	TRBJ1-6
TGTGCCACTCCGGGGGGGGGGTCCTACGAGCAGTACTTC	CATPGGGSYEQYF	TRBV6-4	TRBJ2-7
TGTGCCAGCAGTAGCGGGAAGTCTGCGACAGATACGCAGTATTTT	CASSSGKSATDTQYF	TRBV9	TRBJ2-3
TGTGCCAGCAGTTTGCGGGAGGGCCGCAATCAGCCCCAGCATTTT	CASSLREGRNQPQHF	TRBV27	TRBJ1-5
TGTGCCAGCAGCCCCCTGGGGTCCTATGGCTACACCTTC	CASSPLGSYGYTF	TRBV7-6	TRBJ1-2
TGTGCCACCAGTGATGTCCAAGTAGAAATCGGCAATCAGCCCCAGCATTTT	CATSDVQVEIGNQPQHF	TRBV24-1	TRBJ1-5
TGTGCCAGCAGCCTCCCGGGGGGGAAGTGTCACAATGAGCAGTTCTTC	CASSLPGGKCHNEQFF	TRBV9	TRBJ2-1
TGTGCCAGCAGTGAATCCGCTAGCGGGGGAAAGAGATTCAATGAGCAGTTCTTC	CASSESASGGKRFNEQFF	TRBV6-4	TRBJ2-1
TGTGCCAGCAGTTACAAGCGGGGAGTCGAGCAGTACTTC	CASSYKRGVEQYF	TRBV6-6	TRBJ2-7
TGTGCCAGCAGTTTATGTGGCGGGGGAGGGTGCTACGAGCAGTACTTC	CASSLCGGGGCYEQYF	TRBV27	TRBJ2-7
TGTGCCAGCAGTAAAAGGACGGACTACGAGCAGTACTTC	CASSKRTDYEQYF	TRBV6-4	TRBJ2-7
TGTGCCAGCAGCCACGATTCACCCCTCCACTTT	CASSHDSPLHF	TRBV7-2	TRBJ1-6
TGTGCCAGCAGCGACCGCGGCTATGGCTACACCTTC	CASSDRGYGYTF	TRBV7-9	TRBJ1-2
TGTGCCAGCAGTGCCGGACAGGGGTGGGAGCAGTACTTC	CASSAGQGWEQYF	TRBV27	TRBJ2-7
TGTGCCAGCAGCCGGGGACAGGGCTTCTCACCCCTCCACTTT	CASSRGQGFSPLHF	TRBV7-3	TRBJ1-6
TGCAGTGCTAGAGATAGCAGAGGTGGGACAGGGGGGATGAACACTGAAGCTTTCTTT	CSARDSRGGTGGMNTEAFF	TRBV20-1	TRBJ1-1
TGTGCCAGCAGCAAAAGAGGAAGATGGAGACACCCCACCGGGGAGCTGTTTTTT	CASSKRGRWRHPTGELFF	TRBV5-4	TRBJ2-2
TGTGCCAGCAGCTTAGGGTCCGGGCGAGAGCAGTACTTC	CASSLGSGREQYF	TRBV7-9	TRBJ2-7
TGTGCCAGCAGTGCACCCGGGACAGGGGAGTTGCTGTTTCCAAATCAGCCCCAGCATTTT	CASSAPGTGELLFPNQPQHF	TRBV28	TRBJ1-5
TGTGCCAGCAGCTTATTGGAGGGGTCCTACGAGCAGTACTTC	CASSLLEGSYEQYF	TRBV7-3	TRBJ2-7
TGTGCCAGCAGCAGCCCTCGGGACGTAAATGAGCAGTTCTTC	CASSSPRDVNEQFF	TRBV13	TRBJ2-1
TGTGCCAGCAGCGGACAGGGGCGTACCGGGAATGAAAAACTGTTTTTT	CASSGQGRTGNEKLFF	TRBV9	TRBJ1-4
TGTGCCAGCAGCTTAGAGGGACGACAGGGGCAGAATGAGCAGTTCTTC	CASSLEGRQGQNEQFF	TRBV11-2	TRBJ2-1
TGTGCCAGCAGTGAACGTGATAGCAATCAGCCCCAGCATTTT	CASSERDSNQPQHF	TRBV6-1	TRBJ1-5
TGCAGTGCTAGAGCCACCTGGGACAGGGCCGGCAATCAGCCCCAGCATTTT	CSARATWDRAGNQPQHF	TRBV20-1	TRBJ1-5
TGTGCCAGCAGTGTGGGGGAAGGAGTAGGAGCGGACATTCAGTACTTC	CASSVGEGVGADIQYF	TRBV6-1	TRBJ2-4
TGTGCCACCAGCAGAGTGACCGGGACAAGAGGTTCACCCCTCCACTTT	CATSRVTGTRGSPLHF	TRBV15	TRBJ1-6
TGTGCCACCAGGGGCGGGACAGGGGCCGATACGCAGTATTTT	CATRGGTGADTQYF	TRBV24-1	TRBJ2-3
TGTGCCAGCAGCAAAACGGAGTTAACTAGCGGGAGGGTGCCCTACGAGCAGTACTTC	CASSKTELTSGRVPYEQYF	TRBV13	TRBJ2-7
TGTGCCAGCAGCCGGATAAGACGGGACGTATGCTATGGCTACACCTTC	CASSRIRRDVCYGYTF	TRBV3-1	TRBJ1-2
TGTGCCAGCAGCCTTGTCCGGACAGGGAAAAGTTACGAGCAGTACTTC	CASSLVRTGKSYEQYF	TRBV6-2	TRBJ2-7
TGCGCCAGCAGTGAGTCGAACAGGGTCGACTACGAGCAGTACTTC	CASSESNRVDYEQYF	TRBV10-1	TRBJ2-7
TGTGCCAGCAGCGGGACAGGGAGAACTTCACCCCTCCACTTT	CASSGTGRTSPLHF	TRBV7-3	TRBJ1-6
TGCGCCAGCTCCTCCCCCAGCGACAGCTCCTACGAGCAGTACTTC	CASSSPSDSSYEQYF	TRBV4-3	TRBJ2-7
TGTGCCAGCACCTCAGGGGGAGATGGCTACACCTTC	CASTSGGDGYTF	TRBV6-2	TRBJ1-2
TGTGCCAGCAGTCCGGGACAGGGGATAGCCAAAGCTTTCTTT	CASSPGQGIAKAFF	TRBV6-5	TRBJ1-1
TGCGCCAGCAGCTTGTTAGACAGGGGAGTCCACGGGGCCAACGTCCTGACTTTC	CASSLLDRGVHGANVLTF	TRBV5-1	TRBJ2-6
TGTGCCAGCAGCTTTAGCGGGGTGCCAGAGACCCAGTACTTC	CASSFSGVPETQYF	TRBV13	TRBJ2-5
TGTGCCAGCAGTCGGACAGGGGACACTGAAGCTTTCTTT	CASSRTGDTEAFF	TRBV6-1	TRBJ1-1
TGCCCCGGAGGGGGCACTGAAGCTTTCTTT	CPGGGTEAFF	TRBV20-1	TRBJ1-1
TGTGCCAGGGTTTCAACTAGCGGGAGTAAAGGGCCGGGGGAGCTGTTTTTT	CARVSTSGSKGPGELFF	TRBV19	TRBJ2-2
TGCAGTGCTAGAGATGACTATCGAGATACGCAGTATTTT	CSARDDYRDTQYF	TRBV20-1	TRBJ2-3
TGTGCCAGCAGCGCATCACAGGCAACGACATCCTACGAGCAGTACTTC	CASSASQATTSYEQYF	TRBV7-3	TRBJ2-7
TGTGCCAGCAGCTTGCAGGAGCAGAACACCGGGGAGCTGTTTTTT	CASSLQEQNTGELFF	TRBV7-2	TRBJ2-2
TGCGCCAGCAGCCTTCGCCTTGCCGTAACTAACTATGGCTACACCTTC	CASSLRLAVTNYGYTF	TRBV5-1	TRBJ1-2
TGTGCCACGACAGGTCGGCGTAGCAATCAGCCCCAGCATTTT	CATTGRRSNQPQHF	TRBV6-1	TRBJ1-5
TGTGCCAGCAGCAATTGTTTACCGGGACTAGGCTCCTACAATGAGCAGTTCTTC	CASSNCLPGLGSYNEQFF	TRBV13	TRBJ2-1
TGTGCCATCAGTCCAATGGGACGAGACACCATATATTTT	CAISPMGRDTIYF	TRBV10-3	TRBJ1-3
TGTGCCAGCAGCTTGCAAGGGGACTATGAGCAGTTCTTC	CASSLQGDYEQFF	TRBV7-6	TRBJ2-1
TGTGCCATCAGTCCAGAGGGGGCTACTTATGGAGATACGCAGTATTTT	CAISPEGATYGDTQYF	TRBV10-3	TRBJ2-3
TGTGCCAGCAGTGACTCGGTCACAGGGAAGGGAGAGTTCAATGAGCAGTTCTTC	CASSDSVTGKGEFNEQFF	TRBV6-4	TRBJ2-1
TGTGCTAGTGCGAAAGATCGACAGGGGACAACTAATGAAAAACTGTTTTTT	CASAKDRQGTTNEKLFF	TRBV12-5	TRBJ1-4
TGTGCCAGGGGTCTGGAGGACAGGGTCGTAAAGGGGTCTGAAGCTTTCTTT	CARGLEDRVVKGSEAFF	TRBV11-2	TRBJ1-1
TGTGCCAGCAGAGGGGGCGGGGGGGTGTTCATGAACACTGAAGCTTTCTTT	CASRGGGGVFMNTEAFF	TRBV6-3	TRBJ1-1
TGCGCCAGCAGCTCACGGATCGGGGGCCCGATATTGGTTAACACAGATACGCAGTATTTT	CASSSRIGGPILVNTDTQYF	TRBV5-1	TRBJ2-3
TGTGCCTCTCCGAACGAAGGTGCCAGCACAGATACGCAGTATTTT	CASPNEGASTDTQYF	TRBV30	TRBJ2-3
TGTGCCATCAGTGCCCTTGGGACAGGGAACACTGAAGCTTTCTTT	CAISALGTGNTEAFF	TRBV10-3	TRBJ1-1
TGTGCCAGCAGCAGGGGACGCCTGGGCGGGTATGGCTACACCTTC	CASSRGRLGGYGYTF	TRBV13	TRBJ1-2
TGTGCCAGCAGCCAAGACGGCTACGAGCAGTACTTC	CASSQDGYEQYF	TRBV4-2	TRBJ2-7
TGTGCCAGCAGTGCTGGCCCGGGACAGCCCCAGCCCCAGCATTTT	CASSAGPGQPQPQHF	TRBV6-5	TRBJ1-5
TGTGCCAGCAGCGGCCCCAGCCACCTGCCGGTGAACACTGAAGCTTTCTTT	CASSGPSHLPVNTEAFF	TRBV7-4	TRBJ1-1
TGTGCCAGCAGCTTACGGGAGGGGACGAGGCGAACAGATACGCAGTATTTT	CASSLREGTRRTDTQYF	TRBV7-6	TRBJ2-3
TGCGCCAGCAGCCGAAGTGATACGGCACTGTCGGCGAACACCGGGGAGCTGTTTTTT	CASSRSDTALSANTGELFF	TRBV5-1	TRBJ2-2
TGTGCCAGCAGCTTGCTGGTAACTGAAGCTTTCTTT	CASSLLVTEAFF	TRBV5-4	TRBJ1-1
TGTGCCAGCATGGACCTGTATCAGCCCCAGCATTTT	CASMDLYQPQHF	TRBV27	TRBJ1-5
TGTGCTAGTGGGGCAGTCTCTCCCGAGCCTCATAGCTCCTATAATTCACCCCTCCACTTT	CASGAVSPEPHSSYNSPLHF	TRBV12-5	TRBJ1-6
TGTGCCAGTAGTATGGACAGCGGCTACACCTTC	CASSMDSGYTF	TRBV19	TRBJ1-2
TGTGCCAGCAGTTACTTCCCAGGGGCCCGGCCCAGGACAACCTACGAGCAGTACTTC	CASSYFPGARPRTTYEQYF	TRBV6-3	TRBJ2-7
TGTGCCAGCAGTCCGGCCTGGGGGGGGTGGACAGATACGCAGTATTTT	CASSPAWGGWTDTQYF	TRBV27	TRBJ2-3
TGTGCCAGCAGTTTGACTACTAGCGGGAGACGTCACAATGAGCAGTTCTTC	CASSLTTSGRRHNEQFF	TRBV28	TRBJ2-1
TGTGCTAGCAGCAGGGGAAGGCTGTTTTTT	CASSRGRLFF	TRBV7-7	TRBJ1-4
TGTGCCAGCAGCGGGAGGGTAGCGGGGCAACAAAATACGCAGTATTTT	CASSGRVAGQQNTQYF	TRBV5-4	TRBJ2-3
TGCGCCAGCAGCCAAGCGCCGGGACAGTGGGGGGGCATTCAGTACTTC	CASSQAPGQWGGIQYF	TRBV4-1	TRBJ2-4
TGTGCCAGCAGCTTAGGGGCCGGGGCCAACGTCCTGACTTTC	CASSLGAGANVLTF	TRBV5-4	TRBJ2-6
TGTGCCAGCAGCTTAGATAGGAGGGCGGGGGCAGCGGGCAGCTTCTACGAGCAGTACTTC	CASSLDRRAGAAGSFYEQYF	TRBV7-4	TRBJ2-7
TGTGCCAGCAGTTCCGCCCGACGGACACCCCAGGCGACGGAGACAGATACGCAGTATTTT	CASSSARRTPQATETDTQYF	TRBV6-5	TRBJ2-3
TGTGCCAGCAGTTACGACACAGGGGGCGTCGGAGGAGAGACCCAGTACTTC	CASSYDTGGVGGETQYF	TRBV6-6	TRBJ2-5
TGTGCCAGCAGCGTAGTCTTGGAAGGGGTCTACGAGCAGTACTTC	CASSVVLEGVYEQYF	TRBV9	TRBJ2-7
TGCGCCAGCAGTGTCCAGGGTGGGACCAACACTGAAGCTTTCTTT	CASSVQGGTNTEAFF	TRBV10-1	TRBJ1-1
TGTGCCAGCAGTTTATCCTGGGACAGGGGGCGCAACATTCAGTACTTC	CASSLSWDRGRNIQYF	TRBV12-3	TRBJ2-4
TGTGCCAGCAGCGACTGGCTACCCTCTGGAAACACCATATATTTT	CASSDWLPSGNTIYF	TRBV7-3	TRBJ1-3
TGCGCCAGCAGCTTGGGGCTAGTGGACAATGAGCAGTTCTTC	CASSLGLVDNEQFF	TRBV5-1	TRBJ2-1
TGTGCCAGCAGCCCCTGGACACCGGGATCAGATCAGCCCCAGCATTTT	CASSPWTPGSDQPQHF	TRBV5-6	TRBJ1-5
TGTGCCAGCAGTGAATGGGGGTATGCCCTAGAGGGTTTAGGCAATGAGCAGTTCTTC	CASSEWGYALEGLGNEQFF	TRBV6-1	TRBJ2-1
TGTGCCAGCAGCCCCCGAAGGGGGCGGACTGGTTACACTGAAGCTTTCTTT	CASSPRRGRTGYTEAFF	TRBV5-5	TRBJ1-1
TGCAGTGCTAGAACGGATGTAACAGGGGTAGACTATGGCTACACCTTC	CSARTDVTGVDYGYTF	TRBV20-1	TRBJ1-2
TGTGCCTGGATAGAGGCCCTGGACATATACAAGCTGAACACTGAAGCTTTCTTT	CAWIEALDIYKLNTEAFF	TRBV30	TRBJ1-1
TGCGCCAGCAGCTTGGTGAGGGGACTAGCCTACGTC	CASSLVRGLAYV	TRBV5-1	TRBJ2-7
TGTGCCACCATTGGGGACACTGAAGCTTTCTTT	CATIGDTEAFF	TRBV24-1	TRBJ1-1
TGTGCCAGCCTAAGAGGGGGTAAGCAAGAGACCCAGTACTTC	CASLRGGKQETQYF	TRBV6-1	TRBJ2-5
TGTGCCATCAGTGAGTTCCGGGACAGGGATAGCAATCAGCCCCAGCATTTT	CAISEFRDRDSNQPQHF	TRBV10-3	TRBJ1-5
TGTGCCAGCAGACAAACCCCTCGCAAACGTAGGGGGGGGAGCTACGAGCAGTACTTC	CASRQTPRKRRGGSYEQYF	TRBV7-4	TRBJ2-7
TGCGCCAGCAGCTACAGGACCTGGGGTGAACCCCGAAGCTCCTACAATGAGCAGTTCTTC	CASSYRTWGEPRSSYNEQFF	TRBV5-1	TRBJ2-1
TGTGCCAGCAGCCAAGGGGCAGGGACTGAAGCTTTCTTT	CASSQGAGTEAFF	TRBV14	TRBJ1-1
TGTGCCAGCAGTTCCCAGGGGACAGGGGTATTCTCTGGGGCCAACGTCCTGACTTTC	CASSSQGTGVFSGANVLTF	TRBV27	TRBJ2-6
TGTGGGGCTCTAGCGGGAAGATTCTACGAGCAGTACTTC	CGALAGRFYEQYF	TRBV10-3	TRBJ2-7
TGTGCCAGCACTAAGGCCGGGACAGGGAGCAAAAACATTCAGTACTTC	CASTKAGTGSKNIQYF	TRBV27	TRBJ2-4
TGTGCCAGCAGCCTATCCCGGCCGGGGTATAAGGACGAGCAGTACTTC	CASSLSRPGYKDEQYF	TRBV3-1	TRBJ2-7
TGCGCCAGCAGCTGGGCGGACGAGCAGTACTTC	CASSWADEQYF	TRBV5-1	TRBJ2-7
TGTGCCAACCAGGCGTACTATGGCTACACCTTC	CANQAYYGYTF	TRBV6-5	TRBJ1-2
TGTGCCATTGCCAGGGTTCTGAATTCACCCCTCCACTTT	CAIARVLNSPLHF	TRBV6-5	TRBJ1-6
TGTGCCACAGGGGTTAGGAGTATTAGCAATCAGCCCCAGCATTTT	CATGVRSISNQPQHF	TRBV11-3	TRBJ1-5
TGTGCCAGCTCACCAACACAGGCCGGGGGCTACACCTTC	CASSPTQAGGYTF	TRBV18	TRBJ1-2
TGTGCCAGCAGTGGACTAGCGGAGGTCTTC	CASSGLAEVF	TRBV6-2	TRBJ2-1
TGTGCCAGCCCGAGACGATTCGCCCACGAGCAGTACTTC	CASPRRFAHEQYF	TRBV11-3	TRBJ2-7
TGCAGTGCTAGGGTAAGGACAGCTCCGGCGGGTGATCAGCCCCAGCATTTT	CSARVRTAPAGDQPQHF	TRBV20-1	TRBJ1-5
TGCGCCAGCAGCCAAAAATCGACTAGCGGAAGGTACAATGAGCAGTTCTTC	CASSQKSTSGRYNEQFF	TRBV4-3	TRBJ2-1
TGTGCCACCCCCCCCTGGGGGTCCAGACGCTACGAGCAGTACTTC	CATPPWGSRRYEQYF	TRBV15	TRBJ2-7
TGCACCGCGGGAGGGCGGAGCACAGATACGCAGTATTTT	CTAGGRSTDTQYF	TRBV20-1	TRBJ2-3
TGTGCCAGCAGTAGTGGGGGGCTCTACGAGCAGTACTTC	CASSSGGLYEQYF	TRBV7-9	TRBJ2-7
TGTGCCAGCTGGACTAGCGGGCAGAGCTCCTACAATGAGCAGTTCTTC	CASWTSGQSSYNEQFF	TRBV6-4	TRBJ2-1
TGCGCCAGCAGGAGACAGAATCAGCCCCAGCATTTT	CASRRQNQPQHF	TRBV10-1	TRBJ1-5
TGTGCCAGTAGTATAGATCATCCTCAGGATAACACCTTC	CASSIDHPQDNTF	TRBV19	TRBJ1-2
TGTGCGGGGACAGGGTCTCGGTATAGCAATCAGCCCCAGCATTTT	CAGTGSRYSNQPQHF	TRBV6-2	TRBJ1-5
TGCGCCAGCAGCCAAGAACCTGGGAGACAGGCTGGCTACACCTTC	CASSQEPGRQAGYTF	TRBV4-3	TRBJ1-2
TGTGCCAGCAGCCCGGGGAGGGTAGAGACCCAGTACTTC	CASSPGRVETQYF	TRBV13	TRBJ2-5
TGTGCCAGTAGTACCCCGGGGAGACCTTTGTCAACTGAAGCTTTCTTT	CASSTPGRPLSTEAFF	TRBV19	TRBJ1-1
TGCACGCCGGAGACCCAGTACTTC	CTPETQYF	TRBV20-1	TRBJ2-5
TGCAGTGCTCGTCGCGGAATGGGAGGGCCGGACACCGGGGAGCTGTTTTTT	CSARRGMGGPDTGELFF	TRBV20-1	TRBJ2-2
TGTGCCAGCAGCCCGACTTGGCTTCCAGGGGGCAATCAGCCCCAGCATTTT	CASSPTWLPGGNQPQHF	TRBV3-1	TRBJ1-5
TGTGCCAGCAGACGAGAAGGGCCCAGGGGAATTTACGAGCAGTACTTC	CASRREGPRGIYEQYF	TRBV5-4	TRBJ2-7
TGTGCCAGCAGCCCTTACGATGAAAAACTGTTTTTT	CASSPYDEKLFF	TRBV2	TRBJ1-4
TGTGCCAGTAGTATCCCTAGCGGGTACAATGAGCAGTTCTTC	CASSIPSGYNEQFF	TRBV19	TRBJ2-1
TGTGCCAGCAGCGGGTGTACCCGGACAGGGTCGGGCTACACCTTC	CASSGCTRTGSGYTF	TRBV13	TRBJ1-2
TGTGCCAGCAGTAGGGGTTATGACACTGAAGCTTTCTTT	CASSRGYDTEAFF	TRBV6-5	TRBJ1-1
TGTGCCAGCAGCTTACACGGGACGACTAGGTTGAACACTGAAGCTTTCTTT	CASSLHGTTRLNTEAFF	TRBV7-3	TRBJ1-1
TGCGCCAGCAGCTCATTTCTACTCGGGGAGTGCACCGGGGAGCTGTTTTTT	CASSSFLLGECTGELFF	TRBV5-1	TRBJ2-2
TGTGCCAGCAGCCCTCCGGGACATGAGGTAACCGGGGAGCTGTTTTTT	CASSPPGHEVTGELFF	TRBV6-1	TRBJ2-2
TGCGCCAGCAGCTTACCTTTGCAGGGTTTGAACTTGAAGTACGAGCAGTACTTC	CASSLPLQGLNLKYEQYF	TRBV5-1	TRBJ2-7
TGTGCCTGGAGGGCCAACACTGAAGCTTTCTTT	CAWRANTEAFF	TRBV30	TRBJ1-1
TGTGCCACAAACCCGATAGGGGCAGAGACCCAGTACTTC	CATNPIGAETQYF	TRBV6-5	TRBJ2-5
TGTGCCAGCAGCCGCCCAGGGAGCACCGGGGAGCTGTTTTTT	CASSRPGSTGELFF	TRBV4-2	TRBJ2-2
TGTGCCAGCAGCTTAGGTAACAGGGCGGCTTCCTACGAGCAGTACTTC	CASSLGNRAASYEQYF	TRBV11-2	TRBJ2-7
TGCAGCGTTGACCCAGGGGTGTCTGAAGCTTTCTTT	CSVDPGVSEAFF	TRBV29-1	TRBJ1-1
TGTGCCTTACAGGGGGGAAACACCATATATTTT	CALQGGNTIYF	TRBV30	TRBJ1-3
TGTGCCAGCAGCCCCGGGGGCCCTGACTCTGGGGCCAACGTCCTGACTTTC	CASSPGGPDSGANVLTF	TRBV11-3	TRBJ2-6
TGCGCCAGCAGCTTTACAATCAGCTTTAACGAGCAGTACTTC	CASSFTISFNEQYF	TRBV5-1	TRBJ2-7
TGTGCCAGCAGTACCGGACTAGAGAACACCGGGGAGCTGTTTTTT	CASSTGLENTGELFF	TRBV7-2	TRBJ2-2
TGTGCCAGCAACCCGGGGGCCGCCGCGTTGCAGCCCCAGCATTTT	CASNPGAAALQPQHF	TRBV6-4	TRBJ1-5
TGTGCCAGCAGTTACACCAAAGGGTCGGATGAGCAGTTCTTC	CASSYTKGSDEQFF	TRBV6-5	TRBJ2-1
TGTGCCAGCACCAGTAGGGGGCTCGTCAATCAGCCCCAGCATTTT	CASTSRGLVNQPQHF	TRBV9	TRBJ1-5
TGTGCCAGCAGCAACGAGAGTAGCAATGAGCAGTTCTTC	CASSNESSNEQFF	TRBV5-6	TRBJ2-1
TGTGCCAGCAGCCAAGATTGCGTCAGGGTCTACGAGCAGTACTTC	CASSQDCVRVYEQYF	TRBV4-2	TRBJ2-7
TGTGCCACCCAAACTAGCGGGAGTTACGAGCAGTACTTC	CATQTSGSYEQYF	TRBV25-1	TRBJ2-7
TGTGCCATCAGGACAGGGGGCTACCCTGGCTACGAGCAGTACTTC	CAIRTGGYPGYEQYF	TRBV10-3	TRBJ2-7
TGTGCCACCAGTGACTCCGGGACTAGCGGGAGCTCCTACAATGAGCAGTTCTTC	CATSDSGTSGSSYNEQFF	TRBV24-1	TRBJ2-1
TGTGCCAGCAGTTTATGGCAAAGGGGCGGGACCTCTGGGGCCAACGTCCTGACTTTC	CASSLWQRGGTSGANVLTF	TRBV28	TRBJ2-6
TGTGCCTGGAATTGGAGGGGGGACGAGCAGTACTTC	CAWNWRGDEQYF	TRBV30	TRBJ2-7
TGTGCCAGCAGTGACGTGAACGACGTGCCGGGCTACGAGCAGTACTTC	CASSDVNDVPGYEQYF	TRBV6-4	TRBJ2-7
TGTGCCAGCATACCGAGGCAAGACACCTTC	CASIPRQDTF	TRBV6-6	TRBJ1-2
TGCGCCAGCAGCTGGGGGGGCTGCCCGGGTTCCTACGAGCAGTACTTC	CASSWGGCPGSYEQYF	TRBV5-1	TRBJ2-7
TGCGCCGTCCGGGACAAAACTAATGAAAAACTGTTTTTT	CAVRDKTNEKLFF	TRBV10-1	TRBJ1-4
TGTGCCAGCAGCGTAGACGGACAGTGGGACTCCTACGAGCAGTACTTC	CASSVDGQWDSYEQYF	TRBV9	TRBJ2-7
TGTGCCAGCAGCGTAAAGGGACTGCATTCACCCCTCCACTTT	CASSVKGLHSPLHF	TRBV13	TRBJ1-6
TGTGCCAGCAGTGCCGAACGGGGGGGGCATATCTACGAGCAGTACTTC	CASSAERGGHIYEQYF	TRBV11-2	TRBJ2-7
TGCGCCAGCAGCGTGACGGGGGGTGGATACGAGCAGTACTTC	CASSVTGGGYEQYF	TRBV10-1	TRBJ2-7
TGCGCCAGCAGCCATGGCGAGGACAGTACCCTACGCTGCCAAGAGACCCAGTACTTC	CASSHGEDSTLRCQETQYF	TRBV4-3	TRBJ2-5
TGTGTCCTACTTAGGAGCTCCTACAATGAGCAGTTCTTC	CVLLRSSYNEQFF	TRBV6-4	TRBJ2-1
TGTGCCAGCAGTCGGTTCCCGGGCACAGACCCCTCCTACGAGCAGTACTTC	CASSRFPGTDPSYEQYF	TRBV5-4	TRBJ2-7
TGTGCCAGCATAGAAAGTCTAATGAGACAGGGAAAACGGGGGTACTTC	CASIESLMRQGKRGYF	TRBV12-4	TRBJ2-7
TGTGCCAGCTCACCATCCCTAGCGGGCTCCTACGAGCAGTACTTC	CASSPSLAGSYEQYF	TRBV18	TRBJ2-7
TGTGCCAGTAGTATAGACCCCAGGCCTGCTGAAGCTTTCTTT	CASSIDPRPAEAFF	TRBV19	TRBJ1-1
TGTGCCAGCAGAACCCCTTTGGGGCCCTTGGCTCAGCCCCAGCATTTT	CASRTPLGPLAQPQHF	TRBV14	TRBJ1-5
TGCGCCAGCAGCTTAGACGGACAGGCCAATGAGCAGTTCTTC	CASSLDGQANEQFF	TRBV5-1	TRBJ2-1
TGTGCCACCAGTGATGGACAGGCTGACACTGAAGCTTTCTTT	CATSDGQADTEAFF	TRBV24-1	TRBJ1-1
TGCAGTGCTAGTGGCACCCAGCAACAAAACACAGATACGCAGTATTTT	CSASGTQQQNTDTQYF	TRBV20-1	TRBJ2-3
TGTGCCAGCAGTTCGGTCCACAGGGAAGTGAACACTGAAGCTTTCTTT	CASSSVHREVNTEAFF	TRBV28	TRBJ1-1
TGTGCTAGTGGTGAGGGCCAGCAGCCCCAGCATTTT	CASGEGQQPQHF	TRBV12-5	TRBJ1-5
TGTGCCAGCAGCGGATACAAGAAAGACCATAGCAATCAGCCCCAGCATTTT	CASSGYKKDHSNQPQHF	TRBV9	TRBJ1-5
TGTGCCAGCAGCTTTCTCCAGATACCTCAGAGCAATGAAAAACTGTTTTTT	CASSFLQIPQSNEKLFF	TRBV5-4	TRBJ1-4
TGTGCCAGCAGCCAAGTACCCGGACAAAGGGATTCACCCCTCCACTTT	CASSQVPGQRDSPLHF	TRBV3-1	TRBJ1-6
TGTGCCAGCAGCCCGCGAATTGGGGAGGGGTTGAACACTGAAGCTTTCTTT	CASSPRIGEGLNTEAFF	TRBV7-4	TRBJ1-1
TGTGCCAGCAGAGCACCTCGGGGCTACGAGCAGTACTTC	CASRAPRGYEQYF	TRBV27	TRBJ2-7
TGCAGTGCTAGGGAAACAGGGGGAGTTAGCTATGGCTACACCTTC	CSARETGGVSYGYTF	TRBV20-1	TRBJ1-2
TGTGCCAGCAGATATGGGGTCACAGATACGCAGTATTTT	CASRYGVTDTQYF	TRBV28	TRBJ2-3
TGTGCCAGCAGTTTATGTCTTTTGACAGGTTCAGCCTACGAGCAGTACTTC	CASSLCLLTGSAYEQYF	TRBV28	TRBJ2-7
TGTGCCAGTAGTATAGATAGCAATGGGACAGGGGCAGGCTTGGGCCATTCACCCCTCCACTTT	CASSIDSNGTGAGLGHSPLHF	TRBV19	TRBJ1-6
TGTGCCAGAAAGAAGGACTTTTCCTACGAGCAGTACTTC	CARKKDFSYEQYF	TRBV19	TRBJ2-7
TGCGCCAGCAGCCAAGAGGGGTTGGGCTACACCTTC	CASSQEGLGYTF	TRBV4-1	TRBJ1-2
TGTGCCAGCGGAGGAAATCAGCCCCAGCATTTT	CASGGNQPQHF	TRBV7-3	TRBJ1-5
TGTGCCAGCTCAGGTTCCCCGGACTATGGCTACACCTTC	CASSGSPDYGYTF	TRBV2	TRBJ1-2
TGTGCCAGCTGGTCGCGGGAGAGGGGCTATGGCTACACCTTC	CASWSRERGYGYTF	TRBV6-1	TRBJ1-2
TGTGCCAGAAGACAGGGGGCGGACTATAATCAGCCCCAGCATTTT	CARRQGADYNQPQHF	TRBV19	TRBJ1-5
TGTGAAGGACAGGACGCCTGGAGCTATAGCAATCAGCCCCAGCATTTT	CEGQDAWSYSNQPQHF	TRBV12-3	TRBJ1-5
TGTGCCAATGGTTCCGGGGGGGAAGGAGACGCGGAGATTACGCTAAGTTACGAGCAGTACTTC	CANGSGGEGDAEITLSYEQYF	TRBV6-5	TRBJ2-7
TGTGCCAGCAGCATTATGAAAACCGGGACAGGGAAGGGGAAAGATACGCAGTATTTT	CASSIMKTGTGKGKDTQYF	TRBV13	TRBJ2-3
TGCGCCAGCAGGGCCTTAGAAACCCCCGGGGAGCTGTTTTTT	CASRALETPGELFF	TRBV10-2	TRBJ2-2
TGTGCCAGCTGGACTAGCGGGTCAGGAGAGACCCAGTACTTC	CASWTSGSGETQYF	TRBV27	TRBJ2-5
TGTGCCAGCAGCTTATGGGACAGATTTATGGGAGACGAGCAGTACTTC	CASSLWDRFMGDEQYF	TRBV7-9	TRBJ2-7
TGTGCCAGCAGCTTTCCAAAGGGGACGAGCTACGAGCAGTACTTC	CASSFPKGTSYEQYF	TRBV11-2	TRBJ2-7
TGTGCCAGCTCCTCGCAGGGGCTCAACTATGGCTACACCTTC	CASSSQGLNYGYTF	TRBV18	TRBJ1-2
TGTGCCAGTACGGTTGGATGGGGGGACGTCGCGGATCAGCCCCAGCATTTT	CASTVGWGDVADQPQHF	TRBV19	TRBJ1-5
TGTGCCACCACCCGGGAGGGGACAGCGGAGGGCTACACCTTC	CATTREGTAEGYTF	TRBV24-1	TRBJ1-2
TGTGCCAGCAGCTTAGGCCCGCGGGAGTCGGCTGAAGCTTTCTTT	CASSLGPRESAEAFF	TRBV11-2	TRBJ1-1
TGTGCCAGCAGTGAAACGACAGATGGCTACACCTTC	CASSETTDGYTF	TRBV6-3	TRBJ1-2
TGTGCCAGCAGTTACCAGTGTAAGAGAGGCTACACCTTC	CASSYQCKRGYTF	TRBV6-2	TRBJ1-2
TGCAGTGCTAGAAGGACGGGCTACACCTTC	CSARRTGYTF	TRBV20-1	TRBJ1-2
TGCAGTGCTAGCCCCGACAGGGTGGATCAGCCCCAGCATTTT	CSASPDRVDQPQHF	TRBV20-1	TRBJ1-5
TGTGCCAGCAGCGCCCCACAGGGCGATGGGTCTGGGGCCAACGTCCTGACTTTC	CASSAPQGDGSGANVLTF	TRBV7-9	TRBJ2-6
TGCGCCAGCAAGACACTGGGTGCGGGTAACACTGAAGCTTTCTTT	CASKTLGAGNTEAFF	TRBV10-1	TRBJ1-1
TGTGCCAGCGGTAGGGAGGGAACTAACTATGGCTACACCTTC	CASGREGTNYGYTF	TRBV28	TRBJ1-2
TGTGCCAGCAGTTTCCGGGACAGGGAAACCTTC	CASSFRDRETF	TRBV28	TRBJ1-2
TGTGCCAGCAGCCAAGCCATCCAATTGACTAGCGGGTACAATGAGCAGTTCTTC	CASSQAIQLTSGYNEQFF	TRBV14	TRBJ2-1
TGTGCCAGCAGCCAAGACACCAGGAAATGGGGGGCGAACTACGAGCAGTACTTC	CASSQDTRKWGANYEQYF	TRBV3-1	TRBJ2-7
TGTGCCAGCAGGGGGGGAGGCCCCTACGAGCAGTACTTC	CASRGGGPYEQYF	TRBV6-1	TRBJ2-7
TGTGCCAGCAGACTCGTATCCTTCAATGAGCAGTTCTTC	CASRLVSFNEQFF	TRBV11-3	TRBJ2-1
TGCGCCAGCAGCCAAGACTGCGTCCGGTGTGGGAAGACCCAGTACTTC	CASSQDCVRCGKTQYF	TRBV4-1	TRBJ2-5
TGTGCCAGCAGCTTAGCGCTGCGGGAGCGCACAGATACGCAGTATTTT	CASSLALRERTDTQYF	TRBV7-4	TRBJ2-3
TGTGCCAGCAGTTACTCCTTCACCGTGGGGCCGCATCATCAGCCCCAGCATTTT	CASSYSFTVGPHHQPQHF	TRBV6-5	TRBJ1-5
TGCGCCAGCAGGCCTAGATACGAGCAGTACTTC	CASRPRYEQYF	TRBV5-1	TRBJ2-7
TGTGCCAGCAGCTTTGGAAACGGCGGGAGGGGAGAAAATTCGAACACCGGGGAGCTGTTTTTT	CASSFGNGGRGENSNTGELFF	TRBV5-5	TRBJ2-2
TGTGCCAGCAGCTTGGGCGGGGACACTGAAGCTTTCTTT	CASSLGGDTEAFF	TRBV7-3	TRBJ1-1
TGTGCCACCAGCAGCGGTGCTACAGGGCATCGGGGCTCTGGGGCCAACGTCCTGACTTTC	CATSSGATGHRGSGANVLTF	TRBV15	TRBJ2-6
TGTGCCAGCAGTAGATCAGGCCGGCAGGGGCCCTCCTATTTT	CASSRSGRQGPSYF	TRBV6-2	TRBJ1-3
TGTGCCAGCAAGGGACAGGGGCGACGGTGTCAGCCCCAGCATTTT	CASKGQGRRCQPQHF	TRBV12-4	TRBJ1-5
TGTGCCAGCAGCCGCGGGACAGGGGGGAACACTGAAGCTTTCTTT	CASSRGTGGNTEAFF	TRBV7-9	TRBJ1-1
TGTGCCAGCAGTTGCTCCAGGGGGCGATTCTACGAGCAGTACTTC	CASSCSRGRFYEQYF	TRBV6-2	TRBJ2-7
TGCGCCAGCAGCTTTGGGGACCGCAATCAGCCCCAGCATTTT	CASSFGDRNQPQHF	TRBV5-1	TRBJ1-5
TGTGCCAGCGACAGGGTTTTGAACACTGAAGCTTTCTTT	CASDRVLNTEAFF	TRBV6-1	TRBJ1-1
TGTGCCAGCAGCACGAACTCGGGTCCTAGCACAGATACGCAGTATTTT	CASSTNSGPSTDTQYF	TRBV3-1	TRBJ2-3
TGTGCCACCAGACTCGTACTAGAGACTGATACGCAGTATTTT	CATRLVLETDTQYF	TRBV24-1	TRBJ2-3
TGTGCCAGCAGTTTGGGGTTGACTAGCTCCTACGAGCAGTACTTC	CASSLGLTSSYEQYF	TRBV6-5	TRBJ2-7
TGTGCCAGCAGCCAACCTGGGGCAAGCAGCTACGAGCAGTACTTC	CASSQPGASSYEQYF	TRBV7-9	TRBJ2-7
TGTGCCAGCAGCGATCCAGAACGGGGCTACACCTTC	CASSDPERGYTF	TRBV7-4	TRBJ1-2
TGCAGCGTTGATGCGGCTGTCGCAAGCTCCTACAATGAGCAGTTCTTC	CSVDAAVASSYNEQFF	TRBV29-1	TRBJ2-1
TGTGCCAGCAGCCAAGCCAACAGGGACCACTATGGCTACACCTTC	CASSQANRDHYGYTF	TRBV4-2	TRBJ1-2
TGTGCTAGTGGTTTTTGGCGGGACAGACTTGGGGGGAACACTGAAGCTTTCTTT	CASGFWRDRLGGNTEAFF	TRBV12-5	TRBJ1-1
TGCAGTGCTGGGACAACCTACGAGCAGTACTTC	CSAGTTYEQYF	TRBV20-1	TRBJ2-7
TGTGCCAGCCCCCGTCTAGGGGGGCCGCTAAGCCGGAACTATGGCTACACCTTC	CASPRLGGPLSRNYGYTF	TRBV7-9	TRBJ1-2
TGTGCCAGCTCACCACAATCCAGGGTCGAGACCCAGTACTTC	CASSPQSRVETQYF	TRBV18	TRBJ2-5
TGTGCCAGCGCAGGTCAGGGGGAGAGGCATGCAACTAATGAAAAACTGTTTTTT	CASAGQGERHATNEKLFF	TRBV27	TRBJ1-4
TGTGCCAGCAGTTGGACGGGGTATGGCTACACCTTC	CASSWTGYGYTF	TRBV27	TRBJ1-2
TGTGCCAGCAGCTTAGGCCGCGGGGTTTCGAACACTGAAGCTTTCTTT	CASSLGRGVSNTEAFF	TRBV13	TRBJ1-1
TGCAGTGCTAGGGGCGACCGGAAAGCCCAAGAGACCCAGTACTTC	CSARGDRKAQETQYF	TRBV20-1	TRBJ2-5
TGTGCCAGCAGTCTGAAGGGGACTTGTACCAGGGGCTACGAGCAGTACTTC	CASSLKGTCTRGYEQYF	TRBV28	TRBJ2-7
TGTGCCAGCAGTTACTTTACACAGGGACGGACAAATGAAAAACTGTTTTTT	CASSYFTQGRTNEKLFF	TRBV6-5	TRBJ1-4
TGTGCCAGCAGAAATAGGCTCTACGAGCAGTACTTC	CASRNRLYEQYF	TRBV27	TRBJ2-7
TGTGCCAGCAGCAGAACTAGCGGGAGAAGATCCGGGGAGCTGTTTTTT	CASSRTSGRRSGELFF	TRBV27	TRBJ2-2
TGTGCCAGCAGTCCGGGGGTAGATACGCAGTATTTT	CASSPGVDTQYF	TRBV2	TRBJ2-3
TGCGCCAGCAGTGAGCCTGACAGGGTCAGCGACCATAACTATGGCTACACCTTC	CASSEPDRVSDHNYGYTF	TRBV10-2	TRBJ1-2
TGCGCCAGCAGCTTGGCCCAGCAGGTTAGGCGCCCGGGACAGGGGTTCGTTCCCGAGCAGTACTTC	CASSLAQQVRRPGQGFVPEQYF	TRBV5-1	TRBJ2-7
TGCAGTGCTAGGGGCCTAGGGGGACTAGCGGTTCAGTACTTC	CSARGLGGLAVQYF	TRBV20-1	TRBJ2-5
TGTGCCACCAGAATAGGGGGACCCCAGTACTTC	CATRIGGPQYF	TRBV24-1	TRBJ2-5
TGTGCCAGTACACGAGCTAGCTGCGGGGAGCTGTTTTTT	CASTRASCGELFF	TRBV19	TRBJ2-2
TGTGCCAGCAGAGCGGGAGATGTAGATACTTACCGGCTCTCTGGAAACACCATATATTTT	CASRAGDVDTYRLSGNTIYF	TRBV6-5	TRBJ1-3
TGTGCCAGCAGCCCGAACTCTCGACAGGGGCTCGAGACCCAGTACTTC	CASSPNSRQGLETQYF	TRBV7-9	TRBJ2-5
TGTGCCAGCAGCTTAGGACCCGACTATGGCTACACCTTC	CASSLGPDYGYTF	TRBV5-4	TRBJ1-2
TGCGCCAGCAGCTTGGGTGGGGGGGCTTTGAACACTGAAGCTTTCTTT	CASSLGGGALNTEAFF	TRBV5-1	TRBJ1-1
TGTGCCAGCAGCCGGGAAACTAGAAATTTAGGGAGGACCTCCTACAATGAGCAGTTCTTC	CASSRETRNLGRTSYNEQFF	TRBV5-6	TRBJ2-1
TGTGCCAGCAGCCTACTTGGACTGGGCCAAGAGACCCAGTACTTC	CASSLLGLGQETQYF	TRBV13	TRBJ2-5
TGCAGCGTTGCAGCTGCGACCCGGTGTCCCTACGAGCAGTACTTC	CSVAAATRCPYEQYF	TRBV29-1	TRBJ2-7
TGTGCCAGCAGTGCGACTAGCGGGAGGATGAGCTCCTACAATGAGCAGTTCTTC	CASSATSGRMSSYNEQFF	TRBV28	TRBJ2-1
TGTGCCAGCAGCTTAGTCCTGGGTACTGAAGCTTTCTTT	CASSLVLGTEAFF	TRBV7-9	TRBJ1-1
TGTGCCAGCAGCGTAGCTTTCAAGGACAGTGGGCTGAGTGGTACTGAAGCTTTCTTT	CASSVAFKDSGLSGTEAFF	TRBV9	TRBJ1-1
TGTGCCAGCCCAGGCTTGGGGAAGAACACTGAAGCTTTCTTT	CASPGLGKNTEAFF	TRBV27	TRBJ1-1
TGTGCCAGCAGCGCCCGGAGGGGGGGACTAGCTTTCTTT	CASSARRGGLAFF	TRBV7-6	TRBJ1-1
TGCGCCAGCAGCCTGCCGGGACAGGGGCGGGTCGTGCGGACCGGGGAGCTGTTTTTT	CASSLPGQGRVVRTGELFF	TRBV5-1	TRBJ2-2
TGTGCCAGATTTACTAGCGGGAGTACCTGGGACACTGAAGCTTTCTTT	CARFTSGSTWDTEAFF	TRBV19	TRBJ1-1
TGTGCCAGCAGCCAAGAGTTAGGGGAGGGGGGCTACGAGCAGTACTTC	CASSQELGEGGYEQYF	TRBV14	TRBJ2-7
TGTGCCAGCAGCTTAGTAGGGGGCACAGATACGCAGTATTTT	CASSLVGGTDTQYF	TRBV7-9	TRBJ2-3
TGTGCCAGTCTCAGGACAGTCCCTAACTATGGCTACACCTTC	CASLRTVPNYGYTF	TRBV19	TRBJ1-2
TGTGCCAGCAGCCAGTCGCCCGAGGACAGGGAGGGCACAGATACGCAGTATTTT	CASSQSPEDREGTDTQYF	TRBV5-6	TRBJ2-3
TGTGCCAGCTTACGGACGGATTCTAATCAGCCCCAGCATTTT	CASLRTDSNQPQHF	TRBV9	TRBJ1-5
TGTGCCAGCAGCAGTTGGACGGATACGCAGTATTTT	CASSSWTDTQYF	TRBV14	TRBJ2-3
TGTGCCAGCACTCCCAGTTATTCACCCCTCCACTTT	CASTPSYSPLHF	TRBV6-5	TRBJ1-6
TGCGCCAGCAGCACCCGTTCCAAGGGGAGGGACCGAATCTATGGCTACACCTTC	CASSTRSKGRDRIYGYTF	TRBV5-1	TRBJ1-2
TGCGCCAGCAGCCAAGAGGGGGTGTTTCTTGGTGAAGCTTTCTTT	CASSQEGVFLGEAFF	TRBV4-1	TRBJ1-1
TGTGCCAGCATTCTCCCCCAGCGGGGTGGCTACGAGCAGTACTTC	CASILPQRGGYEQYF	TRBV6-2	TRBJ2-7
TGTGCCAGCAGCGGACTGGTTTCCTACGAGCAGTACTTC	CASSGLVSYEQYF	TRBV7-9	TRBJ2-7
TGCGCCAGCAGCTTGTATGGGACAGGGGACTCCTATAATTCACCCCTCCACTTT	CASSLYGTGDSYNSPLHF	TRBV5-1	TRBJ1-6
TGTGCCAGCAGGACTAATAAGGGGACAGGCTTGGAGCAGTACTTC	CASRTNKGTGLEQYF	TRBV28	TRBJ2-7
TGTGCCATCGCCAGGAACTCCTACGAGCAGTACTTC	CAIARNSYEQYF	TRBV6-4	TRBJ2-7
TGCAGCGTTGACACGCGAGGGGGGAGTTCCGATACGCAGTATTTT	CSVDTRGGSSDTQYF	TRBV29-1	TRBJ2-3
TGTGCCAGCAGCCTAAGGGAGCGGGGCTACACCTTC	CASSLRERGYTF	TRBV13	TRBJ1-2
TGTGCCAGCAGCCCTCTGGCCATAACCAGTCAGCCCCAGCATTTT	CASSPLAITSQPQHF	TRBV7-9	TRBJ1-5
TGTGCCAGCAGTTGGGGGCGCCGAGGCGATCAGCCCCAGCATTTT	CASSWGRRGDQPQHF	TRBV12-4	TRBJ1-5
TGTGCCAGCAGATCGGCCCACAGGGTTGGGGAGTCGTACGAGCAGTACTTC	CASRSAHRVGESYEQYF	TRBV6-5	TRBJ2-7
TGCGCCAGCAGCTTGGCACCCGAAGGTCCAGGGGTCCTGGTGAACACTGAAGCTTTCTTT	CASSLAPEGPGVLVNTEAFF	TRBV5-1	TRBJ1-1
TGTGCCAGCAGCTTACCTTCCGGGGACCGGTATAGCAATCAGCCCCAGCATTTT	CASSLPSGDRYSNQPQHF	TRBV7-6	TRBJ1-5
TGTGCTAGCAGCTGGTCGGACAGGGACCGAGGCGTTGGTTTCCACTATGGCTACACCTTC	CASSWSDRDRGVGFHYGYTF	TRBV7-7	TRBJ1-2
TGTGCCAGCAGCGGGGGGGGGCAGGGGGGCCCTTATGGCTACACCTTC	CASSGGGQGGPYGYTF	TRBV7-3	TRBJ1-2
TGTGCCAGCAGTTGGAGGGGGACACGAGCCAAAAACATTCAGTACTTC	CASSWRGTRAKNIQYF	TRBV12-3	TRBJ2-4
TGCAGCGTTAGTCCGCTAGCGGGAGAGGGTCCCACAGATACGCAGTATTTT	CSVSPLAGEGPTDTQYF	TRBV29-1	TRBJ2-3
TGTGCCAGCAGATGGACACCGAACACCGGGGAGCTGTTTTTT	CASRWTPNTGELFF	TRBV5-6	TRBJ2-2
TGTGCCATCCCAACAGGGGGGAAATTGAACACTGAAGCTTTCTTT	CAIPTGGKLNTEAFF	TRBV10-3	TRBJ1-1
TGTGCCAGCAGTTCGACAAGGGGGATTCCAAACATTCAGTACTTC	CASSSTRGIPNIQYF	TRBV28	TRBJ2-4
TGTGCCAAGTTTAACAGAAAACTCTACACCTTC	CAKFNRKLYTF	TRBV10-3	TRBJ1-2
TGTGCCAGCAGTTTATCCGTCTGCCGGGACACTGAAGCTTTCTTT	CASSLSVCRDTEAFF	TRBV12-4	TRBJ1-1
TGTGCCAGCAAAGGAGAGATCTACAATGAGCAGTTCTTC	CASKGEIYNEQFF	TRBV28	TRBJ2-1
TGTGCCAGCAGCTTAGCTAGAGTTAATTTCGATACGCAGTATTTT	CASSLARVNFDTQYF	TRBV7-6	TRBJ2-3
TGCAGCGTTGCGGCTAGAACTGGACTAGCGGGGGCCCGCTTAAGCAATGAGCAGTTCTTC	CSVAARTGLAGARLSNEQFF	TRBV29-1	TRBJ2-1
TGTGCCAGCAGCCAGCAGCCCCAGCATTTT	CASSQQPQHF	TRBV5-4	TRBJ1-5
TGTGCCAGCAGTTACTCGATTCAGGGGGAGGGAAACACCATATATTTT	CASSYSIQGEGNTIYF	TRBV6-3	TRBJ1-3
TGCGCCAGCAGAGGACAGTTATATGGCTACACCTTC	CASRGQLYGYTF	TRBV5-1	TRBJ1-2
TGTGCCCCCCCCGCGGAGACAGGGGAATATGGCTACACCTTC	CAPPAETGEYGYTF	TRBV12-3	TRBJ1-2
TGCAGTGCTCGTTTCAGGGGCTCCTACAATGAGCAGTTCTTC	CSARFRGSYNEQFF	TRBV20-1	TRBJ2-1
TGTGCCAGCAGCTTAGAACATAAGCGTGGCCCCTCGGACAGGGCGCGGATCTACGAGCAGTACTTC	CASSLEHKRGPSDRARIYEQYF	TRBV7-2	TRBJ2-7
TGTGCCAGCAGCTTAGATAAGCGGGGGAATGCCTACGAGCAGTACTTC	CASSLDKRGNAYEQYF	TRBV7-3	TRBJ2-7
TGTGCCAGCAGCTTAGTTAGGGGGAGAGGGAATCAGCCCCAGCATTTT	CASSLVRGRGNQPQHF	TRBV7-2	TRBJ1-5
TGTGCCAGCATGACCGCACGCCCCTGGAATAGCAATCAGCCCCAGCATTTT	CASMTARPWNSNQPQHF	TRBV28	TRBJ1-5
TGCAGTGCCCCCGGCGATCTAGCTTTCTTT	CSAPGDLAFF	TRBV20-1	TRBJ1-1
TGTGCCAGCCTGGGACAGCCACGGTCACCCCTCCACTTT	CASLGQPRSPLHF	TRBV13	TRBJ1-6
TGTGCCAGCGTTGGGACGAGCTCCTATAATTCACCCCTCCACTTT	CASVGTSSYNSPLHF	TRBV9	TRBJ1-6
TGTGCCTATGTAATGAGGGACAATGGACTCTCTGGAAACACCATATATTTT	CAYVMRDNGLSGNTIYF	TRBV30	TRBJ1-3
TGTGCCAGCAGCTACGACAGGGCCTATGGCTACACCTTC	CASSYDRAYGYTF	TRBV7-9	TRBJ1-2
TGTGCCAGCAGCCTGACAGGACCCCTGGGGGTAGGCACCGGGGAGCTGTTTTTT	CASSLTGPLGVGTGELFF	TRBV13	TRBJ2-2
TGCAGTGCTAGATCCCCCCGACAGGGCAGCTACGAGCAGTACTTC	CSARSPRQGSYEQYF	TRBV20-1	TRBJ2-7
TGTGCCAGCAGTCCCAGGAGATACGAGCAGTACTTC	CASSPRRYEQYF	TRBV9	TRBJ2-7
TGTGCCACCTCTACCCGACCGGGACAGGGCGAACCTTACAATGAGCAGTTCTTC	CATSTRPGQGEPYNEQFF	TRBV24-1	TRBJ2-1
TGTGCCAGCAGCCAAGAACCGGGAGACGAGCAGTACTTC	CASSQEPGDEQYF	TRBV14	TRBJ2-7
TGTGCCAGCAGCGGATCAGGGGGCGAAAAACTGTTTTTT	CASSGSGGEKLFF	TRBV13	TRBJ1-4
TGTGCCAGCAGTTACGCTCCCCAAGCGGGAGCAGAGACCCAGTACTTC	CASSYAPQAGAETQYF	TRBV6-5	TRBJ2-5
TGCGCCAGCAGCCGAGGGGGGTATAAAGAGACCCAGTACTTC	CASSRGGYKETQYF	TRBV4-1	TRBJ2-5
TGTGCCAGCAGCCAAGCCCCTAGCGGGGAAGATACGCAGTATTTT	CASSQAPSGEDTQYF	TRBV14	TRBJ2-3
TGTGCCACCAGTGTTTACAGGACAGGGCTCCGCACAGATACGCAGTATTTT	CATSVYRTGLRTDTQYF	TRBV24-1	TRBJ2-3
TGCAGTGCAGTCCCGGGACAGGGGGACACTGAAGCTTTCTTT	CSAVPGQGDTEAFF	TRBV20-1	TRBJ1-1
TGTGCCAGCAGCTTAGACCATATTTTCACAGATACGCAGTATTTT	CASSLDHIFTDTQYF	TRBV7-4	TRBJ2-3
TGTGCCAGCAGCCAAGATCGTTCCCACTCAGTCCGGGACAGCGCTCGCTCTGGAAACACCATATATTTT	CASSQDRSHSVRDSARSGNTIYF	TRBV3-1	TRBJ1-3
TGTGCCAGCAGCGCTAGGAGCGGGATTCAATGTAACTATGGCTACACCTTC	CASSARSGIQCNYGYTF	TRBV9	TRBJ1-2
TGTGCCAGCAGTTTGGAGGGTACGAGGATCGACGAGCAGTACTTC	CASSLEGTRIDEQYF	TRBV6-5	TRBJ2-7
TGTGCCAGCAGCGCGGGACTGGACTACGAGCAGTACTTC	CASSAGLDYEQYF	TRBV13	TRBJ2-7
TGTGCCCCGACAGGGGGCCACAATGAGCAGTTCTTC	CAPTGGHNEQFF	TRBV5-6	TRBJ2-1
TGTGCCAGCAGTAGAATGGGACTAGCGGGAGGATCCATAGTCTACGAGCAGTACTTC	CASSRMGLAGGSIVYEQYF	TRBV27	TRBJ2-7
TGTGCCAGCATACATTTGTCCTATAATTCACCCCTCCACTTT	CASIHLSYNSPLHF	TRBV27	TRBJ1-6
TGTGCCAGCAGCACCGGCGATAACTACGAGCAGTACTTC	CASSTGDNYEQYF	TRBV13	TRBJ2-7
TGTGCCACAAACCCTAAGCCCGGACTAGCGGGGCTGGCCAACGTCCTGACTTTC	CATNPKPGLAGLANVLTF	TRBV24-1	TRBJ2-6
TGCGCCAGCAGCCCGCGGAGCTCCTACGAGCAGTACTTC	CASSPRSSYEQYF	TRBV4-3	TRBJ2-7
TGTGCCAGCAGTGAAAGGAGCGGACAGGGTTTCCCAATTGAAGCTTTCTTT	CASSERSGQGFPIEAFF	TRBV2	TRBJ1-1
TGTGCCAGGCCCCGCGCGGCGGGAGCCAAAAACATTCAGTACTTC	CARPRAAGAKNIQYF	TRBV28	TRBJ2-4
TGTGCCAGCAGTGGACAGTACGACGAGCAGTACTTC	CASSGQYDEQYF	TRBV27	TRBJ2-7
TGTGCCAGCAAACCGGCTCCGGGGGTTAAGCTAGCCAAAAACATTCAGTACTTC	CASKPAPGVKLAKNIQYF	TRBV7-8	TRBJ2-4
TGCGCCATGCACTTCCAGAACACTGAAGCTTTCTTT	CAMHFQNTEAFF	TRBV10-1	TRBJ1-1
TGTGCCACCAGTGATCAATCCAGGAGCTCTGGGGCCAACGTCCTGACTTTC	CATSDQSRSSGANVLTF	TRBV24-1	TRBJ2-6
TGTGCCACCAGCAGAAATTCACAGGGGCGTTTGGAGACCCAGTACTTC	CATSRNSQGRLETQYF	TRBV15	TRBJ2-5
TGCAGTGCTAGGGACATTAAGCCTCTCACCTTC	CSARDIKPLTF	TRBV20-1	TRBJ1-2
TGCAGTACGTACAGGGGCCGCGAGCAGTACTTC	CSTYRGREQYF	TRBV20-1	TRBJ2-7
TGCGCCAGCAGACAAACGCCGGGACAGCGGGGCAGAAACACCATATATTTT	CASRQTPGQRGRNTIYF	TRBV5-1	TRBJ1-3
TGTGCCAGCAGCTTTGGGGGCAATGAAGCTTTCTTT	CASSFGGNEAFF	TRBV7-3	TRBJ1-1
TGTGCCAGCAGTGGCAGGAGGGGGGGGGACACCTTC	CASSGRRGGDTF	TRBV6-4	TRBJ1-2
TGCAGCGTGAGACGGGGGAACACTGAAGCTTTCTTT	CSVRRGNTEAFF	TRBV29-1	TRBJ1-1
TGTGCCAGCAGCGGGGGGGGCCCGTACGAGCAGTACTTC	CASSGGGPYEQYF	TRBV7-3	TRBJ2-7
TGTGCCACGTTACCCGGGGACAGGGGACACAAAAACATTCAGTACTTC	CATLPGDRGHKNIQYF	TRBV19	TRBJ2-4
TGCGCCAGCAGCTTGGTGGAGCTGAAGGGGGACGGGTTTCACTACGAGCAGTACTTC	CASSLVELKGDGFHYEQYF	TRBV5-1	TRBJ2-7
TGTGCCACCAGAGATACTGGTGGGGACAGGGGACTGTTATATGGCTACACCTTC	CATRDTGGDRGLLYGYTF	TRBV24-1	TRBJ1-2
TGTGCCAGCAGTGACCCGCGGGAGAGTTATAGCAATCAGCCCCAGCATTTT	CASSDPRESYSNQPQHF	TRBV2	TRBJ1-5
TGTGCCAGCAGCCAAGAAAGACAGGGGGCCACAGTGGGAGCTCTCCCTCAAGACTCTGGGGCCAACGTCCTGACTTTC	CASSQERQGATVGALPQDSGANVLTF	TRBV3-1	TRBJ2-6
TGTGCCAGCAGCTGCCTGGACAGCACTGAAGCTTTCTTT	CASSCLDSTEAFF	TRBV5-4	TRBJ1-1
TGTGCCAGCAGCGTACGACTAGCGGGGGGGCCAAAGTACGAGCAGTACTTC	CASSVRLAGGPKYEQYF	TRBV7-8	TRBJ2-7
TGTGCTAGTGGTTTGGCCCGGATCATTAAGGACATCAACATTCAGTACTTC	CASGLARIIKDINIQYF	TRBV12-5	TRBJ2-4
TGTGCCAGCAGTGGGTTCTTTATTACAGGGGGGGTCCGAGGATACAGTCTCTACGAGCAGTACTTC	CASSGFFITGGVRGYSLYEQYF	TRBV2	TRBJ2-7
TGTGCCAGCAGCCAGCCCACTAGGGGAGGCGATGGCTACACCTTC	CASSQPTRGGDGYTF	TRBV3-1	TRBJ1-2
TGTGCCAGCAGAGCCGGGACTAATCAGCCCCAGCATTTT	CASRAGTNQPQHF	TRBV27	TRBJ1-5
TGTGCCAGCAGTTTAAGGGTCCCACAGTCGTCCCAGTACTTC	CASSLRVPQSSQYF	TRBV12-4	TRBJ2-5
TGCGCCAGCAGCCAACGTTGCCCCCTGGACAGGGGTATGAACACTGAAGCTTTCTTT	CASSQRCPLDRGMNTEAFF	TRBV4-3	TRBJ1-1
TGTGCCAGCAGTGGGTGGGGGGCTTGGCAGCCCCAGCATTTT	CASSGWGAWQPQHF	TRBV25-1	TRBJ1-5
TGTGCCAGCAGTTCAGACCCGGCGGGCTACAATGAGCAGTTCTTC	CASSSDPAGYNEQFF	TRBV12-4	TRBJ2-1
TGTGCCAGTAGTATTCCTCCGGGACAGACGGGTCACATTCAGTACTTC	CASSIPPGQTGHIQYF	TRBV19	TRBJ2-4
TGTGCCAGCAGCTACAGGGGGGGGCTTGAAAAACTGTTTTTT	CASSYRGGLEKLFF	TRBV7-3	TRBJ1-4
TGTGCCAGCAGGCTGAGGACAAGGAAGGGACGTACCTACGAGCAGTACTTC	CASRLRTRKGRTYEQYF	TRBV28	TRBJ2-7
TGTGCCAGCAGCCGGACAGGTGGCTACACCTTC	CASSRTGGYTF	TRBV14	TRBJ1-2
TGCGCCAGCAGCTTGTTCCTCGAACGGAACGGTGTCAATGAGCAGTTCTTC	CASSLFLERNGVNEQFF	TRBV5-1	TRBJ2-1
TGCAGTGCTAGTTCGTCAGGGCCCATAACTAATGAAAAACTGTTTTTT	CSASSSGPITNEKLFF	TRBV20-1	TRBJ1-4
TGCAGTGCTAGAGCTCCGGGGGGGAATCACGACAATGAGCAGTTCTTC	CSARAPGGNHDNEQFF	TRBV20-1	TRBJ2-1
TGTGCCAGCAGCTGGGACAGAGGCTACACCTTC	CASSWDRGYTF	TRBV11-3	TRBJ1-2
TGTGCCAGCAGTTACATTAACCTGCTAGCCGCCGGGGAGCTGTTTTTT	CASSYINLLAAGELFF	TRBV6-5	TRBJ2-2
TGTGCCAGCAGCCATAATCCACACAGGGCCAGGGGAAACACCATATATTTT	CASSHNPHRARGNTIYF	TRBV4-2	TRBJ1-3
TGTGCCAGCTCACCACCCCTAAGAACCTTAGGAAACACCATATATTTT	CASSPPLRTLGNTIYF	TRBV18	TRBJ1-3
TGTGCCAGCAGGAGGACAGGTGTCGGACAGCCCCAGCATTTT	CASRRTGVGQPQHF	TRBV6-5	TRBJ1-5
TGTGCCACCAGTCCGGGGGACACAGGCAAAGAGACCCAGTACTTC	CATSPGDTGKETQYF	TRBV24-1	TRBJ2-5
TGTGCCAGCAGTTTGGAGAGGAGTGGGGTAGTTGAGACCCAGTACTTC	CASSLERSGVVETQYF	TRBV27	TRBJ2-5
TGTGCCAGCAGAAGGGACAGCTTGGGGTCACCCCTCCACTTT	CASRRDSLGSPLHF	TRBV9	TRBJ1-6
TGTGCCAGCAGCCAAGCCCCCTGGGATCAACGAAGTGAAGCTTTCTTT	CASSQAPWDQRSEAFF	TRBV4-2	TRBJ1-1
TGTGCCAGCAGCTCTACGGATAACCGGGGAGTAGTAATGTATAGCAATCAGCCCCAGCATTTT	CASSSTDNRGVVMYSNQPQHF	TRBV11-2	TRBJ1-5
TGTGCCAGCAGCGCGGTCATACGGGCCAAAAACATTCAGTACTTC	CASSAVIRAKNIQYF	TRBV7-4	TRBJ2-4
TGTGCCAGCAGTTTCGGAATCAACGAGCAGTACTTC	CASSFGINEQYF	TRBV28	TRBJ2-7
TGTGCCAGCAGCGGAGGGTTGGCGGATCAGCCCCAGCATTTT	CASSGGLADQPQHF	TRBV2	TRBJ1-5
TGCAGTGCTAGAGATTTTACCAGGCGCCTTCGCGGAGATTATAATTCACCCCTCCACTTT	CSARDFTRRLRGDYNSPLHF	TRBV20-1	TRBJ1-6
TGTGCCAGCAGCGAGGGAATTGGGGAGCAGTACTTC	CASSEGIGEQYF	TRBV7-2	TRBJ2-7
TGTGCCAGCAGCTTACCGGATCTCCCAACTAATGAAAAACTGTTTTTT	CASSLPDLPTNEKLFF	TRBV5-8	TRBJ1-4
TGTGCCACCAGTGACCTTGGTCCGGACAGGGGGCGCTCCTACGAGCAGTACTTC	CATSDLGPDRGRSYEQYF	TRBV24-1	TRBJ2-7
TGTGCCAGCAGCTTAGATCGTTTACGGAAACAGGGGGACACTGAAGCTTTCTTT	CASSLDRLRKQGDTEAFF	TRBV11-3	TRBJ1-1
TGTGCCAGCAGTTTATCAGGCGGGTACACCATATATTTT	CASSLSGGYTIYF	TRBV27	TRBJ1-3
TGTGCCAGCAGCTTAGCCCTTCTAGCGGGTTTCACCGGGGAGCTGTTTTTT	CASSLALLAGFTGELFF	TRBV7-4	TRBJ2-2
TGCAGTGCTAGTGGACAGTGTATCCGGAATGAGCAGTTCTTC	CSASGQCIRNEQFF	TRBV20-1	TRBJ2-1
TGTGCCAGCAGCACCGGGAATGCCAATGAGCAGTTCTTC	CASSTGNANEQFF	TRBV7-6	TRBJ2-1
TGTGCCAGCAGCCATCAGGACAGGGAGGGAGATACGCAGTATTTT	CASSHQDREGDTQYF	TRBV3-1	TRBJ2-3
TGTGCCAGCAGCCAAGATAGAAGAAAGCAAGAGACCCAGTACTTC	CASSQDRRKQETQYF	TRBV3-1	TRBJ2-5
TGCGCCAGCAGCTTGGGGATCAGGGTCACAGATACGCAGTATTTT	CASSLGIRVTDTQYF	TRBV5-1	TRBJ2-3
TGTGCCAGCAGCCGTACTAGCGGGATTTTAACCGAGACCCAGTACTTC	CASSRTSGILTETQYF	TRBV3-1	TRBJ2-5
TGTGCCATCAGCGACAGGGGAGTGAACACTGAAGCTTTCTTT	CAISDRGVNTEAFF	TRBV10-3	TRBJ1-1
TGTGCCAGCAGCCAAGATCCACTAGCGGGAGGGCCGGGTCGGTCGTGGCGCCTTCCGAACACTGAAGCTTTCTTT	CASSQDPLAGGPGRSWRLPNTEAFF	TRBV3-1	TRBJ1-1
TGCGCCAGCAGCTTATCACAGGGCCCTCCGGTGGGCACAGATACGCAGTATTTT	CASSLSQGPPVGTDTQYF	TRBV5-1	TRBJ2-3
TGTGCCAGCAGCTTAGGCCGACAGGAGGTGGCCTACGAGCAGTACTTC	CASSLGRQEVAYEQYF	TRBV7-6	TRBJ2-7
TGTGCCAGCAGAGATCCGGCTATGGGCTCCTACGAGCAGTACTTC	CASRDPAMGSYEQYF	TRBV27	TRBJ2-7
TGCGCCAGCAGCCAAGTTCCCAGGGGGGGGGGGCGCACAGATACGCAGTATTTT	CASSQVPRGGGRTDTQYF	TRBV4-1	TRBJ2-3
TGTGCCAGCAGCACGGACAGTAACCGGTTCTCACCCCTCCACTTT	CASSTDSNRFSPLHF	TRBV7-3	TRBJ1-6
TGCAGTGCCCGAATGGACAGAGGCTACGAGCAGTACTTC	CSARMDRGYEQYF	TRBV20-1	TRBJ2-7
TGTGCCAGCAGCTTAGCGAAAAAACAGCTGTTCACCGGGGAGCTGTTTTTT	CASSLAKKQLFTGELFF	TRBV7-6	TRBJ2-2
TGTGCCAGCAGAGGTTTCGAGAAGGATGGAAACACCATATATTTT	CASRGFEKDGNTIYF	TRBV2	TRBJ1-3
TGTGCCAGCAGTGAAAGGGATCCTGAGACCCAGTACTTC	CASSERDPETQYF	TRBV6-1	TRBJ2-5
TGTGCCAGCAGTGATTCCAGCAACGAGATGGAGCTGAACACTGAAGCTTTCTTT	CASSDSSNEMELNTEAFF	TRBV6-1	TRBJ1-1
TGTGCCAGCAGTGCGAGCCTAGCGGGTAGTAGCAATGAGCAGTTCTTC	CASSASLAGSSNEQFF	TRBV28	TRBJ2-1
TGCGCCAGCAGCTTGCGAGACATACGTAACACTGAAGCTTTCTTT	CASSLRDIRNTEAFF	TRBV5-1	TRBJ1-1
TGTGCCTCAGCGGGATTGTGGACTGAAGCTTTCTTT	CASAGLWTEAFF	TRBV9	TRBJ1-1
TGTGCCAGCAGCCAAGTCAGGGGGGCCGTGGTTGAAAAACTGTTTTTT	CASSQVRGAVVEKLFF	TRBV14	TRBJ1-4
TGCAGTGCTAGCCAGGGGACTAGGATACGCTTACAAGAGACCCAGTACTTC	CSASQGTRIRLQETQYF	TRBV20-1	TRBJ2-5
TGTGCCAGCAGCCACGTTTTATACAGGAGGCCCACTAGCAATCAGCCCCAGCATTTT	CASSHVLYRRPTSNQPQHF	TRBV7-8	TRBJ1-5
TGTGCCAGCAGCTTAGAGCCGGTCCTCAGTCATTTCACTGAAGCTTTCTTT	CASSLEPVLSHFTEAFF	TRBV11-3	TRBJ1-1
TGCGCCAGCAGCCAAATGGAGCGTGACTCATGGCCCAAAAACATTCAGTACTTC	CASSQMERDSWPKNIQYF	TRBV4-1	TRBJ2-4
TGTGCCAGCAGTTCGTTCCTCCGTCCGGGACAGGTGGTAAACTATGGCTACACCTTC	CASSSFLRPGQVVNYGYTF	TRBV27	TRBJ1-2
TGTGCCAGCCTCGGGTCCTACAATGAGCAGTTCTTC	CASLGSYNEQFF	TRBV14	TRBJ2-1
TGTGCCTGGATTCGCCCGGGACGTTATGGCTACACCTTC	CAWIRPGRYGYTF	TRBV30	TRBJ1-2
TGCGCCAGCATCCGGGACAGGGAGAACAATCAGCCCCAGCATTTT	CASIRDRENNQPQHF	TRBV5-1	TRBJ1-5
TGTGCCAGCAGCTATTCTGAGACAGGGGTAAGAGGAATGAATGAAAAACTGTTTTTT	CASSYSETGVRGMNEKLFF	TRBV13	TRBJ1-4
TGTGCCAGCAGCAAGGGGGGAAAAGGTGAGCAGTTCTTC	CASSKGGKGEQFF	TRBV5-6	TRBJ2-1
TGTGCCAGCAGTGCCCAACCACCCTCGGGACTCAAGTTCGACGAGCAGTACTTC	CASSAQPPSGLKFDEQYF	TRBV28	TRBJ2-7
TGTGCCAGCAGCGGCCTAGAGGCCGCCTACAATGAGCAGTTCTTC	CASSGLEAAYNEQFF	TRBV7-7	TRBJ2-1
TGTGCCAGCATCTTCCGGACAGGGAACACTGAAGCTTTCTTT	CASIFRTGNTEAFF	TRBV6-5	TRBJ1-1
TGTGCCAGCAGCAGGGCGGACAGGGATGGCTACACCTTC	CASSRADRDGYTF	TRBV7-3	TRBJ1-2
TGTGCCATCAGTGTACGGCCGAAGTGGGGGGCCTCCTACGAGCAGTACTTC	CAISVRPKWGASYEQYF	TRBV10-3	TRBJ2-7
TGTGCCACCAGCAGAGACCCCGGAGGTTACAATGAGCAGTTCTTC	CATSRDPGGYNEQFF	TRBV15	TRBJ2-1
TGTGCCAGCAGGGGGGCCAACGAGAGAGACTATGGCTACACCTTC	CASRGANERDYGYTF	TRBV5-6	TRBJ1-2
TGTGCCAGCAGAGACAGGGATTCGGTCACCGGGGAGCTGTTTTTT	CASRDRDSVTGELFF	TRBV6-1	TRBJ2-2
TGCGCCAGCAGCTTGGACAGGGCCCTCCCTAGCAATCAGCCCCAGCATTTT	CASSLDRALPSNQPQHF	TRBV5-1	TRBJ1-5
TGTGCTAGTGGTTTGGTAGACCAACCAACTAATGAAAAACTGTTTTTT	CASGLVDQPTNEKLFF	TRBV12-5	TRBJ1-4
TGTGCCAGCAGTTACTCTGAACCAGGCTACACCTTC	CASSYSEPGYTF	TRBV6-3	TRBJ1-2
TGTGCCAGCAGTTCTAGCGGGCGTGGCTACAATGAGCAGTTCTTC	CASSSSGRGYNEQFF	TRBV2	TRBJ2-1
TGCGCCAGCAGGGACAGAAAAGAGACCCAGTACTTC	CASRDRKETQYF	TRBV5-1	TRBJ2-5
TGTGCCAGCTCAGGGAAAGTCCAGGAGACCCAGTACTTC	CASSGKVQETQYF	TRBV18	TRBJ2-5
TGTGCCCCTCATCCGACGGGGCGGGGCGACGGGTATGGCTACACCTTC	CAPHPTGRGDGYGYTF	TRBV5-6	TRBJ1-2
TGCGCCAGCAGCCAAAAAAACCCCGGCAGGGCCTACATCAACACCGGGGAGCTGTTTTTT	CASSQKNPGRAYINTGELFF	TRBV4-1	TRBJ2-2
TGTGCCAGCAGCTTAGCCTCCCTGGCCCAAAACATTCAGTACTTC	CASSLASLAQNIQYF	TRBV7-2	TRBJ2-4
TGCGCCAGCAGCTTGGTTAGCGGTGGCGGGACCCACTGCCAAGAGCAGTTCTTC	CASSLVSGGGTHCQEQFF	TRBV5-1	TRBJ2-1
TGTGCCAGCAGCTTAGGAGGCAGGGTGCAGAGAGTGTATGGCAGCACAGATACGCAGTATTTT	CASSLGGRVQRVYGSTDTQYF	TRBV7-9	TRBJ2-3
TGTGCCAGCAGCTGTATCCGCCGGCGGGGGCGCACAGATACGCAGTATTTT	CASSCIRRRGRTDTQYF	TRBV7-9	TRBJ2-3
TGTGCCAGCAGCCAAGGGGGAAGGAATCAGCCCCAGCATTTT	CASSQGGRNQPQHF	TRBV4-2	TRBJ1-5
TGTGCCAGCATGGGGAAAGGTAACCCTGACACTGAAGCTTTCTTT	CASMGKGNPDTEAFF	TRBV6-6	TRBJ1-1
TGTGCCACCAGCAGAGATGTGAAAAGACAGCCAAGGGACGACTACGAGCAGTACTTC	CATSRDVKRQPRDDYEQYF	TRBV15	TRBJ2-7
TGTGCCACCAGTGATTTGCCAAGGGATCCCGGGACAGGGGGCAGCACAGATACGCAGTATTTT	CATSDLPRDPGTGGSTDTQYF	TRBV24-1	TRBJ2-3
TGTGCCAGCTCACCGAAGACTAGCGGGGAGCAGTACTTC	CASSPKTSGEQYF	TRBV18	TRBJ2-7
TGTGCCAGCAGCCCAAGCGCAGGGGGCCTAGTCGAGCCCCAGCATTTT	CASSPSAGGLVEPQHF	TRBV5-4	TRBJ1-5
TGCAGTGCTAGAGAGAAGACAGGGCGGGGTTCTTGCTCCTACAATGAGCAGTTCTTC	CSAREKTGRGSCSYNEQFF	TRBV20-1	TRBJ2-1
TGTGCCAGCAGTGAACCTTCGGGGGAGGGACTGTTTTTT	CASSEPSGEGLFF	TRBV6-1	TRBJ1-4
TGTGCCAGCAGGGGGCCTGGGGCCAACGTCCTGACTTTC	CASRGPGANVLTF	TRBV27	TRBJ2-6
TGCAGTGCTACACGGAGAACCTCTGGGGCCAACGTCCTGACTTTC	CSATRRTSGANVLTF	TRBV20-1	TRBJ2-6
TGTGCCAGCAGCTTGAACCGGGTGAACATCACAGATACGCAGTATTTT	CASSLNRVNITDTQYF	TRBV5-8	TRBJ2-3
TGCGCCAGCAGTGAGAAACCAGGGAATTCCCCCACAGATACGCAGTATTTT	CASSEKPGNSPTDTQYF	TRBV10-1	TRBJ2-3
TGTGCCAGCAGCGAGGAACAGGGTGGAGAAAAACTGTTTTTT	CASSEEQGGEKLFF	TRBV5-8	TRBJ1-4
TGTGCCAGCAGCGCCCAGTCTGCCTTTAAGGGATCCTACGAGCAGTACTTC	CASSAQSAFKGSYEQYF	TRBV9	TRBJ2-7
TGCGCCAGCACCCACGCGCGCGGCTATAGGGGCTCCTACAATGAGCAGTTCTTC	CASTHARGYRGSYNEQFF	TRBV5-1	TRBJ2-1
TGTGCCAGCAGTGCTCAGGGTACCGGGGAGCTGTTTTTT	CASSAQGTGELFF	TRBV6-1	TRBJ2-2
TGTGCCTGTCGAGGTGAGACCCAGTACTTC	CACRGETQYF	TRBV30	TRBJ2-5
TGCGCCAGCAGCTTGCGGTTCCAGCGGGATAAGGGACACACTGAAGCTTTCTTT	CASSLRFQRDKGHTEAFF	TRBV5-1	TRBJ1-1
TGTGCCAGCAGCTTAGGTACCTACACAGAGCGCTACGAGCAGTACTTC	CASSLGTYTERYEQYF	TRBV7-9	TRBJ2-7
TGCAGCGTAGCCAGGGGGCGGGGGCTAGCCAAAAACATTCAGTACTTC	CSVARGRGLAKNIQYF	TRBV29-1	TRBJ2-4
TGTGCCAGCAGTTTAGTGGATTCCAGGGGGGATGGCTACACCTTC	CASSLVDSRGDGYTF	TRBV27	TRBJ1-2
TGCGCCACCACGTATCCACTGCTGGAATATGAGCAGTTCTTC	CATTYPLLEYEQFF	TRBV10-1	TRBJ2-1
TGTGCCACCAGTAGGGGACAGTCTAGCACTAGCACAGATACGCAGTATTTT	CATSRGQSSTSTDTQYF	TRBV24-1	TRBJ2-3
TGTGCCAGCAGCAACAAACAGCGACAGGGGGTTAATCAGCCCCAGCATTTT	CASSNKQRQGVNQPQHF	TRBV7-4	TRBJ1-5
TGTGCCAGCAGCTTCGGTCCGGGACAGTTTCGGAACACTGAAGCTTTCTTT	CASSFGPGQFRNTEAFF	TRBV6-1	TRBJ1-1
TGTGCCAGCTTAGAACAGGGCTATTCACCCCTCCACTTT	CASLEQGYSPLHF	TRBV7-8	TRBJ1-6
TGTGCCAGCAGCCACCCTTGGGGGCCTAACTATGAGCAGTTCTTC	CASSHPWGPNYEQFF	TRBV3-1	TRBJ2-1
TGTGCCAGCAGTGACGGGGCCAGGGGACCCCTGGCTAGGGACTTC	CASSDGARGPLARDF	TRBV6-1	TRBJ2-7
TGTGCCAGCTCACCACGGACAGCCGCGTTAGGTAATGAAAAACTGTTTTTT	CASSPRTAALGNEKLFF	TRBV18	TRBJ1-4
TGTGCCAGCAGACAAGATCTGGATGGTCGGGCTTTCTTT	CASRQDLDGRAFF	TRBV6-1	TRBJ1-1
TGTGCCAGCAGCCTCTGGGACAGGGGCCCGGGTCGAGGCTACACCTTC	CASSLWDRGPGRGYTF	TRBV13	TRBJ1-2
TGTGCCAGCAGCCAAGTGGTGGGACAGGGGACCAGGGGCTACGAGCAGTACTTC	CASSQVVGQGTRGYEQYF	TRBV14	TRBJ2-7
TGTGCCACCAGCCGTCCCCAGATTGCCAAGGGCTACACCTTC	CATSRPQIAKGYTF	TRBV15	TRBJ1-2
TGTGCCAGCAGCTGGCAGGGGCTGAACTATGGCTACACCTTC	CASSWQGLNYGYTF	TRBV7-6	TRBJ1-2
TGTGCCAGCAGAGAACTACTAGCGGGACCTAATGAGCAGTTCTTC	CASRELLAGPNEQFF	TRBV6-4	TRBJ2-1
TGCAGTGCTAGAGAGTTCGGACTAGCGGGTAACGAGCAGTACTTC	CSAREFGLAGNEQYF	TRBV20-1	TRBJ2-7
TGTGCCAGCTCACCAGTCAGGGGCTCGAGCAATCAGCCCCAGCATTTT	CASSPVRGSSNQPQHF	TRBV18	TRBJ1-5
TGTGCCAGCAGAACCGCGGGAGGAGGGGAAAATGAGCAGTTCTTC	CASRTAGGGENEQFF	TRBV6-3	TRBJ2-1
TGTGCCAGCAGTTTATCTAGGACAGGGCCTGTCGCGAACACCGGGGAGCTGTTTTTT	CASSLSRTGPVANTGELFF	TRBV28	TRBJ2-2
TGTGCCAGCAGTCTTGGTAAGACTAGCGGCAAGCTCCGCACAGATACGCAGTATTTT	CASSLGKTSGKLRTDTQYF	TRBV6-3	TRBJ2-3
TGTGCCAGCGTGACCCCCTACAGTGGGTACTATGGCTACACCTTC	CASVTPYSGYYGYTF	TRBV6-1	TRBJ1-2
TGTATTATGGTGGCAATCGGCAAACCGACCACAGATACGCAGTATTTT	CIMVAIGKPTTDTQYF	TRBV6-5	TRBJ2-3
TGTGCCAGCAGTGATACCGGGACATGGCGGAACACTGAAGCTTTCTTT	CASSDTGTWRNTEAFF	TRBV2	TRBJ1-1
TGTGCCAGCAGCTTGGGACGCCTGCCCTACGAGCAGTACTTC	CASSLGRLPYEQYF	TRBV7-3	TRBJ2-7
TGTGCCAGCAGCTTAGATTGGGCCCTATCACAGGGGGCCCACAGCATTCAGTACTTC	CASSLDWALSQGAHSIQYF	TRBV11-2	TRBJ2-4
TGTGCCAGCAGCGCGACAGGGCTCGCTTTCTTT	CASSATGLAFF	TRBV5-4	TRBJ1-1
TGTGCCAGCAGTTACGGAAACGACAGGGGAACCGACTATGGCTACACCTTC	CASSYGNDRGTDYGYTF	TRBV6-5	TRBJ1-2
TGTGCCACCAGTGATTTGTGTCTCCCCAGGGGCAACCCGCCCCAGCATTTT	CATSDLCLPRGNPPQHF	TRBV24-1	TRBJ1-5
TGTGCCAGCAGCCCATTCCAAGACGGGGCGGAATACTTC	CASSPFQDGAEYF	TRBV12-3	TRBJ2-4
TGCGCCAGCAGCCAAGCCAGGCGCAATCAGCCCCAGCATTTT	CASSQARRNQPQHF	TRBV4-1	TRBJ1-5
TGTGCCAGCAGCAGCCCTACACAGGGTTACACTGAAGCTTTCTTT	CASSSPTQGYTEAFF	TRBV9	TRBJ1-1
TGTGCCAGCAGCGTACAGGGCGTCTCAAATGAAAAACTGTTTTTT	CASSVQGVSNEKLFF	TRBV9	TRBJ1-4
TGTGCCAGCAGCCAAGATAAGTCTAGCGAGCAGTACTTC	CASSQDKSSEQYF	TRBV4-2	TRBJ2-7
TGTGCCAGCAGCTTACGGGGGGGGGACACCGGGGAGCTGTTTTTT	CASSLRGGDTGELFF	TRBV5-5	TRBJ2-2
TGTGCCAGCGTCGACAGGGGGAACGAGCAGTACTTC	CASVDRGNEQYF	TRBV6-4	TRBJ2-7
TGTGCCAGCAGTGGTCAGGGAAACAACACTGAAGCTTTCTTT	CASSGQGNNTEAFF	TRBV27	TRBJ1-1
TGTGCCAGCAGCCCTCCGGACAGGGCCGGGGAAAACACCGGGGAGCTGTTTTTT	CASSPPDRAGENTGELFF	TRBV13	TRBJ2-2
TGCAGTGCTACCCCGCAGGGGGGGGCAGATACGCAGTATTTT	CSATPQGGADTQYF	TRBV20-1	TRBJ2-3
TGTGCCAGCAGTTCGGCCCTCCCCCGGGGCCCGATAACCTCCTACAATGAGCAGTTCTTC	CASSSALPRGPITSYNEQFF	TRBV28	TRBJ2-1
TGTGCCAGCAGCTCCGTAGGGACAGTCACGCCTATTTGGACTGAAGCTTTCTTT	CASSSVGTVTPIWTEAFF	TRBV3-1	TRBJ1-1
TGTGCCAGCAGCTTACGAGGGGAAAGAACTAATGAAAAACTGTTTTTT	CASSLRGERTNEKLFF	TRBV7-2	TRBJ1-4
TGTGCCAGTAGCTCCCGGAGGAATAACCCGGGACAGGGTCACACTGAAGCTTTCTTT	CASSSRRNNPGQGHTEAFF	TRBV19	TRBJ1-1
TGTGCCAGCAGCCAAGAGAAGGGACCAGAGAACACTGAAGCTTTCTTT	CASSQEKGPENTEAFF	TRBV14	TRBJ1-1
TGTGCCAGCAGGCCCTTACTAGCGGGAGGTACCTACTATGGCTACACCTTC	CASRPLLAGGTYYGYTF	TRBV2	TRBJ1-2
TGTGCCAGGAGAGGGACAGGGTTTGCTCAGCCCCAGCATTTT	CARRGTGFAQPQHF	TRBV6-4	TRBJ1-5
TGTGCCAGCATAGAATTAGACTGCCCCTACGAGCAGTACTTC	CASIELDCPYEQYF	TRBV6-5	TRBJ2-7
TGTGCCAGAAACAGAGGGTACGAGCAGTACTTC	CARNRGYEQYF	TRBV11-2	TRBJ2-7
TGTGCCAGCAGCTCTTATGCTTCCGGGACTTGTAAGTCCTACGAGCAGTACTTC	CASSSYASGTCKSYEQYF	TRBV7-3	TRBJ2-7
TGTGCCACCAGTGATACCACTTGGGGGGGAAATGAGCAGTTCTTC	CATSDTTWGGNEQFF	TRBV24-1	TRBJ2-1
TGTGCCAGCAGCCAAGGCGATAAAGCCCAGTACTTC	CASSQGDKAQYF	TRBV14	TRBJ2-5
TGTGCCAGCAGCGGGGCGCCCCCCCTGGGTGGGGGCTACGAGCAGTACTTC	CASSGAPPLGGGYEQYF	TRBV13	TRBJ2-7
TGTGCCTGGAGTGTCTCTGGAAACACCATATATTTT	CAWSVSGNTIYF	TRBV30	TRBJ1-3
TGCGCCAGCAGAGGACAGGGCAATCAGCCCCAGCATTTT	CASRGQGNQPQHF	TRBV10-1	TRBJ1-5
TGTGCCAGCAGTGAAGTGAGCGGGAGGGCAGATACGCAGTATTTT	CASSEVSGRADTQYF	TRBV6-1	TRBJ2-3
TGCAGTGCTAGACAAGCCGGGACTAGCGGGACTTACAATGAGCAGTTCTTC	CSARQAGTSGTYNEQFF	TRBV20-1	TRBJ2-1
TGTGCCACTGGGGGACTAGCGTCCTTCTTC	CATGGLASFF	TRBV15	TRBJ2-1
TGTGCCACCAGTGATTTGCATGCCAGGGACGTCGGGCAAAGAGTTCGGAATGAAAAACTGTTTTTT	CATSDLHARDVGQRVRNEKLFF	TRBV24-1	TRBJ1-4
TGTGCCAAATATCTCGACAGAAGAGGGACAGATACGCAGTATTTT	CAKYLDRRGTDTQYF	TRBV27	TRBJ2-3
TGTGCCAGCAGTATCGAGGGTGAGACCCAGTACTTC	CASSIEGETQYF	TRBV6-4	TRBJ2-5
TGCAGCGTTGCTTATCTCCCGGGGCCCAACTATGGCTACACCTTC	CSVAYLPGPNYGYTF	TRBV29-1	TRBJ1-2
TGTGCCAGCAGCCAAGATGGGGTTAGCGGGACGGTCGACGAGCAGTACTTC	CASSQDGVSGTVDEQYF	TRBV14	TRBJ2-7
TGCAGTGCTAGAAACCCCAATGGGGGGACAGGGGCCTCTGGAAACACCATATATTTT	CSARNPNGGTGASGNTIYF	TRBV20-1	TRBJ1-3
TGTGCCAGTAGTACCGGATTCAGCGCGATGGCCTACGAGCAGTACTTC	CASSTGFSAMAYEQYF	TRBV19	TRBJ2-7
TGTGCCAGCGTCAGGGGGGCCGGTAATGAGCAGTTCTTC	CASVRGAGNEQFF	TRBV5-8	TRBJ2-1
TGTGCCAGCAGTTTTCCAACCGGGCGGAAGGACAGAGCGAACACTGAAGCTTTCTTT	CASSFPTGRKDRANTEAFF	TRBV6-5	TRBJ1-1
TGTGCCAGCCCCTTTAAGACCCAGTACTTC	CASPFKTQYF	TRBV5-8	TRBJ2-5
TGTGCCAGCAGCTTACCATCCGGACCACATAACTATGGCTACACCTTC	CASSLPSGPHNYGYTF	TRBV6-5	TRBJ1-2
TGTGCCAGCAGTTCTGCAGGGCCCTGTTTGAGCTCCTACGAGCAGTACTTC	CASSSAGPCLSSYEQYF	TRBV2	TRBJ2-7
TGCAGTGAGAAAGGCCTAGCGGATCCCCCAAAGGATGTAGCCAAAAACATTCAGTACTTC	CSEKGLADPPKDVAKNIQYF	TRBV20-1	TRBJ2-4
TGTGCTAGTGGTTTCTTGGGGGGACAAGAGACCCAGTACTTC	CASGFLGGQETQYF	TRBV12-5	TRBJ2-5
TGTGCCAGCAGTGACCTTTGGACAGGGACCTCCTACGAGCAGTACTTC	CASSDLWTGTSYEQYF	TRBV6-1	TRBJ2-7
TGTGCCAGCAGTGAAGCGGGGACAGGGCGGGCACAGCCCCAGCATTTT	CASSEAGTGRAQPQHF	TRBV6-1	TRBJ1-5
TGTGCCACCCTTAGGAGAGGGGGGGATAGCAATCAGCCCCAGCATTTT	CATLRRGGDSNQPQHF	TRBV24-1	TRBJ1-5
TGTGCCAGCAGGATCGGCAGGGGGAATGGCACTGAAGCTTTCTTT	CASRIGRGNGTEAFF	TRBV27	TRBJ1-1
TGCGCCCGCCGACAGGGGGGCTCTGGGGCCAACGTCCTGACTTTC	CARRQGGSGANVLTF	TRBV5-1	TRBJ2-6
TGTGCCACCATCCCCGGGCTAGAATTATTCGAGCAGTACTTC	CATIPGLELFEQYF	TRBV24-1	TRBJ2-7
TGTGCCAGCAGTTTCCCCTCGTCAAGGTCACCCTGGCCCTACGAGCAGTACTTC	CASSFPSSRSPWPYEQYF	TRBV27	TRBJ2-7
TGTGCCAGCAGTCAAGCAACGGGGGGCAATGAGCAGTTCTTC	CASSQATGGNEQFF	TRBV7-9	TRBJ2-1
TGCGCCAGCAGCGCAGGGGGCCTGGCTGGGGCCAACGTCCTGACTTTC	CASSAGGLAGANVLTF	TRBV5-1	TRBJ2-6
TGTGCCAGCAGGAGGCCGCGCCCCGTGACCTTTATAGAGCCCCAGCATTTT	CASRRPRPVTFIEPQHF	TRBV7-9	TRBJ1-5
TGTGCCAGCAGCGTGGAGGTGGACAGGGATAATAGCTCCTACGAGCAGTACTTC	CASSVEVDRDNSSYEQYF	TRBV6-2	TRBJ2-7
TGTGCCAGTAGTATCTCCGGCTGGACAGGCCGGTTAAGCTCCTACAATGAGCAGTTCTTC	CASSISGWTGRLSSYNEQFF	TRBV19	TRBJ2-1
TGCAGTGCTAGAGGGGAAACAGAGACCCAGTACTTC	CSARGETETQYF	TRBV20-1	TRBJ2-5
TGCGCCAGCAGCTGGACAGGGGGGTACTTC	CASSWTGGYF	TRBV5-1	TRBJ2-4
TGTGCCAGCAGCACCCAGGGGGGGCGACATTCGAACACTGAAGCTTTCTTT	CASSTQGGRHSNTEAFF	TRBV9	TRBJ1-1
TGTGCCAGCAGTCTTCGCCCGGGACTAGCGGGGGGCATGACAGATACGCAGTATTTT	CASSLRPGLAGGMTDTQYF	TRBV27	TRBJ2-3
TGCAGCTTGACCCCCGGGACAATCTCTGGAAACACCATATATTTT	CSLTPGTISGNTIYF	TRBV29-1	TRBJ1-3
TGTGCCTGGAGTCGGGGCGTTAATGGGGCCAACGTCCTGACTTTC	CAWSRGVNGANVLTF	TRBV30	TRBJ2-6
TGCGCCAGCAGCTTGATTCTTAACTACAATGAGCAGTTCTTC	CASSLILNYNEQFF	TRBV5-1	TRBJ2-1
TGTGCCAGCAGCTTAGCAAACACCTACAATGAGCAGTTCTTC	CASSLANTYNEQFF	TRBV7-8	TRBJ2-1
TGCGCCAGCACCTCGGGGTACGAGCAGTACTTC	CASTSGYEQYF	TRBV5-1	TRBJ2-7
TGCAGTGCTAGCGAGACCCCCTGGGGGGTAGTTGACGTCCTGACTTTC	CSASETPWGVVDVLTF	TRBV20-1	TRBJ2-6
TGTGCCAGCAAGTTAGGGGCGCCTAGTGGCTACACCTTC	CASKLGAPSGYTF	TRBV5-5	TRBJ1-2
TGTGCCACCAGCAGTGGCTATGGCTACACCTTC	CATSSGYGYTF	TRBV15	TRBJ1-2
TGTGCCAGCAGCTTAATTACGGACAGGGTTGATCAGCCCCAGCATTTT	CASSLITDRVDQPQHF	TRBV11-3	TRBJ1-5
TGTGCCAGCATTCCCCAGGGATGTGATGGCTACACCTTC	CASIPQGCDGYTF	TRBV6-4	TRBJ1-2
TGCGCCAGCCAGACTAAGTGCAATGAGCAGTTCTTC	CASQTKCNEQFF	TRBV5-1	TRBJ2-1
TGTGCCAGCAGCAGGACAGGGTACCAAGAGACCCAGTACTTC	CASSRTGYQETQYF	TRBV9	TRBJ2-5
TGTGCCAGCAGCTTAATGGAGGGGAACTCAGATACGCAGTATTTT	CASSLMEGNSDTQYF	TRBV7-2	TRBJ2-3
TGTGCCAGCCCAACCAGGACCAGGCCGCAAGCTTTCTTT	CASPTRTRPQAFF	TRBV12-4	TRBJ1-1
TGTGCCAGCAGATATCGTGAAAAACTGTTTTTT	CASRYREKLFF	TRBV6-4	TRBJ1-4
TGTGCCAGCAGCTTTCTCGCGGAAGGGGGGATAGCCAAAAACATTCAGTACTTC	CASSFLAEGGIAKNIQYF	TRBV7-4	TRBJ2-4
TGTGCCAGGGAAAGCTGGGGACAGGAGGGGCATTTT	CARESWGQEGHF	TRBV9	TRBJ1-5
TGTGCCAGCAGCCTCGACTTCGGAGATACGCAGTATTTT	CASSLDFGDTQYF	TRBV7-9	TRBJ2-3
TGTGCCAGCAGCTTGAATGTTCCGGGTGGACGGCAGCCCCAGCATTTT	CASSLNVPGGRQPQHF	TRBV7-8	TRBJ1-5
TGTGCCAGCAGATCGCTTCAAATTAACGAGCAGTACTTC	CASRSLQINEQYF	TRBV27	TRBJ2-7
TGTGCCAGCAGTCCGAGGAAGCTAGATACGCAGTATTTT	CASSPRKLDTQYF	TRBV28	TRBJ2-3
TGCGCCAGCAGCTTGGGACCAGGGGTCCAGGAGGATTCACCCCTCCACTTT	CASSLGPGVQEDSPLHF	TRBV5-1	TRBJ1-6
TGTGCCAGCAGCTTAGCCCGGCGGGACTACGAGCAGTACTTC	CASSLARRDYEQYF	TRBV7-6	TRBJ2-7
TGCGCCTCCGACTGGGGAAAACAGCCCCAGCATTTT	CASDWGKQPQHF	TRBV10-1	TRBJ1-5
TGTGCCAGCAGCTTGGGCAGGGGGGAAGGAACCAGTCGCAATCAGCCCCAGCATTTT	CASSLGRGEGTSRNQPQHF	TRBV7-6	TRBJ1-5
TGTGCCAGCAGTTGTAGCCGGGACAGAATGAACACTGAAGCTTTCTTT	CASSCSRDRMNTEAFF	TRBV27	TRBJ1-1
TGTGCCAGCAGTGTTCGCGGGGACAGCTTGGGAGGTGGCTACACCTTC	CASSVRGDSLGGGYTF	TRBV6-4	TRBJ1-2
TGCGCCAGCAGCCACCCCCTACCCCCGGGGGCAGCAATTAATGAGCAGTTCTTC	CASSHPLPPGAAINEQFF	TRBV4-1	TRBJ2-1
TGCAGCGTTGATAGCGGGGGGAGAGACAATCAGCCCCAGCATTTT	CSVDSGGRDNQPQHF	TRBV29-1	TRBJ1-5
TGTGCCAGCAGTAATGGTCCCACAGGGGGCTCGTTCTTTAACTATGGCTACACCTTC	CASSNGPTGGSFFNYGYTF	TRBV12-4	TRBJ1-2
TGTGCCAGCAGCTTAACGGGGCCCGAGCCGCAGTTCTTC	CASSLTGPEPQFF	TRBV7-3	TRBJ2-1
TGCGCCAGCAGCCAAGATAGCGGGTCGGAACAAGAGACCCAGTACTTC	CASSQDSGSEQETQYF	TRBV4-1	TRBJ2-5
TGTGCCACCAGTGATTTGCCTCTCGAAAAGTGGTATAGCAATCAGCCCCAGCATTTT	CATSDLPLEKWYSNQPQHF	TRBV24-1	TRBJ1-5
TGTGCCATCAGTGTTCGACAGGGGCCCAGCAATCAGCCCCAGCATTTT	CAISVRQGPSNQPQHF	TRBV10-3	TRBJ1-5
TGTGCCAGCAGCCCTTTCTACGAGCAGTACTTC	CASSPFYEQYF	TRBV13	TRBJ2-7
TGTGCCAGCAGCGAAACGACGGGACCCATTGGAAACACCATATATTTT	CASSETTGPIGNTIYF	TRBV7-9	TRBJ1-3
TGCAGTGCTAGGAGGGGACCTGGGGCCAACGTCCTGACTTTC	CSARRGPGANVLTF	TRBV20-1	TRBJ2-6
TGTGCCAGCTCCGGGGGTTGTGAGCAGTACTTC	CASSGGCEQYF	TRBV7-9	TRBJ2-7
TGTGCCAGCCCCCCCGATCAGGCCAATTCACCCCTCCACTTT	CASPPDQANSPLHF	TRBV6-1	TRBJ1-6
TGTGCCAGCAGACGGACAGGGGATGGGGCTGAAGCTTTCTTT	CASRRTGDGAEAFF	TRBV28	TRBJ1-1
TGTGCCAGCAGCTTAGGGAGAGGCGACAGGGATCAGCCCCAGCATTTT	CASSLGRGDRDQPQHF	TRBV7-9	TRBJ1-5
TGTGCCAGCAGCGGCCAGCAACGGAACACTGAAGCTTTCTTT	CASSGQQRNTEAFF	TRBV7-9	TRBJ1-1
TGTGCCAGCTCACCACACCGCGACAGGAGGTATAGCAATCAGCCCCAGCATTTT	CASSPHRDRRYSNQPQHF	TRBV18	TRBJ1-5
TGTGCCAGCAGTTTATGCCGGGAGGCCGGCTACGAGCAGTACTTC	CASSLCREAGYEQYF	TRBV27	TRBJ2-7
TGTGCCAGCAGCTTAGATGGACAGGTATCAACTAATGAAAAACTGTTTTTT	CASSLDGQVSTNEKLFF	TRBV7-4	TRBJ1-4
TGCAGTGCTAGAGCTTTATTGAAGGGACTTAGTGGCAATCAGCCCCAGCATTTT	CSARALLKGLSGNQPQHF	TRBV20-1	TRBJ1-5
TGTGCCAGCAGAGAGGGACAGGCACTCTCCTACGAGCAGTACTTC	CASREGQALSYEQYF	TRBV12-3	TRBJ2-7
TGTGCCAGTAGTACTCTCAGAGCCTACGAGCAGTACTTC	CASSTLRAYEQYF	TRBV19	TRBJ2-7
TGTGCCAGCAGCGTCCTCGGGGTGCAAGAGACCCAGTACTTC	CASSVLGVQETQYF	TRBV9	TRBJ2-5
TGCGCCAGCGGGGACAATGAGACTGAAGCTTTCTTT	CASGDNETEAFF	TRBV4-1	TRBJ1-1
TGTGCCAGCAGTTTCCGGGCCAGTGAACAGCCCCAGCATTTT	CASSFRASEQPQHF	TRBV2	TRBJ1-5
TGCGCCAGCAGCTCCGGGGGCCCGGAAAACATTCAGTACTTC	CASSSGGPENIQYF	TRBV5-1	TRBJ2-4
TGTGCCTGTTCACCTAGGGGGGACAGCTCTGGGGCCAACGTCCTGACTTTC	CACSPRGDSSGANVLTF	TRBV30	TRBJ2-6
TGTGCCAGCAGCTTAGAGCGACTAGTCGAGCAGTACTTC	CASSLERLVEQYF	TRBV11-2	TRBJ2-7
TGTGCCAGCAGCGGCCTCGAGAGGCCACCCCGGTACCAAGAGACCCAGTACTTC	CASSGLERPPRYQETQYF	TRBV7-9	TRBJ2-5
TGTGCCAGCAGCACTTTAGCGGGCCAAGAGACCCAGTACTTC	CASSTLAGQETQYF	TRBV3-1	TRBJ2-5
TGTGCTAGTGGTTTGGTACGGGTAAACAGGGTCACTGAAGCTTTCTTT	CASGLVRVNRVTEAFF	TRBV12-5	TRBJ1-1
TGCGCCAGCAGCCATATGGGACAGGCTTTCTTT	CASSHMGQAFF	TRBV4-1	TRBJ1-1
TGTGCCAGCAGCACGGGACAGGACTATGGCTACACCTTC	CASSTGQDYGYTF	TRBV11-2	TRBJ1-2
TGCAGCGCAGCAATCGAAAAACTGTTTTTT	CSAAIEKLFF	TRBV29-1	TRBJ1-4
TGTGCCAGCAGCTTATCGCGTGAGGACGAGCAGTACTTC	CASSLSREDEQYF	TRBV5-8	TRBJ2-7
TGTGCCAGCGACATTGCGTTAAGGACAGGGGGCCCAAATCGGGGCTATGGCTACACCTTC	CASDIALRTGGPNRGYGYTF	TRBV2	TRBJ1-2
TGTGCCAGCACCTCCATTGGCCAGCGCCAAAACTATGGCTACACCTTC	CASTSIGQRQNYGYTF	TRBV2	TRBJ1-2
TGCAGTGCTAGAGCGGTATCCGGGACTAGCGGGCACATACCCACCTACGAGCAGTACTTC	CSARAVSGTSGHIPTYEQYF	TRBV20-1	TRBJ2-7
TGCGCCAGCAGCTGCGGAGGACCGAAGAGCTACGAGCAGTACTTC	CASSCGGPKSYEQYF	TRBV5-1	TRBJ2-7
TGTGCCAGCTCCTCTTCTAGCGGGGGCACCGGGGAGCTGTTTTTT	CASSSSSGGTGELFF	TRBV18	TRBJ2-2
TGTGCCAGCAGCTTAAGAACACGGGACCTAGAGACCCAGTACTTC	CASSLRTRDLETQYF	TRBV7-3	TRBJ2-5
TGTGCCAGCAGCCTGAGGACAGGGGGGTCTCAGCCCCAGCATTTT	CASSLRTGGSQPQHF	TRBV14	TRBJ1-5
TGTGCCAGCAGCGCGGGGTTGGACACTGAAGCTTTCTTT	CASSAGLDTEAFF	TRBV5-4	TRBJ1-1
TGTGCCAGCACAAGGGGCTCTGGAAACACCATATATTTT	CASTRGSGNTIYF	TRBV5-4	TRBJ1-3
TGTGCCTGGAGTGTACCCCGGACCTACACTGAAGCTTTCTTT	CAWSVPRTYTEAFF	TRBV30	TRBJ1-1
TGCAGCGTTGTGTCAGGGGGTGAAAAACTGTTTTTT	CSVVSGGEKLFF	TRBV29-1	TRBJ1-4
TGTGCTAGTGGTTTGGCCGCGGGGGATTACACAGATACGCAGTATTTT	CASGLAAGDYTDTQYF	TRBV12-5	TRBJ2-3
TGTGCCAGCAAAGGAACCAGGGCTAACTATGGCTACACCTTC	CASKGTRANYGYTF	TRBV6-1	TRBJ1-2
TGTGCCAGCAGCGGGGGGGCACCAGGCAATTCACCCCTCCACTTT	CASSGGAPGNSPLHF	TRBV7-9	TRBJ1-6
TGTGCCACCAGCACAGGAGGAGAGACCACCGGGGAGCTGTTTTTT	CATSTGGETTGELFF	TRBV15	TRBJ2-2
TGTGCCAGCGTCTTAACAGGGGTGATTTATGGCTACACCTTC	CASVLTGVIYGYTF	TRBV6-5	TRBJ1-2
TGTGCCAGCAGCAGGACAAGCTACAATGAGCAGTTCTTC	CASSRTSYNEQFF	TRBV7-4	TRBJ2-1
TGTGCCAGCAGCCGTCCAACGACAGGGGTGGGGTATAGCAATCAGCCCCAGCATTTT	CASSRPTTGVGYSNQPQHF	TRBV6-5	TRBJ1-5
TGTGCCAGCAGCACGGTTTCACCCGGCCAAACAGATACGCAGTATTTT	CASSTVSPGQTDTQYF	TRBV7-9	TRBJ2-3
TGCGCCAGCAGTGAGCGAGATCTAGGGAACACTGAAGCTTTCTTT	CASSERDLGNTEAFF	TRBV10-1	TRBJ1-1
TGTGCCAGCAGGGACAGGGGAAGCTCTGGGGCCAACGTCCTGACTTTC	CASRDRGSSGANVLTF	TRBV6-3	TRBJ2-6
TGTGCCAGCAGTTACCGAGACCCCGAAAGCGCCGGGACAGGGCGGGTCTACGAGCAGTACTTC	CASSYRDPESAGTGRVYEQYF	TRBV6-5	TRBJ2-7
TGTGCCAGCAGTTCCGGGGGAAACTGCACAGATACGCAGTATTTT	CASSSGGNCTDTQYF	TRBV6-3	TRBJ2-3
TGTGCCAGCAGCGGACGCCAGTACACTAGCGGGAGGGGGGAGCAGTACTTC	CASSGRQYTSGRGEQYF	TRBV13	TRBJ2-7
TGTGCCAGCAGCGAGACAGGGAGGGGATTCTGTGGCTACACCTTC	CASSETGRGFCGYTF	TRBV7-2	TRBJ1-2
TGCGCCAGCAGCTCGGAGCTTAGGGGGCAATTACGAGACGAGCAGTACTTC	CASSSELRGQLRDEQYF	TRBV5-1	TRBJ2-7
TGTGCCAGCACGACGGACCAGTTGTTACCCCTCCACTTT	CASTTDQLLPLHF	TRBV28	TRBJ1-6
TGTGCCAGCAGCCAAGAAACGGGTAGAACCTACGAGCAGTACTTC	CASSQETGRTYEQYF	TRBV14	TRBJ2-7
TGTGCCACCAGCAGCGGTGCCCTGGGACTAGCGGGGGCGTACCAAGAGACCCAGTACTTC	CATSSGALGLAGAYQETQYF	TRBV15	TRBJ2-5
TGTGCCTGGAGTGCTACGGGACAGGGGACAGAGACCCAGTACTTC	CAWSATGQGTETQYF	TRBV30	TRBJ2-5
TGCGCCAGCAGCTCCGAAGGCTCTGGGGCCAACGTCCTGACTTTC	CASSSEGSGANVLTF	TRBV5-1	TRBJ2-6
TGCGCCAGCAGTAGACTTAAGGACAGGGCTGAAGAAAAACTGTTTTTT	CASSRLKDRAEEKLFF	TRBV10-1	TRBJ1-4
TGCGCCAGCAGCCAAGCCCGGGGGCCCGTCTATGGCTACACCTTC	CASSQARGPVYGYTF	TRBV4-3	TRBJ1-2
TGTGCCACCAGTAGGTTCGTTCCAGCGGGAGCAAGCTCCTACGAGCAGTACTTC	CATSRFVPAGASSYEQYF	TRBV24-1	TRBJ2-7
TGTGCCAGCAGCTTGCGGAACAGGGACAGGCCCAAGGTGCCTCAGAACACTGAAGCTTTCTTT	CASSLRNRDRPKVPQNTEAFF	TRBV5-6	TRBJ1-1
TGTGCCAGCAGTTTTGGGAAGGACAGGGGTGTAGACACAGATACGCAGTATTTT	CASSFGKDRGVDTDTQYF	TRBV12-4	TRBJ2-3
TGTGCCAGCAGAAGCCCGACAGAAGGAAATGAAAAACTGTTTTTT	CASRSPTEGNEKLFF	TRBV6-2	TRBJ1-4
TGTGCCACCAGGAGCGATACGCAGTATTTT	CATRSDTQYF	TRBV24-1	TRBJ2-3
TGTGCCAGCAGTTCCCGAACCAAGACTAGCGGCATTTTCTACAATGAGCAGTTCTTC	CASSSRTKTSGIFYNEQFF	TRBV6-3	TRBJ2-1
TGTGCCAGCAGTGTACGCAGGGGGCTTGGCGCCTACGAGCAGTACTTC	CASSVRRGLGAYEQYF	TRBV6-6	TRBJ2-7
TGCAGTGCTAGAGCCCCCGGGGGGGCCGGGGTTTACTACAATGAGCAGTTCTTC	CSARAPGGAGVYYNEQFF	TRBV20-1	TRBJ2-1
TGTGCCAGCAGTACCCAGGGGGCCTCTAACTATGGCTACACCTTC	CASSTQGASNYGYTF	TRBV28	TRBJ1-2
TGTGCCAGCAGCTTCTGGGGGGGGACTGACGAGCAGTACTTC	CASSFWGGTDEQYF	TRBV7-2	TRBJ2-7
TGTGCCAGCAGCGTAGGGCTAGCGGTATCCAATGAGCAGTTCTTC	CASSVGLAVSNEQFF	TRBV9	TRBJ2-1
TGTGCCAGCAGCTGGCTGATTCCCTGGGGCTACACCTTC	CASSWLIPWGYTF	TRBV7-9	TRBJ1-2
TGTGGGGGGGTCGTCTACGAGCAGTACTTC	CGGVVYEQYF	TRBV19	TRBJ2-7
TGTGCCAGCAGTGACTCGAGGGGAGACAGGGAGCGGGATACGCAGTATTTT	CASSDSRGDRERDTQYF	TRBV6-4	TRBJ2-3
TGTGCCAGCAAGGGGACAGGGGAACTAAAACTGTTTTTT	CASKGTGELKLFF	TRBV6-4	TRBJ1-4
TGTGCCAGCAGCTTTTTGACAGGGGGGGATCAGCCCCAGCATTTT	CASSFLTGGDQPQHF	TRBV13	TRBJ1-5
TGCGCCAGCAGTTTAACTCTAGCTTTCTTT	CASSLTLAFF	TRBV10-2	TRBJ1-1
TGTGCCAGCAGCCAAGTTGGAGCGTCACCCCTCCACTTT	CASSQVGASPLHF	TRBV14	TRBJ1-6
TGTGCCAGCAGCTCAGGGCGGAATTCACCCCTCCACTTT	CASSSGRNSPLHF	TRBV7-3	TRBJ1-6
TGTGCCAGCAGCCATCCGGGGGAATTAGACTACGAGCAGTACTTC	CASSHPGELDYEQYF	TRBV14	TRBJ2-7
TGCGCCACCCGAAGGCCCGGGGACATACAGCCCCAGCATTTT	CATRRPGDIQPQHF	TRBV5-1	TRBJ1-5
TGTGCTAGTGGTTTGACCCGCAGTAGGACTGAAGCTTTCTTT	CASGLTRSRTEAFF	TRBV12-5	TRBJ1-1
TGCGCCAGCAGCGGTGGGAGGGGAGGCGACAATGAGCAGTTCTTC	CASSGGRGGDNEQFF	TRBV5-1	TRBJ2-1
TGCGCCAGCAGCTTGAGATTTCGGGGGGAGCCGCAAGAGACCCAGTACTTC	CASSLRFRGEPQETQYF	TRBV5-1	TRBJ2-5
TGTGCCAGCAGTGCACCGGGACAGGGTTTAGAGCAGTACTTC	CASSAPGQGLEQYF	TRBV6-4	TRBJ2-7
TGCGCCAGCAGCACTAGCGGGAGGGCGCTAAATGAGCAGTTCTTC	CASSTSGRALNEQFF	TRBV5-1	TRBJ2-1
TGCAGTGCTAGAAAGGACAGGGCCTACGAGCAGTACTTC	CSARKDRAYEQYF	TRBV20-1	TRBJ2-7
TGCGCCAGCAGTGAGCTCCTGGCCCCCCGTTCACCCCTCCACTTT	CASSELLAPRSPLHF	TRBV10-2	TRBJ1-6
TGTGCCAGCAGTTTATCTCCTAGCGGGTGTTTCTTC	CASSLSPSGCFF	TRBV12-4	TRBJ2-7
TGTGCCAGCAGTGAGAAGAGCCCGCGGGTCTGGCCAAGCACAGATACGCAGTATTTT	CASSEKSPRVWPSTDTQYF	TRBV25-1	TRBJ2-3
TGCAGTGCGAAAAGCGGGAACATGAGGCGGGAGGAAGCTTTCTTT	CSAKSGNMRREEAFF	TRBV20-1	TRBJ1-1
TGCAGTGCTAGAGATATTCCCCCTACCCGGTCAGCCCCAAACACCGGGGAGCTGTTTTTT	CSARDIPPTRSAPNTGELFF	TRBV20-1	TRBJ2-2
TGTGCCAGCAGACTCCAGCGAGGGTTAGCTAACTATGGCTACACCTTC	CASRLQRGLANYGYTF	TRBV6-5	TRBJ1-2
TGTGCCAATAGGGGTTCCATCGACGAGCAGTACTTC	CANRGSIDEQYF	TRBV6-6	TRBJ2-7
TGCGCCAGCAGCTTGGGGGAAAAACTGTTTTTT	CASSLGEKLFF	TRBV5-1	TRBJ1-4
TGTGCCAGCTCACCGGACAACAGCAATGAAAAACTGTTTTTT	CASSPDNSNEKLFF	TRBV18	TRBJ1-4
TGTGCCAGCAAGCGCCGGGGGGACGAGCAGTACTTC	CASKRRGDEQYF	TRBV6-2	TRBJ2-7
TGTGCCAGCAGCAGGGGAGAGGCTTTCTTT	CASSRGEAFF	TRBV7-3	TRBJ1-1
TGTGCCAGCAGCAGCCGGGGACCTAGCGGGGAGGTAACGCGGACAGAGGGGGAGCTGTTTTTT	CASSSRGPSGEVTRTEGELFF	TRBV7-9	TRBJ2-2
TGTGCCAGCAGTGGGACTAGCGTTGGGTACAATGAGCAGTTCTTC	CASSGTSVGYNEQFF	TRBV27	TRBJ2-1
TGTGCCAGCAGCTTAGCCCGTCGGACAGGGGGCACCATGAACACTGAAGCTTTCTTT	CASSLARRTGGTMNTEAFF	TRBV7-4	TRBJ1-1
TGTGCCAGCAGTGCCTCCCCCGACAGCGGCTATGGCTACACCTTC	CASSASPDSGYGYTF	TRBV25-1	TRBJ1-2
TGCGCCAGCAGCCAAGTGACAGGCGAAAAACTGTTTTTT	CASSQVTGEKLFF	TRBV4-1	TRBJ1-4
TGTGCCAGCAGCCAAGAGTTACTAGCGGGAGATGAGCAGTTCTTC	CASSQELLAGDEQFF	TRBV14	TRBJ2-1
TGTGCCAGCAGTTATAGACCCGGGACCAGCTCCTACAATGAGCAGTTCTTC	CASSYRPGTSSYNEQFF	TRBV6-5	TRBJ2-1
TGTGCCAGCGAGCCGGACGGAATGAACACTGAAGCTTTCTTT	CASEPDGMNTEAFF	TRBV12-3	TRBJ1-1
TGCAGTGCAAACTATGTACCGGGGTACCTCTTTATCAGGGGCGAGCAGTACTTC	CSANYVPGYLFIRGEQYF	TRBV20-1	TRBJ2-7
TGCGCCAGCAGCCAAGATAAGGGGCTGGGGAATAAGTACTACGAGCAGTACTTC	CASSQDKGLGNKYYEQYF	TRBV4-3	TRBJ2-7
TGTGCCAGTAGTATATTCGAAGGGGTTTCGGGCAGTGAAGCTTTCTTT	CASSIFEGVSGSEAFF	TRBV19	TRBJ1-1
TGCAGTGCTAGCCGGTCTCCCCGGGACAGGGGTCCAGCTAACTATGGCTACACCTTC	CSASRSPRDRGPANYGYTF	TRBV20-1	TRBJ1-2
TGTGCCACTTTTCGACGGCTGACCGGGGAGCTGTTTTTT	CATFRRLTGELFF	TRBV24-1	TRBJ2-2
TGTGCCAGCAGAATGATACAGGGACTACCCTACGAGCAGTACTTC	CASRMIQGLPYEQYF	TRBV27	TRBJ2-7
TGCGCCAGCAGCCAAGCTTATTCCAGGGTTTACACAGATACGCAGTATTTT	CASSQAYSRVYTDTQYF	TRBV4-1	TRBJ2-3
TGTGCCAGTAGTAGGGAGGAGGGTTACGAGCAGTACTTC	CASSREEGYEQYF	TRBV19	TRBJ2-7
TGTGCCAGCAGTTACATTTATATCGAGGATGAAGAGACCCAGTACTTC	CASSYIYIEDEETQYF	TRBV6-5	TRBJ2-5
TGTGCCAGCAGCCTACAGAGTAGCAATCAGCCCCAGCATTTT	CASSLQSSNQPQHF	TRBV13	TRBJ1-5
TGTGCCGGACCGAACAGGGGGCACTATGGCTACACCTTC	CAGPNRGHYGYTF	TRBV19	TRBJ1-2
TGTGCCAGCAGCAGCCGGGACACGACTGAAGCTTTCTTT	CASSSRDTTEAFF	TRBV7-9	TRBJ1-1
TGCGCCAGCCGAGTAGCGGGGAGCTCCTACGAGCAGTACTTC	CASRVAGSSYEQYF	TRBV5-1	TRBJ2-7
TGTGCCAGCAGTTGGGAGGGGGCTACTTGGATGGGACGCTACACCTTC	CASSWEGATWMGRYTF	TRBV28	TRBJ1-2
TGTGCCAGCAGCTTAAAGCTCGTGGGGGCGTCCACAGATACGCAGTATTTT	CASSLKLVGASTDTQYF	TRBV7-2	TRBJ2-3
TGTGCCAGCAGCCAAGATCGCAAGGACAGATCGTTGAACACTGAAGCTTTCTTT	CASSQDRKDRSLNTEAFF	TRBV3-1	TRBJ1-1
TGTGCCAGCGGACTAGCGGGCGCAGAGCAGTTCTTC	CASGLAGAEQFF	TRBV28	TRBJ2-1
TGTGCCAGCAGCTTCCTCGACGGGGGGACAGATACGCAGTATTTT	CASSFLDGGTDTQYF	TRBV7-9	TRBJ2-3
TGCAGTGCTAGGTGTCAGGGGGAGTGGAGTAAGTCTAATTCACCCCTCCACTTT	CSARCQGEWSKSNSPLHF	TRBV20-1	TRBJ1-6
TGTGCCAGCACCCCTACCGGGACAGGGGGCCTTAACGAGACCCAGTACTTC	CASTPTGTGGLNETQYF	TRBV6-1	TRBJ2-5
TGCATTAGTTCCCCGGGGGGGCGGGGCTCCTACAATGAGCAGTTCTTC	CISSPGGRGSYNEQFF	TRBV20-1	TRBJ2-1
TGTGCCAGCAGCTGGTCAGGGGACAGTGGCTACACCTTC	CASSWSGDSGYTF	TRBV5-5	TRBJ1-2
TGCAGTGCTAGAGATGGAGAGAAAGAGACCCAGTACTTC	CSARDGEKETQYF	TRBV20-1	TRBJ2-5
TGTGCCAGCAGCAATACTGAGGGGGATTCCTACGAGCAGTACTTC	CASSNTEGDSYEQYF	TRBV7-2	TRBJ2-7
TGTGCCACCATCTCTCATGACAGTCATAACACCGGGGAGCTGTTTTTT	CATISHDSHNTGELFF	TRBV15	TRBJ2-2
TGTGCCTGGGATCGTAAAGCGGGAGCTTTCTTT	CAWDRKAGAFF	TRBV30	TRBJ1-1
TGTGCCAGCATCAATCTACCGGGAGGTGAGCAGTTCTTC	CASINLPGGEQFF	TRBV27	TRBJ2-1
TGTGCCAGCAGCCCCCGGACAGGATCGACTAGAGGGAAGGGCTACACCTTC	CASSPRTGSTRGKGYTF	TRBV13	TRBJ1-2
TGTGCCAGCAGTGAAAGGGCGGGTCAGTACTTC	CASSERAGQYF	TRBV2	TRBJ2-4
TGTGCCTTTAGCGGGGCGGAGACCCAGTACTTC	CAFSGAETQYF	TRBV15	TRBJ2-5
TGCAGTGCTACAATGGGGGCAGTCCAAGAGACCCAGTACTTC	CSATMGAVQETQYF	TRBV20-1	TRBJ2-5
TGTGCCAGCAGCCAGACAGGCCCAGTCCACGAGCAGTACTTC	CASSQTGPVHEQYF	TRBV4-2	TRBJ2-7
TGCGCCAGGGGACAGGGGACTGAAGCTTTCTTT	CARGQGTEAFF	TRBV5-1	TRBJ1-1
TGTGCTAGTGGTTTGGTACGCTGGTCGGGACTAGCGGTCAGGGCTAGCACAGATACGCAGTATTTT	CASGLVRWSGLAVRASTDTQYF	TRBV12-5	TRBJ2-3
TGTGCCACCAGTGATCCGGCGGGACATTACGGGACGAACACTGAAGCTTTCTTT	CATSDPAGHYGTNTEAFF	TRBV24-1	TRBJ1-1
TGCGCCAGATACCCGGACAGGGAGGAGTGGGACACTGAAGCTTTCTTT	CARYPDREEWDTEAFF	TRBV5-1	TRBJ1-1
TGTGCCAGCAGTGATTGCCCACTAGACGGTAAAGGGGACAGGGATGGCTACACCTTC	CASSDCPLDGKGDRDGYTF	TRBV6-4	TRBJ1-2
TGCGCCAGCAGTGAGCCCCAGGGTGTTGCCCGCTACACCTTC	CASSEPQGVARYTF	TRBV10-2	TRBJ1-2
TGTGCCAGCAGCGTAGCTTGCGCTAGCGGGGTCCAAGAGACCCAGTACTTC	CASSVACASGVQETQYF	TRBV9	TRBJ2-5
TGTGCCACATTACGGACGTTCGGCCAAGAGACCCAGTACTTC	CATLRTFGQETQYF	TRBV24-1	TRBJ2-5
TGTGCCAGCAGCCACGAGGGCTTAGATACGCAGTATTTT	CASSHEGLDTQYF	TRBV6-1	TRBJ2-3
TGTGCCAGCAGTTACGCGGGAGGACGGCCTGGTGAGACCCAGTACTTC	CASSYAGGRPGETQYF	TRBV6-3	TRBJ2-5
TGCGCCAGCAGTGAGGAGAGTAGCGGGAGTGGGCCAACAGATACGCAGTATTTT	CASSEESSGSGPTDTQYF	TRBV10-1	TRBJ2-3
