TGTGCCAGTAGTAACCCCATAAAAAACTCTGGGGCCAACGTCCTGACTTTC	CASSNPIKNSGANVLTF	TRBV19	TRBJ2-6
TGCAGTGCTACACAAGGCTACACCTTC	CSATQGYTF	TRBV20-1	TRBJ1-2
TGTGCCAGCAGCCGTAGAAGAAATCAGCCCCAGCATTTT	CASSRRRNQPQHF	TRBV12-4	TRBJ1-5
TGTGCCAGCAGTCCGAGCGGGAGCTCTGGAAACACCATATATTTT	CASSPSGSSGNTIYF	TRBV2	TRBJ1-3
TGTGCCAGCAGCGGGAGGGGAGTCGGGTTTTTGCACTATGGCTACACCTTC	CASSGRGVGFLHYGYTF	TRBV5-6	TRBJ1-2
TGTGCCAGCAGCTTGCCGGGGATAGGCTACACCTTC	CASSLPGIGYTF	TRBV5-6	TRBJ1-2
TGTGAGGACTTTGAAAAACTGTTTTTT	CEDFEKLFF	TRBV14	TRBJ1-4
TGCGCCAGCAGCTTGCGGCCTTACAAGTACAATGAGCAGTTCTTC	CASSLRPYKYNEQFF	TRBV5-1	TRBJ2-1
TGTGCCAGCAGCGTGACGCTTGCCACTGGGGGACGGAGTAACACTGAAGCTTTCTTT	CASSVTLATGGRSNTEAFF	TRBV7-4	TRBJ1-1
TGTGCCAGCAGTCCCCACCCAGAAACCGGGAGTTCCCAGTACTTC	CASSPHPETGSSQYF	TRBV6-3	TRBJ2-5
TGTGCCAGCAGCTTGGGCGAAGACTATGGCTACACCTTC	CASSLGEDYGYTF	TRBV5-6	TRBJ1-2
TGTGCCAGCAGGGGACTAGCGGGAGGGCCCTATGAGCAGTTCTTC	CASRGLAGGPYEQFF	TRBV5-4	TRBJ2-1
TGTGCCAGCAGTCCCGGGGAGGCAGAGACCCAGTACTTC	CASSPGEAETQYF	TRBV12-3	TRBJ2-5
TGTGCCAGCAGCGTGGGGGGGGAGGGGGCGTTCAAAGAGACCCAGTACTTC	CASSVGGEGAFKETQYF	TRBV9	TRBJ2-5
TGTGCCAGCAGTTACCGGGCCGGGACAGGGTACAATGAGCAGTTCTTC	CASSYRAGTGYNEQFF	TRBV6-2	TRBJ2-1
TGTGCCTGGAACCACACCCTCTTTAATAGCGGGAACAATGAGCAGTTCTTC	CAWNHTLFNSGNNEQFF	TRBV30	TRBJ2-1
TGCGCCAGCAGGCCGGGACTAGCGTGCCAAGGCGAGCAGTACTTC	CASRPGLACQGEQYF	TRBV5-1	TRBJ2-7
TGTGCTAGTGGCCCGCGACGGGACAGGGGCGGCACAGATACGCAGTATTTT	CASGPRRDRGGTDTQYF	TRBV12-5	TRBJ2-3
TGTGCCACCACTAGCGGGTTAGACAATGAGCAGTTCTTC	CATTSGLDNEQFF	TRBV24-1	TRBJ2-1
TGTGCCAGCAAGACCCGGGGGGATCGAAATGTTGGGAGACAGGCCGGTATCGCGGCCTATGGCTACACCTTC	CASKTRGDRNVGRQAGIAAYGYTF	TRBV3-1	TRBJ1-2
TGTGCCAGCAGCAAGGGGACATGCGCTCCCATGTACCCCTATAGCAATCAGCCCCAGCATTTT	CASSKGTCAPMYPYSNQPQHF	TRBV9	TRBJ1-5
TGCAGTGCTAGGACGAGATTTAATGAGCAGTTCTTC	CSARTRFNEQFF	TRBV20-1	TRBJ2-1
TGTGCCAGCAGCTTAGCGAGCCAGAATCAGCCCCAGCATTTT	CASSLASQNQPQHF	TRBV7-9	TRBJ1-5
TGTGCCAGCAGTGAGTCTCCCGGCCCCAAGGGACTGAGGTATAGCAATCAGCCCCAGCATTTT	CASSESPGPKGLRYSNQPQHF	TRBV27	TRBJ1-5
TGTGCCAGCAGCTTGAAAGGGGGCGAATCACCCCTCCACTTT	CASSLKGGESPLHF	TRBV5-6	TRBJ1-6
TGTGCCAGCAGCTGCTATGGCACGGCGCCCGCCTACGAGCAGTACTTC	CASSCYGTAPAYEQYF	TRBV7-3	TRBJ2-7
TGTGCCAGCAGCTTGAACAGGGACTCCACCTTC	CASSLNRDSTF	TRBV11-2	TRBJ1-2
TGCGCCAGCAGCTCCACTACAGGGCTCAGCTGGGGGGATCAGCCCCAGCATTTT	CASSSTTGLSWGDQPQHF	TRBV5-1	TRBJ1-5
TGTGCCAGTAGTACTGGGGGAAACAGGGATCAGCCCCAGCATTTT	CASSTGGNRDQPQHF	TRBV19	TRBJ1-5
TGTGCCAGCAGTTACGGGGTCCACTATGGCTACACCTTC	CASSYGVHYGYTF	TRBV6-4	TRBJ1-2
TGCGCCAGCAGTTGCAGGCCTGGCGGGCCTGGAAACACCATATATTTT	CASSCRPGGPGNTIYF	TRBV5-1	TRBJ1-3
TGTGCCAGCAGTATCTGGGGGGGCTACAATGAGCAGTTCTTC	CASSIWGGYNEQFF	TRBV2	TRBJ2-1
TGTGCGTGGCCGGTCAGGTCAGGGGGCCACCACACTGAAGCTTTCTTT	CAWPVRSGGHHTEAFF	TRBV24-1	TRBJ1-1
TGTGCCAGCAGCTTTCTCTCACATAATTCACCCCTCCACTTT	CASSFLSHNSPLHF	TRBV11-2	TRBJ1-6
TGTGCCAGCAGCTTATGGTCAGACGAGCAGTACTTC	CASSLWSDEQYF	TRBV7-7	TRBJ2-7
TGTGCCATTAACACTGGAAACACCATATATTTT	CAINTGNTIYF	TRBV6-4	TRBJ1-3
TGTGCCAGCAGCTTTAGACAGGGCCCGGAGGGTAGCTCCTACGAGCAGTACTTC	CASSFRQGPEGSSYEQYF	TRBV7-3	TRBJ2-7
TGTGCCAGCAGTGACTCGCTCACCCTGCAACCAGGGAATTCACCCCTCCACTTT	CASSDSLTLQPGNSPLHF	TRBV6-4	TRBJ1-6
TGCAGCGTAAATCAGGCGCGGGCCTTGTCAGATACGCAGTATTTT	CSVNQARALSDTQYF	TRBV29-1	TRBJ2-3
TGTGCCAGTGCGGGAGCTAACGAGCAGTACTTC	CASAGANEQYF	TRBV19	TRBJ2-7
TGTGCCAGCAGTGACACTCAGGGTGGGGTTTATCAGCCCCAGCATTTT	CASSDTQGGVYQPQHF	TRBV6-4	TRBJ1-5
TGTGCCCTGAGGGGAGAAAACAATCAGCCCCAGCATTTT	CALRGENNQPQHF	TRBV10-3	TRBJ1-5
TGTGCCTGGAGTGTACAGACTAGACGTAACGGGGGCGCTAGCACAGATACGCAGTATTTT	CAWSVQTRRNGGASTDTQYF	TRBV30	TRBJ2-3
TGTGCCAGCAGCCGGACACCAGGGTGCTACGAGCAGTACTTC	CASSRTPGCYEQYF	TRBV2	TRBJ2-7
TGTGCCGTTGAGAGGGACAGCTACGAGCAGTACTTC	CAVERDSYEQYF	TRBV19	TRBJ2-7
TGTGCCAGTAGTATAAATAAATTTGACAGGAGCAATCAGCCCCAGCATTTT	CASSINKFDRSNQPQHF	TRBV19	TRBJ1-5
TGTGCCAGCAGAAATTCACCCGGGCCTAACTATGGCTACACCTTC	CASRNSPGPNYGYTF	TRBV2	TRBJ1-2
TGTGAGCCTACAGGGCGTACAGATACGCAGTATTTT	CEPTGRTDTQYF	TRBV27	TRBJ2-3
TGTGCCAGCAGCTTGGACCCGGGACTCCAGCCCCAGCATTTT	CASSLDPGLQPQHF	TRBV5-4	TRBJ1-5
TGCGCCAGCAGCGCAGGGCCCACCAATGAGCAGTTCTTC	CASSAGPTNEQFF	TRBV5-1	TRBJ2-1
TGTGCCAGCAGTTACTCGATCCAGGATCTCGAGACCCAGTACTTC	CASSYSIQDLETQYF	TRBV6-5	TRBJ2-5
TGTGCCAGCAGTCACGGGGTTGGATACAATGAGCAGTTCTTC	CASSHGVGYNEQFF	TRBV28	TRBJ2-1
TGTGCCAGCAGTGGACAGGCAAAAAAGGTTTCTGAAAAACTGTTTTTT	CASSGQAKKVSEKLFF	TRBV6-5	TRBJ1-4
TGTGCCAGCAGCCAAGTAGACAGGGGGCGCTATCCCGGTGCAACTAATGAAAAACTGTTTTTT	CASSQVDRGRYPGATNEKLFF	TRBV3-1	TRBJ1-4
TGTGCCAGCCGGGGCCGGGACAGGGTCGAATCCTACGAGCAGTACTTC	CASRGRDRVESYEQYF	TRBV7-7	TRBJ2-7
TGTGCCAGGACTACCCGCAGGGGGGGGCCGAGCTCCTACAATGAGCAGTTCTTC	CARTTRRGGPSSYNEQFF	TRBV19	TRBJ2-1
TGTGCCAGCAGCTTAGGTTATGACAGGAACTATGGCTACACCTTC	CASSLGYDRNYGYTF	TRBV7-6	TRBJ1-2
TGTGGGACAGGGGGCGGAAAAAGCTCCTACAATGAGCAGTTCTTC	CGTGGGKSSYNEQFF	TRBV7-9	TRBJ2-1
TGCAGTGCTAGTGGCCGGGACAGGGGGCTTTGTGGGATTTGCACAGATACGCAGTATTTT	CSASGRDRGLCGICTDTQYF	TRBV20-1	TRBJ2-3
TGTGCCAGCAGCGGAGATCCAGGGCAACGCGGCAATCAGCCCCAGCATTTT	CASSGDPGQRGNQPQHF	TRBV13	TRBJ1-5
TGTGCCAGTAGTATGAAGGAATTGAGGCCCTACGAGCAGTACTTC	CASSMKELRPYEQYF	TRBV19	TRBJ2-7
TGTGCCAGCACTACGACAGGGGGGGCCAAAAACATTCAGTACTTC	CASTTTGGAKNIQYF	TRBV6-1	TRBJ2-4
TGTGCCAGCAGCTTATCTTTTACTAAACGGATCTTACAAGAGACCCAGTACTTC	CASSLSFTKRILQETQYF	TRBV11-3	TRBJ2-5
TGTGCCAGCAGCTGGTTCCACAGGGAAAATCAGCCCCAGCATTTT	CASSWFHRENQPQHF	TRBV5-6	TRBJ1-5
TGTGCCAGCAGCTTATTACGGCAGTATGGCTACACCTTC	CASSLLRQYGYTF	TRBV11-3	TRBJ1-2
TGTGCCAGCAGGGCTGAAGCTTTCTTT	CASRAEAFF	TRBV6-4	TRBJ1-1
TGTGCCAGCAGTTCCCGGCGGTACGAGCAGTACTTC	CASSSRRYEQYF	TRBV6-5	TRBJ2-7
TGTGCCAGCAGCAGTAGCGGGCCGGAGACCCAGTACTTC	CASSSSGPETQYF	TRBV11-2	TRBJ2-5
TGCAGTGCTAGAAGACGACGGGGGAGCCGTAGGACACCCCTCCACTTT	CSARRRRGSRRTPLHF	TRBV20-1	TRBJ1-6
TGTGCCAGCATGCGGACAGGGGGCTCGACCCACACTGAAGCTTTCTTT	CASMRTGGSTHTEAFF	TRBV6-5	TRBJ1-1
TGCAGCGTTGAGCCACAGGGGGCCGGTACTGGAAACACCATATATTTT	CSVEPQGAGTGNTIYF	TRBV29-1	TRBJ1-3
TGTGCCAGCAGTTACTCTGGTACAGGGGAAGGGAACTATGGCTACACCTTC	CASSYSGTGEGNYGYTF	TRBV6-5	TRBJ1-2
TGTGCCAGCAGCGTCCCTCCGGGATTTGACACTGAAGCTTTCTTT	CASSVPPGFDTEAFF	TRBV11-2	TRBJ1-1
TGTGCCAGGAATGCGGCCAGAGAAGCTTTCTTT	CARNAAREAFF	TRBV6-6	TRBJ1-1
TGTGCCAGCAGCTTAACTCCGGTCTGCCATAATTCACCCCTCCACTTT	CASSLTPVCHNSPLHF	TRBV13	TRBJ1-6
TGTGCCAGCAGCTTAGAAAGGGGCCCCGAGCCCCAGCATTTT	CASSLERGPEPQHF	TRBV7-4	TRBJ1-5
TGTGCCATCAGCCAGGGGGCTTGCAATCAGCCCCAGCATTTT	CAISQGACNQPQHF	TRBV10-3	TRBJ1-5
TGTGCCAGCAGCTCACAGGCGGGGGAGCTGTTTTTT	CASSSQAGELFF	TRBV7-2	TRBJ2-2
TGTGCCACCACCCAAGGGGCTTTAGGCTATGGCTACACCTTC	CATTQGALGYGYTF	TRBV24-1	TRBJ1-2
TGCGCCAATCACCGCCAGGGCCGTAATGAGCAGTTCTTC	CANHRQGRNEQFF	TRBV10-1	TRBJ2-1
TGTGCCAGCAGTTTCCTAGCGGGCGGGGAGCTGTTTTTT	CASSFLAGGELFF	TRBV28	TRBJ2-2
TGTGCCAGCAGCCAAGCCCCACTCTGGAAGGAAAGTAACGAGCAGTACTTC	CASSQAPLWKESNEQYF	TRBV3-1	TRBJ2-7
TGTGCCAGCAGCTTAGGGGGGTCCCACGAGCAGTACTTC	CASSLGGSHEQYF	TRBV5-4	TRBJ2-7
TGTGCCAGCAGCTTAAGGGGACAGAGCCAGCAGTACTTC	CASSLRGQSQQYF	TRBV11-2	TRBJ2-7
TGTGCCACCAGTGCCAGGGATGTGGCCTACGAGCAGTACTTC	CATSARDVAYEQYF	TRBV24-1	TRBJ2-7
TGTGCCAGCAGCCAAGACCCGGCAGAGCAGTACTTC	CASSQDPAEQYF	TRBV14	TRBJ2-7
TGTGCCAGCAGCCTAACCTCGAGGGGTTCCCAGTACTTC	CASSLTSRGSQYF	TRBV7-7	TRBJ2-5
TGTGCCACCAGTGACCGACTAGCGGGAGGGCATCCCAGCTCCTACGAGCAGTACTTC	CATSDRLAGGHPSSYEQYF	TRBV24-1	TRBJ2-7
TGTGCCAGCAGCGCGCAACCGAGGGGACACTACGACGAGCAGTACTTC	CASSAQPRGHYDEQYF	TRBV28	TRBJ2-7
TGTGCCAGCAGTTATAGGGCCTACGAGCAGTACTTC	CASSYRAYEQYF	TRBV6-5	TRBJ2-7
TGTGCCAGCAGCCACAAGCCCAGGCCTGACTCAACGGGTCCCGGGGAGCTGTTTTTT	CASSHKPRPDSTGPGELFF	TRBV5-6	TRBJ2-2
TGTGCCAGCAGCTTAGCCCCGGAAGTGAGGATAGATACGCAGTATTTT	CASSLAPEVRIDTQYF	TRBV7-9	TRBJ2-3
TGTGCCAGCAGCTCGTTGGGGATGGGGTTCCCCTCTCCGCAGCCCCAGCATTTT	CASSSLGMGFPSPQPQHF	TRBV5-4	TRBJ1-5
TGTGCCAGCCCTGGGGGGTTATGGTACAATGAGCAGTTCTTC	CASPGGLWYNEQFF	TRBV19	TRBJ2-1
TGTGCCAGCAGCTTACACACCCGGGACAGGGTTAAACTGACCCCTTTAGCCAAAAACATTCAGTACTTC	CASSLHTRDRVKLTPLAKNIQYF	TRBV7-2	TRBJ2-4
TGTGCCAGCAGCGGTCCGATAAATCAGCCCCAGCATTTT	CASSGPINQPQHF	TRBV13	TRBJ1-5
TGTGCCAGCAGCTATATGCGGAGAGGGGAGAGGTACGAGCAGTACTTC	CASSYMRRGERYEQYF	TRBV7-2	TRBJ2-7
TGTGCCAGCAGCCAAGTAGAGACAGGGGGCCGGTATCACACTGAAGCTTTCTTT	CASSQVETGGRYHTEAFF	TRBV3-1	TRBJ1-1
TGTGCCAGCAGCGTATTGGACAGGGGGCCCCGAGAAAAACTGTTTTTT	CASSVLDRGPREKLFF	TRBV9	TRBJ1-4
TGTGCTAGCAGCTTAGGCGGACACGAGCAGTACTTC	CASSLGGHEQYF	TRBV7-7	TRBJ2-7
TGTGCCAACGTAAGCTCTGGGGCCAACGTCCTGACTTTC	CANVSSGANVLTF	TRBV6-4	TRBJ2-6
TGTGCCAGCAGCTTGGGTGAGGCCCGCAATCAGCCCCAGCATTTT	CASSLGEARNQPQHF	TRBV5-8	TRBJ1-5
TGCAGTGCTAGAAGCTTCCCTGGAGCGGACCGGATGCGTCCCCGGGATCAGCCCCAGCATTTT	CSARSFPGADRMRPRDQPQHF	TRBV20-1	TRBJ1-5
TGTGCCAGCAGCTACCGGCTCGCCTCAGGGGGCGGAAACACCATATATTTT	CASSYRLASGGGNTIYF	TRBV5-6	TRBJ1-3
TGTGCCAGCAGGGTGGGACAGTTCAGCGATAACTATGGCTACACCTTC	CASRVGQFSDNYGYTF	TRBV11-2	TRBJ1-2
TGTGCCAGCAGCTTAGGAGGGGTTGTGTCCTATAATTCACCCCTCCACTTT	CASSLGGVVSYNSPLHF	TRBV11-2	TRBJ1-6
TGTGCCAGCAGACCGGGCGGGTCGATAAACACCGGGGAGCTGTTTTTT	CASRPGGSINTGELFF	TRBV28	TRBJ2-2
TGTGCCGGGTCACCGGGTGGGGGTTGGCCCGGGACAGACGAGACCCAGTACTTC	CAGSPGGGWPGTDETQYF	TRBV2	TRBJ2-5
TGCAGTGCTAGCCCTCGAGGGGTGCTAACCCGTCATAACGAGCAGTACTTC	CSASPRGVLTRHNEQYF	TRBV20-1	TRBJ2-7
TGCGCCAGCAGCTTGTCGGAGAGGACGGGAAGGTTCCTGTATAATTCACCCCTCCACTTT	CASSLSERTGRFLYNSPLHF	TRBV5-1	TRBJ1-6
TGTGCCAGCAGTTACAATCTGGACAGGGGACCCTATGGCTACACCTTC	CASSYNLDRGPYGYTF	TRBV6-5	TRBJ1-2
TGTGCCAGCAGCTGGGGGGCCAGGTCTACTGAAAAACTGTTTTTT	CASSWGARSTEKLFF	TRBV7-2	TRBJ1-4
TGCGCCAGCAGCCAAGATAATGTATCCCCGGGGACTAGGGGTTGGGTAGAGACCCAGTACTTC	CASSQDNVSPGTRGWVETQYF	TRBV4-1	TRBJ2-5
TGTGCCAGCAGTTCCAGCGGTAAGGATCAGCCCCAGCATTTT	CASSSSGKDQPQHF	TRBV28	TRBJ1-5
TGCAGTGCTAGCCGACCGGGGGGGGCCGGCTACGAGCAGTACTTC	CSASRPGGAGYEQYF	TRBV20-1	TRBJ2-7
TGTGCCAGCAGCTCTAGGGGTTATGGCTACACCTTC	CASSSRGYGYTF	TRBV7-9	TRBJ1-2
TGCATCTACAGGGACAATCAGCCCCAGCATTTT	CIYRDNQPQHF	TRBV20-1	TRBJ1-5
TGTGCCAGCAGTGCCCCTAGTAACCGGGAGACCCAGTACTTC	CASSAPSNRETQYF	TRBV28	TRBJ2-5
TGTGCCAGCAGACACGGGGTTGTCCCCTATAATTCACCCCTCCACTTT	CASRHGVVPYNSPLHF	TRBV6-4	TRBJ1-6
TGTGCCAGCAGCCGCCGGTTAGGCACCGGGGAGCTGTTTTTT	CASSRRLGTGELFF	TRBV4-2	TRBJ2-2
TGTGCCAGCAGTCCGCGGGAAACACAGCCCCAGCATTTT	CASSPRETQPQHF	TRBV6-4	TRBJ1-5
TGTGCCAGCAGCAGTGGGCGAGGCACAGATACGCAGTATTTT	CASSSGRGTDTQYF	TRBV7-8	TRBJ2-3
TGTGCCAGCAGCTCCAATAGACTAGCGAGCAAAAACATTCAGTACTTC	CASSSNRLASKNIQYF	TRBV7-9	TRBJ2-4
TGTGCCAGCAGTTACTCAGATACTTTTACAATGCACTCTGGAAACACCATATATTTT	CASSYSDTFTMHSGNTIYF	TRBV6-2	TRBJ1-3
TGTGCCAGCAGTTTCAAGGGGGCGCCCGGAGACTACGAGCAGTACTTC	CASSFKGAPGDYEQYF	TRBV12-4	TRBJ2-7
TGTGCCAGCAGTGAGTCGATTTGGACTAGCGGCGCCACCGGGGAGCTGTTTTTT	CASSESIWTSGATGELFF	TRBV6-1	TRBJ2-2
TGCGCCAGCAGCCAAGCGAAGGGGACAGGGAGGACCGTCAGCTCCTACGAGCAGTACTTC	CASSQAKGTGRTVSSYEQYF	TRBV4-3	TRBJ2-7
TGTGCCAGTAGTATTTTCCCCGGGACAGGGGGCCTCTATGGCTACACCTTC	CASSIFPGTGGLYGYTF	TRBV19	TRBJ1-2
TGCGCCAGCAGCCAACAACCTACCGTCGCTCTCGGGGAGCTGTTTTTT	CASSQQPTVALGELFF	TRBV4-1	TRBJ2-2
TGTGCCAGCAGCTTATCCGGAACTACGAAGGGGGGACTTCGAAACGGGGCCAAAAACATTCAGTACTTC	CASSLSGTTKGGLRNGAKNIQYF	TRBV7-9	TRBJ2-4
TGTGCCAGCAGCCCCCCGGGCCGGGACAGGGGGCCTGGAAACACCATATATTTT	CASSPPGRDRGPGNTIYF	TRBV12-3	TRBJ1-3
TGCGCCAGCAGCACCCTAGATTCAAACACCGGGGAGCTGTTTTTT	CASSTLDSNTGELFF	TRBV5-1	TRBJ2-2
TGTGCCAAAACCGTTACCAAGAACACCGGGGAGCTGTTTTTT	CAKTVTKNTGELFF	TRBV6-6	TRBJ2-2
TGCGACCTAGCGGGATTTCCTGAGCAGTTCTTC	CDLAGFPEQFF	TRBV5-1	TRBJ2-1
TGTGCCACCAGTGATTTCAGCAGGGTCCCGAGTAACACTGAAGCTTTCTTT	CATSDFSRVPSNTEAFF	TRBV24-1	TRBJ1-1
TGTGCCCTCGGACAGACCCAGTACTTC	CALGQTQYF	TRBV19	TRBJ2-5
TGCGCCGGGTGGCCCTCCTACGAGCAGTACTTC	CAGWPSYEQYF	TRBV10-1	TRBJ2-7
TGTGCCAGCAGTTACTATCTCCGGGACAGGGGTGGCAGGACGCTCACTAATGAAAAACTGTTTTTT	CASSYYLRDRGGRTLTNEKLFF	TRBV6-6	TRBJ1-4
TGTGCCAGCAGTTTCGTGCCCTTCAGGGGGCGGAACCCGATGAACACTGAAGCTTTCTTT	CASSFVPFRGRNPMNTEAFF	TRBV28	TRBJ1-1
TGTGCCAGCAGTTTCCGGACCCGGAACACTGAAGCTTTCTTT	CASSFRTRNTEAFF	TRBV12-3	TRBJ1-1
TGTGCCAGCAGCCGGTGCGACGACGAGCAGTACTTC	CASSRCDDEQYF	TRBV14	TRBJ2-7
TGTGCCAGCAGTTGGGGACTAGCGGGAGGGCTATGGGAGAAGAATGAGCAGTTCTTC	CASSWGLAGGLWEKNEQFF	TRBV28	TRBJ2-1
TGTGCCAGCAGTCTGGGACCCCTCGTAGAGACCCAGTACTTC	CASSLGPLVETQYF	TRBV12-4	TRBJ2-5
TGTGCCAGCAGCCAAGATCTCCGTACGGGGGACGAGCAGTACTTC	CASSQDLRTGDEQYF	TRBV3-1	TRBJ2-7
TGTGCCAGCAGCCAAGACCTAACTTGGGGACGGTCCTACGAGCAGTACTTC	CASSQDLTWGRSYEQYF	TRBV14	TRBJ2-7
TGTGCCAGCAGCCAAGGAAGGACGCCAGGCTACACCTTC	CASSQGRTPGYTF	TRBV7-2	TRBJ1-2
TGTGCCAGCAGCAGGGAAGCTAACTATGGCTACACCTTC	CASSREANYGYTF	TRBV13	TRBJ1-2
TGTGCCAGCAGTTACAGGGGGGCGAGAGCTGGCTACACCTTC	CASSYRGARAGYTF	TRBV6-6	TRBJ1-2
TGTGCCACCAGTGACGGGAGTACCACTGAAGCTTTCTTT	CATSDGSTTEAFF	TRBV24-1	TRBJ1-1
TGTGCCAGTAGTATAGGTCGAGCCCAGGCGGGACACCTTCAGCCCCAGCATTTT	CASSIGRAQAGHLQPQHF	TRBV19	TRBJ1-5
TGTGCCAGCAGCTTCACCCTTGGCGACGAGCAGTACTTC	CASSFTLGDEQYF	TRBV11-3	TRBJ2-7
TGTGCCAGCAGCCTGGGGGGCGGCAATCAGCCCCAGCATTTT	CASSLGGGNQPQHF	TRBV7-9	TRBJ1-5
TGCGCCAGCAGCTTACTAGCGGGAGGTCGCACAGATACGCAGTATTTT	CASSLLAGGRTDTQYF	TRBV5-1	TRBJ2-3
TGTGCCACCAGCAGCCGGTGCTGGTACGAGCAGTACTTC	CATSSRCWYEQYF	TRBV15	TRBJ2-7
TGTGCCAGTAGTGGGGAAAGTTGCGGGAGACCCCACATGAACACTGAAGCTTTCTTT	CASSGESCGRPHMNTEAFF	TRBV19	TRBJ1-1
TGTGCCAGCAGCCCCAGCGGAAATTCCCCCAATGAGCAGTTCTTC	CASSPSGNSPNEQFF	TRBV7-4	TRBJ2-1
TGTGCCAGCATAGGCACAGGGACGGTCTATGGCTACACCTTC	CASIGTGTVYGYTF	TRBV6-1	TRBJ1-2
TGTGCCAGCAGCCCCTGGTCCCCACGCCCGCTGTACAAAAACATTCAGTACTTC	CASSPWSPRPLYKNIQYF	TRBV13	TRBJ2-4
TGTGCCAGCAGCCAAGCCTCGACTAGGGATGCTGGGGATGAGCAGTTCTTC	CASSQASTRDAGDEQFF	TRBV3-1	TRBJ2-1
TGTGCCAGCAGTTTATGTATCCCTGGGGAAACCTATAGCAATCAGCCCCAGCATTTT	CASSLCIPGETYSNQPQHF	TRBV12-3	TRBJ1-5
TGTGCTAGTGGTTGGATTCCGGTCGACGGGAACAGCTCTGGAAACACCATATATTTT	CASGWIPVDGNSSGNTIYF	TRBV12-5	TRBJ1-3
TGTGCCAGCAGCTTACCTGAATGGACTGAAGCTTTCTTT	CASSLPEWTEAFF	TRBV7-2	TRBJ1-1
TGCGCCAGCAGTGGGCCACGTTCACCCCTCCACTTT	CASSGPRSPLHF	TRBV10-1	TRBJ1-6
TGTGCCAGCATCTTCGAGGGGGAGGAGGAGACCCAGTACTTC	CASIFEGEEETQYF	TRBV25-1	TRBJ2-5
TGTGCCACCAGTGGCTTCGGACAGGGTAGGGACACTGAAGCTTTCTTT	CATSGFGQGRDTEAFF	TRBV24-1	TRBJ1-1
TGTGCCAGCAGCTTAGTAAACCGGCAGGGAGACACCGGGGAGCTGTTTTTT	CASSLVNRQGDTGELFF	TRBV11-3	TRBJ2-2
TGTGCCAGCAGTAAGGGGGATGGCTACACCTTC	CASSKGDGYTF	TRBV6-1	TRBJ1-2
TGTGCCATCAGTGAGCCTGGGGACTCTAGTGGTACGTACGAGCAGTACTTC	CAISEPGDSSGTYEQYF	TRBV10-3	TRBJ2-7
TGTGCCAGTAGTATAGCAATGACATCTTGTGGACACGCTTTCTTT	CASSIAMTSCGHAFF	TRBV19	TRBJ1-1
TGTGCCAGCAGCTTAGCAGGGGGAATACCGAGGGTGAAACATGGCTACACCTTC	CASSLAGGIPRVKHGYTF	TRBV7-9	TRBJ1-2
TGCAGTGCTAGAGGGAACAGGGGACGTGCTGAAGCTTTCTTT	CSARGNRGRAEAFF	TRBV20-1	TRBJ1-1
TGTGCCAGCAGTTCGCAGCTTAAGGGACTGAATGGCTACACCTTC	CASSSQLKGLNGYTF	TRBV6-2	TRBJ1-2
TGTGCCAGCAGCGGACAGGGGCGAAAATATGTCAATCAGCCCCAGCATTTT	CASSGQGRKYVNQPQHF	TRBV5-5	TRBJ1-5
TGTGCCAGCAAACAGGGCTATGGCTACACCTTC	CASKQGYGYTF	TRBV6-5	TRBJ1-2
TGTGCCAGCAGTTTATTCCCCGGGACAGGGGTCTGGGAACGCACAGATACGCAGTATTTT	CASSLFPGTGVWERTDTQYF	TRBV27	TRBJ2-3
TGTGATCTGTCGCTGGACAGGGGGCCGAGGGAAAACTATGGCTACACCTTC	CDLSLDRGPRENYGYTF	TRBV25-1	TRBJ1-2
TGCGCCAGCAGGACGGGGCGCACAGATACGCAGTATTTT	CASRTGRTDTQYF	TRBV10-1	TRBJ2-3
TGTGCCAGCAGCTGGTCGTCGGCCACCTATTCACCCCTCCACTTT	CASSWSSATYSPLHF	TRBV13	TRBJ1-6
TGCGCCAGCAGCCAAGGTCCCGAAGGGGAGAGCCAGCCCCAGCATTTT	CASSQGPEGESQPQHF	TRBV4-1	TRBJ1-5
TGTGCCAGCAGCCGGCCCGGGACAGGGGGCTGGTCAGAGACCCAGTACTTC	CASSRPGTGGWSETQYF	TRBV7-9	TRBJ2-5
TGTGCCAGCAGCTTAACGCCAGGCTCTGGGGCCAACGTCCTGACTTTC	CASSLTPGSGANVLTF	TRBV7-3	TRBJ2-6
TGTGCCAGCAGACGCCTTGCCCCGGGGTGGGTGAACACTGAAGCTTTCTTT	CASRRLAPGWVNTEAFF	TRBV6-5	TRBJ1-1
TGTGCCAGCACATGCGCCCCCTCCTACGAGCAGTACTTC	CASTCAPSYEQYF	TRBV7-9	TRBJ2-7
TGTGCCAGCAGCTTAGCGGCCCCAATCTTCCGGGACAGGGGCGGAGCTGAAAAACTGTTTTTT	CASSLAAPIFRDRGGAEKLFF	TRBV7-4	TRBJ1-4
TGCGCCAGCAGCCGGTACTCCTACGAGCAGTACTTC	CASSRYSYEQYF	TRBV5-1	TRBJ2-7
TGCAGTGCTAGGGGGACAGGGCTTAGAGGGCAGTTCTTC	CSARGTGLRGQFF	TRBV20-1	TRBJ2-1
TGTGCCAGCAGCTTACTTGCCGGGACGGGATCGGAGCAGTACTTC	CASSLLAGTGSEQYF	TRBV11-1	TRBJ2-7
TGTGCCAGCAGTGGGGGGGTCATAGGGCATAGCTCCTACGAGCAGTACTTC	CASSGGVIGHSSYEQYF	TRBV6-4	TRBJ2-7
TGCGCGAGGCTCAGGAGTAACTATGGCTACACCTTC	CARLRSNYGYTF	TRBV5-1	TRBJ1-2
TGTGCCAGCGGGACTAGCGGAGACGAGCAGTACTTC	CASGTSGDEQYF	TRBV2	TRBJ2-7
TGTGCCAGCAGTGACCCTTATGAGCAGTTCTTC	CASSDPYEQFF	TRBV6-4	TRBJ2-1
TGCAGTGCAAGAAGGGGCAGCAATCAGCCCCAGCATTTT	CSARRGSNQPQHF	TRBV20-1	TRBJ1-5
TGTGCCAGCAGTTTAATCGGGGACGAGCAGTACTTC	CASSLIGDEQYF	TRBV7-9	TRBJ2-7
TGTGCCAGCAGCTTAGGGGGGCGGGAGTTTCATGAGCAGTTCTTC	CASSLGGREFHEQFF	TRBV11-3	TRBJ2-1
TGCAGTTCGCCCCTTGTACGCCCCGACGAGCAGTACTTC	CSSPLVRPDEQYF	TRBV20-1	TRBJ2-7
TGTGCCAGCAGCCAAGATATTAGAGCCACAGGGTATTCCTATAATTCACCCCTCCACTTT	CASSQDIRATGYSYNSPLHF	TRBV14	TRBJ1-6
TGTGCCAGCAGCGTTTGGGTAACGCTAGCGGGAAGAACGAACGAGCAGTACTTC	CASSVWVTLAGRTNEQYF	TRBV9	TRBJ2-7
TGTGCCAGCAGTTTGGGGCTCGACAATTCACCCCTCCACTTT	CASSLGLDNSPLHF	TRBV12-4	TRBJ1-6
TGTGCCAGCAGGGTGGGAGAGAATGAGCAGTTCTTC	CASRVGENEQFF	TRBV6-4	TRBJ2-1
TGCACTCAGGGCGCTAATTCACCCCTCCACTTT	CTQGANSPLHF	TRBV20-1	TRBJ1-6
TGTGCCTGGAGGTGTCGGAATACAGATACGCAGTATTTT	CAWRCRNTDTQYF	TRBV30	TRBJ2-3
TGCGCCAGGGTTGGTCCCCAGACAGGGAGGGGGGCCAACGTCCTGACTTTC	CARVGPQTGRGANVLTF	TRBV5-1	TRBJ2-6
TGTGCCACCAGTGACCAGGGACAGCCAGTGAACACTGAAGCTTTCTTT	CATSDQGQPVNTEAFF	TRBV24-1	TRBJ1-1
TGTGCCAGCAGCCAAGACCAACCGGGACCGAGCAGCTCCTACAATGAGCAGTTCTTC	CASSQDQPGPSSSYNEQFF	TRBV3-1	TRBJ2-1
TGTGCCAGCAGCTTAGCCCCCCGGGACAGGGGCAAGGGAGCTTTCTTT	CASSLAPRDRGKGAFF	TRBV7-6	TRBJ1-1
TGCAGCGCCCAATTGACACTCTATGGCTACACCTTC	CSAQLTLYGYTF	TRBV29-1	TRBJ1-2
TGTGCCAGCAGCTTTAAACGACTAGCGGGGGATTACAATGAGCAGTTCTTC	CASSFKRLAGDYNEQFF	TRBV7-9	TRBJ2-1
TGTGCCAGCAGTGACGAGGGACTAGCGGGCCCTTACTCCTACAATGAGCAGTTCTTC	CASSDEGLAGPYSYNEQFF	TRBV6-4	TRBJ2-1
TGTGCCAGCAGAAGAAGTTTGTGGGGGGGGCTTAACATTCAGTACTTC	CASRRSLWGGLNIQYF	TRBV12-3	TRBJ2-4
TGTGCCAGCAGAGTCTTCATGGACAGGGGAGTCCAGCACCCCGGGGAGCTGTTTTTT	CASRVFMDRGVQHPGELFF	TRBV6-4	TRBJ2-2
TGTGCCAGCAGTGACAAGGGGTGGGTGAATCAGCCCCAGCATTTT	CASSDKGWVNQPQHF	TRBV6-1	TRBJ1-5
TGCAGTGCTAGAGTTCCACCCCAAGGTGAAAAACTGTTTTTT	CSARVPPQGEKLFF	TRBV20-1	TRBJ1-4
TGTGCCAGCAGCCAAGACCCTTGTAACAAAGGGAGGCGGTACAATGAGCAGTTCTTC	CASSQDPCNKGRRYNEQFF	TRBV3-1	TRBJ2-1
TGTGCCAGCAGCAACGGGGCAGGGGGCTACTCTGGAAACACCATATATTTT	CASSNGAGGYSGNTIYF	TRBV9	TRBJ1-3
TGTGCCAGCAGACTCCGGGACCCCTACGAGCAGTACTTC	CASRLRDPYEQYF	TRBV2	TRBJ2-7
TGTGCCAGCAGCGTTGACAGTCGTAAAAGGGGCACTGAAGCTTTCTTT	CASSVDSRKRGTEAFF	TRBV13	TRBJ1-1
TGTGCCAAGCGACTGTACGAGCAGTACTTC	CAKRLYEQYF	TRBV11-2	TRBJ2-7
TGCAGTGCTAGCCCGCTACGCTCCTACAATGAGCAGTTCTTC	CSASPLRSYNEQFF	TRBV20-1	TRBJ2-1
TGTGCCAGCAGTGTCCGTCTGCAGAACGAGCAGTACTTC	CASSVRLQNEQYF	TRBV28	TRBJ2-7
TGCAGTGCGACCCCCGCCCCGGGTAGCACTGAAGCTTTCTTT	CSATPAPGSTEAFF	TRBV20-1	TRBJ1-1
TGTGCCAGCAGCCACGGTGTTGAAAAACTGTTTTTT	CASSHGVEKLFF	TRBV12-3	TRBJ1-4
TGTGCCAGTCACCCCGGGACAGAGGACTTGAGCACAGATACGCAGTATTTT	CASHPGTEDLSTDTQYF	TRBV7-2	TRBJ2-3
TGTGCCAGCAGAGTCGCTCGGGAGGGCCCTGGGGGAGATACGCAGTATTTT	CASRVAREGPGGDTQYF	TRBV6-4	TRBJ2-3
TGTGCCAGCAGTCTGACACCTTCAGGGGGCGAACATGATACGCAGTATTTT	CASSLTPSGGEHDTQYF	TRBV11-2	TRBJ2-3
TGTGCCAGCAGCATGGCAGAGGCCCGTATTGAGCAGTACTTC	CASSMAEARIEQYF	TRBV3-1	TRBJ2-7
TGTGCCAGCACCCTCCTGGACAGTTTATACTTC	CASTLLDSLYF	TRBV6-4	TRBJ2-5
TGTGCTAGTGGTTTGGTACCCGCCGGGACACGGCCGAGCTCCTACAATGAGCAGTTCTTC	CASGLVPAGTRPSSYNEQFF	TRBV12-5	TRBJ2-1
TGTGCCAGCAGTGATCGGGCGGAGGTTAGGACTGAAGCTTTCTTT	CASSDRAEVRTEAFF	TRBV25-1	TRBJ1-1
TGTGCCAGCAGTTACCACGTTCTAGGACAGCCCCCTAATGAAAAACTGTTTTTT	CASSYHVLGQPPNEKLFF	TRBV6-6	TRBJ1-4
TGCGCCAGCCGGGTTGGGGGCCGGATCTATGGCTACACCTTC	CASRVGGRIYGYTF	TRBV5-1	TRBJ1-2
TGTGCCAGCAGCAGTCCGGGACTAGCGGGAGTCCATCAAGAGACCCAGTACTTC	CASSSPGLAGVHQETQYF	TRBV13	TRBJ2-5
TGTGCCAGCAGCGGGTCCGCGGAAAAGAACACTGAAGCTTTCTTT	CASSGSAEKNTEAFF	TRBV7-3	TRBJ1-1
TGTGCCAGCAGCCTGATTGCAGGGAACACTGAAGCTTTCTTT	CASSLIAGNTEAFF	TRBV7-4	TRBJ1-1
TGTGCCAGCAGCCCTAGAGTTGTATATAATTCACCCCTCCACTTT	CASSPRVVYNSPLHF	TRBV5-4	TRBJ1-6
TGTGCCAGCAGCTTATTGGGCCGCTACGAGCAGTACTTC	CASSLLGRYEQYF	TRBV5-6	TRBJ2-7
TGTGCTAGTGGTTTGGTAAGCCGGGACAGGGGATTGAATGAAAAACTGTTTTTT	CASGLVSRDRGLNEKLFF	TRBV12-5	TRBJ1-4
TGTGCCAGCAGCAGGACACCCCAAAGCAATCAGCCCCAGCATTTT	CASSRTPQSNQPQHF	TRBV7-9	TRBJ1-5
TGCGCCAGCAGCCAAGAACAGGGGGCACAGTTGCCCCAGCATTTT	CASSQEQGAQLPQHF	TRBV4-3	TRBJ1-5
TGTGCCAGCAGCAGAAGGGGCTTTATAAACACCGGGGAGCTGTTTTTT	CASSRRGFINTGELFF	TRBV5-5	TRBJ2-2
TGCAGTGCTAGAGATAGAAGGGGACTAGGACGACACAATGAGCAGTTCTTC	CSARDRRGLGRHNEQFF	TRBV20-1	TRBJ2-1
TGTGCCAGCAGCTCACGTAGGGCCTACGAGCAGTACTTC	CASSSRRAYEQYF	TRBV27	TRBJ2-7
TGTGCCAGCAGCGTAGCTACTCAGACCAGGGGCCCCGAGCAGTACTTC	CASSVATQTRGPEQYF	TRBV9	TRBJ2-7
TGTGCCAGCAGTTTTAGGGGGCCGGACTCCGAGCAGTACTTC	CASSFRGPDSEQYF	TRBV12-3	TRBJ2-7
TGTGCCAGCAGGCGGGAGCACTATGGCTACACCTTC	CASRREHYGYTF	TRBV28	TRBJ1-2
TGTGCTAGTGGTTTCTTTGGCTTCTCTGGAAACACCATATATTTT	CASGFFGFSGNTIYF	TRBV12-5	TRBJ1-3
TGTGCCAGCAGTGGATACAAACTTGGGGGGAGCTCCTACAATGAGCAGTTCTTC	CASSGYKLGGSSYNEQFF	TRBV6-1	TRBJ2-1
TGTGCCAGCAGCTTAGGGTCCGATGGGAATCAGCCCCAGCATTTT	CASSLGSDGNQPQHF	TRBV7-9	TRBJ1-5
TGTGCCAGCAGTGACTCCATTCGGGGATTCAATCAGCCCCAGCATTTT	CASSDSIRGFNQPQHF	TRBV6-4	TRBJ1-5
TGTGCCAGCAGGAGACTAGAAGTTAGCTCCTACAATGAGCAGTTCTTC	CASRRLEVSSYNEQFF	TRBV12-4	TRBJ2-1
TGTGCCAGCGGGGACAGGAATGGGAATCAGCCCCAGCATTTT	CASGDRNGNQPQHF	TRBV6-3	TRBJ1-5
TGTGCCAGCAGCCAAGGGAAAAAACCCCCTAGCGGGGCGCTAGATACGCAGTATTTT	CASSQGKKPPSGALDTQYF	TRBV3-1	TRBJ2-3
TGTGCCAGCAATGATAAGGGGGCGAATCAGCCCCAGCATTTT	CASNDKGANQPQHF	TRBV6-4	TRBJ1-5
TGTGCCTCCACTAGCGGAGATACGCAGTATTTT	CASTSGDTQYF	TRBV10-3	TRBJ2-3
TGCAGCGTTCGTCGGCCCTCCTACAATGAGCAGTTCTTC	CSVRRPSYNEQFF	TRBV29-1	TRBJ2-1
TGTGCCACCGAGCAGGCCAATTCACCCCTCCACTTT	CATEQANSPLHF	TRBV24-1	TRBJ1-6
TGTGGGGGGGCTAGCCAGAATGAGCAGTTCTTC	CGGASQNEQFF	TRBV2	TRBJ2-1
TGTGCCAGCAGTGATTTTCCTGGACGTGAAGCTTTCTTT	CASSDFPGREAFF	TRBV6-3	TRBJ1-1
TGTGCCAGACGGGGGGCCTACGAGCAGTACTTC	CARRGAYEQYF	TRBV7-4	TRBJ2-7
TGTGCCAGCACACCTATAGAGTCCGAGTCTGAGACTAGCGGGCCGGATCTACGCTACAATGAGCAGTTCTTC	CASTPIESESETSGPDLRYNEQFF	TRBV3-1	TRBJ2-1
TGCGCCAGCAGCCAAGAAAAACGGGACAACTTACTTCCTGAAGCTTTCTTT	CASSQEKRDNLLPEAFF	TRBV4-3	TRBJ1-1
TGTGCCAGCAGTTACAGTATTCAGGCAGAGACCCAGTACTTC	CASSYSIQAETQYF	TRBV6-6	TRBJ2-5
TGTGCCAGCAGCTTAGGCCCTCCCGACAACTACGAGCAGTACTTC	CASSLGPPDNYEQYF	TRBV11-2	TRBJ2-7
TGTGCCACCAGTGATCCCCACCCTAGGAACAAGGAGGGACAGGGGGCAGGCACCGGGGAGCTGTTTTTT	CATSDPHPRNKEGQGAGTGELFF	TRBV24-1	TRBJ2-2
TGTGCCAGGAGAAAGAGCAATCAGCCCCAGCATTTT	CARRKSNQPQHF	TRBV19	TRBJ1-5
TGTGCCTGGGCCCCAATAAGGGAGCGCTATAATTCACCCCTCCACTTT	CAWAPIRERYNSPLHF	TRBV30	TRBJ1-6
TGTGCCAGCAGTGGACGACAGGGTGGCCAGTCGAGAACCACAGATACGCAGTATTTT	CASSGRQGGQSRTTDTQYF	TRBV2	TRBJ2-3
TGTGCCAGCAGCTTCACGCTGGACACCGGGGAGCTGTTTTTT	CASSFTLDTGELFF	TRBV7-9	TRBJ2-2
TGCGCCAGCAGCTCTGTGACCCCCGGGGTCCTCAGGGGAAACACCATATATTTT	CASSSVTPGVLRGNTIYF	TRBV5-1	TRBJ1-3
TGTGCCAGCAGCAGCGCTTTGGAAGAATACGAGCAGTACTTC	CASSSALEEYEQYF	TRBV7-3	TRBJ2-7
TGTGCCAGCAGCGTAAAAACCCGGGACCGGGGGAAAGACTACGAGCAGTACTTC	CASSVKTRDRGKDYEQYF	TRBV9	TRBJ2-7
TGTGCCAGCAGCGGGGGACGACTCACGACCTACGAGCAGTACTTC	CASSGGRLTTYEQYF	TRBV11-2	TRBJ2-7
TGTGAGAAACAGGCTAGCGGGGTAATCTTC	CEKQASGVIF	TRBV24-1	TRBJ2-1
TGTGCCAGCACCGAGTCCGAGAGATGTTACAATGAGCAGTTCTTC	CASTESERCYNEQFF	TRBV6-1	TRBJ2-1
TGTGCCAGCAGCTTTAGGGGCGCTTTCTTT	CASSFRGAFF	TRBV5-4	TRBJ1-1
TGTGCCACCAGTGATGGGGCCGGATACGAGCAGTACTTC	CATSDGAGYEQYF	TRBV24-1	TRBJ2-7
TGTGCCAGTCGAGGGCAGCGCAATCAGCCCCAGCATTTT	CASRGQRNQPQHF	TRBV12-3	TRBJ1-5
TGTGCCAGCAGCCTAAGGGTGGAACAGGGAGTGACCGGGGAGCTGTTTTTT	CASSLRVEQGVTGELFF	TRBV9	TRBJ2-2
TGTGCCAGCAGTTTCGGGGGAAGCAATCAGCCCCAGCATTTT	CASSFGGSNQPQHF	TRBV28	TRBJ1-5
TGTGCCACGGACGGGGGACAGGGTTACTATGGCTACACCTTC	CATDGGQGYYGYTF	TRBV28	TRBJ1-2
TGTGCCACCAGTGATGGCAGTCGGGACAGGGTTGAAGAGACCCAGTACTTC	CATSDGSRDRVEETQYF	TRBV24-1	TRBJ2-5
TGTGCCACCAGTGATTTACCGGGGACAGGCTACGAGCAGTACTTC	CATSDLPGTGYEQYF	TRBV24-1	TRBJ2-7
TGTGCCACCTACACGTATGGCTACACCTTC	CATYTYGYTF	TRBV24-1	TRBJ1-2
TGTGCCAGCAGTTACAAGGGACAGACTGCCAAAAACATTCAGTACTTC	CASSYKGQTAKNIQYF	TRBV6-5	TRBJ2-4
TGTGCCACCAGTGAGCCAGGGCTGAACCCCTACAATGAGCAGTTCTTC	CATSEPGLNPYNEQFF	TRBV24-1	TRBJ2-1
TGTGCCAGCAGCCAGGGGGGTGAAGCTTTCTTT	CASSQGGEAFF	TRBV9	TRBJ1-1
TGTGCCAGCAGCATAGTTCAGGGACTCGGGGAGCTGTTTTTT	CASSIVQGLGELFF	TRBV9	TRBJ2-2
TGTGCCAGCAGTTACTCGACGGCGGGGGTGAGCTCCTACGAGCAGTACTTC	CASSYSTAGVSSYEQYF	TRBV6-5	TRBJ2-7
TGTGCCAGCACTACAGGAACGCGGGCCAGCGGCGGAGAGACCCAGTACTTC	CASTTGTRASGGETQYF	TRBV6-5	TRBJ2-5
TGTGCCAGCAGCTTAGAGGTCAGGAGAACCTACGAGCAGTACTTC	CASSLEVRRTYEQYF	TRBV7-9	TRBJ2-7
TGTGCCAGCAGTCCAGGGTTCTACGAGCAGTACTTC	CASSPGFYEQYF	TRBV11-1	TRBJ2-7
TGCGCCAGCAGTGAGAGCTCCTACGAGCAGTACTTC	CASSESSYEQYF	TRBV10-1	TRBJ2-7
TGCGCCAGCAGCTTGGGGCGTATGACAGGAAGGAACACTGAAGCTTTCTTT	CASSLGRMTGRNTEAFF	TRBV5-1	TRBJ1-1
TGTGCCACCAGTTTTAGTGTACCCACTAGCAGTGGAAACAATGAGCAGTTCTTC	CATSFSVPTSSGNNEQFF	TRBV24-1	TRBJ2-1
TGCAGCGATTTCCTCAAACCCCTAACTAGCGGGGGGGGAGGCTCCTACAATGAGCAGTTCTTC	CSDFLKPLTSGGGGSYNEQFF	TRBV29-1	TRBJ2-1
TGCGCCAGCAGCCAAGATGGAGGGGGGGTTCGCAGGAACACCGGGGAGCTGTTTTTT	CASSQDGGGVRRNTGELFF	TRBV4-3	TRBJ2-2
TGTGCCAGCTCACCGGCGGGCGAAGGGGGAGCCAAAAACATTCAGTACTTC	CASSPAGEGGAKNIQYF	TRBV18	TRBJ2-4
TGTGCCAGCAACGGACAGGGCTACACCTTC	CASNGQGYTF	TRBV6-5	TRBJ1-2
TGCAGTGCTACCCCGGGACAGCCAGCCAAAAACATTCAGTACTTC	CSATPGQPAKNIQYF	TRBV20-1	TRBJ2-4
TGTGCCAGCAGCTTGACGGCCCGACAGGGGGCGCCAAGATATGGCTACACCTTC	CASSLTARQGAPRYGYTF	TRBV5-4	TRBJ1-2
TGTGCCAGCAGTGAAATGGGACAGTTGACTGAAGCTTTCTTT	CASSEMGQLTEAFF	TRBV6-4	TRBJ1-1
TGTGCCAGCAGTTCCGGGGCTAATGAAAAACTGTTTTTT	CASSSGANEKLFF	TRBV6-3	TRBJ1-4
TGCGCCAGCAGGCTAGCGGGAGAGGACAATGAGCAGTTCTTC	CASRLAGEDNEQFF	TRBV5-1	TRBJ2-1
TGTGCCAGCAGCCAAGGTAGGGGGAAGTCGGGCTACGAGCAGTACTTC	CASSQGRGKSGYEQYF	TRBV14	TRBJ2-7
TGTGCCAGCAGCGGTCGCGCATCAATTGTCTACTACGAGCAGTACTTC	CASSGRASIVYYEQYF	TRBV3-1	TRBJ2-7
TGCAGCGTTGAACGAGGAGCGGGGGGCTACGAGCAGTACTTC	CSVERGAGGYEQYF	TRBV29-1	TRBJ2-7
TGCAGTGCACGGGGGACCAGGTACTTC	CSARGTRYF	TRBV20-1	TRBJ2-7
TGCGCCAGCAGCGGAGCTGGAGATGGTGAAGCTTTCTTT	CASSGAGDGEAFF	TRBV5-1	TRBJ1-1
TGTGCCAGCAGTTTATCCGGGACAGCCCCTATTAACTATGGCTACACCTTC	CASSLSGTAPINYGYTF	TRBV27	TRBJ1-2
TGTGCCAGCAGCTTACCCTGTCAAATGGGGGTGCAATGGCCAGATACGCAGTATTTT	CASSLPCQMGVQWPDTQYF	TRBV7-8	TRBJ2-3
TGTGCCAGCAGTGCCGTCGGACAGGGACCCAGGTCTCAGCCCCAGCATTTT	CASSAVGQGPRSQPQHF	TRBV6-1	TRBJ1-5
TGCAGTGCTAGCGGACAGGGTGAAGCTTTCTTT	CSASGQGEAFF	TRBV20-1	TRBJ1-1
TGTGCCTGGCAGACGTACACTGAAGCTTTCTTT	CAWQTYTEAFF	TRBV30	TRBJ1-1
TGTGCCAGCAGTGCCGTGGGGGGTTCGGGACAAGAGACCCAGTACTTC	CASSAVGGSGQETQYF	TRBV6-1	TRBJ2-5
TGTGCCAGCAGTTTATGCCAGCCGGGACAGGGAATGACGGGGGCCTATGGCTACACCTTC	CASSLCQPGQGMTGAYGYTF	TRBV28	TRBJ1-2
TGCAGTGCTAGAGTTTTGAGCAGGGGGCGCCACCTAGCTTTCTTT	CSARVLSRGRHLAFF	TRBV20-1	TRBJ1-1
TGTGCCAGCAGTTTCCGAGACAGGACCGTAGAGACCCAGTACTTC	CASSFRDRTVETQYF	TRBV12-3	TRBJ2-5
TGTGCTAGTGAACCCCGACTTCTGGGGGTGGGTGGCTACACCTTC	CASEPRLLGVGGYTF	TRBV12-5	TRBJ1-2
TGTGCCAGCAGCCCGACAGGACCCGGCACTGAAGCTTTCTTT	CASSPTGPGTEAFF	TRBV7-3	TRBJ1-1
TGTGCCAGCAGCGGACCCCTTCTGGGGGTTTTACCGTATAGCAATCAGCCCCAGCATTTT	CASSGPLLGVLPYSNQPQHF	TRBV9	TRBJ1-5
TGTGCCAGCAGCGGCGTAGCGGCGGGGGACTACGAGCAGTACTTC	CASSGVAAGDYEQYF	TRBV9	TRBJ2-7
TGTGCCAGCAGCCAAGCCTTAGAAAACGGCAATCAGCCCCAGCATTTT	CASSQALENGNQPQHF	TRBV3-1	TRBJ1-5
TGTGCCAGCACAGCGGGACTCTCCTACGAGCAGTACTTC	CASTAGLSYEQYF	TRBV13	TRBJ2-7
TGTGCCAGCAGTAAGACCCTCCTTCGGTACGAGCAGTACTTC	CASSKTLLRYEQYF	TRBV12-4	TRBJ2-7
TGTGCCAGCAGCTTAGGGCGTTCCGAGGGGGCTTGGCTTGACGAGCAGTACTTC	CASSLGRSEGAWLDEQYF	TRBV7-6	TRBJ2-7
TGTGCCAGCAGCGGGAGGGAGGGCGAAGTGGGATCCTACGAGCAGTACTTC	CASSGREGEVGSYEQYF	TRBV7-4	TRBJ2-7
TGTGCCAGCAGTTTGGGGGGGGTGTACGAGCAGTACTTC	CASSLGGVYEQYF	TRBV6-1	TRBJ2-7
TGTGCCAGTAGTATAGGTCAGACCACCAGGGGGACCAATCAGCCCCAGCATTTT	CASSIGQTTRGTNQPQHF	TRBV19	TRBJ1-5
TGTGCCAGCAGCTCCTTACGCCCCAGCATTCGCTCCTACGAGCAGTACTTC	CASSSLRPSIRSYEQYF	TRBV7-3	TRBJ2-7
TGTGCCAGCACCGGTAGCGACACCTACGAGCAGTACTTC	CASTGSDTYEQYF	TRBV2	TRBJ2-7
TGCAGTGCTAGAGCATCCGGGACTAGCATATTTCTAAGAAGCTCCTACGAGCAGTACTTC	CSARASGTSIFLRSSYEQYF	TRBV20-1	TRBJ2-7
TGTGCCAGCAGTTTACCCGGGGGGGCATATTCTAGGATCTCTGGAAACACCATATATTTT	CASSLPGGAYSRISGNTIYF	TRBV12-4	TRBJ1-3
TGTGCCACCCTCCTAGGGTTCTACGAGCAGTACTTC	CATLLGFYEQYF	TRBV24-1	TRBJ2-7
TGCAGTGCTAGAGCTCTCTCCAGGGAGGGTATTCGAGAAAGCTATGGCTACACCTTC	CSARALSREGIRESYGYTF	TRBV20-1	TRBJ1-2
TGTGCCAGCAGTGACTCTCCCATCCTCATGATAGGTTACTCTGGAAACACCATATATTTT	CASSDSPILMIGYSGNTIYF	TRBV6-4	TRBJ1-3
TGTGCTAGTGGAGACCCGGGGGGACGGGATAACAAAAACATTCAGTACTTC	CASGDPGGRDNKNIQYF	TRBV12-5	TRBJ2-4
TGTGCTAGTGGTTTGGCATTAGATGTCGGACAGTATTACTATGGCTACACCTTC	CASGLALDVGQYYYGYTF	TRBV12-5	TRBJ1-2
TGTGCCACCAGCAGAGGTAAAGAAGCGGGCGCCTGTTTGATAGAGACCCAGTACTTC	CATSRGKEAGACLIETQYF	TRBV15	TRBJ2-5
TGTGCCAGCAGTCTCGGGGCCTACGAGCAGTACTTC	CASSLGAYEQYF	TRBV6-3	TRBJ2-7
TGTGCCAGCAGCCCGGGGGGGAAGTGTAACGAGCAGTACTTC	CASSPGGKCNEQYF	TRBV7-3	TRBJ2-7
TGCGCCAGCATAGTGTCTCGTGAGCAGTTCTTC	CASIVSREQFF	TRBV5-1	TRBJ2-1
TGCGCCAGCAGTCGCGCAAGCCGGGACAGGGGGGGCAGCAATCAGCCCCAGCATTTT	CASSRASRDRGGSNQPQHF	TRBV10-2	TRBJ1-5
TGTGCCAGCAGCGCAGGGCTAGGAGGAAATGAAAAACTGTTTTTT	CASSAGLGGNEKLFF	TRBV6-4	TRBJ1-4
TGTGCCAGCAGCTTTGTCCGGACAGGGGTCGGGGAGCTGTTTTTT	CASSFVRTGVGELFF	TRBV9	TRBJ2-2
TGTGCCAGTAGGCCGCCGACAGGCTCCGACCGGACTGAAGCTTTCTTT	CASRPPTGSDRTEAFF	TRBV19	TRBJ1-1
TGTGCCGGACTAGCGAACGGAGGGTTCCGGTCGCAGTACTTC	CAGLANGGFRSQYF	TRBV6-1	TRBJ2-7
TGTCTACGTCGCCAGCAAGAGGCGAACACCGGGGAGCTGTTTTTT	CLRRQQEANTGELFF	TRBV6-1	TRBJ2-2
TGTGCCAGCAGTTCCCGGGAGCAGCCCCAGCATTTT	CASSSREQPQHF	TRBV28	TRBJ1-5
TGTGCCAGCAGCTTACAAGAGACCCAGTACTTC	CASSLQETQYF	TRBV7-2	TRBJ2-5
TGTGCCAGCAACGGAGGGACCAACACCGGGGAGCTGTTTTTT	CASNGGTNTGELFF	TRBV27	TRBJ2-2
TGCGCCAGCAGCTACCCACCGGGACTGTCCAAAAAAAACATTCAGTACTTC	CASSYPPGLSKKNIQYF	TRBV5-1	TRBJ2-4
TGTGCCAGCAGCTACATCACTAGGGGGTTTGAGCAGTTCTTC	CASSYITRGFEQFF	TRBV9	TRBJ2-1
TGTGCCATCAGTGAGTCGACGGACGAGCAGTACTTC	CAISESTDEQYF	TRBV10-3	TRBJ2-7
TGTGCCAGCAGCGGTCCACACGGGAAGAACACCGGGGAGCTGTTTTTT	CASSGPHGKNTGELFF	TRBV9	TRBJ2-2
TGTGCCAGCAAGGGTCCCCGACAAGAGACCCAGTACTTC	CASKGPRQETQYF	TRBV12-3	TRBJ2-5
TGTGCCAGCAGCCAAGAGGAGACAGGCGATAGCTCCTACAATGAGCAGTTCTTC	CASSQEETGDSSYNEQFF	TRBV14	TRBJ2-1
TGTGCCAGCAGCTCTCCTGTCTCTTGGGAGGGCCCCGGGCGCTCTGGAAACACCATATATTTT	CASSSPVSWEGPGRSGNTIYF	TRBV7-2	TRBJ1-3
TGTGCCAGCAGCCCGGCCGGGACAGGGCGGAGGTACCAAGAGACCCAGTACTTC	CASSPAGTGRRYQETQYF	TRBV13	TRBJ2-5
TGTGCCAGCCAGACTAGACCGGGTCAAGAGACCCAGTACTTC	CASQTRPGQETQYF	TRBV7-9	TRBJ2-5
TGCGCCAGCAGTGACCTCGGGGGAGGTCCTGGTGTTAACAATGAGCAGTTCTTC	CASSDLGGGPGVNNEQFF	TRBV10-1	TRBJ2-1
TGTGCCAGCAGTATCACGGACAGGGGGGTGGCAAACCCTGGGGCCAACGTCCTGACTTTC	CASSITDRGVANPGANVLTF	TRBV27	TRBJ2-6
TGTGCCAGCAGTGACACGGTAGTGGGGAGCAATCAGCCCCAGCATTTT	CASSDTVVGSNQPQHF	TRBV6-5	TRBJ1-5
TGTGCCAGCAGTCGGGAGGAGAACTACCTGAACACTGAAGCTTTCTTT	CASSREENYLNTEAFF	TRBV6-4	TRBJ1-1
TGTGCCAGCAGCCAAGCTCAGGGCGATGATCAGCCCCAGCATTTT	CASSQAQGDDQPQHF	TRBV3-1	TRBJ1-5
TGTGCCAGCAGTTACCAGGGGATAGCGTACGAGCAGTACTTC	CASSYQGIAYEQYF	TRBV6-3	TRBJ2-7
TGTGCCAGCAGCGTCCGGGACGATCAGCCCCAGCATTTT	CASSVRDDQPQHF	TRBV7-8	TRBJ1-5
TGTGCCAGCAGCCTGGATCCCGGGAATGAGCAGTTCTTC	CASSLDPGNEQFF	TRBV13	TRBJ2-1
TGTGCCAGCAGTTACCAAGTACAGGGCGCCATGAACACTGAAGCTTTCTTT	CASSYQVQGAMNTEAFF	TRBV6-5	TRBJ1-1
TGTGCCACCAGCAGAGCTCCCCGGACAGGGGTGAACACTGAAGCTTTCTTT	CATSRAPRTGVNTEAFF	TRBV15	TRBJ1-1
TGCAGCGTTGAGGAGTCTAACTCCTACAATGAGCAGTTCTTC	CSVEESNSYNEQFF	TRBV29-1	TRBJ2-1
TGTGCCAGCAGTAACGGGCCGGGGGGGCCCCGGAAATACAATGAGCAGTTCTTC	CASSNGPGGPRKYNEQFF	TRBV12-3	TRBJ2-1
TGTGCCAGCAGCTTAGTCCTGGACAGTTACAAGCCCCAGCATTTT	CASSLVLDSYKPQHF	TRBV7-9	TRBJ1-5
TGCACGGATCGGGATCCGGGCACAGATACGCAGTATTTT	CTDRDPGTDTQYF	TRBV20-1	TRBJ2-3
TGTGCTACCGGGACTAGCGGAGCACATGCCGAGCAGTACTTC	CATGTSGAHAEQYF	TRBV7-2	TRBJ2-7
TGTGCCAGCAGTGAACTAGGCTACGAGCAGTACTTC	CASSELGYEQYF	TRBV2	TRBJ2-7
TGTGCCAGCAGCGCCGTCTTAGCGGATTGTAATGCAGATACGCAGTATTTT	CASSAVLADCNADTQYF	TRBV13	TRBJ2-3
TGTGCCAGCAGCGACCGGGTCCGGGACAGGGCTTCCTTC	CASSDRVRDRASF	TRBV13	TRBJ1-2
TGTGCCAGCACCACCGGGACAGGGGTCCGGTGGGATACGCAGTATTTT	CASTTGTGVRWDTQYF	TRBV7-3	TRBJ2-3
TGTGCCACCAGTGATCAAACGAGGGGGACCCAGTACTTC	CATSDQTRGTQYF	TRBV24-1	TRBJ2-5
TGTGCCAGCAGGCGTCCGAGGGGGGAGGCCGGAGATACGCAGTATTTT	CASRRPRGEAGDTQYF	TRBV11-3	TRBJ2-3
TGTGCCAGCAGCTTAGGAGGGGGCGGGTCCTACGAGCAGTACTTC	CASSLGGGGSYEQYF	TRBV11-3	TRBJ2-7
TGTGCCAGCAGAGCGGGCAAAAACATTCAGTACTTC	CASRAGKNIQYF	TRBV6-1	TRBJ2-4
TGCAGCGTTCCGGGGGACACTAAGTTAGGCTACACCTTC	CSVPGDTKLGYTF	TRBV29-1	TRBJ1-2
TGTGCCAGCAGCTGTGAAAGGGGGAACCTAGCGGGGGTAGCGAAACCCTACGAGCAGTACTTC	CASSCERGNLAGVAKPYEQYF	TRBV5-4	TRBJ2-7
TGTGCCAGCAGCGTCAATACGGACACATACGAGCAGTACTTC	CASSVNTDTYEQYF	TRBV5-4	TRBJ2-7
TGTGCCAGCGGCCCCGGGACAGGGGCTATAGAGACCCAGTACTTC	CASGPGTGAIETQYF	TRBV13	TRBJ2-5
TGCAGCGTGGCTACCCGGGCTGGCGGGAGCGAAAGGACCTACGAGCAGTACTTC	CSVATRAGGSERTYEQYF	TRBV29-1	TRBJ2-7
TGTGCCAGCAGCGTTACAGGGGGCACCGACGAGCAGTACTTC	CASSVTGGTDEQYF	TRBV13	TRBJ2-7
TGTGCCAGCAGTTCACCCATCGGGGGACAGCCCCAGCATTTT	CASSSPIGGQPQHF	TRBV6-5	TRBJ1-5
TGTGCCAGCAGCTTGGTAGGCCGATGGCGAGCCAATAATTCACCCCTCCACTTT	CASSLVGRWRANNSPLHF	TRBV5-4	TRBJ1-6
TGTGCCAGCAGCATATGTCCCCCGGGTCTAGAGACTAACTATGGCTACACCTTC	CASSICPPGLETNYGYTF	TRBV9	TRBJ1-2
TGTGCCAGCAGTTACTCGACCCTGGACAGCAAAAGTGAAGCTTTCTTT	CASSYSTLDSKSEAFF	TRBV6-6	TRBJ1-1
TGTGCCAGCAGTAGGGGGGCACCCACAGATACGCAGTATTTT	CASSRGAPTDTQYF	TRBV5-5	TRBJ2-3
TGTGCCAGTAGTATCCCCCCGGGACAGATGCAGCCCCAGCATTTT	CASSIPPGQMQPQHF	TRBV19	TRBJ1-5
TGTGCCACCTTTTTCGGCGGACAAAACACTGAAGCTTTCTTT	CATFFGGQNTEAFF	TRBV24-1	TRBJ1-1
TGTGCCAGCAGCTTAGGCGGACAGGGTAATCATGGCTACACCTTC	CASSLGGQGNHGYTF	TRBV7-9	TRBJ1-2
TGCGCCAGCAGCTCTAGCGGTCCAGACTACTACGAGCAGTACTTC	CASSSSGPDYYEQYF	TRBV5-1	TRBJ2-7
TGTGCCAGCAGCCAAGCGGTAACCTACGAGCAGTACTTC	CASSQAVTYEQYF	TRBV7-3	TRBJ2-7
TGCGCCAGCGGTCAAACTAGCGGGAGCTCCTACAATGAGCAGTTCTTC	CASGQTSGSSYNEQFF	TRBV5-1	TRBJ2-1
TGTGCCAGCAGTGCGGGAGGGCCACACACCGGGGAGCTGTTTTTT	CASSAGGPHTGELFF	TRBV12-3	TRBJ2-2
TGTGCCAGCTCACCGGACCCCGGGGGCAATCAGCCCCAGCATTTT	CASSPDPGGNQPQHF	TRBV18	TRBJ1-5
TGTGCCAGCAGCGCGGGAGACACCGGGGAGCTGTTTTTT	CASSAGDTGELFF	TRBV7-9	TRBJ2-2
TGTGCCACTGTTCGCCAGGAGAATGTCTACGAGCAGTACTTC	CATVRQENVYEQYF	TRBV24-1	TRBJ2-7
TGTGCCAGCAGCGTAAGGGAGGGAAACACTGAAGCTTTCTTT	CASSVREGNTEAFF	TRBV9	TRBJ1-1
TGTGCCAGCAGCCCAGGGTCAGTAAACGCGACGCGGCGCGGGGAGCTGTTTTTT	CASSPGSVNATRRGELFF	TRBV13	TRBJ2-2
TGTGCCAGCAGCTTCAGTTGGACAGGGGCCTACGAGCAGTACTTC	CASSFSWTGAYEQYF	TRBV5-8	TRBJ2-7
TGTGCCAGCTCACAGGAGACGGTCCGGACAGGGGGGGCTAGCACAGATACGCAGTATTTT	CASSQETVRTGGASTDTQYF	TRBV18	TRBJ2-3
TGTGCCAGCAGCTTCCAGGCCTCCGGGACTAGCGGGAGACAATTGGGCGGGGAGCTGTTTTTT	CASSFQASGTSGRQLGGELFF	TRBV7-2	TRBJ2-2
TGTGCCATGCAACTCCTAGCGTCTTCAGATACGCAGTATTTT	CAMQLLASSDTQYF	TRBV27	TRBJ2-3
TGCAGTGCTAGGCTACGTGGTAGACCCATCTACGAGCAGTACTTC	CSARLRGRPIYEQYF	TRBV20-1	TRBJ2-7
TGCAGTGCTAGAGCCCCATCTGCAGTCCCCTATAATTCACCCCTCCACTTT	CSARAPSAVPYNSPLHF	TRBV20-1	TRBJ1-6
TGTGCCAGCAGCTTAACGTATGGGCCCGAACGGACCCAGTACTTC	CASSLTYGPERTQYF	TRBV11-3	TRBJ2-5
TGTGCCAGCAGTTTGTCGGGGCGAACATCTGGGGCCAACGTCCTGACTTTC	CASSLSGRTSGANVLTF	TRBV28	TRBJ2-6
TGTGCCAGCAGCATCCCCCGGCGTGGCTACACCTTC	CASSIPRRGYTF	TRBV13	TRBJ1-2
TGTGCCAGCAGTGAATCCCGCATGTATGCGGGAGGCAATCAGCCCCAGCATTTT	CASSESRMYAGGNQPQHF	TRBV6-1	TRBJ1-5
TGCAGTGCTAGGGCCCGATGGTGTGAGCAGTACTTC	CSARARWCEQYF	TRBV20-1	TRBJ2-7
TGTGCCAGCGAAGGGACAGATTCGTCCTACGAGCAGTACTTC	CASEGTDSSYEQYF	TRBV6-4	TRBJ2-7
TGTGCCAGCAGCCAAATGGGGGGGGAAAGCACAGATACGCAGTATTTT	CASSQMGGESTDTQYF	TRBV3-1	TRBJ2-3
TGTGCCAGCAGCCAAGCCGGGACAGACCTTAGCAATCAGCCCCAGCATTTT	CASSQAGTDLSNQPQHF	TRBV14	TRBJ1-5
TGTGCCGGAGTTGGAAAGGGAACCGACAACCGCCGCAATCAGCCCCAGCATTTT	CAGVGKGTDNRRNQPQHF	TRBV30	TRBJ1-5
TGCGCCAGCAGTGAGTCGACTACACCGGGACAGGGATACTATGGCTACACCTTC	CASSESTTPGQGYYGYTF	TRBV10-1	TRBJ1-2
TGTGCCAGCAGTTACATACTAGATGAGCAGTTCTTC	CASSYILDEQFF	TRBV6-2	TRBJ2-1
TGTGCCAGCAGCTGGGGGTCCGACAGGGAGTTCAGATTTTATGAGCAGTTCTTC	CASSWGSDREFRFYEQFF	TRBV5-6	TRBJ2-1
TGCAGTGCTAGCACCACAGTTTCTGGGGCCAACGTCCTGACTTTC	CSASTTVSGANVLTF	TRBV20-1	TRBJ2-6
TGTGCCAGCAGCACCCTAGCGGGGAGGGTCGCGAACACCGGGGAGCTGTTTTTT	CASSTLAGRVANTGELFF	TRBV13	TRBJ2-2
TGTGCCAGCAGCCGGAGCAGAATCGGAGCTAACTATGGCTACACCTTC	CASSRSRIGANYGYTF	TRBV7-9	TRBJ1-2
TGTGCCAGCAGTCAGGGGGGGATGCATCGAGGAGTCCAAGAGACCCAGTACTTC	CASSQGGMHRGVQETQYF	TRBV6-1	TRBJ2-5
TGCGCCAGCAGCGCCCGGACAGGGGCGGCCTACGAGCAGTACTTC	CASSARTGAAYEQYF	TRBV5-1	TRBJ2-7
TGCAGTGCTAGAGGCAGGGACAGGGGGGCATCGAGACCTGGAAACACCATATATTTT	CSARGRDRGASRPGNTIYF	TRBV20-1	TRBJ1-3
TGCAGTGCTAGGGACAGGACAAACTATGGCTACACCTTC	CSARDRTNYGYTF	TRBV20-1	TRBJ1-2
TGCAGTGCTAGAGATTCGTATACTGGCTACACCTTC	CSARDSYTGYTF	TRBV20-1	TRBJ1-2
TGTGCCAGCAGCTTAGGGGAACTGACAGGGAGGAACTCCTACGAGCAGTACTTC	CASSLGELTGRNSYEQYF	TRBV11-2	TRBJ2-7
TGTGCCAGCAGCTTGCGGGAGGCAGAAGGGCAAGAGACCCAGTACTTC	CASSLREAEGQETQYF	TRBV5-5	TRBJ2-5
TGTGCCAGCTTGGGGGGGAAAGATAATCAAGAGACCCAGTACTTC	CASLGGKDNQETQYF	TRBV7-8	TRBJ2-5
TGCGCCAGCAGAGGGAATGGCTACACCTTC	CASRGNGYTF	TRBV4-1	TRBJ1-2
TGCGCCAGCAGGTGGGGCCCAGGCTACACCTTC	CASRWGPGYTF	TRBV10-1	TRBJ1-2
TGTGCCAGCAAAGAGTTGGCTTCTAGCGGGGAGTCCAATGAAGGTACCTACGAGCAGTACTTC	CASKELASSGESNEGTYEQYF	TRBV6-4	TRBJ2-7
TGTGCCAGCAGTCTCTGGCCCACCACCATATATTTT	CASSLWPTTIYF	TRBV28	TRBJ1-3
TGTGCCAGCAGCTTCAGTCCTCAAGAGACCCAGTACTTC	CASSFSPQETQYF	TRBV7-2	TRBJ2-5
TGCAGTGCTAGAGGGTTAACGGTGGGGAAACTATATCATGGCTACACCTTC	CSARGLTVGKLYHGYTF	TRBV20-1	TRBJ1-2
TGTGCCAGCAGTTTAAGAAAACAGGGGGAACGCAATCAGCCCCAGCATTTT	CASSLRKQGERNQPQHF	TRBV27	TRBJ1-5
TGTGCCAGCAATGTTCAAAAGGGCTACACCTTC	CASNVQKGYTF	TRBV6-2	TRBJ1-2
TGTGCCAGCAGCTTAAGGTATACAGGGGGCCTAGGTAGCAATCAGCCCCAGCATTTT	CASSLRYTGGLGSNQPQHF	TRBV7-3	TRBJ1-5
TGCAGCGAGATTAGTTCGTTAACTAAGAACACTGAAGCTTTCTTT	CSEISSLTKNTEAFF	TRBV29-1	TRBJ1-1
TGTGCCTGGATAATCGACCCCGGTCCTGCCAAAAACATTCAGTACTTC	CAWIIDPGPAKNIQYF	TRBV30	TRBJ2-4
TGTGCCAGCAGCTCGAAAAGAGCTGACTTC	CASSSKRADF	TRBV7-2	TRBJ2-5
TGTGCCAGCAGCCGTTCAGCGGGGCAGTACTTC	CASSRSAGQYF	TRBV9	TRBJ2-7
TGTGCCAGCAGCAATCTCCTCGGGACAGGGGGCCAACCAACGAGTTCACCCCTCCACTTT	CASSNLLGTGGQPTSSPLHF	TRBV9	TRBJ1-6
TGTGCCACGCCCACAAATGGGAGCAATCAGCCCCAGCATTTT	CATPTNGSNQPQHF	TRBV24-1	TRBJ1-5
TGTGCCAGCAGTTTAGACCCCCTGAAGGACCGCGAGACCCAGTACTTC	CASSLDPLKDRETQYF	TRBV27	TRBJ2-5
TGCGCCAGCAGTGTGGGGGTCGTGGGACAGCCCCAGCATTTT	CASSVGVVGQPQHF	TRBV10-1	TRBJ1-5
TGTGCCAGCAGCTTAAGTAAGAAGGGGTATCAGCCCCAGCATTTT	CASSLSKKGYQPQHF	TRBV7-9	TRBJ1-5
TGTGCCAGCAGTTATGGACAGGAAACTGAAGCTTTCTTT	CASSYGQETEAFF	TRBV6-3	TRBJ1-1
TGTGCCTGGAGGGAAGGGCTAGAAGGCGGGGAGCTGTTTTTT	CAWREGLEGGELFF	TRBV30	TRBJ2-2
TGTGCCAGCACTAGCGGGACAGACGTTAACCTTCAGCCCCAGCATTTT	CASTSGTDVNLQPQHF	TRBV2	TRBJ1-5
TGTGCCACCAGTGATTTTGGACAGGAAAGGAGAGGGCGACTGAATCAGCCCCAGCATTTT	CATSDFGQERRGRLNQPQHF	TRBV24-1	TRBJ1-5
TGTGCCAGCAGCCAAGGTAAGGACAGGGGGCCGATTGAAGCTTTCTTT	CASSQGKDRGPIEAFF	TRBV3-1	TRBJ1-1
TGTGCCAGCAGCCCTAGGGGGAGCACCGGGGAGCTGTTTTTT	CASSPRGSTGELFF	TRBV7-2	TRBJ2-2
TGTGCCACCAGTAAGAACACTAGCGGGAGTACATCCACCTCTGGGGCCAACGTCCTGACTTTC	CATSKNTSGSTSTSGANVLTF	TRBV24-1	TRBJ2-6
TGTGCCAGCGGCCTGGGCAGGGATGAGGCCACGTCAGGTAACTATGGCTACACCTTC	CASGLGRDEATSGNYGYTF	TRBV11-3	TRBJ1-2
TGTGCCAGCAAGACAGGGGGTGAGTTGGAAATAGGGACCACCCAGTTCATGAACACTGAAGCTTTCTTT	CASKTGGELEIGTTQFMNTEAFF	TRBV28	TRBJ1-1
TGCGCCAGCAGCTTGGGAAGGGACAGGGACACAGATACGCAGTATTTT	CASSLGRDRDTDTQYF	TRBV5-1	TRBJ2-3
TGTGCCAGCAGCTTACCCCCGGGACAGGGTTTCAATAGCACAGATACGCAGTATTTT	CASSLPPGQGFNSTDTQYF	TRBV7-4	TRBJ2-3
TGTGCCAGCAGTTCTAATTGGGGACCATCTGAAAAACTGTTTTTT	CASSSNWGPSEKLFF	TRBV6-2	TRBJ1-4
TGTGCCAGCAGTTTAGGGAGATCCGGCGAGGCTTTCTTT	CASSLGRSGEAFF	TRBV27	TRBJ1-1
TGTGCCAGCAGTGACAGCCCAGCTCTAATGAACACTGAAGCTTTCTTT	CASSDSPALMNTEAFF	TRBV6-4	TRBJ1-1
TGTGCCAGCTCACGGCCTGACAGGCGCGGATCGGGAGTCCGTAATGAAAAACTGTTTTTT	CASSRPDRRGSGVRNEKLFF	TRBV18	TRBJ1-4
TGTGCCAGCAGCCCCCCCCGGGACCAAGAGCAGTACTTC	CASSPPRDQEQYF	TRBV13	TRBJ2-7
TGTGCCACAGGACGCTCCGTAAGCGAGCAGTACTTC	CATGRSVSEQYF	TRBV3-1	TRBJ2-7
TGCAGTGCTAGCCCCCCCCGAGGGACACGGACAAACCGTAAGATCCGGGAAGGAGATACGCAGTATTTT	CSASPPRGTRTNRKIREGDTQYF	TRBV20-1	TRBJ2-3
TGTGCCAGCAGTTACGCCGGGACAGGGGTTGCCGACTCTGGGGCCAACGTCCTGACTTTC	CASSYAGTGVADSGANVLTF	TRBV6-6	TRBJ2-6
TGTGCCAGCAGCTTAGGAGGGGGAATTGCCACTGAAGCTTTCTTT	CASSLGGGIATEAFF	TRBV11-2	TRBJ1-1
TGTGCCACCAGCAGTACGACCCTCCACACTGAAGCTTTCTTT	CATSSTTLHTEAFF	TRBV15	TRBJ1-1
TGCGCCAGCAGCTCAGGTCTAGAGGAGTATTTCTCCTACGAGCAGTACTTC	CASSSGLEEYFSYEQYF	TRBV5-1	TRBJ2-7
TGTGCCAGCAGTTTAAGGAGGGGCGGGGATAATGAAAAACTGTTTTTT	CASSLRRGGDNEKLFF	TRBV27	TRBJ1-4
TGCGCCAGCAGCTTCGCTCAAGTGGCGCCCTATGGCTACACCTTC	CASSFAQVAPYGYTF	TRBV5-1	TRBJ1-2
TGCGCCAGCAGCCTAGGCGGGAGCTCCTACGAGCAGTACTTC	CASSLGGSSYEQYF	TRBV4-1	TRBJ2-7
TGTGCCCCTAGCGGGAGGAACAATGAGCAGTTCTTC	CAPSGRNNEQFF	TRBV24-1	TRBJ2-1
TGTGCCACCAGTGACTGGGGGGGTTTGAACACTGAAGCTTTCTTT	CATSDWGGLNTEAFF	TRBV24-1	TRBJ1-1
TGTGCCAGCAGCTCTGATCGGGCCTCTGGAAACACCATATATTTT	CASSSDRASGNTIYF	TRBV7-4	TRBJ1-3
TGTGCCAGTCGGTCAGATCACAGGGAGCCCCCGCCCCAGCATTTT	CASRSDHREPPPQHF	TRBV19	TRBJ1-5
TGTGCCAGCAGCCGGTGTTTTGGCGGGGGGGGAGTCTACGAGCAGTACTTC	CASSRCFGGGGVYEQYF	TRBV7-3	TRBJ2-7
TGTGCCAGCAGTTACGTCAGATTACGAGAGCAGTACTTC	CASSYVRLREQYF	TRBV6-2	TRBJ2-7
TGTGCCAGCAGTTACTCGAGGGCATCCCCGGCCCGGGACAGGGAGCTCAGGGGGGGCTACACCTTC	CASSYSRASPARDRELRGGYTF	TRBV6-2	TRBJ1-2
TGTGCCAGCAGCTTAAGCAGGCGGGGAAAGGGATCCGGAGATACGCAGTATTTT	CASSLSRRGKGSGDTQYF	TRBV7-3	TRBJ2-3
TGTGCCAGCAGCTTGGCCCATATCTGGTGCAATGAGCAGTTCTTC	CASSLAHIWCNEQFF	TRBV5-4	TRBJ2-1
TGTGCGCTGACCTTAAGCCCGGTCGCAGGGAGGATAAGGCGGGGAATTAATCAGCCCCAGCATTTT	CALTLSPVAGRIRRGINQPQHF	TRBV27	TRBJ1-5
TGTGCCAGCAGCATTAGTGAATACAATGAGCAGTTCTTC	CASSISEYNEQFF	TRBV7-3	TRBJ2-1
TGTGCCAGCAGGGGGGGGCGCGGCTACAATGAGCAGTTCTTC	CASRGGRGYNEQFF	TRBV6-4	TRBJ2-1
TGTGCCAGCAGTTACTCGACTATCCACCTCAGGGAGAACTATGGCTACACCTTC	CASSYSTIHLRENYGYTF	TRBV6-3	TRBJ1-2
TGTGCCAGCCGGTTGGGGGGTAGCTCCTACGAGCAGTACTTC	CASRLGGSSYEQYF	TRBV6-1	TRBJ2-7
TGTGCCAGCAGCTTAACATATCATCAGCCCCAGCATTTT	CASSLTYHQPQHF	TRBV7-9	TRBJ1-5
TGTGCCATTAGTTGGACAAAAGTCGAGCCCCAGCATTTT	CAISWTKVEPQHF	TRBV10-3	TRBJ1-5
TGTGCCAGCAGTGAGCCCAGGGCGACTACCAATCAGCCCCAGCATTTT	CASSEPRATTNQPQHF	TRBV25-1	TRBJ1-5
TGCGCCAGCCTACCCAATGAGCAGTTCTTC	CASLPNEQFF	TRBV10-1	TRBJ2-1
TGTGCCACCAGTCTTAGGAACTACAATGAGCAGTTCTTC	CATSLRNYNEQFF	TRBV24-1	TRBJ2-1
TGTGCCAGCAGCTTCCTAGGGGAGGCAACTAATGAAAAACTGTTTTTT	CASSFLGEATNEKLFF	TRBV5-8	TRBJ1-4
TGCAGTGCTAGAGCCCAGACAGGGGAGAACAGGTCTGGAAACACCATATATTTT	CSARAQTGENRSGNTIYF	TRBV20-1	TRBJ1-3
TGTGCCAGCAATGGGGACAGGGAGGAATACGAGCAGTACTTC	CASNGDREEYEQYF	TRBV6-6	TRBJ2-7
TGTGCCAGCAGCTTAGGACCAGGGACTAGCGGGCAACTCTTC	CASSLGPGTSGQLF	TRBV11-3	TRBJ2-1
TGTGCCAGCAGTCCGGGGGCACGCACAGATACGCAGTATTTT	CASSPGARTDTQYF	TRBV9	TRBJ2-3
TGTGCCAGCAGTGGTCCACAGGGTATTTTCACTGAAGCTTTCTTT	CASSGPQGIFTEAFF	TRBV6-4	TRBJ1-1
TGTGCCAGCATGTCGACTAGCGGGGGGCCGGTAGAGACCCAGTACTTC	CASMSTSGGPVETQYF	TRBV6-4	TRBJ2-5
TGTGCCCCCATCAGGACCTCTGGAAACACCATATATTTT	CAPIRTSGNTIYF	TRBV6-4	TRBJ1-3
TGTGCCAGTAGTATAGATTCGGACAGGCTTAGCCTCACTGAAGCTTTCTTT	CASSIDSDRLSLTEAFF	TRBV19	TRBJ1-1
TGTGCTAGTGGCATGGGACAGGGCGGGGATCAGCCCCAGCATTTT	CASGMGQGGDQPQHF	TRBV12-5	TRBJ1-5
TGTGCCAGCAGGTTTAGCGGGACCGTATCCGGGGAGCTGTTTTTT	CASRFSGTVSGELFF	TRBV7-9	TRBJ2-2
TGTGCCAGCAGCCGAGGACGGGATACGCAGTATTTT	CASSRGRDTQYF	TRBV3-1	TRBJ2-3
TGTGCCAGCAGCACCGGTAAATTCCACCTGGGGGCCCCCGGCACAGATACGCAGTATTTT	CASSTGKFHLGAPGTDTQYF	TRBV13	TRBJ2-3
TGTGCCAGCAGCAAGTCAGCAGGTCAGCCCCAGCATTTT	CASSKSAGQPQHF	TRBV7-3	TRBJ1-5
TGTGCCAGCAGCACACCCAAGAACCCGACTAGGCAAGGCCGCTACGAGCAGTACTTC	CASSTPKNPTRQGRYEQYF	TRBV7-9	TRBJ2-7
TGCAGTGCTCAGGGAAACACTGAAGCTTTCTTT	CSAQGNTEAFF	TRBV20-1	TRBJ1-1
TGTGCCAGCACGCGACAGACGGCTAACTATGGCTACACCTTC	CASTRQTANYGYTF	TRBV28	TRBJ1-2
TGTGCCAGTAGTATAACGAGGGAGGAGGTCAATGAGCAGTTCTTC	CASSITREEVNEQFF	TRBV19	TRBJ2-1
TGTGCCAGCAGGCGACAGGTCGAGACCCAGTACTTC	CASRRQVETQYF	TRBV27	TRBJ2-5
TGCGCCAGCAGTAAAGCCAAATACAGGGGGCATGAAAAACTGTTTTTT	CASSKAKYRGHEKLFF	TRBV10-1	TRBJ1-4
TGTGCCAGCAGTTACTCGAAACGACAGGAAGGCGAGCAGTACTTC	CASSYSKRQEGEQYF	TRBV6-5	TRBJ2-7
TGTGCCAGCAGTGGGACTGGGGGATCCTACGAGCAGTACTTC	CASSGTGGSYEQYF	TRBV6-4	TRBJ2-7
TGCGCCAGCAGCAATTTGAGGGGTCTTCCCAATGAGCAGTTCTTC	CASSNLRGLPNEQFF	TRBV5-1	TRBJ2-1
TGTGCCAGCAGCCAGAGCGGGGGCCACAATGAGCAGTTCTTC	CASSQSGGHNEQFF	TRBV3-1	TRBJ2-1
TGTGCCAGCAGTTTTGTATATGGGGACAACCAGGGAAACACCATATATTTT	CASSFVYGDNQGNTIYF	TRBV28	TRBJ1-3
TGCAGTGCTAGGACCGGACTAGGGGGTGAGCAGTTCTTC	CSARTGLGGEQFF	TRBV20-1	TRBJ2-1
TGCAGTGCTAGGTCTAGCGGGCTCGAGCAGTTCTTC	CSARSSGLEQFF	TRBV20-1	TRBJ2-1
TGTGCCAGCAGTCAATCCGGAGACTTGTCCTCTGGAAACACCATATATTTT	CASSQSGDLSSGNTIYF	TRBV25-1	TRBJ1-3
TGTGCCAGTAGTATCCCTCGGGGGGGCCCGGCTCCTAGCACAGATACGCAGTATTTT	CASSIPRGGPAPSTDTQYF	TRBV19	TRBJ2-3
TGTGCCCATGTGGACGCTGCTTTCTTT	CAHVDAAFF	TRBV30	TRBJ1-1
TGTGCCAGCAGCCCCCAGGGCCCCAAGGCTTTCTTT	CASSPQGPKAFF	TRBV7-6	TRBJ1-1
TGTGCCAGCAGGCCCGTTCTCGCCAGAAATCCCTATGGCTACACCTTC	CASRPVLARNPYGYTF	TRBV12-3	TRBJ1-2
TGTGCCAGCAGCTTCTCGCTAGGGGGGGCCAATGAGCAGTTCTTC	CASSFSLGGANEQFF	TRBV5-4	TRBJ2-1
TGTGCCAGCAGTTCGAGCCCCGGGGAGGAGGCATCTGAAGCTTTCTTT	CASSSSPGEEASEAFF	TRBV6-1	TRBJ1-1
TGTGCCAGCACCCGGCCGGCCGGGACAGGGTTCGAGGGCGGGCGTTATTTACCCCCTTCACCCCTCCACTTT	CASTRPAGTGFEGGRYLPPSPLHF	TRBV12-3	TRBJ1-6
TGTGCCAGCTATCCCCCCGATGAGGACTACTCCTATAATTCACCCCTCCACTTT	CASYPPDEDYSYNSPLHF	TRBV6-1	TRBJ1-6
TGCAGTGCTAGAGCGTTTCTTCCGGGACCGGACGAGCAGTACTTC	CSARAFLPGPDEQYF	TRBV20-1	TRBJ2-7
TGTGCCAGCTCACCCAGCGCTAGCGCAAATGAGCAGTTCTTC	CASSPSASANEQFF	TRBV18	TRBJ2-1
TGTGCCAGCAGCGTATGCGACCCCACGAATTGGGCTGAAAAACTGTTTTTT	CASSVCDPTNWAEKLFF	TRBV9	TRBJ1-4
TGTGCCAGCAGACAACAACGGGCCTACATTCAGTACTTC	CASRQQRAYIQYF	TRBV6-1	TRBJ2-4
TGTGCCAGCAGCTGGATGGGACTCGACGAGCAGTACTTC	CASSWMGLDEQYF	TRBV7-9	TRBJ2-7
TGTGCCAGCAGCGGGACTAGCGGAAAGGTCCCCTACGAGCAGTACTTC	CASSGTSGKVPYEQYF	TRBV5-4	TRBJ2-7
TGCGCCAGCAGTGGGCCCAAGGGACAGGGGAGCTACGAGCAGTACTTC	CASSGPKGQGSYEQYF	TRBV10-1	TRBJ2-7
TGCAGCGTTGATAACAAACAGCCCAGGGCCACGACCTATGGCTACACCTTC	CSVDNKQPRATTYGYTF	TRBV29-1	TRBJ1-2
TGTGCCAGCAGGATCGGGGGACAGGGGGGAGTTGGCTACACCTTC	CASRIGGQGGVGYTF	TRBV11-1	TRBJ1-2
TGTGCCAGCAGCCCTGGGGTTGATTGGCCCCATACGCAGTATTTT	CASSPGVDWPHTQYF	TRBV3-1	TRBJ2-3
TGCGCCAGAATGACAGGGTATGGCTACACCTTC	CARMTGYGYTF	TRBV5-1	TRBJ1-2
TGCAGCGTCTATTTTCCGACAGAGACCCAGTACTTC	CSVYFPTETQYF	TRBV29-1	TRBJ2-5
TGTGCCAGCAGCTTAGTACGCCGAGGAGCGGAGATTGACGAGCAGTACTTC	CASSLVRRGAEIDEQYF	TRBV11-3	TRBJ2-7
TGTGCCAGCAGCAAAACAGACAGGGCCTCTGAAGCTTTCTTT	CASSKTDRASEAFF	TRBV13	TRBJ1-1
TGTGCCAGCAGGGGATTAAAAGACTCCTATAATTCACCCCTCCACTTT	CASRGLKDSYNSPLHF	TRBV25-1	TRBJ1-6
TGTGCCAGCAGCCAAGAGGGGACGGAGGAGGAGAGTCCCCCTAAGGGCAATCAGCCCCAGCATTTT	CASSQEGTEEESPPKGNQPQHF	TRBV3-1	TRBJ1-5
TGTGCCAGCGCAGGGGAGTATCCGCCCCAGCATTTT	CASAGEYPPQHF	TRBV19	TRBJ1-5
TGCGCCAGCAGCCAAGCCAAGGGTGAACAGGGATCGAACACCGGGGAGCTGTTTTTT	CASSQAKGEQGSNTGELFF	TRBV4-3	TRBJ2-2
TGTGCCAGCAGCAGGGACAGGCGCTACGAGCAGTACTTC	CASSRDRRYEQYF	TRBV7-3	TRBJ2-7
TGTGCCAGCAGGGGGGTTAAGGATGAAGAGACCCAGTACTTC	CASRGVKDEETQYF	TRBV2	TRBJ2-5
TGCGCCATGAGGCATCCCCGATTAGCCCCCTCAGGGCGGACCCACACTGAAGCTTTCTTT	CAMRHPRLAPSGRTHTEAFF	TRBV10-2	TRBJ1-1
TGTGCCAGCAGCCAGAGATACGAGCAGTACTTC	CASSQRYEQYF	TRBV13	TRBJ2-7
TGCAGCGTCCCCCCGATATACTCCTACGAGCAGTACTTC	CSVPPIYSYEQYF	TRBV29-1	TRBJ2-7
TGCGCCAGCAGCCAAGCTCCGAAGGGGACTAGCGGGACGGAAGGTTTGTATTTT	CASSQAPKGTSGTEGLYF	TRBV4-1	TRBJ2-3
TGTGCCAGCAGTTACTCGGCGACGACCATGAACACTGAAGCTTTCTTT	CASSYSATTMNTEAFF	TRBV6-5	TRBJ1-1
TGTGCCAGCAGCTATCCGGGACAGGGCTATGGCTACACCTTC	CASSYPGQGYGYTF	TRBV11-1	TRBJ1-2
TGCGCCAGCAGTGATCCCCCTAGTAGTCGAGAATCCGGGACGGGCAAAAACATTCAGTACTTC	CASSDPPSSRESGTGKNIQYF	TRBV10-1	TRBJ2-4
TGTGCCAGCAGCTCCGCCGGGACAGAAAAACTGTTTTTT	CASSSAGTEKLFF	TRBV7-9	TRBJ1-4
TGTGCCAGCAGCATTACGGACAGGAGGGACGGGGAGCTGTTTTTT	CASSITDRRDGELFF	TRBV13	TRBJ2-2
TGTGCCAGCAGCGTGTTCCGGTACAGGGGAGTCAAAAACATTCAGTACTTC	CASSVFRYRGVKNIQYF	TRBV9	TRBJ2-4
TGCGCCAGAGATTGGGGCCCGGATAGCAATCAGCCCCAGCATTTT	CARDWGPDSNQPQHF	TRBV5-1	TRBJ1-5
TGCGCCAGCAGCCAAGATGGGGACAGGATTCTCCACTTT	CASSQDGDRILHF	TRBV4-1	TRBJ1-6
TGTGCCAGCAGCAACACGGGGGGGCTCGATGAGCAGTTCTTC	CASSNTGGLDEQFF	TRBV7-3	TRBJ2-1
TGTGCCACCAGCAGAGGCGGACAGGATGGGTATTCACCCCTCCACTTT	CATSRGGQDGYSPLHF	TRBV15	TRBJ1-6
TGTGCCAGTCCTGGCGCCCAGACCGGGGAGCTGTTTTTT	CASPGAQTGELFF	TRBV19	TRBJ2-2
TGTGCCAGCACGGGGGGCCATTCCTACGAGCAGTACTTC	CASTGGHSYEQYF	TRBV6-2	TRBJ2-7
TGTGCCACCAGCAGAGGGCCCTTCAAAAACATTCAGTACTTC	CATSRGPFKNIQYF	TRBV15	TRBJ2-4
TGTGCCAGCAGCTCGCCCACCCACAAGGGTTCTGAGTACACCTTC	CASSSPTHKGSEYTF	TRBV13	TRBJ1-2
TGCGCCAGCAGTCAGGACAGCGAGGTAGGTGCGATGAACACTGAAGCTTTCTTT	CASSQDSEVGAMNTEAFF	TRBV10-2	TRBJ1-1
TGTGCCAGCAGCCTCTACAGGGGGCTTCTCCACGAGCAGTACTTC	CASSLYRGLLHEQYF	TRBV7-9	TRBJ2-7
TGTGCCAGCATACAGGGACTAGAGAAGGCCGGGGAGCTGTTTTTT	CASIQGLEKAGELFF	TRBV6-1	TRBJ2-2
TGTGCCAGGGCCCGGGAGTTAAACATTCAGTACTTC	CARARELNIQYF	TRBV19	TRBJ2-4
TGTGCCAGCAGCCAAATGTCCGGCCCAAACATTCAGTACTTC	CASSQMSGPNIQYF	TRBV11-1	TRBJ2-4
TGTGCCAGCCGGCCTCCGGAGGAGGATGGCTACACCTTC	CASRPPEEDGYTF	TRBV27	TRBJ1-2
TGTGCCAGCATAAAAGACCGGGGGGGGGGGAACACTGAAGCTTTCTTT	CASIKDRGGGNTEAFF	TRBV6-4	TRBJ1-1
TGTGCCAGCAGAATCGTGGGACCAGGCTACGAGCAGTACTTC	CASRIVGPGYEQYF	TRBV28	TRBJ2-7
TGTGCCAGCAGCGTAATGGGCGACGCTGAAGCTTTCTTT	CASSVMGDAEAFF	TRBV9	TRBJ1-1
TGTGCCTGGAGTAGGGGGCCAGCTTTCTTT	CAWSRGPAFF	TRBV30	TRBJ1-1
TGTGCCAGCAGCCAAGAACCCGACAGGTGCGAAAATCAGCCCCAGCATTTT	CASSQEPDRCENQPQHF	TRBV14	TRBJ1-5
TGTGGGACAACCCTAGTCTCTGGGGCCAACGTCCTGACTTTC	CGTTLVSGANVLTF	TRBV27	TRBJ2-6
TGTGCCAGCAGAACTTTAGCGGGAGGGTCCTACAATGAGCAGTTCTTC	CASRTLAGGSYNEQFF	TRBV12-4	TRBJ2-1
TGCAGTGCTAGTCCTGGACAGGGGGGGAGTATGAGCAATCAGCCCCAGCATTTT	CSASPGQGGSMSNQPQHF	TRBV20-1	TRBJ1-5
TGTGCCAGCAGCCGCCAAGGCTCCCAGACAGATACGCAGTATTTT	CASSRQGSQTDTQYF	TRBV6-2	TRBJ2-3
TGTGCCAGTACCTGCCCCAAGGGAGAGACCCAGTACTTC	CASTCPKGETQYF	TRBV19	TRBJ2-5
TGCGCCAGCAGTGATCTTGACAGGGGTAAGAACGAGCAGTACTTC	CASSDLDRGKNEQYF	TRBV10-1	TRBJ2-7
TGTGCCAGCAGCCCCACCCGACTAGAGTCGAATGAGCAGTTCTTC	CASSPTRLESNEQFF	TRBV5-6	TRBJ2-1
TGTGCCAGCAGCTTAGATCGACAGGGGGCTGCGCTGTACAATGAGCAGTTCTTC	CASSLDRQGAALYNEQFF	TRBV11-3	TRBJ2-1
TGTGCCAGCAGGGGAAGGCAGGGCTCGGGCTACGAGCAGTACTTC	CASRGRQGSGYEQYF	TRBV3-1	TRBJ2-7
TGTGCCAGCAGCGCCGAACTAGCGGGAGGCCTGGACTCCCGGGCCTACAATGAGCAGTTCTTC	CASSAELAGGLDSRAYNEQFF	TRBV13	TRBJ2-1
TGTGCCAGCAGCTTAGCAGGACAGGAGCACTACGAGCAGTACTTC	CASSLAGQEHYEQYF	TRBV7-9	TRBJ2-7
TGTGGGGAAGGGACTAGACGGCAGTCGTATCCCGGGGAGCTGTTTTTT	CGEGTRRQSYPGELFF	TRBV11-3	TRBJ2-2
TGTGCCAGCAGCTTAGTACCTAAGCCGGGACAGGGTAGACCCGGCTACGAGCAGTACTTC	CASSLVPKPGQGRPGYEQYF	TRBV7-6	TRBJ2-7
TGCGCCAGCAGCCGTCCCAGTAGTGAGCAGTTCTTC	CASSRPSSEQFF	TRBV4-1	TRBJ2-1
TGTGCCATTCCGCCAGTTGGCTATGGCTACACCTTC	CAIPPVGYGYTF	TRBV12-3	TRBJ1-2
TGCAGTGCGGAACCTAAGGGGAGCAGTACCGGGGAGCTGTTTTTT	CSAEPKGSSTGELFF	TRBV20-1	TRBJ2-2
TGTGCTAGTGGTTTGGTACCCACTCATCCAACAGGGGTAACCGGGGAGCTGTTTTTT	CASGLVPTHPTGVTGELFF	TRBV12-5	TRBJ2-2
TGTGCCAGCATACCAATCCACTCCCCTGGCTACACCTTC	CASIPIHSPGYTF	TRBV9	TRBJ1-2
TGTGCCAGCAGTTGGACTAGCCGGGCCCAAGAGACCCAGTACTTC	CASSWTSRAQETQYF	TRBV6-2	TRBJ2-5
TGTGCCAGCAGGGGACAGGCTGAAGCTTTCTTT	CASRGQAEAFF	TRBV6-6	TRBJ1-1
TGTGCCAGCACCCTAGGGGCAATAGCGGGCCAGGAGACCCAGTACTTC	CASTLGAIAGQETQYF	TRBV27	TRBJ2-5
TGCGCCAGCAGCCAATTTTCCAGGTGGTATGGCTACACCTTC	CASSQFSRWYGYTF	TRBV4-3	TRBJ1-2
TGTGCCAGCAGCGGGATCTCCCACGCCGGGAGCCCGAGCTCCTACGAGCAGTACTTC	CASSGISHAGSPSSYEQYF	TRBV9	TRBJ2-7
TGTGCCACCTGGAGAGAGACTCTCAGTGAAAAACTGTTTTTT	CATWRETLSEKLFF	TRBV10-3	TRBJ1-4
TGTGCCAGTAGTAGCCTTTGTCGGGACAGGGCGCAGCCCCAGCATTTT	CASSSLCRDRAQPQHF	TRBV19	TRBJ1-5
TGTGCCAGCAGTGAGGGGGACAGGGAGATAGAAGTGGGCCCTGGGGGTACTCAGCCCCAGCATTTT	CASSEGDREIEVGPGGTQPQHF	TRBV6-3	TRBJ1-5
TGTGCCAGCAGTTTACTAGACAGGGTGGTGGTCCCTGGAAACACCATATATTTT	CASSLLDRVVVPGNTIYF	TRBV27	TRBJ1-3
TGTGCCAGCAGTGGTGACAGGGGACCTTATTATGGCTACACCTTC	CASSGDRGPYYGYTF	TRBV6-1	TRBJ1-2
TGTGCCAGCCGGACAGGGACTTCCGGGGAGCTGTTTTTT	CASRTGTSGELFF	TRBV6-1	TRBJ2-2
TGCAGTGCCTACGCCGGCCTCGGGGTCACTGAAGCTTTCTTT	CSAYAGLGVTEAFF	TRBV20-1	TRBJ1-1
TGCAGCGTTGCCGGTACCTCCCCAGGGGGCGCACTGTTTTTT	CSVAGTSPGGALFF	TRBV29-1	TRBJ1-4
TGCAGTGCTAGAGATTTTAGGACTAGGAGCTCCTACAATGAGCAGTTCTTC	CSARDFRTRSSYNEQFF	TRBV20-1	TRBJ2-1
TGCAGCGTGGGACAAGGCCTCATGTATGGCTACACCTTC	CSVGQGLMYGYTF	TRBV29-1	TRBJ1-2
TGTGCCAGCATACCCGAGGGTGGCTACACCTTC	CASIPEGGYTF	TRBV7-9	TRBJ1-2
TGCAGTGCTAGAGGCGTAAGGCTTAGCGGGGGAAGCTCCTACGAGCAGTACTTC	CSARGVRLSGGSSYEQYF	TRBV20-1	TRBJ2-7
TGTGCCAGCGCCCCAACAGGGAGCACTGAAGCTTTCTTT	CASAPTGSTEAFF	TRBV2	TRBJ1-1
TGTGCCAGCTCCGACGACCCGACTCGCTACGAGCAGTACTTC	CASSDDPTRYEQYF	TRBV18	TRBJ2-7
TGTGCCAGCAGCTTCCCAGGGCCGAGACACGAGCAGTACTTC	CASSFPGPRHEQYF	TRBV11-3	TRBJ2-7
TGTGCCAGCTCGGGCCTGAACGGCACCACTGAAGCTTTCTTT	CASSGLNGTTEAFF	TRBV18	TRBJ1-1
TGTGCCAGCAGCCGGCCTCGTCCGTTAGCCAAAAACATTCAGTACTTC	CASSRPRPLAKNIQYF	TRBV7-4	TRBJ2-4
TGTGCCAGCAGTTTCATGACTAAGGTGAACACTGAAGCTTTCTTT	CASSFMTKVNTEAFF	TRBV12-3	TRBJ1-1
TGTGCCAGCAGCCACAGACCGAGTTGGTGTTCCCGGCGCTACACCTTC	CASSHRPSWCSRRYTF	TRBV7-9	TRBJ1-2
TGTGCCAGCAGCCAGGGGCGACAGCAAGAGACCCAGTACTTC	CASSQGRQQETQYF	TRBV14	TRBJ2-5
TGCAGTGCTCTCGTAGGCAATCAGCCCCAGCATTTT	CSALVGNQPQHF	TRBV20-1	TRBJ1-5
TGCGCCAGCAGCAAAATCCCTCCCAACGAGCAGTACTTC	CASSKIPPNEQYF	TRBV5-1	TRBJ2-7
TGTGCCAGCAGCTTAGCCGACAGGAACTCCTACAATGAGCAGTTCTTC	CASSLADRNSYNEQFF	TRBV11-2	TRBJ2-1
TGTGCCAGCAGCGTCACAGACAGGGCGCTCAATCAGCCCCAGCATTTT	CASSVTDRALNQPQHF	TRBV9	TRBJ1-5
TGTGCCAGCAGTAGGTCACAGGTTGCCTCCTACGAGCAGTACTTC	CASSRSQVASYEQYF	TRBV25-1	TRBJ2-7
TGTGCCAGTAGTATACCAGACAGGATCGAGCAGTACTTC	CASSIPDRIEQYF	TRBV19	TRBJ2-7
TGTGCCTGGAGTGTCCAGTGGGTCCTAGCGGTAAGCTCCTACGAGCAGTACTTC	CAWSVQWVLAVSSYEQYF	TRBV30	TRBJ2-7
TGTGCCAGCAGTTTCCTGAATCCCCTAGCGGGGGATCGCTCCTACGAGCAGTACTTC	CASSFLNPLAGDRSYEQYF	TRBV27	TRBJ2-7
TGTGCCAGCAGTTGGCAAAGGAGGGACAGGGGACCACTGTTTTTT	CASSWQRRDRGPLFF	TRBV27	TRBJ1-4
TGTGCCAGCAGCCTAATTATAGATGCCAAAAACATTCAGTACTTC	CASSLIIDAKNIQYF	TRBV9	TRBJ2-4
TGCAGTGCTGTCCCTCCGGACAGTATGAAAGCCAAAAACATTCAGTACTTC	CSAVPPDSMKAKNIQYF	TRBV20-1	TRBJ2-4
TGCAGCGTTCGTCACCTTTGGCCCTACGAGCAGTACTTC	CSVRHLWPYEQYF	TRBV29-1	TRBJ2-7
TGTGCCACCTCCGGTGCGGGAGGAAAAGAGACCCAGTACTTC	CATSGAGGKETQYF	TRBV24-1	TRBJ2-5
TGTGCCAGCAGAGCTAGACTCCTACTAGCGGGGAAGGCGAACACCGGGGAGCTGTTTTTT	CASRARLLLAGKANTGELFF	TRBV7-2	TRBJ2-2
TGTGCCACCAGTGTTCGTCTTCGATTGGGGGCCTACGAGCAGTACTTC	CATSVRLRLGAYEQYF	TRBV24-1	TRBJ2-7
TGTGCCAGCAGTTTGCTATCAAACAGGGGGGAGGCTGGAGAATATAATCAGCCCCAGCATTTT	CASSLLSNRGEAGEYNQPQHF	TRBV28	TRBJ1-5
TGTGCCAGCAGCGCTCACTGGGAGGGTTCAACTAATGAAAAACTGTTTTTT	CASSAHWEGSTNEKLFF	TRBV9	TRBJ1-4
TGTGCCAGCAGTTACGGACTGAGAACTAGCGGGAGAAGGAACACCGGGGAGCTGTTTTTT	CASSYGLRTSGRRNTGELFF	TRBV6-5	TRBJ2-2
TGTGCCAGCAGCGTGGCTAGGAGGACCGTCTCCTACAATGAGCAGTTCTTC	CASSVARRTVSYNEQFF	TRBV7-2	TRBJ2-1
TGCGCCACGCCAGGGGACCAAGAGACCCAGTACTTC	CATPGDQETQYF	TRBV10-1	TRBJ2-5
TGTGCCAGCAGCCAAGACCGGGACTGGGGCTCCTACAATGAGCAGTTCTTC	CASSQDRDWGSYNEQFF	TRBV14	TRBJ2-1
TGCAGTGCTTCCTTTGATAGCAATCAGCCCCAGCATTTT	CSASFDSNQPQHF	TRBV20-1	TRBJ1-5
TGTGCCAGCTGGAGGGGGCTAAACACTGAAGCTTTCTTT	CASWRGLNTEAFF	TRBV7-8	TRBJ1-1
TGCGCCAGCAGCCAAGACACCCTCTTTGTTGAAGCTTTCTTT	CASSQDTLFVEAFF	TRBV4-3	TRBJ1-1
TGCAGCGTTGAACAGATCTACGAGCAGTACTTC	CSVEQIYEQYF	TRBV29-1	TRBJ2-7
TGTGCCTGGAGTGTACGACCTACAGGTTGGACTAATGAAAAACTGTTTTTT	CAWSVRPTGWTNEKLFF	TRBV30	TRBJ1-4
TGTGCCAGCAGCGCGGGAGGGTTAGAGACCCAGTACTTC	CASSAGGLETQYF	TRBV6-3	TRBJ2-5
TGTGCCAGCAGTCCCCTTGAGGACAGCGGTGTTAGCAATCAGCCCCAGCATTTT	CASSPLEDSGVSNQPQHF	TRBV6-5	TRBJ1-5
TGTGCCAGCAGGCTCAGCGGGATAGGTTATAGCAATCAGCCCCAGCATTTT	CASRLSGIGYSNQPQHF	TRBV6-5	TRBJ1-5
TGTGCCAGCAGGACCCATGACGAATCAGGCTATGGCTACACCTTC	CASRTHDESGYGYTF	TRBV6-5	TRBJ1-2
TGTGCCAGCAGTTGTATCCTTCAAACCGGGGAGCTGTTTTTT	CASSCILQTGELFF	TRBV28	TRBJ2-2
TGTGCCAGCACCCCTAGAGTTGAGCAGTACTTC	CASTPRVEQYF	TRBV27	TRBJ2-7
TGTGCCGACGACTGGGTCTCCGGCACAGATACGCAGTATTTT	CADDWVSGTDTQYF	TRBV6-5	TRBJ2-3
TGTGCCAGCAGCTTAGATCACAGGGCCTATTCCTACAATGAGCAGTTCTTC	CASSLDHRAYSYNEQFF	TRBV11-2	TRBJ2-1
TGTGCCAGCACCAATATACCCGCACTTGACAGGGCTAATCAGCCCCAGCATTTT	CASTNIPALDRANQPQHF	TRBV7-3	TRBJ1-5
TGCAGTGCTAGAGGGGAAGCTTTCAATGAGCAGTTCTTC	CSARGEAFNEQFF	TRBV20-1	TRBJ2-1
TGCGCCAGCAGTACCTTAGTTAGCCGGGCAGGCGGCTACACCTTC	CASSTLVSRAGGYTF	TRBV10-1	TRBJ1-2
TGTGCCAGCAGCCAAGATCGGAAGTTCAGGCTGACCTACGAGCAGTACTTC	CASSQDRKFRLTYEQYF	TRBV14	TRBJ2-7
TGTGCCAGCAGTTACTCAAATAAGCCAGGGCGCTACGAGCAGTACTTC	CASSYSNKPGRYEQYF	TRBV6-5	TRBJ2-7
TGTGCCAGCAGCCGCTCGGGACTAGCGGGGGACTACGAGCAGTACTTC	CASSRSGLAGDYEQYF	TRBV16	TRBJ2-7
TGTGCCAGCAGCCAGGACAGGGACCGAACTGAAGCTTTCTTT	CASSQDRDRTEAFF	TRBV14	TRBJ1-1
TGTGCCAGCAGTTATAGGGGGGGATATGGCTACACCTTC	CASSYRGGYGYTF	TRBV27	TRBJ1-2
TGTGCCAGCAGTGGTGGGGTCCCCGGGGAGGCGGAGTCCGAATGGGCAACTAATGAAAAACTGTTTTTT	CASSGGVPGEAESEWATNEKLFF	TRBV6-4	TRBJ1-4
TGTGCCAGCAGCCAGACCCCCCAAAAAGTGCCGAGGGAAGAGACCCAGTACTTC	CASSQTPQKVPREETQYF	TRBV14	TRBJ2-5
TGTGCCAGCAGGGACCGATCGTTTAACTCCTACGAGCAGTACTTC	CASRDRSFNSYEQYF	TRBV6-5	TRBJ2-7
TGTGCCAGCAGTCGGGTAAGTTCGGGACAGGGTGGCTATGGCTACACCTTC	CASSRVSSGQGGYGYTF	TRBV6-3	TRBJ1-2
TGTGCCAGCAGCTTAGCCCGGGGTAGTAAGCCCCAGCATTTT	CASSLARGSKPQHF	TRBV7-8	TRBJ1-5
TGTGCCAGCTCCCCAATCCCAGGGAATGGGTACTTC	CASSPIPGNGYF	TRBV18	TRBJ2-7
TGTGCCAGCAGCTTCGGAGGGACAGGTACTGAAGCTTTCTTT	CASSFGGTGTEAFF	TRBV7-8	TRBJ1-1
TGTGCCAGCAGTCGGGACAGTGGCCGTCAGCCCCAGCATTTT	CASSRDSGRQPQHF	TRBV28	TRBJ1-5
TGCGCCAGCAGCTATACTTGTGGGCCTAGGATCAATGAGCAGTTCTTC	CASSYTCGPRINEQFF	TRBV5-1	TRBJ2-1
TGCGCCACAGGGGGACAGGGGCAGGGGGACTACGAGCAGTACTTC	CATGGQGQGDYEQYF	TRBV5-1	TRBJ2-7
TGTGCCAGACAGGGGATGGCCTACGAGCAGTACTTC	CARQGMAYEQYF	TRBV19	TRBJ2-7
TGTGGATGGGACAGGGGGGGACGGGTCCAGCCCCAGCATTTT	CGWDRGGRVQPQHF	TRBV5-4	TRBJ1-5
TGCAGTGCTAGAGATCGGGGGGGCGGGGTCTACGAGCAGTACTTC	CSARDRGGGVYEQYF	TRBV20-1	TRBJ2-7
TGTGCCAGCAGTGAAGCCTCCATTTGGGGACAGGGCTACGAGCAGTACTTC	CASSEASIWGQGYEQYF	TRBV25-1	TRBJ2-7
TGTGCCAGCAGCTGCGGGGGACGGGTCTCTGGAAACACCATATATTTT	CASSCGGRVSGNTIYF	TRBV5-4	TRBJ1-3
TGTGCCTCAGGCCTCAGCGATACGCAGTATTTT	CASGLSDTQYF	TRBV9	TRBJ2-3
TGTGCCAGCAGTTTGAGTCTCATGGGACTAGCGGGTCCCTATCGACCGAGTACCTACGAGCAGTACTTC	CASSLSLMGLAGPYRPSTYEQYF	TRBV28	TRBJ2-7
TGTGCCACCAGTGATGGGGGGGCTGCCGATTATAGCAATCAGCCCCAGCATTTT	CATSDGGAADYSNQPQHF	TRBV24-1	TRBJ1-5
TGTGCCACCAGGGTACAAGAGCTCCGGGGCAGGAATCAGCCCCAGCATTTT	CATRVQELRGRNQPQHF	TRBV24-1	TRBJ1-5
TGTGCCAGCAGTTTATCGTTCCGGGAGGGTACGCAGTATTTT	CASSLSFREGTQYF	TRBV27	TRBJ2-3
TGTGCCAGCAGCCAACCACAGATCACTGAAGCTTTCTTT	CASSQPQITEAFF	TRBV4-2	TRBJ1-1
TGTGCCAGCAGGAACGGGACAGGGGACTATGGCTACACCTTC	CASRNGTGDYGYTF	TRBV6-5	TRBJ1-2
TGCGCCACCCAACCCCGGGACAGGGACTATGGCTACACCTTC	CATQPRDRDYGYTF	TRBV5-1	TRBJ1-2
TGTGCCAGCTCCCCCCAGGTCCGCACAGATACGCAGTATTTT	CASSPQVRTDTQYF	TRBV18	TRBJ2-3
TGTGCCAGCAGTTACTCTGGACTGATTGAGCAGTTCTTC	CASSYSGLIEQFF	TRBV6-5	TRBJ2-1
TGTGCCACTACGAGACGTAGCAATCAGCCCCAGCATTTT	CATTRRSNQPQHF	TRBV2	TRBJ1-5
TGTGCCAGCAGACGCCACTTAGATACGCAGTATTTT	CASRRHLDTQYF	TRBV14	TRBJ2-3
TGTGCCAGCAGTAGCGCTGGGACAGCAACGTCTTTTGAACTCCGGTTGAACACTGAAGCTTTCTTT	CASSSAGTATSFELRLNTEAFF	TRBV28	TRBJ1-1
TGCAGTGCTAGAGATTCCCGGGACAGGGCTCCGTACGAGCAGTACTTC	CSARDSRDRAPYEQYF	TRBV20-1	TRBJ2-7
TGTGCCAGCAGTTTAATTATCCCGGACAGGGCCCTGGAGTACTTC	CASSLIIPDRALEYF	TRBV28	TRBJ2-7
TGTGCTTCCAGGGCCGAGCAGTACTTC	CASRAEQYF	TRBV27	TRBJ2-7
TGCAGTGCTCATAAGCTCATGACTAAACCTGGGGCCAACGTCCTGACTTTC	CSAHKLMTKPGANVLTF	TRBV20-1	TRBJ2-6
TGTGCCAGCAGGTGGGACAGAGGATGTACAGACGAGCAGTACTTC	CASRWDRGCTDEQYF	TRBV25-1	TRBJ2-7
TGCGCCAGCAGCTTGGCCAGCCTAAAGGACCAAGAGACCCAGTACTTC	CASSLASLKDQETQYF	TRBV5-1	TRBJ2-5
TGCAGCGTTGAGGAGGGGAAGCTTCTGAACACTGAAGCTTTCTTT	CSVEEGKLLNTEAFF	TRBV29-1	TRBJ1-1
TGTGCCAGCAGCACCGGGACAACATACAATGAGCAGTTCTTC	CASSTGTTYNEQFF	TRBV7-2	TRBJ2-1
TGTGCCAGCAGTGAACAGGGGGCAAGACAATATAATGGCTACACCTTC	CASSEQGARQYNGYTF	TRBV6-4	TRBJ1-2
TGTGCCACCACAAGTAACTATCAGCCCCAGCATTTT	CATTSNYQPQHF	TRBV24-1	TRBJ1-5
TGTGCCAGCAGTGCAACTCGATCCCTCCCGGGACGGGGCTACACCTTC	CASSATRSLPGRGYTF	TRBV6-1	TRBJ1-2
TGCACCCCCAACCGGGACAGCGGGGCCAACGTCCTGACTTTC	CTPNRDSGANVLTF	TRBV20-1	TRBJ2-6
TGCGCCAGCAGCCCCCTAGCGGGAAACAATGAGCAGTTCTTC	CASSPLAGNNEQFF	TRBV5-1	TRBJ2-1
TGCAGTGCGCGTTCCCTTCGCACCTCTGGAAACACCATATATTTT	CSARSLRTSGNTIYF	TRBV20-1	TRBJ1-3
TGTGCCAGCAGCTTAATTAGACGCCCACCCCGGAATGAAAAACTGTTTTTT	CASSLIRRPPRNEKLFF	TRBV7-9	TRBJ1-4
TGTGCCAGTCCCCAGGAACGGGGGGGCACTGAAGCTTTCTTT	CASPQERGGTEAFF	TRBV19	TRBJ1-1
TGTGCCATCAGAAACCGGGACAGGGGTCAGCCCCAGCATTTT	CAIRNRDRGQPQHF	TRBV10-3	TRBJ1-5
TGTGCCAGCAGGACAGGGACAGAACTCAATCAGCCCCAGCATTTT	CASRTGTELNQPQHF	TRBV7-8	TRBJ1-5
TGTGCCAGCACCAGCCCTAGCGGGGACTACAATGAGCAGTTCTTC	CASTSPSGDYNEQFF	TRBV2	TRBJ2-1
TGTGCCAGCAGTTACAGACAGGGACCGAACACCGGGGAGCTGTTTTTT	CASSYRQGPNTGELFF	TRBV6-6	TRBJ2-2
TGCGCCAGCACATCCAGGATAGCTGAAGCTTTCTTT	CASTSRIAEAFF	TRBV10-1	TRBJ1-1
TGTGCCAGTAAAGTGGACAGGCCGAGGCAAGAGACCCAGTACTTC	CASKVDRPRQETQYF	TRBV19	TRBJ2-5
TGTGCCAGCAGCTTCTCCCCCCTGAGCTCCTACGAGCAGTACTTC	CASSFSPLSSYEQYF	TRBV7-2	TRBJ2-7
TGCAGTGCTAGAACGGTCGGCTGTCAAGCTAGCAATCAGCCCCAGCATTTT	CSARTVGCQASNQPQHF	TRBV20-1	TRBJ1-5
TGTGCCAGCAGCCAACTTACGTGGGAGTATAATTCACCCCTCCACTTT	CASSQLTWEYNSPLHF	TRBV3-1	TRBJ1-6
TGCAGTGCCGGGGTGAGGTGGACAGATACGCAGTATTTT	CSAGVRWTDTQYF	TRBV20-1	TRBJ2-3
TGTGCCAGCTCACCGGTGACAAACGTCCCGACGGGGACTAGCGGGGGGGGCACGGACAATGAGCAGTTCTTC	CASSPVTNVPTGTSGGGTDNEQFF	TRBV18	TRBJ2-1
TGTGCCAGTAGTCGCATCGATCCCAGCTACGAGCAGTACTTC	CASSRIDPSYEQYF	TRBV19	TRBJ2-7
TGTGCCATCAGCCCGGTCGAATGGGACAGGCTGGAACTCTACGAGCAGTACTTC	CAISPVEWDRLELYEQYF	TRBV10-3	TRBJ2-7
TGTGCCAGGAGACAGGGGGCAGTGCACACCGGGGAGCTGTTTTTT	CARRQGAVHTGELFF	TRBV11-3	TRBJ2-2
TGTGCCAGCAGCGTCCTAGCGGGGAGCAATGAGCAGTTCTTC	CASSVLAGSNEQFF	TRBV6-5	TRBJ2-1
TGTGCCTGGGATCCCACGCCGCAACCCGACTTAAACTCTGGGGCCAACGTCCTGACTTTC	CAWDPTPQPDLNSGANVLTF	TRBV30	TRBJ2-6
TGTGCTAGTGGTCCGCAACCGGGACAGTACATGAACACTGAAGCTTTCTTT	CASGPQPGQYMNTEAFF	TRBV12-5	TRBJ1-1
TGTGCCAGCGGAAGGGTGAGGAAAAATGAGCAGTTCTTC	CASGRVRKNEQFF	TRBV6-5	TRBJ2-1
TGTGCCAGCAGCCATACCTACGAGCAGTACTTC	CASSHTYEQYF	TRBV5-4	TRBJ2-7
TGTGCCAGCAAGTCTGGATCGGACGACTCTCAGCCCCAGCATTTT	CASKSGSDDSQPQHF	TRBV7-9	TRBJ1-5
TGCAGTCCTCAGGGACCATACGAGCAGTACTTC	CSPQGPYEQYF	TRBV20-1	TRBJ2-7
TGTGCCAGCAGCTATTCTTTGCAGTATGGCTACACCTTC	CASSYSLQYGYTF	TRBV6-2	TRBJ1-2
TGTGCCAGCAGTTGGACCAAACTGTTTTTT	CASSWTKLFF	TRBV27	TRBJ1-4
TGTGCCAGCAGGACTAGCGGGTCCTACAATGAGCAGTTCTTC	CASRTSGSYNEQFF	TRBV7-3	TRBJ2-1
TGCAGTGCTAGACTCGGGAAGGACAGTAATCAGCCCCAGCATTTT	CSARLGKDSNQPQHF	TRBV20-1	TRBJ1-5
TGTGCCAGCAGCTCCAACTTCACGGGGGGGAACACTGAAGCTTTCTTT	CASSSNFTGGNTEAFF	TRBV5-6	TRBJ1-1
TGTGCCAGTAGTCGTCAGGGCTGCTATGGCTACACCTTC	CASSRQGCYGYTF	TRBV19	TRBJ1-2
TGTGCCACCAGTGATTTACTCTTGGCCCTCAACCATTCTGCTGGAAACACCATATATTTT	CATSDLLLALNHSAGNTIYF	TRBV24-1	TRBJ1-3
TGTGCCAGCAGCCCGGAAAGCTCCTGTTTTGAGCAGTACTTC	CASSPESSCFEQYF	TRBV7-9	TRBJ2-7
TGCGCCAGCAGCCAAGCGGGTGGCCCCGGGACCGGGGAGCTGTTTTTT	CASSQAGGPGTGELFF	TRBV4-1	TRBJ2-2
TGTGCCAGCAGTCTGCCTAGGGACAGTTCTGGAAACACCATATATTTT	CASSLPRDSSGNTIYF	TRBV28	TRBJ1-3
TGTGCTAGTGGTTTGGGTCAGGGACTAGCGGGAAGAACCTACGAGCAGTACTTC	CASGLGQGLAGRTYEQYF	TRBV12-5	TRBJ2-7
TGTGCCAGCAGTTACTCGTCTTGGGGGCGCCAAGAGACCCAGTACTTC	CASSYSSWGRQETQYF	TRBV6-2	TRBJ2-5
TGTGCCAGCAGCGTAGCGACTGCCCCCTTAATCTACGAGCAGTACTTC	CASSVATAPLIYEQYF	TRBV9	TRBJ2-7
TGTGCCAGCAGCGAAGGGCGGGATCAATTAGTCGATGAGCAGTTCTTC	CASSEGRDQLVDEQFF	TRBV9	TRBJ2-1
TGTGCCAGCAGCGCGGCAACAGGGGGGTTGTCCTACGAGCAGTACTTC	CASSAATGGLSYEQYF	TRBV7-9	TRBJ2-7
TGTGCCAGCCAGACAGGGCCGCAGTACTTC	CASQTGPQYF	TRBV3-1	TRBJ2-7
TGTGCCAGCAGTTTCTTCTTCAATGAGCAGTTCTTC	CASSFFFNEQFF	TRBV27	TRBJ2-1
TGTGCCAGCAGTGGTACGCCGACGCAGTATTTT	CASSGTPTQYF	TRBV11-1	TRBJ2-3
TGTGCCAGCTCACCACCCTCTTCGGGACAGGGTCGAAACGAGCAGTACTTC	CASSPPSSGQGRNEQYF	TRBV18	TRBJ2-7
TGCAGTGCTAGCAACTGGGGTAGGGGGCTTAGTGGGGCCAACGTCCTGACTTTC	CSASNWGRGLSGANVLTF	TRBV20-1	TRBJ2-6
TGTGCCAGCAGTCTGGGACAGAACACTGAAGCTTTCTTT	CASSLGQNTEAFF	TRBV12-4	TRBJ1-1
TGCGCCAGCAGCCAAAAGAGAGGGACAGGGGGAACAGCTTTCTTT	CASSQKRGTGGTAFF	TRBV4-1	TRBJ1-1
TGTGCCAGTGGACTAGCGGGCGACAATGAGCAGTTCTTC	CASGLAGDNEQFF	TRBV30	TRBJ2-1
TGTGCCAGCAGCTTATTGGGTCCAGGGGGCGGGGCCGCGAACACCGGGGAGCTGTTTTTT	CASSLLGPGGGAANTGELFF	TRBV7-9	TRBJ2-2
TGTGCCAGCAGCGTGGCAGGGTCAGGCGAGCAGTACTTC	CASSVAGSGEQYF	TRBV9	TRBJ2-7
TGTGCCAGCAGTTTTTCTCTAAGGGGGCCGCGAAATGAGCAGTTCTTC	CASSFSLRGPRNEQFF	TRBV28	TRBJ2-1
TGTGCCAGCAGCAGCGGGGGGGGTGGCAATCAGCCCCAGCATTTT	CASSSGGGGNQPQHF	TRBV7-3	TRBJ1-5
TGCGCCAGCAGCCGGGCAAAAGGGGGCATTCCGCGGAACACTGAAGCTTTCTTT	CASSRAKGGIPRNTEAFF	TRBV4-1	TRBJ1-1
TGTGCCAGCAGTTTGGGATTCCCCTCTGGAAACACCATATATTTT	CASSLGFPSGNTIYF	TRBV27	TRBJ1-3
TGTGCCAGCAGTTATTCTTCTAGTTATTTGAGGTCCTACGAGCAGTACTTC	CASSYSSSYLRSYEQYF	TRBV6-3	TRBJ2-7
TGTGCCAGTAGACCAGAACATGGCTACACCTTC	CASRPEHGYTF	TRBV19	TRBJ1-2
TGTGCCAGCAGTGATGTAGGGGGGCCTGATGAGCAGTTCTTC	CASSDVGGPDEQFF	TRBV6-4	TRBJ2-1
TGTGCCAGCAGCCAAGAGGTAAGGACGACAGGGCTCGGAGGCCTCGGGGTAGAGACCCAGTACTTC	CASSQEVRTTGLGGLGVETQYF	TRBV4-2	TRBJ2-5
TGTGCCACCAGTGCCCCGGGCGAGACCCAGTACTTC	CATSAPGETQYF	TRBV24-1	TRBJ2-5
TGTGCCAGCAGCTTCAGCGGTCACACCGGGGAGCTGTTTTTT	CASSFSGHTGELFF	TRBV7-9	TRBJ2-2
TGTGCCAGCAGCTTTACCACACAGGCGGGCAATCAGCCCCAGCATTTT	CASSFTTQAGNQPQHF	TRBV11-3	TRBJ1-5
TGTGCCACCAGCAGAGTTAGCGACAGGAGGCCGAACACCGGGGAGCTGTTTTTT	CATSRVSDRRPNTGELFF	TRBV15	TRBJ2-2
TGTGCCATCAACCCGGGGGCCTATGGCTACACCTTC	CAINPGAYGYTF	TRBV10-3	TRBJ1-2
TGTGCCAGGCCCAGCGCCGCTTTCTTT	CARPSAAFF	TRBV27	TRBJ1-1
TGTGCCAGCGCAGACGTACTGCACGGAGTGTGCGGCGCCGGGGAGCTGTTTTTT	CASADVLHGVCGAGELFF	TRBV27	TRBJ2-2
TGTGCCAGCAGCCGGGTTTCTGCCGAGGGCCCTCTCAGCTCCTACAATGAGCAGTTCTTC	CASSRVSAEGPLSSYNEQFF	TRBV13	TRBJ2-1
TGTGCCAGCAGTTCCGGATCCATCAGGACAGATCTAACCTACGAGCAGTACTTC	CASSSGSIRTDLTYEQYF	TRBV27	TRBJ2-7
TGCGCCAGCAGCTTGGATGGAGGGACCCGGGACTATGGCTACACCTTC	CASSLDGGTRDYGYTF	TRBV5-1	TRBJ1-2
TGTGCCAGCAGCGACAACAGGGGTGTCTCTGGGGCCAACGTCCTGACTTTC	CASSDNRGVSGANVLTF	TRBV7-2	TRBJ2-6
TGTGCTAGTGGTTTGGTTCAGGGAGGCCCTGAAGCTTTCTTT	CASGLVQGGPEAFF	TRBV12-5	TRBJ1-1
TGCAGTGCTAGGCCCATCACTAGCGGGAGGAATACGAGACAGACCCAGTACTTC	CSARPITSGRNTRQTQYF	TRBV20-1	TRBJ2-5
TGTGCCAGCAGCTTCCTAAGGGGGCAAGAGACCCAGTACTTC	CASSFLRGQETQYF	TRBV7-3	TRBJ2-5
TGCGCCAGCAGCTTTTCGGGACAGGGGGTCGTTGGGACTGAAGCTTTCTTT	CASSFSGQGVVGTEAFF	TRBV5-1	TRBJ1-1
TGTGCCAGCAGCATATTCCGGGGGGCGAACACCGGGGAGCTGTTTTTT	CASSIFRGANTGELFF	TRBV13	TRBJ2-2
TGCGCCAGGGGAAAGGACAGGGTTCCCCAGCATTTT	CARGKDRVPQHF	TRBV5-1	TRBJ1-5
TGTGCCACTCCTATCTGGGCACCGAACACTGAAGCTTTCTTT	CATPIWAPNTEAFF	TRBV2	TRBJ1-1
TGTGCCAGCAGACTAGCCCGGGACGGAAACACCATATATTTT	CASRLARDGNTIYF	TRBV6-1	TRBJ1-3
TGTGCCAGCAGCTTAGAAAAAGACAGCTTACAGGGAGAAGGTACTGAAGCTTTCTTT	CASSLEKDSLQGEGTEAFF	TRBV11-2	TRBJ1-1
TGCCAGGGACAGGGTAGCTACGAGCAGTACTTC	CQGQGSYEQYF	TRBV5-1	TRBJ2-7
TGTGCCAGCAGTTACGGAGATGTTCAGGGGGCGGGGCCCCAGCATTTT	CASSYGDVQGAGPQHF	TRBV6-3	TRBJ1-5
TGTGCCAGCTCACCATATGGACAGAACAGCTCCTATAATTCACCCCTCCACTTT	CASSPYGQNSSYNSPLHF	TRBV18	TRBJ1-6
TGTGCCAGCAGTGTCAGGGGGAATTCACCCCTCCACTTT	CASSVRGNSPLHF	TRBV6-4	TRBJ1-6
TGTGCCAGCCCCCCCATCCAACAGGGGGGGCAGTACTTC	CASPPIQQGGQYF	TRBV11-1	TRBJ2-7
TGTGCCAGCAGTCCGGGACAGGGGGCCATAGAGTACTTC	CASSPGQGAIEYF	TRBV6-1	TRBJ2-7
TGTGCCAGCAGCCAGGGGACAGCCACAGATACGCAGTATTTT	CASSQGTATDTQYF	TRBV7-4	TRBJ2-3
TGTGCCAGCAGAGACCGATACTATGGCTACACCTTC	CASRDRYYGYTF	TRBV6-5	TRBJ1-2
TGTGCCAGCAGCCCGGGGGGGCCCTACGAGCAGTACTTC	CASSPGGPYEQYF	TRBV2	TRBJ2-7
TGTGCCAGCAGTTACCGGGGCCGGGACATTGGGCCGAATGGCTACACCTTC	CASSYRGRDIGPNGYTF	TRBV6-5	TRBJ1-2
TGTGCCAGCAGCCGTATGCCTCGATCCGAAGAGACCCAGTACTTC	CASSRMPRSEETQYF	TRBV13	TRBJ2-5
TGTGCCAGCAGCTTAGAGGTTAAGAACACCGGGGAGCTGTTTTTT	CASSLEVKNTGELFF	TRBV9	TRBJ2-2
TGTGCCAGCAGACCCGACAGGCCAACCGACTCTTCTGTTGAAGCTTTCTTT	CASRPDRPTDSSVEAFF	TRBV6-4	TRBJ1-1
TGTGCCAGCAGCGGCTTAGCCTACTTC	CASSGLAYF	TRBV13	TRBJ2-5
TGTGCCAGCAGCGGACAGGGGACAGCTTTATACGAGCAGTACTTC	CASSGQGTALYEQYF	TRBV7-9	TRBJ2-7
TGTGCCAGCATTAAATTGGCCAGACTAGTTGGCAGGAGGATCACAGATACGCAGTATTTT	CASIKLARLVGRRITDTQYF	TRBV5-6	TRBJ2-3
TGTGCCAGCAGTGACTCGACCTTCCCCCCGTCGTTCTCCGGGGAGCTGTTTTTT	CASSDSTFPPSFSGELFF	TRBV6-4	TRBJ2-2
TGTGCCAGCAGTTTTCCGAACAGGGGGCGTAGCTCCTACGAGCAGTACTTC	CASSFPNRGRSSYEQYF	TRBV12-3	TRBJ2-7
TGTGCCAGATCAGGCTACCCTAGCACAGATACGCAGTATTTT	CARSGYPSTDTQYF	TRBV6-1	TRBJ2-3
TGCAGCGTGCCGGACAGGGGGATTTTCCAATTGGACTTCACAGATACGCAGTATTTT	CSVPDRGIFQLDFTDTQYF	TRBV29-1	TRBJ2-3
TGTGCCATCATACCGGGACTAGCGGGAGACTGTCCAGTCAAAGAGACCCAGTACTTC	CAIIPGLAGDCPVKETQYF	TRBV10-3	TRBJ2-5
TGTGCCAGCAGGCGGGCGTTTAGAGCTTTCTTT	CASRRAFRAFF	TRBV6-4	TRBJ1-1
TGCGCCAAGGCAGGTAGGGCGGGGGGTTGCAACCTTCATGAGCAGTTCTTC	CAKAGRAGGCNLHEQFF	TRBV5-1	TRBJ2-1
TGTGCCAGCAGTCGACTCAGGGTCCCGGGATCTGACTACGAGCAGTACTTC	CASSRLRVPGSDYEQYF	TRBV27	TRBJ2-7
TGTGCCAGCACTAACCCCGGACAGGGAGGAGCTCATGGCTACACCTTC	CASTNPGQGGAHGYTF	TRBV6-1	TRBJ1-2
TGTGCCACCAGTGATTTACCCACGGACAGGCGGGCCGGCTATGGCTACACCTTC	CATSDLPTDRRAGYGYTF	TRBV24-1	TRBJ1-2
TGTGCCAGCATGGGCCAAAATCAGCCCCAGCATTTT	CASMGQNQPQHF	TRBV7-9	TRBJ1-5
TGCAGTGCCCCTAGATTAGGTTATGAGCAGTTCTTC	CSAPRLGYEQFF	TRBV20-1	TRBJ2-1
TGCGCCAGCAGCTTGGTGCTCAGGGCCCTTAGCAATCAGCCCCAGCATTTT	CASSLVLRALSNQPQHF	TRBV5-1	TRBJ1-5
TGTGCCATCACAAGGGCAGCTTTGAATCAGCCCCAGCATTTT	CAITRAALNQPQHF	TRBV10-3	TRBJ1-5
TGTGCCAGCACCCCAGGAGCAGATACGCAGTATTTT	CASTPGADTQYF	TRBV6-4	TRBJ2-3
TGTGCCAGCAGTTCTTCTGACCAGACCGGCTCAGATACGCAGTATTTT	CASSSSDQTGSDTQYF	TRBV6-3	TRBJ2-3
TGCGCCAGCAGCTTCAAGACAGGGCACAATCAGCCCCAGCATTTT	CASSFKTGHNQPQHF	TRBV5-1	TRBJ1-5
TGTGCCTGGAGTTTACCCCGGATTCATGGACAGGGAATCAAATTAGTCACTGAAGCTTTCTTT	CAWSLPRIHGQGIKLVTEAFF	TRBV30	TRBJ1-1
TGCGCCAGCAGCAACTCTACTTTAGTCCTGAACACTGAAGCTTTCTTT	CASSNSTLVLNTEAFF	TRBV5-1	TRBJ1-1
TGTGCCAGCAGCGGGAGACAGGGGGCTGCTTTAGGGGGAGATACGCAGTATTTT	CASSGRQGAALGGDTQYF	TRBV7-3	TRBJ2-3
TGTGCCAGCAGTTTCCCTTGGACAGTTGGGATCGGAAACACCATATATTTT	CASSFPWTVGIGNTIYF	TRBV28	TRBJ1-3
TGTGCCAGCAGCCAAGATGAGACACAAAGAAACACAGATACGCAGTATTTT	CASSQDETQRNTDTQYF	TRBV14	TRBJ2-3
TGTGCCGCGAGTAGGGGGGCCTACGAGCAGTACTTC	CAASRGAYEQYF	TRBV25-1	TRBJ2-7
TGTGCCAGCAGCGGGCGAGCAGGCTACGAGCAGTACTTC	CASSGRAGYEQYF	TRBV7-3	TRBJ2-7
TGTGCCAGCAGTTTGCCCAATAACACAGATACGCAGTATTTT	CASSLPNNTDTQYF	TRBV27	TRBJ2-3
TGTGCCAGCAGGAGGGGGGCCATATACGAGCAGTACTTC	CASRRGAIYEQYF	TRBV28	TRBJ2-7
TGTGCCAGCAGCCCTGAGGGACAGGGGAGTCCTGCCGAGGCTGAAAAACTGTTTTTT	CASSPEGQGSPAEAEKLFF	TRBV3-1	TRBJ1-4
TGTGCCAGCAGTTTACAGGCACGTCCACAGGGAATTCATGGCTACACCTTC	CASSLQARPQGIHGYTF	TRBV12-4	TRBJ1-2
TGTGCCAGCAGTGACCTACTAGCGGGCCTGGGCGAAATTGAGACCCAGTACTTC	CASSDLLAGLGEIETQYF	TRBV6-4	TRBJ2-5
TGTGCCAGTAGCCCATCCGGACTGAGGCGCGAGCAGTACTTC	CASSPSGLRREQYF	TRBV19	TRBJ2-7
TGTGCCAGCAGTAACCGACAGGGGGGGCCTGCCTCCTACGAGCAGTACTTC	CASSNRQGGPASYEQYF	TRBV6-4	TRBJ2-7
TGTGCCAGCAGTGCGCATCTAGAAGCTTTCTTT	CASSAHLEAFF	TRBV27	TRBJ1-1
TGTGCCAGCTCATATACCACCTCGGGGTCAAGCACTGAAGCTTTCTTT	CASSYTTSGSSTEAFF	TRBV18	TRBJ1-1
TGTGCCAGTAAACTAGCGGGAGGGCGGGACAATGAGCAGTTCTTC	CASKLAGGRDNEQFF	TRBV19	TRBJ2-1
TGTGCCAGCTCACCACCCTCCAGCGGTTCGACTAGCGGCCCCCAAGGCAATGAGCAGTTCTTC	CASSPPSSGSTSGPQGNEQFF	TRBV18	TRBJ2-1
TGTGCCAGCAGAGGACGGACAGGGAATTCCTGGAATGAGCAGTTCTTC	CASRGRTGNSWNEQFF	TRBV6-5	TRBJ2-1
TGTGCCAGCAGCCAAGATACCTATTTACAGGGGGATAGGACAGATACGCAGTATTTT	CASSQDTYLQGDRTDTQYF	TRBV14	TRBJ2-3
TGTGCCATTCAGCGAAGAGATACGCAGTATTTT	CAIQRRDTQYF	TRBV27	TRBJ2-3
TGTGCCAGCGATAGTCCGGACAGGGCCTCCACCGGGGAGCTGTTTTTT	CASDSPDRASTGELFF	TRBV6-1	TRBJ2-2
TGTGCCGGGGAAAGCGGGAGGAGTTACGAGCAGTACTTC	CAGESGRSYEQYF	TRBV25-1	TRBJ2-7
TGTGCCACCAGTGACAATCCGGGGCAGCCCCAGCATTTT	CATSDNPGQPQHF	TRBV24-1	TRBJ1-5
TGTGGCCGGGCCGCCCCGCTTGGCTACGAGCAGTACTTC	CGRAAPLGYEQYF	TRBV10-3	TRBJ2-7
TGTGCCATCACCCCGACAACGAAAGGGGTGCCCCAGCATTTT	CAITPTTKGVPQHF	TRBV10-3	TRBJ1-5
TGTGCCAGCAGCCCCAACCGGACTAACACAGATACGCAGTATTTT	CASSPNRTNTDTQYF	TRBV13	TRBJ2-3
TGCGCCAGCAGCTTTTTCAAGGCCGGGACAGGGGGTTCCTCTGGGGCCAACGTCCTGACTTTC	CASSFFKAGTGGSSGANVLTF	TRBV5-1	TRBJ2-6
TGTGCCAGCAGCTTGCCCGGAAGACAGACCACCTACGAGCAGTACTTC	CASSLPGRQTTYEQYF	TRBV5-6	TRBJ2-7
TGTGCCAGCAGTCGGTGCCCCAGGGTGCCTTCATACGAGCAGTACTTC	CASSRCPRVPSYEQYF	TRBV27	TRBJ2-7
TGCACCACCAGGGGAGCTGAAGCTTTCTTT	CTTRGAEAFF	TRBV5-1	TRBJ1-1
TGCAGTGCAGTTCTACGAGTGTACCAGGACAGGAGGTATGGCTACACCTTC	CSAVLRVYQDRRYGYTF	TRBV20-1	TRBJ1-2
TGTGCCAGCAGTCGTACAGGGGGCAGCCTAGGCTCCTACAATGAGCAGTTCTTC	CASSRTGGSLGSYNEQFF	TRBV27	TRBJ2-1
TGTGCCACCAGCGTGCTAGCGGCCTACAATGAGCAGTTCTTC	CATSVLAAYNEQFF	TRBV15	TRBJ2-1
TGTGCCAGCAGAAAGGGACTAGCGGGCTCCTACGAGCAGTACTTC	CASRKGLAGSYEQYF	TRBV12-3	TRBJ2-7
TGCGCCAGCAGCTTGGCCCACCCGAGGGGTGGCAACTATGGCTACACCTTC	CASSLAHPRGGNYGYTF	TRBV5-1	TRBJ1-2
TGCGCCAGCAGTTCCATTGTCGGGAGGGCCCTAGAAGGGGAGCAGTTCTTC	CASSSIVGRALEGEQFF	TRBV10-2	TRBJ2-1
TGTGCCAGCAGCTATCCCTGCTCTATTGACGCTGGTGGCCCCTACGAGCAGTACTTC	CASSYPCSIDAGGPYEQYF	TRBV7-2	TRBJ2-7
TGTGCCAGCAGCTTCCCAGCCTCCGGTCTCGGTAAAGAGTGGGTCTACGAGCAGTACTTC	CASSFPASGLGKEWVYEQYF	TRBV7-8	TRBJ2-7
TGTGCCAGCAACCAGCCAGGGGGGTTGGATGAAGAGACCCAGTACTTC	CASNQPGGLDEETQYF	TRBV28	TRBJ2-5
TGCGCCAGCAGCTTGGGACGGGGGGAGGGGGTAACCGAAGAGACCCAGTACTTC	CASSLGRGEGVTEETQYF	TRBV5-1	TRBJ2-5
TGTGCCAGCAGCTTCAGTAGACTCGCCTCCTACGAGCAGTACTTC	CASSFSRLASYEQYF	TRBV11-2	TRBJ2-7
TGTGCTAGTGGTCCATATGGACCGGGAAATCAGCCCCAGCATTTT	CASGPYGPGNQPQHF	TRBV12-5	TRBJ1-5
TGTGCCAGCAGCTGGCCGGGACGCTGCTATGGCTACACCTTC	CASSWPGRCYGYTF	TRBV6-4	TRBJ1-2
TGTGCCAGCAGCCAAGACGGGACAGGGATCTCTGGAAACACCATATATTTT	CASSQDGTGISGNTIYF	TRBV3-1	TRBJ1-3
TGCAGTGCTAGACCGGGGCAGTACGAGCAGTACTTC	CSARPGQYEQYF	TRBV20-1	TRBJ2-7
TGTGCCACCAGCCATAGACAGGGGGGAATCAACTATGGCTACACCTTC	CATSHRQGGINYGYTF	TRBV15	TRBJ1-2
TGCGCCAGCAGCTTGTCGGGGGGGCTAGATAGTACATTAGGTAACAATGAGCAGTTCTTC	CASSLSGGLDSTLGNNEQFF	TRBV5-1	TRBJ2-1
TGCGCCAGCAGCTCTTCGCGGGCTTCCGATTCCTACGAGCAGTACTTC	CASSSSRASDSYEQYF	TRBV5-1	TRBJ2-7
TGTGCCAGCAGTAGGAGGACAGGGAACACCGGGGAGCTGTTTTTT	CASSRRTGNTGELFF	TRBV6-5	TRBJ2-2
TGCAGTGCTCACAGGGGGAACGAGCAGTACTTC	CSAHRGNEQYF	TRBV20-1	TRBJ2-7
TGTGCCAGCAGCCAAGGACCGGGGGGTCTGAGAGGCTTCGTCTCCTACAATGAGCAGTTCTTC	CASSQGPGGLRGFVSYNEQFF	TRBV14	TRBJ2-1
TGTGCCAGCAGCCCGCGGGAGAACGAGCAGTACTTC	CASSPRENEQYF	TRBV11-2	TRBJ2-7
TGTGCCGCGCCCAGCGACAGGCGAAACTCACCCCTCCACTTT	CAAPSDRRNSPLHF	TRBV10-3	TRBJ1-6
TGTGCCAGTACCTCCCCCTTAGCCTACGAGCAGTACTTC	CASTSPLAYEQYF	TRBV19	TRBJ2-7
TGTGCCAGCAGTTATTCAGCAAGTACAGGGGGCCGTCAGCCCCAGCATTTT	CASSYSASTGGRQPQHF	TRBV6-9	TRBJ1-5
TGTGCCCAGGGACAGCGGTATAGCAATCAGCCCCAGCATTTT	CAQGQRYSNQPQHF	TRBV5-5	TRBJ1-5
TGTGCCAGCAGCCAAGATATCCCCAGGGGGCCCGGAGCTGAAGCTTTCTTT	CASSQDIPRGPGAEAFF	TRBV4-2	TRBJ1-1
TGTGCCTGGAGTGTAGGGGGCTATCAGCCCCAGCATTTT	CAWSVGGYQPQHF	TRBV30	TRBJ1-5
TGTGCCACCAGCAAGGGGGGGAGGCGCTACAATGAGCAGTTCTTC	CATSKGGRRYNEQFF	TRBV15	TRBJ2-1
TGCAGTGCTAGAGATTACGCGGGACTGGGTACTTTGACAGATACGCAGTATTTT	CSARDYAGLGTLTDTQYF	TRBV20-1	TRBJ2-3
TGCGCCAGCATCCATAGCGGGCCGGAGACCCAGTACTTC	CASIHSGPETQYF	TRBV10-1	TRBJ2-5
TGTGCCAGCAGTTTAGGGGATGTGGGAAACATTCAGTACTTC	CASSLGDVGNIQYF	TRBV27	TRBJ2-4
TGTGCCCCCTTCAGGGGTGCTAAGTACGAGCAGTACTTC	CAPFRGAKYEQYF	TRBV11-2	TRBJ2-7
TGCGCCAGCAGTGAGGGGACTAGCGGGCAGTACAATGAGCAGTTCTTC	CASSEGTSGQYNEQFF	TRBV4-1	TRBJ2-1
TGCGCCAGCAGCGTCGGCGACAGGGGGGCATCATATTCACCCCTCCACTTT	CASSVGDRGASYSPLHF	TRBV4-1	TRBJ1-6
TGTGCCAGCAGCCCAGAGGATGGCGCCTACAATGAGCAGTTCTTC	CASSPEDGAYNEQFF	TRBV13	TRBJ2-1
TGTGCCAGCAGTTCCACAGGGCCGAAAAGGGTCCAGACTGAAGCTTTCTTT	CASSSTGPKRVQTEAFF	TRBV28	TRBJ1-1
TGTGCCAGCAGCTTGGGAGGGTCGCATGAGCAGTTCTTC	CASSLGGSHEQFF	TRBV5-5	TRBJ2-1
TGTGCCAGCAGCATACCCGGGGAGTCCCCGCCCGGGACAGTGACGAGGTGCAATCAGCCCCAGCATTTT	CASSIPGESPPGTVTRCNQPQHF	TRBV11-2	TRBJ1-5
TGCGCCAGCAGGGGACAGGTGGTATTTTCCTATAGCAATCAGCCCCAGCATTTT	CASRGQVVFSYSNQPQHF	TRBV5-1	TRBJ1-5
TGTGCCATCAGTCGCGGATCAGAGCAGTTCTTC	CAISRGSEQFF	TRBV10-3	TRBJ2-1
TGTGCCAGCAGACTAGGGGGGGCCTACGAGCAGTACTTC	CASRLGGAYEQYF	TRBV12-3	TRBJ2-7
TGTGCCAGCAGCCCCGGCCGGGACAGGGGCATTCTCGACACTGAAGCTTTCTTT	CASSPGRDRGILDTEAFF	TRBV6-2	TRBJ1-1
TGCGCCAGCAGCCAAGATAGTAACAGGGGGGGACGACCACCCCTCCACTTT	CASSQDSNRGGRPPLHF	TRBV4-1	TRBJ1-6
TGTGCCACCAGTGATTTGGGGGGCAAGGAATATAATTCACCCCTCCACTTT	CATSDLGGKEYNSPLHF	TRBV24-1	TRBJ1-6
TGTGCCACCATGCCCCAGCGGGATGGAGACAATGAGCAGTTCTTC	CATMPQRDGDNEQFF	TRBV24-1	TRBJ2-1
TGCGCCAGCAGCGAAGGTTTCCGCATAGAACTCTCTGGAAACACCATATATTTT	CASSEGFRIELSGNTIYF	TRBV4-1	TRBJ1-3
TGTGCCAGCAGCCCAACGTCCCCGGGGGGGCTGGAACTAAATGAGCAGTTCTTC	CASSPTSPGGLELNEQFF	TRBV7-9	TRBJ2-1
TGTGCCAGCAGCTCCACGACCTACACCTACGAGCAGTACTTC	CASSSTTYTYEQYF	TRBV7-3	TRBJ2-7
TGTGCCAGCAGTGACCACAGGGCCGGGGAGCTGTTTTTT	CASSDHRAGELFF	TRBV6-1	TRBJ2-2
TGTGCCAGCAGTTACGACAGACTCCCTGAGAATGAGCAGTTCTTC	CASSYDRLPENEQFF	TRBV6-3	TRBJ2-1
TGTGCCAGCAGCCAAGAGGTCCGAAGGGACATGTCAGGACACCCCGAGCAGTACTTC	CASSQEVRRDMSGHPEQYF	TRBV14	TRBJ2-7
TGCGCCAGCATCTGGTCCGGGACTAGCACCGGGGAGCTGTTTTTT	CASIWSGTSTGELFF	TRBV10-1	TRBJ2-2
TGTGCCACCAGCAGACTACAGGGGGCCCTCAATCAGCCCCAGCATTTT	CATSRLQGALNQPQHF	TRBV15	TRBJ1-5
TGTGCCAGCACTTCGCGCGGGAGCCGGTGGGGGGAGGAGCGAGAGACCCAGTACTTC	CASTSRGSRWGEERETQYF	TRBV11-3	TRBJ2-5
TGTGCCTGGAGTGTACGTCGGGCCGGTGACGAGCAGTACTTC	CAWSVRRAGDEQYF	TRBV30	TRBJ2-7
TGCGCCAGCAGTGAGGACCGGGACAGGACGATCCCCTACGAGCAGTACTTC	CASSEDRDRTIPYEQYF	TRBV10-1	TRBJ2-7
TGTGCCAGCAGTGAAAAGCCGGGGTGGAGCCAAGAGACCCAGTACTTC	CASSEKPGWSQETQYF	TRBV2	TRBJ2-5
TGTGCCAGCAGCCCCCAGGGGGCGCTCTTC	CASSPQGALF	TRBV3-1	TRBJ2-1
TGTGCCAGCAGCGGGAGCGAGCAGTACTTC	CASSGSEQYF	TRBV5-5	TRBJ2-7
TGTGCCAGCAGCTTAGGGCACTACGAGCAGTACTTC	CASSLGHYEQYF	TRBV7-9	TRBJ2-7
TGTGCCAGCAGTGGAAACTACGGGGGGTACGAGCAGTACTTC	CASSGNYGGYEQYF	TRBV25-1	TRBJ2-7
TGTGCCAGCAGGAGAAGGTTGGACATCCGGCAGCCCCAGCATTTT	CASRRRLDIRQPQHF	TRBV6-1	TRBJ1-5
TGTGCCAGCAGTTACTCAGCCAGGGGAATACAAGAGACCCAGTACTTC	CASSYSARGIQETQYF	TRBV6-2	TRBJ2-5
TGTGCCAGCGTACCCACCGGAGCCTACAATGAGCAGTTCTTC	CASVPTGAYNEQFF	TRBV6-6	TRBJ2-1
TGTGCCAGTAGGACAGGATCCACTGAAGCTTTCTTT	CASRTGSTEAFF	TRBV19	TRBJ1-1
TGCGCCAGCAGCCCCGGTCGCGTACGGCAGTTCTTC	CASSPGRVRQFF	TRBV4-1	TRBJ2-1
TGCGCCAGCAGCTTGGGAGGGGGGGAGTACGAGCAGTACTTC	CASSLGGGEYEQYF	TRBV5-1	TRBJ2-7
TGTGAACAGATACTACAAGAGACCCAGTACTTC	CEQILQETQYF	TRBV11-3	TRBJ2-5
TGTGCCAGCAGTTCCGCAGACCTTAATGAGCAGTTCTTC	CASSSADLNEQFF	TRBV27	TRBJ2-1
TGTGCCAGCAGCTTAGTCCGAGGGAAGGCTTTCTTT	CASSLVRGKAFF	TRBV7-8	TRBJ1-1
TGTGCCAGCAGTGACGGACTAGATTCCTACGAGCAGTACTTC	CASSDGLDSYEQYF	TRBV28	TRBJ2-7
TGTGCCACCCACATTGAGACCGTTCTCTATGGCTACACCTTC	CATHIETVLYGYTF	TRBV24-1	TRBJ1-2
TGTGCCAGCAGCAACACCCCGCACAGGGTGGCGAGCTCCTACGAGCAGTACTTC	CASSNTPHRVASSYEQYF	TRBV13	TRBJ2-7
TGTGCCAGCTCACCACCGTCCCTGGGTATTCCGGACAGCCACAATGAGCAGTTCTTC	CASSPPSLGIPDSHNEQFF	TRBV18	TRBJ2-1
TGTGCCAGCAGCCAAAACTTTAGCGGGAGGTACGAGCAGTACTTC	CASSQNFSGRYEQYF	TRBV3-1	TRBJ2-7
TGCGCCAGCAGCCAAGATCTTAACAGTGCAGGAGAGCATAACATTCAGTACTTC	CASSQDLNSAGEHNIQYF	TRBV4-1	TRBJ2-4
TGTGCTAGTGGTGGGGGGAAGGTCACCGGGGAGCTGTTTTTT	CASGGGKVTGELFF	TRBV12-5	TRBJ2-2
TGCAGTGCTCCTAAGCAGGGGTATAGCAATCAGCCCCAGCATTTT	CSAPKQGYSNQPQHF	TRBV20-1	TRBJ1-5
TGCGCCAGCAGCTTGGAGTGGGGGGGGGGCTACACCTTC	CASSLEWGGGYTF	TRBV5-1	TRBJ1-2
TGTGCCAGCCTACCGGCCACTAGCACAGATACGCAGTATTTT	CASLPATSTDTQYF	TRBV25-1	TRBJ2-3
TGTGCCAGCAGCCGGGGGGGTAATAACACTGAAGCTTTCTTT	CASSRGGNNTEAFF	TRBV13	TRBJ1-1
TGCGCCAGCAGCTTGAGACTAGCGGATTTTTCCTACGAGCAGTACTTC	CASSLRLADFSYEQYF	TRBV5-1	TRBJ2-7
TGTGCTAGTGGTTCGAGGGGGGGGTGGGCTAATGAGCAGTTCTTC	CASGSRGGWANEQFF	TRBV12-5	TRBJ2-1
TGCGCCAGCAGCTTGCCCTCCGGGACAGGGCCCTCCCAGCATTTT	CASSLPSGTGPSQHF	TRBV5-1	TRBJ1-5
TGCGCCAGCAGCCAAGATGCCCTGTTGACAGGGTATGTTCATCTCGAGACCCAGTACTTC	CASSQDALLTGYVHLETQYF	TRBV4-3	TRBJ2-5
TGTGCCTCCCAGGTAGGCTCGACACAAGAGACCCAGTACTTC	CASQVGSTQETQYF	TRBV30	TRBJ2-5
TGTGCCAGCAGCGCCAGGGGTGATACGCAGTATTTT	CASSARGDTQYF	TRBV12-3	TRBJ2-3
TGTGCCACCAGTGATTTGACTTTGCTCGGAAACTATGGCTACACCTTC	CATSDLTLLGNYGYTF	TRBV24-1	TRBJ1-2
TGTGCCAGCAGGGTTCGCTGGAGTCATCACTACGAGCAGTACTTC	CASRVRWSHHYEQYF	TRBV27	TRBJ2-7
TGCAGTGCACCGGGTGGGACAGGGGTAGACAATCAGCCCCAGCATTTT	CSAPGGTGVDNQPQHF	TRBV20-1	TRBJ1-5
TGCGCCAGCAGTGAGTTTGCCCCATGGAAGACTGGGCCTGCCTCCTACGAGCAGTACTTC	CASSEFAPWKTGPASYEQYF	TRBV10-1	TRBJ2-7
TGTGCCAGCAGTTTATGGCCACGTTGCCCCCTTAGGGAGACCGGGGAGCTGTTTTTT	CASSLWPRCPLRETGELFF	TRBV27	TRBJ2-2
TGTGCCAGCAGCCTGACCCCGACAGTTGAGACCCAGTACTTC	CASSLTPTVETQYF	TRBV5-6	TRBJ2-5
TGCAGCGTTGAAGATGATCTCGGGAGGGATACGCAGTATTTT	CSVEDDLGRDTQYF	TRBV29-1	TRBJ2-3
TGCGCCAGCAGCAATTTGGGCCCAGGCAATCAGCCCCAGCATTTT	CASSNLGPGNQPQHF	TRBV5-1	TRBJ1-5
TGTGCCAGCACCCGAAACTGCATTGAAAAACTGTTTTTT	CASTRNCIEKLFF	TRBV27	TRBJ1-4
TGTGCCAGCAGTTACTTACCCACCAACACTGAAGCTTTCTTT	CASSYLPTNTEAFF	TRBV27	TRBJ1-1
TGTGCCAGCAGTGATGGGGGCTACGAGCAGTACTTC	CASSDGGYEQYF	TRBV6-4	TRBJ2-7
TGTGCCAGCAGCCAAGCCTGCTGGACGTCCTACGAGCAGTACTTC	CASSQACWTSYEQYF	TRBV4-2	TRBJ2-7
TGTGCCAGCATTACCGGGACAGGTTCGAACATTCAGTACTTC	CASITGTGSNIQYF	TRBV27	TRBJ2-4
TGCAAGTTGTGGGGGACGGGCTACGAGCAGTACTTC	CKLWGTGYEQYF	TRBV20-1	TRBJ2-7
TGCGCCAGCAGCAGGAAAGGGGGGGGGGACCAAGAGACCCAGTACTTC	CASSRKGGGDQETQYF	TRBV5-1	TRBJ2-5
TGTGCCAGCAGGAAAAGGAGAAAAAACTATGGCTACACCTTC	CASRKRRKNYGYTF	TRBV6-1	TRBJ1-2
TGTGCCAGCAGCGACCCTCCGGAAAACATTCAGTACTTC	CASSDPPENIQYF	TRBV14	TRBJ2-4
TGCAGCGTTGACCTGCCAGGGGCACTTGAGCAGTACTTC	CSVDLPGALEQYF	TRBV29-1	TRBJ2-7
TGTGCCAGCAGTTTGACAGGTGGCTCACGTTCGGAGCGTTACACTGAAGCTTTCTTT	CASSLTGGSRSERYTEAFF	TRBV6-5	TRBJ1-1
TGTGCCAGCAGTCTATCCCCAGCTGAGGGGGCACTGTTTTTT	CASSLSPAEGALFF	TRBV6-5	TRBJ1-4
TGTGCCAGCAGCTTAGATCCATGGTATGAGCAGTTCTTC	CASSLDPWYEQFF	TRBV11-2	TRBJ2-1
TGCGCCAGCAGCGTTGTGTCGACAGGGGAGAGGGGCTACACCTTC	CASSVVSTGERGYTF	TRBV5-1	TRBJ1-2
TGTGCCAGTAGAAGACCAGGGCAGGGTGCCTTTTTCGCAGAGACCCAGTACTTC	CASRRPGQGAFFAETQYF	TRBV19	TRBJ2-5
TGCGCCAGCAGCCAAGGCACCAGGACGGCCCCCGAGTGGGCCTACGAGCAGTACTTC	CASSQGTRTAPEWAYEQYF	TRBV4-3	TRBJ2-7
TGTGCCAGCAGTGACTCGAAACCCCGGGGGGAGAACACTGAAGCTTTCTTT	CASSDSKPRGENTEAFF	TRBV6-4	TRBJ1-1
TGTGCCAGTGAAGCAGGAGTATACTCTGGAAACACCATATATTTT	CASEAGVYSGNTIYF	TRBV6-5	TRBJ1-3
TGTGCCACCAGCAGAGATCCGGACAGGGTAGGTGACTACGAGCAGTACTTC	CATSRDPDRVGDYEQYF	TRBV15	TRBJ2-7
TGTGCCAGCAGCCGTCTGGTCCAAGAGACCCAGTACTTC	CASSRLVQETQYF	TRBV7-3	TRBJ2-5
TGTGCCAGCAGTCGACAGATCATGAACACTGAAGCTTTCTTT	CASSRQIMNTEAFF	TRBV28	TRBJ1-1
TGCAGTGCGCCTGAGGGGGATGACAATGAGCAGTTCTTC	CSAPEGDDNEQFF	TRBV20-1	TRBJ2-1
TGTGCCAGTAGGGGTTTTCATCAGCCCCAGCATTTT	CASRGFHQPQHF	TRBV19	TRBJ1-5
TGTGCCAGCAGAGTCACGGCAGGGGCTGGGGCCAACGTCCTGACTTTC	CASRVTAGAGANVLTF	TRBV6-2	TRBJ2-6
TGTGCCAAGGGGACCCTCAATCAGCCCCAGCATTTT	CAKGTLNQPQHF	TRBV2	TRBJ1-5
TGCAGTGGGACAGGGGTGACAGCTGAAGCTTTCTTT	CSGTGVTAEAFF	TRBV20-1	TRBJ1-1
TGTGCCAGCAGTTACTACCCATCCGAGGGGACAGGCTACAATGAGCAGTTCTTC	CASSYYPSEGTGYNEQFF	TRBV6-5	TRBJ2-1
TGCAGTGCGCTCTACAATGAGCAGTTCTTC	CSALYNEQFF	TRBV20-1	TRBJ2-1
TGTGCCAGCAGCCGCACAGGGGTCCATAATGAAAAACTGTTTTTT	CASSRTGVHNEKLFF	TRBV13	TRBJ1-4
TGCAGTGCTAGACACGGGACCCTGTTACCCTATGGCTACACCTTC	CSARHGTLLPYGYTF	TRBV20-1	TRBJ1-2
TGTGCCAGCTGTCGGGAGGGATGCACTGAAGCTTTCTTT	CASCREGCTEAFF	TRBV13	TRBJ1-1
TGCGCCAGCAGTGAGCGGCGCGTAAACACTGAAGCTTTCTTT	CASSERRVNTEAFF	TRBV10-1	TRBJ1-1
TGTGCCAGCAGCGAGTTCTCCGCTGGGGGCCTCGAGCAGTACTTC	CASSEFSAGGLEQYF	TRBV13	TRBJ2-7
TGTGGAACCCGTGGGGGGCCTCCTCCCTACGAGCAGTACTTC	CGTRGGPPPYEQYF	TRBV6-2	TRBJ2-7
TGTGCCAGCAGAATCGCGACTAGCGGGTTTAAGCAGTTCTTC	CASRIATSGFKQFF	TRBV12-4	TRBJ2-1
TGTGCCAGCAGTGAAACCAATCCCGCCGGGACAAGAGCTAACTATGGCTACACCTTC	CASSETNPAGTRANYGYTF	TRBV6-1	TRBJ1-2
TGTGCCAGCAGCTTACGGAGGGGGGGCATAGGCCTCTACGAGCAGTACTTC	CASSLRRGGIGLYEQYF	TRBV7-7	TRBJ2-7
TGTGCCAGCAGCGCGCGGGAGAGCTATGGCTACACCTTC	CASSARESYGYTF	TRBV13	TRBJ1-2
TGTGCCATCCCATGGACAGGGCTGAAGACCCAGTACTTC	CAIPWTGLKTQYF	TRBV10-3	TRBJ2-5
TGTGCCAGCAGCCAACAGTCTGACAGGGCAACTACAGAGGAGACCTCTGGGGCCAACGTCCTGACTTTC	CASSQQSDRATTEETSGANVLTF	TRBV4-2	TRBJ2-6
TGTGCCAGCAGTGACAGGCGGCTCGGGAGGGGGGTTTTAATTCAGCCCCAGCATTTT	CASSDRRLGRGVLIQPQHF	TRBV28	TRBJ1-5
TGTGGCCAGATTGAAAAACTGTTTTTT	CGQIEKLFF	TRBV12-3	TRBJ1-4
TGCAGTGCTTTCTGGAGCTGCCAAGAGACCCAGTACTTC	CSAFWSCQETQYF	TRBV20-1	TRBJ2-5
TGTGCCACCAGCAGGGGAAACCCAGGGGGCCAGGGGAACACTGAAGCTTTCTTT	CATSRGNPGGQGNTEAFF	TRBV15	TRBJ1-1
TGCGCCAGCAGTCAGGGACTAGCGGGGGGTCTCGGGGAGCTGTTTTTT	CASSQGLAGGLGELFF	TRBV10-2	TRBJ2-2
TGTGCCAGTAGTATATTGGAGGCGAGCTCTAGGGGCTATAATTCACCCCTCCACTTT	CASSILEASSRGYNSPLHF	TRBV19	TRBJ1-6
TGTGCCAGTAGTTTGAGGGACAGAGGAGGTTACCAGAACACTGAAGCTTTCTTT	CASSLRDRGGYQNTEAFF	TRBV19	TRBJ1-1
TGTGCCAGCAGCTTGATGGGACAGAGTAATGAAAAACTGTTTTTT	CASSLMGQSNEKLFF	TRBV7-4	TRBJ1-4
TGTGCCACTAGCGAAGATGAGCAGTTCTTC	CATSEDEQFF	TRBV6-5	TRBJ2-1
TGTGCCAGCAGCTTAGAGAAACTAGCGGGAGTGAGGTTCTCCCCCGAGCAGTACTTC	CASSLEKLAGVRFSPEQYF	TRBV7-9	TRBJ2-7
TGTGCCAGCCAGGGGAACACTGAAGCTTTCTTT	CASQGNTEAFF	TRBV5-5	TRBJ1-1
TGTGCCAGCAGCGAAGCGGACAGGGGGCTTGAGCAGTACTTC	CASSEADRGLEQYF	TRBV13	TRBJ2-7
TGTGCCAGCAAACTGGAGACCCGGGACTATAGCAATCAGCCCCAGCATTTT	CASKLETRDYSNQPQHF	TRBV6-5	TRBJ1-5
TGTGCCAGAGGGTTCCGGCAGGGACGAATTGAGACCCAGTACTTC	CARGFRQGRIETQYF	TRBV27	TRBJ2-5
TGTGCCAGCAGGCCATGGGGGCAACTTGGAAACACCATATATTTT	CASRPWGQLGNTIYF	TRBV7-9	TRBJ1-3
TGTGCCAGTAGTATAGGGTTTATTGGGACTGATGTGTATCCCGAGCAGTACTTC	CASSIGFIGTDVYPEQYF	TRBV19	TRBJ2-7
TGTGCCAGCAGCAGCGGAGGGAGTGAGCAGTACTTC	CASSSGGSEQYF	TRBV7-4	TRBJ2-7
