TGTGCCAGCAGGCTATGGGGCTCCCAGGCAGGTAGCAATCAGCCCCAGCATTTT	CASRLWGSQAGSNQPQHF	TRBV7-9	TRBJ1-5
TGTGCCACCAGTGAGAGGGGCTACACCTTC	CATSERGYTF	TRBV24-1	TRBJ1-2
TGTGCCAGCAGCCCCGACAACAGAGCTGAAGCTTTCTTT	CASSPDNRAEAFF	TRBV9	TRBJ1-1
TGTGCCAGCAGCCGATATCGGAGCGATACGCAGTATTTT	CASSRYRSDTQYF	TRBV2	TRBJ2-3
TGTGCCATCAGTGAGTCGGGAGGAGGGGGCAGCTCCTACGAGCAGTACTTC	CAISESGGGGSSYEQYF	TRBV10-3	TRBJ2-7
TGTGCCACCAGGGCGGGGGGAGTAAGCAGGAGCTCCTACGAGCAGTACTTC	CATRAGGVSRSSYEQYF	TRBV24-1	TRBJ2-7
TGCAGTGCTATACAGGGAAATGAAAAACTGTTTTTT	CSAIQGNEKLFF	TRBV20-1	TRBJ1-4
TGTGCCAGCAGGGGTGAACCGCCCAGGGATAATCAGCCCCAGCATTTT	CASRGEPPRDNQPQHF	TRBV6-2	TRBJ1-5
TGTGCCAGCACCGTGACTAGATTTTTTCTCTACGAGCAGTACTTC	CASTVTRFFLYEQYF	TRBV25-1	TRBJ2-7
TGTGCCACCAGCAGTCTTCCACCCCTCCACTTT	CATSSLPPLHF	TRBV15	TRBJ1-6
TGTGCCAGCAGAGGGGGTGAGGGTGAGACCCAGTACTTC	CASRGGEGETQYF	TRBV25-1	TRBJ2-5
TGTGCCAGCAGCGCGCCGGAAGGGGAGCTGTTTTTT	CASSAPEGELFF	TRBV5-5	TRBJ2-2
TGTGCCAGACTGGGGGAACACGAGCAGTACTTC	CARLGEHEQYF	TRBV6-5	TRBJ2-7
TGTGCCAGCAGCCAAGTTACTGACCGGGACAGGACCCTCCCGACCGGGGAGCTGTTTTTT	CASSQVTDRDRTLPTGELFF	TRBV14	TRBJ2-2
TGCAGTGCTAGATCGGGACAATCGGGCTACGAGCAGTACTTC	CSARSGQSGYEQYF	TRBV20-1	TRBJ2-7
TGTGCCAGCACAAACAGTAGCTACGAGCAGTACTTC	CASTNSSYEQYF	TRBV7-2	TRBJ2-7
TGTGCCAGCAGCGACAGGGTTCATCAGCCCCAGCATTTT	CASSDRVHQPQHF	TRBV7-3	TRBJ1-5
TGTGCCAGCAGCCTTCAATATGCGGGAGACACTGAAGCTTTCTTT	CASSLQYAGDTEAFF	TRBV9	TRBJ1-1
TGTGCCAGCAGTGGGCAGGGGAATGAAAAACTGTTTTTT	CASSGQGNEKLFF	TRBV27	TRBJ1-4
TGTGCCAGCAGTTACAAGCCAGGGGGCACTGAAGCTTTCTTT	CASSYKPGGTEAFF	TRBV6-5	TRBJ1-1
TGTGCCAGCAGCTTGTCTGGAAAATCACCAGAGACCCAGTACTTC	CASSLSGKSPETQYF	TRBV5-6	TRBJ2-5
TGTGCCAGCAGCAGAATGGACAGGGGGCGGGGTAACTATGGCTACACCTTC	CASSRMDRGRGNYGYTF	TRBV7-8	TRBJ1-2
TGTGCCACAAACGCCGGGACAGGGAGCACTAATGAAAAACTGTTTTTT	CATNAGTGSTNEKLFF	TRBV6-5	TRBJ1-4
TGTGCCAGCAGCCGTCAGTGTGAGATGAACTATGGCTACACCTTC	CASSRQCEMNYGYTF	TRBV7-9	TRBJ1-2
TGCAGTGCTAGAGACAGGGGTTGGCCGGCCTACAATGAGCAGTTCTTC	CSARDRGWPAYNEQFF	TRBV20-1	TRBJ2-1
TGTGCCAGCAGTTTGAATAAGACCTGTATGGTTCAATCCTACGAGCAGTACTTC	CASSLNKTCMVQSYEQYF	TRBV27	TRBJ2-7
TGTGCCGCAGACAGGCAAGCTACTAGCAATCAGCCCCAGCATTTT	CAADRQATSNQPQHF	TRBV28	TRBJ1-5
TGTGCGGGCTTCGGGCAGTTCTTC	CAGFGQFF	TRBV24-1	TRBJ2-1
TGTGCCAGCAGCTCGTCCCCCATCTCTGGGACTAGCGGCACAGATACGCAGTATTTT	CASSSSPISGTSGTDTQYF	TRBV7-2	TRBJ2-3
TGTGCCAGCAGTTACTCGTCGGGAGCGGAGAGAAAGACCCAGTACTTC	CASSYSSGAERKTQYF	TRBV6-6	TRBJ2-5
TGTGCCAGCAGCCCCGGGAGCGGGTACGAGCAGTACTTC	CASSPGSGYEQYF	TRBV5-6	TRBJ2-7
TGTGCCATCAGTGATGAGGGGGGGTTCCGTGTCTACGAGCAGTACTTC	CAISDEGGFRVYEQYF	TRBV10-3	TRBJ2-7
TGCAGTGCTAGAGCTAGTACAGGCCCCGGGGAGCTGTTTTTT	CSARASTGPGELFF	TRBV20-1	TRBJ2-2
TGCGCCAGCAGTGAGTCCGTAGGCAGGACAGGGGGCTACACCTTC	CASSESVGRTGGYTF	TRBV10-1	TRBJ1-2
TGTGCCAGCAGTTACCCCGGCTCCACGTGTCACGAGCAGTACTTC	CASSYPGSTCHEQYF	TRBV6-5	TRBJ2-7
TGTGCCAGCAGCAGCAAGGGACTAGCGCCTCGCGAGCAGTACTTC	CASSSKGLAPREQYF	TRBV14	TRBJ2-7
TGTGCCAGCAGTGAAAGGACTAGCGGAAGAGAGACCCAGTACTTC	CASSERTSGRETQYF	TRBV6-1	TRBJ2-5
TGCGCCAGCAGCCAAGATCCTTTCCCGGCAGTAGCCACTGAAGCTTTCTTT	CASSQDPFPAVATEAFF	TRBV4-3	TRBJ1-1
TGCAGTGCTAGAGGACAGGGGGCACTAGCCAAAAACATTCAGTACTTC	CSARGQGALAKNIQYF	TRBV20-1	TRBJ2-4
TGTGCCAGCAGTTTACCCCGAGGTTGGGCTAGCACAGATACGCAGTATTTT	CASSLPRGWASTDTQYF	TRBV12-3	TRBJ2-3
TGTGCCAGCAGCTTAGCGACCCCGGGGACCCTGAACACTGAAGCTTTCTTT	CASSLATPGTLNTEAFF	TRBV7-4	TRBJ1-1
TGTGCCAGCAGCCAAGAAGACAGGGTCGAGACCCAGTACTTC	CASSQEDRVETQYF	TRBV3-1	TRBJ2-5
TGTGCCACCAGTGAACTAGCGGGAGGGCTTTCACCCCTCCACTTT	CATSELAGGLSPLHF	TRBV24-1	TRBJ1-6
TGTGCCACCAGTGGGGAAATGGGACAGGGCGTTGAAAAACTGTTTTTT	CATSGEMGQGVEKLFF	TRBV24-1	TRBJ1-4
TGCGCCAGCAGCTTGTCTACAGGGGCGATTGGAAACACCATATATTTT	CASSLSTGAIGNTIYF	TRBV5-1	TRBJ1-3
TGTGCCAGCAGCTTAGACCCACGGGAAAGCTACAATGAGCAGTTCTTC	CASSLDPRESYNEQFF	TRBV7-9	TRBJ2-1
TGTGCCAGCAGACCGAGTACGGTGAGGGGCGGCACTGAAGCTTTCTTT	CASRPSTVRGGTEAFF	TRBV12-4	TRBJ1-1
TGTGCCAGCAGCTTGCGCCCTGGTGACAGGGGGCTTGGGCCCCAGCATTTT	CASSLRPGDRGLGPQHF	TRBV7-9	TRBJ1-5
TGTGCCAGGGAAAAGGGCCGACATCGTACTGGAAATGAGCAGTTCTTC	CAREKGRHRTGNEQFF	TRBV6-5	TRBJ2-1
TGTGCCAGTAGCCCCCGGGGGGGTTGGGACACTGAAGCTTTCTTT	CASSPRGGWDTEAFF	TRBV19	TRBJ1-1
TGTGCCTGGAGTGTAGTCGTTAGGGGGCCACCGCAGCCCCAGCATTTT	CAWSVVVRGPPQPQHF	TRBV30	TRBJ1-5
TGCGCCAGCAGCCACCTCCAGACTAGTAAAGAGACCCAGTACTTC	CASSHLQTSKETQYF	TRBV4-3	TRBJ2-5
TGCAGTGACCAGCGGGAGCCCCGCCCGCAGTATTTT	CSDQREPRPQYF	TRBV20-1	TRBJ2-3
TGTGCCAGCAGTGGGGGAGGAAGGGCGACCTACGAGCAGTACTTC	CASSGGGRATYEQYF	TRBV6-5	TRBJ2-7
TGTGCCAGCAGTGGTATTCCGCTAGCCAAAAACATTCAGTACTTC	CASSGIPLAKNIQYF	TRBV12-4	TRBJ2-4
TGTGCCAGCAGTTTGCAGGGAGTAAGATACGAGCAGTACTTC	CASSLQGVRYEQYF	TRBV12-4	TRBJ2-7
TGTGCCAGCAATCCTAGCGGGACGAACACCGGGGAGCTGTTTTTT	CASNPSGTNTGELFF	TRBV6-4	TRBJ2-2
TGTGGGACTGGGGGGGCCCCCAATGAGCAGTTCTTC	CGTGGAPNEQFF	TRBV27	TRBJ2-1
TGCGCCAGCAGTACTAGCGGGATCTCCTACGAGCAGTACTTC	CASSTSGISYEQYF	TRBV10-1	TRBJ2-7
TGTGCCAGCAGTTTGGATCAGGGGAGTGGAGCTTTCTTT	CASSLDQGSGAFF	TRBV12-4	TRBJ1-1
TGTGCCAGCACAGGACAGGGGAGATATGAAGCTTTCTTT	CASTGQGRYEAFF	TRBV11-1	TRBJ1-1
TGTGCCAGCAGCGAAGGGGCCGGATCTGCAGATACGCAGTATTTT	CASSEGAGSADTQYF	TRBV7-4	TRBJ2-3
TGTGCCAGCAGCTTGGCAGTGTCTTTCGGACAGCCCCAGCATTTT	CASSLAVSFGQPQHF	TRBV5-6	TRBJ1-5
TGTGCCAGCATTGAACGACGACGCCTCCCTAACTATGGCTACACCTTC	CASIERRRLPNYGYTF	TRBV6-4	TRBJ1-2
TGTGCCACCAAAGCGGGATTTGGGGGGTACGAGCAGTACTTC	CATKAGFGGYEQYF	TRBV24-1	TRBJ2-7
TGTGCCAGCAGTGAGGCGGTGGGCTCCTACAATGAGCAGTTCTTC	CASSEAVGSYNEQFF	TRBV6-1	TRBJ2-1
TGTGCCAGCAGGAATGCCGGACAGGGATCTCAGCCCCAGCATTTT	CASRNAGQGSQPQHF	TRBV6-1	TRBJ1-5
TGCGCCAGCAGCCAAGACATCCTCGGGGGGACTGAAGCTTTCTTT	CASSQDILGGTEAFF	TRBV4-3	TRBJ1-1
TGTGCCAGCAGTTGGCCCCGAAGGACACCAGAATGTGAAAAACTGTTTTTT	CASSWPRRTPECEKLFF	TRBV6-1	TRBJ1-4
TGTGCCAGCAGCCACTCTTCTCGGAACACCGGGGAGCTGTTTTTT	CASSHSSRNTGELFF	TRBV3-1	TRBJ2-2
TGCGCCAGCAGTGAGGTTATAGGGGACTCAGATACGCAGTATTTT	CASSEVIGDSDTQYF	TRBV10-2	TRBJ2-3
TGCAGTGCTAGAGATGGGCTCCAGCGGAAAGGCTACACCTTC	CSARDGLQRKGYTF	TRBV20-1	TRBJ1-2
TGTGCCAGCAGTGAAGGGACAGGTTACGAGCAGTACTTC	CASSEGTGYEQYF	TRBV6-1	TRBJ2-7
TGCAGTGCTGGACGGCATGGCTACACCTTC	CSAGRHGYTF	TRBV20-1	TRBJ1-2
TGCGCCAGCAGTGTTGTGGGCCTCCCAGATACGCAGTATTTT	CASSVVGLPDTQYF	TRBV10-2	TRBJ2-3
TGTGCCAGCAGCTTGAGAGACAGGCTCGCCGGGGAGACCCAGTACTTC	CASSLRDRLAGETQYF	TRBV5-6	TRBJ2-5
TGCGCCAGCAGCTTGGCCCAACAGGGTTTGCAAGAGACCCAGTACTTC	CASSLAQQGLQETQYF	TRBV5-1	TRBJ2-5
TGTGCCAGCAGTTACTTGACAGGGGGTCCTCGACTGATTAGCAATCAGCCCCAGCATTTT	CASSYLTGGPRLISNQPQHF	TRBV6-2	TRBJ1-5
TGCGCCAGCAGTGGCCGGGACAGGGCCAACTACACTGAAGCTTTCTTT	CASSGRDRANYTEAFF	TRBV10-2	TRBJ1-1
TGTGCCAGCGGTTCGAGGACACTGACCTACACCTTC	CASGSRTLTYTF	TRBV12-3	TRBJ1-2
TGCAGTGCTAGGTCCGCCTATCCCAAGGGTTTGGACTACAATGAGCAGTTCTTC	CSARSAYPKGLDYNEQFF	TRBV20-1	TRBJ2-1
TGCGCCAGCAGGAAGCAAGGATCAGGCTCCGGTATTAGCTCCTACGAGCAGTACTTC	CASRKQGSGSGISSYEQYF	TRBV5-1	TRBJ2-7
TGCGCCAGCAGTATTAAGCGGGAGGTATCCGACTTC	CASSIKREVSDF	TRBV10-1	TRBJ1-2
TGTGCCAGCAGCTGGGACAGGGGAGGAGGGACTAGCTCTGGAAACACCATATATTTT	CASSWDRGGGTSSGNTIYF	TRBV7-8	TRBJ1-3
TGTGCCAGCAGCTTAAATGTGAGGGGGAGCAGCAATCAGCCCCAGCATTTT	CASSLNVRGSSNQPQHF	TRBV7-3	TRBJ1-5
TGTGCCAGCAGTGGGCAACAGGGGGGGCACAATGAGCAGTTCTTC	CASSGQQGGHNEQFF	TRBV6-2	TRBJ2-1
TGTGCCAGCAGTTTTTTCGGGGTTGGACCCTACGAGCAGTACTTC	CASSFFGVGPYEQYF	TRBV28	TRBJ2-7
TGCGCCAGCAGCCAAGGGACAGGGGAAGAATCAACTACGCAGTATTTT	CASSQGTGEESTTQYF	TRBV4-3	TRBJ2-3
TGTGCTAGCAGCACGCCGGGACAGGGGAATGAAGCTTTCTTT	CASSTPGQGNEAFF	TRBV7-7	TRBJ1-1
TGTGCCAGCAGCTGGGGAGAAACGAACTATGGCTACACCTTC	CASSWGETNYGYTF	TRBV7-6	TRBJ1-2
TGCAGCGGGCTGGGGGGGGGAATGAACACTGAAGCTTTCTTT	CSGLGGGMNTEAFF	TRBV29-1	TRBJ1-1
TGTGCCACGGGGGCCCTCTTGGACGAGCAGTACTTC	CATGALLDEQYF	TRBV14	TRBJ2-7
TGTGCCACCAGTGATTTGAATCTATGTCAGGCGGGCTATGGCTACACCTTC	CATSDLNLCQAGYGYTF	TRBV24-1	TRBJ1-2
TGTGCCAGCAGCTTCGGGGATTGGGGACAAGTTTCCGGGGAGCTGTTTTTT	CASSFGDWGQVSGELFF	TRBV5-4	TRBJ2-2
TGTGCCAGACCGACTAGTAGACCCAATGAGCAGTTCTTC	CARPTSRPNEQFF	TRBV28	TRBJ2-1
TGTGCCAGCAGCTTAGATGGTCGGACAGGGTCTGCTTACTATGGCTACACCTTC	CASSLDGRTGSAYYGYTF	TRBV11-2	TRBJ1-2
TGTGCCAGCAGCTGGTCCCGGGAGCGGGGGGAAAACATTCAGTACTTC	CASSWSRERGENIQYF	TRBV7-2	TRBJ2-4
TGTGCCAGCAGCTGGCCGGACAGGGTCTACGAGCAGTACTTC	CASSWPDRVYEQYF	TRBV7-8	TRBJ2-7
TGTGCCAGCAGCAGACTCTCTGGAAACACCATATATTTT	CASSRLSGNTIYF	TRBV5-6	TRBJ1-3
TGCAGTGCTAGAACAGACCGGGAGAGGGCAGATACGCAGTATTTT	CSARTDRERADTQYF	TRBV20-1	TRBJ2-3
TGTGCCAGCAGCCGTGGTACAGGGATCAGGAACACCGGGGAGCTGTTTTTT	CASSRGTGIRNTGELFF	TRBV7-9	TRBJ2-2
TGTGCCAGCAGTGACTCGCGTCTAGGAAGCAATCAGCCCCAGCATTTT	CASSDSRLGSNQPQHF	TRBV6-4	TRBJ1-5
TGTGCCAGCAGACCATTCGCCCATATGACTGAAGCTTTCTTT	CASRPFAHMTEAFF	TRBV2	TRBJ1-1
TGCGCCAGCAGCAGGGACATCACGCAGTACTTC	CASSRDITQYF	TRBV4-1	TRBJ2-7
TGTGCCAGCAGCGGGTCGGTCGTTGGCTACGAGCAGTACTTC	CASSGSVVGYEQYF	TRBV11-3	TRBJ2-7
TGCAGCGCCTCCCAGGGACAGGGAAGCTATGGCTACACCTTC	CSASQGQGSYGYTF	TRBV29-1	TRBJ1-2
TGTGCCAGCAGTGATGAGTCCGTCAACAAGACTAGATTGTCCGCTACTAATGAAAAACTGTTTTTT	CASSDESVNKTRLSATNEKLFF	TRBV6-1	TRBJ1-4
TGTGCCAGCAGCCCGGCCCCGATGGGGGCTCCCCCCACAGATACGCAGTATTTT	CASSPAPMGAPPTDTQYF	TRBV13	TRBJ2-3
TGTGCCAGCCTCAGCCGGGCCACTGAAGCTTTCTTT	CASLSRATEAFF	TRBV6-4	TRBJ1-1
TGTGCTAGCAGCGTTGTAGCGGGAGAGACCCAGTACTTC	CASSVVAGETQYF	TRBV7-7	TRBJ2-5
TGCAGTGCTAGAGATCGAGTGGGAGGTGGAACAGATACGCAGTATTTT	CSARDRVGGGTDTQYF	TRBV20-1	TRBJ2-3
TGCGCCAGCAGCTTGAGCGGGGCGGCGAGCAATCAGCCCCAGCATTTT	CASSLSGAASNQPQHF	TRBV5-1	TRBJ1-5
TGTGCCAGCAGCCCTCGAGGTTCACCCCTCCACTTT	CASSPRGSPLHF	TRBV13	TRBJ1-6
TGCGCCAGCAGCTTGGCCCTAAAACCTGGGGGCTATGGCTACACCTTC	CASSLALKPGGYGYTF	TRBV5-1	TRBJ1-2
TGTGCCAGCAGTTTGATCGATCTCACTCGCGTGGAGAACGAGCAGTACTTC	CASSLIDLTRVENEQYF	TRBV12-3	TRBJ2-7
TGTGCCACCAGCAGACAGAGAGGAGTTAACTATGGCTACACCTTC	CATSRQRGVNYGYTF	TRBV15	TRBJ1-2
TGTGCCACCAGTGACACTGGGGCGGGGCAAGAGACCCAGTACTTC	CATSDTGAGQETQYF	TRBV24-1	TRBJ2-5
TGTGCCAGTAGTATAGTGGCCGGGACAGAGAAGCAGTACTTC	CASSIVAGTEKQYF	TRBV19	TRBJ2-7
TGTGCCAGCAGTTCATTTGCAGGGACGCCTGTGGGGAAGAACTATGGCTACACCTTC	CASSSFAGTPVGKNYGYTF	TRBV12-4	TRBJ1-2
TGTGCCAGCAGCGGGGGGATCCCGGGAGGTATCCTACGTGTGGGCTACACCTTC	CASSGGIPGGILRVGYTF	TRBV3-1	TRBJ1-2
TGCAGCGTTGCCCGGTCTAGCGGCAATAGCTCCTACAATGAGCAGTTCTTC	CSVARSSGNSSYNEQFF	TRBV29-1	TRBJ2-1
TGTGCCAGCAGCCCCGGCCAGTTGGCCCCAAATTCACCCCTCCACTTT	CASSPGQLAPNSPLHF	TRBV7-2	TRBJ1-6
TGTGCCAGCAGCTATGAGGGAGAGGGGGACTATGGCTACACCTTC	CASSYEGEGDYGYTF	TRBV5-6	TRBJ1-2
TGTGCCAGCAGTAGACTAGCGGGAAGTCACAATGAGCAGTTCTTC	CASSRLAGSHNEQFF	TRBV27	TRBJ2-1
TGCGCCAGCAGCTGGGATTCTGGGGGGGTACCCTACAATGAGCAGTTCTTC	CASSWDSGGVPYNEQFF	TRBV5-1	TRBJ2-1
TGTGCCAGCAGCAAAGACGGGCACGAGCAGTACTTC	CASSKDGHEQYF	TRBV11-3	TRBJ2-7
TGCGCCAGCAGCTTGGCCATCCCTGATACGCAGTATTTT	CASSLAIPDTQYF	TRBV5-1	TRBJ2-3
TGTGCCAGCTCACCACCCGCCGGGACTAGATCTGGGGCCAACGTCCTGACTTTC	CASSPPAGTRSGANVLTF	TRBV18	TRBJ2-6
TGCAGAACTAGCTGTCGGACTACGCAGTATTTT	CRTSCRTTQYF	TRBV29-1	TRBJ2-3
TGTGCCACAGGTCAAAAGGACACCGGGGAGCTGTTTTTT	CATGQKDTGELFF	TRBV14	TRBJ2-2
TGTGCCAGCAGTGTGGAGGGGGATTTTCCTTTCACAGATACGCAGTATTTT	CASSVEGDFPFTDTQYF	TRBV6-5	TRBJ2-3
TGTGCCAGCAGTGAAGCGCGGGGGGGTTATAGCAATCAGCCCCAGCATTTT	CASSEARGGYSNQPQHF	TRBV6-1	TRBJ1-5
TGTGCCACCAGCAGACACGCTAGCGGGACAAATGAGCAGTTCTTC	CATSRHASGTNEQFF	TRBV15	TRBJ2-1
TGTGCCAGCAGCTGTTTCCCTGGGGGCGGGAACACTGAAGCTTTCTTT	CASSCFPGGGNTEAFF	TRBV9	TRBJ1-1
TGTGCCAGCAGTGATGGGGGGCAGTCCGCCAATGAGCAGTTCTTC	CASSDGGQSANEQFF	TRBV6-1	TRBJ2-1
TGTGCCAGCAGCCCGTTCGAGGGGACATCGGCAACTAATGAAAAACTGTTTTTT	CASSPFEGTSATNEKLFF	TRBV28	TRBJ1-4
TGTGCCAGGGCGGTGGCCGGGGTCCTGAACACTGAAGCTTTCTTT	CARAVAGVLNTEAFF	TRBV19	TRBJ1-1
TGTGCCAGCAGCAGCCGGGTTGTGGGGACAGGGTACGAGCAGTACTTC	CASSSRVVGTGYEQYF	TRBV11-3	TRBJ2-7
TGTGCCAGCAGCTTCGCGAGGGGGTCCTACGAGCAGTACTTC	CASSFARGSYEQYF	TRBV5-8	TRBJ2-7
TGTGCCAGCAGCCATTTAGGAAACACCATATATTTT	CASSHLGNTIYF	TRBV13	TRBJ1-3
TGTGCCATCAGTGAAAAGGGGGGCGAGGATAACTATGGCTACACCTTC	CAISEKGGEDNYGYTF	TRBV10-3	TRBJ1-2
TGTGCCAGCTCACCATGGGGGGCTAGGAGGTTGAACACTGAAGCTTTCTTT	CASSPWGARRLNTEAFF	TRBV18	TRBJ1-1
TGTGCCAGCAGCCAGGCCCCCCCGAGACTGACCCAGTACTTC	CASSQAPPRLTQYF	TRBV7-2	TRBJ2-5
TGTGCCAGCAGCTTAACCCTCCAGGTTGATGACTCTGGAAACACCATATATTTT	CASSLTLQVDDSGNTIYF	TRBV7-3	TRBJ1-3
TGTGCCAAGGGCCTTAGGGGATCAATGAACACTGAAGCTTTCTTT	CAKGLRGSMNTEAFF	TRBV3-1	TRBJ1-1
TGTGCCAGCAGCCAAGAATACGGGCTCCCAGATACGCAGTATTTT	CASSQEYGLPDTQYF	TRBV4-2	TRBJ2-3
TGTGCCAGCAGCTTAGCCCTCCCATGGCCGGGACAGGGGATTCCCGAGACCCAGTACTTC	CASSLALPWPGQGIPETQYF	TRBV11-3	TRBJ2-5
TGTGCCAGCAGCTTCATCCCCGCTCGCGGGAGGGTGAGGGAGACCCAGTACTTC	CASSFIPARGRVRETQYF	TRBV7-9	TRBJ2-5
TGCAGTGCTAGAGCACGGGGTCCCTATAACTCTGGAAACACCATATATTTT	CSARARGPYNSGNTIYF	TRBV20-1	TRBJ1-3
TGTGCCAGCAGTTTCAGCGGACCAAGAGAGCAGTTCTTC	CASSFSGPREQFF	TRBV28	TRBJ2-1
TGTGCCAGCAGCTTATGTCCGGGGGGGGGGGGCGAGCAGTACTTC	CASSLCPGGGGEQYF	TRBV7-9	TRBJ2-7
TGCAGTGCTCCCCGGAAGGGAACGTTAAGGACTAGCGAAGCATGCTCCTACAATGAGCAGTTCTTC	CSAPRKGTLRTSEACSYNEQFF	TRBV20-1	TRBJ2-1
TGTGCCAGCAGTTTGTCGCGGGAGAGAAGCAAGGCCAAAAACATTCAGTACTTC	CASSLSRERSKAKNIQYF	TRBV7-7	TRBJ2-4
TGTGCCAGCAGCGCCCCGGACAATAGATACTGCTATGAAAAACTGTTTTTT	CASSAPDNRYCYEKLFF	TRBV28	TRBJ1-4
TGCGCCAGCAGCTTGGGGGTGGGGGGGCAGTATTTT	CASSLGVGGQYF	TRBV5-1	TRBJ2-3
TGTGCCACCAGTGATTTATCTTCTGGTATTGGACACAATGAGCAGTTCTTC	CATSDLSSGIGHNEQFF	TRBV24-1	TRBJ2-1
TGTGCCAGCAGCCAAGATCGTCCAGGGTGTTGGGGTGTAGAGACCCAGTACTTC	CASSQDRPGCWGVETQYF	TRBV14	TRBJ2-5
TGTGCCAGCAGCTTGCGACAGAAGCGCTATGGCTACACCTTC	CASSLRQKRYGYTF	TRBV5-6	TRBJ1-2
TGTGCCAGCGTAAAGCGGGGCTACAATGAGCAGTTCTTC	CASVKRGYNEQFF	TRBV27	TRBJ2-1
TGTGCCAGCCGGAATGGGGCTAACTATGGCTACACCTTC	CASRNGANYGYTF	TRBV27	TRBJ1-2
TGTGCTAGTGGTTCGAGACTAGCGGGCTTCCTGGGTTCAAGCACCGGGGAGCTGTTTTTT	CASGSRLAGFLGSSTGELFF	TRBV12-5	TRBJ2-2
TGTGCCAGCAGGTCACTTTACACCGGGGAGCTGTTTTTT	CASRSLYTGELFF	TRBV7-9	TRBJ2-2
TGTGCCAGCAGTTCAGGACAGGATGTTAGGTTTGGCTATAATTCACCCCTCCACTTT	CASSSGQDVRFGYNSPLHF	TRBV6-5	TRBJ1-6
TGTGCCAGCAGCAGATATTGGACTAGCGTGGATTGGGACACAGATACGCAGTATTTT	CASSRYWTSVDWDTDTQYF	TRBV5-6	TRBJ2-3
TGTGCCAGCAGCCAAGACAGGCACAGGGTTTCATCCAAAAACATTCAGTACTTC	CASSQDRHRVSSKNIQYF	TRBV3-1	TRBJ2-4
TGTGCCAGCAGTGAAGCGGGGCCAACTGCGACACTGGGCCCAGATACGCAGTATTTT	CASSEAGPTATLGPDTQYF	TRBV6-1	TRBJ2-3
TGTGCCACCACGCAGGATAACACAGATACGCAGTATTTT	CATTQDNTDTQYF	TRBV24-1	TRBJ2-3
TGTGCCAGCAGCTTAGAAGAACCTGAGGGCCCCCAAGAGACCCAGTACTTC	CASSLEEPEGPQETQYF	TRBV7-2	TRBJ2-5
TGTGCCAGCAGTGGGACTAGCGGGGACAATGAGCAGTTCTTC	CASSGTSGDNEQFF	TRBV2	TRBJ2-1
TGTGCCAGCAGAATTAGAGGAGGCTCCTACGAGCAGTACTTC	CASRIRGGSYEQYF	TRBV6-1	TRBJ2-7
TGTGCCACCAGTGAGGGATTTCTGCGGGGGATCAGCTCCTACGAGCAGTACTTC	CATSEGFLRGISSYEQYF	TRBV24-1	TRBJ2-7
TGTGCCAGCAGTTTTATACGATTTGGGACCCAGTACTTC	CASSFIRFGTQYF	TRBV6-5	TRBJ2-5
TGTGCCAGCAGATTGGAGAGGACCTCTTCCGGTCTCGATGAGCAGTTCTTC	CASRLERTSSGLDEQFF	TRBV6-3	TRBJ2-1
TGCGCCAGCAGGTTCGCGGGAGGTCAAGAGACCCAGTACTTC	CASRFAGGQETQYF	TRBV5-1	TRBJ2-5
TGTGCCAGCCCCGATCACCGAGGGGTGTGGTGCTACGAGCAGTACTTC	CASPDHRGVWCYEQYF	TRBV25-1	TRBJ2-7
TGTGCCAGCAGCCTAGCAGGGTATGGCTACACCTTC	CASSLAGYGYTF	TRBV7-3	TRBJ1-2
TGTGCCAGCAGCTTAGACGACGTCCGACGTAAAAGCACTTACAATGAGCAGTTCTTC	CASSLDDVRRKSTYNEQFF	TRBV7-3	TRBJ2-1
TGTGCCAGCAGCTTAGCGCCAGTACAGCGACAGAACTACGAGCAGTACTTC	CASSLAPVQRQNYEQYF	TRBV7-6	TRBJ2-7
TGTGCCAGCAGTTACTCGACCGTAGGAATCAGGGAAGGCTACACCTTC	CASSYSTVGIREGYTF	TRBV6-2	TRBJ1-2
TGTGCCAGCCCGGGGGACATTGTAGCAGATACGCAGTATTTT	CASPGDIVADTQYF	TRBV6-6	TRBJ2-3
TGTGCCAGCAGCAACAGGGAGCAGTTCTTC	CASSNREQFF	TRBV9	TRBJ2-1
TGTGCCACCAGTGATTTATCCAGTCTAAGAAACACCATATATTTT	CATSDLSSLRNTIYF	TRBV24-1	TRBJ1-3
TGTGCTAGTGGTTGGGGTAGTCCTTCAAACAACGAGCAGTACTTC	CASGWGSPSNNEQYF	TRBV12-5	TRBJ2-7
TGTGCCAGCAGCTTAACCGACGTGGGGGCTCAGCCCCAGCATTTT	CASSLTDVGAQPQHF	TRBV7-3	TRBJ1-5
TGTGCCAGCGAAAGTGGGACTAGCGGGGGGGCGGGGCATCTTCGTCCCAAAAACATTCAGTACTTC	CASESGTSGGAGHLRPKNIQYF	TRBV28	TRBJ2-4
TGTGCCAGCAGCGTAGACCACGGAGAAAGCAATCAGCCCCAGCATTTT	CASSVDHGESNQPQHF	TRBV7-4	TRBJ1-5
TGTGCCAGCAGTTTATCCCCGCGGGATCCCTTCTTTCAGCCCCAGCATTTT	CASSLSPRDPFFQPQHF	TRBV28	TRBJ1-5
TGTGCCAGCAGCTTACCTCTTGCGGCGGGGGGTGCTGAGCAGTTCTTC	CASSLPLAAGGAEQFF	TRBV7-4	TRBJ2-1
TGTGCCAGCAGTTACTCGATCTCACAGGGGAAAAACTATGGCTACACCTTC	CASSYSISQGKNYGYTF	TRBV6-5	TRBJ1-2
TGTGCCAGCAGTGAATTCCGGGGGGTCAATGAGCAGTTCTTC	CASSEFRGVNEQFF	TRBV25-1	TRBJ2-1
TGTGCCAGCAGACCTACTCAAGACAGGGGGCCCAGAGATGGCTACACCTTC	CASRPTQDRGPRDGYTF	TRBV9	TRBJ1-2
TGTGCCAGCAGGGGGGGGGCTTACGAGCAGTACTTC	CASRGGAYEQYF	TRBV28	TRBJ2-7
TGTGCCAGCAGCTCAAGCCGGGCCGGAATCTTC	CASSSSRAGIF	TRBV5-6	TRBJ2-1
TGTGCTAGTGGTCCGACAGGGTTAAATGAAAAACTGTTTTTT	CASGPTGLNEKLFF	TRBV12-5	TRBJ1-4
TGTGCCAGCAGCTTAGGCAAAACACGGGGGCCCAGCGAGCAGTACTTC	CASSLGKTRGPSEQYF	TRBV7-9	TRBJ2-7
TGTGCGGGGGGCCAAGACGGGGAGCTGTTTTTT	CAGGQDGELFF	TRBV6-2	TRBJ2-2
TGTGCCAGCAGCGCGCTAGGCTGGGGGGACCGGGGGGGGACCCAGTACTTC	CASSALGWGDRGGTQYF	TRBV9	TRBJ2-5
TGTGCCACCAGTGATAGTGAGAACAGGGGAGGCTACACCTTC	CATSDSENRGGYTF	TRBV24-1	TRBJ1-2
TGCAGTGCTAGGCCGGGGTCAACTGGAAACACCATATATTTT	CSARPGSTGNTIYF	TRBV20-1	TRBJ1-3
TGTGCCAGCAGCCTTTGTTTAAGGACAAGTTTTTCTGAAGCTTTCTTT	CASSLCLRTSFSEAFF	TRBV6-6	TRBJ1-1
TGCAGTGCTAGAGATCCCCATCGGGACAGGGGGACGGGCACTGAAGCTTTCTTT	CSARDPHRDRGTGTEAFF	TRBV20-1	TRBJ1-1
TGTGCCAGAACCTCAGGGATCACTGGAAACACCATATATTTT	CARTSGITGNTIYF	TRBV28	TRBJ1-3
TGTGCCAGCAGGGGTCCTACTAGCGGGGGGGCATTTGAGCAGTTCTTC	CASRGPTSGGAFEQFF	TRBV6-1	TRBJ2-1
TGTGCCAGCAGTACAGGGGGAAATGAAAAACTGTTTTTT	CASSTGGNEKLFF	TRBV6-4	TRBJ1-4
TGTGCCAGCAGCTTGGCGGGGGCGTACCAAGAGACCCAGTACTTC	CASSLAGAYQETQYF	TRBV5-4	TRBJ2-5
TGCGCCAGCAGTTTCCGCACAGGGTCGTATGGCTACACCTTC	CASSFRTGSYGYTF	TRBV10-1	TRBJ1-2
TGCAGTGCTAATGCAACTAGCGGGAGGTCTGGGGGGTTCGGAGGCAATGAGCAGTTCTTC	CSANATSGRSGGFGGNEQFF	TRBV20-1	TRBJ2-1
TGTGCCAGCAGCAAACAGGTAGCGGGATCGGTTAGAAACTATGGCTACACCTTC	CASSKQVAGSVRNYGYTF	TRBV7-9	TRBJ1-2
TGTGCCAGCAGCGACCCCGACAGTTTCTTGGCCTACGAGCAGTACTTC	CASSDPDSFLAYEQYF	TRBV12-3	TRBJ2-7
TGTGCCAGCAGGACAGGGTTAACCCAAGAGACCCAGTACTTC	CASRTGLTQETQYF	TRBV12-3	TRBJ2-5
TGTGCCAGTAGTATAGACCGACAGATGCTCAATGAGCAGTTCTTC	CASSIDRQMLNEQFF	TRBV19	TRBJ2-1
TGTGCCAGCAGCGAGGCGGCGGGAAGGGAAGAGACCCAGTACTTC	CASSEAAGREETQYF	TRBV7-3	TRBJ2-5
TGTGCCAGCAGTTACCTCGACAGGAGGGCCTATGGCTACACCTTC	CASSYLDRRAYGYTF	TRBV6-5	TRBJ1-2
TGTGCCAGTAGCGCCTTCACTAGCGGAATGGCCTACGAGCAGTACTTC	CASSAFTSGMAYEQYF	TRBV19	TRBJ2-7
TGCGCCAGCAGTGACGGACGGAATCAGCCCCAGCATTTT	CASSDGRNQPQHF	TRBV10-1	TRBJ1-5
TGTGCCAGCAGGGCCATCGGCAATCAGCCCCAGCATTTT	CASRAIGNQPQHF	TRBV27	TRBJ1-5
TGTGCCAGTCCTCCCAGACTAGCGGACACCGGGGAGCTGTTTTTT	CASPPRLADTGELFF	TRBV19	TRBJ2-2
TGTGCCAAAGTCCCACGGGGCAATCAGCCCCAGCATTTT	CAKVPRGNQPQHF	TRBV7-8	TRBJ1-5
TGTGCCAGCAGCAATAGGGGTGAGCAGTTCTTC	CASSNRGEQFF	TRBV7-9	TRBJ2-1
TGTGCCAGCAGCTTCTCGAGCGGGGAGCAATCCTCCTACGAGCAGTACTTC	CASSFSSGEQSSYEQYF	TRBV5-4	TRBJ2-7
TGCAGTGCTTCAAATTACGGTGGGGGCAATCAGCCCCAGCATTTT	CSASNYGGGNQPQHF	TRBV20-1	TRBJ1-5
TGTGCCAGCAGACGAGCAGGGAACGGGGAGCTGTTTTTT	CASRRAGNGELFF	TRBV6-4	TRBJ2-2
TGTGCCTGGAGTGTAGGCGGCCCAAGGGACCTAGCGGGGGTCGTTATTTACAATGAGCAGTTCTTC	CAWSVGGPRDLAGVVIYNEQFF	TRBV30	TRBJ2-1
TGTGCCAGCAGTGAACCGCCGGACAGGTATTATTCCTACGAGCAGTACTTC	CASSEPPDRYYSYEQYF	TRBV6-6	TRBJ2-7
TGTGCCCCCCTGTACCCCACGGGGGGCATGAACACTGAAGCTTTCTTT	CAPLYPTGGMNTEAFF	TRBV6-5	TRBJ1-1
TGTGCCAGCAGCTTGGGGGGCCTAAATGGCCTCCCGGGGCTTGCAACTAATGAAAAACTGTTTTTT	CASSLGGLNGLPGLATNEKLFF	TRBV11-3	TRBJ1-4
TGTGCCAGCAGCCCTCGGGCAGCTAACTATGGCTACACCTTC	CASSPRAANYGYTF	TRBV3-1	TRBJ1-2
TGTGCCAGCAGCCGTGACCCGGGGTCGGTCAATGAGCAGTTCTTC	CASSRDPGSVNEQFF	TRBV6-1	TRBJ2-1
TGTGCCAGCAGCGGGGGGAACACCGGGGAGCTGTTTTTT	CASSGGNTGELFF	TRBV13	TRBJ2-2
TGTGCCAGCAGCGGACAGGTAGAACGGTATGGCTACACCTTC	CASSGQVERYGYTF	TRBV11-3	TRBJ1-2
TGCGCCAGCAGTGAAACGGACAGGGGTCCGAATCAGCCCCAGCATTTT	CASSETDRGPNQPQHF	TRBV10-1	TRBJ1-5
TGTGCCAGCAGCCGGGACACAGATACGCAGTATTTT	CASSRDTDTQYF	TRBV13	TRBJ2-3
TGTGCCAGCAGCGTACGGTTACACGAGATGAACACTGAAGCTTTCTTT	CASSVRLHEMNTEAFF	TRBV9	TRBJ1-1
TGTGCCAGCAGTTACTGGAGCGGGAAAGGCTCCTACGAGCAGTACTTC	CASSYWSGKGSYEQYF	TRBV6-3	TRBJ2-7
TGTGCCAGCAGCCTGACAGGGGGCGGGCTCGGGCCTGGGGCCAACGTCCTGACTTTC	CASSLTGGGLGPGANVLTF	TRBV12-4	TRBJ2-6
TGTGCCAGCAGTGGAAGGGGGGTCCCCGGGGAGCTGTTTTTT	CASSGRGVPGELFF	TRBV27	TRBJ2-2
TGTGCCAGCAGTTATGAGATGAACTATGGCTACACCTTC	CASSYEMNYGYTF	TRBV28	TRBJ1-2
TGCGCCAGCAGCCAAGGTCGGGAGACCCAGTACTTC	CASSQGRETQYF	TRBV4-1	TRBJ2-5
TGTGCCAGCAGCACATCGGGGGAAAGGTCGACGCAGTATTTT	CASSTSGERSTQYF	TRBV13	TRBJ2-3
TGTGCCAGCAGCGTAGCCCCGGGACAGGGGGCGCGGAAATATGGCTACACCTTC	CASSVAPGQGARKYGYTF	TRBV9	TRBJ1-2
TGTGCCAGCAGCTTGGTAGGCAGAAGACCAGGACTCTATGGCTACACCTTC	CASSLVGRRPGLYGYTF	TRBV5-4	TRBJ1-2
TGTGCCAGCAGTGACTCCGGGACTAGCGGGGGGGCTGGAAACACCGGGGAGCTGTTTTTT	CASSDSGTSGGAGNTGELFF	TRBV25-1	TRBJ2-2
TGTGCCAGTAGTAAGAGGCTAGATGAGCAGTTCTTC	CASSKRLDEQFF	TRBV19	TRBJ2-1
TGTGCCAGCACCCGACGGGGGGGTGAGACCCAGTACTTC	CASTRRGGETQYF	TRBV28	TRBJ2-5
TGCGCCAGCAGCTGGGGGGCCGAGCAGTACTTC	CASSWGAEQYF	TRBV4-1	TRBJ2-7
TGTGCCACCAGTGATTTGAACACCGACGAGCAGTACTTC	CATSDLNTDEQYF	TRBV24-1	TRBJ2-7
TGTGCCAGCAGCCAAGATCCCCCCTCTTCCGGGCGGGAAGCCTACAATGAGCAGTTCTTC	CASSQDPPSSGREAYNEQFF	TRBV4-2	TRBJ2-1
TGTGCCAGCAGCCCGGGACTAGCGGGAGTGGAGACCCAGTACTTC	CASSPGLAGVETQYF	TRBV13	TRBJ2-5
TGTGCCAGCAGCTGCCGGGACAAAAAGGGCATTGGGAACACCGGGGAGCTGTTTTTT	CASSCRDKKGIGNTGELFF	TRBV13	TRBJ2-2
TGTGCCAGCAGCTCCGGGCGCTGGGGAGGTCTTTGGAACACCGGGGAGCTGTTTTTT	CASSSGRWGGLWNTGELFF	TRBV5-4	TRBJ2-2
TGTGCCACCACAGGGGGCACCGGGGAGCTGTTTTTT	CATTGGTGELFF	TRBV24-1	TRBJ2-2
TGTGCCAGCAGTGAAGCGCTAAAGCGGGAGGGTGAGACCCAGTACTTC	CASSEALKREGETQYF	TRBV6-1	TRBJ2-5
TGTGCCATCAGTGAGTCTCCCGGGGAGCTGTTTTTT	CAISESPGELFF	TRBV10-3	TRBJ2-2
TGTGCCAGCAGCCAAGACTTCAAGCCGGCACTATATTCTCCCTACGAGCAGTACTTC	CASSQDFKPALYSPYEQYF	TRBV14	TRBJ2-7
TGCAGTGCTAGACCGGGACGGACTGTCTATGGCTACACCTTC	CSARPGRTVYGYTF	TRBV20-1	TRBJ1-2
TGCGCCAGCCCGGGGACGGGTGGTGGCTACACCTTC	CASPGTGGGYTF	TRBV10-1	TRBJ1-2
TGTGCCAGCAGTTTATGCGATAAGGGATATGAGCAGTTCTTC	CASSLCDKGYEQFF	TRBV28	TRBJ2-1
TGCGCCAGCAGCTTGGGGGACACCGGGGAGCTGTTTTTT	CASSLGDTGELFF	TRBV5-1	TRBJ2-2
TGCGCCGGGGGGCAGCCCCAGCATTTT	CAGGQPQHF	TRBV10-1	TRBJ1-5
TGTGCCAGCAGTTGTGTTGCCTACAGGGCCGGAGTTCATGAGCAGTTCTTC	CASSCVAYRAGVHEQFF	TRBV6-5	TRBJ2-1
TGTGCCTGGAGGACAGGGCTGGGGAACACTGAAGCTTTCTTT	CAWRTGLGNTEAFF	TRBV30	TRBJ1-1
TGTGCCAGCAGCGGAGAGGGCGACAATGAGCAGTTCTTC	CASSGEGDNEQFF	TRBV5-6	TRBJ2-1
TGTGCCACCAGTGATTTGGGTCTGATAGATTCCCCCTACTACGAGCAGTACTTC	CATSDLGLIDSPYYEQYF	TRBV24-1	TRBJ2-7
TGCGCCAGCAGGTTAAAACGGCTCAGGGAGTTCAATGAGCAGTTCTTC	CASRLKRLREFNEQFF	TRBV4-1	TRBJ2-1
TGTGCCAGCAGGGTGACTGAAGCTTTCTTT	CASRVTEAFF	TRBV6-6	TRBJ1-1
TGTGCCAGCGACAGGGTGGTATCCTACGAGCAGTACTTC	CASDRVVSYEQYF	TRBV12-4	TRBJ2-7
TGTGCCAGCAGTTATTTTCGCAGGGGCCTCAATCAGCCCCAGCATTTT	CASSYFRRGLNQPQHF	TRBV5-5	TRBJ1-5
TGTGCTAGCAGCTCCGGAGGTAGCACAGATACGCAGTATTTT	CASSSGGSTDTQYF	TRBV7-7	TRBJ2-3
TGTGCCAGCAGCGGCGGTCACCCGTATAGACTGTTACCCTACGAGCAGTACTTC	CASSGGHPYRLLPYEQYF	TRBV7-9	TRBJ2-7
TGCGCCAGCAGCTCGGTGTTTATTTACAGGGGGCTCCAGCCCCAGCATTTT	CASSSVFIYRGLQPQHF	TRBV5-1	TRBJ1-5
TGCGCCAGCAGCTTGGCGGGTTTTAGCCTCTCTTCAGATACGCAGTATTTT	CASSLAGFSLSSDTQYF	TRBV5-1	TRBJ2-3
TGTGCCAGCAGCCTTCTACTAGCGGGCTCCGATGGAAGGGATACGCAGTATTTT	CASSLLLAGSDGRDTQYF	TRBV14	TRBJ2-3
TGTGCCAGCAGCCAACTAGTACGCACAGATACGCAGTATTTT	CASSQLVRTDTQYF	TRBV14	TRBJ2-3
TGCGCCAGCTCGACAGGGCAGCCCCAGCATTTT	CASSTGQPQHF	TRBV10-2	TRBJ1-5
TGTGCCAGCACACCCCGGTGCTTACCAAGCACAGATACGCAGTATTTT	CASTPRCLPSTDTQYF	TRBV6-2	TRBJ2-3
TGTGCCAGCAGTAAACACAGGGCGAAGCCCCAGCATTTT	CASSKHRAKPQHF	TRBV28	TRBJ1-5
TGTGCCAGCAGTGACTGGGGACTAGCGGGTGATGAGCAGTTCTTC	CASSDWGLAGDEQFF	TRBV2	TRBJ2-1
TGTGCCAGCAGCACCCCGGGACTAAGCTACGAGCAGTACTTC	CASSTPGLSYEQYF	TRBV11-2	TRBJ2-7
TGCGCCAGCAGCTTACGGATTACTAGCGGGAGAGGGTTCCCTGAAGCTTTCTTT	CASSLRITSGRGFPEAFF	TRBV5-1	TRBJ1-1
TGTGCCAGCTCCCCCAGACTAGCGGTCGCCGGGTTGCAGTACTTC	CASSPRLAVAGLQYF	TRBV18	TRBJ2-7
TGTGCCAGCAGCTTAATGCTGACTAGGGACACCGGGGAGCTGTTTTTT	CASSLMLTRDTGELFF	TRBV7-7	TRBJ2-2
TGTGCCAGCAGTGCCGGACCGGTGGCCCAGCATTTT	CASSAGPVAQHF	TRBV6-1	TRBJ1-5
TGTGCCAGCCCCGGGACTAGAGGGGCCTCCTACGAGCAGTACTTC	CASPGTRGASYEQYF	TRBV7-3	TRBJ2-7
TGTGCCAGCAGTTACGTCAGGACAGGCTGGGAGAGCTCCTACAATGAGCAGTTCTTC	CASSYVRTGWESSYNEQFF	TRBV6-6	TRBJ2-1
TGTGCCAGCAGTGGAAGGACAGGGCAGGCTGAAGCTTTCTTT	CASSGRTGQAEAFF	TRBV6-1	TRBJ1-1
TGTGCCTGGAGAAGTCCCCGGGACAACCCTACTAATGAAAAACTGTTTTTT	CAWRSPRDNPTNEKLFF	TRBV30	TRBJ1-4
TGCGCCAGCAGCTTGGCACAGGGCCACACTGAAGCTTTCTTT	CASSLAQGHTEAFF	TRBV5-1	TRBJ1-1
TGTGTGGGCCAGGTAGATACGCAGTATTTT	CVGQVDTQYF	TRBV7-9	TRBJ2-3
TGTGCTAGTGGTTTGAGGGGTACTAACTATGGCTACACCTTC	CASGLRGTNYGYTF	TRBV12-5	TRBJ1-2
TGTGCCAGCAGTGAATCACGGAAATATGAGCAGTTCTTC	CASSESRKYEQFF	TRBV25-1	TRBJ2-1
TGTGCCAGCAGCTACCCCGAACGGGGGGGGCTCCGTCACCCTGGGAGACCTGGGGCCAACGTCCTGACTTTC	CASSYPERGGLRHPGRPGANVLTF	TRBV7-3	TRBJ2-6
TGTGCCAGCAGTGAAGTGAACCAAGTCAGGGTGGTTAATTCACCCCTCCACTTT	CASSEVNQVRVVNSPLHF	TRBV2	TRBJ1-6
TGCGCCAGCAGCCGGGGGGGGTTTACCAGTGTGACTAATGAAAAACTGTTTTTT	CASSRGGFTSVTNEKLFF	TRBV4-1	TRBJ1-4
TGTGCCAGCAGTGCTGGGGACAGCTACGAGCAGTACTTC	CASSAGDSYEQYF	TRBV27	TRBJ2-7
TGCGCCAGCAGCTTACCTCGGTGGGGAATGACCGAGCAGTACTTC	CASSLPRWGMTEQYF	TRBV5-1	TRBJ2-7
TGTGCCAGCAGCCCTCGGGTCTATTCATACTCCTACGAGCAGTACTTC	CASSPRVYSYSYEQYF	TRBV7-3	TRBJ2-7
TGTGCCAGCAGCGCCCGTTTGAACACCGGGGAGCTGTTTTTT	CASSARLNTGELFF	TRBV5-5	TRBJ2-2
TGTGCCAGCAGTGATACCAAACTAGCGGATCTCTACGAGCAGTACTTC	CASSDTKLADLYEQYF	TRBV25-1	TRBJ2-7
TGCGCCAGCAGCTTGGGGGGGGAGTACGAGCAGTACTTC	CASSLGGEYEQYF	TRBV5-1	TRBJ2-7
TGTGCCAGCAGTGAAATAGCGGGCTGGGCTAGCACAGATACGCAGTATTTT	CASSEIAGWASTDTQYF	TRBV2	TRBJ2-3
TGTGCCAGCAGCGGGGTATTGGTGGCGAGGATCCTAGAGACCCAGTACTTC	CASSGVLVARILETQYF	TRBV5-6	TRBJ2-5
TGTGCCAGCAGTGAAGTCAGGGGTTCTTATAGCAATCAGCCCCAGCATTTT	CASSEVRGSYSNQPQHF	TRBV2	TRBJ1-5
TGTGCCATCAGTGGGCCGGGACAGGGGGAAGGGAGCTCCTACGAGCAGTACTTC	CAISGPGQGEGSSYEQYF	TRBV10-3	TRBJ2-7
TGTGCCAGCATACGGGGTCGCCGAGCCGATGGCTACACCTTC	CASIRGRRADGYTF	TRBV6-5	TRBJ1-2
TGTGCCACCAGTGATAAAAGACAGGGATCACCCCTCCACTTT	CATSDKRQGSPLHF	TRBV24-1	TRBJ1-6
TGTGCCAGCATGGCCCCGGGAGGAAACTACGAGCAGTACTTC	CASMAPGGNYEQYF	TRBV6-4	TRBJ2-7
TGCGCCAGCAGCTTGGCCCGACAGGGGGTAGTCACTGAAGCTTTCTTT	CASSLARQGVVTEAFF	TRBV5-1	TRBJ1-1
TGTGCCAGCAGCCAAGCGGTACGGGGCACGTGGACCCAGTACTTC	CASSQAVRGTWTQYF	TRBV4-2	TRBJ2-5
TGTGCCAGACGACATAATGACCAGTACGAGCAGTACTTC	CARRHNDQYEQYF	TRBV6-1	TRBJ2-7
TGTGCCAGCAGCCAAGCCACGATTAATCAGCCCCAGCATTTT	CASSQATINQPQHF	TRBV4-2	TRBJ1-5
TGTGCCAGCAGCTTGCACCTTGCTAGTGCTGAGACCCAGTACTTC	CASSLHLASAETQYF	TRBV5-8	TRBJ2-5
TGTGCCATCAGTGAGGGTCCGGTATCGTATGAAAAACTGTTTTTT	CAISEGPVSYEKLFF	TRBV10-3	TRBJ1-4
TGTGCCTGGAGAGACGGACTCTACGAGCAGTACTTC	CAWRDGLYEQYF	TRBV30	TRBJ2-7
TGTGCCAGCAGCCAAGATGGACAGGAGAATGAGCAGTTCTTC	CASSQDGQENEQFF	TRBV4-2	TRBJ2-1
TGTGCCAGCAGCTTGCTAGGGGGGGAGCAGTACTTC	CASSLLGGEQYF	TRBV5-6	TRBJ2-7
TGTGCCAGCAGCGTTGGTACTAGCGGAGAGGGAGAGACCCAGTACTTC	CASSVGTSGEGETQYF	TRBV9	TRBJ2-5
TGCAGACCTAGCAAGCTCTTC	CRPSKLF	TRBV20-1	TRBJ2-1
TGTGCCAGCACCCGGACAGGGGTTTCCCTCCACTTT	CASTRTGVSLHF	TRBV7-9	TRBJ1-6
TGTGCCAGCAGTAACAGGGGGAGATCCTATAATTCACCCCTCCACTTT	CASSNRGRSYNSPLHF	TRBV7-2	TRBJ1-6
TGTGCCAGCAGGGTGGGACCGCAGGACTACGAGCAGTACTTC	CASRVGPQDYEQYF	TRBV28	TRBJ2-7
TGTGCCAGCAGCTTAGATCGACCGAGGACAGGGTACCAAGAGACCCAGTACTTC	CASSLDRPRTGYQETQYF	TRBV11-3	TRBJ2-5
TGTGCCTGGCTTCATACCAGGGGGCCCAGCAATCAGCCCCAGCATTTT	CAWLHTRGPSNQPQHF	TRBV30	TRBJ1-5
TGTGCCAGCAGCTTGGTGACAGGGGGCGCAAAACTGTTTTTT	CASSLVTGGAKLFF	TRBV7-9	TRBJ1-4
TGTGCCAGCTCCGACCGGACTAGCGGGATGCTATCAGATACGCAGTATTTT	CASSDRTSGMLSDTQYF	TRBV6-4	TRBJ2-3
TGTGCCATCAGCAATTACCACTGGGAGCGGATAAGGCCACTGGAGGGGGAGACCCAGTACTTC	CAISNYHWERIRPLEGETQYF	TRBV10-3	TRBJ2-5
TGCGCCAGCAGCCAACGGGGGGGTCCTAACACCGGGGAGCTGTTTTTT	CASSQRGGPNTGELFF	TRBV5-1	TRBJ2-2
TGCAGTGCTCGGGGGAATGAAAAACTGTTTTTT	CSARGNEKLFF	TRBV20-1	TRBJ1-4
TGCAGTGCTACCCCCATTCAGGGGGTAGGCCAAGAGACCCAGTACTTC	CSATPIQGVGQETQYF	TRBV20-1	TRBJ2-5
TGTGCCAGCAGCGTCCAGGCCCACTCTAGCGGGCTCTACGAGCAGTACTTC	CASSVQAHSSGLYEQYF	TRBV3-1	TRBJ2-7
TGTGCCACCAGCACAGGATCGAAGAACTATGGCTACACCTTC	CATSTGSKNYGYTF	TRBV15	TRBJ1-2
TGTGCCAGCAGTAACCACAGGGGATCCCATCGATCTAGTCGACGGCAAACTGGAAACACCATATATTTT	CASSNHRGSHRSSRRQTGNTIYF	TRBV27	TRBJ1-3
TGCAGTGCTCGAACCATGGGGCGTTATAGCAATCAGCCCCAGCATTTT	CSARTMGRYSNQPQHF	TRBV20-1	TRBJ1-5
TGTGCTAGTGGTTTGGATACAGGGAGGAGTATGAACACTGAAGCTTTCTTT	CASGLDTGRSMNTEAFF	TRBV12-5	TRBJ1-1
TGTGCCAGCAGCCCCCCTAGCGGGGGGTTCCTTAACACAGATACGCAGTATTTT	CASSPPSGGFLNTDTQYF	TRBV9	TRBJ2-3
TGTGCCAGCAGTAAACCCCCAGGGGCTAAGGGAAACAATCAGCCCCAGCATTTT	CASSKPPGAKGNNQPQHF	TRBV27	TRBJ1-5
TGTGCCAGCAGTTACACAGGCTTGTATGGCTACACCTTC	CASSYTGLYGYTF	TRBV6-5	TRBJ1-2
TGTGCCAGCAGCCCAGGGGGCATGAACACTGAAGCTTTCTTT	CASSPGGMNTEAFF	TRBV11-3	TRBJ1-1
TGTGCCAGCAGGGGACTAGCGGGGGGGCCCAAAAGAGATACGCAGTATTTT	CASRGLAGGPKRDTQYF	TRBV6-1	TRBJ2-3
TGTGCCAGCAGTGAGACAGACAATGAAGCTTTCTTT	CASSETDNEAFF	TRBV2	TRBJ1-1
TGTGCCAGCAGTTTAACTCTACAGGGCGAGGGGCGGGGAGCAGATACGCAGTATTTT	CASSLTLQGEGRGADTQYF	TRBV12-4	TRBJ2-3
TGCAGTGCGGGGGGGACAGAGGGGAACACCGGGGAGCTGTTTTTT	CSAGGTEGNTGELFF	TRBV20-1	TRBJ2-2
TGTGCCACCAGTGAGCGCGGCGGACGAGGAGTACTATTGGGAAAACCGTATGGCTACACCTTC	CATSERGGRGVLLGKPYGYTF	TRBV24-1	TRBJ1-2
TGTGCCAGCAGTGAGGGGGCCTACGAGCAGTACTTC	CASSEGAYEQYF	TRBV6-1	TRBJ2-7
TGTGCCAGCAGTCGGGAAGTAACAGGGCCCCTTTCCTACAATGAGCAGTTCTTC	CASSREVTGPLSYNEQFF	TRBV28	TRBJ2-1
TGTGCCAGCAGTTACCCGGGACAGACAGACTATGGCTACACCTTC	CASSYPGQTDYGYTF	TRBV12-3	TRBJ1-2
TGTGCCATCAGGCTACTCTCTCCTACCCAAGAGACCCAGTACTTC	CAIRLLSPTQETQYF	TRBV10-3	TRBJ2-5
TGTGCCAGAGACACCGTAAACACTGAAGCTTTCTTT	CARDTVNTEAFF	TRBV6-1	TRBJ1-1
TGTGCCAGCAGCCCCGTCAAGGGGACAGCTGGGAACACTGAAGCTTTCTTT	CASSPVKGTAGNTEAFF	TRBV7-4	TRBJ1-1
TGTGCCAGCAGCGCGATGCGCGGTCAGGACTTCATCATTCAGTACTTC	CASSAMRGQDFIIQYF	TRBV7-3	TRBJ2-4
TGTGCCAGCAGTGCCTGGGGCCTACCAGATACGCAGTATTTT	CASSAWGLPDTQYF	TRBV2	TRBJ2-3
TGCGGAGGGGCCCCCCGGGGGGCGGAATGGGGGCAAGAGACCCAGTACTTC	CGGAPRGAEWGQETQYF	TRBV10-1	TRBJ2-5
TGTGCCAGCAGTTTCGTCCCAAGTACTAACTATGGCTACACCTTC	CASSFVPSTNYGYTF	TRBV12-3	TRBJ1-2
TGTGCCAGCTCACGATCGGGGCCTTTGTATGGCTACACCTTC	CASSRSGPLYGYTF	TRBV18	TRBJ1-2
TGTGCCACCACCCTTCCGGGACAGGGAAATGAACATGAGCAGTTCTTC	CATTLPGQGNEHEQFF	TRBV24-1	TRBJ2-1
TGCGCCAGCAGCCAACACCCCCAAAGCAGGGACATTAGTAATTCACCCCTCCACTTT	CASSQHPQSRDISNSPLHF	TRBV4-3	TRBJ1-6
TGTGCCAGCAGTTTCGCGGTGGAGGGAGGGTACGAGCAGTACTTC	CASSFAVEGGYEQYF	TRBV12-4	TRBJ2-7
TGTGCCAGCAGCTGTTGTGGACAGCCCTACGAGCAGTACTTC	CASSCCGQPYEQYF	TRBV7-3	TRBJ2-7
TGTGCCAGCAGCCAGGGGCCCCGGGGTGTCTACCTGGACGAGCAGTACTTC	CASSQGPRGVYLDEQYF	TRBV13	TRBJ2-7
TGCAGTGCTAGTTCACAGGGGCCGAACACCGGGGAGCTGTTTTTT	CSASSQGPNTGELFF	TRBV20-1	TRBJ2-2
TGTGCCGGCGCCGCGGGAGACGGGAGCACAGATACGCAGTATTTT	CAGAAGDGSTDTQYF	TRBV30	TRBJ2-3
TGTGCCAGCAGCACACGGGACAGGGGGTCTCATCAGCCCCAGCATTTT	CASSTRDRGSHQPQHF	TRBV7-3	TRBJ1-5
TGTGCCAGCAGCTTATGGAGGGCAGGGGGCTCAGATACGCAGTATTTT	CASSLWRAGGSDTQYF	TRBV7-9	TRBJ2-3
TGTGCCAGCAGTGCCACTGGGGACACTGAGGGTTTTAGGCAGCCCCAGCATTTT	CASSATGDTEGFRQPQHF	TRBV6-3	TRBJ1-5
TGCAGTGCTAGAGATCGATGGACAGGGGGGGGCTACACCTTC	CSARDRWTGGGYTF	TRBV20-1	TRBJ1-2
TGCAGTGCTAGGACGGGTTATAGCTCCTACGAGCAGTACTTC	CSARTGYSSYEQYF	TRBV20-1	TRBJ2-7
TGCGCCAGCAGCGCTCCGGGACTAGCGGACCAAGAGACCCAGTACTTC	CASSAPGLADQETQYF	TRBV5-1	TRBJ2-5
TGTGCCAGCATAAACGGAAGGAATCAGCCCCAGCATTTT	CASINGRNQPQHF	TRBV6-4	TRBJ1-5
TGTGCCAGCAGCTTGGGACAGACTGAAGCTTTCTTT	CASSLGQTEAFF	TRBV5-6	TRBJ1-1
TGTGCCAGCAGTGACTCCCTCCCGACCCCTCACGAGCAGTACTTC	CASSDSLPTPHEQYF	TRBV6-4	TRBJ2-7
TGTGCCATCAGTGAAAGGGACGCAGGGTATAGCAATCAGCCCCAGCATTTT	CAISERDAGYSNQPQHF	TRBV10-3	TRBJ1-5
TGTGCCAGCAGCTTATGGCCTGAAGCTTTCTTT	CASSLWPEAFF	TRBV7-3	TRBJ1-1
TGCGCCAGCAGCCAAGGCCAGGGCTACACCTTC	CASSQGQGYTF	TRBV4-1	TRBJ1-2
TGTGCCAGTAGTATGGGAAGGGGACCTTCCACAGATACGCAGTATTTT	CASSMGRGPSTDTQYF	TRBV19	TRBJ2-3
TGCAGCGATGAACGAACCCGTTCCTCGAGAGTCCGGACAGACGCCTACGAGCAGTACTTC	CSDERTRSSRVRTDAYEQYF	TRBV29-1	TRBJ2-7
TGTGCCAGCAGGGGACATCGCACCTTC	CASRGHRTF	TRBV7-9	TRBJ1-2
TGTGCCAGCAGTTACCAAAATCACCGGTTGGTGCCCAGGGTTGTCACTGAAGCTTTCTTT	CASSYQNHRLVPRVVTEAFF	TRBV6-5	TRBJ1-1
TGTGCCAGCAGTTATTTTAGGGGCCCAGGAAACGAGCAGTACTTC	CASSYFRGPGNEQYF	TRBV6-2	TRBJ2-7
TGTGCCAGCAGCGGCCATGCGTCCTACGAGCAGTACTTC	CASSGHASYEQYF	TRBV5-6	TRBJ2-7
TGTGAGCACAGGGGAATTTGCAATCAGCCCCAGCATTTT	CEHRGICNQPQHF	TRBV7-9	TRBJ1-5
TGCGCCAGCGGGGGGGGGTTCTACACCTTC	CASGGGFYTF	TRBV10-1	TRBJ1-2
TGTGCCAGCAGCCTGGGTTCACGGGGGGTGGGGCAAGAGACCCAGTACTTC	CASSLGSRGVGQETQYF	TRBV7-7	TRBJ2-5
TGTGCCTGGAGTGTACGTGTGGACAGGTGGGGGAGATACGAGCAGTACTTC	CAWSVRVDRWGRYEQYF	TRBV30	TRBJ2-7
TGTGCCACGCGGCGGCTTGGGAGGAACGAGCAGTACTTC	CATRRLGRNEQYF	TRBV24-1	TRBJ2-7
TGCGCCAGCAGTGATCCCGTTCCGAAGAACAGGGGGGCCTACGAGCAGTACTTC	CASSDPVPKNRGAYEQYF	TRBV10-2	TRBJ2-7
TGCAGTGCTAGTCTGGGGACAGGGTCCCCTCAGCCCCAGCATTTT	CSASLGTGSPQPQHF	TRBV20-1	TRBJ1-5
TGTGCCAGTAGTAAGATGACATACCACACCGGGGAGCTGTTTTTT	CASSKMTYHTGELFF	TRBV19	TRBJ2-2
TGTGCCAGCAGCCACCCCGAGGGAGGTAGTCGAACTGAAGCTTTCTTT	CASSHPEGGSRTEAFF	TRBV9	TRBJ1-1
TGTGCTAGCAGCTTGCCTCACTGGGCAGATACGCAGTATTTT	CASSLPHWADTQYF	TRBV7-7	TRBJ2-3
TGTGCCAGGACTGCCAAAAACATTCAGTACTTC	CARTAKNIQYF	TRBV7-3	TRBJ2-4
TGTGCCAGCAGTTACTCCGGCGTCCCTAGCAATCAGCCCCAGCATTTT	CASSYSGVPSNQPQHF	TRBV6-5	TRBJ1-5
TGTGCCAGCAGCCCCCGGGGGGTGCGGACTAAACTGTTTTTT	CASSPRGVRTKLFF	TRBV13	TRBJ1-4
TGTGCCAGCAGCTTGAAACCGGACAGGGGGCGGGAATACACTGAAGCTTTCTTT	CASSLKPDRGREYTEAFF	TRBV5-4	TRBJ1-1
TGCGCCAGCAGCCTTCCGGGGAACTGGGCGGCCCAAGCTTTCTTT	CASSLPGNWAAQAFF	TRBV5-1	TRBJ1-1
TGTGCCAGCAGGAATGCGACGGACAGGGGAAAGGGTGAAGCTTTCTTT	CASRNATDRGKGEAFF	TRBV6-8	TRBJ1-1
TGTGCCAGCACTCCCCCCTCGCGCAGATTGAACACTGAAGCTTTCTTT	CASTPPSRRLNTEAFF	TRBV27	TRBJ1-1
TGTGCCAGTCGTTCATGGGGAACGAAACTTAATTCACCCCTCCACTTT	CASRSWGTKLNSPLHF	TRBV25-1	TRBJ1-6
TGTGCCAGCAGGGAAGAGAAATCCCGGGACAGGGGCTGGGATGGCTACACCTTC	CASREEKSRDRGWDGYTF	TRBV12-4	TRBJ1-2
TGTGCCAGCGGGGAGGCCACCATATATTTT	CASGEATIYF	TRBV5-4	TRBJ1-3
TGCGCCAGCAGCCCACCAGGGAGCGATACGCAGTATTTT	CASSPPGSDTQYF	TRBV5-1	TRBJ2-3
TGTGCCAGCAGCAAGCGACAGGGCACAGATACGCAGTATTTT	CASSKRQGTDTQYF	TRBV5-6	TRBJ2-3
TGCAGTGCTCGGACGTTAGGAAACTATGGCTACACCTTC	CSARTLGNYGYTF	TRBV20-1	TRBJ1-2
TGTGCCTGGACATCAGGGTTTACAAACATTCAGTACTTC	CAWTSGFTNIQYF	TRBV30	TRBJ2-4
TGTGCCAGCAGCCATCAGACTGAATTAGAGAATGAGCAGTTCTTC	CASSHQTELENEQFF	TRBV7-9	TRBJ2-1
TGTGCCAGCAGCCAGGACAGGACAACTCTCTACGAGCAGTACTTC	CASSQDRTTLYEQYF	TRBV7-7	TRBJ2-7
TGTGCCAGCAGTTGCCCGGGGTCACAGAAGGTTGGCTACACCTTC	CASSCPGSQKVGYTF	TRBV28	TRBJ1-2
TGTGCCAATCCGGGACAGGGGACTGGCTACACCTTC	CANPGQGTGYTF	TRBV2	TRBJ1-2
TGTGCCAGCAGTTCCACCGGGACTAGAGATACGCAGTATTTT	CASSSTGTRDTQYF	TRBV27	TRBJ2-3
TGTGCCAGCAGCTTACCGGGGACAGGGGAGAGTAGCAATCAGCCCCAGCATTTT	CASSLPGTGESSNQPQHF	TRBV7-3	TRBJ1-5
TGTGCCAGCAGGTGGGGACAGGGACTTAACACTGAAGCTTTCTTT	CASRWGQGLNTEAFF	TRBV27	TRBJ1-1
TGTGCCAGCAGCACTACCTGGGACAGGGGACTCCCTGACGGCTACACCTTC	CASSTTWDRGLPDGYTF	TRBV13	TRBJ1-2
TGCAGCGTGACGCTAGGACAGATCTCTGGAAACACCATATATTTT	CSVTLGQISGNTIYF	TRBV29-1	TRBJ1-3
TGTGCCACACGACTAGAACTTAATACGCAGTATTTT	CATRLELNTQYF	TRBV15	TRBJ2-3
TGCGCCAGCAGCCTCAGGGTGGAAAAACTGTTTTTT	CASSLRVEKLFF	TRBV4-1	TRBJ1-4
TGTGCCAGCAGTTACTCGTCGACTCCACCCCCCCAGAACACTGAAGCTTTCTTT	CASSYSSTPPPQNTEAFF	TRBV6-5	TRBJ1-1
TGCAGCGTTGAAAGCCCGGGACAGGGTCCCCGAGGTAATTCACCCCTCCACTTT	CSVESPGQGPRGNSPLHF	TRBV29-1	TRBJ1-6
TGTGCCAGCAGTTATCAGGACGAGCAGTACTTC	CASSYQDEQYF	TRBV2	TRBJ2-7
TGTGCCAGCAGGCCAGCTTTCTTT	CASRPAFF	TRBV6-1	TRBJ1-1
TGTGCCAGCACGAGTGACCTCCACGGGGAGGGGAAAGAGACCCAGTACTTC	CASTSDLHGEGKETQYF	TRBV6-5	TRBJ2-5
TGTGCCAGCAGCCCCGATCCAAAAACAGGGGGAGAGCAGTTCTTC	CASSPDPKTGGEQFF	TRBV13	TRBJ2-1
TGTGCCAGCAGTTCCAGAACAGGGACCCATCCGGACACTGAAGCTTTCTTT	CASSSRTGTHPDTEAFF	TRBV12-4	TRBJ1-1
TGTGCTAGTGGTTTGGGCCTAGCGGGAATAGGAACAGTCTCTGGGGCCAACGTCCTGACTTTC	CASGLGLAGIGTVSGANVLTF	TRBV12-5	TRBJ2-6
TGTGCCAGCAGATCCCCACAGGGCATGAACACTGAAGCTTTCTTT	CASRSPQGMNTEAFF	TRBV6-4	TRBJ1-1
TGCGCCAGCAGCCAAGAGGCTAGCGGTACCCCCCCCAATGAGCAGTTCTTC	CASSQEASGTPPNEQFF	TRBV4-1	TRBJ2-1
TGTGCCAGCAGCCAAGTATGGACGGGTTCACCCCTCCACTTT	CASSQVWTGSPLHF	TRBV14	TRBJ1-6
TGTGCCAGCAGTTACCTGGGACTAGCGGCCGGCTATAATGAGCAGTTCTTC	CASSYLGLAAGYNEQFF	TRBV6-2	TRBJ2-1
TGTGCCAGCAGCACCCGAAATAACCCCTTGGGGACAGGGTATAACTATGGCTACACCTTC	CASSTRNNPLGTGYNYGYTF	TRBV7-3	TRBJ1-2
TGCGCCAGCAGCGTCAGTTCCATGGGGTCCTTC	CASSVSSMGSF	TRBV5-1	TRBJ1-2
TGCGCCAGCAGTCGAACAGGGCCGAACACTGAAGCTTTCTTT	CASSRTGPNTEAFF	TRBV10-1	TRBJ1-1
TGTGCCATCAGTGAGACTTGGCGGGGGAATCAGCCCCAGCATTTT	CAISETWRGNQPQHF	TRBV10-3	TRBJ1-5
TGCGCCAGCAGTGAGCCTATCTACCGCCGGTTCTACGAGCAGTACTTC	CASSEPIYRRFYEQYF	TRBV10-1	TRBJ2-7
TGTGCCAGCGGCGAAGCTTTCTACTATGGCTACACCTTC	CASGEAFYYGYTF	TRBV11-3	TRBJ1-2
TGCATGCTGGACGAAAAAAACATTCAGTACTTC	CMLDEKNIQYF	TRBV20-1	TRBJ2-4
TGCGCCAGCAGCCGGAGTTTAGACAGGGTAATAAACACTGAAGCTTTCTTT	CASSRSLDRVINTEAFF	TRBV5-1	TRBJ1-1
TGTGCCACCAGTCGGGGGACAGGGGGGGCTAACGAGCAGTACTTC	CATSRGTGGANEQYF	TRBV24-1	TRBJ2-7
TGTGCCAGCAGCTTATTAATCCGGGACCGTGGCAGCGAGCAGTTCTTC	CASSLLIRDRGSEQFF	TRBV5-4	TRBJ2-1
TGTGCCAGCAGTGAAGCGACTCCCGACAGGGGGGGGGAAGGGGCCTACGAGCAGTACTTC	CASSEATPDRGGEGAYEQYF	TRBV2	TRBJ2-7
TGTGCCAGTAGTCCTTACGGAGCAAGGACTAGGGGGATGTTGGTTAAAAACACTGAAGCTTTCTTT	CASSPYGARTRGMLVKNTEAFF	TRBV19	TRBJ1-1
TGTGCCAGCAGCCAATACCCAGGACAGGGGGAAGGCTACACCTTC	CASSQYPGQGEGYTF	TRBV14	TRBJ1-2
TGTGCCAGCAGCTTGTTCTCCTACAATGAGCAGTTCTTC	CASSLFSYNEQFF	TRBV5-6	TRBJ2-1
TGCAGCCCTAGATCACGGGACAGGGCAGGCTACGAGCAGTACTTC	CSPRSRDRAGYEQYF	TRBV29-1	TRBJ2-7
TGTGCCATCAGTGCTCGGGACCCGAACACTGAAGCTTTCTTT	CAISARDPNTEAFF	TRBV10-3	TRBJ1-1
TGTGCCACCAGTCACGGGACAGAGGGGCGCTATGGCTACACCTTC	CATSHGTEGRYGYTF	TRBV24-1	TRBJ1-2
TGTGCCAGCAGCAGGTCGTCAGGGCTTCCCGAGCAGTACTTC	CASSRSSGLPEQYF	TRBV5-6	TRBJ2-7
TGTGCCAGCAGTTACAGAGCAGGGTGGCAAAGTCGGGCTGGAAACACCATATATTTT	CASSYRAGWQSRAGNTIYF	TRBV6-5	TRBJ1-3
TGTGCCTGGAGTCCTGGACTAGAGGTCTCCTACAATGAGCAGTTCTTC	CAWSPGLEVSYNEQFF	TRBV30	TRBJ2-1
TGTGCCAGCAGCGCCATGCACACCGGGGAGCTGTTTTTT	CASSAMHTGELFF	TRBV7-3	TRBJ2-2
TGCAGTGCTAGAGCTTGGGGTAGGGTGGGGAGTGCAACTAATGAAAAACTGTTTTTT	CSARAWGRVGSATNEKLFF	TRBV20-1	TRBJ1-4
TGTGCCAGCAGCAAGGACGAGACCCAGTACTTC	CASSKDETQYF	TRBV9	TRBJ2-5
TGTGCCAGCAGCGAGGTTCTTAAGGAAGCTTTCTTT	CASSEVLKEAFF	TRBV12-3	TRBJ1-1
TGTGCCAGCAGCTGGAAGGGTAGGGTCTATGGCTACACCTTC	CASSWKGRVYGYTF	TRBV5-5	TRBJ1-2
TGTGCCAGCAGCTCGGAACAGGGGGGGGGCAATCAGCCCCAGCATTTT	CASSSEQGGGNQPQHF	TRBV7-7	TRBJ1-5
TGCGCCAGCAGCCAAGATCACTTATTAACAGGGAGCAATCAGCCCCAGCATTTT	CASSQDHLLTGSNQPQHF	TRBV4-1	TRBJ1-5
TGCAGTGCTAGAGTAAACCCGAGACAGGGATTCAATCAGCCCCAGCATTTT	CSARVNPRQGFNQPQHF	TRBV20-1	TRBJ1-5
TGTGCCAGCAGCCTAAATGCCCCCCGGGACAGGTATAGCAATCAGCCCCAGCATTTT	CASSLNAPRDRYSNQPQHF	TRBV7-2	TRBJ1-5
TGTGCCAGCAGTCGGGCTTCCTCGATAGAAGCTTTCTTT	CASSRASSIEAFF	TRBV28	TRBJ1-1
TGTGCCAGCAGCCAAGATCGTTTAACTAACGGAATATCCTACGAGCAGTACTTC	CASSQDRLTNGISYEQYF	TRBV3-1	TRBJ2-7
TGTGCCTGGAGTATTATTAGGGGGGCAGATTCACCCCTCCACTTT	CAWSIIRGADSPLHF	TRBV30	TRBJ1-6
TGTGCCAGCAGCGCAGGGGGCGACTACGAGCAGTACTTC	CASSAGGDYEQYF	TRBV11-2	TRBJ2-7
TGCGCCAGCAGCCTAGCGAGGGTCTACGAGCAGTACTTC	CASSLARVYEQYF	TRBV5-1	TRBJ2-7
TGTGCCAGCAGTGGCGGGAGGCCCTCTGACTATGGCTACACCTTC	CASSGGRPSDYGYTF	TRBV6-1	TRBJ1-2
TGTGCCAGAATCAGGGTAATATACTACGAGCAGTACTTC	CARIRVIYYEQYF	TRBV19	TRBJ2-7
TGTGCCAGCAGCTGGACACACAGGGGGCGTAGGACTGAAGCTTTCTTT	CASSWTHRGRRTEAFF	TRBV5-6	TRBJ1-1
TGCGCCAGCAGCTTGGCCCTCAGGATGAGCTCCTATAATTCACCCCTCCACTTT	CASSLALRMSSYNSPLHF	TRBV5-1	TRBJ1-6
TGTGCCAGCAGTCTTTGGTCCGGACAGGGTTTACGGAGCACTGAAGCTTTCTTT	CASSLWSGQGLRSTEAFF	TRBV12-3	TRBJ1-1
TGCATCGTCAAAATTAGACAGCTGGCAACTAATGAAAAACTGTTTTTT	CIVKIRQLATNEKLFF	TRBV20-1	TRBJ1-4
TGTGCCAGCATGAGGGGGAGACAGCCCCAGCATTTT	CASMRGRQPQHF	TRBV2	TRBJ1-5
TGTGCCAGCAAATCTCGTAGTGTTGGGGCTGGATTCTCCCTCCGCTACGAGCAGTACTTC	CASKSRSVGAGFSLRYEQYF	TRBV12-3	TRBJ2-7
TGTGCCACCAGCAGGGGACCCCGACAGGGGGTAAATTCACCCCTCCACTTT	CATSRGPRQGVNSPLHF	TRBV15	TRBJ1-6
TGTGCCAGCAGCCAAGATCTAGGAATATTTGAGACCCAGTACTTC	CASSQDLGIFETQYF	TRBV3-1	TRBJ2-5
TGTGCCAGCAGCACCTCATCTAGCCCGCCAGCTAACTATGGCTACACCTTC	CASSTSSSPPANYGYTF	TRBV13	TRBJ1-2
TGTGCCTGGCCGGGATCGGTCTCTGGAAACACCATATATTTT	CAWPGSVSGNTIYF	TRBV30	TRBJ1-3
TGTGCCAGGGGTGTGACTAGTGCCGAGTCAGATACGCAGTATTTT	CARGVTSAESDTQYF	TRBV11-2	TRBJ2-3
TGCGCCAGCAGCAGCCAAGCTACGGACACAGATACGCAGTATTTT	CASSSQATDTDTQYF	TRBV5-1	TRBJ2-3
TGTGCCAGCAGCCAAGGCCCCGATGGGGCAAGCAATCAGCCCCAGCATTTT	CASSQGPDGASNQPQHF	TRBV3-1	TRBJ1-5
TGTGCCAGCAGCGGTTGGGGGGAGCTAGCCAAAAACATTCAGTACTTC	CASSGWGELAKNIQYF	TRBV7-3	TRBJ2-4
TGTGCCAGTAGTATAGATGGCCGGGGGCGCCTTGAGCAGTACTTC	CASSIDGRGRLEQYF	TRBV19	TRBJ2-7
TGTGCCTGGACAGTGCCGGGACAATCCGAGCAGTACTTC	CAWTVPGQSEQYF	TRBV30	TRBJ2-7
TGTGCCAGCAGTGGAAAACAAATCCCTTGGACGTGCAATCAGCCCCAGCATTTT	CASSGKQIPWTCNQPQHF	TRBV6-1	TRBJ1-5
TGTGCCAGCAGCACAGGGGAGCAGCCCCAGCATTTT	CASSTGEQPQHF	TRBV7-3	TRBJ1-5
TGTGCCAGCAAGGGGACTTCACGGGAGCAGTACTTC	CASKGTSREQYF	TRBV2	TRBJ2-7
TGTGCCATCAGTGCCCGTTACAGGGCTGGCACAGATACGCAGTATTTT	CAISARYRAGTDTQYF	TRBV10-3	TRBJ2-3
TGTGCCAGCAGCCAAGATGAAACAGCTGACTACGAGCAGTACTTC	CASSQDETADYEQYF	TRBV3-1	TRBJ2-7
TGTGCCATGCGTAGACAGAGACTGTTTTTT	CAMRRQRLFF	TRBV6-4	TRBJ1-4
TGTGCCACCAGTGATTTGCCCCCCGTCGGGACTAGCTGGACAGATACGCAGTATTTT	CATSDLPPVGTSWTDTQYF	TRBV24-1	TRBJ2-3
TGTGCCAGCAGTGAAATCTTTCTGGGACAGGTAGGGGAATGGGAAAGGACCTACGAGCAGTACTTC	CASSEIFLGQVGEWERTYEQYF	TRBV2	TRBJ2-7
TGTGCCAGCAGTTGCTTCACTCTAGCGGGGGGGGAGACCCAGTACTTC	CASSCFTLAGGETQYF	TRBV28	TRBJ2-5
TGTGCCAGAAAGATGGGACTAGCAATTGGTGGGGAGACCCAGTACTTC	CARKMGLAIGGETQYF	TRBV19	TRBJ2-5
TGTGCCAGGAGACCCCCCTCTGGTCTATACAATGAGCAGTTCTTC	CARRPPSGLYNEQFF	TRBV19	TRBJ2-1
TGTGCCAGCAGCTTAGCCCCGGGACAGGGGACCGACTGGGTTGCCAATCAGCCCCAGCATTTT	CASSLAPGQGTDWVANQPQHF	TRBV7-6	TRBJ1-5
TGTGCTAGTGGTGACCAAAGGGACATTCAGTACTTC	CASGDQRDIQYF	TRBV12-5	TRBJ2-4
TGTGCCAGCAGAACGCATGGCTACACCTTC	CASRTHGYTF	TRBV28	TRBJ1-2
TGTGCCAGCAGTTACGGCCTACTAGACAGGGGGGCCTATGGCTACACCTTC	CASSYGLLDRGAYGYTF	TRBV6-5	TRBJ1-2
TGTGCCAGCAGCTTACGGAGTCAGCCCCAGCATTTT	CASSLRSQPQHF	TRBV7-6	TRBJ1-5
TGTGCCAGCCTAGCATGCCGGGACTCAGATACGCAGTATTTT	CASLACRDSDTQYF	TRBV5-6	TRBJ2-3
TGTGCCAGCAGCCTCCCGGCCGGGACAGGGAGCTCCTACGAGCAGTACTTC	CASSLPAGTGSSYEQYF	TRBV7-4	TRBJ2-7
TGTGCCAGCTCATCCGACTCCGGGGACCATGATTACGAGCAGTACTTC	CASSSDSGDHDYEQYF	TRBV4-2	TRBJ2-7
TGCGCCAGCAGCTCCTTGACAGGGGCTAACTATGGCTACACCTTC	CASSSLTGANYGYTF	TRBV5-1	TRBJ1-2
TGTGCCAGCAGCCAGCCAGCGCGTGAAAAACTGTTTTTT	CASSQPAREKLFF	TRBV4-2	TRBJ1-4
TGCGCCAGCAACCTAACGGAAAGGCACTATGGCTACACCTTC	CASNLTERHYGYTF	TRBV10-1	TRBJ1-2
TGTGCCAGCAGCTTACAGTCACTATATGAGCAGTTCTTC	CASSLQSLYEQFF	TRBV7-9	TRBJ2-1
TGTGCCAGCAGCACAGGGCAGAACACTGAAGCTTTCTTT	CASSTGQNTEAFF	TRBV13	TRBJ1-1
TGTGCCAGCAGTGAATCCGCCGGAGAGTCTATGGACAAAAACATTCAGTACTTC	CASSESAGESMDKNIQYF	TRBV25-1	TRBJ2-4
TGCGCCAGCAGCCAAGAGAAGGACAGGGTTTTCATGAACACTGAAGCTTTCTTT	CASSQEKDRVFMNTEAFF	TRBV4-1	TRBJ1-1
TGCGCCAGCAGTCTAGCGGGGGGACCCGAGCAGTACTTC	CASSLAGGPEQYF	TRBV10-1	TRBJ2-7
TGTGCCAGCAGCTTAGACAGGGTAGCTAACTATGGCTACACCTTC	CASSLDRVANYGYTF	TRBV13	TRBJ1-2
TGTGCCAGCAGCTTTTCCGATAGTCAGGCCTACGAGCAGTACTTC	CASSFSDSQAYEQYF	TRBV5-4	TRBJ2-7
TGCGCCAGCAGCACCACTTCTGGTTACTACTCCTACGAGCAGTACTTC	CASSTTSGYYSYEQYF	TRBV4-1	TRBJ2-7
TGTGCCAGCAGCTTTTGCGGGACAGGGTCACCGATTGAAAAACTGTTTTTT	CASSFCGTGSPIEKLFF	TRBV5-4	TRBJ1-4
TGTGCCAGCAGTCTAGCGGGCCGTGTGCCCTACGAGCAGTACTTC	CASSLAGRVPYEQYF	TRBV6-8	TRBJ2-7
TGTGCCAGCAGAAAGACTATCATTTACAATGAGCAGTTCTTC	CASRKTIIYNEQFF	TRBV7-3	TRBJ2-1
TGTGCCAGCAGCTCCCAGGGGAACACCGGGGAGCTGTTTTTT	CASSSQGNTGELFF	TRBV5-4	TRBJ2-2
TGTGCCATCAGTGAGTTCACAGGGGCATTGTTCAGCTACACCTTC	CAISEFTGALFSYTF	TRBV10-3	TRBJ1-2
TGCAGCGGGTTCCGCTTCAGTAGGACCGCCGGTCTCTCTGGGGCCAACGTCCTGACTTTC	CSGFRFSRTAGLSGANVLTF	TRBV29-1	TRBJ2-6
TGTGCCAGCGGAGAATCCTCTGGAAACACCATATATTTT	CASGESSGNTIYF	TRBV19	TRBJ1-3
TGCAGGTCTACTATAAGCCCGTCGTCTGGGGCCAACGTCCTGACTTTC	CRSTISPSSGANVLTF	TRBV20-1	TRBJ2-6
TGTGCCATCAGCCGGACAGACACGACTAATGAAAAACTGTTTTTT	CAISRTDTTNEKLFF	TRBV10-3	TRBJ1-4
TGTGCCAGCAGCTTATGCCCTCCTTTCGAAGCTTTCTTT	CASSLCPPFEAFF	TRBV11-2	TRBJ1-1
TGTGCCAGTAGGACGACTAGCGGGAGGGGGAGCTCCTACAATGAGCAGTTCTTC	CASRTTSGRGSSYNEQFF	TRBV19	TRBJ2-1
TGCAGCGTTGAGCACAGGGGGCCCCAGCATTTT	CSVEHRGPQHF	TRBV29-1	TRBJ1-5
TGCGCCAGCAGCCAAGCTGCCGGGACAGGGGGGAGCAATCAGCCCCAGCATTTT	CASSQAAGTGGSNQPQHF	TRBV4-1	TRBJ1-5
TGTGCCAGCAGCCAAGACTTGCATGGAGATACGCAGTATTTT	CASSQDLHGDTQYF	TRBV4-2	TRBJ2-3
TGCAGTGCTTTAAAGGAGTCATCTTCACCCCTCCACTTT	CSALKESSSPLHF	TRBV20-1	TRBJ1-6
TGTGCCAGCAGCTTACGACTAGCGGGAGAGACCCCGGAGCTGTTTTTT	CASSLRLAGETPELFF	TRBV7-9	TRBJ2-2
TGTGCCAGCAGTTTTCCCCAGGGCTCTGGGGCCAACGTCCTGACTTTC	CASSFPQGSGANVLTF	TRBV12-4	TRBJ2-6
TGTGCCAGCAGACGGGGGACTAGGGATGAGCAGTTCTTC	CASRRGTRDEQFF	TRBV7-8	TRBJ2-1
TGTGCCAGCAGTGCCGGGGCCCAAGAGACCCAGTACTTC	CASSAGAQETQYF	TRBV6-4	TRBJ2-5
TGCAGTGCGCCGGGGGCCAGGCAATCCTACGAGCAGTACTTC	CSAPGARQSYEQYF	TRBV20-1	TRBJ2-7
TGTGCCAGCAGCTTAAGCGGGAATCGTAGGAACACTGAAGCTTTCTTT	CASSLSGNRRNTEAFF	TRBV7-9	TRBJ1-1
TGTGCTAGTGGTTTGACCGGGACAGGGCAAGAGACCCAGTACTTC	CASGLTGTGQETQYF	TRBV12-5	TRBJ2-5
TGTGCCAGCCCCGGGACAACTGAGCCCTACAATGAGCAGTTCTTC	CASPGTTEPYNEQFF	TRBV28	TRBJ2-1
TGTGCCTGGAGTGTACTCCTAGCGGGCCGAGTGGGAGATACGCAGTATTTT	CAWSVLLAGRVGDTQYF	TRBV30	TRBJ2-3
TGTGCCATCAGGGGCTTGCACTACTCTGGCTACACCTTC	CAIRGLHYSGYTF	TRBV10-3	TRBJ1-2
TGTGCCAGCAGCGTAGCTCCCACCCGGGACTACGAGCAGTACTTC	CASSVAPTRDYEQYF	TRBV9	TRBJ2-7
TGTCAGGAGAGCTATGGCTACACCTTC	CQESYGYTF	TRBV7-9	TRBJ1-2
TGCAGTGCTAGGACATACAAGGGGCCAGGCTACGAGCAGTACTTC	CSARTYKGPGYEQYF	TRBV20-1	TRBJ2-7
TGTGCCAGCAGGTCCCCGCAGGGGCAGTACTTC	CASRSPQGQYF	TRBV2	TRBJ2-7
TGTGCCAGCAGTTACCCGGCAGAAGTCAATCAGCCCCAGCATTTT	CASSYPAEVNQPQHF	TRBV6-2	TRBJ1-5
TGTGCCAGCAGCTCCTGGGAGGGGGGGGAAGGCACAGATACGCAGTATTTT	CASSSWEGGEGTDTQYF	TRBV13	TRBJ2-3
TGCAGCGAGTGCTGTTATCGGGGCATTCAGTACTTC	CSECCYRGIQYF	TRBV29-1	TRBJ2-4
TGTGCCAGCAGGCCCCGGGACAGGGGCTGCTATGGCTACACCTTC	CASRPRDRGCYGYTF	TRBV25-1	TRBJ1-2
TGTGCCAGCAGTTTATCGGGGGCCTACGAGCAGTACTTC	CASSLSGAYEQYF	TRBV27	TRBJ2-7
TGCGCCAGCACGAAACTAGCGGGAGGAACCTCCGGGGAGCTGTTTTTT	CASTKLAGGTSGELFF	TRBV10-2	TRBJ2-2
TGCGCCAGCAGCCAACACCAAGAGGGCAGGAGGGGGCACACTGAAGCTTTCTTT	CASSQHQEGRRGHTEAFF	TRBV4-1	TRBJ1-1
TGCGCCAGCAGTGCCAGCAGGGATCCCTACGAGCAGTACTTC	CASSASRDPYEQYF	TRBV10-1	TRBJ2-7
TGCGCCAGCTCGACAGGGGGCCACGAGCAGTACTTC	CASSTGGHEQYF	TRBV10-1	TRBJ2-7
TGTGCCAGATTAATCGGAGTGTATGGACAGCCCGAGCAGTACTTC	CARLIGVYGQPEQYF	TRBV11-3	TRBJ2-7
TGTGCCACCAGCAGCCTGCACCCGGGACCCTACGAGCAGTACTTC	CATSSLHPGPYEQYF	TRBV15	TRBJ2-7
TGCAGTGCTAGCCCCTACAGGGGGAGGAATCAGCCCCAGCATTTT	CSASPYRGRNQPQHF	TRBV20-1	TRBJ1-5
TGTGCCGCCCCCCAGCGGGAGAATCAGCCCCAGCATTTT	CAAPQRENQPQHF	TRBV2	TRBJ1-5
TGTGCCAGCAGCCCGCTACAGGCCTTAACCAACAATCAGCCCCAGCATTTT	CASSPLQALTNNQPQHF	TRBV11-3	TRBJ1-5
TGTGCCACCAGCACCCCGGGGACAGGGTTAAACGAGCAGTACTTC	CATSTPGTGLNEQYF	TRBV24-1	TRBJ2-7
TGCAGTGCTAGACAGGGGTGGGAGCAGTACTTC	CSARQGWEQYF	TRBV20-1	TRBJ2-7
TGCAGTGCTAGACCGGACAGGGAGAGATACTACAATGAGCAGTTCTTC	CSARPDRERYYNEQFF	TRBV20-1	TRBJ2-1
TGTGCCAGGGTCACAGGGAGGGAAGAGACCCAGTACTTC	CARVTGREETQYF	TRBV6-1	TRBJ2-5
TGCGCCAGCAGCGGTCCTCTAGCGGGAATCAACACAGATACGCAGTATTTT	CASSGPLAGINTDTQYF	TRBV5-1	TRBJ2-3
TGTGCCATCACTCTGGGAGGGGAGCAGTTCTTC	CAITLGGEQFF	TRBV10-3	TRBJ2-1
TGTGCCAGCAGTGAAGTACCTGGGGTGCTTACCTACGAGCAGTACTTC	CASSEVPGVLTYEQYF	TRBV6-1	TRBJ2-7
TGTGCCGGGACCGGGGAGCTGTTTTTT	CAGTGELFF	TRBV9	TRBJ2-2
TGTGCCAGCAGCCGACCCACTCAGGGAAACACCGGGGAGCTGTTTTTT	CASSRPTQGNTGELFF	TRBV6-4	TRBJ2-2
TGTGCCAGCAGTTACCTGGTGAACACTGAAGCTTTCTTT	CASSYLVNTEAFF	TRBV6-5	TRBJ1-1
TGTGCCAGCAGCTTAGCTTGGCCGGAGAACACCGGGGAGCTGTTTTTT	CASSLAWPENTGELFF	TRBV11-2	TRBJ2-2
TGCAGCGTTGATTTAATCGCAGGGGGCACCCGCTCGATCTTTCAGCCCCAGCATTTT	CSVDLIAGGTRSIFQPQHF	TRBV29-1	TRBJ1-5
TGTGCCAGCAGCTCTATGCAGGGGAGGGCCAAAAACATTCAGTACTTC	CASSSMQGRAKNIQYF	TRBV7-9	TRBJ2-4
TGTGCCAGCAGCTTAGCGTTACAGGGGCAGTACAATGAGCAGTTCTTC	CASSLALQGQYNEQFF	TRBV13	TRBJ2-1
TGTGCCAGCCGAGGGGGGGCGATTGGGACGTCTCAAGAGACCCAGTACTTC	CASRGGAIGTSQETQYF	TRBV3-1	TRBJ2-5
TGTGCCAGCAGCCACTATATACGACGTTCTTGGGGGGACACTGAAGCTTTCTTT	CASSHYIRRSWGDTEAFF	TRBV13	TRBJ1-1
TGTGCCAGCAGTTTTTCCATTACTAGCGGGAGGGTCCGAAGCTCCTATAATTCACCCCTCCACTTT	CASSFSITSGRVRSSYNSPLHF	TRBV28	TRBJ1-6
TGCGCCAGCAGCCAATGCCGACAGGGTGTCCCGGGGGCCTACGAGCAGTACTTC	CASSQCRQGVPGAYEQYF	TRBV4-1	TRBJ2-7
TGCGCCAGCAGTGAGAGAGCACTCAGCTCCTACGAGCAGTACTTC	CASSERALSSYEQYF	TRBV10-1	TRBJ2-7
TGTGCCAGCAGCTTAGATTCTGACGGAGGAAAGAACTCCTACGAGCAGTACTTC	CASSLDSDGGKNSYEQYF	TRBV11-3	TRBJ2-7
TGTGCCAGCAATGACAGGGCGAACTCCTACGAGCAGTACTTC	CASNDRANSYEQYF	TRBV14	TRBJ2-7
TGCGCCAGCAGCAACGACGCGGGAAACACCATATATTTT	CASSNDAGNTIYF	TRBV4-1	TRBJ1-3
TGTGCCAGCACGAGGAGGGGGCCCCGGGATGGTAATTCACCCCTCCACTTT	CASTRRGPRDGNSPLHF	TRBV9	TRBJ1-6
TGTGCCACCAGCATACGTCTGGGGTACGAGCAGTACTTC	CATSIRLGYEQYF	TRBV15	TRBJ2-7
TGTGCCAGCTCACCTATTAGGGGATCCAGCACAGATACGCAGTATTTT	CASSPIRGSSTDTQYF	TRBV18	TRBJ2-3
TGTGCCAGCAGTCACTCGGGACAGTGGGACGGACGGTACGAGCAGTACTTC	CASSHSGQWDGRYEQYF	TRBV6-1	TRBJ2-7
TGTGCCACCGGTGGGGTTAGCAGTAACTATGGCTACACCTTC	CATGGVSSNYGYTF	TRBV6-5	TRBJ1-2
TGCAGTGCACGTGGGGGGCCGGGCTACACCTTC	CSARGGPGYTF	TRBV20-1	TRBJ1-2
TGTGCCAGCAGTCGCAGTACGGACAGGCGGACCTACGAGCAGTACTTC	CASSRSTDRRTYEQYF	TRBV5-4	TRBJ2-7
TGTGCCAGTAGTATAGGACCGGGGAAAGAGACCCAGTACTTC	CASSIGPGKETQYF	TRBV19	TRBJ2-5
TGTGCCAGCAGTCCGCCAGTGACACTACGGGCGGAGGACGGGCAGGACGTTCAGTCCGGGGAGCTGTTTTTT	CASSPPVTLRAEDGQDVQSGELFF	TRBV2	TRBJ2-2
TGCAGCGTTGAACAGGGGGAGCATAGAAAGCCAGATACGCAGTATTTT	CSVEQGEHRKPDTQYF	TRBV29-1	TRBJ2-3
TGTGCCCCACCCTGGGGCACGTCCTGGCATAGCAATCAGCCCCAGCATTTT	CAPPWGTSWHSNQPQHF	TRBV19	TRBJ1-5
TGTGCCAGCAGCTTGGGAGCAGGGACGGGGCACTCCTACGAGCAGTACTTC	CASSLGAGTGHSYEQYF	TRBV5-6	TRBJ2-7
TGTGCCAGCAGTTTATTGCCTACAGGACTAGGGGACGAGCAGTACTTC	CASSLLPTGLGDEQYF	TRBV27	TRBJ2-7
TGTGCCAGCAGTCCGCAGGAGGAGGCCCTCCACTTT	CASSPQEEALHF	TRBV27	TRBJ1-6
TGTGCCAGCAGCCAAAACGGGGAAGGACAAAACATTCAGTACTTC	CASSQNGEGQNIQYF	TRBV3-1	TRBJ2-4
TGCGCCAGCAGTGAGTCGGGCTTGCCAGTCACCCGGACAGATACGCAGTATTTT	CASSESGLPVTRTDTQYF	TRBV10-1	TRBJ2-3
TGCGCCAGCAGCGAGGGACAGGGGGCTAACTATGGCTACACCTTC	CASSEGQGANYGYTF	TRBV5-1	TRBJ1-2
TGTGCCAGCCCGTCCGGGGCCGGGGCAACTAATGAAAAACTGTTTTTT	CASPSGAGATNEKLFF	TRBV7-9	TRBJ1-4
TGTGCCAGCACAGGACTAAGGTACAATGAGCAGTTCTTC	CASTGLRYNEQFF	TRBV27	TRBJ2-1
TGTGCCAGCAGTGACTGGACAGGATCGGTGGCACCGGCTGAAAAACTGTTTTTT	CASSDWTGSVAPAEKLFF	TRBV6-1	TRBJ1-4
TGCGCCAGCAGTGTGCGACTAGCGGAACTCTACGAGCAGTACTTC	CASSVRLAELYEQYF	TRBV10-1	TRBJ2-7
TGCGCCAGCAGCCAAGATTCCAGTTTAGAGCAGTTCTTC	CASSQDSSLEQFF	TRBV4-1	TRBJ2-1
TGTGCCAGCAAACTAGACGGGACATGGGCCTACGAGCAGTACTTC	CASKLDGTWAYEQYF	TRBV5-4	TRBJ2-7
TGCAGTGCTAGGGGCACGAATAGCAATCAGCCCCAGCATTTT	CSARGTNSNQPQHF	TRBV20-1	TRBJ1-5
TGTGCCAGCAGTGGGGCTCGGGGCCGGAGTGATCAGCCCCAGCATTTT	CASSGARGRSDQPQHF	TRBV6-1	TRBJ1-5
TGTGCCAGCAGCCCAGATCTTGACAGTCGCAACACTGAAGCTTTCTTT	CASSPDLDSRNTEAFF	TRBV7-7	TRBJ1-1
TGTGCCAGCAGCTTTGTTGGGGGCGCTGTTGACTCTGGAAACACCATATATTTT	CASSFVGGAVDSGNTIYF	TRBV11-3	TRBJ1-3
TGTGGTCCTTCCCCACTCAGGGAAGACTACGAGCAGTACTTC	CGPSPLREDYEQYF	TRBV5-4	TRBJ2-7
TGTGCCAGCAGTTTAGGGCGCTCTGGGGCCAACGTCCTGACTTTC	CASSLGRSGANVLTF	TRBV27	TRBJ2-6
TGCGCCAGCAGCCAAGAAGAGTCCCCCCAGGGGGTCTCTGGGGCCAACGTCCTGACTTTC	CASSQEESPQGVSGANVLTF	TRBV4-3	TRBJ2-6
TGTGCCAGCAGCGTAGGAGGCCATCCCCCCGGGAAAGAGCAGTACTTC	CASSVGGHPPGKEQYF	TRBV9	TRBJ2-7
TGTGCCAGCAGTTACTCCCCGTCTCTTGGGGGCAATGAGCAGTTCTTC	CASSYSPSLGGNEQFF	TRBV6-6	TRBJ2-1
TGCAGTGCTAGAGCCGGGACTAGCGGGCCCGACTACGAGCAGTACTTC	CSARAGTSGPDYEQYF	TRBV20-1	TRBJ2-7
TGCGCCAGCAGCGCAACAGGGACATTGGGGGGCGAGCAGTACTTC	CASSATGTLGGEQYF	TRBV5-1	TRBJ2-7
TGTGCCAGCACCACCTTCCGGGACAGGGGGGTAGATACGCAGTATTTT	CASTTFRDRGVDTQYF	TRBV19	TRBJ2-3
TGTGCCATCAGTGACGGCGGGGGCACTGAAGCTTTCTTT	CAISDGGGTEAFF	TRBV10-3	TRBJ1-1
TGTGCCAGCAGTGACAGACAGGGGGGAAGAGTGGGCAATGAGCAGTTCTTC	CASSDRQGGRVGNEQFF	TRBV6-4	TRBJ2-1
TGTGCCAGCAGCTTATGGGACCCTACAGTAGCGGGTACCTCCTACGAGCAGTACTTC	CASSLWDPTVAGTSYEQYF	TRBV11-3	TRBJ2-7
TGTGCCAGCAGTTACTCGAGCATGGCGGGGGGCCAGCCCCAGCATTTT	CASSYSSMAGGQPQHF	TRBV6-6	TRBJ1-5
TGTGCCACCAGCAGGGGTGGGGGGGGCGGGGAAAAACTGTTTTTT	CATSRGGGGGEKLFF	TRBV15	TRBJ1-4
TGCAGTGCTCTATCTAGGGAGTCGAGCTCCTATAATTCACCCCTCCACTTT	CSALSRESSSYNSPLHF	TRBV20-1	TRBJ1-6
TGTGCCAGCCTTAAGCGCCGGGACAGGGCCTATGGCTACACCTTC	CASLKRRDRAYGYTF	TRBV9	TRBJ1-2
TGTGCCAGCAGCGTAGGACTAGCGGGAGGAAGGAACACTGAAGCTTTCTTT	CASSVGLAGGRNTEAFF	TRBV9	TRBJ1-1
TGTGCCAGCAGTGAAGTGGGACTAGCGGGTCGATCCTACAATGAGCAGTTCTTC	CASSEVGLAGRSYNEQFF	TRBV2	TRBJ2-1
TGTGCCACCAGCAGAAGTGGGCCAATCCATTCTCGGTGGGACACCGGGGAGCTGTTTTTT	CATSRSGPIHSRWDTGELFF	TRBV15	TRBJ2-2
TGTGCCACCAGCACAGGGGACGAAAAACTGTTTTTT	CATSTGDEKLFF	TRBV15	TRBJ1-4
TGTGCCAGCAGCGTTAGGGAGGATCCCGGGAATAATTCACCCCTCCACTTT	CASSVREDPGNNSPLHF	TRBV9	TRBJ1-6
TGCAGTGACTCCACGGAGACCCAGTACTTC	CSDSTETQYF	TRBV20-1	TRBJ2-5
TGTGCCAGCAGATCTCGAGAAACGTTGAACACTGAAGCTTTCTTT	CASRSRETLNTEAFF	TRBV28	TRBJ1-1
TGTGCCAGCGCCCACCCGATGGAGGGCGGCTACACCTTC	CASAHPMEGGYTF	TRBV11-2	TRBJ1-2
TGTGCCAGCAGCTTAGATCGGGGGGAAGGGGGGGGAAATGGCTACACCTTC	CASSLDRGEGGGNGYTF	TRBV11-2	TRBJ1-2
TGCAGTGAGGGACCTAAGAGTAGCAATCAGCCCCAGCATTTT	CSEGPKSSNQPQHF	TRBV20-1	TRBJ1-5
TGCAGTAGTTGTCCGAGGGGGTTCTCCTACGAGCAGTACTTC	CSSCPRGFSYEQYF	TRBV20-1	TRBJ2-7
TGTGCCAGTAGTACCCTTAATGGGACAGGGGCGGACGGAAATCAGCCCCAGCATTTT	CASSTLNGTGADGNQPQHF	TRBV19	TRBJ1-5
TGTGCCAGCAGCCAAGTGCGCCGAGGGCCTCCAGACGGGGAGCTGTTTTTT	CASSQVRRGPPDGELFF	TRBV4-2	TRBJ2-2
TGTGCCAGCAGCCAATCGAAGTACCCCCCCGACAGGAGCTCCTACAATGAGCAGTTCTTC	CASSQSKYPPDRSSYNEQFF	TRBV16	TRBJ2-1
TGTGCCAGCAGCTTACCATCGCGCGGGACGGGGGGCATTCAGTACTTC	CASSLPSRGTGGIQYF	TRBV7-8	TRBJ2-4
TGCGCCAGCAGGACAGTACGCACAGATACGCAGTATTTT	CASRTVRTDTQYF	TRBV5-1	TRBJ2-3
TGTGCCAGCAGACCCACGACAGGGTCCTACAATGAGCAGTTCTTC	CASRPTTGSYNEQFF	TRBV6-4	TRBJ2-1
TGTGCCAGCAGTGAGCAAGTGGGAGCTTTCTTT	CASSEQVGAFF	TRBV7-9	TRBJ1-1
TGTGCCAGAAATTCCGGGACATTTGTGGGGGGTGAGCAGTTCTTC	CARNSGTFVGGEQFF	TRBV19	TRBJ2-1
TGTGCCAGCAGCGATAACCTAGCGGGACGGTCCTCCTACGAGCAGTACTTC	CASSDNLAGRSSYEQYF	TRBV9	TRBJ2-7
TGCAGTGCTAGGGGGCCCCTCCAAGGCGGTACCGGGGAGCTGTTTTTT	CSARGPLQGGTGELFF	TRBV20-1	TRBJ2-2
TGTGCCAGCAGGCCAGGGTACTCCTACGAGCAGTACTTC	CASRPGYSYEQYF	TRBV11-2	TRBJ2-7
TGTGCCACCAGCAGATATCTTAAGTCGGGGGGGCATGGGGCCAACGTCCTGACTTTC	CATSRYLKSGGHGANVLTF	TRBV15	TRBJ2-6
TGTGCCAGCAGCACGACTAGTCGCACCGAGCAGTACTTC	CASSTTSRTEQYF	TRBV7-3	TRBJ2-7
TGTGCCAGCAGCCAAGATTCCCCGTACGAAGCCGGGGCCTACGAGCAGTACTTC	CASSQDSPYEAGAYEQYF	TRBV4-2	TRBJ2-7
TGTGCCAGCAGTGGGGTTCAGCGCGGGGGGTCCTACGAGCAGTACTTC	CASSGVQRGGSYEQYF	TRBV2	TRBJ2-7
TGTGCCAGCGGCAAACAGGGGGGGGCCCAGCATTTT	CASGKQGGAQHF	TRBV6-4	TRBJ1-5
TGTGCCAGCAGTTGGACAGGGTGCTCCTACAATGAGCAGTTCTTC	CASSWTGCSYNEQFF	TRBV27	TRBJ2-1
TGCGCCAGCAAGGACGGTGGGGGTGGGGGCAATCAGCCCCAGCATTTT	CASKDGGGGGNQPQHF	TRBV10-1	TRBJ1-5
TGCAGCGTTAGCCGACTTGGTGAAGCTTTCTTT	CSVSRLGEAFF	TRBV29-1	TRBJ1-1
TGTGCCAGCAGTTCTAGCGGGACAGTCACTCGCTCTGGAAACACCATATATTTT	CASSSSGTVTRSGNTIYF	TRBV27	TRBJ1-3
TGCGCCAGCAGCCAGGAAGACAGGGAGGAAGAGACCCAGTACTTC	CASSQEDREEETQYF	TRBV4-1	TRBJ2-5
TGTGCCAGCAGCTGCGGCACACAGGGGGGGTATGGCTACACCTTC	CASSCGTQGGYGYTF	TRBV7-9	TRBJ1-2
TGTGCCAGCAGCCAAGAGAAATCGAGGGAGGGTTGGGCCTACGAGCAGTACTTC	CASSQEKSREGWAYEQYF	TRBV14	TRBJ2-7
TGTGCCAGCAGCCAAGAACGAGGGGGGGGGGTCCTTTTAGAAGCTTTCTTT	CASSQERGGGVLLEAFF	TRBV14	TRBJ1-1
TGTGCCAGCAGCCTAGCAGGGGCCCTCTACAATGAGCAGTTCTTC	CASSLAGALYNEQFF	TRBV7-3	TRBJ2-1
TGCAGTGCTTCGGGGGGGGATAATGAGCAGTTCTTC	CSASGGDNEQFF	TRBV20-1	TRBJ2-1
TGTGCCAGCAGTTTAGGGGGTAGGCTGGGGGAGCTGTTTTTT	CASSLGGRLGELFF	TRBV12-3	TRBJ2-2
TGTGCCAGCAGGCCCTGCAGCGGGAGGGACAATGAGCAGTTCTTC	CASRPCSGRDNEQFF	TRBV6-1	TRBJ2-1
TGCGCCAGCAGCTTTGCCGGGACAGGGTTCCCCAACGAGCAGTACTTC	CASSFAGTGFPNEQYF	TRBV5-1	TRBJ2-7
TGTGCCAGCAGCTTGGTTAGGGGGGCCGGGGAGCTGTTTTTT	CASSLVRGAGELFF	TRBV5-5	TRBJ2-2
TGCAGTGCTAGGGGAACGTATCAGCCCCAGCATTTT	CSARGTYQPQHF	TRBV20-1	TRBJ1-5
TGTGCCAGCAGCCAAATGCTGGGACAGGGAGTGCCCCAGCATTTT	CASSQMLGQGVPQHF	TRBV3-1	TRBJ1-5
TGTGCCACCAGTGATTCTGGCCGGACAGACTCCTGCAACACTGAAGCTTTCTTT	CATSDSGRTDSCNTEAFF	TRBV24-1	TRBJ1-1
TGTGCCAGCAATAACGGTTCCTACGAGCAGTACTTC	CASNNGSYEQYF	TRBV9	TRBJ2-7
TGTGCCAGCTCGATCACTACCTATGGCTACACCTTC	CASSITTYGYTF	TRBV18	TRBJ1-2
TGTGCCAGTTGCTATGCGGGGGGTGTTCACAATGAGCAGTTCTTC	CASCYAGGVHNEQFF	TRBV6-6	TRBJ2-1
TGTGCCAGCAGTTTGACAGGGGGCGGGGAGGAGACCCAGTACTTC	CASSLTGGGEETQYF	TRBV6-2	TRBJ2-5
TGCAGTGCTAGAGATGGCACGGGACACGAGCAGTACTTC	CSARDGTGHEQYF	TRBV20-1	TRBJ2-7
TGTGCCAGCAGTTGTCGGCCGGGACCTCAGCCCCAGCATTTT	CASSCRPGPQPQHF	TRBV27	TRBJ1-5
TGTGCCAGCAGCCAGACCGGCTCCCTCCAGGAGGTTGCTGGAAACACCATATATTTT	CASSQTGSLQEVAGNTIYF	TRBV12-4	TRBJ1-3
TGTGCTAGTGGTCCAGCGGGAGAGACCCCTGAAGCTTTCTTT	CASGPAGETPEAFF	TRBV12-5	TRBJ1-1
TGTGCCAGCCCGGACCTGGCTCGGTATAATTCACCCCTCCACTTT	CASPDLARYNSPLHF	TRBV27	TRBJ1-6
TGTGCCAGCAGCAGAGGAACAGGGATACAAAACATTCAGTACTTC	CASSRGTGIQNIQYF	TRBV13	TRBJ2-4
TGTGCCAGCAGTCAAGGAGGTAAGAATGAGCAGTTCTTC	CASSQGGKNEQFF	TRBV27	TRBJ2-1
TGTGCCAGCAGTCCTAGGGGCCTGAACACTGAAGCTTTCTTT	CASSPRGLNTEAFF	TRBV6-8	TRBJ1-1
TGCGCCAGCAGCTTGGGGAGACCCGGGGCCTACGAGCAGTACTTC	CASSLGRPGAYEQYF	TRBV5-1	TRBJ2-7
TGCAGCGTGTCTGGACAGGGTGGAAAAGGCTTCCCGAACACTGAAGCTTTCTTT	CSVSGQGGKGFPNTEAFF	TRBV29-1	TRBJ1-1
TGTGCCAGCAGTTCTAAGGACCGTGAGCAGTTCTTC	CASSSKDREQFF	TRBV6-9	TRBJ2-1
TGTGCCCGCCACCTGACAGATACGCAGTATTTT	CARHLTDTQYF	TRBV25-1	TRBJ2-3
TGTGCCAGCAGCGTACTTGAGCAGTTCTTC	CASSVLEQFF	TRBV9	TRBJ2-1
TGCGCCAGCATCGGTGAGGGGAAAGCCAAAAACATTCAGTACTTC	CASIGEGKAKNIQYF	TRBV10-2	TRBJ2-4
TGTGCCAGCAGGACAGGGGGGGATGAGCAGTTCTTC	CASRTGGDEQFF	TRBV2	TRBJ2-1
TGTGCCACCTGGAGGAACGAGCAGTACTTC	CATWRNEQYF	TRBV15	TRBJ2-7
TGCAGCGTCCGGGGACAGGGGGCTTACACTGAAGCTTTCTTT	CSVRGQGAYTEAFF	TRBV29-1	TRBJ1-1
TGTGCCACCAGGCCCGCGGGCGTTTTTCAGCCCCAGCATTTT	CATRPAGVFQPQHF	TRBV15	TRBJ1-5
TGCGCCAGCAGCGCCGGGACTCCAGGATACGAGCAGTACTTC	CASSAGTPGYEQYF	TRBV5-1	TRBJ2-7
TGTGCCACCAGGGGCACAAGGAGTGGAAACACCATATATTTT	CATRGTRSGNTIYF	TRBV15	TRBJ1-3
TGTGCCAGCAGCCGCCTAGCGGGGAACTTC	CASSRLAGNF	TRBV11-2	TRBJ2-5
TGTGCAGCCTGGGCTTACCGGGACGAGAAGCCGGACGAGCAGTACTTC	CAAWAYRDEKPDEQYF	TRBV6-2	TRBJ2-7
TGTGCCACCAGCAGAAGTCGGTTGGGGACAGGGAAGGAGGGAAACACCATATATTTT	CATSRSRLGTGKEGNTIYF	TRBV15	TRBJ1-3
TGCGCCAGCAGCCAAATTAGGCTAGGGGGGGGCCTGGAGACCCAGTACTTC	CASSQIRLGGGLETQYF	TRBV4-1	TRBJ2-5
TGCGCCAGCAGCCCCCGGGACAGGGGTCCCTTTCAGCCCCAGCATTTT	CASSPRDRGPFQPQHF	TRBV4-1	TRBJ1-5
TGTGCCAGCAGCTTCCTCAGGTACGCTCACACTGAAGCTTTCTTT	CASSFLRYAHTEAFF	TRBV7-4	TRBJ1-1
TGTGCCAGCAAACTTCCAGGGGTGTCTGACTTC	CASKLPGVSDF	TRBV6-4	TRBJ2-7
TGTGCTAGTGGTTTGTCATGGACTAATGAAAAACTGTTTTTT	CASGLSWTNEKLFF	TRBV12-5	TRBJ1-4
TGTGCCAGCAACGGTACTACTAGCACAGATACGCAGTATTTT	CASNGTTSTDTQYF	TRBV11-3	TRBJ2-3
TGTGCCAGCAGCGCTAGGTATCAAGTGGTCTATGGCTACACCTTC	CASSARYQVVYGYTF	TRBV7-9	TRBJ1-2
TGCGCCAGCAGTGCGGGCACGGGACATCCTGAAGCTTTCTTT	CASSAGTGHPEAFF	TRBV10-1	TRBJ1-1
TGTGCCAGCAGGAGAGGACAGCCTAGACAGAAGGACACTGAAGCTTTCTTT	CASRRGQPRQKDTEAFF	TRBV27	TRBJ1-1
TGTGCCAGCAGCCAAGTTATCTTCCGCAAGGGAGAAAAACTGTTTTTT	CASSQVIFRKGEKLFF	TRBV4-2	TRBJ1-4
TGTGCCAGCAGCGACCTGCCCTTCAATCAGCCCCAGCATTTT	CASSDLPFNQPQHF	TRBV6-6	TRBJ1-5
TGTGCCAATCTAGGGGGCCAAGCTTTCTTT	CANLGGQAFF	TRBV6-2	TRBJ1-1
TGTGCCAGCAGTTTGGAACTCGGCCATGAGACCCAGTACTTC	CASSLELGHETQYF	TRBV12-4	TRBJ2-5
TGTGCCACCCTCCATTGCTCCGGGACAGGGACTGAAGCTTTCTTT	CATLHCSGTGTEAFF	TRBV24-1	TRBJ1-1
TGCAGCGTTGGGAGGACAGGGATCCGATCTTACTCCTACGAGCAGTACTTC	CSVGRTGIRSYSYEQYF	TRBV29-1	TRBJ2-7
TGTGCCAGCAGCAGGCCCTACGAGCAGTACTTC	CASSRPYEQYF	TRBV14	TRBJ2-7
TGTGCCAGCTCTCCCCAGGGACCTCACTCTGGAAACACCATATATTTT	CASSPQGPHSGNTIYF	TRBV18	TRBJ1-3
TGCAGCGTTTTCGAGGGACTGAACAATGAGCAGTTCTTC	CSVFEGLNNEQFF	TRBV29-1	TRBJ2-1
TGTGCCAGCAGCCCCCCGGGACAGGGGTCGTTCTGTCAGCCCCAGCATTTT	CASSPPGQGSFCQPQHF	TRBV13	TRBJ1-5
TGCGCCAGCACCTGTCCCTTGAGATACGAGCAGTACTTC	CASTCPLRYEQYF	TRBV10-2	TRBJ2-7
TGCAGTGCGTTAGCGAAACCAGCCCTCCACTTT	CSALAKPALHF	TRBV20-1	TRBJ1-6
TGCGCCAGCAGTGATCCGGACAGAGGCAATCAGCCCCAGCATTTT	CASSDPDRGNQPQHF	TRBV10-1	TRBJ1-5
TGTGCCAGCAGTTACCGGGACATCACCGGGGAGCTGTTTTTT	CASSYRDITGELFF	TRBV11-3	TRBJ2-2
TGTGCTAGTGGACGGGGCTACAATGAGCAGTTCTTC	CASGRGYNEQFF	TRBV12-5	TRBJ2-1
TGTGCCAGCAGGAAGCTACTGATCCAACAGGGGGCAAGGGATACGCAGTATTTT	CASRKLLIQQGARDTQYF	TRBV2	TRBJ2-3
TGTGCCAGCAGCTTAGTCGGGTCCTATAATTCACCCCTCCACTTT	CASSLVGSYNSPLHF	TRBV9	TRBJ1-6
TGTGCCAGCAGCTTACCGGGACTAGGTAGTCAACCCGAGGGAGAGGAGACCCAGTACTTC	CASSLPGLGSQPEGEETQYF	TRBV7-9	TRBJ2-5
TGTGGGCCCCCCTGGGGGGGCCGGGACGAGCAGTACTTC	CGPPWGGRDEQYF	TRBV14	TRBJ2-7
TGTGCTAGTGGGAGCGAGAGCGAGCAGTACTTC	CASGSESEQYF	TRBV12-5	TRBJ2-7
TGTGCCAGCAGCTTCTCTCGCAATGAGCAGTTCTTC	CASSFSRNEQFF	TRBV5-8	TRBJ2-1
TGTGCCAGCAGCTCAGGGGACAGTTTTAAAAGACCCAATCAGCCCCAGCATTTT	CASSSGDSFKRPNQPQHF	TRBV7-2	TRBJ1-5
TGCGCCAGCAGCTTGGGGCACTCGTCGGAGACCCAGTACTTC	CASSLGHSSETQYF	TRBV5-1	TRBJ2-5
TGTGCCAGCAGTGACCCCCTAGCTGACACCTTC	CASSDPLADTF	TRBV6-4	TRBJ1-2
TGTGCTAGTGCAGGGAAGCGGAGCACTGAAGCTTTCTTT	CASAGKRSTEAFF	TRBV12-5	TRBJ1-1
TGTGCCAGCTCACCACCCCCCTGGGGGACAGGGGGGCACACTGAAGCTTTCTTT	CASSPPPWGTGGHTEAFF	TRBV18	TRBJ1-1
TGTGCCAGCAGCATGGGACTAGGTCTTAATGAGCAGTTCTTC	CASSMGLGLNEQFF	TRBV5-8	TRBJ2-1
TGTGCCAGCAGCCACCGCCAGGAAAGCGAGCAGTACTTC	CASSHRQESEQYF	TRBV7-4	TRBJ2-7
TGTGCCAGCAGTTCGCACCGCATTCAAGGAGATACGCAGTATTTT	CASSSHRIQGDTQYF	TRBV12-3	TRBJ2-3
TGTGCCGGTCCATGGGGGGCTTTGATCTTC	CAGPWGALIF	TRBV7-3	TRBJ2-1
TGCGCCAGCAGTGAGAACACAGGTCCAGGCACGGGCGATCAGCCCCAGCATTTT	CASSENTGPGTGDQPQHF	TRBV10-2	TRBJ1-5
TGTGCCAGCATTGGACAGTACTATCAGCCCCAGCATTTT	CASIGQYYQPQHF	TRBV25-1	TRBJ1-5
TGTGCCAGCAGTGAAGAAGCAAAAGGGTACGAGCAGTACTTC	CASSEEAKGYEQYF	TRBV6-1	TRBJ2-7
TGCGCCAGCAGCTTGGTCAGGGGACCGGTTACGGAAAAACTGTTTTTT	CASSLVRGPVTEKLFF	TRBV5-1	TRBJ1-4
TGTGCCAGCAGTTCCAGGGGGCGTGCGGCTGTGAACACTGAAGCTTTCTTT	CASSSRGRAAVNTEAFF	TRBV6-1	TRBJ1-1
TGTGCCAGCAGCTTAGGACTGACCTACGAGCAGTACTTC	CASSLGLTYEQYF	TRBV13	TRBJ2-7
TGTGCCAGCAGCGCGGGGGGCCCATTTCAGACCCAGTACTTC	CASSAGGPFQTQYF	TRBV7-2	TRBJ2-5
TGTGCCAGGGGGTCCCAGCGGGAGGCCTACAATGAGCAGTTCTTC	CARGSQREAYNEQFF	TRBV28	TRBJ2-1
TGTGCCTGGAGTGAAAGGCACAAAACCGGGGAGCTGTTTTTT	CAWSERHKTGELFF	TRBV30	TRBJ2-2
TGTGCCAGCAGTTTCCAGGGGGAAAATCAGCCCCAGCATTTT	CASSFQGENQPQHF	TRBV27	TRBJ1-5
TGTGCCACCAGTGATCCGGTAGCGGGGACTAGCGGGAGGGAGGAAAGCCAAGAGACCCAGTACTTC	CATSDPVAGTSGREESQETQYF	TRBV24-1	TRBJ2-5
TGCGCCAGCAGCTTTACATCTAACGAGCAGTACTTC	CASSFTSNEQYF	TRBV5-1	TRBJ2-7
TGTGCCAGGCCCCGGCCCCCACGCTACGAGCAGTACTTC	CARPRPPRYEQYF	TRBV19	TRBJ2-7
TGTGCCAGCACCTGCTTACAGCAGTACTTC	CASTCLQQYF	TRBV27	TRBJ2-7
TGTGCCAGCAGCCAGGGCTACGAGCAGTACTTC	CASSQGYEQYF	TRBV6-4	TRBJ2-7
TGTGCCAGCAGCAGGGGGGGGTACGAGCAGTACTTC	CASSRGGYEQYF	TRBV2	TRBJ2-7
TGTGCCAGCCCGGGGGAGGATGGCTACACCTTC	CASPGEDGYTF	TRBV7-9	TRBJ1-2
TGTGCCATCAGTGAGTCGGCGAGGGGACAGGGGGGGTCGAACACCGGGGAGCTGTTTTTT	CAISESARGQGGSNTGELFF	TRBV10-3	TRBJ2-2
TGTGCCAGCAGCACCACGGCGGACAGGGGGCGTTTCTATAGCACAGATACGCAGTATTTT	CASSTTADRGRFYSTDTQYF	TRBV7-9	TRBJ2-3
TGTGCCAGCAGTCCCTGGACAGAGTGCACTGAAGCTTTCTTT	CASSPWTECTEAFF	TRBV7-9	TRBJ1-1
TGTGCCAGCAGCCTACAAGGGGGCTACACCTTC	CASSLQGGYTF	TRBV13	TRBJ1-2
TGTGCCAGCAGCCAAGAGGGGCTGAATCCCGTGACAGAGCAGTACTTC	CASSQEGLNPVTEQYF	TRBV14	TRBJ2-7
TGCAGTGCTAGAGATCCGGGCTTCCAGCCCCAGCATTTT	CSARDPGFQPQHF	TRBV20-1	TRBJ1-5
TGTGCCAGCAGCTTGCCTATGGGCTATGGCTACACCTTC	CASSLPMGYGYTF	TRBV9	TRBJ1-2
TGTGCCAGCAGCTTAGGGGGGGTTTACAAGTTTCCAGATACGCAGTATTTT	CASSLGGVYKFPDTQYF	TRBV7-4	TRBJ2-3
TGCGCCAGCAGTGAGCTCCTAGCATACGAGCAGTACTTC	CASSELLAYEQYF	TRBV10-1	TRBJ2-7
TGTGCCAGCAGCCTTTCTAGTCCCACAGATACGCAGTATTTT	CASSLSSPTDTQYF	TRBV5-5	TRBJ2-3
TGTGCCAGCAGCCCAGGTCCCTCAGACTTC	CASSPGPSDF	TRBV14	TRBJ2-7
TGTGCCAGCAGTTTGCAGACAACCTGGAACACTGAAGCTTTCTTT	CASSLQTTWNTEAFF	TRBV12-4	TRBJ1-1
TGTGCCGAAACAGGGACAGGGTGTAAGGATAGAAGCTCCTATAATTCACCCCTCCACTTT	CAETGTGCKDRSSYNSPLHF	TRBV10-3	TRBJ1-6
TGTGCCAGTAGTCGTAGGAACACTGAAGCTTTCTTT	CASSRRNTEAFF	TRBV19	TRBJ1-1
TGTGCCAGCGGCGGCTCGGCGAGGGGAAGGTCCTACAATGAGCAGTTCTTC	CASGGSARGRSYNEQFF	TRBV27	TRBJ2-1
TGTGCCAGCAGTTACATCCCTAGGGTACCTCTCACAGATACGCAGTATTTT	CASSYIPRVPLTDTQYF	TRBV6-6	TRBJ2-3
TGTGCCAGCAACTGCGTAAAGGGGGCCAGGCTCACTGAAGCTTTCTTT	CASNCVKGARLTEAFF	TRBV11-3	TRBJ1-1
TGTGCCAGCAGCAGCAGATACAGGGCGAGGAATTCACCCCTCCACTTT	CASSSRYRARNSPLHF	TRBV9	TRBJ1-6
TGCAGTGCGACTGGCCCCCGGACAGATCAGCCCCAGCATTTT	CSATGPRTDQPQHF	TRBV20-1	TRBJ1-5
TGCGCCAGCAGTGCTTTTGGCATGGGGACCGCCCTGGAGCCTAACTATGGCTACACCTTC	CASSAFGMGTALEPNYGYTF	TRBV10-1	TRBJ1-2
TGTGCCAGCAGCCAAGATTCAGAATCCCCCCTCGGACTAGCGGCCCACGGAGATACGCAGTATTTT	CASSQDSESPLGLAAHGDTQYF	TRBV4-2	TRBJ2-3
TGTGCCACCGGCCGGGACTCTGGAAACACCATATATTTT	CATGRDSGNTIYF	TRBV15	TRBJ1-3
TGTGCCAGCTCTTATAGAACCCGGGACCGCCATAAGAACATTCAGTACTTC	CASSYRTRDRHKNIQYF	TRBV7-2	TRBJ2-4
TGCAGTGGACAGGGTGGGTCGCTTGCAACTAATGAAAAACTGTTTTTT	CSGQGGSLATNEKLFF	TRBV20-1	TRBJ1-4
TGTGCCAGCACCGCAGGGGTTGAAGCTTTCTTT	CASTAGVEAFF	TRBV9	TRBJ1-1
TGTGCCAGCAGCCATGCTTTATGGGGCAGGGGAGTGAACACTGAAGCTTTCTTT	CASSHALWGRGVNTEAFF	TRBV14	TRBJ1-1
TGTGCCAGCACAAAGGTAGATGAAAAACTGTTTTTT	CASTKVDEKLFF	TRBV28	TRBJ1-4
TGTGCCAGCAGCCCCGAAAACCAGACAGGGAGGGATAACTATGGCTACACCTTC	CASSPENQTGRDNYGYTF	TRBV6-6	TRBJ1-2
TGTGCCAGCAGTAATGGGGGACAGGCCACGGGGCGAAATCAGCCCCAGCATTTT	CASSNGGQATGRNQPQHF	TRBV28	TRBJ1-5
TGTGCCAGCAGCGAGTCCAGGGGGTCTCACAATGAGCAGTTCTTC	CASSESRGSHNEQFF	TRBV7-6	TRBJ2-1
TGTGCCAGCAGTTACTCGCGAGGAGTCGAAAAACTGTTTTTT	CASSYSRGVEKLFF	TRBV6-2	TRBJ1-4
TGTGCCAGCAGCCATGGGGACAGGGGCAGGAACTATGGCTACACCTTC	CASSHGDRGRNYGYTF	TRBV7-3	TRBJ1-2
TGTGCCAGCAGCACAGGGCTCGGGACAGATACGCAGTATTTT	CASSTGLGTDTQYF	TRBV6-5	TRBJ2-3
TGCGCCAGCAGCCGTCGGACCGGAGCTTTCTTT	CASSRRTGAFF	TRBV4-1	TRBJ1-1
TGTGCCAGCAGCCAAGCATTCCGGGGTGGGGGACGGGACTCCTACAATGAGCAGTTCTTC	CASSQAFRGGGRDSYNEQFF	TRBV4-2	TRBJ2-1
TGCGCCAGCAGCCACCGGGACAGGGGTCTTGGCTCTGGAAACACCATATATTTT	CASSHRDRGLGSGNTIYF	TRBV4-1	TRBJ1-3
TGTGCCAGCAGCTTGAAGGACAGCTCCAATGGCTACACCTTC	CASSLKDSSNGYTF	TRBV7-2	TRBJ1-2
TGCAGTGCTGTAGGCTTAACTTGCAATCAGCCCCAGCATTTT	CSAVGLTCNQPQHF	TRBV20-1	TRBJ1-5
TGTGCCAGCAGCATGCTTGAGGTAGGGGGTTATAATTCACCCCTCCACTTT	CASSMLEVGGYNSPLHF	TRBV13	TRBJ1-6
TGCGCCAGCAGTGAACCCGAGGAACCGAACACCGGGGAGCTGTTTTTT	CASSEPEEPNTGELFF	TRBV10-1	TRBJ2-2
TGTGCCAGCAGCTTAGCACCAGGGGGGATGTCCATTGAAAAACTGTTTTTT	CASSLAPGGMSIEKLFF	TRBV11-2	TRBJ1-4
TGTGCCATCAGTGGGGGGGCTGAAGTCAATCAGCCCCAGCATTTT	CAISGGAEVNQPQHF	TRBV10-3	TRBJ1-5
TGTGCCAGCAGCAGAGGACTAGGAAGCTCCTACAATGAGCAGTTCTTC	CASSRGLGSSYNEQFF	TRBV13	TRBJ2-1
TGTGCCTGGAGTGTAAAAATGGGCCAGGGCACTGAAGCTTTCTTT	CAWSVKMGQGTEAFF	TRBV30	TRBJ1-1
TGTGCCAGCAGTTTAGAAGAGCCGGGAAGAGGGGAGGGGCCCACAGATACGCAGTATTTT	CASSLEEPGRGEGPTDTQYF	TRBV12-4	TRBJ2-3
TGCAGTGCTATCATCACAGGTAATCAGCCCCAGCATTTT	CSAIITGNQPQHF	TRBV20-1	TRBJ1-5
TGCGCCAGCATCCGACCCAGAGAAGAGACCCAGTACTTC	CASIRPREETQYF	TRBV5-1	TRBJ2-5
TGTGCCAGCAGCCAGGGGGGAATGGAAGAGACCCAGTACTTC	CASSQGGMEETQYF	TRBV6-4	TRBJ2-5
TGCAAGGATCCCACTAGCGGGAGCATGTACGAGCAGTACTTC	CKDPTSGSMYEQYF	TRBV20-1	TRBJ2-7
TGTGCCAGCAGAACAGGCTCAACCGAGGCACCAATCTCTGGGGCCAACGTCCTGACTTTC	CASRTGSTEAPISGANVLTF	TRBV6-5	TRBJ2-6
TGTGCCTTGTCGGGGGGGGGCACCCCCTACGAGCAGTACTTC	CALSGGGTPYEQYF	TRBV30	TRBJ2-7
TGTGCCAGCAGCTTTGACAGGGTGAACACCGGGGAGCTGTTTTTT	CASSFDRVNTGELFF	TRBV7-9	TRBJ2-2
TGTGCCAGCAGTTTATTTAACCCCCGGACTACCAATGAGCAGTTCTTC	CASSLFNPRTTNEQFF	TRBV27	TRBJ2-1
TGTGCCGGGGGGGTCGGGGAGTACGAGCAGTACTTC	CAGGVGEYEQYF	TRBV30	TRBJ2-7
TGTGCCAGCAGTTTATACCTTAGGCAGCCCCAGCATTTT	CASSLYLRQPQHF	TRBV27	TRBJ1-5
TGCGCCAGCAGCTCGTCGAGAGGGTGTCGCACAGATACGCAGTATTTT	CASSSSRGCRTDTQYF	TRBV10-1	TRBJ2-3
TGCAGTGCTAGAGTAACAGTTTACGAGCAGTACTTC	CSARVTVYEQYF	TRBV20-1	TRBJ2-7
TGCGCCAGCAGCTGGACCCCCCCGACTAGCGGGAGGGTGGGGGCCAACGTCCTGACTTTC	CASSWTPPTSGRVGANVLTF	TRBV5-1	TRBJ2-6
TGTGCCAGCACGGGTGAGCACAAACCGGGACTAGAATACGAGCAGTACTTC	CASTGEHKPGLEYEQYF	TRBV12-4	TRBJ2-7
TGTGCCAGCAGCTTAGAGTCCCCCTTTGGGACTAGCACGCTGTTTTTT	CASSLESPFGTSTLFF	TRBV7-2	TRBJ2-2
TGCGCCAGCAGCCAAGATCCCAGGGACAGAGGTTGCTACACCTTC	CASSQDPRDRGCYTF	TRBV4-1	TRBJ1-2
TGTGCCAGCAGTTGGGGGCAAAGAGGCTATGGCTACACCTTC	CASSWGQRGYGYTF	TRBV3-1	TRBJ1-2
TGTGCCACCAGCGGTAGGAGACGGGACAGCTCCTACGAGCAGTACTTC	CATSGRRRDSSYEQYF	TRBV15	TRBJ2-7
TGTGCCAGCAGCTTAGCGCCTCCGACCACCGGGGAGCTGTTTTTT	CASSLAPPTTGELFF	TRBV7-8	TRBJ2-2
TGTGCCAGCAGCGGTCCGGGACTAGGAGGGAACACCGGGGAGCTGTTTTTT	CASSGPGLGGNTGELFF	TRBV7-9	TRBJ2-2
TGTGCCAGCAGCCGCCCAACCGGAGTGAACACTGAAGCTTTCTTT	CASSRPTGVNTEAFF	TRBV13	TRBJ1-1
TGTGCCAGCAGCCAACGACCAATCAACAATGAGCAGTTCTTC	CASSQRPINNEQFF	TRBV14	TRBJ2-1
TGCAGTGCTAGAGCAGCCTATGGCTACACCTTC	CSARAAYGYTF	TRBV20-1	TRBJ1-2
TGTGCCAGCAGTACCTCGGCCCGAGGGGTGGGGCGCAATCAGCCCCAGCATTTT	CASSTSARGVGRNQPQHF	TRBV6-5	TRBJ1-5
TGTGCCAGCAGCTTGGGGGCGGGGAGTGAGCAGTACTTC	CASSLGAGSEQYF	TRBV11-3	TRBJ2-7
TGTGCCAGCAGTATATCCGCGGAGTGCACAGATACGCAGTATTTT	CASSISAECTDTQYF	TRBV28	TRBJ2-3
TGTGCCAGCAGTGGTCCACAGGGCATAGGGAATGAAAAACTGTTTTTT	CASSGPQGIGNEKLFF	TRBV28	TRBJ1-4
TGTGCCAGCAGCTTGGGGCATTATAATTCACCCCTCCACTTT	CASSLGHYNSPLHF	TRBV13	TRBJ1-6
TGTGCCAGGTCGGGTTGTGGGGCGGTTGTAATAAGGGCGGGGTACAATGAGCAGTTCTTC	CARSGCGAVVIRAGYNEQFF	TRBV13	TRBJ2-1
TGCGCCAGTGCCCAGGACAACGGTGACGAGCAGTACTTC	CASAQDNGDEQYF	TRBV10-1	TRBJ2-7
TGTGCCACCAGTGATTTAGAATGCGGGAACTCTGGGGCCAACGTCCTGACTTTC	CATSDLECGNSGANVLTF	TRBV24-1	TRBJ2-6
TGTGCCACCACGCCAGTTCGCCAGCCCCAGCATTTT	CATTPVRQPQHF	TRBV24-1	TRBJ1-5
TGTGCCTGGAGTAATCTTTGGGGACCGGGCTACGAGCAGTACTTC	CAWSNLWGPGYEQYF	TRBV30	TRBJ2-7
TGTGCCAGGTTTGGGGACAGGAAATCTGGGGCCAACGTCCTGACTTTC	CARFGDRKSGANVLTF	TRBV6-5	TRBJ2-6
TGTGCCAGTAGTATAGGGGCCAGGGGGTATGGCTACACCTTC	CASSIGARGYGYTF	TRBV19	TRBJ1-2
TGTGCCTGGAGTGTAAACGGAAAAAGCGGGAGGGATAGCAATCAGCCCCAGCATTTT	CAWSVNGKSGRDSNQPQHF	TRBV30	TRBJ1-5
TGTGCCACCAGTCCTACCTCCAACAGGGGCACAGATACGCAGTATTTT	CATSPTSNRGTDTQYF	TRBV24-1	TRBJ2-3
TGCGCCAGCAGCCAAGTCCCCTCCTACGAGCAGTACTTC	CASSQVPSYEQYF	TRBV4-3	TRBJ2-7
TGTGCTAGCAGTGGGACAGGGTTTCGGAACACTGAAGCTTTCTTT	CASSGTGFRNTEAFF	TRBV7-7	TRBJ1-1
TGTGCCAGCAGCTCGTCTAGCGGGGGGCTTCGTACCGGGGAGCTGTTTTTT	CASSSSSGGLRTGELFF	TRBV12-3	TRBJ2-2
TGTGCCAGCAGTTTATCCCAGAGCTATCAACCTGGAAACACCATATATTTT	CASSLSQSYQPGNTIYF	TRBV27	TRBJ1-3
TGTGCCAGCAGCGACGGGATGGGTTCGGCGAATGAGCAGTTCTTC	CASSDGMGSANEQFF	TRBV5-4	TRBJ2-1
TGTGCCAGCAGAGGGAGCGCAGTTCTCGACCAAGAGACCCAGTACTTC	CASRGSAVLDQETQYF	TRBV7-2	TRBJ2-5
TGTGCCAGCAGTTACTCGGGGGAGCCCCAAGACGGAGAGACCCAGTACTTC	CASSYSGEPQDGETQYF	TRBV6-5	TRBJ2-5
TGTGCCAGCAGCACCTCGCAGGGGGCTGCCAGTGATGGCTACACCTTC	CASSTSQGAASDGYTF	TRBV9	TRBJ1-2
TGTGCCAGCAGGAATTCACCAGCAGAGGCAGATACGCAGTATTTT	CASRNSPAEADTQYF	TRBV6-5	TRBJ2-3
TGTGCCACCTTAGGTTACACCTTC	CATLGYTF	TRBV19	TRBJ1-2
TGCAGCGTTGAAGATGAGGGAAAGGTGTCTGCCCGTCGGACGCCTAGCTCCTACAATGAGCAGTTCTTC	CSVEDEGKVSARRTPSSYNEQFF	TRBV29-1	TRBJ2-1
TGTGCCAGCAGTTACTCGACGATGCGCGGACTATATGAGCAGTTCTTC	CASSYSTMRGLYEQFF	TRBV6-5	TRBJ2-1
TGTGCCAGCAGCACCAGTGACAGGGGACCTGGAAACACCATATATTTT	CASSTSDRGPGNTIYF	TRBV7-8	TRBJ1-3
TGCGCCAGCAGCCAAGTTAGGACAGGGGAACCAGGGCGCACAGATACGCAGTATTTT	CASSQVRTGEPGRTDTQYF	TRBV4-1	TRBJ2-3
TGTGCCAGCAGTTTATCGCCCCCGGGGGCCAGCTACGAGCAGTACTTC	CASSLSPPGASYEQYF	TRBV27	TRBJ2-7
TGTGCCAGCAGTTACCCGCAGAACACTGAAGCTTTCTTT	CASSYPQNTEAFF	TRBV28	TRBJ1-1
TGTGCCAGCAGCCCACGTTTAACCGGGACAGAAAACGAGGAGAACTATGGCTACACCTTC	CASSPRLTGTENEENYGYTF	TRBV6-6	TRBJ1-2
TGTGCCAGCAGCTTAGCGCGGGACATTTCTTCCTCCGGACAGTTCTCCTACGAGCAGTACTTC	CASSLARDISSSGQFSYEQYF	TRBV7-2	TRBJ2-7
TGTGCCAGCAGGGGGTCCTACGAGCAGTACTTC	CASRGSYEQYF	TRBV6-5	TRBJ2-7
TGTGCCAGCAGCTTAGCGTGGTGGAGGCGCGATGAGCAGTTCTTC	CASSLAWWRRDEQFF	TRBV7-2	TRBJ2-1
TGTGCCAGCAGCTTGGTACGAAAGGACAGGGAGGCCGAGCAGTACTTC	CASSLVRKDREAEQYF	TRBV5-8	TRBJ2-7
TGTGCCAGCAGCTTTTGGGAACTAGCAGGTCGGGGCTACACCTTC	CASSFWELAGRGYTF	TRBV11-2	TRBJ1-2
TGCGCCAGCAGCTTGCGACATAGGGGGACAGGGGTCAATGGCTACACCTTC	CASSLRHRGTGVNGYTF	TRBV5-1	TRBJ1-2
TGTGCCAGCCGTACAGAGGGAAGCACAGATACGCAGTATTTT	CASRTEGSTDTQYF	TRBV27	TRBJ2-3
TGTGCCAGCAGCCCTATGGGACTAGCGGGAGGCTCCTACGAGCAGTACTTC	CASSPMGLAGGSYEQYF	TRBV7-9	TRBJ2-7
TGTGCCAGCAGCTCTCCCACAGGGTTAAGGCCCCCCAATCAGCCCCAGCATTTT	CASSSPTGLRPPNQPQHF	TRBV13	TRBJ1-5
TGCGCCAGCAGCTTGCCGAGTCCGCCGGACCATGGGGGGGCCTACGAGCAGTACTTC	CASSLPSPPDHGGAYEQYF	TRBV5-1	TRBJ2-7
TGTGCCAGCAGTCCCATGGCAAAAAATTCACCCCTCCACTTT	CASSPMAKNSPLHF	TRBV28	TRBJ1-6
TGTGCCTGGAGTGTAGCCGGAGTGGGCATGGACGAGCAGTACTTC	CAWSVAGVGMDEQYF	TRBV30	TRBJ2-7
TGTGCCAGCAGCAATAAGGCCAGGGACTCCTATAATTCACCCCTCCACTTT	CASSNKARDSYNSPLHF	TRBV7-7	TRBJ1-6
TGTGCCAGCAGCTTGGGGTTCGTCTCCCAAGTAAGGAGAAACACCATATATTTT	CASSLGFVSQVRRNTIYF	TRBV5-6	TRBJ1-3
TGCAAGCACCGGACAGGCGTAAGAAGCAATCAGCCCCAGCATTTT	CKHRTGVRSNQPQHF	TRBV29-1	TRBJ1-5
TGCGCCAGCAGCCGCACGACCTATAATTCACCCCTCCACTTT	CASSRTTYNSPLHF	TRBV4-3	TRBJ1-6
TGTGCCAGCAGTAGGACAGGGGGGTATAGCAATCAGCCCCAGCATTTT	CASSRTGGYSNQPQHF	TRBV6-4	TRBJ1-5
TGTGCCAGCAGCTTACATCGGGAGGGAGGGAACTATGGCTACACCTTC	CASSLHREGGNYGYTF	TRBV7-9	TRBJ1-2
TGCGCCAGCAGATGGACAGGCTATGGCTACACCTTC	CASRWTGYGYTF	TRBV5-1	TRBJ1-2
TGTGCCAGTAGAACCATCAGACCCAACACCGGGGAGCTGTTTTTT	CASRTIRPNTGELFF	TRBV19	TRBJ2-2
TGTGCCATCAGTGGAGCGAGGCTGAACACTGAAGCTTTCTTT	CAISGARLNTEAFF	TRBV10-3	TRBJ1-1
TGTGCCACCAGCAGAGATGCGGCCCTGTTTGCGAACACTGAAGCTTTCTTT	CATSRDAALFANTEAFF	TRBV15	TRBJ1-1
TGTGCCAGCAGCTTAGACAACCGGGACAGGGCAAGACGTGCCTACGAGCAGTACTTC	CASSLDNRDRARRAYEQYF	TRBV11-3	TRBJ2-7
TGTGCCAGCAGCTTAGAAGGTGGGGGGGGACGTAGCAATCAGCCCCAGCATTTT	CASSLEGGGGRSNQPQHF	TRBV11-3	TRBJ1-5
TGTGCCAGCAGTTTACCGGCTCGGACAGGGAACAGCGAGCCCCAGCATTTT	CASSLPARTGNSEPQHF	TRBV28	TRBJ1-5
TGTGCCAGGGCCATGGGGGAGTACGAGCAGTACTTC	CARAMGEYEQYF	TRBV2	TRBJ2-7
TGTGCCAGCAGAAGACAGGGCACTGAAGCTTTCTTT	CASRRQGTEAFF	TRBV6-5	TRBJ1-1
TGTGCCAGCAGCGTGTCCGGACAGGACAAAGCTTCAGACGAGCAGTACTTC	CASSVSGQDKASDEQYF	TRBV5-8	TRBJ2-7
TGTGCCAGCAGGATGCGGGAGCAACGGACTGGAAACACCATATATTTT	CASRMREQRTGNTIYF	TRBV9	TRBJ1-3
TGTGCCAGCACAAGAGAAAAGAAGACCCAGTACTTC	CASTREKKTQYF	TRBV6-2	TRBJ2-5
TGTGCCAGCCCGACAGGGGGCGTCTCCGAGCAGTACTTC	CASPTGGVSEQYF	TRBV6-1	TRBJ2-7
TGCAGTGCTAATGCGAGGGAGGGCCTATCTGGAGAAGACTACGAGCAGTACTTC	CSANAREGLSGEDYEQYF	TRBV20-1	TRBJ2-7
TGTGCCAGCAGCGTAGCCCTCGAGAAGGGACACCACGAGCAGTACTTC	CASSVALEKGHHEQYF	TRBV9	TRBJ2-7
TGCAGCGCGCGGGACAGGGGGGGCTCTGGGGCCAACGTCCTGACTTTC	CSARDRGGSGANVLTF	TRBV29-1	TRBJ2-6
TGTGCCAGCAGCACGGGACAGGGGAAGCGTAGGTTGGCCGAGCAGTACTTC	CASSTGQGKRRLAEQYF	TRBV7-3	TRBJ2-7
TGTGCCAGCAGTTTGGGACCAGACCCCTATAATTCACCCCTCCACTTT	CASSLGPDPYNSPLHF	TRBV27	TRBJ1-6
TGCAGTGCTCAGAAGAAAACCTCCCCAGGGTTGGGGTCTAACTATGGCTACACCTTC	CSAQKKTSPGLGSNYGYTF	TRBV20-1	TRBJ1-2
TGTGCCAGCAGTAGTGGGACCTACGAGCAGTACTTC	CASSSGTYEQYF	TRBV6-4	TRBJ2-7
TGTGCCAGCAGTTGCCAGGGGGCGACTGAAGCTTTCTTT	CASSCQGATEAFF	TRBV6-2	TRBJ1-1
TGTGCCAGCAGCAAGGGTCCCCGGCCGTACTTC	CASSKGPRPYF	TRBV7-2	TRBJ2-7
TGTGCCAGCAGATTAATTACCCGCAGGAACACTGAAGCTTTCTTT	CASRLITRRNTEAFF	TRBV6-1	TRBJ1-1
TGTGCCAGCAAAGGACAGGGGGCGGTCTTTACTGAAGCTTTCTTT	CASKGQGAVFTEAFF	TRBV12-3	TRBJ1-1
TGTGCCACCAGTGGGAGACTATCGCAAGAGACCCAGTACTTC	CATSGRLSQETQYF	TRBV24-1	TRBJ2-5
TGTGCCACCAGTGATTTGAACCCTAACCCCAGGGGGTATGGCTACACCTTC	CATSDLNPNPRGYGYTF	TRBV24-1	TRBJ1-2
TGTGCCAGCAGCCGGGACAGCCTTAATCAGCCCCAGCATTTT	CASSRDSLNQPQHF	TRBV7-3	TRBJ1-5
TGTGCCAGCAGTTACGGACAGGGTTTAAAGTATAGCAATCAGCCCCAGCATTTT	CASSYGQGLKYSNQPQHF	TRBV6-5	TRBJ1-5
TGCAGTGCTAGAGATGGTTGCAGGGGCACGGATGAAAAACTGTTTTTT	CSARDGCRGTDEKLFF	TRBV20-1	TRBJ1-4
TGTGCCAGCAGCCTCCCGGGACAAGGCACTAATGAAAAACTGTTTTTT	CASSLPGQGTNEKLFF	TRBV7-9	TRBJ1-4
TGTGCCAGAAAGGCGGACTATGGCTACACCTTC	CARKADYGYTF	TRBV19	TRBJ1-2
TGTGCCAGCAGCCAGGGACAGGGGGAACAGGCGAACACCGGGGAGCTGTTTTTT	CASSQGQGEQANTGELFF	TRBV7-9	TRBJ2-2
TGCAGTGCTAGAGATTGCGGCCCAGGGCACTTAGGACAAGAGACCCAGTACTTC	CSARDCGPGHLGQETQYF	TRBV20-1	TRBJ2-5
TGTGCCAGCAGCCAGAATCCTAAAGCTAACTATGGCTACACCTTC	CASSQNPKANYGYTF	TRBV7-4	TRBJ1-2
TGTGCCACCAGTGCATACCAAGGACGTAACGAGCAGTACTTC	CATSAYQGRNEQYF	TRBV24-1	TRBJ2-7
TGTGCCACCGGGAGGGGCAGGGGGCCGTATAGCAATCAGCCCCAGCATTTT	CATGRGRGPYSNQPQHF	TRBV28	TRBJ1-5
TGTGCCAGCAGTGAAGGGGGGGGCTTCCAAGAGACCCAGTACTTC	CASSEGGGFQETQYF	TRBV6-1	TRBJ2-5
TGTGCCAGCTCACTTTCCTATCAGGGCGAGCAGTACTTC	CASSLSYQGEQYF	TRBV18	TRBJ2-7
TGCAGCGTTGCACCTCAGCGGGAAGTGGAAGAGACCCAGTACTTC	CSVAPQREVEETQYF	TRBV29-1	TRBJ2-5
TGCGCCAGCAGCGAGGAGGGGTGGAACACTGAAGCTTTCTTT	CASSEEGWNTEAFF	TRBV5-1	TRBJ1-1
TGCGCCAGCCTTCGAGGGGGCGAGCAGTACTTC	CASLRGGEQYF	TRBV5-1	TRBJ2-7
TGCAGTGCTAGATGGGACAGGGACACTGAAGCTTTCTTT	CSARWDRDTEAFF	TRBV20-1	TRBJ1-1
TGTGCTAGTGGGTGCCTACATCCTTTGACGGGGCCCACTGAAGCTTTCTTT	CASGCLHPLTGPTEAFF	TRBV12-5	TRBJ1-1
TGCAGTTTGTCAGTAGAGAACACCGGGGAGCTGTTTTTT	CSLSVENTGELFF	TRBV20-1	TRBJ2-2
TGTGCCAGCCCAGTCCTTCAAGAGACCCAGTACTTC	CASPVLQETQYF	TRBV19	TRBJ2-5
TGTGCCAGAAATAGCGGGTATATGGCAGAAATCAGCTCCTACGAGCAGTACTTC	CARNSGYMAEISSYEQYF	TRBV7-3	TRBJ2-7
TGCAGTGCTCCTGATGAAACACCCGGGCCCTCCGGGACCTACAATGAGCAGTTCTTC	CSAPDETPGPSGTYNEQFF	TRBV20-1	TRBJ2-1
TGTGCCAGCAGCCATCGCCGGGGTTTCCAAACTAGTCGAAAGTACGAGCAGTACTTC	CASSHRRGFQTSRKYEQYF	TRBV3-1	TRBJ2-7
TGTGCCAGCAGTCGACCTACGGGGAATAGGGAGACCCAGTACTTC	CASSRPTGNRETQYF	TRBV6-1	TRBJ2-5
TGTGCCATCGATCACCTAGGAAAACTGTTTTTT	CAIDHLGKLFF	TRBV6-4	TRBJ1-4
TGCGCCAGCCTCGCTCTGGGGCCTCTCGACTATGGCTACACCTTC	CASLALGPLDYGYTF	TRBV10-1	TRBJ1-2
TGTGCCAGCAGTTACTCGGGCTCTCATCCTGATGTCACTGAAGCTTTCTTT	CASSYSGSHPDVTEAFF	TRBV6-5	TRBJ1-1
TGTGCCAGCACAATCACAGATACGCAGTATTTT	CASTITDTQYF	TRBV6-5	TRBJ2-3
TGTGCCAGCAGCAAACGGGGGACAGGGTTCACCTTC	CASSKRGTGFTF	TRBV7-4	TRBJ1-2
TGTGCCAGCAGTTTCGGACAGGGACGACCGCGCGAGCAGTACTTC	CASSFGQGRPREQYF	TRBV12-4	TRBJ2-7
TGTGCCAGCAGTCCTTCATGGAACAATGAGCAGTTCTTC	CASSPSWNNEQFF	TRBV6-1	TRBJ2-1
TGTGCCAGCAGCCAACTGGTTCGAGGGGACAGTGAAGCCTACGAGCAGTACTTC	CASSQLVRGDSEAYEQYF	TRBV3-1	TRBJ2-7
TGTGCCAGCAGCTTTTATCGAAGACCTAAAAGGGAGACCCAGTACTTC	CASSFYRRPKRETQYF	TRBV7-3	TRBJ2-5
TGTGCCAGCAGCACCACGTGGGACAGCTGGTATAGCAATCAGCCCCAGCATTTT	CASSTTWDSWYSNQPQHF	TRBV11-3	TRBJ1-5
TGTGCCAGCAGTCCGCACACTGAAGCTTTCTTT	CASSPHTEAFF	TRBV27	TRBJ1-1
TGTGCCAGCAGCTTGGGCCCATCGGGAGAAAAAACTGAAGCTTTCTTT	CASSLGPSGEKTEAFF	TRBV7-7	TRBJ1-1
TGTGCCACCAGCAAGTACTATTCATCCTATGGCTACACCTTC	CATSKYYSSYGYTF	TRBV15	TRBJ1-2
TGTGCCAGTAGTATCCGGGCCGGGATGCTCAATCAGCCCCAGCATTTT	CASSIRAGMLNQPQHF	TRBV19	TRBJ1-5
TGTGCCAGCAGCGTGGGAGACGGATACGAGCAGTACTTC	CASSVGDGYEQYF	TRBV9	TRBJ2-7
TGCAGTGCTAGAGTTACGGTACGTTCACCCCTCCACTTT	CSARVTVRSPLHF	TRBV20-1	TRBJ1-6
TGTGCCAGCAGCTTGCTGTGGGGCTGGGATCAGCCCCAGCATTTT	CASSLLWGWDQPQHF	TRBV5-5	TRBJ1-5
TGTGCCAGCAGTTCCTTGGTGAGCGGGATGAAGGGTCCCTACCTCCTGCCCCAGCATTTT	CASSSLVSGMKGPYLLPQHF	TRBV12-3	TRBJ1-5
TGTGCCAGCACTACAGGGGAGACCCAGTACTTC	CASTTGETQYF	TRBV27	TRBJ2-5
TGTGCCAGCAGCACGATAGGAGGGATACAGGCCAATGAACGACCCTACGAGCAGTACTTC	CASSTIGGIQANERPYEQYF	TRBV11-3	TRBJ2-7
TGCGCCAGCAGCTTCGGAATGTTGACAGATAGTTACACTGAAGCTTTCTTT	CASSFGMLTDSYTEAFF	TRBV5-1	TRBJ1-1
TGTGCCATCAGCGGGAATCGATCCTACAATGAGCAGTTCTTC	CAISGNRSYNEQFF	TRBV10-3	TRBJ2-1
TGTGCCAGCAGTTTAAAGGGACAGGGGGCTGGCGGCTATGGCTACACCTTC	CASSLKGQGAGGYGYTF	TRBV12-4	TRBJ1-2
TGTGCCAGCAGCTCTCGTAGGAAGATGAACACTGAAGCTTTCTTT	CASSSRRKMNTEAFF	TRBV5-4	TRBJ1-1
TGTGCCAGCAGTGCTTGGTACAATGAGCAGTTCTTC	CASSAWYNEQFF	TRBV6-4	TRBJ2-1
TGTCCCAACAGGGTATATGGCTACACCTTC	CPNRVYGYTF	TRBV7-2	TRBJ1-2
TGTGCCAGCAGCTTAGCGGGACAGGGAGCCAAAAACATTCAGTACTTC	CASSLAGQGAKNIQYF	TRBV11-3	TRBJ2-4
TGTGCCAGCAGCGCCCGACGAACCGAGCAGTACTTC	CASSARRTEQYF	TRBV13	TRBJ2-7
TGTGCCATCACCCTTAGCGGGGTTCGGACCCCCTACGAGCAGTACTTC	CAITLSGVRTPYEQYF	TRBV10-3	TRBJ2-7
TGTGCCACCAGTCTCCGAGGACGCTACACCTTC	CATSLRGRYTF	TRBV24-1	TRBJ1-2
TGTGCCAGCAGTTACTCGGGTGAACACCCGGGACTAGCGGGGTACAATGAGCAGTTCTTC	CASSYSGEHPGLAGYNEQFF	TRBV6-3	TRBJ2-1
TGTGCCAGCAGCACCCGGCTTAACTACGAGCAGTACTTC	CASSTRLNYEQYF	TRBV13	TRBJ2-7
TGTGCCAGCAGAGCTCGACAAATTGAGCAGTTCTTC	CASRARQIEQFF	TRBV27	TRBJ2-1
TGCAGTGCACCCCAGGGGAGAGACTATAATTCACCCCTCCACTTT	CSAPQGRDYNSPLHF	TRBV20-1	TRBJ1-6
TGTGCCAGCAGCGTAGCTCGTCTGGACTATGGCTACACCTTC	CASSVARLDYGYTF	TRBV9	TRBJ1-2
TGTGCCAGCAGCTTCGGGGGAGCGCCCGAGCAGTACTTC	CASSFGGAPEQYF	TRBV11-3	TRBJ2-7
TGTGCCAGCAGTTACCCGGGACTAGCGGGAGGTCCAAAAGGCACCGGGGAGCTGTTTTTT	CASSYPGLAGGPKGTGELFF	TRBV6-5	TRBJ2-2
TGTGCCAGCAGCCGGGACTGGTACAATGAGCAGTTCTTC	CASSRDWYNEQFF	TRBV7-3	TRBJ2-1
TGTGCCAGCAGCTTGTTCGGTGGGGACAGTAACTATGGCTACACCTTC	CASSLFGGDSNYGYTF	TRBV5-6	TRBJ1-2
TGTGCCAGCAGCGTAGTTACCTACAACACTGAAGCTTTCTTT	CASSVVTYNTEAFF	TRBV9	TRBJ1-1
TGTGCCAGCAGCTTGGGAGTCCAGGAGCAAGAGACCCAGTACTTC	CASSLGVQEQETQYF	TRBV5-6	TRBJ2-5
TGCAGTGCTAAGGTTATCCCTGAGCAGTTCTTC	CSAKVIPEQFF	TRBV20-1	TRBJ2-1
TGTGCCAGCAGTTCGGAACAAGAGACCCAGTACTTC	CASSSEQETQYF	TRBV6-4	TRBJ2-5
TGTGCCAGCAGCTTAGCCTACAGAAGACCCCCTGAGCAGTACTTC	CASSLAYRRPPEQYF	TRBV7-8	TRBJ2-7
TGCCCAAACGGCCTTCGGGACGAGCAGTACTTC	CPNGLRDEQYF	TRBV20-1	TRBJ2-7
TGTGCCAGCAGTAACCCCCCCAGACTAGGAGAGACCCAGTACTTC	CASSNPPRLGETQYF	TRBV6-5	TRBJ2-5
TGCCCAGCGGGAGATACGACTAAGCTCTATGGCTACACCTTC	CPAGDTTKLYGYTF	TRBV19	TRBJ1-2
TGTGCCAGTAGTCCGGACACGACAAATTCTGGAAACACCATATATTTT	CASSPDTTNSGNTIYF	TRBV19	TRBJ1-3
TGCGCCAGCAGAGGCATAACCTCTGGGGCCAACGTCCTGACTTTC	CASRGITSGANVLTF	TRBV10-1	TRBJ2-6
TGTGCCAGCAGCTTATACGCGCGGGAGGGTGGAGGCCTGGACTCCTACAATGAGCAGTTCTTC	CASSLYAREGGGLDSYNEQFF	TRBV7-4	TRBJ2-1
TGTGCCAGCAGCAAGCTGATCGATACGCAGTATTTT	CASSKLIDTQYF	TRBV13	TRBJ2-3
TGTGCCAGCAGCCAAGATACGGGACTAGGAAGTAGCACAGATACGCAGTATTTT	CASSQDTGLGSSTDTQYF	TRBV14	TRBJ2-3
TGTGCCAGTAGTATAGGACGTGGGGGGGAAGCAGAGCAGTTCTTC	CASSIGRGGEAEQFF	TRBV19	TRBJ2-1
TGTGCCAGCAGCCGTCCGGGACTAGCGGGAGTGAACACTGAAGCTTTCTTT	CASSRPGLAGVNTEAFF	TRBV7-3	TRBJ1-1
TGTGCCAGCAGCCCCGGACAGGCAACCACAAAACTGTTTTTT	CASSPGQATTKLFF	TRBV7-3	TRBJ1-4
TGTGCCAGCAGTCACCTACGCGCCAATCAGCCCCAGCATTTT	CASSHLRANQPQHF	TRBV25-1	TRBJ1-5
TGTGCCAGCAGCCAAAACGGGGGGGAACAATCGTTGAACACTGAAGCTTTCTTT	CASSQNGGEQSLNTEAFF	TRBV3-1	TRBJ1-1
TGTGCCAGCAGTTACGACGCGACAGTTGGCCAAGAGACCCAGTACTTC	CASSYDATVGQETQYF	TRBV6-6	TRBJ2-5
TGTGCCAGCAGTGACTCGAATAAGGGGGGGCCGGAGAACACCGGGGAGCTGTTTTTT	CASSDSNKGGPENTGELFF	TRBV6-4	TRBJ2-2
TGTGCCAGCAGCTCCCCGATGACAGGGGCGTCAAACACTGAAGCTTTCTTT	CASSSPMTGASNTEAFF	TRBV5-5	TRBJ1-1
TGTGCTAGCGCAGTATGTAGGCGGCCCTCTGGAAACACCATATATTTT	CASAVCRRPSGNTIYF	TRBV12-5	TRBJ1-3
TGTGCCAGCAGCCTAAGCAGGGCCATCGCTGGAAACACCATATATTTT	CASSLSRAIAGNTIYF	TRBV14	TRBJ1-3
TGTGCCAGCACCCAGAACCCGGGGGGGTACGAGCAGTACTTC	CASTQNPGGYEQYF	TRBV6-2	TRBJ2-7
TGTGCCAGGATCAGGGGGCAACTGTATGAAAAACTGTTTTTT	CARIRGQLYEKLFF	TRBV28	TRBJ1-4
TGTGCCAGCAGTGATTTTCGAGACGGAAACACCATATATTTT	CASSDFRDGNTIYF	TRBV12-3	TRBJ1-3
TGTGCCAGCTCCCGGAGGGTGGGCTACGAGCAGTACTTC	CASSRRVGYEQYF	TRBV18	TRBJ2-7
TGTGCCAGTAGTATTTTCTCGCCCGGGACAGATACGCAGTATTTT	CASSIFSPGTDTQYF	TRBV19	TRBJ2-3
TGTGCCAGCAGCTTAGTCCATCAGCCGTGTAGCAATCAGCCCCAGCATTTT	CASSLVHQPCSNQPQHF	TRBV13	TRBJ1-5
TGCGCCAGCAGTGAGATGGAAGGGGGCGCAGAGACCCAGTACTTC	CASSEMEGGAETQYF	TRBV10-1	TRBJ2-5
TGCGCCAGCAGGCTCATAAATGACAACTATGGCTACACCTTC	CASRLINDNYGYTF	TRBV10-1	TRBJ1-2
TGTGCCAGCAGCGGACCCTGGACCTACAATGAGCAGTTCTTC	CASSGPWTYNEQFF	TRBV11-3	TRBJ2-1
TGCAGTGGTTCGCCGACAGGGGGAAGCACTGAAGCTTTCTTT	CSGSPTGGSTEAFF	TRBV20-1	TRBJ1-1
TGCAGCGTACAAGGACGGGGTTTTCAGCCCCAGCATTTT	CSVQGRGFQPQHF	TRBV29-1	TRBJ1-5
TGTGCCAGCAGCTGGGGGACATTGGAAAAACTGTTTTTT	CASSWGTLEKLFF	TRBV11-2	TRBJ1-4
TGCAGTGCTACCAGGACAGCGGGACGTCGGTATGGCTACACCTTC	CSATRTAGRRYGYTF	TRBV20-1	TRBJ1-2
TGTGCCAGCAGCAGCCCTTCCCGGGGACAGGGGCTATGGGTTGGCTCCTATAATTCACCCCTCCACTTT	CASSSPSRGQGLWVGSYNSPLHF	TRBV7-3	TRBJ1-6
TGTGCCAGCAGCCAAGGCACGGTTCAAAGCGACATTCAGTACTTC	CASSQGTVQSDIQYF	TRBV14	TRBJ2-4
TGTGCCAGCACCGGGACAGGCGGTGCTGGAAACACCATATATTTT	CASTGTGGAGNTIYF	TRBV27	TRBJ1-3
TGTGCCAGCAGTCTTAGGAAGGGTGGAGAGACCCAGTACTTC	CASSLRKGGETQYF	TRBV6-5	TRBJ2-5
TGTGCCAGCAGCTTGGACAGGGGGATCACTGAAGCTTTCTTT	CASSLDRGITEAFF	TRBV5-4	TRBJ1-1
TGTGCCTGGAGGGACAGGGGGTGCTGTAGCAATCAGCCCCAGCATTTT	CAWRDRGCCSNQPQHF	TRBV30	TRBJ1-5
TGCGCCAGCAGCTTGGATTCCGGGGACAGGACGACCCAGTACTTC	CASSLDSGDRTTQYF	TRBV5-1	TRBJ2-5
TGCAGTGCTAGAGGGGTGGGCTACACCTTC	CSARGVGYTF	TRBV20-1	TRBJ1-2
TGTGCCAGCAGCATTCGGGGTAAGGGCGACCTCGACTATGGCTACACCTTC	CASSIRGKGDLDYGYTF	TRBV9	TRBJ1-2
TGCAGTGCCCCGGGACAGGGTCTCCACTTT	CSAPGQGLHF	TRBV20-1	TRBJ1-6
TGCAGCGGCATTAGGTCCCTCACAGGGGAAGAAGCTTTCTTT	CSGIRSLTGEEAFF	TRBV29-1	TRBJ1-1
TGTGCCAGCAGCTTACCCAGGGATCATCAGCCCCAGCATTTT	CASSLPRDHQPQHF	TRBV11-3	TRBJ1-5
TGTGCCAGCTGGGGGGGGCAAGAGACCCAGTACTTC	CASWGGQETQYF	TRBV6-6	TRBJ2-5
TGTGCCAGCAGTATATGTGCAAACAACTATGGCTACACCTTC	CASSICANNYGYTF	TRBV6-1	TRBJ1-2
TGTGCCAGCAGTTACCTACGTCAGGGAGTTAACTATGGCTACACCTTC	CASSYLRQGVNYGYTF	TRBV6-6	TRBJ1-2
TGTGCCAGCAGCCAAACCGCGGGAGCGCCTTCCACAGATACGCAGTATTTT	CASSQTAGAPSTDTQYF	TRBV3-1	TRBJ2-3
TGTGCCAGCAGTTACTCCCGCCGTGACGAGACCCAGTACTTC	CASSYSRRDETQYF	TRBV6-5	TRBJ2-5
TGTGCCAGCAGCTGGAATTCTCCGGGACATGAAAAACTGTTTTTT	CASSWNSPGHEKLFF	TRBV5-6	TRBJ1-4
