TGTGCCAATGCTGGGGGGGGAGCGCTGATCGACGAGCAGTACTTC	CANAGGGALIDEQYF	TRBV19	TRBJ2-7
TGTGCCAGCAGCGTAGAGCCTCACCGAGCGTCCTACGAGCAGTACTTC	CASSVEPHRASYEQYF	TRBV9	TRBJ2-7
TGTGCCAGCATACATTCCCGACAGCACACAGGGCTCGGCACGAACACTGAAGCTTTCTTT	CASIHSRQHTGLGTNTEAFF	TRBV12-3	TRBJ1-1
TGTGCCAGCAGCCCCCAGAGGGACACTGAAGCTTTCTTT	CASSPQRDTEAFF	TRBV5-6	TRBJ1-1
TGTGCCAGCCACTTAGAATTCGGCATGGAGACCCAGTACTTC	CASHLEFGMETQYF	TRBV6-6	TRBJ2-5
TGTGCCAGCAGTTTAACACCCACAGGGGCCCTCCACTTT	CASSLTPTGALHF	TRBV27	TRBJ1-6
TGTGCCAGCAGCCTCGGGACAGAGGCATACGAGCAGTACTTC	CASSLGTEAYEQYF	TRBV7-3	TRBJ2-7
TGTGCCGGAGGGGGGTGCGAGGCGGTGAACACTGAAGCTTTCTTT	CAGGGCEAVNTEAFF	TRBV6-5	TRBJ1-1
TGTGCCAGTGCCCTTGGGGGGCCCGAGTATACGCTTAGAGAGACCCAGTACTTC	CASALGGPEYTLRETQYF	TRBV7-9	TRBJ2-5
TGTGCCAGCAGCTTAGAATCCCATTCAGGGGACCCTGAAGCTTTCTTT	CASSLESHSGDPEAFF	TRBV7-9	TRBJ1-1
TGTGCCAGCAGCCGGGTCGTTACCTACGAGCAGTACTTC	CASSRVVTYEQYF	TRBV3-1	TRBJ2-7
TGCGCCAGCAGCCCACCTTCCATGGGAGTCTACGAGCAGTACTTC	CASSPPSMGVYEQYF	TRBV5-1	TRBJ2-7
TGTGCCAGCAGCCCCGGGGACGTTTACAATGAGCAGTTCTTC	CASSPGDVYNEQFF	TRBV11-3	TRBJ2-1
TGTGCCGCAGACGGCGTACGGAAATATGGTTCACCCCTCCACTTT	CAADGVRKYGSPLHF	TRBV30	TRBJ1-6
TGTGCCAGCAAGAGAGTGGGGGCGGAGGAAAACATTCAGTACTTC	CASKRVGAEENIQYF	TRBV5-4	TRBJ2-4
TGCTGCCCCCCTACAAGCAATCAGCCCCAGCATTTT	CCPPTSNQPQHF	TRBV20-1	TRBJ1-5
TGCGCCAGCAGCAATCTCGACAGAGGCACTGAAGCTTTCTTT	CASSNLDRGTEAFF	TRBV5-1	TRBJ1-1
TGTGCCAGTATATTGCACCGTGGGGGAGCTGAAGCTTTCTTT	CASILHRGGAEAFF	TRBV19	TRBJ1-1
TGTGCCAGCAGTCGTCGCAATATTCTCGACTCCTACGAGCAGTACTTC	CASSRRNILDSYEQYF	TRBV6-3	TRBJ2-7
TGTGCCAGCTCACCACCACACACGGGCAGTTCAAAGCAGCCCCAGCATTTT	CASSPPHTGSSKQPQHF	TRBV18	TRBJ1-5
TGTGCCAGCAGCACTTTAAGGACAGGGTTTGCCTACGAGCAGTACTTC	CASSTLRTGFAYEQYF	TRBV13	TRBJ2-7
TGTGCCAGCAGCGGCGGACACACTGAAGCTTTCTTT	CASSGGHTEAFF	TRBV7-3	TRBJ1-1
TGTGCCAGCAGCACGGGAAACACAGGGGAGGGGCACGAGCAGTACTTC	CASSTGNTGEGHEQYF	TRBV11-3	TRBJ2-7
TGTGCCACCAGTTACCAGGGGGCCGTTAGCACAGATACGCAGTATTTT	CATSYQGAVSTDTQYF	TRBV24-1	TRBJ2-3
TGTGCCAGCGTGTCACGGAACAACACCGGGGAGCTGTTTTTT	CASVSRNNTGELFF	TRBV27	TRBJ2-2
TGTGCCAGCAGCCTCCATAATCAAAATGAGCAGTTCTTC	CASSLHNQNEQFF	TRBV7-9	TRBJ2-1
TGTGCCAGCAGCAATCACGGACAGCTTGACACCGGGGAGCTGTTTTTT	CASSNHGQLDTGELFF	TRBV6-4	TRBJ2-2
TGTGCCAGCAGTTACGGCCCCCCACGCGTCGGGATATCGAACACCGGGGAGCTGTTTTTT	CASSYGPPRVGISNTGELFF	TRBV6-2	TRBJ2-2
TGTGCCAGCAGGTATCGACAGATGGATTCACCCCTCCACTTT	CASRYRQMDSPLHF	TRBV12-4	TRBJ1-6
TGTGCCAGCAGTGCGGGAGACTGGAATAGCTCCTACAATGAGCAGTTCTTC	CASSAGDWNSSYNEQFF	TRBV6-6	TRBJ2-1
TGTGCTAGTGGTCCCGAGTCAGGGACCGAGGGGTCAGACGGGGAGCTGTTTTTT	CASGPESGTEGSDGELFF	TRBV12-5	TRBJ2-2
TGTGCCAGCAGCTTACTGTGCCGGACAGATGGGCAGCCCCAGCATTTT	CASSLLCRTDGQPQHF	TRBV7-9	TRBJ1-5
TGTGCCAGTAGTATGGACAACACTGAAGCTTTCTTT	CASSMDNTEAFF	TRBV19	TRBJ1-1
TGTGCCAGCAGCTTAGATCTCGGGGGAATAAGCTACGAGCAGTACTTC	CASSLDLGGISYEQYF	TRBV7-6	TRBJ2-7
TGTGCCAGCAGTATGCCGGGGCGGGAGGGCTCCTACGAGCAGTACTTC	CASSMPGREGSYEQYF	TRBV6-4	TRBJ2-7
TGTGCCAGCAGGGAGGGGGGGGGCTACACCTTC	CASREGGGYTF	TRBV6-4	TRBJ1-2
TGCGCCAGCAGCTTGAAACCCCACCAGATTGCAACTAATGAAAAACTGTTTTTT	CASSLKPHQIATNEKLFF	TRBV5-1	TRBJ1-4
TGTGCCAGCAGTTTAAAGACAGGGGGAATGAACACTGAAGCTTTCTTT	CASSLKTGGMNTEAFF	TRBV27	TRBJ1-1
TGCAGTACACAGGGTGGGAATCAGCCCCAGCATTTT	CSTQGGNQPQHF	TRBV20-1	TRBJ1-5
TGCAGTGGTCCCTTGAGGGGTAACCACTTCTACAATGAGCAGTTCTTC	CSGPLRGNHFYNEQFF	TRBV20-1	TRBJ2-1
TGTGCCAGCAGTCAGGGCCGTCCCTATGGCTACACCTTC	CASSQGRPYGYTF	TRBV27	TRBJ1-2
TGTGCCAGCATCCCAGGGGGAAAGGCAGATACGCAGTATTTT	CASIPGGKADTQYF	TRBV12-3	TRBJ2-3
TGTGCTAGTGGTTTCGGACTAGTGGACACCGGGGAGCTGTTTTTT	CASGFGLVDTGELFF	TRBV12-5	TRBJ2-2
TGTGCCAGCAGCTCGCCTAGCGGTTGGGACCAAGAGACCCAGTACTTC	CASSSPSGWDQETQYF	TRBV13	TRBJ2-5
TGTGCCAGCAGCTGGCCTGCAGGGATGGAGACCCAGTACTTC	CASSWPAGMETQYF	TRBV7-3	TRBJ2-5
TGTGCCAGCAGCGGGTCAGAGGGTAAAGCGAGCTCCTACGAGCAGTACTTC	CASSGSEGKASSYEQYF	TRBV5-5	TRBJ2-7
TGCGCCAGCAGCTTCCCGGATAATGGGGGGGATGAGCAGTTCTTC	CASSFPDNGGDEQFF	TRBV5-1	TRBJ2-1
TGTGCCAGCAGCCAAATCCGGGACAGGGGAAATCAGCCCCAGCATTTT	CASSQIRDRGNQPQHF	TRBV7-2	TRBJ1-5
TGTGCCAGATATACCAGGGGCAAAAACATTCAGTACTTC	CARYTRGKNIQYF	TRBV28	TRBJ2-4
TGCAGCGTTAAGTATAGTAACGGGGCCAATCAGCCCCAGCATTTT	CSVKYSNGANQPQHF	TRBV29-1	TRBJ1-5
TGTGCCATCAGTGAGCGGGCTGAGATTTTAGGCTATGGCTACACCTTC	CAISERAEILGYGYTF	TRBV10-3	TRBJ1-2
TGTGCCAGCAGTGACTCGACGAGACAGGGGGCGCCGGGGAACACTGAAGCTTTCTTT	CASSDSTRQGAPGNTEAFF	TRBV6-4	TRBJ1-1
TGTGCGACAGGCTACACCTTC	CATGYTF	TRBV24-1	TRBJ1-2
TGTGCCAGCAGCCCCCCCTCCCCCAATAAGAACACTGAAGCTTTCTTT	CASSPPSPNKNTEAFF	TRBV14	TRBJ1-1
TGTGCCAGCAGTTCACAATGGGGGCATAAGAACAATCAGCCCCAGCATTTT	CASSSQWGHKNNQPQHF	TRBV27	TRBJ1-5
TGTGCCAGCAGTTATTTCCCGGGACTAGCGGGTGAGCAGTTCTTC	CASSYFPGLAGEQFF	TRBV6-3	TRBJ2-1
TGTGCCAGCAGCTGGGTTTGTCGGGGGCTCGGCTCACAGGACACTGAAGCTTTCTTT	CASSWVCRGLGSQDTEAFF	TRBV13	TRBJ1-1
TGTGCCAGCGCGGGTCGACGGACTAGTCATTTGACCTCCTACGAGCAGTACTTC	CASAGRRTSHLTSYEQYF	TRBV6-1	TRBJ2-7
TGTGCCAGCAGCTTAGACTTTTTGGGACAGAATTACACCTTC	CASSLDFLGQNYTF	TRBV11-3	TRBJ1-2
TGTGCCAGCAGGATGTTAAACGGGACTAGCCAGGATACGCAGTATTTT	CASRMLNGTSQDTQYF	TRBV6-1	TRBJ2-3
TGTGCCAGCAGCCGGATGCGGGGAGACTACACCGGGGAGCTGTTTTTT	CASSRMRGDYTGELFF	TRBV5-6	TRBJ2-2
TGCGCCAGGCCGGGACAGGGGCTCGGAACCGGGGAGCTGTTTTTT	CARPGQGLGTGELFF	TRBV4-1	TRBJ2-2
TGTGCCACCAGCAGGCTCCAAGATAGGCGGAACACCGGGGAGCTGTTTTTT	CATSRLQDRRNTGELFF	TRBV15	TRBJ2-2
TGCGCCAGCTCCAGCGGGGCCTACGAGCAGTACTTC	CASSSGAYEQYF	TRBV10-1	TRBJ2-7
TGTGCCAGCAGTTTACCCTTCAGGGGGAATTCAAACACTGAAGCTTTCTTT	CASSLPFRGNSNTEAFF	TRBV27	TRBJ1-1
TGTGCCATTGAAGGGACGCTACATGGCTACACCTTC	CAIEGTLHGYTF	TRBV6-5	TRBJ1-2
TGTGCCAGCAGCCAAGAGTTGGACCCAAGAACTAGCGGGAGTCCAGGGTCGTTGGAAGAGACCCAGTACTTC	CASSQELDPRTSGSPGSLEETQYF	TRBV3-1	TRBJ2-5
TGCAGTGCTAGAGGCACAGGGGTTTATTGGGTCCAAGAGACCCAGTACTTC	CSARGTGVYWVQETQYF	TRBV20-1	TRBJ2-5
TGTGCCAGCAGCCCCTGGGGGGCAGGCTCCTACGAGCAGTACTTC	CASSPWGAGSYEQYF	TRBV11-3	TRBJ2-7
TGTGCCAGCTCACCAGGTGGACAGGGGGCTTTAACTGAAGCTTTCTTT	CASSPGGQGALTEAFF	TRBV18	TRBJ1-1
TGTGCCAGCTCTTGTGGGACAGGGTGGGGTACTACTAGTCGCATTCAGTACTTC	CASSCGTGWGTTSRIQYF	TRBV18	TRBJ2-4
TGTGCCAGCAGGACAGGGGGGGGGAGCACAGATACGCAGTATTTT	CASRTGGGSTDTQYF	TRBV6-4	TRBJ2-3
TGTGCCACCAGTGAAATCTGCCGGGACACGAGCATAAAGAGCTCTGGAAACACCATATATTTT	CATSEICRDTSIKSSGNTIYF	TRBV24-1	TRBJ1-3
TGTGCCCGGGGGACGGGCAATCAGCCCCAGCATTTT	CARGTGNQPQHF	TRBV10-3	TRBJ1-5
TGTGCCAGCAGCTTACGGGCCGATTCCCCCCGGGGTAGCTCCTACAATGAGCAGTTCTTC	CASSLRADSPRGSSYNEQFF	TRBV7-9	TRBJ2-1
TGTGCCAGCAGTGGAGGTTACTGGTATGGCTACACCTTC	CASSGGYWYGYTF	TRBV12-4	TRBJ1-2
TGTGCCAGCAGTGACAGGGGGGCGAAGGAAGCTTTCTTT	CASSDRGAKEAFF	TRBV2	TRBJ1-1
TGTGCCAAAGGGACCGAGCAGTACTTC	CAKGTEQYF	TRBV9	TRBJ2-7
TGTGCTAGTGGTTTGAATAGTGGACCCTTTCGGACAGGGTGGGGTAACACCGGGGAGCTGTTTTTT	CASGLNSGPFRTGWGNTGELFF	TRBV12-5	TRBJ2-2
TGTGCCAGCAGTTACCCCGCTTACGGACAGTTCCCGAATCGGAATGAGCAGTTCTTC	CASSYPAYGQFPNRNEQFF	TRBV6-3	TRBJ2-1
TGCAGCGGACGGAGGCATGGCTACACCTTC	CSGRRHGYTF	TRBV29-1	TRBJ1-2
TGTGCCACCAGCGGGGGGGGGCGCTATAATTCACCCCTCCACTTT	CATSGGGRYNSPLHF	TRBV15	TRBJ1-6
TGTGCCAGCAGCTATATACCAGAGTCCCAAGAGACCCAGTACTTC	CASSYIPESQETQYF	TRBV5-4	TRBJ2-5
TGCAGTGCTAAAATTCCTGGCTACAATGAGCAGTTCTTC	CSAKIPGYNEQFF	TRBV20-1	TRBJ2-1
TGCAGTGCTAGACCCGAGTTTTCCGAGCAGTACTTC	CSARPEFSEQYF	TRBV20-1	TRBJ2-7
TGTGCCAGTAGTATAGGTAAGGACTCAGAGACCCAGTACTTC	CASSIGKDSETQYF	TRBV19	TRBJ2-5
TGTGCCAGCAGACCGGGACAGAGCGAGCAGTACTTC	CASRPGQSEQYF	TRBV9	TRBJ2-7
TGCGCCAGCAGCGACCGACTAGCGGGGGGGTTGGGATTAGAGCAGTTCTTC	CASSDRLAGGLGLEQFF	TRBV10-1	TRBJ2-1
TGTGCCAGCAGCGGCAGGTGGAATGAAAAACTGTTTTTT	CASSGRWNEKLFF	TRBV6-5	TRBJ1-4
TGCAGTGCAAGGATACTACCCGGGGCAGAGACCCAGTACTTC	CSARILPGAETQYF	TRBV20-1	TRBJ2-5
TGTGCCAGTAGTACCCCCCAGGGGGCTCCTAACTATGGCTACACCTTC	CASSTPQGAPNYGYTF	TRBV19	TRBJ1-2
TGTGCCTGGATACCCGGGACAGGGGGCTCCCCTGGAAACACCATATATTTT	CAWIPGTGGSPGNTIYF	TRBV30	TRBJ1-3
TGCGCCAGCAGGGACAGGGGCGACTATGGCTACACCTTC	CASRDRGDYGYTF	TRBV5-1	TRBJ1-2
TGTGCCAGCAGCGTAGCTCTGGGGATCTCGAACACCGGGGAGCTGTTTTTT	CASSVALGISNTGELFF	TRBV9	TRBJ2-2
TGTGCCAGCACTCGATGGGGCCCCTACGAGCAGTACTTC	CASTRWGPYEQYF	TRBV6-1	TRBJ2-7
TGTGCCAGCAGCCAAGTGCGACGAAAGAGGGAGGGAATTTTGCTCACTGAAGCTTTCTTT	CASSQVRRKREGILLTEAFF	TRBV3-1	TRBJ1-1
TGTGCCAGCAGCAGCCCCGGGGGGGGTTCCTACGAGCAGTACTTC	CASSSPGGGSYEQYF	TRBV9	TRBJ2-7
TGTGCCAGGGTCTTACTCAAACAGGGGGGGGTCGCAACTAATGAAAAACTGTTTTTT	CARVLLKQGGVATNEKLFF	TRBV27	TRBJ1-4
TGCGCCAGCAGCATTTGGACAGTGGCCTACGAGCAGTACTTC	CASSIWTVAYEQYF	TRBV5-1	TRBJ2-7
TGTGCCAGCAGGAGACAGGGTACTGGTCTAGCCAAAAACATTCAGTACTTC	CASRRQGTGLAKNIQYF	TRBV6-6	TRBJ2-4
TGTGCCACCAATCATCGCCCAACTAGCGGGAGGCACCAGACCCAGTACTTC	CATNHRPTSGRHQTQYF	TRBV24-1	TRBJ2-5
TGTGCCTGGCTCGAGGGGGCAGGACAGGGATGGTATCAGCCCCAGCATTTT	CAWLEGAGQGWYQPQHF	TRBV30	TRBJ1-5
TGCAGAGAACAAGTCTGGGGTAGAATCGGCACAGATACGCAGTATTTT	CREQVWGRIGTDTQYF	TRBV20-1	TRBJ2-3
TGTGCCAGCCCGACAGGGGATACGCAGTATTTT	CASPTGDTQYF	TRBV6-8	TRBJ2-3
TGTGCCAGCAGTGCAGGTGAGAACACTGAAGCTTTCTTT	CASSAGENTEAFF	TRBV6-5	TRBJ1-1
TGTGCCAGCAGCTACTTCCGGGACAGGAACACCGGGGAGCTGTTTTTT	CASSYFRDRNTGELFF	TRBV7-2	TRBJ2-2
TGTGCCAGCAGCTTAGAATTGCCTACCCCCACGCGAGGGAGAGTTAGGAGGTCCACAGATACGCAGTATTTT	CASSLELPTPTRGRVRRSTDTQYF	TRBV11-2	TRBJ2-3
TGCAGCGTTGGATGGACAGGGGAATGTTCACCCCTCCACTTT	CSVGWTGECSPLHF	TRBV29-1	TRBJ1-6
TGTGCCAGCAGCCAAGGTCACCAGGGGGGAGTTAATTCACCCCTCCACTTT	CASSQGHQGGVNSPLHF	TRBV4-2	TRBJ1-6
TGTGCCAGGCCCCCGGGCGGTCACCGCACCGGGGAGCTGTTTTTT	CARPPGGHRTGELFF	TRBV7-9	TRBJ2-2
TGCGCCAGCAGCCAAGCCGAGGGGGGCCCAAGGGATGGCTACACCTTC	CASSQAEGGPRDGYTF	TRBV4-1	TRBJ1-2
TGTGCCAGCAGTTTAAAAGTGGACAGGGCAACCTACGAGCAGTACTTC	CASSLKVDRATYEQYF	TRBV12-3	TRBJ2-7
TGTGCCATCAAACGGACAGGGTATGCCAATCAGCCCCAGCATTTT	CAIKRTGYANQPQHF	TRBV10-3	TRBJ1-5
TGCGCCAGCAGCTTACGGGGCCGCGAGCAGTACTTC	CASSLRGREQYF	TRBV5-1	TRBJ2-7
TGTGCTAGTGGCCCCGGGGGTTACTCTGGGGCCAACGTCCTGACTTTC	CASGPGGYSGANVLTF	TRBV12-5	TRBJ2-6
TGTGCCAGCAGTTGTAGGGCTATCCAGGCCGAGACCCAGTACTTC	CASSCRAIQAETQYF	TRBV27	TRBJ2-5
TGTGCCAGCAGCGGGGGGGGGGAGGAGGGCTCCTACGAGCAGTACTTC	CASSGGGEEGSYEQYF	TRBV7-2	TRBJ2-7
TGTGCCAGCAGCTGTTCACGGCGGGGCAATGAGCAGTTCTTC	CASSCSRRGNEQFF	TRBV7-6	TRBJ2-1
TGCGCCAGCAAACACGGTGGGGGCTCGGAGCAGTACTTC	CASKHGGGSEQYF	TRBV10-1	TRBJ2-7
TGTGCCAGCTCACCACGGGCGCCGGGGGGGCAGCGTGAGGCCTACGAGCAGTACTTC	CASSPRAPGGQREAYEQYF	TRBV18	TRBJ2-7
TGTGCCTGGAATAACAGGACTCAGACCCAGTACTTC	CAWNNRTQTQYF	TRBV30	TRBJ2-5
TGTGCCAGCAGCTGCCGTAGGCAGTCCAACACCGGGGAGCTGTTTTTT	CASSCRRQSNTGELFF	TRBV7-9	TRBJ2-2
TGTGCCAGCAGCCAATTCCCAGGGACTGAAGCTTTCTTT	CASSQFPGTEAFF	TRBV3-1	TRBJ1-1
TGCGCCAGCAGCTCTCCCGGGGGGTCCACCTACTTTGGACGGAACACTGAAGCTTTCTTT	CASSSPGGSTYFGRNTEAFF	TRBV5-1	TRBJ1-1
TGTGCCAGCAGCCGTCCACTTCGGGGGGCGTACGAGGACCAAGAGACCCAGTACTTC	CASSRPLRGAYEDQETQYF	TRBV9	TRBJ2-5
TGTGCCAGGGGGATACAGCTCGACGGTGAGCAGTTCTTC	CARGIQLDGEQFF	TRBV7-8	TRBJ2-1
TGCAGCGTTGATTTTCCGGGTCCGGACAGGAGGGCGAATCACGAGCAGTACTTC	CSVDFPGPDRRANHEQYF	TRBV29-1	TRBJ2-7
TGTGCCACCTGCGGGACACCAGATACGCAGTATTTT	CATCGTPDTQYF	TRBV24-1	TRBJ2-3
TGTGCCAGCAGCAGCCGGGACAGGGCGTGCGAGCAGTACTTC	CASSSRDRACEQYF	TRBV7-4	TRBJ2-7
TGTGCCTGGAGTGTACGAAAACCAGGGCATCAGCAGTACTTC	CAWSVRKPGHQQYF	TRBV30	TRBJ2-7
TGCCCTACTGACCCGAACACCGGGGAGCTGTTTTTT	CPTDPNTGELFF	TRBV6-1	TRBJ2-2
TGCAGTGCTAGCTTGACTAGCGGGAAGGTTCACAATGAGCAGTTCTTC	CSASLTSGKVHNEQFF	TRBV20-1	TRBJ2-1
TGTGCCAGCAGCTTAGAACTGGGCTCTGGCTCCTACAATGAGCAGTTCTTC	CASSLELGSGSYNEQFF	TRBV11-2	TRBJ2-1
TGTGCCAGCAGTTACCCCCGGGGACTAGCGGGGATCCTTTACGAGCAGTACTTC	CASSYPRGLAGILYEQYF	TRBV6-2	TRBJ2-7
TGTGCCATCAGGTTTCAGTTAACAGGGGGCGAGTACTATGGCTACACCTTC	CAIRFQLTGGEYYGYTF	TRBV10-3	TRBJ1-2
TGTTATTCCCGCAGGGCATTACTTACCTACGAGCAGTACTTC	CYSRRALLTYEQYF	TRBV7-9	TRBJ2-7
TGCGCCAGCAGCCATAGGCCCGCGAATAGCAATCAGCCCCAGCATTTT	CASSHRPANSNQPQHF	TRBV5-1	TRBJ1-5
TGTGCCAGCAGCTTACCAATGGTGACCTATCAGCCCCAGCATTTT	CASSLPMVTYQPQHF	TRBV7-9	TRBJ1-5
TGTGCCAGCAGCGGTACCCCCGGGGCCCCCGGGGCCAATGAGCAGTTCTTC	CASSGTPGAPGANEQFF	TRBV9	TRBJ2-1
TGTGCCAGCAGCCAAGAAAACACGACTCAGCCCCAGCATTTT	CASSQENTTQPQHF	TRBV14	TRBJ1-5
TGCGCCAGCAGCCAAGATGAATGGGGGGGTTTGGGACGGTATGGGGAGACCCAGTACTTC	CASSQDEWGGLGRYGETQYF	TRBV4-1	TRBJ2-5
TGCCTGTTAAGGCTAGCGGGGCAGTACAATGAGCAGTTCTTC	CLLRLAGQYNEQFF	TRBV20-1	TRBJ2-1
TGTGCCAGCAGTGAAGACAGGGGGACCTATAATTCACCCCTCCACTTT	CASSEDRGTYNSPLHF	TRBV2	TRBJ1-6
TGTGCCACCAGCAACACGGTTACGGCGAACACCGGGGAGCTGTTTTTT	CATSNTVTANTGELFF	TRBV15	TRBJ2-2
TGTGCCACCAGGGGCTCCCCGGGACAGGTCCCTACTGAAGCTTTCTTT	CATRGSPGQVPTEAFF	TRBV24-1	TRBJ1-1
TGTGCCAGCAGTAGAACGGACAGGTATAAGCCCCAGCATTTT	CASSRTDRYKPQHF	TRBV27	TRBJ1-5
TGTGCCCCCACGGGACAGGGGGCCTCCTATAATTCACCCCTCCACTTT	CAPTGQGASYNSPLHF	TRBV12-4	TRBJ1-6
TGCGCCAGCAGCCAAGTTCTTAGGACAGGGAGGAATCAGCCCCAGCATTTT	CASSQVLRTGRNQPQHF	TRBV4-1	TRBJ1-5
TGCGCCAGCAGTGAGATTCACACCTACGAGCAGTACTTC	CASSEIHTYEQYF	TRBV10-2	TRBJ2-7
TGTGCCAGCAGCCTCCCGGGACGAGCTTTCTTT	CASSLPGRAFF	TRBV13	TRBJ1-1
TGTGCCAGCAGCTTAAGCGGGAGAATGTACGAGCAGTACTTC	CASSLSGRMYEQYF	TRBV13	TRBJ2-7
TGTGCCAGCAGTGGAGATGGCGACACCGGGGAGCTGTTTTTT	CASSGDGDTGELFF	TRBV12-3	TRBJ2-2
TGTGCCAGCAGCACCCACCCGATGACAGGGAGGACCGGGGAGCTGTTTTTT	CASSTHPMTGRTGELFF	TRBV7-7	TRBJ2-2
TGTGCCACCAGTGATTTAACCTTCTTCCGAGTGGGGGGCCCGGCGAACACCGGGGAGCTGTTTTTT	CATSDLTFFRVGGPANTGELFF	TRBV24-1	TRBJ2-2
TGTGCCAGCACCCTAGGGGGGGATGATACTGAGTACTTC	CASTLGGDDTEYF	TRBV12-3	TRBJ2-7
TGTGCCAGTAGTATAGATACGACTAGAAGGGAGACCCAGTACTTC	CASSIDTTRRETQYF	TRBV19	TRBJ2-5
TGTGCCAGCAGTTTAGGGCCGGGGACTAGCACAGATACGCAGTATTTT	CASSLGPGTSTDTQYF	TRBV12-3	TRBJ2-3
TGTGCCAGCAGAAGACCGGGGGGAGTCACTGAAGCTTTCTTT	CASRRPGGVTEAFF	TRBV6-4	TRBJ1-1
TGTGCCAGCAGCCAGTTTCACAGGGGAGGCTACGAGCAGTACTTC	CASSQFHRGGYEQYF	TRBV14	TRBJ2-7
TGTGCCTGGGCCGGGACTAGCGGGGGGGCAACTTGGGGGGGTACCTACGAGCAGTACTTC	CAWAGTSGGATWGGTYEQYF	TRBV30	TRBJ2-7
TGTGCCAGTTCCGGCAGGGGGTTTGGCTACACCTTC	CASSGRGFGYTF	TRBV27	TRBJ1-2
TGCGCCAGCAGCTTGGGGAATGAGGACAGAGAGGGAGGAATGAACACTGAAGCTTTCTTT	CASSLGNEDREGGMNTEAFF	TRBV5-1	TRBJ1-1
TGTGCCAGTAGTATCTTACCGACCGGGCCGCAAGCAGATACGCAGTATTTT	CASSILPTGPQADTQYF	TRBV19	TRBJ2-3
TGCGCCAGCGGATTTTGGGGAGCGAACGAGCAGTACTTC	CASGFWGANEQYF	TRBV5-1	TRBJ2-7
TGTGCCAGCAGCTTAACAAAGGACTCGGTTGGGTACGAGCAGTACTTC	CASSLTKDSVGYEQYF	TRBV11-2	TRBJ2-7
TGTGCCACCAGTGCGTTTGGGAGGAACACCGGGGAGCTGTTTTTT	CATSAFGRNTGELFF	TRBV24-1	TRBJ2-2
TGTGCCAGTACCGGCTTAGTTCCCGGGAACGGACAGTACTTC	CASTGLVPGNGQYF	TRBV19	TRBJ2-7
TGTGCCAGCCCCTGGACTAGTTCCTACGAGCAGTACTTC	CASPWTSSYEQYF	TRBV6-3	TRBJ2-7
TGCGCCAGCACGGGCCTAATCTGTGAGCAGTACTTC	CASTGLICEQYF	TRBV5-1	TRBJ2-7
TGTGCCAGCAGCGTAGCTAGACCAAGGGTACACGAAAAACTGTTTTTT	CASSVARPRVHEKLFF	TRBV9	TRBJ1-4
TGTGCCAGCTCTCGGGGGGCCCTCACAGATACGCAGTATTTT	CASSRGALTDTQYF	TRBV2	TRBJ2-3
TGCAGTGCTAGAGCCCGCGGGAAGGAGCAGTACTTC	CSARARGKEQYF	TRBV20-1	TRBJ2-7
TGTGCCGATAGTGCTAGCACAGATACGCAGTATTTT	CADSASTDTQYF	TRBV7-4	TRBJ2-3
TGTGCCAGCAGTTACGTTTCCGTTATCTCATTGAACGAGCAGTACTTC	CASSYVSVISLNEQYF	TRBV6-5	TRBJ2-7
TGCAGTGCTAGATGCATTAGTCGACAGTTATTGGAGCAAGAGACCCAGTACTTC	CSARCISRQLLEQETQYF	TRBV20-1	TRBJ2-5
TGTGCCAGCAGCGGAGTAGACAGGGGTCGCAATCAGCCCCAGCATTTT	CASSGVDRGRNQPQHF	TRBV7-6	TRBJ1-5
TGTGCCAGCAGCTCCCGGCCGGGACAGGGGTATAATTCACCCCTCCACTTT	CASSSRPGQGYNSPLHF	TRBV7-9	TRBJ1-6
TGTGCCTGGAGTGTATGTCGGGACAACTACGAGCAGTACTTC	CAWSVCRDNYEQYF	TRBV30	TRBJ2-7
TGCAGTGCTAGGGCGCGGGGGTGGACACCCCTCCACTTT	CSARARGWTPLHF	TRBV20-1	TRBJ1-6
TGTGCCAGCAGGCGTGGACAGGGTCGAGAAAAACTGTTTTTT	CASRRGQGREKLFF	TRBV5-6	TRBJ1-4
TGTGCCAGCAGCTTGCCCCCGCACAGGGCCCGGCGCACAGATACGCAGTATTTT	CASSLPPHRARRTDTQYF	TRBV7-2	TRBJ2-3
TGCAGCGGTAGGACAGGCTCCTACGAGCAGTACTTC	CSGRTGSYEQYF	TRBV29-1	TRBJ2-7
TGTGCCAGCAGCTTAGTTGCATCTGAGCGGGGGGATGACAATGAGCAGTTCTTC	CASSLVASERGDDNEQFF	TRBV11-3	TRBJ2-1
TGTGCCAGCACGCCGGGCGGTAGGGGCAATGAGCAGTTCTTC	CASTPGGRGNEQFF	TRBV7-9	TRBJ2-1
TGTGCCTGGAGTGGGACAGGGGGATCGCTGTATGGCTACACCTTC	CAWSGTGGSLYGYTF	TRBV30	TRBJ1-2
TGTGCCACCAGTGATCCGAACGGGATGGTTTCCTCACAGCCCCAGCATTTT	CATSDPNGMVSSQPQHF	TRBV24-1	TRBJ1-5
TGCGCCAGCAGCCACCAGGACAGGGCGATCTACTATGGCTACACCTTC	CASSHQDRAIYYGYTF	TRBV4-1	TRBJ1-2
TGTGCCAGCAGCCAAGATACGGTACAGGGCGCCTACGAGCAGTACTTC	CASSQDTVQGAYEQYF	TRBV4-2	TRBJ2-7
TGTGCTAGTGGTTTGGGGCTAGCGGGGGTCGAGCAGTACTTC	CASGLGLAGVEQYF	TRBV12-5	TRBJ2-7
TGTGCCAGCAGTTCCACCTCAGGGACTGAAGGCAATCAGCCCCAGCATTTT	CASSSTSGTEGNQPQHF	TRBV28	TRBJ1-5
TGTGCCAGCACGTGGAAGGGGCGGTCAACCGGGGAGCTGTTTTTT	CASTWKGRSTGELFF	TRBV27	TRBJ2-2
TGTGCCAGCAGCCAAGACAGGGAACAGCCCCAGCATTTT	CASSQDREQPQHF	TRBV3-1	TRBJ1-5
TGTGCCAGCAGCCGGGGGGGGGCAGTTGAGCAGTTCTTC	CASSRGGAVEQFF	TRBV4-2	TRBJ2-1
TGTGCCAGGGGACAGAAGATCTACGAGCAGTACTTC	CARGQKIYEQYF	TRBV28	TRBJ2-7
TGTGCCAGTAAAAACTGGGACAGATCTACCACGCAGTATTTT	CASKNWDRSTTQYF	TRBV19	TRBJ2-3
TGTGCCAGCAGTACCCAGTGGGGAGTCACTGAAGCTTTCTTT	CASSTQWGVTEAFF	TRBV27	TRBJ1-1
TGTGCCAGCAGTGACAGAGGGGAGACTAACTATGGCTACACCTTC	CASSDRGETNYGYTF	TRBV6-4	TRBJ1-2
TGTGCCAGCAGCGTAGCGGGACTAGCGGGGGAGCAGACGGGGGAGGAGCTAAGCTCCTACAATGAGCAGTTCTTC	CASSVAGLAGEQTGEELSSYNEQFF	TRBV9	TRBJ2-1
TGTGCCAGCAGTTACCTAGGGGCTGAAGCTTTCTTT	CASSYLGAEAFF	TRBV6-6	TRBJ1-1
TGTGCCAGCAGTTACCAGGGAAGCTACGAGCAGTACTTC	CASSYQGSYEQYF	TRBV6-5	TRBJ2-7
TGCGCCAGCAGCCAAGACCCTGTTTCGAGCTATGGCTACACCTTC	CASSQDPVSSYGYTF	TRBV4-1	TRBJ1-2
TGTGCCAGCAAGATATGGACAGGGGAGCTAAGGCGCTCACCCCTCCACTTT	CASKIWTGELRRSPLHF	TRBV6-4	TRBJ1-6
TGCGCCAGCAGCTTGCGGGACGGCTACCCAGAGCAGTTCTTC	CASSLRDGYPEQFF	TRBV5-1	TRBJ2-1
TGTGCCACCAGCAGAGATTTTTCTACACTCGCAACTAATGAAAAACTGTTTTTT	CATSRDFSTLATNEKLFF	TRBV15	TRBJ1-4
TGTGCCAGCAGGCCCGGGACAGGGTCCCAGGGGATAAACACTGAAGCTTTCTTT	CASRPGTGSQGINTEAFF	TRBV6-2	TRBJ1-1
TGTGCCAGCAGCAGACGGTGGTGTGGAAACACCATATATTTT	CASSRRWCGNTIYF	TRBV9	TRBJ1-3
TGTGCCAGCAGCAAATTCAGGGGACCCTATGGCTACACCTTC	CASSKFRGPYGYTF	TRBV9	TRBJ1-2
TGTGCCAGCAGTTTTCTCGGGACAGGTTTCTCTGGGGCCAACGTCCTGACTTTC	CASSFLGTGFSGANVLTF	TRBV6-8	TRBJ2-6
TGCGCCAGCAGTGCCTCGGTTACAGGGGGGTACACTGAAGCTTTCTTT	CASSASVTGGYTEAFF	TRBV10-1	TRBJ1-1
TGTGCCAGCAGCTTCCGGAGGAAACTGTTTTTT	CASSFRRKLFF	TRBV7-9	TRBJ1-4
TGTGCCAGCGAACACAGGGGAAGCGAGACCCAGTACTTC	CASEHRGSETQYF	TRBV28	TRBJ2-5
TGTGCCAGCAGTGTTCAAGCGGGAATTCCAAATGAAAAACTGTTTTTT	CASSVQAGIPNEKLFF	TRBV27	TRBJ1-4
TGTGCCAGCAGCCAAGATTGGAGGGGCAGGACGGGGATCCAAGAGACCCAGTACTTC	CASSQDWRGRTGIQETQYF	TRBV4-2	TRBJ2-5
TGTGCCAGCAGCCCAGGACTTTACTACGAGCAGTACTTC	CASSPGLYYEQYF	TRBV27	TRBJ2-7
TGTGCCAGCAGCGTAGGGTCGAGGGGCCGTGGCTACACCTTC	CASSVGSRGRGYTF	TRBV9	TRBJ1-2
TGTGCCAGCAGCGCCGGAGAAATGGACGAGCAGTACTTC	CASSAGEMDEQYF	TRBV7-9	TRBJ2-7
TGTGCCAGCAAATGGGGTAAAGCGTTAACAGCTTTCTTT	CASKWGKALTAFF	TRBV28	TRBJ1-1
TGCAGTGCTAGGGAGGGGGGGGGGGGTGCCTACGAGCAGTACTTC	CSAREGGGGAYEQYF	TRBV20-1	TRBJ2-7
TGTGCCAGCACAAGTGACCTCGAAGGGCGAGGGGGCATGAACACTGAAGCTTTCTTT	CASTSDLEGRGGMNTEAFF	TRBV6-4	TRBJ1-1
TGCCGGGACAGCGGAAGGGGAGGCACCTACAATGAGCAGTTCTTC	CRDSGRGGTYNEQFF	TRBV29-1	TRBJ2-1
TGTGCCAGCAGACCCTACTCTGAGCAGTTCTTC	CASRPYSEQFF	TRBV7-9	TRBJ2-1
TGTGCCAGGTCCCGGGACAGGGTTAGAGGTGAGAGCTACGAGCAGTACTTC	CARSRDRVRGESYEQYF	TRBV27	TRBJ2-7
TGCAGCGTGGGGACAGCGGATCAGCCCCAGCATTTT	CSVGTADQPQHF	TRBV29-1	TRBJ1-5
TGTGCCAGCAGAAGACAGGGGGCCATCTACGAGCAGTACTTC	CASRRQGAIYEQYF	TRBV12-3	TRBJ2-7
TGTGCCAGCAGCTGGGAGGGGGCCGTTAGAATCGGTTCACCCCTCCACTTT	CASSWEGAVRIGSPLHF	TRBV7-9	TRBJ1-6
TGTGCCAGCAGTGGGGGGGCCAGGAACACCGGGGAGCTGTTTTTT	CASSGGARNTGELFF	TRBV7-4	TRBJ2-2
TGCAGCGTGGAGGGGGGGCCGTCTTATGAGCAGTTCTTC	CSVEGGPSYEQFF	TRBV29-1	TRBJ2-1
TGTGCCAGTAGTATAGGCCACCGGGGCCCGGAGAACACTGAAGCTTTCTTT	CASSIGHRGPENTEAFF	TRBV19	TRBJ1-1
TGTGCCAGCAGTTACGGGGCTCCGAGGCAGTTCTTC	CASSYGAPRQFF	TRBV6-5	TRBJ2-1
TGCAGCGTTGAAGCTCACCACCGGGACAGGGCCTACGAGCAGTACTTC	CSVEAHHRDRAYEQYF	TRBV29-1	TRBJ2-7
TGTGCCAGCAGTTTGAAGACCAACCATAACGAGCAGTACTTC	CASSLKTNHNEQYF	TRBV12-3	TRBJ2-7
TGTGCCAGCAGTCGTCTCCCGGGACAGGGTAAGAACACTGAAGCTTTCTTT	CASSRLPGQGKNTEAFF	TRBV6-5	TRBJ1-1
TGCAGTGCGTCTCGCTCGACCGCGCCAGGTGAGCAGTTCTTC	CSASRSTAPGEQFF	TRBV20-1	TRBJ2-1
TGCGCCAGCAGCCGGGCAGGGGGCAGGAGCAATCAGCCCCAGCATTTT	CASSRAGGRSNQPQHF	TRBV4-1	TRBJ1-5
TGTGCCAGCAGCCACGAGAGACTAGCGGAGGGGGAGTGGGATACGCAGTATTTT	CASSHERLAEGEWDTQYF	TRBV13	TRBJ2-3
TGTGCCACCAGTGGAACTAGCGGGAGTTCTAACTATGGCTACACCTTC	CATSGTSGSSNYGYTF	TRBV24-1	TRBJ1-2
TGTGCCAGCAGTCCGGACCTGCACGAGCAGTACTTC	CASSPDLHEQYF	TRBV6-3	TRBJ2-7
TGTGCCAGCAGCGGCTTAGGGGACTCTGGAAACACCATATATTTT	CASSGLGDSGNTIYF	TRBV5-8	TRBJ1-3
TGCGCCAATAAGCGCGGGAAATCAACTGAGACCCAGTACTTC	CANKRGKSTETQYF	TRBV5-1	TRBJ2-5
TGCAGTGCCTCTGATAGGGTGAGCAATCAGCCCCAGCATTTT	CSASDRVSNQPQHF	TRBV20-1	TRBJ1-5
TGTGCCAGCAGCTTACCAGGAGCGGCCGAAAAACTGTTTTTT	CASSLPGAAEKLFF	TRBV7-3	TRBJ1-4
TGTGCCAGCAGCGAGGCGACTAGCGTTAGAAGCACAGATACGCAGTATTTT	CASSEATSVRSTDTQYF	TRBV9	TRBJ2-3
TGTGCCAGCAGTATTCCCCAGGCGGAGACTGAAGCTTTCTTT	CASSIPQAETEAFF	TRBV28	TRBJ1-1
TGTGCCAGCAGCTCGACAGGGGCGGGGACTAATGAAAAACTGTTTTTT	CASSSTGAGTNEKLFF	TRBV7-3	TRBJ1-4
TGTGCCAGCACCGATGTTCCTCAGGGATATACGCAGTATTTT	CASTDVPQGYTQYF	TRBV12-3	TRBJ2-3
TGTGCCAGCAGCCTTCGGAGGGAGCCGGATCAGCCCCAGCATTTT	CASSLRREPDQPQHF	TRBV3-1	TRBJ1-5
TGCGCCAGCAGTGCACCTACAGAAGGGCGGGACGAGAGCTCCTACAATGAGCAGTTCTTC	CASSAPTEGRDESSYNEQFF	TRBV10-1	TRBJ2-1
TGTGCCAGCTCACCACGGGGGCCTAACGAGACCCAGTACTTC	CASSPRGPNETQYF	TRBV18	TRBJ2-5
TGTGCCAGTACCCGACCCCCTAAGGGACTAGCGGGGAACCCAGGATCCTACGAGCAGTACTTC	CASTRPPKGLAGNPGSYEQYF	TRBV19	TRBJ2-7
TGTGCCAGCAGCTACCAACCCCCAACGGGGAGCTCCTACAATGAGCAGTTCTTC	CASSYQPPTGSSYNEQFF	TRBV13	TRBJ2-1
TGCAGTGCACGGGTGAGCAATGAGCAGTTCTTC	CSARVSNEQFF	TRBV20-1	TRBJ2-1
TGCAGTGCTAGAACTGGACAGGGTAGCAATCAGCCCCAGCATTTT	CSARTGQGSNQPQHF	TRBV20-1	TRBJ1-5
TGTGCCAGCAGCGGCAAGGGGTACGAAAACACCGGGGAGCTGTTTTTT	CASSGKGYENTGELFF	TRBV9	TRBJ2-2
TGCGCCAGCAGCTGGGGCGGGCACGAGCAGTACTTC	CASSWGGHEQYF	TRBV5-1	TRBJ2-7
TGTGCCAGTCCCGGACTAGCGGGGGGAGGCTACGAGCAGTACTTC	CASPGLAGGGYEQYF	TRBV7-3	TRBJ2-7
TGTGCCAGCGGGCGGGCTTCGGGCTACACCTTC	CASGRASGYTF	TRBV18	TRBJ1-2
TGTGCCAGCAGCTTGGGACGACTAGCGGGAGGCAATCAGCCCCAGCATTTT	CASSLGRLAGGNQPQHF	TRBV5-6	TRBJ1-5
TGTGCCAGCAAGGAGGGAACTGAAGCTTTCTTT	CASKEGTEAFF	TRBV7-3	TRBJ1-1
TGCAGTGCTAGCGGAGGCCGCTACGAGCAGTACTTC	CSASGGRYEQYF	TRBV20-1	TRBJ2-7
TGCGCCGGGGGGGAGCAGTACTTC	CAGGEQYF	TRBV10-1	TRBJ2-7
TGTGCCAGCAGTTACTCTCTGGTACTCCGGGGGCGGGCCTATCAGCCCCAGCATTTT	CASSYSLVLRGRAYQPQHF	TRBV6-5	TRBJ1-5
TGTGCCAGCAGTGTGGGAACCCGCTGCTCTGGAAACACCATATATTTT	CASSVGTRCSGNTIYF	TRBV12-3	TRBJ1-3
TGTGCCAGCAGAGGACTAGCGGCGTACAATGAGCAGTTCTTC	CASRGLAAYNEQFF	TRBV6-5	TRBJ2-1
TGTGCCAGTAGTAGAGGGGGGAGGGATGGTGTGAACACTGAAGCTTTCTTT	CASSRGGRDGVNTEAFF	TRBV19	TRBJ1-1
TGCCGGGGTGACAGGGGTACCTGCTACGAGCAGTACTTC	CRGDRGTCYEQYF	TRBV5-1	TRBJ2-7
TGCGCCAGCAGTTCAACGGACATGTTGGCTTTCTTT	CASSSTDMLAFF	TRBV10-2	TRBJ1-1
TGTGCCAGCAGCCAGAGGGATCCCTACGAGCAGTACTTC	CASSQRDPYEQYF	TRBV3-1	TRBJ2-7
TGTGCCAGCAGAGGGCAGGGGTACGAGCAGTACTTC	CASRGQGYEQYF	TRBV5-4	TRBJ2-7
TGTGCCAGCAGTTCAGGGAGAATTGCTGGAAACACCATATATTTT	CASSSGRIAGNTIYF	TRBV6-6	TRBJ1-3
TGTGCCAGCAGCGAGTGGCGGACCCCGACAAACACCCAAGAGACCCAGTACTTC	CASSEWRTPTNTQETQYF	TRBV9	TRBJ2-5
TGCAGCGTTGTGGACCCGGGGGAGGGGGAGCAGTTCTTC	CSVVDPGEGEQFF	TRBV29-1	TRBJ2-1
TGTGCCAGCAGCTGTGGGGGTACCCTGAACACCGGGGAGCTGTTTTTT	CASSCGGTLNTGELFF	TRBV5-4	TRBJ2-2
TGTGCCAGCAGCTTTCACAAATACAATGAGCAGTTCTTC	CASSFHKYNEQFF	TRBV7-3	TRBJ2-1
TGTGCCAGCAGCATGACAGGGTCGTTCCTCGCTAATGAAAAACTGTTTTTT	CASSMTGSFLANEKLFF	TRBV7-8	TRBJ1-4
TGTGCCAGCAGCTTATGCCTAAGGTGGGCGGCCATAGGTCATCAGCCCCAGCATTTT	CASSLCLRWAAIGHQPQHF	TRBV7-6	TRBJ1-5
TGCAGCGTTCGTCGGCTCTACGAGCAGTACTTC	CSVRRLYEQYF	TRBV29-1	TRBJ2-7
TGTGCCTGGGCGGACAGGGGGAGAGGTAATGAAAAACTGTTTTTT	CAWADRGRGNEKLFF	TRBV30	TRBJ1-4
TGTGCCAGCAGTGACGTGGGGAGGGGAAGCAATCAGCCCCAGCATTTT	CASSDVGRGSNQPQHF	TRBV6-4	TRBJ1-5
TGTGCCAGCAGCCAAGAGGCCATTGAACATACAGGGTCCATATATTTT	CASSQEAIEHTGSIYF	TRBV3-1	TRBJ1-3
TGTGCCAGCAGAGCAGTCCCCGAGGCAGGGGGCTCCTACAATGAGCAGTTCTTC	CASRAVPEAGGSYNEQFF	TRBV6-1	TRBJ2-1
TGTGCCAGCAGATCCCCCCGGAGAGAGACCCAGTACTTC	CASRSPRRETQYF	TRBV6-4	TRBJ2-5
TGTGCCAGCACCAAGGGTTATAGCAATCAGCCCCAGCATTTT	CASTKGYSNQPQHF	TRBV27	TRBJ1-5
TGTGCCAGCGGATCAAGACGGGGGTTCTATGGCTACACCTTC	CASGSRRGFYGYTF	TRBV12-3	TRBJ1-2
TGTGCCAGCAGCCCGGCCGGGACAGGGCCCCGAGAGACCCAGTACTTC	CASSPAGTGPRETQYF	TRBV7-3	TRBJ2-5
TGTGCCAGCAGTGTCCTAGGGGAGAACACCGGGGAGCTGTTTTTT	CASSVLGENTGELFF	TRBV28	TRBJ2-2
TGTGCCAGACCTGGGGGGTATACAAGCAATCAGCCCCAGCATTTT	CARPGGYTSNQPQHF	TRBV6-1	TRBJ1-5
TGTGCCAGCAGCCAAGATAGGCTCACCGGGACAGGCTACAATGAGCAGTTCTTC	CASSQDRLTGTGYNEQFF	TRBV4-2	TRBJ2-1
TGTGCTAGTGGTTTGCGGGGAAAGCGCTATGGCTACACCTTC	CASGLRGKRYGYTF	TRBV12-5	TRBJ1-2
TGTGCCAGCAGCCACTCGGGCCCTCCATGTAATGAGCAGTTCTTC	CASSHSGPPCNEQFF	TRBV6-5	TRBJ2-1
TGTGCCAGCAGCTTGAAGCTGAGCCCCAACGAGCAGTACTTC	CASSLKLSPNEQYF	TRBV7-3	TRBJ2-7
TGCGCCAGCCTGACGGGACTAGCGGGGGGGCACGGGACCTCCTACGAGCAGTACTTC	CASLTGLAGGHGTSYEQYF	TRBV5-1	TRBJ2-7
TGCAGCGTGAACCCAGTGACGACTAACTATGGCTACACCTTC	CSVNPVTTNYGYTF	TRBV29-1	TRBJ1-2
TGTGCCAGCTCGCGACTAGCGCTTTATGAGCAGTTCTTC	CASSRLALYEQFF	TRBV18	TRBJ2-1
TGTGCCAGTAGTCGCTTGACTAGCGGGAACCCGCACTACGAGCAGTACTTC	CASSRLTSGNPHYEQYF	TRBV19	TRBJ2-7
TGTGCCAGCAAGGAGATGTTTCCGTGTCAACAGGGGGGAGAGACCCAGTACTTC	CASKEMFPCQQGGETQYF	TRBV5-4	TRBJ2-5
TGTGCCAGCAGTAAGTCCCCCCCGGGCTATGGCTACACCTTC	CASSKSPPGYGYTF	TRBV6-1	TRBJ1-2
TGCAGCGTCCGGGCATGGGACAGGCCAACCCTCCACTTT	CSVRAWDRPTLHF	TRBV29-1	TRBJ1-6
TGTGCCAGTCGGGAGGGTGGCTCCTACGAGCAGTACTTC	CASREGGSYEQYF	TRBV19	TRBJ2-7
TGTGCCAGCAGCTTAAATCCAGGGGTATATCAGCCCCAGCATTTT	CASSLNPGVYQPQHF	TRBV7-4	TRBJ1-5
TGTGCCAGCAGCATTAGGATCGGCACAGATACGCAGTATTTT	CASSIRIGTDTQYF	TRBV7-9	TRBJ2-3
TGTGCCAGGTATTGTCGGGTTTTAACAGATACGCAGTATTTT	CARYCRVLTDTQYF	TRBV7-3	TRBJ2-3
TGTGCCAGACGGAGCTGCCGGGGCTACGAGCAGTACTTC	CARRSCRGYEQYF	TRBV2	TRBJ2-7
TGTGCCAGCAGTTACTTCAGGACAGGGGGCTACACCTTC	CASSYFRTGGYTF	TRBV6-3	TRBJ1-2
TGTGCCAGCAGCCATGGAATTTGCGGGCCCGGGGAAGCTTTCTTT	CASSHGICGPGEAFF	TRBV7-8	TRBJ1-1
TGTGCCAGCAGTGAGCTAGGACCCGCTGAAGCTTTCTTT	CASSELGPAEAFF	TRBV2	TRBJ1-1
TGCAGTGCTAGACAGGGAAATTCACCCCTCCACTTT	CSARQGNSPLHF	TRBV20-1	TRBJ1-6
TGCGCCAGCAGCAGGAAGGGAACAACTAGGACAGGGGGCCGAAACTACGAGCAGTACTTC	CASSRKGTTRTGGRNYEQYF	TRBV5-1	TRBJ2-7
TGTGCCAGCAGTTCGGGGCATAATGAAAAACTGTTTTTT	CASSSGHNEKLFF	TRBV28	TRBJ1-4
TGTGCCTGGAGTGATAAACAGGGGGCTAAAGTGAACACCGGGGAGCTGTTTTTT	CAWSDKQGAKVNTGELFF	TRBV30	TRBJ2-2
TGTGCCAGTAGTCTTCTGACTAATGAAAAACTGTTTTTT	CASSLLTNEKLFF	TRBV19	TRBJ1-4
TGTGCCAGCAGCCCGCCAACATCGCGCAGGCCCACTGAAAAACTGTTTTTT	CASSPPTSRRPTEKLFF	TRBV13	TRBJ1-4
TGCAGTGCTAGAGTAACCCACGGGGGTGGGGACTACACTGAAGCTTTCTTT	CSARVTHGGGDYTEAFF	TRBV20-1	TRBJ1-1
TGTGCCAGCAGGCCTCTGGGGGGGCCTGAGCAGTTCTTC	CASRPLGGPEQFF	TRBV7-8	TRBJ2-1
TGCGCCAGCAGCCATTCTAAAAAGCTCGGGGCCCAACAGCCCCAGCATTTT	CASSHSKKLGAQQPQHF	TRBV4-1	TRBJ1-5
TGTGCCAGCAGCAGTCCGCCCCAGGGGTATCCTGAAGCTTTCTTT	CASSSPPQGYPEAFF	TRBV7-3	TRBJ1-1
TGTGCCAGCAGCTCTTCCAGGGGGAACTATGGCTACACCTTC	CASSSSRGNYGYTF	TRBV7-4	TRBJ1-2
TGTGCCTGGCCTGGGAGCGGGAGCACCATATATTTT	CAWPGSGSTIYF	TRBV30	TRBJ1-3
TGCAGTGCCAATGGATGGACAGGCAGAAGACCCGGGGTGGGCACAGATACGCAGTATTTT	CSANGWTGRRPGVGTDTQYF	TRBV20-1	TRBJ2-3
TGCAGTGCTACTAGCGGGAGGGCTTCTTCCGAGCAGTACTTC	CSATSGRASSEQYF	TRBV20-1	TRBJ2-7
TGCGCCAGCAGCTATCAAGAGACAGGGGTTGATAAAGGAACTAATGAAAAACTGTTTTTT	CASSYQETGVDKGTNEKLFF	TRBV5-1	TRBJ1-4
TGTGCCAGCAGCCAAGATTGCCCATTGAGAACTAATGAAAAACTGTTTTTT	CASSQDCPLRTNEKLFF	TRBV3-1	TRBJ1-4
TGTGCCAGCAGCTGCGAGAGCCGCAATCAGCCCCAGCATTTT	CASSCESRNQPQHF	TRBV5-4	TRBJ1-5
TGCGCGGACAGGGGGGGTAGTACCTATGGCTACACCTTC	CADRGGSTYGYTF	TRBV10-1	TRBJ1-2
TGCGCCAGCAGCTGTCGACTAGCGGGGGGGGATGAGCAGTTCTTC	CASSCRLAGGDEQFF	TRBV5-1	TRBJ2-1
TGCAGCGCACTTCCCCGCCGGGGGTATGGCTACACCTTC	CSALPRRGYGYTF	TRBV29-1	TRBJ1-2
TGTGCCAGCAGTACTCAGCGGGAGGGGCAAAAGAACAATGAGCAGTTCTTC	CASSTQREGQKNNEQFF	TRBV2	TRBJ2-1
TGTGCCAGCACACAGCGGCCGGGACTATCACCCCTCCACTTT	CASTQRPGLSPLHF	TRBV6-5	TRBJ1-6
TGTGCCAGTAGATTCCCTTACTCGGACCACCATCAGCCCCAGCATTTT	CASRFPYSDHHQPQHF	TRBV19	TRBJ1-5
TGTGCCAGCAGCAACTCGGAGGCCGGGGAGCTGTTTTTT	CASSNSEAGELFF	TRBV9	TRBJ2-2
TGTGCCAGCAGTTACCTCGGGACAGGGGACTACGAGCAGTACTTC	CASSYLGTGDYEQYF	TRBV6-6	TRBJ2-7
TGTGCCAGCAGCTCCCGACATGGAGAGTACTTC	CASSSRHGEYF	TRBV7-3	TRBJ2-7
TGTGCCAGCAGCGTGGGGACTAGCGGCTACGAGCAGTACTTC	CASSVGTSGYEQYF	TRBV9	TRBJ2-7
TGTGCCATCAGTGACCACCGGGAGGGTGGCTACACCTTC	CAISDHREGGYTF	TRBV10-3	TRBJ1-2
TGTGCCAGCAGTGAACCCGGGGGGAGGCATTCAGCCAAAAACATTCAGTACTTC	CASSEPGGRHSAKNIQYF	TRBV6-4	TRBJ2-4
TGTGCCAGCAGTTACTCACCTAAAAGTCCTCTAACAGATACGCAGTATTTT	CASSYSPKSPLTDTQYF	TRBV6-5	TRBJ2-3
TGTGCCAGCAGTGACTCCCGTACCCGGGGGGGGGTAAGGGTCAGCGAGCAGTACTTC	CASSDSRTRGGVRVSEQYF	TRBV6-4	TRBJ2-7
TGTGCCAGCAGGTTCTTGACTAGCGGGTACAATGAGCAGTTCTTC	CASRFLTSGYNEQFF	TRBV3-1	TRBJ2-1
TGTGCCAGCAGTGTTTGGTGGGGGTCAGCCAAAAACATTCAGTACTTC	CASSVWWGSAKNIQYF	TRBV27	TRBJ2-4
TGTGCCAGCAGCTTAGATCGGGACTATCCTGGCTACACCTTC	CASSLDRDYPGYTF	TRBV11-3	TRBJ1-2
TGTGTATTAAATTGCGTGTATGAGCAGTTCTTC	CVLNCVYEQFF	TRBV2	TRBJ2-1
TGTGCCAGCAGCGGAGGGGTCGGCAACTATGGCTACACCTTC	CASSGGVGNYGYTF	TRBV5-4	TRBJ1-2
TGTGCCAGCAGCGGGTGGGAAGCTGAAGCTTTCTTT	CASSGWEAEAFF	TRBV13	TRBJ1-1
TGTGCCACCAGTGATTATACTAGGGGGTGCTACAATGAGCAGTTCTTC	CATSDYTRGCYNEQFF	TRBV24-1	TRBJ2-1
TGTGCCAGCACAAAGCGCAGGGGGATGTCGAAAAACATTCAGTACTTC	CASTKRRGMSKNIQYF	TRBV12-4	TRBJ2-4
TGTGCCAGCAGCTTAGACCGCGGGAGCCAGTACTTC	CASSLDRGSQYF	TRBV7-6	TRBJ2-5
TGTGCCAGCAGCCGTGTGGGCCCCTACGAGCAGTACTTC	CASSRVGPYEQYF	TRBV7-3	TRBJ2-7
TGCAGTGCATCGGGGAGTTCTAACTATGGCTACACCTTC	CSASGSSNYGYTF	TRBV20-1	TRBJ1-2
TGTGCCAGCAGCACCCCGGGCCCCCGGGTAGGGGACACGATACTTAATGAAAAACTGTTTTTT	CASSTPGPRVGDTILNEKLFF	TRBV7-9	TRBJ1-4
TGCAGTGCTCCTAAACCGACGGGGAAAAAACTGTTTTTT	CSAPKPTGKKLFF	TRBV20-1	TRBJ1-4
TGTGCCAGCAGCTTAGATCTCGTATATTTGGGGCGGTGCTGCTACACCTTC	CASSLDLVYLGRCCYTF	TRBV11-3	TRBJ1-2
TGTGCCAGCAGCTTGGTGCTTCAACAGACAGGGGTAGGCGGCTACACCTTC	CASSLVLQQTGVGGYTF	TRBV5-4	TRBJ1-2
TGTGCCAGCAGCTTTTCCAGGAGTGACACCGGGGAGCTGTTTTTT	CASSFSRSDTGELFF	TRBV7-3	TRBJ2-2
TGTGCCAGCAGCGAAAGTCCGGTTAATGAAAAACTGTTTTTT	CASSESPVNEKLFF	TRBV13	TRBJ1-4
TGTGCCAGCAGACCCTGGACTAGCGGGAGTTTGAAACTGTTTTTT	CASRPWTSGSLKLFF	TRBV27	TRBJ1-4
TGTGCCAGCAGCTTGCTAGGGGGCGGCTTGAAGCCCTACAATGAGCAGTTCTTC	CASSLLGGGLKPYNEQFF	TRBV7-6	TRBJ2-1
TGCAGTGCTAGCCCGGCAGAGCACGTGAATCAGCCCCAGCATTTT	CSASPAEHVNQPQHF	TRBV20-1	TRBJ1-5
TGTGCCAGCAGCGCCCCGGGTGAGCAGTTCTTC	CASSAPGEQFF	TRBV9	TRBJ2-1
TGTGCCAGCAGCCTTACAGGGTTGAACACTGAAGCTTTCTTT	CASSLTGLNTEAFF	TRBV7-9	TRBJ1-1
TGTGCCAGCAGCCGAAAGGGTGCCAGGGGGCTAGGCTACAATGAGCAGTTCTTC	CASSRKGARGLGYNEQFF	TRBV14	TRBJ2-1
TGTGCCAGCAGCATGCCGGGACAGGGGCCCCATGAGCAGTACTTC	CASSMPGQGPHEQYF	TRBV7-3	TRBJ2-7
TGTGCCAGGAGGACAATCCAATACCGGGTCCTAAGGACCTATAATTCACCCCTCCACTTT	CARRTIQYRVLRTYNSPLHF	TRBV6-1	TRBJ1-6
TGCGCCAGCAGCTTGGCCCCCCCGCAGGGGCACGACTCCTACGAGCAGTACTTC	CASSLAPPQGHDSYEQYF	TRBV5-1	TRBJ2-7
TGCGCCAGCTACAGGCTAGCCCAGCATTTT	CASYRLAQHF	TRBV5-1	TRBJ1-5
TGCGCCAGCACCCGGGACAGGGAGTCCTACGAGCAGTACTTC	CASTRDRESYEQYF	TRBV5-1	TRBJ2-7
TGTGCCAGCAGCAATGGGGGGGGAGAGCAGTACTTC	CASSNGGGEQYF	TRBV12-3	TRBJ2-7
TGTGCCAGCAGCTTAGCTGAGACTAGCGTTAGCACAGATACGCAGTATTTT	CASSLAETSVSTDTQYF	TRBV11-2	TRBJ2-3
TGTGCCAGCAGCCCCGCCGGGACAGGGCGTGTGAGCAATCAGCCCCAGCATTTT	CASSPAGTGRVSNQPQHF	TRBV3-1	TRBJ1-5
TGTGCCAGCAGCCGAAAAGGCCTAACGGGACAGGAGGGTACGCAGTATTTT	CASSRKGLTGQEGTQYF	TRBV14	TRBJ2-3
TGTGCCAGCAGCCAAGCACCCTGGGGGGGGCCCTACAATGAGCAGTTCTTC	CASSQAPWGGPYNEQFF	TRBV3-1	TRBJ2-1
TGTGCCAGGGGGGGGAGGGAAGGAAATGAGCAGTTCTTC	CARGGREGNEQFF	TRBV19	TRBJ2-1
TGTGCCAGCAGTCAACGGGACACTGAAGCTTTCTTT	CASSQRDTEAFF	TRBV27	TRBJ1-1
TGTGCCGGTCCGGGACAGAATTACAGCTCTGGAAACACCATATATTTT	CAGPGQNYSSGNTIYF	TRBV7-2	TRBJ1-3
TGCAGTGCTAGAGTTGGAGGCCCTGACTATGGCTACACCTTC	CSARVGGPDYGYTF	TRBV20-1	TRBJ1-2
TGTGGAAGGCGTTCACCCAAAAACATTCAGTACTTC	CGRRSPKNIQYF	TRBV6-2	TRBJ2-4
TGCAGTGCTAGAGAACCCGAGTGGGGGAGCAAACACGAGCAGTACTTC	CSAREPEWGSKHEQYF	TRBV20-1	TRBJ2-7
TGTGCCAGCAGCACGGTGGGGATACACACCGGGGAGCTGTTTTTT	CASSTVGIHTGELFF	TRBV7-9	TRBJ2-2
TGTGCCAGCAGCCTGTACCCCGGGACTAGCGGGTCCGACACCGGGGAGCTGTTTTTT	CASSLYPGTSGSDTGELFF	TRBV9	TRBJ2-2
TGTGCCAGCAGCCACCCCCTAGAGCGACAGGGGGCCACGCAGGCCTACGAGCAGTACTTC	CASSHPLERQGATQAYEQYF	TRBV3-1	TRBJ2-7
TGTGCCAGCAGCCGAGGAGGGGGCTATGGCTACACCTTC	CASSRGGGYGYTF	TRBV13	TRBJ1-2
TGCAGTGCTAGTACCTATCTAGGCGGGGAGCTGTTTTTT	CSASTYLGGELFF	TRBV20-1	TRBJ2-2
TGTGCCAGCAGCTTGGCGACCTTGACAATCTCCTACGAGCAGTACTTC	CASSLATLTISYEQYF	TRBV7-3	TRBJ2-7
TGCAGCGTTGAGACAGGGGGCCTTTCTTCACCCCTCCACTTT	CSVETGGLSSPLHF	TRBV29-1	TRBJ1-6
TGCAGTGCTAGCCGTCAAAGGAAACACGAGCAGTACTTC	CSASRQRKHEQYF	TRBV20-1	TRBJ2-7
TGTGCCAGCAGCTTAGAGATTGGCGGTGGCTACACCTTC	CASSLEIGGGYTF	TRBV11-2	TRBJ1-2
TGCGCCAGCAGCTTGGAAGGAAAGGACAGGGGTCGAGGGGACACCGGGGAGCTGTTTTTT	CASSLEGKDRGRGDTGELFF	TRBV5-1	TRBJ2-2
TGTGCCAGCAGTTTGGGGGAGGGACGCACAGATACGCAGTATTTT	CASSLGEGRTDTQYF	TRBV28	TRBJ2-3
TGTGCCAGCAGGACAGGGGTAAAGCAGCCCCAGCATTTT	CASRTGVKQPQHF	TRBV6-4	TRBJ1-5
TGTGCCAGCAGTGAATCCCGACAGGGAGGTGGGTACTACGAGCAGTACTTC	CASSESRQGGGYYEQYF	TRBV6-4	TRBJ2-7
TGCAGTGCTAGAGATGTGACAACCCGGATCTGGGGTTACGAGCAGTACTTC	CSARDVTTRIWGYEQYF	TRBV20-1	TRBJ2-7
TGTGCCGAAGAACCGGGCTCTAATGAGCAGTTCTTC	CAEEPGSNEQFF	TRBV19	TRBJ2-1
TGTGCCAGCAGTGACCCCATGTCCGGGACTTCTGAAGCTTTCTTT	CASSDPMSGTSEAFF	TRBV6-4	TRBJ1-1
TGCAGTGCATTGACAGGGATGAACACTGAAGCTTTCTTT	CSALTGMNTEAFF	TRBV20-1	TRBJ1-1
TGTGCCAGCGGGGGCCCGGACGGCAGCACAGATACGCAGTATTTT	CASGGPDGSTDTQYF	TRBV6-1	TRBJ2-3
TGTGCCAGCAGCTTGGGTGGGCATGGTGAGCAGTTCTTC	CASSLGGHGEQFF	TRBV5-6	TRBJ2-1
TGTGCCAGCAGCATCGGAGACTTCTACGAGCAGTACTTC	CASSIGDFYEQYF	TRBV9	TRBJ2-7
TGTGGAGCACCCAGGCTCAGTGCCACAGATACGCAGTATTTT	CGAPRLSATDTQYF	TRBV7-9	TRBJ2-3
TGTGCCAGCAGCTACGGGGGGCAAGAGACCCAGTACTTC	CASSYGGQETQYF	TRBV7-9	TRBJ2-5
TGTGCCGCCGGACAAGGATCCATAGAAATCAATCAGCCCCAGCATTTT	CAAGQGSIEINQPQHF	TRBV6-1	TRBJ1-5
TGCGCCAGCAGCCACTCGGGGGGCCAGCAGTTCTTC	CASSHSGGQQFF	TRBV4-1	TRBJ2-1
TGTGCCAGCAGTAGTGTAGGGACAGTTTTCCAGGACGGGGGGTACGAGCAGTACTTC	CASSSVGTVFQDGGYEQYF	TRBV3-1	TRBJ2-7
TGTGCCATAAACCGGGGGGAAGCTTTCTTT	CAINRGEAFF	TRBV10-3	TRBJ1-1
TGTGCCAGCAGCGTAGCAGGGAAAGCAAGCAATCAGCCCCAGCATTTT	CASSVAGKASNQPQHF	TRBV9	TRBJ1-5
TGTGCCAGTAGTATAGGTCCCCGGCCGGGACCGATAAAAAACACTGAAGCTTTCTTT	CASSIGPRPGPIKNTEAFF	TRBV19	TRBJ1-1
TGCGCCAGCAGCTTGGGTGGCGGGGACGGCTACACCTTC	CASSLGGGDGYTF	TRBV5-1	TRBJ1-2
TGTGCCAGCAGTTCCAGAGCCCCCGGGACTAGCGAGTGGAGTCGAGAGACCCAGTACTTC	CASSSRAPGTSEWSRETQYF	TRBV12-3	TRBJ2-5
TGCAGTGCTAGAGATCCGGGTCGGGATGAAGCTTTCTTT	CSARDPGRDEAFF	TRBV20-1	TRBJ1-1
TGCGCCAGCTCAGAAAGGGGTTATGAAAAACTGTTTTTT	CASSERGYEKLFF	TRBV10-1	TRBJ1-4
TGCGCCAGCAGCCAACAGGGAGGCTTTGAAAAACTGTTTTTT	CASSQQGGFEKLFF	TRBV4-1	TRBJ1-4
TGTGCCAGCAGCCTAATATTGGCAGACAGTGGTAAATACGAGCAGTACTTC	CASSLILADSGKYEQYF	TRBV2	TRBJ2-7
TGTGCCAGCAGTTACTCGAACCGGGACAGGGAAGAGACCCAGTACTTC	CASSYSNRDREETQYF	TRBV6-5	TRBJ2-5
TGTGCCAGCAGCTTGGGTTGGGGCCGCTCCACGCAGTATTTT	CASSLGWGRSTQYF	TRBV5-4	TRBJ2-3
TGTGCCAGCAGCTTAATGAGGATTAGTTGCCCAGGTAAGGGAACCTACGAGCAGTACTTC	CASSLMRISCPGKGTYEQYF	TRBV7-2	TRBJ2-7
TGTGCCAGCAGCTTGGGACCGCCCATAGTCCGGGGATTTAACACCGGGGAGCTGTTTTTT	CASSLGPPIVRGFNTGELFF	TRBV11-1	TRBJ2-2
TGCGCCAGCAGCCCGCTGGCGGGGTCCGACAATGAGCAGTTCTTC	CASSPLAGSDNEQFF	TRBV5-1	TRBJ2-1
TGTGCCAGCAGCTTAGCAAGCAGTGTTGGCTACACCTTC	CASSLASSVGYTF	TRBV7-2	TRBJ1-2
TGTGCCCGTAGGAGCGGTTACGGGGAGCTGTTTTTT	CARRSGYGELFF	TRBV24-1	TRBJ2-2
TGTGCCAGCAGTATCCGATCAGGACAGGGCTTTAGCGAGCAGTACTTC	CASSIRSGQGFSEQYF	TRBV28	TRBJ2-7
TGTGCCAGCAGCTTAGAGCCCCCGGGACTAGCGGGGTACTACGAGCAGTACTTC	CASSLEPPGLAGYYEQYF	TRBV7-6	TRBJ2-7
TGTGCCAGCCTCCCAGGGGGGTCTTTCTATGGCTACACCTTC	CASLPGGSFYGYTF	TRBV13	TRBJ1-2
TGTGCCAGCAGCGAGGAACCGGGAAAACAGGGCTACGAGCAGTACTTC	CASSEEPGKQGYEQYF	TRBV9	TRBJ2-7
TGTGCCAGCAGCCGGCCGGGACATTCCGTAACAGATACGCAGTATTTT	CASSRPGHSVTDTQYF	TRBV11-2	TRBJ2-3
TGTGCCAGCAGCGGGATTCCAAATAGTGATGCCTACAATGAGCAGTTCTTC	CASSGIPNSDAYNEQFF	TRBV9	TRBJ2-1
TGTGCCAGCAGCCGCGGCACGACAGGAAGGGCTGAAGCTTTCTTT	CASSRGTTGRAEAFF	TRBV9	TRBJ1-1
TGCGCCAGCAGCGGGATAGCGGGAGAGGGGTGTAACTATGGCTACACCTTC	CASSGIAGEGCNYGYTF	TRBV5-1	TRBJ1-2
TGTGCCAGCCCTCGCCCGGAGTCACTAGCGGGAGAAACAGATAGCAATCAGCCCCAGCATTTT	CASPRPESLAGETDSNQPQHF	TRBV28	TRBJ1-5
TGCAGCGTTGGGGACAGGGCGGGCTCTGGAAACACCATATATTTT	CSVGDRAGSGNTIYF	TRBV29-1	TRBJ1-3
TGCAGCGGCAGACAGGGTGCCCTGGACGAGCAGTACTTC	CSGRQGALDEQYF	TRBV29-1	TRBJ2-7
TGTGCCAGCAGCTGGGAGGTAACCCAAGAGACCCAGTACTTC	CASSWEVTQETQYF	TRBV6-4	TRBJ2-5
TGTGCCAGCAGCTTAGACCCGGGACAGGGGCTCCGATACGAGCAGTACTTC	CASSLDPGQGLRYEQYF	TRBV11-3	TRBJ2-7
TGCAGTGCTAGGAAGCGGGCGTATGGCTACACCTTC	CSARKRAYGYTF	TRBV20-1	TRBJ1-2
TGTGCCAGCAGTGAACTCGCTGGGAATTACGAGCAGTACTTC	CASSELAGNYEQYF	TRBV6-1	TRBJ2-7
TGTGCCAGCAGAAGGGGAACGCTGTTTTTT	CASRRGTLFF	TRBV12-4	TRBJ1-4
TGTGCCAGCAGGAGAGAATTAGACGATAAAAGCACAGATACGCAGTATTTT	CASRRELDDKSTDTQYF	TRBV28	TRBJ2-3
TGTGCCACCAGTTCAGGAACGGGCACAGATACGCAGTATTTT	CATSSGTGTDTQYF	TRBV15	TRBJ2-3
TGTGCCAGCGTGCCAGCTAGCGAGGGAAAAGAGACCCAGTACTTC	CASVPASEGKETQYF	TRBV5-6	TRBJ2-5
TGTGCCAGCAGTTTAACACGACAGATCCTTCTAGCCAAAAACATTCAGTACTTC	CASSLTRQILLAKNIQYF	TRBV27	TRBJ2-4
TGCAGCGTTGACCGCCGGGACAGACGGCAAGAGACCCAGTACTTC	CSVDRRDRRQETQYF	TRBV29-1	TRBJ2-5
TGTGCCAGCAGCCCCGGGCCCGTGGGGCTCCCCGCCCAGCATTTT	CASSPGPVGLPAQHF	TRBV5-6	TRBJ1-5
TGTGCCAGCAGCCCTTGGGGTTCGGAAAAACTGTTTTTT	CASSPWGSEKLFF	TRBV6-5	TRBJ1-4
TGTGCCAGCAGTTTATCCCGGACAAGGAACACTGAAGCTTTCTTT	CASSLSRTRNTEAFF	TRBV12-3	TRBJ1-1
TGTGCCAGCACCCACAGGTATCAGCCCCAGCATTTT	CASTHRYQPQHF	TRBV6-4	TRBJ1-5
TGTGCCAGCAGTTTACTCTTCCCCTCGGGAGGGGACCGCTCTGGGGCCAACGTCCTGACTTTC	CASSLLFPSGGDRSGANVLTF	TRBV28	TRBJ2-6
TGCGCCAGCAGCTTGTCCAAACTAGCGGGGGGGCGGTCGCAAGAGACCCAGTACTTC	CASSLSKLAGGRSQETQYF	TRBV5-1	TRBJ2-5
TGCCCGCATTATCGGGGCCAGCCCCTTAATCAGCCCCAGCATTTT	CPHYRGQPLNQPQHF	TRBV5-1	TRBJ1-5
TGTGCCAGCAGTATTGACAGGAATCGAATCGGTGTGAACACTGAAGCTTTCTTT	CASSIDRNRIGVNTEAFF	TRBV6-4	TRBJ1-1
TGTGCCAGCAGAGGGAGGGGAGGCTCTGGAAACACCATATATTTT	CASRGRGGSGNTIYF	TRBV6-8	TRBJ1-3
TGTGCCACCAGTGAGGGGCTAGAGACCCAGTACTTC	CATSEGLETQYF	TRBV24-1	TRBJ2-5
TGTGCCAGCAGTGAAACAGGGGGTTACGAGCAGTACTTC	CASSETGGYEQYF	TRBV6-4	TRBJ2-7
TGTGCCAGCAAGTGGGGACATATCCAGTACTTC	CASKWGHIQYF	TRBV6-4	TRBJ2-4
TGCAGCGTTGAAGTCCAGAGCGGCGTGAACACTGAAGCTTTCTTT	CSVEVQSGVNTEAFF	TRBV29-1	TRBJ1-1
TGTGCCAGCAGTGTGACAGGGTTGGCGAGTCTCGGAAACACCATATATTTT	CASSVTGLASLGNTIYF	TRBV6-1	TRBJ1-3
TGTGCCAGCAGCACCGACAGAGGCCCGGGGCATAACACTGAAGCTTTCTTT	CASSTDRGPGHNTEAFF	TRBV11-3	TRBJ1-1
TGTGCCAGCAGTGAAGGTGTGGCTAGGGACAGGCGGAAGGGGCGGAATCAGCCCCAGCATTTT	CASSEGVARDRRKGRNQPQHF	TRBV6-1	TRBJ1-5
TGTGCCAGCACCCCAGGGTCAAATTCACCCCTCCACTTT	CASTPGSNSPLHF	TRBV6-4	TRBJ1-6
TGTGCCAGCAGCCTCGACCGGGACACTGGAGAGGCCTACGAGCAGTACTTC	CASSLDRDTGEAYEQYF	TRBV14	TRBJ2-7
TGCGCCAGCAGGGGACTAGCATATACAGATACGCAGTATTTT	CASRGLAYTDTQYF	TRBV10-1	TRBJ2-3
TGTGCCAGCAGCCGGGACAGAAACACCATATATTTT	CASSRDRNTIYF	TRBV9	TRBJ1-3
TGTGCCTGGCCTCAAGGGACGGCCGGCTATGGCTACACCTTC	CAWPQGTAGYGYTF	TRBV30	TRBJ1-2
TGTGCCAGCGGACAGAGCGGGATTCATAGCAATCAGCCCCAGCATTTT	CASGQSGIHSNQPQHF	TRBV27	TRBJ1-5
TGCAGTGCTAGAGATGATTTTGGGACAGGAAACACCATATATTTT	CSARDDFGTGNTIYF	TRBV20-1	TRBJ1-3
TGTGCCAGCAGTGAGGACAGGTCGATTTCCACTGAAGCTTTCTTT	CASSEDRSISTEAFF	TRBV6-4	TRBJ1-1
TGTGCCAGCTCACCTCCCTGGTCGCGCCTACGGGGGGCGAAGACAGAGACCCAGTACTTC	CASSPPWSRLRGAKTETQYF	TRBV18	TRBJ2-5
TGTGCCAGCAGACAGGGAGACGAGCAGTACTTC	CASRQGDEQYF	TRBV27	TRBJ2-7
TGTGCCAGCAGCTCGCGGGAGCCTTATATCGATCAGCCCCAGCATTTT	CASSSREPYIDQPQHF	TRBV7-4	TRBJ1-5
TGTGCCAGCATGTTAAAACAGGACACTGAAGCTTTCTTT	CASMLKQDTEAFF	TRBV5-5	TRBJ1-1
TGCAGTGCTAGTCGAATACCTGAGACCCAGTACTTC	CSASRIPETQYF	TRBV20-1	TRBJ2-5
TGTGCCAGCAGTTACGTATCAACAGGGCCGGAGCAGTACTTC	CASSYVSTGPEQYF	TRBV6-3	TRBJ2-7
TGCAGCGTTGAGCAGGGCCGTCCCTACGAGCAGTACTTC	CSVEQGRPYEQYF	TRBV29-1	TRBJ2-7
TGTGCCTACCAGGAGCGCACAGATACGCAGTATTTT	CAYQERTDTQYF	TRBV7-4	TRBJ2-3
TGTGCCAGCAGCTTGAACGCGGGAGTCGTGAACACTGAAGCTTTCTTT	CASSLNAGVVNTEAFF	TRBV27	TRBJ1-1
TGTGCCAGCAGCTTTATCACAGCGGGAGCAGACGAGCAGTACTTC	CASSFITAGADEQYF	TRBV6-3	TRBJ2-7
TGTGCCTGGAGTGTCCGGGACCCCCCGTGGGCCTACGAGCAGTACTTC	CAWSVRDPPWAYEQYF	TRBV30	TRBJ2-7
TGTGCCATCCTCGGAGGGGGTGGGGGCAGCTCCTACGAGCAGTACTTC	CAILGGGGGSSYEQYF	TRBV10-3	TRBJ2-7
TGTGCCAGCAGGGATGGCGAAGTGAACACTGAAGCTTTCTTT	CASRDGEVNTEAFF	TRBV12-3	TRBJ1-1
TGCGCCAGCATGAAACTCGGGACTAGAGAGACCCAGTACTTC	CASMKLGTRETQYF	TRBV10-1	TRBJ2-5
TGTGCCACCAGTGATCCGGAGAGAAGGGGATTTCGGGCCAAAAACATTCAGTACTTC	CATSDPERRGFRAKNIQYF	TRBV24-1	TRBJ2-4
TGTGCCAGCAGCAGCGAGATTAGCAATCAGCCCCAGCATTTT	CASSSEISNQPQHF	TRBV7-9	TRBJ1-5
TGTGCCAGCAGCCCCCCAACGACCCAGTACTTC	CASSPPTTQYF	TRBV5-4	TRBJ2-5
TGTGCCAGCAGCTCCACCCCAGCGGTCGAGACCCAGTACTTC	CASSSTPAVETQYF	TRBV12-3	TRBJ2-5
TGTGCCAGCAGCTTGATCCGGGAGGGAGGCGTCCACGCGTATGGCTACACCTTC	CASSLIREGGVHAYGYTF	TRBV7-4	TRBJ1-2
TGTGCCAGCAGCCGTCCGGAGGGGTTAAAGCATAGCAATCAGCCCCAGCATTTT	CASSRPEGLKHSNQPQHF	TRBV11-3	TRBJ1-5
TGTGCCAGCAGAGGGAAGCGTCGGCACGAGTCTGGAAACACCATATATTTT	CASRGKRRHESGNTIYF	TRBV6-5	TRBJ1-3
TGTGCCAGCAGTTCCCCTGCAGGGTCCTATAATTCACCCCTCCACTTT	CASSSPAGSYNSPLHF	TRBV12-4	TRBJ1-6
TGTGCCAGCAGCAAAGGGGCTAATGAAGACACTGAAGCTTTCTTT	CASSKGANEDTEAFF	TRBV7-3	TRBJ1-1
TGCGCCAGCAGTCCCGGGGGCAACGGAGACAATGAGCAGTTCTTC	CASSPGGNGDNEQFF	TRBV10-1	TRBJ2-1
TGTGCCAGCAGCTTGAGGACAGGGAGAAGAACCGTAAGTAGCCAGGTCTACGAGCAGTACTTC	CASSLRTGRRTVSSQVYEQYF	TRBV11-3	TRBJ2-7
TGTGCCAGCAGAATACTAGCGGGTGACAATGAGCAGTTCTTC	CASRILAGDNEQFF	TRBV12-3	TRBJ2-1
TGTGCCACCAGTGAGTTAGGCCCGGGGCAGGGACAGGGGTCGTACTCTGGAAACACCATATATTTT	CATSELGPGQGQGSYSGNTIYF	TRBV24-1	TRBJ1-3
TGTGCCAGCTCACCTTACCGGGACAGGATTGTCGGAAACTATGGCTACACCTTC	CASSPYRDRIVGNYGYTF	TRBV18	TRBJ1-2
TGTGCCAGCAGACGCAATGGACAGTTACCGCGCCATTACGAGCAGTACTTC	CASRRNGQLPRHYEQYF	TRBV27	TRBJ2-7
TGTGCCAGCAGAAGTTGCGGACAGAGTGCTTTCTTT	CASRSCGQSAFF	TRBV6-4	TRBJ1-1
TGCGCCAGCAGCTTGGCTTCTAGCGGGGTCCCTGCCCAGTACTTC	CASSLASSGVPAQYF	TRBV5-1	TRBJ2-5
TGTGCCAGCAGTTGCGGGGCAGACAGGAGGCAGCCCCAGCATTTT	CASSCGADRRQPQHF	TRBV27	TRBJ1-5
TGTGCCAAGGTACAGGGGCACGAGCAGTACTTC	CAKVQGHEQYF	TRBV6-5	TRBJ2-7
TGCACCCAGGGAGAGGGGGGACAAGCTTTCTTT	CTQGEGGQAFF	TRBV6-1	TRBJ1-1
TGTGCCAGCAGCGGCGGTAGCATTCCAGTCTCTGGAAACACCATATATTTT	CASSGGSIPVSGNTIYF	TRBV12-3	TRBJ1-3
TGTGCCAGCAGTTTCCAGTTAACTCGTTCTGAAGCTTTCTTT	CASSFQLTRSEAFF	TRBV27	TRBJ1-1
TGTGCCAGCAGCACTAGGCCTCAGCCCCAGCATTTT	CASSTRPQPQHF	TRBV5-4	TRBJ1-5
TGTGCCAGCAGCAACTTAAGGGGACCCTACGAGCAGTACTTC	CASSNLRGPYEQYF	TRBV13	TRBJ2-7
TGTGCCAGCAGCTCTACGATGCTTCGGCGGATGGCTCTAAACAATCAGCCCCAGCATTTT	CASSSTMLRRMALNNQPQHF	TRBV7-3	TRBJ1-5
TGTGCCAGCTCACCGCGGGCAGGGAAGCAGCCCCAGCATTTT	CASSPRAGKQPQHF	TRBV18	TRBJ1-5
TGTGCCAGCAGCTTGGTCCCCAACCACGAGGCCTACAATGAGCAGTTCTTC	CASSLVPNHEAYNEQFF	TRBV5-5	TRBJ2-1
TGCGCCAGCAGCCAAGACCAGCACGTAACAATTGGGGAGACCCAGTACTTC	CASSQDQHVTIGETQYF	TRBV4-1	TRBJ2-5
TGTGCCAGCAGCTTAGCCAACACAGGAGTTTGCACAGATACGCAGTATTTT	CASSLANTGVCTDTQYF	TRBV5-5	TRBJ2-3
TGTGCCAGCAGCCGTAGGGGGCGCTATACGAATAGCAATCAGCCCCAGCATTTT	CASSRRGRYTNSNQPQHF	TRBV13	TRBJ1-5
TGTGCCAGCAGCCAAGGGGGCCCTGGGGCCTGCTATGGCTACACCTTC	CASSQGGPGACYGYTF	TRBV14	TRBJ1-2
TGTGCCAGCAGCTTAGGTAGATTATCGGCCCACCTTAGGGGAGACACCGGGGAGCTGTTTTTT	CASSLGRLSAHLRGDTGELFF	TRBV11-2	TRBJ2-2
TGTGCCAGCAGTTACCCACCTGTGGGCGACAGGGGGCAGAACCCTAGCAATCAGCCCCAGCATTTT	CASSYPPVGDRGQNPSNQPQHF	TRBV6-5	TRBJ1-5
TGTGCCAGCAGCACCACCGGGACAAAACAGCCCCAGCATTTT	CASSTTGTKQPQHF	TRBV5-6	TRBJ1-5
TGTGCCAGCAGTTTACCGGTCCCTCCAGGGACTAGCGATCGAGAGACCCAGTACTTC	CASSLPVPPGTSDRETQYF	TRBV27	TRBJ2-5
TGTGCCAGCAGCCAACTAGAGGTAGGACGGGGCTACGAGCAGTACTTC	CASSQLEVGRGYEQYF	TRBV3-1	TRBJ2-7
TGTGCCAGCAGTGGACGCGAAGGCAGCTTAGGCGGAACGAACACTGAAGCTTTCTTT	CASSGREGSLGGTNTEAFF	TRBV6-5	TRBJ1-1
TGCAGGGACAGGGGCTTCTATGGCTACACCTTC	CRDRGFYGYTF	TRBV20-1	TRBJ1-2
TGTGCCAGCAAAAACAGCTTAAACACCATATATTTT	CASKNSLNTIYF	TRBV5-6	TRBJ1-3
TGTGCCAGCAGCGGACCCCACAGGATTGTGAATAGCAATCAGCCCCAGCATTTT	CASSGPHRIVNSNQPQHF	TRBV9	TRBJ1-5
TGTGCCAGTAGGGGGAGCCGGAGAGTATACGAGCAGTACTTC	CASRGSRRVYEQYF	TRBV7-3	TRBJ2-7
TGTGCCAGCAGCTCAGAAACGTGGGGCTCCGAAGCTTTCTTT	CASSSETWGSEAFF	TRBV6-4	TRBJ1-1
TGTGCCAGCAGCTACAACAGGGAGATTTACGCAACTAATGAAAAACTGTTTTTT	CASSYNREIYATNEKLFF	TRBV9	TRBJ1-4
TGTGCCAGCAGTTACTCGAGGTTCTTTTGGGGGGCCGGTCACACCGGGGAGCTGTTTTTT	CASSYSRFFWGAGHTGELFF	TRBV6-5	TRBJ2-2
TGTGCCAGCAGTGGATTCCGGGACAGGGAGGATATGGAGACCCAGTACTTC	CASSGFRDREDMETQYF	TRBV27	TRBJ2-5
TGCAGTGCTAGAGATCCTCCAGGGAGAAACCATTCCACTGAAGCTTTCTTT	CSARDPPGRNHSTEAFF	TRBV20-1	TRBJ1-1
TGCAGTGCTAGAGATCGCTTCGGACAGGGGCAGGTTGCCTACGAGCAGTACTTC	CSARDRFGQGQVAYEQYF	TRBV20-1	TRBJ2-7
TGTGCCAGCAGCCAAGGCCGGGACGATTACAATGAGCAGTTCTTC	CASSQGRDDYNEQFF	TRBV3-1	TRBJ2-1
TGTGCCACCAGCAGAGATCCCGACACTAATGAAAAACTGTTTTTT	CATSRDPDTNEKLFF	TRBV15	TRBJ1-4
TGTGCCAGCAGGGTCCTCGTAAGGGACCCGGGCTCCTACAATGAGCAGTTCTTC	CASRVLVRDPGSYNEQFF	TRBV25-1	TRBJ2-1
TGTGCCAGCAGTGAAAGGAATTGGACAGGGCCGAACACCGGGGAGCTGTTTTTT	CASSERNWTGPNTGELFF	TRBV25-1	TRBJ2-2
TGTGCCAGCAGTCAGCTTGCCAGGGGGAAAGAATGCAATCAGCCCCAGCATTTT	CASSQLARGKECNQPQHF	TRBV6-8	TRBJ1-5
TGTGCCAGCAGCTCCCTGCTAGCGGCTCAAGAGACCCAGTACTTC	CASSSLLAAQETQYF	TRBV7-8	TRBJ2-5
TGTGCTGGACGGGACAAAGGTGAAGCTTTCTTT	CAGRDKGEAFF	TRBV2	TRBJ1-1
TGTGCCAGCAGAACTGGACAGGGTGGGACTGAGACCCAGTACTTC	CASRTGQGGTETQYF	TRBV2	TRBJ2-5
TGTGCCATCAGTGAGTCGATACCTCCCTGGGGAGTACTCTCCTACAATGAGCAGTTCTTC	CAISESIPPWGVLSYNEQFF	TRBV10-3	TRBJ2-1
TGTGCCAGCAGCCAAGTAGCGGGTTTACCCGCATACCAAGAGACCCAGTACTTC	CASSQVAGLPAYQETQYF	TRBV3-1	TRBJ2-5
TGTGCCAGCAGTAACGACAGGGGCCTTATGGCTGAAGCTTTCTTT	CASSNDRGLMAEAFF	TRBV27	TRBJ1-1
TGCGCCAGCAGCGGGACAGAATCCTACGAGCAGTACTTC	CASSGTESYEQYF	TRBV5-1	TRBJ2-7
TGTGCCACCAGGCCCGACGGAGACGAGCAGTACTTC	CATRPDGDEQYF	TRBV24-1	TRBJ2-7
TGTGCCAGCAGTTCCGGACTAGCGAGTAGGGAGCAGTTCTTC	CASSSGLASREQFF	TRBV6-3	TRBJ2-1
TGCGCCAGCCATCCAATTGAGCAGTTCTTC	CASHPIEQFF	TRBV10-1	TRBJ2-1
TGTGCCAGCACCTTGCGGCTCGAGTCCTACGAGCAGTACTTC	CASTLRLESYEQYF	TRBV27	TRBJ2-7
TGTGCCAGGCACGTAACTCCAGACAGGGACCCTAAAGAGACCCAGTACTTC	CARHVTPDRDPKETQYF	TRBV6-1	TRBJ2-5
TGTGCCAGCAGCTTAGATCTGAATGACCCGGCGGGAGAGGGGTACGAGCAGTACTTC	CASSLDLNDPAGEGYEQYF	TRBV11-3	TRBJ2-7
TGTGCCAGCAGATTAGGAGGGAGTGGCGATGAGCAGTTCTTC	CASRLGGSGDEQFF	TRBV6-8	TRBJ2-1
TGCACTCTAGCGGGCACAGATACGCAGTATTTT	CTLAGTDTQYF	TRBV20-1	TRBJ2-3
TGTGCCAGCAGTGAACACAGGGGGCGGGTCCTCCACACTGAAGCTTTCTTT	CASSEHRGRVLHTEAFF	TRBV6-1	TRBJ1-1
TGTGCCAGTACCTGCGGGCCCAGGACGATGCGGGGGGGGAACACTGAAGCTTTCTTT	CASTCGPRTMRGGNTEAFF	TRBV19	TRBJ1-1
TGTGCCAGCAGTCAGCAGGGGTTAAAGGGAACCATATATTTT	CASSQQGLKGTIYF	TRBV27	TRBJ1-3
TGTGCCAGCAGCGTAGGAAATAGCGACCGAGGGGAGCTGTTTTTT	CASSVGNSDRGELFF	TRBV9	TRBJ2-2
TGCGCCAGCAGCTTCCTTCCTATAGAGACCCAGTACTTC	CASSFLPIETQYF	TRBV5-1	TRBJ2-5
TGTGCCAGCAGCCAACCTCCGGACCTGGGGTGGGGCGCTTTCTTT	CASSQPPDLGWGAFF	TRBV4-2	TRBJ1-1
TGTGCCACGAGGGGACAGGGCTCTCCCGGGAATTCACCCCTCCACTTT	CATRGQGSPGNSPLHF	TRBV19	TRBJ1-6
TGTGCCAGCAGCGCGGGCTCTTCCGAATCAGGTTTCGGGGAGCTGTTTTTT	CASSAGSSESGFGELFF	TRBV7-9	TRBJ2-2
TGTGCCAGCAGCAGGGGGTTGAATGAAAAACTGTTTTTT	CASSRGLNEKLFF	TRBV2	TRBJ1-4
TGTGCCAGCAGCCAAGATAGACGGACAAGGGGGCAGCCCCAGCATTTT	CASSQDRRTRGQPQHF	TRBV14	TRBJ1-5
TGTGCCAGCAGCTTAGGCCCGAGCTATAATTCACCCCTCCACTTT	CASSLGPSYNSPLHF	TRBV7-2	TRBJ1-6
TGCAGTGCTAGAGATCCGGAGTTGGGACTAGCGGGGGGGCACAATGAGCAGTTCTTC	CSARDPELGLAGGHNEQFF	TRBV20-1	TRBJ2-1
TGTGCCTGGGGGGAGTATCACCGCATGAACACTGAAGCTTTCTTT	CAWGEYHRMNTEAFF	TRBV30	TRBJ1-1
TGCGCCAGCAGTGTATTTCCACGGGGAAATAGCAATCAGCCCCAGCATTTT	CASSVFPRGNSNQPQHF	TRBV10-1	TRBJ1-5
TGTGCCAGCAGTCGAAAATGCGTCCCCGGGGAGCTGTTTTTT	CASSRKCVPGELFF	TRBV27	TRBJ2-2
TGCAGTGCTAGAATTGCGACAGGGAGGAAGCCCCAGCATTTT	CSARIATGRKPQHF	TRBV20-1	TRBJ1-5
TGTGCCAGCAGCCGGTTTCACAGGGTGGCTGAAGCTTTCTTT	CASSRFHRVAEAFF	TRBV11-2	TRBJ1-1
TGTGCCAGCAGCCAAGACTACTGGACAGGGCTAGACTATGGCTACACCTTC	CASSQDYWTGLDYGYTF	TRBV14	TRBJ1-2
TGCGCCAGCAGCTCCTGGACGTCGGGTGGCTACACCTTC	CASSSWTSGGYTF	TRBV5-1	TRBJ1-2
TGTGCCAGCAGCCAACTCAGGGTCGAGCAGTACTTC	CASSQLRVEQYF	TRBV3-1	TRBJ2-7
TGCGCCAGCAGCCAAGATTCCAGGCGAGGCGGCAGGGGGGACTCCTACGAGCAGTACTTC	CASSQDSRRGGRGDSYEQYF	TRBV4-3	TRBJ2-7
TGTGCCAGCCCAGACAGTGTTGTCAACTATGGCTACACCTTC	CASPDSVVNYGYTF	TRBV6-4	TRBJ1-2
TGTGCCTGGAGGTGGGACAGAACTGAAGCTTTCTTT	CAWRWDRTEAFF	TRBV30	TRBJ1-1
TGTGCCAGCAGTGCGGGGGGGCCGGGCTCCTACGAGCAGTACTTC	CASSAGGPGSYEQYF	TRBV6-5	TRBJ2-7
TGTGCCAGCAGCTTCAGGGTGGCCTCTGGAAACACCATATATTTT	CASSFRVASGNTIYF	TRBV9	TRBJ1-3
TGTGCCAAATTTGGTCCCCCCGCGGGCACTGAAGCTTTCTTT	CAKFGPPAGTEAFF	TRBV27	TRBJ1-1
TGCGCCAGCAGCTTGGGACAGGGGGACCGTACTCAGGACGCTTACCACATTGAGCAGTTCTTC	CASSLGQGDRTQDAYHIEQFF	TRBV5-1	TRBJ2-1
TGCGCCAGCAGGCCTCCATGGGTGCGAGGACAGGGGACTGGACCTGAAGCTTTCTTT	CASRPPWVRGQGTGPEAFF	TRBV5-1	TRBJ1-1
TGTGCCAGCAGAGTGGGAGGGGGGGGTTACGAGCAGTACTTC	CASRVGGGGYEQYF	TRBV6-5	TRBJ2-7
TGCAGTGCAACAGCTGGCTACACCTTC	CSATAGYTF	TRBV20-1	TRBJ1-2
TGTGCCAGCAGCGGGACAGAGAATCAGCCCCAGCATTTT	CASSGTENQPQHF	TRBV7-3	TRBJ1-5
TGTGCCAGCAGTTACCAGACTAACTATGGCTACACCTTC	CASSYQTNYGYTF	TRBV6-5	TRBJ1-2
TGTGCTAGTGGTTTGGTACGAGGGCCAACTGAAGCTTTCTTT	CASGLVRGPTEAFF	TRBV12-5	TRBJ1-1
TGTGCCATCAGTGAGGGACCTTTGGGCACCTTC	CAISEGPLGTF	TRBV10-3	TRBJ1-2
TGCGCCAGCAGTTTTAACGGGGGGCTCTACGAGCAGTACTTC	CASSFNGGLYEQYF	TRBV10-2	TRBJ2-7
TGTGCCAGCAGGCTGACTACCTACGAGCAGTACTTC	CASRLTTYEQYF	TRBV25-1	TRBJ2-7
TGTGCCAGCAGGACCTCTTTGTATGAGCAGTTCTTC	CASRTSLYEQFF	TRBV12-4	TRBJ2-1
TGTGCCAGCAGTTTAAAGACCTTGGACAACCGAAGAAGATGCAATCAGCCCCAGCATTTT	CASSLKTLDNRRRCNQPQHF	TRBV12-3	TRBJ1-5
TGTGCTAGGCGGCTCAATCAGCCCCAGCATTTT	CARRLNQPQHF	TRBV6-4	TRBJ1-5
TGTGCCAGCTCACCTTTCCACACGGGGGCGGGGCACGAGCAGTACTTC	CASSPFHTGAGHEQYF	TRBV18	TRBJ2-7
TGTGCCAGCTCACCACTGGGGCGTGGGCAGCCGGGTAATGAAAAACTGTTTTTT	CASSPLGRGQPGNEKLFF	TRBV18	TRBJ1-4
TGCAGTGCTGGAAGCGTAAGACAGGGAAACTCATTTCGAGAAGAGACCCAGTACTTC	CSAGSVRQGNSFREETQYF	TRBV20-1	TRBJ2-5
TGTGCCAGCAGCTTAGGGGCAGCTCCGCTGACTGGAAACACCATATATTTT	CASSLGAAPLTGNTIYF	TRBV11-2	TRBJ1-3
TGTGCCAGCATTTGTTATTTGGGACTCGTCACAACCATTCAGTACTTC	CASICYLGLVTTIQYF	TRBV13	TRBJ2-4
TGCAGTGCTGACAGGGGGCCGTATGGCTACACCTTC	CSADRGPYGYTF	TRBV20-1	TRBJ1-2
TGTGCCAGCAGTTCGGGGGGGGTTCAGAATGAGCAGTTCTTC	CASSSGGVQNEQFF	TRBV27	TRBJ2-1
TGTGCCAGCAGCTTCCTTCCTCAGGAGTTCGTCGAGACCCAGTACTTC	CASSFLPQEFVETQYF	TRBV11-2	TRBJ2-5
TGTGCCAGCAGTTACAGTAATTGCGAGCAGTACTTC	CASSYSNCEQYF	TRBV6-5	TRBJ2-7
TGTGCCAGCAGTTACGGGGCAAGGATGATCTATGGCTACACCTTC	CASSYGARMIYGYTF	TRBV6-5	TRBJ1-2
TGCAGTGCTCCCGACTTCACAGATACGCAGTATTTT	CSAPDFTDTQYF	TRBV20-1	TRBJ2-3
TGTGCCAGCAGCAATGAAGGGCCTGGAGGGAACACTGAAGCTTTCTTT	CASSNEGPGGNTEAFF	TRBV7-3	TRBJ1-1
TGTGCCAGCAGTGCTACCCCACAGGGATGGTCTGGAAACACCATATATTTT	CASSATPQGWSGNTIYF	TRBV6-4	TRBJ1-3
TGCGCCAGCAGCTATGGGGACAGGGGCGATCGGAGGATACAGCCCCAGCATTTT	CASSYGDRGDRRIQPQHF	TRBV5-1	TRBJ1-5
TGCAGTGCTGCTTTCGGGACAGTCGGGAACACTGAAGCTTTCTTT	CSAAFGTVGNTEAFF	TRBV20-1	TRBJ1-1
TGTGCCAGCAGCTTAAGGGGGTCGGGGAACGTCCTGACTTTC	CASSLRGSGNVLTF	TRBV7-9	TRBJ2-6
TGTGCCAGCAGCCGACCGACAGGTTGTGAAGCTTTCTTT	CASSRPTGCEAFF	TRBV11-3	TRBJ1-1
TGTGCCAGCAGTTACGGACCAACGGGGACGGTCGAGCAGTACTTC	CASSYGPTGTVEQYF	TRBV6-5	TRBJ2-7
TGTGCCACACCTAGTCTGAATGAGCAGTTCTTC	CATPSLNEQFF	TRBV13	TRBJ2-1
TGTGCCAGCAGTTACTCAGTCCGCGGGGGGACAGATACGCAGTATTTT	CASSYSVRGGTDTQYF	TRBV6-5	TRBJ2-3
TGTGCCAGCAGTCCCGGGGGGGGAGACTACGAGCAGTACTTC	CASSPGGGDYEQYF	TRBV27	TRBJ2-7
TGTGCCAGCAGTATAGCGGTAACTTCGTTTACTGAAGCTTTCTTT	CASSIAVTSFTEAFF	TRBV27	TRBJ1-1
TGCGCCAGCAGTGAGCTGGGTGGACAGGGAGGCACAGATACGCAGTATTTT	CASSELGGQGGTDTQYF	TRBV10-1	TRBJ2-3
TGTGCTAGTGGTTTGCCCCTGGGGGGGGGCCCTAGCACAGATACGCAGTATTTT	CASGLPLGGGPSTDTQYF	TRBV12-5	TRBJ2-3
TGTGCCAGCAGCCAGGGTCATACGGAGTACAATGAGCAGTTCTTC	CASSQGHTEYNEQFF	TRBV13	TRBJ2-1
TGTGCTAGTGGTTTGCGGACTAGTTCCGGGCAGGACATTCAGTACTTC	CASGLRTSSGQDIQYF	TRBV12-5	TRBJ2-4
TGTGCCAAGACTGACCGCACTGAAGCTTTCTTT	CAKTDRTEAFF	TRBV7-9	TRBJ1-1
TGCAGTGCGCCAGGGGGACTAGCGGGAGGTCCCTACGAGCAGTACTTC	CSAPGGLAGGPYEQYF	TRBV20-1	TRBJ2-7
TGCGCCAGCAGTGATAACACCAGAACAACTAATGAAAAACTGTTTTTT	CASSDNTRTTNEKLFF	TRBV10-1	TRBJ1-4
TGTGCCAGCAGCTCGGTGCCCCCCGGGACGGTTTACAATGAGCAGTTCTTC	CASSSVPPGTVYNEQFF	TRBV7-6	TRBJ2-1
TGTGCCAGATTAAGACTAGCGGGAGTGAAAGAGACCCAGTACTTC	CARLRLAGVKETQYF	TRBV19	TRBJ2-5
TGTGCCAGCAGTCTCGGGACAGGGGGCCGTAACAACACCGGGGAGCTGTTTTTT	CASSLGTGGRNNTGELFF	TRBV6-3	TRBJ2-2
TGTGCCAGCAGCTCCAACAAAGGGGTTTGCTATGGCTACACCTTC	CASSSNKGVCYGYTF	TRBV5-6	TRBJ1-2
TGTGCCAGCAGTTACGGAAAAACGGGACAGGGGGGTGGCTACACCTTC	CASSYGKTGQGGGYTF	TRBV6-5	TRBJ1-2
TGTGCCAGCAGCTTGGCAAGGTTCCCAGCGGGGGCCAAAAACATTCAGTACTTC	CASSLARFPAGAKNIQYF	TRBV5-6	TRBJ2-4
TGTGCCAGCAGTGATGACAGGGGGAATGAAAAACTGTTTTTT	CASSDDRGNEKLFF	TRBV6-2	TRBJ1-4
TGTGCCAGCAGCGTAGCGAGGGCCTATGGCTACACCTTC	CASSVARAYGYTF	TRBV9	TRBJ1-2
TGTGCCAGCAGCTTCGGTCGTCCGAAACAGGGGGGCACAGATACGCAGTATTTT	CASSFGRPKQGGTDTQYF	TRBV11-2	TRBJ2-3
TGTGCCAGCAGTTCGCTGGACAGTCGGGCTGGAAACACCATATATTTT	CASSSLDSRAGNTIYF	TRBV27	TRBJ1-3
TGTGCCAGCAGCGCGAGGGTCGGACAGCCCCAGCATTTT	CASSARVGQPQHF	TRBV7-9	TRBJ1-5
TGCGCCAGCAGTCCTGCTGGCCCGGGACTAGCCCCGTCCTACAATGAGCAGTTCTTC	CASSPAGPGLAPSYNEQFF	TRBV5-1	TRBJ2-1
TGTGCCAGCAGTGGGACATTAGACAGCGTGTACGAGCAGTACTTC	CASSGTLDSVYEQYF	TRBV25-1	TRBJ2-7
TGTGCCAGCAGTTACTCGGGGCTGGCTATCCCCGGGGAGCTGTTTTTT	CASSYSGLAIPGELFF	TRBV6-5	TRBJ2-2
TGTGCCAGAAGTCGGGAAAGCTCCTATAATTCACCCCTCCACTTT	CARSRESSYNSPLHF	TRBV6-1	TRBJ1-6
TGTGCCAGCAGTCGGAATTTAGCGGGGGGGGCCACAGATACGCAGTATTTT	CASSRNLAGGATDTQYF	TRBV6-6	TRBJ2-3
TGTGCCAGCAGCTTGACTGAGGGGACAGGGGGCTACAATGAGCAGTTCTTC	CASSLTEGTGGYNEQFF	TRBV5-6	TRBJ2-1
TGTGCCAGCAGTCCGGAAACCTACGAGCAGTACTTC	CASSPETYEQYF	TRBV7-3	TRBJ2-7
TGTGCCAGCACTGAAACCGGGACAGGGTCGTTGAACACCGGGGAGCTGTTTTTT	CASTETGTGSLNTGELFF	TRBV6-5	TRBJ2-2
TGTGCCAGCAGTGCGAAGGGACTAGCAATGGAGCAGTACTTC	CASSAKGLAMEQYF	TRBV2	TRBJ2-7
TGTGCCAGCAGCGTAGCGATAGGAAGTAGGGGGGCCTCTGGAAACACCATATATTTT	CASSVAIGSRGASGNTIYF	TRBV9	TRBJ1-3
TGCAGTGCTCAGTTGCCGGGACAGGGCGAGCAGTACTTC	CSAQLPGQGEQYF	TRBV20-1	TRBJ2-7
TGTGCCAGCAGCCCAGGGTGGACAGCGGGGGGGCCACATGTAGACAATGAGCAGTTCTTC	CASSPGWTAGGPHVDNEQFF	TRBV7-6	TRBJ2-1
TGCAGTAGGGCAGGAAACACCATATATTTT	CSRAGNTIYF	TRBV20-1	TRBJ1-3
TGTGCCATCAGGGGACTAGCGGGAGAGAAGAATCATGAGCAGTTCTTC	CAIRGLAGEKNHEQFF	TRBV10-3	TRBJ2-1
TGCAGCGCCCGGACTGGCGAAGAAAATCAGCCCCAGCATTTT	CSARTGEENQPQHF	TRBV29-1	TRBJ1-5
TGTGCCAGCAGCAGGGGGGGTTCCAGAGAGACCCAGTACTTC	CASSRGGSRETQYF	TRBV6-4	TRBJ2-5
TGCAGTGCTAGAAGACAGGGATGTGGCTACACCTTC	CSARRQGCGYTF	TRBV20-1	TRBJ1-2
TGTGCCAGCAGCTTAGGTAAACAGGGGAGGAATCAGCCCCAGCATTTT	CASSLGKQGRNQPQHF	TRBV7-9	TRBJ1-5
TGTGCCAGCAGTTTAAATAAGGGACCATCCCTGTGGACCCATCCTATAGTTAGGAACACTGAAGCTTTCTTT	CASSLNKGPSLWTHPIVRNTEAFF	TRBV27	TRBJ1-1
TGTGCCAGCAGCTTAGGGCCTAGCGGAAAGCAGTACTTC	CASSLGPSGKQYF	TRBV13	TRBJ2-7
TGTGCCAGCATTGGACCAGGGGTCTATAATTCACCCCTCCACTTT	CASIGPGVYNSPLHF	TRBV6-5	TRBJ1-6
TGTGCCAGCAGCTTAGACGCCTCCGGGTCCTTC	CASSLDASGSF	TRBV7-8	TRBJ2-7
TGTGCCAGCAGTTTACTCCCCGGGGGGAGCGGTTCACCCCTCCACTTT	CASSLLPGGSGSPLHF	TRBV28	TRBJ1-6
TGTGCCACCAGCAAAACGCCTCAGCCCCAGCATTTT	CATSKTPQPQHF	TRBV15	TRBJ1-5
TGTGCCAGCAGTGGGGCCCCTCCAGGGGGGGGTAGCACAGATACGCAGTATTTT	CASSGAPPGGGSTDTQYF	TRBV6-4	TRBJ2-3
TGTGCCTGGAGTCCTAACCACAGGAGTTATCAGCCCCAGCATTTT	CAWSPNHRSYQPQHF	TRBV30	TRBJ1-5
TGTGCCACCAGTGATCTCCGGTTGGGGGGGAGCTCCTATAATTCACCCCTCCACTTT	CATSDLRLGGSSYNSPLHF	TRBV24-1	TRBJ1-6
TGTGCCAGCAGCTGGACAGGGGGCACTGAAGCTTTCTTT	CASSWTGGTEAFF	TRBV13	TRBJ1-1
TGCGCCAGCAGCTTGGCGATGTTGGCCAAAAACATTCAGTACTTC	CASSLAMLAKNIQYF	TRBV5-1	TRBJ2-4
TGTGCCAGCAGCCCCGGGTCAAATTTTGAGTGTGGCTACACCTTC	CASSPGSNFECGYTF	TRBV7-8	TRBJ1-2
TGTGCCAGCAGCCAGCGGACTTCAGGGTTTAATGAGCAGTTCTTC	CASSQRTSGFNEQFF	TRBV7-6	TRBJ2-1
TGTGCCAGTAGTATAGCCTGGTTGTGGATAAGTTCCATCCAAGAGACCCAGTACTTC	CASSIAWLWISSIQETQYF	TRBV19	TRBJ2-5
TGTGCCAGCAGTTTAGCTCCCGGTTCCGGGACTAGCGAGCACACAGATACGCAGTATTTT	CASSLAPGSGTSEHTDTQYF	TRBV12-4	TRBJ2-3
TGTGCCAGCAGCCGGTGCCCCTCCAGGCCTGAAGCTTTCTTT	CASSRCPSRPEAFF	TRBV9	TRBJ1-1
TGTGCCAGCATTTCCCGAGAGGAGGGATCAGCCAACTACGAGCAGTACTTC	CASISREEGSANYEQYF	TRBV7-3	TRBJ2-7
TGTGCCAGCAGGCCGGGACACACTGAAGCTTTCTTT	CASRPGHTEAFF	TRBV12-3	TRBJ1-1
TGTGCCAGCAGTGAATCGGGGTGGGAGGGAGTTATTGTTCGAGATCAGCCCCAGCATTTT	CASSESGWEGVIVRDQPQHF	TRBV25-1	TRBJ1-5
TGTGCCAGCAGAAACAGGGTCGTAGAGACCCAGTACTTC	CASRNRVVETQYF	TRBV27	TRBJ2-5
TGTGCCAGCAGCAAGGGGGATGGGAGGCCAACTAATGAAAAACTGTTTTTT	CASSKGDGRPTNEKLFF	TRBV11-2	TRBJ1-4
TGTGCCACCAACCAGACAGCAGGGGAAGAGACCCAGTACTTC	CATNQTAGEETQYF	TRBV24-1	TRBJ2-5
TGTGCCAGCAGCCCCATTTGGGACGCTAACTATGGCTACACCTTC	CASSPIWDANYGYTF	TRBV7-3	TRBJ1-2
TGTGCCAGCAGCCGCACAACGGGACTATACGCCTACGAGCAGTACTTC	CASSRTTGLYAYEQYF	TRBV7-8	TRBJ2-7
TGTGCCAGCAGCTTGGGAAGGCACAGGGAGAACCTGCTGTTTTTT	CASSLGRHRENLLFF	TRBV5-6	TRBJ1-4
TGCGCCAGCATGGGGACTTGTGGAGAGACCCAGTACTTC	CASMGTCGETQYF	TRBV10-1	TRBJ2-5
TGCAGTGGTGTACACAATGAGCAGTTCTTC	CSGVHNEQFF	TRBV20-1	TRBJ2-1
TGTGCTAGTGGGACAGGGAACTACACCTACGAGCAGTACTTC	CASGTGNYTYEQYF	TRBV12-5	TRBJ2-7
TGTGCCAGTAGTATCGCACCCCCAACCTGGCCCCCAAACGAGCAGTACTTC	CASSIAPPTWPPNEQYF	TRBV19	TRBJ2-7
TGCGCCAGCAGCCAAGCCCCCACAGGGCAAGATTGCAATCAGCCCCAGCATTTT	CASSQAPTGQDCNQPQHF	TRBV4-1	TRBJ1-5
TGCGCCAGCATCGACAGGGGACGGGGGGAAGACACCGGGGAGCTGTTTTTT	CASIDRGRGEDTGELFF	TRBV10-1	TRBJ2-2
TGTGCCAGCAGCTTGATGGACAGGGGAACCCGTAATGAAAAACTGTTTTTT	CASSLMDRGTRNEKLFF	TRBV5-6	TRBJ1-4
TGTGCCAGCAGCTTGGAACGGACAGGGGCTGAGCAGTTCTTC	CASSLERTGAEQFF	TRBV5-5	TRBJ2-1
TGCAGTGCAGGGGGGCTTGCAGTGGGCAATCAGCCCCAGCATTTT	CSAGGLAVGNQPQHF	TRBV20-1	TRBJ1-5
TGTGCCAGCAGGGACAGGGATTGGCACACTGAAGCTTTCTTT	CASRDRDWHTEAFF	TRBV6-4	TRBJ1-1
TGTGCTGAGGGCCATTTTCTCAACGAGCAGTACTTC	CAEGHFLNEQYF	TRBV7-7	TRBJ2-7
TGTGCCAGCAGCCCCCGCCGGGACAGGGGACAAACGGGGGAGCAGTACTTC	CASSPRRDRGQTGEQYF	TRBV14	TRBJ2-7
TGTGCCAGCAGTTACTCGAGTGTAGAAAACAGGGGGGGCACCTACGAGCAGTACTTC	CASSYSSVENRGGTYEQYF	TRBV6-6	TRBJ2-7
TGTGCCAGCAGAGGGAGGGAGGTCGAGCAGTACTTC	CASRGREVEQYF	TRBV6-3	TRBJ2-7
TGTGCCAGCAGCGCTGACAGGGGACACACCGGGGAGCTGTTTTTT	CASSADRGHTGELFF	TRBV4-2	TRBJ2-2
TGTGAGTGTTGCGACAGAGGCAATCAGCCCCAGCATTTT	CECCDRGNQPQHF	TRBV3-1	TRBJ1-5
TGTGCCAGCAGCGTCCAGTTGCGGGCCCAGCATTTT	CASSVQLRAQHF	TRBV11-3	TRBJ1-5
TGTGCCAGCAGTTTCCGGAGGAGGGGGGTCTGCGGAACCCACACCGGGGAGCTGTTTTTT	CASSFRRRGVCGTHTGELFF	TRBV28	TRBJ2-2
TGTGCCAGCAGTTTAGGTCCCGGGACAGGGGCCTGCGGGGAGCTGTTTTTT	CASSLGPGTGACGELFF	TRBV28	TRBJ2-2
TGTGCCAGCAGTCCCTTCCGGGACAGGGCTGAAGCTTTCTTT	CASSPFRDRAEAFF	TRBV6-2	TRBJ1-1
TGTGCCAGCAGCAAAGAAATTTCGACCCACAGGGGGGTGGGTGTCTTAGCCAAAAACATTCAGTACTTC	CASSKEISTHRGVGVLAKNIQYF	TRBV13	TRBJ2-4
TGCGCCAGCAGCCATCCTACGCTTCAGCCCCAGCATTTT	CASSHPTLQPQHF	TRBV4-1	TRBJ1-5
TGTGCCAGCAGCCTTTACCCAGGGGGAAGGCAGCCCCAGCATTTT	CASSLYPGGRQPQHF	TRBV7-3	TRBJ1-5
TGCAGTGCTAACGGGACTAGCGGGACCCAGTACTTC	CSANGTSGTQYF	TRBV20-1	TRBJ2-5
TGTGCCAGCAGCTTAGGCGGGAGGTCTTACAATGAGCAGTTCTTC	CASSLGGRSYNEQFF	TRBV7-6	TRBJ2-1
TGTGCCAGCACCCCTATGGACAGTAGCTCTGGGGCCAACGTCCTGACTTTC	CASTPMDSSSGANVLTF	TRBV6-2	TRBJ2-6
TGCGCCAGTTTCGAGACCGGAGGTCAGCCCCAGCATTTT	CASFETGGQPQHF	TRBV10-1	TRBJ1-5
TGTGCCATCAGTGAGCAAGGGCGGGAGCGGGGGAATCAGCCCCAGCATTTT	CAISEQGRERGNQPQHF	TRBV10-3	TRBJ1-5
TGCGCCAGCAGCTCCGAGCACAATGAGCAGTTCTTC	CASSSEHNEQFF	TRBV5-1	TRBJ2-1
TGTGCCAGCAGAAGCGCGGGTGGGAGGGGCACAGATACGCAGTATTTT	CASRSAGGRGTDTQYF	TRBV7-9	TRBJ2-3
TGTGCCAGCGGTAGAACGAGGGGGACGCCTAACTATGGCTACACCTTC	CASGRTRGTPNYGYTF	TRBV9	TRBJ1-2
TGTGCCACCGCCCTAGGCGCCCGCACCTACAATGAGCAGTTCTTC	CATALGARTYNEQFF	TRBV24-1	TRBJ2-1
TGTGCCTGGACTACCAAGAGACTGAAGGGGAAAAACATTCAGTACTTC	CAWTTKRLKGKNIQYF	TRBV30	TRBJ2-4
TGCAGTGCACGTCGGACTAGCGGGGGCCCGAGGACAGGTGTGCAGTTCTTC	CSARRTSGGPRTGVQFF	TRBV20-1	TRBJ2-1
TGTGCCAGCAGCCGAACAGGGGTGTACGAGCAGTACTTC	CASSRTGVYEQYF	TRBV13	TRBJ2-7
TGTGCCAGCTCACCACTCAAGCTCCGATTGGGGGGGAGTTTTCCCGGGGGGGCCGGGGAGCTGTTTTTT	CASSPLKLRLGGSFPGGAGELFF	TRBV18	TRBJ2-2
TGTGCCATTCCTTGGACTAGCCGGGACGAGCAGTACTTC	CAIPWTSRDEQYF	TRBV30	TRBJ2-7
TGTGCCAGCAGTTTGAAGCCCGGGACCCCCAGTGTGGGTGAAAAACTGTTTTTT	CASSLKPGTPSVGEKLFF	TRBV27	TRBJ1-4
TGTGCCAGCAGCCAGGGGCTGCCGGGACAATGGAATAGCAATCAGCCCCAGCATTTT	CASSQGLPGQWNSNQPQHF	TRBV7-9	TRBJ1-5
TGTGCCAGCAGCATGTCCGGAACCTACGAGCAGTACTTC	CASSMSGTYEQYF	TRBV6-5	TRBJ2-7
TGTGCCACCAGTGAACTGGAGCGGTTAGGGACCTACGAGCAGTACTTC	CATSELERLGTYEQYF	TRBV24-1	TRBJ2-7
TGTGCCAGCAGTGACTCGAGACTAGCGTCTGGGCGCATGTACCAAGAGACCCAGTACTTC	CASSDSRLASGRMYQETQYF	TRBV6-4	TRBJ2-5
TGTGCCAGCAGTGAATCGGGGAGCAATCAGCCCCAGCATTTT	CASSESGSNQPQHF	TRBV25-1	TRBJ1-5
TGTGCCCTGATAAGCCGGGACAGCTATGGCTACACCTTC	CALISRDSYGYTF	TRBV24-1	TRBJ1-2
TGCGCCAGCAGGGGTTGGCTCTACGAGCAGTACTTC	CASRGWLYEQYF	TRBV4-3	TRBJ2-7
TGTGCCAGCAGTTTATGCTCAAGGACAGGGAGCACAGATACGCAGTATTTT	CASSLCSRTGSTDTQYF	TRBV28	TRBJ2-3
TGTGCCAGCAAGGGAATACACTCCTACGAGCAGTACTTC	CASKGIHSYEQYF	TRBV6-1	TRBJ2-7
TGTGCCAGCAGCCAAGGAGTGAACCGGGACAGGGTGGCGCGCTCTGGGGCCAACGTCCTGACTTTC	CASSQGVNRDRVARSGANVLTF	TRBV4-2	TRBJ2-6
TGTGCCAGCAGGGGGGTGCGGGGGGGGAGGGACAATGAGCAGTTCTTC	CASRGVRGGRDNEQFF	TRBV9	TRBJ2-1
TGTGCTAGTGGTTCATTCCGCTACAGGGGGACCCAGTACTTC	CASGSFRYRGTQYF	TRBV12-5	TRBJ2-5
TGTGCCAGCAGCTCCGAGTGCAACCTCCCGGGACAGGGGAGGATTGAGCAGTACTTC	CASSSECNLPGQGRIEQYF	TRBV5-6	TRBJ2-7
TGCGCCAGCAGTATCATTCGGGGGGAGGAGTATAATGAGCAGTTCTTC	CASSIIRGEEYNEQFF	TRBV10-2	TRBJ2-1
TGTGCCAGCAGCATTAAATTCCGACTAGAATCGTACTGGAACATTCAGTACTTC	CASSIKFRLESYWNIQYF	TRBV7-3	TRBJ2-4
TGTGCCAGCAGCCCCAAGACCTACACTTTTCAGCCCCAGCATTTT	CASSPKTYTFQPQHF	TRBV3-1	TRBJ1-5
TGTGCCAGCAGCCAAGAAGACACGGGGACAGGGGGCACCGGGGAGCTGTTTTTT	CASSQEDTGTGGTGELFF	TRBV3-1	TRBJ2-2
TGTGCCAGCAGCTCGGTTTCTAGGATTTACGAGCAGTACTTC	CASSSVSRIYEQYF	TRBV7-3	TRBJ2-7
TGCAGTGCTAGTCGGGGGGGTGGAAACACCATATATTTT	CSASRGGGNTIYF	TRBV20-1	TRBJ1-3
TGTGCCACGGGACTAGCGCCCTACAATGAGCAGTTCTTC	CATGLAPYNEQFF	TRBV6-3	TRBJ2-1
TGCGCCAGCAGCTTGGCGCGCAGGCGTGGGACCGACGAGCAGTACTTC	CASSLARRRGTDEQYF	TRBV5-1	TRBJ2-7
TGCGCCAGCCCCCTAGGTGAATACGAGCAGTACTTC	CASPLGEYEQYF	TRBV10-1	TRBJ2-7
TGTGCCAGCAACAGGCCCGGAAACACCATATATTTT	CASNRPGNTIYF	TRBV5-5	TRBJ1-3
TGTGCCAGCAGCATTAAGTCTGGGGGGGTTGAGAAGAAGACATACAATGAGCAGTTCTTC	CASSIKSGGVEKKTYNEQFF	TRBV5-6	TRBJ2-1
TGTGCCAGTAGTGGGACTAGCGGAAGCTTAGAGCAGTTCTTC	CASSGTSGSLEQFF	TRBV19	TRBJ2-1
TGCGCCAGCAGCTTGGGGAGCAGGGTAAGGGGGGCCTACGAGCAGTACTTC	CASSLGSRVRGAYEQYF	TRBV5-1	TRBJ2-7
TGTGCCAGCAGCGGCCAGACAGGGCGGTTATACGAGCAGTACTTC	CASSGQTGRLYEQYF	TRBV9	TRBJ2-7
TGTGCCATTTCCCCCTCGGGGGCGAGTCGTAACTATGGCTACACCTTC	CAISPSGASRNYGYTF	TRBV10-3	TRBJ1-2
TGTGCCAGCAGTGCGACAGGTGTACCGGGATGTAGCAATCAGCCCCAGCATTTT	CASSATGVPGCSNQPQHF	TRBV6-1	TRBJ1-5
TGTGCCAGCAGTGATGAGGGAGGCGTCAACACCGGGGAGCTGTTTTTT	CASSDEGGVNTGELFF	TRBV6-1	TRBJ2-2
TGTGCGGACAGGGGGCGGAGTAACGAGCAGTACTTC	CADRGRSNEQYF	TRBV2	TRBJ2-7
TGCAGTGCTAGAGGGACAGGGGGCTTACCGAACACTGAAGCTTTCTTT	CSARGTGGLPNTEAFF	TRBV20-1	TRBJ1-1
TGTGCCAGCAGCGCCAGCGGGAGGAGCAGCTCCTATAATTCACCCCTCCACTTT	CASSASGRSSSYNSPLHF	TRBV11-3	TRBJ1-6
TGTGCCAGCAGCCCATACGAAACGTATCAGCCCCAGCATTTT	CASSPYETYQPQHF	TRBV13	TRBJ1-5
TGCAGCGTTGAAGTACCTCGACTAGCGGGAGAGAGATACGAGCAGTACTTC	CSVEVPRLAGERYEQYF	TRBV29-1	TRBJ2-7
TGTGCCAGCAGCGGGGGCGAAGATAAAAACATTCAGTACTTC	CASSGGEDKNIQYF	TRBV7-3	TRBJ2-4
TGTGCCAGCAACAGAATAGTACCCTACGAGCAGTACTTC	CASNRIVPYEQYF	TRBV5-5	TRBJ2-7
TGTGCCAGCAGCGGTGGGGGGGCGAGAGAGCAGTACTTC	CASSGGGAREQYF	TRBV5-5	TRBJ2-7
TGCAGCGTTGAAAGGCCGACTAGCGGAAGATTAACCTACAATGAGCAGTTCTTC	CSVERPTSGRLTYNEQFF	TRBV29-1	TRBJ2-1
TGTGCCACCAGCCTATCGACGGGGACGGTGCCCTACGAGCAGTACTTC	CATSLSTGTVPYEQYF	TRBV15	TRBJ2-7
TGCAGTGCTAGCGGGCCGGGCACAGATACGCAGTATTTT	CSASGPGTDTQYF	TRBV20-1	TRBJ2-3
TGCAGCGTTGCCGAAAGAAGTACCGGCGGGAGAGGCGGGGAGCTGTTTTTT	CSVAERSTGGRGGELFF	TRBV29-1	TRBJ2-2
TGTGCCAGCAGCCAAGATCGCCCTCCCCGGGACAGCCCCCCTGAAGCTTTCTTT	CASSQDRPPRDSPPEAFF	TRBV3-1	TRBJ1-1
TGTGCCAGCAGCCAAGCAAGATATGACGAGCAGTACTTC	CASSQARYDEQYF	TRBV3-1	TRBJ2-7
TGTGCCAGCAGTGACTGGGGTCCGAGGGGGCCACCTGAGCAGTACTTC	CASSDWGPRGPPEQYF	TRBV6-4	TRBJ2-7
TGTGCCAGCAGCCTCGGGGGCGGGAGACGGCCAGATACGCAGTATTTT	CASSLGGGRRPDTQYF	TRBV4-2	TRBJ2-3
TGTGCCAGCAGCGTGCCTGACCTTCTAGCGGTCTCCTACAATGAGCAGTTCTTC	CASSVPDLLAVSYNEQFF	TRBV9	TRBJ2-1
TGTGCCAGCAGTGTCGGACTAGCGGGGCTGAGAACAGATACGCAGTATTTT	CASSVGLAGLRTDTQYF	TRBV6-5	TRBJ2-3
TGTGCCAGCAGTTTCGGGGTAGGGACTAGCGGGGGCCCTAGCACAGATACGCAGTATTTT	CASSFGVGTSGGPSTDTQYF	TRBV6-1	TRBJ2-3
TGCGCCAGCAGCCAAGCTGCGGGACAGCGAGGGTACTATGGCTACACCTTC	CASSQAAGQRGYYGYTF	TRBV4-3	TRBJ1-2
TGCAGCGTGGCCCGACACACAGAGCAGTTCTTC	CSVARHTEQFF	TRBV29-1	TRBJ2-1
TGTGCCAGCGGCGTGGAAACTAGCGGGTACAATGAGCAGTTCTTC	CASGVETSGYNEQFF	TRBV6-2	TRBJ2-1
TGTGCCAGCAGCCCAGATCCTAGGACAGGGGGCTTGGCCCGGTGGGGCTACACCTTC	CASSPDPRTGGLARWGYTF	TRBV7-8	TRBJ1-2
TGCGCCAGCACGGGGGGGCTAGGGAACTACGAGCAGTACTTC	CASTGGLGNYEQYF	TRBV10-2	TRBJ2-7
TGTGCCAGCAGTTGGGAGGGACAGGGAACCAGCAATCAGCCCCAGCATTTT	CASSWEGQGTSNQPQHF	TRBV6-3	TRBJ1-5
TGTGCCAGCAGTGGGGGGACAGGGAATTCACCCCTCCACTTT	CASSGGTGNSPLHF	TRBV6-1	TRBJ1-6
TGTGACGGGTTGGGACTAGCGGGGGCCGGGGAGCTGTTTTTT	CDGLGLAGAGELFF	TRBV4-2	TRBJ2-2
TGCAGTGCTAGAGGGGGGGATTATGGCTACACCTTC	CSARGGDYGYTF	TRBV20-1	TRBJ1-2
TGTGCCAGCAGCCGCAAGGGACTAGAGGTCAGTCATCGTTTACAAACAGATACGCAGTATTTT	CASSRKGLEVSHRLQTDTQYF	TRBV7-9	TRBJ2-3
TGTGCCAGCAGTACCGGGGTCCAGGCAGCCTCTAACTATGGCTACACCTTC	CASSTGVQAASNYGYTF	TRBV27	TRBJ1-2
TGTGCCAGCAGTTACTCGATCAGGGGCTACGGCCATACCGGGGAGCTGTTTTTT	CASSYSIRGYGHTGELFF	TRBV6-2	TRBJ2-2
TGTGAACTAGCGGGAGTGACCTACGAGCAGTACTTC	CELAGVTYEQYF	TRBV25-1	TRBJ2-7
TGTGCCAGCAGCTTAGTAGGGGGGAGAGGCAGTGCAGATACGCAGTATTTT	CASSLVGGRGSADTQYF	TRBV7-8	TRBJ2-3
TGTGCCACCAGGGAGGAAAACGAGCAGTACTTC	CATREENEQYF	TRBV24-1	TRBJ2-7
TGTGCCAGCAGTTATTTCCTCGTGGGGGGGCCTTACAATGAGCAGTTCTTC	CASSYFLVGGPYNEQFF	TRBV6-9	TRBJ2-1
TGTGCCAGCAGCCAAGATCAGCGGCTAGAGACCCAGTACTTC	CASSQDQRLETQYF	TRBV14	TRBJ2-5
TGCGCCAGCACCAGGGAAAATCAGCCCCAGCATTTT	CASTRENQPQHF	TRBV10-2	TRBJ1-5
TGTGTTTCCAACCGCCGTGAGACCCAGTACTTC	CVSNRRETQYF	TRBV12-3	TRBJ2-5
TGTGCCAGCAGTTTACCGGTCTCCGGGACCACAGATACGCAGTATTTT	CASSLPVSGTTDTQYF	TRBV28	TRBJ2-3
TGTGCCACCAGAGAGGGACAGGGGTTAAACATTCAGTACTTC	CATREGQGLNIQYF	TRBV24-1	TRBJ2-4
TGTGCCAGCAGCAAGGGGCTGGAGCTTAATGAGCAGTTCTTC	CASSKGLELNEQFF	TRBV7-3	TRBJ2-1
TGTGCCAGCAGCTGGTTGAGTCTGGGCTACGAGCAGTACTTC	CASSWLSLGYEQYF	TRBV7-2	TRBJ2-7
TGCGCCAGCAGCTTGGTAGAACAAAACGAGCAGTACTTC	CASSLVEQNEQYF	TRBV5-1	TRBJ2-7
TGTGCCAGTATTGGGGGGTACAATGAGCAGTTCTTC	CASIGGYNEQFF	TRBV19	TRBJ2-1
TGCGCCAGCAGCCCGTGGGACAACTACGAGCAGTACTTC	CASSPWDNYEQYF	TRBV4-1	TRBJ2-7
TGTGCCAACTCGAGATCCACAGATACGCAGTATTTT	CANSRSTDTQYF	TRBV19	TRBJ2-3
TGTGCCAGCAGCGGACTAGCGGACAATGAGCAGTTCTTC	CASSGLADNEQFF	TRBV9	TRBJ2-1
TGCGCCAGCAGCCGTCCCAGGTCTTCAACTAATGAAAAACTGTTTTTT	CASSRPRSSTNEKLFF	TRBV4-1	TRBJ1-4
TGTGCCAGCTCACCCCCCCGGGGGAGAACTAACTATGGCTACACCTTC	CASSPPRGRTNYGYTF	TRBV18	TRBJ1-2
TGTGCCACCAGTGATTTTCTAGGTGGGACAGAAGCCTACGAGCAGTACTTC	CATSDFLGGTEAYEQYF	TRBV24-1	TRBJ2-7
TGCAGTGCTAGACGGGTTAGGGAGGGGATGAACACTGAAGCTTTCTTT	CSARRVREGMNTEAFF	TRBV20-1	TRBJ1-1
TGCGCCAGGGGACTATGTACGCAAGAGACCCAGTACTTC	CARGLCTQETQYF	TRBV5-1	TRBJ2-5
TGCAGTGCTAGAGCCGCTCCGACTAGCGGGAGCTTCAATGAGCAGTTCTTC	CSARAAPTSGSFNEQFF	TRBV20-1	TRBJ2-1
TGTGCCAGCAGTTTAAATCGGAGCGGAGGCTTCGAGCAGTACTTC	CASSLNRSGGFEQYF	TRBV27	TRBJ2-7
TGTGCTAGTGGTTTGGGGATCTTACCGGGACAAGGCACTAATGAAAAACTGTTTTTT	CASGLGILPGQGTNEKLFF	TRBV12-5	TRBJ1-4
TGTGCCAGCAGCTTTCCAACGACTAGCGGCAATGAGCAGTTCTTC	CASSFPTTSGNEQFF	TRBV11-3	TRBJ2-1
TGTGCCAGCAGCATACCACGGATAGATTGGGATGGCTACACCTTC	CASSIPRIDWDGYTF	TRBV11-1	TRBJ1-2
TGTGCCAGCAGGGGACAGTTGCCCCAGCATTTT	CASRGQLPQHF	TRBV28	TRBJ1-5
TGTGCCTGGAGGAATTTGGAATGGTCCTACGAGCAGTACTTC	CAWRNLEWSYEQYF	TRBV30	TRBJ2-7
TGTGCCAGCAAATACGCCCCCAGGGGGTGCTCTGGGGCCAACGTCCTGACTTTC	CASKYAPRGCSGANVLTF	TRBV6-1	TRBJ2-6
TGTGCCAGCAGCCAAGCCGTTCAGGGGCGGGAGGAAAAACTGTTTTTT	CASSQAVQGREEKLFF	TRBV14	TRBJ1-4
TGTGCCAGCAACCGGAGGGCTCGTTTGGTTTCCTACAATGAGCAGTTCTTC	CASNRRARLVSYNEQFF	TRBV9	TRBJ2-1
TGTGCCAGCAGTTTATCGCAGGACAGGGCTCATGGCTACACCTTC	CASSLSQDRAHGYTF	TRBV27	TRBJ1-2
TGTGCCAGCAGTGACTTTGGGGGGAGCGCGAACACCGGGGAGCTGTTTTTT	CASSDFGGSANTGELFF	TRBV6-4	TRBJ2-2
TGTGCCAGCAGCTTAAGAGGAAATGAGCAGTTCTTC	CASSLRGNEQFF	TRBV7-2	TRBJ2-1
TGTGCCAGCAGCACCCGACTAGTTTCCTACAATGAGCAGTTCTTC	CASSTRLVSYNEQFF	TRBV5-4	TRBJ2-1
TGTGCCAGCAGGCCGGCAGAAGGAAACTATGGCTACACCTTC	CASRPAEGNYGYTF	TRBV11-3	TRBJ1-2
TGTGCCAGCAGTTTCCACCCTGGACTAGCGGGAGCCGGAGCGGACACCGGGGAGCTGTTTTTT	CASSFHPGLAGAGADTGELFF	TRBV27	TRBJ2-2
TGTGCCAGCAGTCCCCAGGGCAATCAGCCCCAGCATTTT	CASSPQGNQPQHF	TRBV6-1	TRBJ1-5
TGTGCCAGCAGCTGGACATTACTAGCGGGAGAGGGCCTCACCGGGGAGCTGTTTTTT	CASSWTLLAGEGLTGELFF	TRBV7-2	TRBJ2-2
TGTGCCAGCAGCCAACTCTTCCCCCGGGCAAAGTCCAATCAGCCCCAGCATTTT	CASSQLFPRAKSNQPQHF	TRBV4-2	TRBJ1-5
TGTGCCACCCTGGGACAGGGGGGGGACTACGAGCAGTACTTC	CATLGQGGDYEQYF	TRBV24-1	TRBJ2-7
TGTGCCACCAGTGATGTGGGGTCCTTAGATAGCAATCAGCCCCAGCATTTT	CATSDVGSLDSNQPQHF	TRBV24-1	TRBJ1-5
TGCGCCAGCAGCATTAGACTGACAGGGTACTTCGAGCAGTACTTC	CASSIRLTGYFEQYF	TRBV5-1	TRBJ2-7
TGTGCCAGCCTTTACAGACTAGCGGGTGGGGGCTACAATGAGCAGTTCTTC	CASLYRLAGGGYNEQFF	TRBV6-4	TRBJ2-1
TGTGCCAGCAGCCAGCGTCGCTCCTACGAGCAGTACTTC	CASSQRRSYEQYF	TRBV7-2	TRBJ2-7
TGTGCCAGCAGCCGAGGGACAGGGGGAAACACCATATATTTT	CASSRGTGGNTIYF	TRBV4-2	TRBJ1-3
TGTGCCAGCAGCCCTGATCTGTTGCACGTCACAGATACGCAGTATTTT	CASSPDLLHVTDTQYF	TRBV3-1	TRBJ2-3
TGTGCCCCAAACGGGACAGGGGCGCCCTATGAAAAACTGTTTTTT	CAPNGTGAPYEKLFF	TRBV27	TRBJ1-4
TGTGCCACCAGTTGTCGGGGGCTCTCCTACGAGCAGTACTTC	CATSCRGLSYEQYF	TRBV24-1	TRBJ2-7
TGCGCCAGCAGACAGGGAGTCTATGGCTACACCTTC	CASRQGVYGYTF	TRBV10-1	TRBJ1-2
TGTGCCAGCAGCTCGGGAAACACCCCGACAGGTAATGCTGGAAACACCATATATTTT	CASSSGNTPTGNAGNTIYF	TRBV7-6	TRBJ1-3
TGTGCCAGCAGTTGGGCCGGGGGGACAGCTCCCTACGAGCAGTACTTC	CASSWAGGTAPYEQYF	TRBV27	TRBJ2-7
TGTGCCAGCAGCGCTTTACTAGCGGGAAAATCGCTCGGGTTGCATACGCAGTATTTT	CASSALLAGKSLGLHTQYF	TRBV9	TRBJ2-3
TGTGCCAGCAGTTACGCGGTTAGGTTAGTGTCGGAAAAACTGTTTTTT	CASSYAVRLVSEKLFF	TRBV6-5	TRBJ1-4
TGTGCCAGCAGTTACAGGGCCTACAATGAGCAGTTCTTC	CASSYRAYNEQFF	TRBV2	TRBJ2-1
TGTGCCAGCAGATTGTACAATGAGCAGTTCTTC	CASRLYNEQFF	TRBV6-6	TRBJ2-1
TGTGCCAGTAGTGGTGGGGGACAGGTACACGAGCAGTACTTC	CASSGGGQVHEQYF	TRBV19	TRBJ2-7
TGTGCCAGCACCTGGACAGCAACTAATGAAAAACTGTTTTTT	CASTWTATNEKLFF	TRBV6-5	TRBJ1-4
TGTGCCAGCAGTGACTGGCCGGGGGGGGCCAGGGCGAATGAAAAACTGTTTTTT	CASSDWPGGARANEKLFF	TRBV6-4	TRBJ1-4
TGTGCCAGCAGTCAATCGAGGGGCATACCGCCCGGGTACGAGCAGTACTTC	CASSQSRGIPPGYEQYF	TRBV6-3	TRBJ2-7
TGTGCCAGCAGTTATTGCCCCAGAGACTTCACGGCTGAAGCTTTCTTT	CASSYCPRDFTAEAFF	TRBV6-2	TRBJ1-1
TGTGCCAGCAGCTTAGAGCCCCTTTCCGGACTAGCGGGGTATACGCAGTATTTT	CASSLEPLSGLAGYTQYF	TRBV7-9	TRBJ2-3
TGTGCCCACAGGCAGGAGGGAGATACGCAGTATTTT	CAHRQEGDTQYF	TRBV24-1	TRBJ2-3
TGTGCCACCAGGAAACGTGGCGGGGGGTACGACAATGAGCAGTTCTTC	CATRKRGGGYDNEQFF	TRBV24-1	TRBJ2-1
TGCAGTGCTGCAGGGTTGTCTCAGCCCCAGCATTTT	CSAAGLSQPQHF	TRBV20-1	TRBJ1-5
TGTGCCAGCAGTGACGACCGGACAGGGCAACGAGAAAAACTGTTTTTT	CASSDDRTGQREKLFF	TRBV6-4	TRBJ1-4
TGTGCCAGCAGAGATCCGACGGGCTCCTACGAGCAGTACTTC	CASRDPTGSYEQYF	TRBV7-3	TRBJ2-7
TGTGCCAGCAGTTACATTTCCAATATGGATGGCTACACCTTC	CASSYISNMDGYTF	TRBV6-2	TRBJ1-2
TGTGCCAGCAGGTACTCCAATGGTACTGAAGCTTTCTTT	CASRYSNGTEAFF	TRBV28	TRBJ1-1
TGTGCCAGCTGGATCGACACCGGGGAGCTGTTTTTT	CASWIDTGELFF	TRBV7-2	TRBJ2-2
TGCAGCGTTGAGGACTTAGGAGGCCTATTCCAGATTAATCCAAACAACTATGGCTACACCTTC	CSVEDLGGLFQINPNNYGYTF	TRBV29-1	TRBJ1-2
TGTGCCAGCAGTTGGGGGGGCAAAGCTGAAGCTTTCTTT	CASSWGGKAEAFF	TRBV12-3	TRBJ1-1
TGTGCCACGCTCGGGAAGGGCGGGGACACTGAAGCTTTCTTT	CATLGKGGDTEAFF	TRBV15	TRBJ1-1
TGTGCCAGCAGCACCAGTTCTAATCATTTTTCGTACGAGCAGTACTTC	CASSTSSNHFSYEQYF	TRBV6-3	TRBJ2-7
TGCGCCAGCAGTCTCGTCCACAGGTTGAACACTGAAGCTTTCTTT	CASSLVHRLNTEAFF	TRBV5-1	TRBJ1-1
TGTGCCAGCCTCGGGACTAGCGGGAGGCAGTATTTT	CASLGTSGRQYF	TRBV6-1	TRBJ2-3
TGCAGTGCTAGTCCCCGGGATGCCCACAATGAGCAGTTCTTC	CSASPRDAHNEQFF	TRBV20-1	TRBJ2-1
TGTGCCAGCAGCTTACGGCCCTCGACAGATACGCAGTATTTT	CASSLRPSTDTQYF	TRBV7-4	TRBJ2-3
TGTGCCAGCAGTTACCCTTCCCTGACACTAGCGGGAGATGAGCAGTTCTTC	CASSYPSLTLAGDEQFF	TRBV6-6	TRBJ2-1
TGTGCCATGGGGACAGGGGAGTCTAACTATGGCTACACCTTC	CAMGTGESNYGYTF	TRBV27	TRBJ1-2
TGTGCCAGCAGCTTAGGACAGGGGCAAGAGACCCAGTACTTC	CASSLGQGQETQYF	TRBV13	TRBJ2-5
TGCAGTGCTAGAGCCGTGACAGGATCCTCTGGAAACACCATATATTTT	CSARAVTGSSGNTIYF	TRBV20-1	TRBJ1-3
TGTGCCAGCAGCTTGCGGGGAAGCTACACCTTC	CASSLRGSYTF	TRBV7-8	TRBJ1-2
TGTGCCACCAGTGATACCCGGTCGATAGAGACCCAGTACTTC	CATSDTRSIETQYF	TRBV24-1	TRBJ2-5
TGCAGTGCTCGGATTGATGGGGGGGCCTATGGCTACACCTTC	CSARIDGGAYGYTF	TRBV20-1	TRBJ1-2
TGTGCCACCAGTGAGCAATCGAAAATCGCTGCCTACGAGCAGTACTTC	CATSEQSKIAAYEQYF	TRBV24-1	TRBJ2-7
TGTGCTAGTGGTATGAGGCCGGGACTAGTCAGGGGAAAGACCCAGTACTTC	CASGMRPGLVRGKTQYF	TRBV12-5	TRBJ2-5
TGTGCCAGCGAAAGGGATGGGAGAAGCTCCTATAATTCACCCCTCCACTTT	CASERDGRSSYNSPLHF	TRBV7-9	TRBJ1-6
TGCAGTGCTAGCAAACCGGGCAGTGACTCCTACGAGCAGTACTTC	CSASKPGSDSYEQYF	TRBV20-1	TRBJ2-7
TGTGCCAGCAGCTTGCGGACGGGCCACGGAAGCAATCAGCCCCAGCATTTT	CASSLRTGHGSNQPQHF	TRBV7-6	TRBJ1-5
TGTGCCAGCTCACCAAAAGGAGGGACCGGGAAAAGTGGCTATGGCTACACCTTC	CASSPKGGTGKSGYGYTF	TRBV18	TRBJ1-2
TGCAGTGCTAGATCGTCCCCGGCCTCCTACGAGCAGTACTTC	CSARSSPASYEQYF	TRBV20-1	TRBJ2-7
TGCGCCAGCAGATGTTGGGACTTCGAGACCCAGTACTTC	CASRCWDFETQYF	TRBV5-1	TRBJ2-5
TGTGCCAGCAGTTTCCTCAGTTCCGAGACCCAGTACTTC	CASSFLSSETQYF	TRBV12-3	TRBJ2-5
TGTGCCAGCAGCCAAGCGAAGACTAATGAGCAGTACTTC	CASSQAKTNEQYF	TRBV4-2	TRBJ2-7
TGTGCCAGCAGCCGGGCCCTGTCTGAGCAGTTCTTC	CASSRALSEQFF	TRBV13	TRBJ2-1
TGTGCCAGTGCCCCTAGAGAGACCCAGTACTTC	CASAPRETQYF	TRBV19	TRBJ2-5
TGCGCCAGCAGCCAGGATTTGGCTGACTCCCAAGAGACCCAGTACTTC	CASSQDLADSQETQYF	TRBV4-1	TRBJ2-5
TGTGCCAGCAGAGGGGGGGTCTCCCAAGAGACCCAGTACTTC	CASRGGVSQETQYF	TRBV7-9	TRBJ2-5
TGCGCCAGCAGCTTCTCGGCCAGGGTAGTTGACAATGAGCAGTTCTTC	CASSFSARVVDNEQFF	TRBV5-1	TRBJ2-1
TGTGCCAGCAGCTTCCAGAGTAGCAATCAGCCCCAGCATTTT	CASSFQSSNQPQHF	TRBV11-2	TRBJ1-5
TGTGCCAGCCCGGGACAGGATAATTCACCCCTCCACTTT	CASPGQDNSPLHF	TRBV27	TRBJ1-6
TGCGCCAGCAGCATGTTGCGGACCCGGGACAGGGCGACGTTCACTGAAGCTTTCTTT	CASSMLRTRDRATFTEAFF	TRBV4-3	TRBJ1-1
TGTGCCAGCAGTTACTTCCGGAAGGGGACTAGCGGGCCTGTGTATGAGCAGTTCTTC	CASSYFRKGTSGPVYEQFF	TRBV28	TRBJ2-1
TGTGCCAATAAATGTCGGAAGCACTATGGCTACACCTTC	CANKCRKHYGYTF	TRBV19	TRBJ1-2
TGTGCCAGCAGACCAGAGCAGGGGCTCGGCTACGAGCAGTACTTC	CASRPEQGLGYEQYF	TRBV6-5	TRBJ2-7
TGTGCCAGCAGCTTGACATTGGGGCTTGAAAAACTGTTTTTT	CASSLTLGLEKLFF	TRBV5-8	TRBJ1-4
TGTGCCAGCAGCCGGGATGGGGTACAGGGGGCTGGAAACACCATATATTTT	CASSRDGVQGAGNTIYF	TRBV5-4	TRBJ1-3
TGCAGTGCTTTTACTAGCGGCCTATCCTACAATGAGCAGTTCTTC	CSAFTSGLSYNEQFF	TRBV20-1	TRBJ2-1
TGTGCCAGCTTAATGACAGGAGCTCATAGCAATCAGCCCCAGCATTTT	CASLMTGAHSNQPQHF	TRBV9	TRBJ1-5
TGTGCCAGCAGTAGGAGGGACCTCTACGAGCAGTACTTC	CASSRRDLYEQYF	TRBV7-9	TRBJ2-7
TGTGCCAGCAGCACCGTAAGAAAAGGTAACTATGGCTACACCTTC	CASSTVRKGNYGYTF	TRBV13	TRBJ1-2
TGTGCCAGCAGTGACCTCAACGAGCAGTACTTC	CASSDLNEQYF	TRBV6-4	TRBJ2-7
TGTGCCACCAGTGATTATAGGACAGGGGGGGTTGGTGGCGAGCAGTACTTC	CATSDYRTGGVGGEQYF	TRBV24-1	TRBJ2-7
TGCGCCAGCAGCTTGTTAACTCCGAGGAACATTCAGTACTTC	CASSLLTPRNIQYF	TRBV5-1	TRBJ2-4
TGTGCCAGCAGCAATCCAGAGATCACTGAAGCTTTCTTT	CASSNPEITEAFF	TRBV13	TRBJ1-1
TGTGCCAGCAGCTTGAGGACAGGGTGGGGGGCCAACGTCCTGACTTTC	CASSLRTGWGANVLTF	TRBV5-4	TRBJ2-6
TGTGCCAGCAGCTTCAAGTTACTGGGGACAGCGCACTATGGCTACACCTTC	CASSFKLLGTAHYGYTF	TRBV7-4	TRBJ1-2
TGTGCCAGTACCGGACAGGGTCAGATCCAAGAGACCCAGTACTTC	CASTGQGQIQETQYF	TRBV19	TRBJ2-5
TGTGCCAGCAGCTCGGCTTGCAGCAATCAGCCCCAGCATTTT	CASSSACSNQPQHF	TRBV5-4	TRBJ1-5
TGTGCCAGCAGTGAATGCCGGACTAGCGGGAATCCCTACGAGCAGTACTTC	CASSECRTSGNPYEQYF	TRBV6-1	TRBJ2-7
TGCAGTGCTAGAGCGGGACATCAGCCCCAGCATTTT	CSARAGHQPQHF	TRBV20-1	TRBJ1-5
TGTGCCAGCAACTCGAATAGCGGGCCGTCCTACGAGCAGTACTTC	CASNSNSGPSYEQYF	TRBV2	TRBJ2-7
TGTGCCAGCAGCCTCCAGGGGGGACATGAGACTGAAGCTTTCTTT	CASSLQGGHETEAFF	TRBV3-1	TRBJ1-1
TGTGCCAGCAGCCCATTCCAGGGGGCTTGCAACACCGGGGAGCTGTTTTTT	CASSPFQGACNTGELFF	TRBV7-9	TRBJ2-2
TGCGCCAGCAGCTTCCGGGGGGGGAGCCTCACAGATACGCAGTATTTT	CASSFRGGSLTDTQYF	TRBV5-1	TRBJ2-3
TGTGCCAGCAGTTACAGGACTAGCGGGTGGGAAGAGACCCAGTACTTC	CASSYRTSGWEETQYF	TRBV6-3	TRBJ2-5
TGCGCCAGCAGCCGCGGACAGGGCACGGTGTGTAATTGTCGGACAGAGGTACTCTCCTACGAGCAGTACTTC	CASSRGQGTVCNCRTEVLSYEQYF	TRBV4-3	TRBJ2-7
TGTGCCAGTAGTGGACGGCACACCATATATTTT	CASSGRHTIYF	TRBV19	TRBJ1-3
TGTGCCAGCAGTGAAGCCCCGGGGGACAGGGAAGACTACGAGCAGTACTTC	CASSEAPGDREDYEQYF	TRBV2	TRBJ2-7
TGCCACCTAGCGGGGACAGACTGGGGTCAGCCCCAGCATTTT	CHLAGTDWGQPQHF	TRBV29-1	TRBJ1-5
TGTGCCAGCAGTTTACCAGGGACAGGAATAAGCTCCTACGAGCAGTACTTC	CASSLPGTGISSYEQYF	TRBV6-5	TRBJ2-7
TGCGCCAGCAGTGAGGGGTACAATGAAAAACTGTTTTTT	CASSEGYNEKLFF	TRBV10-1	TRBJ1-4
TGCGCCAGCAGCTTGATAAAGACTATTCACACTGAAGCTTTCTTT	CASSLIKTIHTEAFF	TRBV5-1	TRBJ1-1
TGTGCCAGCAGTTCAGGCCACTATGGCTACACCTTC	CASSSGHYGYTF	TRBV6-1	TRBJ1-2
TGTGCCAGCAGCACAACAGGGGGCCTCCCTGAAGCTTTCTTT	CASSTTGGLPEAFF	TRBV13	TRBJ1-1
TGTGCCAGCACTTTCGCCAGGGGTAATTGGGGTTATAGCAATCAGCCCCAGCATTTT	CASTFARGNWGYSNQPQHF	TRBV9	TRBJ1-5
TGTGCATACACTGAGACCCAGTACTTC	CAYTETQYF	TRBV7-3	TRBJ2-5
TGTGCCAGCAGTGAAGAACGGACCGGGGACTACGAGCAGTACTTC	CASSEERTGDYEQYF	TRBV6-4	TRBJ2-7
TGTGCCAGCAGGGTTTTACACGAGCAGTACTTC	CASRVLHEQYF	TRBV6-1	TRBJ2-7
TGTGCCAGCAGCACCGGACTAGGTGACGTCTACGAGCAGTACTTC	CASSTGLGDVYEQYF	TRBV7-2	TRBJ2-7
TGTGCCACCAGCCCCGGGCAAGAGACCCAGTACTTC	CATSPGQETQYF	TRBV15	TRBJ2-5
TGTGCCAGCAGTGGCCAGGGGGAAAGGACCGTAAGCACGGATTACGAGCAGTACTTC	CASSGQGERTVSTDYEQYF	TRBV2	TRBJ2-7
TGTGCCAGCAGCTGGACAGGGGGCTCAAGATACGAGCAGTACTTC	CASSWTGGSRYEQYF	TRBV7-3	TRBJ2-7
TGTGCCAGCAGCCGGGACAAAGATAGCAATCAGCCCCAGCATTTT	CASSRDKDSNQPQHF	TRBV7-4	TRBJ1-5
TGTGCCAGCAGCTTAGTTCGCGGTATTGCTGGGGCCAACGTCCTGACTTTC	CASSLVRGIAGANVLTF	TRBV11-1	TRBJ2-6
TGTGCCAGTAGGTCGGGACTAGAGGCGAACATTCAGTACTTC	CASRSGLEANIQYF	TRBV19	TRBJ2-4
TGCGCCGAGGGGAGCAATCAGCCCCAGCATTTT	CAEGSNQPQHF	TRBV4-1	TRBJ1-5
TGTGCCAGCAGCTTGATCCAGATCAGGGGCTCTTCCGAGCAGTACTTC	CASSLIQIRGSSEQYF	TRBV5-5	TRBJ2-7
TGTGCCACCAGTGATTGGGGAGGGGAGCAGTACTTC	CATSDWGGEQYF	TRBV24-1	TRBJ2-7
TGCGCCAGCAGTGACCTAGAGAGCACAGATACGCAGTATTTT	CASSDLESTDTQYF	TRBV10-1	TRBJ2-3
TGTGCCAGCAGCGCCTCCCCCCCTGGACAGGGGGCGGGAGGGATCAAGGGCTACACCTTC	CASSASPPGQGAGGIKGYTF	TRBV7-8	TRBJ1-2
TGTGCCAGCAGCGTAGTGGACAGGGCGCAGCCCCAGCATTTT	CASSVVDRAQPQHF	TRBV9	TRBJ1-5
TGTGCTAGTGGTAGGAAGGGGGATGATACGCAGTATTTT	CASGRKGDDTQYF	TRBV12-5	TRBJ2-3
TGTGCCACCAGTGATGGCGACAGAGGGGGTGCTGGGGCCAACGTCCTGACTTTC	CATSDGDRGGAGANVLTF	TRBV24-1	TRBJ2-6
TGCAGCGTCGGAAAGACAGCCGGCTATGGCTACACCTTC	CSVGKTAGYGYTF	TRBV29-1	TRBJ1-2
TGTGCTAGTGGTTTGGTACAGACACTTCATGAAAAACTGTTTTTT	CASGLVQTLHEKLFF	TRBV12-5	TRBJ1-4
TGTGCCAGCAGGGGGCGGGACAGGGAGGGATTAACATCTAATTCACCCCTCCACTTT	CASRGRDREGLTSNSPLHF	TRBV5-4	TRBJ1-6
TGTGCCAGCAGTGACCGTCCACCCTCCTATAATTCACCCCTCCACTTT	CASSDRPPSYNSPLHF	TRBV6-1	TRBJ1-6
TGTGCCAGCAGCTTAGCAGACCACTTCTACGAGCAGTACTTC	CASSLADHFYEQYF	TRBV7-3	TRBJ2-7
TGTGCTAGTGGTTTGGTACTTAGAAGGGACTACGAGCAGTACTTC	CASGLVLRRDYEQYF	TRBV12-5	TRBJ2-7
TGCAGTGCTCGCAGGACAGGGCTAGGAAACTCTGGAAACACCATATATTTT	CSARRTGLGNSGNTIYF	TRBV20-1	TRBJ1-3
TGTGCCAGCAGCTTAGATGCGGGTGAAGAGACCCAGTACTTC	CASSLDAGEETQYF	TRBV11-2	TRBJ2-5
TGTGCCACCAGTGATGGTTATCGGGGCAGAAACACCATATATTTT	CATSDGYRGRNTIYF	TRBV24-1	TRBJ1-3
TGCAGTGCTAGAACTCAAACTGAGGCGGCCCCCTACGAGCAGTACTTC	CSARTQTEAAPYEQYF	TRBV20-1	TRBJ2-7
TGCGCCAGCAGCGTTGGACGGACTAGCGGGAGAGGTCCGGATGAGCAGTTCTTC	CASSVGRTSGRGPDEQFF	TRBV5-1	TRBJ2-1
TGTGCCAGCAGGTGCCGGGACGGAAAACTTATCACCGGGGAGCTGTTTTTT	CASRCRDGKLITGELFF	TRBV27	TRBJ2-2
TGTGCCAGCATTAGGAAAGGAAGCAATCAGCCCCAGCATTTT	CASIRKGSNQPQHF	TRBV7-4	TRBJ1-5
TGTGCCAGCAGCCGGGATTTTGCCTCTTCAGATACGCAGTATTTT	CASSRDFASSDTQYF	TRBV6-3	TRBJ2-3
TGTGCCAGCATAGCGGGCGATTCGGGGGAGCTGTTTTTT	CASIAGDSGELFF	TRBV27	TRBJ2-2
TGCGCCAGCAGCCAAGAGACTAGCGGGCGGACCGGGGAGCTGTTTTTT	CASSQETSGRTGELFF	TRBV4-1	TRBJ2-2
TGCAGCATAGAGGGACTGGGGGGAAGTAACTATGGCTACACCTTC	CSIEGLGGSNYGYTF	TRBV29-1	TRBJ1-2
TGTGCCACCACCCGGGGGGGAGCTAACTATGGCTACACCTTC	CATTRGGANYGYTF	TRBV24-1	TRBJ1-2
TGTAGGCGGACCACGCCCACCTTC	CRRTTPTF	TRBV19	TRBJ1-2
TGTGCCAGCAGCTTAGCCCCCCGGTACAGGGTACCACGCTCTGGGGCCAACGTCCTGACTTTC	CASSLAPRYRVPRSGANVLTF	TRBV11-3	TRBJ2-6
TGTGCCAGCAGCCTCGAGGGCGGCCTTGACACTGAAGCTTTCTTT	CASSLEGGLDTEAFF	TRBV5-4	TRBJ1-1
TGTGCCAGCAGTACGCAGTTTCACCCGACTAGCACGGTAAGCTCCTACGAGCAGTACTTC	CASSTQFHPTSTVSSYEQYF	TRBV6-5	TRBJ2-7
TGTGCCAGTAGTTCCGTAGGGACCGTCGCCTACGAGCAGTACTTC	CASSSVGTVAYEQYF	TRBV19	TRBJ2-7
TGCAGCGGTGGGACAGGTACGACTTCCGGGGAGCTGTTTTTT	CSGGTGTTSGELFF	TRBV29-1	TRBJ2-2
TGTGCCAGCAGCGGAGACAGTTATAGCAATCAGCCCCAGCATTTT	CASSGDSYSNQPQHF	TRBV7-4	TRBJ1-5
TGTGCCAGCAGTTACTCGGGCAGCCTTCCCGCGAGGAACACTGAAGCTTTCTTT	CASSYSGSLPARNTEAFF	TRBV6-5	TRBJ1-1
TGTGCCAGCAGCCAAGGAGCCCCCGCAGTCAGCTCCTACAATGAGCAGTTCTTC	CASSQGAPAVSSYNEQFF	TRBV4-2	TRBJ2-1
TGCGCCAGCAGCTCCACCCAGCGGGGGGTAGGCAATGAGCAGTTCTTC	CASSSTQRGVGNEQFF	TRBV5-1	TRBJ2-1
TGCGCCAGCAGCTTCCCAGTCTCTCTGAATCAGCCCCAGCATTTT	CASSFPVSLNQPQHF	TRBV5-1	TRBJ1-5
TGTGCCAACGGGACTAGCGGAAGGAGTACCTACAATGAGCAGTTCTTC	CANGTSGRSTYNEQFF	TRBV13	TRBJ2-1
TGTGCCAGCAGCCAAGATGTGTTAGCGGCGGCAAACACCGGGGAGCTGTTTTTT	CASSQDVLAAANTGELFF	TRBV4-2	TRBJ2-2
TGCAGTGCCCAGGTCCCGCAAGGAACCGGACAGGAGACCTATGGCTACACCTTC	CSAQVPQGTGQETYGYTF	TRBV20-1	TRBJ1-2
TGCGCCAGCAGTGAAGGGAGAGGCGAGCAGTACTTC	CASSEGRGEQYF	TRBV10-1	TRBJ2-7
TGCGCCAGCAAACAAGAGAGGCGGGGTAGTGGACGGAAGAACACCGGGGAGCTGTTTTTT	CASKQERRGSGRKNTGELFF	TRBV5-1	TRBJ2-2
TGTGCCAGCAGTGTAAAACCGGGCCAGGCAACTAATGAAAAACTGTTTTTT	CASSVKPGQATNEKLFF	TRBV6-6	TRBJ1-4
TGTGCCAGTAGTATATCCCCACTAAGCTACAATGAGCAGTTCTTC	CASSISPLSYNEQFF	TRBV19	TRBJ2-1
TGTGCCAGCAGCCCCTTACCCCCGGGACGGTCTAGCTCCTACGAGCAGTACTTC	CASSPLPPGRSSSYEQYF	TRBV9	TRBJ2-7
TGTGCCACCATGGAGGGGAACTATGGCTACACCTTC	CATMEGNYGYTF	TRBV24-1	TRBJ1-2
TGTGCCAGCATGGGCACGAAGCAGTACTTC	CASMGTKQYF	TRBV27	TRBJ2-7
TGTGCCTGGAGTGTGTATCCCACAGGCTATGGCTACACCTTC	CAWSVYPTGYGYTF	TRBV30	TRBJ1-2
TGTGCCAGCAAATCAGGGACAGGGCTTAATCAGCCCCAGCATTTT	CASKSGTGLNQPQHF	TRBV12-4	TRBJ1-5
TGTGCCACTGGAGTAAGTATGACAGAGACCCAGTACTTC	CATGVSMTETQYF	TRBV15	TRBJ2-5
TGCGCCAGCAGTGAGTCTCGTAAGGGGGGATATTTT	CASSESRKGGYF	TRBV10-1	TRBJ2-3
TGTGCCAGCAAAGCGTTAAGTCCGGGCACAGATACGCAGTATTTT	CASKALSPGTDTQYF	TRBV7-9	TRBJ2-3
TGCGCCAGCAGCTTGTTGGTCAACGGCCCGAGGGCGGCCCATGAGCAGTTCTTC	CASSLLVNGPRAAHEQFF	TRBV5-1	TRBJ2-1
TGTGCCAGCAGCTGGTGTGGGCCCTTAATCGAGCAGTACTTC	CASSWCGPLIEQYF	TRBV5-5	TRBJ2-7
TGTGCCACGACGTGCTTCCAGCGAATTCAGCCCCAGCATTTT	CATTCFQRIQPQHF	TRBV6-2	TRBJ1-5
TGTGCCAGGCAGGGGCAGGGTGGCTACACCTTC	CARQGQGGYTF	TRBV7-2	TRBJ1-2
TGTGCTAGTGGTTTGCCTTGTAGCGGGGATGAGCAGTTCTTC	CASGLPCSGDEQFF	TRBV12-5	TRBJ2-1
TGTGCCAGCAGTGAGTTGGACAGGGCGAGGACCTACGAGCAGTACTTC	CASSELDRARTYEQYF	TRBV6-1	TRBJ2-7
TGTGCCAGCAAACCGCTGACAGGGACGACCCAGTACTTC	CASKPLTGTTQYF	TRBV6-4	TRBJ2-5
TGTGCCAGCAGTTCTAAGTATAGCAATCAGCCCCAGCATTTT	CASSSKYSNQPQHF	TRBV12-4	TRBJ1-5
TGTGCCACCAGTGCCGGGCCTTACAATGAGCAGTTCTTC	CATSAGPYNEQFF	TRBV24-1	TRBJ2-1
TGCGCCAGCAGGTATAAGAGACGCGCCGAGACCCAGTACTTC	CASRYKRRAETQYF	TRBV10-1	TRBJ2-5
TGTGCCAGCAGCTCCACCACAGATCAGCCCCAGCATTTT	CASSSTTDQPQHF	TRBV5-4	TRBJ1-5
TGTGCCAGCACGGGGGTACAGGTGATAGAAAAACTGTTTTTT	CASTGVQVIEKLFF	TRBV6-4	TRBJ1-4
TGTGCCAGCACCTGCCATTACCCCTACGAGCAGTACTTC	CASTCHYPYEQYF	TRBV6-1	TRBJ2-7
TGCAGTGCTAGAGCTCGAGGGTCTCGGGACCTCCCTCGCGAGCAGTACTTC	CSARARGSRDLPREQYF	TRBV20-1	TRBJ2-7
TGTGCCAGCAGCTTACGGACCCGTATGAACACTGAAGCTTTCTTT	CASSLRTRMNTEAFF	TRBV7-6	TRBJ1-1
TGTGCCACGGGGCATCCGGAAAAACTGTTTTTT	CATGHPEKLFF	TRBV9	TRBJ1-4
TGTGCCAGCAGTTACAGAGACCATGCTAGACGCGGGGGCCTAGAGACCCAGTACTTC	CASSYRDHARRGGLETQYF	TRBV6-2	TRBJ2-5
TGTGCCAGCAGCAGCCGCCCGAGGGACGGATCTTTCTTT	CASSSRPRDGSFF	TRBV13	TRBJ1-1
TGTGCCAGCAGCCACCCAAAGGGGGAGTTGGGTCGCAATCAGCCCCAGCATTTT	CASSHPKGELGRNQPQHF	TRBV3-1	TRBJ1-5
TGCAGTGCTAGAGAACGGGGATTCTACAATGAGCAGTTCTTC	CSARERGFYNEQFF	TRBV20-1	TRBJ2-1
TGCAGCGTGGGTATCAGTTACGAGCAGTACTTC	CSVGISYEQYF	TRBV29-1	TRBJ2-7
TGCAGCGTGACGGATCGCTACACCTTC	CSVTDRYTF	TRBV29-1	TRBJ1-2
TGCGCCAGCAGTGAGCTCCCGTTGAATACGGGTCCTCCTTGGCGGTCCTACAATGAGCAGTTCTTC	CASSELPLNTGPPWRSYNEQFF	TRBV10-2	TRBJ2-1
TGTGCCACCAGTGATCCGGGACCTAATGAAAAACTGTTTTTT	CATSDPGPNEKLFF	TRBV24-1	TRBJ1-4
TGTGCCAGCAGCATTCGGCACCTTTATTCGGGGGCAGATACGCAGTATTTT	CASSIRHLYSGADTQYF	TRBV13	TRBJ2-3
TGTGCCAGCAGTTTTCCACCCGATAGCAATCAGCCCCAGCATTTT	CASSFPPDSNQPQHF	TRBV27	TRBJ1-5
TGCGCCAGCAGCCCCGAACACGGAACCAATTTCCTCTTT	CASSPEHGTNFLF	TRBV5-1	TRBJ1-1
TGCGCCAGCAGCTTGACAGGTAACTATGGCTACACCTTC	CASSLTGNYGYTF	TRBV5-1	TRBJ1-2
TGTGCCAGCAGCGGAGAGCCCCTCCGCGGACAGGGCAATCAGCCCCAGCATTTT	CASSGEPLRGQGNQPQHF	TRBV11-2	TRBJ1-5
TGCGCCAGCAGTTCACTCCGACTAGCGGGAGGGGAAGAGACCCAGTACTTC	CASSSLRLAGGEETQYF	TRBV10-1	TRBJ2-5
TGTGCCAGCAGCTTAGGGGGTGACGAGCAGTACTTC	CASSLGGDEQYF	TRBV7-4	TRBJ2-7
TGTGCCAGCATCCCAGCCTCAGTTTCCGCTGGGGGCACCGGGGAGCTGTTTTTT	CASIPASVSAGGTGELFF	TRBV12-3	TRBJ2-2
TGTGCCAGCAGACCGACAGGTGAGACTAATGAAAAACTGTTTTTT	CASRPTGETNEKLFF	TRBV27	TRBJ1-4
TGTGCCAGCAGCTTGGGGCATGACCCAGAGACCCAGTACTTC	CASSLGHDPETQYF	TRBV7-4	TRBJ2-5
TGTGCCAGCAGTGTTAAAGGGATAGAGCAGTACTTC	CASSVKGIEQYF	TRBV6-4	TRBJ2-5
TGTGCCAGCAGCCAAACTAGCGGGGGAAGTACCGGGGAGCTGTTTTTT	CASSQTSGGSTGELFF	TRBV14	TRBJ2-2
TGTGCCAGCAGTGCAGGCAACAGGGCCGAAAAACTGTTTTTT	CASSAGNRAEKLFF	TRBV6-1	TRBJ1-4
TGTGCCAGCAGTTTCGACAGGCTCGAGCGCAATCAGCCCCAGCATTTT	CASSFDRLERNQPQHF	TRBV28	TRBJ1-5
