TGTGCCAGCAACCCCGTTGAAAGCGGGACTAGCACAGATACGCAGTATTTT	CASNPVESGTSTDTQYF	TRBV11-3	TRBJ2-3
TGTGCCAGCAGTGAAGGAGCAGGGAGGGGGAACACTGAAGCTTTCTTT	CASSEGAGRGNTEAFF	TRBV2	TRBJ1-1
TGTGCCAGCAGCTTATACCGACAGGGGGGGAAGAACACCGGGGAGCTGTTTTTT	CASSLYRQGGKNTGELFF	TRBV7-3	TRBJ2-2
TGCAGTGCTAGATGTACCGGGAGCGGGGAGCTGTTTTTT	CSARCTGSGELFF	TRBV20-1	TRBJ2-2
TGTGCCAGCATGCAGCGGGATGGCTACACCTTC	CASMQRDGYTF	TRBV28	TRBJ1-2
TGTGGAACAGTGTGGGGGACACCCTATAGCAATCAGCCCCAGCATTTT	CGTVWGTPYSNQPQHF	TRBV28	TRBJ1-5
TGTGCCAGCAGCTGGTATGGCTACACCTTC	CASSWYGYTF	TRBV5-6	TRBJ1-2
TGTGCCAGCAGTACGGAGGGCAAGGTGGACGAGCAGTACTTC	CASSTEGKVDEQYF	TRBV6-1	TRBJ2-7
TGTGCCTGGAGTGGAAAAAACATTCAGTACTTC	CAWSGKNIQYF	TRBV30	TRBJ2-4
TGTGCCAGCAGCCAAGATTTAAGGGAGGGGTTATTTAAGGGTTCACTACTACCCTACGAGCAGTACTTC	CASSQDLREGLFKGSLLPYEQYF	TRBV14	TRBJ2-7
TGTGCCAGCAGTAACCAAGGACAGGGGCTCGCCAATCAGCCCCAGCATTTT	CASSNQGQGLANQPQHF	TRBV27	TRBJ1-5
TGTGCCAGCAGTTACGTTCATCGGAGGAGCGGGAGCGGGTTAGAACTGTTTTTT	CASSYVHRRSGSGLELFF	TRBV6-5	TRBJ1-4
TGTGCCTGGTTACGAGTTTACGAGCAGTACTTC	CAWLRVYEQYF	TRBV27	TRBJ2-7
TGTGCCACCAGCCCCGAGCGGGACACAGTCCAAGAGACCCAGTACTTC	CATSPERDTVQETQYF	TRBV15	TRBJ2-5
TGTGCCAGCAGCTCTTGGGGGGGCGGGGTAGCCGAGCAGTACTTC	CASSSWGGGVAEQYF	TRBV7-2	TRBJ2-7
TGTGCCACGTCAACCAGGCCTGAGCGAGACAGCTCCTACAATGAGCAGTTCTTC	CATSTRPERDSSYNEQFF	TRBV6-5	TRBJ2-1
TGTGCCATTTCGGAGTCTTTTTACAATGAGCAGTTCTTC	CAISESFYNEQFF	TRBV19	TRBJ2-1
TGTGCCACCAGCAGACGCACCGGACAGTATGGCTACACCTTC	CATSRRTGQYGYTF	TRBV15	TRBJ1-2
TGTGCCACCAGTGATTTAACCAAAGGGGGCGGGGCCTCAGAGCCCCAGCATTTT	CATSDLTKGGGASEPQHF	TRBV24-1	TRBJ1-5
TGTGCCAGCAGCTTACGTTTAGGACACTACGAGCAGTACTTC	CASSLRLGHYEQYF	TRBV7-2	TRBJ2-7
TGTGCCAGCAGGGTTTCTAGGACAGAAGTCAACGAGCAGTACTTC	CASRVSRTEVNEQYF	TRBV28	TRBJ2-7
TGTGCCAGCAGCTCGAGACAGAGCTCCTACAATGAGCAGTTCTTC	CASSSRQSSYNEQFF	TRBV6-1	TRBJ2-1
TGTGCCAGCATTAGAACACAAAACACTGAAGCTTTCTTT	CASIRTQNTEAFF	TRBV6-1	TRBJ1-1
TGTGCCAGCAGCAACGGGGCTTGTTCAGATACGCAGTATTTT	CASSNGACSDTQYF	TRBV5-8	TRBJ2-3
TGTGCCAGCAGCCGGGGGGGATTGGTATATAGCAATCAGCCCCAGCATTTT	CASSRGGLVYSNQPQHF	TRBV5-4	TRBJ1-5
TGTGCCAGCAGTTTATTTACTGTCGGGGGGGACCCCTCTGGGGCCAACGTCCTGACTTTC	CASSLFTVGGDPSGANVLTF	TRBV28	TRBJ2-6
TGTGCCAGCAGTGACAGACAGGGGGGCTCTGGAAACACCATATATTTT	CASSDRQGGSGNTIYF	TRBV6-4	TRBJ1-3
TGTGCCAGCAGTGAGAACAGGCGTAATGAAAAACTGTTTTTT	CASSENRRNEKLFF	TRBV6-5	TRBJ1-4
TGTGCCAGCAGTTACTCGCAAGAGAGACTTACGCAGTATTTT	CASSYSQERLTQYF	TRBV6-5	TRBJ2-3
TGCAGTGCTAGAGGGGGGCCCGGGAATTACAATGAGCAGTTCTTC	CSARGGPGNYNEQFF	TRBV20-1	TRBJ2-1
TGCAGCGTTGAATTCCCGAAAGGGGCGTTGAACTATGGCTACACCTTC	CSVEFPKGALNYGYTF	TRBV29-1	TRBJ1-2
TGTGCCACCTTAAAACCCTTGGTGCAGGGTGCGGCGGCAGATACGCAGTATTTT	CATLKPLVQGAAADTQYF	TRBV7-8	TRBJ2-3
TGTGCCAGCAGCTTCGGGCTGCAAGGACAGGCGAGCTCCTACAATGAGCAGTTCTTC	CASSFGLQGQASSYNEQFF	TRBV9	TRBJ2-1
TGTGCCAGCAGCGAGTCAATGGGGGCAGCTTTCTTT	CASSESMGAAFF	TRBV5-4	TRBJ1-1
TGTGCCAGGGGGCGGGAGGGAAATGAGCAGTTCTTC	CARGREGNEQFF	TRBV12-3	TRBJ2-1
TGTGCCAGCAGCCAAGATTATTGCCCCCTAACCTCTACGGGACAGGGGGCTTACGAGCAGTACTTC	CASSQDYCPLTSTGQGAYEQYF	TRBV14	TRBJ2-7
TGTGCCAGCAGTGACTCGGGGGGGGCCATCTATGGCTACACCTTC	CASSDSGGAIYGYTF	TRBV6-4	TRBJ1-2
TGTGCCAGCAGCATGACGGGGCCTCAGAACACTGAAGCTTTCTTT	CASSMTGPQNTEAFF	TRBV7-3	TRBJ1-1
TGTGCCAGCTCGTGCGACGACAGTTGCACTGAAGCTTTCTTT	CASSCDDSCTEAFF	TRBV18	TRBJ1-1
TGTGCCTGGACCCAGGGGGGGGGTCCAGAAGAGACCCAGTACTTC	CAWTQGGGPEETQYF	TRBV30	TRBJ2-5
TGTGCCAGCAGTGAACGGGACAGGGAAGTTGCCTACGAGCAGTACTTC	CASSERDREVAYEQYF	TRBV6-1	TRBJ2-7
TGTGCCAGCAGAGACCAAGTGGGACAGGACAAAAACATTCAGTACTTC	CASRDQVGQDKNIQYF	TRBV6-6	TRBJ2-4
TGTGCCAGCAGCCTTTCCCGCGTTAAAGGACAGAGAAAAGAGACCCAGTACTTC	CASSLSRVKGQRKETQYF	TRBV7-3	TRBJ2-5
TGCGCCAGCAGCCGGGCGAGGAAGAAACACCCCGGCTCCTACGAGCAGTACTTC	CASSRARKKHPGSYEQYF	TRBV4-3	TRBJ2-7
TGTGCCAGCAGCTTAGGTCCGGGAGCGGGAGTGGCAAGCTCCTACGAGCAGTACTTC	CASSLGPGAGVASSYEQYF	TRBV7-6	TRBJ2-7
TGTGCCAGCAGTGTGAGACCGATGGGCCCTTGCAATCAGCCCCAGCATTTT	CASSVRPMGPCNQPQHF	TRBV6-4	TRBJ1-5
TGTGCCAGCAGTTCTGTATCCCATTCCAAAAACATTCAGTACTTC	CASSSVSHSKNIQYF	TRBV27	TRBJ2-4
TGTGCCAGCAGTCACCCAGATACTAGCGGGAGGGTCCACTATGGCTACACCTTC	CASSHPDTSGRVHYGYTF	TRBV6-5	TRBJ1-2
TGTGCCTGGACGTTCAGGGACAGGGGACGGGATTCCTACGAGCAGTACTTC	CAWTFRDRGRDSYEQYF	TRBV30	TRBJ2-7
TGTGCCAGCCCTACTACTGCGTACTCCTACGAGCAGTACTTC	CASPTTAYSYEQYF	TRBV27	TRBJ2-7
TGTGCCAATTTTTTCCCGGACTGCACAGCCAAAAACATTCAGTACTTC	CANFFPDCTAKNIQYF	TRBV7-6	TRBJ2-4
TGTGCCAGCAAGAGAGGGGGGGGCAAGGGAGCAGGCACTGAAGCTTTCTTT	CASKRGGGKGAGTEAFF	TRBV9	TRBJ1-1
TGTGCCACCCGTCGGGGACATTGCCTTTATTTCGCCTACGAGCAGTACTTC	CATRRGHCLYFAYEQYF	TRBV15	TRBJ2-7
TGTGCCAGCAGCCGGGACAGGCTTGAGACTAATGAAAAACTGTTTTTT	CASSRDRLETNEKLFF	TRBV27	TRBJ1-4
TGTGCCAGCAGCCGACTACGCTCTGGAAACACCATATATTTT	CASSRLRSGNTIYF	TRBV11-3	TRBJ1-3
TGTGCCAGCAGCAAAACTAGCGGGAGCAATGAGCAGTTCTTC	CASSKTSGSNEQFF	TRBV9	TRBJ2-1
TGTGCCAGCAGTTACTCGAGACAGGGTACCTACAATGAGCAGTTCTTC	CASSYSRQGTYNEQFF	TRBV6-5	TRBJ2-1
TGTGCCAGTAGCCCCCCCCGAGGCCGGGATACGCAGTATTTT	CASSPPRGRDTQYF	TRBV19	TRBJ2-3
TGTGCCTGGAGTGTACGGAGAACAGGAAAGTCCTACAATGAGCAGTTCTTC	CAWSVRRTGKSYNEQFF	TRBV30	TRBJ2-1
TGTGCCAGCCAAGCAGACCTTAATTCACCCCTCCACTTT	CASQADLNSPLHF	TRBV6-2	TRBJ1-6
TGTGCCAGCAGGCCTCTCGCGCGGGACCGTTTGGCTTTGCCAAACACCGGGGAGCTGTTTTTT	CASRPLARDRLALPNTGELFF	TRBV7-3	TRBJ2-2
TGTGCCAGCAGCGTTCGGGGGGCCGCTACCTACGAGCAGTACTTC	CASSVRGAATYEQYF	TRBV13	TRBJ2-7
TGTGCCAGCAGTCCTTCCAGAACCGGGTTGGCCTACAATGAGCAGTTCTTC	CASSPSRTGLAYNEQFF	TRBV27	TRBJ2-1
TGTGCCAGCGGACAGGGCGATTACTATGGCTACACCTTC	CASGQGDYYGYTF	TRBV7-3	TRBJ1-2
TGTGCCAGCAGTGCTGGCGGGCCCCAGCATTTT	CASSAGGPQHF	TRBV2	TRBJ1-5
TGTGCCAGCAATCTTTTTAGGGGGGAGGAAAGCTACGAGCAGTACTTC	CASNLFRGEESYEQYF	TRBV12-4	TRBJ2-7
TGCGCCAGCAGCCAAGGCCGAACCGGGACAGGGCATAGCAATCAGCCCCAGCATTTT	CASSQGRTGTGHSNQPQHF	TRBV4-1	TRBJ1-5
TGTGCCAGCACTAGCGCTAGGGCCTACGAGCAGTACTTC	CASTSARAYEQYF	TRBV11-2	TRBJ2-7
TGTGCCAGCAGCCCTGCCCCCCGACGGAAAGGAGGGGATCAGCCCCAGCATTTT	CASSPAPRRKGGDQPQHF	TRBV3-1	TRBJ1-5
TGTGCCAGCAGCTACCGGGACCCAGACGAGCAGTACTTC	CASSYRDPDEQYF	TRBV5-8	TRBJ2-7
TGTGCCAGCAGCTCCCCTAAACAACGCCGAAACGGCACTGAAGCTTTCTTT	CASSSPKQRRNGTEAFF	TRBV7-2	TRBJ1-1
TGTGCCAGCCATCACGCCGAAAACTACGAGCAGTACTTC	CASHHAENYEQYF	TRBV27	TRBJ2-7
TGCAGTGCTAGGTCCAAGAGGGGGGATGAGCAGTTCTTC	CSARSKRGDEQFF	TRBV20-1	TRBJ2-1
TGTGCCAGCAGCAGGGGGCCGGACACAGAGACCCAGTACTTC	CASSRGPDTETQYF	TRBV7-3	TRBJ2-5
TGTGCCAGCAGCTTAGAGCAGGACAGGGTTACTGAAGCTTTCTTT	CASSLEQDRVTEAFF	TRBV7-9	TRBJ1-1
TGTGCCAGCTCACCTGGGGCGGGAGTGGAGGAGACCCAGTACTTC	CASSPGAGVEETQYF	TRBV18	TRBJ2-5
TGTGCCAGCAGTCCAACAGGGGGCCCTTACGAGCAGTACTTC	CASSPTGGPYEQYF	TRBV27	TRBJ2-7
TGTGCCAGCAGCCCAACGGCAGCCAAAAACATTCAGTACTTC	CASSPTAAKNIQYF	TRBV13	TRBJ2-4
TGCGCCAGCAGCTTCAGGGGGCTATATCAGCCCCAGCATTTT	CASSFRGLYQPQHF	TRBV5-1	TRBJ1-5
TGTGCCAGCAGTTACAGGAAGTCGGGACAGGCGGGGGATTCCAAAGACGAGCAGTACTTC	CASSYRKSGQAGDSKDEQYF	TRBV6-6	TRBJ2-7
TGCAGTGCTAGAGTGACGGGGGTTTATCAGCCCCAGCATTTT	CSARVTGVYQPQHF	TRBV20-1	TRBJ1-5
TGTGCCAGCAGCATAGGACTAGCGGTCTTC	CASSIGLAVF	TRBV5-8	TRBJ2-1
TGCAGTGCTTCCCGACAGGGCCGTCGTTCTGAAGCTTTCTTT	CSASRQGRRSEAFF	TRBV20-1	TRBJ1-1
TGTGCCAGCAGCGAAATCCCAATACAACCTCATGAGCAGTTCTTC	CASSEIPIQPHEQFF	TRBV5-5	TRBJ2-1
TGTGCCACCAGTGATGTGACAGATGGCCAAGAGACCCAGTACTTC	CATSDVTDGQETQYF	TRBV24-1	TRBJ2-5
TGCAGTGCTAGAGATTACCGACCGACAGACAATTCTGGGGCCAACGTCCTGACTTTC	CSARDYRPTDNSGANVLTF	TRBV20-1	TRBJ2-6
TGTGCCAGCAGCCAAGATATGGGCCGCTCTGGGGCCAACGTCCTGACTTTC	CASSQDMGRSGANVLTF	TRBV4-2	TRBJ2-6
TGCACTCGGAGGGAGCTTAGCACAGATACGCAGTATTTT	CTRRELSTDTQYF	TRBV20-1	TRBJ2-3
TGTGCCAGCAGCCGCTTTCTGAGAGGGGGGATGTACGAGCAGTACTTC	CASSRFLRGGMYEQYF	TRBV13	TRBJ2-7
TGTGCCACCAGCAGGGGGTGTCAGCCCCAGCATTTT	CATSRGCQPQHF	TRBV15	TRBJ1-5
TGTGCCAGCAGCCCCGGGACAGGCCGGTCTGGGGCCAACGTCCTGACTTTC	CASSPGTGRSGANVLTF	TRBV7-9	TRBJ2-6
TGTGCCAGCAGCTTCGACAGGTACGAGCAGTACTTC	CASSFDRYEQYF	TRBV7-4	TRBJ2-7
TGTGCCAGCATCCGCGGGAATGAGCAGTTCTTC	CASIRGNEQFF	TRBV6-1	TRBJ2-1
TGTGCCAGCAGCGAAGCGGGGGCCAGAACGTGCACAGATACGCAGTATTTT	CASSEAGARTCTDTQYF	TRBV13	TRBJ2-3
TGCGCCAGCAGGTTCCTCACCCAGTACTTC	CASRFLTQYF	TRBV10-1	TRBJ2-5
TGCGCCAGCAGCCAGGGAAGAGACAATCAGCCCCAGCATTTT	CASSQGRDNQPQHF	TRBV5-1	TRBJ1-5
TGTGCCAGCAGCTTAGACGATTCGACCAGGTGCCCGGACACCGGGGAGCTGTTTTTT	CASSLDDSTRCPDTGELFF	TRBV11-3	TRBJ2-2
TGCAGTGCTTACGGGCCCCAGAGCACAGATACGCAGTATTTT	CSAYGPQSTDTQYF	TRBV20-1	TRBJ2-3
TGCGCCAGTAAAGCCTTTGCGGGATTAAACTCTGGGGCCAACGTCCTGACTTTC	CASKAFAGLNSGANVLTF	TRBV10-1	TRBJ2-6
TGTGCCAGCGGCAGGGATTACAATGAGCAGTTCTTC	CASGRDYNEQFF	TRBV6-4	TRBJ2-1
TGTGCCAGCAGTGCCCCTGACAGGGGAAACGAGCAGTACTTC	CASSAPDRGNEQYF	TRBV6-1	TRBJ2-7
TGTGCCAGCAATTGCCCGGCTTACTGGGGATTCACTGAAGCTTTCTTT	CASNCPAYWGFTEAFF	TRBV6-5	TRBJ1-1
TGTGCCAGCAGGATCGGCTTGGGACAGGTCCTTGGCGAGCAGTACTTC	CASRIGLGQVLGEQYF	TRBV6-1	TRBJ2-7
TGTGCCAGCAGCTTCTCATCTGGGAGGGATAGCAATCAGCCCCAGCATTTT	CASSFSSGRDSNQPQHF	TRBV7-2	TRBJ1-5
TGTGCCAGTAGTGTGTCGGGAGGGCCCTGGGCAACTAATGAAAAACTGTTTTTT	CASSVSGGPWATNEKLFF	TRBV19	TRBJ1-4
TGCGCCAGCAGCGATGTGACGGGCGCTGGCTACACCTTC	CASSDVTGAGYTF	TRBV5-1	TRBJ1-2
TGTGCCATCAGGACAGGGATAGCAGATACGCAGTATTTT	CAIRTGIADTQYF	TRBV10-3	TRBJ2-3
TGTGCCAGCAGTGATAGACAGGAGGGGAACACTGAAGCTTTCTTT	CASSDRQEGNTEAFF	TRBV25-1	TRBJ1-1
TGCGCCAGCAGCGGAGGGGGAAATAGCAATCAGCCCCAGCATTTT	CASSGGGNSNQPQHF	TRBV10-2	TRBJ1-5
TGTGCCAGTAGTGGGGCGAGCTCCTACAATGAGCAGTTCTTC	CASSGASSYNEQFF	TRBV19	TRBJ2-1
TGTGCCAGCAGTGCACGGATTTCGACAGGGGAAAATGTGGACACTGAAGCTTTCTTT	CASSARISTGENVDTEAFF	TRBV6-1	TRBJ1-1
TGCAGTGCTAGAGGGGGGCCGGGACTGGGCACAGATACGCAGTATTTT	CSARGGPGLGTDTQYF	TRBV20-1	TRBJ2-3
TGTGCCAGCAGTACAGCAGGGAGGTTACCGGCATTAGAAAAACTGTTTTTT	CASSTAGRLPALEKLFF	TRBV6-2	TRBJ1-4
TGCGCCAGCAGCCAAGATAAAGGGGGAGGGCACGAGCAGTACTTC	CASSQDKGGGHEQYF	TRBV4-1	TRBJ2-7
TGTGCCAGCAGCCCCCTTTCGGGACAGGGCTCCTACGAGCAGTACTTC	CASSPLSGQGSYEQYF	TRBV3-1	TRBJ2-7
TGTGCCAGCAGTTCTTCTTGGCCAGTCACTCTACCGAGCTACGAGCAGTACTTC	CASSSSWPVTLPSYEQYF	TRBV28	TRBJ2-7
TGTGCCAGCAGCATTTCGACATGGGATCTAGCCAAAAACATTCAGTACTTC	CASSISTWDLAKNIQYF	TRBV11-2	TRBJ2-4
TGTGCCAGCAGCTTACAGGGGCCCCCTTCCTACAATGAGCAGTTCTTC	CASSLQGPPSYNEQFF	TRBV11-3	TRBJ2-1
TGCGCCAGCAGCCAATGTCGGAGTACGCAGTATTTT	CASSQCRSTQYF	TRBV4-3	TRBJ2-3
TGTGCCAGCAGCTCCGGGGGGCAGGGAGACACCGGGGAGCTGTTTTTT	CASSSGGQGDTGELFF	TRBV7-2	TRBJ2-2
TGCGCCAGCAGTGAGTCGGCTGCAGGGGGCAATCAGCCCCAGCATTTT	CASSESAAGGNQPQHF	TRBV10-1	TRBJ1-5
TGTGCCACCAGTTTGCGGGAGGCAGATACGCAGTATTTT	CATSLREADTQYF	TRBV24-1	TRBJ2-3
TGCGCCAGCAGTGAGTCTAGCAGGGTTCAGGGGGGTCCCTACTATGGCTACACCTTC	CASSESSRVQGGPYYGYTF	TRBV10-2	TRBJ1-2
TGTGCCAGCAGCACTAGGGACAGGGCCGGGGAGCTGTTTTTT	CASSTRDRAGELFF	TRBV13	TRBJ2-2
TGTGCCTGGAGTGTACACCCAGGCTATTATGGCTACACCTTC	CAWSVHPGYYGYTF	TRBV30	TRBJ1-2
TGTGCCAGCAGCGCCCCAAGAGGGCGACAGGTGGGTACTCAGCCCCAGCATTTT	CASSAPRGRQVGTQPQHF	TRBV9	TRBJ1-5
TGTGCCAGCAACAGGGGGCGGTTTGGCTATGGCTACACCTTC	CASNRGRFGYGYTF	TRBV27	TRBJ1-2
TGTGCCAGCAGCCTACGTTACTCTGGGGCCAACGTCCTGACTTTC	CASSLRYSGANVLTF	TRBV5-4	TRBJ2-6
TGTGCCAGCAGCCGGGGGGGGGGAATCACAGATACGCAGTATTTT	CASSRGGGITDTQYF	TRBV3-1	TRBJ2-3
TGTGCCAGCAGCGCTATGGCTGAAGCTTTCTTT	CASSAMAEAFF	TRBV9	TRBJ1-1
TGTGCCACCAGTGACCGTGGGACAGGGGTGGGGAACACTGAAGCTTTCTTT	CATSDRGTGVGNTEAFF	TRBV24-1	TRBJ1-1
TGTGCCAGCAGCGTAGAGTGCCCGACAGGCTACGAGCAGTACTTC	CASSVECPTGYEQYF	TRBV9	TRBJ2-7
TGTGCCAGCAGCCAGACGAGTTACGAGCAGTACTTC	CASSQTSYEQYF	TRBV13	TRBJ2-7
TGTGCCAACCTCCAGGGCATAAGATCTGAAGCTTTCTTT	CANLQGIRSEAFF	TRBV2	TRBJ1-1
TGTGCCAGCAGTTACCCTTTAAGCACAGATACGCAGTATTTT	CASSYPLSTDTQYF	TRBV6-5	TRBJ2-3
TGTGCCACCACAGGTGGCTACACCTTC	CATTGGYTF	TRBV19	TRBJ1-2
TGCGCCAGCAGCTTGTCAGAGAACGGGGAGCTGTTTTTT	CASSLSENGELFF	TRBV5-1	TRBJ2-2
TGCGCCAGCAGCCAGAGGCAGGGACAGCCGGGGGGAGACCCCAGCAATGAGCAGTTCTTC	CASSQRQGQPGGDPSNEQFF	TRBV4-1	TRBJ2-1
TGTGCCAGCAGCCAAGGGAAAACCCGTAGGACTAGCGGGGGTGCCGGGGAGCTGTTTTTT	CASSQGKTRRTSGGAGELFF	TRBV4-2	TRBJ2-2
TGTGCCAGCAGCTTGGAGACTGGGGGCCCCGGTCCGAACTTC	CASSLETGGPGPNF	TRBV7-2	TRBJ2-5
TGTGCCAGCAGCTTAGAAGGGGATGAAAAACTGTTTTTT	CASSLEGDEKLFF	TRBV7-9	TRBJ1-4
TGTGCCTGGAGTGCCCTCAGGGGTCCTAGATACAATGAGCAGTTCTTC	CAWSALRGPRYNEQFF	TRBV30	TRBJ2-1
TGTGCCAGCAGCCAAGAAGCGCAGGTGGGGGGCATTGGCAATGAGCAGTTCTTC	CASSQEAQVGGIGNEQFF	TRBV4-2	TRBJ2-1
TGTGCCACCAGTGACGCTAGAGGGCCCTCTGGGGCCAACGTCCTGACTTTC	CATSDARGPSGANVLTF	TRBV24-1	TRBJ2-6
TGCGCCAGCAGTAAGGACGGGGAAGCTTTCTTT	CASSKDGEAFF	TRBV10-1	TRBJ1-1
TGTGCCAGCAGTGATCTTGGGCCTCCACAGCCCCAGCATTTT	CASSDLGPPQPQHF	TRBV6-4	TRBJ1-5
TGCAGCGTTGACCTCCGGGCGAGAGCTTTCTTT	CSVDLRARAFF	TRBV29-1	TRBJ1-1
TGTGCCAGCAGCTTAGGACTTCCTTGGCATAGCAATCAGCCCCAGCATTTT	CASSLGLPWHSNQPQHF	TRBV11-3	TRBJ1-5
TGTGCCAGCAGCTCGTGTAGACAGGACTCCTACAATGAGCAGTTCTTC	CASSSCRQDSYNEQFF	TRBV7-3	TRBJ2-1
TGTGCCAGCAGGGTTCCCCCGTATATTCCGACTGGCTACACCTTC	CASRVPPYIPTGYTF	TRBV6-6	TRBJ1-2
TGCGCCAGCAGCCAAGATCTGAGCGTGGGGGGGATAGATCAGCCCCAGCATTTT	CASSQDLSVGGIDQPQHF	TRBV4-1	TRBJ1-5
TGCAGTGCTAGAGAGACAGGGGGCGGAAACACCATATATTTT	CSARETGGGNTIYF	TRBV20-1	TRBJ1-3
TGCAGTGCTAGGCACTGGAAGCAGTACTTC	CSARHWKQYF	TRBV20-1	TRBJ2-7
TGTGCCAGCAGCCGCGCAGGCTTTAGGGAAGGTGGCTACACCTTC	CASSRAGFREGGYTF	TRBV14	TRBJ1-2
TGTGCCACAGCGGCCTACGAGCAGTACTTC	CATAAYEQYF	TRBV24-1	TRBJ2-7
TGTGCCAGCAGCTTCGGAACCCTATGCCGGCCGGGACTAGCGGGAGGGGTACAGAACACTGAAGCTTTCTTT	CASSFGTLCRPGLAGGVQNTEAFF	TRBV7-3	TRBJ1-1
TGCGCCAGCAGCTGTGAACTATCCTCTGGAAACACCATATATTTT	CASSCELSSGNTIYF	TRBV5-1	TRBJ1-3
TGTGCCAGTAGTAGGGACCGACGTCCCAGTGTAGAGCAGTACTTC	CASSRDRRPSVEQYF	TRBV19	TRBJ2-7
TGTGCCAGCAGCGGGACAAGAAATTCACCCCTCCACTTT	CASSGTRNSPLHF	TRBV7-3	TRBJ1-6
TGTGCCAGCAGCGCCCGGGGGCGAGCCACAGATACGCAGTATTTT	CASSARGRATDTQYF	TRBV5-6	TRBJ2-3
TGTGCCAGTAGTAACCGGACAGGGGGGGCCTACGAGCAGTACTTC	CASSNRTGGAYEQYF	TRBV19	TRBJ2-7
TGTGCCAGCAGTGAAGACAGGGCGAGGGGCACTGAAGCTTTCTTT	CASSEDRARGTEAFF	TRBV25-1	TRBJ1-1
TGTGCCAGCAGTTATAAGTGGCCGACTGGGCAAGAGACCCAGTACTTC	CASSYKWPTGQETQYF	TRBV6-2	TRBJ2-5
TGTGCCAGCAGCTTAGGTGACAGGGGGCTAATGGAGCAGTACTTC	CASSLGDRGLMEQYF	TRBV7-9	TRBJ2-7
TGTGCCACCACCCGGGCGACCTACGAGCAGTACTTC	CATTRATYEQYF	TRBV24-1	TRBJ2-7
TGTGCCAGCAGTGACTTTTCCCCTAGACAAGTTGGCTACACCTTC	CASSDFSPRQVGYTF	TRBV6-4	TRBJ1-2
TGCGCCAGCAGCGGACTAGCCGGCGGGGAGCTGTTTTTT	CASSGLAGGELFF	TRBV5-1	TRBJ2-2
TGTGCCAGCAGTTTTGCAACAGGGTGGGACTATGGCTACACCTTC	CASSFATGWDYGYTF	TRBV27	TRBJ1-2
TGTGCCAGCAGATTCGATTCGGGACAGAACACCTTC	CASRFDSGQNTF	TRBV28	TRBJ1-2
TGTGCCAGCAGTTCACTGGAACTGACTAGCGGGAGGGTATACAATGAGCAGTTCTTC	CASSSLELTSGRVYNEQFF	TRBV27	TRBJ2-1
TGCAGTGCAGAGGGACAGTATAACTATGGCTACACCTTC	CSAEGQYNYGYTF	TRBV20-1	TRBJ1-2
TGCGCCAGCAGAAGGGGGGATGTCATATATTTT	CASRRGDVIYF	TRBV10-1	TRBJ1-3
TGTGCCAGCAGCTTAGCGGGCAGGTCACCCCTCCACTTT	CASSLAGRSPLHF	TRBV7-2	TRBJ1-6
TGTGCCAGCAGTTTACGAAGGGGGGGGCCAAACATTCAGTACTTC	CASSLRRGGPNIQYF	TRBV12-4	TRBJ2-4
TGTGCCAGCAGCTTAACGCTTGGACAGGGATGCATAGAAGAGACCCAGTACTTC	CASSLTLGQGCIEETQYF	TRBV7-3	TRBJ2-5
TGTGCCAGCAGCTTGGGCCGAGGGGGTTCGTACCAAGAGACCCAGTACTTC	CASSLGRGGSYQETQYF	TRBV7-3	TRBJ2-5
TGTGCCAGCAGCGATGGGCAGGTTCCTGGCACAGATACGCAGTATTTT	CASSDGQVPGTDTQYF	TRBV9	TRBJ2-3
TGTGCCAGCAGCTCTGCGACTACATACGAGCAGTACTTC	CASSSATTYEQYF	TRBV7-6	TRBJ2-7
TGTGCCAGCAGCTTAGATCCAGGTTCGGGCAGGGAGGGACAGGGGAGGTACGAGCAGTACTTC	CASSLDPGSGREGQGRYEQYF	TRBV11-3	TRBJ2-7
TGTGCCAGTAGTATGACGACAGGGAATTGGAACACTGAAGCTTTCTTT	CASSMTTGNWNTEAFF	TRBV19	TRBJ1-1
TGTGCCAGCAGTTTATGGATTTTCTTAAAACCAGCATCGAGCAATCAGCCCCAGCATTTT	CASSLWIFLKPASSNQPQHF	TRBV27	TRBJ1-5
TGCGCCAGCAGCTTGGCTCTGGGGGGACAGGGAGCTCCCGGGGCCAACGTCCTGACTTTC	CASSLALGGQGAPGANVLTF	TRBV5-1	TRBJ2-6
TGTGCCAGCAGCGTAGGCGATGCCGAGACCCAGTACTTC	CASSVGDAETQYF	TRBV7-4	TRBJ2-5
TGTGCCAGCAGCAGACAGGGGGCGTGCACTGAAGCTTTCTTT	CASSRQGACTEAFF	TRBV13	TRBJ1-1
TGCAGTGCGGGGGCTTGGGGGGGGGTCCACTTC	CSAGAWGGVHF	TRBV20-1	TRBJ2-7
TGTGCCAGCAGCAGCGCCGGGAGAAGCGGGAACACCGGGGAGCTGTTTTTT	CASSSAGRSGNTGELFF	TRBV13	TRBJ2-2
TGTGCCAGCAGTAATCTGCGGAGCTCCTACGAGCAGTACTTC	CASSNLRSSYEQYF	TRBV27	TRBJ2-7
TGTGCCAGCAGCCGGCGACTAGCGGGGGCGTCTCCCTACGAGCAGTACTTC	CASSRRLAGASPYEQYF	TRBV9	TRBJ2-7
TGTGCCAGCAGCCAGTCTGGACAGGGTAGGCAGCCCCAGCATTTT	CASSQSGQGRQPQHF	TRBV4-2	TRBJ1-5
TGTGCCAGCAGCTTAGGGGTCCACCCAGCCGGGACGAGGGGCTATGGCTACACCTTC	CASSLGVHPAGTRGYGYTF	TRBV11-3	TRBJ1-2
TGTGCCAGCAGCCAAGGGGGGCCGTTAGAGTACGAGCAGTACTTC	CASSQGGPLEYEQYF	TRBV12-3	TRBJ2-7
TGTGCCAGCAGTCGGGACAGGGTGAAACTGACGGGCTCTGGAAACACCATATATTTT	CASSRDRVKLTGSGNTIYF	TRBV12-3	TRBJ1-3
TGTGCCAGCTCACCACCCATAGACATTTTCAATCAGCCCCAGCATTTT	CASSPPIDIFNQPQHF	TRBV18	TRBJ1-5
TGTGCCAGCAGTTACACCCCAGCCAGTGGGGCCTACGAGCAGTACTTC	CASSYTPASGAYEQYF	TRBV6-5	TRBJ2-7
TGTGCCAGCAGTGGGGACAGGGCCCGCCATTATAGCAATCAGCCCCAGCATTTT	CASSGDRARHYSNQPQHF	TRBV2	TRBJ1-5
TGTGCCAGCAGCTTCCGGGGAACTAGCGGACGCGATACCCAGCGAAACACCATATATTTT	CASSFRGTSGRDTQRNTIYF	TRBV7-7	TRBJ1-3
TGTGCCAGCAGTTTATCGTGGAAGACTAGCGGGCCAGAATATGAGCAGTTCTTC	CASSLSWKTSGPEYEQFF	TRBV27	TRBJ2-1
TGCGCCAGCAGCTTTGTTCGGGACAGCTTGCTTACTGAAGCTTTCTTT	CASSFVRDSLLTEAFF	TRBV5-1	TRBJ1-1
TGCAGTGCTAGGTCTATGGCGGGCACAGATACGCAGTATTTT	CSARSMAGTDTQYF	TRBV20-1	TRBJ2-3
TGCAGTGCTAGAATAAAAAGGGGACAGGGGGGGTACGAGCAGTACTTC	CSARIKRGQGGYEQYF	TRBV20-1	TRBJ2-7
TGCAGTGCTAATGATAAAGATATTACAGGGTGGGCCTTT	CSANDKDITGWAF	TRBV20-1	TRBJ1-1
TGTGCCAGCAGCCCGCCCGGGGGGCGGTATTTT	CASSPPGGRYF	TRBV7-4	TRBJ2-3
TGTGCCAGCAGCAGACAGCCGGAAGAGACCCAGTACTTC	CASSRQPEETQYF	TRBV2	TRBJ2-5
TGTGCCAGCATACCCAAGAGGACAGAAGACTATGGCTACACCTTC	CASIPKRTEDYGYTF	TRBV27	TRBJ1-2
TGTGCCAGCACTAGTGCCTACGAGCAGTACTTC	CASTSAYEQYF	TRBV6-2	TRBJ2-7
TGCGCCAGCAGCTTGGCTCGCAATGGACGTCTTGAAGCTTTCTTT	CASSLARNGRLEAFF	TRBV5-1	TRBJ1-1
TGTGCCAGCAGCCCCCTAGGGACAGATACGCAGTATTTT	CASSPLGTDTQYF	TRBV11-2	TRBJ2-3
TGCAGTGCTCGCTTGGGACTCCCAGAAGTTCGCACCGGGGAGCTGTTTTTT	CSARLGLPEVRTGELFF	TRBV20-1	TRBJ2-2
TGTGCTAGCAGCTTAGGGGGACGATCCTACGAGCAGTACTTC	CASSLGGRSYEQYF	TRBV7-7	TRBJ2-7
TGTGCCATCAGTGGCGATCCCATGAACTACGAGCAGTACTTC	CAISGDPMNYEQYF	TRBV10-3	TRBJ2-7
TGCAGTGCTAGAGGTAGAAATAAAGCTTTCAATGAGCAGTTCTTC	CSARGRNKAFNEQFF	TRBV20-1	TRBJ2-1
TGTGCCAGCAGCAGTGGACAGCACAACCTCACCGGCACCGGGGAGCTGTTTTTT	CASSSGQHNLTGTGELFF	TRBV7-6	TRBJ2-2
TGCGCCAGGGGGGGTAAAGAGACCCAGTACTTC	CARGGKETQYF	TRBV4-1	TRBJ2-5
TGTGCCTGGAGTGATCGCGGGGCCTTCGCTCAGAATGGCTACACCTTC	CAWSDRGAFAQNGYTF	TRBV30	TRBJ1-2
TGTGCCAGCAGCTTCGTGGGAATGATCAGGAAGGCTGAAGCTTTCTTT	CASSFVGMIRKAEAFF	TRBV7-8	TRBJ1-1
TGTGCCAGCAGTGGTAGGCCGGGGGGAAAGGCTGGAAACACCATATATTTT	CASSGRPGGKAGNTIYF	TRBV12-4	TRBJ1-3
TGTGCCAGCACTTATCGACGAGAAGCTTTCTTT	CASTYRREAFF	TRBV9	TRBJ1-1
TGTGCCAGCAGTGGCGGGACGGTGGAAAAACTGTTTTTT	CASSGGTVEKLFF	TRBV28	TRBJ1-4
TGTGCCAGCAGCCAAGAGGGGGGGCTAGGACAGTACTTC	CASSQEGGLGQYF	TRBV3-1	TRBJ2-7
TGTGCCAGCAGACTTCTCGGGGAGCAACGCCGGTACTTC	CASRLLGEQRRYF	TRBV6-1	TRBJ2-7
TGTGCCAGCAGTTACTCCTACTCTGGGGCCAACGTCCTGACTTTC	CASSYSYSGANVLTF	TRBV6-3	TRBJ2-6
TGTGCCAGCAGCGCCGGGGAAGGAGAGCAGTTCTTC	CASSAGEGEQFF	TRBV13	TRBJ2-1
TGCAGCGTTGGATGGAACATTAAGGGGCTCCCCTATAATTCACCCCTCCACTTT	CSVGWNIKGLPYNSPLHF	TRBV29-1	TRBJ1-6
TGTGCCAGCCCGGTATCGGCGATCTACGAGCAGTACTTC	CASPVSAIYEQYF	TRBV2	TRBJ2-7
TGTGCCAGCAGCTGGGGGGGGAGGTACAATGAGCAGTTCTTC	CASSWGGRYNEQFF	TRBV11-2	TRBJ2-1
TGTGCCAGCAGTTCGCGAAAGCAGTACTTC	CASSSRKQYF	TRBV6-2	TRBJ2-7
TGTGCCAGCAGCTTTAAGGGGGGGGGGTCCTACGAGCAGTACTTC	CASSFKGGGSYEQYF	TRBV7-8	TRBJ2-7
TGTGCCACCAGCACTGATTTCTACGAGCAGTACTTC	CATSTDFYEQYF	TRBV15	TRBJ2-7
TGTGCCAGCACCCCGGGGGGGCACCCTGCCTACAATGAGCAGTTCTTC	CASTPGGHPAYNEQFF	TRBV6-2	TRBJ2-1
TGTGCCAGCAGCCCTCGGGACAGCTTAGGTGGGAGCTCCTACGAGCAGTACTTC	CASSPRDSLGGSSYEQYF	TRBV14	TRBJ2-7
TGTGCCAGCAGTAAGGACAGGGGCCGGTATAGCAATCAGCCCCAGCATTTT	CASSKDRGRYSNQPQHF	TRBV6-2	TRBJ1-5
TGCGCCAGCACTCTCGGCACTGAAGCTTTCTTT	CASTLGTEAFF	TRBV10-1	TRBJ1-1
TGTGCCAGCAGCCGAACCGGGACTTGGGTGAACACTGAAGCTTTCTTT	CASSRTGTWVNTEAFF	TRBV13	TRBJ1-1
TGCGCCAGCAGCTCCCCACTAGCGGGAGCGTACCCAAGCGGGAGCTCCTACAATGAGCAGTTCTTC	CASSSPLAGAYPSGSSYNEQFF	TRBV5-1	TRBJ2-1
TGTGCCAGTAAACTGTGTAGGGAAAACCAGGACAGGGGAGGTACCCGGGCTAATGAAAAACTGTTTTTT	CASKLCRENQDRGGTRANEKLFF	TRBV19	TRBJ1-4
TGTGCCAGGGGTTCTCCGGGACCCTACGAGCAGTACTTC	CARGSPGPYEQYF	TRBV7-9	TRBJ2-7
TGTGCCAGCAGTGCTAAAAAACTGTTTTTT	CASSAKKLFF	TRBV6-1	TRBJ1-4
TGTGCCAGCACGGTGAGGCGGGTTAAAAGCTTTTCCGGGGAGCTGTTTTTT	CASTVRRVKSFSGELFF	TRBV14	TRBJ2-2
TGTGCCAGCAGCCCACGACGGAGGAAAGAGCAGTACTTC	CASSPRRRKEQYF	TRBV5-5	TRBJ2-7
TGTGCCAGCAGCAATGGGACAGCGGCTGACCACCCCTACAATGAGCAGTTCTTC	CASSNGTAADHPYNEQFF	TRBV13	TRBJ2-1
TGCGCCAGCAGCTTCGAGCGTGGAGGGACCATTATCAAGGAAGAGACCCAGTACTTC	CASSFERGGTIIKEETQYF	TRBV5-1	TRBJ2-5
TGTGCCTGGAGTTACCCGGGATCTGGCTCTGGAAACACCATATATTTT	CAWSYPGSGSGNTIYF	TRBV30	TRBJ1-3
TGTGCCAGCAGGCCTGGGAGGGGGGGGCTTGGCTACGAGCAGTACTTC	CASRPGRGGLGYEQYF	TRBV6-8	TRBJ2-7
TGTGCCAGCAGCCGGGAAGCCGAGGGGAGCACAGATACGCAGTATTTT	CASSREAEGSTDTQYF	TRBV13	TRBJ2-3
TGTGCCATCAGTGAATTAGGAGCCGGGACAGGGGGCGCTAACTATGGCTACACCTTC	CAISELGAGTGGANYGYTF	TRBV10-3	TRBJ1-2
TGTGCCAGCAGTCAGCTGGGGGGGGCCCAGTACTTC	CASSQLGGAQYF	TRBV6-1	TRBJ2-5
TGTGCCAGCAGCTGTCGGGGGGGTCAGCCCCAGCATTTT	CASSCRGGQPQHF	TRBV5-6	TRBJ1-5
TGCAGTGGGGTCGACTGGGAGCAAGAGACCCAGTACTTC	CSGVDWEQETQYF	TRBV20-1	TRBJ2-5
TGCAGTGCTAGCTCGGTTTCCTGTACCTACGAGCAGTACTTC	CSASSVSCTYEQYF	TRBV20-1	TRBJ2-7
TGTGCCAGCAGCCAATCGAAGGCTTGGGGTGAAAAACTGTTTTTT	CASSQSKAWGEKLFF	TRBV14	TRBJ1-4
TGTGCCAGCAGTGAAGGAACAGGGGTTCGAGCTTTCTTT	CASSEGTGVRAFF	TRBV6-1	TRBJ1-1
TGTGCCAGCAGTTACCTAGTAGGGCGCGCTTATGGCTACACCTTC	CASSYLVGRAYGYTF	TRBV6-3	TRBJ1-2
TGCAGCGTTGGCCGGACTAGCGGGAGACCAGACTATGGCTACACCTTC	CSVGRTSGRPDYGYTF	TRBV29-1	TRBJ1-2
TGTGCCAGCAGCCAAATTCGCATAAACCGAACCAAAAACATTCAGTACTTC	CASSQIRINRTKNIQYF	TRBV4-2	TRBJ2-4
TGTGCCAGCAGCCTGGACAGGGGGGATCGAAGGGGGGGTTCTGGAAACACCATATATTTT	CASSLDRGDRRGGSGNTIYF	TRBV13	TRBJ1-3
TGTGCCAGCAGCTTAAAAGCGGAGAGAAAACTGTTTTTT	CASSLKAERKLFF	TRBV7-3	TRBJ1-4
TGCATACTAGCGGGTGAGCAGTTCTTC	CILAGEQFF	TRBV29-1	TRBJ2-1
TGTGCCAGTACTCGAGCGGGAGAAGTACACATGAACACCGGGGAGCTGTTTTTT	CASTRAGEVHMNTGELFF	TRBV19	TRBJ2-2
TGTGCCAGCAGCAATAACAGGACAGGCCGCTACACCTTC	CASSNNRTGRYTF	TRBV7-3	TRBJ1-2
TGCGCCAGCAACCCACCGGGTACCACTGAAGCTTTCTTT	CASNPPGTTEAFF	TRBV5-1	TRBJ1-1
TGTGCCAGCAGCCTCCCGGGGGGCCCAGAAACCGGGGAGCTGTTTTTT	CASSLPGGPETGELFF	TRBV7-2	TRBJ2-2
TGTGCCGTGGGGGCGGGTGATCAGCCCCAGCATTTT	CAVGAGDQPQHF	TRBV6-4	TRBJ1-5
TGCGCCAGCACAGACAGGGGTTTCACAGATACGCAGTATTTT	CASTDRGFTDTQYF	TRBV4-3	TRBJ2-3
TGTGCCAGCAGTGGGCTCCGAAACATTCAGTACTTC	CASSGLRNIQYF	TRBV6-1	TRBJ2-4
TGTGCCAGGTTCCACCGAGTCCAGTATAATTCACCCCTCCACTTT	CARFHRVQYNSPLHF	TRBV19	TRBJ1-6
TGTGCCAGCAGTAGGCAGGAGGATCAGCCCCAGCATTTT	CASSRQEDQPQHF	TRBV27	TRBJ1-5
TGTGCCACCAGTGAAATCCTTGGGGCCACGGACTATGGCTACACCTTC	CATSEILGATDYGYTF	TRBV24-1	TRBJ1-2
TGTGCCAGCAGTACGGCTCGAGGAGAGCAGTTCTTC	CASSTARGEQFF	TRBV6-2	TRBJ2-1
TGTGCCAGCAGAGGGGACGTTTCCTACGAGCAGTACTTC	CASRGDVSYEQYF	TRBV6-2	TRBJ2-7
TGTGCCAGCGTTGGGGTTAATGGCTACACCTTC	CASVGVNGYTF	TRBV27	TRBJ1-2
TGTGCCAGCAGTTACATATTTAGCATCGAGGGGTCCGGCCATTGGCCGGGAATCTATGGCTACACCTTC	CASSYIFSIEGSGHWPGIYGYTF	TRBV6-8	TRBJ1-2
TGTGCCAGCAGTTATCGTTCGCCATGCAGGGCTAGGGTAAATCAGCCCCAGCATTTT	CASSYRSPCRARVNQPQHF	TRBV6-5	TRBJ1-5
TGTGCCAGCAGCGGGCTATCTAATCTAGGGGGTTGGTCCTATGGCTACACCTTC	CASSGLSNLGGWSYGYTF	TRBV9	TRBJ1-2
TGTGCCACCAGTAACACAAATGTAGACAAACTCGAAAAACTGTTTTTT	CATSNTNVDKLEKLFF	TRBV24-1	TRBJ1-4
TGTGCCATGAGGGGATTACGGAACACTGAAGCTTTCTTT	CAMRGLRNTEAFF	TRBV6-4	TRBJ1-1
TGCAGTGCTAGAGATCGGGGGCAAGTTCGCACAGATACGCAGTATTTT	CSARDRGQVRTDTQYF	TRBV20-1	TRBJ2-3
TGTGCCAGCAAGTTAAGGGTAGAGGCCGGGGAGCTGTTTTTT	CASKLRVEAGELFF	TRBV14	TRBJ2-2
TGTGCCAGCCCGCACGGGAGGGGAAGCCAAGCAGGGTTGGGGCGGGTAGGCGCTAGCACAGATACGCAGTATTTT	CASPHGRGSQAGLGRVGASTDTQYF	TRBV7-6	TRBJ2-3
TGTGCCAGCAATCTAGCGGTGGCCAATGAGCAGTTCTTC	CASNLAVANEQFF	TRBV27	TRBJ2-1
TGTGCCAGCAGGGGTAGCAAGAACAATGAGCAGTTCTTC	CASRGSKNNEQFF	TRBV12-4	TRBJ2-1
TGCGCCAGCAGCCGACAGTCCTACAATGAGCAGTTCTTC	CASSRQSYNEQFF	TRBV5-1	TRBJ2-1
TGCAGCGTTCCCGGGACAGCACGACATCAGCCCCAGCATTTT	CSVPGTARHQPQHF	TRBV29-1	TRBJ1-5
TGTGCCAGCAGCTTAGAGGGGCCGACAGGCTCGTTACCGGGCTACGAGCAGTACTTC	CASSLEGPTGSLPGYEQYF	TRBV11-3	TRBJ2-7
TGTGCCAGCAGCCGGGTAGTCTCGACTAGCGGGGCCTACAATGAGCAGTTCTTC	CASSRVVSTSGAYNEQFF	TRBV9	TRBJ2-1
TGTGCCACCAGTGGGACAGGAGTTCAGCCCCAGCATTTT	CATSGTGVQPQHF	TRBV24-1	TRBJ1-5
TGTGCCAGCAGCCAAGGAAAAGGGTGTGGCAATCAGCCCCAGCATTTT	CASSQGKGCGNQPQHF	TRBV14	TRBJ1-5
TGTGCCAGCAGCGACTTTTCCGGGAAAGGCTCCTACGAGCAGTACTTC	CASSDFSGKGSYEQYF	TRBV27	TRBJ2-7
TGCAGTGCTCCATCGGATGCAACTAATGAAAAACTGTTTTTT	CSAPSDATNEKLFF	TRBV20-1	TRBJ1-4
TGTGCCAGCAGTAAGGACAAGTGCAATCAGCCCCAGCATTTT	CASSKDKCNQPQHF	TRBV6-3	TRBJ1-5
TGTGGGGTTTGTTGTAAGTACTTC	CGVCCKYF	TRBV10-3	TRBJ2-7
TGTGCCAGCAGCCTGGGTCCGGGACTAGCGGGGGGGCGAGTCAGGTCCGGCAATGAGCAGTTCTTC	CASSLGPGLAGGRVRSGNEQFF	TRBV7-2	TRBJ2-1
TGTGCCAGCAGCGTAGAAAATTCCGTAGTGGGACTAGCGGGGGATGAGCAGTTCTTC	CASSVENSVVGLAGDEQFF	TRBV9	TRBJ2-1
TGTGCCAGCAGTGACTGGTTGGCCGGACAGGGGACTAACTATGGCTACACCTTC	CASSDWLAGQGTNYGYTF	TRBV6-1	TRBJ1-2
TGTGCCAGCAGCTCAAGACGCGGGTACTTC	CASSSRRGYF	TRBV7-2	TRBJ2-5
TGTGCCATCATCCCTCCCAGGAGCTTTAAGGGCTACGAGCAGTACTTC	CAIIPPRSFKGYEQYF	TRBV10-3	TRBJ2-7
TGCAGCTACGGGGGGGCGCAGGGAAGAGGGGCTAGTGAGCAGTTCTTC	CSYGGAQGRGASEQFF	TRBV29-1	TRBJ2-1
TGTGCCAGCACAGGCTCCGGGCGGTACGGGGCCAACGTCCTGACTTTC	CASTGSGRYGANVLTF	TRBV11-1	TRBJ2-6
TGCGCCAGCCCGGGGCCCTGTAATGAAAAACTGTTTTTT	CASPGPCNEKLFF	TRBV4-3	TRBJ1-4
TGCGCCAGCAGTGAGTCCTCGGCGAGCCGCCCCTACGAGCAGTACTTC	CASSESSASRPYEQYF	TRBV10-2	TRBJ2-7
TGCAGTGCCCGTCAGACAGGGGGCGCGAACACTGAAGCTTTCTTT	CSARQTGGANTEAFF	TRBV20-1	TRBJ1-1
TGCAGCGTTGAAAGGACGGCCGAGCAGTACTTC	CSVERTAEQYF	TRBV29-1	TRBJ2-7
TGTGCCGGGGAGGAAGGGACAGCGGCTCAAGAGACCCAGTACTTC	CAGEEGTAAQETQYF	TRBV27	TRBJ2-5
TGTGCCAGCATCCCTTCAGGGTCGCAGCCCCAGCATTTT	CASIPSGSQPQHF	TRBV6-4	TRBJ1-5
TGTGCCAGCAGCAGGGAGGGGGTCAAGTTCGGAAACACCATATATTTT	CASSREGVKFGNTIYF	TRBV12-4	TRBJ1-3
TGTGCCAGCAGCTTTAAGCGTATTGGCGGGACGTCCCATCAGCCCCAGCATTTT	CASSFKRIGGTSHQPQHF	TRBV7-4	TRBJ1-5
TGTGCCACCAGTGATTTGACAGGCAGACACGAGCAGTACTTC	CATSDLTGRHEQYF	TRBV24-1	TRBJ2-7
TGTGCCAGCAGCCCCGCAGCAGGGGTAGGAAACACCATATATTTT	CASSPAAGVGNTIYF	TRBV13	TRBJ1-3
TGTGCCACCAGTTGGAGGGGACAGGGGCTGGGGTCCTACGAGCAGTACTTC	CATSWRGQGLGSYEQYF	TRBV24-1	TRBJ2-7
TGTGCCAGCAGCTTAGGAAGACGGACCGGGCTCTATGGCTACACCTTC	CASSLGRRTGLYGYTF	TRBV11-3	TRBJ1-2
TGCAGCGTTGCGAAAGGGGCAGGGGCCTTCCAGTATGGCTACACCTTC	CSVAKGAGAFQYGYTF	TRBV29-1	TRBJ1-2
TGTGCCAGCAGCTCACGGCGAGAGACTTTCACTGAAGCTTTCTTT	CASSSRRETFTEAFF	TRBV7-3	TRBJ1-1
TGTGCCACCACCCTGACGGGGGGGTACGAGCAGTACTTC	CATTLTGGYEQYF	TRBV24-1	TRBJ2-7
TGTGCCAGCAGTGTAGCGGGTTACGAGCAGTACTTC	CASSVAGYEQYF	TRBV6-4	TRBJ2-7
TGTGCCAGCAGCCAAGGGACAGTGGAAACTAATGAAAAACTGTTTTTT	CASSQGTVETNEKLFF	TRBV14	TRBJ1-4
TGTGCCAGCAGCTTAAAGTTCCAGGCAGGTAGCAATCAGCCCCAGCATTTT	CASSLKFQAGSNQPQHF	TRBV11-1	TRBJ1-5
TGTGCCAGCAGCGTAGAGGACAGGGGGCGGGATAGACAGGGGGGCTACACCTTC	CASSVEDRGRDRQGGYTF	TRBV9	TRBJ1-2
TGTGCCAGCTCACCCCCCGGACAGGGCGGGGATAGCAATCAGCCCCAGCATTTT	CASSPPGQGGDSNQPQHF	TRBV18	TRBJ1-5
TGTGCCAGCAGCCAAGACGGTCCATGGGGGGAAGCTTTCTTT	CASSQDGPWGEAFF	TRBV3-1	TRBJ1-1
TGCAGTGCTAGGGAGAGACAACTTTGGCCTGAAGCTTTCTTT	CSARERQLWPEAFF	TRBV20-1	TRBJ1-1
TGTGCCACCACGGACCGGGACAGGGGGGATTCCGAGCAGTACTTC	CATTDRDRGDSEQYF	TRBV24-1	TRBJ2-7
TGTGCCATCAGTGAGTCTCTGAGATCCATCCCGGGACATGAGCTGGGGGAAACTGAAGCTTTCTTT	CAISESLRSIPGHELGETEAFF	TRBV10-3	TRBJ1-1
TGTGCCAGCAGCGGATCACAGAACACTGAAGCTTTCTTT	CASSGSQNTEAFF	TRBV9	TRBJ1-1
TGCAGTGCTAGACAGGGCCGGGAGCAGTACTTC	CSARQGREQYF	TRBV20-1	TRBJ2-7
TGTGCCAGCACGGCGGGAGGCTCTTACTATGGCTACACCTTC	CASTAGGSYYGYTF	TRBV3-1	TRBJ1-2
TGTGCCAGCAGATCTCAGGGGGTTCTGGGTCAGCCCCAGCATTTT	CASRSQGVLGQPQHF	TRBV28	TRBJ1-5
TGTGCCAGCACCGGACTAGCGGGGCCCTACGAGCAGTACTTC	CASTGLAGPYEQYF	TRBV6-4	TRBJ2-7
TGTGCCAGCAGTCGACGAGTTCAAGAGACCCAGTACTTC	CASSRRVQETQYF	TRBV28	TRBJ2-5
TGTGCCAGCAGACCGGTAGGCGGGCACTACACCTTC	CASRPVGGHYTF	TRBV6-5	TRBJ1-2
TGTGCCAGCCCCTGTAACGGGAATTCGCCAGATACGCAGTATTTT	CASPCNGNSPDTQYF	TRBV6-2	TRBJ2-3
TGTGCCAGCAGCATACCGGTGGACAGGGATCAGCCCCAGCATTTT	CASSIPVDRDQPQHF	TRBV12-3	TRBJ1-5
TGTGCCAGCAGTGAACCCGACAGGGGGCACGGGTTGCGGGAAAGTGAGACCCAGTACTTC	CASSEPDRGHGLRESETQYF	TRBV25-1	TRBJ2-5
TGTGCCAGCAGTCCGGGGAAGCCCCAGCATTTT	CASSPGKPQHF	TRBV28	TRBJ1-5
TGTGCCAGCAGCCGAAAGGACAGGAAGGGAAAACTGTTTTTT	CASSRKDRKGKLFF	TRBV3-1	TRBJ1-4
TGTGCCAGCTCACGAAAAAACGGACAGCGGACCGGGGAGCTGTTTTTT	CASSRKNGQRTGELFF	TRBV18	TRBJ2-2
TGTGCCAGCAGCCAACCGCTGGGAGCGGCTTACAATGAGCAGTTCTTC	CASSQPLGAAYNEQFF	TRBV14	TRBJ2-1
TGTGCCAGCAGCCGGGGTTACACTGAAGCTTTCTTT	CASSRGYTEAFF	TRBV14	TRBJ1-1
TGTGCCAGCAGCTTTGGGACAGGGACGACCGGGGAGCTGTTTTTT	CASSFGTGTTGELFF	TRBV7-9	TRBJ2-2
TGTGCCAGCAGCTCCAAACAGTTAGAGACCCAGTACTTC	CASSSKQLETQYF	TRBV11-2	TRBJ2-5
TGTGCCAGCAGCCAGGGGGGGCCCTACGAGCAGTACTTC	CASSQGGPYEQYF	TRBV14	TRBJ2-7
TGTGCCAGCAGCGGGCCTTGTCCCACAGATACGCAGTATTTT	CASSGPCPTDTQYF	TRBV3-1	TRBJ2-3
TGTGCCAGCAGCGTAGAGGTGGACTATCTCAATGAGCAGTTCTTC	CASSVEVDYLNEQFF	TRBV9	TRBJ2-1
TGCGCCAGCAGCCCCATCTCCGAGCAGTACTTC	CASSPISEQYF	TRBV4-3	TRBJ2-7
TGCGCCAGCAGCTCTTTGGGGTCACCCCTCCACTTT	CASSSLGSPLHF	TRBV5-1	TRBJ1-6
TGTGCCTGGAACACCGGAGGGACAGGGTCCGATAGCACCGGGGAGCTGTTTTTT	CAWNTGGTGSDSTGELFF	TRBV30	TRBJ2-2
TGTGCCAGCAGCTTAGAATCTGGGGACCCAGCGGGGGGGCCCCCCGAGACCCAGTACTTC	CASSLESGDPAGGPPETQYF	TRBV7-9	TRBJ2-5
TGTGCCAGTAGTATGTTACCCTCTCCTGAGACCCAGTACTTC	CASSMLPSPETQYF	TRBV19	TRBJ2-5
TGTGCCCCATCTCGGGATGAGCAGTTCTTC	CAPSRDEQFF	TRBV15	TRBJ2-1
TGTGCCAGCAGCCCCGTACTAGCGGGAGCGGGGGGCAAAAGGAACACTGAAGCTTTCTTT	CASSPVLAGAGGKRNTEAFF	TRBV7-9	TRBJ1-1
TGTGCCAGCAGTGACGGTAATTCACCCCTCCACTTT	CASSDGNSPLHF	TRBV7-2	TRBJ1-6
TGTGCCAGCAGTGTCCGCAGTGGGGCTGGCTACACCTTC	CASSVRSGAGYTF	TRBV25-1	TRBJ1-2
TGTGCCAGCAGGTCCCTATGCGGGACACACTCTGCTCGGGGCTACACCTTC	CASRSLCGTHSARGYTF	TRBV6-5	TRBJ1-2
TGCGCCAGCGCAGCGAGACCGCAGGGGGGTTTAGGCTACACCTTC	CASAARPQGGLGYTF	TRBV10-1	TRBJ1-2
TGCGCCAGCAAAGGTCCGGGACAGGACTACGAGCAGTACTTC	CASKGPGQDYEQYF	TRBV10-1	TRBJ2-7
TGTGCCAAAGCCTTCCCCGACAGGCTTAGGTACAATGAGCAGTTCTTC	CAKAFPDRLRYNEQFF	TRBV6-6	TRBJ2-1
TGCGCCAGCAGTGACATTCGGGGGCTCGGATGGAACAAGATGAACACTGAAGCTTTCTTT	CASSDIRGLGWNKMNTEAFF	TRBV10-1	TRBJ1-1
TGTGCCATCAGTGAGCCACAGAGTAGGGAAAGTCTGTGGGTCCTTTCTGAAAAACTGTTTTTT	CAISEPQSRESLWVLSEKLFF	TRBV10-3	TRBJ1-4
TGTGCCAGCAGTGGGGGACTTGGGTATGAGCAGTTCTTC	CASSGGLGYEQFF	TRBV12-4	TRBJ2-1
TGTGCCAGTAGAGCTCAGGGGTGGGCTGGAAACACCATATATTTT	CASRAQGWAGNTIYF	TRBV19	TRBJ1-3
TGTGCCAGTACAATGACAGGAGGCAATCAGCCCCAGCATTTT	CASTMTGGNQPQHF	TRBV19	TRBJ1-5
TGCGCCAGCAGCTTAGGGCACCCGGGACCGTCTCAAGAGACCCAGTACTTC	CASSLGHPGPSQETQYF	TRBV5-1	TRBJ2-5
TGCGCCAGCAGCGACTTGGGACTTCTTGGGGAGCTGTTTTTT	CASSDLGLLGELFF	TRBV5-1	TRBJ2-2
TGTGCCAGCAGTCGGACAGGGCCGGATTCACCCCTCCACTTT	CASSRTGPDSPLHF	TRBV6-3	TRBJ1-6
TGCGCCAGCAGCTTTTGGGAATATCGAGGGGAGCCGGGAGTAACTCAAGAGACCCAGTACTTC	CASSFWEYRGEPGVTQETQYF	TRBV5-1	TRBJ2-5
TGTGCGGTTCGTTCACAGCGATGGACTGAAGCTTTCTTT	CAVRSQRWTEAFF	TRBV6-5	TRBJ1-1
TGTGCCAGCAGCCAAGACGAGGAAGCTTTCTTT	CASSQDEEAFF	TRBV7-4	TRBJ1-1
TGTGCCAGCTCACCCGTCTCGATTCCCGAGCAGTACTTC	CASSPVSIPEQYF	TRBV18	TRBJ2-7
TGTGCCAGCAGCCTAGGTGAGACCCAGTACTTC	CASSLGETQYF	TRBV9	TRBJ2-5
TGTGCCAGCAGTTACTCCCTACTGGAGAACTATCAGCCCCAGCATTTT	CASSYSLLENYQPQHF	TRBV6-3	TRBJ1-5
TGTGCCAGTAGTACGCTTGGTGGACACGAGCAGTACTTC	CASSTLGGHEQYF	TRBV19	TRBJ2-7
TGTGCCAGCACATTAAAGCAAGGGGAAGCTGGAAACACCATATATTTT	CASTLKQGEAGNTIYF	TRBV9	TRBJ1-3
TGTGCCAGCTCACCACAGGGGCGGGGGAGAAATCAGCCCCAGCATTTT	CASSPQGRGRNQPQHF	TRBV18	TRBJ1-5
TGTGCCAGCAGACAGGGGGCGTCATCCTGGAAGTCTGGAAACACCATATATTTT	CASRQGASSWKSGNTIYF	TRBV25-1	TRBJ1-3
TGTGCCAGCTCACCCAGAGCCGCAGATACGCAGTATTTT	CASSPRAADTQYF	TRBV18	TRBJ2-3
TGTGCCAGTAGTCGGCATTGGACCCGATCACCCCTCCACTTT	CASSRHWTRSPLHF	TRBV19	TRBJ1-6
TGTGCCAGCAGTTTTCAGCGGGGGGGAGACTACGAGCAGTACTTC	CASSFQRGGDYEQYF	TRBV27	TRBJ2-7
TGTGCCACCAGAAATCAGCCCCAGCATTTT	CATRNQPQHF	TRBV24-1	TRBJ1-5
TGTGCCAGCAGCTTACGTGACACATATGGCTACACCTTC	CASSLRDTYGYTF	TRBV5-6	TRBJ1-2
TGTGCCAGCATAGCGGGATCCTATGGCTACACCTTC	CASIAGSYGYTF	TRBV12-3	TRBJ1-2
TGTGCCAGCAGTGACTCGAACCGATTATTACCCGGGGCATCGCCGGAGACCCAGTACTTC	CASSDSNRLLPGASPETQYF	TRBV6-4	TRBJ2-5
TGTGCCACCAGTCGTAACGTGTGGAGGCGCACAGATACGCAGTATTTT	CATSRNVWRRTDTQYF	TRBV24-1	TRBJ2-3
TGCAGTGCTAGGCACGTCCGGGGAATCTCCAACACTGAAGCTTTCTTT	CSARHVRGISNTEAFF	TRBV20-1	TRBJ1-1
TGCGCCAGCAGCGACAGGGAGCTGATCGGGGCCAAAAACATTCAGTACTTC	CASSDRELIGAKNIQYF	TRBV4-1	TRBJ2-4
TGTGCCAGCAGTGAAAGTGAGCGGGGGAGGAAGGGGAACACTGAAGCTTTCTTT	CASSESERGRKGNTEAFF	TRBV6-1	TRBJ1-1
TGTGCCAGCAGAATGCGAGGACAGGAGCAGTACTTC	CASRMRGQEQYF	TRBV13	TRBJ2-7
TGTGCCAGCAGTGAAGTAGAGGAGGGTGAAAAACTGTTTTTT	CASSEVEEGEKLFF	TRBV6-1	TRBJ1-4
TGCGCCAGCAGCCAAATAGGGGGGCCCTACTTC	CASSQIGGPYF	TRBV4-1	TRBJ2-5
TGCGCCAGCAGCTCGAGGGCCACAAGCAATCAGCCCCAGCATTTT	CASSSRATSNQPQHF	TRBV5-1	TRBJ1-5
TGTGCCAGCAGCCCCGGGGACACTGAAGCTTTCTTT	CASSPGDTEAFF	TRBV12-4	TRBJ1-1
TGTGCCAGCAGCCAGGGGGGGGGGTCAAAGCTACTGTTTTTT	CASSQGGGSKLLFF	TRBV14	TRBJ1-4
TGTGCCCTCCACCGGACTAGCCCATGCGGGGAGCTGTTTTTT	CALHRTSPCGELFF	TRBV19	TRBJ2-2
TGTGCCAGCAGTGACACCGCGGTTGGTAATGCCCCCTACGAGCAGTACTTC	CASSDTAVGNAPYEQYF	TRBV6-4	TRBJ2-7
TGTGCCACCCCCCCCTCTCTGACTAGCGGGTCTCAAGATACGCAGTATTTT	CATPPSLTSGSQDTQYF	TRBV25-1	TRBJ2-3
TGCGCCAGCAGTGAAACTCACAGGGTGGTGAACACTGAAGCTTTCTTT	CASSETHRVVNTEAFF	TRBV10-1	TRBJ1-1
TGTGCCAGCAGCGAGCCCGGAGGTTGTGAAGCTTTCTTT	CASSEPGGCEAFF	TRBV12-4	TRBJ1-1
TGTGCCAGCAGTGTCCAGGAGACCCAGTACTTC	CASSVQETQYF	TRBV27	TRBJ2-5
TGTGCCAGCTCACCACCCCCTGGGATGGGAGCCTACGAGCAGTACTTC	CASSPPPGMGAYEQYF	TRBV18	TRBJ2-7
TGTGCCACCTCCTCGCGGGAGATAGAGAGTGAAGCTTTCTTT	CATSSREIESEAFF	TRBV24-1	TRBJ1-1
TGCGCCAGCAGCCAGGCCAGGGACAATGAAAAACTGTTTTTT	CASSQARDNEKLFF	TRBV4-1	TRBJ1-4
TGCAGGGTTAACTACGACCGCTCTGGGGCCAACGTCCTGACTTTC	CRVNYDRSGANVLTF	TRBV20-1	TRBJ2-6
TGTGCCAGCAGTTTGGCCGGAAACTACGAGCAGTACTTC	CASSLAGNYEQYF	TRBV27	TRBJ2-7
TGTGCCACCAGCAGGGGGGGCCCGGACGCCGGGGAGCTGTTTTTT	CATSRGGPDAGELFF	TRBV15	TRBJ2-2
TGTGCCAGCAGTGAGCAGGGAGGGAACCATTGGAGCAATCAGCCCCAGCATTTT	CASSEQGGNHWSNQPQHF	TRBV6-1	TRBJ1-5
TGTGCCACCAGTGCGGACAGGGCGACCTTCGGGGAGCTGTTTTTT	CATSADRATFGELFF	TRBV24-1	TRBJ2-2
TGTGCCAGCAGCCCCTTAGACCTCGGCTACCAGAGGTCTGGGGCCAACGTCCTGACTTTC	CASSPLDLGYQRSGANVLTF	TRBV11-3	TRBJ2-6
TGTGCCAGCAGCGTAGGCCGACAGGGTCGGACCGGGGAGCTGTTTTTT	CASSVGRQGRTGELFF	TRBV9	TRBJ2-2
TGTGCCAGCAGCCCAACCCCGACAGGGGGCGGCTACACCTTC	CASSPTPTGGGYTF	TRBV14	TRBJ1-2
TGCGCCGACAGGGTTATGAACACCGGGGAGCTGTTTTTT	CADRVMNTGELFF	TRBV4-3	TRBJ2-2
TGCAGTGCTGTAATGGACAGGGCTGGGATGAACACTGAAGCTTTCTTT	CSAVMDRAGMNTEAFF	TRBV20-1	TRBJ1-1
TGTGCCAGCAGCGTAGCCGTCACCCATAGGGGGCGGGACTCTGACGAGCAGTACTTC	CASSVAVTHRGRDSDEQYF	TRBV9	TRBJ2-7
TGTGCCAGCAGCGTTTGTCTGACAAAACTAGCTGAAGCTTTCTTT	CASSVCLTKLAEAFF	TRBV7-6	TRBJ1-1
TGTGCCAGCAGTTTAAGGGCAGCAGGGGGACATCAGCCCCAGCATTTT	CASSLRAAGGHQPQHF	TRBV28	TRBJ1-5
TGTGCCAGCAGCTTACACCAGGGGCACTGTCCAAACACCGGGGAGCTGTTTTTT	CASSLHQGHCPNTGELFF	TRBV7-3	TRBJ2-2
TGTGCCACCAGTGATGGGGCAGGCTCTGGAAACACCATATATTTT	CATSDGAGSGNTIYF	TRBV24-1	TRBJ1-3
TGTGCCTGGAAGGAGGGGGGACAGGAAGGTTCTGGAAACACCATATATTTT	CAWKEGGQEGSGNTIYF	TRBV30	TRBJ1-3
TGTGCCAGCAGAAATAGGGAGAAGGCTAACTATGGCTACACCTTC	CASRNREKANYGYTF	TRBV6-5	TRBJ1-2
TGTGCCACCCCCCGGGGGAGCTCCTACAATGAGCAGTTCTTC	CATPRGSSYNEQFF	TRBV24-1	TRBJ2-1
TGTGCCAGCAGCGGGGACAACAGGGTCATCTGGTACTATGGCTACACCTTC	CASSGDNRVIWYYGYTF	TRBV7-2	TRBJ1-2
TGTGCCACCAGTGATTTGCCAGGACTAGCGGGGGGGCCCACCCAAGAGACCCAGTACTTC	CATSDLPGLAGGPTQETQYF	TRBV24-1	TRBJ2-5
TGTGCCAGCAGCCCCATGGGACAGGGCCCCTACGAGCAGTACTTC	CASSPMGQGPYEQYF	TRBV9	TRBJ2-7
TGTGCCACCAGGTACCGGGGGGGGTGTTCCGGTGATACGCAGTATTTT	CATRYRGGCSGDTQYF	TRBV24-1	TRBJ2-3
TGTGCGGGGACAGGGTTTCTCGGAAACACCATATATTTT	CAGTGFLGNTIYF	TRBV7-6	TRBJ1-3
TGTGCCAGCAGCTTATCCAACTGGTGGGCGGGTAGCTCCTACGAGCAGTACTTC	CASSLSNWWAGSSYEQYF	TRBV7-2	TRBJ2-7
TGTGCCAGCAGCTTAGAGTGTCACAGTGATGGCTACACCTTC	CASSLECHSDGYTF	TRBV7-9	TRBJ1-2
TGTGCCAGCAGCATCAATGAAGCCGGGACAAGGCTAGCCAAAAACATTCAGTACTTC	CASSINEAGTRLAKNIQYF	TRBV11-2	TRBJ2-4
TGTGCCTCCGTACCGGGGGGAGCAACTAATGAAAAACTGTTTTTT	CASVPGGATNEKLFF	TRBV24-1	TRBJ1-4
TGCGCCAGCAGTGGGGGTCGGACGGAGCAGTACTTC	CASSGGRTEQYF	TRBV10-1	TRBJ2-7
TGCGCCAGCAGCCCCGAGGGTACGAGTATCTACGAGCAGTACTTC	CASSPEGTSIYEQYF	TRBV4-1	TRBJ2-7
TGTGCCAGCAGCGGACCCTCCCGACTAGCGGGAGGGCATGTGGGGTACGAGCAGTACTTC	CASSGPSRLAGGHVGYEQYF	TRBV7-3	TRBJ2-7
TGTGCCAGCAGCATCCCCGGAAACCGGACAGTGTCGTCCTACGAGCAGTACTTC	CASSIPGNRTVSSYEQYF	TRBV11-3	TRBJ2-7
TGTGCCAGCAGCCCGGTGCCCCAGAGTGGGACAGCCACTACTGAAGCTTTCTTT	CASSPVPQSGTATTEAFF	TRBV7-2	TRBJ1-1
TGTGCCTGGAGTGCCTCAGCCTACAATGAGCAGTTCTTC	CAWSASAYNEQFF	TRBV30	TRBJ2-1
TGTGCCAGCAGCTATATAAACGGACCACAAGGCTACACCTTC	CASSYINGPQGYTF	TRBV7-8	TRBJ1-2
TGTGCCAGCAACCTCCTTAGCAATCAGCCCCAGCATTTT	CASNLLSNQPQHF	TRBV11-2	TRBJ1-5
TGCAGTGCTAGTGGGGGCATTCCAGCCTCTGAAGCTTATGAGCAGTTCTTC	CSASGGIPASEAYEQFF	TRBV20-1	TRBJ2-1
TGTGCCAGCAGCTTTTCCGGTGGTGCAGATACGCAGTATTTT	CASSFSGGADTQYF	TRBV5-5	TRBJ2-3
TGTGCCAGCAGTTATCGGGACAGAGGGGGGGTGAACACTGAAGCTTTCTTT	CASSYRDRGGVNTEAFF	TRBV12-4	TRBJ1-1
TGTGCCAGCAGCACAGGGGAGACAGGCTACGAGCAGTACTTC	CASSTGETGYEQYF	TRBV13	TRBJ2-7
TGTGCCAGCAGCAAAAGACGACAGGGGCCAATCACCGAGCAGTACTTC	CASSKRRQGPITEQYF	TRBV7-4	TRBJ2-7
TGCGCCAGCACAGCCGGGACAGAGTTGAACACTGAAGCTTTCTTT	CASTAGTELNTEAFF	TRBV10-1	TRBJ1-1
TGTGCCAGCAGCGTCTCCTACCTAGGCGGGACAGTTCATGAGCAGTTCTTC	CASSVSYLGGTVHEQFF	TRBV7-3	TRBJ2-1
TGCGCCAGCGGAGGGGGAGCTTTCTTT	CASGGGAFF	TRBV4-3	TRBJ1-1
TGTGCCAGCAGCTTAGCGCCCGACAGGGCCCTTTCCTCCTACGAGCAGTACTTC	CASSLAPDRALSSYEQYF	TRBV7-4	TRBJ2-7
TGTGCCAGCACCGAACGGACAGGGTTCTATGGCTACACCTTC	CASTERTGFYGYTF	TRBV2	TRBJ1-2
TGTGCCAGCAGCTACCGTTGGGGGGCCCACTACGAGCAGTACTTC	CASSYRWGAHYEQYF	TRBV7-9	TRBJ2-7
TGTGCCAGCAGCACAGGCCGTGAGCAGTTCTTC	CASSTGREQFF	TRBV7-6	TRBJ2-1
TGTGCCAGCAGCCAAGAGGCAACGGGGGCGAGGACGAACACTGAAGCTTTCTTT	CASSQEATGARTNTEAFF	TRBV4-2	TRBJ1-1
TGTGCCAGCACATTTTCGGCTGGGAATCAGCCCCAGCATTTT	CASTFSAGNQPQHF	TRBV2	TRBJ1-5
TGCAGTGCTAGAAAGTCATCCGAGGGCTCGGGCCCGTTCAGGAAGTACTTC	CSARKSSEGSGPFRKYF	TRBV20-1	TRBJ2-7
TGCGCCAGCAGTGCACTTCCGGGACAGGGGGGTTCCTATAATTCACCCCTCCACTTT	CASSALPGQGGSYNSPLHF	TRBV10-1	TRBJ1-6
TGTGCCACCAGTGATTTGCACGTCCTAATCTTTCGGAGGTGCGAGCAGTTCTTC	CATSDLHVLIFRRCEQFF	TRBV24-1	TRBJ2-1
TGTGCCAGCTCAAGCGGGACTAGGGCTCAGTATTTT	CASSSGTRAQYF	TRBV6-1	TRBJ2-3
TGTGCCAGCAGCTTTGGGGGCATGGAGCTCTCTGGGGCCAACGTCCTGACTTTC	CASSFGGMELSGANVLTF	TRBV11-3	TRBJ2-6
TGTGCCAGCAGCTTAACGCGGGCCTACGGGTCCTACAATGAGCAGTTCTTC	CASSLTRAYGSYNEQFF	TRBV11-3	TRBJ2-1
TGTGCCAGCAGCCACCCTCAGGTCTACATTCAGCCCCAGCATTTT	CASSHPQVYIQPQHF	TRBV7-2	TRBJ1-5
TGCGCCAGCAGCCCACCGGGGGGCTACGAGCAGTACTTC	CASSPPGGYEQYF	TRBV5-1	TRBJ2-7
TGTGCTAGTGGTTTGGAGCTGAGAGCCGGGGAAAAACTGTTTTTT	CASGLELRAGEKLFF	TRBV12-5	TRBJ1-4
TGTGCCAGCAGCTCCAATTTCAGGGGGCGGAGAAACACCATATATTTT	CASSSNFRGRRNTIYF	TRBV11-2	TRBJ1-3
TGCGCCAGCAGCCAAGATTCCAGGAGCCAAGAGACCCAGTACTTC	CASSQDSRSQETQYF	TRBV4-3	TRBJ2-5
TGTGCCAGCTCACCACTTGCGGGAGGGACATCGCTAGCCAAAAACATTCAGTACTTC	CASSPLAGGTSLAKNIQYF	TRBV18	TRBJ2-4
TGCGCCAGCAGAGGGGACTCAGAGACCCAGTACTTC	CASRGDSETQYF	TRBV10-1	TRBJ2-5
TGTGCCAGCAGTTTAACCGGGACAGGGGCTCGGGCTCAGCCCCAGCATTTT	CASSLTGTGARAQPQHF	TRBV27	TRBJ1-5
TGTGCCAGCAGTGACCACCACGGGACTAGCGGTACGTGGCAAGAGACCCAGTACTTC	CASSDHHGTSGTWQETQYF	TRBV6-1	TRBJ2-5
TGTGCCAGCAGCTTAAAGGGGGCAGGGGAGTCACCCCTCCACTTT	CASSLKGAGESPLHF	TRBV11-2	TRBJ1-6
TGCGCCAGCATGATCCCGGGGGTTCTGAACACCGGGGAGCTGTTTTTT	CASMIPGVLNTGELFF	TRBV5-1	TRBJ2-2
TGCAGTGCTAGGCCCGAGGGAGATACGCAGTATTTT	CSARPEGDTQYF	TRBV20-1	TRBJ2-3
TGTGCCAGCAGTTTTTTCTCCCCGGGACAGGGTGGAAACACCATATATTTT	CASSFFSPGQGGNTIYF	TRBV27	TRBJ1-3
TGTGCCAGCAGTCCCAGCGGACCGCGCACAGATACGCAGTATTTT	CASSPSGPRTDTQYF	TRBV6-4	TRBJ2-3
TGTGCCAGCAGTTACTTTTCTGGGATAACCACAGATACGCAGTATTTT	CASSYFSGITTDTQYF	TRBV6-5	TRBJ2-3
TGCAGTGCTAAGGGACAAGGTAACTATGGCTACACCTTC	CSAKGQGNYGYTF	TRBV20-1	TRBJ1-2
TGCAGTGCTCACCAGGACAACTATGGCTACACCTTC	CSAHQDNYGYTF	TRBV20-1	TRBJ1-2
TGTGCCAGCAACAGACAGTACAATGAGCAGTTCTTC	CASNRQYNEQFF	TRBV6-2	TRBJ2-1
TGTGCCAGCAGTTCTTTACGACAGGTGAATCAGCCCCAGCATTTT	CASSSLRQVNQPQHF	TRBV12-4	TRBJ1-5
TGTGCCAGCAGCCAGGGTCGAACCTATGGCTACACCTTC	CASSQGRTYGYTF	TRBV7-4	TRBJ1-2
TGTGCCAGCAGTTTATGCTCCACTGAAGCTTTCTTT	CASSLCSTEAFF	TRBV28	TRBJ1-1
TGTGCCAGCAGAAAGGGGCTAAATCAGCCCCAGCATTTT	CASRKGLNQPQHF	TRBV6-3	TRBJ1-5
TGTGCCAGCAGGCGGAAGGTTACTTATAACAATGAGCAGTTCTTC	CASRRKVTYNNEQFF	TRBV7-2	TRBJ2-1
TGCGCCAGCAGTGATAGTCGTATAGCCCCGATGACTAGCGGGGGGGGTAAGGAAGAGACCCAGTACTTC	CASSDSRIAPMTSGGGKEETQYF	TRBV10-2	TRBJ2-5
TGTGCCAGCAGCCAAGATAACAGGGGGCCCAACGCAACTAATGAAAAACTGTTTTTT	CASSQDNRGPNATNEKLFF	TRBV14	TRBJ1-4
TGTGCCAGCAGGGGTACTCCGGGGATCTCCGGCGAGCAGTACTTC	CASRGTPGISGEQYF	TRBV6-1	TRBJ2-7
TGTGCCAGCAGAGACCGGGACAGGGTACCGTATGGCTACACCTTC	CASRDRDRVPYGYTF	TRBV2	TRBJ1-2
TGTGCCAGCACCGGGGGGGGGAGCTCCTATAATTCACCCCTCCACTTT	CASTGGGSSYNSPLHF	TRBV27	TRBJ1-6
TGCAGCGTTGAAGATTTACAGGGGGCCTTGCAGTTCTTC	CSVEDLQGALQFF	TRBV29-1	TRBJ2-1
TGTGCCAGCAGCGTACGACTATGGACTAGCGGGGGGGAGCAGTACTTC	CASSVRLWTSGGEQYF	TRBV9	TRBJ2-7
TGCAGTGCAGAAGGTCGGGGTTCCAATTCACCCCTCCACTTT	CSAEGRGSNSPLHF	TRBV20-1	TRBJ1-6
TGTGCCAGCAACCCGGGACAGGGTGCTACTGAAGCTTTCTTT	CASNPGQGATEAFF	TRBV6-1	TRBJ1-1
TGTGCCAGCAGCCAACGGACGGGACTAGAGAGGACAGATACGCAGTATTTT	CASSQRTGLERTDTQYF	TRBV14	TRBJ2-3
TGCAGTGCTCCCTACAGCAGAAAGGGTTGTGAAGCTTTCTTT	CSAPYSRKGCEAFF	TRBV20-1	TRBJ1-1
TGTGCCACCAGTGACTATAAAATCGAGGCCGCGCGCAATGAGCAGTTCTTC	CATSDYKIEAARNEQFF	TRBV24-1	TRBJ2-1
TGTGCAACAAGCAGTTTTTACTGGACGGCCGTAAATGAAAAACTGTTTTTT	CATSSFYWTAVNEKLFF	TRBV6-4	TRBJ1-4
TGTGCCAGCGGGACAGGAGGATTCTACGAGCAGTACTTC	CASGTGGFYEQYF	TRBV28	TRBJ2-7
TGTGCCAGCAGTACCGGGACTAGCGGGAGCCGAGAGACCCAGTACTTC	CASSTGTSGSRETQYF	TRBV25-1	TRBJ2-5
TGTGCCAGCAGTTACTGGGACAGCGGATACAATGAGCAGTTCTTC	CASSYWDSGYNEQFF	TRBV6-5	TRBJ2-1
TGTGCCAGCTTGGCCGGACTAGCGGGCATGGCCTACAATGAGCAGTTCTTC	CASLAGLAGMAYNEQFF	TRBV7-6	TRBJ2-1
TGCGCCAATGGGGGGCCCCCGGGCGAGACCCAGTACTTC	CANGGPPGETQYF	TRBV10-2	TRBJ2-5
TGTGCCAGCAGTTTAACCTTTTTAGCCAAAAACATTCAGTACTTC	CASSLTFLAKNIQYF	TRBV28	TRBJ2-4
TGTGCCACCAGTGTCGCAGGGCCCTACGGGGGATACGAGCAGTACTTC	CATSVAGPYGGYEQYF	TRBV24-1	TRBJ2-7
TGTGCCAGAGGGGCGTATGAAAAACTGTTTTTT	CARGAYEKLFF	TRBV6-1	TRBJ1-4
TGTGCCAGCAGTGACGCCCCGAGTCCGTTAAATGGCTACACCTTC	CASSDAPSPLNGYTF	TRBV6-4	TRBJ1-2
TGTGCCAGCAGCCAAACAAATCAGGGGGCACATTCACCCCTCCACTTT	CASSQTNQGAHSPLHF	TRBV14	TRBJ1-6
TGTGCCAGCAGTTGGCCATGCCCCACCCGGGGGGGCGGACAGATGTTCTACGAGCAGTACTTC	CASSWPCPTRGGGQMFYEQYF	TRBV6-5	TRBJ2-7
TGTGCCAGCAGTTTAGACTTGACTAGCGGGGGGGGCTTC	CASSLDLTSGGGF	TRBV12-3	TRBJ2-7
TGTGCCTTGACATATAGGGACTCCTGGCCCGACGAGCAGTACTTC	CALTYRDSWPDEQYF	TRBV30	TRBJ2-7
TGTGCCAGCAGTGAAGGCAGGACTAGCGGGTTGCAGCAGTACTTC	CASSEGRTSGLQQYF	TRBV6-1	TRBJ2-7
TGTGCCAGCAGCCAAGGACTGTCGCAGCCCCAGCATTTT	CASSQGLSQPQHF	TRBV3-1	TRBJ1-5
TGCAGTGCTAGCCAGACTAGCAGGGCCTACGAGCAGTACTTC	CSASQTSRAYEQYF	TRBV20-1	TRBJ2-7
TGTGCCAGCAGCTTAAGGGGGGGAGCAGATACGCAGTATTTT	CASSLRGGADTQYF	TRBV7-9	TRBJ2-3
TGTGCCAGCAGCTGGGGTTCAGATACGCAGTATTTT	CASSWGSDTQYF	TRBV13	TRBJ2-3
TGTGCCAGCAGCTTACACCCGGGGCGTCCGAGCGAGCAGTACTTC	CASSLHPGRPSEQYF	TRBV7-9	TRBJ2-7
TGTGCCAGCAGTAAACGGGACAGGGGCGCCTACGAGCAGTACTTC	CASSKRDRGAYEQYF	TRBV12-4	TRBJ2-7
TGTGCCAGCAGTTTATGTAGGGGCGTCGGGTCCAACTATGGCTACACCTTC	CASSLCRGVGSNYGYTF	TRBV27	TRBJ1-2
TGTGCCAGGCTTAGACATCGGACTGAAGCTTTCTTT	CARLRHRTEAFF	TRBV27	TRBJ1-1
TGTGCCAGCAGTGATCTCGAGCGGGACAGGGGGAATGAGCAGTTCTTC	CASSDLERDRGNEQFF	TRBV6-1	TRBJ2-1
TGTGCCAGCAGATGTGAGGGGAGATACACTGAAGCTTTCTTT	CASRCEGRYTEAFF	TRBV6-4	TRBJ1-1
TGTGCCAGCAGCTTGATTCGTAGCACAGATACGCAGTATTTT	CASSLIRSTDTQYF	TRBV11-3	TRBJ2-3
TGTGCCAGCAGTGCGACAGGGCCCAAAGAAAAACTGTTTTTT	CASSATGPKEKLFF	TRBV28	TRBJ1-4
TGCGCCAGCAGCTTGCCCGGGTACAGGGGGCTCTTC	CASSLPGYRGLF	TRBV5-1	TRBJ2-1
TGTGCCAGCACTGTAGCAGGGACAGGGGGCGGAGTTACGAGAATTGAGCAGTACTTC	CASTVAGTGGGVTRIEQYF	TRBV2	TRBJ2-7
TGTGCCAGCGGGGGGGACAGCGGGGAGCTGTTTTTT	CASGGDSGELFF	TRBV6-4	TRBJ2-2
TGCAGTGCTCTAGCCGACAGGGGCCATATGAACACTGAAGCTTTCTTT	CSALADRGHMNTEAFF	TRBV20-1	TRBJ1-1
TGCGCCAGCAGCCTTATCCTCACCGGGTATGGCTACACCTTC	CASSLILTGYGYTF	TRBV5-1	TRBJ1-2
TGCGCCAGCAGCACCCGACAGGGTCGTAGCTCCTATAATTCACCCCTCCACTTT	CASSTRQGRSSYNSPLHF	TRBV5-1	TRBJ1-6
TGTGCCACCAGTGCGGAATCTAGACTAAGTATAGCCTCCTACGAGCAGTACTTC	CATSAESRLSIASYEQYF	TRBV24-1	TRBJ2-7
TGCAGTGCTAGGGCACGGGACAGGGGTTCAAACGAGCAGTACTTC	CSARARDRGSNEQYF	TRBV20-1	TRBJ2-7
TGCGCCAGCAGCATTGCGGCGGCTCAGACCACTGGCTACACCTTC	CASSIAAAQTTGYTF	TRBV5-1	TRBJ1-2
TGTGCCACGAAGGGGGCCAACACTGAAGCTTTCTTT	CATKGANTEAFF	TRBV6-1	TRBJ1-1
TGCAGTGCCGAGACTAGCGGTCAGCAGGGGAATGAGCAGTTCTTC	CSAETSGQQGNEQFF	TRBV20-1	TRBJ2-1
TGTGCCAGTAGTAGGGCGGACGCCGAGCAGTACTTC	CASSRADAEQYF	TRBV19	TRBJ2-7
TGCAGTGCTAGCGAGCGGATACCGGGACGCTCATACGAGCAGTACTTC	CSASERIPGRSYEQYF	TRBV20-1	TRBJ2-7
TGTGCCAGCAGCGGTGGGACAGGGCGTTCCACAGATACGCAGTATTTT	CASSGGTGRSTDTQYF	TRBV13	TRBJ2-3
TGTGCCAGCAGCTTAGGGGGAGGGAAGACAGATACGCAGTATTTT	CASSLGGGKTDTQYF	TRBV7-9	TRBJ2-3
TGCGCCAGCAGCTTGGTACCGGACAGGTTGAGTAACCATCAGCCCCAGCATTTT	CASSLVPDRLSNHQPQHF	TRBV5-1	TRBJ1-5
TGTGCCATCGTGGGACAGGGGCAGTACCAAGAGACCCAGTACTTC	CAIVGQGQYQETQYF	TRBV10-3	TRBJ2-5
TGTGCCAGCAGCCTCATGAAGGGACTACCAGATACGCAGTATTTT	CASSLMKGLPDTQYF	TRBV7-2	TRBJ2-3
TGTGCCTGGGACAGGGCAACTAATGAAAAACTGTTTTTT	CAWDRATNEKLFF	TRBV30	TRBJ1-4
TGTGCCAGCACACTAGAAGGAAGAAGGATTGCAGATACGCAGTATTTT	CASTLEGRRIADTQYF	TRBV6-3	TRBJ2-3
TGTGCCATCCCAGGACAGGGTACCTACGAGCAGTACTTC	CAIPGQGTYEQYF	TRBV14	TRBJ2-7
TGTGCCAGCAGATACAGGGGTACCTACGAGCAGTACTTC	CASRYRGTYEQYF	TRBV11-2	TRBJ2-7
TGTGCCAGCAGTTTTTTCAGGGGCCACTCCTACAATGAGCAGTTCTTC	CASSFFRGHSYNEQFF	TRBV27	TRBJ2-1
TGTGCCAGCAGCTTTTCGAGGGAAATTAACACCGGGGAGCTGTTTTTT	CASSFSREINTGELFF	TRBV5-6	TRBJ2-2
TGTGCCAGCAGTTACAAAGGGGGGTATGGAGTGGAAGCTTTCTTT	CASSYKGGYGVEAFF	TRBV6-5	TRBJ1-1
TGTGCCAGCAGCTACCCCAGTTGGGGGGGCGGGGAGCTGTTTTTT	CASSYPSWGGGELFF	TRBV11-3	TRBJ2-2
TGTGCCAGCAGCCAAGAGGAGTACTCCTACGAGCAGTACTTC	CASSQEEYSYEQYF	TRBV3-1	TRBJ2-7
TGTGCCAGCAGCAACAGGGGTCGAGGGGAGCTGTTTTTT	CASSNRGRGELFF	TRBV7-3	TRBJ2-2
TGTGCCAGCAGCTTCAGGACAGGTGAAAAACTGTTTTTT	CASSFRTGEKLFF	TRBV13	TRBJ1-4
TGTGCCAGTAGTATCCCAAACCAGGCCCCCTCCTACGAGCAGTACTTC	CASSIPNQAPSYEQYF	TRBV19	TRBJ2-7
TGCAGTGCATGGACAGGGTGCGACACTGAAGCTTTCTTT	CSAWTGCDTEAFF	TRBV20-1	TRBJ1-1
TGTGCCAGCAGTTACTGGAAGGACCCCCGGCCCAACTCTGGAAACACCATATATTTT	CASSYWKDPRPNSGNTIYF	TRBV6-5	TRBJ1-3
TGTGCCACCAGTGATTGGCGGACAGGGAACACTGAAGCTTTCTTT	CATSDWRTGNTEAFF	TRBV24-1	TRBJ1-1
TGTGCCAGCAGGGGTAGGAGTAACACCGGGGAGCTGTTTTTT	CASRGRSNTGELFF	TRBV6-5	TRBJ2-2
TGTGGTCATAGAACATCCCCGACCGAAGCTTTCTTT	CGHRTSPTEAFF	TRBV6-2	TRBJ1-1
TGTGCCAGCAGCGTCGGATGGGGGCGCCCATGTTGGACCTACGAGCAGTACTTC	CASSVGWGRPCWTYEQYF	TRBV7-3	TRBJ2-7
TGTGCCAGCAGCCAAGACTGGGGGACGCTAAAACTGTTTTTT	CASSQDWGTLKLFF	TRBV3-1	TRBJ1-4
TGTGCCAGCAGTCAGATAAGCTCCTACGAGCAGTACTTC	CASSQISSYEQYF	TRBV3-1	TRBJ2-7
TGCAGCGTCGGGAGGGGCGGTGGCTACACCTTC	CSVGRGGGYTF	TRBV29-1	TRBJ1-2
TGTGCCAGCAGCTTAGTGCGGGAGCTCAATGAGCAGTTCTTC	CASSLVRELNEQFF	TRBV7-3	TRBJ2-1
TGTGCCAGCAGCCTCGCGGGAGTATACGAGCAGTACTTC	CASSLAGVYEQYF	TRBV7-9	TRBJ2-7
TGTGCCAGCAGTCCAAGGACAGGGAGTGCCGACTCGCGCAATCAGCCCCAGCATTTT	CASSPRTGSADSRNQPQHF	TRBV6-4	TRBJ1-5
TGTGCCAGCTCGGACAGGGTTATTTATAGCAATCAGCCCCAGCATTTT	CASSDRVIYSNQPQHF	TRBV18	TRBJ1-5
TGCAGTGCTAGAATGTCCGACAGGGACCTCGAGCAGTTCTTC	CSARMSDRDLEQFF	TRBV20-1	TRBJ2-1
TGTGCCAGCAGCACGCCTAGCGTACTGTCCTACAATGAGCAGTTCTTC	CASSTPSVLSYNEQFF	TRBV7-6	TRBJ2-1
TGTGCCAGCAGCCCCCGGGGTGGGAATGAGCAGTTCTTC	CASSPRGGNEQFF	TRBV5-4	TRBJ2-1
TGCGCCAAGGGCTACACCTTC	CAKGYTF	TRBV5-1	TRBJ1-2
TGCAGTGGGGTGAGGGGAGGGGGCTCCTACAATGAGCAGTTCTTC	CSGVRGGGSYNEQFF	TRBV20-1	TRBJ2-1
TGTGCCAGCAGCCTTGGACTACCGACCGATACGCAGTATTTT	CASSLGLPTDTQYF	TRBV13	TRBJ2-3
TGTGCCAGCAGTACTGGGCGAGATACGCAGTATTTT	CASSTGRDTQYF	TRBV12-4	TRBJ2-3
TGTGCCAGCCCAAAGGGGGGCGGGGTTGACTATGGCTACACCTTC	CASPKGGGVDYGYTF	TRBV7-4	TRBJ1-2
TGTGCCAGCAGTCCCGGGACTAGAGGGGCCGGGGAGCTGTTTTTT	CASSPGTRGAGELFF	TRBV27	TRBJ2-2
TGCGCCAGCAGCCACAGCCGCAGATCTAGGGAGTCTGGGGCCAACGTCCTGACTTTC	CASSHSRRSRESGANVLTF	TRBV4-1	TRBJ2-6
TGTGCCTGGAGTTCTCTGCGCGACAGGGGCCTTATCGATAGCAATCAGCCCCAGCATTTT	CAWSSLRDRGLIDSNQPQHF	TRBV30	TRBJ1-5
TGTGCCAGCAGTGACTCCCCGTTACAGGGACAGGGTCATGAGCAGTTCTTC	CASSDSPLQGQGHEQFF	TRBV6-4	TRBJ2-1
TGTGCCAGCACTTGGACAGGGACCGGGGCTTCACCCCTCCACTTT	CASTWTGTGASPLHF	TRBV11-3	TRBJ1-6
TGCGCCAACCCGACGGTGTCCCGGTGTAATGGAAACACCATATATTTT	CANPTVSRCNGNTIYF	TRBV5-1	TRBJ1-3
TGCAGTGCTAGAGGGCCGGGGGCGGACTACGAGCAGTACTTC	CSARGPGADYEQYF	TRBV20-1	TRBJ2-7
TGTGCCAGTGAACCCATTCCCGCTAGCGCGGTAGACACAGATACGCAGTATTTT	CASEPIPASAVDTDTQYF	TRBV11-2	TRBJ2-3
TGCAGTGCAGGGGCATGTAGCACAGATACGCAGTATTTT	CSAGACSTDTQYF	TRBV20-1	TRBJ2-3
TGCAGCGTGGTTCTAAGGGGGCTTAACGAGCAGTACTTC	CSVVLRGLNEQYF	TRBV29-1	TRBJ2-7
TGTGCCTGGAGTGGGTGGGGGGGTGAGCAGTTCTTC	CAWSGWGGEQFF	TRBV30	TRBJ2-1
TGTGCCAGCAGCTCGCCCACTAGGCCTCAAGAGACCCAGTACTTC	CASSSPTRPQETQYF	TRBV7-9	TRBJ2-5
TGTGCCAGCAGCGTAGTGACAGGGGAGAGGTACCAAGAGACCCAGTACTTC	CASSVVTGERYQETQYF	TRBV9	TRBJ2-5
TGTGCCACCACACATGCCGGGACCGAGCAGTACTTC	CATTHAGTEQYF	TRBV24-1	TRBJ2-7
TGTGCCAGCAGTGAAGGAATCGGTACAGAGACCCAGTACTTC	CASSEGIGTETQYF	TRBV25-1	TRBJ2-5
TGTGCCAGCAGTTCTGACAGGCTCACCTACAATGAGCAGTTCTTC	CASSSDRLTYNEQFF	TRBV12-4	TRBJ2-1
TGTGCCAGCAGTAGGGGGGGGCGCACAGATACGCAGTATTTT	CASSRGGRTDTQYF	TRBV6-4	TRBJ2-3
TGTGCCAGCAGCCAAGCAGGCTACGGTTCCTACAATGAGCAGTTCTTC	CASSQAGYGSYNEQFF	TRBV3-1	TRBJ2-1
TGCGCCAGCAGAGGGGACAAGGATCGGGTCACCAATGAGCAGTTCTTC	CASRGDKDRVTNEQFF	TRBV4-1	TRBJ2-1
TGTGCCAGTAGTCCCATGGGCCACAACAGTGAAGTACCAGAGGACACTGAAGCTTTCTTT	CASSPMGHNSEVPEDTEAFF	TRBV19	TRBJ1-1
TGCGCCAGCAGCTTGTCGATACAAAACCCCGGTTACAATGAGCAGTTCTTC	CASSLSIQNPGYNEQFF	TRBV5-1	TRBJ2-1
TGTGCCACCAGTGAGCCTTGTCCGGGACTAGCGGGACTTTCCTATAATTCACCCCTCCACTTT	CATSEPCPGLAGLSYNSPLHF	TRBV24-1	TRBJ1-6
TGCAGTGCTAGCCGGGGACTAGCGGGCTATGGCGAGCAGTACTTC	CSASRGLAGYGEQYF	TRBV20-1	TRBJ2-7
TGTGGTCCAGAGGGAAGGTATGGCTACACCTTC	CGPEGRYGYTF	TRBV7-3	TRBJ1-2
TGTGCCATCAGGCTACTAGCGGGAGCGGACGTGGACTACGAGCAGTACTTC	CAIRLLAGADVDYEQYF	TRBV10-3	TRBJ2-7
TGTGCCATGTACCAGGTCCAGGGCAATCAGCCCCAGCATTTT	CAMYQVQGNQPQHF	TRBV10-3	TRBJ1-5
TGCGCCAGCAGCGACCCACGTGGCCCTAACTATGGCTACACCTTC	CASSDPRGPNYGYTF	TRBV5-1	TRBJ1-2
TGTGCCAGCAGTGTAAGCGGGACAAACCCGAGCGGGAACACTGAAGCTTTCTTT	CASSVSGTNPSGNTEAFF	TRBV6-1	TRBJ1-1
TGTGCCAGCAGCTTGACAGCGGACGAGCAGTACTTC	CASSLTADEQYF	TRBV13	TRBJ2-7
TGTGCCAGCACTCAAGTCGGGGAGGTGAACACTGAAGCTTTCTTT	CASTQVGEVNTEAFF	TRBV6-6	TRBJ1-1
TGTGCCAGCAGTACGGGACAGGGTGCTGAGCAGTTCTTC	CASSTGQGAEQFF	TRBV28	TRBJ2-1
TGTGCCATTGCGGGGGCACCGAACACTGAAGCTTTCTTT	CAIAGAPNTEAFF	TRBV10-3	TRBJ1-1
TGTCCCTATAGGCCCCAGGAGACCCAGTACTTC	CPYRPQETQYF	TRBV19	TRBJ2-5
TGTGCCAGCACCTTCCTAGGCGTTCAGCCCCAGCATTTT	CASTFLGVQPQHF	TRBV12-4	TRBJ1-5
TGTGCCAGCAGTGCAGCCGTGGGGCTCACCGGGGAGCTGTTTTTT	CASSAAVGLTGELFF	TRBV25-1	TRBJ2-2
TGTGCCAGCTCACCACCCCAGGGGAATAATAGCAATCAGCCCCAGCATTTT	CASSPPQGNNSNQPQHF	TRBV18	TRBJ1-5
TGTGCCAGCTCACCAATGCGGACAGGCAACTACGAGCAGTACTTC	CASSPMRTGNYEQYF	TRBV18	TRBJ2-7
TGCGCCAGCAGCCAAAAACCCTTGTCTGACCGATGCCTCTTCGTAGCCAAAAACATTCAGTACTTC	CASSQKPLSDRCLFVAKNIQYF	TRBV4-1	TRBJ2-4
TGTGCCAGCAGCCGGTCCCCCCCACTAGCGCCAGATACGCAGTATTTT	CASSRSPPLAPDTQYF	TRBV6-4	TRBJ2-3
TGTGCCAGCAGTGCTGACGCGACAGGGAGGGAAAACACTGAAGCTTTCTTT	CASSADATGRENTEAFF	TRBV6-1	TRBJ1-1
TGTGCCAGCAGCTTATCCAGGGAGGCCAATGAGCAGTTCTTC	CASSLSREANEQFF	TRBV7-8	TRBJ2-1
TGTGCCAGCAGAAACAGGCCCGACAATGAGCAGTTCTTC	CASRNRPDNEQFF	TRBV27	TRBJ2-1
TGTGCCAGCAGTGACCGCGGGGGGCGGGATGAGCAGTTCTTC	CASSDRGGRDEQFF	TRBV6-1	TRBJ2-1
TGTGCCAGCAGCCCCAAGGTCTATAGCAATCAGCCCCAGCATTTT	CASSPKVYSNQPQHF	TRBV7-6	TRBJ1-5
TGTGCCAGCAGCTCGGGATTGACTAGCGGCACCAATGAGCAGTTCTTC	CASSSGLTSGTNEQFF	TRBV7-2	TRBJ2-1
TGTGCCAGCGGGGGCCCCATGAGCTCTGGAAACACCATATATTTT	CASGGPMSSGNTIYF	TRBV6-2	TRBJ1-3
TGTGCCAGCAGCGATTGGGGGCCTGGGGGCTACACCTTC	CASSDWGPGGYTF	TRBV9	TRBJ1-2
TGTGCCACCCCCAGGGGTCCGCACGATTTTAATCAGCCCCAGCATTTT	CATPRGPHDFNQPQHF	TRBV13	TRBJ1-5
TGTGCCAGACGAGGGGTTGGCGAGCAGTACTTC	CARRGVGEQYF	TRBV7-4	TRBJ2-7
TGCAGTTCCACCCAACTAGGTCTATTATCCGAAGCTTTCTTT	CSSTQLGLLSEAFF	TRBV20-1	TRBJ1-1
TGTGCCAGCAGCCAAGGAGAGGGAGATCAGACCCAGTACTTC	CASSQGEGDQTQYF	TRBV3-1	TRBJ2-5
TGCAGCGTATCAGGGGGTCACACCATATATTTT	CSVSGGHTIYF	TRBV29-1	TRBJ1-3
TGTGCCAGCAGTACTTCGGAGATGTCGAACACTGAAGCTTTCTTT	CASSTSEMSNTEAFF	TRBV27	TRBJ1-1
TGTGCCAGTAGTATCCCCGCGGGCATGTCGGCTAGCACAGATACGCAGTATTTT	CASSIPAGMSASTDTQYF	TRBV19	TRBJ2-3
TGTGCCTGGAGTGTAATCGAGGGAAAAGGGAGCACAGATACGCAGTATTTT	CAWSVIEGKGSTDTQYF	TRBV30	TRBJ2-3
TGCAGCGTTCGGTTACAGGGGACTCTCCAAGAGACCCAGTACTTC	CSVRLQGTLQETQYF	TRBV29-1	TRBJ2-5
TGTGCCACACACAGGGGGAACACTGAAGCTTTCTTT	CATHRGNTEAFF	TRBV10-3	TRBJ1-1
TGCGCCAGCCATCTAGGAGACAGAGACGACCAAGAGACCCAGTACTTC	CASHLGDRDDQETQYF	TRBV10-1	TRBJ2-5
TGTGCCAGCAGCTTATACAAGGGGAGTCAGAACACTGAAGCTTTCTTT	CASSLYKGSQNTEAFF	TRBV7-9	TRBJ1-1
TGTGCCAGCAGTTACACTCTACCCAGCGGGACTTCAGATACGCAGTATTTT	CASSYTLPSGTSDTQYF	TRBV6-5	TRBJ2-3
TGTGCCAGTAGTCAGATGGGGGGGCTGGATCACCCCTCCTACAATGAGCAGTTCTTC	CASSQMGGLDHPSYNEQFF	TRBV19	TRBJ2-1
TGTGCCAGCAGTTACGGAGGAGGCGGGAGGGTCGAAGCTTTCTTT	CASSYGGGGRVEAFF	TRBV6-5	TRBJ1-1
TGCGCCAGCAGTCGAAGGGCGGATGGCGCAACTAATGAAAAACTGTTTTTT	CASSRRADGATNEKLFF	TRBV10-1	TRBJ1-4
TGTGCCAGCAGCTTATGTATGACTAGCGGGAGGGCAGATACGCAGTATTTT	CASSLCMTSGRADTQYF	TRBV11-1	TRBJ2-3
TGTGCTAGTGGTTTGCCCTTCAAGAACACTGAAGCTTTCTTT	CASGLPFKNTEAFF	TRBV12-5	TRBJ1-1
TGCGCCAGCAGCTCCGGGACACATTTTAGTTTCCGGAGCACCGGGGAGCTGTTTTTT	CASSSGTHFSFRSTGELFF	TRBV5-1	TRBJ2-2
TGCGCCAGCAGCTTGGGGTGTGACCGGGACACCGGCAATGAGCAGTTCTTC	CASSLGCDRDTGNEQFF	TRBV5-1	TRBJ2-1
TGTGCCTACAGGGGCCCCTACGAGCAGTACTTC	CAYRGPYEQYF	TRBV30	TRBJ2-7
TGTGCCAGCAGTTCCGCGGGGCTCCAAGAGACCCAGTACTTC	CASSSAGLQETQYF	TRBV27	TRBJ2-5
TGCGCCAGCAGCCAAGAAACTAGCGGGAGTGAAGCTTTCTTT	CASSQETSGSEAFF	TRBV4-1	TRBJ1-1
TGTGCCAGTAGTTTCAGTATCAATTCGGAGGGGGGAGGGACTAGCACAGATACGCAGTATTTT	CASSFSINSEGGGTSTDTQYF	TRBV19	TRBJ2-3
TGTGCCACCAGACCGCTGCCAGGGAACACCATATATTTT	CATRPLPGNTIYF	TRBV24-1	TRBJ1-3
TGTGCCAGCAGCTTAGCGCTAACTCGATGGGACTTGCCAGATACGCAGTATTTT	CASSLALTRWDLPDTQYF	TRBV7-9	TRBJ2-3
TGTGCCAGCAGTTACGGTGGGACAGGGAATAGAACGGAGACCCAGTACTTC	CASSYGGTGNRTETQYF	TRBV6-5	TRBJ2-5
TGTGCCAGCAGTGACTGCGGGAAAGCCAAAAACATTCAGTACTTC	CASSDCGKAKNIQYF	TRBV6-4	TRBJ2-4
TGTGCCAGCAGCGGGTCAGGGAACCCCCTAACAAGCTCCTACGAGCAGTACTTC	CASSGSGNPLTSSYEQYF	TRBV7-3	TRBJ2-7
TGTGCCAGCAGAACCCCGGGGACTAATGAAAAACTGTTTTTT	CASRTPGTNEKLFF	TRBV2	TRBJ1-4
TGTGCCAGCAGCCAAGACAGGGAGAGCAGAGGCTCCTACAATGAGCAGTTCTTC	CASSQDRESRGSYNEQFF	TRBV14	TRBJ2-1
TGTCCTCTAGCGTTGCCCTACAATGAGCAGTTCTTC	CPLALPYNEQFF	TRBV30	TRBJ2-1
TGTGCCAGCAGCTTACCATTAACTCGGCTCGAGCAGTACTTC	CASSLPLTRLEQYF	TRBV11-2	TRBJ2-7
TGTGCCACCAGCCGGGGGGCTGAAGCTTTCTTT	CATSRGAEAFF	TRBV24-1	TRBJ1-1
TGTGCCAGCAGCGTGCGACGGGACAGACCGGAAACGCCCCAGCATTTT	CASSVRRDRPETPQHF	TRBV7-9	TRBJ1-5
TGTGCCAGCAGCTTCCACACAACTAATGAAAAACTGTTTTTT	CASSFHTTNEKLFF	TRBV13	TRBJ1-4
TGTGCCAGCAGCCAAGATAGGAGGGACAGGGTGAAAAGGGACGAAAGCTCCTACGAGCAGTACTTC	CASSQDRRDRVKRDESSYEQYF	TRBV4-2	TRBJ2-7
TGTGCCTTGGCTCCGGCCTCCTACGAGCAGTACTTC	CALAPASYEQYF	TRBV7-9	TRBJ2-7
TGTGCCAGCAGTTACTCGGCAGGGACAGGGGGGGGGAATAGCAATCAGCCCCAGCATTTT	CASSYSAGTGGGNSNQPQHF	TRBV6-5	TRBJ1-5
TGTGCCCCCGTAGGTACAGGAAATTACGAGCAGTACTTC	CAPVGTGNYEQYF	TRBV24-1	TRBJ2-7
TGCGCCAGCAGCCCGAGTATATTCCGGGCTGGCGAGCAGTACTTC	CASSPSIFRAGEQYF	TRBV4-1	TRBJ2-7
TGCAGCGTTGTTAAAAGGGACCAGTACGAGCAGTACTTC	CSVVKRDQYEQYF	TRBV29-1	TRBJ2-7
TGTGCCAGCAAAAGGGGGGTCGGGACCGGGGAGCTGTTTTTT	CASKRGVGTGELFF	TRBV27	TRBJ2-2
TGTGCCAGCAGCTGGGTTAGGAGGGACAGGGAAAGGGGCTCCTACGAGCAGTACTTC	CASSWVRRDRERGSYEQYF	TRBV7-3	TRBJ2-7
TGTGCCAGCAGCTTTCCTAACGGGACTAGCGGGGCGGAGGAGACCCAGTACTTC	CASSFPNGTSGAEETQYF	TRBV5-6	TRBJ2-5
TGTGCCAGCAGTTTTCATCGGCCGGGCGAGCAGTACTTC	CASSFHRPGEQYF	TRBV12-3	TRBJ2-7
TGTGCCAGCACTTACCTGACAGCTAACTATGGCTACACCTTC	CASTYLTANYGYTF	TRBV6-4	TRBJ1-2
TGTGCCAGCAGCCAAGCCCCAATAGCGGGCCGACTAGAGATCTGCACAGATACGCAGTATTTT	CASSQAPIAGRLEICTDTQYF	TRBV3-1	TRBJ2-3
TGTGCCAGCAGCCCTATGGGACAGGGTTCCTATGGCTACACCTTC	CASSPMGQGSYGYTF	TRBV5-6	TRBJ1-2
TGCAGCCTTACAGGGTGTCGGACAGATACGCAGTATTTT	CSLTGCRTDTQYF	TRBV29-1	TRBJ2-3
TGTGCCAGCAGCCCCCCCCAGGGTCACGCCAAAAACATTCAGTACTTC	CASSPPQGHAKNIQYF	TRBV7-6	TRBJ2-4
TGTGCCAGCAGCCTCCGACATGGGCAGTTCTTC	CASSLRHGQFF	TRBV3-1	TRBJ2-1
TGTGCCAGGGACAATAATAAAGGGGCCAACGTCCTGACTTTC	CARDNNKGANVLTF	TRBV7-3	TRBJ2-6
TGTGCCAGCAGTGAAAATGGGACAGGGGGCTACACCTTC	CASSENGTGGYTF	TRBV6-1	TRBJ1-2
TGCGCCAGCAGTTTTGCGTCCCAGCGGGAGTTAGATGAGCAGTTCTTC	CASSFASQRELDEQFF	TRBV10-1	TRBJ2-1
TGTGCCAGCAGCCCCGGGTCGGGCTTCACAGATACGCAGTATTTT	CASSPGSGFTDTQYF	TRBV11-2	TRBJ2-3
TGTGCCAGCAGTTACTGGACTAGAGAACCCTCCTACGAGCAGTACTTC	CASSYWTREPSYEQYF	TRBV6-3	TRBJ2-7
TGCAGCGTTGGGAAAGAAGGTACTAATCAGCCCCAGCATTTT	CSVGKEGTNQPQHF	TRBV29-1	TRBJ1-5
TGTGCCAGCACGGAGACAGTAAACTATGGCTACACCTTC	CASTETVNYGYTF	TRBV27	TRBJ1-2
TGTGCCAGCAGCCCGGTAGGAGGTGAAGCTTTCTTT	CASSPVGGEAFF	TRBV13	TRBJ1-1
TGTGCCAGCAGTCCGCGTGGCGGAGGGAGCGTCGTCTACGAGCAGTACTTC	CASSPRGGGSVVYEQYF	TRBV27	TRBJ2-7
TGTGCCAGTGCGCGATCGGGACCCATAATCGAGAATTTCTCCTACGAGCAGTACTTC	CASARSGPIIENFSYEQYF	TRBV19	TRBJ2-7
TGTGCCAGCAGTTTATTTAGGACAGGGGGGGTTCCCAACTATGGCTACACCTTC	CASSLFRTGGVPNYGYTF	TRBV27	TRBJ1-2
TGTGCCAGCAGCCAAGGACAGTCGAACACCGGGGAGCTGTTTTTT	CASSQGQSNTGELFF	TRBV4-2	TRBJ2-2
TGCGCCAGCGGCTCCAGGGGCCGCGTGCAGCCCCAGCATTTT	CASGSRGRVQPQHF	TRBV4-3	TRBJ1-5
TGTGCCAGCAGCTCGGACAGGGGGCAATCGCCGTACAATGAGCAGTTCTTC	CASSSDRGQSPYNEQFF	TRBV7-6	TRBJ2-1
TGTGCCAGCAGCTTGCTACAGGGGGCGACGAGCAATCAGCCCCAGCATTTT	CASSLLQGATSNQPQHF	TRBV7-8	TRBJ1-5
TGCGCCAGCAGCCAAAGACACCCAAACACAGATACGCAGTATTTT	CASSQRHPNTDTQYF	TRBV4-3	TRBJ2-3
TGTGCCACCAGACATGTTATCGCGGGAGCGGCCTACGAGCAGTACTTC	CATRHVIAGAAYEQYF	TRBV24-1	TRBJ2-7
TGTGCCAGCAGAAATAAGGGGAGGGAACGACAAGATACGCAGTATTTT	CASRNKGRERQDTQYF	TRBV9	TRBJ2-3
TGTGCCAGCAAGGGGGGACTCGGAAACACCATATATTTT	CASKGGLGNTIYF	TRBV11-3	TRBJ1-3
TGCGCTCCCGGACAGGGAGAGACCCAGTACTTC	CAPGQGETQYF	TRBV5-1	TRBJ2-5
TGTGCCAGCAGTTTTGGGACTAGCGGGGGGGGTGAGCAGTTCTTC	CASSFGTSGGGEQFF	TRBV27	TRBJ2-1
TGTGCCAGCGAACCCGGACAGGGCCCCATCGGTTACAATGAGCAGTTCTTC	CASEPGQGPIGYNEQFF	TRBV9	TRBJ2-1
TGCGCCAGCAGTGCGCGGAGTGTACAGGCTGTTCTCACTGAAGCTTTCTTT	CASSARSVQAVLTEAFF	TRBV10-1	TRBJ1-1
TGCGCCAGCAGCCAACCCATTATAAACAGATACACTTATCAGCCCCAGCATTTT	CASSQPIINRYTYQPQHF	TRBV4-1	TRBJ1-5
TGTGCCGGGGGCCAACCCTTAAGAGATACGCAGTATTTT	CAGGQPLRDTQYF	TRBV6-5	TRBJ2-3
TGTGCCAGCAGCTTAGATGAACGGGCCGGGGGCTACGAGCAGTACTTC	CASSLDERAGGYEQYF	TRBV7-9	TRBJ2-7
TGTGCCAGCAGCTTAGCAGGTCCGGCCCAAGAGACCCAGTACTTC	CASSLAGPAQETQYF	TRBV7-4	TRBJ2-5
TGTGCCACCAGTGACCTCCGGGACAGGGGGGCTGAGCAGTTCTTC	CATSDLRDRGAEQFF	TRBV24-1	TRBJ2-1
TGCGCCAGCACCCGGACTAGCGGGGGAAACACAGATACGCAGTATTTT	CASTRTSGGNTDTQYF	TRBV10-1	TRBJ2-3
TGCGCCAGCAGCGAGGACAGATATAGCAATCAGCCCCAGCATTTT	CASSEDRYSNQPQHF	TRBV5-1	TRBJ1-5
TGTGCCAGCAGCGATAGGACAGGGCTCTCGGATGGCTACACCTTC	CASSDRTGLSDGYTF	TRBV9	TRBJ1-2
TGCGCCAGCAAAAGGGGGGAGGCAACTAATGAAAAACTGTTTTTT	CASKRGEATNEKLFF	TRBV10-1	TRBJ1-4
TGTGCCAGCAGCTGGGGGAGAAGCAATCAGCCCCAGCATTTT	CASSWGRSNQPQHF	TRBV9	TRBJ1-5
TGCGCCAGCAGCCAGGCTAGCGGGGATATCTCCTACAATGAGCAGTTCTTC	CASSQASGDISYNEQFF	TRBV4-3	TRBJ2-1
TGTGCCAGCAGCTTAGTTAATGCCGGGACTGGAATTCAGCCCCAGCATTTT	CASSLVNAGTGIQPQHF	TRBV7-9	TRBJ1-5
TGTGCCACCAGTGGCCGGACTAGCGGGGGCTCCTACAATGAGCAGTTCTTC	CATSGRTSGGSYNEQFF	TRBV24-1	TRBJ2-1
TGTGCCAGCAAGACAGGGAAATCTCGCCTTAACACCGGGGAGCTGTTTTTT	CASKTGKSRLNTGELFF	TRBV7-3	TRBJ2-2
TGCGCCAGACGACTAGACGAGCAGTACTTC	CARRLDEQYF	TRBV10-1	TRBJ2-7
TGTGCCACCAGTGGGGGCCCGCTAGAGGGGCCCTCCTACAATGAGCAGTTCTTC	CATSGGPLEGPSYNEQFF	TRBV24-1	TRBJ2-1
TGTGCCAGCAGCCGCGACGGTTGGGGGACTAGCGAAAATAGTACCGGGGAGCTGTTTTTT	CASSRDGWGTSENSTGELFF	TRBV7-3	TRBJ2-2
TGTGCCAGCCCTAGGCGGCCCGGGCCCGCCGGGGAGCTGTTTTTT	CASPRRPGPAGELFF	TRBV2	TRBJ2-2
TGTGCCAGCAGTTTTTGGCTAGGAAGCACAGATACGCAGTATTTT	CASSFWLGSTDTQYF	TRBV28	TRBJ2-3
TGTGCCTGGAGTTACGGGACTAGGGATCAGCCCCAGCATTTT	CAWSYGTRDQPQHF	TRBV30	TRBJ1-5
TGTGCCACCCGACGAGAAGCGGGAGTCCAGCCCCAGCATTTT	CATRREAGVQPQHF	TRBV27	TRBJ1-5
TGTGCCAGCAGCTTGTCAGCACAGGGAAGGGGGGGTAATGAAAAACTGTTTTTT	CASSLSAQGRGGNEKLFF	TRBV7-9	TRBJ1-4
TGTGCCAGCACGACCGGATGGGTCTACAATGAGCAGTTCTTC	CASTTGWVYNEQFF	TRBV7-9	TRBJ2-1
TGTGCCAGCAGCGGGAAATACGGGGAGCTGTTTTTT	CASSGKYGELFF	TRBV7-3	TRBJ2-2
TGTGCCAGCCCTGGGGGCTTGGGCTCTGGAAACACCATATATTTT	CASPGGLGSGNTIYF	TRBV6-1	TRBJ1-3
TGTGCCAGCTCACCCCCCCCGTTCCGAGGCATCCGAAGGGAGCAGTACTTC	CASSPPPFRGIRREQYF	TRBV18	TRBJ2-7
TGTGCCAGACCCCCACTAGGCTACGAGCAGTACTTC	CARPPLGYEQYF	TRBV28	TRBJ2-7
TGTGCCAGCAGTAAAAGAGGGTACGAGCAGTACTTC	CASSKRGYEQYF	TRBV6-1	TRBJ2-7
TGTGCCAGGCGGAGAGCCGGGAATGAGCAGTTCTTC	CARRRAGNEQFF	TRBV7-9	TRBJ2-1
TGTGCCAGCAGTTACTGGGGGGGATACGAGCAGTACTTC	CASSYWGGYEQYF	TRBV6-8	TRBJ2-7
TGTGCCAGCAGTGAACGTCCAGGGAGTTCCTATAATTCACCCCTCCACTTT	CASSERPGSSYNSPLHF	TRBV2	TRBJ1-6
TGTGCCAGCAGCCAAGATGCGGGGACAGGCCTACTTTGCACAGATACGCAGTATTTT	CASSQDAGTGLLCTDTQYF	TRBV4-2	TRBJ2-3
TGTGCCAGCAGCCACTCGGGGGCCCCCGAGCAGTACTTC	CASSHSGAPEQYF	TRBV13	TRBJ2-7
TGTGCCAGCAGCGCGCAGGGGGGAACGGTTTATCACGGCTACACCTTC	CASSAQGGTVYHGYTF	TRBV5-4	TRBJ1-2
TGTGCCAGTAGCAGGGAAGAGAACATTCAGTACTTC	CASSREENIQYF	TRBV19	TRBJ2-4
TGCGCCAGCAGCTTGGGGACAGGGGATCTATTTGGCTACACCTTC	CASSLGTGDLFGYTF	TRBV5-1	TRBJ1-2
TGTGCCAGCAGCGCCATTGCACCGCCCCCGGGACAGAAGAGCTCCTACGAGCAGTACTTC	CASSAIAPPPGQKSSYEQYF	TRBV13	TRBJ2-7
TGTGCCAGCAGTTTACCCGGACAGAAGATTATAAGGGGTGAAGCTTTCTTT	CASSLPGQKIIRGEAFF	TRBV6-9	TRBJ1-1
TGTGCCAGCCCCCATCCGGGACAGGGCTATAATTCACCCCTCCACTTT	CASPHPGQGYNSPLHF	TRBV19	TRBJ1-6
TGTGCCAGCAGCTGGGGGGGTATTACTAACTATGGCTACACCTTC	CASSWGGITNYGYTF	TRBV5-6	TRBJ1-2
TGTGCCAGTAGTGGAAGGACGGTGGAGGAAAAACTGTTTTTT	CASSGRTVEEKLFF	TRBV19	TRBJ1-4
TGTGCCTGGGGGGACGGGGGCTACACCTTC	CAWGDGGYTF	TRBV30	TRBJ1-2
TGTGCCAGCAGGGTTCTAACGATGTGTCTCCTGTCCCACTACGAGCAGTACTTC	CASRVLTMCLLSHYEQYF	TRBV6-4	TRBJ2-7
TGTGCCAGCAGTGAGCTAAACAGTGGAGGATGGGAGGATCAGCCCCAGCATTTT	CASSELNSGGWEDQPQHF	TRBV6-1	TRBJ1-5
TGCGCCAGCAGCCACCCCTCCGCTCGCGGGGAGCTGTTTTTT	CASSHPSARGELFF	TRBV4-3	TRBJ2-2
TGTGCCACCAGTGTGACCAGGGACTATGGCTACACCTTC	CATSVTRDYGYTF	TRBV24-1	TRBJ1-2
TGTGCCAGCAGCTTGCCACGGGGGGGAGAGACCCAGTACTTC	CASSLPRGGETQYF	TRBV7-2	TRBJ2-5
TGTGCCAGTCCGACCGGGACAGTGGGGAGAGAAAAACTGTTTTTT	CASPTGTVGREKLFF	TRBV19	TRBJ1-4
TGTGCCAGAAGTGAGGAGACCCAGTACTTC	CARSEETQYF	TRBV6-4	TRBJ2-5
TGTGCCAGCAGCAGTCAAACACGAGAAATGGCTGGGGCCAACGTCCTGACTTTC	CASSSQTREMAGANVLTF	TRBV13	TRBJ2-6
TGTGCCAGCAGCTTAACTGGGAACCAAAGGGTGAAGCTAGCGATTACGCAGTATTTT	CASSLTGNQRVKLAITQYF	TRBV7-4	TRBJ2-3
TGTGCCACCCCCGCGGAAGGCAATCAGCCCCAGCATTTT	CATPAEGNQPQHF	TRBV24-1	TRBJ1-5
TGCGCCAGCAGCTTCTTCCGGGACTTCTATAGCAATCAGCCCCAGCATTTT	CASSFFRDFYSNQPQHF	TRBV5-1	TRBJ1-5
TGTGCCAGTAGTATCAGGGGGGGCAATCAGCCCCAGCATTTT	CASSIRGGNQPQHF	TRBV19	TRBJ1-5
TGCGCCAGCAGCCCACCCGGGACAGGGACTATTACTTACGAGCAGTACTTC	CASSPPGTGTITYEQYF	TRBV4-1	TRBJ2-7
TGTGCCAGCAGCGTAGCTCTTACGCAGTATTTT	CASSVALTQYF	TRBV9	TRBJ2-3
TGTGCCAGCACATACTTGGACAGTCGGCCTGGCTCCTACGAGCAGTACTTC	CASTYLDSRPGSYEQYF	TRBV7-9	TRBJ2-7
TGTGCCTGGAGGGTCCATTCACCCCTCCACTTT	CAWRVHSPLHF	TRBV30	TRBJ1-6
TGCAGTGTCTGCCCCCTAGCGCTGTTGGGCAATGAGCAGTTCTTC	CSVCPLALLGNEQFF	TRBV20-1	TRBJ2-1
TGTGCCATGGGTGTGGGAAGGGGCAATGAGCAGTTCTTC	CAMGVGRGNEQFF	TRBV10-3	TRBJ2-1
TGTGCCAGCAGCGTAGCCCTTGCGGCCTATAGCAATCAGCCCCAGCATTTT	CASSVALAAYSNQPQHF	TRBV9	TRBJ1-5
TGTGCCACCAGTGATCCAAGGAGGACAGCAGCCTACAATGAGCAGTTCTTC	CATSDPRRTAAYNEQFF	TRBV24-1	TRBJ2-1
TGTGCCAGCAGCCTTGGACTAGCGGGGTTCTACGAGCAGTACTTC	CASSLGLAGFYEQYF	TRBV4-2	TRBJ2-7
TGTGCCAGCAGCAGGTATACCTTGGGCTCCTACAATGAGCAGTTCTTC	CASSRYTLGSYNEQFF	TRBV7-9	TRBJ2-1
TGTGCCAGCAAAAGGACTCGCACTGAAGCTTTCTTT	CASKRTRTEAFF	TRBV25-1	TRBJ1-1
TGTGCCAGCAGCGAGAACACCGAGCAGTACTTC	CASSENTEQYF	TRBV7-9	TRBJ2-7
TGTGCCAGTGACCTCCGGACTAGCGGGAAGGCCAAAAACATTCAGTACTTC	CASDLRTSGKAKNIQYF	TRBV5-5	TRBJ2-4
TGTGCCATTTCAGGGGAACGCACAGATACGCAGTATTTT	CAISGERTDTQYF	TRBV10-3	TRBJ2-3
TGTGCCAGCAGTGAGATCCGACAGGGGGGAAGCAATCAGCCCCAGCATTTT	CASSEIRQGGSNQPQHF	TRBV6-4	TRBJ1-5
TGTGCCAGCAGCCCCGAACAAGGACGAGAGCGCTTC	CASSPEQGRERF	TRBV13	TRBJ1-2
TGTGCCAGCAGCTTACTATCAGGACAGGGGAAGGGTCAGCCCCAGCATTTT	CASSLLSGQGKGQPQHF	TRBV7-9	TRBJ1-5
TGTGCCAGCAGCATAAGGCCAGGGGCCCAAGGCAATCAGCCCCAGCATTTT	CASSIRPGAQGNQPQHF	TRBV13	TRBJ1-5
TGTGCCAGGGGACAGCAGCCCCAGCATTTT	CARGQQPQHF	TRBV5-8	TRBJ1-5
TGTGCCACCAGTGATTTGCTAAGTCAACCCAGGAAGTGGATAGGCAACTATGGCTACACCTTC	CATSDLLSQPRKWIGNYGYTF	TRBV24-1	TRBJ1-2
TGTGCCAGCAGGGGATCCGGGCGTCGTGGAAACACCATATATTTT	CASRGSGRRGNTIYF	TRBV19	TRBJ1-3
TGTGCCAGCAGCTCATTTGGGACCTGCCCGGACAGCTCCTATAATTCACCCCTCCACTTT	CASSSFGTCPDSSYNSPLHF	TRBV5-4	TRBJ1-6
TGTGCCAGCAGTACGGCCATTTACAATGAGCAGTTCTTC	CASSTAIYNEQFF	TRBV9	TRBJ2-1
TGTGCCAGCAGCCGCCGCACGACTAGCGGGGGGGCCAACAATGAGCAGTTCTTC	CASSRRTTSGGANNEQFF	TRBV7-3	TRBJ2-1
TGTGCCAGCAGCTTGTCTAGGTCGAGGTTGTTGGGCGCCAAAAACATTCAGTACTTC	CASSLSRSRLLGAKNIQYF	TRBV7-8	TRBJ2-4
TGTGCCAGCAGTGGTCCGGCCATAATGACTGAAGCTTTCTTT	CASSGPAIMTEAFF	TRBV2	TRBJ1-1
TGTGCCAGCGGGGGGAGTAACGAGACCCAGTACTTC	CASGGSNETQYF	TRBV7-3	TRBJ2-5
TGTGCCACTCCTGACAGGGCCTTCGGAAACACCATATATTTT	CATPDRAFGNTIYF	TRBV13	TRBJ1-3
TGTGCCAGGATCTGGGACCTCGGTTTGGAAAAACTGTTTTTT	CARIWDLGLEKLFF	TRBV6-4	TRBJ1-4
TGTGGACCCAGGGCAGGGGGATCTATCTACGAGCAGTACTTC	CGPRAGGSIYEQYF	TRBV10-3	TRBJ2-7
TGTGCCAGCACCGAGGGACATCAGCCCCAGCATTTT	CASTEGHQPQHF	TRBV11-2	TRBJ1-5
TGTGCCAGCAGGGATCGCACAGGGTGTCCATACGAGCAGTACTTC	CASRDRTGCPYEQYF	TRBV6-3	TRBJ2-7
TGTGCCACCGGACGGACGTTACCCGGGGAGCTGTTTTTT	CATGRTLPGELFF	TRBV28	TRBJ2-2
TGCAGTGCTAGAGATCTAGCAGGGGCGTTCTACATGGTACGACCAGCTAACTATGGCTACACCTTC	CSARDLAGAFYMVRPANYGYTF	TRBV20-1	TRBJ1-2
TGTGCCAGCAGTGAAGCGGGTCAGGGGGCGTTGTATAGCAATCAGCCCCAGCATTTT	CASSEAGQGALYSNQPQHF	TRBV6-1	TRBJ1-5
TGTGCCAGCAGCTTAGCTGCGCCTACCGAGAGAAACAAGAATTCACCCCTCCACTTT	CASSLAAPTERNKNSPLHF	TRBV7-6	TRBJ1-6
TGTGCCAGCAGCCAATTGGGGGAAACCACTGAAGCTTTCTTT	CASSQLGETTEAFF	TRBV14	TRBJ1-1
TGTGCCATCAGTTCTCTCTCCGGGACAGGGGTAGGCTCTGGGGCCAACGTCCTGACTTTC	CAISSLSGTGVGSGANVLTF	TRBV10-3	TRBJ2-6
TGCGCCAGCAGGGCAGGTGGTACTGAAGCTTTCTTT	CASRAGGTEAFF	TRBV5-1	TRBJ1-1
TGTGCCAGCAGCCCAGGGGGCGCATGGGGTGACTACAATGAGCAGTTCTTC	CASSPGGAWGDYNEQFF	TRBV9	TRBJ2-1
TGCAGTGCTAGAAGACGGGAAGGAAACACCGGGGAGCTGTTTTTT	CSARRREGNTGELFF	TRBV20-1	TRBJ2-2
TGTGCCAGCAGCTTAGTAGGGCCCGGGAGCTCCTACGAGCAGTACTTC	CASSLVGPGSSYEQYF	TRBV7-6	TRBJ2-7
TGTGCCAGCAGCCAAGATACTCTAGTTGGACAGGGGGGGGCGCGGGGGGAGCTGTTTTTT	CASSQDTLVGQGGARGELFF	TRBV3-1	TRBJ2-2
TGTGCCAGCAGACCGGACAGGGATAAGGACGAGCAGTACTTC	CASRPDRDKDEQYF	TRBV28	TRBJ2-7
TGTGCCAGCAGTTTAATACGGTCCGGAAACACCATATATTTT	CASSLIRSGNTIYF	TRBV27	TRBJ1-3
TGTGCCAGCAGCCAAGGGGGGGGGAGCTATGGCTACACCTTC	CASSQGGGSYGYTF	TRBV14	TRBJ1-2
TGCAGTGCTAGGGCCTGGAGAGGCCCTAACTATGGCTACACCTTC	CSARAWRGPNYGYTF	TRBV20-1	TRBJ1-2
TGTGCCACCAGCAGAGATCCCTTGTGGACAGGGGTAGATGAAGCTTTCTTT	CATSRDPLWTGVDEAFF	TRBV15	TRBJ1-1
TGCGCCAGCAGCTTGGTCGGACAGGGGGCCAATGAGCAGTTCTTC	CASSLVGQGANEQFF	TRBV5-1	TRBJ2-1
TGTGCCAGCAGCCGGGACACGGGCCGACCCCCAACTAATGAAAAACTGTTTTTT	CASSRDTGRPPTNEKLFF	TRBV7-4	TRBJ1-4
TGTGCCAGCAGTCTCCGGGCGAGGGAGTCAGCGGAGATTGCAGATACGCAGTATTTT	CASSLRARESAEIADTQYF	TRBV12-3	TRBJ2-3
TGTGCCAGCAGCTCGAGGTACACCGGGGAGCTGTTTTTT	CASSSRYTGELFF	TRBV7-4	TRBJ2-2
TGCGCCAGCAGCCAAACTCTTGGGGGGTACTTGAACACTGAAGCTTTCTTT	CASSQTLGGYLNTEAFF	TRBV4-3	TRBJ1-1
TGTGCCAGCTCACTCAGGGATACAGACATTCAGTACTTC	CASSLRDTDIQYF	TRBV18	TRBJ2-4
TGTGCCAGCTCACCAGTTGGGGAAGTCACTGAAGCTTTCTTT	CASSPVGEVTEAFF	TRBV18	TRBJ1-1
TGTGCCAGCAGCCAAGATGACGGAAGGACAGGGGGCTCGCGGGCCTACGAGCAGTACTTC	CASSQDDGRTGGSRAYEQYF	TRBV14	TRBJ2-7
TGTGCCAGCAGCGGCGGGAGGGCCCTTTGTAGCAATCAGCCCCAGCATTTT	CASSGGRALCSNQPQHF	TRBV13	TRBJ1-5
TGCGCCAGCAGCCATTCTACAGGTATTGTGCTCCATCAGCCCCAGCATTTT	CASSHSTGIVLHQPQHF	TRBV4-1	TRBJ1-5
TGCACATGCAGGGGTCTGTTTTTT	CTCRGLFF	TRBV20-1	TRBJ1-4
TGTGCCAGCAGGAAAGTTTGGGGAGGTGGCTACACCTTC	CASRKVWGGGYTF	TRBV13	TRBJ1-2
TGTGCCAGCAGTCCACCGGTCAAGGGGCAGCCCCAGCATTTT	CASSPPVKGQPQHF	TRBV12-4	TRBJ1-5
TGCAGTGCAAAGCAGGCGTACACCGGGGAGCTGTTTTTT	CSAKQAYTGELFF	TRBV20-1	TRBJ2-2
TGCGCCAGCAGCCAAGATAATAGCGGGTGGGGCGAGCAGTACTTC	CASSQDNSGWGEQYF	TRBV4-1	TRBJ2-7
TGTGCCAGCAGAGGGGGTGTGCTAGCGGGTACTGCAGATACGCAGTATTTT	CASRGGVLAGTADTQYF	TRBV6-5	TRBJ2-3
TGTGCCAGCAGCGACCTAGACAGGGAGAAAGCGCAGTTCTTC	CASSDLDREKAQFF	TRBV5-5	TRBJ2-1
TGTGCCAGCAGTTATAGGGGGGGGCGCGAGCAGTACTTC	CASSYRGGREQYF	TRBV28	TRBJ2-7
TGTGCCAGCAGCTCCCTCGTACGGGCTTGGGGGTCCTACGAGCAGTACTTC	CASSSLVRAWGSYEQYF	TRBV7-6	TRBJ2-7
TGTGCCAGCAGTTACCCGGGACAGGTGCAGAACACTGAAGCTTTCTTT	CASSYPGQVQNTEAFF	TRBV6-5	TRBJ1-1
TGCAGTGCTAGAGCGACCCTTTCCCCAGTCCCCTCCTACAATGAGCAGTTCTTC	CSARATLSPVPSYNEQFF	TRBV20-1	TRBJ2-1
TGTGCCAGCAGCTTACATCGGACAGGTTGGGTTAATAAGACGCAGTATTTT	CASSLHRTGWVNKTQYF	TRBV7-4	TRBJ2-3
TGTGCCAGCCCAGGGGGGAACACTGAAGCTTTCTTT	CASPGGNTEAFF	TRBV10-3	TRBJ1-1
TGTGCCAGCAGCTACCCTGGACAGGGGCAAAGGGGATGCAATCAGCCCCAGCATTTT	CASSYPGQGQRGCNQPQHF	TRBV5-4	TRBJ1-5
TGTGCCCCGCGGGAGGTTGCAAGCACAGATACGCAGTATTTT	CAPREVASTDTQYF	TRBV7-8	TRBJ2-3
TGTGCCAGCAGTAAGTACGGAAGGGGGCATACGCAGTATTTT	CASSKYGRGHTQYF	TRBV6-4	TRBJ2-3
TGCAGTGCTCGGGGGGGCGCAGATACGCAGTATTTT	CSARGGADTQYF	TRBV20-1	TRBJ2-3
TGTGCCAGCAGCGGGGGCCGGGCCTACGAGCAGTACTTC	CASSGGRAYEQYF	TRBV11-3	TRBJ2-7
TGTGCCAGCAGCGGGACAGGTGAAAACATTCAGTACTTC	CASSGTGENIQYF	TRBV28	TRBJ2-4
TGTGCCAGCACTCCCGACAGGATGAACACTGAAGCTTTCTTT	CASTPDRMNTEAFF	TRBV12-3	TRBJ1-1
TGTGCCAGTAGTAGGTTAGGGGAACACACTGAAGCTTTCTTT	CASSRLGEHTEAFF	TRBV19	TRBJ1-1
TGCAGTGCTCGCCCTAGAGTAGTGGATACGCAGTATTTT	CSARPRVVDTQYF	TRBV20-1	TRBJ2-3
TGTGCCAGCAGTGACCAGGGACAGGGCCTCAATTCACCCCTCCACTTT	CASSDQGQGLNSPLHF	TRBV6-1	TRBJ1-6
TGTGCCAGCAGAGGACAACAGGCAGGGGGGTGGCGGGGCTACACCTTC	CASRGQQAGGWRGYTF	TRBV6-5	TRBJ1-2
TGTGCCAGCAGTTTATTAAGTGGGACACTGGGCAATCAGCCCCAGCATTTT	CASSLLSGTLGNQPQHF	TRBV12-4	TRBJ1-5
TGTGCCAGCAAGATCCTAGGGAGTTGTGAGCAGTTCTTC	CASKILGSCEQFF	TRBV2	TRBJ2-1
TGTGCCAGCAGCGAGGAAAGGAACACTGAAGCTTTCTTT	CASSEERNTEAFF	TRBV13	TRBJ1-1
TGTGTCGGACAGGATTCTGTGAACACTGAAGCTTTCTTT	CVGQDSVNTEAFF	TRBV28	TRBJ1-1
TGTGCCAGTAGTATAGTGACAGGGGGCAACTATGGCTACACCTTC	CASSIVTGGNYGYTF	TRBV19	TRBJ1-2
TGCGCCAGCAGCACCGAGAAGGACAGGGCTAGACGGAATTCACCCCTCCACTTT	CASSTEKDRARRNSPLHF	TRBV5-1	TRBJ1-6
TGTGCCAGCATTATGCCGGGGCGGATGGAAGACACCATATATTTT	CASIMPGRMEDTIYF	TRBV25-1	TRBJ1-3
TGTGCCATCAGCCAAGGACAGGACGGTAATGAAAAACTGTTTTTT	CAISQGQDGNEKLFF	TRBV10-3	TRBJ1-4
TGTGCCAGCAGAAGGACAGGGGGCGGTCGTTATAGCAATCAGCCCCAGCATTTT	CASRRTGGGRYSNQPQHF	TRBV16	TRBJ1-5
TGTGCCAAGTGGGCCACTCCGGGACAGGGCTTCAATCAGCCCCAGCATTTT	CAKWATPGQGFNQPQHF	TRBV28	TRBJ1-5
TGCGCCAGCAGCTTGTCAGGGACAGGGGACACTGAAGCTTTCTTT	CASSLSGTGDTEAFF	TRBV5-1	TRBJ1-1
TGTGCCACCAGGCAGATTCCCCGGGACAGGGAGGATAACTATGGCTACACCTTC	CATRQIPRDREDNYGYTF	TRBV24-1	TRBJ1-2
TGTGCCAGCAGGCCAGGGGATGATGGGACAGATACGCAGTATTTT	CASRPGDDGTDTQYF	TRBV2	TRBJ2-3
TGTGCCAGCAGCTGGGCAAGGAGGGACAGGTGGGCTTTCTTT	CASSWARRDRWAFF	TRBV13	TRBJ1-1
TGTGCCAGCAATGGCGAAGGCGTTACAGATACGCAGTATTTT	CASNGEGVTDTQYF	TRBV7-3	TRBJ2-3
TGTGCCTGGAAGCCCACCGGGGGGGTCTTC	CAWKPTGGVF	TRBV30	TRBJ2-1
TGTGCCAGCAGTGACCCCGGGACTAGCGGGGAGACCCAGTACTTC	CASSDPGTSGETQYF	TRBV6-4	TRBJ2-5
TGTGCCAGCAGCTGGGGCGGACAAGAGACCCAGTACTTC	CASSWGGQETQYF	TRBV13	TRBJ2-5
TGTGCCAGCTCCCGGGACAGCAGGTGCTCCTACGAGCAGTACTTC	CASSRDSRCSYEQYF	TRBV12-3	TRBJ2-7
TGTGCCAGCAGCGTAGTCTCGCAGGAACGCCCAGATACGCAGTATTTT	CASSVVSQERPDTQYF	TRBV9	TRBJ2-3
TGCCCGACTGAAGCTTTCTTT	CPTEAFF	TRBV20-1	TRBJ1-1
TGTGCCAGCAGCGGGGTTAGCAATCAGCCCCAGCATTTT	CASSGVSNQPQHF	TRBV7-9	TRBJ1-5
TGCGCCAGCAGCTCAGGTTCACCCCTCCACTTT	CASSSGSPLHF	TRBV5-1	TRBJ1-6
TGTGCCAGCAGCAACTCCAAAGGGGCCGGTCCAGCTTTCTTT	CASSNSKGAGPAFF	TRBV11-2	TRBJ1-1
TGTGCCAGCAGCTTAGAAGGAATAGATGTGTACGAGCAGTACTTC	CASSLEGIDVYEQYF	TRBV11-3	TRBJ2-7
TGTGCCAGAATCGGGGGGCACTATGGCTACACCTTC	CARIGGHYGYTF	TRBV14	TRBJ1-2
TGTGCCAGCAGCTGTAAGACAGGTAGCACAGATACGCAGTATTTT	CASSCKTGSTDTQYF	TRBV7-9	TRBJ2-3
TGTGCCAGCTCACAAGCAGCTAATCAGCCCCAGCATTTT	CASSQAANQPQHF	TRBV18	TRBJ1-5
TGTGCCAGCAGCAACGAGGGACAGGGAACTTTCTTT	CASSNEGQGTFF	TRBV7-2	TRBJ1-1
TGTGCCAGCAGCAATCAGGGACGGAGCAATCAGCCCCAGCATTTT	CASSNQGRSNQPQHF	TRBV5-8	TRBJ1-5
TGTGCCAGCAGCTTGGGGGCGGTATCCCTCTACGAGCAGTACTTC	CASSLGAVSLYEQYF	TRBV5-6	TRBJ2-7
TGCAGCGACACAGGGGTGAACGAGCAGTACTTC	CSDTGVNEQYF	TRBV29-1	TRBJ2-7
TGTGCCAGCAGCCAAGACTACGATCGGGACAGTGGGGACGAGCAGTACTTC	CASSQDYDRDSGDEQYF	TRBV14	TRBJ2-7
TGCGCCAGCAGCTTGCACGTGTGGACTAGGGGTCCCTACGAGCAGTACTTC	CASSLHVWTRGPYEQYF	TRBV5-1	TRBJ2-7
TGTGCCAGCAGCCGCAGGAGGCACAATGAGCAGTTCTTC	CASSRRRHNEQFF	TRBV7-2	TRBJ2-1
TGTGCTAGTGACCCGCGGGAGAGCAATCAGCCCCAGCATTTT	CASDPRESNQPQHF	TRBV12-5	TRBJ1-5
TGTGCCAGCAGGTTTTCCGGGGCTCAGTTCTACGAGCAGTACTTC	CASRFSGAQFYEQYF	TRBV2	TRBJ2-7
TGTGCCAAATCACAGGGGCTGGAGCAAGAGACCCAGTACTTC	CAKSQGLEQETQYF	TRBV10-3	TRBJ2-5
TGCGCCAGCAGCCCGACCAGAAGGGGTTATGGCTACACCTTC	CASSPTRRGYGYTF	TRBV10-1	TRBJ1-2
TGTGCCAGCAGCCTCCGACAGGGGGGAACGCAGTATTTT	CASSLRQGGTQYF	TRBV5-6	TRBJ2-3
TGTGCCAGCAGCTTATGTGGAGTGGCCTCCTACGAGCAGTACTTC	CASSLCGVASYEQYF	TRBV7-3	TRBJ2-7
TGTGCCAGCAGGGCGACAGGTTGCCAGTATTCACCCCTCCACTTT	CASRATGCQYSPLHF	TRBV7-9	TRBJ1-6
TGTGCCAGCAGCACCGGGGGTCCCTACGAGCAGTACTTC	CASSTGGPYEQYF	TRBV7-3	TRBJ2-7
TGTGCTAGTGGTGGGGGACACGAGCAGTACTTC	CASGGGHEQYF	TRBV12-5	TRBJ2-7
TGTGCCAACGCCAGGCGAACGACAGCCTACGAGCAGTACTTC	CANARRTTAYEQYF	TRBV6-5	TRBJ2-7
TGTGCCAGTAGTATAGATGGGGCCTCAAGGGACAGGGAAAAGCCCGACCTCTCTGGAAACACCATATATTTT	CASSIDGASRDREKPDLSGNTIYF	TRBV19	TRBJ1-3
TGTGCCAAGGCTGGCCTTGTTTGGTATTTT	CAKAGLVWYF	TRBV6-4	TRBJ2-3
TGTGCCAGCAGAAAAATAGCGCAGCTAGTCCAAGAGACCCAGTACTTC	CASRKIAQLVQETQYF	TRBV6-4	TRBJ2-5
TGTGCCAGCTCACTTAGCGGTCCCAAAGCAGATACGCAGTATTTT	CASSLSGPKADTQYF	TRBV18	TRBJ2-3
TGTGCCAGCAGCCAGGGCTCGGTCCCGGGACAGCGTCAGCCCCAGCATTTT	CASSQGSVPGQRQPQHF	TRBV3-1	TRBJ1-5
TGTGCCAGCAGCGGCCTGACCGGGGAGCTGTTTTTT	CASSGLTGELFF	TRBV9	TRBJ2-2
TGCAGTGATCGGGGGACAGGGATGCATCACACTGAAGCTTTCTTT	CSDRGTGMHHTEAFF	TRBV20-1	TRBJ1-1
TGTTGGGGCAATCAGCCCCAGCATTTT	CWGNQPQHF	TRBV20-1	TRBJ1-5
TGTGCCAGCAGTTGGTGGGGAGGTGTGACCGGGGAGCTGTTTTTT	CASSWWGGVTGELFF	TRBV27	TRBJ2-2
TGTGCCAGCAGTGAATCCGGGGAAGGACAGTTCGATGGCTACACCTTC	CASSESGEGQFDGYTF	TRBV6-1	TRBJ1-2
TGTGCCAGCAGCTTAGGCACAGGGTCTGGGAGAGAGACCCAGTACTTC	CASSLGTGSGRETQYF	TRBV11-2	TRBJ2-5
TGTGCCAGCAGTGACAAAGGACCTCTCGAGGACGGGGCCAACGTCCTGACTTTC	CASSDKGPLEDGANVLTF	TRBV6-4	TRBJ2-6
TGTGCCAGCAACGGCTGGGAGGGCGAGCAGTACTTC	CASNGWEGEQYF	TRBV6-4	TRBJ2-7
TGCAGTGCTAAGGAAGTCGGGGGGGAAAGTGCTGAGCAGTACTTC	CSAKEVGGESAEQYF	TRBV20-1	TRBJ2-7
TGCGCCAGCAGCTTGGCCGGGAGGACAGGGAGCCCAGATACGCAGTATTTT	CASSLAGRTGSPDTQYF	TRBV5-1	TRBJ2-3
TGTGCCAGCAGCGTTGGGGGCGGCAATCAGCCCCAGCATTTT	CASSVGGGNQPQHF	TRBV7-3	TRBJ1-5
TGTGCCACCAGTGACGGGGACAGAGATACCGGGGAGCTGTTTTTT	CATSDGDRDTGELFF	TRBV24-1	TRBJ2-2
TGTGCCAGCAGTTATGGACAGGGGGACCTCAATGAAAAACTGTTTTTT	CASSYGQGDLNEKLFF	TRBV28	TRBJ1-4
TGTGCCAGCAGTCCTTTCCCCACGTTCAGCTCCTATAATTCACCCCTCCACTTT	CASSPFPTFSSYNSPLHF	TRBV27	TRBJ1-6
TGCAGCACGGGCCCTCCCCAAGAAGGACGGGACAGGAAGGAAAACATTCAGTACTTC	CSTGPPQEGRDRKENIQYF	TRBV29-1	TRBJ2-4
TGTGCCAGCAGCCTCCAGATCTATGGCTACACCTTC	CASSLQIYGYTF	TRBV6-4	TRBJ1-2
TGTGCCAGCACCCCGGGGGGGACAGGGGGCCCCTACGAGCAGTACTTC	CASTPGGTGGPYEQYF	TRBV6-5	TRBJ2-7
TGTGCCAGCAGCTTAGGCTTCCCTTCCAGGGCCAGCACAGATACGCAGTATTTT	CASSLGFPSRASTDTQYF	TRBV11-3	TRBJ2-3
TGTGCCAGCTCACAGGGGGGACTAAATCAGCCCCAGCATTTT	CASSQGGLNQPQHF	TRBV18	TRBJ1-5
TGCAGTGCGCTCTCGGGGGGGGGCCAGCCCTACAATGAGCAGTTCTTC	CSALSGGGQPYNEQFF	TRBV20-1	TRBJ2-1
TGCAGTGCTAGATCTATGAGGCAAGGGAACACTGAAGCTTTCTTT	CSARSMRQGNTEAFF	TRBV20-1	TRBJ1-1
TGTGCTAGCAGCTTTCAGCTAGGGCTGGAGACCCAGTACTTC	CASSFQLGLETQYF	TRBV7-7	TRBJ2-5
TGTGCCAGCAGCCGGCCTTTGTTGGGACAGGGCAGTTACAATGAGCAGTTCTTC	CASSRPLLGQGSYNEQFF	TRBV6-4	TRBJ2-1
TGTGCCAGCAGCGGATCCGGAGGGAGGGACACCGGGGAGCTGTTTTTT	CASSGSGGRDTGELFF	TRBV13	TRBJ2-2
TGTGCCAGCAGTTACAAAGGGACAGGTTGGAATTCACCCCTCCACTTT	CASSYKGTGWNSPLHF	TRBV6-5	TRBJ1-6
TGCAGTGCTAGAGTAGCGGGCTCACAAAGATACAATGAGCAGTTCTTC	CSARVAGSQRYNEQFF	TRBV20-1	TRBJ2-1
TGCAGCTTGTACCCCGGGGGGGACCATGAGCAGTTCTTC	CSLYPGGDHEQFF	TRBV29-1	TRBJ2-1
TGCAGTGCGGAGGGGGGGGGGTTACGGGGAATCCGGACCCAGTACTTC	CSAEGGGLRGIRTQYF	TRBV20-1	TRBJ2-5
TGTGCCTGGATAGGGCATGAGGTGGCCTCCTACGAGCAGTACTTC	CAWIGHEVASYEQYF	TRBV30	TRBJ2-7
TGTGCCAGCAGCGCCTGGACCTATGGCTACACCTTC	CASSAWTYGYTF	TRBV7-2	TRBJ1-2
TGTGCCAGCAGTTTATTGGAAGGGTGTCCAGGGATCCTGTACCAAGAGACCCAGTACTTC	CASSLLEGCPGILYQETQYF	TRBV28	TRBJ2-5
TGTGCCAGCAGCTCGCTACTCGTTACTGACAATGAGCAGTTCTTC	CASSSLLVTDNEQFF	TRBV7-9	TRBJ2-1
TGTGCCAGCCGTCCAGTCCGGGAGGGGGGGTACCTGAACACTGAAGCTTTCTTT	CASRPVREGGYLNTEAFF	TRBV7-9	TRBJ1-1
TGTGCCTGGAGTTTTCGCCGGGAAGTAGGACAGACCGGGGAGCTGTTTTTT	CAWSFRREVGQTGELFF	TRBV30	TRBJ2-2
TGTGCCAGCAGCCCTGCCGGGACAGGGACCAATCAGCCCCAGCATTTT	CASSPAGTGTNQPQHF	TRBV9	TRBJ1-5
TGCAGCCCCCCGGGGACAGCTTCTAGAATCGGGGAAAGCTCTGGGGCCAACGTCCTGACTTTC	CSPPGTASRIGESSGANVLTF	TRBV29-1	TRBJ2-6
TGTGCCACCAGCCCGACAGGGCGGGGCACGTACGAGCAGTACTTC	CATSPTGRGTYEQYF	TRBV15	TRBJ2-7
TGTGCCAGCAGCGGCAGGGTCTTAGAGCAGTACTTC	CASSGRVLEQYF	TRBV12-4	TRBJ2-7
TGTGCCAGCCTAGTCCCAAACACCGGGGAGCTGTTTTTT	CASLVPNTGELFF	TRBV6-6	TRBJ2-2
TGTGCCAGCAGCAGGAACTCACCGGGACTAGCGGTAAGCTCCTACGAGCAGTACTTC	CASSRNSPGLAVSSYEQYF	TRBV6-5	TRBJ2-7
TGTGCCAGCAGCCGCAGTGGGCATGAGCAGTTCTTC	CASSRSGHEQFF	TRBV3-1	TRBJ2-1
TGTGCCAGCGCCAAGAGCACAGTCAATGAGCAGTTCTTC	CASAKSTVNEQFF	TRBV11-2	TRBJ2-1
TGTGCCAGCAGCCTATCCAGGGGGGGCCAGTTGGGAGCTTCCTACGAGCAGTACTTC	CASSLSRGGQLGASYEQYF	TRBV7-3	TRBJ2-7
TGTGCCAGCAGTTACGTAATAGAGGGCCTCGAGTCGAACACCGGGGAGCTGTTTTTT	CASSYVIEGLESNTGELFF	TRBV6-6	TRBJ2-2
TGTGCCAGCATAAAATGTATGTACGAGCAGTACTTC	CASIKCMYEQYF	TRBV12-4	TRBJ2-7
TGTGCCAGTACACCTCGGACAGGGGATTCCTTCCGGGCCGGGGAGCTGTTTTTT	CASTPRTGDSFRAGELFF	TRBV19	TRBJ2-2
TGTGCCAGCAGCCTAGACTCAGTAGCCAAAAACATTCAGTACTTC	CASSLDSVAKNIQYF	TRBV14	TRBJ2-4
TGTGCCAGCAGTGATGTACGGGGCGAGCAGTACTTC	CASSDVRGEQYF	TRBV6-4	TRBJ2-7
TGTGCCAGCAGCGCAAGAACGGGGAGTTGGCACTTC	CASSARTGSWHF	TRBV7-3	TRBJ2-7
TGTGCCAGCAGCGTAGCCACAGTCAGTTTAGACTCAGGTTCACCCCTCCACTTT	CASSVATVSLDSGSPLHF	TRBV9	TRBJ1-6
TGTGCCACCAGTGATAAGATCTCCGGAGGGGGGGCCCCCACCGGGGAGCTGTTTTTT	CATSDKISGGGAPTGELFF	TRBV24-1	TRBJ2-2
TGTGCCAGCAGTGACTCGAGGACAGGGATCCTGCCCCAGCATTTT	CASSDSRTGILPQHF	TRBV6-4	TRBJ1-5
TGTGCCTGGGAGGGACTAGCTTCCTACGAGCAGTACTTC	CAWEGLASYEQYF	TRBV30	TRBJ2-7
TGTGCCAGCATGCGACAGGAGACCCAGTACTTC	CASMRQETQYF	TRBV9	TRBJ2-5
TGTGCTAGCAGCTTAGGACTGTGGAATGAAAAACTGTTTTTT	CASSLGLWNEKLFF	TRBV7-7	TRBJ1-4
TGTGCCATCAGTGCCCCAGGCGAGCAGTACTTC	CAISAPGEQYF	TRBV10-3	TRBJ2-7
TGTGCTAGTGGTTTTTTCGGGACAGGGACGGCTGAAGCTTTCTTT	CASGFFGTGTAEAFF	TRBV12-5	TRBJ1-1
TGTGCCAGCAGTTTAAGCCGGACTACTAAGGAAGCTTTCTTT	CASSLSRTTKEAFF	TRBV12-4	TRBJ1-1
TGCAGTGCGTGGGACAGGAACCTGAGCAATCAGCCCCAGCATTTT	CSAWDRNLSNQPQHF	TRBV20-1	TRBJ1-5
TGTGCCACCAGTGATAAAACCATTCCGTCTAGGAGGGGTCAGTACTTC	CATSDKTIPSRRGQYF	TRBV24-1	TRBJ2-7
TGTGCCAGCAGTCGAATAAGTCAGCCCCAGCATTTT	CASSRISQPQHF	TRBV27	TRBJ1-5
TGTGCCAGCAGTTATGCGGGGACTGAAGCTTTCTTT	CASSYAGTEAFF	TRBV6-2	TRBJ1-1
TGTGCCTGGACAACTCCCGAGACCCAGTACTTC	CAWTTPETQYF	TRBV30	TRBJ2-5
TGTGCCAGCAGCAAAAACTTCCCCCTAAGTTCAGGGGATCAGCCCCAGCATTTT	CASSKNFPLSSGDQPQHF	TRBV13	TRBJ1-5
TGCAGTGCTAGAGCGCAGGGGAGTGCCACTGAAGCTTTCTTT	CSARAQGSATEAFF	TRBV20-1	TRBJ1-1
TGCGCCAGCAGCAAGGGCAAGACCCAGTACTTC	CASSKGKTQYF	TRBV5-1	TRBJ2-5
TGCGCCAGCAGCGTCAGAGATAAGGGGAACACTGAAGCTTTCTTT	CASSVRDKGNTEAFF	TRBV5-1	TRBJ1-1
TGTGCCAGCAATCCGGGCTGGAACACTGAAGCTTTCTTT	CASNPGWNTEAFF	TRBV3-1	TRBJ1-1
TGTGCCTGGAGTGTACTTGACAGGGCCCCCTACAATGAGCAGTTCTTC	CAWSVLDRAPYNEQFF	TRBV30	TRBJ2-1
TGTGCCAACCCCCGGGACAGGGTTTATGAAGCTTTCTTT	CANPRDRVYEAFF	TRBV7-9	TRBJ1-1
TGCAGTGCTAGGCCCCCATCAGGGAAAGCGACCCAGTACTTC	CSARPPSGKATQYF	TRBV20-1	TRBJ2-5
TGTGCCAGCAGTGACACCAACATTGGTGTTCGCTACGAGCAGTACTTC	CASSDTNIGVRYEQYF	TRBV6-4	TRBJ2-7
TGCAGTGCTAGACCGGGACAGGGATACTGCAATCAGCCCCAGCATTTT	CSARPGQGYCNQPQHF	TRBV20-1	TRBJ1-5
TGTGCCAGCAGCCAAGAACAGGGCCCGGGACTAGCGGGGGGGCGGAATGAGCAGTTCTTC	CASSQEQGPGLAGGRNEQFF	TRBV4-2	TRBJ2-1
TGCAGTGCTAGAGAGATCCCCCGCGGGACTAGCGGGAGGAGGGGCTACACCTTC	CSAREIPRGTSGRRGYTF	TRBV20-1	TRBJ1-2
TGCAGTGCTAGAGTGAGGACCGCGGCCGGGACAGGGAAAGGGTACGAGCAGTACTTC	CSARVRTAAGTGKGYEQYF	TRBV20-1	TRBJ2-7
TGTGCCCCCCCTAGCGGGTCGAAGGGAGAGGGTAGGGACATTCAGTACTTC	CAPPSGSKGEGRDIQYF	TRBV19	TRBJ2-4
TGCGCCAGCAGCCAAGGATGCGGGAGCCACAGCTCCTACAATGAGCAGTTCTTC	CASSQGCGSHSSYNEQFF	TRBV4-1	TRBJ2-1
TGTGCCAGCAGCTTGGGACCTAGTGTATTTGAGACCCAGTACTTC	CASSLGPSVFETQYF	TRBV7-7	TRBJ2-5
TGTGCCACGTCAACTTCTGGTGGGGGAATTCAGCCCCAGCATTTT	CATSTSGGGIQPQHF	TRBV24-1	TRBJ1-5
TGTGCCAGCAGCGACAGACTGTCCTATGGCTACACCTTC	CASSDRLSYGYTF	TRBV7-7	TRBJ1-2
TGTGCCAGCAGTACCTCGTGGGTGGGAGGGGGGCTAGCCAAAAACATTCAGTACTTC	CASSTSWVGGGLAKNIQYF	TRBV12-4	TRBJ2-4
TGTGCCAGCAGCGCCGCGTACCCGGGGCGCTACGAGCAGTACTTC	CASSAAYPGRYEQYF	TRBV9	TRBJ2-7
TGTGCCACCAGGAAGGACGACGTTACCCGAGAGACCCAGTACTTC	CATRKDDVTRETQYF	TRBV24-1	TRBJ2-5
TGTGCCAGCAGCCACAATGTAAAGACTAGCTTCTTTGTCAATGAGCAGTTCTTC	CASSHNVKTSFFVNEQFF	TRBV3-1	TRBJ2-1
TGTGCCACCCTTACTTGGACTAAAAGGGACTATGGCTACACCTTC	CATLTWTKRDYGYTF	TRBV24-1	TRBJ1-2
TGTGCCAGCAGCTTAGGGACGTATCAGCCCCAGCATTTT	CASSLGTYQPQHF	TRBV7-9	TRBJ1-5
TGTGCCTGGATTCGAATTTGGGACAGTGGCATTCAGTACTTC	CAWIRIWDSGIQYF	TRBV30	TRBJ2-4
TGTGCCAGCAATTGTTCCCGGGACAGGGGCTCTGGCTCTGGGGCCAACGTCCTGACTTTC	CASNCSRDRGSGSGANVLTF	TRBV9	TRBJ2-6
TGTGCCAGCAGTCTAGGGGGAGCAGAGACCCAGTACTTC	CASSLGGAETQYF	TRBV6-4	TRBJ2-5
TGTGCCAGTAGCGGTACGCAGTATTTT	CASSGTQYF	TRBV28	TRBJ2-3
TGCGCCAGCAGCCAAGATCCCCTCCACCCTGAGCTGTTTTTT	CASSQDPLHPELFF	TRBV4-1	TRBJ2-2
TGCGCCAGCCAGCCCTTACGAATCTCTGGGGACGAGCAGTACTTC	CASQPLRISGDEQYF	TRBV10-1	TRBJ2-7
TGTGCCAGCAGTTACTCGACTACTAGCGGGAGTTCACCCCTCCACTTT	CASSYSTTSGSSPLHF	TRBV6-5	TRBJ1-6
TGTGCCAGCAGCTTAGCCCCGGGACTAGCGGGTGCTGAGCAGTTCTTC	CASSLAPGLAGAEQFF	TRBV7-4	TRBJ2-1
TGCGCCAGCAGCCAAGGCAGGGGGAAACACGAGCAGTACTTC	CASSQGRGKHEQYF	TRBV4-1	TRBJ2-7
TGCAGTGCTAGAGGGTTGATCGCGAACACCGGGGAGCTGTTTTTT	CSARGLIANTGELFF	TRBV20-1	TRBJ2-2
TGCAGTGCTAGAGATGACCTACAGGGACCCGGCTCCTACGAGCAGTACTTC	CSARDDLQGPGSYEQYF	TRBV20-1	TRBJ2-7
TGTGCCAGCATCCATACCGGCTATGGCTACACCTTC	CASIHTGYGYTF	TRBV6-4	TRBJ1-2
TGTGCCAGCAGTTTGAGAAGATACTACGAGCAGTACTTC	CASSLRRYYEQYF	TRBV27	TRBJ2-7
TGTGCCAGCAGCTTCCCGGCGAACACTGAAGCTTTCTTT	CASSFPANTEAFF	TRBV7-8	TRBJ1-1
TGTGCCAGCAGCTTGACCAGTAGCGGTCAGCCCCAGCATTTT	CASSLTSSGQPQHF	TRBV5-6	TRBJ1-5
TGTGCCAGCATCCGACTAATAAATGAGCAGTTCTTC	CASIRLINEQFF	TRBV9	TRBJ2-1
TGCGCCAGCAGCCAAGGGCCGGAGGCTGAAGCTTTCTTT	CASSQGPEAEAFF	TRBV4-1	TRBJ1-1
TGTGCCACCCTGCCCGGGGGGCCCCAAGAGACCCAGTACTTC	CATLPGGPQETQYF	TRBV24-1	TRBJ2-5
TGCAGCGTGTGGGGCGGGGAGCAGTTCTTC	CSVWGGEQFF	TRBV29-1	TRBJ2-1
TGCGCCAGCAGCTTGGGGCCAGACATCGAGCAGTACTTC	CASSLGPDIEQYF	TRBV5-1	TRBJ2-7
TGTGCCAGCAGTGAGACAGGCGGTGGGGGCAATCAGCCCCAGCATTTT	CASSETGGGGNQPQHF	TRBV6-5	TRBJ1-5
TGTGCCAGCAGTCCCCTAACAGGGTATGGCTACACCTTC	CASSPLTGYGYTF	TRBV6-5	TRBJ1-2
TGTGCCAGCATATCCTGGGACAGGCTCGAACGTTCACCCCTCCACTTT	CASISWDRLERSPLHF	TRBV7-3	TRBJ1-6
TGTGCCAGCAGTTACTCGCCGGACAGGCCCATAGAGTTTCCGGCAGTACATCGGGGTAATGAAAAACTGTTTTTT	CASSYSPDRPIEFPAVHRGNEKLFF	TRBV6-6	TRBJ1-4
TGTGCCAGCCTCATCGACAGGCCCTCCTACAATGAGCAGTTCTTC	CASLIDRPSYNEQFF	TRBV27	TRBJ2-1
TGTGCCAGCAGCCAAGATCTTCCGACCGGGACTAGCGGGGGAGATAAGAATGAGCAGTTCTTC	CASSQDLPTGTSGGDKNEQFF	TRBV3-1	TRBJ2-1
TGTGCCAGCAGGCCGGGGGGGCGGGGTTCCTACAATGAGCAGTTCTTC	CASRPGGRGSYNEQFF	TRBV6-5	TRBJ2-1
TGTGCCAGCAGCCAAGAAGCGCCTAATATCTCCTACGAGCAGTACTTC	CASSQEAPNISYEQYF	TRBV4-2	TRBJ2-7
TGTGCCAGCAGTTACTACGGGGAGGGACCGTACTACGAGCAGTACTTC	CASSYYGEGPYYEQYF	TRBV6-5	TRBJ2-7
TGCGCCAGCAGTGCGGGAGGTGCCGAAGCTTTCTTT	CASSAGGAEAFF	TRBV5-1	TRBJ1-1
TGTGCCAGCAGTGAGAACCGGGACCACCATAATTCACCCCTCCACTTT	CASSENRDHHNSPLHF	TRBV25-1	TRBJ1-6
TGTGCCAGCAGCTACATTTTAGGGGGACTAGCGGGTCATACCTCTAGCACAGATACGCAGTATTTT	CASSYILGGLAGHTSSTDTQYF	TRBV5-6	TRBJ2-3
TGTGCCAGCAGTCCCTCTACGGGGGCTGGCTACACCTTC	CASSPSTGAGYTF	TRBV6-2	TRBJ1-2
TGCGCCAGCCAGATTATTGGGGACCGGGACACCAACACCATATATTTT	CASQIIGDRDTNTIYF	TRBV10-1	TRBJ1-3
TGCAGCGTCCCAACGGGACAGGAGACCCAGTACTTC	CSVPTGQETQYF	TRBV29-1	TRBJ2-5
TGCAGTGCTAGAGATGAAGTGGGACAGGGGCGTAACACTGAAGCTTTCTTT	CSARDEVGQGRNTEAFF	TRBV20-1	TRBJ1-1
TGCATTCGGGAAGAGACCCAGTACTTC	CIREETQYF	TRBV20-1	TRBJ2-5
TGTGCCAGCAGCTTAGCGGAGGGGGGTGAAGATCTCAGCACTGAAGCTTTCTTT	CASSLAEGGEDLSTEAFF	TRBV7-9	TRBJ1-1
TGTGCCACCAGAAGGACCCTAAACAGGGATCAGCCCCAGCATTTT	CATRRTLNRDQPQHF	TRBV24-1	TRBJ1-5
