TGCGCCAGCAGCTTGCCATCTAAAAGAGTATGGGGGCGCATCAATAACGAGCAGTACTTC	CASSLPSKRVWGRINNEQYF	TRBV5-1	TRBJ2-7
TGTGCCAGCAGCTTAGTGGCTAAACAGGGAGGACTCACTGAAGCTTTCTTT	CASSLVAKQGGLTEAFF	TRBV7-2	TRBJ1-1
TGTGCCAGCCGATCCAGGGGGTCAGAGACCCAGTACTTC	CASRSRGSETQYF	TRBV18	TRBJ2-5
TGTGCCAGCAGCTCCTCCGGGACAGGGATGTCTGGGGCCAACGTCCTGACTTTC	CASSSSGTGMSGANVLTF	TRBV9	TRBJ2-6
TGTGCCAGCAGCGGCTTACAGGGCTATCAGCCCCAGCATTTT	CASSGLQGYQPQHF	TRBV7-3	TRBJ1-5
TGTGCCAGCATGAGAGTTCCTACTCCCAGCGGGAGTTTCAACACAGATACGCAGTATTTT	CASMRVPTPSGSFNTDTQYF	TRBV3-1	TRBJ2-3
TGTGCCAGCAGAGGGGGGGCCACTGAAGCTTTCTTT	CASRGGATEAFF	TRBV6-5	TRBJ1-1
TGTGCCAGCAGTGGCGGACTAGCCTACGAGCAGTACTTC	CASSGGLAYEQYF	TRBV6-4	TRBJ2-7
TGTGCCAGCTCACCACCGGTGCGCATAGATAGGCGTATTTTTAGCTCCTATAATTCACCCCTCCACTTT	CASSPPVRIDRRIFSSYNSPLHF	TRBV18	TRBJ1-6
TGCAGTGCCTCGGAGGACAGGGCACCCAACTATGGCTACACCTTC	CSASEDRAPNYGYTF	TRBV20-1	TRBJ1-2
TGCGCCAGCAGCTTGGGGGCGGGAGGCAGGACCGAGGACAATGAGCAGTTCTTC	CASSLGAGGRTEDNEQFF	TRBV5-1	TRBJ2-1
TGTGCCAGCAGCTCATGTCCGGGATATGGCTACACCTTC	CASSSCPGYGYTF	TRBV16	TRBJ1-2
TGTGCCAACGGGACTAGCTACGAGCAGTACTTC	CANGTSYEQYF	TRBV27	TRBJ2-7
TGTGCCAGCAGCAGTTCAAGACAGTACCGTAACGAGCAGTACTTC	CASSSSRQYRNEQYF	TRBV7-9	TRBJ2-7
TGTGCCAGCAGCCTATTGGAAGCAGGGGGCAAAAACATTCAGTACTTC	CASSLLEAGGKNIQYF	TRBV14	TRBJ2-4
TGTGCCAGCAGCCTGACGAGGCTTGGAAACACCATATATTTT	CASSLTRLGNTIYF	TRBV9	TRBJ1-3
TGCGCCAGCATTACAGTGATACAATCGGGACTAGGGGGGATAGGTCCCTACGAGCAGTACTTC	CASITVIQSGLGGIGPYEQYF	TRBV5-1	TRBJ2-7
TGTGCCAGCAGTGGGCCACCACGGGGGGAAAGGCATGGAAATCAGCCCCAGCATTTT	CASSGPPRGERHGNQPQHF	TRBV6-2	TRBJ1-5
TGTGCCAGCAGACAGGGACCTCCCGGTTACACTGAAGCTTTCTTT	CASRQGPPGYTEAFF	TRBV28	TRBJ1-1
TGTGCCAGCAGCCAAAAGGGGGCGGAGTCGAACACTGAAGCTTTCTTT	CASSQKGAESNTEAFF	TRBV14	TRBJ1-1
TGTGCCAGCAGAAATAGGAGGGTGAATGAGCAGTTCTTC	CASRNRRVNEQFF	TRBV6-1	TRBJ2-1
TGTGCCAGCAGTAAACCTCAGGGGCTGCTTCCGAGTCAGCCCCAGCATTTT	CASSKPQGLLPSQPQHF	TRBV28	TRBJ1-5
TGTGCCAGCAGGAACTGCCTCGATACGCAGTATTTT	CASRNCLDTQYF	TRBV5-4	TRBJ2-3
TGTGCCAGCCTTCCGTTTTCTCAGCAAGCTAACTATGGCTACACCTTC	CASLPFSQQANYGYTF	TRBV11-3	TRBJ1-2
TGTGCCAGTCCGGCACACCCAGGGACTAGCCCAGATGAGCAGTTCTTC	CASPAHPGTSPDEQFF	TRBV19	TRBJ2-1
TGTGCCAGCAGTTACTCGGACCGGGACAGGGGGGGACGGGTCCCCTACGAGCAGTACTTC	CASSYSDRDRGGRVPYEQYF	TRBV6-3	TRBJ2-7
TGTGCCAGCAGCTTGCACAATGTCCCACAGGGCTTGTCCTACGAGCAGTACTTC	CASSLHNVPQGLSYEQYF	TRBV5-5	TRBJ2-7
TGCGCCAGCAGCTGTTTTGAGCCCCACACTGAAGCTTTCTTT	CASSCFEPHTEAFF	TRBV5-1	TRBJ1-1
TGTGCCACCAGTGAGTGGGGACGTAACGATGACTATGGCTACACCTTC	CATSEWGRNDDYGYTF	TRBV24-1	TRBJ1-2
TGCAGCGTTGGGACAGGGGCTACCTACAATGAGCAGTTCTTC	CSVGTGATYNEQFF	TRBV29-1	TRBJ2-1
TGTGCCAGCATTAGCGCCAATGAGCAGTTCTTC	CASISANEQFF	TRBV7-2	TRBJ2-1
TGTGCCAGCCGAGGGACAGAGGCACTCTTGGCTGGCTACACCTTC	CASRGTEALLAGYTF	TRBV2	TRBJ1-2
TGTGCCTGGCTCTCTAGAAATGAGCAGTTCTTC	CAWLSRNEQFF	TRBV30	TRBJ2-1
TGTGCCAGCAGAGGACGTAAGACAGGGGGCCCAGTTATCTACGAGCAGTACTTC	CASRGRKTGGPVIYEQYF	TRBV2	TRBJ2-7
TGTGCCAGCAGTTACAGGAGGCAGCAGAGCTCTGAAGCTTTCTTT	CASSYRRQQSSEAFF	TRBV6-5	TRBJ1-1
TGTGCCAGCACTCCCGCTTCAACAAGAATCGAAAAACTGTTTTTT	CASTPASTRIEKLFF	TRBV2	TRBJ1-4
TGCAGTGCTAAGGCTCCGGGACACAATCAGCCCCAGCATTTT	CSAKAPGHNQPQHF	TRBV20-1	TRBJ1-5
TGTGCCAGCAGCTTGATGGGGCCAGGGGATAACTATGGCTACACCTTC	CASSLMGPGDNYGYTF	TRBV5-4	TRBJ1-2
TGTGCCAGCAGAGAGCAAGAGGGCAGTGAGCAGTACTTC	CASREQEGSEQYF	TRBV7-9	TRBJ2-7
TGTGCCAGCAGCCACGGGCCGCGGGGGGGCACTTCCTACGAGCAGTACTTC	CASSHGPRGGTSYEQYF	TRBV7-3	TRBJ2-7
TGTGCCAGCAGCTTGTTAAGGCATGGGACAGGCGACGAGCAGTACTTC	CASSLLRHGTGDEQYF	TRBV5-8	TRBJ2-7
TGTGCCACACCTGGACAGGGGTTCGGAAGGAACACTGAAGCTTTCTTT	CATPGQGFGRNTEAFF	TRBV19	TRBJ1-1
TGTGCCAGCAGCTTATCAACCGCCGGGACAGCGGGATTTGAAAAACTGTTTTTT	CASSLSTAGTAGFEKLFF	TRBV7-9	TRBJ1-4
TGTGCCAGCACCAGCGGGAGCTATGGCTACACCTTC	CASTSGSYGYTF	TRBV7-2	TRBJ1-2
TGTGCCAGCAGCCGTGGGACGAAGCTGTGGCAGCAGTACTTC	CASSRGTKLWQQYF	TRBV13	TRBJ2-7
TGTGTGACTCTAGCCAAAAACATTCAGTACTTC	CVTLAKNIQYF	TRBV30	TRBJ2-4
TGTGCCAGCAGTTCTAGCCCTAGTCGCCTGAAGAACACCGGGGAGCTGTTTTTT	CASSSSPSRLKNTGELFF	TRBV27	TRBJ2-2
TGTGCCAGCTCAGACCGGGACAGGGGTAGGGTAATTGAACCCCACGAAAAACTGTTTTTT	CASSDRDRGRVIEPHEKLFF	TRBV18	TRBJ1-4
TGTGCCAGCAGCGGAGGGGACACCTATAATTCACCCCTCCACTTT	CASSGGDTYNSPLHF	TRBV7-9	TRBJ1-6
TGTGCCAGCAGCTTCTCCAATCCAGGGTTCTACGAGCAGTACTTC	CASSFSNPGFYEQYF	TRBV11-3	TRBJ2-7
TGTGCCAGCAGCTTCATGTCAAACTACGAGCAGTACTTC	CASSFMSNYEQYF	TRBV6-5	TRBJ2-7
TGTGCCGGGACAGGGAGAAGGAACACTGAAGCTTTCTTT	CAGTGRRNTEAFF	TRBV6-5	TRBJ1-1
TGTGCCAGCAGCCCCGGAGGCCTGAGAGGTTCCGCTGAAAAACTGTTTTTT	CASSPGGLRGSAEKLFF	TRBV7-7	TRBJ1-4
TGTGCCAGCAGCACCTTAAGGAGTACCGTGTACGACGGAATAGGGAGAGACACCGGGGAGCTGTTTTTT	CASSTLRSTVYDGIGRDTGELFF	TRBV11-3	TRBJ2-2
TGTGCCTGGAGTGTTCCAGGGGGAGACAATGAGCAGTTCTTC	CAWSVPGGDNEQFF	TRBV30	TRBJ2-1
TGCAGCGTTGATCATTGGCCAACGGCTTACGTCTACGAGCAGTACTTC	CSVDHWPTAYVYEQYF	TRBV29-1	TRBJ2-7
TGCAGCGCTCCCTACCGAAGGGAGACCCAGTACTTC	CSAPYRRETQYF	TRBV29-1	TRBJ2-5
TGTGCCAGCAGCCGGGTTTTAGCCCACAATCAGCCCCAGCATTTT	CASSRVLAHNQPQHF	TRBV6-2	TRBJ1-5
TGTGCCAGCAGCTTGCGGGGGCATGAGCAGTTCTTC	CASSLRGHEQFF	TRBV5-4	TRBJ2-1
TGCACCCCACTAGCGGGTGACCCCCGAGGGGTGCTAGAGACCCAGTACTTC	CTPLAGDPRGVLETQYF	TRBV20-1	TRBJ2-5
TGCGCCAGCCCTCCGGACAGGGGCATCTCCAATCAGCCCCAGCATTTT	CASPPDRGISNQPQHF	TRBV10-1	TRBJ1-5
TGTGCCAGCAGCGTAGGAGCATTCTCTGGGGCCAACGTCCTGACTTTC	CASSVGAFSGANVLTF	TRBV9	TRBJ2-6
TGTGCCAGCTCAAGCTGGTGGTACGAGCAGTACTTC	CASSSWWYEQYF	TRBV18	TRBJ2-7
TGTGCCGGGAAAAACAGGGACGACAATCAGCCCCAGCATTTT	CAGKNRDDNQPQHF	TRBV5-6	TRBJ1-5
TGCGCCAGCAGCCGTACGGCGGTTTGGACAGGAGAGACCCAGTACTTC	CASSRTAVWTGETQYF	TRBV4-1	TRBJ2-5
TGTGCCAGCTCACCACCGACGGCCGGGACCTTAAGGAACACTGAAGCTTTCTTT	CASSPPTAGTLRNTEAFF	TRBV18	TRBJ1-1
TGTGCCACCAGCAGTTTAGAGACGCAGTATTTT	CATSSLETQYF	TRBV15	TRBJ2-3
TGTGCCAGCAGTTTAATGGTTATGTCCAATCAGCCCCAGCATTTT	CASSLMVMSNQPQHF	TRBV6-5	TRBJ1-5
TGTGCCAGCACGGGGCACAGACCCTACGAGCAGTACTTC	CASTGHRPYEQYF	TRBV11-1	TRBJ2-7
TGTGCCAGCAGAACCCGTCCGGGACAGTCACCCCTCCACTTT	CASRTRPGQSPLHF	TRBV11-3	TRBJ1-6
TGTGCCAGTCCTGACTGGACTCCGTCCATCGGGTCTGGCTACACCTTC	CASPDWTPSIGSGYTF	TRBV19	TRBJ1-2
TGTGCCAGCAGCCAGGGGGCAACTAATGAAAAACTGTTTTTT	CASSQGATNEKLFF	TRBV7-9	TRBJ1-4
TGCGCCAGCAGCTTGCACCTCTCGACAGGGAGCGAGGGCTACACCTTC	CASSLHLSTGSEGYTF	TRBV5-1	TRBJ1-2
TGTGCCAGCTACGGGACAGGCTACGAGCAGTACTTC	CASYGTGYEQYF	TRBV5-8	TRBJ2-7
TGTGCCAGCAGCCAAGATACGGGACTAGCGGGTGTTCGGACAGCAGAGACCCAGTACTTC	CASSQDTGLAGVRTAETQYF	TRBV3-1	TRBJ2-5
TGCGCCAGCAGCCATGGGCGGGAGGGCGATTACGAGCAGTACTTC	CASSHGREGDYEQYF	TRBV4-3	TRBJ2-7
TGTGCCAGCAGCTTAGCGGACAATCAGCCCCAGCATTTT	CASSLADNQPQHF	TRBV7-3	TRBJ1-5
TGTGCCAGCAGCATATTCGTACTAGCGGGAGCTGGAGAGTACTTC	CASSIFVLAGAGEYF	TRBV5-8	TRBJ2-7
TGTGCCACCAGTGATTTGCAGGGGAGAAGGGGTCGCAATCAGCCCCAGCATTTT	CATSDLQGRRGRNQPQHF	TRBV24-1	TRBJ1-5
TGTGCCAGCAGCTTAGAAACGACAGGGAATTCACCCCTCCACTTT	CASSLETTGNSPLHF	TRBV7-4	TRBJ1-6
TGTGCCGGTCTCAACAGGGTTAAAACTAATGAAAAACTGTTTTTT	CAGLNRVKTNEKLFF	TRBV28	TRBJ1-4
TGTGCCAGCAGCTTAGGGATCTGGATTGAAGCTTTCTTT	CASSLGIWIEAFF	TRBV7-6	TRBJ1-1
TGTGCCAGCAGCTTATACTGGGGCTATGGCTACACCTTC	CASSLYWGYGYTF	TRBV7-7	TRBJ1-2
TGCAGCGGGGGCGACAATGAGCAGTTCTTC	CSGGDNEQFF	TRBV29-1	TRBJ2-1
TGCGCCAGCGGAACCCCTCCAGGCCGACTAGACACCGGGGAGCTGTTTTTT	CASGTPPGRLDTGELFF	TRBV5-1	TRBJ2-2
TGTGCCAGCAGTGAACAAGGACAGGTCTATAATTCACCCCTCCACTTT	CASSEQGQVYNSPLHF	TRBV6-1	TRBJ1-6
TGTGCCAGCAGCCGAAATTTCAGGGAGAACTATGGCTACACCTTC	CASSRNFRENYGYTF	TRBV14	TRBJ1-2
TGTGCCACCAGTGATAGAGTAGGGGCCAACGTCCTGACTTTC	CATSDRVGANVLTF	TRBV24-1	TRBJ2-6
TGTGCCAGTAGTATCTGCTGGACAGGGGATTCCGAGCAGTACTTC	CASSICWTGDSEQYF	TRBV19	TRBJ2-7
TGTGCCAGCAGTGAAGACCCAGGGGGGGAGCAAGAGACCCAGTACTTC	CASSEDPGGEQETQYF	TRBV6-1	TRBJ2-5
TGTGCCAGCAGCCCTGTTTTGAGCACTGAAGCTTTCTTT	CASSPVLSTEAFF	TRBV6-6	TRBJ1-1
TGTGCCAGCAGTGAATTACGGGGGGGGGTGGGGGCCTACAATGAGCAGTTCTTC	CASSELRGGVGAYNEQFF	TRBV25-1	TRBJ2-1
TGTGCAGGCGGACGAGGTAACAGCTCCTACGAGCAGTACTTC	CAGGRGNSSYEQYF	TRBV27	TRBJ2-7
TGCAGTGCTTCCCCCTGGACAGCCGGCTATGGCTACACCTTC	CSASPWTAGYGYTF	TRBV20-1	TRBJ1-2
TGTGCCAGCAGAGGACAGGATAGCAATCAGCCCCAGCATTTT	CASRGQDSNQPQHF	TRBV7-9	TRBJ1-5
TGTGCCAGCAGCTGGGAGGGCTGTCAGCCCCAGCATTTT	CASSWEGCQPQHF	TRBV14	TRBJ1-5
TGCAGCGGGGGGCGGGAGTCCTACAATGAGCAGTTCTTC	CSGGRESYNEQFF	TRBV29-1	TRBJ2-1
TGTGCCACCAGCAGGACTACCGGGGAGCTGTTTTTT	CATSRTTGELFF	TRBV24-1	TRBJ2-2
TGTGCCAGACCGGGACAGGGGTCCTACGAGCAGTACTTC	CARPGQGSYEQYF	TRBV2	TRBJ2-7
TGTGCCTGGAGTGGCCTTTTTATAACTGAAGCTTTCTTT	CAWSGLFITEAFF	TRBV30	TRBJ1-1
TGTGCCAGCAGCTTTTACAGGGCCTGCCTACCGGGCGGGAACACTGAAGCTTTCTTT	CASSFYRACLPGGNTEAFF	TRBV11-3	TRBJ1-1
TGTGCCAGCCCCAGACTAGCGGGGGCTAGCACAGATACGCAGTATTTT	CASPRLAGASTDTQYF	TRBV9	TRBJ2-3
TGTGCCAGGACAGAGCGCACTGAAGCTTTCTTT	CARTERTEAFF	TRBV10-3	TRBJ1-1
TGTGCCTCCAGCGACCCCTCCTACGAGCAGTACTTC	CASSDPSYEQYF	TRBV28	TRBJ2-7
TGTGCCACTAAAGTGGGGAATAGCGAGCAGTACTTC	CATKVGNSEQYF	TRBV19	TRBJ2-7
TGTGCCAGCAGTCCCCCCGCTGGGGCCAACGTCCTGACTTTC	CASSPPAGANVLTF	TRBV28	TRBJ2-6
TGTGCCAGCAGTTACTCGAAGCCGGGACAGGGGACCCTCACTGAAGCTTTCTTT	CASSYSKPGQGTLTEAFF	TRBV6-3	TRBJ1-1
TGTGCCAGCCCGGGCTACACAGATACGCAGTATTTT	CASPGYTDTQYF	TRBV9	TRBJ2-3
TGCGCCAGCAGCTTGTCAGGGTTGCCGGCGACTGAAGCTTTCTTT	CASSLSGLPATEAFF	TRBV5-1	TRBJ1-1
TGTGCCAGCAGCCAGGTCCCGGAGAAGGGGGGAATCCCTGGGGCCAACGTCCTGACTTTC	CASSQVPEKGGIPGANVLTF	TRBV14	TRBJ2-6
TGTGCCAGCAGCTGGGTGGGGGGGTTCTCCTACAATGAGCAGTTCTTC	CASSWVGGFSYNEQFF	TRBV11-3	TRBJ2-1
TGTGCCACCAGTGAAGCCCTCGGGACTAGCGGGGGGCGCTCCTACAATGAGCAGTTCTTC	CATSEALGTSGGRSYNEQFF	TRBV24-1	TRBJ2-1
TGTGCCAGCAGGCACTTGGGACAGGGGGGTCAAAGGTATCCGAACACCGGGGAGCTGTTTTTT	CASRHLGQGGQRYPNTGELFF	TRBV14	TRBJ2-2
TGTGCTAGTGAGATACGGTCCGACGACTTCGAGCAGTACTTC	CASEIRSDDFEQYF	TRBV12-5	TRBJ2-7
TGTGCCAGCAGAAGGCCCTGGACTAGCGGGTCACGGGGTGTGGCAGATACGCAGTATTTT	CASRRPWTSGSRGVADTQYF	TRBV9	TRBJ2-3
TGTGCCTCCGCTCCTGCGGGAGCACTCACAGATACGCAGTATTTT	CASAPAGALTDTQYF	TRBV24-1	TRBJ2-3
TGTGCCAGCAGTGAACCAGTATCAGGGTACTATGGCTACACCTTC	CASSEPVSGYYGYTF	TRBV2	TRBJ1-2
TGCAGTGCTAGAGCAGCGGATGGCTACACCTTC	CSARAADGYTF	TRBV20-1	TRBJ1-2
TGCGCCAGCAGCGGGTACTACGAGCAGTACTTC	CASSGYYEQYF	TRBV5-1	TRBJ2-7
TGTGCCAGCAGTCTCCGCGGAATCAGCTCCTACAATGAGCAGTTCTTC	CASSLRGISSYNEQFF	TRBV6-2	TRBJ2-1
TGTGCCAGCAGCCAGGGGCGCGCGTTTGCCGAGCAGTACTTC	CASSQGRAFAEQYF	TRBV7-8	TRBJ2-7
TGCGCCAGCAGCTGCCGGGCGGCCTCCTACGAGCAGTACTTC	CASSCRAASYEQYF	TRBV5-1	TRBJ2-7
TGCGCCAGCAGCTGCGAGTACGGTAATTGTCCGAACACTGAAGCTTTCTTT	CASSCEYGNCPNTEAFF	TRBV5-1	TRBJ1-1
TGTGCCAGGGAAACTAATAGCAATCAGCCCCAGCATTTT	CARETNSNQPQHF	TRBV5-4	TRBJ1-5
TGCAGTGCATTGGACAGGGCAGGGTTAGTTTCCGGGCGGTTCCCTGAAGCTTTCTTT	CSALDRAGLVSGRFPEAFF	TRBV20-1	TRBJ1-1
TGCGCCAGCAGGGGGGGGGGGGGATCTAGCAAAAACATTCAGTACTTC	CASRGGGGSSKNIQYF	TRBV10-1	TRBJ2-4
TGTGCCAGCAGCCAAGATGGCCCCCGTATGGGGGCAGGGAATACTGAAGCTTTCTTT	CASSQDGPRMGAGNTEAFF	TRBV14	TRBJ1-1
TGCAGCGTTGTGGGAGGAGGGAGAGGTGCTAATCAGCCCCAGCATTTT	CSVVGGGRGANQPQHF	TRBV29-1	TRBJ1-5
TGTGCCAGCAGCCACCCGGAAAGGGATGGCTACACCTTC	CASSHPERDGYTF	TRBV5-5	TRBJ1-2
TGTGCCAGCAGTGACCCCCCCCGGGAGGACAGGGGCATTAATGAAAAACTGTTTTTT	CASSDPPREDRGINEKLFF	TRBV6-4	TRBJ1-4
TGTGCCACCAGCAGAGTACGCAGGAGCGACTCCTACGAGCAGTACTTC	CATSRVRRSDSYEQYF	TRBV15	TRBJ2-7
TGTGCCATCAGTGTGGAAACACGGGTTGGAAAACCAGAGACCCAGTACTTC	CAISVETRVGKPETQYF	TRBV10-3	TRBJ2-5
TGTGCCAGCAGCCTTGGCAGGCAGTCCCGAGCTTTCTTT	CASSLGRQSRAFF	TRBV11-3	TRBJ1-1
TGTGCCAGCAGCTCTGGACACAACTACACTGAAGCTTTCTTT	CASSSGHNYTEAFF	TRBV5-4	TRBJ1-1
TGTGCCAGCAGCGACCCCCGAAGACACACCGGGGAGCTGTTTTTT	CASSDPRRHTGELFF	TRBV13	TRBJ2-2
TGTGCCTGGAGGGGCTACAATCAGCCCCAGCATTTT	CAWRGYNQPQHF	TRBV30	TRBJ1-5
TGTGCCAGCCGACCGTCTTCAAGTTACCTTGCCAAAAACATTCAGTACTTC	CASRPSSSYLAKNIQYF	TRBV9	TRBJ2-4
TGTGCCAGCAGCTTATCCGCGGGGGGAGAGCAGTACTTC	CASSLSAGGEQYF	TRBV5-6	TRBJ2-7
TGTGCCAGCAGGGAAGAGGGAGCGGGGACGAACACCGGGGAGCTGTTTTTT	CASREEGAGTNTGELFF	TRBV2	TRBJ2-2
TGCAGTGCTAGAGCCAGGGTCGGGACGGGTTCCTACGAGCAGTACTTC	CSARARVGTGSYEQYF	TRBV20-1	TRBJ2-7
TGTGCCAGCAGCTGGGGAGGAGGCAGGGAGGGGACCTCCTACGAGCAGTACTTC	CASSWGGGREGTSYEQYF	TRBV11-3	TRBJ2-7
TGTGCCAGCACATTCTGGCCCCCCTACGAGCAGTACTTC	CASTFWPPYEQYF	TRBV27	TRBJ2-7
TGTGCCAGCAGGGCACTGCGGGAGGGAGTCCTCTACGAGCAGTACTTC	CASRALREGVLYEQYF	TRBV12-4	TRBJ2-7
TGTGCCAGCAGCAAGGCCCGAGCGGGACGGGACTACGAGCAGTACTTC	CASSKARAGRDYEQYF	TRBV9	TRBJ2-7
TGTGCCAGCAGCCAGTCAGATACGCAGTATTTT	CASSQSDTQYF	TRBV9	TRBJ2-3
TGTGCCAGCAATCCCGGGACTAGCGGGGAGACCCAGTACTTC	CASNPGTSGETQYF	TRBV6-1	TRBJ2-5
TGTGCCAGCTCACACCGCCCCCCGGGACAGAGCTTTGCAACTAATGAAAAACTGTTTTTT	CASSHRPPGQSFATNEKLFF	TRBV18	TRBJ1-4
TGCGCCAGCAGTGATTGGGCACGGGGACAGGGGGGGGTGAAAGATCTTTCTAGCAATCAGCCCCAGCATTTT	CASSDWARGQGGVKDLSSNQPQHF	TRBV10-1	TRBJ1-5
TGTGCCAGCAGCCCGGGACAGGGTGGGGGAAACTATGGCTACACCTTC	CASSPGQGGGNYGYTF	TRBV7-2	TRBJ1-2
TGCGCCAGCAGTAGAATTCCGGAGGCTAGTCCCTGCTATGGCTACACCTTC	CASSRIPEASPCYGYTF	TRBV10-1	TRBJ1-2
TGTGCCAGCAGCCAAGTTCAGGGGGAAAGCACCAATCAGCCCCAGCATTTT	CASSQVQGESTNQPQHF	TRBV14	TRBJ1-5
TGTGCCAGCAACCCCAAACGGGCTCCCATTAACAGGGGACATGAGCAGTTCTTC	CASNPKRAPINRGHEQFF	TRBV6-5	TRBJ2-1
TGTGCCAGCAGCCAAGAGCCGGGAGGCAACTCCTACAATGAGCAGTTCTTC	CASSQEPGGNSYNEQFF	TRBV14	TRBJ2-1
TGTGCCAGCAGTTACCATAGTCCTAGAGATGGCACAGATACGCAGTATTTT	CASSYHSPRDGTDTQYF	TRBV6-5	TRBJ2-3
TGTGCCAAGATGCAGTTTACCGACTACAATGAGCAGTTCTTC	CAKMQFTDYNEQFF	TRBV12-3	TRBJ2-1
TGTGCCAGCAGTAATGGGGGGGACAGCGTTGATGACCAGCCCCAGCATTTT	CASSNGGDSVDDQPQHF	TRBV6-5	TRBJ1-5
TGCGCCAGCAGCAACGAGACTAGACTTTATGAGCAGTTCTTC	CASSNETRLYEQFF	TRBV5-1	TRBJ2-1
TGTGCCAGCAGCGAAGGAACGCAGCCCCAGCATTTT	CASSEGTQPQHF	TRBV9	TRBJ1-5
TGTGCCAGCAGCAAGAAACGCAAGGAACCCGGGGAGCTGTTTTTT	CASSKKRKEPGELFF	TRBV13	TRBJ2-2
TGCAGTGCTACGACAGGGAGACAGCCCCAGCATTTT	CSATTGRQPQHF	TRBV20-1	TRBJ1-5
TGTGCCAGCACAGGGGGGGTGGACGAGCAGTACTTC	CASTGGVDEQYF	TRBV6-5	TRBJ2-7
TGTGCCAGCAGTCCCTGCCTCAGGGGGCATACGCAGTATTTT	CASSPCLRGHTQYF	TRBV6-4	TRBJ2-3
TGTGCCAGCAGCTTATTCGGGGGCCGGACTAGATTGGAGCAGGAGACCCAGTACTTC	CASSLFGGRTRLEQETQYF	TRBV7-9	TRBJ2-5
TGTGCCAGCAGCCACGAATCTTTTCAACGGGATAGCCAAGAGACCCAGTACTTC	CASSHESFQRDSQETQYF	TRBV14	TRBJ2-5
TGTGCCAGCAGCCGGGGGGGGCGTGGGTTTGGCTACGAGCAGTACTTC	CASSRGGRGFGYEQYF	TRBV5-6	TRBJ2-7
TGTGCCACGCCCCCCCGCCTGAGGGACCTGGGAACTGAAGCTTTCTTT	CATPPRLRDLGTEAFF	TRBV24-1	TRBJ1-1
TGTGCCAGCAGGGACGTATACTACGAGCAGTACTTC	CASRDVYYEQYF	TRBV6-6	TRBJ2-7
TGTGCCAGCAGCCAAGCTTATCGGGGGACACGGAACACTGAAGCTTTCTTT	CASSQAYRGTRNTEAFF	TRBV3-1	TRBJ1-1
TGTGCCACCAGTCCACCGGGACAGGGGGTCCGATCCTACGAGCAGTACTTC	CATSPPGQGVRSYEQYF	TRBV24-1	TRBJ2-7
TGTGCCAGCAGCGGACTAGCGGGCGCGGAGGAGCAAGAGACCCAGTACTTC	CASSGLAGAEEQETQYF	TRBV7-9	TRBJ2-5
TGCGCCAGCGGAAACACGGCCAATCCTAATGAGCAGTTCTTC	CASGNTANPNEQFF	TRBV10-1	TRBJ2-1
TGTGCCAGCAGTCTTCAGCTTCTATCAACAGATACGCAGTATTTT	CASSLQLLSTDTQYF	TRBV6-6	TRBJ2-3
TGTGCCAGCAGCTTGGCGCAAGACGGGCGGCGCGACTCAGATACGCAGTATTTT	CASSLAQDGRRDSDTQYF	TRBV5-6	TRBJ2-3
TGTGCCAGCAGCGGGACAGGGGGGATGAACACTGAAGCTTTCTTT	CASSGTGGMNTEAFF	TRBV13	TRBJ1-1
TGTGCCAGCAGACCAGACAGGGGGGAGAACACTGAAGCTTTCTTT	CASRPDRGENTEAFF	TRBV28	TRBJ1-1
TGTGCCAGCAGCATCCCCGTGAGTCACGAGCAGTACTTC	CASSIPVSHEQYF	TRBV5-4	TRBJ2-7
TGCGCCATGTCTGTGGGGTTTCGATCGGCCTATGGCTACACCTTC	CAMSVGFRSAYGYTF	TRBV10-2	TRBJ1-2
TGTGCCACCAGTGAGGACAGGGGGGCCTCTGAAGCTTTCTTT	CATSEDRGASEAFF	TRBV24-1	TRBJ1-1
TGTGCCAGCAGCTTAGCTTGGGAGGGCGGGGACACTGAAGCTTTCTTT	CASSLAWEGGDTEAFF	TRBV7-9	TRBJ1-1
TGTGCCAGCAGCCAAGCAACCGACAGACCAAGGGTCGACAATCAGCCCCAGCATTTT	CASSQATDRPRVDNQPQHF	TRBV3-1	TRBJ1-5
TGCAGTGCTAGAGTAGGACTAGCTCCCTACAATGAGCAGTTCTTC	CSARVGLAPYNEQFF	TRBV20-1	TRBJ2-1
TGTGCCACCAGTGATTTAACCGGGAGGGGAAGCTCCTACAATGAGCAGTTCTTC	CATSDLTGRGSSYNEQFF	TRBV24-1	TRBJ2-1
TGTGCCAGCAGTGACTCGACCGGTTGGACAGCCCAGCCCCAGCATTTT	CASSDSTGWTAQPQHF	TRBV6-4	TRBJ1-5
TGCGCCGCCTGGGGAGGGTCACGTTGGCCTAATGAGCAGTTCTTC	CAAWGGSRWPNEQFF	TRBV10-1	TRBJ2-1
TGTGCCAGCAGCCGGCTAGCGGGGAAACGAATTGATACGCAGTATTTT	CASSRLAGKRIDTQYF	TRBV7-9	TRBJ2-3
TGTGCCAGTAGTATAGATGGGTCCGGGACAGGGTTACTCCCGGGTTTCTACGAGCAGTACTTC	CASSIDGSGTGLLPGFYEQYF	TRBV19	TRBJ2-7
TGTGCCAGCAGCGTAGCGGACAGATTGGGAGGCACTGAAGCTTTCTTT	CASSVADRLGGTEAFF	TRBV9	TRBJ1-1
TGCGCCAGCAGCCTGACAGGGGGCCAGGGCAATCAGCCCCAGCATTTT	CASSLTGGQGNQPQHF	TRBV5-1	TRBJ1-5
TGTGCCAGCAGTTGGAGCGCTCCACTAGGGGGGGAGGCCTACGAGCAGTACTTC	CASSWSAPLGGEAYEQYF	TRBV6-1	TRBJ2-7
TGTGCTAGTGGTTTGGTACATTGTTGTTTCAGCGGGGCGCAAGAGACCCAGTACTTC	CASGLVHCCFSGAQETQYF	TRBV12-5	TRBJ2-5
TGTGCCAGCAGGGCAGGTCGGCTTAGCTACGAGCAGTACTTC	CASRAGRLSYEQYF	TRBV27	TRBJ2-7
TGTGCCAGCAGCCACTATAGCAATCAGCCCCAGCATTTT	CASSHYSNQPQHF	TRBV13	TRBJ1-5
TGTGCCAGCAGCCTACGGGAACAGTATGGCTACACCTTC	CASSLREQYGYTF	TRBV12-4	TRBJ1-2
TGTGCCAGCAGTGGGTGGGACAGGGGCTCGGATCAGCCCCAGCATTTT	CASSGWDRGSDQPQHF	TRBV6-4	TRBJ1-5
TGTGCTAGTGGTTTGGGATTTACTAGACTCGGACAAGAGACCCAGTACTTC	CASGLGFTRLGQETQYF	TRBV12-5	TRBJ2-5
TGTGCCAGTAGCGGGGGGACTCAAAGCTACGAGCAGTACTTC	CASSGGTQSYEQYF	TRBV19	TRBJ2-7
TGTGCCACCTTCTTGGGGGGTGAAAAACTGTTTTTT	CATFLGGEKLFF	TRBV24-1	TRBJ1-4
TGTGCCAGCAGCGAAGAAAGGACGCTCTACGAGCAGTACTTC	CASSEERTLYEQYF	TRBV13	TRBJ2-7
TGCAGTGCTAGAGGGACCGGGACAGAAAAACTGTTTTTT	CSARGTGTEKLFF	TRBV20-1	TRBJ1-4
TGCGCCAGCAGCTTACCCAGTAAAAGCAATCAGCCCCAGCATTTT	CASSLPSKSNQPQHF	TRBV5-1	TRBJ1-5
TGTGCCAGCAGCTCATCTTTCGGAACTAATGAAAAACTGTTTTTT	CASSSSFGTNEKLFF	TRBV6-4	TRBJ1-4
TGCGCCAGCAGCTTGACATTCCGGACTGAAACGTCCGAGCAGTACTTC	CASSLTFRTETSEQYF	TRBV5-1	TRBJ2-7
TGTGCCAGTAGGACACCCCCGGGACAAGAGGGCGAGCAGTACTTC	CASRTPPGQEGEQYF	TRBV19	TRBJ2-7
TGTGCCAGCAGTCCCGGGGGAACAGATCAGCCCCAGCATTTT	CASSPGGTDQPQHF	TRBV6-2	TRBJ1-5
TGTGCCACCAGCAAGAGGGACAGGGGTAAGGATGAAAAACTGTTTTTT	CATSKRDRGKDEKLFF	TRBV15	TRBJ1-4
TGTGCCAGCAGCTTAGCCGGAGGAGGACATGAGCAGTTCTTC	CASSLAGGGHEQFF	TRBV7-4	TRBJ2-1
TGCAGCGCTACCTCATGTCCTCGTGAGCAGTTCTTC	CSATSCPREQFF	TRBV29-1	TRBJ2-1
TGTGCCAGCAGCATGGGGGGCCAGGAAATGAACACTGAAGCTTTCTTT	CASSMGGQEMNTEAFF	TRBV5-4	TRBJ1-1
TGTGCCAGCAGCTTAGATAGCGGGAAAGGGAACACCGGGGAGCTGTTTTTT	CASSLDSGKGNTGELFF	TRBV7-2	TRBJ2-2
TGCAGTGCCCCACAGGGGGGGGTCAAAGACGAGCAGTACTTC	CSAPQGGVKDEQYF	TRBV20-1	TRBJ2-7
TGTGCCAGCTCCCGGACTAGCGGGGGGGCCGGCAATGAGCAGTTCTTC	CASSRTSGGAGNEQFF	TRBV6-2	TRBJ2-1
TGTGCCAGCAGCTTAGCCCACCATCAGCCCCAGCATTTT	CASSLAHHQPQHF	TRBV7-6	TRBJ1-5
TGTGCCAGCAGCCAAGATATAGAGCGGGGTACATCCACAGATACGCAGTATTTT	CASSQDIERGTSTDTQYF	TRBV14	TRBJ2-3
TGTGCCAGCAGTTCCGGGGTCTCCTACGAGCAGTACTTC	CASSSGVSYEQYF	TRBV2	TRBJ2-7
TGTGCCAGCAGCTTAGGGTGGGACAGGGGCCCGACTGAAGCTTTCTTT	CASSLGWDRGPTEAFF	TRBV7-9	TRBJ1-1
TGTGCCAGCAGCCCACCACAGGAACTGTATGGCTACACCTTC	CASSPPQELYGYTF	TRBV14	TRBJ1-2
TGTGCCAGCAGCCAAGCAGGGAGTTCAAGGGCAACTAATGAAAAACTGTTTTTT	CASSQAGSSRATNEKLFF	TRBV3-1	TRBJ1-4
TGTGCCAGCAGTGACTGGTTTGACAGGGCGTTTTATGGCTACACCTTC	CASSDWFDRAFYGYTF	TRBV2	TRBJ1-2
TGTGCCAGCAGCCAAGTAAGCTACCGGAGAGAGACCCAGTACTTC	CASSQVSYRRETQYF	TRBV3-1	TRBJ2-5
TGTGCCAGCAGTTTTGACTTCGAAAACATTCAGTACTTC	CASSFDFENIQYF	TRBV7-8	TRBJ2-4
TGTGCCAGCATTGAGACAGGGTTCCCCTACGAGCAGTACTTC	CASIETGFPYEQYF	TRBV7-3	TRBJ2-7
TGTGCCATCGAGGGCCGAAGTACCAAAAACATTCAGTACTTC	CAIEGRSTKNIQYF	TRBV10-3	TRBJ2-4
TGTGCCAGCAGCGGGAGAACCATGAACACTGAAGCTTTCTTT	CASSGRTMNTEAFF	TRBV5-4	TRBJ1-1
TGCGCCAGCAGAGACCTAGCCGGGGGCAATGAGCAGTTCTTC	CASRDLAGGNEQFF	TRBV10-1	TRBJ2-1
TGTGCCAGCAGCCTAGGCGAGACCCAGTACTTC	CASSLGETQYF	TRBV13	TRBJ2-5
TGCGCCAGCAGCTGTGAGGGGGGGGCATACAATGAGCAGTTCTTC	CASSCEGGAYNEQFF	TRBV5-1	TRBJ2-1
TGCAGTGCTGTGGAGGGGAGGAGCTCCTACGAGCAGTACTTC	CSAVEGRSSYEQYF	TRBV20-1	TRBJ2-7
TGTGCCAGCAGTCCCTGTCAAGGGTTAAAGGGTTTGAACACTGAAGCTTTCTTT	CASSPCQGLKGLNTEAFF	TRBV6-6	TRBJ1-1
TGTGCCAGCAGCCAAGATCCGACAGGGAACGGGTTTAGTTCCTCCTACAATGAGCAGTTCTTC	CASSQDPTGNGFSSSYNEQFF	TRBV14	TRBJ2-1
TGTGCCAGCAGCCCCCCGCTGGACAGGGGCACAAGCGGATCCACCGGGGAGCTGTTTTTT	CASSPPLDRGTSGSTGELFF	TRBV7-3	TRBJ2-2
TGTGCCAGCAGCTTAGGGGAAAAACAGAGGGGACCTGAAAAACTGTTTTTT	CASSLGEKQRGPEKLFF	TRBV7-9	TRBJ1-4
TGTGCCAGCAGCACAGCCGGGAGGGGGGACACCGGGGAGCTGTTTTTT	CASSTAGRGDTGELFF	TRBV9	TRBJ2-2
TGTGCCAGCTCAGAGGAGGGACAGGGGCAAGAGACCCAGTACTTC	CASSEEGQGQETQYF	TRBV18	TRBJ2-5
TGTGCCAGCAGAAATAGGTACCCCGGGACAGGGAGCCAAGAGACCCAGTACTTC	CASRNRYPGTGSQETQYF	TRBV9	TRBJ2-5
TGTGCCAGTACAGGGAGAGTCTACGAGCAGTACTTC	CASTGRVYEQYF	TRBV19	TRBJ2-7
TGTGCCAGCAGTTTGGATGCGGAAGATGGCTACACCTTC	CASSLDAEDGYTF	TRBV27	TRBJ1-2
TGTGCCAGCAGGACTGTTCCGATGGGGACAGGGGTCAATGAGCAGTTCTTC	CASRTVPMGTGVNEQFF	TRBV14	TRBJ2-1
TGTGCCACCAGTGATTTGAGTGGGACAGCCCAGCCCCAGCATTTT	CATSDLSGTAQPQHF	TRBV24-1	TRBJ1-5
TGCTGGGGACAGAGCCACCAAGAGACCCAGTACTTC	CWGQSHQETQYF	TRBV20-1	TRBJ2-5
TGTGCCAGCAGTGAGACAGTCACCTACGAGCAGTACTTC	CASSETVTYEQYF	TRBV2	TRBJ2-7
TGTGCCAGCAGCGGGGGGGCTGAGCAAACCTACGAGCAGTACTTC	CASSGGAEQTYEQYF	TRBV6-1	TRBJ2-7
TGTGCCAGCAGCCAAGATCCTGAGTTAGAGGGGGACTACGAGCAGTACTTC	CASSQDPELEGDYEQYF	TRBV14	TRBJ2-7
TGTGCCAGCAGTGACGCGGGAGTAGGCTTAGAGACCCAGTACTTC	CASSDAGVGLETQYF	TRBV6-4	TRBJ2-5
TGTGCCAGCAGCCAAGGGGAACTGGGACAAGACCTGGCCTACGAGCAGTACTTC	CASSQGELGQDLAYEQYF	TRBV3-1	TRBJ2-7
TGTGCCAGCAGGACTCTCCGGGACTTGGACACTGAAGCTTTCTTT	CASRTLRDLDTEAFF	TRBV28	TRBJ1-1
TGTGCTAGCAGCTATGTCTCAGGGAATTGGGTCAATGAAAAACTGTTTTTT	CASSYVSGNWVNEKLFF	TRBV7-7	TRBJ1-4
TGTGCCAGCAGCCAAGACCCGGACGGGGACTACGAGCAGTACTTC	CASSQDPDGDYEQYF	TRBV3-1	TRBJ2-7
TGTGCCAGCCATCTAGGACAGGGAAGGAACACTGAAGCTTTCTTT	CASHLGQGRNTEAFF	TRBV3-1	TRBJ1-1
TGTGCCAGCTCATCATATTCCCACCAGCGGACTCAATATGACACTGAAGCTTTCTTT	CASSSYSHQRTQYDTEAFF	TRBV18	TRBJ1-1
TGCAGCGTTGATCACAGGGTTCTCCAACTTTATGGCTACACCTTC	CSVDHRVLQLYGYTF	TRBV29-1	TRBJ1-2
TGTGCTAGTGGTTTGGAGGGGACAGGGGCTGGTACTGAAGCTTTCTTT	CASGLEGTGAGTEAFF	TRBV12-5	TRBJ1-1
TGTGCCACCAGCTTCGCACCGGGACTAGAATGTGAGACCCAGTACTTC	CATSFAPGLECETQYF	TRBV15	TRBJ2-5
TGCGCCAGCATATGTGGCGGGAGGGGCTCCTACGAGCAGTACTTC	CASICGGRGSYEQYF	TRBV10-1	TRBJ2-7
TGTGCCAGCAGAACACCGAGAGCAAACGAGCAGTACTTC	CASRTPRANEQYF	TRBV12-4	TRBJ2-7
TGTGCCTTATCGGGTCGGGACTATGGTAACAATGAGCAGTTCTTC	CALSGRDYGNNEQFF	TRBV24-1	TRBJ2-1
TGTGCCACAGTAACGCCCCCTGATAGCAATCAGCCCCAGCATTTT	CATVTPPDSNQPQHF	TRBV2	TRBJ1-5
TGCGCCAAAGACAGGTTCCATCAAGAGACCCAGTACTTC	CAKDRFHQETQYF	TRBV10-1	TRBJ2-5
TGTGCCAGCAGCCGGTCGAGGGAGAAACAGCCCCAGCATTTT	CASSRSREKQPQHF	TRBV7-3	TRBJ1-5
TGTGCCAGCAGCAAGCCGGGGGGTAAAGAGCAGTACTTC	CASSKPGGKEQYF	TRBV7-3	TRBJ2-7
TGTGCCAGCAGCGTCCTCACCATATATTTT	CASSVLTIYF	TRBV7-2	TRBJ1-3
TGTGCCAGCAGTCCGATTATCGACAGGGGAGGGACTGAAGCTTTCTTT	CASSPIIDRGGTEAFF	TRBV6-2	TRBJ1-1
TGTGCCAGCGACAGCGGGACTGAAGCTTTCTTT	CASDSGTEAFF	TRBV12-3	TRBJ1-1
TGTGCCAGCAGCTTAAAGACCGCCGGGACGGGCAGAGGGAACACTGAAGCTTTCTTT	CASSLKTAGTGRGNTEAFF	TRBV7-3	TRBJ1-1
TGTGCCAGCAGGTCGGGCGGTAGGGGTAGCAGCTCCTATAATTCACCCCTCCACTTT	CASRSGGRGSSSYNSPLHF	TRBV6-1	TRBJ1-6
TGCGCCAGCAGCTTGCGCCATCACGGACATGCCAAAAACATTCAGTACTTC	CASSLRHHGHAKNIQYF	TRBV5-1	TRBJ2-4
TGTGCCAGCAGCTTAACTGACAGGGGAGAGCCTCCTAACTATGGCTACACCTTC	CASSLTDRGEPPNYGYTF	TRBV7-2	TRBJ1-2
TGTGCCAGCAGGTATAGCGGGTACAATGAGCAGTTCTTC	CASRYSGYNEQFF	TRBV6-5	TRBJ2-1
TGCGCCAGCAGCCCGGCCCCGTTATACAATGAGCAGTTCTTC	CASSPAPLYNEQFF	TRBV4-3	TRBJ2-1
TGTGCCAGCAGCTTAGGTGAGGACAGGACAACTAATGAAAAACTGTTTTTT	CASSLGEDRTTNEKLFF	TRBV7-9	TRBJ1-4
TGTGCCAGCAGCCCGCTAGGGGATTCACCCCTCCACTTT	CASSPLGDSPLHF	TRBV9	TRBJ1-6
TGTGCCGTCGGGAACACCGGGGAGCTGTTTTTT	CAVGNTGELFF	TRBV19	TRBJ2-2
TGTCCCCCCGCCACATCGGGACAGGGCGACGGACGGAAGAACACTGAAGCTTTCTTT	CPPATSGQGDGRKNTEAFF	TRBV7-9	TRBJ1-1
TGCAGTGGACAGGGGCGGGACCTAGAGACCCAGTACTTC	CSGQGRDLETQYF	TRBV29-1	TRBJ2-5
TGTGCCAGCAGCCGAGAATGGGCCTCCGGGACAGGGGGGTATTTT	CASSREWASGTGGYF	TRBV4-2	TRBJ1-3
TGTGCCATGATCAATCAGCAAAACTCCTACGAGCAGTACTTC	CAMINQQNSYEQYF	TRBV10-3	TRBJ2-7
TGCGCCAGCAGCTTGGCCCCCCAAAGAAACACTGAAGCTTTCTTT	CASSLAPQRNTEAFF	TRBV5-1	TRBJ1-1
TGCGCCAGCAGCCAAGATGGCAGGGGAGGGGGGCAGTTCTTC	CASSQDGRGGGQFF	TRBV4-1	TRBJ2-1
TGTGCCAGCAGTTACAGGTGCCAGCCGGGGAACACTGAAGCTTTCTTT	CASSYRCQPGNTEAFF	TRBV6-3	TRBJ1-1
TGTGCCAGCAGTGGTCTAAAGGGGATACCAGCCTACGAGCAGTACTTC	CASSGLKGIPAYEQYF	TRBV6-1	TRBJ2-7
TGTGCCAGCAGCCAGAGGGACAGGGGGGTGGACACCGGGGAGCTGTTTTTT	CASSQRDRGVDTGELFF	TRBV4-2	TRBJ2-2
TGTGCCAGCGGGAGGACTAATGAAAAACTGTTTTTT	CASGRTNEKLFF	TRBV10-3	TRBJ1-4
TGTGCCACCAGTGATTTCCGGGGGCTAGTGGGCGAGCAGTACTTC	CATSDFRGLVGEQYF	TRBV24-1	TRBJ2-7
TGTGCCAATATCAGATGCAATGATTATGAGCAGTTCTTC	CANIRCNDYEQFF	TRBV19	TRBJ2-1
TGTGCCAGCAGTTACTTGTACGAAAATGGGTACGAGCAGTACTTC	CASSYLYENGYEQYF	TRBV6-3	TRBJ2-7
TGCGCCAGCAGCTTCCCATACCATTGCTGGAACACTGAAGCTTTCTTT	CASSFPYHCWNTEAFF	TRBV5-1	TRBJ1-1
TGTGCCAGCAGTGGGACAAGCCCAGGGACAGGGAGGGAACAAGAAAAACTGTTTTTT	CASSGTSPGTGREQEKLFF	TRBV6-1	TRBJ1-4
TGTGCCAGCCGGGGAAGCAATCAGCCCCAGCATTTT	CASRGSNQPQHF	TRBV11-3	TRBJ1-5
TGTGCCAGCACCCCCAGGGGAGGAAACACCATATATTTT	CASTPRGGNTIYF	TRBV25-1	TRBJ1-3
TGTGCCAGCAGCGTAGAGGGGGCCCCTAGGTATGAGCAGTTCTTC	CASSVEGAPRYEQFF	TRBV9	TRBJ2-1
TGTGCCACCAGCAGAGATGAGGACAGGGAGCTCACCTACGAGCAGTACTTC	CATSRDEDRELTYEQYF	TRBV15	TRBJ2-7
TGCAGCGTAGCAGCATTTGGCTACACCTTC	CSVAAFGYTF	TRBV29-1	TRBJ1-2
TGTGCCAGCAACGGGAGAGTGTCCCGCGGATACGAGCAGTACTTC	CASNGRVSRGYEQYF	TRBV6-5	TRBJ2-7
TGTGCCAGCAGCTTAGAGGGCTGGGCGGCCTACGAGCAGTACTTC	CASSLEGWAAYEQYF	TRBV7-9	TRBJ2-7
TGCAGCGTTGGGACGTATGGCTACACCTTC	CSVGTYGYTF	TRBV29-1	TRBJ1-2
TGTGCCAGCAGTTGGTTCGGGGTCGGACCGAACACCGGGGAGCTGTTTTTT	CASSWFGVGPNTGELFF	TRBV28	TRBJ2-2
TGTGCCAGCAGTTTAGAGGGAGACTATGGCTACACCTTC	CASSLEGDYGYTF	TRBV27	TRBJ1-2
TGTGCCAGCAGTTTAGCGTCAAACGTGGGGGGGGTCTGGTATGGCTACACCTTC	CASSLASNVGGVWYGYTF	TRBV12-4	TRBJ1-2
TGTGCCACCAAACGACAGGCTAATCAGCCCCAGCATTTT	CATKRQANQPQHF	TRBV24-1	TRBJ1-5
TGTGCCAGCAAGGGGTTACCACGAGCCTACGAGCAGTACTTC	CASKGLPRAYEQYF	TRBV6-2	TRBJ2-7
TGTGCCAGCAGTATCAGGGGGCGGACCGGGGAGCTGTTTTTT	CASSIRGRTGELFF	TRBV12-4	TRBJ2-2
TGTGCCAGCAACTTAGTTATTCCGGGACAGGGGGCGCCGCAGCCCCAGCATTTT	CASNLVIPGQGAPQPQHF	TRBV6-5	TRBJ1-5
TGCAGCGGGCACTTAGGCTACACCTTC	CSGHLGYTF	TRBV29-1	TRBJ1-2
TGTGCTAGCAGCTTAGACAGGGTCATCTCCTACAATGAGCAGTTCTTC	CASSLDRVISYNEQFF	TRBV7-7	TRBJ2-1
TGTGCCATACGGACAGGGGAGTACTTC	CAIRTGEYF	TRBV27	TRBJ2-7
TGTGCCTGGAGTAAATCCAAGGCAAACACAGATACGCAGTATTTT	CAWSKSKANTDTQYF	TRBV30	TRBJ2-3
TGTGCCACCAGTGCGACAGGGGGAGGGTACGAGCAGTACTTC	CATSATGGGYEQYF	TRBV24-1	TRBJ2-7
TGTGCCAGCACAGTTGGGGGGGCCGGGACCTACGAGCAGTACTTC	CASTVGGAGTYEQYF	TRBV6-4	TRBJ2-7
TGTGCCAGCAGCCAGCACGAGGGAATTGGAAACACCATATATTTT	CASSQHEGIGNTIYF	TRBV3-1	TRBJ1-3
TGTGCCAGCAGTTTCGGGGACCCGCTCAGCTCCTACGAGCAGTACTTC	CASSFGDPLSSYEQYF	TRBV12-3	TRBJ2-7
TGCGCCAGCAGCCAAGATACAGGGACACCCGAGGGCACTGGAAACACCATATATTTT	CASSQDTGTPEGTGNTIYF	TRBV4-1	TRBJ1-3
TGTGCCAGCAGCTCCCCCCATGGTAGTAGTTCCTACGAGCAGTACTTC	CASSSPHGSSSYEQYF	TRBV11-3	TRBJ2-7
TGCAGTCCTTGGCTGGGAGGGCAGCCCCAGCATTTT	CSPWLGGQPQHF	TRBV20-1	TRBJ1-5
TGTGCCAGCTCACCCGGGACGGAGACCCAGTACTTC	CASSPGTETQYF	TRBV18	TRBJ2-5
TGTGCCAGCAGTTACACAGGTGGGGCCGAAGGGCGGGGGCTCGGACGCGAGCAGTACTTC	CASSYTGGAEGRGLGREQYF	TRBV6-3	TRBJ2-7
TGCAGTGCTAGACAGGGGGACTTAGACGAGCAGTACTTC	CSARQGDLDEQYF	TRBV20-1	TRBJ2-7
TGTGCCAGCAGCCAGACACCGGGGGCGGCCCCCATACCGAGATCCTACGAGCAGTACTTC	CASSQTPGAAPIPRSYEQYF	TRBV9	TRBJ2-7
TGTGCCAGTAGGTGGCCGGAGGGCTACACCTTC	CASRWPEGYTF	TRBV19	TRBJ1-2
TGCAGTGCTAGGAGGCACAGGGGGGATGAAAAACTGTTTTTT	CSARRHRGDEKLFF	TRBV20-1	TRBJ1-4
TGTGCCAGCAGTGACCTCTGTAACCCTCTAACCAGCTCCTACAATGAGCAGTTCTTC	CASSDLCNPLTSSYNEQFF	TRBV6-4	TRBJ2-1
TGTGCCAGCAGCTTCGACAGGGTTGCCTACGAGCAGTACTTC	CASSFDRVAYEQYF	TRBV11-2	TRBJ2-7
TGTGCTAGTGGTTTGTCAACGGGACAGGGCCATCAGCCCCAGCATTTT	CASGLSTGQGHQPQHF	TRBV12-5	TRBJ1-5
TGCGCCAGCAGCTTGTACCTCAGCGCGGACAGGGTGTACGAAAAACTGTTTTTT	CASSLYLSADRVYEKLFF	TRBV5-1	TRBJ1-4
TGTGCCAGCGGACAGGCGAGCACTGAAGCTTTCTTT	CASGQASTEAFF	TRBV9	TRBJ1-1
TGTGCCAGCAGGGGAATAGGCGCCTACGAGCAGTACTTC	CASRGIGAYEQYF	TRBV6-1	TRBJ2-7
TGCAGTGCTAGTAACCTCGCAGGGTTCTACGAAGAGACCCAGTACTTC	CSASNLAGFYEETQYF	TRBV20-1	TRBJ2-5
TGTGCCAGCAGCTTACCGGGACCAGATACGCAGTATTTT	CASSLPGPDTQYF	TRBV7-8	TRBJ2-3
TGTGCCAGCAGTGAATCGAGGAGCTATGGCTACACCTTC	CASSESRSYGYTF	TRBV6-1	TRBJ1-2
TGCGCCATATGGCCGGGGGGGCTCACCGAGACCCAGTACTTC	CAIWPGGLTETQYF	TRBV5-1	TRBJ2-5
TGTGCCTGGAGTAGCTCCAGCGGGAGGGACAATGAGCAGTTCTTC	CAWSSSSGRDNEQFF	TRBV30	TRBJ2-1
TGTGCCAGCAGCATCCGGGGACGAGAGACCCAGTACTTC	CASSIRGRETQYF	TRBV13	TRBJ2-5
TGTGCCAGCAGCTTCGCAAAGGTGTATTTT	CASSFAKVYF	TRBV5-6	TRBJ2-3
TGTGCCAGCAGCTTACGCTCTGGGGCCAACGTCCTGACTTTC	CASSLRSGANVLTF	TRBV11-3	TRBJ2-6
TGTGCCAGCAGCTTAAAGGGGGCGGGGCAAGAGACCCAGTACTTC	CASSLKGAGQETQYF	TRBV7-6	TRBJ2-5
TGTGCCAGCAAGGTCCCTTGGGGCGGCACTGAAGCTTTCTTT	CASKVPWGGTEAFF	TRBV12-4	TRBJ1-1
TGCAGTGCCACCCGGGACAGCTACGAGCAGTACTTC	CSATRDSYEQYF	TRBV20-1	TRBJ2-7
TGTGCCAGCTTCGGAGAAAAACTGTTTTTT	CASFGEKLFF	TRBV7-3	TRBJ1-4
TGCAGTGCTAGGGAAGGGGGACAGAGCCCCTACGAGCAGTACTTC	CSAREGGQSPYEQYF	TRBV20-1	TRBJ2-7
TGTGCCAGCAGTTACAGGGGTAGCAATCAGCCCCAGCATTTT	CASSYRGSNQPQHF	TRBV27	TRBJ1-5
TGCGCCAGCAGTGAGGAGGTTGGGTTACGGCCTAATGAAAAACTGTTTTTT	CASSEEVGLRPNEKLFF	TRBV10-1	TRBJ1-4
TGTGCCACCCCGGACAGGTCTGATGGCTACACCTTC	CATPDRSDGYTF	TRBV24-1	TRBJ1-2
TGTGCCATCATAAAACGGACAGGGAGTGCAACTAATGAAAAACTGTTTTTT	CAIIKRTGSATNEKLFF	TRBV10-3	TRBJ1-4
TGTGCCAGCAGTTACGGGGGGGGGTTCGGCTACAATGAGCAGTTCTTC	CASSYGGGFGYNEQFF	TRBV6-6	TRBJ2-1
TGTGCCAGTAGGTTGACAGGGTTCCTTCCCGACATTCAGTACTTC	CASRLTGFLPDIQYF	TRBV19	TRBJ2-4
TGTGCCTTCCGGCCCGGGGAGCTGTTTTTT	CAFRPGELFF	TRBV30	TRBJ2-2
TGTGCCAGCAGTTTAGGACAGGGTCATGAGCAGTTCTTC	CASSLGQGHEQFF	TRBV28	TRBJ2-1
TGTGCCAGCAGTGACTCTGGGGTCCTGAACTATGGCTACACCTTC	CASSDSGVLNYGYTF	TRBV6-4	TRBJ1-2
TGTGCCAGCCTGGGGAGCTATGGCTACACCTTC	CASLGSYGYTF	TRBV12-4	TRBJ1-2
TGTGCCACAGGGACAGGGGGCATATCTGGAAACACCATATATTTT	CATGTGGISGNTIYF	TRBV24-1	TRBJ1-3
TGTGCCAGCAGTTACTCCGAGCGGGAAAGTACCGGGGAGCTGTTTTTT	CASSYSERESTGELFF	TRBV6-2	TRBJ2-2
TGTGCCAGCAGTTACTATTTAGGGGTCCTAACGACTGAAGCTTTCTTT	CASSYYLGVLTTEAFF	TRBV6-5	TRBJ1-1
TGTGCCTGGAGGGCGGGCCGTAGTGATCAGCCCCAGCATTTT	CAWRAGRSDQPQHF	TRBV30	TRBJ1-5
TGCAGTGCTAGCCCTTCACCATTTCAGCCCCAGCATTTT	CSASPSPFQPQHF	TRBV20-1	TRBJ1-5
TGTGCCAGCAGACGCTCCTTGTCGAACACCGGGGAGCTGTTTTTT	CASRRSLSNTGELFF	TRBV6-2	TRBJ2-2
TGTGCCAGCAGTTTCAGGCACCCCGACGGTGAGACCCAGTACTTC	CASSFRHPDGETQYF	TRBV12-4	TRBJ2-5
TGCGCCAGCAGCCAAAAGAACGGAGTCGATGAGAGCGAGCAGTACTTC	CASSQKNGVDESEQYF	TRBV5-1	TRBJ2-7
TGTGCCAGCAGCCGGGGCGGGAGACGTCTTCCCTTTGGTAAAAACATTCAGTACTTC	CASSRGGRRLPFGKNIQYF	TRBV12-4	TRBJ2-4
TGTGCCAGCAGTGACCACAGGGGGCAGTCTGGAAACACCATATATTTT	CASSDHRGQSGNTIYF	TRBV6-4	TRBJ1-3
TGTGCCAGCTCAAGTTGCGGACTAGCGGGGACGTCCTACAATGAGCAGTTCTTC	CASSSCGLAGTSYNEQFF	TRBV18	TRBJ2-1
TGCGCCAGCACTGTTGGCTACACCTTC	CASTVGYTF	TRBV10-1	TRBJ1-2
TGTGCCAGCTCACCGGGAGGGACTGTAGAGCAGTACTTC	CASSPGGTVEQYF	TRBV18	TRBJ2-7
TGCAGTGCCGGGGGCGACACTGAAGCTTTCTTT	CSAGGDTEAFF	TRBV20-1	TRBJ1-1
TGTGCCAGCAGCTTAGTTCCTACCACTAGGGGGGAAGTCTACAATGAGCAGTTCTTC	CASSLVPTTRGEVYNEQFF	TRBV7-6	TRBJ2-1
TGTGCCAGCAGCCCCCTGGGGGACTTCAAGGGCTACGAGCAGTACTTC	CASSPLGDFKGYEQYF	TRBV7-2	TRBJ2-7
TGTGCCAGCAGCCAAACGACTAGCGGGAGACCCGCTAATGAAAAACTGTTTTTT	CASSQTTSGRPANEKLFF	TRBV14	TRBJ1-4
TGTGCCAGCAGTTTCAACCACAGGGACCCCTACGAGCAGTACTTC	CASSFNHRDPYEQYF	TRBV12-4	TRBJ2-7
TGTGCCAGCTCACCACACCCTAAAAGGAGGGCAACCCGTGCTGGTGGCTACACCTTC	CASSPHPKRRATRAGGYTF	TRBV18	TRBJ1-2
TGTGCCAGCAGCTCGGTAATCTTCCGACCTCTTCCGAGGGACTATGGCTACACCTTC	CASSSVIFRPLPRDYGYTF	TRBV5-4	TRBJ1-2
TGTGCCAGGAAATGGGGCTCATCCCAGCCCCAGCATTTT	CARKWGSSQPQHF	TRBV27	TRBJ1-5
TGCAGTGCTAGAGAGGAATGGGGTAACTGGGGCAACACTGAAGCTTTCTTT	CSAREEWGNWGNTEAFF	TRBV20-1	TRBJ1-1
TGTGCCAGCAGCTTATTCTGCCATGGGGGGTACATTCAGTACTTC	CASSLFCHGGYIQYF	TRBV11-3	TRBJ2-4
TGCGCCAGCAGGCTGGGGGGCTCGGAGACCAAGCCCCAGCATTTT	CASRLGGSETKPQHF	TRBV10-1	TRBJ1-5
TGCGCCAGCATATCCGGGACAGGGAGCAACTATGGCTACACCTTC	CASISGTGSNYGYTF	TRBV10-1	TRBJ1-2
TGTGCCAGCAGTGGCATCCCATCCTACGAGCAGTACTTC	CASSGIPSYEQYF	TRBV27	TRBJ2-7
TGTGCCAGCAGCTTAGATGACCGACGGATGGGACAGCCCGGGGGCCACTCACCCCTCCACTTT	CASSLDDRRMGQPGGHSPLHF	TRBV11-2	TRBJ1-6
TGTGCCAGCCCCGACAGGCGTTCCCAGTACTTC	CASPDRRSQYF	TRBV9	TRBJ2-5
TGTGCCAGCAGCGTAGCTAGCACAGATACGCAGTATTTT	CASSVASTDTQYF	TRBV9	TRBJ2-3
TGTGCCAGCAGCTTGAAACGGGGGACCCAGTACTTC	CASSLKRGTQYF	TRBV5-6	TRBJ2-5
TGTGCCAGCTCCGGGACAGGGGCCTGTTGCAATCAGCCCCAGCATTTT	CASSGTGACCNQPQHF	TRBV7-2	TRBJ1-5
TGTGCCAGCAGTGACGCCCAGTTTACGGAGAACACCGGGGAGCTGTTTTTT	CASSDAQFTENTGELFF	TRBV6-4	TRBJ2-2
TGTGCCAGCAGTTTATTCCGGGAGGAGTGGCAGCCCCAGCATTTT	CASSLFREEWQPQHF	TRBV27	TRBJ1-5
TGCAGTGCTAGATGGGAACGGGGCCCCGATTTAGAAACTGAAGCTTTCTTT	CSARWERGPDLETEAFF	TRBV20-1	TRBJ1-1
TGTGCCATCAGCCCCGGACGTTGGGAGCAGTACTTC	CAISPGRWEQYF	TRBV10-3	TRBJ2-7
TGTGCCAGCAGCCAAGGTCCCGCGGACAATTCACCCCTCCACTTT	CASSQGPADNSPLHF	TRBV14	TRBJ1-6
TGTGCCAGCAGCCAAAAGGACCTTGCTGGAAACACCATATATTTT	CASSQKDLAGNTIYF	TRBV3-1	TRBJ1-3
TGTGCCAGCAGCTCGAGCGGGACAATGGAGTACTCTGGGGCCAACGTCCTGACTTTC	CASSSSGTMEYSGANVLTF	TRBV11-2	TRBJ2-6
TGCGCCAGCAGCTTTGTAGGGTCGGCGAGCACAGATACGCAGTATTTT	CASSFVGSASTDTQYF	TRBV5-1	TRBJ2-3
TGTGCCAGTAGTATAGATCTCGCAGGGTCGGGCTACGAGCAGTACTTC	CASSIDLAGSGYEQYF	TRBV19	TRBJ2-7
TGCAGCGTTGAAGAGAACAACCGGGGCCCACCCAATCAGCCCCAGCATTTT	CSVEENNRGPPNQPQHF	TRBV29-1	TRBJ1-5
TGTGCCAGCAGTTTATTCACAGGGGCTTCGAACACCGGGGAGCTGTTTTTT	CASSLFTGASNTGELFF	TRBV28	TRBJ2-2
TGTGCCAGCAGCTCTCCCCGGGACAGTGAAGCTTTCTTT	CASSSPRDSEAFF	TRBV5-6	TRBJ1-1
TGCAGTGCTTACGGAGCAGGGGTTCTCTATGGCTACACCTTC	CSAYGAGVLYGYTF	TRBV20-1	TRBJ1-2
TGCGCCAGCCCACCAAAGTACTTC	CASPPKYF	TRBV5-1	TRBJ2-4
TGTGCCAGCAGCTTGGGTCACAGGGTCCAGCCCCAGCATTTT	CASSLGHRVQPQHF	TRBV5-8	TRBJ1-5
TGTGCCAGCAGCCCCCAACGTAAGGGGGAGGAGCAGTACTTC	CASSPQRKGEEQYF	TRBV4-2	TRBJ2-7
TGTGCCAGCAGTCCCACCGTAGTGCGGGTAGGTACAGATACGCAGTATTTT	CASSPTVVRVGTDTQYF	TRBV12-3	TRBJ2-3
TGTGCCAGCAGCTTAGGGGGGGAGCGCTACGAGCAGTACTTC	CASSLGGERYEQYF	TRBV7-9	TRBJ2-7
TGTGCCAGCAGTCCCCGAAGGGGTCCTACTGAAGCTTTCTTT	CASSPRRGPTEAFF	TRBV6-2	TRBJ1-1
TGTGCCAGCGATTCCTCCAGGGGAAAACTGTTTTTT	CASDSSRGKLFF	TRBV6-3	TRBJ1-4
TGCGCCAGCAGCTTAGGACCGGGAGGCCTCACAGATACGCAGTATTTT	CASSLGPGGLTDTQYF	TRBV5-1	TRBJ2-3
TGCAGTGCTAGAGATCTCAGGAAAGGCAGGGGCGCCCACTACGAGCAGTACTTC	CSARDLRKGRGAHYEQYF	TRBV20-1	TRBJ2-7
TGCAGTGACCTCGGGGGGCAGCCCGGGGAGCTGTTTTTT	CSDLGGQPGELFF	TRBV20-1	TRBJ2-2
TGTGCCAGCAGCACCAATATGGGGGGTATAGGATGGTCTGGAAACACCATATATTTT	CASSTNMGGIGWSGNTIYF	TRBV11-2	TRBJ1-3
TGTGCCAGCAGTGAACAGGCACCAGACGAGCAGTACTTC	CASSEQAPDEQYF	TRBV6-1	TRBJ2-7
TGCAGTGCTAGGGGGCCGCGTGGGGCTGAAGCTTTCTTT	CSARGPRGAEAFF	TRBV20-1	TRBJ1-1
TGTGCCAGCAGCACTAAATCCAGTTGCAGCAATCAGCCCCAGCATTTT	CASSTKSSCSNQPQHF	TRBV13	TRBJ1-5
TGTGCCAGCAGCTTTAACCCAGGGGGCGCGAGGGGGGTCGGCTACACCTTC	CASSFNPGGARGVGYTF	TRBV11-1	TRBJ1-2
TGCAGTGCTAGTAATGACAGTTTCAACGAGCAGTACTTC	CSASNDSFNEQYF	TRBV20-1	TRBJ2-7
TGTGCCAGCAGTTATGGGTCACGCCCCGGGACGGTTTATGAGCAGTTCTTC	CASSYGSRPGTVYEQFF	TRBV6-9	TRBJ2-1
TGTGCCAGGCACCACTCTGGAAACACCATATATTTT	CARHHSGNTIYF	TRBV6-1	TRBJ1-3
TGCGCCAGCAGCACGGGGAAGTCGACGGCATACCCCGGTGAAAAACTGTTTTTT	CASSTGKSTAYPGEKLFF	TRBV5-1	TRBJ1-4
TGTGCCAGCAGCCTGAACTGGGACAGGGGGAATCCTCAGCCCCAGCATTTT	CASSLNWDRGNPQPQHF	TRBV7-3	TRBJ1-5
TGTGCCAGCAGTGAAGCCTGGGGGCCCAATCAGCCCCAGCATTTT	CASSEAWGPNQPQHF	TRBV2	TRBJ1-5
TGTGCCAGCAGCTTTGCGGACAATGAAAAACTGTTTTTT	CASSFADNEKLFF	TRBV11-2	TRBJ1-4
TGTGCCAGCAGTGAAGTAGAGGGGTTCTGGGGTCAGTACTTC	CASSEVEGFWGQYF	TRBV2	TRBJ2-5
TGTGCCACCAGCGATTCTCGGGGGACCGATACGCAGTATTTT	CATSDSRGTDTQYF	TRBV15	TRBJ2-3
TGTGCCAGCAGCTTTTACCGCACAGATACGCAGTATTTT	CASSFYRTDTQYF	TRBV7-9	TRBJ2-3
TGCGCCAGCAGCCAAGATCGGAAACAGGAGTACGAGCAGTACTTC	CASSQDRKQEYEQYF	TRBV4-1	TRBJ2-7
TGCGCCAGCAGCGAGCCGGCAGGGAAGTCGGGTAATGAGCAGTTCTTC	CASSEPAGKSGNEQFF	TRBV5-1	TRBJ2-1
TGTGCCATCAGTGGGGGGGAGCAGTACTTC	CAISGGEQYF	TRBV10-3	TRBJ2-7
TGTGCCAGCAGCTTCCTCTTAGGGGTGAACTATGGCTACACCTTC	CASSFLLGVNYGYTF	TRBV11-2	TRBJ1-2
TGTGCCAGCAGTTTATGTAACAGGGGGAACTGCTACGAGCAGTACTTC	CASSLCNRGNCYEQYF	TRBV27	TRBJ2-7
TGTGCCAGCAGCCCCCGTGGCGGGAGAGTAGGCAATCAGCCCCAGCATTTT	CASSPRGGRVGNQPQHF	TRBV11-3	TRBJ1-5
TGCAGTGCTAGAGAAAGTATGAGGACCCCCCCTAACTATGGCTACACCTTC	CSARESMRTPPNYGYTF	TRBV20-1	TRBJ1-2
TGCGCCAGCCCTCCGCACAGGGCTGAAGCTTTCTTT	CASPPHRAEAFF	TRBV5-1	TRBJ1-1
TGTGCCAGGAGCCGGTGGGTTAGGGGGCGCTCCTACGAGCAGTACTTC	CARSRWVRGRSYEQYF	TRBV19	TRBJ2-7
TGTGCCAGCAGTTTAGTCTACAGGGGGGGGAACACTGAAGCTTTCTTT	CASSLVYRGGNTEAFF	TRBV27	TRBJ1-1
TGTGCCAGCAGTGGGTCCGAGATGACAGGTGTCTACGAGCAGTACTTC	CASSGSEMTGVYEQYF	TRBV28	TRBJ2-7
TGCAGTGCAGGTGGGGCTGAAGCTTTCTTT	CSAGGAEAFF	TRBV20-1	TRBJ1-1
TGTGCCACCAGCAGAGATAGGGGGCATGGCTACACCTTC	CATSRDRGHGYTF	TRBV15	TRBJ1-2
TGTGCCAGCAGTGACTCCCGACAGCTCGGCCGCACTAATGAAAAACTGTTTTTT	CASSDSRQLGRTNEKLFF	TRBV6-4	TRBJ1-4
TGCAGCCAACCGGGAGGGCTACCCCAGCAAACTGAAGCTTTCTTT	CSQPGGLPQQTEAFF	TRBV29-1	TRBJ1-1
TGTGCCAGCAGCTTAGGAATCCGCGGGAGATACAAAAACATTCAGTACTTC	CASSLGIRGRYKNIQYF	TRBV7-2	TRBJ2-4
TGTGCCAGCAGAAGAGGTAGCTCCTACAATGAGCAGTTCTTC	CASRRGSSYNEQFF	TRBV7-6	TRBJ2-1
TGTGCCAGCAGTTTCAAGGGCTACGAGCAGTACTTC	CASSFKGYEQYF	TRBV12-3	TRBJ2-7
TGCGCCAGCATTGGGGGACAGGGGGGGGAACGCAGCTCCTATAATTCACCCCTCCACTTT	CASIGGQGGERSSYNSPLHF	TRBV4-1	TRBJ1-6
TGTGCCAGCAGTGGTCCCAGTGGGACAGGGGGATACACTGAAGCTTTCTTT	CASSGPSGTGGYTEAFF	TRBV2	TRBJ1-1
TGCAGCGTTGAAACCAACGAGCAGTACTTC	CSVETNEQYF	TRBV29-1	TRBJ2-7
TGTGCCAGCAGTGAACGCAGGGACCATGAAGCTTTCTTT	CASSERRDHEAFF	TRBV25-1	TRBJ1-1
TGTGCCACCAGCAGTGGGACTAGCCGTCAGTACTTC	CATSSGTSRQYF	TRBV15	TRBJ2-5
TGTGCCAGCAGCTTGGCGGATAGGGGACTAGCGCGGAGCTCCTACAATGAGCAGTTCTTC	CASSLADRGLARSSYNEQFF	TRBV5-6	TRBJ2-1
TGTGCCATCAGAAAGGAGCACAATGAGCAGTTCTTC	CAIRKEHNEQFF	TRBV10-3	TRBJ2-1
TGCGCCAGCAGCCAAGAAGGACGACAGGTCCTCTACGAGCAGTACTTC	CASSQEGRQVLYEQYF	TRBV4-1	TRBJ2-7
TGTGCCAGCAGTCCCCGGGACAGCCGGTACGAGCAGTACTTC	CASSPRDSRYEQYF	TRBV27	TRBJ2-7
TGTGCCAAAGGGGCCTACAATGAGCAGTTCTTC	CAKGAYNEQFF	TRBV6-1	TRBJ2-1
TGCAGCGTTGAAGATCTAAGCGGGATAGAGCAGTACTTC	CSVEDLSGIEQYF	TRBV29-1	TRBJ2-7
TGTGCCAGCAGCGTCCCACAGGGTGGACTCGATTGCAATCAGCCCCAGCATTTT	CASSVPQGGLDCNQPQHF	TRBV9	TRBJ1-5
TGTGCTGCACCCCCGGGACAGGGGAACACCGGGGAGCTGTTTTTT	CAAPPGQGNTGELFF	TRBV27	TRBJ2-2
TGTGCCAGCAGCTTGGGGGGGGCCAGGGAGACCCAGTACTTC	CASSLGGARETQYF	TRBV5-5	TRBJ2-5
TGTGCCAGCAGCTATACAGGACCTGGAAACACCATATATTTT	CASSYTGPGNTIYF	TRBV5-6	TRBJ1-3
TGTGCCAGCAGCCCACAGGGGGCGGGAGAGACCCAGTACTTC	CASSPQGAGETQYF	TRBV9	TRBJ2-5
TGCGCCAGCAGCAGAACAGGAAACTACGAGCAGTACTTC	CASSRTGNYEQYF	TRBV5-1	TRBJ2-7
TGTGCCTCCACCAGGGTTTGGTATAATTCACCCCTCCACTTT	CASTRVWYNSPLHF	TRBV30	TRBJ1-6
TGCGCCAGCAGCTTGGTAATACTCTACGAGCAGTACTTC	CASSLVILYEQYF	TRBV5-1	TRBJ2-7
TGCGCCAGCCGCGTAGGGTACGAGCAGTACTTC	CASRVGYEQYF	TRBV10-1	TRBJ2-7
TGTGCCAGCAGTAAAGTCTGGGGGGAGGGTCAGCCCCAGCATTTT	CASSKVWGEGQPQHF	TRBV12-4	TRBJ1-5
TGTGCCAGCAGTTTTGGGGATTCGGGAGAGAATGAGCAGTTCTTC	CASSFGDSGENEQFF	TRBV7-3	TRBJ2-1
TGCGCCAGCAGCTTGGCCCGTTCAGAGCGGGGGGGAGACGTAGGCTCCTACGAGCAGTACTTC	CASSLARSERGGDVGSYEQYF	TRBV5-1	TRBJ2-7
TGCAGTGCTAGAGCCGACAGGGCGCCCAATCAGCCCCAGCATTTT	CSARADRAPNQPQHF	TRBV20-1	TRBJ1-5
TGTGCCAGCAGTTTACCTCCTCCTAGCCCGGACAGCTATGGCTACACCTTC	CASSLPPPSPDSYGYTF	TRBV28	TRBJ1-2
TGCAGCGTTGACAGGGGGCGCCACAATGAGCAGTTCTTC	CSVDRGRHNEQFF	TRBV29-1	TRBJ2-1
TGTGCCGGCAGGGTTAGTACTTCGGAAAAACTGTTTTTT	CAGRVSTSEKLFF	TRBV6-5	TRBJ1-4
TGTGCCTCCCGACAGGCCGCATACTGTAACTATGGCTACACCTTC	CASRQAAYCNYGYTF	TRBV24-1	TRBJ1-2
TGTGCCAGCAGCTTCACTTCCGGAATTGTGGGACAGGGTGAAAAACTGTTTTTT	CASSFTSGIVGQGEKLFF	TRBV7-9	TRBJ1-4
TGTGGTCATAAACAGGGGGGATGGGAAGAGACCCAGTACTTC	CGHKQGGWEETQYF	TRBV12-3	TRBJ2-5
TGTGCCAGCAGCCCAACAGGGGGCGACTACACTGAAGCTTTCTTT	CASSPTGGDYTEAFF	TRBV13	TRBJ1-1
TGCGCCAGCAGCGGGGGACAGACGGATCTGACTAATGAAAAACTGTTTTTT	CASSGGQTDLTNEKLFF	TRBV5-1	TRBJ1-4
TGCGCCAGCATGGTGGGACAGGGGAAATTCTATGGCTACACCTTC	CASMVGQGKFYGYTF	TRBV10-1	TRBJ1-2
TGTGCCAGCAGCCCGGGGCGCGAGCAGTACTTC	CASSPGREQYF	TRBV7-9	TRBJ2-7
TGTGCCAGCAGCTTGCACAGGGGAGGGATGAACACTGAAGCTTTCTTT	CASSLHRGGMNTEAFF	TRBV7-3	TRBJ1-1
TGTGCCAGCAGCTTATCAGGGGATTTCTGTAATCAGCCCCAGCATTTT	CASSLSGDFCNQPQHF	TRBV7-6	TRBJ1-5
TGTGCCAGCATCCTGGGCATTCTGGAGGTACCCAAGCAGTACTTC	CASILGILEVPKQYF	TRBV27	TRBJ2-7
TGCAGCGTTGAAGATCATCGGCCCATTCGGGACGGCTATGGCTACACCTTC	CSVEDHRPIRDGYGYTF	TRBV29-1	TRBJ1-2
TGCGCCAGCAGCTTGGGTGGGTTCAGGGTTCCCTATGGCTACACCTTC	CASSLGGFRVPYGYTF	TRBV5-1	TRBJ1-2
TGCAGTGCTAGAGCGGTGACACAGGACGGGCAGTTGGCTTTCTTT	CSARAVTQDGQLAFF	TRBV20-1	TRBJ1-1
TGCAGTGCGGTGGGGGGTTGGGACAGTCGAAAAACCTACGAGCAGTACTTC	CSAVGGWDSRKTYEQYF	TRBV20-1	TRBJ2-7
TGCAGTGCTACAGGGGTTAGGTCCTACGAGCAGTACTTC	CSATGVRSYEQYF	TRBV20-1	TRBJ2-7
TGTGCCAGCAGTGTATACCCGGGGGGGCGGGCCTACGAGCAGTACTTC	CASSVYPGGRAYEQYF	TRBV6-4	TRBJ2-7
TGTGCCAGCAGCACCACAGGACAGAATCAGCCCCAGCATTTT	CASSTTGQNQPQHF	TRBV13	TRBJ1-5
TGTGCCAGCACTGATACCGACAACGGGGGGGGTGCTCAGCCCCAGCATTTT	CASTDTDNGGGAQPQHF	TRBV9	TRBJ1-5
TGTGCCAGCAGTTCGACGCTACCAAAGAACACTGAAGCTTTCTTT	CASSSTLPKNTEAFF	TRBV6-2	TRBJ1-1
TGTGCCAGCAGCTTGGAGGTGGACTCCACCGGGGAGCTGTTTTTT	CASSLEVDSTGELFF	TRBV5-4	TRBJ2-2
TGTGCCAGCAGCTTAGACGGATTCTCCACCGGGGAGCTGTTTTTT	CASSLDGFSTGELFF	TRBV7-3	TRBJ2-2
TGTGCCAGCAGCTTGGAGCGGGACAGGGAACGAGGAGATAGCAATCAGCCCCAGCATTTT	CASSLERDRERGDSNQPQHF	TRBV7-8	TRBJ1-5
TGTGCCACCAGTGAGAGGGGGACAGCCAAAAACATTCAGTACTTC	CATSERGTAKNIQYF	TRBV24-1	TRBJ2-4
TGTGCCAGCAGTTACAGGCAGGGGTGGAGGTCTTGCTCCTACGAGCAGTACTTC	CASSYRQGWRSCSYEQYF	TRBV6-5	TRBJ2-7
TGTGCCAGCAGTTTCACTGGGGGGGCCTACGAGCAGTACTTC	CASSFTGGAYEQYF	TRBV6-3	TRBJ2-7
TGCAGTGCAGGTTTCTCGACTGCGGGAGGTAGCAATCAGCCCCAGCATTTT	CSAGFSTAGGSNQPQHF	TRBV20-1	TRBJ1-5
TGCGCCAGCAGCCCGGACATTGCGGGTTCTAACTATGGCTACACCTTC	CASSPDIAGSNYGYTF	TRBV5-1	TRBJ1-2
TGTGCCAGCAGCGTGAAAGGGACAGGTTCGGAGCTGTTTTTT	CASSVKGTGSELFF	TRBV9	TRBJ2-2
TGTGCCTGGCGGTTAGAGCCCCAGCATTTT	CAWRLEPQHF	TRBV30	TRBJ1-5
TGTGCCAGCACCGTTCGACACGGTAACACCATATATTTT	CASTVRHGNTIYF	TRBV12-4	TRBJ1-3
TGTGCCAGCAGGGAACCCTACGAGCAGTACTTC	CASREPYEQYF	TRBV9	TRBJ2-7
TGTGCCAGCCCACAGGCCCAGGGCGGTTCACCCCTCCACTTT	CASPQAQGGSPLHF	TRBV12-3	TRBJ1-6
TGTGCCAGCAGTCCCAAAAGGGGGGACCAAGAGACCCAGTACTTC	CASSPKRGDQETQYF	TRBV6-1	TRBJ2-5
TGTGCCATCAACACCGGGACAGGGGCAGATACGCAGTATTTT	CAINTGTGADTQYF	TRBV10-3	TRBJ2-3
TGTGCCAGCAGCTTAGACCCCCGGGACAGGGTTCCCCAGCATTTT	CASSLDPRDRVPQHF	TRBV7-2	TRBJ1-5
TGTGCCAGCAGCCAAGGGGGGGCATTACGCGGGCAGGTCTATGGCTACACCTTC	CASSQGGALRGQVYGYTF	TRBV3-1	TRBJ1-2
TGTGCCAGCTCACCACGACAGGGAAACTATGGCTACACCTTC	CASSPRQGNYGYTF	TRBV18	TRBJ1-2
TGTGCCAGCAGCTTGTCTTTGACGAGCTCCGGGCAAGAGACCCAGTACTTC	CASSLSLTSSGQETQYF	TRBV5-6	TRBJ2-5
TGTGCCAGCAGTACACAGGGCTGTTACGAGCAGTACTTC	CASSTQGCYEQYF	TRBV27	TRBJ2-7
TGTGCCAGCAGCCACCTAGCGGGGGGGGTCAGCACAGATACGCAGTATTTT	CASSHLAGGVSTDTQYF	TRBV3-1	TRBJ2-3
TGTGCCAGCAGCTTAGAGGAACCGGGGGGTTATTCACCCCTCCACTTT	CASSLEEPGGYSPLHF	TRBV7-4	TRBJ1-6
TGTGCCAGCAGATTAACTAGCGGGAGACTATACGAGCAGTACTTC	CASRLTSGRLYEQYF	TRBV6-2	TRBJ2-7
TGTGCCAGCAGCTTACTGGAAGACAGGCCTAGCAATCAGCCCCAGCATTTT	CASSLLEDRPSNQPQHF	TRBV7-2	TRBJ1-5
TGTGCCAGCAGCCTGGGCCCACAGGAGGCTGGAAACACCATATATTTT	CASSLGPQEAGNTIYF	TRBV14	TRBJ1-3
TGTGCCTGGAAATCAAACCTAAACGACGAGCAGTACTTC	CAWKSNLNDEQYF	TRBV30	TRBJ2-7
TGTGCCAGCAGCACCGGGACAGGGGGGGGTCGGCCCCAGCATTTT	CASSTGTGGGRPQHF	TRBV7-9	TRBJ1-5
TGTGCCAGCAGCGACGGGCTAGGCTTCCACCCGGGGGGTCGGAACATTCCCATATATTTT	CASSDGLGFHPGGRNIPIYF	TRBV5-4	TRBJ1-3
TGTGCCAGCAGCGCCACAGGGGGCACAGATACGCAGTATTTT	CASSATGGTDTQYF	TRBV13	TRBJ2-3
TGTGCCAGCACCCAGGGGTCCCGAGAATCTGGCTACGAGCAGTACTTC	CASTQGSRESGYEQYF	TRBV27	TRBJ2-7
TGCGCCAGCGGCGGACGCCACGAGCAGTACTTC	CASGGRHEQYF	TRBV10-1	TRBJ2-7
TGTGCCAGCAGCTTAGTTAGGGGGGAGGCTGGAAAGTCCTACAATGAGCAGTTCTTC	CASSLVRGEAGKSYNEQFF	TRBV11-3	TRBJ2-1
TGTGCCACCAGCCTGGCGGGAGGGGGGGTAGATACGCAGTATTTT	CATSLAGGGVDTQYF	TRBV15	TRBJ2-3
TGTGCCAGCAGTTTATCGAGCCGGGACATAGCCCGTTTCTTT	CASSLSSRDIARFF	TRBV27	TRBJ1-1
TGTGCCAGCAGCACCGGTGAGCAGTTCTTC	CASSTGEQFF	TRBV7-4	TRBJ2-1
TGTGCCACCAGTGATATGGGGCCCCCGGTCGAGCAGTACTTC	CATSDMGPPVEQYF	TRBV24-1	TRBJ2-7
TGTGCCAGCAGCCAAGATACTGATACGCAGTATTTT	CASSQDTDTQYF	TRBV14	TRBJ2-3
TGCGCCAGCAGCCTAGGGGACAGCAATCAGCCCCAGCATTTT	CASSLGDSNQPQHF	TRBV5-1	TRBJ1-5
TGTGCCAGCAGCCGTGGGACCGCAGATACGCAGTATTTT	CASSRGTADTQYF	TRBV13	TRBJ2-3
TGCAGTGCTGGTACAGGAAATAGCAATCAGCCCCAGCATTTT	CSAGTGNSNQPQHF	TRBV20-1	TRBJ1-5
TGTGCCAGCAGCTCAGGGGGCGGTAGCCTCCCCGAGACCCAGTACTTC	CASSSGGGSLPETQYF	TRBV7-9	TRBJ2-5
TGTGCCAAACTTGCTTGCACAGATACGCAGTATTTT	CAKLACTDTQYF	TRBV12-4	TRBJ2-3
TGTGCCAGCAGCTTAGTATCCGGGAGGGTGCTGAATGAGCAGTTCTTC	CASSLVSGRVLNEQFF	TRBV7-9	TRBJ2-1
TGTGCCAGCAAAAGAAAGGAAAAACTGTTTTTT	CASKRKEKLFF	TRBV3-1	TRBJ1-4
TGTGCCAGCAGCGATCGGCCCTACTCAAGACAGTACCAAGAGACCCAGTACTTC	CASSDRPYSRQYQETQYF	TRBV7-3	TRBJ2-5
TGCAGCGGGACCCAGCAGGGGGCGGGCTCAGAGACCCAGTACTTC	CSGTQQGAGSETQYF	TRBV29-1	TRBJ2-5
TGTGCCAGCAGTCCGAGGGGAATCTCTGGAAACACCATATATTTT	CASSPRGISGNTIYF	TRBV6-5	TRBJ1-3
TGTGCCAACCAGGACAGAGACACAGATACGCAGTATTTT	CANQDRDTDTQYF	TRBV10-3	TRBJ2-3
TGTGCCAGTACCGGGGTCATTTACGAGCAGTACTTC	CASTGVIYEQYF	TRBV19	TRBJ2-7
TGTGCCTGGATCCCCAGGGGCTATTCACCCCTCCACTTT	CAWIPRGYSPLHF	TRBV30	TRBJ1-6
TGTGCCAGCAGTGCGCGAAATTTACCTAGTTACAATGAGCAGTTCTTC	CASSARNLPSYNEQFF	TRBV6-4	TRBJ2-1
TGTGCCAGCAGCCTGAGCGGAAACACCATATATTTT	CASSLSGNTIYF	TRBV7-2	TRBJ1-3
TGTGCCAGCAGCAACCCGGCAGACCATGAGGCAGATACGCAGTATTTT	CASSNPADHEADTQYF	TRBV7-3	TRBJ2-3
TGTGCCAGCAGCTTACCTAGTTCGAGCTCCTACAATGAGCAGTTCTTC	CASSLPSSSSYNEQFF	TRBV7-9	TRBJ2-1
TGTGCCAGCAGCTACGTAAGGGGTAACACTAACTATGGCTACACCTTC	CASSYVRGNTNYGYTF	TRBV5-6	TRBJ1-2
TGTGCCAGCAGCGACTGCTGCTACGAGCAGTACTTC	CASSDCCYEQYF	TRBV9	TRBJ2-7
TGTGCCAGCAGTTATAAGGCCATAGACCCGGACAGGACCGGGGAGCTGTTTTTT	CASSYKAIDPDRTGELFF	TRBV6-5	TRBJ2-2
TGTGCCAGCAGCCAAATCCCTAGTCAAACCAATCAGCCCCAGCATTTT	CASSQIPSQTNQPQHF	TRBV3-1	TRBJ1-5
TGCGCCAGCAGTGAGCCGGGGTTCGGGGCTGAAGCTTTCTTT	CASSEPGFGAEAFF	TRBV10-1	TRBJ1-1
TGTGCCTGGCTAAGAAGGTCCTACGAGCAGTACTTC	CAWLRRSYEQYF	TRBV30	TRBJ2-7
TGTGCCAGCAGCTTAAAAGAGGGGGCACTGTACAATGAGCAGTTCTTC	CASSLKEGALYNEQFF	TRBV7-9	TRBJ2-1
TGCAGTGCTAGGAGACAGGGCCCCAGCAATCAGCCCCAGCATTTT	CSARRQGPSNQPQHF	TRBV20-1	TRBJ1-5
TGCGCCAGCAGCGAAGAGGACAGTCTGAACACTGAAGCTTTCTTT	CASSEEDSLNTEAFF	TRBV5-1	TRBJ1-1
TGTGCCAGCAGCCCTCAGTGGCGGGCCGGCTACACCTTC	CASSPQWRAGYTF	TRBV13	TRBJ1-2
TGTGCCAGCAGCGCTCTTGCGGGGGGGCCCACAGATACGCAGTATTTT	CASSALAGGPTDTQYF	TRBV13	TRBJ2-3
TGTGCCAGCAGCGGGGGTAGGAATCAGCCCCAGCATTTT	CASSGGRNQPQHF	TRBV6-5	TRBJ1-5
TGTGCCAGCAGCCGTCGGGACAGGGAGACCCAGTACTTC	CASSRRDRETQYF	TRBV14	TRBJ2-5
TGCGCCAGCAGTGAGACCTGGGCCAGCGGGGAGACCCAGTACTTC	CASSETWASGETQYF	TRBV10-1	TRBJ2-5
TGTGGGGGGGGGTGCAATTCACCCCTCCACTTT	CGGGCNSPLHF	TRBV10-3	TRBJ1-6
TGTGCCAGCAGCGCCAAGAGGGAAGGCGGGGGGGGCTTCGGCCGTGAGCAGTTCTTC	CASSAKREGGGGFGREQFF	TRBV7-3	TRBJ2-1
TGCGCCAGCAGCCAATACTTCACTGAAGCTTTCTTT	CASSQYFTEAFF	TRBV5-1	TRBJ1-1
TGTGCCTGGAGTGTACTCGGGAGGGCCTCCTACGAGCAGTACTTC	CAWSVLGRASYEQYF	TRBV30	TRBJ2-7
TGTGCCAGTAGTATAGACCGGCCATGGGGGGTATATGGCTACACCTTC	CASSIDRPWGVYGYTF	TRBV19	TRBJ1-2
TGTGCCAGCAGCAAGAAGCAGGACAAGACAGGGGCCGGTGGCTACACCTTC	CASSKKQDKTGAGGYTF	TRBV11-2	TRBJ1-2
TGCAGCGTTGAGGCTCGCCAGGGATGGGCGGGCTACGAGCAGTACTTC	CSVEARQGWAGYEQYF	TRBV29-1	TRBJ2-7
TGTGCCAGCAGCCAATCGTCAAGGGGGCTGGAAGCTTTCTTT	CASSQSSRGLEAFF	TRBV14	TRBJ1-1
TGTGCCAGCAGCACGGACAACTTCAATGAGCAGTTCTTC	CASSTDNFNEQFF	TRBV7-3	TRBJ2-1
TGTGCCAGTAGTAGGCGTTTCCATGGGGGGTTCAGGGGCACAGATACGCAGTATTTT	CASSRRFHGGFRGTDTQYF	TRBV19	TRBJ2-3
TGTGCCAGCAGGGGACTAGCGGGGGGTGGGGAGCAGTTCTTC	CASRGLAGGGEQFF	TRBV7-9	TRBJ2-1
TGTGCCAGCAGCCCCCTCAAACCGGGACAAATTCCTCTAGAAGACACTGAAGCTTTCTTT	CASSPLKPGQIPLEDTEAFF	TRBV7-3	TRBJ1-1
TGTGCCAGTGACAGGGGCCGCTCTGGGGCCAACGTCCTGACTTTC	CASDRGRSGANVLTF	TRBV6-1	TRBJ2-6
TGTGCCAGCAGTTTCTTTCCCAGAATACAGGGAGAGACCCAGTACTTC	CASSFFPRIQGETQYF	TRBV28	TRBJ2-5
TGTGCCAGCAGTAAGGGCCGGGTACACACTGAAGCTTTCTTT	CASSKGRVHTEAFF	TRBV6-4	TRBJ1-1
TGTGCCAGCCGGGGGTGGTTGGGGGGCTGCACAGATACGCAGTATTTT	CASRGWLGGCTDTQYF	TRBV19	TRBJ2-3
TGCGCCACCCTGGTTAGGAACTACGAGCAGTACTTC	CATLVRNYEQYF	TRBV5-1	TRBJ2-7
TGTGCCATCAGTGAAAGTACGGGGCCCCAGCATTTT	CAISESTGPQHF	TRBV10-3	TRBJ1-5
TGTGCCAGCAGTTACTCGCTCCCGGGACGTTACGAGCAGTACTTC	CASSYSLPGRYEQYF	TRBV6-2	TRBJ2-7
TGTGCCAGCAGCCCTGAGAAATCAACAGGGGGAACTGAAGCTTTCTTT	CASSPEKSTGGTEAFF	TRBV13	TRBJ1-1
TGTGCCATCAGCCATGCCGGGACGCCTGTGGGAGGGGAGCCCCCTTTTTCCACTGAAGCTTTCTTT	CAISHAGTPVGGEPPFSTEAFF	TRBV10-3	TRBJ1-1
TGTGCCAGCAGACTAGCGGGCCGCGGCTCCTACAATGAGCAGTTCTTC	CASRLAGRGSYNEQFF	TRBV6-4	TRBJ2-1
TGTGCCAGCACTTGGTCATTCAGGGGGCTAGACACAGATACGCAGTATTTT	CASTWSFRGLDTDTQYF	TRBV9	TRBJ2-3
TGTGCCAGCAGCACGCCGCAAGTGGACAGGGGGCGATTTAGATCTGGAAACACCATATATTTT	CASSTPQVDRGRFRSGNTIYF	TRBV28	TRBJ1-3
TGTGCTAGTGGGCCTACAGGGAGAGCTGAAGCTTTCTTT	CASGPTGRAEAFF	TRBV12-5	TRBJ1-1
TGTGCCAGCAGGAAAACGGGACATCCCGATCTTCCAGGCTCCTACGAGCAGTACTTC	CASRKTGHPDLPGSYEQYF	TRBV6-1	TRBJ2-7
TGTGCTAGTGGTCTAAAGGGCGCCTACGAGCAGTACTTC	CASGLKGAYEQYF	TRBV12-5	TRBJ2-7
TGTGCCAGCAGGTTTGCTCGGGGGGCCGACAATGAGCAGTTCTTC	CASRFARGADNEQFF	TRBV5-6	TRBJ2-1
TGTGCCAGCAGCTTGGACAGCTATGGCTACACCTTC	CASSLDSYGYTF	TRBV5-5	TRBJ1-2
TGTGCCACCAGTGATAGGTACTCACCGGGACAGGGGCTCTTATACGAGCAGTACTTC	CATSDRYSPGQGLLYEQYF	TRBV24-1	TRBJ2-7
TGTGCCAGCAGCTTCACTATATCGAGGGATACGCAGTATTTT	CASSFTISRDTQYF	TRBV11-3	TRBJ2-3
TGTGCCAGCTCACCACTAGTTGGGGGGCCGCCCATAGTTGCAACTAATGAAAAACTGTTTTTT	CASSPLVGGPPIVATNEKLFF	TRBV18	TRBJ1-4
TGTGCCAGCAGCCGGGGCCAGGGCTTTACTGAAGCTTTCTTT	CASSRGQGFTEAFF	TRBV3-1	TRBJ1-1
TGTGCCAGCAGTGAGGGGACAGGGCGGAACACTGAAGCTTTCTTT	CASSEGTGRNTEAFF	TRBV12-4	TRBJ1-1
TGCGCCAGCAGTGATCCTCAATACACCGCTGGGGCCAACGTCCTGACTTTC	CASSDPQYTAGANVLTF	TRBV10-2	TRBJ2-6
TGTGCCATCTGGAGGGAGGCCTACGAGCAGTACTTC	CAIWREAYEQYF	TRBV10-3	TRBJ2-7
TGTGCAGTTGGACGGAGGTGCAATCAGCCCCAGCATTTT	CAVGRRCNQPQHF	TRBV7-2	TRBJ1-5
TGTGCCTGGCAGGGGGCCCCTAAGCCACACGGAGGGACAGGGGGCTACGAGCAGTACTTC	CAWQGAPKPHGGTGGYEQYF	TRBV30	TRBJ2-7
TGTGCCAGCAGCTTAGATAGCGGTACGGAGCAGTACTTC	CASSLDSGTEQYF	TRBV11-3	TRBJ2-7
TGTGCCAGCAGCTCTGGGGGGTCTGGCTACGAGCAGTACTTC	CASSSGGSGYEQYF	TRBV6-1	TRBJ2-7
TGTGCCACCCACAGCTACGAGCAGTACTTC	CATHSYEQYF	TRBV10-3	TRBJ2-7
TGTGCCAGCAGCTTAGATCACCTGGGTAGCACTGAAGCTTTCTTT	CASSLDHLGSTEAFF	TRBV11-2	TRBJ1-1
TGTGCCAGCAGCTTAGGTAAGGAGCCCCAGGACGCCCACACCTTC	CASSLGKEPQDAHTF	TRBV7-4	TRBJ1-2
TGTGCCAGCAGTTACGAATCGCAGGAGGGCTCCTACGAGCAGTACTTC	CASSYESQEGSYEQYF	TRBV6-6	TRBJ2-7
TGTGCCAGCAGTCAGAGGGGGGACTACGAGCAGTACTTC	CASSQRGDYEQYF	TRBV12-3	TRBJ2-7
TGTGCCAGCAGTTTTTGGGGCAAAGGCACCGGGGAGCTGTTTTTT	CASSFWGKGTGELFF	TRBV12-3	TRBJ2-2
TGTGCCAGCAGCTGTTTGTCCCCCAGGGGGGCCTATGGCTACACCTTC	CASSCLSPRGAYGYTF	TRBV11-2	TRBJ1-2
TGTGCCAGCAGCTTAGCCGTTTCAGGGCCCTCTGGAAACACCATATATTTT	CASSLAVSGPSGNTIYF	TRBV11-2	TRBJ1-3
TGTGCCTGGAGTGGCTTAGATCATTATAGCAATCAGCCCCAGCATTTT	CAWSGLDHYSNQPQHF	TRBV30	TRBJ1-5
TGTGCCATCAGTGAGTCGTTGGGGGTGTTAGGTGATACGCAGTATTTT	CAISESLGVLGDTQYF	TRBV10-3	TRBJ2-3
TGTGCCAGCAGTGAAGGCGTGCCTTTACCTCGGGGGGCCTATGGCTACACCTTC	CASSEGVPLPRGAYGYTF	TRBV6-1	TRBJ1-2
TGTGCCAGCAGCTTGAGAGGAAAGCTAGCGGGGCCGCAGTTCTTC	CASSLRGKLAGPQFF	TRBV5-8	TRBJ2-1
TGTGCCAGCAGTGACTCACCTATCCAGGGGGCGGGAACTAACTATGGCTACACCTTC	CASSDSPIQGAGTNYGYTF	TRBV6-4	TRBJ1-2
TGCAGTGCCAGAAGTTGGAGGGCGGCCTATAGCAATCAGCCCCAGCATTTT	CSARSWRAAYSNQPQHF	TRBV20-1	TRBJ1-5
TGTGCCAGCAGCAGTTCTGGGAGGTTTGAAAAACTGTTTTTT	CASSSSGRFEKLFF	TRBV7-3	TRBJ1-4
TGTGCCAGCAGTAGACAGGGCAGAAGCTCCTACAATGAGCAGTTCTTC	CASSRQGRSSYNEQFF	TRBV5-6	TRBJ2-1
TGTGCCAGCTTAGGTGGGGGGGGTCGCAATCAGCCCCAGCATTTT	CASLGGGGRNQPQHF	TRBV7-2	TRBJ1-5
TGCGCCAGCGACGGGGGAAACCAAGAGACCCAGTACTTC	CASDGGNQETQYF	TRBV5-1	TRBJ2-5
TGTGCCAGCAGTTTATGGGACAGGGGGGGTAGCACAGATACGCAGTATTTT	CASSLWDRGGSTDTQYF	TRBV28	TRBJ2-3
TGTGCCAGCAGCCAAGTGCGGCCCGGCCTTAAAGGTAACACCGGGGAGCTGTTTTTT	CASSQVRPGLKGNTGELFF	TRBV3-1	TRBJ2-2
TGTGCCACCAGTCGGAAGCCCCCTAGCGAAAAGAGACCCTACGAGCAGTACTTC	CATSRKPPSEKRPYEQYF	TRBV24-1	TRBJ2-7
TGTGCCAGCGGGAGTCGGAGGGGGGATAGCAATCAGCCCCAGCATTTT	CASGSRRGDSNQPQHF	TRBV27	TRBJ1-5
TGCAGTGCTAGAGGGTCGGACAGGGGGACCGGCTATGGCTACACCTTC	CSARGSDRGTGYGYTF	TRBV20-1	TRBJ1-2
TGTGCCAGCAGTTTCATTATGGGGACAAAACAGGCTCATCAGCCCCAGCATTTT	CASSFIMGTKQAHQPQHF	TRBV27	TRBJ1-5
TGCGCCAGCAGCCCGGGGGACAGGACTACAGGAGTCTACGAGCAGTACTTC	CASSPGDRTTGVYEQYF	TRBV4-3	TRBJ2-7
TGTGCCAGCAGCTCGGGTTCCCGATCAATCTCCAGCTCCTACGAGCAGTACTTC	CASSSGSRSISSSYEQYF	TRBV11-2	TRBJ2-7
TGTGCCAGCAGTTACTCCGACAGAAGGGTTGCTACACGCACTGAAGCTTTCTTT	CASSYSDRRVATRTEAFF	TRBV6-2	TRBJ1-1
TGCAGTGTAAGGCGGGAGAGTACACACGAGCAGTACTTC	CSVRRESTHEQYF	TRBV20-1	TRBJ2-7
TGTGCCAGCAGTCAACTCCAGCACGCCTACCAAGAGACCCAGTACTTC	CASSQLQHAYQETQYF	TRBV12-4	TRBJ2-5
TGTGCCACCAGTGATTTCTACGGGAGGGCCCTATGTAAGCAGTACTTC	CATSDFYGRALCKQYF	TRBV24-1	TRBJ2-7
TGTGCTAGTGGCCGAGACAGGGAGGGAAGCTCCTACAATGAGCAGTTCTTC	CASGRDREGSSYNEQFF	TRBV12-5	TRBJ2-1
TGTGCCAGCAGGTTTGGGACCAGGTTCACCTACGAGCAGTACTTC	CASRFGTRFTYEQYF	TRBV2	TRBJ2-7
TGTGCCAGTAGTAGAGCCCTCGGAGGGTACAATGAGCAGTTCTTC	CASSRALGGYNEQFF	TRBV19	TRBJ2-1
TGTGCCACTGGCGTTACCGGTGACTATGGCTACACCTTC	CATGVTGDYGYTF	TRBV28	TRBJ1-2
TGTGCTAGTGGTTTGGCTAGAGGATCTTTGAAGGGGTGGTACGAGCAGTACTTC	CASGLARGSLKGWYEQYF	TRBV12-5	TRBJ2-7
TGCGCCAGCAGCTTTGTGATTTTTTTTAGGGAGGACGAGCAGTACTTC	CASSFVIFFREDEQYF	TRBV5-1	TRBJ2-7
TGTGCCAGCAGAAGACTGGTACGGCCTATCATGAGCTCTGGAAACACCATATATTTT	CASRRLVRPIMSSGNTIYF	TRBV6-1	TRBJ1-3
TGTGCCACCAGTGATAAAGTGGACAGGGGGGTTCCAGAAAATCAGCCCCAGCATTTT	CATSDKVDRGVPENQPQHF	TRBV24-1	TRBJ1-5
TGTGCCAGCAGCTTGGGTAGGGCGGCCGGGACTAGACCCGATGAGCAGTTCTTC	CASSLGRAAGTRPDEQFF	TRBV5-4	TRBJ2-1
TGCAGTGCCAAAGGGGGACTCCCTGGTACAGATACGCAGTATTTT	CSAKGGLPGTDTQYF	TRBV20-1	TRBJ2-3
TGTGCCCAGGTTGCGGGAGGGATCCTGGGAAACACCATATATTTT	CAQVAGGILGNTIYF	TRBV11-2	TRBJ1-3
TGTGCCAGCAGCGTAGGCAGCGGGAGGAACACTGAAGCTTTCTTT	CASSVGSGRNTEAFF	TRBV9	TRBJ1-1
TGTGCCACCAGAGCAGAGTGGGGAGAGTCCTACGAGCAGTACTTC	CATRAEWGESYEQYF	TRBV24-1	TRBJ2-7
TGCAGTGCTAGAGTACCTACCGCCCCGGGTCACGAGCAGTACTTC	CSARVPTAPGHEQYF	TRBV20-1	TRBJ2-7
TGTGCCAGCAGCTTGGAAAATAGAGGGTTTTTAGCTTTCTTT	CASSLENRGFLAFF	TRBV5-4	TRBJ1-1
TGTGCCAGCACCCACGGGGGCCAGCCCCAGCATTTT	CASTHGGQPQHF	TRBV27	TRBJ1-5
TGTGCCAGCAGGGGACAGGGCGCAACTAATGAAAAACTGTTTTTT	CASRGQGATNEKLFF	TRBV28	TRBJ1-4
TGTGCCAGCTCACCACCCCCCCTGGGCTATAGCAATCAGCCCCAGCATTTT	CASSPPPLGYSNQPQHF	TRBV18	TRBJ1-5
TGTGCCAGCAGTTTATGGGGGCGGAACACTGAAGCTTTCTTT	CASSLWGRNTEAFF	TRBV28	TRBJ1-1
TGTGCCAGCAGCACAAACCGGGACCATAGAAAGTACGAGCAGTACTTC	CASSTNRDHRKYEQYF	TRBV28	TRBJ2-7
TGTGCCAGCAAGGGGGCGATTTGTGGACCTAATGAAAAACTGTTTTTT	CASKGAICGPNEKLFF	TRBV28	TRBJ1-4
TGTGCCAGCAGCGTGCCATCCGAAGCAGGTCTCGGCTACACCTTC	CASSVPSEAGLGYTF	TRBV27	TRBJ1-2
TGTGCCAGCAAGCTTAACCCGACTAGCGGTTTAAACATTCAGTACTTC	CASKLNPTSGLNIQYF	TRBV27	TRBJ2-4
TGCGCCAGGTATACCTGCCACAATGAGCAGTTCTTC	CARYTCHNEQFF	TRBV10-1	TRBJ2-1
TGTGCCAGCAGTGTCTCCACGACAGGGATCAACATTCAGTACTTC	CASSVSTTGINIQYF	TRBV25-1	TRBJ2-4
TGTGCCAGCAGTGACGTACAGGGAGACGATAGCAATCAGCCCCAGCATTTT	CASSDVQGDDSNQPQHF	TRBV6-4	TRBJ1-5
TGTGCCAGCAGATCGGGTCAAGAGACCCAGTACTTC	CASRSGQETQYF	TRBV27	TRBJ2-5
TGTGCCAGCAGCGCGACGAGGCCCGAGCAGTACTTC	CASSATRPEQYF	TRBV5-4	TRBJ2-7
TGTGCCACCAGTGATTTTCCTTTACATCTCCTGGGACAGGGGCAAGTGTACGAGCAGTACTTC	CATSDFPLHLLGQGQVYEQYF	TRBV24-1	TRBJ2-7
TGTGCCAGCAGGATCGGACAGGCCAGTAGCTATGGCTACACCTTC	CASRIGQASSYGYTF	TRBV12-3	TRBJ1-2
TGTGCCAGCAGTGGGGACAGGGGGACGGAGAACAGGTACGAGCAGTACTTC	CASSGDRGTENRYEQYF	TRBV2	TRBJ2-7
TGTGCTAGCAGCTTAGCGTCGAGTCATCCCAAGGGCGGCGAGCAGTACTTC	CASSLASSHPKGGEQYF	TRBV7-7	TRBJ2-7
TGTGCCAGCAGCCCAGGTGGGGGCTATGGCTACACCTTC	CASSPGGGYGYTF	TRBV3-1	TRBJ1-2
TGTGCCAGCAGCTTAAGGCGTCTCTACGAGCAGTACTTC	CASSLRRLYEQYF	TRBV7-3	TRBJ2-7
TGTGCCAGCAATCTTCGTTTGGGGGAGCGGCAGTTCTTC	CASNLRLGERQFF	TRBV2	TRBJ2-1
TGTGCCAGCAGCAACGGCCCTGGGACCTACGAGCAGTACTTC	CASSNGPGTYEQYF	TRBV5-4	TRBJ2-7
TGCAGCGAGGGGGAGGGTGGAGCCACTGAAGCTTTCTTT	CSEGEGGATEAFF	TRBV29-1	TRBJ1-1
TGTGCCAGTGGTCGCTTACAGGGTAGGGAGCTTCAGCCCCAGCATTTT	CASGRLQGRELQPQHF	TRBV6-4	TRBJ1-5
TGTGCCCCCCCCGACCCCGTACCCTTC	CAPPDPVPF	TRBV10-3	TRBJ1-2
TGTGCCATCAGTGAGGTGTGGGGCCTGTGGCTGGGGCTGTTTTTT	CAISEVWGLWLGLFF	TRBV10-3	TRBJ2-2
TGTGCCTTGTGGCATGGAAGTTGGTCAGATCAGCCCCAGCATTTT	CALWHGSWSDQPQHF	TRBV30	TRBJ1-5
TGTGCCACCAGCAGAGATGCTCCGGGACTAGGTCGTACCGATACGCAGTATTTT	CATSRDAPGLGRTDTQYF	TRBV15	TRBJ2-3
TGTGCCAGCAGCCAAGGGGGCGGCACAGATACGCAGTATTTT	CASSQGGGTDTQYF	TRBV7-4	TRBJ2-3
TGTGCCAGCAGTGCTGCTGGGATTGATACGCAGTATTTT	CASSAAGIDTQYF	TRBV6-4	TRBJ2-3
TGTGCCAGCAGTTACTCGGCATGGACAGGGACCTGTTATGGCTACACCTTC	CASSYSAWTGTCYGYTF	TRBV6-2	TRBJ1-2
TGTGCCACCAGTATGCCGCTAGACCAGGCCTGCACAGATACGCAGTATTTT	CATSMPLDQACTDTQYF	TRBV24-1	TRBJ2-3
TGTGCCAGCAGCTGGACCGACTCTGGAAACACCATATATTTT	CASSWTDSGNTIYF	TRBV6-2	TRBJ1-3
TGTGCCTGGAGTGTACGTGCTTCGTACTCCTACAATGAGCAGTTCTTC	CAWSVRASYSYNEQFF	TRBV30	TRBJ2-1
TGTGCCAGCAGACAGATTTATTCACCCCTCCACTTT	CASRQIYSPLHF	TRBV6-1	TRBJ1-6
TGTGCCAGCAGCGTAGGGTTGCTGCTGGATTTAGAGGACGAGCAGTACTTC	CASSVGLLLDLEDEQYF	TRBV9	TRBJ2-7
TGTGCCAGCAGACAGGGGTGGTACGAGCAGTACTTC	CASRQGWYEQYF	TRBV2	TRBJ2-7
TGCGCCAGCATTCGGGGGCATTCGTCCTACAATGAGCAGTTCTTC	CASIRGHSSYNEQFF	TRBV10-1	TRBJ2-1
TGCGCCAGCAGTGAGGGGGACAGGGGGGGCCACGCTTTCTTT	CASSEGDRGGHAFF	TRBV10-1	TRBJ1-1
TGTGCCAGCAGCTTATCACCCTGCATCTACAATGAGCAGTTCTTC	CASSLSPCIYNEQFF	TRBV7-3	TRBJ2-1
TGTGCCAGCAGCTTACAATCCGAACCGGGGCCCTACGAGCAGTACTTC	CASSLQSEPGPYEQYF	TRBV7-4	TRBJ2-7
TGCGCCCCCGTCAGGTTCAATCAGCCCCAGCATTTT	CAPVRFNQPQHF	TRBV10-1	TRBJ1-5
TGCGCCAGCAGCCAAGAGTCCCTATCCTCCGGGACTCCCACTGAAGCTTTCTTT	CASSQESLSSGTPTEAFF	TRBV4-1	TRBJ1-1
TGCAGCGTGACTAGTACCTACGAGCAGTACTTC	CSVTSTYEQYF	TRBV29-1	TRBJ2-7
TGTGCCAGCAGCCCACTGGACAGCACTGAAGCTTTCTTT	CASSPLDSTEAFF	TRBV28	TRBJ1-1
TGTGCCAGCAGCTTAGCCCCTACAGCGCGGACAGATACGCAGTATTTT	CASSLAPTARTDTQYF	TRBV7-4	TRBJ2-3
TGTGCCACCAGTGCCGGAGGGATGGGCAATCAGCCCCAGCATTTT	CATSAGGMGNQPQHF	TRBV24-1	TRBJ1-5
TGTGCCAGCAGCCCGGGTGCCTGCCTCATGAACACTGAAGCTTTCTTT	CASSPGACLMNTEAFF	TRBV11-3	TRBJ1-1
TGCGCCAGCAGCACAGTGGACAGTGTGGCGATCTATGGCTACACCTTC	CASSTVDSVAIYGYTF	TRBV5-1	TRBJ1-2
TGTGCCAGCAGCTTGCAGGGGGGGGTTGCGGCCGAGCAGTACTTC	CASSLQGGVAAEQYF	TRBV11-2	TRBJ2-7
TGTGCCAGCAGCTCCACGGACAGGGCTGGTCATGGGGGGACTCTGGACACCGGGGAGCTGTTTTTT	CASSSTDRAGHGGTLDTGELFF	TRBV7-2	TRBJ2-2
TGTGCCAGCAGCTTAGGCGGACAGGAAGAGACCCAGTACTTC	CASSLGGQEETQYF	TRBV7-9	TRBJ2-5
TGTGCTAGTGCAACGGAGGTCCGCACAGATACGCAGTATTTT	CASATEVRTDTQYF	TRBV12-5	TRBJ2-3
TGTGCCAGAACTCTCCGGTGGCAAGAAGGGACCCAGTACTTC	CARTLRWQEGTQYF	TRBV7-2	TRBJ2-5
TGTGCCAGCAGCATTCTCTTAACCGGGACAGGGGGCCCCAACACTGAAGCTTTCTTT	CASSILLTGTGGPNTEAFF	TRBV7-2	TRBJ1-1
TGCAGTGCTAGAGCGGTGGAGAATCTCCTGGAGGATAATGAGCAGTTCTTC	CSARAVENLLEDNEQFF	TRBV20-1	TRBJ2-1
TGTGCCACCAGTGATTCGCAAGAGATTCCGGGACAGGGATCCTACGAGCAGTACTTC	CATSDSQEIPGQGSYEQYF	TRBV24-1	TRBJ2-7
TGTGCCAGCAGCTTAGAACCCGAGTACTTC	CASSLEPEYF	TRBV11-3	TRBJ2-7
TGTGCCAGCAGTTTCAGGGGTTCTGAAGCTTTCTTT	CASSFRGSEAFF	TRBV12-3	TRBJ1-1
TGTGCCAGCAGTCCGGGACTAGCGGGGGGGCAGGTGGGAAATGAGCAGTTCTTC	CASSPGLAGGQVGNEQFF	TRBV12-4	TRBJ2-1
TGCAGTGCAGGACAAGACAGGGGGGAAACCCCGGATGGCTACACCTTC	CSAGQDRGETPDGYTF	TRBV20-1	TRBJ1-2
TGTGCCAGCAGCGAGGAGGGGCATCAGCCCCAGCATTTT	CASSEEGHQPQHF	TRBV7-9	TRBJ1-5
TGTGCCAGCAGTGACTCTCGTGGGGCAGTCAGCCAAGAGACCCAGTACTTC	CASSDSRGAVSQETQYF	TRBV6-4	TRBJ2-5
TGTGCCAGCAGTTCCAATACTCGATCCTTCACAGATACGCAGTATTTT	CASSSNTRSFTDTQYF	TRBV7-9	TRBJ2-3
TGTGCCAGCAGTGGGAACTCAGGGGGACCCAAATTAGGCTATGGCTACACCTTC	CASSGNSGGPKLGYGYTF	TRBV28	TRBJ1-2
TGTGCCAGCAGACGCAGGGTCACCGCTGAAGCTTTCTTT	CASRRRVTAEAFF	TRBV6-6	TRBJ1-1
TGTGCCAGCAGCCAAACCGGGACAGGGGTTGAAGCTTTCTTT	CASSQTGTGVEAFF	TRBV3-1	TRBJ1-1
TGTGCCAGCAGCTTGGAAAGGGGTCGGCAAAGGGAAAAACTGTTTTTT	CASSLERGRQREKLFF	TRBV5-6	TRBJ1-4
TGTGCCAGCAGCTTGGTAAGAACCCTAGCGGCGAACACCGGGGAGCTGTTTTTT	CASSLVRTLAANTGELFF	TRBV5-6	TRBJ2-2
TGTGCCAGCAGTAATCCGGGACAGGGGCTCGATACGCAGTATTTT	CASSNPGQGLDTQYF	TRBV6-1	TRBJ2-3
TGTGCCAGCAGCCGACCACTAGCGGGAGCCCCACCCTACAATGAGCAGTTCTTC	CASSRPLAGAPPYNEQFF	TRBV6-5	TRBJ2-1
TGTGCCAGCAGTATCCATGGGGGGGCCGGGTACGAGCAGTACTTC	CASSIHGGAGYEQYF	TRBV6-1	TRBJ2-7
TGTGCCAGCAGAACAGGGGCGGGTAACACCGGGGAGCTGTTTTTT	CASRTGAGNTGELFF	TRBV14	TRBJ2-2
TGTGCCAGCAGGGGCGCGTCGCGAGTCTATGGCTACACCTTC	CASRGASRVYGYTF	TRBV6-6	TRBJ1-2
TGCGCCAGCAGCCAAGAACTCAGGTGCCCCCACACTGAAGCTTTCTTT	CASSQELRCPHTEAFF	TRBV4-1	TRBJ1-1
TGTGCCAGCAGCTTACGGATGGGTCGGTACAATGAGCAGTTCTTC	CASSLRMGRYNEQFF	TRBV7-2	TRBJ2-1
TGCGCCAGCAGTGAGACATGGACTAGCGTTACGGACTCCTACGAGCAGTACTTC	CASSETWTSVTDSYEQYF	TRBV10-2	TRBJ2-7
TGTGCCAGCAGCTTAGAAGCCGGGACAGTGGGGGCCACTGAAGCTTTCTTT	CASSLEAGTVGATEAFF	TRBV7-4	TRBJ1-1
TGCGCCAGCAGCCAAGACCCGAAGGGACAGGGCGAAAAACTGTTTTTT	CASSQDPKGQGEKLFF	TRBV4-1	TRBJ1-4
TGTGCCAGCAGTGGGGGGCAGGGAATGGGGACCAGAGCTAACTATGGCTACACCTTC	CASSGGQGMGTRANYGYTF	TRBV6-1	TRBJ1-2
TGTGCCAGCAGCTCCCACAGGGGTGAGCAGTTCTTC	CASSSHRGEQFF	TRBV13	TRBJ2-1
TGTGCCAGCAAGGGGGGGGGCAAAGAAGGTCGGGAGACCCAGTACTTC	CASKGGGKEGRETQYF	TRBV6-1	TRBJ2-5
TGTGCCAGCTCACCACGGACTAGCAGGGGGGAGCAGTACTTC	CASSPRTSRGEQYF	TRBV18	TRBJ2-7
TGCAGTCTAATTGACCATTCACCCCTCCACTTT	CSLIDHSPLHF	TRBV20-1	TRBJ1-6
TGCGCCAGCAGCCGATTGGCTGGGGGGGGTAGTAGCTCTGGAAACACCATATATTTT	CASSRLAGGGSSSGNTIYF	TRBV4-1	TRBJ1-3
TGTGCCAGCAGCTTCGGACAGGGGGCAGGGGGAACTGAAGCTTTCTTT	CASSFGQGAGGTEAFF	TRBV11-2	TRBJ1-1
TGTGCCAGCAGGGGGCCCAGCTACATTCAGTACTTC	CASRGPSYIQYF	TRBV6-1	TRBJ2-4
TGCAGTGCTAGCAGTAAAGCAGGGACTGAAGCTTTCTTT	CSASSKAGTEAFF	TRBV20-1	TRBJ1-1
TGTGCCAGCATAACTTCGGATTTCGGGAGGGCAGCCGAAAGCAATCAGCCCCAGCATTTT	CASITSDFGRAAESNQPQHF	TRBV6-3	TRBJ1-5
TGTGCCAGCAGCCGGTACCCTTTACCTTCAGGGCCATATGGGGGAGTCGAGCAGTACTTC	CASSRYPLPSGPYGGVEQYF	TRBV7-7	TRBJ2-7
TGTGCCAGCTCACCGCCGGCGGGAACCCAGCATTTT	CASSPPAGTQHF	TRBV18	TRBJ1-5
TGTGCCAGCAGCAAAGGACGATTACAAGGCTCCTACAATGAGCAGTTCTTC	CASSKGRLQGSYNEQFF	TRBV7-3	TRBJ2-1
TGTGCCAGTAGTATAAGGCGGCTGCCAGACACTGAAGCTTTCTTT	CASSIRRLPDTEAFF	TRBV19	TRBJ1-1
TGTGCCAGGCTACGACGAGGGTTCAATCAGCCCCAGCATTTT	CARLRRGFNQPQHF	TRBV6-3	TRBJ1-5
TGTGCCAGCAGCCTACCCCCGTCACTAGCGGGGGTACACTCCTACGAGCAGTACTTC	CASSLPPSLAGVHSYEQYF	TRBV13	TRBJ2-7
TGTGCCAGCAGCAATGTGGGGCGACCGGGATCACCCCTCCACTTT	CASSNVGRPGSPLHF	TRBV3-1	TRBJ1-6
TGTGCCCCGCGCGGGAGGGTGTACAATGAGCAGTTCTTC	CAPRGRVYNEQFF	TRBV9	TRBJ2-1
TGTGCCAGCAGCTTAGCCGTTCACCCCTACAGAAATTTTAACACTGAAGCTTTCTTT	CASSLAVHPYRNFNTEAFF	TRBV7-9	TRBJ1-1
TGTGCCAGCAGCCACGGCTCCGGGGTCCCTCAGCCCCAGCATTTT	CASSHGSGVPQPQHF	TRBV11-2	TRBJ1-5
TGTGCCAGCAGCGTAGTGGACAGAGGCAGGTGCGGTGAGCAGTTCTTC	CASSVVDRGRCGEQFF	TRBV9	TRBJ2-1
TGCGCCAGCAGCAAGAAGCGACAGGGGAGTGGCTACACCTTC	CASSKKRQGSGYTF	TRBV5-1	TRBJ1-2
TGCGCCAGCAGCCGGGATACCGGGCTTCCGAACACCGGGGAGCTGTTTTTT	CASSRDTGLPNTGELFF	TRBV4-1	TRBJ2-2
TGCGCCAGCAGTGAGTCTCTGGGGGGCTCTGGAAACACCATATATTTT	CASSESLGGSGNTIYF	TRBV10-1	TRBJ1-3
TGTGCCATCACAAAAATAGGGACACACGGGGAGCTGTTTTTT	CAITKIGTHGELFF	TRBV10-3	TRBJ2-2
TGCGCCAGCAGAACGCGGCTGGAGGCTTTCTTT	CASRTRLEAFF	TRBV10-1	TRBJ1-1
TGTGCCAGCAGTCGGGGGACTAGCGGGGATCGCACAGATACGCAGTATTTT	CASSRGTSGDRTDTQYF	TRBV27	TRBJ2-3
TGTGCCAGCAGCCGGGGGCCTTACTTCGCTGGGGCCAACGTCCTGACTTTC	CASSRGPYFAGANVLTF	TRBV13	TRBJ2-6
TGCAGTGCTAGAGGGGCCCGGGGACTCAACACTGAAGCTTTCTTT	CSARGARGLNTEAFF	TRBV20-1	TRBJ1-1
TGTGCCAGCAGCCCCGCCGGGACTAGCGGGAAGGTCCAAGAGACCCAGTACTTC	CASSPAGTSGKVQETQYF	TRBV14	TRBJ2-5
TGCGCCAGCAGCCAAGCGGGCCCGGGCTCTGGTGAAGCTTTCTTT	CASSQAGPGSGEAFF	TRBV4-3	TRBJ1-1
TGCAGTGCTTCCCATCGAAGGGGACGGAACTTTGAGAACACTGAAGCTTTCTTT	CSASHRRGRNFENTEAFF	TRBV20-1	TRBJ1-1
TGTGCCAGCAGCTTATACGAGGGGGGGAGAGTGCACGAGCAGTACTTC	CASSLYEGGRVHEQYF	TRBV13	TRBJ2-7
TGCGCCAGCAGCTCCTGTTCACGAGGAGCCAATCAGCCCCAGCATTTT	CASSSCSRGANQPQHF	TRBV5-1	TRBJ1-5
TGCAGCGTTGAATTACAGGGTAACTATGGCTACACCTTC	CSVELQGNYGYTF	TRBV29-1	TRBJ1-2
TGCGCCAGCAGCGGGGCCCGGTCAACAGGGAGGGGACACACAGATACGCAGTATTTT	CASSGARSTGRGHTDTQYF	TRBV5-1	TRBJ2-3
TGTGCCAGCAGCGCGTCAGGAGGGTCAGTCAATCAGCCCCAGCATTTT	CASSASGGSVNQPQHF	TRBV9	TRBJ1-5
TGCACCAGATGGCGGGAGAATGAGCAGTTCTTC	CTRWRENEQFF	TRBV29-1	TRBJ2-1
TGTGCCAGCAGCTCACAGAGAGTTGGCTACACCTTC	CASSSQRVGYTF	TRBV5-6	TRBJ1-2
TGCAGTGCTAGAACGTACTCTAGCAGGAACGAGCAGTACTTC	CSARTYSSRNEQYF	TRBV20-1	TRBJ2-7
TGCAGTGCTAGACCCGATAAGCGGGAAACCCAAGAGACCCAGTACTTC	CSARPDKRETQETQYF	TRBV20-1	TRBJ2-5
TGTGCCAGCAGCTCGGAAGGGATTCGTACAGGGGGCAGCACAGATACGCAGTATTTT	CASSSEGIRTGGSTDTQYF	TRBV7-6	TRBJ2-3
TGCAGTGCTAGAGGGAGGCCCGGGGAGCTGTTTTTT	CSARGRPGELFF	TRBV20-1	TRBJ2-2
TGTGCCGGGGCTGACAGGAACCCGAGCAATCAGCCCCAGCATTTT	CAGADRNPSNQPQHF	TRBV10-3	TRBJ1-5
TGTGCCAGCAGCTATCAGGGGTCATCCACAGATACGCAGTATTTT	CASSYQGSSTDTQYF	TRBV5-4	TRBJ2-3
TGTGCCATGTTACGCGGGCCCGGCAATCAGCCCCAGCATTTT	CAMLRGPGNQPQHF	TRBV6-5	TRBJ1-5
TGTGCCAGCAGCCAAGCCCCCCTAGCGGGGGGGGTAGCACACAATGAGCAGTTCTTC	CASSQAPLAGGVAHNEQFF	TRBV14	TRBJ2-1
TGCGCCAGCAGTCGCGGGGAAGGGGAGAAGGCTTACTACGAGCAGTACTTC	CASSRGEGEKAYYEQYF	TRBV10-2	TRBJ2-7
TGCGCCAGCAGCTTCACACAGAACTCAGCTAACACTGAAGCTTTCTTT	CASSFTQNSANTEAFF	TRBV5-1	TRBJ1-1
TGTGCCAGCCGCATGGAAGGTAGGGACAGAGGATACCCGCCCTACGAGCAGTACTTC	CASRMEGRDRGYPPYEQYF	TRBV27	TRBJ2-7
TGTGCCACCAGCAGAGATGGGGAAAGGCGCACCGGGGAGCTGTTTTTT	CATSRDGERRTGELFF	TRBV15	TRBJ2-2
TGTGCCAGCAGCCAAGCCCGTTTCCCGGAGCTGGCCAACGTCCTGACTTTC	CASSQARFPELANVLTF	TRBV14	TRBJ2-6
TGTGCCAGCACAGGGGGAACTAATTCACCCCTCCACTTT	CASTGGTNSPLHF	TRBV27	TRBJ1-6
TGTGCCAGCAGTGGAGCCCGAACCCGACTTCCGAACACTGAAGCTTTCTTT	CASSGARTRLPNTEAFF	TRBV27	TRBJ1-1
TGTGCCAGCAGCTTCACTGACAGGGCGGGCTCCGAGCAGTACTTC	CASSFTDRAGSEQYF	TRBV7-9	TRBJ2-7
TGTGCCAGTAGCGGCGGACATTCCATTCAAAAACTGTTTTTT	CASSGGHSIQKLFF	TRBV19	TRBJ1-4
TGCAGCGTGAATACCGCCAAAATTTTGGGAGCTTTCTTT	CSVNTAKILGAFF	TRBV29-1	TRBJ1-1
TGTGCCAGCATTAGGGCTTTGTCTAACTATGGCTACACCTTC	CASIRALSNYGYTF	TRBV27	TRBJ1-2
TGTGCCAGCAGCAAAGGGCGGGAGACAGATACGCAGTATTTT	CASSKGRETDTQYF	TRBV7-3	TRBJ2-3
TGTGCCAGCATGGTGGCCCAGGGGGAGACTAATGAAAAACTGTTTTTT	CASMVAQGETNEKLFF	TRBV6-4	TRBJ1-4
TGTGCCAGCAGTGAGGTCTGGGGAATTAGCAATCAGCCCCAGCATTTT	CASSEVWGISNQPQHF	TRBV6-4	TRBJ1-5
TGCGCCAGCAGCTCTTACATGGACGAAAGCCAAGAGACCCAGTACTTC	CASSSYMDESQETQYF	TRBV5-1	TRBJ2-5
TGTGCCAGCAGCCTATGGGACACTGAGACCCAGTACTTC	CASSLWDTETQYF	TRBV5-6	TRBJ2-5
TGCGCCAGCAGCTTACCGGGGACACAGGGTGCTTTACAGAGTGAAGCTTTCTTT	CASSLPGTQGALQSEAFF	TRBV5-1	TRBJ1-1
TGTGCCAGCAGCAGGGGCGGAAAAAATCGGGAGACCCAGTACTTC	CASSRGGKNRETQYF	TRBV5-6	TRBJ2-5
TGTGCCAGCAGTAGGGCTAGGTACTTC	CASSRARYF	TRBV27	TRBJ2-5
TGTGCCAGCAGAGCTATGGGGACGTACCAAGAGACCCAGTACTTC	CASRAMGTYQETQYF	TRBV11-2	TRBJ2-5
TGTGCCAGCAGTTTATGGTCAAAAGAGACCCAGTACTTC	CASSLWSKETQYF	TRBV28	TRBJ2-5
TGTGCCAGCAGTGACCTTGTACGACCAGTAGACTTGCATGAAAAACTGTTTTTT	CASSDLVRPVDLHEKLFF	TRBV6-4	TRBJ1-4
TGTGCCAGCAGCGGCCGACTCGGGAGCTCCTACAATGAGCAGTTCTTC	CASSGRLGSSYNEQFF	TRBV13	TRBJ2-1
TGTGCCAGCAGCATGATAGCCGGGTACTTC	CASSMIAGYF	TRBV11-1	TRBJ2-7
TGTGCCTGGAAGTTTAGGGGGGAGAACATTCAGTACTTC	CAWKFRGENIQYF	TRBV30	TRBJ2-4
TGCGCCAGCAGCCAATCGCAGGTATCCTACAATGAGCAGTTCTTC	CASSQSQVSYNEQFF	TRBV5-1	TRBJ2-1
TGTGCCAGCAGTTTCCGGCGGAAACCCACTGAAGCTTTCTTT	CASSFRRKPTEAFF	TRBV12-3	TRBJ1-1
TGTGCCAGCTCCGGGACAGACAGACCTGGGGCCAACGTCCTGACTTTC	CASSGTDRPGANVLTF	TRBV28	TRBJ2-6
TGTGCCAGCAGTCCCGGACAGGGTTCACCCCTCCACTTT	CASSPGQGSPLHF	TRBV12-3	TRBJ1-6
TGTGCCAGCAGCCAAGATTTTGGGACAGGGTATTGGGGAAACACCATATATTTT	CASSQDFGTGYWGNTIYF	TRBV14	TRBJ1-3
TGTGCCAGCAGTGCCGGACAGGTCGTTTTGAGCACTGAAGCTTTCTTT	CASSAGQVVLSTEAFF	TRBV25-1	TRBJ1-1
TGTGCCAGCTCACCGGACAGGGAAGAAAGAGGCAATGAGCAGTTCTTC	CASSPDREERGNEQFF	TRBV18	TRBJ2-1
TGTGCCAGCTCACCATGGGTTTCCCCGCAGGGGTGCCCCTATAGCAATCAGCCCCAGCATTTT	CASSPWVSPQGCPYSNQPQHF	TRBV18	TRBJ1-5
TGTGCCTGGAGTGTGGGACTGATCTACGAGCAGTACTTC	CAWSVGLIYEQYF	TRBV30	TRBJ2-7
TGTGCCAGCAGTTTCCGTCCCGGTGGCTACACCTTC	CASSFRPGGYTF	TRBV28	TRBJ1-2
TGTGCCAGCAGTGACTTGGGGAACACTGAAGCTTTCTTT	CASSDLGNTEAFF	TRBV6-4	TRBJ1-1
TGTGCCAGCAGTCTCCGACAGGGCAGCACAGATACGCAGTATTTT	CASSLRQGSTDTQYF	TRBV11-2	TRBJ2-3
TGTGCCAGCAGTTACTCATTCACAGAGTATAGCAATCAGCCCCAGCATTTT	CASSYSFTEYSNQPQHF	TRBV6-2	TRBJ1-5
TGTGCCAGCACCAAACAGGAGCAAAGTTACGGGGAGCTGTTTTTT	CASTKQEQSYGELFF	TRBV28	TRBJ2-2
TGTGCCAGCAGCCAAGAGACTCAGGAGATTGACAGCTCCTACGAGCAGTACTTC	CASSQETQEIDSSYEQYF	TRBV4-2	TRBJ2-7
TGTGCCAGCAGTTTCACGGGGTCCTTAACCTATGGCTACACCTTC	CASSFTGSLTYGYTF	TRBV27	TRBJ1-2
TGTGCCAGCAGTTCCGACTGGAGGGGAGACGAGCAGTACTTC	CASSSDWRGDEQYF	TRBV6-5	TRBJ2-7
TGTGCCAGCAATCGGACTAGAGGACACGAGCAGTACTTC	CASNRTRGHEQYF	TRBV6-6	TRBJ2-7
TGTGCCAGCAGTATGCCGGGACTAGCGGGAGAGTCAAAGAATACGCAGTATTTT	CASSMPGLAGESKNTQYF	TRBV6-4	TRBJ2-3
TGTGCCAGCAGCTTAGCCCGGGCCCGCAGCGGCACTGAAGCTTTCTTT	CASSLARARSGTEAFF	TRBV11-3	TRBJ1-1
TGTGCCAGCAGCCAGGGACAGGGCTACACAGATACGCAGTATTTT	CASSQGQGYTDTQYF	TRBV14	TRBJ2-3
TGTGCCATCACAACTAGCGGGCTGGCTGGACCTAATGAGCAGTTCTTC	CAITTSGLAGPNEQFF	TRBV10-3	TRBJ2-1
TGTGCCAGCAGTCTACCTCTAGACCCTATTTGGGTCTCCTACAATGAGCAGTTCTTC	CASSLPLDPIWVSYNEQFF	TRBV6-4	TRBJ2-1
TGTGCCAGCAGCCAAGCCCCTCGGCCTGAATATGAGCAGTTCTTC	CASSQAPRPEYEQFF	TRBV3-1	TRBJ2-1
TGTGCCAGCAGCCAAGCCCCTACCGGGGGGCGACCCACCGGGGAGCTGTTTTTT	CASSQAPTGGRPTGELFF	TRBV3-1	TRBJ2-2
TGTGCCAGCAGTTGTTCACAGGGGGGGAACACTGAAGCTTTCTTT	CASSCSQGGNTEAFF	TRBV6-8	TRBJ1-1
TGCGCCAGCAGTGATGCCGGGACAGGGGGCGGCAATCAGCCCCAGCATTTT	CASSDAGTGGGNQPQHF	TRBV10-2	TRBJ1-5
TGTGCCAGCAGCCAACCAAGACTCCGTAATGAGCAGTTCTTC	CASSQPRLRNEQFF	TRBV14	TRBJ2-1
TGTGCCAGCAGCGACAGGGAGAGGGGAAACACCATATATTTT	CASSDRERGNTIYF	TRBV9	TRBJ1-3
TGTGCCAGCATCCCGGACCGGACAGATACGCAGTATTTT	CASIPDRTDTQYF	TRBV6-5	TRBJ2-3
TGTGCCAGCAGCCGTTTAAGCCCGGCGGGTACTCCGTACGAGCAGTACTTC	CASSRLSPAGTPYEQYF	TRBV14	TRBJ2-7
TGTGCCAGCAGGGCCCAGGTGTCTTCCGACTACGAGCAGTACTTC	CASRAQVSSDYEQYF	TRBV28	TRBJ2-7
TGCGCCAGCAGCTCGCTAACATCGCAGTACTTC	CASSSLTSQYF	TRBV5-1	TRBJ2-7
TGTGCCAGCAGCTCTAGGACTAGCGGGTCCCGCACAGATACGCAGTATTTT	CASSSRTSGSRTDTQYF	TRBV27	TRBJ2-3
TGTGCCAGCAGTGTATTGTCGACAGGGGACCCCTATGGCTACACCTTC	CASSVLSTGDPYGYTF	TRBV28	TRBJ1-2
TGTGCCAGCAGCTGCCTAGCGGATGAGCAGTTCTTC	CASSCLADEQFF	TRBV7-9	TRBJ2-1
TGTGCCGGATGGACTTTAGCCAGCACAGATACGCAGTATTTT	CAGWTLASTDTQYF	TRBV6-4	TRBJ2-3
TGTGCCAGCAGAAACCGGACCTACGAGCAGTACTTC	CASRNRTYEQYF	TRBV6-5	TRBJ2-7
TGTGCCAGCTGTAAACCCAGGGATCTAATACCCTATAATTCACCCCTCCACTTT	CASCKPRDLIPYNSPLHF	TRBV7-6	TRBJ1-6
TGTGCCAGCAGCATTTACCCCCTGGCCGACCTAGCAGATACGCAGTATTTT	CASSIYPLADLADTQYF	TRBV4-2	TRBJ2-3
TGTGCCAGCAGTTACCCCGACAGAGACCTTGGAAACACCATATATTTT	CASSYPDRDLGNTIYF	TRBV6-2	TRBJ1-3
TGCAGTGCTGGGACAGAGTTGGTATACGAGCAGTACTTC	CSAGTELVYEQYF	TRBV20-1	TRBJ2-7
TGCGCCAGCAGCCGGGCGACATACAATGAGCAGTTCTTC	CASSRATYNEQFF	TRBV4-1	TRBJ2-1
TGCGCCAGCAGCCAGGCCTCCTACGAGCAGTACTTC	CASSQASYEQYF	TRBV5-1	TRBJ2-7
TGTGCCAGCAGTTTATCGGGACAGCCCGCTGAAGCTTTCTTT	CASSLSGQPAEAFF	TRBV27	TRBJ1-1
TGTGCCACCAGTCCGAGAACACATGAGGGCCGGGAATCCTACGAGCAGTACTTC	CATSPRTHEGRESYEQYF	TRBV24-1	TRBJ2-7
TGTGCCAGCACACGTGTAGAGCAGTACTTC	CASTRVEQYF	TRBV6-5	TRBJ2-7
TGTGCCAGCAGTTTTACCCCCGGGACTAGCGGTAGAGAGACCCAGTACTTC	CASSFTPGTSGRETQYF	TRBV28	TRBJ2-5
TGTGCCAGCAGCAGGGGAAGGAATGAGCAGTTCTTC	CASSRGRNEQFF	TRBV12-3	TRBJ2-1
TGCGCCAGCAGTGAGCCCCCTTACGAGCAGTACTTC	CASSEPPYEQYF	TRBV10-2	TRBJ2-7
TGTGCCAGCAGCCGGACAGGGAATAGCAATCAGCCCCAGCATTTT	CASSRTGNSNQPQHF	TRBV5-6	TRBJ1-5
TGCAGTGCTAGAGGGTCCTGGGAGCAGTACTTC	CSARGSWEQYF	TRBV20-1	TRBJ2-7
TGTGCCAGCAGTGGGGACACCACCGGGGAGCTGTTTTTT	CASSGDTTGELFF	TRBV7-9	TRBJ2-2
TGTGCCAGCAGCGTAGTAGCGGGGTACGAGCAGTACTTC	CASSVVAGYEQYF	TRBV9	TRBJ2-7
TGTGCCACAGAGCCCCGGGACAGCGACAATGAGCAGTTCTTC	CATEPRDSDNEQFF	TRBV24-1	TRBJ2-1
TGTGCCAGCAGTGACTCATGGGGACGGGGGCCGGCCGTAGCCCTTGTATGTGAAGCTTTCTTT	CASSDSWGRGPAVALVCEAFF	TRBV6-4	TRBJ1-1
TGTGCCAGCACACCCCGGGGGGGGCTGTCCTACGAGCAGTACTTC	CASTPRGGLSYEQYF	TRBV2	TRBJ2-7
TGTGCCAGCAGTACCACAAAGGGGGAAGGCAATCAGCCCCAGCATTTT	CASSTTKGEGNQPQHF	TRBV27	TRBJ1-5
TGTGCCAGCAGCTCAGCGCCTGAGTGTGTCGCCTACGAGCAGTACTTC	CASSSAPECVAYEQYF	TRBV11-3	TRBJ2-7
TGTGCCAGCAGCAGGACCAATTCACCCCTCCACTTT	CASSRTNSPLHF	TRBV7-9	TRBJ1-6
TGTGCCAGCAGGATTTTTGTGGCGACTAGCGGGTCTAATGGGCCAGAGACCCAGTACTTC	CASRIFVATSGSNGPETQYF	TRBV6-5	TRBJ2-5
TGTGCCAGCAGCCGACCAGGCGACTGTAGGATCTTCTACGAGCAGTACTTC	CASSRPGDCRIFYEQYF	TRBV14	TRBJ2-7
TGTGCCAGCAGCTTAACGGTAAATTGGGTACGAGAGACCCAGTACTTC	CASSLTVNWVRETQYF	TRBV7-3	TRBJ2-5
TGTGCCAGCAGTTATAAGGGAGGGTACAATGAGCAGTTCTTC	CASSYKGGYNEQFF	TRBV7-2	TRBJ2-1
TGTGCCCCCGCTGGACTAGCGGGTGAGCAGTACTTC	CAPAGLAGEQYF	TRBV6-1	TRBJ2-7
TGCGCCAGCGATCCGTCTAGCGGGGACGAGCAGTACTTC	CASDPSSGDEQYF	TRBV10-1	TRBJ2-7
TGTGCCAGTAGTATCCCCACTGACAGTCCCAAAAACATTCAGTACTTC	CASSIPTDSPKNIQYF	TRBV19	TRBJ2-4
TGTGCCAGCAGTTACTCGAAATTCGGACAGTCGGTGAACACTGAAGCTTTCTTT	CASSYSKFGQSVNTEAFF	TRBV6-5	TRBJ1-1
TGTGCCACCAGGGTGGGGGAAATCTCCTACAATGAGCAGTTCTTC	CATRVGEISYNEQFF	TRBV15	TRBJ2-1
TGTGCCAGTAGGGATAGCGGGGGGCTCGCGAGACAGTACTTC	CASRDSGGLARQYF	TRBV19	TRBJ2-7
TGCGCCAGCAGCCAAGGAGGACAGGGGTCTTATAGCAATCAGCCCCAGCATTTT	CASSQGGQGSYSNQPQHF	TRBV4-1	TRBJ1-5
TGTGCCACCAGTGCCGGGGGAGGAGGATCCTACAATGAGCAGTTCTTC	CATSAGGGGSYNEQFF	TRBV24-1	TRBJ2-1
TGTGCCAGCAGTGAAGTCGGGGTGGGAGGGACAGAATACGATACAAGTCAGCCCCAGCATTTT	CASSEVGVGGTEYDTSQPQHF	TRBV6-1	TRBJ1-5
TGTGCCAGCCGATACGAGACCCAGTACTTC	CASRYETQYF	TRBV7-9	TRBJ2-5
TGCGCCAGCAGCAGTGGGACAGGGTGGCAAAATGGCTACACCTTC	CASSSGTGWQNGYTF	TRBV5-1	TRBJ1-2
TGTGCCAGCAGTCTGACAGGTTTAGAGACCCAGTACTTC	CASSLTGLETQYF	TRBV6-5	TRBJ2-5
TGTGCCAGCAGTGACCTTGGGGACTATTCCTACGAGCAGTACTTC	CASSDLGDYSYEQYF	TRBV6-4	TRBJ2-7
TGTGCCAGCAGTGAAGCACGTCTTACAGATACGCAGTATTTT	CASSEARLTDTQYF	TRBV6-1	TRBJ2-3
TGTGCCAGCAGCTTAGAAGGGACAGAAAAGCCAGCTAACTATGGCTACACCTTC	CASSLEGTEKPANYGYTF	TRBV7-4	TRBJ1-2
TGTGCCAGCAGTCAAGTAACAGGATTCGAGCAGTACTTC	CASSQVTGFEQYF	TRBV6-3	TRBJ2-7
TGTGCCAACGACCCGGTCCCCGGGGACAGAGGGGAAACAAGGGTCACAGATACGCAGTATTTT	CANDPVPGDRGETRVTDTQYF	TRBV10-3	TRBJ2-3
TGTGCCAGCAGCTTAACGACAGGGAATGGCTACACCTTC	CASSLTTGNGYTF	TRBV13	TRBJ1-2
TGTGCCACCAGTGATTCACCGGGGCCAAACGAGCAGTACTTC	CATSDSPGPNEQYF	TRBV24-1	TRBJ2-7
TGCGCCAGCAGCGCCACCCCCGGGACTAGCCGAGGGAGCTCCTACGAGCAGTACTTC	CASSATPGTSRGSSYEQYF	TRBV5-1	TRBJ2-7
TGTGCCAGCAGCATCCTGACCGGGGAGCTGTTTTTT	CASSILTGELFF	TRBV7-9	TRBJ2-2
TGTGCCACAGGGGCGGACTATGGCTACACCTTC	CATGADYGYTF	TRBV27	TRBJ1-2
TGCAGTCAACAGGATGGGAGCAATCAGCCCCAGCATTTT	CSQQDGSNQPQHF	TRBV20-1	TRBJ1-5
TGTGCCAGCAGCCGGACTAGCGGGGAGTTTCCGGCCTACAATGAGCAGTTCTTC	CASSRTSGEFPAYNEQFF	TRBV7-6	TRBJ2-1
TGTGCCACCAGTGATTGGGGGACGATTGAGGGCTACACCTTC	CATSDWGTIEGYTF	TRBV24-1	TRBJ1-2
TGTGCCAGCAGCTCAGGGTGGAACACTGAAGCTTTCTTT	CASSSGWNTEAFF	TRBV11-3	TRBJ1-1
TGTGCCAGCAGCTGGCACTTAGAAGATACGCAGTATTTT	CASSWHLEDTQYF	TRBV7-9	TRBJ2-3
TGTGCCAGCAGCTTGGAACGAACAAGAGGGGGGGAGAGAGGCACCGGGGAGCTGTTTTTT	CASSLERTRGGERGTGELFF	TRBV5-4	TRBJ2-2
TGTGCCAGCAGTACTCTCTCTCGTCGCGAGCAGTACTTC	CASSTLSRREQYF	TRBV6-5	TRBJ2-7
TGTGCCAGCAGTAAGGTGGGCACCCGCACCGGGGAGCTGTTTTTT	CASSKVGTRTGELFF	TRBV27	TRBJ2-2
TGTGCCAGCAGCAGTCCCCGCCGGGACAGTCTTAGCTCCTACGAGCAGTACTTC	CASSSPRRDSLSSYEQYF	TRBV5-6	TRBJ2-7
TGTGCCAGCAGCCCAAGGACCTCAGTAAAGGCCGGCTACACCTTC	CASSPRTSVKAGYTF	TRBV7-3	TRBJ1-2
TGTGCCACCGGCCCAGGGCACACTGAAGCTTTCTTT	CATGPGHTEAFF	TRBV24-1	TRBJ1-1
TGTGCCAGCAGTGCGGGGGCGCAGGAAGCTTTCTTT	CASSAGAQEAFF	TRBV6-4	TRBJ1-1
TGTGCACAGACAGGGGGCAATTACACTGAAGCTTTCTTT	CAQTGGNYTEAFF	TRBV28	TRBJ1-1
TGTGCCAGCAGCAACGGGACACCCAGGACCTATGGCTACACCTTC	CASSNGTPRTYGYTF	TRBV7-4	TRBJ1-2
TGCGCCAGCCCCCAGGACCCCTACGAGCAGTACTTC	CASPQDPYEQYF	TRBV5-1	TRBJ2-7
TGTGCCAGCAGTGACTCGACCCGCGGACTAGCGGTTAAAGAGACCCAGTACTTC	CASSDSTRGLAVKETQYF	TRBV6-4	TRBJ2-5
TGTGCCAGCAGCGGTGGGGGATTAAGCCGGGCTCCCTCCTACGAGCAGTACTTC	CASSGGGLSRAPSYEQYF	TRBV9	TRBJ2-7
TGTGCCAGCAGCGAGGGAGCTCCCGTAAGTGGAGATACGCAGTATTTT	CASSEGAPVSGDTQYF	TRBV9	TRBJ2-3
TGCGCCAGCAGACGAAAGAAAAGCAATCAGCCCCAGCATTTT	CASRRKKSNQPQHF	TRBV5-1	TRBJ1-5
TGTGCCAGCAGCTTAGGCCCCAGGACTAGCGGGGGGGCGAACAATGAGCAGTTCTTC	CASSLGPRTSGGANNEQFF	TRBV7-2	TRBJ2-1
TGTGCCAGCAGCTTAAGAGGAGGGAAGCAGTTCTTC	CASSLRGGKQFF	TRBV7-2	TRBJ2-1
TGTGCCAGCAGTTGGACCGTCACCTGGCGCTATGGCTACACCTTC	CASSWTVTWRYGYTF	TRBV6-1	TRBJ1-2
TGTGCCACCAGTGAATCAGTATTATACGAGCAGTACTTC	CATSESVLYEQYF	TRBV24-1	TRBJ2-7
TGTGCCAGCAGCGGGAGTCTGGAGCAGTTCTTC	CASSGSLEQFF	TRBV14	TRBJ2-1
TGTGCCAGCAGGAGAGAACAGGGGTCTAGCTACAATGAGCAGTTCTTC	CASRREQGSSYNEQFF	TRBV6-5	TRBJ2-1
TGTGCCAGCAGCTGGTACCGATACTATGGCTACACCTTC	CASSWYRYYGYTF	TRBV7-9	TRBJ1-2
TGTGCCATCAGTGAGGGGCTACGGGACCTGGGGGACGAGCAGTACTTC	CAISEGLRDLGDEQYF	TRBV10-3	TRBJ2-7
TGTGCGGCTATAAGGGTGCCGAAGTTTAGTCCCGTATCACCCCTCCACTTT	CAAIRVPKFSPVSPLHF	TRBV9	TRBJ1-6
TGTGCCAACGGACAGGGGCAAGAGACCCAGTACTTC	CANGQGQETQYF	TRBV6-6	TRBJ2-5
TGTGCCAGTAGTATGTCCTCCGCGACCTCTCGGGACTTTCACGAGCAGTACTTC	CASSMSSATSRDFHEQYF	TRBV19	TRBJ2-7
TGCGCCAGCAGCTCTTCTCGGAAACCGCAAGACTACGAGCAGTACTTC	CASSSSRKPQDYEQYF	TRBV5-1	TRBJ2-7
TGCGCCCGATGGTCAGGCAACCCGAACACCGGGGAGCTGTTTTTT	CARWSGNPNTGELFF	TRBV10-1	TRBJ2-2
TGTGCCAGCAGGCTGACAGGTTTCACAGATACGCAGTATTTT	CASRLTGFTDTQYF	TRBV6-4	TRBJ2-3
TGTGCCAGCAGCCAACTTCCCAGACAGGGAAAGGGCACTGAAGCTTTCTTT	CASSQLPRQGKGTEAFF	TRBV14	TRBJ1-1
TGTGCCAGCAAGGGAACCCAGGACATTAATGGCTACACCTTC	CASKGTQDINGYTF	TRBV7-9	TRBJ1-2
TGTGCCACCAGTGCAGGGACGGAATGTCGCTACGAGCAGTACTTC	CATSAGTECRYEQYF	TRBV24-1	TRBJ2-7
TGTGCCACCAGTGATTTGTTCGCAACCGGGGGGAGGAGCTCCTACAATGAGCAGTTCTTC	CATSDLFATGGRSSYNEQFF	TRBV24-1	TRBJ2-1
TGCGCCAGCACAGGCTTCCCGGGGGGCAATCAGCCCCAGCATTTT	CASTGFPGGNQPQHF	TRBV10-2	TRBJ1-5
TGCGCCAGCAGCCAAGCAGGGGGCGGGAACTCTGGAAACACCATATATTTT	CASSQAGGGNSGNTIYF	TRBV4-1	TRBJ1-3
TGTGCCAGCAAAACCACACTAGCGGGCCTACGGGATACGCAGTATTTT	CASKTTLAGLRDTQYF	TRBV27	TRBJ2-3
TGTGCCACCAGCAGTTCCAGCGGACGCGGGGCTTGCACAGATACGCAGTATTTT	CATSSSSGRGACTDTQYF	TRBV15	TRBJ2-3
TGCGCCAGCAGGCAGGGACGGGTTGTGGCCACTTTATCTGAAGCTTTCTTT	CASRQGRVVATLSEAFF	TRBV10-1	TRBJ1-1
TGTGCCAGCAGGCCAGGGGAAGGGGTAGCTTTCTTT	CASRPGEGVAFF	TRBV25-1	TRBJ1-1
TGCAGTGCTAGAGGGCCTGGGGGGAGGGACACTGAAGCTTTCTTT	CSARGPGGRDTEAFF	TRBV20-1	TRBJ1-1
TGTGCCACCAGTGATTTGAGGCGGGGACAGGGCAATCAGCCCCAGCATTTT	CATSDLRRGQGNQPQHF	TRBV24-1	TRBJ1-5
TGTGCCAGCAGCTTAGACACCGGGACAGACGAGGACTACGAGCAGTACTTC	CASSLDTGTDEDYEQYF	TRBV11-2	TRBJ2-7
TGTGCCAGCAGTGACGGACCCCTGGTCAGTACTCGGCCGAACACCGGGGAGCTGTTTTTT	CASSDGPLVSTRPNTGELFF	TRBV6-4	TRBJ2-2
TGTGCCAGCAGTGAGGAGCCCATCCAGGGCCGGATAGGCCAGTACTTC	CASSEEPIQGRIGQYF	TRBV6-1	TRBJ2-5
TGTGCCAGCAGTCTTCGGGGGGGCACCTTC	CASSLRGGTF	TRBV6-6	TRBJ1-2
TGTGCCAGCAGCCAATTGGGCGGGGGCCACTTCCTATACTACGAGCAGTACTTC	CASSQLGGGHFLYYEQYF	TRBV3-1	TRBJ2-7
TGTGCCATCAGTGGAGTAGTACTTAGGAGGCTTCTGCGGGGGTTTAACTATGGCTACACCTTC	CAISGVVLRRLLRGFNYGYTF	TRBV10-3	TRBJ1-2
TGTGCCACCAACCAAACCGGGACTAGCGGGAGCCACACTGAAGCTTTCTTT	CATNQTGTSGSHTEAFF	TRBV24-1	TRBJ1-1
TGTGCCAGCAGCTTATTTGGGGTCAGACGAGGTAATGAAAAACTGTTTTTT	CASSLFGVRRGNEKLFF	TRBV5-4	TRBJ1-4
TGTGCCACCAGTGATGAGGAGATTATTGAGGGGGAGCTGTTTTTT	CATSDEEIIEGELFF	TRBV24-1	TRBJ2-2
TGCAGTGCTAGTTTCGAGCTAACTGAAGCTTTCTTT	CSASFELTEAFF	TRBV20-1	TRBJ1-1
TGTGCCAGCAGCTTAGATCACCCCCGGTCCTGTAGCGCCAGCACAGATACGCAGTATTTT	CASSLDHPRSCSASTDTQYF	TRBV11-3	TRBJ2-3
TGCGCCAGCACCCAGGGGGTCCATATACAAGAGACCCAGTACTTC	CASTQGVHIQETQYF	TRBV10-1	TRBJ2-5
TGTGCCAGCAGCGAGGGGGCTACTGAAGCTTTCTTT	CASSEGATEAFF	TRBV7-2	TRBJ1-1
TGTGCCAGCAGCGCCCAGGGGGATGGCTACACCTTC	CASSAQGDGYTF	TRBV13	TRBJ1-2
TGTGCAGTCCACTCCGGGACAGGGGGTAAGGTGAACACTGAAGCTTTCTTT	CAVHSGTGGKVNTEAFF	TRBV9	TRBJ1-1
TGTGCCAGCATCCTGGGGGGCTTGGCGAGTGGGTACAATCAGCCCCAGCATTTT	CASILGGLASGYNQPQHF	TRBV6-4	TRBJ1-5
TGTGCTAGTGTACGCCGGGGGGCGTTAGAGACCCAGTACTTC	CASVRRGALETQYF	TRBV12-5	TRBJ2-5
TGTGCCAGCAGTTATGCTAGTTTGAGGGATGAGCAGTTCTTC	CASSYASLRDEQFF	TRBV6-9	TRBJ2-1
TGTGCCAGCAGTCCGGGGGTTACGAACACTGAAGCTTTCTTT	CASSPGVTNTEAFF	TRBV27	TRBJ1-1
TGTGCCAGCAGCTTTATCAGAGGCTTC	CASSFIRGF	TRBV7-9	TRBJ2-7
TGCAGTGCGGAAGGGAAGCCTGGCAATCAGCCCCAGCATTTT	CSAEGKPGNQPQHF	TRBV20-1	TRBJ1-5
TGTGCCAGCAGCGGGAGTAGCGACCTTACCGGGGAGCTGTTTTTT	CASSGSSDLTGELFF	TRBV14	TRBJ2-2
TGTGCCAGCAGCTTGGGGGGTATAACTCTGGCCTACGAGCAGTACTTC	CASSLGGITLAYEQYF	TRBV7-2	TRBJ2-7
TGTGCCAGCAGCACGCCCCCGGACAGACATAACTATGGCTACACCTTC	CASSTPPDRHNYGYTF	TRBV9	TRBJ1-2
TGCAGTGCACAGTGCACGAAAGCATCGACCTATGGCTACACCTTC	CSAQCTKASTYGYTF	TRBV20-1	TRBJ1-2
TGTGCCAGCAGCCGGTTGTATAATGAGCAGTTCTTC	CASSRLYNEQFF	TRBV4-2	TRBJ2-1
TGTGCCATCGACGGCGGGAGTAGGGGGAAAGCTTTCTTT	CAIDGGSRGKAFF	TRBV10-3	TRBJ1-1
TGTGCCAGCAGCGCCGTGTTACCCAGAGCTCAGCCCCAGCATTTT	CASSAVLPRAQPQHF	TRBV7-8	TRBJ1-5
TGCGCCAGCACAACACGACAGGGGAGGGCCTACGAGCAGTACTTC	CASTTRQGRAYEQYF	TRBV5-1	TRBJ2-7
TGTGCCAGCAGCGTAGCGGGAGAGATCTACGAGCAGTACTTC	CASSVAGEIYEQYF	TRBV3-1	TRBJ2-7
TGTGCCAGCAGCAGCGGGCTCCCGGGGACGTTGGGAAACACCATATATTTT	CASSSGLPGTLGNTIYF	TRBV5-6	TRBJ1-3
TGTGCCAGCTCGGACCGGGACAGGGGAGGAGCCAAAAACATTCAGTACTTC	CASSDRDRGGAKNIQYF	TRBV13	TRBJ2-4
TGTGCCATCAGTTCAGGACAGGGAGGGTTAGGCTACACCTTC	CAISSGQGGLGYTF	TRBV10-3	TRBJ1-2
TGTGCCACCAGTGATTGTAAACCGGGACAGGTATGTGTAAGAAGTGAGCAGTACTTC	CATSDCKPGQVCVRSEQYF	TRBV24-1	TRBJ2-7
TGTGCCAGCAGCGCAGGGAGCTCTGGAAACACCATATATTTT	CASSAGSSGNTIYF	TRBV9	TRBJ1-3
TGTGCCAGCAAATTAGCGGGTCCCTCGAACACCGGGGAGCTGTTTTTT	CASKLAGPSNTGELFF	TRBV12-3	TRBJ2-2
TGTGCCAGCAGCCAAGCGGGACAGGCTAGGACCTCAACTAATGAAAAACTGTTTTTT	CASSQAGQARTSTNEKLFF	TRBV4-2	TRBJ1-4
TGTGCCAGCGAGAAACTGTTTTTT	CASEKLFF	TRBV6-1	TRBJ1-4
TGCAGTGCTAGCCCCGGGACAGGGAACACTGAAGCTTTCTTT	CSASPGTGNTEAFF	TRBV20-1	TRBJ1-1
TGTGCCAGCAGCTCGCTAAGCGGACAGGGGTCCGCGTATAGCAATCAGCCCCAGCATTTT	CASSSLSGQGSAYSNQPQHF	TRBV9	TRBJ1-5
TGTGCCAGCAGCTCCATGGGCAGCTCTGGAAACACCATATATTTT	CASSSMGSSGNTIYF	TRBV13	TRBJ1-3
TGCGCCAGCAGTGAGTCGAGGAAGGGGAAGAATCAGCCCCAGCATTTT	CASSESRKGKNQPQHF	TRBV10-1	TRBJ1-5
TGTGCCAGTAGTATATTACTAAAGCCCACCCGCTATAATTCACCCCTCCACTTT	CASSILLKPTRYNSPLHF	TRBV19	TRBJ1-6
TGTGCCAGGGGGCAATCGCCCCAGCATTTT	CARGQSPQHF	TRBV30	TRBJ1-5
TGCGCCAGCAGCTTTACAGGGACCCGTGCCTACGAGCAGTACTTC	CASSFTGTRAYEQYF	TRBV5-1	TRBJ2-7
TGTGCCAGCAGCTCTGGCCAGACCAGTGTCTCCGGGACAGGGGAGGTCACTAACTATGGCTACACCTTC	CASSSGQTSVSGTGEVTNYGYTF	TRBV7-9	TRBJ1-2
TGTGCCAGCAGTGTCTTCGTCCGGTCGGACGAGCAGTACTTC	CASSVFVRSDEQYF	TRBV5-4	TRBJ2-7
TGTGCCAGCAGGGGGGGCAGGGGCTACGAGCAGTACTTC	CASRGGRGYEQYF	TRBV7-9	TRBJ2-7
TGTGCCAGCAGGGGGTCTCCCGGGACAGGTGCGGAAGCTTTCTTT	CASRGSPGTGAEAFF	TRBV6-4	TRBJ1-1
TGTGCCAGCAGCCAAAGGCGGGACAGGGGAGACGAGCAGTACTTC	CASSQRRDRGDEQYF	TRBV3-1	TRBJ2-7
TGTGCTAGTGGTAGTTGGGGACTAGCGGTTGAGGAGCAGTACTTC	CASGSWGLAVEEQYF	TRBV12-5	TRBJ2-7
TGTGCCAGTGGGGTATCCTTCCCGGGACAAGGCTACGAGCAGTACTTC	CASGVSFPGQGYEQYF	TRBV19	TRBJ2-7
TGTGCCAGCAGAGGGGACAGGGGATTCAAAAAAGGTACAGGCTACACCTTC	CASRGDRGFKKGTGYTF	TRBV27	TRBJ1-2
TGTGCCAGCCGACTGAACACCGGGGAGCTGTTTTTT	CASRLNTGELFF	TRBV27	TRBJ2-2
TGTGCCAGCAGCCCTTGGCTAGCGAACGAGCAGTACTTC	CASSPWLANEQYF	TRBV13	TRBJ2-7
TGTGCCAGCAGTTACTCCCGTGCTGGCTACACCTTC	CASSYSRAGYTF	TRBV6-5	TRBJ1-2
TGTGCCAGCAGCTTAGGGTACGAACTAGCGGGCCCCTACGAGCAGTACTTC	CASSLGYELAGPYEQYF	TRBV11-2	TRBJ2-7
TGCAGTGCTAGAGATGTTCGCGTTGGGTGGTATAGCAATCAGCCCCAGCATTTT	CSARDVRVGWYSNQPQHF	TRBV20-1	TRBJ1-5
TGCAGTGCTAGTACAGGGAGCTACGAGCAGTACTTC	CSASTGSYEQYF	TRBV20-1	TRBJ2-7
TGTGCCACCAGTGATTTGCAGGGTTACCAGGGTCATCAGCCCCAGCATTTT	CATSDLQGYQGHQPQHF	TRBV24-1	TRBJ1-5
TGTGCTAGTGGTTTGGAACTAGCGGGAGGGCCTTCCTACGAGCAGTACTTC	CASGLELAGGPSYEQYF	TRBV12-5	TRBJ2-7
TGTGCCAGCACCCCCGGGCGGGAGGTCCTTGCTTTCTTT	CASTPGREVLAFF	TRBV6-8	TRBJ1-1
TGTGCCAGCAGTTTCCTAGTATCCGCAAGGGTCGAGCAGTACTTC	CASSFLVSARVEQYF	TRBV27	TRBJ2-7
TGTGCCAGCAGTGGACCGGTCGTACCTGGGGATGAGCAGTTCTTC	CASSGPVVPGDEQFF	TRBV6-5	TRBJ2-1
TGTGCCAGCAGCTCTCGGTGCACAGATACGCAGTATTTT	CASSSRCTDTQYF	TRBV7-9	TRBJ2-3
TGCGCCAGCAGCTTGCCTGTCGGACAGGGAACAGATACGCAGTATTTT	CASSLPVGQGTDTQYF	TRBV5-1	TRBJ2-3
TGTGCCAGCAGCCCGGACAGGGGGGAAGAGACCCAGTACTTC	CASSPDRGEETQYF	TRBV9	TRBJ2-5
TGTGCCACCAGTGAACACTATGGCTACACCTTC	CATSEHYGYTF	TRBV24-1	TRBJ1-2
TGCGCCAGCGAGGGGACAGGGGCAATTAGCTCCTACGAGCAGTACTTC	CASEGTGAISSYEQYF	TRBV4-1	TRBJ2-7
TGTGCCAGCAGTGTAAGGCTAGTCACCGGGGAGCTGTTTTTT	CASSVRLVTGELFF	TRBV12-4	TRBJ2-2
TGCGCCAGCAGCCGACTGGGTCACAATGAGCAGTTCTTC	CASSRLGHNEQFF	TRBV4-1	TRBJ2-1
TGTGCCAGCAGCTTAAATGAGGGGGACAGGCACACAGATACGCAGTATTTT	CASSLNEGDRHTDTQYF	TRBV7-6	TRBJ2-3
TGCGCCAGCAGCCACATTGGACAGGGGATGCCTCCTAGCTCCTATAATTCACCCCTCCACTTT	CASSHIGQGMPPSSYNSPLHF	TRBV4-3	TRBJ1-6
TGCGCCAGCAGCCAAGCAAAAGGAAGCAATCAGCCCCAGCATTTT	CASSQAKGSNQPQHF	TRBV4-3	TRBJ1-5
TGTGCCAGCAGCGTGACAGGGAGTAGCAATCAGCCCCAGCATTTT	CASSVTGSSNQPQHF	TRBV5-8	TRBJ1-5
TGCGCCAGCAGCTTCCGGCATCCCGGTGGAGGACAGTCCAATCAGCCCCAGCATTTT	CASSFRHPGGGQSNQPQHF	TRBV5-1	TRBJ1-5
TGTGCCAGCAGCTTAAGTGACAGGGCCCAGTACTTC	CASSLSDRAQYF	TRBV7-3	TRBJ2-5
TGTGCCAGCAGTGCAGGGTCGGGAGCTAACTATGGCTACACCTTC	CASSAGSGANYGYTF	TRBV2	TRBJ1-2
TGTGCCAGCAGTATTTCCCCGGACAGGGGCCGATGTTATAGCAATCAGCCCCAGCATTTT	CASSISPDRGRCYSNQPQHF	TRBV6-1	TRBJ1-5
TGTGCCAGCTCACCAATGGAACCCCCAGGAAGGGCCTGGGGACTAGCGTACTACGAGCAGTACTTC	CASSPMEPPGRAWGLAYYEQYF	TRBV18	TRBJ2-7
TGTGCCAGCAGCTTGGAGGGGGGGGAGACCAAGCCCCAGCATTTT	CASSLEGGETKPQHF	TRBV5-4	TRBJ1-5
TGTGCCATCAGTACGTTATTCTACGAGCAGTACTTC	CAISTLFYEQYF	TRBV10-3	TRBJ2-7
TGTGCCAGCAGCGTAGGTGGCCACCGGGGGACAGCAGCGGCCAATACGCAGTATTTT	CASSVGGHRGTAAANTQYF	TRBV9	TRBJ2-3
TGTGCCACGTCGGGACTAGTAAACACCGGGGAGCTGTTTTTT	CATSGLVNTGELFF	TRBV7-9	TRBJ2-2
TGTGCCAGGCCTTCTCCGGACAGGGTTGGCTACACCTTC	CARPSPDRVGYTF	TRBV19	TRBJ1-2
TGTGCCTGGACGGAGCTTTACGAGCAGTACTTC	CAWTELYEQYF	TRBV30	TRBJ2-7
