TGTGCCAGCAGCTCATCGGGACAGGCTAACTATGGCTACACCTTC	CASSSSGQANYGYTF	TRBV7-7	TRBJ1-2
TGTGCCAGCATTCAGGACAGCTTCAATGAGCAGTTCTTC	CASIQDSFNEQFF	TRBV28	TRBJ2-1
TGTGCCAGCAGCTTATGGGAGCGGGAAGCGCCACGGAAAGAGACCCAGTACTTC	CASSLWEREAPRKETQYF	TRBV7-3	TRBJ2-5
TGTGCCAGCAGTGACGGCGAGCAGTACTTC	CASSDGEQYF	TRBV9	TRBJ2-7
TGCGTTAGGACAGAACAGGGAACTCGCAAACACACTGAAGCTTTCTTT	CVRTEQGTRKHTEAFF	TRBV10-2	TRBJ1-1
TGTGCCAGCAGCCACCCTTTACCTAGCGGGGGGGCCTACAATGAGCAGTTCTTC	CASSHPLPSGGAYNEQFF	TRBV4-2	TRBJ2-1
TGTGCCAGCAGCCTTAAGGGGGAGAAGGAAAGGAGTGAGCAGTTCTTC	CASSLKGEKERSEQFF	TRBV6-4	TRBJ2-1
TGTGCCAGTAGTATCGGGCACGCAGGACTAGCGGGGGGGCCGGCCTACAATGAGCAGTTCTTC	CASSIGHAGLAGGPAYNEQFF	TRBV19	TRBJ2-1
TGTGCCAGTTATACGGACACGAAACTGTTTTTT	CASYTDTKLFF	TRBV11-3	TRBJ1-4
TGTGCCACCAGTGATTTTACAAGACTAGCGGGAGACAAGGACTACAATGAGCAGTTCTTC	CATSDFTRLAGDKDYNEQFF	TRBV24-1	TRBJ2-1
TGTGCCAGATCCATCGCCCAGGAGGGCTACACCTTC	CARSIAQEGYTF	TRBV6-4	TRBJ1-2
TGTGCTAGTGGTTTGGGATTAGCGGGTCGGTCTCAAGCCAAAAACATTCAGTACTTC	CASGLGLAGRSQAKNIQYF	TRBV12-5	TRBJ2-4
TGTGCCTGGAGTGTACCTCGCCGATCGCTCGACAGGGCCTCCTATGGCTACACCTTC	CAWSVPRRSLDRASYGYTF	TRBV30	TRBJ1-2
TGTGCCAGCAGCCAAGGGGGGGGGGACGGCCCCGGGGAGCTGTTTTTT	CASSQGGGDGPGELFF	TRBV3-1	TRBJ2-2
TGTGCCAGCAGCTTGCCGGGTTGGGGGGCAGCCCACAATGAGCAGTTCTTC	CASSLPGWGAAHNEQFF	TRBV7-9	TRBJ2-1
TGTGCCAGCAGCTATCTCTGCGAGACCCAGTACTTC	CASSYLCETQYF	TRBV11-2	TRBJ2-5
TGTGCCAGCAGTTTAAGCGGGACGCCCGAGCAGTACTTC	CASSLSGTPEQYF	TRBV12-3	TRBJ2-7
TGTGCCAGCAGTGAAGCGAGATACAGGGGGCCATTGCGCATTCAGTACTTC	CASSEARYRGPLRIQYF	TRBV6-1	TRBJ2-4
TGTGCCAGCGAAGACAGGGACGTCAACAATCAGCCCCAGCATTTT	CASEDRDVNNQPQHF	TRBV27	TRBJ1-5
TGTGCCAGCAGTGCGTCAGACAGGGACTATGGCTACACCTTC	CASSASDRDYGYTF	TRBV6-4	TRBJ1-2
TGTGCCAGCCTCCGGGACTTGTGGCTAGCCAAAAACATTCAGTACTTC	CASLRDLWLAKNIQYF	TRBV12-3	TRBJ2-4
TGTGCCAGCAGTCCCCGGGACAGTCTGGGCTACACCTTC	CASSPRDSLGYTF	TRBV4-2	TRBJ1-2
TGCGCCAGCAGTGGGGGTGCGGGAGACGAGCAGTACTTC	CASSGGAGDEQYF	TRBV10-1	TRBJ2-7
TGTGCCAGCAGCTTAAGGCGACGGAGCTACGAGCAGTACTTC	CASSLRRRSYEQYF	TRBV7-3	TRBJ2-7
TGTGCCAGCAGCGTGGGGATAGGCTATGGCTACACCTTC	CASSVGIGYGYTF	TRBV9	TRBJ1-2
TGTGCCAGCAGCGTTCAGAAGAACACTGAAGCTTTCTTT	CASSVQKNTEAFF	TRBV9	TRBJ1-1
TGTGCCAGCAGTGATACCTGGGGGAACTATTCACCCCTCCACTTT	CASSDTWGNYSPLHF	TRBV6-4	TRBJ1-6
TGTGCCAGCTCACCCGTTTTTTTCGAAGGACGCTACACCTTC	CASSPVFFEGRYTF	TRBV18	TRBJ1-2
TGTGCCAGCAGCTTAGCAGAGCCGGGACGGGCTAATGAAAAACTGTTTTTT	CASSLAEPGRANEKLFF	TRBV11-2	TRBJ1-4
TGTGCCAGCAGTTATATGGTGCATTTT	CASSYMVHF	TRBV27	TRBJ1-5
TGTGCCAGCAGCGCGGATACAAAGACAGGCCGGATGAACACTGAAGCTTTCTTT	CASSADTKTGRMNTEAFF	TRBV5-8	TRBJ1-1
TGTGCCAGCAGCGGGTCTGGGGTAGTAGATACGCAGTATTTT	CASSGSGVVDTQYF	TRBV9	TRBJ2-3
TGTGCCAGCAGCTATACACTAGCGGAGATCACCGGGGAGCTGTTTTTT	CASSYTLAEITGELFF	TRBV5-4	TRBJ2-2
TGTGCCAGCTTCGTGGGACAGAAGGGGGTACATTGCTACGAGCAGTACTTC	CASFVGQKGVHCYEQYF	TRBV7-9	TRBJ2-7
TGTGCCAGCAGTACTACTCGCTATGAGCAGTTCTTC	CASSTTRYEQFF	TRBV27	TRBJ2-1
TGTGCCAGCAGGGGGTGTTACACTGAAGCTTTCTTT	CASRGCYTEAFF	TRBV6-5	TRBJ1-1
TGCGCCAGCAGCTTGGTAGTGAACTGGGTCGGAAACACCATATATTTT	CASSLVVNWVGNTIYF	TRBV5-1	TRBJ1-3
TGTGCCAGCAGACCAAGCTACGAGCAGTACTTC	CASRPSYEQYF	TRBV12-4	TRBJ2-7
TGTGCCAGCAGTCACTTGAGATCAGGGGGGGCCTTAACTGAAGCTTTCTTT	CASSHLRSGGALTEAFF	TRBV6-1	TRBJ1-1
TGTGCCAGCAGCTCCGTTAACTGTCTTAGCAAACCATACGAGCAGTACTTC	CASSSVNCLSKPYEQYF	TRBV13	TRBJ2-7
TGTGCTAGCAGCTTAGACTGGACTAGCGGGGCCTCCGATACGCAGTATTTT	CASSLDWTSGASDTQYF	TRBV7-7	TRBJ2-3
TGTGCCAGCAGCCGTAATTACCGGGACCTGGGGCAGAATGAAAAACTGTTTTTT	CASSRNYRDLGQNEKLFF	TRBV27	TRBJ1-4
TGTGCCAGCAGCAGTCAGGGGAGGAACTATGGCTACACCTTC	CASSSQGRNYGYTF	TRBV13	TRBJ1-2
TGTGCCAGCAGCTTAGGACACGGACTAGCGGGCCCTTACGAGCAGTACTTC	CASSLGHGLAGPYEQYF	TRBV7-9	TRBJ2-7
TGTGCCAAGGTCCGGCCGAACTATGGCTACACCTTC	CAKVRPNYGYTF	TRBV6-4	TRBJ1-2
TGTGCCAGCAGTGGACTAGCGGGACAAGAGACCCAGTACTTC	CASSGLAGQETQYF	TRBV6-5	TRBJ2-5
TGTGCCAGCAGTTACTGCGTCGGGTGCCTAGCGAATGAGCAGTTCTTC	CASSYCVGCLANEQFF	TRBV6-5	TRBJ2-1
TGTGCCAGCAGCGACCCGGGGATGCCGGCTTTCTTT	CASSDPGMPAFF	TRBV5-6	TRBJ1-1
TGTGCCAGCAGCCAAGATATACGACTAGCGGGTCCCAACACCGGGGAGCTGTTTTTT	CASSQDIRLAGPNTGELFF	TRBV14	TRBJ2-2
TGCGCCAGCAATGTCAGATATAGGGTGAGGTTAACAGATACGCAGTATTTT	CASNVRYRVRLTDTQYF	TRBV5-1	TRBJ2-3
TGTGCCAGCAGCTTAGACAGGTCAAACGTCCAAGAGACCCAGTACTTC	CASSLDRSNVQETQYF	TRBV7-6	TRBJ2-5
TGTGCCAGCAGCTTGGCCCAAAGGGGGCGGATTCCACGCACAGATACGCAGTATTTT	CASSLAQRGRIPRTDTQYF	TRBV5-4	TRBJ2-3
TGTGCCAGCAGTTTCAACACGGGGGAAGAGACCCAGTACTTC	CASSFNTGEETQYF	TRBV27	TRBJ2-5
TGCAGCGTTGAAGGGACAGGGTACCGAGTTGGTAACTATGGCTACACCTTC	CSVEGTGYRVGNYGYTF	TRBV29-1	TRBJ1-2
TGCAGTGCTATCCCATACGGGGAGCTGTTTTTT	CSAIPYGELFF	TRBV20-1	TRBJ2-2
TGTGCCAGCAGCTGTGCGGCTGGTGAGCAGTTCTTC	CASSCAAGEQFF	TRBV7-3	TRBJ2-1
TGTGCCCGTACGACAGGGAAACTGTTTTTT	CARTTGKLFF	TRBV12-3	TRBJ1-4
TGTGCCAGCAAATACGCGGAAACCGCAGATACGCAGTATTTT	CASKYAETADTQYF	TRBV2	TRBJ2-3
TGTGCCAGCAGTGACACCCAGTTTCGAGATGTCGATGAAAAACTGTTTTTT	CASSDTQFRDVDEKLFF	TRBV6-4	TRBJ1-4
TGTGCCAGCGCCCAATCTGGGGAGGAGAGTGGCACCGGGGAGCTGTTTTTT	CASAQSGEESGTGELFF	TRBV7-8	TRBJ2-2
TGTGCCCCGACAGGGTATGAAGAGACCCAGTACTTC	CAPTGYEETQYF	TRBV27	TRBJ2-5
TGCGCCAGCAGCAATACATACCTCCAAGAGACCCAGTACTTC	CASSNTYLQETQYF	TRBV4-1	TRBJ2-5
TGTGCCAGCAGCGTAGGCCTATGTAGGGGAAACATTCAGTACTTC	CASSVGLCRGNIQYF	TRBV9	TRBJ2-4
TGTGCCAGCACAAAAGGGACGGGGCATTGGGAAATGAACACTGAAGCTTTCTTT	CASTKGTGHWEMNTEAFF	TRBV27	TRBJ1-1
TGTGCCACCAGTGATGGGGGCGATACGCAGTATTTT	CATSDGGDTQYF	TRBV24-1	TRBJ2-3
TGCGCCAGCCGTGGAGAAGAGACCCAGTACTTC	CASRGEETQYF	TRBV10-1	TRBJ2-5
TGTGCCAGCAGCCCCATGGTTAACTATGGCTACACCTTC	CASSPMVNYGYTF	TRBV13	TRBJ1-2
TGCGCCAGCAGCCCGACTCCGGGGGGGGAAAGCTACAATGAGCAGTTCTTC	CASSPTPGGESYNEQFF	TRBV10-1	TRBJ2-1
TGCAGCGTTGCGACCCCTTCAGTACCTGGGACGGGGGGGCATTACACGAACACTGAAGCTTTCTTT	CSVATPSVPGTGGHYTNTEAFF	TRBV29-1	TRBJ1-1
TGTGCCAGCAGTTTAAAAACCCTCCCGGGACAGGCCAAAAACATTCAGTACTTC	CASSLKTLPGQAKNIQYF	TRBV27	TRBJ2-4
TGTGCCAGCAGCTTAGAGGGCCCCAAGGAGGCCAGAAATTCACCCCTCCACTTT	CASSLEGPKEARNSPLHF	TRBV11-3	TRBJ1-6
TGCGCCAGCAGCCACGAGTCGGGGGGGTCCTCGGCTTTCTTT	CASSHESGGSSAFF	TRBV4-1	TRBJ1-1
TGCGCCAGCAGATTACAAGAGGGGTTGGGGGAGACCCAGTACTTC	CASRLQEGLGETQYF	TRBV10-1	TRBJ2-5
TGCGCCAGCAGCTCTGGGACAGGGGAAAACTCACCCCTCCACTTT	CASSSGTGENSPLHF	TRBV5-1	TRBJ1-6
TGTGCCAGCAGTTTAAACGGACAGGGGCCTCGCTACGGGAGTACTGAAGCTTTCTTT	CASSLNGQGPRYGSTEAFF	TRBV27	TRBJ1-1
TGTGCCAGCAGGGACAGGCGTGGGGGCAATCAGCCCCAGCATTTT	CASRDRRGGNQPQHF	TRBV3-1	TRBJ1-5
TGTGCCAGTAGCCCGGGGCAGATAGAGCACTCTGGAAACACCATATATTTT	CASSPGQIEHSGNTIYF	TRBV19	TRBJ1-3
TGTGCCAGCAGCTTCGGAGCGGGGATCTACGAGCAGTACTTC	CASSFGAGIYEQYF	TRBV7-3	TRBJ2-7
TGCGCCAGCAGCTCCCTGGGGGGCCGCTACGAGCAGTACTTC	CASSSLGGRYEQYF	TRBV5-1	TRBJ2-7
TGCGCCAGCAGCTTGCGTGGCCAGGGCTACACCTTC	CASSLRGQGYTF	TRBV5-1	TRBJ1-2
TGTGCCTGTTGTGGGGGGTTTTTCTACGAGCAGTACTTC	CACCGGFFYEQYF	TRBV30	TRBJ2-7
TGTGCCATCTCACTGGTCGGACAGGGTCGGCGTCAAGAGACCCAGTACTTC	CAISLVGQGRRQETQYF	TRBV10-3	TRBJ2-5
TGTGCTAGTGGTTTGGTACTCGGGACTAGCGGGAGGGCGGGAGTCGATACGCAGTATTTT	CASGLVLGTSGRAGVDTQYF	TRBV12-5	TRBJ2-3
TGTGCCAGCAGCGCAAAGGGACTATCCGCAGATACGCAGTATTTT	CASSAKGLSADTQYF	TRBV9	TRBJ2-3
TGTGCCAGCAGCAGACGGGACACCGCCGGGGAGCTGTTTTTT	CASSRRDTAGELFF	TRBV13	TRBJ2-2
TGTGCCAGCTCACTACTAAACGTGGGACTCACAGATACGCAGTATTTT	CASSLLNVGLTDTQYF	TRBV18	TRBJ2-3
TGTGCCAGCAGCTTCCCGGAGAATAATACGCAGTATTTT	CASSFPENNTQYF	TRBV5-6	TRBJ2-3
TGCAGTGCTCTTGGACAGGGGCGGGATTCACCCCTCCACTTT	CSALGQGRDSPLHF	TRBV20-1	TRBJ1-6
TGCGCCAGCAGCCAAGAAGGGACTAGCGCCTACGAGCAGTACTTC	CASSQEGTSAYEQYF	TRBV4-1	TRBJ2-7
TGTGCCAGCTCCAGGACAGGGAGTGGAACTGAAGCTTTCTTT	CASSRTGSGTEAFF	TRBV11-3	TRBJ1-1
TGCGCCAGCAGCCAAGGGGGCGGATCTGGGGCCAACGTCCTGACTTTC	CASSQGGGSGANVLTF	TRBV4-1	TRBJ2-6
TGCAGTGTGCCCACCCCGGGACGACTAACACGGAACACTGAAGCTTTCTTT	CSVPTPGRLTRNTEAFF	TRBV20-1	TRBJ1-1
TGCGCCAGCAGCCAAGCTTTTTCCCTAAGACAGGGGGGAAACACCATATATTTT	CASSQAFSLRQGGNTIYF	TRBV4-3	TRBJ1-3
TGCAGTGCTAGCCGACTAGGGATCTTC	CSASRLGIF	TRBV20-1	TRBJ2-1
TGTGCCAGCAGCTTTCGGACAGGGACTGAAGCTTTCTTT	CASSFRTGTEAFF	TRBV11-2	TRBJ1-1
TGTGCCAGCAGGGGGATCAGGGGGAATTCACCCCTCCACTTT	CASRGIRGNSPLHF	TRBV28	TRBJ1-6
TGCGCCAGCAGCTTCTTGGAGCAGGGAGAAGCGAACACTGAAGCTTTCTTT	CASSFLEQGEANTEAFF	TRBV5-1	TRBJ1-1
TGCGCCAGCATCCTAATCTGCACAGATACGCAGTATTTT	CASILICTDTQYF	TRBV10-1	TRBJ2-3
TGTGCCAGCAGTTATCTCCCCCTGCGGGACAGGGCTACGTTTCTTCAGCCCCAGCATTTT	CASSYLPLRDRATFLQPQHF	TRBV27	TRBJ1-5
TGCAGCGTTGAAGATGGGCGTTCTAGCGGGGGAGCCGGGGAGGCGCAGTATTTT	CSVEDGRSSGGAGEAQYF	TRBV29-1	TRBJ2-3
TGTGCCAGCAGCTGTAGGAGGAAGGCCAAAAACATTCAGTACTTC	CASSCRRKAKNIQYF	TRBV7-3	TRBJ2-4
TGTGCCAGCAGCTTGACGGACAGGAGCAATCAGCCCCAGCATTTT	CASSLTDRSNQPQHF	TRBV5-8	TRBJ1-5
TGTGCCAGCAGTTGGGAGCCCCCCTACGAGCAGTACTTC	CASSWEPPYEQYF	TRBV6-5	TRBJ2-7
TGTGCCAGCAGCGAGAGGCGGAATAAAACCGGGGAGACCCAGTACTTC	CASSERRNKTGETQYF	TRBV7-4	TRBJ2-5
TGTGCCAGCAGCAGCCGGGACAGCAGTTGGGGAAGGACCGGGGAGCTGTTTTTT	CASSSRDSSWGRTGELFF	TRBV11-2	TRBJ2-2
TGTGCCAGCAGCGGGGCGAATGAGCAGTTCTTC	CASSGANEQFF	TRBV13	TRBJ2-1
TGTGCCAGCTCACCAATGTTCCGGGACAGGGAATTAACTAATGAAAAACTGTTTTTT	CASSPMFRDRELTNEKLFF	TRBV18	TRBJ1-4
TGCAGTGCTAGGGTGGACAGCGAAAGGGGCACAGATACGCAGTATTTT	CSARVDSERGTDTQYF	TRBV20-1	TRBJ2-3
TGTGCCAGCAGTGACAGGGGCAAAGAGACCCAGTACTTC	CASSDRGKETQYF	TRBV28	TRBJ2-5
TGCGCCAGCAGCCCTGGGGGGTGGTTTGGGGAGCTGTTTTTT	CASSPGGWFGELFF	TRBV5-1	TRBJ2-2
TGTGCCAGCAGCTTAGAAGACGCTATCAATCAGCCCCAGCATTTT	CASSLEDAINQPQHF	TRBV11-2	TRBJ1-5
TGTGCCAGCAGCTCTACACCCGCAGCACAGGACACTGAAGCTTTCTTT	CASSSTPAAQDTEAFF	TRBV11-3	TRBJ1-1
TGTGCCAGCTTTAAGAATTGGGGACAGTCGACTGCGCCGTTGAACACTGAAGCTTTCTTT	CASFKNWGQSTAPLNTEAFF	TRBV7-9	TRBJ1-1
TGTGCCAGCAGGAACGGGAGGGGACTTACTGAGCAGTTCTTC	CASRNGRGLTEQFF	TRBV9	TRBJ2-1
TGCGCCAGCAGTGAAAGGACAGGGGGCGAGACCCAGTACTTC	CASSERTGGETQYF	TRBV10-1	TRBJ2-5
TGTGCCAGCATGAACAGGCTATACGAGCAGTACTTC	CASMNRLYEQYF	TRBV6-3	TRBJ2-7
TGTGCCAGCAGTATTGGCCCTAAACCCTGGGCGAACACCGGGGAGCTGTTTTTT	CASSIGPKPWANTGELFF	TRBV12-3	TRBJ2-2
TGTGCCAGCAATCCGTCCACAGTAAACACTGAAGCTTTCTTT	CASNPSTVNTEAFF	TRBV27	TRBJ1-1
TGCGCCAGCAGTCTACGGGGGAATTACAATGAGCAGTTCTTC	CASSLRGNYNEQFF	TRBV10-2	TRBJ2-1
TGTGCCAGCAGCCAAGCACTAGTGGCCTACGAGCAGTACTTC	CASSQALVAYEQYF	TRBV4-2	TRBJ2-7
TGCAGTGCTAGGGGGGGGACCGAGAAACTGTTTTTT	CSARGGTEKLFF	TRBV20-1	TRBJ1-4
TGTGCCAGCAGGGGTATGGAGGGGGCATATAGCAATCAGCCCCAGCATTTT	CASRGMEGAYSNQPQHF	TRBV6-8	TRBJ1-5
TGTGCCAGCAGCCAAGAACCCGGGGACAATGAGCAGTTCTTC	CASSQEPGDNEQFF	TRBV14	TRBJ2-1
TGTGCCAGCCAGACTAGCGGGAGCTATTACGAGCAGTACTTC	CASQTSGSYYEQYF	TRBV2	TRBJ2-7
TGTGCCAGCAGGGTACGGGGTGAAGCTTTCTTT	CASRVRGEAFF	TRBV6-6	TRBJ1-1
TGTGCCTGGAGCCCAACGGGTAACATGCCCCAGCATTTT	CAWSPTGNMPQHF	TRBV30	TRBJ1-5
TGTGCCAGCAGCCAAGAGAGAAGCGGGACTAGCGGGGGGGGCTACAATGAGCAGTTCTTC	CASSQERSGTSGGGYNEQFF	TRBV3-1	TRBJ2-1
TGTGCCAGTAGTGCGGGGCTTGGGGGCTACACCTTC	CASSAGLGGYTF	TRBV19	TRBJ1-2
TGCGCCAGCTTTTGGGCGGACAGACATAACATTCAGTACTTC	CASFWADRHNIQYF	TRBV10-1	TRBJ2-4
TGTGCCAGCACAACGGAACCCGGGACTAGCGGTTTCTCCTACGAGCAGTACTTC	CASTTEPGTSGFSYEQYF	TRBV28	TRBJ2-7
TGTGCCAGCAGCGAGCACCCCCTAAGGTACAATGAGCAGTTCTTC	CASSEHPLRYNEQFF	TRBV5-4	TRBJ2-1
TGCAGTGCTAGAGATTCTGGTTGGAGCTGCACAGATACGCAGTATTTT	CSARDSGWSCTDTQYF	TRBV20-1	TRBJ2-3
TGTGCCAGCAGCTTGGCCCATCGACGGGACCCCACTAATGAAAAACTGTTTTTT	CASSLAHRRDPTNEKLFF	TRBV5-5	TRBJ1-4
TGTGCCAGCAGCGCGGGGAGAGGATCCTCCTACGAGCAGTACTTC	CASSAGRGSSYEQYF	TRBV9	TRBJ2-7
TGTGCCAGCAGCTTGGGTCGGACAGGGGAATGCACAGATACGCAGTATTTT	CASSLGRTGECTDTQYF	TRBV5-8	TRBJ2-3
TGCGCCAGCAGCCTTCGGTATTCCTACGAGCAGTACTTC	CASSLRYSYEQYF	TRBV5-1	TRBJ2-7
TGTGCCAGTAGTATCTTGGGCTGGGACATTCGGGGGCTTCATTATAGCAATCAGCCCCAGCATTTT	CASSILGWDIRGLHYSNQPQHF	TRBV19	TRBJ1-5
TGTGCCAGCATCGGCAGTAAAGAAGAGCAGTTCTTC	CASIGSKEEQFF	TRBV6-5	TRBJ2-1
TGCGCCAGCAGCTTGACACAGGGGGCCTTACCCAATGAGCAGTTCTTC	CASSLTQGALPNEQFF	TRBV5-1	TRBJ2-1
TGTGCCAGCAGCTTAGAGAATTGTAGGGAAGCCCAGCCCCAGCATTTT	CASSLENCREAQPQHF	TRBV11-2	TRBJ1-5
TGTGCCACCAAGACAGGGACCCAGTACTTC	CATKTGTQYF	TRBV24-1	TRBJ2-5
TGTGCCAGCAGGAAACAGGGCCTACGGCCACCTAGCACAGATACGCAGTATTTT	CASRKQGLRPPSTDTQYF	TRBV6-1	TRBJ2-3
TGTGCCAGCAGCCCGAACGCTTACGCGGGTCACACGAACACTGAAGCTTTCTTT	CASSPNAYAGHTNTEAFF	TRBV3-1	TRBJ1-1
TGTGCCAGCAGCTTAAGACTGGGACTAGCGGCGAGGTTCTTC	CASSLRLGLAARFF	TRBV7-3	TRBJ2-1
TGCAGTGCTAGAGAAATCCGAAGGGGGTACTATGGCTACACCTTC	CSAREIRRGYYGYTF	TRBV20-1	TRBJ1-2
TGTGCCAGCAGCGGGGACTGGCCGGCAGATACGCAGTATTTT	CASSGDWPADTQYF	TRBV5-4	TRBJ2-3
TGTGCCAGCAGCCAAGAAGGTGGGACACCGGAAAAACTGTTTTTT	CASSQEGGTPEKLFF	TRBV14	TRBJ1-4
TGCGCCAGCAGCTTTGGGGGGGACTATGGCTACACCTTC	CASSFGGDYGYTF	TRBV4-1	TRBJ1-2
TGCGCCAGCAGTGCGTTGAGCTCTTGGTACGAGCAGTACTTC	CASSALSSWYEQYF	TRBV10-1	TRBJ2-7
TGTGCCAGTAGTCGTCTGACAGGAAGGATTGTGAACACTGAAGCTTTCTTT	CASSRLTGRIVNTEAFF	TRBV19	TRBJ1-1
TGTGCCAGCAGCTTAAAACCCTGTGGCGCCTACGAGCAGTACTTC	CASSLKPCGAYEQYF	TRBV11-2	TRBJ2-7
TGTGCCAGCAGCCAAGCGGATGAACACGAGGGGTCTGAAGCTTTCTTT	CASSQADEHEGSEAFF	TRBV4-2	TRBJ1-1
TGCAGTGCCCCGTTAAGGGCAGGCAACTCCTACGAGCAGTACTTC	CSAPLRAGNSYEQYF	TRBV20-1	TRBJ2-7
TGTGCCAGCAGCCGCCGAGGGGGGAACACCGGGGAGCTGTTTTTT	CASSRRGGNTGELFF	TRBV3-1	TRBJ2-2
TGCGCCAGCAGCTTGGCCCCGCCTTCAGAGGGCTATGGCTACACCTTC	CASSLAPPSEGYGYTF	TRBV5-1	TRBJ1-2
TGTGCCAGCAGCACACTAGCGGGAGGGGCTTACAATGAGCAGTTCTTC	CASSTLAGGAYNEQFF	TRBV11-3	TRBJ2-1
TGCAGTGCTAGATCAGATAAGTTGGGTTACACCGGGGAGCTGTTTTTT	CSARSDKLGYTGELFF	TRBV20-1	TRBJ2-2
TGTGCCACGGGGAGCAATCAGCCCCAGCATTTT	CATGSNQPQHF	TRBV6-1	TRBJ1-5
TGTGCCAGCAGCTGGGACAGGGTTGAAAAACTGTTTTTT	CASSWDRVEKLFF	TRBV7-7	TRBJ1-4
TGTGCCAGCAGCGGGGGAGCCGAGACCCAGTACTTC	CASSGGAETQYF	TRBV11-2	TRBJ2-5
TGTGCCAGCAGCGACCCGTTACGGGGGGGGGACCGGCCTGGGGCCAACGTCCTGACTTTC	CASSDPLRGGDRPGANVLTF	TRBV9	TRBJ2-6
TGTGCCAGCTCACCACCTGGCCGGGAGGACCATCAGCCCCAGCATTTT	CASSPPGREDHQPQHF	TRBV18	TRBJ1-5
TGTGCCAGCAGTTTACAGGATGACAGGGGAGATGGCTACACCTTC	CASSLQDDRGDGYTF	TRBV28	TRBJ1-2
TGTGCCAGCAGCCCCACACCGACGATTGGGGGCCTCCTTGAAAAACTGTTTTTT	CASSPTPTIGGLLEKLFF	TRBV14	TRBJ1-4
TGTGCCAGCATGCAAGGGGGCTACACCTTC	CASMQGGYTF	TRBV27	TRBJ1-2
TGTGCCATCAGTGAGTCAGGGGATAACACTGAAGCTTTCTTT	CAISESGDNTEAFF	TRBV10-3	TRBJ1-1
TGTGCCAGCATTCGTTGGGGTCGTGGCTACACCTTC	CASIRWGRGYTF	TRBV5-6	TRBJ1-2
TGTGCCTGGAGTGTACCGGCAAACTACTATTCACCCCTCCACTTT	CAWSVPANYYSPLHF	TRBV30	TRBJ1-6
TGTGCCAGCGTCATAGCGGAAACATGTCCCTACAATGAGCAGTTCTTC	CASVIAETCPYNEQFF	TRBV27	TRBJ2-1
TGTGCCAGCAGCGTGGCCCGGGACTCCTCCAGCAATCAGCCCCAGCATTTT	CASSVARDSSSNQPQHF	TRBV9	TRBJ1-5
TGCGCCAGCAGCCAAGAAGGGCGGGACAGGAGCAATCAGCCCCAGCATTTT	CASSQEGRDRSNQPQHF	TRBV4-1	TRBJ1-5
TGTGCCTGGAGTGTGCCCTTCGGACAGGGGAACTATGGCTACACCTTC	CAWSVPFGQGNYGYTF	TRBV30	TRBJ1-2
TGTGCCAGCAGTTATACGGGCCAAGAGACCCAGTACTTC	CASSYTGQETQYF	TRBV6-2	TRBJ2-5
TGTGCCAGCAGGGGACTAGCGGGTAGTAACACCGGGGAGCTGTTTTTT	CASRGLAGSNTGELFF	TRBV11-3	TRBJ2-2
TGTGCCAGCAGCTTAAGAACAACCGGGAACAACACCATATATTTT	CASSLRTTGNNTIYF	TRBV7-7	TRBJ1-3
TGTGCCAGCAGAAGACGGGGAGGACGGGTTTCCGAAAAACTGTTTTTT	CASRRRGGRVSEKLFF	TRBV7-3	TRBJ1-4
TGTGCCAGCAGCTTTGAAGGACAGGGGAAGGGGAGACTAGCCGGGCGCACGCACTTATACGAGCAGTACTTC	CASSFEGQGKGRLAGRTHLYEQYF	TRBV7-9	TRBJ2-7
TGTGCCAGCAATGACAGGGCTAAGACAGATACGCAGTATTTT	CASNDRAKTDTQYF	TRBV27	TRBJ2-3
TGTGCCAGCAGCATTGGACAGGGCAGGAACACTGAAGCTTTCTTT	CASSIGQGRNTEAFF	TRBV13	TRBJ1-1
TGTGCTAGCAGCCCCTACTTAGAAAAACTGTTTTTT	CASSPYLEKLFF	TRBV7-7	TRBJ1-4
TGTGCCAGCAGCTTAGCGGGCGATTCCTTCCCCTACGAGCAGTACTTC	CASSLAGDSFPYEQYF	TRBV7-2	TRBJ2-7
TGTGCCAGCAGCTTGAAAGTACGTACGCCCGAAATGGGGGCGTCCAATCAGCCCCAGCATTTT	CASSLKVRTPEMGASNQPQHF	TRBV5-6	TRBJ1-5
TGTGCCAGCAGTGACTCTAGGGGGACCGGGGAGCTGTTTTTT	CASSDSRGTGELFF	TRBV6-4	TRBJ2-2
TGTGCCAGCGAGGAAATGATGGATGGGGGGATGAACACTGAAGCTTTCTTT	CASEEMMDGGMNTEAFF	TRBV2	TRBJ1-1
TGCAGCCCGGGGGGAGGAAGCTCCTACAATGAGCAGTTCTTC	CSPGGGSSYNEQFF	TRBV29-1	TRBJ2-1
TGCAGTGCTAAGCGGGGGGCCCCAGGCGAGACCCAGTACTTC	CSAKRGAPGETQYF	TRBV20-1	TRBJ2-5
TGTGCCAGTCTCGCTGCCTACGAGCAGTACTTC	CASLAAYEQYF	TRBV6-4	TRBJ2-7
TGTGCCAGCAGTTCCCTGGGACAGCGGGTAAAACTGTTTTTT	CASSSLGQRVKLFF	TRBV28	TRBJ1-4
TGTGCCAGCAGTTTGGATGGGGACAACTCAAAAAACATTCAGTACTTC	CASSLDGDNSKNIQYF	TRBV27	TRBJ2-4
TGCGCCAGCAGCTACAGGGTTGGGACTATCGGAAACACCATATATTTT	CASSYRVGTIGNTIYF	TRBV5-1	TRBJ1-3
TGTGCCAGCAGCGGAGACAGGAAACGTACCGGGGAGCTGTTTTTT	CASSGDRKRTGELFF	TRBV11-3	TRBJ2-2
TGTGCCAGCAGCTTAGTAGAACACCGAAGCCTTTCCTACGAGCAGTACTTC	CASSLVEHRSLSYEQYF	TRBV7-2	TRBJ2-7
TGTGCCAGCAAAGTTTACTCGGCCCATCAGCCCCAGCATTTT	CASKVYSAHQPQHF	TRBV2	TRBJ1-5
TGTGCCAGCAGGCGAGGCCCAAATAACGGTGATTCACCCCTCCACTTT	CASRRGPNNGDSPLHF	TRBV6-5	TRBJ1-6
TGCGCCAGCAGGGAATCTCGGGACAGGGGGGCAAGGATCACAGATACGCAGTATTTT	CASRESRDRGARITDTQYF	TRBV10-2	TRBJ2-3
TGTGCCAGCAGTTTGGCGTCTAGCATTGGATACAATGAGCAGTTCTTC	CASSLASSIGYNEQFF	TRBV27	TRBJ2-1
TGTGCCAGCTCGGGGGGGTTAGATACGCAGTATTTT	CASSGGLDTQYF	TRBV6-5	TRBJ2-3
TGCGCCAGCAGCTTGTTCCACCCAGAGAGCACAGATACGCAGTATTTT	CASSLFHPESTDTQYF	TRBV5-1	TRBJ2-3
TGTGCCAAACGGGCTGAAGCTTTCTTT	CAKRAEAFF	TRBV12-4	TRBJ1-1
TGTGCCAGCAGCTTATCCCCGGGACAACCCTACGAGCAGTACTTC	CASSLSPGQPYEQYF	TRBV7-3	TRBJ2-7
TGTGCCAGCAGAAAAGGGTCTAGGAACTATGGCTACACCTTC	CASRKGSRNYGYTF	TRBV6-4	TRBJ1-2
TGTGCCAGCAGCTTAGTGCGGGAGGGTAACTATTGCTCCTACGAGCAGTACTTC	CASSLVREGNYCSYEQYF	TRBV7-2	TRBJ2-7
TGTGCCAGTAGTATGCCTAGGTTGAACACTGAAGCTTTCTTT	CASSMPRLNTEAFF	TRBV19	TRBJ1-1
TGTGCCAGCAGTTGGGCCCCCGACAGGGTGGACGAGCAGTACTTC	CASSWAPDRVDEQYF	TRBV6-2	TRBJ2-7
TGTGCCAGCAGCTTGCTTTGGACCGGACCAGGAGGACTAGCGACAACCGGGGAGCTGTTTTTT	CASSLLWTGPGGLATTGELFF	TRBV5-6	TRBJ2-2
TGTGCCACCAGTGATTTGACGAGGGGGTTTAATGAGCAGTTCTTC	CATSDLTRGFNEQFF	TRBV24-1	TRBJ2-1
TGTGCCAGCAGTTACTCGAGCCCGGGTGGACAGGGGGGCTTGAATGGCTACACCTTC	CASSYSSPGGQGGLNGYTF	TRBV6-3	TRBJ1-2
TGTGCCAGCAGTGCTAGCGGTAGGCCAGATACGCAGTATTTT	CASSASGRPDTQYF	TRBV6-4	TRBJ2-3
TGTGCCATCAGTGAGTCGCCGGGGGCACTTAATGAAAAACTGTTTTTT	CAISESPGALNEKLFF	TRBV10-3	TRBJ1-4
TGTGCCAGCCAGACAGGGGATATGGATTCCTACAATGAGCAGTTCTTC	CASQTGDMDSYNEQFF	TRBV19	TRBJ2-1
TGTGCCAGCGTGGGGGAAGCGGGGAACTATGGCTACACCTTC	CASVGEAGNYGYTF	TRBV25-1	TRBJ1-2
TGTGCCAGCAGTTCCATTTCTGTCGGACTAGCCTCAGCTTTCTTT	CASSSISVGLASAFF	TRBV6-1	TRBJ1-1
TGTGCCAGCAGCTTAATTGGTACGACTAGCTCAACAGATACGCAGTATTTT	CASSLIGTTSSTDTQYF	TRBV7-3	TRBJ2-3
TGTGCCAGGCCAACTAGCGGGGGGGCAAGACCAGATACGCAGTATTTT	CARPTSGGARPDTQYF	TRBV19	TRBJ2-3
TGCGCCAGCAGATTAGGGGGACAGGGGGGTGAAAGCACAGATACGCAGTATTTT	CASRLGGQGGESTDTQYF	TRBV10-1	TRBJ2-3
TGCGCCAGCAGCTTGATTCTTTACGGACCTTTTAACACTGAAGCTTTCTTT	CASSLILYGPFNTEAFF	TRBV5-1	TRBJ1-1
TGTGCCAGCAGTTACCTGGGGGGAAGAGACCCGATACGCAATCAGCCCCAGCATTTT	CASSYLGGRDPIRNQPQHF	TRBV6-5	TRBJ1-5
TGTGCCAGTAGTATAGATCGCCTAACTAGCGGGAGGGCAAGTAAGAACACTGAAGCTTTCTTT	CASSIDRLTSGRASKNTEAFF	TRBV19	TRBJ1-1
TGTGCCAGCAGGTGGTTGACTAGCGGATTGAGCACAGATACGCAGTATTTT	CASRWLTSGLSTDTQYF	TRBV2	TRBJ2-3
TGCGCCACTCGTCCGGGGAATATCAGTAACCCGCGGGAGACCTGCTACGAGCAGTACTTC	CATRPGNISNPRETCYEQYF	TRBV5-1	TRBJ2-7
TGTGCCAGCAGCCCCCACAAGGGGGAGAAGGGTTCACCCCTCCACTTT	CASSPHKGEKGSPLHF	TRBV7-4	TRBJ1-6
TGTGCCAGCAGCCTGGACGGGGGCACCCTCTCCTACGAGCAGTACTTC	CASSLDGGTLSYEQYF	TRBV14	TRBJ2-7
TGTGCCAGCCACCCGGTAGCGGGTCCAGGAAACGACGAGCAGTACTTC	CASHPVAGPGNDEQYF	TRBV7-9	TRBJ2-7
TGCGCCAGCAGTGACAGGGGGGACACTGAAGCTTTCTTT	CASSDRGDTEAFF	TRBV10-2	TRBJ1-1
TGCGCCAGCAGGAGACGTCCCGATACGCAGTATTTT	CASRRRPDTQYF	TRBV5-1	TRBJ2-3
TGTGCCAGCAGTTCAAGAGGGCGGAACTATGGCTACACCTTC	CASSSRGRNYGYTF	TRBV27	TRBJ1-2
TGTGCCAGCAGCTTAACCGGGACAGGGGAGGGGGCTAAGCATGAAAAACTGTTTTTT	CASSLTGTGEGAKHEKLFF	TRBV7-3	TRBJ1-4
TGTGCCAGCAGTGTGACTGCGAATCAGCCCCAGCATTTT	CASSVTANQPQHF	TRBV27	TRBJ1-5
TGTGCCACCGGATCATCAGGGTTAGAGCAGTACTTC	CATGSSGLEQYF	TRBV13	TRBJ2-7
TGTGCCAGCAGCTTAGCGCGGACAGAAACCTTGGAAAAACTGTTTTTT	CASSLARTETLEKLFF	TRBV7-4	TRBJ1-4
TGTGCCAGCAACTGCTCCTACAATGAGCAGTTCTTC	CASNCSYNEQFF	TRBV6-4	TRBJ2-1
TGTGCCAGCAGCGAACCGAATGGGGGGAGCGAGCAGTACTTC	CASSEPNGGSEQYF	TRBV9	TRBJ2-7
TGTGCCAGCAGTGACTCGAGGACTGGAAAGGCGGATGCAACTAATGAAAAACTGTTTTTT	CASSDSRTGKADATNEKLFF	TRBV6-4	TRBJ1-4
TGCGCCAGCAGGACCCCTCCATGGGACAGGGATGAGCAGTTCTTC	CASRTPPWDRDEQFF	TRBV10-1	TRBJ2-1
TGTGCCAGCAGCTTAGCGGGACTATTCACAGATACGCAGTATTTT	CASSLAGLFTDTQYF	TRBV7-2	TRBJ2-3
TGCAGCGTTTGGGTAGGGGGGACTAGCACAGATACGCAGTATTTT	CSVWVGGTSTDTQYF	TRBV29-1	TRBJ2-3
TGCGCCAGCAGTCGACGGAGGGACGGCAATCAGCCCCAGCATTTT	CASSRRRDGNQPQHF	TRBV5-1	TRBJ1-5
TGTGCCAGCAGCTTATCGGCTCCGGGACTAGCGGCTGGGGCAGATACGCAGTATTTT	CASSLSAPGLAAGADTQYF	TRBV5-5	TRBJ2-3
TGTGCCAGCAGCCTCCCCCGACAGTCTGAGCAGTTCTTC	CASSLPRQSEQFF	TRBV14	TRBJ2-1
TGTGCCAGCAATCCTAATCCGGGACAGGAAGTTATAACCTACGAGCAGTACTTC	CASNPNPGQEVITYEQYF	TRBV27	TRBJ2-7
TGCAGTGCTAGAGTAAAGACAGGGGCTCCGGTCGGCTACGAGCAGTACTTC	CSARVKTGAPVGYEQYF	TRBV20-1	TRBJ2-7
TGTGCCAGCAGCTTCAGAAAACTAGCGGGATGGATTAATGAGCAGTTCTTC	CASSFRKLAGWINEQFF	TRBV7-9	TRBJ2-1
TGTGCCACCAGCGGGCCGGGACTGGCTTCCCGGATCGATGATACGCAGTATTTT	CATSGPGLASRIDDTQYF	TRBV15	TRBJ2-3
TGCGCCAGCACAGCGGGGAGGCTAGTGCTTTACGAGCAGTACTTC	CASTAGRLVLYEQYF	TRBV10-1	TRBJ2-7
TGCAGTGCGGGGTCGACTAGCGGGAATGAGCAGTTCTTC	CSAGSTSGNEQFF	TRBV20-1	TRBJ2-1
TGCAGTGCCCTCCCGGGGATCTCCTACGAGCAGTACTTC	CSALPGISYEQYF	TRBV20-1	TRBJ2-7
TGTGCCAGCAAGGGTCGGGGGCGCAGAAGGGCTAACTATGGCTACACCTTC	CASKGRGRRRANYGYTF	TRBV7-9	TRBJ1-2
TGCAGTGCTAGAGATCGGGGAGATTATACAGGGAGGTTATATCAGCCCCAGCATTTT	CSARDRGDYTGRLYQPQHF	TRBV20-1	TRBJ1-5
TGTGCCAGCTCACCACTGGACGGGGTGGATGAGCAGTTCTTC	CASSPLDGVDEQFF	TRBV18	TRBJ2-1
TGTGCCAGCAGCACAGGGGCCACTGAAGCTTTCTTT	CASSTGATEAFF	TRBV11-2	TRBJ1-1
TGTGCCAGCAGTTTGAAAGGGGGGGAAAATGAGCAGTTCTTC	CASSLKGGENEQFF	TRBV27	TRBJ2-1
TGTGCCAGCAGTGATGGGAGAGCGGACCTGGTTAAGGGTAGCACAGATACGCAGTATTTT	CASSDGRADLVKGSTDTQYF	TRBV6-1	TRBJ2-3
TGTGCCAGCAGCAGTGTGGGGCGCTCGGAGACCCAGTACTTC	CASSSVGRSETQYF	TRBV9	TRBJ2-5
TGTGCCAGCAGCTTACAAGGGGGGGCCAAAAACATTCAGTACTTC	CASSLQGGAKNIQYF	TRBV7-3	TRBJ2-4
TGCGCCAGCCCGAGAAAGGATTCACCCCTCCACTTT	CASPRKDSPLHF	TRBV4-3	TRBJ1-6
TGCAGTGCTAGGTACCGCGGGGAGCTGTTTTTT	CSARYRGELFF	TRBV20-1	TRBJ2-2
TGCAGCGATGGGGGGACGTGCTACAATGAGCAGTTCTTC	CSDGGTCYNEQFF	TRBV29-1	TRBJ2-1
TGCGCCAGCAGCTTGCGGGTGGGCCCACAGTACCAAGAGACCCAGTACTTC	CASSLRVGPQYQETQYF	TRBV5-1	TRBJ2-5
TGTGCCAGTGACACAGGGTGGAGGTCCTACGAGCAGTACTTC	CASDTGWRSYEQYF	TRBV7-9	TRBJ2-7
TGCAGTGCTAGCGCAGCCGCCACCGGGGAGCTGTTTTTT	CSASAAATGELFF	TRBV20-1	TRBJ2-2
TGTGCCAGCAGTAGGGTGGGGGGAGCTAACTATGGCTACACCTTC	CASSRVGGANYGYTF	TRBV27	TRBJ1-2
TGTGCCAGCAGTGACAATTGCCAGAGGGACAGGGTTCCGAACACTGAAGCTTTCTTT	CASSDNCQRDRVPNTEAFF	TRBV6-4	TRBJ1-1
TGTGCCAGCTCCTGGGACAGAAGCAATCAGCCCCAGCATTTT	CASSWDRSNQPQHF	TRBV18	TRBJ1-5
TGCGCCAGCAGTCCTTCAGGATTAGTCGCCACTGAAGCTTTCTTT	CASSPSGLVATEAFF	TRBV10-1	TRBJ1-1
TGTGCCAGCAGCGACGCTGGTGGTAATGAGCAGTTCTTC	CASSDAGGNEQFF	TRBV7-3	TRBJ2-1
TGTGCCAGCAGTTACGCACAGGGTTCAGCTTTCTTT	CASSYAQGSAFF	TRBV6-2	TRBJ1-1
TGCGCCAGCAGCCTAAAGGACCGGGACAGGGGGACGAATTCACCCCTCCACTTT	CASSLKDRDRGTNSPLHF	TRBV5-1	TRBJ1-6
TGTGCCACCAGCAGAGATACCAGGTCCTTGGTCGGGGACAGGTGGTACGAGCAGTACTTC	CATSRDTRSLVGDRWYEQYF	TRBV15	TRBJ2-7
TGTGCCAGCAGCCTGACTTATGGCTACACCTTC	CASSLTYGYTF	TRBV7-6	TRBJ1-2
TGTGCCAGCAGCTTCAGATACGGACTAGCGGGGGGGCCGAACACCGGGGAGCTGTTTTTT	CASSFRYGLAGGPNTGELFF	TRBV7-8	TRBJ2-2
TGTGCCAGCAAAGTCCGGGACAATCAGCCCCAGCATTTT	CASKVRDNQPQHF	TRBV14	TRBJ1-5
TGTGCCACCAGTGATTTGAGGGGGGGCAGCTATGGAGAGTCCTACGAGCAGTACTTC	CATSDLRGGSYGESYEQYF	TRBV24-1	TRBJ2-7
TGCAGTGCTAGTGGTTTCCCGAGGGACAGGGCGAGCTCCTATAATTCACCCCTCCACTTT	CSASGFPRDRASSYNSPLHF	TRBV20-1	TRBJ1-6
TGTGCCAGCAGCTTAGTGCAAGACACAGATACGCAGTATTTT	CASSLVQDTDTQYF	TRBV7-8	TRBJ2-3
TGTGCCAGCAGCTCCATCTCTCGGGACAGGGTCCACAATCAGCCCCAGCATTTT	CASSSISRDRVHNQPQHF	TRBV7-3	TRBJ1-5
TGTGCCATCAGCAAACGGGGTCGGGCAGATACGCAGTATTTT	CAISKRGRADTQYF	TRBV10-3	TRBJ2-3
TGTGCCAGCAGCTTAGGGGGGAGTTCCTACAATGAGCAGTTCTTC	CASSLGGSSYNEQFF	TRBV7-2	TRBJ2-1
TGTGCCAGCAGTGACTATGACGACAGGGGGCACTATGGCTACACCTTC	CASSDYDDRGHYGYTF	TRBV12-4	TRBJ1-2
TGTGCCAGCAACAGAAGGGGTCCAAGAGAGACCCAGTACTTC	CASNRRGPRETQYF	TRBV28	TRBJ2-5
TGTGCCAGCAGTCGACCTAGCGGCGAAGAGACCCAGTACTTC	CASSRPSGEETQYF	TRBV6-5	TRBJ2-5
TGCGCCAGCAGCCTGTCCCCCCCCCCGGGACAGCCAATGAACACTGAAGCTTTCTTT	CASSLSPPPGQPMNTEAFF	TRBV4-3	TRBJ1-1
TGTGCCAGCAGCGGACAGGCGAGGGGCTACACCTTC	CASSGQARGYTF	TRBV7-4	TRBJ1-2
TGTGCCAGCAGACAACTGTATAGCTCCTACGAGCAGTACTTC	CASRQLYSSYEQYF	TRBV6-1	TRBJ2-7
TGTGCCAGCAGCAACGGAGGGCCCTGGAGAACCACTAAAAACTATGGCTACACCTTC	CASSNGGPWRTTKNYGYTF	TRBV13	TRBJ1-2
TGCGCCAGCAGCTCAAAGTTCCGGGACAGGGACCAGGTGGGTATGAACACTGAAGCTTTCTTT	CASSSKFRDRDQVGMNTEAFF	TRBV5-1	TRBJ1-1
TGCGCCAGCAGCTCTAATAAGGGAGCATATAGCAATCAGCCCCAGCATTTT	CASSSNKGAYSNQPQHF	TRBV5-1	TRBJ1-5
TGTGCCTGGATATGGCCGGGCTTGGCCAAAAACATTCAGTACTTC	CAWIWPGLAKNIQYF	TRBV30	TRBJ2-4
TGCGCCAGTCTACGGGCTGAGCAGTTCTTC	CASLRAEQFF	TRBV5-1	TRBJ2-1
TGTGCCAGCAGTCCTACTCTATGGGCCAAAAACATTCAGTACTTC	CASSPTLWAKNIQYF	TRBV6-5	TRBJ2-4
TGTGCCAGCAGTTTATTCGGGTTTAGTAGGGCCTACGAGCAGTACTTC	CASSLFGFSRAYEQYF	TRBV28	TRBJ2-7
TGTGCCAGCATCAATTCAGGGGGAAACACCATATATTTT	CASINSGGNTIYF	TRBV6-4	TRBJ1-3
TGCGCCAGCAGCTTGAGCAGGGGGGGCTATAGCAATCAGCCCCAGCATTTT	CASSLSRGGYSNQPQHF	TRBV5-1	TRBJ1-5
TGTGCCAGCAGCCCCCGGGACAGGGGAAAAAACATTCAGTACTTC	CASSPRDRGKNIQYF	TRBV2	TRBJ2-4
TGTGCCAGCAGCGTAGGGGTGGCGGTCGCCAAAAACATTCAGTACTTC	CASSVGVAVAKNIQYF	TRBV9	TRBJ2-4
TGTGCCAGTAGGGAGGCTACTAATGGAAACACCATATATTTT	CASREATNGNTIYF	TRBV19	TRBJ1-3
TGTGCCACCCATATGAATCTAGACGAGCAGTACTTC	CATHMNLDEQYF	TRBV15	TRBJ2-7
TGTGCCAGCAGTATGGTGGAGGGGATGGGGGCTGGAACTGGAGAGCGGGTGGGGAAACTGTTTTTT	CASSMVEGMGAGTGERVGKLFF	TRBV9	TRBJ1-4
TGTGCCAGCAGCCGATCGGGGGTAGAGACAGATACGCAGTATTTT	CASSRSGVETDTQYF	TRBV7-2	TRBJ2-3
TGTGCCATCCCAGGAAATGAGCAGTTCTTC	CAIPGNEQFF	TRBV30	TRBJ2-1
TGTGCCAGCAGCTTAGAACATAGCGGGGAGGGATTACTAGATACGCAGTATTTT	CASSLEHSGEGLLDTQYF	TRBV11-2	TRBJ2-3
TGCAGTGCTAGAGCGGCTCGCCCCGGGGGGGTCTACGAGCAGTACTTC	CSARAARPGGVYEQYF	TRBV20-1	TRBJ2-7
TGTGCCAGCAGTCGGGACAGGGTGGGCAATCAGCCCCAGCATTTT	CASSRDRVGNQPQHF	TRBV27	TRBJ1-5
TGTGCCAGCAGCGCCCCGGGGCGATTTATCAATGAGCAGTTCTTC	CASSAPGRFINEQFF	TRBV13	TRBJ2-1
TGTGCCAGCAGCTTAGGGCGCATGAACACTGAAGCTTTCTTT	CASSLGRMNTEAFF	TRBV11-3	TRBJ1-1
TGTGCCAGCAGCAACGCGGGAGTCCCCACTGGAAACACCATATATTTT	CASSNAGVPTGNTIYF	TRBV7-3	TRBJ1-3
TGTGCCAGTAAGGGTTCCCAGGGAACTTATGAGCAGTTCTTC	CASKGSQGTYEQFF	TRBV19	TRBJ2-1
TGTGCCAGCAGCTTAGACAGGGGTGGCTACACCTTC	CASSLDRGGYTF	TRBV11-3	TRBJ1-2
TGCGCCAGCAGCCCCGGGACAGCCTTGTACACCATATATTTT	CASSPGTALYTIYF	TRBV5-1	TRBJ1-3
TGTGCCAGCAGCCCCTTACAGAGGAGCGAGCAGTACTTC	CASSPLQRSEQYF	TRBV7-3	TRBJ2-7
TGTGCCAGCAGCACTGGGGCCCACAGGGGGAATGGAAACACCATATATTTT	CASSTGAHRGNGNTIYF	TRBV7-3	TRBJ1-3
TGTGCCAGCAGCTTAGACGGGGCCAGCTACAATGAGCAGTTCTTC	CASSLDGASYNEQFF	TRBV7-9	TRBJ2-1
TGCGCCAGCAGCCCCCCCGGGACAGCGACGAGCTCCTACGAGCAGTACTTC	CASSPPGTATSSYEQYF	TRBV4-1	TRBJ2-7
TGTGCCAGCAGTTACCGGGCGGGAGGGGCAGTTACCCATGAGCAGTTCTTC	CASSYRAGGAVTHEQFF	TRBV6-5	TRBJ2-1
TGTGCCAGCAGCTACCCCGACAGGCATCATGGTCTTAACTATGGCTACACCTTC	CASSYPDRHHGLNYGYTF	TRBV13	TRBJ1-2
TGTGCCAGCAGCTGTTTTACGGGTTGCATAAACCAAGAGACCCAGTACTTC	CASSCFTGCINQETQYF	TRBV11-2	TRBJ2-5
TGTGCCAGCAGAAGCCCACCACTGGAGGCTGCTAAGATCATGAATGCCTACGAGCAGTACTTC	CASRSPPLEAAKIMNAYEQYF	TRBV14	TRBJ2-7
TGTGCCAGCAGTGGTTTGGGACCCCCGGCCGGGACTAGCGGGAGGGAGAACACTGAAGCTTTCTTT	CASSGLGPPAGTSGRENTEAFF	TRBV25-1	TRBJ1-1
TGCGCCAGCACCGGGACAATTTACGAGCAGTACTTC	CASTGTIYEQYF	TRBV10-1	TRBJ2-7
TGTGCCAGCAGTCAGGGAACAAATGAAGCTTTCTTT	CASSQGTNEAFF	TRBV7-9	TRBJ1-1
TGTGCCAGCAGTGGGCCGGATCACAAACAGCCCCAGCATTTT	CASSGPDHKQPQHF	TRBV27	TRBJ1-5
TGTGCCGGGGGGGCCGGAACGGAGGAGACCCAGTACTTC	CAGGAGTEETQYF	TRBV9	TRBJ2-5
TGTGCCTGGAACGGGTGGGGGGGCGAGTACTTC	CAWNGWGGEYF	TRBV30	TRBJ2-5
TGTGCCAGCAGAATCCAGGGACGACCTGCAACTAATGAAAAACTGTTTTTT	CASRIQGRPATNEKLFF	TRBV9	TRBJ1-4
TGCAGCGTGACCTCCTACGAGCAGTACTTC	CSVTSYEQYF	TRBV29-1	TRBJ2-7
TGTGCCAGCAGTTACCCAGACAGGGGGCGGCCAGAGACCCAGTACTTC	CASSYPDRGRPETQYF	TRBV6-5	TRBJ2-5
TGCAGTGCTAGACCGGACAGGGGCAGGTCCTACGAGCAGTACTTC	CSARPDRGRSYEQYF	TRBV20-1	TRBJ2-7
TGTGCCAGCAGCACCCGGACAGGTGACGAGCAGTACTTC	CASSTRTGDEQYF	TRBV7-8	TRBJ2-7
TGCAGTGCTAGATCAGGGCTCGGAAGCTATGGCTACACCTTC	CSARSGLGSYGYTF	TRBV20-1	TRBJ1-2
TGTGCCAGCCCCCCTGACTGCGCAAATCAGCCCCAGCATTTT	CASPPDCANQPQHF	TRBV11-2	TRBJ1-5
TGTGCCAGCAGCGTGTTGGGACTAGCGGGGGGAGGCTACGAGCAGTACTTC	CASSVLGLAGGGYEQYF	TRBV7-9	TRBJ2-7
TGTGCCTGGAGTGTACAGGGGGGACAGGCTTTCTTT	CAWSVQGGQAFF	TRBV30	TRBJ1-1
TGTGCCAGCAGCTTAGCGGGAGCGGAGTACAATGAGCAGTTCTTC	CASSLAGAEYNEQFF	TRBV7-3	TRBJ2-1
TGTGCCAGCAGTACCCAACAGTCTCAGCCCCAGCATTTT	CASSTQQSQPQHF	TRBV6-3	TRBJ1-5
TGTGCCAGCAGAACCGGGACAGGGGGCGTGTGGAACACTGAAGCTTTCTTT	CASRTGTGGVWNTEAFF	TRBV6-5	TRBJ1-1
TGCGCCAGCAGTGATGACCCCTTCTTC	CASSDDPFF	TRBV10-1	TRBJ2-1
TGCGCCAGCAGCCAAGGGATAATGAATCAGCCCCAGCATTTT	CASSQGIMNQPQHF	TRBV4-1	TRBJ1-5
TGTGCCAGCAGCTCAGGGGTTCAGCCCCAGCATTTT	CASSSGVQPQHF	TRBV12-3	TRBJ1-5
TGCGCCAGCAGCTTGGGCGCATTTCATGAGACCCAGTACTTC	CASSLGAFHETQYF	TRBV5-1	TRBJ2-5
TGTGCCAGCAGCTTAGATTGGGGACAGGGCTACAATGAGCAGTTCTTC	CASSLDWGQGYNEQFF	TRBV11-3	TRBJ2-1
TGTGCCAGCAGTTATGGCGGTAGGTTTCCGGACTATGGCTACACCTTC	CASSYGGRFPDYGYTF	TRBV6-3	TRBJ1-2
TGCGCCAGCCCCGGGACTTCGGCCTCCTCTGGGGCCAACGTCCTGACTTTC	CASPGTSASSGANVLTF	TRBV10-2	TRBJ2-6
TGTGCCAGCAGCCCCAGACATGGATTGGCGGGAACGGGTTGCAATCAGCCCCAGCATTTT	CASSPRHGLAGTGCNQPQHF	TRBV3-1	TRBJ1-5
TGTGCCAGCAGTCAGGGGGCAGGGGGGTCTGGAAACACCATATATTTT	CASSQGAGGSGNTIYF	TRBV27	TRBJ1-3
TGTGCCAGCAGCTACACCGTGACGGGCAGTCATCTGAGCTCCTACGAGCAGTACTTC	CASSYTVTGSHLSSYEQYF	TRBV7-9	TRBJ2-7
TGTGCCAGCAGTGAAATGCCCTCATGGGGGGGCTCCTACGAGCAGTACTTC	CASSEMPSWGGSYEQYF	TRBV6-1	TRBJ2-7
TGCGCCAGCAGCTTGCGGGCATTTAATGAAAAACTGTTTTTT	CASSLRAFNEKLFF	TRBV5-1	TRBJ1-4
TGTGCCATCAGACCCAGGGGGCATGGTTCCTACGAGCAGTACTTC	CAIRPRGHGSYEQYF	TRBV10-3	TRBJ2-7
TGTGCCAGCAGTTCGGTGGCAGGGAGAAAAAGCATATATTTT	CASSSVAGRKSIYF	TRBV6-5	TRBJ1-3
TGCAGCGTGGGGGGGACAGTATACGAGCAGTACTTC	CSVGGTVYEQYF	TRBV29-1	TRBJ2-7
TGTGCCACCAGTGAGTGTAGAGAGGGTCCACCAACTAATGAAAAACTGTTTTTT	CATSECREGPPTNEKLFF	TRBV24-1	TRBJ1-4
TGTGCCAGAACTATCCTTCGGGGGACAGGCAACAATGAGCAGTTCTTC	CARTILRGTGNNEQFF	TRBV6-4	TRBJ2-1
TGTGCCAGCAGTGGCCTAACAGGTCCTAATCAGCCCCAGCATTTT	CASSGLTGPNQPQHF	TRBV6-3	TRBJ1-5
TGTGCCAGCCCTTCATATTCGGAGGGCCAGACCCAGTACTTC	CASPSYSEGQTQYF	TRBV11-1	TRBJ2-5
TGTGCCAGCAGCTGTAGCGGGAGGGATGAGCAGTTCTTC	CASSCSGRDEQFF	TRBV7-9	TRBJ2-1
TGTGCCAGCAGTTATGACTCACAGGGGACTGCCTACGAGCAGTACTTC	CASSYDSQGTAYEQYF	TRBV6-3	TRBJ2-7
TGTGCCAGCAGTGAACCCCCAGGGGCGCTTTCACAAGCTTTCTTT	CASSEPPGALSQAFF	TRBV2	TRBJ1-1
TGTGCCAGCGTCCTAGGGAACAGGGTGAACACTGAAGCTTTCTTT	CASVLGNRVNTEAFF	TRBV6-5	TRBJ1-1
TGTGCCAGCAGCCAAGATCCTAGACCGGGACAGGGGGCCTTCCCGGCCGAGCAGTACTTC	CASSQDPRPGQGAFPAEQYF	TRBV14	TRBJ2-7
TGTGCCAGCAGACATCGGGGGGAGACCCAGTACTTC	CASRHRGETQYF	TRBV6-5	TRBJ2-5
TGTGCCAGCAGCTTAGGCCCTGGGACCACAGGGGGCGTAACACGGAGGATCGGGGCAGATACGCAGTATTTT	CASSLGPGTTGGVTRRIGADTQYF	TRBV11-2	TRBJ2-3
TGCGCCAGCCGGAGGGGCGACACGGATCAGCCCCAGCATTTT	CASRRGDTDQPQHF	TRBV5-1	TRBJ1-5
TGTGCCAGCCGCCCTATAATACGGGCCCAAGAGACCCAGTACTTC	CASRPIIRAQETQYF	TRBV6-2	TRBJ2-5
TGTGCCAGCAGCCCCGGACAGCCCAACTACGAGCAGTACTTC	CASSPGQPNYEQYF	TRBV4-2	TRBJ2-7
TGCGCCAGCAGCCGGCGGACCTACGAGCAGTACTTC	CASSRRTYEQYF	TRBV4-1	TRBJ2-7
TGTGCCAGTCAGGGCAGCCAAGAGACCCAGTACTTC	CASQGSQETQYF	TRBV19	TRBJ2-5
TGTGCCAGCAGTTACCGGGGGTACGGCGGGGGCTCCTACAATGAGCAGTTCTTC	CASSYRGYGGGSYNEQFF	TRBV6-5	TRBJ2-1
TGTGCCAGCAGTGTCCACAGGGGTTTGTCTAACTATGGCTACACCTTC	CASSVHRGLSNYGYTF	TRBV6-1	TRBJ1-2
TGTGCTAGTGGAACGCCAAAACTGTTTTTT	CASGTPKLFF	TRBV12-5	TRBJ1-4
TGTGCCAGCAGCGTGGACAGGGGGGGTAGCTCCTACGAGCAGTACTTC	CASSVDRGGSSYEQYF	TRBV13	TRBJ2-7
TGCGCCGGCTCCTTCAGGGTGATTTTGAACACTGAAGCTTTCTTT	CAGSFRVILNTEAFF	TRBV4-3	TRBJ1-1
TGCAGTGCTAGAGTTCGGGAGGGGATTGAGCAGTTCTTC	CSARVREGIEQFF	TRBV20-1	TRBJ2-1
TGTGCCAGCAGTTTGAGTGGGGGTGGGCGGAAAGCTTCTGGAAACACCATATATTTT	CASSLSGGGRKASGNTIYF	TRBV12-3	TRBJ1-3
TGTGCCAGCAATCACAGGGCCGAGCAGTACTTC	CASNHRAEQYF	TRBV7-6	TRBJ2-7
TGCGCCAGCAACTGGGGGAGAGCTTTCTTT	CASNWGRAFF	TRBV5-1	TRBJ1-1
TGTGCCAGCAGCGGACAGGGAAAGAATCAGCCCCAGCATTTT	CASSGQGKNQPQHF	TRBV6-4	TRBJ1-5
TGCAGTGCTGCGTTTGGTCAAGGGCAGACCGGGGAGCTGTTTTTT	CSAAFGQGQTGELFF	TRBV20-1	TRBJ2-2
TGTGCCAGCATAGCGGGCACAGATACGCAGTATTTT	CASIAGTDTQYF	TRBV14	TRBJ2-3
TGTGCCAGCAGCCAAGGTTCCCTAGGGACTAGCGGGTTCGACAATGAGCAGTTCTTC	CASSQGSLGTSGFDNEQFF	TRBV3-1	TRBJ2-1
TGCGCCAGCAGCTTGCGGCAGGGGGCTAGAGAGCAGTACTTC	CASSLRQGAREQYF	TRBV5-1	TRBJ2-7
TGTGCCAGCACTTGGACCTCTGGAAACACCATATATTTT	CASTWTSGNTIYF	TRBV6-5	TRBJ1-3
TGTGCCAGCAGCGGGCAGCCAGGTTGGGACGAGCAGTACTTC	CASSGQPGWDEQYF	TRBV7-9	TRBJ2-7
TGTGCCAGCAGTGCTGGGGCCGCGGGAGAGACAGGCTCGGAAATCTTC	CASSAGAAGETGSEIF	TRBV6-4	TRBJ2-1
TGTGCCCCGTTACAGCAGCCCCAGCATTTT	CAPLQQPQHF	TRBV10-3	TRBJ1-5
TGTGCCAGCAGCGCCTTACGGGGGGAGAATGGCTACACCTTC	CASSALRGENGYTF	TRBV7-2	TRBJ1-2
TGTGCCAGCAGCTTAGGTCCCCCTAAACAGGGGGGACCCCCTCAAGAGACCCAGTACTTC	CASSLGPPKQGGPPQETQYF	TRBV7-9	TRBJ2-5
TGTGCCAGCAGTGGTTTCGTTCATAGCCCCAATGAGCAGTTCTTC	CASSGFVHSPNEQFF	TRBV6-1	TRBJ2-1
TGTGCCTGGAGGTACCGCTCCTCTTGTGTGACCTACGAGCAGTACTTC	CAWRYRSSCVTYEQYF	TRBV30	TRBJ2-7
TGCGCCAGCAGCAGTCAGGGAGTGGTCTCCTGCCAAGAGACCCAGTACTTC	CASSSQGVVSCQETQYF	TRBV5-1	TRBJ2-5
TGCGCCAGCAGCATCACCCGGGCCGACCCCTACGAGCAGTACTTC	CASSITRADPYEQYF	TRBV5-1	TRBJ2-7
TGTGCCACCAGTGATCTAAATATTAAACCAGGAAACACCATATATTTT	CATSDLNIKPGNTIYF	TRBV24-1	TRBJ1-3
TGTGCCAGCGTCCCGAGGGACTTTTCCCGTTGGCCGGGACTAGTCGGGGAGCTGTTTTTT	CASVPRDFSRWPGLVGELFF	TRBV6-6	TRBJ2-2
TGCGCCAGCAGCCAAGAAAGGGCGGGAGGGGCTGGGGCCAACGTCCTGACTTTC	CASSQERAGGAGANVLTF	TRBV4-1	TRBJ2-6
TGCAGTGCTATTGCGGGAGGGGATGAGCAGTTCTTC	CSAIAGGDEQFF	TRBV20-1	TRBJ2-1
TGCAGTGCTAGTTTTAGGGAAAACGGTGAGACCCAGTACTTC	CSASFRENGETQYF	TRBV20-1	TRBJ2-5
TGTGCCGGACTAGCGGGAGAGGTTTTACAAGAGACCCAGTACTTC	CAGLAGEVLQETQYF	TRBV30	TRBJ2-5
TGTGCCAACCCAGACTACGAGCAGTACTTC	CANPDYEQYF	TRBV19	TRBJ2-7
TGTGCCAGCAGCTTGCAACGGGAGAGCTACGAGCAGTACTTC	CASSLQRESYEQYF	TRBV5-8	TRBJ2-7
TGTGCCAGCAGCGGGATGTTGGACCCGGGGTTTTCGGACTATGGCTACACCTTC	CASSGMLDPGFSDYGYTF	TRBV7-6	TRBJ1-2
TGTGCCAGCCGCCTAGCGGGGAAAGAGACCCAGTACTTC	CASRLAGKETQYF	TRBV6-4	TRBJ2-5
TGTGCCAGCAGTTACTGGGGTAGTTCTACAGATACGCAGTATTTT	CASSYWGSSTDTQYF	TRBV6-5	TRBJ2-3
TGTGCCAGCAGCTGGGCAGGAAACGAGCAGTACTTC	CASSWAGNEQYF	TRBV7-4	TRBJ2-7
TGTGCCAGCAGCGGCCAATCCGGCAATGAGCAGTTCTTC	CASSGQSGNEQFF	TRBV9	TRBJ2-1
TGTGCCAGTAGTATACGGACGCAGTACTTC	CASSIRTQYF	TRBV19	TRBJ2-7
TGTGCCACCAGCAGAGTCGGGGGGGCGAATTATCAGGTCCAAGAGACCCAGTACTTC	CATSRVGGANYQVQETQYF	TRBV15	TRBJ2-5
TGTGCCAGCAGCTCCCGACAGGGGCCCAATGAGCAGTTCTTC	CASSSRQGPNEQFF	TRBV7-6	TRBJ2-1
TGTGCCAGCAGCTTAGGGATACAGGGTCGGTCCCAGTACTTC	CASSLGIQGRSQYF	TRBV11-2	TRBJ2-5
TGTGCCTTTCTTCCTAATAGGGACAGGGGGTTTTCACCCCTCCACTTT	CAFLPNRDRGFSPLHF	TRBV28	TRBJ1-6
TGCAGTGGGGTCCAGGGGTGGAACACTGAAGCTTTCTTT	CSGVQGWNTEAFF	TRBV20-1	TRBJ1-1
TGTGCCAGCAGCCGAGGAGGCCAAGCTCCGTGCAATCAGCCCCAGCATTTT	CASSRGGQAPCNQPQHF	TRBV6-5	TRBJ1-5
TGTGCCAGCAGTTACTCGACTAGCGGGGAAGAGACCCAGTACTTC	CASSYSTSGEETQYF	TRBV6-5	TRBJ2-5
TGTGCCAGCAGACCGGAACAGGTTGGCTACACCTTC	CASRPEQVGYTF	TRBV27	TRBJ1-2
TGTGCCACCTCACCGGACATTAGGGCAACTAATGAAAAACTGTTTTTT	CATSPDIRATNEKLFF	TRBV15	TRBJ1-4
TGCAGTGCTAGAACTCCGGTGCGTAGCAATCAGCCCCAGCATTTT	CSARTPVRSNQPQHF	TRBV20-1	TRBJ1-5
TGTGTCAAGGACGGGGGCACCAGCACAGATACGCAGTATTTT	CVKDGGTSTDTQYF	TRBV6-4	TRBJ2-3
TGTGCCAGTATCTTTCAGGGGGGGCTTGAAGCTTTCTTT	CASIFQGGLEAFF	TRBV19	TRBJ1-1
TGTGCCAGCAGCTGCAGGCACCCGGGACTAGCACTAAGCTCCTACAATGAGCAGTTCTTC	CASSCRHPGLALSSYNEQFF	TRBV13	TRBJ2-1
TGTGCCAGCAGTTTTGTCAACCGCTCCTACAATGAGCAGTTCTTC	CASSFVNRSYNEQFF	TRBV27	TRBJ2-1
TGTGCCAGCAGTGCAGGTCATTACTACGAGCAGTACTTC	CASSAGHYYEQYF	TRBV25-1	TRBJ2-7
TGTGCCACCAGTGATCTCAAGGCTAGCACAGATACGCAGTATTTT	CATSDLKASTDTQYF	TRBV24-1	TRBJ2-3
TGTGCCAGCAGCTTAGAGGCGATGCGGGACTTCAAACGCAATCAGCCCCAGCATTTT	CASSLEAMRDFKRNQPQHF	TRBV7-8	TRBJ1-5
TGTGCCAGCAGCTTCCTGACCCCGTACAATGAGCAGTTCTTC	CASSFLTPYNEQFF	TRBV9	TRBJ2-1
TGTGCCAGCAGTTTGAGCCAGGGCAGCAGACCCGAAAAGGGAGTAAAACTGTTTTTT	CASSLSQGSRPEKGVKLFF	TRBV28	TRBJ1-4
TGCGCCAGCAGTCTCAATTTGTCTCCGGCCCATTCGGCCTACGAGCAGTACTTC	CASSLNLSPAHSAYEQYF	TRBV10-1	TRBJ2-7
TGTGCTAGGGGGGGGGGGGCGAGGTATACGCAGTATTTT	CARGGGARYTQYF	TRBV12-5	TRBJ2-3
TGTGCCAGCGGCTCGAGGAGGGGGTGGGCCTCTGGAAACACCATATATTTT	CASGSRRGWASGNTIYF	TRBV6-1	TRBJ1-3
TGTGCCAGCAGCGTAGCTTTTAGGCACTATGGCTACACCTTC	CASSVAFRHYGYTF	TRBV9	TRBJ1-2
TGTGCCAGCAGCACGGGGGGGCTCCAAACAGGCGCGAACACCGGGGAGCTGTTTTTT	CASSTGGLQTGANTGELFF	TRBV6-5	TRBJ2-2
TGTGCCAGCAGCAAGCTATCCTACGAGCAGTACTTC	CASSKLSYEQYF	TRBV6-1	TRBJ2-7
TGCGCCAGTCACGGCGGCAATGAGCAGTTCTTC	CASHGGNEQFF	TRBV10-1	TRBJ2-1
TGTGCCAGCAGATCCACTAGCGGGAGTACGCGCTCCTACGAGCAGTACTTC	CASRSTSGSTRSYEQYF	TRBV28	TRBJ2-7
TGTGCCAGCAGCGGCAGGGGCCTAGAGCAGTACTTC	CASSGRGLEQYF	TRBV7-8	TRBJ2-7
TGTGCCAGCAGCCATGGGCGGACCTACGAGCAGTACTTC	CASSHGRTYEQYF	TRBV7-9	TRBJ2-7
TGCAGTGCTAGGGACAGGGGGGAGCAGTTCTTC	CSARDRGEQFF	TRBV20-1	TRBJ2-1
TGTGCCTGGGTGCGGGAGTCGGCGCTCACTGAAGCTTTCTTT	CAWVRESALTEAFF	TRBV30	TRBJ1-1
TGTGCCAGCAGCGGAGGGACACCTAATGAAAAACTGTTTTTT	CASSGGTPNEKLFF	TRBV9	TRBJ1-4
TGTGCCAGCAGCTTGACCGAGGTCGGGGATGGCTACACCTTC	CASSLTEVGDGYTF	TRBV5-6	TRBJ1-2
TGTGCCAGCAGTTTGCGTACCATCTTGAATCAGCCCCAGCATTTT	CASSLRTILNQPQHF	TRBV27	TRBJ1-5
TGTGCCAGCAGTGACGGGGGGGGGCGTCCAGATACGCAGTATTTT	CASSDGGGRPDTQYF	TRBV6-4	TRBJ2-3
TGTGCCACCCCCCGACTCAAAAATGAGCAGTTCTTC	CATPRLKNEQFF	TRBV24-1	TRBJ2-1
TGTGCCAGCAGCCACTATGGCTACACCTTC	CASSHYGYTF	TRBV6-6	TRBJ1-2
TGTGCCAGCACTGGGGGGCCTTCCGACGAGCAGTACTTC	CASTGGPSDEQYF	TRBV11-3	TRBJ2-7
TGTGCCAGCAGCGCAGGCATGTCCACTAGCCTACTCACAGATACGCAGTATTTT	CASSAGMSTSLLTDTQYF	TRBV11-3	TRBJ2-3
TGTGCCAGCAGTGATTGGCGCACAGATACGCAGTATTTT	CASSDWRTDTQYF	TRBV6-5	TRBJ2-3
TGTGCCAGCAGCTTGGGGGGGAGTAATGAAAAACTGTTTTTT	CASSLGGSNEKLFF	TRBV7-2	TRBJ1-4
TGTGCCTGGAGTGTAGAGAATTCTCGGCATAGCGAGCAGTACTTC	CAWSVENSRHSEQYF	TRBV30	TRBJ2-7
TGTGCCACCCTGGACAGCTGGGATGGCTACACCTTC	CATLDSWDGYTF	TRBV24-1	TRBJ1-2
TGCGCCAGCAGCACAGATCGACAGGGAGATACGCAGTATTTT	CASSTDRQGDTQYF	TRBV5-1	TRBJ2-3
TGTGCCAGCAGTGAAGCAGCTCGCGGTGAAAAACTGTTTTTT	CASSEAARGEKLFF	TRBV6-1	TRBJ1-4
TGCAGTGCATCCCGTCACAGGGGTCTCCACTTT	CSASRHRGLHF	TRBV20-1	TRBJ1-6
TGTGCCTGGAGCAGGGACGAGCAGTACTTC	CAWSRDEQYF	TRBV30	TRBJ2-7
TGTGCCAGCAACTCGTACAATGACAGCCCAGGTCACTATGGCTACACCTTC	CASNSYNDSPGHYGYTF	TRBV27	TRBJ1-2
TGTGCCAGCAGCACTAGCGGGAGGGCAGGGCAGGTAACCCTTGAGCAGTTCTTC	CASSTSGRAGQVTLEQFF	TRBV11-2	TRBJ2-1
TGTGCCAGCAGCTATTATAATTCGTATTACCAACAGAGGAGTAATCGCAATCAGCCCCAGCATTTT	CASSYYNSYYQQRSNRNQPQHF	TRBV7-3	TRBJ1-5
TGTGCCATCAGTGAGTCCCGCGCGGGACTAGGGGTCCAAGAGACCCAGTACTTC	CAISESRAGLGVQETQYF	TRBV10-3	TRBJ2-5
TGTGCCAGCAGCCAACCCCCCAGAGGCCAGGGGGGGCCGAAAGAAAAACTGTTTTTT	CASSQPPRGQGGPKEKLFF	TRBV7-9	TRBJ1-4
TGTGCCAGTAGTATCGGGGCTAGGGACAGGGATGGCTACACCTTC	CASSIGARDRDGYTF	TRBV19	TRBJ1-2
TGTGCCAGCAGCTTAACCTCTAACACCGGGGAGCTGTTTTTT	CASSLTSNTGELFF	TRBV7-3	TRBJ2-2
TGCGCCAGCAGCTTTGGGGGCGCTGGAATTGAGCAGTACTTC	CASSFGGAGIEQYF	TRBV5-1	TRBJ2-7
TGTCCATGGAAAGGGGACAGTCTATTCAATCAGCCCCAGCATTTT	CPWKGDSLFNQPQHF	TRBV14	TRBJ1-5
TGTGCCAGCAGCCATTATCATAGGGGCTACACCTTC	CASSHYHRGYTF	TRBV4-2	TRBJ1-2
TGTGCCAGCAGCTTAGCGATAAGGGGTCCCTCTGGAAACACCATATATTTT	CASSLAIRGPSGNTIYF	TRBV7-9	TRBJ1-3
TGTGCCATCAGCAGGGACAGGTTTGGCTACACCTTC	CAISRDRFGYTF	TRBV10-3	TRBJ1-2
TGTGCCAGCAGCCTCCCCGGGACTAGCGGGAGTGCACCGACCTCTGGGGCCAACGTCCTGACTTTC	CASSLPGTSGSAPTSGANVLTF	TRBV14	TRBJ2-6
TGCAGCGTTGGCCGGGAGAGGCATTCACCCCTCCACTTT	CSVGRERHSPLHF	TRBV29-1	TRBJ1-6
TGTGCCAGCAGCCCCGGAGGGCCTCCAGATACGCAGTATTTT	CASSPGGPPDTQYF	TRBV14	TRBJ2-3
TGCGCCAGCAGCGCGGAAGGGGGGGACAGGGGGGCGGAACCGGCTTTAGCCAAAAACATTCAGTACTTC	CASSAEGGDRGAEPALAKNIQYF	TRBV5-1	TRBJ2-4
TGTGCCTGGGCTCACAGGCGGGGCCCCCGGAATCAGCCCCAGCATTTT	CAWAHRRGPRNQPQHF	TRBV30	TRBJ1-5
TGTGCCAGCAGCATGGACAGCCGGGGGGGCGCCTACGAGCAGTACTTC	CASSMDSRGGAYEQYF	TRBV7-9	TRBJ2-7
TGCAGCGGGGGGCGATCCTCGGATAGCTTC	CSGGRSSDSF	TRBV29-1	TRBJ2-5
TGTGCCAGCACCCCTGGTCGGGGGGGGAGACGCAATGAGCAGTTCTTC	CASTPGRGGRRNEQFF	TRBV27	TRBJ2-1
TGCAGTCCTCCGGGACAGGGCTTTGGGGAGACCCAGTACTTC	CSPPGQGFGETQYF	TRBV20-1	TRBJ2-5
TGCGCCAGCAAGCGGGAGGGTTACACCATATATTTT	CASKREGYTIYF	TRBV10-1	TRBJ1-3
TGTGCCAGTGGCCCCGAGATGTATTTT	CASGPEMYF	TRBV19	TRBJ2-3
TGCAGTGCTAGAGATGGCCGGGACGAGACTCACTCCTACGAGCAGTACTTC	CSARDGRDETHSYEQYF	TRBV20-1	TRBJ2-7
TGCAGCGTTGGAGAGTCTCATGATAACTATGGCTACACCTTC	CSVGESHDNYGYTF	TRBV29-1	TRBJ1-2
TGCGCCAGCAGTGAAACAGTCAACATTCAGTACTTC	CASSETVNIQYF	TRBV10-1	TRBJ2-4
TGTGCCAGCAGTTCCTTAGAGGCGTTGGCAGATACGCAGTATTTT	CASSSLEALADTQYF	TRBV27	TRBJ2-3
TGTGCCAGCAGCCCCCTTTTGGGGGAAAAACTGTTTTTT	CASSPLLGEKLFF	TRBV27	TRBJ1-4
TGTGCCAGCAGCTCCCGTTTTTATCCCGGATGGCCCTACGAGCAGTACTTC	CASSSRFYPGWPYEQYF	TRBV7-2	TRBJ2-7
TGCAGTGCATTGCAATCGCCCCGGGACCACGGCTCCTACAATGAGCAGTTCTTC	CSALQSPRDHGSYNEQFF	TRBV20-1	TRBJ2-1
TGCGCCAGCGTCGTCCCGCGAGCGGCGGAGACCCAGTACTTC	CASVVPRAAETQYF	TRBV10-1	TRBJ2-5
TGTGCCAGTAGTATGGCCCGGGACATATGGAACACCATATATTTT	CASSMARDIWNTIYF	TRBV19	TRBJ1-3
TGTGCCAGCAGCTTTCCAGCACAGGGGGCTAACACTGAAGCTTTCTTT	CASSFPAQGANTEAFF	TRBV7-3	TRBJ1-1
TGTGCTAGCATTCTAGCGGGCAGATACGAGCAGTACTTC	CASILAGRYEQYF	TRBV7-7	TRBJ2-7
TGTGCCAGCCCGGGACTAGCGGGAAGCGAGTACAATGAGCAGTTCTTC	CASPGLAGSEYNEQFF	TRBV6-2	TRBJ2-1
TGTGCCAGCGTAAGGGGGGGATTGAATGAGCAGTTCTTC	CASVRGGLNEQFF	TRBV6-1	TRBJ2-1
TGTAGGCGGCTACAGGGGCGCTCCTCCTACGAGCAGTACTTC	CRRLQGRSSYEQYF	TRBV7-2	TRBJ2-7
TGTGCCAGCAGCAAAAGAAGATCAGGACAAATTTATGGCTACACCTTC	CASSKRRSGQIYGYTF	TRBV11-2	TRBJ1-2
TGTGCCAGCAGCTTCTCGGACAGCTACGAGCAGTACTTC	CASSFSDSYEQYF	TRBV7-3	TRBJ2-7
TGTGCCAGCAGCCAAGGTCTCGGGATTAGCACAGATACGCAGTATTTT	CASSQGLGISTDTQYF	TRBV4-2	TRBJ2-3
TGTGCCAGCGACAGGGACGGCTTCACCTACGAGCAGTACTTC	CASDRDGFTYEQYF	TRBV2	TRBJ2-7
TGTGCCAGCAGCTTAAAGTTTGGACGTAACTACCCAGATACGCAGTATTTT	CASSLKFGRNYPDTQYF	TRBV11-3	TRBJ2-3
TGTGCCAGCAGCTCCTACGGGGAGCCCTCCTACGAGCAGTACTTC	CASSSYGEPSYEQYF	TRBV11-3	TRBJ2-7
TGCGCCAGCACCCTGGGGGCGTATTTCACTGAAGCTTTCTTT	CASTLGAYFTEAFF	TRBV10-1	TRBJ1-1
TGTGCCAGCAGGGGGCCGCCCCAGCATTTT	CASRGPPQHF	TRBV6-4	TRBJ1-5
TGTGCCAGCAGTACCCTCGAGGCAGTCGGCTACACCTTC	CASSTLEAVGYTF	TRBV6-1	TRBJ1-2
TGTGCCAGCAGCCATAATGGCGGGTCTACGCAGTATTTT	CASSHNGGSTQYF	TRBV14	TRBJ2-3
TGTGCCAGCAGCTTAGGGCCATACGGGACAGAGAGCGGTAGGGCAACTAATGAAAAACTGTTTTTT	CASSLGPYGTESGRATNEKLFF	TRBV11-2	TRBJ1-4
TGTGCCAGCAGCGTGGACAGCAATCAGCCCCAGCATTTT	CASSVDSNQPQHF	TRBV13	TRBJ1-5
TGTGCCAGCCCCGACAGGGGACGGTATAGCAATCAGCCCCAGCATTTT	CASPDRGRYSNQPQHF	TRBV25-1	TRBJ1-5
TGTGCCAGCAGGGAGAAGCTCTATTTTCCGAACACCGGGGAGCTGTTTTTT	CASREKLYFPNTGELFF	TRBV28	TRBJ2-2
TGTGCCAGCTCACCTCTGAAGAGGGCTTTCTTT	CASSPLKRAFF	TRBV18	TRBJ1-1
TGTGCCACGGCCTCGGGAGGCAAGTCCTACGAGCAGTACTTC	CATASGGKSYEQYF	TRBV24-1	TRBJ2-7
TGTGCCAGCAGTTACGGGCTAGCGGGACGGGGTCAGAGACCCTACAATGAGCAGTTCTTC	CASSYGLAGRGQRPYNEQFF	TRBV6-5	TRBJ2-1
TGTGCCAGTAGTCCCCCTAGCGGCGCCGAGCAGTACTTC	CASSPPSGAEQYF	TRBV19	TRBJ2-7
TGTGCCAGCAGCCCTATGAATTGCTCTGGAAACACCATATATTTT	CASSPMNCSGNTIYF	TRBV27	TRBJ1-3
TGCAGTCCTGCCCAACATTGGGCCCGGGCTCCACAAGCTTTCTTT	CSPAQHWARAPQAFF	TRBV20-1	TRBJ1-1
TGTGCTAGTGGTTTGTTCGGGGGTGAAAAACTGTTTTTT	CASGLFGGEKLFF	TRBV12-5	TRBJ1-4
TGTGCCAGCAGCTTCCACTTCGAAGCTTTCTTT	CASSFHFEAFF	TRBV13	TRBJ1-1
TGTGCCAGCAGCTTACGAGGACTAGCGGGACGGAGCTCCTACAATGAGCAGTTCTTC	CASSLRGLAGRSSYNEQFF	TRBV7-9	TRBJ2-1
TGTGCCACCAGAAACAGACAGGTGGAGTCCACCGAGCAGTACTTC	CATRNRQVESTEQYF	TRBV24-1	TRBJ2-7
TGTGCCAGCAGCGTCCAGGGTGTTAAGAGCTCCTACGAGCAGTACTTC	CASSVQGVKSSYEQYF	TRBV13	TRBJ2-7
TGTGCCAGTGGGTCGCTAGCGGGAAATCCTAAACACAATGAGCAGTTCTTC	CASGSLAGNPKHNEQFF	TRBV19	TRBJ2-1
TGTGCCAGCTCACCGTTTTACAGGGGGCATAATCAGCCCCAGCATTTT	CASSPFYRGHNQPQHF	TRBV18	TRBJ1-5
TGTGCCAGCAGCTTATGCTTAGCATCTAGTAATGAAAAACTGTTTTTT	CASSLCLASSNEKLFF	TRBV11-1	TRBJ1-4
TGTGCCAGCAGCCTTCCTTCTTCCGGACTAGCGGGACTAGAGACCCAGTACTTC	CASSLPSSGLAGLETQYF	TRBV7-6	TRBJ2-5
TGTGAAGGGGGGCCCAATCAGCCCCAGCATTTT	CEGGPNQPQHF	TRBV12-3	TRBJ1-5
TGTGCCAGCAGCAGCGGGCTAGCGGGGTTAACCCCCAAAAACATTCAGTACTTC	CASSSGLAGLTPKNIQYF	TRBV13	TRBJ2-4
TGTGCCAGTAGTATAAGTCTCGCGGGACAGGGGAAGTCAGGTCTCTACGAGCAGTACTTC	CASSISLAGQGKSGLYEQYF	TRBV19	TRBJ2-7
TGTGCCAGCAGGGGACTGGAACGTAGTTCAGATACGCAGTATTTT	CASRGLERSSDTQYF	TRBV6-3	TRBJ2-3
TGTGCCAGCAGGCCGCGTTCCGGGGAGCTGTTTTTT	CASRPRSGELFF	TRBV7-9	TRBJ2-2
TGCGCCAGCAGCTTAGGCGGACAGGGGTGTGGGAGGGGGGACATGAACACTGAAGCTTTCTTT	CASSLGGQGCGRGDMNTEAFF	TRBV5-1	TRBJ1-1
TGCAGCGGCAGGGCGGGTCATAGCAATCAGCCCCAGCATTTT	CSGRAGHSNQPQHF	TRBV29-1	TRBJ1-5
TGTGCCACCAACCTGGGCCAGTATTCCCCCTACGAGCAGTACTTC	CATNLGQYSPYEQYF	TRBV15	TRBJ2-7
TGTGCCGGACTGGTTCCTTGCCTCGGGGTTAGAAGAACGACCGAGACCCAGTACTTC	CAGLVPCLGVRRTTETQYF	TRBV30	TRBJ2-5
TGTGCCGGACAGGGTGCCGAAGCTTTCTTT	CAGQGAEAFF	TRBV19	TRBJ1-1
TGTGCCAGCAGGAGGGGAAAGAAAAGCTCCTACGAGCAGTACTTC	CASRRGKKSSYEQYF	TRBV5-6	TRBJ2-7
TGCGCCAGCAGCCAGCGGGCCCGCAGGGGCGGATGGTCAGATACGCAGTATTTT	CASSQRARRGGWSDTQYF	TRBV4-1	TRBJ2-3
TGCTTTAGGTCAAACGGCCTCTGGGTAAATGAGCAGTTCTTC	CFRSNGLWVNEQFF	TRBV20-1	TRBJ2-1
TGTGCCAGCAGCCGTCTCGTCGGAAGCAAAAACATTCAGTACTTC	CASSRLVGSKNIQYF	TRBV5-4	TRBJ2-4
TGTGCCAGCAGCTTGTTACAAAGGAGCAATCAGCCCCAGCATTTT	CASSLLQRSNQPQHF	TRBV7-3	TRBJ1-5
TGTGCCAGCAGCTTAACGGGGGGGGGGCAAATCTATGGCTACACCTTC	CASSLTGGGQIYGYTF	TRBV7-3	TRBJ1-2
TGTGCCAGCAGCCGGGACCGGACATGTCGGAATGAGCAGTTCTTC	CASSRDRTCRNEQFF	TRBV7-9	TRBJ2-1
TGTGCCAGCAGCGAGGGGCGTACTGAAGCTTTCTTT	CASSEGRTEAFF	TRBV3-1	TRBJ1-1
TGCGCCAGCAGCCATCCGGAGGGGCCGTTCCCGAAACAGTACTTC	CASSHPEGPFPKQYF	TRBV4-3	TRBJ2-5
TGTGCGCGTTGCGGGACTAGCCCCTACAATGAGCAGTTCTTC	CARCGTSPYNEQFF	TRBV28	TRBJ2-1
TGTGCCAGCACTCATGACCAGCCCCAGCATTTT	CASTHDQPQHF	TRBV28	TRBJ1-5
TGTGCCAGAGGGGCCCCTAATGAAAAACTGTTTTTT	CARGAPNEKLFF	TRBV28	TRBJ1-4
TGCAGCGGGCGAACCCTGGACAGGGCCCTTGCGGGGGGCAATCAGCCCCAGCATTTT	CSGRTLDRALAGGNQPQHF	TRBV29-1	TRBJ1-5
TGTGCCAGCAGCGAGGGGGGGGGGGGGCCCTCCTACAATGAGCAGTTCTTC	CASSEGGGGPSYNEQFF	TRBV7-9	TRBJ2-1
TGTGCCAGCAGCTTAGCCCTCCTATGTAGGGGGGAGACCCAGTACTTC	CASSLALLCRGETQYF	TRBV7-3	TRBJ2-5
TGTGCCAGCAGACAGGGGTACATAGAAAAACAGCCCCAGCATTTT	CASRQGYIEKQPQHF	TRBV6-4	TRBJ1-5
TGCGCCAGCAGCTTGCCGGGGACAGTAGCGAGCAAATATAGCAATCAGCCCCAGCATTTT	CASSLPGTVASKYSNQPQHF	TRBV5-1	TRBJ1-5
TGCAGTGCACCGGACAACACTGAAGCTTTCTTT	CSAPDNTEAFF	TRBV20-1	TRBJ1-1
TGTGCCAGCAGCGAACGGGAAGGACAGGGCCGGAACACTGAAGCTTTCTTT	CASSEREGQGRNTEAFF	TRBV13	TRBJ1-1
TGTGCCAGCAGCACCCTCGGTGGTAATGAAAAACTGTTTTTT	CASSTLGGNEKLFF	TRBV13	TRBJ1-4
TGTGCCAGCAGCCTAAAGCGGGACAACGAAGCTTTCTTT	CASSLKRDNEAFF	TRBV7-4	TRBJ1-1
TGTGCCAGCAGTTACTCGAACCAAGGGCCGGCGGGGGACCAGAAAGCTTTCTTT	CASSYSNQGPAGDQKAFF	TRBV6-5	TRBJ1-1
TGTGCCAGCAGGGGGGGGGTTTTTGGGGAGACCCAGTACTTC	CASRGGVFGETQYF	TRBV25-1	TRBJ2-5
TGTGCCAGCCCTTATACTAGCGGGAGGAGGGAGCAGTACTTC	CASPYTSGRREQYF	TRBV6-4	TRBJ2-7
TGTGCCAGCAGCTTAAAGAGGATTCCGTACAGCCAGCCCCAGCATTTT	CASSLKRIPYSQPQHF	TRBV7-3	TRBJ1-5
TGCGCCAGCAGCCGGGGAAGCGGCCCGGGACATTCAGATACGCAGTATTTT	CASSRGSGPGHSDTQYF	TRBV4-3	TRBJ2-3
TGTGCCAGCAGCTGGGGCATCTTCACAGATACGCAGTATTTT	CASSWGIFTDTQYF	TRBV7-9	TRBJ2-3
TGTGCCAGCTCACCACGCCCGCAGGGGGCCTTC	CASSPRPQGAF	TRBV18	TRBJ1-2
TGTGCCCGGGGGGTAGTTGCTTTCTTT	CARGVVAFF	TRBV6-1	TRBJ1-1
TGTGCCTGGAGAGACGGTGGTTGCGCCCTCACAGATACGCAGTATTTT	CAWRDGGCALTDTQYF	TRBV30	TRBJ2-3
TGTGCCAGCAGCTTATCGGTATACGAGCAGTACTTC	CASSLSVYEQYF	TRBV7-9	TRBJ2-7
TGTGCCTGGATCCTCGGGGGAACCTACGAGCAGTACTTC	CAWILGGTYEQYF	TRBV30	TRBJ2-7
TGTGCCAGCAGTGTCCGAACTAGGACCCTGAGCAATCAGCCCCAGCATTTT	CASSVRTRTLSNQPQHF	TRBV6-8	TRBJ1-5
TGTGCCCAAACATACAGGGGACGATCCTACGAGCAGTACTTC	CAQTYRGRSYEQYF	TRBV3-1	TRBJ2-7
TGTGCTAGTGCCACCTCCCAGCATCAGGGGGCAGAGCAGTACTTC	CASATSQHQGAEQYF	TRBV12-5	TRBJ2-7
TGTGCTAGCAGCCTGGATCTAGCGGGCTCAGATACGCAGTATTTT	CASSLDLAGSDTQYF	TRBV7-7	TRBJ2-3
TGTGCTAGTGGTCGCCGATTGGGTATTAGCTCCTATAATTCACCCCTCCACTTT	CASGRRLGISSYNSPLHF	TRBV12-5	TRBJ1-6
TGTGCCAGCAGTTACCCCCAGGGGGCAGGCGAGCAGTACTTC	CASSYPQGAGEQYF	TRBV6-6	TRBJ2-7
TGTGCCAGCAGTGATTCCGCTAGCGGAAGCCTAAGGGGTGAGACAGATACGCAGTATTTT	CASSDSASGSLRGETDTQYF	TRBV6-1	TRBJ2-3
TGTGCCAGCAGCCCACAACATAGCAATCAGCCCCAGCATTTT	CASSPQHSNQPQHF	TRBV4-2	TRBJ1-5
TGTGCCCAGGTAGTTCGCGGGAGAGGGAACTATGGCTACACCTTC	CAQVVRGRGNYGYTF	TRBV7-8	TRBJ1-2
TGTGCCAGCAGCTCAAGAGCGGGAATTTTTCCGGGCTACGAGCAGTACTTC	CASSSRAGIFPGYEQYF	TRBV7-3	TRBJ2-7
TGCGCCAGCAGCCGTCCGGGTGACAGGGCCCCAGGGTGTGCAGATACGCAGTATTTT	CASSRPGDRAPGCADTQYF	TRBV4-1	TRBJ2-3
TGTGCCAGCAGCTTAGAGTGGCCTAGTAGCAAGTTTAGGGAGAAAGAGACCCAGTACTTC	CASSLEWPSSKFREKETQYF	TRBV11-3	TRBJ2-5
TGTGCTAGTGGTTCCATCATCGGCTACTCTGGGGCCAACGTCCTGACTTTC	CASGSIIGYSGANVLTF	TRBV12-5	TRBJ2-6
TGCGCCAGCAGCGGGAGATGGACGGATAATGAAAAACTGTTTTTT	CASSGRWTDNEKLFF	TRBV5-1	TRBJ1-4
TGCGCCAGCAGCTTGGTTAGCCACAGAGCCCGACGGATCTACGAGCAGTACTTC	CASSLVSHRARRIYEQYF	TRBV5-1	TRBJ2-7
TGTGCCACCGGTTTGTTGTATGTGACAGCCTACGAGCAGTACTTC	CATGLLYVTAYEQYF	TRBV6-3	TRBJ2-7
TGTGCCAGCAGCGCCTCCGACAGGGGGCTATGCGAGAGATCCTACGAGCAGTACTTC	CASSASDRGLCERSYEQYF	TRBV13	TRBJ2-7
TGTGCCACCAGCAGAGAGAGCCGGCAGGCTCGCCAGCCCCAGCATTTT	CATSRESRQARQPQHF	TRBV15	TRBJ1-5
TGTGCCAGCAGTGGTCTCCGGGACAGGGACCCCTACAATGAGCAGTTCTTC	CASSGLRDRDPYNEQFF	TRBV27	TRBJ2-1
TGCGCCAGCAGCTTGTCACCTCGGTATTGCTATGGCTACACCTTC	CASSLSPRYCYGYTF	TRBV5-1	TRBJ1-2
TGTGCCAGCAGCTGGTACCTGGGGGGCCGTAAAACGGGCTCCTACAATGAGCAGTTCTTC	CASSWYLGGRKTGSYNEQFF	TRBV7-3	TRBJ2-1
TGTGCCAGCAGTTTATGCACTCGAAGGGTTGGGCATGGCTACACCTTC	CASSLCTRRVGHGYTF	TRBV28	TRBJ1-2
TGTGCCAGCAGCCAAAACCAGGGGGTGTCTGGGGCCAACGTCCTGACTTTC	CASSQNQGVSGANVLTF	TRBV6-1	TRBJ2-6
TGTGCCAGCAGCTCGTCGGCTTGTGGACAATGCGAGCAGTACTTC	CASSSSACGQCEQYF	TRBV7-2	TRBJ2-7
TGTGCCAGCAGCTTGGGGACTAGCGGGAACACCGGGGAGCTGTTTTTT	CASSLGTSGNTGELFF	TRBV7-8	TRBJ2-2
TGTGCCAGCAGCAGTTTAATGGGACTGGCGGAGACCCAGTACTTC	CASSSLMGLAETQYF	TRBV11-2	TRBJ2-5
TGTGCCAGCAGCGTAGCTTTAATGGGGGCATTGTCCCTCCACTTT	CASSVALMGALSLHF	TRBV9	TRBJ1-6
TGTGCCATCAGTGCATTAAACATCGGGGGGCCTGATGAGCAGTTCTTC	CAISALNIGGPDEQFF	TRBV10-3	TRBJ2-1
TGTGCCAGCATCCGGTTAGCGGGGATCTTC	CASIRLAGIF	TRBV6-4	TRBJ2-1
TGTGCCAGCAGTTCCAAGTGCGCGGAGGGGGGGCAGCATTTT	CASSSKCAEGGQHF	TRBV12-4	TRBJ1-5
TGTGCCAGCAGCTTAACAACCCATACCCAGACTAGCGGGAGTCCCACAGATACGCAGTATTTT	CASSLTTHTQTSGSPTDTQYF	TRBV11-3	TRBJ2-3
TGTGCCAGCAGTAAGACAGGTAGGATTGATAATTCACCCCTCCACTTT	CASSKTGRIDNSPLHF	TRBV25-1	TRBJ1-6
TGTGCCACCAGTGATTTAGTCGGGACTCGTCAGCCCCAGCATTTT	CATSDLVGTRQPQHF	TRBV24-1	TRBJ1-5
TGCGCCAGCAGTGAAAACGACAGGGGGGACTGGAAGAACACTGAAGCTTTCTTT	CASSENDRGDWKNTEAFF	TRBV10-1	TRBJ1-1
TGCGCCAGCAGCCAAGCCAGTAGACAGGTCCCGACTTCTGAAAAACTGTTTTTT	CASSQASRQVPTSEKLFF	TRBV4-3	TRBJ1-4
TGTGCCAGCAGCTTGGGATTTAGCGGCGAGCAGTACTTC	CASSLGFSGEQYF	TRBV5-5	TRBJ2-7
TGTGCCAGCAGTTACGGAGGCCGTCCCAATCAGCCCCAGCATTTT	CASSYGGRPNQPQHF	TRBV6-5	TRBJ1-5
TGTGCGCCCCCGGACGATGCACCAGATACGCAGTATTTT	CAPPDDAPDTQYF	TRBV4-2	TRBJ2-3
TGTGCCAGCCCGGGGCGCCTTCCGGGCGAGCAGTACTTC	CASPGRLPGEQYF	TRBV5-6	TRBJ2-7
TGTGCCAGCAGTAGAGCGGGGGCGCCAGAAGAGACCCAGTACTTC	CASSRAGAPEETQYF	TRBV12-3	TRBJ2-5
TGTGCCACGGGGATAAACGGCTCCTACGAGCAGTACTTC	CATGINGSYEQYF	TRBV9	TRBJ2-7
TGCAGTGCTAGTTCGTCTGTCGAGCAGTACTTC	CSASSSVEQYF	TRBV20-1	TRBJ2-7
TGTGCCAGCAGTCCGGGACAGTACGAGCAGTACTTC	CASSPGQYEQYF	TRBV25-1	TRBJ2-7
TGTGCCAGCATAAGGACAGGGAACACCGGGGAGCTGTTTTTT	CASIRTGNTGELFF	TRBV6-4	TRBJ2-2
TGTGCCAGCAGTGACGGATCAAGACAGAAAAATCAGCCCCAGCATTTT	CASSDGSRQKNQPQHF	TRBV6-1	TRBJ1-5
TGCAGTGCCCAGGGACAGAGCCTCCCCCAGCATTTT	CSAQGQSLPQHF	TRBV20-1	TRBJ1-5
TGCAGCGTGTGGACTAGCCCTCCCTACGAGCAGTACTTC	CSVWTSPPYEQYF	TRBV29-1	TRBJ2-7
TGTGCCAGCAGGTACCCGGGGGGGTCGGGTTCACCCCTCCACTTT	CASRYPGGSGSPLHF	TRBV28	TRBJ1-6
TGTGCCAGCATCCCATCAGGGGGCGTAATCTACGAGCAGTACTTC	CASIPSGGVIYEQYF	TRBV2	TRBJ2-7
TGTGCCAGCAGCGCACAGATCAGGGCTGCCTACGAGCAGTACTTC	CASSAQIRAAYEQYF	TRBV13	TRBJ2-7
TGTGCCAGCACGTCCGGACTAGCGGGCAGGGGGGTCACAGATACGCAGTATTTT	CASTSGLAGRGVTDTQYF	TRBV14	TRBJ2-3
TGTGCCAGCAGCTTACGCATTGCCCTAGCGGGCACTGGTATAACAACAGATACGCAGTATTTT	CASSLRIALAGTGITTDTQYF	TRBV7-2	TRBJ2-3
TGCGCCAGCAGCTTGGTAACTAGTTTCTACGAGCAGTACTTC	CASSLVTSFYEQYF	TRBV5-1	TRBJ2-7
TGTGCCAGCAGCATCCGACAGGGCGGGGACACTGAAGCTTTCTTT	CASSIRQGGDTEAFF	TRBV13	TRBJ1-1
TGTGCCAGCAGTTACTTGGGACTCTTACGTTACTTC	CASSYLGLLRYF	TRBV6-5	TRBJ2-5
TGTGCCAGCAGTTACTTTCAGCCCCAGCATTTT	CASSYFQPQHF	TRBV12-3	TRBJ1-5
TGTGCCAGCAGTTTGACGGGACATGTAGGCTACACCTTC	CASSLTGHVGYTF	TRBV28	TRBJ1-2
TGTGCCAGCAGGGGCGGGAGATGCAATCAGCCCCAGCATTTT	CASRGGRCNQPQHF	TRBV7-9	TRBJ1-5
TGCAGTGCTAGAGGGGGCGCGCGGGCCTCTGGGGCCAACGTCCTGACTTTC	CSARGGARASGANVLTF	TRBV20-1	TRBJ2-6
TGTGCCAGCAGCAAAGGCGGACAGGGCCAAGGCTCCTACGAGCAGTACTTC	CASSKGGQGQGSYEQYF	TRBV7-9	TRBJ2-7
TGTGCCAGCAGCCAAGTTTTAATGGGCATGGAAAACATTCAGTACTTC	CASSQVLMGMENIQYF	TRBV3-1	TRBJ2-4
TGTGCCAGCTCACCCTCACAGGAATATGGCTACACCTTC	CASSPSQEYGYTF	TRBV18	TRBJ1-2
TGCAGTGCTAGCAAATTGCCTACGGGCGGGGAAAAACTGTTTTTT	CSASKLPTGGEKLFF	TRBV20-1	TRBJ1-4
TGCGGCTACAGGGCCAATCAGCCCCAGCATTTT	CGYRANQPQHF	TRBV5-1	TRBJ1-5
TGTGCCAGCAGCTTGGACCTAGCGGGGGTTGAGCAGTTCTTC	CASSLDLAGVEQFF	TRBV5-6	TRBJ2-1
TGCGCCAGCACCCAGGTCCAGGGTAGACAGACCCAGTACTTC	CASTQVQGRQTQYF	TRBV10-1	TRBJ2-5
TGCGCCAGCAACCTGAGCGGGACATCGAATCAGCCCCAGCATTTT	CASNLSGTSNQPQHF	TRBV4-3	TRBJ1-5
TGCGCCAGCAATGGAGGGGGAAGGGAGCAGTACTTC	CASNGGGREQYF	TRBV10-1	TRBJ2-7
TGCGCCAGCAGTGAGTCTGGCCCAAGGGAGAACACTGAAGCTTTCTTT	CASSESGPRENTEAFF	TRBV10-1	TRBJ1-1
TGCGCCAGCAGCCAAGGCAGGGAAGATGAGCAGTTCTTC	CASSQGREDEQFF	TRBV4-3	TRBJ2-1
TGTGCCAGCAGATGCAGGGGCCACTACGAGCAGTACTTC	CASRCRGHYEQYF	TRBV6-6	TRBJ2-7
TGTGCCAGCAGTTACTCGAGTGCGGTGCGGGTTAGCACAGATACGCAGTATTTT	CASSYSSAVRVSTDTQYF	TRBV6-5	TRBJ2-3
TGTGCCAGCAGCCAACAGAGGGACAGGGCAGACAATGAGCAGTTCTTC	CASSQQRDRADNEQFF	TRBV4-2	TRBJ2-1
TGCGCCAGCAGCCAGAACCGTCGACTAGCGGGGACTAACAATGAGCAGTTCTTC	CASSQNRRLAGTNNEQFF	TRBV4-1	TRBJ2-1
TGTGCCAGCAGCCCCCGGGACCCCACTGAAGCTTTCTTT	CASSPRDPTEAFF	TRBV6-1	TRBJ1-1
TGTGCCTCCAGGCCGGGACAGGGCCTCCACTACAATGAGCAGTTCTTC	CASRPGQGLHYNEQFF	TRBV27	TRBJ2-1
TGTGCCAGCAGTCACGGGATAAAGGAGACTGAAGCTTTCTTT	CASSHGIKETEAFF	TRBV5-4	TRBJ1-1
TGTGCCAGCAGCTTAATGCAGGGTTCATCTCGCAATCAGCCCCAGCATTTT	CASSLMQGSSRNQPQHF	TRBV7-9	TRBJ1-5
TGTGCCAGCACTGATGGCTACACCTTC	CASTDGYTF	TRBV2	TRBJ1-2
TGTGCCAGCAGCTTAGTGTCTTGGACAGGGCACCGCTTC	CASSLVSWTGHRF	TRBV11-3	TRBJ1-2
TGCAGTGAACCGACTAGCGGGCGTGATCGCGAGCAGTACTTC	CSEPTSGRDREQYF	TRBV20-1	TRBJ2-7
TGTGCCAGCAGCTTGAGGGAGGGGAGCAAAAACATTCAGTACTTC	CASSLREGSKNIQYF	TRBV5-4	TRBJ2-4
TGTGCCAGCAGCTTAGAGGACCAACTAGAAGCTTTCTTT	CASSLEDQLEAFF	TRBV7-9	TRBJ1-1
TGTGCCACCAGAGGGGCCCAATACGAGCAGTACTTC	CATRGAQYEQYF	TRBV24-1	TRBJ2-7
TGTGCCAGCAGCGTGCGTATGGTACGACGGTCTCACCGGACAGGGTCGAAGGGCAATCAGCCCCAGCATTTT	CASSVRMVRRSHRTGSKGNQPQHF	TRBV7-2	TRBJ1-5
TGCGCCAGCAGCCAAGGTTCAGGCCACTATGGCTACACCTTC	CASSQGSGHYGYTF	TRBV4-3	TRBJ1-2
TGTGCCAGCAGCCAAGTATCCCCCAGGGAAATTTGCAATCAGCCCCAGCATTTT	CASSQVSPREICNQPQHF	TRBV3-1	TRBJ1-5
TGTGCCAGCAGCTTAGCCGTAGGCATTCAGTGGCACGAACACGAGCAGTACTTC	CASSLAVGIQWHEHEQYF	TRBV7-2	TRBJ2-7
TGTGCCAGCAGTCGTACCGGGACAGGGGCCATTTATGGCTACACCTTC	CASSRTGTGAIYGYTF	TRBV12-3	TRBJ1-2
TGTGCCAGCACGCGACTGTTAGCTTTCTTT	CASTRLLAFF	TRBV27	TRBJ1-1
TGCGCCAGCAGTGAGTCCCGACAGGGGGGCGGCTACAATGAGCAGTTCTTC	CASSESRQGGGYNEQFF	TRBV10-1	TRBJ2-1
TGTGCCATAGCCAGGGGATGGATCTTTATTAGCTCCTATAATTCACCCCTCCACTTT	CAIARGWIFISSYNSPLHF	TRBV6-1	TRBJ1-6
TGCGCCAGCAGTGAGACCTCTGGGGGGCCTGAAGCTTTCTTT	CASSETSGGPEAFF	TRBV10-2	TRBJ1-1
TGTGCCAGCCCCCTAGAGGAGCAGTACTTC	CASPLEEQYF	TRBV28	TRBJ2-7
TGCAGTGCTGTTAGGGCTGATCTTTCCCCCGTGGACAGGCTACCCGAAAAACTGTTTTTT	CSAVRADLSPVDRLPEKLFF	TRBV20-1	TRBJ1-4
TGTGCCAGCAGCTTGAAACGCTATATTCAGTACTTC	CASSLKRYIQYF	TRBV5-5	TRBJ2-4
TGTGCCAGCAGCTTAGAGGCCCTAGACCCCTACGAGCAGTACTTC	CASSLEALDPYEQYF	TRBV11-2	TRBJ2-7
TGTGCCAGCAGTTTATCGGGGGGGCGACCTGAGACAGATACGCAGTATTTT	CASSLSGGRPETDTQYF	TRBV27	TRBJ2-3
TGTGCCAGCAGTGCGTCCCTTATCCACCGGGACAGGGGTTTCGTGACCCAGTACTTC	CASSASLIHRDRGFVTQYF	TRBV6-1	TRBJ2-5
TGTGCCAGCAGCTTATTATCGAGAGGGCGAACTAACTATGGCTACACCTTC	CASSLLSRGRTNYGYTF	TRBV7-6	TRBJ1-2
TGCGCCAGCAGCCAAGATCTGGACGTAGACTACGAGCAGTACTTC	CASSQDLDVDYEQYF	TRBV4-1	TRBJ2-7
TGTGCCAGCAGCTTGGGGTTCCCCGGGACAGGGGGGGTAGACAACACTGAAGCTTTCTTT	CASSLGFPGTGGVDNTEAFF	TRBV5-4	TRBJ1-1
TGCAGTGCTAGAGATTCAAACCCGGGACAGGGTTCCGGAAGCTCCTACAATGAGCAGTTCTTC	CSARDSNPGQGSGSSYNEQFF	TRBV20-1	TRBJ2-1
TGTGCCAGCAGAAAGAACGGGTACGAGCAGTACTTC	CASRKNGYEQYF	TRBV2	TRBJ2-7
TGCGCCAGCAGCTTGGTGCCGAACAAGGGGGCACTGGCCGAGCAGTACTTC	CASSLVPNKGALAEQYF	TRBV5-1	TRBJ2-7
TGTGCCACCAGCAGATACTTACCTACAGGACAAACCGAGCAGTACTTC	CATSRYLPTGQTEQYF	TRBV15	TRBJ2-7
TGTGGGCGGGACAGGGCCCATCAGCCCCAGCATTTT	CGRDRAHQPQHF	TRBV9	TRBJ1-5
TGTGCCACCAGTGACCGTAGACAGGGGGCCGATGAAAAACTGTTTTTT	CATSDRRQGADEKLFF	TRBV24-1	TRBJ1-4
TGTGCCAGCAGCCGGGGGTATGAAGAGACCCAGTACTTC	CASSRGYEETQYF	TRBV7-3	TRBJ2-5
TGTGCAGACGAGCAGTACTTC	CADEQYF	TRBV7-2	TRBJ2-7
TGTGCCAGCAGTTTTAAGGGGCGCCAGAGGCTGTTTTTT	CASSFKGRQRLFF	TRBV27	TRBJ1-4
TGTGCCAGCAGCCAAGATGGGGGGGTGAACACTGAAGCTTTCTTT	CASSQDGGVNTEAFF	TRBV4-2	TRBJ1-1
TGCGCCAGCAGCCAAGCCAAGAGATGGTACTATGGCTACACCTTC	CASSQAKRWYYGYTF	TRBV4-3	TRBJ1-2
TGTGCCAGCAGCCCCAGGGTCTACGAGCAGTACTTC	CASSPRVYEQYF	TRBV7-9	TRBJ2-7
TGTGCCAGCAGCGTTATTTCTAACTATGGCTACACCTTC	CASSVISNYGYTF	TRBV7-9	TRBJ1-2
TGTGCCAGCAGCCAGCAACTAGGCAGTACAGATACGCAGTATTTT	CASSQQLGSTDTQYF	TRBV4-2	TRBJ2-3
TGTGCCAGCAGCTACCTGAAGGGCTGGAACACTGAAGCTTTCTTT	CASSYLKGWNTEAFF	TRBV11-3	TRBJ1-1
TGCAGTGCTCCCTCGGGATCGGAGGACCCCAGGGGGCACTTCTCGAACACTGAAGCTTTCTTT	CSAPSGSEDPRGHFSNTEAFF	TRBV20-1	TRBJ1-1
TGCGCCAGCAGCCAAGAGATTCCGACATTGAATTCACCCCTCCACTTT	CASSQEIPTLNSPLHF	TRBV4-3	TRBJ1-6
TGTGCCAGCGACCGTACAGACAATGAGCAGTTCTTC	CASDRTDNEQFF	TRBV9	TRBJ2-1
TGTGCCAGCAGCAGGACGAGGCCCTCCTACAATGAGCAGTTCTTC	CASSRTRPSYNEQFF	TRBV7-3	TRBJ2-1
TGTGCCAGTATAGTAGAGGGTGGTCCCTATGGCTACACCTTC	CASIVEGGPYGYTF	TRBV19	TRBJ1-2
TGTGCCAGCAGCGTAGCAGCCGCGAGATCTGAAGCTTTCTTT	CASSVAAARSEAFF	TRBV9	TRBJ1-1
TGCAGTGCTGGCTATGAGCAGTACTTC	CSAGYEQYF	TRBV20-1	TRBJ2-7
TGTGCCAGCAGTCCGGGACTAGCTTCCTCCTACAATGAGCAGTTCTTC	CASSPGLASSYNEQFF	TRBV6-1	TRBJ2-1
TGTGCCAGCAGTGAAGCGGGAGCAGAAAATCAGCCCCAGCATTTT	CASSEAGAENQPQHF	TRBV6-1	TRBJ1-5
TGTGCCAGCTCACTCATTAGGGACAGGGAGGGGCCCCAGCATTTT	CASSLIRDREGPQHF	TRBV18	TRBJ1-5
TGTGCCAGCAGTGACCCAGAACCTGTGAGGTTCGGCAATCAGCCCCAGCATTTT	CASSDPEPVRFGNQPQHF	TRBV6-4	TRBJ1-5
TGTGCCACCAGTGATCGTCGGGGGCCCGTAGGAACTAGCACAGATACGCAGTATTTT	CATSDRRGPVGTSTDTQYF	TRBV24-1	TRBJ2-3
TGTGCCAGCAGCCAAGTCCAAGGGAGGGGGGATAGGTACTACGAGCAGTACTTC	CASSQVQGRGDRYYEQYF	TRBV14	TRBJ2-7
TGTGCCACCAGCAGAGAAACGGGACAGGAAGTTTTAGAGTACACTGAAGCTTTCTTT	CATSRETGQEVLEYTEAFF	TRBV15	TRBJ1-1
TGCAGTGCAAGGGATGGACAGGGTGGGTGGGGGTATGAAAAACTGTTTTTT	CSARDGQGGWGYEKLFF	TRBV20-1	TRBJ1-4
TGTGCCAGCAGTTTATCGACAGGGGGCTCTCGCTCTGGAAACACCATATATTTT	CASSLSTGGSRSGNTIYF	TRBV27	TRBJ1-3
TGTGCCAGCAGCTTAGCCTGTTCGCTAGTCTACGAGCAGTACTTC	CASSLACSLVYEQYF	TRBV7-2	TRBJ2-7
TGTGCCAGCAGCACTCATAGCGGGACCTCCCAGCCCCAGCATTTT	CASSTHSGTSQPQHF	TRBV7-9	TRBJ1-5
TGCGCCAGCAGCCCAGCTCTAGAGACTAGCAATCAGCCCCAGCATTTT	CASSPALETSNQPQHF	TRBV5-1	TRBJ1-5
TGCAGTGCTAGAGAACCCAGGCAGAACTATGGCTACACCTTC	CSAREPRQNYGYTF	TRBV20-1	TRBJ1-2
TGCGCCAGCATAGGGGACCCGGTCAGGGTGGGGGGCAAAAACATTCAGTACTTC	CASIGDPVRVGGKNIQYF	TRBV5-1	TRBJ2-4
TGTGCCAGCAGTGAAGGTGGCGGAATACCATATGAGCAGTTCTTC	CASSEGGGIPYEQFF	TRBV2	TRBJ2-1
TGTGCCAGCAGCCACGACTGCTGGATTAACACAGATACGCAGTATTTT	CASSHDCWINTDTQYF	TRBV3-1	TRBJ2-3
TGTGCCTGGCATTGCCGGGACAGGGGATACGAGCAGTACTTC	CAWHCRDRGYEQYF	TRBV30	TRBJ2-7
TGTGCCAGCAGCCAAAGGAACTTCTTCGAGACCCAGTACTTC	CASSQRNFFETQYF	TRBV6-5	TRBJ2-5
TGTGCCAGCTCACCACATGGCGTCAGGGCCCTCGACAATGAGCAGTTCTTC	CASSPHGVRALDNEQFF	TRBV18	TRBJ2-1
TGTGCCAGCAGCTTGTCAGTGGCCGGGACTAGCGGAGGCACCAATGAGCAGTTCTTC	CASSLSVAGTSGGTNEQFF	TRBV5-6	TRBJ2-1
TGCGCCAGCAGCCAAGAAGGGGCAGTAGGGGGCGAGGGCTACACCTTC	CASSQEGAVGGEGYTF	TRBV4-3	TRBJ1-2
TGCAGTGCTACTTTGCCGAGTGGCTACACCTTC	CSATLPSGYTF	TRBV20-1	TRBJ1-2
TGTGCCAGCAGTTACTCTAGCGGACGCTCCTACGAGCAGTACTTC	CASSYSSGRSYEQYF	TRBV6-9	TRBJ2-7
TGCGCCAGCAGCGATCCCCGGTGGTACGAGCAGTACTTC	CASSDPRWYEQYF	TRBV5-1	TRBJ2-7
TGTGCCAGCAGCAAGGGCGACTCTGGAAACACCATATATTTT	CASSKGDSGNTIYF	TRBV13	TRBJ1-3
TGTGCCAGCAGCGGGGGGGGTCGGCTGATTGAGACCCAGTACTTC	CASSGGGRLIETQYF	TRBV7-3	TRBJ2-5
TGTGCCAGCAGTTTATACGGGGGAGGCTACGAGCAGTACTTC	CASSLYGGGYEQYF	TRBV27	TRBJ2-7
TGTGCCAGCAGTGATTCGCAGCCCTCCTATAATTCACCCCTCCACTTT	CASSDSQPSYNSPLHF	TRBV25-1	TRBJ1-6
TGCGCCAGCAGCGACGAGAGACAGGGGCGGACTTTCTTT	CASSDERQGRTFF	TRBV4-1	TRBJ1-1
TGTGCCATGCGAGCCACAGGGGTAGCCAATCAGCCCCAGCATTTT	CAMRATGVANQPQHF	TRBV25-1	TRBJ1-5
TGTGCCAGCAGTGGTCGGACAGGGGCGGAAGCTTTCTTT	CASSGRTGAEAFF	TRBV6-3	TRBJ1-1
TGTGCCAGCAAACGGGGGGAGGGGCGCTCCTACGAGCAGTACTTC	CASKRGEGRSYEQYF	TRBV9	TRBJ2-7
TGTGCCAGCAGTTTCCAGATTCGAAACACCATATATTTT	CASSFQIRNTIYF	TRBV6-6	TRBJ1-3
TGTGCCATCAGAGCAATGGACAGGGAAGACGAGCAGTACTTC	CAIRAMDREDEQYF	TRBV10-3	TRBJ2-7
TGCAGCGTTGAAGAGCCAAAGGGGACTAGCGGGAATGGGGTCTTC	CSVEEPKGTSGNGVF	TRBV29-1	TRBJ2-1
TGTGCCAGCAACGGGGGGGCCGACCAAGAGACCCAGTACTTC	CASNGGADQETQYF	TRBV6-5	TRBJ2-5
TGTGCCAGCAGTTTATGTGGCAGCAAGGAAAACATTCAGTACTTC	CASSLCGSKENIQYF	TRBV27	TRBJ2-4
TGCAGTGCGATTCGGATACCGGGACAGGGGCAGTGCAATGAGCAGTTCTTC	CSAIRIPGQGQCNEQFF	TRBV20-1	TRBJ2-1
TGCAGTGCTAGGATGGGAGAACTAGCGGGTATACTCGGGGAGCTGTTTTTT	CSARMGELAGILGELFF	TRBV20-1	TRBJ2-2
TGTGCCAGCCCCGGGGAGGGTGCAAATGAGCAGTTCTTC	CASPGEGANEQFF	TRBV6-5	TRBJ2-1
TGTGCCAGCAGCGCCCGGTGGGACAAAAATGAAAAACTGTTTTTT	CASSARWDKNEKLFF	TRBV9	TRBJ1-4
TGTGCCAGCAGCACTAGCGAGGACAGCGACAACACCGGGGAGCTGTTTTTT	CASSTSEDSDNTGELFF	TRBV7-9	TRBJ2-2
TGTGCCAGCAGCGGGCCCAAGACTAGCGGGCGGGCAGAAGAGACCCAGTACTTC	CASSGPKTSGRAEETQYF	TRBV13	TRBJ2-5
TGCAGCGTTGAAGATGTAAGGGCAGATACGCAGTATTTT	CSVEDVRADTQYF	TRBV29-1	TRBJ2-3
TGTGCCAGCAGCACCGCCAGTTACTCTGGAAACACCATATATTTT	CASSTASYSGNTIYF	TRBV7-9	TRBJ1-3
TGTGCCAGCAGTGACAGACGAGGGTTGCAGAATGAAAAACTGTTTTTT	CASSDRRGLQNEKLFF	TRBV27	TRBJ1-4
TGTGCCACCAGTGACACTGGGCCCGGGGTTGGGGCCAACGTCCTGACTTTC	CATSDTGPGVGANVLTF	TRBV24-1	TRBJ2-6
TGTGCCAGCACAACGGGACTAGCGGGGGGCTACCAGTCCTACGAGCAGTACTTC	CASTTGLAGGYQSYEQYF	TRBV27	TRBJ2-7
TGTGCCAGCAGCCACCACGCAGGGGGCGCATCAATTGAGACCCAGTACTTC	CASSHHAGGASIETQYF	TRBV5-4	TRBJ2-5
TGTGCCAGCAGCTCCCGAGCGGTTGGAGGGTACGAGCAGTACTTC	CASSSRAVGGYEQYF	TRBV7-3	TRBJ2-7
TGTGCCACGACAGGGGGCTCACCCCTCCACTTT	CATTGGSPLHF	TRBV19	TRBJ1-6
TGTGCCAGCAGCGGACGGGCACCTGAAGCTTTCTTT	CASSGRAPEAFF	TRBV5-4	TRBJ1-1
TGCGCCAGCAGTTCAGGGGGCGGTATCTACGAGCAGTACTTC	CASSSGGGIYEQYF	TRBV10-1	TRBJ2-7
TGTGCCTGGACTGACTACGAGCAGTACTTC	CAWTDYEQYF	TRBV30	TRBJ2-7
TGTGCCATCCTTCCGAGTGTGGACAATGAGCAGTTCTTC	CAILPSVDNEQFF	TRBV6-5	TRBJ2-1
TGTGCCAGCAGCCAAGGAAGACTCACTGAAGCTTTCTTT	CASSQGRLTEAFF	TRBV13	TRBJ1-1
TGCGCCAGCAGCCAAGCCTGGGGACAGGGGGAAGTTGATTCACCCCTCCACTTT	CASSQAWGQGEVDSPLHF	TRBV4-1	TRBJ1-6
TGTGCCAGCAGCGGTGGGGGGGAGGTCTTC	CASSGGGEVF	TRBV13	TRBJ2-1
TGTGCCAGCTTAGAGACATACAATGAGCAGTTCTTC	CASLETYNEQFF	TRBV6-4	TRBJ2-1
TGTGCCAGCAGGGCGGGTGCGGGACAGGGGGCGGCTAATGAAAAACTGTTTTTT	CASRAGAGQGAANEKLFF	TRBV11-3	TRBJ1-4
TGCAGTGCGGGGAGGGGGAAGGATACGCAGTATTTT	CSAGRGKDTQYF	TRBV20-1	TRBJ2-3
TGTGCCTGGAGACAGGGACAGACTAATGAAAAACTGTTTTTT	CAWRQGQTNEKLFF	TRBV30	TRBJ1-4
TGTGCCAGCAGCCGGGACAAGGTCCAAGAGACCCAGTACTTC	CASSRDKVQETQYF	TRBV11-3	TRBJ2-5
TGTGCCAGCAGCCCAACCCACAAACAAGGGGGGAAAGAGACCCAGTACTTC	CASSPTHKQGGKETQYF	TRBV7-3	TRBJ2-5
TGCGCCAGCAGGAAGAGATTCTACGAGCAGTACTTC	CASRKRFYEQYF	TRBV5-1	TRBJ2-7
TGTGCCAGCAGTGAACCAGGGGGTTGCAATCAGCCCCAGCATTTT	CASSEPGGCNQPQHF	TRBV6-1	TRBJ1-5
TGTGCCAGGGAGAAATGGGACAGGACGAGAGGGGGAAGCAATCAGCCCCAGCATTTT	CAREKWDRTRGGSNQPQHF	TRBV6-4	TRBJ1-5
TGTGGCCCACAGCAGGGTAGTGAAAAACTGTTTTTT	CGPQQGSEKLFF	TRBV12-3	TRBJ1-4
TGTGCCAGCAAGTTCCGACAGGATAACTATGGCTACACCTTC	CASKFRQDNYGYTF	TRBV3-1	TRBJ1-2
TGTGCCAGCAGTTACGACCAGCGGGAGCAGTACTTC	CASSYDQREQYF	TRBV6-5	TRBJ2-7
TGTGCCAGACCTGCCCAGCGGGGTCCTAACGACACCGGGGAGCTGTTTTTT	CARPAQRGPNDTGELFF	TRBV7-2	TRBJ2-2
TGCAGCGTTGAAATGGAGGGACAGGGCTTAGCCAAAAACATTCAGTACTTC	CSVEMEGQGLAKNIQYF	TRBV29-1	TRBJ2-4
TGTGCCAGCAGAGTTACGAGGAGGGATGAGCAGTTCTTC	CASRVTRRDEQFF	TRBV11-3	TRBJ2-1
TGTGCCAGCAGTTACTCACCGAAGGGGGTCGAGGATGGCTACACCTTC	CASSYSPKGVEDGYTF	TRBV6-2	TRBJ1-2
TGTGCTAGTGGTTCTGATCGGGGAGAGGAGACCCAGTACTTC	CASGSDRGEETQYF	TRBV12-5	TRBJ2-5
TGTGCCACCAGTGACGTTCAGACAGAAGCTTTCTTT	CATSDVQTEAFF	TRBV24-1	TRBJ1-1
TGTGCCAGCAGTTTGGGAACCCCCTGTTGGGAGCAGTTCTTC	CASSLGTPCWEQFF	TRBV12-3	TRBJ2-1
TGTGCCAGCAGCCCTCCGGGACAACCCGCCCAGCCCCAGCATTTT	CASSPPGQPAQPQHF	TRBV7-2	TRBJ1-5
TGTGCCAGCAGCGGGGGGACAGGGAATGGCTACACCTTC	CASSGGTGNGYTF	TRBV5-4	TRBJ1-2
TGTGCCAGGCTAGGCGGGAGTTACAATGAGCAGTTCTTC	CARLGGSYNEQFF	TRBV25-1	TRBJ2-1
TGCAGTGTTGACACGGCCTATGGCTACACCTTC	CSVDTAYGYTF	TRBV20-1	TRBJ1-2
TGTGCCAGCACTCCCCTAGCGGGTACGGACTACGAGCAGTACTTC	CASTPLAGTDYEQYF	TRBV27	TRBJ2-7
TGCGCCAGCAGCTTTCAGGGGCCCTACTATGGCTACACCTTC	CASSFQGPYYGYTF	TRBV5-1	TRBJ1-2
TGTGCCAGCAGCCAAGCCGGGACAAAGACCTACGAGCAGTACTTC	CASSQAGTKTYEQYF	TRBV14	TRBJ2-7
TGTGCCAGCAGTTGGTTCAAGGCCACACGTAGCAATCAGCCCCAGCATTTT	CASSWFKATRSNQPQHF	TRBV6-2	TRBJ1-5
TGCAGTGCCCCCAATAGGACAGGGGGCCGATCTGAAAAACTGTTTTTT	CSAPNRTGGRSEKLFF	TRBV20-1	TRBJ1-4
TGTGCCAGCAGCTCCCGACTACACGCAGATACGCAGTATTTT	CASSSRLHADTQYF	TRBV7-2	TRBJ2-3
TGTGCCAGCAGCTTAGCCAGGGGGCGCGGGTGTGGCACCGGGGAGCTGTTTTTT	CASSLARGRGCGTGELFF	TRBV13	TRBJ2-2
TGCGCCAGCAGCTGCGTACTAGAGATCTCTGGGGCCAACGTCCTGACTTTC	CASSCVLEISGANVLTF	TRBV5-1	TRBJ2-6
TGTGCCAGCAGGTCCATGGACAGGGGGCGCCTGAATCAGCCCCAGCATTTT	CASRSMDRGRLNQPQHF	TRBV6-1	TRBJ1-5
TGTGCCAGCCAGAGACAGCATAACTATGGCTACACCTTC	CASQRQHNYGYTF	TRBV11-3	TRBJ1-2
TGTGCCAGCAGCTACGGAGTTGGGACAGGGTCGGGGTGTAGAGGAGGCACAGATACGCAGTATTTT	CASSYGVGTGSGCRGGTDTQYF	TRBV11-3	TRBJ2-3
TGTGCCAGCAGCTTATGTGGACATAGCAATCAGCCCCAGCATTTT	CASSLCGHSNQPQHF	TRBV7-3	TRBJ1-5
TGTGCCAGCAGTGACTCACAAGACTCGCTAGGTGGCTACACCTTC	CASSDSQDSLGGYTF	TRBV6-4	TRBJ1-2
TGTGCCAGCAGTTACTCGGCCTCGGGACCGTACAATGAGCAGTTCTTC	CASSYSASGPYNEQFF	TRBV6-2	TRBJ2-1
TGTGCCAGCAGTCGGGTTAGATCCCCCGCCTACGACCGGACAGGGTCCAAACTGTTTTTT	CASSRVRSPAYDRTGSKLFF	TRBV12-3	TRBJ1-4
TGTGCCAGCATATGCCCGCACCCCTACAATGAGCAGTTCTTC	CASICPHPYNEQFF	TRBV12-3	TRBJ2-1
TGCGCCAGCAGCTCCTATGGGGATGACACTGAAGCTTTCTTT	CASSSYGDDTEAFF	TRBV4-1	TRBJ1-1
TGTGCCACCAGTGCGGACAGGGGGCGCAATCAGCCCCAGCATTTT	CATSADRGRNQPQHF	TRBV24-1	TRBJ1-5
TGCAGCGTTGAAAATCGGCCTAGGCTCCCCCCGGGGACCCAGTACTTC	CSVENRPRLPPGTQYF	TRBV29-1	TRBJ2-5
TGTGCCAGCAGCCTCGAGTCCTACGAGCAGTACTTC	CASSLESYEQYF	TRBV7-3	TRBJ2-7
TGTGCCACCAGAAGGGCCATTTTGCCCTTCGAGACCCAGTACTTC	CATRRAILPFETQYF	TRBV24-1	TRBJ2-5
TGTGCCAGCAGAACAGGATGGAAGAACACCGGGGAGCTGTTTTTT	CASRTGWKNTGELFF	TRBV7-8	TRBJ2-2
TGTGCCAGCAGTTTACTGTCAGGGGCAGGAGACACTGAAGCTTTCTTT	CASSLLSGAGDTEAFF	TRBV27	TRBJ1-1
TGTGACGGGGAAGCTTTCTTT	CDGEAFF	TRBV29-1	TRBJ1-1
TGCGCCAGCAAGTCTGTAGCGGGGCAAAACATTCAGTACTTC	CASKSVAGQNIQYF	TRBV5-1	TRBJ2-4
TGTGCCACCAGCTTCCTGAAGGGGGGCTACACCTTC	CATSFLKGGYTF	TRBV15	TRBJ1-2
TGTGCCAGCAGTTACTCGGAGCTCCCCCGTCTCTGGGTCTCTGGAAACACCATATATTTT	CASSYSELPRLWVSGNTIYF	TRBV6-6	TRBJ1-3
TGTGCCAGCAGCCTGGACAGGGTGCAGGGATACAATGAGCAGTTCTTC	CASSLDRVQGYNEQFF	TRBV13	TRBJ2-1
TGTGCCAGCAGCTTACCCAGGGTGGACAATCAGCCCCAGCATTTT	CASSLPRVDNQPQHF	TRBV7-2	TRBJ1-5
TGTGCCAGCAGCTGTTTACCCCCCCCCTGGAACACGAGCTATGGCTACACCTTC	CASSCLPPPWNTSYGYTF	TRBV7-9	TRBJ1-2
TGTGCCAGCAGCTTATATACTGGACATGAGACCCAGTACTTC	CASSLYTGHETQYF	TRBV7-3	TRBJ2-5
TGTGCCAGCAGCCCGGTGGGACACTCCTACGAGCAGTACTTC	CASSPVGHSYEQYF	TRBV7-3	TRBJ2-7
TGCAGTGGGCATTTTCACATTCAGTACTTC	CSGHFHIQYF	TRBV20-1	TRBJ2-4
TGCAGTGCTAGAGATCTTAGGCTGTACCTAGAGCTCTCCTACGAGCAGTACTTC	CSARDLRLYLELSYEQYF	TRBV20-1	TRBJ2-7
TGTGCCAGCAGTTTACCCGGACGCTCTCGCACAGATACGCAGTATTTT	CASSLPGRSRTDTQYF	TRBV27	TRBJ2-3
TGTGCCAGCAGAGATCTATGGGTCTACGAGCAGTACTTC	CASRDLWVYEQYF	TRBV2	TRBJ2-7
TGTGCCAGCAGTCAGGGACAGAATGAGCCCCAGCATTTT	CASSQGQNEPQHF	TRBV6-1	TRBJ1-5
TGTGCCAGCAGCTTCAGGACCGAGACCCAGTACTTC	CASSFRTETQYF	TRBV7-9	TRBJ2-5
TGTGCCAGCAATACCCCTCCGGGAGGGCTAGCCAAAAACATTCAGTACTTC	CASNTPPGGLAKNIQYF	TRBV6-6	TRBJ2-4
TGTGCCAGCAGGAGACAGGATTCGACGCATAGCAATCAGCCCCAGCATTTT	CASRRQDSTHSNQPQHF	TRBV27	TRBJ1-5
TGCAGCGTTGTGGGACTAGCTTGTTTTGCAGATACGCAGTATTTT	CSVVGLACFADTQYF	TRBV29-1	TRBJ2-3
TGTGCCAGCAGTAACTGGGAGGGAGCCTACGAGCAGTACTTC	CASSNWEGAYEQYF	TRBV25-1	TRBJ2-7
TGTGCCAGCAGCTCCCCAGCCTCCTATAATTCACCCCTCCACTTT	CASSSPASYNSPLHF	TRBV14	TRBJ1-6
TGCGCCAGCAATGGGACAGCCTACGAGCAGTACTTC	CASNGTAYEQYF	TRBV4-1	TRBJ2-7
TGTGCCAGCAGTTTAGGTCGAGGCACCAAGTGGACAGGGGGCTACACCTTC	CASSLGRGTKWTGGYTF	TRBV12-4	TRBJ1-2
TGTGCCTGGAGTGTAGCTCCTATAGGCGTCGGGGCCTTTCAGCCCCAGCATTTT	CAWSVAPIGVGAFQPQHF	TRBV30	TRBJ1-5
TGCGCCGTGGGGCGAAAAAGCTCCTATAATTCACCCCTCCACTTT	CAVGRKSSYNSPLHF	TRBV5-1	TRBJ1-6
TGTGCCAGTAGGGGAGCCCGAGGCTACACCTTC	CASRGARGYTF	TRBV19	TRBJ1-2
TGTGCCAGCAGTGAAACGCTAGCGGGAGAGACCCAGTACTTC	CASSETLAGETQYF	TRBV6-1	TRBJ2-5
TGCAATGGGGGCAGGCCCTATAATTCACCCCTCCACTTT	CNGGRPYNSPLHF	TRBV20-1	TRBJ1-6
TGCGCCAGCAGCTTTTCCTCCCGGGACAGTGGAAGCTCCTACGAGCAGTACTTC	CASSFSSRDSGSSYEQYF	TRBV5-1	TRBJ2-7
TGTGCCAGCAGCTTGGTTAGCGGACAGGGTTTGACAAACACCATATATTTT	CASSLVSGQGLTNTIYF	TRBV5-8	TRBJ1-3
TGTGCCAGCCTTACTAGGGGGCTGAATCACGAGCAGTACTTC	CASLTRGLNHEQYF	TRBV6-5	TRBJ2-7
TGTGCCAGCAGCCCCCAGGACAGTGGGGCCAAAAACATTCAGTACTTC	CASSPQDSGAKNIQYF	TRBV13	TRBJ2-4
TGCGCCAGCAGCCAAGATGGAAGGGGGACGGAGAGAGGGTCAACTAATGAAAAACTGTTTTTT	CASSQDGRGTERGSTNEKLFF	TRBV4-3	TRBJ1-4
TGTGCCAGCAGCGAACTAGCGGGTTCCTCATACGAGCAGTACTTC	CASSELAGSSYEQYF	TRBV7-2	TRBJ2-7
TGTGCCAGCAGCGTCCTGGCCGTTATGAGCAATGAGCAGTTCTTC	CASSVLAVMSNEQFF	TRBV7-4	TRBJ2-1
TGCGCCAGCAGCCACCCCCCCAGGGGTCCGGCCAATGAGCAGTTCTTC	CASSHPPRGPANEQFF	TRBV5-1	TRBJ2-1
TGTGCCAGCAGCCGTAGAATGAATGAGCAGTTCTTC	CASSRRMNEQFF	TRBV27	TRBJ2-1
TGTGCCAGCAGCTTGCCGTATTCTAGTCGATTCAGGGTGAGGAATAATGAAAAACTGTTTTTT	CASSLPYSSRFRVRNNEKLFF	TRBV5-4	TRBJ1-4
TGTGCCAGCAGGACCCCCGAGGGAGGGCTAAGGGAAAAACTGTTTTTT	CASRTPEGGLREKLFF	TRBV25-1	TRBJ1-4
TGCGCCAGCAGCCACCCGGCTAGCGGGGTCTGCTCTGGGGCCAACGTCCTGACTTTC	CASSHPASGVCSGANVLTF	TRBV4-1	TRBJ2-6
TGTGCCAGCAGCCGCGTTAGGGAGGGTTACACCTTC	CASSRVREGYTF	TRBV25-1	TRBJ1-2
TGCGCCAGCAGCATTGAGGGCACGACTAGCGGTCACCCCTCCTACGAGCAGTACTTC	CASSIEGTTSGHPSYEQYF	TRBV5-1	TRBJ2-7
TGTGCCACCAGTGATGGATTCCCCCGACTAGCGGGAGGGCTAATCCAAGAGACCCAGTACTTC	CATSDGFPRLAGGLIQETQYF	TRBV24-1	TRBJ2-5
TGTGCCAGCAGCCGGTGGGGACAGGGAGTCTCCGCCCCTGGGGCCAACGTCCTGACTTTC	CASSRWGQGVSAPGANVLTF	TRBV7-4	TRBJ2-6
TGTGCCAGCAGTGTCCGGTGCCGGGACAGGGCGGGCTACACCTTC	CASSVRCRDRAGYTF	TRBV6-1	TRBJ1-2
TGTGCCAGCAGACCACCCGGCTGGGCCCGAGTCCCACGATCTGAAGCTTTCTTT	CASRPPGWARVPRSEAFF	TRBV6-1	TRBJ1-1
TGTGCCAGTAGTTCGGTTCGTGACAGGGAATGCTACGAGCAGTACTTC	CASSSVRDRECYEQYF	TRBV19	TRBJ2-7
TGCAGTGCAACTGGACAGGGCTCTGGAAACACCATATATTTT	CSATGQGSGNTIYF	TRBV20-1	TRBJ1-3
TGCGCCAGCAGCTTACTCACAGCCATTTCCGAGGGGGGGGTGGGCACAGATACGCAGTATTTT	CASSLLTAISEGGVGTDTQYF	TRBV5-1	TRBJ2-3
TGCAGTGCTAGAGAGTGTGACGCGGGACAGGGGGGAGAGTACTTC	CSARECDAGQGGEYF	TRBV20-1	TRBJ2-7
TGTGCCAGCAGCTTAGCGGCCATGGCCCACTACGAGCAGTACTTC	CASSLAAMAHYEQYF	TRBV11-3	TRBJ2-7
TGTGCCAGCAGTGACTCGAAAGCAGGGGTTGGCGAGCAGTACTTC	CASSDSKAGVGEQYF	TRBV6-4	TRBJ2-7
TGTGCCAGCAGCTTAGTGGCCCCCTACGAGCAGTACTTC	CASSLVAPYEQYF	TRBV7-9	TRBJ2-7
TGTGCCAGCAGCAAAGGGGGCTCCTACGAGCAGTACTTC	CASSKGGSYEQYF	TRBV9	TRBJ2-7
TGTGCCAGCAGTTACCATACGGGTTACGAGCAGTACTTC	CASSYHTGYEQYF	TRBV6-5	TRBJ2-7
TGTGCCAGCATTTTTAACGGACTAGCGACTGACAATGAGCAGTTCTTC	CASIFNGLATDNEQFF	TRBV27	TRBJ2-1
TGCGCCAGCAGCTTGCTGTGCCGGGACATGGCGTTTGAGACCCAGTACTTC	CASSLLCRDMAFETQYF	TRBV5-1	TRBJ2-5
TGTGCTAGTGGTTTGGAAAGGGGGCTTGAAAGGGGCACAGATACGCAGTATTTT	CASGLERGLERGTDTQYF	TRBV12-5	TRBJ2-3
TGTGATAAGATATCCGTCCTAGCGGCCTCCTACGAGCAGTACTTC	CDKISVLAASYEQYF	TRBV27	TRBJ2-7
TGTGCCAGCAGCTTGCCCTTACTAGCGGCTTGCAGAAATGAGCAGTTCTTC	CASSLPLLAACRNEQFF	TRBV5-4	TRBJ2-1
TGCGCCAGCAGCCACAGGCCGGTAGCGGGAAGCAATCAGCCCCAGCATTTT	CASSHRPVAGSNQPQHF	TRBV4-1	TRBJ1-5
TGCAGTGCTAGACGGAAACTAGCGGGAGAGACCCAGTACTTC	CSARRKLAGETQYF	TRBV20-1	TRBJ2-5
TGTGCCAGCAGGGTGCAGGGGACCCAGTACTTC	CASRVQGTQYF	TRBV6-2	TRBJ2-5
TGTGCCAGCAGTGACCTTAGGCAAAAGTACGAGCAGTACTTC	CASSDLRQKYEQYF	TRBV6-4	TRBJ2-7
TGTGCCAGCGCTCGTCCGGGGAACACCGGGGAGCTGTTTTTT	CASARPGNTGELFF	TRBV11-3	TRBJ2-2
TGTGCCAGGGCCGACAGCGACACCGGGGAGCTGTTTTTT	CARADSDTGELFF	TRBV6-1	TRBJ2-2
TGTGCCAGCAGCTGGTCGGAGGGGGGGGGAGATACGCAGTATTTT	CASSWSEGGGDTQYF	TRBV7-9	TRBJ2-3
TGCGCCAGCAGCTTGCGTCTTGAGGATTTTAACACTGAAGCTTTCTTT	CASSLRLEDFNTEAFF	TRBV5-1	TRBJ1-1
TGTGCCATCACCAAAGACACCCAGGGGGCGAAGAGCACAGATACGCAGTATTTT	CAITKDTQGAKSTDTQYF	TRBV10-3	TRBJ2-3
TGTGCCAGCCTGTTGGAGAGACAATGCGAGCAGTACTTC	CASLLERQCEQYF	TRBV19	TRBJ2-7
TGTGCCAGCAGCTTCCCTAGGAACCCTACGGAAACGCCCTACGAGCAGTACTTC	CASSFPRNPTETPYEQYF	TRBV9	TRBJ2-7
TGTGCCAGCAGCTGGGGGGACAGGGGATTCTGCTCTGGAAACACCATATATTTT	CASSWGDRGFCSGNTIYF	TRBV5-6	TRBJ1-3
TGTGCCAGCAGGCGACAGACCGCGGCGGACTACGAGCAGTACTTC	CASRRQTAADYEQYF	TRBV6-4	TRBJ2-7
TGTGCCAGCAGGCCCACTAGCGGGAGCACGAACACCGGGGAGCTGTTTTTT	CASRPTSGSTNTGELFF	TRBV9	TRBJ2-2
TGCAGCGTTGAAGAGGATTCGGTACAACAGGGGGGCATGGTACCTGAAGCTTTCTTT	CSVEEDSVQQGGMVPEAFF	TRBV29-1	TRBJ1-1
TGTGCCAGCAGCTTACCTAAAGATCGAGATACGCAGTATTTT	CASSLPKDRDTQYF	TRBV11-2	TRBJ2-3
TGTGCCAGCAGCTTACCACTAGCGGGAGCTGACCAGAGTGAGACCCAGTACTTC	CASSLPLAGADQSETQYF	TRBV11-2	TRBJ2-5
TGCGCCAGCAGTGAGTGCATAGAAAGTTACAATGAGCAGTTCTTC	CASSECIESYNEQFF	TRBV10-1	TRBJ2-1
TGTGCCAGCAGAACCCCGGGGGCCTACGAGCAGTACTTC	CASRTPGAYEQYF	TRBV25-1	TRBJ2-7
TGTGCCAGTCACAGGAGAGTATCACCCCTCCACTTT	CASHRRVSPLHF	TRBV25-1	TRBJ1-6
TGTGCCGCCGGGGAATCCAACGCTTTCTTT	CAAGESNAFF	TRBV19	TRBJ1-1
TGTGCCAGCAGCGGAGCTCGGGGGCGGTGTGAAGCTTTCTTT	CASSGARGRCEAFF	TRBV9	TRBJ1-1
TGTGCCAGCAGCTTGCGGGGGCCAACAAATCAGCCCCAGCATTTT	CASSLRGPTNQPQHF	TRBV7-3	TRBJ1-5
TGTGCCAGCAGCCTCCCGGGAGGGCCACCGACAGATACGCAGTATTTT	CASSLPGGPPTDTQYF	TRBV14	TRBJ2-3
TGTGCCAGCAGCTTCGAGGGTCCCTCCTACAATGAGCAGTTCTTC	CASSFEGPSYNEQFF	TRBV7-9	TRBJ2-1
TGTGCCAGCAGTTACAGAGCGGGCCGCACAGATACGCAGTATTTT	CASSYRAGRTDTQYF	TRBV6-6	TRBJ2-3
TGTGCCAGCAGCGGCCCGGACAGGGCTAACATTGCTGAAGCTTTCTTT	CASSGPDRANIAEAFF	TRBV28	TRBJ1-1
TGTGCCAGCAGCCACTTCTATGGCTACACCTTC	CASSHFYGYTF	TRBV13	TRBJ1-2
TGTGCCAGCAGCGTAAGGGTTAGGGGGGAGACCCAGTACTTC	CASSVRVRGETQYF	TRBV9	TRBJ2-5
TGTGCCAGCAGAAGGGGCCGGTGCACAGATACGCAGTATTTT	CASRRGRCTDTQYF	TRBV12-4	TRBJ2-3
TGCAGTGCAATACTAAAGAGGGCCGGGAGGGACAATGGCTACACCTTC	CSAILKRAGRDNGYTF	TRBV20-1	TRBJ1-2
TGTGCCAGCAGTTTAAGGTTTATAACAGGAACGGCAGGGGACACCGGGGAGCTGTTTTTT	CASSLRFITGTAGDTGELFF	TRBV12-3	TRBJ2-2
TGTGCCAGCAGCTTAGAAGCAGGGGCTGTTCGAGGCTACACCTTC	CASSLEAGAVRGYTF	TRBV7-7	TRBJ1-2
TGCAGCGTTGCCTCAAGACCTCCAGTCCCCAGGAGGACAGGGCGCGGGTATGAGTACGAGCAGTACTTC	CSVASRPPVPRRTGRGYEYEQYF	TRBV29-1	TRBJ2-7
TGTGCCAGTACTTGTAGCGCCTTAAGGCAAGAGACCCAGTACTTC	CASTCSALRQETQYF	TRBV19	TRBJ2-5
TGTGCCAGCAGCCCCCGGACAGGTGAAGAGACCCAGTACTTC	CASSPRTGEETQYF	TRBV7-4	TRBJ2-5
TGTGCCACCAGCCAACGACAGGGGCACTACGAGCAGTACTTC	CATSQRQGHYEQYF	TRBV15	TRBJ2-7
TGTGCCAGCACAGGGCTTCGGGAAAAACTGTTTTTT	CASTGLREKLFF	TRBV19	TRBJ1-4
TGTGCCAGCAGCGTAGAGAACGACAGGGCGAGTCTGAACACTGAAGCTTTCTTT	CASSVENDRASLNTEAFF	TRBV9	TRBJ1-1
TGTGCCAGCGGGACAGGGGGTGGGACTGAAGCTTTCTTT	CASGTGGGTEAFF	TRBV6-5	TRBJ1-1
TGCGCCAACAGCGGGAGTCGCGAGGATCAGCCCCAGCATTTT	CANSGSREDQPQHF	TRBV4-1	TRBJ1-5
TGTGACCCGCGGGGGTATTCCTACGAGCAGTACTTC	CDPRGYSYEQYF	TRBV5-4	TRBJ2-7
TGTGCCAGTAGATGGGACTTAAGCTACAATGAGCAGTTCTTC	CASRWDLSYNEQFF	TRBV19	TRBJ2-1
TGCAGTGCTAGAGGGCGGGAGCAACCCACAGATACGCAGTATTTT	CSARGREQPTDTQYF	TRBV20-1	TRBJ2-3
TGTGCTAGTGGAAACTCCTCCCTCCGGGACAGGGGACGCTATGGCTACACCTTC	CASGNSSLRDRGRYGYTF	TRBV12-5	TRBJ1-2
TGCAGCGTTGAAATGGGGACTAGTCATAACCTACACAATGAGCAGTTCTTC	CSVEMGTSHNLHNEQFF	TRBV29-1	TRBJ2-1
TGTGCCAGTAGTATAAGTATCAGGGGACCTTGCCAAAGGGAAAGCACCGGGGAGCTGTTTTTT	CASSISIRGPCQRESTGELFF	TRBV19	TRBJ2-2
TGTGCCAGCAGCTTGAACCGGGGGCACTCCTACAATGAGCAGTTCTTC	CASSLNRGHSYNEQFF	TRBV11-3	TRBJ2-1
TGTGCCAGCAGCATCCTGAGGGTACCCTACGAGCAGTACTTC	CASSILRVPYEQYF	TRBV11-2	TRBJ2-7
TGTGCCTCCGGGGAAGAGACCCAGTACTTC	CASGEETQYF	TRBV7-9	TRBJ2-5
TGTGCCAGCAGCCGTCTAACCACCACAGATACGCAGTATTTT	CASSRLTTTDTQYF	TRBV14	TRBJ2-3
TGCAGTGCTGGTAGGGTCCGGGACAGGGGGCCTGGGGGGACGGAGCTGTTTTTT	CSAGRVRDRGPGGTELFF	TRBV20-1	TRBJ2-2
TGTGCCAGCATGTCGCCGGACCAACCGAACACCGGGGAGCTGTTTTTT	CASMSPDQPNTGELFF	TRBV6-2	TRBJ2-2
TGTGCCAGTAGTATCCAACGGGGGGGGGCCGACGTGGGAAACATTCAGTACTTC	CASSIQRGGADVGNIQYF	TRBV19	TRBJ2-4
TGTGCCAGCAGCGTAGCCGACACCCTTATAGCTAGCTCCTACGAGCAGTACTTC	CASSVADTLIASSYEQYF	TRBV9	TRBJ2-7
TGTGCCAGCAGCTATTTGGGAGGACGTCCAGATACGCAGTATTTT	CASSYLGGRPDTQYF	TRBV7-7	TRBJ2-3
TGTGCCAGCAGTTGTACTGAGGGGGCTGAAGCTTTCTTT	CASSCTEGAEAFF	TRBV12-3	TRBJ1-1
TGTGCCAGCTCACCAAACCGGGACAGGGACAGCACCGGGGAGCTGTTTTTT	CASSPNRDRDSTGELFF	TRBV18	TRBJ2-2
TGCGCCAGCAATAGCTTCAGGGGACCATACGAGCAGTACTTC	CASNSFRGPYEQYF	TRBV4-1	TRBJ2-7
TGTGCCAGCAGCTTGGGAGGCCGGGACAGGGTTTTCGCTCAGCCCCAGCATTTT	CASSLGGRDRVFAQPQHF	TRBV5-6	TRBJ1-5
TGTGCCATCAGGATCCATGCGATTCTTATTGGCTACGAGCAGTACTTC	CAIRIHAILIGYEQYF	TRBV10-3	TRBJ2-7
TGTGCCAGCAGATCCAATAAAGGGGAGCAGTACTTC	CASRSNKGEQYF	TRBV12-4	TRBJ2-7
TGTGCCAAAGGGCTAGCGACCGCAGATACGCAGTATTTT	CAKGLATADTQYF	TRBV6-8	TRBJ2-3
TGTGCCAGCAGCTGGGACCGAGGGGGGGGATCAGAGACCCAGTACTTC	CASSWDRGGGSETQYF	TRBV7-2	TRBJ2-5
TGTGCCTGGACTGGACAGGGGTACGAGCAGTACTTC	CAWTGQGYEQYF	TRBV30	TRBJ2-7
TGTGCCAAAAGGGACAGGTACTACGAGCAGTACTTC	CAKRDRYYEQYF	TRBV19	TRBJ2-7
TGTGCCAGCAGCCCACTCCGGGACAGGGTTTCAAATCGCAGCAATCAGCCCCAGCATTTT	CASSPLRDRVSNRSNQPQHF	TRBV9	TRBJ1-5
TGCAGTGCTAGAGATCCCAGGGTTGAGCAGTTCTTC	CSARDPRVEQFF	TRBV20-1	TRBJ2-1
TGCAGTGCTAGTTCGGGGGAAGGCACAGATACGCAGTATTTT	CSASSGEGTDTQYF	TRBV20-1	TRBJ2-3
TGTGCCAGCAGCCACGTCAGGGCGGGAGGTTATGAGCAGTTCTTC	CASSHVRAGGYEQFF	TRBV14	TRBJ2-1
TGTGCCAGCAGTGTCGGGGAAAGCCAAGAGACCCAGTACTTC	CASSVGESQETQYF	TRBV6-4	TRBJ2-5
TGTGCCAGTAGTATAGATGCAGAGGGGGGGGGAGAAACTAGCAATCAGCCCCAGCATTTT	CASSIDAEGGGETSNQPQHF	TRBV19	TRBJ1-5
TGCGCCAGCAGCCTTACCTTAGTACGGGGCGGGAACACTGAAGCTTTCTTT	CASSLTLVRGGNTEAFF	TRBV5-1	TRBJ1-1
TGCAGCGTTGAAGATCCGAAACTAGCGGGCCACCCTGCCAAAAACATTCAGTACTTC	CSVEDPKLAGHPAKNIQYF	TRBV29-1	TRBJ2-4
TGTGCCAGCAGCACCCTTAGTGCGGGGCTTCAGCCCCAGCATTTT	CASSTLSAGLQPQHF	TRBV13	TRBJ1-5
TGTGCCAGCAGCCAAAGTCGGCTCCGGACCTCAGGCAATCAGCCCCAGCATTTT	CASSQSRLRTSGNQPQHF	TRBV14	TRBJ1-5
TGTGCCAGCAGCTCAAGTCTTCCGGGACATAGCAATCAGCCCCAGCATTTT	CASSSSLPGHSNQPQHF	TRBV7-8	TRBJ1-5
TGTGCCAGCAGCGTAGCCCGGACGATCCCTTTTCTGAACACTGAAGCTTTCTTT	CASSVARTIPFLNTEAFF	TRBV9	TRBJ1-1
TGTGCCACCAGTGATTTGCGTCCCCCGGGGGGAGTCGAGCAGTACTTC	CATSDLRPPGGVEQYF	TRBV24-1	TRBJ2-7
TGTGCCAGCAGAAGGGTTGGAACCGGGGAGCTGTTTTTT	CASRRVGTGELFF	TRBV28	TRBJ2-2
TGTGCCAGCAGCCCGGAATGCGGGGACAGGGGGCGTTACAACGAGCAGTACTTC	CASSPECGDRGRYNEQYF	TRBV5-6	TRBJ2-7
TGTGCCAGCAGTTTAAAAGCGATGTTCCGGGTCATCTGGGGCCTGACCACCTACGAGCAGTACTTC	CASSLKAMFRVIWGLTTYEQYF	TRBV12-3	TRBJ2-7
TGTGCCAGCAGCGTAGGCTTGAGGGACAGGAATGAAAAACTGTTTTTT	CASSVGLRDRNEKLFF	TRBV9	TRBJ1-4
TGTGCCAGTAACAACAGGGAACCCAACGTCCTGACTTTC	CASNNREPNVLTF	TRBV19	TRBJ2-6
TGTGCCAGCAGCCAAGATCTCTACGGACAGGGAGCAACTAATGAAAAACTGTTTTTT	CASSQDLYGQGATNEKLFF	TRBV4-2	TRBJ1-4
TGTGCCAGCAGTTACTCCGGGAATGTGCTAGGGGGGATCCATACGCAGTATTTT	CASSYSGNVLGGIHTQYF	TRBV6-5	TRBJ2-3
TGTGCCAGCAGTTTACTGCTTCGTTATCAGTTGAGGACCTTCTACAATGAGCAGTTCTTC	CASSLLLRYQLRTFYNEQFF	TRBV28	TRBJ2-1
TGTGCCAGCAGTGTGCAGGGGAGAAGGACTGACGAGCAGTACTTC	CASSVQGRRTDEQYF	TRBV12-3	TRBJ2-7
TGTGCCAGCAGCCCAGTTGGACATAGCAATCAGCCCCAGCATTTT	CASSPVGHSNQPQHF	TRBV9	TRBJ1-5
TGTGCCAGCATTCTGGGAGAGACCCAGTACTTC	CASILGETQYF	TRBV2	TRBJ2-5
TGTGCCAGCAGTCAAAGCACCTATGAAAAACTGTTTTTT	CASSQSTYEKLFF	TRBV6-6	TRBJ1-4
TGTGCCAGCAGCCGTCCCAGGGTCGGGGACAAATACAGCACAGATACGCAGTATTTT	CASSRPRVGDKYSTDTQYF	TRBV7-7	TRBJ2-3
TGTGCCAGCAGCCGCACCCCCTGGTCGGCGGATTGCTACGAGCAGTACTTC	CASSRTPWSADCYEQYF	TRBV13	TRBJ2-7
TGTGCCAGCAGCCGTCGTGACCTGGGGCGAACCCATTCACCCCTCCACTTT	CASSRRDLGRTHSPLHF	TRBV7-4	TRBJ1-6
TGCGCCAGCAGTCACCATGAGGGGACAGGGGCTCAGCCCCAGCATTTT	CASSHHEGTGAQPQHF	TRBV10-2	TRBJ1-5
TGTGCCAGCACTCCCGAGGGGATCGCAGATACGCAGTATTTT	CASTPEGIADTQYF	TRBV14	TRBJ2-3
TGTGCCAGCAGAGACAGGGCTGAGTACACTGAAGCTTTCTTT	CASRDRAEYTEAFF	TRBV6-3	TRBJ1-1
TGTGCCAGCAGCGGTTTACAAGCCAACAGGGTCCCGAGCAATCAGCCCCAGCATTTT	CASSGLQANRVPSNQPQHF	TRBV11-3	TRBJ1-5
TGTGCCTGCAAGCTTAACGAGCAGTACTTC	CACKLNEQYF	TRBV30	TRBJ2-7
TGTGCCAGCAGCAAGGAGGATAGCTCCTATAATTCACCCCTCCACTTT	CASSKEDSSYNSPLHF	TRBV13	TRBJ1-6
TGTGCCCCCAGGGGGGGCCCCGAGCAGTACTTC	CAPRGGPEQYF	TRBV12-3	TRBJ2-7
TGTGCCAGCAGCTTCCCAGGGAAAGAGACCCAGTACTTC	CASSFPGKETQYF	TRBV7-9	TRBJ2-5
TGCGCCAGCAGTGAGTTCGGGGGCGCTCTTGAAGCTTTCTTT	CASSEFGGALEAFF	TRBV10-1	TRBJ1-1
TGTGCCAGCAGCTGCGGACTAGCGGGGGGTGCCTACGAGCAGTACTTC	CASSCGLAGGAYEQYF	TRBV7-2	TRBJ2-7
TGTGCCACCAGCCCGAGGGGCTATGGCTACACCTTC	CATSPRGYGYTF	TRBV24-1	TRBJ1-2
TGCGCCAGCAGCCAAGATCAGGGAAGGTTAGGGACTAGCGGGTCCCACAATGAGCAGTTCTTC	CASSQDQGRLGTSGSHNEQFF	TRBV4-1	TRBJ2-1
TGTCGTGGGCTTACCTACGAGCAGTACTTC	CRGLTYEQYF	TRBV14	TRBJ2-7
TGTGCCAGCAGTGAGCCGCTCGGGGAAAGTACAGATACGCAGTATTTT	CASSEPLGESTDTQYF	TRBV6-4	TRBJ2-3
TGTGCCAGCAGCTCTGAGGACATAGCTGAAGCTTTCTTT	CASSSEDIAEAFF	TRBV7-9	TRBJ1-1
TGTGCCAAAATGGCAGTCAAACCCCTTGGCTCCTACGAGCAGTACTTC	CAKMAVKPLGSYEQYF	TRBV27	TRBJ2-7
TGTGCCACCTCCGCAGGGGGTTGGGAGACCCAGTACTTC	CATSAGGWETQYF	TRBV24-1	TRBJ2-5
TGTGCCAGCAAAGAAGACAGCTACGAGCAGTACTTC	CASKEDSYEQYF	TRBV12-3	TRBJ2-7
TGTGCCACCATCAGGGGCAATCAGCCCCAGCATTTT	CATIRGNQPQHF	TRBV24-1	TRBJ1-5
TGCAGTGCTAGAGCGACCGACAGGAATTTCGAAAAACTGTTTTTT	CSARATDRNFEKLFF	TRBV20-1	TRBJ1-4
TGCAGTGCGTTATTCTCTAAAGCAACTGGGATGAACACCGGGGAGCTGTTTTTT	CSALFSKATGMNTGELFF	TRBV20-1	TRBJ2-2
TGTGCCAGCAGCCAAGATAAACGGCCACTAGGTGGACAGCCCCAGCATTTT	CASSQDKRPLGGQPQHF	TRBV14	TRBJ1-5
TGTGCCAGCAGCCAAGAAACTCGGACAGGGGACGGTAATTCACCCCTCCACTTT	CASSQETRTGDGNSPLHF	TRBV14	TRBJ1-6
TGTGCCAGCAGCTTGCCAGGAGGGGGAAGCAATCAGCCCCAGCATTTT	CASSLPGGGSNQPQHF	TRBV5-4	TRBJ1-5
TGTGCCATCAGTGAGTCGAAGAGCATTGGGGAGGGAAACACCATATATTTT	CAISESKSIGEGNTIYF	TRBV10-3	TRBJ1-3
TGCGCCAGCTCCTACAGGACGAGGAGCTCTGGAAACACCATATATTTT	CASSYRTRSSGNTIYF	TRBV10-1	TRBJ1-3
TGTGCCAGCTCACCTTTTATCAAGAACAAAATTGGGAACACCGGGGAGCTGTTTTTT	CASSPFIKNKIGNTGELFF	TRBV18	TRBJ2-2
TGTGCCAGCGCCAAAGGACAGGGACGACCGAACTATGGCTACACCTTC	CASAKGQGRPNYGYTF	TRBV7-4	TRBJ1-2
TGTGCCTCACAAGGGGGGAGGAGAGCCAAAAACATTCAGTACTTC	CASQGGRRAKNIQYF	TRBV30	TRBJ2-4
TGTGCCTTTCGCGGGGAGGGAGGACGTGAAAAACTGTTTTTT	CAFRGEGGREKLFF	TRBV30	TRBJ1-4
TGTGCCAGCAGTCAGGTTCCACTAGCGGGGGGGCCGAGCATCAATGAGCAGTTCTTC	CASSQVPLAGGPSINEQFF	TRBV6-3	TRBJ2-1
TGTGCCAGCAGCCTAAGGCGACAGAGGCGGCTCACTGAAGCTTTCTTT	CASSLRRQRRLTEAFF	TRBV25-1	TRBJ1-1
TGTGCCAGCAGCTTAGTCCTATTACAGGGGGGGAGGATGAACTATGGCTACACCTTC	CASSLVLLQGGRMNYGYTF	TRBV13	TRBJ1-2
TGCGCCAGCAGCTTGGCCCGGGGGGCCAATACCGGGGAGCTGTTTTTT	CASSLARGANTGELFF	TRBV5-1	TRBJ2-2
TGTGCCAGCAGTTTATACCAGGTGGGCCCCGGGGACAAGCCAGGCAATCAGCCCCAGCATTTT	CASSLYQVGPGDKPGNQPQHF	TRBV27	TRBJ1-5
TGTGCCAGCAGCGCCCAGGCAGAGATCAACGCCCAGCATTTT	CASSAQAEINAQHF	TRBV7-3	TRBJ1-5
TGTGCCAGCAGCTTACGGGGGGGGCTAATACAGGGTGAGCAGTTCTTC	CASSLRGGLIQGEQFF	TRBV7-2	TRBJ2-1
TGTGCCAGCATGACAGGGCACGTAGATGAGCAGTTCTTC	CASMTGHVDEQFF	TRBV27	TRBJ2-1
TGTGCCAGCAGTTACTCGAACAACCGGGGGAAGGCTGGGGCCAACGTCCTGACTTTC	CASSYSNNRGKAGANVLTF	TRBV6-5	TRBJ2-6
TGTGCCAGCACGCAGGGGACCCTTTTTGCCGAGACCCAGTACTTC	CASTQGTLFAETQYF	TRBV6-5	TRBJ2-5
TGTGCCACCACACGGCGGGACAGGGGACACAATCAGCCCCAGCATTTT	CATTRRDRGHNQPQHF	TRBV24-1	TRBJ1-5
TGTGCCAGCAGTTACATAACTGAGGGGTACGAGCAGTACTTC	CASSYITEGYEQYF	TRBV6-5	TRBJ2-7
TGTGCCAGCAGTTACGTCATAACTCGGGGGGGGGGAGACAATGAGCAGTTCTTC	CASSYVITRGGGDNEQFF	TRBV6-5	TRBJ2-1
TGTGCCAGCAGCCAGCCAGGGGGCACCTACGAGCAGTACTTC	CASSQPGGTYEQYF	TRBV3-1	TRBJ2-7
TGCGGGGGCGGGGGAATGTATTCACCCCTCCACTTT	CGGGGMYSPLHF	TRBV20-1	TRBJ1-6
TGTGCCAGCAGCCAATGGACAGGGCGAGGAACCAATCAGCCCCAGCATTTT	CASSQWTGRGTNQPQHF	TRBV4-2	TRBJ1-5
TGTGCCAGCAGCTTCAAGGGACCGAGAGGGACCCAGCCCCAGCATTTT	CASSFKGPRGTQPQHF	TRBV7-9	TRBJ1-5
TGTGCCAGTAGTATCCTATGCTACAATGAGCAGTTCTTC	CASSILCYNEQFF	TRBV19	TRBJ2-1
TGTGCCAGCAGCCTCAACCCGACAGGGTGGGGGGAAGCTTTCTTT	CASSLNPTGWGEAFF	TRBV7-3	TRBJ1-1
TGTGCTAGTGGTTTGGGGTATTCCGGACCCAGCACAGATACGCAGTATTTT	CASGLGYSGPSTDTQYF	TRBV12-5	TRBJ2-3
TGTGCCAAGGATAGCGAGCAGTACTTC	CAKDSEQYF	TRBV6-1	TRBJ2-7
TGTGCCAGCATTAGCGGGAGAGATGAGCAGTTCTTC	CASISGRDEQFF	TRBV6-4	TRBJ2-1
TGCAGTGCTAGAGATAACCTAAGGGGGGACAGGGTGGAAGAGCGGGAAAAACTGTTTTTT	CSARDNLRGDRVEEREKLFF	TRBV20-1	TRBJ1-4
TGCGCCAGCCTCCATAACTACGAGCAGTACTTC	CASLHNYEQYF	TRBV5-1	TRBJ2-7
TGCGCCAGCAGCCCCCCCCGTGGGGGCGGGAGCTCTGGAAACACCATATATTTT	CASSPPRGGGSSGNTIYF	TRBV4-3	TRBJ1-3
TGTGCCAGCAGCCGCGACAGGGATGGCTACACCTTC	CASSRDRDGYTF	TRBV6-5	TRBJ1-2
TGTGCCAGCAGCGTGGGACTAGTTTTTTACAATGAGCAGTTCTTC	CASSVGLVFYNEQFF	TRBV9	TRBJ2-1
TGTGCCAGCAGTTGGCGGAGAAGTCGAAACACCATATATTTT	CASSWRRSRNTIYF	TRBV27	TRBJ1-3
TGTGCCATCAGTGGACAGGGGGGGTCAGATACGCAGTATTTT	CAISGQGGSDTQYF	TRBV10-3	TRBJ2-3
TGTGCCTGGAGTGTGGGGGGCCACGAGCAGTACTTC	CAWSVGGHEQYF	TRBV30	TRBJ2-7
TGTGCCAGCAGTATACAGCAGCCACCGGGACAGGATTTCCAAGAGACCCAGTACTTC	CASSIQQPPGQDFQETQYF	TRBV6-1	TRBJ2-5
