TGTGCCAGCAGTTACAGGCAGGGAGCGAACACCGGGGAGCTGTTTTTT	CASSYRQGANTGELFF	TRBV6-6	TRBJ2-2
TGTGCCATCAGTGATTCCGGAGGGCGCACAGATACGCAGTATTTT	CAISDSGGRTDTQYF	TRBV10-3	TRBJ2-3
TGTGCCAGCAGTGCGTGGGAACGACTAGGGAGCACAGATACGCAGTATTTT	CASSAWERLGSTDTQYF	TRBV25-1	TRBJ2-3
TGCGCCAGCAGCTTGGGGGGTCACACCGGGGAGCTGTTTTTT	CASSLGGHTGELFF	TRBV5-1	TRBJ2-2
TGTGCCAGCAGCGTTCGACAGGGCAATGAGCAGTTCTTC	CASSVRQGNEQFF	TRBV9	TRBJ2-1
TGTGCCAGCAGGGAGGGGGTCCATGGCTACACCTTC	CASREGVHGYTF	TRBV6-4	TRBJ1-2
TGTGCCAGCAGGGAGGGGGTCACAGATACGCAGTATTTT	CASREGVTDTQYF	TRBV28	TRBJ2-3
TGTGCCACCAGCAGAGCCTCACCAATACGCGGTGTGGAGCCCTACGAGCAGTACTTC	CATSRASPIRGVEPYEQYF	TRBV15	TRBJ2-7
TGTGCCAGCAGGCCCAGGACTAGCGGGTTGGAGCTTCCCTCCTACAATGAGCAGTTCTTC	CASRPRTSGLELPSYNEQFF	TRBV6-1	TRBJ2-1
TGTGCCAGCAGCTTGAACGGTGAAGAGACCCAGTACTTC	CASSLNGEETQYF	TRBV5-4	TRBJ2-5
TGTGCCAGCAGCATAAACGACGGTAGCTCCTACAATGAGCAGTTCTTC	CASSINDGSSYNEQFF	TRBV5-4	TRBJ2-1
TGTGCCAGCAAGGGTTGGGAGACCCAGTACTTC	CASKGWETQYF	TRBV7-3	TRBJ2-5
TGTGCCAGCAGTTACGGCGTCGGACTAGATACAGATACGCAGTATTTT	CASSYGVGLDTDTQYF	TRBV6-6	TRBJ2-3
TGCGCCAGCAGCGAAGCTAGCGAATCCTCCTACGAGCAGTACTTC	CASSEASESSYEQYF	TRBV5-1	TRBJ2-7
TGCGCCAGCAGCCACAGGGGTTGGGGCTACGAGCAGTACTTC	CASSHRGWGYEQYF	TRBV4-1	TRBJ2-7
TGTGCCAGCAGCTTAGCTCTAATTCAAGAGACCCAGTACTTC	CASSLALIQETQYF	TRBV11-2	TRBJ2-5
TGCGCCAGCAGCCAAAATAGAAATCAGCCCCAGCATTTT	CASSQNRNQPQHF	TRBV4-1	TRBJ1-5
TGTGCCAGCAGCTTGGCCGGGACTAAGACTGAAGCTTTCTTT	CASSLAGTKTEAFF	TRBV5-6	TRBJ1-1
TGCAGTGCTCCTAGTAGGACGGCAACTAGCGGGAGAGAAGATACGCAGTATTTT	CSAPSRTATSGREDTQYF	TRBV20-1	TRBJ2-3
TGTGCCCGGGGCAAGAATAATTCACCCCTCCACTTT	CARGKNNSPLHF	TRBV24-1	TRBJ1-6
TGTGCCAGCATCCCGACCCCTAATTTTGTCTACAATGAGCAGTTCTTC	CASIPTPNFVYNEQFF	TRBV6-5	TRBJ2-1
TGTGCCAGCAGCCAAGACCTGGACAGGGTCGCCGGGGAGCTGTTTTTT	CASSQDLDRVAGELFF	TRBV4-2	TRBJ2-2
TGTGCCAGCAGCCAAGGGATAGGGGGGCTCTACGCTAACTATGGCTACACCTTC	CASSQGIGGLYANYGYTF	TRBV4-2	TRBJ1-2
TGTGCCAGCAGTTTAGGTCGCGTTGATACGCAGTATTTT	CASSLGRVDTQYF	TRBV27	TRBJ2-3
TGTGCCAGAGACGGTCGTGGCTACACCTTC	CARDGRGYTF	TRBV10-3	TRBJ1-2
TGTGCCAGCGGGCGGAACCAGGGGGACGCTAAGCCAGACACCGGGGAGCTGTTTTTT	CASGRNQGDAKPDTGELFF	TRBV4-2	TRBJ2-2
TGCGCCAGCAGCTTGCCCTACCGGGACAGAGGTATCTCCTACGAGCAGTACTTC	CASSLPYRDRGISYEQYF	TRBV5-1	TRBJ2-7
TGTGCTAGCAGCTTGCTTACGCGGAAGTACAATGAGCAGTTCTTC	CASSLLTRKYNEQFF	TRBV7-7	TRBJ2-1
TGTGCCAGCAGCCGGGTTTCCGGGACAGGGATCCCCTCTGGAAACACCATATATTTT	CASSRVSGTGIPSGNTIYF	TRBV13	TRBJ1-3
TGTGCCAGCAGTTGCGGCGAGGTGTCCTACGAGCAGTACTTC	CASSCGEVSYEQYF	TRBV12-3	TRBJ2-7
TGTGCCACCAGGGATTGCCGGGACAGATGTAACTATGGCTACACCTTC	CATRDCRDRCNYGYTF	TRBV24-1	TRBJ1-2
TGTGCCAGCAGCCCTCCCTGTTTGGGACAGGGACACACTGAAGCTTTCTTT	CASSPPCLGQGHTEAFF	TRBV12-3	TRBJ1-1
TGTGCCTGGAGAGGGACAGGGAGGGGGGAGTACGAGCAGTACTTC	CAWRGTGRGEYEQYF	TRBV30	TRBJ2-7
TGTGCCAGCAGTTACCTGACCGAGGGGGGCTGGGATGAGCAGTTCTTC	CASSYLTEGGWDEQFF	TRBV6-6	TRBJ2-1
TGTGCCAGCAGCTTAGCTCCACCGCTAGACTGGGAAGATACGCAGTATTTT	CASSLAPPLDWEDTQYF	TRBV11-2	TRBJ2-3
TGTGCCAGTCCGCGACGGAGGCCGTACGAGCAGTACTTC	CASPRRRPYEQYF	TRBV11-2	TRBJ2-7
TGTGCCAGAACTAGGGCTAGCACAGATACGCAGTATTTT	CARTRASTDTQYF	TRBV25-1	TRBJ2-3
TGTGCCAGCACAATGGGACCGGGACTAGCGGGGGGGCGGGTCTACGAGCAGTACTTC	CASTMGPGLAGGRVYEQYF	TRBV27	TRBJ2-7
TGTGCCAGCAGCTCTGGCGAGCAGTACTTC	CASSSGEQYF	TRBV6-4	TRBJ2-7
TGTGCCAGCAGCCGTGGAACTAGCGGGAGCCAGAATCAGCCCCAGCATTTT	CASSRGTSGSQNQPQHF	TRBV13	TRBJ1-5
TGTGCCAGCAGTGACCCATCGCGACAGGGTGGTGTCTACGAGCAGTACTTC	CASSDPSRQGGVYEQYF	TRBV6-4	TRBJ2-7
TGTGCCACCATCCTCAGTAATCAGTCACCCCTCCACTTT	CATILSNQSPLHF	TRBV24-1	TRBJ1-6
TGTGCCACCAAAGCGGCCCTTGCCCAGTACTTC	CATKAALAQYF	TRBV24-1	TRBJ2-5
TGTGCCTGGATCTCCCGAGGGATGAACACTGAAGCTTTCTTT	CAWISRGMNTEAFF	TRBV30	TRBJ1-1
TGTGCCAGCAGTCTCCCTTCCCCATACCGACAGGGTGAAGCTTTCTTT	CASSLPSPYRQGEAFF	TRBV6-3	TRBJ1-1
TGTGCCAGCAGCCATCCAGGACTAGCGGTTCCGAGCTCCTACGAGCAGTACTTC	CASSHPGLAVPSSYEQYF	TRBV3-1	TRBJ2-7
TGTGCCACCAGTGAGACGAATAAGGGGGCGGAGGATTCACCCCTCCACTTT	CATSETNKGAEDSPLHF	TRBV24-1	TRBJ1-6
TGTGCCAGCAGCCCAGGGGAGGGGGGGGAGACCCAGTACTTC	CASSPGEGGETQYF	TRBV14	TRBJ2-5
TGTGCCAGCAGCAGTCGAGGCTTTGTTGAAAAACTGTTTTTT	CASSSRGFVEKLFF	TRBV7-3	TRBJ1-4
TGTGCCAGCAGCCCGTTAGGGTTCTACGAGCAGTACTTC	CASSPLGFYEQYF	TRBV13	TRBJ2-7
TGTGCTAGCAGCTTAGCGGGAGCGGGACCAATGGGGGGAAGCGGGAATGAGCAGTTCTTC	CASSLAGAGPMGGSGNEQFF	TRBV7-7	TRBJ2-1
TGTGCCAGCTCACCCCTAAAAGACGGGACAAAAGGCCTCAATCAGCCCCAGCATTTT	CASSPLKDGTKGLNQPQHF	TRBV18	TRBJ1-5
TGCGCCAGCAGATACCCCGACCGAAGACTAGCGGTTCGTGAGACCCAGTACTTC	CASRYPDRRLAVRETQYF	TRBV5-1	TRBJ2-5
TGTGCCAGCAGCTGCCGGACAGCGCCCCAGCATTTT	CASSCRTAPQHF	TRBV7-2	TRBJ1-5
TGTGCCAGCAGGTCCCCTTTTGACTGGCAAGAGACCCAGTACTTC	CASRSPFDWQETQYF	TRBV7-4	TRBJ2-5
TGTGCCAGCAGCTTAGGAAAAAGGACGGCACACGAGCAGTACTTC	CASSLGKRTAHEQYF	TRBV7-3	TRBJ2-7
TGCAGTGCGAAAGGGCATGCCAATGAGCAGTTCTTC	CSAKGHANEQFF	TRBV20-1	TRBJ2-1
TGTGCCAGCAGTGAATCAGACTCAGCCTACGAGCAGTACTTC	CASSESDSAYEQYF	TRBV25-1	TRBJ2-7
TGTGCCAGTAGTAGAAGGGTCAGGTCGGACAGGGGGCCGAGCACAGATACGCAGTATTTT	CASSRRVRSDRGPSTDTQYF	TRBV19	TRBJ2-3
TGTGCCAGTAGTGCGGGCTCGAACACTGAAGCTTTCTTT	CASSAGSNTEAFF	TRBV19	TRBJ1-1
TGTGCCAGCAGTGAACCCCTCCACACACCGGGGCGCCGGGGTGGGACCTACGAGCAGTACTTC	CASSEPLHTPGRRGGTYEQYF	TRBV25-1	TRBJ2-7
TGCGCCAGCAGCCAAGATCCCCCCAGCTACGAGCAGTACTTC	CASSQDPPSYEQYF	TRBV4-1	TRBJ2-7
TGTGCCAGCAGCCGGGAGGGGGGGACCAAAACGGAGCAGTACTTC	CASSREGGTKTEQYF	TRBV7-4	TRBJ2-7
TGTGCCAGCAGGTTTTTCGGGGGAGATACGCAGTATTTT	CASRFFGGDTQYF	TRBV6-5	TRBJ2-3
TGTGCCAGCAGCCAAGAGGTCTTTACAAACACTGAAGCTTTCTTT	CASSQEVFTNTEAFF	TRBV3-1	TRBJ1-1
TGTGCCAGCAGCCGGACAGATACAGGCTACACCTTC	CASSRTDTGYTF	TRBV13	TRBJ1-2
TGTGCCAGCAGCATTTGGAGGAATCAGCCCCAGCATTTT	CASSIWRNQPQHF	TRBV9	TRBJ1-5
TGTGCCAGCAGCCAACGCCGCCCGGAAGTCTCACGCGTAGGGTATAGCAATCAGCCCCAGCATTTT	CASSQRRPEVSRVGYSNQPQHF	TRBV5-4	TRBJ1-5
TGTGCCAGCAGTGAAAACACCCCCGGGCCGTTTTACGACGAGCAGTACTTC	CASSENTPGPFYDEQYF	TRBV6-4	TRBJ2-7
TGTGCCACCAGTACCGAATGGACAGCTGGTAACACCGGGGAGCTGTTTTTT	CATSTEWTAGNTGELFF	TRBV24-1	TRBJ2-2
TGTGCCACCGGTCCTTGGACCTACGAGCAGTACTTC	CATGPWTYEQYF	TRBV2	TRBJ2-7
TGTGCCAGCAGCTTAATTTGGGGCGGGGGCTCCTACGAGCAGTACTTC	CASSLIWGGGSYEQYF	TRBV7-6	TRBJ2-7
TGCAGCGTTGCAACAGGCACAGATACGCAGTATTTT	CSVATGTDTQYF	TRBV29-1	TRBJ2-3
TGCGCCAGCACACTAATGAATCAGCCCCAGCATTTT	CASTLMNQPQHF	TRBV5-1	TRBJ1-5
TGTGCCAGCAGCAGGGCGGACAGGGTATATCAGCCCCAGCATTTT	CASSRADRVYQPQHF	TRBV7-3	TRBJ1-5
TGCAGTGCTAGATCCCGGGACAGGGGATGCAATCAGCCCCAGCATTTT	CSARSRDRGCNQPQHF	TRBV20-1	TRBJ1-5
TGTGCCAGCAAAGGCGACAGGGCTAATTTGAATTCACCCCTCCACTTT	CASKGDRANLNSPLHF	TRBV28	TRBJ1-6
TGTGCCACCAGTGATTTGAATTCTCGGGCGGGGAGCACAGATACGCAGTATTTT	CATSDLNSRAGSTDTQYF	TRBV24-1	TRBJ2-3
TGCGCCAGCAGCCACCCCTCCGGGACAGGGAGGGAGCTGTTTTTT	CASSHPSGTGRELFF	TRBV4-1	TRBJ2-2
TGTGCCTGGAGTGTCGTTGGGCTCCTAACCACCGGGGAGCTGTTTTTT	CAWSVVGLLTTGELFF	TRBV30	TRBJ2-2
TGTGCCAGCAGCTTAGATCGGAATTTCCTGGGCTACGGAAACACCATATATTTT	CASSLDRNFLGYGNTIYF	TRBV11-2	TRBJ1-3
TGTGCCAGCAGCCAAGATGGGGGGGGGTTTGGGAGCTACGAGCAGTACTTC	CASSQDGGGFGSYEQYF	TRBV14	TRBJ2-7
TGTGCCTGGAGTCCTCTTAAGGGGAGGGTAACCACTGAAGCTTTCTTT	CAWSPLKGRVTTEAFF	TRBV30	TRBJ1-1
TGTGCCACCAGCAGAGTAGAGCCCCCGTTGGGGACAAGCTCAAGCTCTGGGGCCAACGTCCTGACTTTC	CATSRVEPPLGTSSSSGANVLTF	TRBV15	TRBJ2-6
TGTGCCATCAGTGCTCAGGGTGAAGCTTTCTTT	CAISAQGEAFF	TRBV10-3	TRBJ1-1
TGCGCCAGCAGTGAATTTCCGGGACATGGCTACACCTTC	CASSEFPGHGYTF	TRBV10-2	TRBJ1-2
TGTGCCCTCGGGGGACTAGCGGGCATGAAGATCACAGATACGCAGTATTTT	CALGGLAGMKITDTQYF	TRBV7-2	TRBJ2-3
TGTGCCAGCAGGGTGACCGGGACAGGGAGAACCGAGACCCAGTACTTC	CASRVTGTGRTETQYF	TRBV6-2	TRBJ2-5
TGTGCCAGCAGCCAAGGAGCGGACAGGGGACCTAACTATGGCTACACCTTC	CASSQGADRGPNYGYTF	TRBV3-1	TRBJ1-2
TGTGCCAGCAGCTTCTGGATAGCGGGTGACTACGAGCAGTACTTC	CASSFWIAGDYEQYF	TRBV7-9	TRBJ2-7
TGCGCCAGCAGCTGCGCGGGGGGAAACACCATATATTTT	CASSCAGGNTIYF	TRBV5-1	TRBJ1-3
TGTGCCATCAGCCGACAGGGGGGACCAGAAAATCAGCCCCAGCATTTT	CAISRQGGPENQPQHF	TRBV10-3	TRBJ1-5
TGTGCCAGCAGCTCCACCCTAGAGACTGAAGCTTTCTTT	CASSSTLETEAFF	TRBV5-6	TRBJ1-1
TGTGCCACCAGCAGGCCCGGCGCTGGAGTAGAGTGCTACGAGCAGTACTTC	CATSRPGAGVECYEQYF	TRBV15	TRBJ2-7
TGCAGTGCTAGAGGGGATAACCAAGAGACCCAGTACTTC	CSARGDNQETQYF	TRBV20-1	TRBJ2-5
TGTGCCAGCAGCGATGGGAGACTTTACACTGAAGCTTTCTTT	CASSDGRLYTEAFF	TRBV7-9	TRBJ1-1
TGTGCCAGCAGCGTGCCTCCAGAGTTAGAAAAACTGTTTTTT	CASSVPPELEKLFF	TRBV3-1	TRBJ1-4
TGCAGCGTCTGGGACTACAATGAGCAGTTCTTC	CSVWDYNEQFF	TRBV29-1	TRBJ2-1
TGTGCCAGCCCGTGGGGACTAGCGGGCGGGAACACCGGGGAGCTGTTTTTT	CASPWGLAGGNTGELFF	TRBV9	TRBJ2-2
TGTGCCAGCAGCAATGGACAGGGCGAAGACGAGCAGTACTTC	CASSNGQGEDEQYF	TRBV13	TRBJ2-7
TGTGCCAGCAGACCAGCGGGAAACACCATATATTTT	CASRPAGNTIYF	TRBV3-1	TRBJ1-3
TGTGCCAGCAGCTTGTGGGACAGGATGAATAGCAATCAGCCCCAGCATTTT	CASSLWDRMNSNQPQHF	TRBV7-4	TRBJ1-5
TGCGCCAGCAGCTTGGTAGGGGACATAAAAAGGGATGGCTACACCTTC	CASSLVGDIKRDGYTF	TRBV5-1	TRBJ1-2
TGTGCCAGTAGTATAGTTACGGGGTTGAGTGAAGCTTTCTTT	CASSIVTGLSEAFF	TRBV19	TRBJ1-1
TGCGCCAGCAGCGGGGGGCTAGCGAGAACACAGGCCTACAATGAGCAGTTCTTC	CASSGGLARTQAYNEQFF	TRBV5-1	TRBJ2-1
TGCGCCAGCAGCTTGGTGTCACACCAGCAAGAGACCCAGTACTTC	CASSLVSHQQETQYF	TRBV5-1	TRBJ2-5
TGTGGCGAGGGATTTCAGCCCCAGCATTTT	CGEGFQPQHF	TRBV4-2	TRBJ1-5
TGCGCCAGCAGCTTGAGAATGAGGGACAGGGGTTGCAATCAGCCCCAGCATTTT	CASSLRMRDRGCNQPQHF	TRBV5-1	TRBJ1-5
TGTGCCACCGGACAGGGGCGGGTCAACACTGAAGCTTTCTTT	CATGQGRVNTEAFF	TRBV6-5	TRBJ1-1
TGTGCTAGCAGCTTAGGGCAGGGGGACTACGAGCAGTACTTC	CASSLGQGDYEQYF	TRBV7-7	TRBJ2-7
TGTGCCAGCAGCGTAGGAATCCGCTCAGTAGAGCAGTACTTC	CASSVGIRSVEQYF	TRBV9	TRBJ2-7
TGCAGTGGGACTAGCGGCGGGGACGAGCAGTACTTC	CSGTSGGDEQYF	TRBV20-1	TRBJ2-7
TGTGCCAGCAGCCAAGATCCCCTGGGGTCGTTCGAGCAGTACTTC	CASSQDPLGSFEQYF	TRBV3-1	TRBJ2-7
TGTGCCAGCAGCTCAGTATCTAGGGAGGGAACAGATACGCAGTATTTT	CASSSVSREGTDTQYF	TRBV6-1	TRBJ2-3
TGTGCCACGGGAATAGTACTCAGCTCCTACGAGCAGTACTTC	CATGIVLSSYEQYF	TRBV28	TRBJ2-7
TGTGCCAGCAGACCAGGTAGAGGGGCTTTCTTT	CASRPGRGAFF	TRBV5-5	TRBJ1-1
TGTGCCAGCAGCTTGCCGGCCGGGACAGGGGGACCGGGGGGGGAAAGCCTCTACACCTTC	CASSLPAGTGGPGGESLYTF	TRBV7-9	TRBJ1-2
TGTGCCAGGCACAGGGAGACAGGGGGGAGAAACACCATATATTTT	CARHRETGGRNTIYF	TRBV6-1	TRBJ1-3
TGTGCCAGCAGTTACCCAGGGTGTAATTCACCCCTCCACTTT	CASSYPGCNSPLHF	TRBV6-6	TRBJ1-6
TGTGCCAGCAGTCGGGGACCGGGGCCTGGTCCCGGAGCCGGGGAGCTGTTTTTT	CASSRGPGPGPGAGELFF	TRBV6-3	TRBJ2-2
TGTGCCAGCAGCTTACCAGGGACTAGCGCCGGGGAGCTGTTTTTT	CASSLPGTSAGELFF	TRBV11-1	TRBJ2-2
TGTGCCACAGGCATTACCGGGGAGCTGTTTTTT	CATGITGELFF	TRBV10-3	TRBJ2-2
TGTGCCACCAGCAGCAGGGCCCACAATCAGCCCCAGCATTTT	CATSSRAHNQPQHF	TRBV15	TRBJ1-5
TGTGCCAGCAGCGAGCCTATCCCCTACGAGCAGTACTTC	CASSEPIPYEQYF	TRBV9	TRBJ2-7
TGTGCCAGCAGCCGTGAGGGGGGGGCCATGAAAGGGGCCAACGTCCTGACTTTC	CASSREGGAMKGANVLTF	TRBV5-5	TRBJ2-6
TGTGCCACCCCCCGCCTCTGGGACAGGGGTAAAGGGCAGCCCCAGCATTTT	CATPRLWDRGKGQPQHF	TRBV24-1	TRBJ1-5
TGTGCCACCCCCAAAAACGGCCGCAATGAAAAACTGTTTTTT	CATPKNGRNEKLFF	TRBV24-1	TRBJ1-4
TGTGCCAGCAGCTTGGCCCGGACCACGTCGAATGGCTACACCTTC	CASSLARTTSNGYTF	TRBV5-5	TRBJ1-2
TGCACTCCACAGGGGAGGGACGAGCAGTACTTC	CTPQGRDEQYF	TRBV20-1	TRBJ2-7
TGCGCCAGCAGCCAAGATCTCGACGAGCAGTACTTC	CASSQDLDEQYF	TRBV4-3	TRBJ2-7
TGCAGCGTTGACGCTCCGGGACTAGCGGGAGGGCTTGCCGAAAAACTGTTTTTT	CSVDAPGLAGGLAEKLFF	TRBV29-1	TRBJ1-4
TGTGCCAGCAGCTTAGATCCCGGACTCTATAGCAATCAGCCCCAGCATTTT	CASSLDPGLYSNQPQHF	TRBV11-3	TRBJ1-5
TGTGCCAGCAGCCTCTCGTTGAACACTGAAGCTTTCTTT	CASSLSLNTEAFF	TRBV5-6	TRBJ1-1
TGCGCCAGAACCGGGAGAGATACGCAGTATTTT	CARTGRDTQYF	TRBV5-1	TRBJ2-3
TGTGCCAGCAGCTGTCCACAGGGCGGGTTTGAAAAACTGTTTTTT	CASSCPQGGFEKLFF	TRBV6-2	TRBJ1-4
TGTGCCAGCAGTTCACCTAGTAGAATGAACACTGAAGCTTTCTTT	CASSSPSRMNTEAFF	TRBV27	TRBJ1-1
TGTGCCAGCAGCGGATTGACAGGAATCCTGTTTTTT	CASSGLTGILFF	TRBV7-3	TRBJ1-4
TGTGCCAGTAGATCCGGGACAGTTCTAGATACGCAGTATTTT	CASRSGTVLDTQYF	TRBV19	TRBJ2-3
TGTGCCAGCAGCTTGTGTGGGAAAAGCGGGAAGTACAATGAGCAGTTCTTC	CASSLCGKSGKYNEQFF	TRBV7-9	TRBJ2-1
TGTGCCAGCAGTGACTCGAATTTGGGACTAGCGGCTAGGTCCTACGAGCAGTACTTC	CASSDSNLGLAARSYEQYF	TRBV6-4	TRBJ2-7
TGCGCCAGCAGGACAGAGCCCCAGCATTTT	CASRTEPQHF	TRBV5-1	TRBJ1-5
TGTGCCACCAGTGATTTGCAGCGCACCGGGGAGCTGTTTTTT	CATSDLQRTGELFF	TRBV24-1	TRBJ2-2
TGTGCCATCAGTGAGAGGGGAAAGAACACCGGGGAGCTGTTTTTT	CAISERGKNTGELFF	TRBV10-3	TRBJ2-2
TGCGCCAGCAGCTTAGGGGACAGGGTTAGGTCCACCGGGGAGCTGTTTTTT	CASSLGDRVRSTGELFF	TRBV5-1	TRBJ2-2
TGTGCCACCGGGGCATGCCCTAATTCACCCCTCCACTTT	CATGACPNSPLHF	TRBV24-1	TRBJ1-6
TGTGCCATTTCCCCGACAGAGGGGAGGGGCGAGCAGTACTTC	CAISPTEGRGEQYF	TRBV6-1	TRBJ2-7
TGTGCCACCAGCCCCAAGGGGGCGGCCAGACAGTACTTC	CATSPKGAARQYF	TRBV24-1	TRBJ2-5
TGCAGTGCTCGGAACACTAGGTTGAGGGACAATGAGCAGTTCTTC	CSARNTRLRDNEQFF	TRBV20-1	TRBJ2-1
TGTGCCAGCAGCTTAGATCTCCAGGGGCTAGGCCAAGAGACCCAGTACTTC	CASSLDLQGLGQETQYF	TRBV11-3	TRBJ2-5
TGTGCCAGCAGCCCCGTTCCCGGGGGGAGCCAAGAGACCCAGTACTTC	CASSPVPGGSQETQYF	TRBV14	TRBJ2-5
TGTGCCAGCAGTCGGGACAGGGGCTTACCTGGGGCCAACGTCCTGACTTTC	CASSRDRGLPGANVLTF	TRBV6-2	TRBJ2-6
TGTGCCAGCAGCCAAGCTACCGGGACTAGTCGGTACGAGCAGTACTTC	CASSQATGTSRYEQYF	TRBV4-2	TRBJ2-7
TGCGCCAGCAGCTTGAATAGGACGGGAGGCGCCAAAAACATTCAGTACTTC	CASSLNRTGGAKNIQYF	TRBV5-1	TRBJ2-4
TGCGCCAGCAGTGAGAGGGACAGGAGCGAGCAGTACTTC	CASSERDRSEQYF	TRBV10-1	TRBJ2-7
TGCAGTGCTAGAGATCAGGGGTATGGCTACACCTTC	CSARDQGYGYTF	TRBV20-1	TRBJ1-2
TGTGCCAGCAGGCGGGAGGTACTCGGTGGCTACACCTTC	CASRREVLGGYTF	TRBV25-1	TRBJ1-2
TGTGCCACCAGTGAGGGGACTAGCGGGGGGAATGAGCAGTTCTTC	CATSEGTSGGNEQFF	TRBV24-1	TRBJ2-1
TGTGCCAGCAGCCAAGATCCACCGGGGTTGCAAAACATTCAGTACTTC	CASSQDPPGLQNIQYF	TRBV3-1	TRBJ2-4
TGTGCCAGCATGCGTAAGCGGGTACCACAAGCCACCTACGAGCAGTACTTC	CASMRKRVPQATYEQYF	TRBV12-4	TRBJ2-7
TGTGCCAGCAGTTTAGAGGGGGGGAGTCCAACAGATACGCAGTATTTT	CASSLEGGSPTDTQYF	TRBV28	TRBJ2-3
TGTGCCACCCCGACAGGGGTCCCCTACGAGCAGTACTTC	CATPTGVPYEQYF	TRBV24-1	TRBJ2-7
TGCAGTGCTAGAGAAGGGACCGGGGAGCTGTTTTTT	CSAREGTGELFF	TRBV20-1	TRBJ2-2
TGTGCCAGCACGGGGTATGAAGCTTTCTTT	CASTGYEAFF	TRBV28	TRBJ1-1
TGTGCCTACTCAGGTGGGGGCAGGCTGGGCAATTTAGGGAACACTGAAGCTTTCTTT	CAYSGGGRLGNLGNTEAFF	TRBV28	TRBJ1-1
TGTGCCACCAGGGGGGACAGGGCCTACGAGCAGTACTTC	CATRGDRAYEQYF	TRBV24-1	TRBJ2-7
TGCAGTGCTAGGCGACCCGGGACTAGTGGAACAGATACGCAGTATTTT	CSARRPGTSGTDTQYF	TRBV20-1	TRBJ2-3
TGTGCCAGCAGAAGGACAGGGAACGAGCAGTACTTC	CASRRTGNEQYF	TRBV27	TRBJ2-7
TGCAGTGAGGCCGACCTGAGGCCCCAGCATTTT	CSEADLRPQHF	TRBV20-1	TRBJ1-5
TGTGCCAGCAGTTACGGAGATAGGGAAAAACTGTTTTTT	CASSYGDREKLFF	TRBV6-2	TRBJ1-4
TGTGCCAGCAGTTACAGCAGTCCGGGCAATCAGCCCCAGCATTTT	CASSYSSPGNQPQHF	TRBV6-5	TRBJ1-5
TGTGCCAGCAGCGTAGGAGAGCTTTTCATGAGGAACACTGAAGCTTTCTTT	CASSVGELFMRNTEAFF	TRBV9	TRBJ1-1
TGTGCCAGCCCCCTCAATCAGCCCCAGCATTTT	CASPLNQPQHF	TRBV6-5	TRBJ1-5
TGTGCCACCAGCAGCGTGACTAGCGGGAATACGCAGTATTTT	CATSSVTSGNTQYF	TRBV15	TRBJ2-3
TGTGCCAGTAGTATAGAACCTAGTAAGCCCTACGAGCAGTACTTC	CASSIEPSKPYEQYF	TRBV19	TRBJ2-7
TGTGCCAGCAGCTTGCAACAGGGCCACTACACCTTC	CASSLQQGHYTF	TRBV5-4	TRBJ1-2
TGTGCCAGCAGTTACTGTTGGGTACCGGGACAGGGAGGGTCGGATGGCATGGAGCAGTACTTC	CASSYCWVPGQGGSDGMEQYF	TRBV6-5	TRBJ2-7
TGTGCCAGCAGCTTAGACCTAGCCAACAATGAGCAGTTCTTC	CASSLDLANNEQFF	TRBV7-6	TRBJ2-1
TGTGCCAGCGTACAGGGTAGTCTCTCCTACGAGCAGTACTTC	CASVQGSLSYEQYF	TRBV6-1	TRBJ2-7
TGCAGTGCTAGAGCAGGCCAACCGGGACGTGGAGAGACCCAGTACTTC	CSARAGQPGRGETQYF	TRBV20-1	TRBJ2-5
TGTGCCAGCAGCCAAGAAATCGAACTTTCGGGGTCGGACCTTCTTGAAAAACTGTTTTTT	CASSQEIELSGSDLLEKLFF	TRBV3-1	TRBJ1-4
TGTGCCACCAGTGGTTTCCTTTTTTCTCAGGGGTCTGAAGCTTTCTTT	CATSGFLFSQGSEAFF	TRBV24-1	TRBJ1-1
TGCGCCAGCAGCCGCCTGACTAGTTGGGACCAAAGCTCCTACAATGAGCAGTTCTTC	CASSRLTSWDQSSYNEQFF	TRBV5-1	TRBJ2-1
TGCAGCGTCGAAGCCCTGGCGAGCTCTGGGGCCAACGTCCTGACTTTC	CSVEALASSGANVLTF	TRBV29-1	TRBJ2-6
TGTGCCAGCAGCCAAGCTCGTGGGGGGCTTATATCCTACAATGAGCAGTTCTTC	CASSQARGGLISYNEQFF	TRBV4-2	TRBJ2-1
TGTGCCAGCAGTTTAAGGACGCTGGAGACCCAGTACTTC	CASSLRTLETQYF	TRBV12-3	TRBJ2-5
TGTGCCAGCAGGCTCTGCATCACAGATACGCAGTATTTT	CASRLCITDTQYF	TRBV12-3	TRBJ2-3
TGCAGTGCTAGCGGCGTCTTCCGCAGAAGGGACAGGGGGAGAGATACGCAGTATTTT	CSASGVFRRRDRGRDTQYF	TRBV20-1	TRBJ2-3
TGCGCCAGCCAACTAAGGGGGACAGGGGACCCTGGCTACACCTTC	CASQLRGTGDPGYTF	TRBV5-1	TRBJ1-2
TGTGCCAGCAGCTCTCCCGTCGGAAACGAGACCCAGTACTTC	CASSSPVGNETQYF	TRBV7-4	TRBJ2-5
TGCGCCAGCACCCGCGGGGGGGACTCCGGAGCGTCTTGTTACTATGGCTACACCTTC	CASTRGGDSGASCYYGYTF	TRBV10-1	TRBJ1-2
TGTGCCAGCAGCTCACGACGGGGAGGCCCTAATTCACCCCTCCACTTT	CASSSRRGGPNSPLHF	TRBV12-4	TRBJ1-6
TGTGCCAGCTCACCAGGATCTAGGGATAAAAACATTCAGTACTTC	CASSPGSRDKNIQYF	TRBV18	TRBJ2-4
TGCAGTGCTAGAGCGCCGGGGGCGGCCAGCTCTGGAAACACCATATATTTT	CSARAPGAASSGNTIYF	TRBV20-1	TRBJ1-3
TGTGTAAGTAGACTAGCGGAGGGGAAAAGGGCCAAAAACATTCAGTACTTC	CVSRLAEGKRAKNIQYF	TRBV28	TRBJ2-4
TGTGCCAGCGCCAGAGATACGCAGTATTTT	CASARDTQYF	TRBV6-5	TRBJ2-3
TGTGCCACCGTAACTCCCCGGGACAGGAATCAGCCCCAGCATTTT	CATVTPRDRNQPQHF	TRBV24-1	TRBJ1-5
TGTGCCAGCAGTGCCGGGACACGAGATGGCTACACCTTC	CASSAGTRDGYTF	TRBV27	TRBJ1-2
TGTGCCAGCAGCAAGGCCGGGAGGGTAAGGCAAGAGACCCAGTACTTC	CASSKAGRVRQETQYF	TRBV13	TRBJ2-5
TGTGCCAGCAGTAATGGAGTTTTAGCACCCCTCCACTTT	CASSNGVLAPLHF	TRBV6-5	TRBJ1-6
TGTGCCAGCAGCTTAATCCGCGGGTCTTTCTCACCCCTCCACTTT	CASSLIRGSFSPLHF	TRBV7-3	TRBJ1-6
TGTGCCAGCAGTTACTTCGTGGGGCCGAGAAGATGCAAAAACATTCAGTACTTC	CASSYFVGPRRCKNIQYF	TRBV6-2	TRBJ2-4
TGTGCCAGCAGTTTAGTGCATGATTATCAGCCCCAGCATTTT	CASSLVHDYQPQHF	TRBV12-3	TRBJ1-5
TGTGCCAGCAGTGTGGACCGAGAGACCCAGTACTTC	CASSVDRETQYF	TRBV6-3	TRBJ2-5
TGTGCCAGCAGTTTCGTGGGGGGGAGTGGGATGTACGAGCAGTACTTC	CASSFVGGSGMYEQYF	TRBV28	TRBJ2-7
TGTGCCAGCAGACGTCAGGGGTACACTGAAGCTTTCTTT	CASRRQGYTEAFF	TRBV6-1	TRBJ1-1
TGTGCCAGCAGTGAAGTCTCGTGGAAGGACCGGAACTATGGCTACACCTTC	CASSEVSWKDRNYGYTF	TRBV6-1	TRBJ1-2
TGTGCCAGCAGCCAAGAGCAGGGGACTGTGGAGCAGTACTTC	CASSQEQGTVEQYF	TRBV14	TRBJ2-7
TGTGCCACCAGTGAGGGGGGGGCAGCCTACAATTCAGAGTCATCACCCCTCCACTTT	CATSEGGAAYNSESSPLHF	TRBV24-1	TRBJ1-6
TGCAGTGCTAGTACAGGGGTGGAGGGCTCTACAGATACGCAGTATTTT	CSASTGVEGSTDTQYF	TRBV20-1	TRBJ2-3
TGTGCCAGCAGCTTCACGAAAGATCAGCCCCAGCATTTT	CASSFTKDQPQHF	TRBV5-5	TRBJ1-5
TGTGCCCCCTCCGGGACTAGCGGGAGTGAGCAGTTCTTC	CAPSGTSGSEQFF	TRBV12-3	TRBJ2-1
TGTGCCAGCAGCCGATCGGGGGCTATGAGGAGTTCGTTGAACACTGAAGCTTTCTTT	CASSRSGAMRSSLNTEAFF	TRBV6-3	TRBJ1-1
TGTGCCAGCAGTGTACCCATGGGGGGGGGGGCTGACGATACGCAGTATTTT	CASSVPMGGGADDTQYF	TRBV6-1	TRBJ2-3
TGTGCCAGCATCGGCGGTGAAGGCAATCAGCCCCAGCATTTT	CASIGGEGNQPQHF	TRBV6-2	TRBJ1-5
TGTGCCACCAGCAGAGATGGACCTTCCGAGCAGTACTTC	CATSRDGPSEQYF	TRBV15	TRBJ2-7
TGTGCCAGCAGCTTACTAGCGGCGTACTACGAGCAGTACTTC	CASSLLAAYYEQYF	TRBV11-2	TRBJ2-7
TGTGCCGTAATTGGGAACTTCACCTACAATGAGCAGTTCTTC	CAVIGNFTYNEQFF	TRBV19	TRBJ2-1
TGTGCCAGCCCGAGACTAGCGGGAGAGATTAAGGAGAACGAGCAGTACTTC	CASPRLAGEIKENEQYF	TRBV2	TRBJ2-7
TGTGCCAGCATTACGCGGGAGTTGCTAATGTTCATGAACACTGAAGCTTTCTTT	CASITRELLMFMNTEAFF	TRBV11-2	TRBJ1-1
TGCGCCAGCAGCCTGAGTTCCGGGACATCTAGCACAGATACGCAGTATTTT	CASSLSSGTSSTDTQYF	TRBV5-1	TRBJ2-3
TGTGCCAGCAGTAAATGGACTATCTTTAGGCGAGAGACCCAGTACTTC	CASSKWTIFRRETQYF	TRBV6-5	TRBJ2-5
TGTGCCTTTCGTTCTGCGGGAGGGCCCTGGGGGGCCAAAAACATTCAGTACTTC	CAFRSAGGPWGAKNIQYF	TRBV3-1	TRBJ2-4
TGTGCCAGCAGTTTTGGAGCTGAGCAGTTCTTC	CASSFGAEQFF	TRBV6-5	TRBJ2-1
TGCAGTGAGGACTTGAATGAGCAGTTCTTC	CSEDLNEQFF	TRBV20-1	TRBJ2-1
TGTGCCAGCAGGCAAGGGACTAGCGGGGGGGCTGATACGCAGTATTTT	CASRQGTSGGADTQYF	TRBV6-2	TRBJ2-3
TGCGCCAGCAGCTCCTCCTGGGGTTACCTGGGCGAGACCCAGTACTTC	CASSSSWGYLGETQYF	TRBV5-1	TRBJ2-5
TGCGCCAGCAGCCAAGAACCGACAGACCTTAACTATGGCTACACCTTC	CASSQEPTDLNYGYTF	TRBV4-1	TRBJ1-2
TGTGCCAGCAGTTATCGAGACAGGGGTGGGAGGGAGAACACTGAAGCTTTCTTT	CASSYRDRGGRENTEAFF	TRBV27	TRBJ1-1
TGCGCCAGCAGCTTGATTAAGCGTAACATTCAGTACTTC	CASSLIKRNIQYF	TRBV5-1	TRBJ2-4
TGTGCCAGCAGCCCCCAAGGCAGGACAGGGACGACAGATACGCAGTATTTT	CASSPQGRTGTTDTQYF	TRBV2	TRBJ2-3
TGTGCCGACCCAGAGACAGAAACTGGCTACACCTTC	CADPETETGYTF	TRBV30	TRBJ1-2
TGCAGTGCTAGCTGGCAGTACTTC	CSASWQYF	TRBV20-1	TRBJ2-5
TGTGCCAGCAGTTCCTCTCAAAAAGGGGGGAACAGATGTTGCGTCGGTGAGCAGTTCTTC	CASSSSQKGGNRCCVGEQFF	TRBV6-5	TRBJ2-1
TGTGCCAGCAGTTACTCGAACCGGGACCGCGTTCAGCCCCAGCATTTT	CASSYSNRDRVQPQHF	TRBV6-5	TRBJ1-5
TGTGCCAGCAGCTTAGGCGGGGAGGGTCTTGGGGACAGGGGCGGGGAGCTGTTTTTT	CASSLGGEGLGDRGGELFF	TRBV11-2	TRBJ2-2
TGTGCCAGCAGTTGCGCGGGGGGACCCCACGAGCAGTACTTC	CASSCAGGPHEQYF	TRBV12-3	TRBJ2-7
TGTGCCAGCAGCAACATAACGCAGGTGTGCTCCTACAATGAGCAGTTCTTC	CASSNITQVCSYNEQFF	TRBV13	TRBJ2-1
TGTGCCAGCAGCCAAGATTCGGCGCGACACGAAGGGGGCACGCAGTATTTT	CASSQDSARHEGGTQYF	TRBV14	TRBJ2-3
TGTGCCAGCAGCTCCCTAGGGGGGAATGAGCAGTTCTTC	CASSSLGGNEQFF	TRBV7-9	TRBJ2-1
TGTGCCAGCAGCTTAGGCATCTCTAGGACTAGCGGGACCCCAGATACGCAGTATTTT	CASSLGISRTSGTPDTQYF	TRBV11-3	TRBJ2-3
TGTGCCAGCAGCTTGGCCGAAATGGGGCCGACGGGTGTGACCGGGGAGCTGTTTTTT	CASSLAEMGPTGVTGELFF	TRBV5-4	TRBJ2-2
TGTGCCAGCATCACGGGGGGGAAGTTGTCGAACACCGGGGAGCTGTTTTTT	CASITGGKLSNTGELFF	TRBV7-9	TRBJ2-2
TGTGCCAGCAGTATGGACCCAGTCAAAGAGACCCAGTACTTC	CASSMDPVKETQYF	TRBV6-4	TRBJ2-5
TGCAGCGTAAACTGTATGGGGGGCAATAACTTCTCCACAGATACGCAGTATTTT	CSVNCMGGNNFSTDTQYF	TRBV29-1	TRBJ2-3
TGTGCCATCAGTGACTTTCCCGGGACTCAAAGTTCTAATGAAAAACTGTTTTTT	CAISDFPGTQSSNEKLFF	TRBV10-3	TRBJ1-4
TGTGCCAGCAGGTTTGGGGACATATACCCCTACGAGCAGTACTTC	CASRFGDIYPYEQYF	TRBV6-4	TRBJ2-7
TGTGCCAGCAGCCAAGATGGTATACCGGGTTGTCCCTATGGCTACACCTTC	CASSQDGIPGCPYGYTF	TRBV14	TRBJ1-2
TGCGCCAGCAGTGATGGTCAGGGGAACTATGGCTACACCTTC	CASSDGQGNYGYTF	TRBV10-2	TRBJ1-2
TGCAGTGCGGGGAAGAAGAACACTGAAGCTTTCTTT	CSAGKKNTEAFF	TRBV20-1	TRBJ1-1
TGTGCCAGCAGTTTGCACGCGCCAGGGTTGGGGGGCAGCAATCAGCCCCAGCATTTT	CASSLHAPGLGGSNQPQHF	TRBV27	TRBJ1-5
TGTGCCAGCAGCCTTATGGACGGCACTGAAGCTTTCTTT	CASSLMDGTEAFF	TRBV5-6	TRBJ1-1
TGTGCCTGGAGGCGGGGGAACCTGGGGGGAGAGGCGGGACGAACCGATACGCAGTATTTT	CAWRRGNLGGEAGRTDTQYF	TRBV30	TRBJ2-3
TGTGCCACCAGTGAGTCCGGACAGGGTCGCTACGAGCAGTACTTC	CATSESGQGRYEQYF	TRBV24-1	TRBJ2-7
TGTGCCAGCAGGGGACAGGGGGGCTCCTCACACACTGAAGCTTTCTTT	CASRGQGGSSHTEAFF	TRBV14	TRBJ1-1
TGTGCCAGCAGTGACTATCACGACGTAGGGATTAACGAGACCCAGTACTTC	CASSDYHDVGINETQYF	TRBV6-4	TRBJ2-5
TGTGCCATCAGTGACGCCAACAGGGGGGAGCAGTACTTC	CAISDANRGEQYF	TRBV10-3	TRBJ2-7
TGTGCCACCAGAATGGCGGGAGGTTTTCAGCCCCAGCATTTT	CATRMAGGFQPQHF	TRBV24-1	TRBJ1-5
TGTGCCAGCAGTTACTCGAGGGGACAGGGTCTGGCACAGCCCCAGCATTTT	CASSYSRGQGLAQPQHF	TRBV6-5	TRBJ1-5
TGTGCCAGCAGCTTATATCGGGATTACTGGAGGGATAATGAAAAACTGTTTTTT	CASSLYRDYWRDNEKLFF	TRBV7-3	TRBJ1-4
TGTGCCAGCAGCCAAGATTCCGTAAATGGGATTTACAATGAGCAGTTCTTC	CASSQDSVNGIYNEQFF	TRBV3-1	TRBJ2-1
TGTGCCAGCAGCCGTTCGAGACAGGGTATCGAGCAGTACTTC	CASSRSRQGIEQYF	TRBV7-8	TRBJ2-7
TGCAGTGCTAGAGCGCGGGCCGGGACTAGCGGGGGGAGAAATCGGAAGTACAATGAGCAGTTCTTC	CSARARAGTSGGRNRKYNEQFF	TRBV20-1	TRBJ2-1
TGTGCCAGCAGCAATATAGGGTACGAGCAGTACTTC	CASSNIGYEQYF	TRBV11-2	TRBJ2-7
TGTGCCAGCACCCACAGGGGGTACACTGAAGCTTTCTTT	CASTHRGYTEAFF	TRBV5-4	TRBJ1-1
TGTGCCAGCAGTACATTCCGGGACAGCAGGGGCACTGAAGCTTTCTTT	CASSTFRDSRGTEAFF	TRBV6-5	TRBJ1-1
TGTGCCAGCAGTGAATTCCACGGGACAGGGCGACGTCAGCCCCAGCATTTT	CASSEFHGTGRRQPQHF	TRBV25-1	TRBJ1-5
TGCGCCAGCAACCGGACAGGGGGGAACACTGAAGCTTTCTTT	CASNRTGGNTEAFF	TRBV10-1	TRBJ1-1
TGTGCCAGCAGCTTAGTCTTCCCGACAGGGATCGAGCAGTACTTC	CASSLVFPTGIEQYF	TRBV11-2	TRBJ2-7
TGCAGTGCTAGAGACCTATCCCTGGTATACCGGGACAACACCGGGGAGCTGTTTTTT	CSARDLSLVYRDNTGELFF	TRBV20-1	TRBJ2-2
TGTGCCAGCAGTTACTCGGAGGACAGGGCGGTAATTGAGTGCTACGAGCAGTACTTC	CASSYSEDRAVIECYEQYF	TRBV6-5	TRBJ2-7
TGCGAGTTGCGCCCGACCTATAATTCACCCCTCCACTTT	CELRPTYNSPLHF	TRBV10-2	TRBJ1-6
TGCGCCTCGCCGGGGATACGAGGCTACACCTTC	CASPGIRGYTF	TRBV10-1	TRBJ1-2
TGTGCCAGCAGCCAAGCAGGACTGGCGCGGGCCGAGCAGTACTTC	CASSQAGLARAEQYF	TRBV14	TRBJ2-7
TGTGCCAGCAGCCAACGATTGCAGGGCGGGTCCTACGAGCAGTACTTC	CASSQRLQGGSYEQYF	TRBV14	TRBJ2-7
TGTGCCAGCAGTGACATAGGGGGATATGACACCGGGGAGCTGTTTTTT	CASSDIGGYDTGELFF	TRBV6-4	TRBJ2-2
TGTGCCAGTAGCCGAGGGGAGCATGGGGTAATAAAAGCTTTCTTT	CASSRGEHGVIKAFF	TRBV19	TRBJ1-1
TGTGCCACCGCTATCGGACTGGAGCAGTACTTC	CATAIGLEQYF	TRBV24-1	TRBJ2-7
TGTGCCAGCAGCTTGGGTGGACAGATTAGACCCGAGCAGTACTTC	CASSLGGQIRPEQYF	TRBV5-6	TRBJ2-7
TGTGCCAGCAGCTTAGTACCCCGACTAGCGTCCCGTTACGAGCAGTACTTC	CASSLVPRLASRYEQYF	TRBV11-3	TRBJ2-7
TGTGCCATCAGTGTGGGGGAAACCTACGAGCAGTACTTC	CAISVGETYEQYF	TRBV10-3	TRBJ2-7
TGCAGCGTAAACCCGGGACTAGCTCTTGGAGGCTACAATGAGCAGTTCTTC	CSVNPGLALGGYNEQFF	TRBV29-1	TRBJ2-1
TGTGCCAGTAGGGTGGCTGGAAAGCAGGCGACGGAGACCCAGTACTTC	CASRVAGKQATETQYF	TRBV19	TRBJ2-5
TGCGCCAGCAGGGACGGTAGTAAGTATCAGCCCCAGCATTTT	CASRDGSKYQPQHF	TRBV5-1	TRBJ1-5
TGTGCCAGCAGTGCGGGAGCGATTGAGCAGTTCTTC	CASSAGAIEQFF	TRBV6-5	TRBJ2-1
TGTGCCAGCAGCTTCGGGGGGGGCACTGAAGCTTTCTTT	CASSFGGGTEAFF	TRBV7-9	TRBJ1-1
TGTGCCAGCAGCAATATCGCAGATACGCAGTATTTT	CASSNIADTQYF	TRBV5-6	TRBJ2-3
TGTGCCAGCAGCGCCCCGGGACCTGAAGCTTTCTTT	CASSAPGPEAFF	TRBV9	TRBJ1-1
TGTGCCAGCAGCGAGGGGACAGGGCGGGGCTACACCTTC	CASSEGTGRGYTF	TRBV7-9	TRBJ1-2
TGTGCCAGCAGGCTCCCAGAGGGCACCATATATTTT	CASRLPEGTIYF	TRBV14	TRBJ1-3
TGTGCCAGCAGCCCCAGGACCGGTCCCTACGAGCAGTACTTC	CASSPRTGPYEQYF	TRBV7-3	TRBJ2-7
TGTGCCAGCAGTGCCGGGGGGTCGCTAGATACGCAGTATTTT	CASSAGGSLDTQYF	TRBV6-4	TRBJ2-3
TGTGCCAGCAGCTCCCTCGGTGGTCCACAGGGTGCCCTGAACACTGAAGCTTTCTTT	CASSSLGGPQGALNTEAFF	TRBV5-4	TRBJ1-1
TGTGCCAGCAGTTTAAACTGGCGGTATCAGGCAACTAATGAAAAACTGTTTTTT	CASSLNWRYQATNEKLFF	TRBV12-4	TRBJ1-4
TGTGCCAGCAGTGTAGTAGAACCCGAGCAGTACTTC	CASSVVEPEQYF	TRBV6-4	TRBJ2-7
TGTGCCAGATCACTAGCGGGAGCTAACCAAGAGACCCAGTACTTC	CARSLAGANQETQYF	TRBV19	TRBJ2-5
TGCAGCGGCAGGGGAATATCCACTGAAAAACTGTTTTTT	CSGRGISTEKLFF	TRBV29-1	TRBJ1-4
TGTGCCACTAGCCAGACCTACAGCTACGAGCAGTACTTC	CATSQTYSYEQYF	TRBV7-9	TRBJ2-7
TGCGCCAGCAGGTCCTTAAGGGGGGCAGGGGGGAATGAGCAGTTCTTC	CASRSLRGAGGNEQFF	TRBV10-2	TRBJ2-1
TGTGCCAGCAGGGGGTCACTGAGCAATCAGCCCCAGCATTTT	CASRGSLSNQPQHF	TRBV28	TRBJ1-5
TGTGCCAGCAGCGAAGTCACCGGGACAGGGGCTCGCGGCTACACCTTC	CASSEVTGTGARGYTF	TRBV11-1	TRBJ1-2
TGTGCCACCATTTCCAGGGTCACCGGGGAGCTGTTTTTT	CATISRVTGELFF	TRBV24-1	TRBJ2-2
TGCGCCAGCAGCCGGAGGCTGGTTAACTATGGCTACACCTTC	CASSRRLVNYGYTF	TRBV4-1	TRBJ1-2
TGTGCCTCCAGGGATCTAAGGCAGGAATCGCAGGTTTGGAATGAAAAACTGTTTTTT	CASRDLRQESQVWNEKLFF	TRBV2	TRBJ1-4
TGTGCCAGCAGTTACCCGACAGGGGGAGACTGTAACTATGGCTACACCTTC	CASSYPTGGDCNYGYTF	TRBV6-3	TRBJ1-2
TGTGCCAGCCAAAGGGAGGTGTACAATGAGCAGTTCTTC	CASQREVYNEQFF	TRBV6-5	TRBJ2-1
TGTGCCAGCAGCCGTCTAGTCGTTCCCGGGGAGCTGTTTTTT	CASSRLVVPGELFF	TRBV13	TRBJ2-2
TGCAGTGCTAGCCGTTGGAGGACAGGGGAGACCCCCACCGGGGAGCTGTTTTTT	CSASRWRTGETPTGELFF	TRBV20-1	TRBJ2-2
TGTGCCAGCAGTGACTCGTCCTGGAAAGGGGGCAAGTACGGGGAGCTGTTTTTT	CASSDSSWKGGKYGELFF	TRBV6-4	TRBJ2-2
TGTGCCAGCAGTTACTCGAGCCCGGGGGGCCATGAAAAACTGTTTTTT	CASSYSSPGGHEKLFF	TRBV6-5	TRBJ1-4
TGTGCCTGGGGCTTACAGGGGGGCTTTGGAGAGCAGTTCTTC	CAWGLQGGFGEQFF	TRBV30	TRBJ2-1
TGTGCCAGCAGCTTAGCGGGACTAGCGGGGTACAATGAGCAGTTCTTC	CASSLAGLAGYNEQFF	TRBV11-2	TRBJ2-1
TGCAGTGCTAGAAACTGGGGTGTTAGCACAGATACGCAGTATTTT	CSARNWGVSTDTQYF	TRBV20-1	TRBJ2-3
TGTGCCAGCAAACAGGGACAGGAGACCCAGTACTTC	CASKQGQETQYF	TRBV7-8	TRBJ2-5
TGTGCCAGCAGCAGGACGAAAGGACAGGGGGCCTATGGCTACACCTTC	CASSRTKGQGAYGYTF	TRBV13	TRBJ1-2
TGTGCCATCACCCCGAACGTACAAGAGACCCAGTACTTC	CAITPNVQETQYF	TRBV10-3	TRBJ2-5
TGCAGCGTTGAAGATCTCTTTTCTCCTCAAGAGACCCAGTACTTC	CSVEDLFSPQETQYF	TRBV29-1	TRBJ2-5
TGTGCCAGCAGCGTAATAGGGGGACAACTAGCGGGAGGGCGGACAGATACGCAGTATTTT	CASSVIGGQLAGGRTDTQYF	TRBV9	TRBJ2-3
TGTGCCAGTACTCGTGTCGAATGGGACAGAGATACGCAGTATTTT	CASTRVEWDRDTQYF	TRBV19	TRBJ2-3
TGTGTTCACACATGCGACAGAGCCCGCTTC	CVHTCDRARF	TRBV6-4	TRBJ2-7
TGTGCCAGCAGGGGTCAACCCGAACTAGCGGGAGGGCCCTGGGGCACCGGGGAGCTGTTTTTT	CASRGQPELAGGPWGTGELFF	TRBV28	TRBJ2-2
TGTGCCAGCAGCCATCTGGGCGCCCAAAATGTTTACAATGAGCAGTTCTTC	CASSHLGAQNVYNEQFF	TRBV14	TRBJ2-1
TGCGCCAGCAGCGTAGGGACAGCCTACGAGCAGTACTTC	CASSVGTAYEQYF	TRBV5-1	TRBJ2-7
TGTGCCAGCAGCGGTGGGACAGGGGGCAGACCTCAGCCCCAGCATTTT	CASSGGTGGRPQPQHF	TRBV13	TRBJ1-5
TGTGCCAGCAGATGGAGGATAGGCTACACCTTC	CASRWRIGYTF	TRBV6-2	TRBJ1-2
TGTGCCAGCAGCGTACTTAGCGGAATAGAGCCTGAAAAACTGTTTTTT	CASSVLSGIEPEKLFF	TRBV9	TRBJ1-4
TGCGCCAGCAGCTTGGGGGTGGACGGGAGGGGGAGCTATGGCTACACCTTC	CASSLGVDGRGSYGYTF	TRBV5-1	TRBJ1-2
TGTGCCAGCAGTAATGCCGGGACAGGGGTTTCACCCCTCCACTTT	CASSNAGTGVSPLHF	TRBV27	TRBJ1-6
TGTGCCAGCAGCTCCCGGGACAGGGTGGGCATTCAGTACTTC	CASSSRDRVGIQYF	TRBV11-3	TRBJ2-4
TGTGCCAGATCCCATGCCCCCGCGGGACTAGAGAATGAGCAGTTCTTC	CARSHAPAGLENEQFF	TRBV19	TRBJ2-1
TGTGCCAGCAGTTGTGACGGACTAGCGGGGGGGCCCTCCTACAATGAGCAGTTCTTC	CASSCDGLAGGPSYNEQFF	TRBV6-5	TRBJ2-1
TGTGCCAGCAGTGACTCCAGAAACAGGATCTATAATTCACCCCTCCACTTT	CASSDSRNRIYNSPLHF	TRBV6-4	TRBJ1-6
TGTGCCAGCATCGTTCGGGGATCTTATAGCAATCAGCCCCAGCATTTT	CASIVRGSYSNQPQHF	TRBV7-9	TRBJ1-5
TGTGCCAAGTGGACTCCCACAGATACGCAGTATTTT	CAKWTPTDTQYF	TRBV6-4	TRBJ2-3
TGCATTGACGTCGACGAGCAGTACTTC	CIDVDEQYF	TRBV29-1	TRBJ2-7
TGTGCAATGGGGGCGGCACCCAACTATGGCTACACCTTC	CAMGAAPNYGYTF	TRBV6-2	TRBJ1-2
TGCAGCGTTCCCCAAGGGCGGCCGGGACTAGCGGGAGTTCCGTACAATGAGCAGTTCTTC	CSVPQGRPGLAGVPYNEQFF	TRBV29-1	TRBJ2-1
TGCGCCAGCACTTGGGGGCGCCCGAACACTGAAGCTTTCTTT	CASTWGRPNTEAFF	TRBV4-1	TRBJ1-1
TGTGCCAGCAGCTCGAGCGGGGACGAGCAGTACTTC	CASSSSGDEQYF	TRBV11-2	TRBJ2-7
TGCAGTGCTCCAGATTTAAGGCCCCAGCATTTT	CSAPDLRPQHF	TRBV20-1	TRBJ1-5
TGTGCCAGCAGCTTACGGGGGGCAAGGGTTTTAGTGACCCAGTACTTC	CASSLRGARVLVTQYF	TRBV7-6	TRBJ2-5
TGTGCCAGCAGTCATAATGAAAAACTGTTTTTT	CASSHNEKLFF	TRBV6-5	TRBJ1-4
TGTGCCTGGATCCGAAGGGTCTACGAGCAGTACTTC	CAWIRRVYEQYF	TRBV30	TRBJ2-7
TGTGCCAGCAGCCATCAATGGGTATCCTACGAGCAGTACTTC	CASSHQWVSYEQYF	TRBV11-2	TRBJ2-7
TGTGCCAGTCTTTTGATCCGGATGGACAGCGAAGACAGGTACGAGCAGTACTTC	CASLLIRMDSEDRYEQYF	TRBV19	TRBJ2-7
TGTGCCAGCAGTTCCTGCCCTGGGCAGCTAGATTCACCCCTCCACTTT	CASSSCPGQLDSPLHF	TRBV28	TRBJ1-6
TGTGCCATTCGGGGCGCGTATGAAAAACTGTTTTTT	CAIRGAYEKLFF	TRBV9	TRBJ1-4
TGTGCCAGCACCGAGACCCAGGGAAAGGTGAGCAATCAGCCCCAGCATTTT	CASTETQGKVSNQPQHF	TRBV28	TRBJ1-5
TGCGCCAGCAGCTCCCGCAAACGTCCTAGAAGCAATGAGCAGTTCTTC	CASSSRKRPRSNEQFF	TRBV5-1	TRBJ2-1
TGTGCCAGCAGCGGATGGCCCCGATACGAGCAGTACTTC	CASSGWPRYEQYF	TRBV7-4	TRBJ2-7
TGCGCCAGCAGTGAGCGAAGGCCCCTCCAGAATCAGCCCCAGCATTTT	CASSERRPLQNQPQHF	TRBV10-1	TRBJ1-5
TGTGCCAGCAGAATTTCCGACACGAGGTGTGGGGAGACCCAGTACTTC	CASRISDTRCGETQYF	TRBV2	TRBJ2-5
TGTGCCACCAGTGACCACACTAGCTACGAGCAGTACTTC	CATSDHTSYEQYF	TRBV24-1	TRBJ2-7
TGTGCCACCAGCAGAGGCCCGGGACAGGGGGCTGATGGCTACACCTTC	CATSRGPGQGADGYTF	TRBV15	TRBJ1-2
TGTGCCAGCAGCCACGACGGACTAGCGGGTGACTCCTACGAGCAGTACTTC	CASSHDGLAGDSYEQYF	TRBV11-2	TRBJ2-7
TGTGCCAGCAGCCTTCCGGAAAGGGGGCGAGATACGCAGTATTTT	CASSLPERGRDTQYF	TRBV5-8	TRBJ2-3
TGTGCCAGCAGCTCCCGGGACAGGGACCTTGCCTACGAGCAGTACTTC	CASSSRDRDLAYEQYF	TRBV7-3	TRBJ2-7
TGTGCCAGCAGTCCCCGGGCGGTATACACTGAAGCTTTCTTT	CASSPRAVYTEAFF	TRBV27	TRBJ1-1
TGTGCCTGGAGGTATATACTAGATACGCAGTATTTT	CAWRYILDTQYF	TRBV30	TRBJ2-3
TGTGCCAGCAGTTACTCAGGACAGGGGGGATACAATCAGCCCCAGCATTTT	CASSYSGQGGYNQPQHF	TRBV6-5	TRBJ1-5
TGTGCCAGCAGGGACTATTTTCGGGCCCGTAATTCACCCCTCCACTTT	CASRDYFRARNSPLHF	TRBV6-4	TRBJ1-6
TGCAGTGCACGTAGGAAAGGACCGGGGTCCTACGAGCAGTACTTC	CSARRKGPGSYEQYF	TRBV20-1	TRBJ2-7
TGTGCCAGCAACAGGGCACACGAGCAGTACTTC	CASNRAHEQYF	TRBV27	TRBJ2-7
TGTGCCAGGACAGGGTCCCGACCAACTAATGAAAAACTGTTTTTT	CARTGSRPTNEKLFF	TRBV10-3	TRBJ1-4
TGTGCCAGCAGTTTATGGGAGTTAGGGTCCTACGAGCAGTACTTC	CASSLWELGSYEQYF	TRBV28	TRBJ2-7
TGTGCCAGCAGTTTACTAATGCCCCAGGGCGCCAAGAACACTGAAGCTTTCTTT	CASSLLMPQGAKNTEAFF	TRBV12-4	TRBJ1-1
TGCGCCAGCAGCAGGGGAGGACAGTTGTTCGCCTTC	CASSRGGQLFAF	TRBV5-1	TRBJ1-2
TGTGCCAGCAGTCATTGGTATCGTCCCCAGGGAGGCCACTCCTACAATGAGCAGTTCTTC	CASSHWYRPQGGHSYNEQFF	TRBV6-4	TRBJ2-1
TGTGCCAGCAGCGGGAGTAAGACTGAAGCTTTCTTT	CASSGSKTEAFF	TRBV5-4	TRBJ1-1
TGTGCCAGGAGAACGGGTGATACACCTACAGATACGCAGTATTTT	CARRTGDTPTDTQYF	TRBV6-5	TRBJ2-3
TGCGCCAGCAGCCACTGGAGGGGACAACCAGTGAGGGACGAGCAGTACTTC	CASSHWRGQPVRDEQYF	TRBV4-1	TRBJ2-7
TGCAGTGGGAACCGCAGGGAATTAGATCAGCCCCAGCATTTT	CSGNRRELDQPQHF	TRBV20-1	TRBJ1-5
TGCAGTGCTAGACAGGGCCGACAGGGAGAGAACCACGAGCAGTACTTC	CSARQGRQGENHEQYF	TRBV20-1	TRBJ2-7
TGTGCCAGCAAGAGAGTTGGGATAGGAGAGACCCAGTACTTC	CASKRVGIGETQYF	TRBV6-8	TRBJ2-5
TGTGCCAGCAGTGATATAGGTCGGGGCTATGGCTACACCTTC	CASSDIGRGYGYTF	TRBV2	TRBJ1-2
TGTGCCTGGACTCGGGCGGGCTATGGCTACACCTTC	CAWTRAGYGYTF	TRBV30	TRBJ1-2
TGTGCCAGCAGTCCTGGGTGGACAGACCCCTATGGCTACACCTTC	CASSPGWTDPYGYTF	TRBV6-2	TRBJ1-2
TGTGCCAGCAGCCCCCGACTAGCGGGGCATAGAGTGGGCACAGATACGCAGTATTTT	CASSPRLAGHRVGTDTQYF	TRBV7-2	TRBJ2-3
TGTGCCAGCAGCCCTTCAAATACCGGACAGGTGAACACCGGGGAGCTGTTTTTT	CASSPSNTGQVNTGELFF	TRBV4-2	TRBJ2-2
TGTGCCAGCAGTGGGGTGCAGTACAATGAGCAGTTCTTC	CASSGVQYNEQFF	TRBV6-1	TRBJ2-1
TGTGCCAGCAGTTACTCCCGCTGGAGCAATGAGCAGTTCTTC	CASSYSRWSNEQFF	TRBV6-5	TRBJ2-1
TGTGCCAGCAGCCAAGGGGATTCACCCCTCCACTTT	CASSQGDSPLHF	TRBV14	TRBJ1-6
TGTGCCAGCAGTGATCACAGGGGGGGTCGGCGGTCCTACAATGAGCAGTTCTTC	CASSDHRGGRRSYNEQFF	TRBV2	TRBJ2-1
TGCGCCAGCAGCCAAGAGGGGCTGCATAGCAATCAGCCCCAGCATTTT	CASSQEGLHSNQPQHF	TRBV4-1	TRBJ1-5
TGTGCCAGCAGCCAAGGAGGGGGGGCCCGGCCAGATACGCAGTATTTT	CASSQGGGARPDTQYF	TRBV14	TRBJ2-3
TGTGCTAGCAGCTTACAGGGGGGGCCAGATACGCAGTATTTT	CASSLQGGPDTQYF	TRBV7-7	TRBJ2-3
TGCAGCGTTGGGATTTTTAGCGGACAGAGACTAGCCTACGTGCAGCCCCAGCATTTT	CSVGIFSGQRLAYVQPQHF	TRBV29-1	TRBJ1-5
TGTGCCAGCTTCCCACGGGGACGGGACAGGGGTTGCACAGATACGCAGTATTTT	CASFPRGRDRGCTDTQYF	TRBV9	TRBJ2-3
TGTGGTCGGTTTTGGAACACCGGGGAGCTGTTTTTT	CGRFWNTGELFF	TRBV6-5	TRBJ2-2
TGTGCCATCAGTGACAAACGCCATCGCGCCAAAAACATTCAGTACTTC	CAISDKRHRAKNIQYF	TRBV10-3	TRBJ2-4
TGTGCCAGCAGCTTAGCGCGAGGGTTGACTGAAGCTTTCTTT	CASSLARGLTEAFF	TRBV7-8	TRBJ1-1
TGTGCCAGTAGTGTGGGGGGGCCAAACGGCAATGAGCAGTTCTTC	CASSVGGPNGNEQFF	TRBV19	TRBJ2-1
TGCAGCGTTGAGGCTAAAACCCCCTCTGGAAACACCATATATTTT	CSVEAKTPSGNTIYF	TRBV29-1	TRBJ1-3
TGTGCCAGCAGCGGGAGCGCCTACGAGCAGTACTTC	CASSGSAYEQYF	TRBV13	TRBJ2-7
TGTGCCAGCAGCCCGGGGGGGCACTGGGCGGGCTACGAGCAGTACTTC	CASSPGGHWAGYEQYF	TRBV11-3	TRBJ2-7
TGTGCCAGCAGCCGCCGTAGATGCCCCATTCCGAACACCGGGGAGCTGTTTTTT	CASSRRRCPIPNTGELFF	TRBV13	TRBJ2-2
TGTGCCAGCAGTTTAGAAATGCGGGAGAAAAGCAATCAGCCCCAGCATTTT	CASSLEMREKSNQPQHF	TRBV28	TRBJ1-5
TGTGCCAGCAGTGATAGCTTTCACGACTACGAGCAGTACTTC	CASSDSFHDYEQYF	TRBV6-1	TRBJ2-7
TGTGCCAGCAGCCCCCCTAGCGGGGACTGTTATGAGCAGTTCTTC	CASSPPSGDCYEQFF	TRBV7-2	TRBJ2-1
TGTGCCACCAGTGGGAAGGGGAAAGTAGAGACCCAGTACTTC	CATSGKGKVETQYF	TRBV24-1	TRBJ2-5
TGTGCCAGCAGTTATGGATTTGGGGGGGGGTCCTACGAGCAGTACTTC	CASSYGFGGGSYEQYF	TRBV6-3	TRBJ2-7
TGCGCCAGCAGCTTGCAAGGGGATTCAGATACGCAGTATTTT	CASSLQGDSDTQYF	TRBV5-1	TRBJ2-3
TGCGCCAGCAACGGACTAGCGGGGCAGTACAATGAGCAGTTCTTC	CASNGLAGQYNEQFF	TRBV5-1	TRBJ2-1
TGTGCCAGCAGCTCAAGGACGGCTGGGGCCAACGTCCTGACTTTC	CASSSRTAGANVLTF	TRBV7-9	TRBJ2-6
TGTGCCATTAGGGGGCAGTATTACGAGCAGTACTTC	CAIRGQYYEQYF	TRBV28	TRBJ2-7
TGTGCCAGCAGCGTGAGGACAGGTACAACTGGAAACACCATATATTTT	CASSVRTGTTGNTIYF	TRBV7-3	TRBJ1-3
TGTGCCAGCTCACCACCGCCCGGTCGTCGGCACTATGGCTACACCTTC	CASSPPPGRRHYGYTF	TRBV18	TRBJ1-2
TGTGCCAGCAGCCGGGGGACAGGGAGGCGGGAGCTGTTTTTT	CASSRGTGRRELFF	TRBV11-3	TRBJ2-2
TGTGCCAGCAGTCCAGGTGGGCCCCCCATTGGAGGGATGCTATCAGATACGCAGTATTTT	CASSPGGPPIGGMLSDTQYF	TRBV27	TRBJ2-3
TGTGCCAGCAGCGAGGAGCCCCGAGCAGGGTCTGGGGCCAACGTCCTGACTTTC	CASSEEPRAGSGANVLTF	TRBV11-3	TRBJ2-6
TGTGCCTGGAGTGTACTAGGGTACCAAGAGAACACTGAAGCTTTCTTT	CAWSVLGYQENTEAFF	TRBV30	TRBJ1-1
TGCAGCGTTGAGTCCCTATACATCAGGAAAGTTGCAACTAATGAAAAACTGTTTTTT	CSVESLYIRKVATNEKLFF	TRBV29-1	TRBJ1-4
TGTGCCAGCAGCCCACTAGCGGCCCATGTCCAGAATGAGCAGTTCTTC	CASSPLAAHVQNEQFF	TRBV7-4	TRBJ2-1
TGCAAAGCCCGGCGGGAGATCTACGAGCAGTACTTC	CKARREIYEQYF	TRBV29-1	TRBJ2-7
TGTGCCAGCAGCCTGACTAGCGTGGGTCGAACTTACAATGAGCAGTTCTTC	CASSLTSVGRTYNEQFF	TRBV5-6	TRBJ2-1
TGTGCCAGCAGTGAGGACAGACTTGCCGTAGCCAAAAACATTCAGTACTTC	CASSEDRLAVAKNIQYF	TRBV28	TRBJ2-4
TGTGCCAGCAGCGTATTTGGTGTAGCGGGGCCTCTCTACAATGAGCAGTTCTTC	CASSVFGVAGPLYNEQFF	TRBV9	TRBJ2-1
TGTGCCAGCTCACCACACTTACGATTTAGCAATCAGCCCCAGCATTTT	CASSPHLRFSNQPQHF	TRBV18	TRBJ1-5
TGTGCCAGCAGTTCCTCTTGCGCAGGGGGCGCTGGGAGAGTGTCCTACAATGAGCAGTTCTTC	CASSSSCAGGAGRVSYNEQFF	TRBV28	TRBJ2-1
TGTGCCAGCAGTTACGAACATTACGGGGGCGGCGTGCGAGCCAAAAACATTCAGTACTTC	CASSYEHYGGGVRAKNIQYF	TRBV6-8	TRBJ2-4
TGTGCCAGCAGCTTAGAGCGGGAGTGCACAGATACGCAGTATTTT	CASSLERECTDTQYF	TRBV7-3	TRBJ2-3
TGTGCCAGCAGCTTACCTAGTGGCAATGAGCAGTTCTTC	CASSLPSGNEQFF	TRBV7-8	TRBJ2-1
TGTGCTAGTGGTAAGGGACTAGCAGGACGCTACGAGCAGTACTTC	CASGKGLAGRYEQYF	TRBV12-5	TRBJ2-7
TGTGCCAGCAGTTTATCGGACCGATACAATGAGCAGTTCTTC	CASSLSDRYNEQFF	TRBV28	TRBJ2-1
TGTGCCAGCATCGAGGGAACGTGCACAGATACGCAGTATTTT	CASIEGTCTDTQYF	TRBV7-3	TRBJ2-3
TGCAGTGCAGGTGACAGGGGGAGGAAAAATGAGCAGTTCTTC	CSAGDRGRKNEQFF	TRBV20-1	TRBJ2-1
TGCGCCAGCAGCCAAGGTCGTACTAGCGGGAGCAGAGAGACCCAGTACTTC	CASSQGRTSGSRETQYF	TRBV4-3	TRBJ2-5
TGTGCCAGCAGCGCTCCGTCTTGGGCCCGGATGATCTCTGGGGCCAACGTCCTGACTTTC	CASSAPSWARMISGANVLTF	TRBV9	TRBJ2-6
TGTGCCAGCAGCTGGAGAAGTTCAGTTGGGATGTACTTC	CASSWRSSVGMYF	TRBV11-3	TRBJ2-5
TGTGCCAGCAGCTTACCCCCGGGAGAAAATGTAGAGACCCAGTACTTC	CASSLPPGENVETQYF	TRBV7-9	TRBJ2-5
TGTGCCAGCAGTTACAGACGTGTAGGACCCGAGCAGTACTTC	CASSYRRVGPEQYF	TRBV6-2	TRBJ2-7
TGTGCCATCAGTGACCCCACTGTGGGCTACACAGGCTATAATTCACCCCTCCACTTT	CAISDPTVGYTGYNSPLHF	TRBV10-3	TRBJ1-6
TGTGCCTGGAGTGTACCCCTCAGACAGATTGGATATGGCTACACCTTC	CAWSVPLRQIGYGYTF	TRBV30	TRBJ1-2
TGTGCCAGCAGTGACCGGGACTACCAAGAGACCCAGTACTTC	CASSDRDYQETQYF	TRBV6-4	TRBJ2-5
TGTGCCAGCAGCTCCCAAAACAGGGCCAACACCGGGGAGCTGTTTTTT	CASSSQNRANTGELFF	TRBV13	TRBJ2-2
TGTGCCAGCAGTTGTACCAGGGAAAAGCCCCAGCATTTT	CASSCTREKPQHF	TRBV6-3	TRBJ1-5
TGCAGTGGTCCACGGGAAAATGAAAAACTGTTTTTT	CSGPRENEKLFF	TRBV20-1	TRBJ1-4
TGTGCCAGCAGCTCTAAAGTCCAGGGAGGCAATTATAGCAATCAGCCCCAGCATTTT	CASSSKVQGGNYSNQPQHF	TRBV7-3	TRBJ1-5
TGTGCCAGCAGTGGAGGGACTAATGAAAAACTGTTTTTT	CASSGGTNEKLFF	TRBV6-4	TRBJ1-4
TGTGCCAGCAGAGAAAGGGGGGCCCCCCGGGACTCTGGAAACACCATATATTTT	CASRERGAPRDSGNTIYF	TRBV28	TRBJ1-3
TGTGCCAGCAGAGCAGGGACTGAAGCTTTCTTT	CASRAGTEAFF	TRBV6-4	TRBJ1-1
TGTGCCAGCTATAAGTTAGCGGGGAGATACAATGAGCAGTTCTTC	CASYKLAGRYNEQFF	TRBV28	TRBJ2-1
TGTGCCAGCAGCTTAACCAACAGGGTAAACACCATATATTTT	CASSLTNRVNTIYF	TRBV7-9	TRBJ1-3
TGCGCCAGCAGCTATGCGACTTACAAAGATCCCTTGAACACTGAAGCTTTCTTT	CASSYATYKDPLNTEAFF	TRBV5-1	TRBJ1-1
TGTGCCAGCAGCGTTCAAGCGGTAAGCTACAATGAGCAGTTCTTC	CASSVQAVSYNEQFF	TRBV7-4	TRBJ2-1
TGCAGCGTTGAAGCAGTTCTACTGCATGAGCAGTTCTTC	CSVEAVLLHEQFF	TRBV29-1	TRBJ2-1
TGTGCCACCAGCAGGGGTAGACAGGGGAGCACCGGGGAGCTGTTTTTT	CATSRGRQGSTGELFF	TRBV15	TRBJ2-2
TGTGCCATCAGTGCAGGGCCCCCCTGCGGTGAAGCTTTCTTT	CAISAGPPCGEAFF	TRBV10-3	TRBJ1-1
TGCAGTGCGTACCGGGGGGATCCCCTCCACTTT	CSAYRGDPLHF	TRBV20-1	TRBJ1-6
TGTGCCAGTATTCCGACAGGGAACTCCTACGAGCAGTACTTC	CASIPTGNSYEQYF	TRBV25-1	TRBJ2-7
TGTGCCAGCAGCGGGGATGACAGGGTTTACGAGCAGTACTTC	CASSGDDRVYEQYF	TRBV13	TRBJ2-7
TGCAGCGTTGTAGTCTATGAGCAGTACTTC	CSVVVYEQYF	TRBV29-1	TRBJ2-7
TGTGCCAGCAGCTTAGCCTTTCGTGGAAATCAGCCCCAGCATTTT	CASSLAFRGNQPQHF	TRBV11-2	TRBJ1-5
TGTGCCAGCCCCCCTCGACAGGTTTCCACCTTC	CASPPRQVSTF	TRBV11-3	TRBJ1-2
TGTGCCAGCAGTGGAACACGGGAGTTCTTT	CASSGTREFF	TRBV6-5	TRBJ1-1
TGTGCCAGCTCACCGTTCGGACAAAGTTGGGTGGGACAAGAGACCCAGTACTTC	CASSPFGQSWVGQETQYF	TRBV18	TRBJ2-5
TGTGCCAGCAGCGGAGCGGGAGCAGTTAACTATGGCTACACCTTC	CASSGAGAVNYGYTF	TRBV9	TRBJ1-2
TGTGCCACCAGTGATACGAAGTCCCACGAGCAGTACTTC	CATSDTKSHEQYF	TRBV24-1	TRBJ2-7
TGCGCCAGCAGCCGTCTTCTGAACGCTGAGCAGTTCTTC	CASSRLLNAEQFF	TRBV5-1	TRBJ2-1
TGTCGCGGGAGGGGGTACAAAAACATTCAGTACTTC	CRGRGYKNIQYF	TRBV20-1	TRBJ2-4
TGTGCCACCCTATACGAGCAGTACTTC	CATLYEQYF	TRBV30	TRBJ2-7
TGCGCCAGCAGCCGTAGGGGTCGGGGCTACACCTTC	CASSRRGRGYTF	TRBV4-3	TRBJ1-2
TGTGCCAGCAGCGTCAGACCTCGCTACGAGCAGTACTTC	CASSVRPRYEQYF	TRBV11-2	TRBJ2-7
TGTGCCAGAAGCAGGACAGGGAACTACGAGCAGTACTTC	CARSRTGNYEQYF	TRBV6-4	TRBJ2-7
TGCGCCACGCGGGGCTACGAGCAGTACTTC	CATRGYEQYF	TRBV10-1	TRBJ2-7
TGCGCCAGCAGCCAGTGTGACCAGGGACGTTCCTACAATGAGCAGTTCTTC	CASSQCDQGRSYNEQFF	TRBV4-1	TRBJ2-1
TGTGCCTACCCAGCATCTGGAAACACCATATATTTT	CAYPASGNTIYF	TRBV30	TRBJ1-3
TGTGCCAGCACCCCCCGACTAGGTGATACGCAGTATTTT	CASTPRLGDTQYF	TRBV25-1	TRBJ2-3
TGCGCCAGCAGCTTGAACCAAACCGGGACAGCCTTACATCAGAGGGCCTACGAGCAGTACTTC	CASSLNQTGTALHQRAYEQYF	TRBV5-1	TRBJ2-7
TGTGCCAGCAGTCTCGGCCATGGTCAAGAGACCCAGTACTTC	CASSLGHGQETQYF	TRBV27	TRBJ2-5
TGTGCCAGCAGAGGACCGGGACTAGCGGGAAGGGTAGATGACGAGCAGTACTTC	CASRGPGLAGRVDDEQYF	TRBV6-5	TRBJ2-7
TGCGCCAGCACACGGACAGCATCTAGAAACCGCTCCTATAATTCACCCCTCCACTTT	CASTRTASRNRSYNSPLHF	TRBV10-2	TRBJ1-6
TGTGCCAGCAGGTCCAGGACAGGGGGCACTGAAGCTTTCTTT	CASRSRTGGTEAFF	TRBV6-3	TRBJ1-1
TGTGCCAGCAGTATTCAAGTGGGACAGGGGGAGCAGTACTTC	CASSIQVGQGEQYF	TRBV27	TRBJ2-7
TGTGCCAGCAGCCAGGGGTCTGGGAGACACGGCACTGAAGCTTTCTTT	CASSQGSGRHGTEAFF	TRBV13	TRBJ1-1
TGTGCCAGCAGCTTAGGTGGGATAGCGTCATATCAGCCCCAGCATTTT	CASSLGGIASYQPQHF	TRBV5-6	TRBJ1-5
TGTGCCAGCATTATTTCCCGCGGGAGCTACGAGCAGTACTTC	CASIISRGSYEQYF	TRBV9	TRBJ2-7
TGTGCCAGCAGTTTAGATTCGGGTACGAACACCGGGGAGCTGTTTTTT	CASSLDSGTNTGELFF	TRBV27	TRBJ2-2
TGTGCCAGCTCACCATTGTACCGGGACACCATAACTGGGGCCAACGTCCTGACTTTC	CASSPLYRDTITGANVLTF	TRBV18	TRBJ2-6
TGTGCCAGCCCAGGCTTATCTGATCAGCCCCAGCATTTT	CASPGLSDQPQHF	TRBV12-3	TRBJ1-5
TGTGCCAGCAGTTATTTACCGGGGGCCCGATTCGGCCGTTACGTCTTC	CASSYLPGARFGRYVF	TRBV6-9	TRBJ2-1
TGTGCCAGCGATCAGGAGGGGTTTTACAGCTCCTACAATGAGCAGTTCTTC	CASDQEGFYSSYNEQFF	TRBV19	TRBJ2-1
TGTGCCAGCAGCCAAAGCAGGACAGATAATCAGCCCCAGCATTTT	CASSQSRTDNQPQHF	TRBV13	TRBJ1-5
TGCAGTGCTACAAGCGCGGAGGGAAACACCATATATTTT	CSATSAEGNTIYF	TRBV20-1	TRBJ1-3
TGCAGTGCTAGAGACAGGAGCACTGAAGCTTTCTTT	CSARDRSTEAFF	TRBV20-1	TRBJ1-1
TGTGCCAGCAGTTTAACTTGGTCCGGGCCCTCCTACGAGCAGTACTTC	CASSLTWSGPSYEQYF	TRBV12-3	TRBJ2-7
TGTGCCAGCAGCTACTCAGATGAGACCCAGTACTTC	CASSYSDETQYF	TRBV5-4	TRBJ2-5
TGTGCCAGCAGATCGCGGACATCGGATCAGCCCCAGCATTTT	CASRSRTSDQPQHF	TRBV9	TRBJ1-5
TGCGCCAGCCCGGGGGGCGCTCACGCGAACACCGGGGAGCTGTTTTTT	CASPGGAHANTGELFF	TRBV5-1	TRBJ2-2
TGTGCCAGCAGCTTGGAGGTTTCCTCCAATATGGTTCCCTACGAGCAGTACTTC	CASSLEVSSNMVPYEQYF	TRBV5-6	TRBJ2-7
TGCGCCAGCAGCCAAGTTATCCCTCGACAGGCCTACGAGCAGTACTTC	CASSQVIPRQAYEQYF	TRBV4-3	TRBJ2-7
TGTGCCAGCAGCAATGGACTAGCTAATGAGCAGTTCTTC	CASSNGLANEQFF	TRBV5-4	TRBJ2-1
TGTGCCACGTGGGGGCTCGCCTACGAGCAGTACTTC	CATWGLAYEQYF	TRBV15	TRBJ2-7
TGTGCCATCAGTGAGCCGGGCTTGCTCCAATATGGCTACACCTTC	CAISEPGLLQYGYTF	TRBV10-3	TRBJ1-2
TGTGCCAGCAGGGGGGGGGCAATCTACAATGAGCAGTTCTTC	CASRGGAIYNEQFF	TRBV27	TRBJ2-1
TGTGCCAGCAGTACGGCAGGCTACACCTTC	CASSTAGYTF	TRBV27	TRBJ1-2
TGTGCCAGCAGCGTAGGACAGGGAAAAGGTTCTAACACTGAAGCTTTCTTT	CASSVGQGKGSNTEAFF	TRBV9	TRBJ1-1
TGTGCCAGCAGTGGGTCCGGGACAGGGCCTGGCTACACCTTC	CASSGSGTGPGYTF	TRBV6-1	TRBJ1-2
TGTGCCACCAGTTCCGGGGCGACCTACAATGAGCAGTTCTTC	CATSSGATYNEQFF	TRBV24-1	TRBJ2-1
TGTGCCAGCAGCGGGCCACTAGCGGGAGCGCCGAACACCGGGGAGCTGTTTTTT	CASSGPLAGAPNTGELFF	TRBV9	TRBJ2-2
TGTGCCAGCAGTTCAAGGGGCCGTAATTCACCCCTCCACTTT	CASSSRGRNSPLHF	TRBV6-9	TRBJ1-6
TGTGCCAGCAACCTGGGGGAGAATTCACCCCTCCACTTT	CASNLGENSPLHF	TRBV12-3	TRBJ1-6
TGCGCCAGCAGCTTGGACATACCGATGGCTTTCTTT	CASSLDIPMAFF	TRBV5-1	TRBJ1-1
TGCAGTGCTAGAGATAAACTTCGCACGTCTAGCGGGTTCAACGAGCAGTACTTC	CSARDKLRTSSGFNEQYF	TRBV20-1	TRBJ2-7
TGCGCCAGCAGGACACTACAGGGAGGTAACGGGGGGGGGAGCTCCTACGAGCAGTACTTC	CASRTLQGGNGGGSSYEQYF	TRBV10-1	TRBJ2-7
TGTGCCAGCAGTTACGGCAATGGACAGGCTTTGTTCCGAAAAAACATTCAGTACTTC	CASSYGNGQALFRKNIQYF	TRBV6-5	TRBJ2-4
TGTGCCATCAGTGCAGACGAAGGGAGGACGCAGTATTTT	CAISADEGRTQYF	TRBV10-3	TRBJ2-3
TGCAGCGTTGTCAGCAATCAGCCCCAGCATTTT	CSVVSNQPQHF	TRBV29-1	TRBJ1-5
TGCGCCAGCAGCCAAGAACGGACTAGGGAGTCCTACGAGCAGTACTTC	CASSQERTRESYEQYF	TRBV4-1	TRBJ2-7
TGTGCCAGCAGCCCTCCGGGACTAGCGGGGTTAGAGACCCAGTACTTC	CASSPPGLAGLETQYF	TRBV5-6	TRBJ2-5
TGCAGTGCTACCGAACACTATCATGGCTACACCTTC	CSATEHYHGYTF	TRBV20-1	TRBJ1-2
TGTGCCAGCAGCGGGGTCGAGATGACTAGCGGGTGGGTATACGAGCAGTACTTC	CASSGVEMTSGWVYEQYF	TRBV7-4	TRBJ2-7
TGTGCCAACCCCGATAGGACTAGCGGGGGGAGCACAGATACGCAGTATTTT	CANPDRTSGGSTDTQYF	TRBV6-5	TRBJ2-3
TGTGCCAGTAGTATAGACCGGGACACCGAGACCCAGTACTTC	CASSIDRDTETQYF	TRBV19	TRBJ2-5
TGTGCCAGCAGTGCCAGGGGGGCTGAAGCTTTCTTT	CASSARGAEAFF	TRBV2	TRBJ1-1
TGCGCCAGCAGCTCCCAGTCCCATCAGCCCCAGCATTTT	CASSSQSHQPQHF	TRBV5-1	TRBJ1-5
TGTGCCAGCAGTCCCGGGATCACAAGCTCTGGAAACACCATATATTTT	CASSPGITSSGNTIYF	TRBV11-2	TRBJ1-3
TGTGCCATCAGTCCAGGGACAGCGGCTGTCAATCAGCCCCAGCATTTT	CAISPGTAAVNQPQHF	TRBV10-3	TRBJ1-5
TGTGCCAGCAGCTTGGCCCTGGCGCTGAATCAGCCCCAGCATTTT	CASSLALALNQPQHF	TRBV5-4	TRBJ1-5
TGTGCCAGCAGCTCAAAGCCGCTTGGGGGGCCTAGCCTGGGCACAGATACGCAGTATTTT	CASSSKPLGGPSLGTDTQYF	TRBV7-6	TRBJ2-3
TGTGCCAGCAGTCTGTTAGTGGGAGGTCCGGCCGGGGAGCTGTTTTTT	CASSLLVGGPAGELFF	TRBV6-3	TRBJ2-2
TGTGCCTGGTGGGGGGTTTTAGATACGCAGTATTTT	CAWWGVLDTQYF	TRBV30	TRBJ2-3
TGTGCCAGCTCACCACCGCGCAAGGGGGTTAGGGCTGAAGCTTTCTTT	CASSPPRKGVRAEAFF	TRBV18	TRBJ1-1
TGTCCCCCAGGGCTGACGTTCTACGAGCAGTACTTC	CPPGLTFYEQYF	TRBV27	TRBJ2-7
TGTGCCAGTAGTATAGCCGCCGGGACAGGGAATGAGCAGTTCTTC	CASSIAAGTGNEQFF	TRBV19	TRBJ2-1
TGTGCCAGCTCACAGCGGCGACGCGAGCAGTACTTC	CASSQRRREQYF	TRBV7-3	TRBJ2-7
TGTGCCAGCAGCGGAACGGAGAGGGTATATAGCAATCAGCCCCAGCATTTT	CASSGTERVYSNQPQHF	TRBV6-4	TRBJ1-5
TGCGCCAGCATGATCCACAGTTCCTACGAGCAGTACTTC	CASMIHSSYEQYF	TRBV10-1	TRBJ2-7
TGTGCCAGCAGCTTACCAAAGCCCGTTGGGAGCACAGATACGCAGTATTTT	CASSLPKPVGSTDTQYF	TRBV11-1	TRBJ2-3
TGTGCCAGCAGCGTATTGCGGGGGCGCTATGGCTACACCTTC	CASSVLRGRYGYTF	TRBV6-4	TRBJ1-2
TGTGCCAGCAGCCGGGACAGACCTATCCTTCAGCCCCAGCATTTT	CASSRDRPILQPQHF	TRBV5-6	TRBJ1-5
TGCAGTGCTCGGTATGGGGGCAAAAACCTCACAGATACGCAGTATTTT	CSARYGGKNLTDTQYF	TRBV20-1	TRBJ2-3
TGTGCCAGCAGTTTACACCTAGGACTCAAAGGGAATACGCAGTATTTT	CASSLHLGLKGNTQYF	TRBV27	TRBJ2-3
TGTGCCACCGTTCGGTCCGGGACTGCCTACGAGCAGTACTTC	CATVRSGTAYEQYF	TRBV24-1	TRBJ2-7
TGTGCCAGCAGCCAAGAGCATATCGGAACCAAGAACACCGGGGAGCTGTTTTTT	CASSQEHIGTKNTGELFF	TRBV7-9	TRBJ2-2
TGTGCCAGTACCGGGGTGGGCCCCCAAAGCTCCTACGAGCAGTACTTC	CASTGVGPQSSYEQYF	TRBV19	TRBJ2-7
TGCGCCAGCAGCGGGCGATGCCTACAAGAGACCCAGTACTTC	CASSGRCLQETQYF	TRBV5-1	TRBJ2-5
TGTGCCATCAGTAAGGGACAGGATGAGCAGTACTTC	CAISKGQDEQYF	TRBV10-3	TRBJ2-7
TGTGCCACCCACACCGTGACGGTCACAGATACGCAGTATTTT	CATHTVTVTDTQYF	TRBV24-1	TRBJ2-3
TGTGCCAGCAGTGAATGGGATGGACAAGAGGATAGCAATCAGCCCCAGCATTTT	CASSEWDGQEDSNQPQHF	TRBV6-4	TRBJ1-5
TGTGCCAGCAGCCAAGATAACCGGGACGGGAGGTGCAGCACAGATACGCAGTATTTT	CASSQDNRDGRCSTDTQYF	TRBV14	TRBJ2-3
TGTGCCAGCAGTTCAGGGGGGGAGCCACCCTACGAGCAGTACTTC	CASSSGGEPPYEQYF	TRBV6-6	TRBJ2-7
TGTGCCAGCAGCGGAGTGGCCGGGACAGGGGTAAGGCGGTACTTC	CASSGVAGTGVRRYF	TRBV13	TRBJ2-4
TGCGCCAGCAGCAGTGGGACAGGGGCGGTCTACGAGCAGTACTTC	CASSSGTGAVYEQYF	TRBV5-1	TRBJ2-7
TGTGCCATCAGACAAGTAAAGCAGTCGGATAGCAATCAGCCCCAGCATTTT	CAIRQVKQSDSNQPQHF	TRBV10-3	TRBJ1-5
TGTGCCAGCTGTCCCCCCTTCGTTGGGCGTGCTAGGACAACGAGGACCCTCTACGAGCAGTACTTC	CASCPPFVGRARTTRTLYEQYF	TRBV18	TRBJ2-7
TGTGCCAGTAGTGGAAATCCGGGACTAGCGGGAAACGAGACCCAGTACTTC	CASSGNPGLAGNETQYF	TRBV19	TRBJ2-5
TGTGCCGCCGGGACTAGCGGGAGCGACCGCACCGGGGAGCTGTTTTTT	CAAGTSGSDRTGELFF	TRBV7-2	TRBJ2-2
TGTGCTAGTGGCCCCCCAGGTTCTGCAAATGAGCAGTTCTTC	CASGPPGSANEQFF	TRBV12-5	TRBJ2-1
TGTGCCAGCAGCCCCCCAGGCAGGGAGGACGAGCAGTACTTC	CASSPPGREDEQYF	TRBV9	TRBJ2-7
TGCAGTGCTAGAGAGGGGGTTCACACTGAAGCTTTCTTT	CSAREGVHTEAFF	TRBV20-1	TRBJ1-1
TGCGCCACGTATATCGAAAACTCCTATAATTCACCCCTCCACTTT	CATYIENSYNSPLHF	TRBV10-1	TRBJ1-6
TGTGCCAGCAGCTCTGGGAGAGAGAACACTGAAGCTTTCTTT	CASSSGRENTEAFF	TRBV5-8	TRBJ1-1
TGTGCCAGCAGCACCACGAATCTACCTGTGCGGGAGATTGGGGCTGACGCCACCGGGGAGCTGTTTTTT	CASSTTNLPVREIGADATGELFF	TRBV7-9	TRBJ2-2
TGTGCCAGCAGTGACGTCACAGGGGGCACTGAAGCTTTCTTT	CASSDVTGGTEAFF	TRBV6-4	TRBJ1-1
TGTGCCCCGCGGGCCAGGGACTCCTACAATGAGCAGTTCTTC	CAPRARDSYNEQFF	TRBV30	TRBJ2-1
TGTGCCAGCAGTTACTCGGAAAGCCGGGGACAGGGGGCTACTGTAGGGAACTATGGCTACACCTTC	CASSYSESRGQGATVGNYGYTF	TRBV6-6	TRBJ1-2
TGTGCCAGCAGCTTGCGGCGGGGGGTGCCTGGCTATGGCTACACCTTC	CASSLRRGVPGYGYTF	TRBV7-6	TRBJ1-2
TGTGCCACCAGTGATTGGGACCACTGGTGTACTAGCGGGAGGTGGTACGAGCAGTACTTC	CATSDWDHWCTSGRWYEQYF	TRBV24-1	TRBJ2-7
TGTGCTAGTGGTTTGGATCGGGGACAGGCCGGGAATCAGCCCCAGCATTTT	CASGLDRGQAGNQPQHF	TRBV12-5	TRBJ1-5
TGTGCTAGTGGTTTGTTAGGGGACAGGGTAAAACTGTTTTTT	CASGLLGDRVKLFF	TRBV12-5	TRBJ1-4
TGTGCCAGCAGACCAGACGTGAACACTGAAGCTTTCTTT	CASRPDVNTEAFF	TRBV2	TRBJ1-1
TGTGCCAGCAGTTACGCGGAAGAAAATCAAGAGACCCAGTACTTC	CASSYAEENQETQYF	TRBV6-3	TRBJ2-5
TGTGCCAGTAGTAGCCCTAATCTGGGGGTGGACACTGAAGCTTTCTTT	CASSSPNLGVDTEAFF	TRBV19	TRBJ1-1
TGTGCAGAGGGGGGATACAATGAGCAGTTCTTC	CAEGGYNEQFF	TRBV24-1	TRBJ2-1
TGTGCCGGAATCTTCAACCGGCCGACAGAATTCAATGAAAAACTGTTTTTT	CAGIFNRPTEFNEKLFF	TRBV6-5	TRBJ1-4
TGCAGTGCTAGAGATTCTTTCCAGGGACTATTCTGTCCTGATGGGCAGTACTTC	CSARDSFQGLFCPDGQYF	TRBV20-1	TRBJ2-7
TGTGCCAGCAGCTTAAAGGGCGACAGGCATTCTGGAAACACCATATATTTT	CASSLKGDRHSGNTIYF	TRBV7-7	TRBJ1-3
TGCGCCAGCAGCTTGCTAGCCGACACAGATACGCAGTATTTT	CASSLLADTDTQYF	TRBV5-1	TRBJ2-3
TGTGCCACCAGCAGGGGGGGCCGGGCAGTAGCCAAAAACATTCAGTACTTC	CATSRGGRAVAKNIQYF	TRBV15	TRBJ2-4
TGCGCCAGCAGCCAAGGGTTTAGGGGTTATGAGCAGTTCTTC	CASSQGFRGYEQFF	TRBV4-1	TRBJ2-1
TGTGCCAGCAGTGCCAAGCGGGAGCGACACACTGAAGCTTTCTTT	CASSAKRERHTEAFF	TRBV6-4	TRBJ1-1
TGTGCCAGCAGCGGCCGGGCCCAGCATTTT	CASSGRAQHF	TRBV5-4	TRBJ1-5
TGCAGCAGGCACGGTGGGGTTGGGCCCCCTAACTATGGCTACACCTTC	CSRHGGVGPPNYGYTF	TRBV29-1	TRBJ1-2
TGTGCCAGCAGGACTTTTTCTAGGAAAGAGACCCAGTACTTC	CASRTFSRKETQYF	TRBV6-4	TRBJ2-5
TGTGCCAGCGGGGCAAGCACCGGGGAGCTGTTTTTT	CASGASTGELFF	TRBV6-4	TRBJ2-2
TGTGCCAGCAGTGAAGGTAAGGACAGGGCGGGGTATTCGATAGAAGCTTTCTTT	CASSEGKDRAGYSIEAFF	TRBV6-4	TRBJ1-1
TGTGCCATTAGGTACCCCCTCATTGCTCCCTCCTACGAGCAGTACTTC	CAIRYPLIAPSYEQYF	TRBV13	TRBJ2-7
TGTGCCAGCAGTTGGAGGGTAACTGAAGCTTTCTTT	CASSWRVTEAFF	TRBV11-3	TRBJ1-1
TGTGCCAGCAGCGCGGACAGGGACGAGCAGTACTTC	CASSADRDEQYF	TRBV7-9	TRBJ2-7
TGTGCCAGCAGCCGGGCACCTGGCTACACCTTC	CASSRAPGYTF	TRBV5-4	TRBJ1-2
TGTGCCACCATTAACCTGCAGAGGGGTTACTACGAGCAGTACTTC	CATINLQRGYYEQYF	TRBV24-1	TRBJ2-7
TGTGCCAGCAGCTCCGGTTGGGCCGGGGAGCTGTTTTTT	CASSSGWAGELFF	TRBV7-2	TRBJ2-2
TGTGCCAGCAGCCGGACAGGGATTAGGTGGGGTTACAATGAGCAGTTCTTC	CASSRTGIRWGYNEQFF	TRBV7-3	TRBJ2-1
TGCAGTAGCGCAAACAATGGCTCCTACAATGAGCAGTTCTTC	CSSANNGSYNEQFF	TRBV20-1	TRBJ2-1
TGTGCCAGCAGTTACCCCAAACCGTGGCAAGAGACCCAGTACTTC	CASSYPKPWQETQYF	TRBV6-5	TRBJ2-5
TGTGCCAGCAGCCAAGATCTTCCGTTATTTTCCAATCAGCCCCAGCATTTT	CASSQDLPLFSNQPQHF	TRBV3-1	TRBJ1-5
TGTGCCAGCAGTGAAATGGGACACTGGCCCTCTGGGGCCAACGTCCTGACTTTC	CASSEMGHWPSGANVLTF	TRBV6-1	TRBJ2-6
TGTGCCAGTAGTTATGGGGGCCCTTCACCCCTCCACTTT	CASSYGGPSPLHF	TRBV19	TRBJ1-6
TGTGCCAGCAGCGAAGGACAGGGGGGATTTCCTCTCTCTGGGGCCAACGTCCTGACTTTC	CASSEGQGGFPLSGANVLTF	TRBV11-1	TRBJ2-6
TGTGCCAGCAGCTTTACCAGGTGGGTCTGCGGGGAGCTGTTTTTT	CASSFTRWVCGELFF	TRBV7-3	TRBJ2-2
TGTGCCAGCAGCTTATGGGACAGGGTCGGCTATGGCTACACCTTC	CASSLWDRVGYGYTF	TRBV7-3	TRBJ1-2
TGTGCCAGCAGTGAAGGCCCAGGTGAAGAGACCCAGTACTTC	CASSEGPGEETQYF	TRBV25-1	TRBJ2-5
TGTGCCAGCAGCAGGGACAGAGGCAATCAGCCCCAGCATTTT	CASSRDRGNQPQHF	TRBV7-9	TRBJ1-5
TGTGCCAGCAGTTACTCTCCCCGACAGGGGCGCTTTTCACCCCTCCACTTT	CASSYSPRQGRFSPLHF	TRBV6-5	TRBJ1-6
TGCGCCAGCAGCTTGGCCGACGTCTATCAGCCCCAGCATTTT	CASSLADVYQPQHF	TRBV5-1	TRBJ1-5
TGCAGCGTTGTCCCAGAAACTGGCTACACCTTC	CSVVPETGYTF	TRBV29-1	TRBJ1-2
TGTGCCAGCAGCCCACGGGCCCGGGGCTCTGGGGCCAACGTCCTGACTTTC	CASSPRARGSGANVLTF	TRBV3-1	TRBJ2-6
TGTGCCAGCAGTTACAACCTGCTCGGTCGACAGGGGATTGAAAAACTGTTTTTT	CASSYNLLGRQGIEKLFF	TRBV6-5	TRBJ1-4
TGCAGTGCTAGAGAGATTACCCCTAGGGTGGACAGGTCCCCTCAGCCCCAGCATTTT	CSAREITPRVDRSPQPQHF	TRBV20-1	TRBJ1-5
TGTGCCAGCAGTCATGGACACCGACAGGGGAAAATAGTAGAAAAACTGTTTTTT	CASSHGHRQGKIVEKLFF	TRBV27	TRBJ1-4
TGTGCCAGCAGCCGAGGGTCCAGAGGCTACACCTTC	CASSRGSRGYTF	TRBV13	TRBJ1-2
TGTGCCAGCAGTGAACTAGCGCAAGGCATTCAGTACTTC	CASSELAQGIQYF	TRBV6-4	TRBJ2-4
TGTGCCAGCAGTTACCCCGCAACCCCTAGGAAATCCACAGATACGCAGTATTTT	CASSYPATPRKSTDTQYF	TRBV6-2	TRBJ2-3
TGCGCCAGCACCGCCCACTTCGGGGGGGAGCTGTTTTTT	CASTAHFGGELFF	TRBV5-1	TRBJ2-2
TGTGCCAGCATACCCACCAATCCCAAAGGGACCAAGGGGCAGCCCCAGCATTTT	CASIPTNPKGTKGQPQHF	TRBV25-1	TRBJ1-5
TGTGCCAGCAGCGTACGGGACAGACCCTACGAGCAGTACTTC	CASSVRDRPYEQYF	TRBV13	TRBJ2-7
TGTGCCACCAGCGCAGGGTGTAGCGTCAGTCGGTCTGAAGCTTTCTTT	CATSAGCSVSRSEAFF	TRBV15	TRBJ1-1
TGTGCCAGCAGCCAAGACCAAAAGAACGGGACAGGCCCATGCAATCAGCCCCAGCATTTT	CASSQDQKNGTGPCNQPQHF	TRBV14	TRBJ1-5
TGTGCCACCACAACACCCTGTCACCGGTCCTACGAGCAGTACTTC	CATTTPCHRSYEQYF	TRBV15	TRBJ2-7
TGCGCCAGCAGCCCCCCCCTAACGAGGGGGCTAATAGAAAGGATCGATCAGCCCCAGCATTTT	CASSPPLTRGLIERIDQPQHF	TRBV5-1	TRBJ1-5
TGTGCCAGCAGCTTCTACCGGCCTAAAGGGGGCTACGAGCAGTACTTC	CASSFYRPKGGYEQYF	TRBV7-3	TRBJ2-7
TGTGCCAGCAGTGACCATGTAGGACACGAGCAGTACTTC	CASSDHVGHEQYF	TRBV6-4	TRBJ2-7
TGCAGTGCCCAGATCAGCACTTTGGGAACGACTGAAGCTTTCTTT	CSAQISTLGTTEAFF	TRBV20-1	TRBJ1-1
TGTGCCAGTAGGTTGGTCGAGATAAACTATGGCTACACCTTC	CASRLVEINYGYTF	TRBV19	TRBJ1-2
TGTGCCACCAGTGATGTGCGGGAGACAGGGGGCTATGGCTACACCTTC	CATSDVRETGGYGYTF	TRBV24-1	TRBJ1-2
TGTGCCACCAGTGATTACCTGGTACTAGCGGGAGAGAAAGAGACCCAGTACTTC	CATSDYLVLAGEKETQYF	TRBV24-1	TRBJ2-5
TGTGCCAGCAGCTTGGTTCCGGTGACGGACGTCGGTTCCAACACCGGGGAGCTGTTTTTT	CASSLVPVTDVGSNTGELFF	TRBV5-8	TRBJ2-2
TGTGCTAGTTATTGTACAGGGGGCACTTCACCCCTCCACTTT	CASYCTGGTSPLHF	TRBV12-5	TRBJ1-6
TGTGCCAAAAACAACGCGGCGACCACTGAAGCTTTCTTT	CAKNNAATTEAFF	TRBV12-4	TRBJ1-1
TGTGCCAGCAGGTCCCCTTTAGGCGGGCAAGACCCCTCCTACGAGCAGTACTTC	CASRSPLGGQDPSYEQYF	TRBV2	TRBJ2-7
TGTGCCAGCAGTTTCACAGGGGGAAACACCATATATTTT	CASSFTGGNTIYF	TRBV27	TRBJ1-3
TGTGCCAGCAGCCACCGGGACAGGGTCTTGGCATACCGCTACGAGCAGTACTTC	CASSHRDRVLAYRYEQYF	TRBV5-6	TRBJ2-7
TGTGCCAGCAGAATCGGGACAGGCGCTTTCTTT	CASRIGTGAFF	TRBV6-5	TRBJ1-1
TGTGCCAGCCCACCGGGGGACGAAGGCTTTAACTCTGGAAACACCATATATTTT	CASPPGDEGFNSGNTIYF	TRBV6-4	TRBJ1-3
TGTGCCAGCAGCTTAGGCCACCGACGAACCTACGAGCAGTACTTC	CASSLGHRRTYEQYF	TRBV7-8	TRBJ2-7
TGTGCCGGTCGGGTCAGGGCCCTCGGGGAGCTGTTTTTT	CAGRVRALGELFF	TRBV15	TRBJ2-2
TGTGCCAGCAAGTTTGGAAGGGGGGCCTACTATGACGAGCAGTACTTC	CASKFGRGAYYDEQYF	TRBV25-1	TRBJ2-7
TGTGCCAGCAGTGAAGATCGGATAAGCAATCAGCCCCAGCATTTT	CASSEDRISNQPQHF	TRBV2	TRBJ1-5
TGTGCCAGCAGCACCCAGCTGGAAGAGAATGAGCAGTTCTTC	CASSTQLEENEQFF	TRBV7-9	TRBJ2-1
TGTGCCAGCAGTTCCAACGGCCCCGAATACGACTCCTTTAATGAAAAACTGTTTTTT	CASSSNGPEYDSFNEKLFF	TRBV6-1	TRBJ1-4
TGCAGTGCTAGAACTCCACCGGAAGCTAGTACGCAGTATTTT	CSARTPPEASTQYF	TRBV20-1	TRBJ2-3
TGTGCCTGGCTTGTGGGGACAGGGGGCGCCTTGGGAAGCACAGATACGCAGTATTTT	CAWLVGTGGALGSTDTQYF	TRBV30	TRBJ2-3
TGTGTCTGGCCCGGCGAGGTAGATCCCCAGCATTTT	CVWPGEVDPQHF	TRBV5-6	TRBJ1-5
TGTGCCAGCAGCGGGGATCACAGCGGGGGGCCCAATGAGCAGTTCTTC	CASSGDHSGGPNEQFF	TRBV7-9	TRBJ2-1
TGTGCCATCAGTGAGTCGATATCGGACACTGCTACCAATGGCTACACCTTC	CAISESISDTATNGYTF	TRBV10-3	TRBJ1-2
TGCGACGGGCACTTCTCTGGAAACACCATATATTTT	CDGHFSGNTIYF	TRBV10-2	TRBJ1-3
TGTGCCAGCAGTGATCGGGACTTAGCCCGGGGAAACACTGAAGCTTTCTTT	CASSDRDLARGNTEAFF	TRBV7-3	TRBJ1-1
TGTGCCAGCAGCGGGAGGGGGGGCAAAGAGACCCAGTACTTC	CASSGRGGKETQYF	TRBV9	TRBJ2-5
TGTGCCAGCAGGGGACAATCCCAGGAGACCCAGTACTTC	CASRGQSQETQYF	TRBV3-1	TRBJ2-5
TGTGCCACCAGTGTTAACCCGGCTGGGCGGGTAAACATTCAGTACTTC	CATSVNPAGRVNIQYF	TRBV24-1	TRBJ2-4
TGCAGTGCTACGATTTTGGGACATGGCTACACCTTC	CSATILGHGYTF	TRBV20-1	TRBJ1-2
TGCAGTGCTAGCTTTCTGCGGGGCACAGATACGCAGTATTTT	CSASFLRGTDTQYF	TRBV20-1	TRBJ2-3
TGCGCCAGCAGCTTAGGGCTGACCGCTGGGAGGGTATTGAACACTGAAGCTTTCTTT	CASSLGLTAGRVLNTEAFF	TRBV5-1	TRBJ1-1
TGCAGTGGGCTGACAGGGGACTATGGCTACACCTTC	CSGLTGDYGYTF	TRBV20-1	TRBJ1-2
TGTGCCAGCAACACCTCAAACTCCTACGAGCAGTACTTC	CASNTSNSYEQYF	TRBV5-6	TRBJ2-7
TGTGCCAGCTCCCCGGGCAGGGGGGGTCGTCAAGTGCAAGAGACCCAGTACTTC	CASSPGRGGRQVQETQYF	TRBV6-4	TRBJ2-5
TGTGCCAGCCGGGACGATGCAAACCGGTTCTACGAGCAGTACTTC	CASRDDANRFYEQYF	TRBV6-4	TRBJ2-7
TGTGCCAGCAGTAACATATCGGGACAGGTAACTGAAGCTTTCTTT	CASSNISGQVTEAFF	TRBV12-4	TRBJ1-1
TGTGCCAGCAGTTTCGTCGACAGTCACTACGAGCAGTACTTC	CASSFVDSHYEQYF	TRBV27	TRBJ2-7
TGCGCCAGCAGCTTGGGTCGTTGGACCTACGAGCAGTACTTC	CASSLGRWTYEQYF	TRBV5-1	TRBJ2-7
TGTGCCAGCAGCCCCCCCATGGGAAACACTGAAGCTTTCTTT	CASSPPMGNTEAFF	TRBV13	TRBJ1-1
TGTGCCAGCAGCGGAAGCTCGGGTGGAACCGAACGGACAGGGGCTGAAAAACTGTTTTTT	CASSGSSGGTERTGAEKLFF	TRBV13	TRBJ1-4
TGTGCCAGTAGGGTCCGTAGCGGGATATACAATGAGCAGTTCTTC	CASRVRSGIYNEQFF	TRBV19	TRBJ2-1
TGCAGTGCTAGAGGCCTGGGGGGCCGTGGTAATTCACCCCTCCACTTT	CSARGLGGRGNSPLHF	TRBV20-1	TRBJ1-6
TGTGCCACCAGTGGTGTCCTAAGTTCTTGCCGAGCTAACTATGGCTACACCTTC	CATSGVLSSCRANYGYTF	TRBV24-1	TRBJ1-2
TGTGCCAGCAGTTACGAACAGGGAGGTTACTATGGCTACACCTTC	CASSYEQGGYYGYTF	TRBV28	TRBJ1-2
TGTGCCAGCTCAGTGCCGGACAGGGCCTTGAGCTCCTACGAGCAGTACTTC	CASSVPDRALSSYEQYF	TRBV18	TRBJ2-7
TGCAGCGTCGACGGGACAGCTTCCCTCCACTTT	CSVDGTASLHF	TRBV29-1	TRBJ1-6
TGTGCCAGCAGCGTCTCGACAGGAAGGTCCTATAATTCACCCCTCCACTTT	CASSVSTGRSYNSPLHF	TRBV7-9	TRBJ1-6
TGTGCCAGCAGCGGTTGGGACTTCCGATTTCAGCCCCAGCATTTT	CASSGWDFRFQPQHF	TRBV6-5	TRBJ1-5
TGTGCCAGCAGTAATAAGGGGCTGGCCTTCTCCTACGAGCAGTACTTC	CASSNKGLAFSYEQYF	TRBV27	TRBJ2-7
TGTGCCTGGAGTCTTCGGGACAGAAACAATGAGCAGTTCTTC	CAWSLRDRNNEQFF	TRBV30	TRBJ2-1
TGTGCCAGCAGCGGGGCCAGGGATCTTCGACACACCGGGGAGCTGTTTTTT	CASSGARDLRHTGELFF	TRBV7-3	TRBJ2-2
TGTGCCAGCAGCTTAGGTACGGAGGGCAATTGTCTAGCCAAAAACATTCAGTACTTC	CASSLGTEGNCLAKNIQYF	TRBV11-3	TRBJ2-4
TGTGCCACCAGTGATTTGCCGGGGACAGGGAAAGTTTCCTACGAGCAGTACTTC	CATSDLPGTGKVSYEQYF	TRBV24-1	TRBJ2-7
TGTGCCAGCAGCCGTTCCCCGGGACTTATCGAGACCCAGTACTTC	CASSRSPGLIETQYF	TRBV3-1	TRBJ2-5
TGTGCCAGCAGCGAGGGACATGCTAATTGCTCCTACGAGCAGTACTTC	CASSEGHANCSYEQYF	TRBV5-6	TRBJ2-7
TGCGCCAGCAGCCAAGACGTTAGCAGCACAGATACGCAGTATTTT	CASSQDVSSTDTQYF	TRBV4-1	TRBJ2-3
TGTGCCAGCAGCTTACAGGGAACACCTGATGGCTACACCTTC	CASSLQGTPDGYTF	TRBV28	TRBJ1-2
TGCGCCAGCGGGTGTAGACTAGAGTCCTACAATGAGCAGTTCTTC	CASGCRLESYNEQFF	TRBV10-1	TRBJ2-1
TGTGCCAGCATAATGCCGGGACAGGCGTATGGCTACACCTTC	CASIMPGQAYGYTF	TRBV7-2	TRBJ1-2
TGCAGTGATAGCGGGACAGGGGAGTGGGACAGCCAAGAGACCCAGTACTTC	CSDSGTGEWDSQETQYF	TRBV20-1	TRBJ2-5
TGTGCCAGCAGCACAGGTAGGGGTGATACGCAGTATTTT	CASSTGRGDTQYF	TRBV7-8	TRBJ2-3
TGTGCCAGCAGCGAGGACAGGGCCTCTGATACGCAGTATTTT	CASSEDRASDTQYF	TRBV13	TRBJ2-3
TGTGCTAGTGGTTTGGTAGATGGTCCGATGATAGGTATCATGAACACTGAAGCTTTCTTT	CASGLVDGPMIGIMNTEAFF	TRBV12-5	TRBJ1-1
TGTGCCAGCAGCCCCATCTTGATGACAGGAGCCCCCCCCTATTCCTACGAGCAGTACTTC	CASSPILMTGAPPYSYEQYF	TRBV3-1	TRBJ2-7
TGTGCCAGCAGCTTAGATCAACTATTAGAGACCCAGTACTTC	CASSLDQLLETQYF	TRBV11-2	TRBJ2-5
TGTGCCAGCAGCCATACCTCGCCCTACGAGCAGTACTTC	CASSHTSPYEQYF	TRBV4-2	TRBJ2-7
TGTGCCAGCAGCTTGGAGTACGGGGGCACCGGGGAGCTGTTTTTT	CASSLEYGGTGELFF	TRBV7-3	TRBJ2-2
TGTACGCCCACAGGGCATATCACCGGGGAGCTGTTTTTT	CTPTGHITGELFF	TRBV10-3	TRBJ2-2
TGTGCCAGCAGTTGGGCCCCGCAATACTTACCGGCTGAGCAGTACTTC	CASSWAPQYLPAEQYF	TRBV27	TRBJ2-7
TGTGCCAGCAACCGGAAGACGCGGGAGCGATCCCGAGATACGCAGTATTTT	CASNRKTRERSRDTQYF	TRBV27	TRBJ2-3
TGTGCCAGCGTCGGAAGGGGAGGTACTGAAGCTTTCTTT	CASVGRGGTEAFF	TRBV7-9	TRBJ1-1
TGTGCCAGCAGTTTCGAGGGACACGAGCAGTACTTC	CASSFEGHEQYF	TRBV27	TRBJ2-7
TGTGCCAGCAGCCATGAGACTAGCGGTATCCCCACCGGGGAGCTGTTTTTT	CASSHETSGIPTGELFF	TRBV3-1	TRBJ2-2
TGTGCCAGCAGCGTAGGGGATTTTAACTATGGCTACACCTTC	CASSVGDFNYGYTF	TRBV9	TRBJ1-2
TGTGCCACCAGTGATTTCCACGGGACAGGGCTAGCCAAAAACATTCAGTACTTC	CATSDFHGTGLAKNIQYF	TRBV24-1	TRBJ2-4
TGTGCCAGCAGTGAACTAGTGCCCGGGACGGGGGATAGCTCCTACAATGAGCAGTTCTTC	CASSELVPGTGDSSYNEQFF	TRBV6-4	TRBJ2-1
TGTGCCACCATCCAACCGGGACAGGCCGGGGCTTTCTTT	CATIQPGQAGAFF	TRBV24-1	TRBJ1-1
TGCGCCAGCAGTGGGGACGGGTGCAATCAGCCCCAGCATTTT	CASSGDGCNQPQHF	TRBV10-1	TRBJ1-5
TGTGCCAGGTGCTCGACGACTGAGCAGTACTTC	CARCSTTEQYF	TRBV6-5	TRBJ2-7
TGCGCCAGCAGCCAAGATTTGGGACAGGGTGTCCACACTGAAGCTTTCTTT	CASSQDLGQGVHTEAFF	TRBV4-1	TRBJ1-1
TGCGCCAGCAGCCGGACCTGCGGGAGTAGAATTATGGATACGCAGTATTTT	CASSRTCGSRIMDTQYF	TRBV4-3	TRBJ2-3
TGTGCCAGCAGACCAGACCCCGGGACTAGCGGGAGCCCAGGCTACACCTTC	CASRPDPGTSGSPGYTF	TRBV6-4	TRBJ1-2
TGTGCCAGCAGTTACCCGAGGCGAGGAAGAGTAGATACGCAGTATTTT	CASSYPRRGRVDTQYF	TRBV27	TRBJ2-3
TGCGCCAGCAGTGGGACATGGTACGAGCAGTACTTC	CASSGTWYEQYF	TRBV10-1	TRBJ2-7
TGTGCCAGCAGCGGACAGGGGGCGAGACCGGAGCTGTTTTTT	CASSGQGARPELFF	TRBV4-2	TRBJ2-2
TGTGCCAGCAGTGAGGGACAGGGAGCCTACGAGCAGTACTTC	CASSEGQGAYEQYF	TRBV6-1	TRBJ2-7
TGTGCCAGCAGCTGGCGGAACACGAACACTGAAGCTTTCTTT	CASSWRNTNTEAFF	TRBV5-4	TRBJ1-1
TGTGCCAGCAGATTTGGGGGCGTAGACACCGGGGAGCTGTTTTTT	CASRFGGVDTGELFF	TRBV12-3	TRBJ2-2
TGCGCCAGCAATTGGGTCTTTTTAGATACGCAGTATTTT	CASNWVFLDTQYF	TRBV10-1	TRBJ2-3
TGTGCCACCAGTGATGATCTGAAGGGGGGCTATAGCAATCAGCCCCAGCATTTT	CATSDDLKGGYSNQPQHF	TRBV24-1	TRBJ1-5
TGTGCCAGCAGCCAAGGAATTGGGGGGATCCGAAGGAGCTCTGGGGCCAACGTCCTGACTTTC	CASSQGIGGIRRSSGANVLTF	TRBV4-2	TRBJ2-6
TGTGCCACCATCCCCAGGGACAGCTCCTACGAGCAGTACTTC	CATIPRDSSYEQYF	TRBV5-5	TRBJ2-7
TGCGCCAGCAGCTTGGCCTCGGCAGGGGGGGGCTACACCTTC	CASSLASAGGGYTF	TRBV5-1	TRBJ1-2
TGTGCCAGCAGCTTCGTAACGGAGGGCCGGTACGAGCAGTACTTC	CASSFVTEGRYEQYF	TRBV13	TRBJ2-7
TGTGCCAGCATACAGACTGAAGCTTTCTTT	CASIQTEAFF	TRBV6-4	TRBJ1-1
TGCAGTGCTAGAGAGGGGCGCACTGAAGCTTTCTTT	CSAREGRTEAFF	TRBV20-1	TRBJ1-1
TGTGCCAGCAGGGGGACCGGGACTAGCGGGAGAGTGTCCTGCTACAATGAGCAGTTCTTC	CASRGTGTSGRVSCYNEQFF	TRBV6-4	TRBJ2-1
TGTGCCAGTAGTATCCTGGGGTTGGTGGACAGGGAGGGCAACGTCCTGACTTTC	CASSILGLVDREGNVLTF	TRBV19	TRBJ2-6
TGTGCCAGCAGTGAGGGGGGGATTGACGTGAACACTGAAGCTTTCTTT	CASSEGGIDVNTEAFF	TRBV25-1	TRBJ1-1
TGTGCCAGCAGCTTGAGTCCCGCTTCCACAGATACGCAGTATTTT	CASSLSPASTDTQYF	TRBV5-6	TRBJ2-3
TGCAGTGCTAGAGATAAGGGGAACCACAGCGATTTCTTC	CSARDKGNHSDFF	TRBV20-1	TRBJ2-1
TGTGCCAGCAGAGCCGAGCAGTACTTC	CASRAEQYF	TRBV5-5	TRBJ2-7
TGTGCCAGCAGTGAAGGAAAATCCGGGACAGGGGACACCATATATTTT	CASSEGKSGTGDTIYF	TRBV6-4	TRBJ1-3
TGCAGTGCTAGAGCGCCCCCCTCCAGGGGCTCGGGTACCTACGAGCAGTACTTC	CSARAPPSRGSGTYEQYF	TRBV20-1	TRBJ2-7
TGTGCCAGCAGAAAGGGCCGCACGAACTACGAGCAGTACTTC	CASRKGRTNYEQYF	TRBV27	TRBJ2-7
TGCGCCAGCAGCTCAGTAAAAACCCCAGGGTATGGCTACACCTTC	CASSSVKTPGYGYTF	TRBV5-1	TRBJ1-2
TGTGCCAGCCCAAGGGGAGCTACAGATACGCAGTATTTT	CASPRGATDTQYF	TRBV5-6	TRBJ2-3
TGTGCCATCAGTGCCTCGCAGTCCTACAATGAGCAGTTCTTC	CAISASQSYNEQFF	TRBV10-3	TRBJ2-1
TGCGCCACCCAAAGGAAAGGACAGGGAGATACGCAGTATTTT	CATQRKGQGDTQYF	TRBV10-1	TRBJ2-3
TGCAGTGCTAGAGAGACAGGGGGGGGAAAATTCAAAAACATTCAGTACTTC	CSARETGGGKFKNIQYF	TRBV20-1	TRBJ2-4
TGTGCCAGCAGCTTTCTCAGGGTATCCGACACTGAAGCTTTCTTT	CASSFLRVSDTEAFF	TRBV11-3	TRBJ1-1
TGCAGTGCTGGATCTGGCCGGGCCCCACCCACCATATATTTT	CSAGSGRAPPTIYF	TRBV20-1	TRBJ1-3
TGTGCCAGCAGGTGTGGACAGGGGTATATGGCTTTCTTT	CASRCGQGYMAFF	TRBV2	TRBJ1-1
TGTGCCACCAGCGGCACAGGGGATGGCTACACCTTC	CATSGTGDGYTF	TRBV15	TRBJ1-2
TGTGCCAGCAGCTTGGACGGGGGAGGTCAGCCCCAGCATTTT	CASSLDGGGQPQHF	TRBV5-6	TRBJ1-5
TGTGCCAGCAGCAAGGGGAGTACAATTTCTAACTATGGCTACACCTTC	CASSKGSTISNYGYTF	TRBV7-8	TRBJ1-2
TGTGCCACCAAGGGGACTCGTTCGATAGAGCTAGCTTTCTTT	CATKGTRSIELAFF	TRBV24-1	TRBJ1-1
TGCGCCAGCAGTTCTACCGCAGGGGGCCGGGAGCACTCAGTGAATCAGCCCCAGCATTTT	CASSSTAGGREHSVNQPQHF	TRBV5-1	TRBJ1-5
TGTGCCACCAGCAGAGGAGTCAGAGAGACCCAGTACTTC	CATSRGVRETQYF	TRBV15	TRBJ2-5
TGTGCCAGCAGTGAAAAGCGGGAATTTGGAAACACCATATATTTT	CASSEKREFGNTIYF	TRBV6-4	TRBJ1-3
TGTGCCAGCAGCTTGGCGGGGTATAGGTATGGCTACACCTTC	CASSLAGYRYGYTF	TRBV5-5	TRBJ1-2
TGTGCCAGCAGCTACCCCAGGGGTTACACCTTC	CASSYPRGYTF	TRBV13	TRBJ1-2
TGTGCCAGCAGTGGGGAAGAGGTCGTCCTGACTTTC	CASSGEEVVLTF	TRBV6-8	TRBJ2-6
TGTGCCACCAAGACGGGGGACTACGAGCAGTACTTC	CATKTGDYEQYF	TRBV24-1	TRBJ2-7
TGTGCCAGCAGGGAACAGACTAATGAAAAACTGTTTTTT	CASREQTNEKLFF	TRBV6-1	TRBJ1-4
TGTGCCAGTAGTATACTAGCCAAAGTTAGGGAGGCCTACAATGAGCAGTTCTTC	CASSILAKVREAYNEQFF	TRBV19	TRBJ2-1
TGCAGCGTTCTGGGGGCCTCCTACGAGCAGTACTTC	CSVLGASYEQYF	TRBV29-1	TRBJ2-7
TGCAGCGGAGGGGGGGCGGGAGTTAGCACAGATACGCAGTATTTT	CSGGGAGVSTDTQYF	TRBV29-1	TRBJ2-3
TGTGCCAGCAGTTTAACCCGGGGCTTCACAGATACGCAGTATTTT	CASSLTRGFTDTQYF	TRBV12-4	TRBJ2-3
TGCGCCAGCAGCCAAGAAGGGACAGGGGGCCGGAACACTGAAGCTTTCTTT	CASSQEGTGGRNTEAFF	TRBV4-1	TRBJ1-1
TGTGCCAGCAGCTTAGCCCATGAACTCCGGGACAGACCCCAAGAGACCCAGTACTTC	CASSLAHELRDRPQETQYF	TRBV7-9	TRBJ2-5
TGTGCCAGCAGTACCATAGGGGGACCGGGGGCTAATGAAAAACTGTTTTTT	CASSTIGGPGANEKLFF	TRBV2	TRBJ1-4
TGTGCCAGCAGTGCCAGCGGGAAAAGCGGGGAGCTGTTTTTT	CASSASGKSGELFF	TRBV6-4	TRBJ2-2
TGTGCCAGCAGCTTAGCCACGGGAAACGAGCAGTACTTC	CASSLATGNEQYF	TRBV7-2	TRBJ2-7
TGTGCCAGCAGCGTACCTACCGGGACTAGCGGGTACTCCTACAATGAGCAGTTCTTC	CASSVPTGTSGYSYNEQFF	TRBV7-3	TRBJ2-1
TGTGCCAGTAGTATCTCCGGGGTGTTCTCTGGAAACACCATATATTTT	CASSISGVFSGNTIYF	TRBV19	TRBJ1-3
TGTGCCAGCAGTTTGGGCCCTTACCTCAAGGGGGGAGGGGGACAGCCCCAGCATTTT	CASSLGPYLKGGGGQPQHF	TRBV27	TRBJ1-5
TGTGCCAGCAGCTTAATGGGACCCGGGGGTTCGCCTGAAGCTTTCTTT	CASSLMGPGGSPEAFF	TRBV7-3	TRBJ1-1
TGTGCCAGCAACCGGAGGTCCACCCGCAATCAGCCCCAGCATTTT	CASNRRSTRNQPQHF	TRBV27	TRBJ1-5
TGTGCCAGCAGCTTTATCCACATGGCCGGGACAAGGTCTGGAAACACCATATATTTT	CASSFIHMAGTRSGNTIYF	TRBV7-3	TRBJ1-3
TGCAGCGTTGGGATCAGGGGGCGGAAGCTCAATGAAGCTTTCTTT	CSVGIRGRKLNEAFF	TRBV29-1	TRBJ1-1
TGTGCCAGCAGCAGGCCGCAAGCAGGGGCCTACGAGCAGTACTTC	CASSRPQAGAYEQYF	TRBV5-4	TRBJ2-7
TGCGGTGGCAGGGGGCAGTTAGTGAATTCACCCCTCCACTTT	CGGRGQLVNSPLHF	TRBV20-1	TRBJ1-6
TGCAGTGCTAGGGGGAAGGCGCAGGTGGGCGTCTGGTGCACAGATACGCAGTATTTT	CSARGKAQVGVWCTDTQYF	TRBV20-1	TRBJ2-3
TGCGCCAGCAGCATCCCCGGGGGGGGCCATCGATACAATGAGCAGTTCTTC	CASSIPGGGHRYNEQFF	TRBV5-1	TRBJ2-1
TGTGCCAGCAGTGCAGACAGGGTTTCTGAAGCTTTCTTT	CASSADRVSEAFF	TRBV5-6	TRBJ1-1
TGTGCCATCCCGACCGGGACAGATGGGTACTATGGCTACACCTTC	CAIPTGTDGYYGYTF	TRBV10-3	TRBJ1-2
TGTGCCAGCAGCCTAGGAGATGGCTACACCTTC	CASSLGDGYTF	TRBV13	TRBJ1-2
TGCAGACGCCAGGTACATCTGATGGCGAACACCGGGGAGCTGTTTTTT	CRRQVHLMANTGELFF	TRBV20-1	TRBJ2-2
TGTGCCAGCAGTTGGTTTATTAACGTGACAGGGGAAAAACTGTTTTTT	CASSWFINVTGEKLFF	TRBV27	TRBJ1-4
TGTGCCAGCAGAACGAGAGACGAGCAGTACTTC	CASRTRDEQYF	TRBV5-6	TRBJ2-7
TGTGCCAGCAGCACGGGGGGATCCTGGGACAACTCTGGAAACACCATATATTTT	CASSTGGSWDNSGNTIYF	TRBV11-2	TRBJ1-3
TGTGCCAGCAGAGCACGCGGGAGTACCGGGGAGCTGTTTTTT	CASRARGSTGELFF	TRBV27	TRBJ2-2
TGTGCCAGTAGTAGTCGGCTTAAGGATACGCAGTATTTT	CASSSRLKDTQYF	TRBV19	TRBJ2-3
TGTGCCAGCAGTTATGCAGACAGCGCGACCCAGTACTTC	CASSYADSATQYF	TRBV6-2	TRBJ2-5
TGTGCCAGCAGTGCTGCACAGGGAAGCTTACCTCAGCCCCAGCATTTT	CASSAAQGSLPQPQHF	TRBV6-4	TRBJ1-5
TGTGCCAGCAGCCCATCCGGGACTGGATACGAGCAGTACTTC	CASSPSGTGYEQYF	TRBV3-1	TRBJ2-7
TGCAGTGCTAGCAGACTAGCGGGGGAAACCTACGAGCAGTACTTC	CSASRLAGETYEQYF	TRBV20-1	TRBJ2-7
TGCAGTGCTAGAACACGGGGACAGGACACCTTC	CSARTRGQDTF	TRBV20-1	TRBJ1-2
TGTGCCACCAGTGAAACAGGGGGCAGCGCAGATACGCAGTATTTT	CATSETGGSADTQYF	TRBV24-1	TRBJ2-3
TGTGCCAGCAGACAGCGGGACAGGGGGCAGGCGTACGAGCAGTACTTC	CASRQRDRGQAYEQYF	TRBV6-5	TRBJ2-7
TGTGCCAGCAGCTCACCCCAGAGGTATGAGCAGTTCTTC	CASSSPQRYEQFF	TRBV7-9	TRBJ2-1
TGTGCCAGCAGCCAACCCGGTCCTGGGGGAGGGACTGAAGCTTTCTTT	CASSQPGPGGGTEAFF	TRBV11-3	TRBJ1-1
TGTGCCAGCCCGGACAGGGTGAGGCTCCTTGAGCAGTTCTTC	CASPDRVRLLEQFF	TRBV7-6	TRBJ2-1
TGTGCCAGCGAGGACTTACTATTCTTC	CASEDLLFF	TRBV28	TRBJ2-1
TGTGCCAGCAGGAATCTTGGGGGCTTAACGGGCAATCAGCCCCAGCATTTT	CASRNLGGLTGNQPQHF	TRBV6-5	TRBJ1-5
TGTGCCAGCAGCCATATTCTAAGGAACTCTGTGGGCTACGAGCAGTACTTC	CASSHILRNSVGYEQYF	TRBV7-4	TRBJ2-7
TGTGCCAGCAGCCTCGTGGACGTTCGATCAGCCAAAAACATTCAGTACTTC	CASSLVDVRSAKNIQYF	TRBV11-2	TRBJ2-4
TGTGCCAGCAGCTGGACTAGCGGGGGGGCCGGCACAGATACGCAGTATTTT	CASSWTSGGAGTDTQYF	TRBV5-8	TRBJ2-3
TGCGCCAGCAGTCCGCGGGGCAATCAGCCCCAGCATTTT	CASSPRGNQPQHF	TRBV10-1	TRBJ1-5
TGCAGTGCTTCCCGCCGGGACAGGGGGGAGCAGTACTTC	CSASRRDRGEQYF	TRBV20-1	TRBJ2-7
TGTGCCAGCAGGGGGGACAGCGTTCTGACCTGCTACGAGCAGTACTTC	CASRGDSVLTCYEQYF	TRBV7-9	TRBJ2-7
TGTGCCAGCAGTAGAGTCTCTCATGAGCAGTTCTTC	CASSRVSHEQFF	TRBV27	TRBJ2-1
TGCAGCGTCAGAGCACAGGGATACAACGTCCTGACTTTC	CSVRAQGYNVLTF	TRBV29-1	TRBJ2-6
TGTGCCATCAACGGCTCGGGACAGGGCTACACTGAAGCTTTCTTT	CAINGSGQGYTEAFF	TRBV10-3	TRBJ1-1
TGCAGTGCTAGAAATACCCAGGGGGAGATGAACACTGAAGCTTTCTTT	CSARNTQGEMNTEAFF	TRBV20-1	TRBJ1-1
TGCGCCAGCAGTGAGACTGGAAACACCATATATTTT	CASSETGNTIYF	TRBV10-2	TRBJ1-3
TGTGCCAGCACTTGGGGGTATGGCTACACCTTC	CASTWGYGYTF	TRBV7-2	TRBJ1-2
TGTGCCAAGCAGCCCTATAGCAATCAGCCCCAGCATTTT	CAKQPYSNQPQHF	TRBV27	TRBJ1-5
TGCAGTGCATCAGAGCGGGATCTAGTTGAGACCCAGTACTTC	CSASERDLVETQYF	TRBV20-1	TRBJ2-5
TGTGCCAGCAGTTTATGGTCCTTGTGGCTCGGTGGCTACACCTTC	CASSLWSLWLGGYTF	TRBV28	TRBJ1-2
TGTGCCGGTATAGGCTGGACAGGCACTGAAGCTTTCTTT	CAGIGWTGTEAFF	TRBV6-3	TRBJ1-1
TGTGCCTGGTGGGGCCAGTATTTTAGGGGGGCGGAAAACACCATATATTTT	CAWWGQYFRGAENTIYF	TRBV30	TRBJ1-3
TGTGCCAGCAGTAGACAGGGGTTAGCCAAAAACATTCAGTACTTC	CASSRQGLAKNIQYF	TRBV2	TRBJ2-4
TGTGCCACTCGGGGCGCTACAGATACGCAGTATTTT	CATRGATDTQYF	TRBV2	TRBJ2-3
TGTGCCAGCAGCAGGGATGGTAGTGAAGCTTTCTTT	CASSRDGSEAFF	TRBV7-3	TRBJ1-1
TGTGCCAGCAGCTCTTCGCGGGAGCGGACAACAAAGCCCGGGGAGCTGTTTTTT	CASSSSRERTTKPGELFF	TRBV13	TRBJ2-2
TGTGCCAGCAGTCCCCACAAGACCCAGTACTTC	CASSPHKTQYF	TRBV27	TRBJ2-5
TGTGCCAGCAGTTACCACCGGAGGGATAGAGGAAACACCATATATTTT	CASSYHRRDRGNTIYF	TRBV6-5	TRBJ1-3
TGTGCCATCAGTCCCCGGGACAGGGTCTGTCTCCACACAGATACGCAGTATTTT	CAISPRDRVCLHTDTQYF	TRBV10-3	TRBJ2-3
TGCGCCAGCAGCACAATTTCTAGGGACAGACGGTATTCTGAAAAACTGTTTTTT	CASSTISRDRRYSEKLFF	TRBV5-1	TRBJ1-4
TGTGCCAGCAGCATCAGGATGGGGCGCTACGAGCAGTACTTC	CASSIRMGRYEQYF	TRBV11-2	TRBJ2-7
TGCGCCAGCAGCCTTACCTCCTACGAGCAGTACTTC	CASSLTSYEQYF	TRBV4-3	TRBJ2-7
TGTGCCAGCAGCTTACAACCAACCGGGACGAAGACTCAGCCCCAGCATTTT	CASSLQPTGTKTQPQHF	TRBV11-3	TRBJ1-5
TGTGCCAGCAGCCTGTTATCAGGGCCCCCTAGCACAGATACGCAGTATTTT	CASSLLSGPPSTDTQYF	TRBV14	TRBJ2-3
TGTGCCAGCAGCTGCAGTCCTGGAACACCCGCCCGATGCAATCAGCCCCAGCATTTT	CASSCSPGTPARCNQPQHF	TRBV5-6	TRBJ1-5
TGTGCCAGTAGTCTCGGACAGGGGAGGCAGTACTTC	CASSLGQGRQYF	TRBV19	TRBJ2-7
TGTGCCTGGAGTCGGCGAGTGGAGAGCACAGATACGCAGTATTTT	CAWSRRVESTDTQYF	TRBV30	TRBJ2-3
TGTGCCAGCAGCGTAGACCGGGCACATAGTTCCAATGAAAAACTGTTTTTT	CASSVDRAHSSNEKLFF	TRBV9	TRBJ1-4
TGTGCCAAGGGGAACTCTGGAAACACCATATATTTT	CAKGNSGNTIYF	TRBV6-5	TRBJ1-3
TGCGCCAGCAGCTCCTGCCCGGGACAGGGCCTCGAAGATAGGTGGACGTGCAATCAGCCCCAGCATTTT	CASSSCPGQGLEDRWTCNQPQHF	TRBV5-1	TRBJ1-5
TGTGCCAGCAGGGTTTTACCACAGGGGGGGGATAAGTCACCCCTCCACTTT	CASRVLPQGGDKSPLHF	TRBV6-3	TRBJ1-6
TGTGCCAGCAGTTCCGCCCCAGGGGCCGACGGCAATCAGCCCCAGCATTTT	CASSSAPGADGNQPQHF	TRBV6-1	TRBJ1-5
TGTGCCAGCACTGGACAGGAGTGCCTCACTGAAGCTTTCTTT	CASTGQECLTEAFF	TRBV6-1	TRBJ1-1
TGTGCCAGCAGTTTGTCCGGGGGCGAACTAGCCAAAAACATTCAGTACTTC	CASSLSGGELAKNIQYF	TRBV28	TRBJ2-4
TGTGCCAGCAGTGTGGAGGGGACAGGGTACACCGGGGAGCTGTTTTTT	CASSVEGTGYTGELFF	TRBV6-3	TRBJ2-2
TGTGCCAGCAGCCAAGAGCGACATGGGACTAAGGAGGACCACTTC	CASSQERHGTKEDHF	TRBV14	TRBJ2-5
TGTGCCAGCAGCCCCTCCGCAGAGGATAGCAATCAGCCCCAGCATTTT	CASSPSAEDSNQPQHF	TRBV27	TRBJ1-5
TGTGCCAGCAGTTACTCGCGGGGGCGGAACACTGAAGCTTTCTTT	CASSYSRGRNTEAFF	TRBV6-6	TRBJ1-1
TGTGCCAGTAGTATAGAGAGGGGGGAGACCCAGTACTTC	CASSIERGETQYF	TRBV19	TRBJ2-5
TGTGCCAGCAAACCTAGCGGGGGAACATCCTACAATGAGCAGTTCTTC	CASKPSGGTSYNEQFF	TRBV27	TRBJ2-1
TGTGCCATCAGGAAGCGGAACACTGAAGCTTTCTTT	CAIRKRNTEAFF	TRBV10-3	TRBJ1-1
TGCACCCCGGACAGTGCGAACTTTGATGGCTACACCTTC	CTPDSANFDGYTF	TRBV20-1	TRBJ1-2
TGTGCCAGCAGTGAAGGGACATGGGGGCGATGGAACACTGAAGCTTTCTTT	CASSEGTWGRWNTEAFF	TRBV6-1	TRBJ1-1
TGTGCCAGCTCTACAGAGTTGCGTCAGCCCCAGCATTTT	CASSTELRQPQHF	TRBV18	TRBJ1-5
TGTGCCAGCAGTCGACGGGCTCGATTTAGAGGGTACGAGCAGTACTTC	CASSRRARFRGYEQYF	TRBV28	TRBJ2-7
TGTGCCAGCAGCGTAGCCGGGTCGCACATGGGGGCTAATGAAAAACTGTTTTTT	CASSVAGSHMGANEKLFF	TRBV9	TRBJ1-4
TGCGCCAGCAGCGAGCACAGGGACATGGACACTGAAGCTTTCTTT	CASSEHRDMDTEAFF	TRBV5-1	TRBJ1-1
TGTGCCAGCAGCTTACCCTGTCAGGCCCATCAGCCCCAGCATTTT	CASSLPCQAHQPQHF	TRBV5-4	TRBJ1-5
TGTGCCAGCAGCCCACAACCCCGGGGCCAGGCTATATATCAGCCCCAGCATTTT	CASSPQPRGQAIYQPQHF	TRBV3-1	TRBJ1-5
TGTGCCAGCAGCCCGGGACACAATGAGCAGTTCTTC	CASSPGHNEQFF	TRBV6-5	TRBJ2-1
TGTGCCAGCAGTTGGGTGGGGGACAATGAGCAGTTCTTC	CASSWVGDNEQFF	TRBV6-5	TRBJ2-1
TGTGCCAGCATCATGAGACAGGGGTCCAGACGGAGGGGTCAGCCCCAGCATTTT	CASIMRQGSRRRGQPQHF	TRBV7-9	TRBJ1-5
TGCAGTGCTAGTTGGGGGATAACCGACGAGCAGTACTTC	CSASWGITDEQYF	TRBV20-1	TRBJ2-7
TGTGCCAGCAGCCAACTCCCCCGGGATGGCTACACCTTC	CASSQLPRDGYTF	TRBV3-1	TRBJ1-2
TGTGCCAGCAGTCCCGGGACAGGGTTGAACAATCAGCCCCAGCATTTT	CASSPGTGLNNQPQHF	TRBV6-8	TRBJ1-5
TGTGCTCCGTCAACCGGGACTAGCCCGGAAGATACGCAGTATTTT	CAPSTGTSPEDTQYF	TRBV12-5	TRBJ2-3
TGTGCCAGCAGCGTCGGACAATCTGGAAACACCATATATTTT	CASSVGQSGNTIYF	TRBV7-9	TRBJ1-3
TGTGCCAGCAGCACCGACACGGTGGATCGGAACACTGAAGCTTTCTTT	CASSTDTVDRNTEAFF	TRBV13	TRBJ1-1
TGTGCCAGCACGTTGCGGCCCTTTACCCGCTACGAGCAGTACTTC	CASTLRPFTRYEQYF	TRBV27	TRBJ2-7
TGTGCCAGCAGTGAACACTCTACTTATGGCTACACCTTC	CASSEHSTYGYTF	TRBV6-1	TRBJ1-2
TGTGCCAGCAGCCAAGCTTCGGGGGGCGGGCGCAATGAGCAGTTCTTC	CASSQASGGGRNEQFF	TRBV4-2	TRBJ2-1
TGTGCCAGTAGTATAATAGGGGGAAACACCGGGGAGCTGTTTTTT	CASSIIGGNTGELFF	TRBV19	TRBJ2-2
TGCAGTGCTAGAGGAACGACTAGGGATGAGCAGTTCTTC	CSARGTTRDEQFF	TRBV20-1	TRBJ2-1
TGTGCCAGCAGCGGTCCCCCCAGGGGGCCCGCTAATGAAAAACTGTTTTTT	CASSGPPRGPANEKLFF	TRBV9	TRBJ1-4
TGTGCCAGCAGCTGCGTGCCGACAGGGACAGATACGCAGTATTTT	CASSCVPTGTDTQYF	TRBV11-3	TRBJ2-3
TGTGCCAGCAGCCCGGCGGGAGCTACCCTAGTTGAAGCTTTCTTT	CASSPAGATLVEAFF	TRBV6-1	TRBJ1-1
TGTGCCAGCAGCGAACCGCTAGATGAGCAGTTCTTC	CASSEPLDEQFF	TRBV9	TRBJ2-1
TGCGCCAGCAGCCAAGACCTCAATCAGCCCCAGCATTTT	CASSQDLNQPQHF	TRBV4-3	TRBJ1-5
TGTGCCAGTAGGGTGCAGCACTCTAGCACAGATACGCAGTATTTT	CASRVQHSSTDTQYF	TRBV19	TRBJ2-3
TGTGCCACCAGTGGTATGACCCCCCGATCGGAATTCTGCCCTCGCTCTGGAAACACCATATATTTT	CATSGMTPRSEFCPRSGNTIYF	TRBV24-1	TRBJ1-3
TGCAGTGCTAGGGATATTCAAAGGGGGACTGGAGACAATGAGCAGTTCTTC	CSARDIQRGTGDNEQFF	TRBV20-1	TRBJ2-1
TGTGCCAGCAACGGACAGCTGTCTGGAAACACCATATATTTT	CASNGQLSGNTIYF	TRBV10-3	TRBJ1-3
TGTGCCAGCAGTGAACTAGGACAGGCGAGGGTGAAATCCTACGAGCAGTACTTC	CASSELGQARVKSYEQYF	TRBV6-4	TRBJ2-7
TGTGCCAGCAGCGGGGACTACGGGGACACAGATACGCAGTATTTT	CASSGDYGDTDTQYF	TRBV7-6	TRBJ2-3
TGTGCTAGTCAAAACACTGAAGCTTTCTTT	CASQNTEAFF	TRBV12-5	TRBJ1-1
TGTGCCAGCAGCGCCCGTGGACTAGCGGTCGACAATGAGCAGTTCTTC	CASSARGLAVDNEQFF	TRBV3-1	TRBJ2-1
TGTGCCAGCAGCTGGGACAGGGGGATAAAGGGATACACTGAAGCTTTCTTT	CASSWDRGIKGYTEAFF	TRBV7-8	TRBJ1-1
TGTGCCAGCTCACCACGCGGGACAGTGGCAGATACGCAGTATTTT	CASSPRGTVADTQYF	TRBV18	TRBJ2-3
TGTGCCAGCAGCGTGAGGGACAGGGACACTGAAGCTTTCTTT	CASSVRDRDTEAFF	TRBV7-9	TRBJ1-1
TGTGAGAAAGGTATGCAAGAGACCCAGTACTTC	CEKGMQETQYF	TRBV25-1	TRBJ2-5
TGTGCCAGCAGCCAAGGGCGTGGCTCCTACGAGCAGTACTTC	CASSQGRGSYEQYF	TRBV3-1	TRBJ2-7
TGTGCCAGCAGTGACTCAGCGAACGAGCAGTACTTC	CASSDSANEQYF	TRBV27	TRBJ2-7
TGTGCCAGCTCACCACCCCATTGTACGGACAGGTTCACAGATACGCAGTATTTT	CASSPPHCTDRFTDTQYF	TRBV18	TRBJ2-3
TGTGCCAGCAGTGACAGTACGGCACGGACTTACGAGCAGTACTTC	CASSDSTARTYEQYF	TRBV6-4	TRBJ2-7
TGTGCGAACTACAGGGAAAAGTACGAGCAGTACTTC	CANYREKYEQYF	TRBV6-2	TRBJ2-7
TGTGCCAGCAGCAGAAGGGACAACTTCCATCAGCCCCAGCATTTT	CASSRRDNFHQPQHF	TRBV7-2	TRBJ1-5
TGTGCCAGCAGTGGGGGGGACGTTGAAGCTTTCTTT	CASSGGDVEAFF	TRBV25-1	TRBJ1-1
TGTGCCAGCAGTATAGGCTCCGCGGGTAACTATGGCTACACCTTC	CASSIGSAGNYGYTF	TRBV27	TRBJ1-2
TGTGCCAGCAGTAGGGAACCCTTACAGGCGGAAAAACTGTTTTTT	CASSREPLQAEKLFF	TRBV25-1	TRBJ1-4
TGTGCCAGCAGTAACTATGAGCAGTTCTTC	CASSNYEQFF	TRBV12-4	TRBJ2-1
TGTGCCCTCGGGGAAACCAAAAACATTCAGTACTTC	CALGETKNIQYF	TRBV6-1	TRBJ2-4
TGTGCCAGCAGTTACTGTGGGACAGGGCAGCCCCAGCATTTT	CASSYCGTGQPQHF	TRBV7-9	TRBJ1-5
TGTGCCAGCAGGGGACAGGGGGGTGAACTGTTTTTT	CASRGQGGELFF	TRBV27	TRBJ1-4
TGTGCCAGCAGCGGGAAAGACAGGGCCACGATTAGCTCCTACGAGCAGTACTTC	CASSGKDRATISSYEQYF	TRBV9	TRBJ2-7
TGTGCTAGTGGTAAGGACAGGGGGGGCACCGGGGAGCTGTTTTTT	CASGKDRGGTGELFF	TRBV12-5	TRBJ2-2
TGTGCCATAACTGGGCAGGTAGAGACCCAGTACTTC	CAITGQVETQYF	TRBV6-6	TRBJ2-5
TGTGCCAGCAGCGACCCGGGACAACAACAGCCCCAGCATTTT	CASSDPGQQQPQHF	TRBV11-3	TRBJ1-5
TGTGCTAGTGGTTTGGCCCCGGGGGGCGATATACCTGAAGCTTTCTTT	CASGLAPGGDIPEAFF	TRBV12-5	TRBJ1-1
TGTGCCAGCAGCGCCAGGACAGGAGGGGCACGAAACATTCAGTACTTC	CASSARTGGARNIQYF	TRBV9	TRBJ2-4
TGCGCCAGCAGAGTTCGGGGGACCTACGAGCAGTACTTC	CASRVRGTYEQYF	TRBV10-1	TRBJ2-7
TGTGCCAGCAGCGGGGGGGGAACTAGTGCAACTAATGAAAAACTGTTTTTT	CASSGGGTSATNEKLFF	TRBV5-4	TRBJ1-4
TGTGCCAGCAGTGACTTCCACCTCTTTCGCCCGCTAGCGCCTTCGAGCCTAGCCAAAAACATTCAGTACTTC	CASSDFHLFRPLAPSSLAKNIQYF	TRBV6-1	TRBJ2-4
TGCGCCAGCAGCCAAGACAGGGTGCGGACTAGCGGGGGGTGGGGCACAGATACGCAGTATTTT	CASSQDRVRTSGGWGTDTQYF	TRBV4-1	TRBJ2-3
TGTGCCAGCAGTTTTCCCGGATATACCTATAATTCACCCCTCCACTTT	CASSFPGYTYNSPLHF	TRBV12-3	TRBJ1-6
TGTGCCAGCAGTGGGGAGAATGAGCAGTTCTTC	CASSGENEQFF	TRBV6-5	TRBJ2-1
TGTGCCAGCAGTGGCCAGGGGCCCTACGAGCAGTACTTC	CASSGQGPYEQYF	TRBV6-4	TRBJ2-7
TGTGCCTGGTGCCGGGACAGGGGGCGGCGGGATACGCAGTATTTT	CAWCRDRGRRDTQYF	TRBV30	TRBJ2-3
TGTGCCAGCAGTAGACAGACAGACTACGAGCAGTACTTC	CASSRQTDYEQYF	TRBV12-3	TRBJ2-7
TGCAGCGACTCCCGTCAGGGTCCGTGGAACACTGAAGCTTTCTTT	CSDSRQGPWNTEAFF	TRBV29-1	TRBJ1-1
TGTGCCAGCAGCTTATTCCGGACTTCCCGGCAGTATTTT	CASSLFRTSRQYF	TRBV7-6	TRBJ2-3
TGCAGCCGGTGCCGCGGGCCTCGCACAGATACGCAGTATTTT	CSRCRGPRTDTQYF	TRBV29-1	TRBJ2-3
TGCAGCGTTGAAAAGGTATCTACGGGGCGGGGGCAGAGCTCCTACGAGCAGTACTTC	CSVEKVSTGRGQSSYEQYF	TRBV29-1	TRBJ2-7
TGTGCCAGCAGGGGCGGGGAGACCCAGTACTTC	CASRGGETQYF	TRBV27	TRBJ2-5
TGCAGTGCTCAGAGCGGTACCAGCACAGATACGCAGTATTTT	CSAQSGTSTDTQYF	TRBV20-1	TRBJ2-3
TGTGCCAGCTCATTGCGGGGGATTTATGGCTACACCTTC	CASSLRGIYGYTF	TRBV18	TRBJ1-2
TGTGCCACCAGCCCCCCGTGCCACGCCTACGAGCAGTACTTC	CATSPPCHAYEQYF	TRBV24-1	TRBJ2-7
TGCAGCGTTGAAGTGCGTCGGAGTTTCCCGAATGGGACAATTCGGAGCAATCAGCCCCAGCATTTT	CSVEVRRSFPNGTIRSNQPQHF	TRBV29-1	TRBJ1-5
TGCGCCAGCAGCCAGCTAGCGGGAAGTTGCTACAATGAGCAGTTCTTC	CASSQLAGSCYNEQFF	TRBV4-1	TRBJ2-1
TGTGCCTGGAGAAACCCCGACAGGGGCCACTCCTACGAGCAGTACTTC	CAWRNPDRGHSYEQYF	TRBV30	TRBJ2-7
TGTGCCAGCAGCGGAATGGGTACTAATGAAAAACTGTTTTTT	CASSGMGTNEKLFF	TRBV13	TRBJ1-4
TGCAGTGCTAGATGGCGGACCATGGACGGCTACACCTTC	CSARWRTMDGYTF	TRBV20-1	TRBJ1-2
TGTGCCAGCAGGAATTTGAAGGGACTAGGATCTGGCGCTTTCTTT	CASRNLKGLGSGAFF	TRBV11-1	TRBJ1-1
TGTGCCAGCAAGGGGGCCGAAAATCAGCCCCAGCATTTT	CASKGAENQPQHF	TRBV7-4	TRBJ1-5
TGTGCCAGCAGCGTTAATACATTTGACAGGACCACGTTGTTCTATGGCTACACCTTC	CASSVNTFDRTTLFYGYTF	TRBV9	TRBJ1-2
TGTGCCAGCTCACCGACGGCGGATACGCAGTATTTT	CASSPTADTQYF	TRBV18	TRBJ2-3
TGTGCCAGCAGCTTAATCGGGTGGTACGAGCAGTACTTC	CASSLIGWYEQYF	TRBV7-2	TRBJ2-7
TGTGCCAGCAGTCCCAGGTATAGAGACACTGAAGCTTTCTTT	CASSPRYRDTEAFF	TRBV6-5	TRBJ1-1
TGTGCCAGCAGTTTACTTAGACCGGTGGGGTGTCAGCCCCAGCATTTT	CASSLLRPVGCQPQHF	TRBV12-3	TRBJ1-5
TGTGCCAGCAGTTTGTACAGGGCACTCACCTACGAGCAGTACTTC	CASSLYRALTYEQYF	TRBV6-8	TRBJ2-7
TGTGCCAGCAGCCCCGGGGACAGGGGCACAGATACGCAGTATTTT	CASSPGDRGTDTQYF	TRBV13	TRBJ2-3
TGTGCCAGCAGCTTAGGCGGCCTAGCGGGAGTTAGCTCCTACAATGAGCAGTTCTTC	CASSLGGLAGVSSYNEQFF	TRBV7-2	TRBJ2-1
TGTGCCAGCAGCGCCGTAGACAGCCTTTGTCCTTATCCTGGCTACACCTTC	CASSAVDSLCPYPGYTF	TRBV5-4	TRBJ1-2
TGTGCCAAACTGGACAGGAGGTTCAACTATGGCTACACCTTC	CAKLDRRFNYGYTF	TRBV9	TRBJ1-2
TGCGCCAGCAGTGACATCGACAGGGGCACCGGGGAGCTGTTTTTT	CASSDIDRGTGELFF	TRBV10-1	TRBJ2-2
TGCAGTGCTTGTGGGGGGGGGAGGAGGGACGATGAGCAGTTCTTC	CSACGGGRRDDEQFF	TRBV20-1	TRBJ2-1
TGTGCCAGCAGTTACAGGGAGGTCTACGAGCAGTACTTC	CASSYREVYEQYF	TRBV6-3	TRBJ2-7
TGTGCCAGCAGCCCAAACTGGAGGCAGTTCTTC	CASSPNWRQFF	TRBV13	TRBJ2-1
TGTGCCAGCTCACCGGGGGGGTTTTGGAACGGAAGTCAAAAGAGCACAGATACGCAGTATTTT	CASSPGGFWNGSQKSTDTQYF	TRBV18	TRBJ2-3
TGTGCCGGACTAGCGGGAATAGAGACCCAGTACTTC	CAGLAGIETQYF	TRBV7-2	TRBJ2-5
TGTGCCAGCTCCAGCGCGACGTACAATGAGCAGTTCTTC	CASSSATYNEQFF	TRBV9	TRBJ2-1
TGTGCTAGTGGTTTGAACACTAGAGAGGCTACCTACGAGCAGTACTTC	CASGLNTREATYEQYF	TRBV12-5	TRBJ2-7
TGCAGTGCTAGCGACAGTCACGAGCAGTACTTC	CSASDSHEQYF	TRBV20-1	TRBJ2-7
TGTGCCAGCAGCTTAGCTAGGGGGGGGTGGGAGTACTTC	CASSLARGGWEYF	TRBV7-9	TRBJ2-5
TGTGCCAGCAGCCACAGGGGGGAGGGCTACAATGAGCAGTTCTTC	CASSHRGEGYNEQFF	TRBV5-6	TRBJ2-1
TGCATCTCACAGGGCCATATTCCGTACCAAGAGACCCAGTACTTC	CISQGHIPYQETQYF	TRBV20-1	TRBJ2-5
TGCAGTGCTAGAGTTAGGGGCCTTTGGTATGGCTACACCTTC	CSARVRGLWYGYTF	TRBV20-1	TRBJ1-2
TGTGCCAGCAGGGCCCGTACCACCGGGACAGGGGGAGAAGACGAGCAGTACTTC	CASRARTTGTGGEDEQYF	TRBV5-4	TRBJ2-7
TGTGCCAGCAGAGAAACGGACAGAGAGGAAAAACTGTTTTTT	CASRETDREEKLFF	TRBV27	TRBJ1-4
TGTGCCAGTCTCCTTGCACAGGGGCTAACCTACGAGCAGTACTTC	CASLLAQGLTYEQYF	TRBV19	TRBJ2-7
TGTGCCAGCACATCGGGGGGACCGTACGAGCAGTACTTC	CASTSGGPYEQYF	TRBV6-4	TRBJ2-7
TGCGCCAGCAGTAAGAGTCTAGCGGGGGACTCCTACGAGCAGTACTTC	CASSKSLAGDSYEQYF	TRBV10-1	TRBJ2-7
TGCAGTGCTAGCCTGAGAGAGCAGTACTTC	CSASLREQYF	TRBV20-1	TRBJ2-7
TGTGCCAGGGGGGGGGCCGGCCACAATGAGCAGTTCTTC	CARGGAGHNEQFF	TRBV2	TRBJ2-1
TGTGCCAGCAGTTACTCGAGCCCAGTGCCGGGACAATGCTCTGGGGCCAACGTCCTGACTTTC	CASSYSSPVPGQCSGANVLTF	TRBV6-5	TRBJ2-6
TGTGCCAGCAGCTTGGGCCAACCGGAAGCGGGATCCGACCTGGGCGGCTACACCTTC	CASSLGQPEAGSDLGGYTF	TRBV5-4	TRBJ1-2
TGTGCCTGGAGTGTACCCCAACAGGGGTCTGGAAACACCATATATTTT	CAWSVPQQGSGNTIYF	TRBV30	TRBJ1-3
TGTGCCAGCAGCTTAGCGAAGTGGAGGACGGGCTCCTACGAGCAGTACTTC	CASSLAKWRTGSYEQYF	TRBV7-9	TRBJ2-7
TGCGCCAGCAGCCCTCTAGCGGGGCACACCGGGGAGCTGTTTTTT	CASSPLAGHTGELFF	TRBV4-1	TRBJ2-2
TGTGCCAGCAGTGTACAGGGACAGGGGGATGGCTACACCTTC	CASSVQGQGDGYTF	TRBV27	TRBJ1-2
TGTGCCAGCAGTTACGGGGGACAGGGCCCCGCGGACCAAGAGACCCAGTACTTC	CASSYGGQGPADQETQYF	TRBV6-5	TRBJ2-5
TGTGCCAGCAGTAGCATGGATTTTCCAACCGGGAACACTGAAGCTTTCTTT	CASSSMDFPTGNTEAFF	TRBV27	TRBJ1-1
TGTGCCATCAGTGACTGCCAGGGACATGAGACCCAGTACTTC	CAISDCQGHETQYF	TRBV10-3	TRBJ2-5
TGTGCCAGCAGCAGTTTGGCCCTTAGAAGCCATGGCTACACCTTC	CASSSLALRSHGYTF	TRBV7-3	TRBJ1-2
TGCGCCAGCAGCCTAAGGGGGGGTAGCACAGATACGCAGTATTTT	CASSLRGGSTDTQYF	TRBV4-1	TRBJ2-3
TGTGCCAGCAGTTACTCGTGCAAGCCTAATGAAAAACTGTTTTTT	CASSYSCKPNEKLFF	TRBV6-2	TRBJ1-4
TGTGCCAGCAGCGTGACCGGGACAGGGGGTGGAAACACCATATATTTT	CASSVTGTGGGNTIYF	TRBV11-2	TRBJ1-3
TGTGCCCGGACTGGAGGCAATGAGCAGTTCTTC	CARTGGNEQFF	TRBV30	TRBJ2-1
TGCGCCAGCAGCCAAGCCTCAGAATGTAGCAATCAGCCCCAGCATTTT	CASSQASECSNQPQHF	TRBV4-1	TRBJ1-5
TGTGCCATCAGTGACGGGAGGGACAGGGGTCCTAGCAATCAGCCCCAGCATTTT	CAISDGRDRGPSNQPQHF	TRBV10-3	TRBJ1-5
TGTGCCAGCAGTTGGCGAGGTGACTCTGGAAACACCATATATTTT	CASSWRGDSGNTIYF	TRBV27	TRBJ1-3
TGTGCCAGCAGTTATCCGGGACAGGGGGAACTATCCTTGAACACTGAAGCTTTCTTT	CASSYPGQGELSLNTEAFF	TRBV6-9	TRBJ1-1
TGTGCCAGCAGTCGACAGGGAAGTGGGGCCAACGTCCTGACTTTC	CASSRQGSGANVLTF	TRBV6-5	TRBJ2-6
TGTGCCAGCAGCCAAGCTCCGGGGTCGGTCAATCAGCCCCAGCATTTT	CASSQAPGSVNQPQHF	TRBV4-2	TRBJ1-5
TGTGCCAGCAGCCGCCTTGTGGGGCGTGATCTCTCCCACTCCTACAATGAGCAGTTCTTC	CASSRLVGRDLSHSYNEQFF	TRBV4-2	TRBJ2-1
TGTGCCAGCAGCCCATCAGCGCAAGAGACCCAGTACTTC	CASSPSAQETQYF	TRBV11-3	TRBJ2-5
TGTGCCAGCAGTGTCATGGGTGGCTACACCTTC	CASSVMGGYTF	TRBV6-2	TRBJ1-2
TGCGCCAGCAGCACTACGCTAGGGCATTACAATGAGCAGTTCTTC	CASSTTLGHYNEQFF	TRBV5-1	TRBJ2-1
TGTGCCAGCCAGATGTACGGGAAACAAGCCAAAAACATTCAGTACTTC	CASQMYGKQAKNIQYF	TRBV9	TRBJ2-4
TGTGCCACCAACCGGGAGAATCAGCCCCAGCATTTT	CATNRENQPQHF	TRBV24-1	TRBJ1-5
TGTGCCAGCAGCGAACAGAAGTCTGAAGCTTTCTTT	CASSEQKSEAFF	TRBV7-3	TRBJ1-1
TGTGCCAGCAGCACAATTCGCGATGAGCAGTTCTTC	CASSTIRDEQFF	TRBV13	TRBJ2-1
TGTGCCTGTTTACGGAAGGGGCAGCCCCAGCATTTT	CACLRKGQPQHF	TRBV30	TRBJ1-5
TGTGCCAGCAGTGGCCTGGGGACTCGTAACTATGGCTACACCTTC	CASSGLGTRNYGYTF	TRBV28	TRBJ1-2
TGCGCCAGCAGCTCTATTGGGGGGGACTACGAGCAGTACTTC	CASSSIGGDYEQYF	TRBV5-1	TRBJ2-7
TGTGCCAGCAGCAAATCTCGGAAGGCCAAAAACATTCAGTACTTC	CASSKSRKAKNIQYF	TRBV13	TRBJ2-4
TGCAGTGCTACGGCTGAAGCTTTCTTT	CSATAEAFF	TRBV20-1	TRBJ1-1
TGCAGCGAGCGGGAAGGGGATGTCTACGAGCAGTACTTC	CSEREGDVYEQYF	TRBV29-1	TRBJ2-7
TGCGCCAGCAGCTTGGGTTGGCGGGGGCACGGGGCCAACGTCCTGACTTTC	CASSLGWRGHGANVLTF	TRBV5-1	TRBJ2-6
TGTGCCAGCAGCTATCGGACTAGCGGGGCTGTAACCACCGGGGAGCTGTTTTTT	CASSYRTSGAVTTGELFF	TRBV7-2	TRBJ2-2
TGTGCCAGCAGTCCCCGGGACGAGCAGTACTTC	CASSPRDEQYF	TRBV6-5	TRBJ2-7
TGTGCCAGCAGCTTATTGCCAGGGGGAGATACGCAGTATTTT	CASSLLPGGDTQYF	TRBV7-3	TRBJ2-3
TGCAGCGTACCCTTAAACCCCGACAGGGGCTCAGATACGCAGTATTTT	CSVPLNPDRGSDTQYF	TRBV29-1	TRBJ2-3
TGTGCCAGCAGCTTAGGCAAAAAGGGTGGCCCGTCTACTGTCCAGGGGGCCCCCGAAAAACTGTTTTTT	CASSLGKKGGPSTVQGAPEKLFF	TRBV7-9	TRBJ1-4
TGTGCCAGCAGCCAAGGAGGGTACAGGGGCGATGGAAAGTACAATAACACTGAAGCTTTCTTT	CASSQGGYRGDGKYNNTEAFF	TRBV14	TRBJ1-1
TGTGCCAGCAGTGCGGGTGTCAGACAGGGAAACACCGGGGAGCTGTTTTTT	CASSAGVRQGNTGELFF	TRBV25-1	TRBJ2-2
TGTGCCAGCAGCTGGACAACACAGAGAGGCTATGGCTACACCTTC	CASSWTTQRGYGYTF	TRBV13	TRBJ1-2
TGTGCCAGCAGTTACCGGGACAGGGACCGCGAGCAGTACTTC	CASSYRDRDREQYF	TRBV6-5	TRBJ2-7
TGCAGTGCAGGTTGGGGTGGGGAAATTGACTACAATGAGCAGTTCTTC	CSAGWGGEIDYNEQFF	TRBV20-1	TRBJ2-1
TGTGCCAGCAGTGATTCGCAAGAGACCCAGTACTTC	CASSDSQETQYF	TRBV6-1	TRBJ2-5
TGTGCCAGCAGTTACTCGACGTATCACTATAGCAATCAGCCCCAGCATTTT	CASSYSTYHYSNQPQHF	TRBV6-5	TRBJ1-5
TGTGCCAAACACAGGAGCCGCTGGAATGAGCAGTTCTTC	CAKHRSRWNEQFF	TRBV19	TRBJ2-1
TGTGCCAGCAGTGACGGAGCTGGACTCTATGGCTACACCTTC	CASSDGAGLYGYTF	TRBV6-4	TRBJ1-2
TGCGCCAGCAGCCAAGACCCGCCTAGGGTTCAGCCCCAGCATTTT	CASSQDPPRVQPQHF	TRBV4-1	TRBJ1-5
TGTGCCTGGAGTGAAGCGGTTTCCTACAATGAGCAGTTCTTC	CAWSEAVSYNEQFF	TRBV30	TRBJ2-1
TGTGCCATTTTGGGGATTCCTAACACTGAAGCTTTCTTT	CAILGIPNTEAFF	TRBV27	TRBJ1-1
TGTGCCACCAGTGATTTGGGGACAGCTTGGATGAACACTGAAGCTTTCTTT	CATSDLGTAWMNTEAFF	TRBV24-1	TRBJ1-1
TGCGCCAGCAGCCGAAAGGGACAGGGGGGGGGGGTCGAGCAGTACTTC	CASSRKGQGGGVEQYF	TRBV4-1	TRBJ2-7
TGCGCCAGCAGCCAAGACTCGACAGGGCTTGACTACTATGGCTACACCTTC	CASSQDSTGLDYYGYTF	TRBV4-1	TRBJ1-2
TGTGCCAGCAGCTTGGACAGGGGGAGCTACGAGCAGTACTTC	CASSLDRGSYEQYF	TRBV5-6	TRBJ2-7
TGTGCCAGCGGGGACCGACTTTCCATGCACAACTATGGCTACACCTTC	CASGDRLSMHNYGYTF	TRBV18	TRBJ1-2
TGCGCCAGCAGTCCGGGACTAGCGGGGGGAGGGAGGGACACAGATACGCAGTATTTT	CASSPGLAGGGRDTDTQYF	TRBV5-1	TRBJ2-3
TGTGCCAGCAGTGATTCGCGACGGGGGGGGCCATCCACAGATACGCAGTATTTT	CASSDSRRGGPSTDTQYF	TRBV6-5	TRBJ2-3
TGTGCCAGCCCAGCAATGGATAATTCACCCCTCCACTTT	CASPAMDNSPLHF	TRBV7-9	TRBJ1-6
TGTGCCAGCAGCTGTCGAACCCGAGGCTACACCTTC	CASSCRTRGYTF	TRBV7-3	TRBJ1-2
TGTGCCAGCAGTGAATGCGACTACAGTCAGGCCGGGTCCGGGCAGTTCTTC	CASSECDYSQAGSGQFF	TRBV25-1	TRBJ2-1
TGCGCCAGCAGGGGGGATGACACTGAAGCTTTCTTT	CASRGDDTEAFF	TRBV5-1	TRBJ1-1
TGTGCCAGCAGCTCCCGTACTTGTAGTACTGAAGCTTTCTTT	CASSSRTCSTEAFF	TRBV7-2	TRBJ1-1
