TGTGCCAGCCGCTATGCAGGGAATAATCAGCCCCAGCATTTT	CASRYAGNNQPQHF	TRBV9	TRBJ1-5
TGCGCCAGCAGCTCGCCCATCCTAGCGGGAGCCAGCAATGAGCAGTACTTC	CASSSPILAGASNEQYF	TRBV5-1	TRBJ2-7
TGTGCCAAGTATCGAATCGGGACGGGCTCCTACAATGAGCAGTTCTTC	CAKYRIGTGSYNEQFF	TRBV27	TRBJ2-1
TGTGCCAACTTAGATCCGACTTATGGAATGTACGAGCAGTACTTC	CANLDPTYGMYEQYF	TRBV13	TRBJ2-7
TGCGCCAGGGGTACGACAGGGGTTGAAAAACTGTTTTTT	CARGTTGVEKLFF	TRBV5-1	TRBJ1-4
TGTGCCAGCAGCTTCCAAAGGACAGGGCTCTACGAGCAGTACTTC	CASSFQRTGLYEQYF	TRBV11-3	TRBJ2-7
TGTGCCATCAGGCTGCGGGTTAATGAAAAACTGTTTTTT	CAIRLRVNEKLFF	TRBV10-3	TRBJ1-4
TGTGCCTGGAGTCGGGAGGATAGCAATCAGCCCCAGCATTTT	CAWSREDSNQPQHF	TRBV30	TRBJ1-5
TGTGCCAGCAGCTTATTGGGTAGAAACACCATATATTTT	CASSLLGRNTIYF	TRBV7-3	TRBJ1-3
TGTGCCAGCAGCCATCGAGTGGACAGCGCGAACACCGGGGAGCTGTTTTTT	CASSHRVDSANTGELFF	TRBV14	TRBJ2-2
TGCGCCAGCAGCAAGGTAGCGGGAGGCTACGAGCAGTACTTC	CASSKVAGGYEQYF	TRBV5-1	TRBJ2-7
TGTGCCAGCAGCCAGAGGGGACACAATGAGCAGTTCTTC	CASSQRGHNEQFF	TRBV7-4	TRBJ2-1
TGTGCCAGCAGTGAGAGACAGGGGGGTATCGTTGAAGCTTTCTTT	CASSERQGGIVEAFF	TRBV6-4	TRBJ1-1
TGTGCCAGCAGTTTGAGCTGCGCTCCAGTCTGCTACAATGAGCAGTTCTTC	CASSLSCAPVCYNEQFF	TRBV27	TRBJ2-1
TGTGCCAGCACCAACGGGGGCCCCTGTGGCTACACCTTC	CASTNGGPCGYTF	TRBV6-8	TRBJ1-2
TGTGCCAGCAGCTCTACCGCGACTGAAGCTTTCTTT	CASSSTATEAFF	TRBV7-3	TRBJ1-1
TGCAGTGCTAGAAGGATTATAGGGAGGCGCTCTGGAAACACCATATATTTT	CSARRIIGRRSGNTIYF	TRBV20-1	TRBJ1-3
TGTGCCACCAGTGATTTGACTAGCGGGACGATGGCAGGCTACAATGAGCAGTTCTTC	CATSDLTSGTMAGYNEQFF	TRBV24-1	TRBJ2-1
TGCAGCGGAAGTAACCACCTAGCTTCAGACAATGAGCAGTTCTTC	CSGSNHLASDNEQFF	TRBV29-1	TRBJ2-1
TGTGCCAGCAGCCAAGACCCAAGTCTTAGCGGGAGGGGGTACGAGCAGTACTTC	CASSQDPSLSGRGYEQYF	TRBV4-2	TRBJ2-7
TGTGCCAGCAGTTACCGAGAAAAACTGTTTTTT	CASSYREKLFF	TRBV6-2	TRBJ1-4
TGTGCCAGCAGCGGAATTCACGGGCGGAATGAGCAGTTCTTC	CASSGIHGRNEQFF	TRBV9	TRBJ2-1
TGTGCCAGCAGCAGATTCGGGAAAGGCAGGGGTCCCAACACTGAAGCTTTCTTT	CASSRFGKGRGPNTEAFF	TRBV5-4	TRBJ1-1
TGTGCCGTTCCCCAGGGGGCGAGGCTATTACTAGATACGCAGTATTTT	CAVPQGARLLLDTQYF	TRBV19	TRBJ2-3
TGTGCCAGCAGCGGGAGGAGTTCACCCCTCCACTTT	CASSGRSSPLHF	TRBV9	TRBJ1-6
TGTTTCACAGGGGATGAGCAGTTCTTC	CFTGDEQFF	TRBV19	TRBJ2-1
TGCGCCAGCAGCCAAGGCGGGGTACGGTGCAATCAGCCCCAGCATTTT	CASSQGGVRCNQPQHF	TRBV4-3	TRBJ1-5
TGTGCCAGCAGGACAGGGGTACCCCTCCACTTT	CASRTGVPLHF	TRBV27	TRBJ1-6
TGCAGTGCCCGGGGAGGTCCTGTTCGGACTAGCGGGTTAAACGAGACCCAGTACTTC	CSARGGPVRTSGLNETQYF	TRBV20-1	TRBJ2-5
TGTGCCTGGAGTGCCGGCCGGGACAGGGTATCACCCCTCCACTTT	CAWSAGRDRVSPLHF	TRBV30	TRBJ1-6
TGTGCCAGCAGCTTAGCGGGAAACAAGAACGAGCAGTACTTC	CASSLAGNKNEQYF	TRBV7-4	TRBJ2-7
TGTGCCAGCAGTGAAGCTCGACAGGGGATCTTCAATCAGCCCCAGCATTTT	CASSEARQGIFNQPQHF	TRBV6-1	TRBJ1-5
TGTGCCAGCAGCGTAGGGAAGCGGGATATGTACGAGCAGTACTTC	CASSVGKRDMYEQYF	TRBV9	TRBJ2-7
TGCGCCAGCAGCCTGACAGCCTGCCCGACAGGTGTGGAGACCCAGTACTTC	CASSLTACPTGVETQYF	TRBV4-3	TRBJ2-5
TGTGCCAGCAGCTTAACGCGCGGGGAGGGTCATTTATTAGGCAACTATGGCTACACCTTC	CASSLTRGEGHLLGNYGYTF	TRBV7-3	TRBJ1-2
TGTGCTAGTGGTTTGGTACAAAGAGGGACCTACGAGCAGTACTTC	CASGLVQRGTYEQYF	TRBV12-5	TRBJ2-7
TGTGCCAGCCCAACCCCTCCCCAGGGATGCTCCTACGAGCAGTACTTC	CASPTPPQGCSYEQYF	TRBV19	TRBJ2-7
TGTGCCACCAAGAAGGGGGCGTTAACCGGGGAGCTGTTTTTT	CATKKGALTGELFF	TRBV24-1	TRBJ2-2
TGTGCCAGCAGCGACTGGAATCAGCCCCAGCATTTT	CASSDWNQPQHF	TRBV7-3	TRBJ1-5
TGTGCCAGCAGCTTATATTGTCTCCGACTGTACGAGCAGTACTTC	CASSLYCLRLYEQYF	TRBV7-2	TRBJ2-7
TGCAGTGCTCCGGGGGGCGGGCCCCAGCATTTT	CSAPGGGPQHF	TRBV20-1	TRBJ1-5
TGTGCCAGCAGTGAAGCATGGGCCCATAGCAATCAGCCCCAGCATTTT	CASSEAWAHSNQPQHF	TRBV6-1	TRBJ1-5
TGTGCCAGCAGTTGCAGACGGACAGGGACAGACTATGGCTACACCTTC	CASSCRRTGTDYGYTF	TRBV12-3	TRBJ1-2
TGTGCCAGCAGCCCTCCAGGTTTTAGCGAGCAGTACTTC	CASSPPGFSEQYF	TRBV5-4	TRBJ2-7
TGTGCCAGCAGCTTAAACGCTAAATCTGGCTACACCTTC	CASSLNAKSGYTF	TRBV11-3	TRBJ1-2
TGTGCCAGTAGTATAGGAGGGGGAAAGTACTTC	CASSIGGGKYF	TRBV19	TRBJ2-7
TGTGCCAGTAGTATGGAATTCGGGACTAACTATGGCTACACCTTC	CASSMEFGTNYGYTF	TRBV19	TRBJ1-2
TGTGCCAGCAGCTTAGCTCCCCGTCGCGGGGGCCAGAGGCAGACCCAGTACTTC	CASSLAPRRGGQRQTQYF	TRBV11-3	TRBJ2-5
TGCAGTGCTAGTGGCCCCGGGACTAGGGGATACGAGCAGTACTTC	CSASGPGTRGYEQYF	TRBV20-1	TRBJ2-7
TGTGCCAGGGTGCCAATGCGGGGGGGAGATACGCAGTATTTT	CARVPMRGGDTQYF	TRBV25-1	TRBJ2-3
TGTGCCAGCAGTGACGGGGGGGTTCTAGGGGGAGAGCTGAACACTGAAGCTTTCTTT	CASSDGGVLGGELNTEAFF	TRBV6-4	TRBJ1-1
TGTGCCAGCAGCATTACTGGACTAGCGGGGCCCTTCGGGGAGCTGTTTTTT	CASSITGLAGPFGELFF	TRBV3-1	TRBJ2-2
TGCGCCAGCCCACGCGAGGTTATCGGTGATGAGCAGTTCTTC	CASPREVIGDEQFF	TRBV4-1	TRBJ2-1
TGTGCCAGCAGCGTGCTCCGGGACAGAGGGTGGAATCAGCCCCAGCATTTT	CASSVLRDRGWNQPQHF	TRBV9	TRBJ1-5
TGCGCCGACCTATTCAGAGAAGGAATGAACACTGAAGCTTTCTTT	CADLFREGMNTEAFF	TRBV10-1	TRBJ1-1
TGCGCCAACTGGGGCGGACAGTCGGGGGGCGATTACGAGCAGTACTTC	CANWGGQSGGDYEQYF	TRBV4-3	TRBJ2-7
TGTGCCAGCAGCCAAGACAGGGAAGCGATAGCACGCCCAACTAATGAAAAACTGTTTTTT	CASSQDREAIARPTNEKLFF	TRBV13	TRBJ1-4
TGTGCCAGCAGCCCTGTTGAAGAAAGACGATTTGCTAGGGAGCAGTACTTC	CASSPVEERRFAREQYF	TRBV6-6	TRBJ2-7
TGTGCCAGCAGTTCAAATCTAGGGCCAGAGCAGTACTTC	CASSSNLGPEQYF	TRBV7-9	TRBJ2-7
TGTGCCAGCAGTTACGGGCCCACCGGGGAGCTGTTTTTT	CASSYGPTGELFF	TRBV6-4	TRBJ2-2
TGTGCCAGCTCACCAAGGGCGCGGGAGGGCACAGATACGCAGTATTTT	CASSPRAREGTDTQYF	TRBV18	TRBJ2-3
TGTGAGTTTACCCCAGACAGGGACACTGAAGCTTTCTTT	CEFTPDRDTEAFF	TRBV10-3	TRBJ1-1
TGTGCTAGCAGTAAGGACAGGGGAGGAGGCACTGGGGCCAACGTCCTGACTTTC	CASSKDRGGGTGANVLTF	TRBV7-7	TRBJ2-6
TGTGCCAGCAGCTTTTGTCAGGGCTCTGGAGGTCTAGCCAAAAACATTCAGTACTTC	CASSFCQGSGGLAKNIQYF	TRBV7-8	TRBJ2-4
TGCGCCAGCAGCTTAACAAGGGGACTAGATACGCAGTATTTT	CASSLTRGLDTQYF	TRBV5-1	TRBJ2-3
TGTGCCAGCAGCCCCGGAGGTATCTTC	CASSPGGIF	TRBV4-2	TRBJ2-1
TGTGCCAGCAGCAAGTGTAGGGGAGGAATATACTTC	CASSKCRGGIYF	TRBV13	TRBJ2-5
TGTGCCTGGAGAACCTCAGGGGTAAAAGAAGCTTTCTTT	CAWRTSGVKEAFF	TRBV30	TRBJ1-1
TGTGCCAGCAGCTTCAGGCAGGGGCTCTCCTACGAGCAGTACTTC	CASSFRQGLSYEQYF	TRBV5-5	TRBJ2-7
TGTGCCAGCAGCGTAGAGTACCGTACACCATCCTGGGAGGGAGGGGACGAGCAGTACTTC	CASSVEYRTPSWEGGDEQYF	TRBV9	TRBJ2-7
TGTGCCAGCAGCGCCGACAGGGTGGTGAACACTGAAGCTTTCTTT	CASSADRVVNTEAFF	TRBV7-4	TRBJ1-1
TGTGCCAGCAGTGACCCAAAGGAGGGAAACACCATATATTTT	CASSDPKEGNTIYF	TRBV6-4	TRBJ1-3
TGTGCCAGCAGCTGTAACCATAGCGGGTGGCTTGGCTTC	CASSCNHSGWLGF	TRBV5-6	TRBJ2-5
TGTGCCAGCAGCCATCTAGGGGGGGGCTACGAGCAGTACTTC	CASSHLGGGYEQYF	TRBV7-9	TRBJ2-7
TGTGCCTGGGGGGGTAACCAAGCATACGAGCAGTACTTC	CAWGGNQAYEQYF	TRBV30	TRBJ2-7
TGTGCCAGCAGTTTATGGGGGTGGATCCAGCGGGATGGTCGGACCGGGGAGCTGTTTTTT	CASSLWGWIQRDGRTGELFF	TRBV27	TRBJ2-2
TGTGCCAGCAGCTTAGCCAAGGGCGTAAATGTCGCCAAAAACATTCAGTACTTC	CASSLAKGVNVAKNIQYF	TRBV7-9	TRBJ2-4
TGTGCCAGCAGCCAAGAGGTCTTTGGCTGTCAGGAGCAGTACTTC	CASSQEVFGCQEQYF	TRBV14	TRBJ2-7
TGTGCCACCAGTGAAAGGACCTTCGAGACCCAGTACTTC	CATSERTFETQYF	TRBV24-1	TRBJ2-5
TGCGCCAGCACCCGGGACAGAGAGCAGCCCCAGCATTTT	CASTRDREQPQHF	TRBV10-1	TRBJ1-5
TGTGCCACCAGTGAACACAAGGGGAATAACAATGAGCAGTTCTTC	CATSEHKGNNNEQFF	TRBV24-1	TRBJ2-1
TGTGCCAGCAGTTACGGTCCCATTAACCGGGTACCGGGACAGGGGCAAGAGACCCAGTACTTC	CASSYGPINRVPGQGQETQYF	TRBV6-6	TRBJ2-5
TGTGCCAGCAGCGTGACAGCACAAGAGACCCAGTACTTC	CASSVTAQETQYF	TRBV11-3	TRBJ2-5
TGTGCCAGCAGCCAAGACCCCTCGGGATCAGGGGGCCCACACACTGAAGCTTTCTTT	CASSQDPSGSGGPHTEAFF	TRBV14	TRBJ1-1
TGTGCCAGCAGCGGCATTGGCTATGGCTACACCTTC	CASSGIGYGYTF	TRBV11-2	TRBJ1-2
TGCGCCAGCAGCCGGGTTACGGACCTAGATCAGCCCCAGCATTTT	CASSRVTDLDQPQHF	TRBV10-2	TRBJ1-5
TGTGCCAGCAGCCCTTGGACTAGAGACGTAGGGTGGAATGAGCAGTTCTTC	CASSPWTRDVGWNEQFF	TRBV14	TRBJ2-1
TGCAGCGTAACGGGCGGGAGCACTGAAGCTTTCTTT	CSVTGGSTEAFF	TRBV29-1	TRBJ1-1
TGCGCCATGATACTAGCGGGAGGGGCCGGGGAGACCCAGTACTTC	CAMILAGGAGETQYF	TRBV10-2	TRBJ2-5
TGTGCCAGCAGTTACAGAATCACAGATACGCAGTATTTT	CASSYRITDTQYF	TRBV6-5	TRBJ2-3
TGTGCCAGCAGCTCGGACAGAGTAACGACTGAAGCTTTCTTT	CASSSDRVTTEAFF	TRBV5-6	TRBJ1-1
TGTGCCCCCTCCGGCATCCCTGGTGTTAGCACAGATACGCAGTATTTT	CAPSGIPGVSTDTQYF	TRBV30	TRBJ2-3
TGTGCCTGGCAGGCCAGGGGAACCTACGAGCAGTACTTC	CAWQARGTYEQYF	TRBV30	TRBJ2-7
TGTGCCAGCAGCTTAGATCATACGATTCGGCAGCCCCAGCATTTT	CASSLDHTIRQPQHF	TRBV11-2	TRBJ1-5
TGTGCCAGCAGCTGCCCCAACAGGGGAAGGACGAGCTCCTATAATTCACCCCTCCACTTT	CASSCPNRGRTSSYNSPLHF	TRBV5-6	TRBJ1-6
TGTGCCAGCAGCCAAGAATTGGTAGGGCCGAGCAATCAGCCCCAGCATTTT	CASSQELVGPSNQPQHF	TRBV4-2	TRBJ1-5
TGTGCCAGTATTCCCCGGGACGAAGAGACCCAGTACTTC	CASIPRDEETQYF	TRBV19	TRBJ2-5
TGTGCCAGCAGGGATGCAGGATGCTCCTACGAGCAGTACTTC	CASRDAGCSYEQYF	TRBV3-1	TRBJ2-7
TGTGCCAGCAGCTCAAATGGGGCCATCTCTGGAAACACCATATATTTT	CASSSNGAISGNTIYF	TRBV11-3	TRBJ1-3
TGCAGTGCTAGAGATTGGAAATATAACCGGGTTACAGATACGCAGTATTTT	CSARDWKYNRVTDTQYF	TRBV20-1	TRBJ2-3
TGTGCCAGCAGTTGGCCCAGGGGGTTTGGCTACACCTTC	CASSWPRGFGYTF	TRBV25-1	TRBJ1-2
TGTGCCCGCGGGAGGGCCTACGAGCAGTACTTC	CARGRAYEQYF	TRBV6-1	TRBJ2-7
TGTGCCAGCACTAGGGGGGCCGGGGAGCTGTTTTTT	CASTRGAGELFF	TRBV6-2	TRBJ2-2
TGCGCCAGCTTTACTGGGTTAGTTGAGCAGTTCTTC	CASFTGLVEQFF	TRBV10-2	TRBJ2-1
TGTGCCAGCAATCAGACAGGGAAGCGCTCCTACGAGCAGTACTTC	CASNQTGKRSYEQYF	TRBV11-2	TRBJ2-7
TGCGCCAGGATTCCAGGCTACACCTTC	CARIPGYTF	TRBV5-1	TRBJ1-2
TGTGCCACCAGCAAAAACCAGGGCGAAAGGGCCTATAATTCACCCCTCCACTTT	CATSKNQGERAYNSPLHF	TRBV15	TRBJ1-6
TGTGCCAGCAGTTTAAAAGGGAGGGGGGGCTATGAAAAACTGTTTTTT	CASSLKGRGGYEKLFF	TRBV12-4	TRBJ1-4
TGTGCCACCAGTGACTGGGACAGGAGGGCGACTTACGAGCAGTACTTC	CATSDWDRRATYEQYF	TRBV24-1	TRBJ2-7
TGCAGTGCGAAAACGGGGGCAGGTTGGGAAGAGACCCAGTACTTC	CSAKTGAGWEETQYF	TRBV20-1	TRBJ2-5
TGTGCCAGCAGCGGGAAGTCTAGACGGGGCACTGAAGCTTTCTTT	CASSGKSRRGTEAFF	TRBV7-3	TRBJ1-1
TGTGCCAGCAGCCAAGGAACCAAGACTAGGGGGGTAGCCAAAAACATTCAGTACTTC	CASSQGTKTRGVAKNIQYF	TRBV14	TRBJ2-4
TGTGCCAGCAACCCACACGAGGACACGGCCTTC	CASNPHEDTAF	TRBV28	TRBJ1-2
TGTGCCAGCAGTGCATGGACAGGGGGTTGCACAGATACGCAGTATTTT	CASSAWTGGCTDTQYF	TRBV6-3	TRBJ2-3
TGTGCCAGCAGCGCGGACAGGGGGAGTAGAGGCGGCTCGGCTGGAAACACCATATATTTT	CASSADRGSRGGSAGNTIYF	TRBV9	TRBJ1-3
TGTGCCAGCAGTTTAGCGGGAGGACAGAATCAGCCCCAGCATTTT	CASSLAGGQNQPQHF	TRBV28	TRBJ1-5
TGTGCCAGCAGCCAAGGGACTAGCGGGTTCTCCCGGTTCCCATACGAGCAGTACTTC	CASSQGTSGFSRFPYEQYF	TRBV3-1	TRBJ2-7
TGTGCCAGCAGCTTCCCAAAGGTCAGGGGCACTGAAGCTTTCTTT	CASSFPKVRGTEAFF	TRBV11-3	TRBJ1-1
TGTGCCAGCAGTCCTATCAAGGGGGCTTCGCAGTACTTC	CASSPIKGASQYF	TRBV27	TRBJ2-7
TGCAGTGCTAGAGCGCAAGCGGGAGAACCCTCCTACGAGCAGTACTTC	CSARAQAGEPSYEQYF	TRBV20-1	TRBJ2-7
TGTGCCAGCAGCTTGGCGACAGCGGAGAGTAATGAAAAACTGTTTTTT	CASSLATAESNEKLFF	TRBV7-4	TRBJ1-4
TGTGCCACTAGGCCACCAGGGGTTCCACACTACAATGAGCAGTTCTTC	CATRPPGVPHYNEQFF	TRBV19	TRBJ2-1
TGTGCCAGCAAAAAAATGGAGGAGGTGAACACTGAAGCTTTCTTT	CASKKMEEVNTEAFF	TRBV6-1	TRBJ1-1
TGTGCCAGCATCAGGGGGGCGTGTTACACAGATACGCAGTATTTT	CASIRGACYTDTQYF	TRBV28	TRBJ2-3
TGCGCCAGCAGCCAAGCGCCGGGAAGGCCCGAGCAGTTCTTC	CASSQAPGRPEQFF	TRBV4-1	TRBJ2-1
TGTGCCAGCAAAGGGGACAGAAACTACGAGCAGTACTTC	CASKGDRNYEQYF	TRBV25-1	TRBJ2-7
TGCAGTGCTAGAGACCAAAGGGGAAACACCATATATTTT	CSARDQRGNTIYF	TRBV20-1	TRBJ1-3
TGTGCCAGTAGTGAGACAGGGGCCTTTCCGCCCACCGGGGAGCTGTTTTTT	CASSETGAFPPTGELFF	TRBV19	TRBJ2-2
TGTGCCAGCAGTGATTGGAGACAGGGACGAGTCTCTGGAAACACCATATATTTT	CASSDWRQGRVSGNTIYF	TRBV6-1	TRBJ1-3
TGTGCCAGTAGTGCCCCCCAGGGGATTACTGAAGCTTTCTTT	CASSAPQGITEAFF	TRBV19	TRBJ1-1
TGTGCCAGCAGACCGGGACACGACACTGAAGCTTTCTTT	CASRPGHDTEAFF	TRBV11-2	TRBJ1-1
TGTGCCAGCAGGTACAGGGGAGATAGCAATCAGCCCCAGCATTTT	CASRYRGDSNQPQHF	TRBV12-3	TRBJ1-5
TGTGCCAGCAGTTCCCCCCCTCACAGGGTAAACACCGGGGAGCTGTTTTTT	CASSSPPHRVNTGELFF	TRBV12-3	TRBJ2-2
TGCGCCAGCAGCTTGGGTTCGGGACAGCTTGAACTTGATGGCTACACCTTC	CASSLGSGQLELDGYTF	TRBV5-1	TRBJ1-2
TGTGCCAGCAGCTTATGTCACAGGGGGCAATATAGCAATCAGCCCCAGCATTTT	CASSLCHRGQYSNQPQHF	TRBV7-3	TRBJ1-5
TGTGCCAGCAGCTTACGGACTCCTGCGGAGGCTAGCTACGAGCAGTACTTC	CASSLRTPAEASYEQYF	TRBV7-9	TRBJ2-7
TGTGCCAGCAGTTACGGCAGGGGCGTCCGTCCAGATACGCAGTATTTT	CASSYGRGVRPDTQYF	TRBV6-5	TRBJ2-3
TGTGCCAGCAGTTACTCAGGGGTCGGGATTTCCGGGGAGCTGTTTTTT	CASSYSGVGISGELFF	TRBV6-5	TRBJ2-2
TGTGCCTGGAACGGGCCCATATGCAATCAGCCCCAGCATTTT	CAWNGPICNQPQHF	TRBV30	TRBJ1-5
TGTGCCAGCAGCGTAGTCTACAGGGGGCCAACGGGATGTGCAACTAATGAAAAACTGTTTTTT	CASSVVYRGPTGCATNEKLFF	TRBV9	TRBJ1-4
TGTGCCAGCAGCGGGAGGTCCTACGAGCAGTACTTC	CASSGRSYEQYF	TRBV5-6	TRBJ2-7
TGTGCCAGCAGCTTAGTAAGGATCTTGGGGGGGGGCGACGAGCAGTACTTC	CASSLVRILGGGDEQYF	TRBV7-3	TRBJ2-7
TGTGCCAGCAGTGCAGGGGTCACTGAAGCTTTCTTT	CASSAGVTEAFF	TRBV6-1	TRBJ1-1
TGTGCCAGCAGTTTAACGTCACGGTGGACTAGCGGTCAGGATGCCGAAGAGACCCAGTACTTC	CASSLTSRWTSGQDAEETQYF	TRBV28	TRBJ2-5
TGTGCCACCAGTGAATTGACTAGCGGGAGTAAAAACATTCAGTACTTC	CATSELTSGSKNIQYF	TRBV24-1	TRBJ2-4
TGTGCCAGCAGCTTAAACCCGGGACTAGCCTACAATGAGCAGTTCTTC	CASSLNPGLAYNEQFF	TRBV11-2	TRBJ2-1
TGTGCCAGCATAAGTCAAGGCTATGGCTACACCTTC	CASISQGYGYTF	TRBV6-8	TRBJ1-2
TGTGCCAGCAGTTACTCGTCCCGACAGGGGGCAGGTCATGAGCAGTTCTTC	CASSYSSRQGAGHEQFF	TRBV6-5	TRBJ2-1
TGCGCCAGCAGCCATCTTACCGGGACAGCGGGCTACACCTTC	CASSHLTGTAGYTF	TRBV4-1	TRBJ1-2
TGTGCCAGTAGTTGGGCAAGGGCGAATGAAGCTTTCTTT	CASSWARANEAFF	TRBV19	TRBJ1-1
TGTGCCAGCAGTTACTCCGGACGAATATATAAGGGTCACGAGCAGTACTTC	CASSYSGRIYKGHEQYF	TRBV6-5	TRBJ2-7
TGCAGTGCTAGAGGGGTGACAGAGAGTGGGGAGCAGTACTTC	CSARGVTESGEQYF	TRBV20-1	TRBJ2-7
TGTGCCAGCAAGGAGCTAGGTTTCTACGAGCAGTACTTC	CASKELGFYEQYF	TRBV28	TRBJ2-7
TGTGCCAGCAGCTTATCGTGGAATAGATACGAGCAGTACTTC	CASSLSWNRYEQYF	TRBV7-3	TRBJ2-7
TGTGCCAGCAGTTCCGGGGGTAACTATGGCTACACCTTC	CASSSGGNYGYTF	TRBV27	TRBJ1-2
TGTGCCACCATCGGGAGGGGAGTCTACGAGCAGTACTTC	CATIGRGVYEQYF	TRBV24-1	TRBJ2-7
TGTGCCAGCAGGGCAACTAGCGGGAGTAACTATGGCTACACCTTC	CASRATSGSNYGYTF	TRBV5-6	TRBJ1-2
TGTGCCAGCAGTTATCCAGCCCGGAACGGAGAGACCCAGTACTTC	CASSYPARNGETQYF	TRBV6-6	TRBJ2-5
TGCGCCAGCAGCTTGTCTAGCGGGGAGCCTCCGATCAATGAGCAGTTCTTC	CASSLSSGEPPINEQFF	TRBV5-1	TRBJ2-1
TGTGCCAGCAGCTTAGAAGACCTAGGGGGGCTCAGGGAGACCCAGTACTTC	CASSLEDLGGLRETQYF	TRBV11-3	TRBJ2-5
TGTGCCAGCAGCAGTCCACTAGCGGGAGATCAATGCTATGGCTACACCTTC	CASSSPLAGDQCYGYTF	TRBV7-9	TRBJ1-2
TGTGCCAGCAGAACCCGGGACCTATACTATGGCTACACCTTC	CASRTRDLYYGYTF	TRBV6-6	TRBJ1-2
TGTGCCAGCAGCCAACGCGGGCAAGAGACCCAGTACTTC	CASSQRGQETQYF	TRBV3-1	TRBJ2-5
TGTGCCAGCTCACCGGGGCGGGACCTCACCGGGGAGCTGTTTTTT	CASSPGRDLTGELFF	TRBV18	TRBJ2-2
TGTGCCAGCAGTGACCAATCCGCAGGGTCGGATTGGGGGAGGGCGGAGCAGCCCCAGCATTTT	CASSDQSAGSDWGRAEQPQHF	TRBV6-1	TRBJ1-5
TGTGCCAGCAGCTTAGGGCACTCCGGGGGAGAGACCCAGTACTTC	CASSLGHSGGETQYF	TRBV7-6	TRBJ2-5
TGCAGTGCGGTTCCCCCCGGGACAGGGAGGGGTTTCGCTAATGAAAAACTGTTTTTT	CSAVPPGTGRGFANEKLFF	TRBV20-1	TRBJ1-4
TGTGCCAGCAGCGTACCGGGGGGCGGGGGCTACGAGCAGTACTTC	CASSVPGGGGYEQYF	TRBV9	TRBJ2-7
TGTGCCTTGGGACAGGGGGGTGGGCCATCCTACGAGCAGTACTTC	CALGQGGGPSYEQYF	TRBV7-2	TRBJ2-7
TGTGCCAGCACCAAGGCAGGCTTGTCCGTAAACTCTGGAAACACCATATATTTT	CASTKAGLSVNSGNTIYF	TRBV27	TRBJ1-3
TGTGCCAGAGGTTGGGGGGGAGAATCCCGAATACGCTACGAGCAGTACTTC	CARGWGGESRIRYEQYF	TRBV19	TRBJ2-7
TGCAGTGCGGGGTACGAGCAGTACTTC	CSAGYEQYF	TRBV20-1	TRBJ2-7
TGCAGTGCCATAAAGAGGGGGGCCAGTGCAGATACGCAGTATTTT	CSAIKRGASADTQYF	TRBV20-1	TRBJ2-3
TGTGCCAGCAGCGGAGGACAGGGGACAGGGTATAATTCACCCCTCCACTTT	CASSGGQGTGYNSPLHF	TRBV9	TRBJ1-6
TGTGCCAGCAGCGTCCCTATGACCGGGACAGGGGGCGAAAAACTGTTTTTT	CASSVPMTGTGGEKLFF	TRBV9	TRBJ1-4
TGTGCCAGCAATAGTTACCACGCGGGGACGAACTTCGAATCCTACTTC	CASNSYHAGTNFESYF	TRBV6-4	TRBJ2-5
TGTGCCAGCAGTGAATTCAGGAACAATCAGCCCCAGCATTTT	CASSEFRNNQPQHF	TRBV25-1	TRBJ1-5
TGTGCCAGCAGTGCAGGCTCAGACAGCCCGCTGTTTTTT	CASSAGSDSPLFF	TRBV27	TRBJ1-4
TGTGCCAGCAGCCATGAAGGACAGGGTTATCAGCCCCAGCATTTT	CASSHEGQGYQPQHF	TRBV14	TRBJ1-5
TGTGCCAGCAGTGGGGACAACAGTAAGCCCCAGCATTTT	CASSGDNSKPQHF	TRBV2	TRBJ1-5
TGTGCCAGCAAAGCCGACACTGAGCAGTACTTC	CASKADTEQYF	TRBV6-2	TRBJ2-7
TGCAGTGCTAGAGACCCGGGACAGGGGGCTTGGAACACTGAAGCTTTCTTT	CSARDPGQGAWNTEAFF	TRBV20-1	TRBJ1-1
TGTGCCTGGAGTGTAGGTCCAGGGAGCCTAAGCACTGAAGCTTTCTTT	CAWSVGPGSLSTEAFF	TRBV30	TRBJ1-1
TGTGCCAGTAGTCAGGAGAAGCCGAGCTCCTATAATTCACCCCTCCACTTT	CASSQEKPSSYNSPLHF	TRBV19	TRBJ1-6
TGCGCCAGCACCCAGGGGAGGAACGAGCAGTACTTC	CASTQGRNEQYF	TRBV10-1	TRBJ2-7
TGTGCCAGCAGCCTGGAGAATGACAGGGGTAGCAATCAGCCCCAGCATTTT	CASSLENDRGSNQPQHF	TRBV5-6	TRBJ1-5
TGTGCCAGCAGCAAACATCTAGGATACAATGAGCAGTTCTTC	CASSKHLGYNEQFF	TRBV13	TRBJ2-1
TGTGCCAGCAGCGAAGCCGCAGGGGGATCAAACACTGAAGCTTTCTTT	CASSEAAGGSNTEAFF	TRBV9	TRBJ1-1
TGCGCCATATACCCGGGACAGACCGGGAGCTCCTATAATTCACCCCTCCACTTT	CAIYPGQTGSSYNSPLHF	TRBV4-3	TRBJ1-6
TGTGCCAGCAGGGTGTTAGCGGGTCCGCAAAGCACAGATACGCAGTATTTT	CASRVLAGPQSTDTQYF	TRBV28	TRBJ2-3
TGCAGTCCCCGGGCCCAGGGATTTTCTTATCAGCCCCAGCATTTT	CSPRAQGFSYQPQHF	TRBV20-1	TRBJ1-5
TGTGCCAGCAGCGGCCGGGACAGGGAGTGGTACGAGCAGTACTTC	CASSGRDREWYEQYF	TRBV11-2	TRBJ2-7
TGTGCCAGCAGCTTAGATATTCGGGACAGTTGTTCGGGCTCCTACGAGCAGTACTTC	CASSLDIRDSCSGSYEQYF	TRBV11-3	TRBJ2-7
TGTGCCAGTAGTAGACTAGCGGGCGGGACCGGGGAGCTGTTTTTT	CASSRLAGGTGELFF	TRBV19	TRBJ2-2
TGTGCCAGCTCACGAGGGCTCCGGGATAGCAATCAGCCCCAGCATTTT	CASSRGLRDSNQPQHF	TRBV18	TRBJ1-5
TGCGCCAGCAGCCAAGAAAACCTCCATTCGAATTACGAGGGCGGGGGCTACGAGCAGTACTTC	CASSQENLHSNYEGGGYEQYF	TRBV4-3	TRBJ2-7
TGTGCCAGCAGCCAAGATACAGGGCATCAGCCCCAGCATTTT	CASSQDTGHQPQHF	TRBV3-1	TRBJ1-5
TGTGCCAGCAGTATGACAGGGTCCTACGAGCAGTACTTC	CASSMTGSYEQYF	TRBV6-2	TRBJ2-7
TGTGCCAGCAGCTTATACGGGGACAGGGGGGGGGAGCTGTTTTTT	CASSLYGDRGGELFF	TRBV7-9	TRBJ2-2
TGCAGTGCAGGAAGGAGGTTTTCGCACGAGCAGTACTTC	CSAGRRFSHEQYF	TRBV20-1	TRBJ2-7
TGCGCCGGGCCGGGTGGCTACACCTTC	CAGPGGYTF	TRBV5-1	TRBJ1-2
TGTGCCAGCCCCTCGGGGCCCTTCTCACCCCTCCACTTT	CASPSGPFSPLHF	TRBV25-1	TRBJ1-6
TGCGCCAGCAGCCCCGCACTGGACAGGGCATCCGTTACGCAGTATTTT	CASSPALDRASVTQYF	TRBV5-1	TRBJ2-3
TGTGCCAGCACCCCAAGGGACAGCAATCAGCCCCAGCATTTT	CASTPRDSNQPQHF	TRBV9	TRBJ1-5
TGTGCCAGCAGAGGGGGGGTCAGCTCCTACAATGAGCAGTTCTTC	CASRGGVSSYNEQFF	TRBV6-5	TRBJ2-1
TGTGCCAGCAGCCAAGCACGTTCGCGTGGTGGAAACACCATATATTTT	CASSQARSRGGNTIYF	TRBV3-1	TRBJ1-3
TGCGCCAGCAGCTTGACAAGACAGGATAGCAATCAGCCCCAGCATTTT	CASSLTRQDSNQPQHF	TRBV5-1	TRBJ1-5
TGTGCCAGCAGCGTACCCGGGGTGATATCAAACTACGAGCAGTACTTC	CASSVPGVISNYEQYF	TRBV5-8	TRBJ2-7
TGCAGTGCTACTGTCTACGAGCAGTACTTC	CSATVYEQYF	TRBV20-1	TRBJ2-7
TGCGCCAGCAGCTGGACGATAGTCCGCTCCTACAATGAGCAGTTCTTC	CASSWTIVRSYNEQFF	TRBV5-1	TRBJ2-1
TGTGCCAGCAGCTACGGCGGCTACACCTTC	CASSYGGYTF	TRBV6-1	TRBJ1-2
TGTGCCAGCAGCCTTCCCCACCGGGATTTATCCTACGAGCAGTACTTC	CASSLPHRDLSYEQYF	TRBV5-4	TRBJ2-7
TGCGCCAGCAGCCAAGGGGGGGGTAGGAAATGCTACGAGCAGTACTTC	CASSQGGGRKCYEQYF	TRBV4-3	TRBJ2-7
TGCGCCAGCAGGCGGACAGGGGGCGTTTCTGGAAACACCATATATTTT	CASRRTGGVSGNTIYF	TRBV10-1	TRBJ1-3
TGTGCCAGTAGTATAGCAGGGGACCGCTCGGCCACCGGGGAGCTGTTTTTT	CASSIAGDRSATGELFF	TRBV19	TRBJ2-2
TGTGCCACCAAAAACCTAGCGGGGGGGACAGATACGCAGTATTTT	CATKNLAGGTDTQYF	TRBV24-1	TRBJ2-3
TGTGCCAGCAGCGAGGGAGGGACGAGAAGCTCCTACAATGAGCAGTTCTTC	CASSEGGTRSSYNEQFF	TRBV5-6	TRBJ2-1
TGTGCCAGCAGCTTCTCCACACTCGGGAGTTGGGACAGTGCTCCCAAAAGCAATCAGCCCCAGCATTTT	CASSFSTLGSWDSAPKSNQPQHF	TRBV11-2	TRBJ1-5
TGTGCCAGCAGTTACAGACCCGGGACACATAATGAAAAACTGTTTTTT	CASSYRPGTHNEKLFF	TRBV6-6	TRBJ1-4
TGTGCCAGCGGACTAGCGGGTTCTAACTACGAGCAGTACTTC	CASGLAGSNYEQYF	TRBV25-1	TRBJ2-7
TGCGCCAGCACTGTGTCGTGGGGGGACGCTGGAAACACCATATATTTT	CASTVSWGDAGNTIYF	TRBV5-1	TRBJ1-3
TGTGCCAGCAGCCCGAGGGAGCAGTACTTC	CASSPREQYF	TRBV3-1	TRBJ2-7
TGTGCCGAAACGACAGGGGGAGCGAGTCGTGGCTACACCTTC	CAETTGGASRGYTF	TRBV27	TRBJ1-2
TGTGCCAGCAGTGGCCCGACTAGCGGGGGGGCATGGGAGACCCAGTACTTC	CASSGPTSGGAWETQYF	TRBV25-1	TRBJ2-5
TGTGCCAGCAGGGCTGGTAGTTCGCCGGGACTAGCGGGGGGCCCCATGCCCTGTGGACAAGAGACCCAGTACTTC	CASRAGSSPGLAGGPMPCGQETQYF	TRBV6-4	TRBJ2-5
TGTGCCAGAGGACAAGTAGCTAGTAACGCTTTCTTT	CARGQVASNAFF	TRBV9	TRBJ1-1
TGTGCCATCAGTGAGCAGGGACTTACAAGACGTTACGAGCAGTACTTC	CAISEQGLTRRYEQYF	TRBV10-3	TRBJ2-7
TGCAGTGCTAGGACAGGACAGGGACGTACTTCACCCCTCCACTTT	CSARTGQGRTSPLHF	TRBV20-1	TRBJ1-6
TGTGCCAGCAGTGAAGCGACCCCCAGGGACAGGGGGGATCAAGAGACCCAGTACTTC	CASSEATPRDRGDQETQYF	TRBV2	TRBJ2-5
TGTGCCAGCAGCTTAACGGGACGGAACACTGAAGCTTTCTTT	CASSLTGRNTEAFF	TRBV5-6	TRBJ1-1
TGTGCCAGCAGCCATCGGGCCAAGGGACAGAGCTCTGGGGCCAACGTCCTGACTTTC	CASSHRAKGQSSGANVLTF	TRBV14	TRBJ2-6
TGTGCCAGCAGCACGGTACCGGGACAGGGGGGGTCTGAAGCTTTCTTT	CASSTVPGQGGSEAFF	TRBV7-2	TRBJ1-1
TGCGCCAGCTATTCAGCAGTGATGAGTGCGAACACCGGGGAGCTGTTTTTT	CASYSAVMSANTGELFF	TRBV10-1	TRBJ2-2
TGTGCCACCAGTCGGAGAACTAGCGGGAGGACGGATGGCTACACCTTC	CATSRRTSGRTDGYTF	TRBV24-1	TRBJ1-2
TGTGCCAGCAGCCAAGACCGGGACAGGGGCGACCGCACAGATACGCAGTATTTT	CASSQDRDRGDRTDTQYF	TRBV4-2	TRBJ2-3
TGTGCCAGCAGCTGTCCAGGGGGGGGGTACGAGCAGTACTTC	CASSCPGGGYEQYF	TRBV5-6	TRBJ2-7
TGTGCCAGCAGCGGTCAGGGGGGCGTAGTACCCGATGGTTTCGAGCAGTACTTC	CASSGQGGVVPDGFEQYF	TRBV3-1	TRBJ2-7
TGTGCCACCAGTGATTTGCCTCGTCAGGTAAACTATGGCTACACCTTC	CATSDLPRQVNYGYTF	TRBV24-1	TRBJ1-2
TGTGCCACCGGTGCAGGGGGCCGTGAGCAGTACTTC	CATGAGGREQYF	TRBV27	TRBJ2-7
TGTGCCAGTAGTACGGGACAGGGAGGTATGAACACTGAAGCTTTCTTT	CASSTGQGGMNTEAFF	TRBV19	TRBJ1-1
TGTGCCAGCAGGGAGTGCCCCTACGAGCAGTACTTC	CASRECPYEQYF	TRBV6-2	TRBJ2-7
TGTGCCAGCAGCTTAGCCCCAGGGGAGAACACTGAAGCTTTCTTT	CASSLAPGENTEAFF	TRBV7-2	TRBJ1-1
TGCGCCAGCAGCTTCAAAGACCCGGGCCCCGGGGAGGAGCTGTTTTTT	CASSFKDPGPGEELFF	TRBV5-1	TRBJ2-2
TGTGCCAGCAGGGGCACCAGAGGGAACTATGGCTACACCTTC	CASRGTRGNYGYTF	TRBV6-2	TRBJ1-2
TGTGCCATCAGTGGGACAGGCTACGAGCAGTACTTC	CAISGTGYEQYF	TRBV10-3	TRBJ2-7
TGTGCCAGCAGCCCGGGGCACACAGATACGCAGTATTTT	CASSPGHTDTQYF	TRBV11-2	TRBJ2-3
TGTGCCTGGAGTGACATGCGGTATGGCACTGAAGCTTTCTTT	CAWSDMRYGTEAFF	TRBV30	TRBJ1-1
TGTGCCAGCAGTTTCCACCGGGACAGGGAGTCCACTGAAGCTTTCTTT	CASSFHRDRESTEAFF	TRBV6-3	TRBJ1-1
TGTGCCAGCAGTAAGGAGTTACTCCGACAGGGGCACTCTGGGGCCAACGTCCTGACTTTC	CASSKELLRQGHSGANVLTF	TRBV28	TRBJ2-6
TGTGCCAGCCCAGGGGGCAGGACCCTTCTGAACACTGAAGCTTTCTTT	CASPGGRTLLNTEAFF	TRBV7-3	TRBJ1-1
TGCAGTGCACAGGGCGCTGGGCCCTACGAGCAGTACTTC	CSAQGAGPYEQYF	TRBV20-1	TRBJ2-7
TGCGCCAGCAGCCAAGAAGTGCCACCTTGGCATTTCTCCTACAATGAGCAGTTCTTC	CASSQEVPPWHFSYNEQFF	TRBV4-1	TRBJ2-1
TGTGCCAGCAGCCGTCCGGGGGATCGCCCACACGGGGAGCTGTTTTTT	CASSRPGDRPHGELFF	TRBV13	TRBJ2-2
TGTGCCAGCACTTTCAGGGTTGAAGCTTTCTTT	CASTFRVEAFF	TRBV28	TRBJ1-1
TGCGCCAGCAGCTTTGCATCTATTCCGGGACAGGATAGGGAAGCTAACTATGGCTACACCTTC	CASSFASIPGQDREANYGYTF	TRBV5-1	TRBJ1-2
TGTGCCAGCAGTGACCACAGGGGAGGACCAAACACCATATATTTT	CASSDHRGGPNTIYF	TRBV2	TRBJ1-3
TGCGCCAGCAGCTTTAATGGAGGGGAAAATCTAGCCAAAAACATTCAGTACTTC	CASSFNGGENLAKNIQYF	TRBV5-1	TRBJ2-4
TGTGCCAGCAGCTTAGCCAACGGAGCCTGGGGGCTGTGGTACGAGCAGTACTTC	CASSLANGAWGLWYEQYF	TRBV7-9	TRBJ2-7
TGTGCCAGCAGCAGTTCTTGGATTCTGGGTGTCCGCACAGATACGCAGTATTTT	CASSSSWILGVRTDTQYF	TRBV7-9	TRBJ2-3
TGTGCCAGCATTACATCCCGGGGCTTAGCAACTAATGAAAAACTGTTTTTT	CASITSRGLATNEKLFF	TRBV27	TRBJ1-4
TGTGCCCGGTCAAAACTAGCGGGAGAGGGGGGCTACACCTTC	CARSKLAGEGGYTF	TRBV9	TRBJ1-2
TGTGCCAGCAGCCCACCGGGACAGGGTGCCTCTGGAAACACCATATATTTT	CASSPPGQGASGNTIYF	TRBV28	TRBJ1-3
TGCAGCGTTGCCTCAGGTAATGGCTACACCTTC	CSVASGNGYTF	TRBV29-1	TRBJ1-2
TGCGCCAGGAGGGAAAGAAGCTCCTACAATGAGCAGTTCTTC	CARRERSSYNEQFF	TRBV10-1	TRBJ2-1
TGTGCCAGCAGCCTATCATACACTTGTCAAGAGACCCAGTACTTC	CASSLSYTCQETQYF	TRBV11-2	TRBJ2-5
TGTGCCAGCTCTTCTAGCGGGGGTGGCTACAATGAGCAGTTCTTC	CASSSSGGGYNEQFF	TRBV6-4	TRBJ2-1
TGTGCCAGCAGTTCCCCGCTTGCTCGGGACAGGGGGAGGGACGAGCAGTACTTC	CASSSPLARDRGRDEQYF	TRBV6-5	TRBJ2-7
TGTGCCAGGGTGACCAGACAGGGGGTGGTTAGCAATCAGCCCCAGCATTTT	CARVTRQGVVSNQPQHF	TRBV25-1	TRBJ1-5
TGTGCCAGCAGTGAAAAACGTACTAGCGGGGTGGAGCTCAATGAGCAGTTCTTC	CASSEKRTSGVELNEQFF	TRBV6-1	TRBJ2-1
TGTGCCAGCAGCGTAGCGGAGTACGAGCAGTACTTC	CASSVAEYEQYF	TRBV9	TRBJ2-7
TGCGCCAGCCGGACGGGACAGTCGTTTGGCTACACCTTC	CASRTGQSFGYTF	TRBV5-1	TRBJ1-2
TGTGCCAGCAGCTTTGACAGGGAAGCCTACGAGCAGTACTTC	CASSFDREAYEQYF	TRBV7-7	TRBJ2-7
TGCAGTGCTAGAGATTCAGGGACTAGCGGGTCAAACACCGGGGAGCTGTTTTTT	CSARDSGTSGSNTGELFF	TRBV20-1	TRBJ2-2
TGTGCCAGCAGTGACAGGAGAGACGAGCAGTACTTC	CASSDRRDEQYF	TRBV27	TRBJ2-7
TGTGCCAGCAGCCTCGGGGACCTATCCGGAGATACGCAGTATTTT	CASSLGDLSGDTQYF	TRBV7-8	TRBJ2-3
TGCGCCAGCAGCCAAGAGGGCCCGGGACAGGGTTTTTCACCCCTCCACTTT	CASSQEGPGQGFSPLHF	TRBV4-1	TRBJ1-6
TGTGCCTGGAGTGTACAGGTACGAGTAGAGACCCAGTACTTC	CAWSVQVRVETQYF	TRBV30	TRBJ2-5
TGTGCCACCAGTGCCGAGATGACGGGGCGCGGTAACTATGGCTACACCTTC	CATSAEMTGRGNYGYTF	TRBV24-1	TRBJ1-2
TGTGCCAGCAGCTTAGGGATCGACCAGCGAGGCCATGGCTACACCTTC	CASSLGIDQRGHGYTF	TRBV11-3	TRBJ1-2
TGTGCCACCCCCCGTTTCAGACAGGGGCTGGGGTCACCCCTCCACTTT	CATPRFRQGLGSPLHF	TRBV27	TRBJ1-6
TGTGCCAGCAGCCCGCTTCCAGAGTACTTC	CASSPLPEYF	TRBV3-1	TRBJ2-7
TGTGCCAGCAGCGGGGGGGCCGGGGAAAAACTGTTTTTT	CASSGGAGEKLFF	TRBV11-2	TRBJ1-4
TGTGCCAGCAGCCGGGATGGCTTCGCGGGAGTAACACACGAGCAGTACTTC	CASSRDGFAGVTHEQYF	TRBV11-2	TRBJ2-7
TGCATGAGTTGGGGCCTTCAAATAGGTAACTATGGCTACACCTTC	CMSWGLQIGNYGYTF	TRBV20-1	TRBJ1-2
TGCAGCGTTATCGTTGGAGGGGGGGGCGGCTATGGCTACACCTTC	CSVIVGGGGGYGYTF	TRBV29-1	TRBJ1-2
TGTGCCAGCGAAGAGGGGGCTTTCTTT	CASEEGAFF	TRBV6-1	TRBJ1-1
TGCGCCAGCACCGCGGGTAGGGTTAATGAGCAGTTCTTC	CASTAGRVNEQFF	TRBV10-2	TRBJ2-1
TGTGCCAGCACCTCCCAGAGGACCAAAAACATTCAGTACTTC	CASTSQRTKNIQYF	TRBV6-5	TRBJ2-4
TGTGCCAGCAGTTTTTTGACAAAATCCCCAGAGGCCAATGAGCAGTTCTTC	CASSFLTKSPEANEQFF	TRBV6-2	TRBJ2-1
TGCAGCGTCCAAGGGACAGGGCAGTATAGCAATCAGCCCCAGCATTTT	CSVQGTGQYSNQPQHF	TRBV29-1	TRBJ1-5
TGTGCTAGTGGTTTGGTAAGACAGGAAAAACTGTTTTTT	CASGLVRQEKLFF	TRBV12-5	TRBJ1-4
TGCGCCAGCAGCTTGATGAGGGGATTTAAGGGTTTCGGAACTTTTAATGAAAAACTGTTTTTT	CASSLMRGFKGFGTFNEKLFF	TRBV5-1	TRBJ1-4
TGTGCCAGCAGCTTTCTCTACGAGCAGTACTTC	CASSFLYEQYF	TRBV9	TRBJ2-7
TGTGCCAGCAGCTTGGCGGGTAGGAGGCAGGGGTCCGGGACCCACATTCAGTACTTC	CASSLAGRRQGSGTHIQYF	TRBV5-6	TRBJ2-4
TGTGCCAGCAGCCGGGAGGGGTGCTACACCTTC	CASSREGCYTF	TRBV7-3	TRBJ1-2
TGTGCCACCATCGGGGGAATCTGCTACACCTTC	CATIGGICYTF	TRBV24-1	TRBJ1-2
TGCGCCAGCAGCCAGGGGTACGGCTCCTATAATTCACCCCTCCACTTT	CASSQGYGSYNSPLHF	TRBV4-1	TRBJ1-6
TGTGCCAGCAGTATGGGATATCATTTCGAGCAGTACTTC	CASSMGYHFEQYF	TRBV7-2	TRBJ2-7
TGCAGTGCTAGAGCCTCACGACTTTTTCGAAGCTCCTACGAGCAGTACTTC	CSARASRLFRSSYEQYF	TRBV20-1	TRBJ2-7
TGTGCCAGTAGTGGACAGCGGGAAAACTACGAGCAGTACTTC	CASSGQRENYEQYF	TRBV19	TRBJ2-7
TGTGCCAGACGGGACAGGGGGGGAAACTATGGCTACACCTTC	CARRDRGGNYGYTF	TRBV25-1	TRBJ1-2
TGTGCCATCGGGGACAGGAAGAGGACCAATCAGCCCCAGCATTTT	CAIGDRKRTNQPQHF	TRBV24-1	TRBJ1-5
TGTGCCAGCAGCCTAGCGGGCCGCGGGAGCTACGAGCAGTACTTC	CASSLAGRGSYEQYF	TRBV13	TRBJ2-7
TGCGCCAGCGCGCAGGGGGACTATGGCTACACCTTC	CASAQGDYGYTF	TRBV10-1	TRBJ1-2
TGTGCCACCAGTTCAGAGAAGGACACGCGAATAAGGAACACTGAAGCTTTCTTT	CATSSEKDTRIRNTEAFF	TRBV24-1	TRBJ1-1
TGTGCCAGCAGTGAGGTCCAGCCAGACACTGAAGCTTTCTTT	CASSEVQPDTEAFF	TRBV27	TRBJ1-1
TGTGCCAGCAGCCACCGACAGGGCACCGGGGAGCTGTTTTTT	CASSHRQGTGELFF	TRBV14	TRBJ2-2
TGCGCCAGCAGCCAAGCTTTATTCGGTGCAGATACGCAGTATTTT	CASSQALFGADTQYF	TRBV4-1	TRBJ2-3
TGTGCCAGCAGTTACCCTCTTCCGAAGCGAAAGGAGGGGGACGAGCAGTACTTC	CASSYPLPKRKEGDEQYF	TRBV6-3	TRBJ2-7
TGTGCCAGCAGTGCCTGCCCCTTGACAGGGGAGTCCCAGCATTTT	CASSACPLTGESQHF	TRBV12-3	TRBJ1-5
TGTGCCAGCAGGAAGGAGGCCCCTTTCTTT	CASRKEAPFF	TRBV6-4	TRBJ1-1
TGCAGTGCTAGGGGGGGCTTGCGATTTCCCCGGAGTATTACTCCAGAGACCCAGTACTTC	CSARGGLRFPRSITPETQYF	TRBV20-1	TRBJ2-5
TGTGCCAGCAGCACTAATGGACGTAATTCACCCCTCCACTTT	CASSTNGRNSPLHF	TRBV7-9	TRBJ1-6
TGTGCCAGCAGTTTGGACAGGGCCTACGAGCAGTACTTC	CASSLDRAYEQYF	TRBV27	TRBJ2-7
TGTGCCAGCAGCTTAGTTGGGGCTCAGCCCCAGCATTTT	CASSLVGAQPQHF	TRBV7-6	TRBJ1-5
TGTGCCAGCAGTGACCGGACAGGGGGCCAGAGCAATCAGCCCCAGCATTTT	CASSDRTGGQSNQPQHF	TRBV6-4	TRBJ1-5
TGTGCCAGCAGCTATATAGCGGCGGGCGCGAGCTCCTACAATGAGCAGTTCTTC	CASSYIAAGASSYNEQFF	TRBV13	TRBJ2-1
TGTGCCAGCAGCTGGGACAAGGGGTACGAGCAGTACTTC	CASSWDKGYEQYF	TRBV27	TRBJ2-7
TGTGCCATTCGGGGGGGAAACACCGGGGAGCTGTTTTTT	CAIRGGNTGELFF	TRBV28	TRBJ2-2
TGTGCCAGCAGCCAAGAGAGGGGCACTGAAGCTTTCTTT	CASSQERGTEAFF	TRBV3-1	TRBJ1-1
TGCAGTGCTAGAGATCCCCTTCCGGGCCGAGATACGCAGTATTTT	CSARDPLPGRDTQYF	TRBV20-1	TRBJ2-3
TGCAGCGTTGGCCCCCGGGGGATCTGGAACACTGAAGCTTTCTTT	CSVGPRGIWNTEAFF	TRBV29-1	TRBJ1-1
TGTGCCAGCAGCTCCGGGACCTTCTACGAGCAGTACTTC	CASSSGTFYEQYF	TRBV5-6	TRBJ2-7
TGTGCCAGCAGTGCGGCAACGGAGGAGCAGTACTTC	CASSAATEEQYF	TRBV6-4	TRBJ2-7
TGTGCCATCAGTGAGAGTACCTACGAGCAGTACTTC	CAISESTYEQYF	TRBV10-3	TRBJ2-7
TGTGCCAAGCGAGGGGTAAGGGGAGCTAATGAAAAACTGTTTTTT	CAKRGVRGANEKLFF	TRBV7-9	TRBJ1-4
TGTGCCAGCACCAGGGCGTCACACAGGGGCGAAAAACTGTTTTTT	CASTRASHRGEKLFF	TRBV6-4	TRBJ1-4
TGTGCCTGGAGTGAACCTAGCGGGAAGATGAGATTAATGGGCGGGGAGCTGTTTTTT	CAWSEPSGKMRLMGGELFF	TRBV30	TRBJ2-2
TGTGCCAGCAGCAACCGGGACAGGGGACCGCAGTACTTC	CASSNRDRGPQYF	TRBV5-6	TRBJ2-7
TGCGCCAGCAGCAAATTCACCGGGACAGGCACTGAAGCTTTCTTT	CASSKFTGTGTEAFF	TRBV5-1	TRBJ1-1
TGTGCCAGCAGCTTAGAGCAGTTCTACGAGCAGTACTTC	CASSLEQFYEQYF	TRBV7-4	TRBJ2-7
TGTGCCAGCTCCATCGAGCCCCCAACTGAAGCTTTCTTT	CASSIEPPTEAFF	TRBV18	TRBJ1-1
TGTGCCAGCAGAATAGAATGGGGGGAAGCTTTCTTT	CASRIEWGEAFF	TRBV27	TRBJ1-1
TGCGCCAGCAGCTTGGATGGGGGGGGTGCCTACGAGCAGTACTTC	CASSLDGGGAYEQYF	TRBV5-1	TRBJ2-7
TGCAGTGCTAGAGTCCTATATTCTAACTATGGCTACACCTTC	CSARVLYSNYGYTF	TRBV20-1	TRBJ1-2
TGCGCCAGCAGCTCACGAGGGGGGTCCCAGGAGACCCAGTACTTC	CASSSRGGSQETQYF	TRBV10-1	TRBJ2-5
TGTGCTAGCAGCTTGTCGGGACACATGAGCCTATCCTACGAGCAGTACTTC	CASSLSGHMSLSYEQYF	TRBV7-7	TRBJ2-7
TGTGCCAGTAGTAATCACTCGACTAGAGATTCAGGATTCCGCTCCTACAATGAGCAGTTCTTC	CASSNHSTRDSGFRSYNEQFF	TRBV19	TRBJ2-1
TGTGCGGGGACAGGGCAGGGGCGGCGGTCACCCCTCCACTTT	CAGTGQGRRSPLHF	TRBV27	TRBJ1-6
TGTGCCAGCAGCTTAGCGCTGCCTGCAGAGCACCCGGCTGGGGCCAACGTCCTGACTTTC	CASSLALPAEHPAGANVLTF	TRBV7-9	TRBJ2-6
TGTGCCAGCCGACACATGGGCTACAATGAGCAGTTCTTC	CASRHMGYNEQFF	TRBV7-2	TRBJ2-1
TGCAGTGCTACGGGGGAGTTTGCACTCCTGAAGTACTTC	CSATGEFALLKYF	TRBV20-1	TRBJ2-4
TGTGCCAGCAGCAAGGGCGGGCGGTCTTTCTTT	CASSKGGRSFF	TRBV5-8	TRBJ1-1
TGTGCCAGCAGCGAAAGGGGAGAGACCCAGTACTTC	CASSERGETQYF	TRBV7-3	TRBJ2-5
TGCGCCAGCAGCCAAGTAACGGGGGGAGCTCGCAATCAGCCCCAGCATTTT	CASSQVTGGARNQPQHF	TRBV4-1	TRBJ1-5
TGTGCCAGCAGCGGGACAGGGGGGGACTCATTCCCAGATACGCAGTATTTT	CASSGTGGDSFPDTQYF	TRBV5-5	TRBJ2-3
TGCGCCAGCAGCCAAGAAGACGACAGGGGCGAGGGTAAATTTGAAGCTTTCTTT	CASSQEDDRGEGKFEAFF	TRBV4-1	TRBJ1-1
TGCGCCACGAATTCTAGGGGGCCCCTAGACTATGGCTACACCTTC	CATNSRGPLDYGYTF	TRBV10-1	TRBJ1-2
TGTGCCAGCAGCTTAGGATTTGGGGGGGTCACAGATACGCAGTATTTT	CASSLGFGGVTDTQYF	TRBV7-2	TRBJ2-3
TGCGCCAGCAGCTTGCCTGTTAAAAACATTCAGTACTTC	CASSLPVKNIQYF	TRBV5-1	TRBJ2-4
TGCGCCAGCACGGGCCGGGACACGCAGTATTTT	CASTGRDTQYF	TRBV10-1	TRBJ2-3
TGTTCGGGGGGAGACAATGAGCAGTTCTTC	CSGGDNEQFF	TRBV14	TRBJ2-1
TGTGCCATCTCCCTCCACTTAGGGAGGGCCCGCAATGAGCAGTTCTTC	CAISLHLGRARNEQFF	TRBV7-9	TRBJ2-1
TGTGCCAGCAGTGGAAATCAGAGAGGTCAGCCCAATCAGCCCCAGCATTTT	CASSGNQRGQPNQPQHF	TRBV6-1	TRBJ1-5
TGTGCCAGCAGCTTAATTATTGAGTATGAGCAGTTCTTC	CASSLIIEYEQFF	TRBV7-9	TRBJ2-1
TGTGCCAGCAGCGGTGACAGAGGGGCTTTCCAAGAGACCCAGTACTTC	CASSGDRGAFQETQYF	TRBV9	TRBJ2-5
TGCGCCAGCAGCAAGCAGGGTGATGAAAAACTGTTTTTT	CASSKQGDEKLFF	TRBV5-1	TRBJ1-4
TGTGCCACCAGTGATGCGACAGGGCATCTGGGTACCGAGTACAATGAGCAGTTCTTC	CATSDATGHLGTEYNEQFF	TRBV24-1	TRBJ2-1
TGCAGTGCTAGGGGGGGGGACAGGGCGGACTCTGGAAACACCATATATTTT	CSARGGDRADSGNTIYF	TRBV20-1	TRBJ1-3
TGTGCCAGCAGCTTGCGGACTAGCGGGAGGCTTTCGCAGTACTTC	CASSLRTSGRLSQYF	TRBV11-2	TRBJ2-7
TGTGCCAGCAGCTCCACGACAGTTCCGTACGAGCAGTACTTC	CASSSTTVPYEQYF	TRBV7-3	TRBJ2-7
TGTGCCATCATAGCGGACGCTAGCACAGATACGCAGTATTTT	CAIIADASTDTQYF	TRBV10-3	TRBJ2-3
TGTGCCTGGAGCTCGGGACTAGCGGGGACCTACAATGAGCAGTTCTTC	CAWSSGLAGTYNEQFF	TRBV30	TRBJ2-1
TGTGCCACCAGTGAACGTAGCGGGTGGGACAATGAGCAGTTCTTC	CATSERSGWDNEQFF	TRBV24-1	TRBJ2-1
TGTGCCAGCAGCCAAAACAGGGAAAAGAACACTGAAGCTTTCTTT	CASSQNREKNTEAFF	TRBV7-8	TRBJ1-1
TGTGCCAGCAGTCCATCAATTGGGGGGGTTTGGACAGGCGGGGAGCTGTTTTTT	CASSPSIGGVWTGGELFF	TRBV6-3	TRBJ2-2
TGTGCCAGCAGCTGGCAGCCCGGAAACACCATATATTTT	CASSWQPGNTIYF	TRBV5-6	TRBJ1-3
TGTGCCAGCAGCTTGCGGGAGAGAAATCAGCCCCAGCATTTT	CASSLRERNQPQHF	TRBV13	TRBJ1-5
TGTGCCAGGAGCAATAGGGGGGGGGCATCCTACGAGCAGTACTTC	CARSNRGGASYEQYF	TRBV28	TRBJ2-7
TGTGCCAGTGGCCGGGACAGGGAACACGTCGGGGAGCTGTTTTTT	CASGRDREHVGELFF	TRBV19	TRBJ2-2
TGTGCCACCAGTGATCGCGGGACAGGGTCAGATTCACCCCTCCACTTT	CATSDRGTGSDSPLHF	TRBV24-1	TRBJ1-6
TGTGCCAGCAGGGACGGGGGACCACAAGAGACCCAGTACTTC	CASRDGGPQETQYF	TRBV11-3	TRBJ2-5
TGTGCCAGCAGCCTCGGAGGGCCCCGCTGCGGGGAAGATCCCAAGTACTTC	CASSLGGPRCGEDPKYF	TRBV5-5	TRBJ2-7
TGCAAAACTCACAGGGAAGAGGCTGAAGCTTTCTTT	CKTHREEAEAFF	TRBV20-1	TRBJ1-1
TGTGCCAGCAGTTTCGCGACTAGGATGACGAATGAGCAGTTCTTC	CASSFATRMTNEQFF	TRBV28	TRBJ2-1
TGTGCCGGACCGGGTCTACAGGGATTCTATGGCTACACCTTC	CAGPGLQGFYGYTF	TRBV27	TRBJ1-2
TGTGCCAGCAACCCTAGTGACTACGAGCAGTACTTC	CASNPSDYEQYF	TRBV28	TRBJ2-7
TGTGCCAGCAGCCCCCCACGGGGTGGCTACACCTTC	CASSPPRGGYTF	TRBV3-1	TRBJ1-2
TGTGCCAGCACCACACTAGCGGGAGATTCCCCAAGCTCCTATAATTCACCCCTCCACTTT	CASTTLAGDSPSSYNSPLHF	TRBV7-9	TRBJ1-6
TGCGCCAGCAGCTTGGTCGGTTGGATCGGGAGAATGCGCACAGATACGCAGTATTTT	CASSLVGWIGRMRTDTQYF	TRBV5-1	TRBJ2-3
TGCGCCAGCAGCCAAGTCTTCGACAGGGTTGTGCAGTACTTC	CASSQVFDRVVQYF	TRBV4-1	TRBJ2-5
TGTGCCAGCAGCTTAGCACTAGGGGTTGCATCCAGCTCCTACAATGAGCAGTTCTTC	CASSLALGVASSSYNEQFF	TRBV7-2	TRBJ2-1
TGCGCCAGCGCAGGGGGACTTGGCTACACCTTC	CASAGGLGYTF	TRBV10-1	TRBJ1-2
TGTGCCAGCAGCTATCCTGGGGATAGCAATCAGCCCCAGCATTTT	CASSYPGDSNQPQHF	TRBV9	TRBJ1-5
TGTGCCAGCTCACCATCCGAGAATGAGGGGACAGCCAAGGGGCAGGGGCCTAACTATGGCTACACCTTC	CASSPSENEGTAKGQGPNYGYTF	TRBV18	TRBJ1-2
TGTGCCACGGTAGGATTGGGGAACACCGGGGAGCTGTTTTTT	CATVGLGNTGELFF	TRBV24-1	TRBJ2-2
TGTGCCAGCAGCGTATCATACGGGAGCCTTCGCTCTGGAAACACCATATATTTT	CASSVSYGSLRSGNTIYF	TRBV9	TRBJ1-3
TGTGCCAGCAGTGAATATTTTGGGGGGCCTTCTAACTATGGCTACACCTTC	CASSEYFGGPSNYGYTF	TRBV25-1	TRBJ1-2
TGTGCCAGCAGTTACGCCGCCCCCGTAGGTAGCTCCTACAATGAGCAGTTCTTC	CASSYAAPVGSSYNEQFF	TRBV6-8	TRBJ2-1
TGTGCCAGCAGTGGGACGGACGGAAACTACGAGCAGTACTTC	CASSGTDGNYEQYF	TRBV6-2	TRBJ2-7
TGTGCCAGCAGTGGACGGTTTGCTCTAAATGGCTACACCTTC	CASSGRFALNGYTF	TRBV25-1	TRBJ1-2
TGTGCCAGCAGCGGCGGACTAGCGGATCTGTACAATGAGCAGTTCTTC	CASSGGLADLYNEQFF	TRBV7-3	TRBJ2-1
TGTGCCAGCAGCTTCCTTAAGCCAATACCGGGACGCTATGGCTACACCTTC	CASSFLKPIPGRYGYTF	TRBV5-6	TRBJ1-2
TGTGCCAGCAGTTACACAGGGGTTCATGGCTACACCTTC	CASSYTGVHGYTF	TRBV6-5	TRBJ1-2
TGTGCGGGTTTTGAAAAACTGTTTTTT	CAGFEKLFF	TRBV24-1	TRBJ1-4
TGTGCCAGCCCCCCCCGAGTCGAGGGAGGGCTGTTGGATTACAATGAGCAGTTCTTC	CASPPRVEGGLLDYNEQFF	TRBV27	TRBJ2-1
TGTGCCAGCAGCGAGGACTGCACTGAAGCTTTCTTT	CASSEDCTEAFF	TRBV6-4	TRBJ1-1
TGTGCCACGGCCCCCGGGGTATCCGACAACGATAGCAATCAGCCCCAGCATTTT	CATAPGVSDNDSNQPQHF	TRBV2	TRBJ1-5
TGTGCCAGCAGCTTAGCAGGGGGAGCCTACGAGCAGTACTTC	CASSLAGGAYEQYF	TRBV7-9	TRBJ2-7
TGTGCCAGCAGTTACACCTTAAGGGGCGATACTAGCGTAACTGAAGCTTTCTTT	CASSYTLRGDTSVTEAFF	TRBV6-5	TRBJ1-1
TGCGCCAGCAGCTTGGTAACAACTCAGAAGGACCCAGCCAAAAACATTCAGTACTTC	CASSLVTTQKDPAKNIQYF	TRBV5-1	TRBJ2-4
TGTGCCAGCAGCCATCCAAGGGAACACACTGAAGCTTTCTTT	CASSHPREHTEAFF	TRBV14	TRBJ1-1
TGTGCCAGCAGCGTAACAGTTTGGAGCTCCCGGATACTCACTGAAGCTTTCTTT	CASSVTVWSSRILTEAFF	TRBV9	TRBJ1-1
TGCGCCAGCAGCTTGTCAAGGACAGGGAGAGCCGGCTACACCTTC	CASSLSRTGRAGYTF	TRBV5-1	TRBJ1-2
TGTGCCAGCAGGGTGGAAGGGACTAGCGGGTCCACAGATACGCAGTATTTT	CASRVEGTSGSTDTQYF	TRBV9	TRBJ2-3
TGCGCCAGTCCCCAGGGTCATAATTCACCCCTCCACTTT	CASPQGHNSPLHF	TRBV4-1	TRBJ1-6
TGTGCCAGCAGGCCGCAGGGAGGGGGGGCTAACTATGGCTACACCTTC	CASRPQGGGANYGYTF	TRBV12-3	TRBJ1-2
TGTGCCAGCAGCCAGTTGGGGGGACATCAACGGGGCTACACCTTC	CASSQLGGHQRGYTF	TRBV14	TRBJ1-2
TGCAGCTCCGGCGTCCGATACAATGAGCAGTTCTTC	CSSGVRYNEQFF	TRBV29-1	TRBJ2-1
TGCGCCAGCAGCTTGCATAAGTTCAGCTCCTACAATGAGCAGTTCTTC	CASSLHKFSSYNEQFF	TRBV5-1	TRBJ2-1
TGTGCCAGCAGCGACAGGGTGGAACCCCTCCACTTT	CASSDRVEPLHF	TRBV9	TRBJ1-6
TGCGCCAGCAGCTTTCTGTGGGACAGGGGTTCTGAGCAGTACTTC	CASSFLWDRGSEQYF	TRBV5-1	TRBJ2-7
TGTGCCAGCAGGAGGGGGGGAGCCAATGAGCAGTTCTTC	CASRRGGANEQFF	TRBV14	TRBJ2-1
TGTGCCACCAGTGATTCTAGTAGGGGGGGGGCGGCCTACGAGCAGTACTTC	CATSDSSRGGAAYEQYF	TRBV24-1	TRBJ2-7
TGTGCCAGCAGCCAAAGACTAGCGGGCCAAAGGCAGCAAGAGACCCAGTACTTC	CASSQRLAGQRQQETQYF	TRBV14	TRBJ2-5
TGTGCCAGCAGTTTGACCCCTGACAGGCAGGAGACCCAGTACTTC	CASSLTPDRQETQYF	TRBV6-5	TRBJ2-5
TGTGCCACTGGACACGGGGGGATCCGAGAAATCTACAATGAGCAGTTCTTC	CATGHGGIREIYNEQFF	TRBV24-1	TRBJ2-1
TGCGCCAGCAGCCTGCGGGAGGGCTACGAGCAGTACTTC	CASSLREGYEQYF	TRBV5-1	TRBJ2-7
TGTGCCAGCAGCTCACCGGGACAGGGATTAGAGGATACAGATACGCAGTATTTT	CASSSPGQGLEDTDTQYF	TRBV7-2	TRBJ2-3
TGTGCCAGCAGTAGACCGGGATCTGGAAACACCATATATTTT	CASSRPGSGNTIYF	TRBV12-4	TRBJ1-3
TGTGCCAGCAGCTTAGTCAGGGGTAGAGGGGAGCTGTTTTTT	CASSLVRGRGELFF	TRBV11-2	TRBJ2-2
TGTGCCAGCAGCTTAAGGGGGGGACGACCACGGGGAGGCTATGGCTACACCTTC	CASSLRGGRPRGGYGYTF	TRBV7-9	TRBJ1-2
TGCGCCAGCAGCCTGATAATGCGGTTTCAAACCGGGGAGCTGTTTTTT	CASSLIMRFQTGELFF	TRBV4-1	TRBJ2-2
TGCAGTGCTATTCGAGACGCGGGAGGGCCCTACGAGCAGTACTTC	CSAIRDAGGPYEQYF	TRBV20-1	TRBJ2-7
TGTGCCAGCCAACTCATTCAAGTAACGCAGTATTTT	CASQLIQVTQYF	TRBV2	TRBJ2-3
TGTGCCAGCAGCGCCTGGTCGAATGGCTACACCTTC	CASSAWSNGYTF	TRBV6-5	TRBJ1-2
TGCGCCAGCAGCGCCCGCTCCCCCGCAACTAATGAAAAACTGTTTTTT	CASSARSPATNEKLFF	TRBV5-1	TRBJ1-4
TGTGCCAGCAATGGAAAGACGAATGGGGCCAACGTCCTGACTTTC	CASNGKTNGANVLTF	TRBV28	TRBJ2-6
TGTGCCTGGCTTGGAGGTCCGGAGCAGTACTTC	CAWLGGPEQYF	TRBV30	TRBJ2-7
TGCAGCGAATCGGGACAGGGAGGGCCTAGCAATCAGCCCCAGCATTTT	CSESGQGGPSNQPQHF	TRBV29-1	TRBJ1-5
TGTGCCACCCACGGCGACACAGATACGCAGTATTTT	CATHGDTDTQYF	TRBV24-1	TRBJ2-3
TGTGCCAGCAGTTACTCCTTTCCTCCGGGACACACTGAAGCTTTCTTT	CASSYSFPPGHTEAFF	TRBV6-5	TRBJ1-1
TGTGCCAGCAGCTGCCCTGGAGCGAAAGGCTCTGGAAACACCATATATTTT	CASSCPGAKGSGNTIYF	TRBV7-8	TRBJ1-3
TGTGCCAGCAGCTTAGTCCTAGGGGGCCAGCCCCAGCATTTT	CASSLVLGGQPQHF	TRBV7-2	TRBJ1-5
TGTGCCAGCATCAGGAGGGGCCGGGAGAATGAAAAACTGTTTTTT	CASIRRGRENEKLFF	TRBV6-6	TRBJ1-4
TGCAGTGCTAGCCATAGAATCCGCACAGATACGCAGTATTTT	CSASHRIRTDTQYF	TRBV20-1	TRBJ2-3
TGTGCCATCAGTGAACGGCGGCAGGGGGTGAATAACTATGGCTACACCTTC	CAISERRQGVNNYGYTF	TRBV10-3	TRBJ1-2
TGTGCCAGCTCACCACGCGCAGGGTGGTCCTACGAGCAGTACTTC	CASSPRAGWSYEQYF	TRBV18	TRBJ2-7
TGTGCCAGCAGCCCCCCGGGTGTAGGGACTAGCGGGCAATCAGATACGCAGTATTTT	CASSPPGVGTSGQSDTQYF	TRBV13	TRBJ2-3
TGTGCCTGGGAGGTCCGGGACAGTGAAAAACTGTTTTTT	CAWEVRDSEKLFF	TRBV30	TRBJ1-4
TGTGCCAGCAGGCAGCCGGGGGGGTGCGGGGGTAATGAGCAGTTCTTC	CASRQPGGCGGNEQFF	TRBV7-3	TRBJ2-1
TGTGCCACCAGTGGTACAGATGGCTACACCTTC	CATSGTDGYTF	TRBV24-1	TRBJ1-2
TGTGCCAGCACTCAGTGGCTAGCGAGCGAGCAGTACTTC	CASTQWLASEQYF	TRBV6-1	TRBJ2-7
TGCAGCTGTGGGGGGGGGCTCTACACCGGGGAGCTGTTTTTT	CSCGGGLYTGELFF	TRBV29-1	TRBJ2-2
TGTGCCAGCAGCTATCTAGCGGCAGCGAGCTCCTACAATGAGCAGTTCTTC	CASSYLAAASSYNEQFF	TRBV12-3	TRBJ2-1
TGTGCCAGCAGCTACCAAATAAGCCCTCGGGACTTGGCTATTAAGGAGACCCAGTACTTC	CASSYQISPRDLAIKETQYF	TRBV6-1	TRBJ2-5
TGCGCCAGCTTATCAGCGGGACGTAACTACGAGCAGTACTTC	CASLSAGRNYEQYF	TRBV10-1	TRBJ2-7
TGTGCCTGGGGGACCCCACAACGGGGTTCAAATCAGCCCCAGCATTTT	CAWGTPQRGSNQPQHF	TRBV30	TRBJ1-5
TGCGCCAGCAGTGAGTCAGGGAGAGATACGCAGTATTTT	CASSESGRDTQYF	TRBV10-2	TRBJ2-3
TGTGCCAGTCATTCAGGGGGCGAGTCCTACGAGCAGTACTTC	CASHSGGESYEQYF	TRBV19	TRBJ2-7
TGCGCCAGCAGTGGCGGGCCCCAAGAGACCCAGTACTTC	CASSGGPQETQYF	TRBV10-1	TRBJ2-5
TGTGCCAGCAGCGTAGCAGGGGTTCGTCAGCCCCAGCATTTT	CASSVAGVRQPQHF	TRBV9	TRBJ1-5
TGCAGCGTTGTCGGGACAGGGGGGGACCTGAACACTGAAGCTTTCTTT	CSVVGTGGDLNTEAFF	TRBV29-1	TRBJ1-1
TGTGCTAGTGGGTTGGGACAGGGGGGGGACCATGGCTACACCTTC	CASGLGQGGDHGYTF	TRBV12-5	TRBJ1-2
TGTGCCAGCAGCCCGATAGGTGAGCAGTTCTTC	CASSPIGEQFF	TRBV7-8	TRBJ2-1
TGCGCCAGCAGCCAAGGACAGCTTACTGAAGCTTTCTTT	CASSQGQLTEAFF	TRBV5-1	TRBJ1-1
TGCACGACTAGCGTTGGCTCCTACAATGAGCAGTTCTTC	CTTSVGSYNEQFF	TRBV20-1	TRBJ2-1
TGCAGCGGATGTAGACAGGGCGCAGATCGGAGCAATCAGCCCCAGCATTTT	CSGCRQGADRSNQPQHF	TRBV29-1	TRBJ1-5
TGTGCCAGCAGTTTGGGGGGGGAGATTCACTCCTACGAGCAGTACTTC	CASSLGGEIHSYEQYF	TRBV27	TRBJ2-7
TGCAGCGTTGGGGGCCACGAGCAGTACTTC	CSVGGHEQYF	TRBV29-1	TRBJ2-7
TGTGCCAGCAGCTTAGGGATGATCAGAGGCTATGGCTACACCTTC	CASSLGMIRGYGYTF	TRBV7-2	TRBJ1-2
TGTGCCACCAGCAGACTAGCGGCTATCACCGGGGAGCTGTTTTTT	CATSRLAAITGELFF	TRBV15	TRBJ2-2
TGTGCCAGTAGTCCCGACAGCCCTAGTGTGAAAAACATTCAGTACTTC	CASSPDSPSVKNIQYF	TRBV19	TRBJ2-4
TGTGCCAGCAGTACTGGGCCAGACACTGAAGCTTTCTTT	CASSTGPDTEAFF	TRBV27	TRBJ1-1
TGTGCCACGGCTTCTTTTTTTGACAGCTTCCCCGCCGGGGAGCTGTTTTTT	CATASFFDSFPAGELFF	TRBV24-1	TRBJ2-2
TGTGCCAGCCAGGGGTTACTCCGACAAAATGAGCAGTTCTTC	CASQGLLRQNEQFF	TRBV7-3	TRBJ2-1
TGTGCCAGCCTCCACAGGGGATATGGCTACACCTTC	CASLHRGYGYTF	TRBV6-4	TRBJ1-2
TGTGCCAGCAGCCAACAGCGGGGGGGCGCCGGGGACTACAATGAGCAGTTCTTC	CASSQQRGGAGDYNEQFF	TRBV7-4	TRBJ2-1
TGTGCCAGCAGCTCACGACGAAAGGGCGAAGATGCCAATCAGCCCCAGCATTTT	CASSSRRKGEDANQPQHF	TRBV7-9	TRBJ1-5
TGTGCCAGCAGCCGGGACAGGAACACTGAAGCTTTCTTT	CASSRDRNTEAFF	TRBV9	TRBJ1-1
TGTGCCAGCAGCTTACAACAGCTGAGGGGGGTCAAATGGAACACTGAAGCTTTCTTT	CASSLQQLRGVKWNTEAFF	TRBV7-2	TRBJ1-1
TGCGCCAGCAGAAACCTGAGGGGGGGCCTTGGAAACACCATATATTTT	CASRNLRGGLGNTIYF	TRBV5-1	TRBJ1-3
TGTGCCACCAGTGATTGGATAGGTTCCTACAATGAGCAGTTCTTC	CATSDWIGSYNEQFF	TRBV24-1	TRBJ2-1
TGTGCCAGCAGCCATCGGCTTCCGGGGGGCCGGAAAGAGACCCAGTACTTC	CASSHRLPGGRKETQYF	TRBV3-1	TRBJ2-5
TGTGCCAGCAGTGACAACCTCCCCTCTGGGGCCAACGTCCTGACTTTC	CASSDNLPSGANVLTF	TRBV6-4	TRBJ2-6
TGCGCCAGCAGCCAAGATTCCAGGGGGGGCGGTAATTCACCCCTCCACTTT	CASSQDSRGGGNSPLHF	TRBV4-1	TRBJ1-6
TGTGCCAGCAGCTTAAGGAGGGAGGTACTACTAACCTATGGCTACACCTTC	CASSLRREVLLTYGYTF	TRBV7-3	TRBJ1-2
TGCAGTGCTAGGGAAGGGGGACCGAAGTATGGCTACACCTTC	CSAREGGPKYGYTF	TRBV20-1	TRBJ1-2
TGCAGTGCACAGGACCGGAATGAGCAGTTCTTC	CSAQDRNEQFF	TRBV20-1	TRBJ2-1
TGCGCCAGCAGCTTGACATGGATTCCAAACAATGAGCAGTTCTTC	CASSLTWIPNNEQFF	TRBV5-1	TRBJ2-1
TGTGCCAGCAGTGACTGGACAGCCATTACAGATACGCAGTATTTT	CASSDWTAITDTQYF	TRBV6-1	TRBJ2-3
TGTGCCAGCAGTGAAATGTCCGGGGTCTATGGCTACACCTTC	CASSEMSGVYGYTF	TRBV6-1	TRBJ1-2
TGTGCCAGCAGTGTCCGAGGCTCTGGAAACACCATATATTTT	CASSVRGSGNTIYF	TRBV27	TRBJ1-3
TGTGCCGACAATCAGACAGGGGTGAAGAGCAATCAGCCCCAGCATTTT	CADNQTGVKSNQPQHF	TRBV6-5	TRBJ1-5
TGTGCCAGCAGCTTAGACGGGATCCAGCCTAGCGGTCTAGATGAGCAGTTCTTC	CASSLDGIQPSGLDEQFF	TRBV7-9	TRBJ2-1
TGTGCCAGCAGCCTTGGATCTCACAGGGGGCCTGAGCAGTACTTC	CASSLGSHRGPEQYF	TRBV13	TRBJ2-7
TGCAGTGCTAGAACCCTACTCAGTAACAATGAGCAGTTCTTC	CSARTLLSNNEQFF	TRBV20-1	TRBJ2-1
TGTGCCAGCAGCTTGGACTCCGGGACTAGAATGGCGGAGGAGACCCAGTACTTC	CASSLDSGTRMAEETQYF	TRBV11-2	TRBJ2-5
TGTGCCAGCAGCTTAGAGGGCATCTACGAGCAGTACTTC	CASSLEGIYEQYF	TRBV7-6	TRBJ2-7
TGTGCCAGCAGCCCCCCCGCAGGGGATCCACAGGGGGAGCTGTTTTTT	CASSPPAGDPQGELFF	TRBV7-3	TRBJ2-2
TGCGCCAGCAGCCAAGCCCCAGGGGTCGGAAATCAGCCCCAGCATTTT	CASSQAPGVGNQPQHF	TRBV4-1	TRBJ1-5
TGTGCCAGCAGTGCGGACAGGGTACCACCCTCCTATAATTCACCCCTCCACTTT	CASSADRVPPSYNSPLHF	TRBV6-1	TRBJ1-6
TGTGCCATCAGTGTTAAGCGCAGCCGGGCTAAAATTGCCAACTATGGCTACACCTTC	CAISVKRSRAKIANYGYTF	TRBV10-3	TRBJ1-2
TGTGCCAGCAGTTCCCGGGGCCCTAAGTCTCCCCAGCATTTT	CASSSRGPKSPQHF	TRBV27	TRBJ1-5
TGTGCCAGCCCACAAGGACAGGGCTATGGCTACACCTTC	CASPQGQGYGYTF	TRBV27	TRBJ1-2
TGTGCCAGCAGCTTACCGGGACTAGCGGGGGCTGGAAGCTCCTACGAGCAGTACTTC	CASSLPGLAGAGSSYEQYF	TRBV7-8	TRBJ2-7
TGTGCCAGCAGCCAAGATCCGCTCCCCAGTATTAGCGGGACGAAGAAAAGGGTAGCCAAAAACATTCAGTACTTC	CASSQDPLPSISGTKKRVAKNIQYF	TRBV14	TRBJ2-4
TGCGCCAGCAGTGAGTCATCCAATGCGGGGGCGTGGTCGCAGCCCCAGCATTTT	CASSESSNAGAWSQPQHF	TRBV10-1	TRBJ1-5
TGTGCCAGCAGCGCGGGAGCTGCCTACAATGAGCAGTTCTTC	CASSAGAAYNEQFF	TRBV7-4	TRBJ2-1
TGTGCCAGCAGTTCGACGACTAGAGGGGAAGAGACCCAGTACTTC	CASSSTTRGEETQYF	TRBV14	TRBJ2-5
TGTGCCAGCAGTGAAGCATGTCTGGGGGTGGTCTCTGGAAACACCATATATTTT	CASSEACLGVVSGNTIYF	TRBV6-1	TRBJ1-3
TGTGCCAGCAGCCAAGATACGTTGACTTCACTTCCGAGGGGGATGGACTTCGGCTACACCTTC	CASSQDTLTSLPRGMDFGYTF	TRBV3-1	TRBJ1-2
TGTGCCAGCAGCTCCGCCGTCCAGGGGAAGACTTACAATGAGCAGTTCTTC	CASSSAVQGKTYNEQFF	TRBV7-2	TRBJ2-1
TGTGCCAGCAGCGTAGATTGCCAGGGTCCGGAGACTAATGAAAAACTGTTTTTT	CASSVDCQGPETNEKLFF	TRBV9	TRBJ1-4
TGTGCCAGCAGCGTAGTCCGATGGACTAGCGGGCCCGGCTCCTACAATGAGCAGTTCTTC	CASSVVRWTSGPGSYNEQFF	TRBV9	TRBJ2-1
TGCGCCAGCAGCTTGCCCTTCCCGGCGCAGGGCTACACCTTC	CASSLPFPAQGYTF	TRBV5-1	TRBJ1-2
TGCGCCAGCAGCCAAGATCTCGGTTCACATCCTTCCTACGAGCAGTACTTC	CASSQDLGSHPSYEQYF	TRBV4-1	TRBJ2-7
TGTGCCAGCAGCAGGCATCAGGGGGTAACAGATACGCAGTATTTT	CASSRHQGVTDTQYF	TRBV13	TRBJ2-3
TGCGCCAGCAGTGAGTCCTACATCACAGGCACAGGGGATACGCAGTATTTT	CASSESYITGTGDTQYF	TRBV10-2	TRBJ2-3
TGTGCCAGCAGCGGAGAGTACCCGTACACTGAAGCTTTCTTT	CASSGEYPYTEAFF	TRBV5-6	TRBJ1-1
TGTGCCAGCAGCTTTTCTTATAACGGGGAGCTGTTTTTT	CASSFSYNGELFF	TRBV5-8	TRBJ2-2
TGTGCATCCGGGACGAAGCCCTACGAGCAGTACTTC	CASGTKPYEQYF	TRBV2	TRBJ2-7
TGTGCCAGCAGCCAAGATACCCGGGACAAAGTTTCCACAGATACGCAGTATTTT	CASSQDTRDKVSTDTQYF	TRBV4-2	TRBJ2-3
TGCAGTGCTAGAGGTCCTGACGTTTCCTATAATTCACCCCTCCACTTT	CSARGPDVSYNSPLHF	TRBV20-1	TRBJ1-6
TGTGCCAGCAGCCAAGGGGGTTCTGCCACAGGGGGGAGCTCCTACAATGAGCAGTTCTTC	CASSQGGSATGGSSYNEQFF	TRBV14	TRBJ2-1
TGTGCCAGCAGCTCGGGGGCCAATCCTCAGCCCCAGCATTTT	CASSSGANPQPQHF	TRBV3-1	TRBJ1-5
TGTGCCAGCAGCCAAGATGGACTAGCGCATGAGTGGAGCACAGATACGCAGTATTTT	CASSQDGLAHEWSTDTQYF	TRBV14	TRBJ2-3
TGTGACAAGATACGAAATGACGAGCAGTACTTC	CDKIRNDEQYF	TRBV2	TRBJ2-7
TGTGCCAGCAGCGGGATAAGGGGGGCTCAGCCCCAGCATTTT	CASSGIRGAQPQHF	TRBV9	TRBJ1-5
TGTGCCAGACTAGAGCATGAGCAGTTCTTC	CARLEHEQFF	TRBV19	TRBJ2-1
TGTGCCATCAGTCGTTTTAACAAGGGCCAGCCCCAGCATTTT	CAISRFNKGQPQHF	TRBV10-3	TRBJ1-5
TGTGCCAGCAGCTCGAACCCACAGAACACCGGGGAGCTGTTTTTT	CASSSNPQNTGELFF	TRBV13	TRBJ2-2
TGCAGTGCTGCCGGGACAGGGTGGGTATATGGCTACACCTTC	CSAAGTGWVYGYTF	TRBV20-1	TRBJ1-2
TGTGCCAGCAGTGACGGGATAAGGGGGGGCTGCACTGAAGCTTTCTTT	CASSDGIRGGCTEAFF	TRBV2	TRBJ1-1
TGCGCCAGCAGCTTGGGGGCCTCTAGGGCACCTAATTCACCCCTCCACTTT	CASSLGASRAPNSPLHF	TRBV5-1	TRBJ1-6
TGTGCCAGCAGTAAACCAAACAGGGGATCTGAAGCTTTCTTT	CASSKPNRGSEAFF	TRBV28	TRBJ1-1
TGTGCCAGCAGTACTCCCCGCCGGGACGTTTTAACCTACGAGCAGTACTTC	CASSTPRRDVLTYEQYF	TRBV27	TRBJ2-7
TGCAGTGCTAGAGATGGAGACGAAAAACTGTTTTTT	CSARDGDEKLFF	TRBV20-1	TRBJ1-4
TGTGCCAGCAGCTCAAGATCTATGACCTACGAGCAGTACTTC	CASSSRSMTYEQYF	TRBV13	TRBJ2-7
TGTGCCAGCAGCGACGATCAGGGACAAGAGACCCAGTACTTC	CASSDDQGQETQYF	TRBV7-2	TRBJ2-5
TGTGCCAGCAGTTACTGGTGGGCCGGAAATCAGCCCCAGCATTTT	CASSYWWAGNQPQHF	TRBV6-5	TRBJ1-5
TGTGCCAGCAGCGTCCCTAAAGACAGGGGGGGGGAATCTCCCGGGGAGCTGTTTTTT	CASSVPKDRGGESPGELFF	TRBV13	TRBJ2-2
TGTGCCAGCAGCTTACTGGACTATTTATACGAGCAGTACTTC	CASSLLDYLYEQYF	TRBV7-9	TRBJ2-7
TGTGCCAGCAGCCACCGGGACTCTGTGAACACTGAAGCTTTCTTT	CASSHRDSVNTEAFF	TRBV7-3	TRBJ1-1
TGTGCCACAGCCACAGGGTTCGCTGATCAGCCCCAGCATTTT	CATATGFADQPQHF	TRBV19	TRBJ1-5
TGTGCCAGCGGCTTCTTCCGGGACAGGGGGCAAGTATCCTACAATGAGCAGTTCTTC	CASGFFRDRGQVSYNEQFF	TRBV25-1	TRBJ2-1
TGCGCCAGCAGCTTGGATTCGTGCAGTTCTTGCCTCTATGGCTACACCTTC	CASSLDSCSSCLYGYTF	TRBV5-1	TRBJ1-2
TGTGCCAGCAGTGACGGGGGGGCGACTGAAGCTTTCTTT	CASSDGGATEAFF	TRBV27	TRBJ1-1
TGTGCCAGCTACCGATATGCAGGCTACACCTTC	CASYRYAGYTF	TRBV6-1	TRBJ1-2
TGTGCCAGCCTCTCCGGGACTAGCGGGGAGGCCTACAATGAGCAGTTCTTC	CASLSGTSGEAYNEQFF	TRBV12-4	TRBJ2-1
TGTGCCAGCAGTTACAGTAGGACAGGTTTGATAGCCAAAAACATTCAGTACTTC	CASSYSRTGLIAKNIQYF	TRBV6-2	TRBJ2-4
TGTGCCAGCAGCGCAGGGGGTGGGGACTATGGCTACACCTTC	CASSAGGGDYGYTF	TRBV9	TRBJ1-2
TGTGCCAGCAACGAAGACAGGGCCGCTTTCTTT	CASNEDRAAFF	TRBV27	TRBJ1-1
TGTGCCACCAGTGATTTCCTTCAGCGGGATAGCAATCAGCCCCAGCATTTT	CATSDFLQRDSNQPQHF	TRBV24-1	TRBJ1-5
TGCAGTGCTAGGGGGACTAGCGGGACGTGGGATGGGCAAGAGACCCAGTACTTC	CSARGTSGTWDGQETQYF	TRBV20-1	TRBJ2-5
TGTGCCAGCAGCTTGATTACCGACAGTTTTGTTTCCTACACCTTC	CASSLITDSFVSYTF	TRBV7-7	TRBJ1-2
TGTGCCAGCAGCCACCAGGTTACAAGCAATCAGCCCCAGCATTTT	CASSHQVTSNQPQHF	TRBV7-3	TRBJ1-5
TGTGCCAGCAGGACTACCTCCACAGTCCGCACAGATACGCAGTATTTT	CASRTTSTVRTDTQYF	TRBV7-2	TRBJ2-3
TGTGCCAGCAGCGGAGTGAGGAGCGGCAATCAGCCCCAGCATTTT	CASSGVRSGNQPQHF	TRBV13	TRBJ1-5
TGTGCCACCTCTCAGGGGGCCGGGTCCCTGAACACTGAAGCTTTCTTT	CATSQGAGSLNTEAFF	TRBV24-1	TRBJ1-1
TGCGCCAGCAGTAGACCGGGACAGGGGATTTACGAGCAGTACTTC	CASSRPGQGIYEQYF	TRBV10-1	TRBJ2-7
TGTGGGAAGCGGGGGCCGAATGGGGCTAGCACAGATACGCAGTATTTT	CGKRGPNGASTDTQYF	TRBV28	TRBJ2-3
TGTGCCAGCAGCCCCCAAGGGGGTTCAACTAATGAAAAACTGTTTTTT	CASSPQGGSTNEKLFF	TRBV14	TRBJ1-4
TGTGCCAGCAAGTATGGTCCAGCTTTCTTT	CASKYGPAFF	TRBV6-4	TRBJ1-1
TGTGCCAGCAGCTTAGCGTGTATCCAGGGTTCCGAAGACACTGAAGCTTTCTTT	CASSLACIQGSEDTEAFF	TRBV7-4	TRBJ1-1
TGTGCCACCAGTGCCCCCCCGGCGGGAGCGTACGAGCAGTACTTC	CATSAPPAGAYEQYF	TRBV24-1	TRBJ2-7
TGCGCCAGCAAGGAAGGGGGGGAGCGGGGGGTGAACACTGAAGCTTTCTTT	CASKEGGERGVNTEAFF	TRBV5-1	TRBJ1-1
TGCAGTGCTGCCAAGCTGTTCTCCTACGAGCAGTACTTC	CSAAKLFSYEQYF	TRBV20-1	TRBJ2-7
TGTGCCAGCAGCAGGACAGATACGACCCCTGAAGCTTTCTTT	CASSRTDTTPEAFF	TRBV27	TRBJ1-1
TGTGCCAGCAGTTTAAAGGGAAGGGGGCACGATGGCTACACCTTC	CASSLKGRGHDGYTF	TRBV12-4	TRBJ1-2
TGTGCCAGCAGCATTACGAATCCTAGCCCCTACGAGCAGTACTTC	CASSITNPSPYEQYF	TRBV7-9	TRBJ2-7
TGTGCCAGCAGCGTAGCTAACAAAATGAACACTGAAGCTTTCTTT	CASSVANKMNTEAFF	TRBV9	TRBJ1-1
TGCAGTGCTAGTCGCGGTACCGGGACAGCGGGGCGCACCGGGGAGCTGTTTTTT	CSASRGTGTAGRTGELFF	TRBV20-1	TRBJ2-2
TGTGCCACCAGTGATTTCGTCCTAGGGGACACTGAAGCTTTCTTT	CATSDFVLGDTEAFF	TRBV24-1	TRBJ1-1
TGCAGTGCTTCCCTGGGGTCCTATAATTCACCCCTCCACTTT	CSASLGSYNSPLHF	TRBV20-1	TRBJ1-6
TGTGCCAGCAGCTTAGACAGGGCGGCTAAGAGTCAGCCCCAGCATTTT	CASSLDRAAKSQPQHF	TRBV7-9	TRBJ1-5
TGTGCCACCAGCAGAGATAGTTCCATGATAGCGGGAGAAAAACTGTTTTTT	CATSRDSSMIAGEKLFF	TRBV15	TRBJ1-4
TGCAGTGCTCGGACCGGGGGGAAATCCGACACCGGGGAGCTGTTTTTT	CSARTGGKSDTGELFF	TRBV20-1	TRBJ2-2
TGTGCCACCAGTGCCACAGGGCACTCTGGAAACACCATATATTTT	CATSATGHSGNTIYF	TRBV24-1	TRBJ1-3
TGTGCCAATACTGAATCCCGTTACGAGCAGTACTTC	CANTESRYEQYF	TRBV6-3	TRBJ2-7
TGTGCCAGCAGTGGAATGACTAGCGGGGGTAGCACAGATACGCAGTATTTT	CASSGMTSGGSTDTQYF	TRBV25-1	TRBJ2-3
TGTGCCAGCAGCTCCGGGCGGGACAGTAGGCTCCAAGAGACCCAGTACTTC	CASSSGRDSRLQETQYF	TRBV7-9	TRBJ2-5
TGTGCCAGCAGCTCTCTGTATGAGCAGTTCTTC	CASSSLYEQFF	TRBV7-3	TRBJ2-1
TGTGCCAGCAGCGCCGCCCCGGGGGCCTACGAGCAGTACTTC	CASSAAPGAYEQYF	TRBV13	TRBJ2-7
TGTGCCAGCAGCGGAAAACGGACAGCGAACACTGAAGCTTTCTTT	CASSGKRTANTEAFF	TRBV13	TRBJ1-1
TGTGCCAGCAGCTTTCTGGGACACAGGGGCCGCTACGAGCAGTACTTC	CASSFLGHRGRYEQYF	TRBV11-2	TRBJ2-7
TGTGCCAGCAGTCCCGCGGGTTACAATGAGCAGTTCTTC	CASSPAGYNEQFF	TRBV12-3	TRBJ2-1
TGTGCCAGCAGCTTAATCCCCCGAAACAATGAGCAGTTCTTC	CASSLIPRNNEQFF	TRBV13	TRBJ2-1
TGTGCCAGCACTCGGACGGCCGGGCCAACGCACGAGCAGTACTTC	CASTRTAGPTHEQYF	TRBV27	TRBJ2-7
TGTGCCAGCAGTTACGGGACAGAACGCACAGATACGCAGTATTTT	CASSYGTERTDTQYF	TRBV6-3	TRBJ2-3
TGTGCCAGCAGCCATAAGATTAGGGGCTACGAGCAGTACTTC	CASSHKIRGYEQYF	TRBV7-8	TRBJ2-7
TGCAGTGCTAGAGATTCTTCTAGTATTTACAGGGGGGCGGCCGGGGAGCTGTTTTTT	CSARDSSSIYRGAAGELFF	TRBV20-1	TRBJ2-2
TGCGCCAGCAGCCGGGGGGGGCCCTCCTTCTCAGAGACCCAGTACTTC	CASSRGGPSFSETQYF	TRBV5-1	TRBJ2-5
TGTGCCAGCAGCTTAGGCCGACAGCCCCCCTACGAGCAGTACTTC	CASSLGRQPPYEQYF	TRBV7-9	TRBJ2-7
TGTGCCAGCAGCTTAGATCTTTTGCGTACTTTCATGAACACTGAAGCTTTCTTT	CASSLDLLRTFMNTEAFF	TRBV11-3	TRBJ1-1
TGTGCCAGCAGCTCCGCTAGCGGATCTTTCCGACCGGACGAGCAGTACTTC	CASSSASGSFRPDEQYF	TRBV7-4	TRBJ2-7
TGTGCCAGCAGCTTAGAGGAGTCGGGAGGGACCAACACCGGGGAGCTGTTTTTT	CASSLEESGGTNTGELFF	TRBV7-9	TRBJ2-2
TGTGCCAGAGAGGGGTTTGAGACCCAGTACTTC	CAREGFETQYF	TRBV19	TRBJ2-5
TGTGCCAGCAGTGCCTGCTTCACTACCCTAGAGACCCAGTACTTC	CASSACFTTLETQYF	TRBV6-4	TRBJ2-5
TGCAGTGCCCTAGCGGTTGGGGTTTACAATGAGCAGTTCTTC	CSALAVGVYNEQFF	TRBV20-1	TRBJ2-1
TGTGCCAGCAGCCAGCCTGAGCAGCCCCAGCATTTT	CASSQPEQPQHF	TRBV14	TRBJ1-5
TGTGCCAGCAGTTATATTCGGACTAGCGGGCGGCACGAGACCCAGTACTTC	CASSYIRTSGRHETQYF	TRBV6-5	TRBJ2-5
TGCAGTCCCAAACTAGCGGGAGCCCAAGGCTCTGGGGCCAACGTCCTGACTTTC	CSPKLAGAQGSGANVLTF	TRBV20-1	TRBJ2-6
TGTGCCAGCAGCCAGGACAGGGGGGGCACTGAAGCTTTCTTT	CASSQDRGGTEAFF	TRBV13	TRBJ1-1
TGTGCCAGCACGGACAGCATTACCTCACTGGCGGCCAGATACGAGCAGTACTTC	CASTDSITSLAARYEQYF	TRBV7-9	TRBJ2-7
TGTGCCAGCAGCCAAGAGAGAAATGACAGGTTAGTGGATGAGAACAATCAGCCCCAGCATTTT	CASSQERNDRLVDENNQPQHF	TRBV3-1	TRBJ1-5
TGTGCCAGCAGTGAAGACCGGGGTGTTGGACTAGTATGTATCTACAATGAGCAGTTCTTC	CASSEDRGVGLVCIYNEQFF	TRBV25-1	TRBJ2-1
TGTGCCAGCAGCGTTAACGCAGTAAGAGGGAGGGGGAAATATGGCTACACCTTC	CASSVNAVRGRGKYGYTF	TRBV7-4	TRBJ1-2
TGTGCCAGCAGCTTGTTTGAACAGTTCCAGCCCCAGCATTTT	CASSLFEQFQPQHF	TRBV12-3	TRBJ1-5
TGTGCCAGCAGTTTAAGCACAGGCAAGAGCTCCTACAATGAGCAGTTCTTC	CASSLSTGKSSYNEQFF	TRBV12-4	TRBJ2-1
TGTGCCTGGGAGCCCGGTGACAGTTTCGGGGTGGCCCGAGCTTTCTTT	CAWEPGDSFGVARAFF	TRBV30	TRBJ1-1
TGCAGCGTTCGGGGACGGGCTAACTATGGCTACACCTTC	CSVRGRANYGYTF	TRBV29-1	TRBJ1-2
TGTGCCAGCAGCTCTCGCGGGGGTAGGGTCTACGAGCAGTACTTC	CASSSRGGRVYEQYF	TRBV7-2	TRBJ2-7
TGTGCCACCAGCAGCTTCCCGGGGACTAGCACAGATACGCAGTATTTT	CATSSFPGTSTDTQYF	TRBV15	TRBJ2-3
TGCAGTGCTAGAGATCGCAAACCCCCGGGAGGTCAGCCCCAGCATTTT	CSARDRKPPGGQPQHF	TRBV20-1	TRBJ1-5
TGCAGTGTCAATCACAGGGGGGACAATGAGCAGTTCTTC	CSVNHRGDNEQFF	TRBV20-1	TRBJ2-1
TGTGCCAGCGCGGGGGCGAACACCGGGGAGCTGTTTTTT	CASAGANTGELFF	TRBV6-5	TRBJ2-2
TGCAGTGCTAGAACAATCGCGGGGGTGAACCACCCTTACACTGAAGCTTTCTTT	CSARTIAGVNHPYTEAFF	TRBV20-1	TRBJ1-1
TGTGCCAGCAGCTTAGCCATGTGGGGGGGATGGCCCGCGAACACCGGGGAGCTGTTTTTT	CASSLAMWGGWPANTGELFF	TRBV7-4	TRBJ2-2
TGTGCCAGCATCCACAGAGAGAACACTGAAGCTTTCTTT	CASIHRENTEAFF	TRBV14	TRBJ1-1
TGTGCCAGCAGCGCGGATCCCATCGGAAACACCATATATTTT	CASSADPIGNTIYF	TRBV13	TRBJ1-3
TGTGCCAGCTCACCTCCAGACAGGGCCGGGGTGAACACTGAAGCTTTCTTT	CASSPPDRAGVNTEAFF	TRBV18	TRBJ1-1
TGTGCCAGCTTCTCGGACAGTAGCTACAATGAGCAGTTCTTC	CASFSDSSYNEQFF	TRBV2	TRBJ2-1
TGTGCCGATCAGGGGAAATCGGCCTATGGCTACACCTTC	CADQGKSAYGYTF	TRBV9	TRBJ1-2
TGTGCCAGCAGCTTGGTTGCCCTTGGACAGGGAAACTCCTACGAGCAGTACTTC	CASSLVALGQGNSYEQYF	TRBV5-5	TRBJ2-7
TGTGCCAGTAGTATAGCAGGGGTTCGCGGGGCCGGGGAGCTGTTTTTT	CASSIAGVRGAGELFF	TRBV19	TRBJ2-2
TGCAGTGCTGGTGGACCTAATAAGGAGTCAGCCTACGAGCAGTACTTC	CSAGGPNKESAYEQYF	TRBV20-1	TRBJ2-7
TGCGCCAGCAGCTTGGCTAGAGAATTAGCCAAAAACATTCAGTACTTC	CASSLARELAKNIQYF	TRBV5-1	TRBJ2-4
TGTGCCAGCAGCCAAGATCCCGCAGGGGGGGGCCCCCACAATGAGCAGTTCTTC	CASSQDPAGGGPHNEQFF	TRBV3-1	TRBJ2-1
TGTGCCTGGAGTGTACAGGTAGGGCTCCCCAGCTCCTACAATGAGCAGTTCTTC	CAWSVQVGLPSSYNEQFF	TRBV30	TRBJ2-1
TGTGCCTGGAGTGGCCTCCCAACTGGTGGAAACACCATATATTTT	CAWSGLPTGGNTIYF	TRBV30	TRBJ1-3
TGCGCCAGCAGCTTGTTGGGGGATCAGCCCCAGCATTTT	CASSLLGDQPQHF	TRBV5-1	TRBJ1-5
TGTGCCAGCAAATCGGGGGGCGCCCAGCCCCAGCATTTT	CASKSGGAQPQHF	TRBV11-3	TRBJ1-5
TGTGCCAGCAGCGTAGTTGTCGCCCGGGACAGGGGGCGCGATGACGGGGAGCTGTTTTTT	CASSVVVARDRGRDDGELFF	TRBV9	TRBJ2-2
TGCGCCAGCAGCTCTTTGCTGGGGCTGGCCAGGACCCAGTACTTC	CASSSLLGLARTQYF	TRBV5-1	TRBJ2-5
TGTGCCAGCAGCTTAGATCCAGCGACAGGGTTTGCCAAAAACATTCAGTACTTC	CASSLDPATGFAKNIQYF	TRBV11-3	TRBJ2-4
TGCAGTGCTAGAGTCCGAGCGGGAGCCGAGGGGAATGAGCAGTTCTTC	CSARVRAGAEGNEQFF	TRBV20-1	TRBJ2-1
TGTGCCAGCAGTTACGGCCTCCCAGATACGCAGTATTTT	CASSYGLPDTQYF	TRBV6-2	TRBJ2-3
TGTGCCAGCAGCTTACAGGGCGAGAACACTGAAGCTTTCTTT	CASSLQGENTEAFF	TRBV11-2	TRBJ1-1
TGTGCCACAAAACTAGCGGGAGACCCGAATCAGCCCCAGCATTTT	CATKLAGDPNQPQHF	TRBV15	TRBJ1-5
TGCGCCAGCAGTTTGGCCCCGGGACCTGGCCTCCACTTT	CASSLAPGPGLHF	TRBV10-1	TRBJ1-6
TGTGCCAGCAGCCCATTGGGCTTCGAACCCAATGAGCAGTTCTTC	CASSPLGFEPNEQFF	TRBV6-1	TRBJ2-1
TGTGCCAGCAGCTGCCACCTTTTGGACCAGAGAGTCACTGAAGCTTTCTTT	CASSCHLLDQRVTEAFF	TRBV7-8	TRBJ1-1
TGTGCCAGCAGTGAAACGCTAACTAGAACAGGGCCGACCCAGTACTTC	CASSETLTRTGPTQYF	TRBV6-1	TRBJ2-5
TGTGCCAGCAGTTTAGCAAAGCAGGGGGGGAACACTGAAGCTTTCTTT	CASSLAKQGGNTEAFF	TRBV12-3	TRBJ1-1
TGCAGCGTTGCAAGTCCTCGGCAGAATCATAGTCAGCCCCAGCATTTT	CSVASPRQNHSQPQHF	TRBV29-1	TRBJ1-5
TGCGCCAGCAGCAGGTGTTTCGAGAGAGGGGGCTTTGACACCGGGGAGCTGTTTTTT	CASSRCFERGGFDTGELFF	TRBV5-1	TRBJ2-2
TGTGCCACCAGGCCGGGACTAGCGGGGGGGCACTACGAGCAGTACTTC	CATRPGLAGGHYEQYF	TRBV24-1	TRBJ2-7
TGTGCCAGCAGCTCAGCGGGAGTAGGAGAGACCCAGTACTTC	CASSSAGVGETQYF	TRBV6-3	TRBJ2-5
TGTGCCAGCAGTTTAGGCGTCACAGGGGGTTTGGGAGGGAACACTGAAGCTTTCTTT	CASSLGVTGGLGGNTEAFF	TRBV12-3	TRBJ1-1
TGTGCCAGCAGCTTTTTCCCTGGGGATAACAACAGCGGAGTTGGCTACACCTTC	CASSFFPGDNNSGVGYTF	TRBV13	TRBJ1-2
TGTGCCAGCAGCTTATCGGACGAGTCGATTAGCACAGATACGCAGTATTTT	CASSLSDESISTDTQYF	TRBV11-2	TRBJ2-3
TGCGCCAGCAGCCAAGCACAGGGTCCGGGTCACTATGGCTACACCTTC	CASSQAQGPGHYGYTF	TRBV4-1	TRBJ1-2
TGTGCCAGCAGTGCCGAGGGGATCAAGTACAATGAGCAGTTCTTC	CASSAEGIKYNEQFF	TRBV25-1	TRBJ2-1
TGTGCCAGCAGACGATTGAAGACAGGGAACAATCAGCCCCAGCATTTT	CASRRLKTGNNQPQHF	TRBV6-4	TRBJ1-5
TGCGCCAGCAGTGAGTCACGACTCCTGTTTAATCAGCCCCAGCATTTT	CASSESRLLFNQPQHF	TRBV10-1	TRBJ1-5
TGTGCCAGCAAACGGACTAGCGGGGGGGGAGAAAGCTCCTACAATGAGCAGTTCTTC	CASKRTSGGGESSYNEQFF	TRBV6-4	TRBJ2-1
TGCGCCAGCAGCGCCTTGGGCCCCCCTAGCGCCTACGAGCAGTACTTC	CASSALGPPSAYEQYF	TRBV5-1	TRBJ2-7
TGTGCCAGCAGCCAGGGGGGGCCCACCTACGAGCAGTACTTC	CASSQGGPTYEQYF	TRBV3-1	TRBJ2-7
TGCGCCAGCAGTAGCGGGAACGAGACCCAGTACTTC	CASSSGNETQYF	TRBV10-2	TRBJ2-5
TGTGCCAAAGAGTCTCCTAGCGGGTCATCCGCTTCCCTGGGGAAGGGAATTAATGAGCAGTTCTTC	CAKESPSGSSASLGKGINEQFF	TRBV25-1	TRBJ2-1
TGTGCCAGCAGTGACTCCACAGCCCCTAGCGGCTACGAGCAGTACTTC	CASSDSTAPSGYEQYF	TRBV6-4	TRBJ2-7
TGTGCCAGCAACTACGGATCCGGGGACCCCTCCTACGAGCAGTACTTC	CASNYGSGDPSYEQYF	TRBV6-1	TRBJ2-7
TGTGCCAGCAGCTTGGACTATAAGATCCAAAAACTGTTTTTT	CASSLDYKIQKLFF	TRBV5-6	TRBJ1-4
TGTGCCAGCAGAAGCGGGAGTAGAGCCTATGGCTACACCTTC	CASRSGSRAYGYTF	TRBV27	TRBJ1-2
TGCAGCGCGGGGTCAGAGACCCAGTACTTC	CSAGSETQYF	TRBV29-1	TRBJ2-5
TGCGCCAGCAGCTTGGCGGGACAGGGGAACTATGGCTACACCTTC	CASSLAGQGNYGYTF	TRBV5-1	TRBJ1-2
TGTGCCAGCAGTTACATCCGGGACAGGGACTCCTACGAGCAGTACTTC	CASSYIRDRDSYEQYF	TRBV6-2	TRBJ2-7
TGTGCAGGCCGGGCGTCCTCCTACGAGCAGTACTTC	CAGRASSYEQYF	TRBV30	TRBJ2-7
TGTGCCAGTATATCGTCTCTACTGCGAGATACGCAGTATTTT	CASISSLLRDTQYF	TRBV6-6	TRBJ2-3
TGTGCCAGCGGCAGGGTCTTCAGCAATCAGCCCCAGCATTTT	CASGRVFSNQPQHF	TRBV7-9	TRBJ1-5
TGTGCCAGCAGTTTATGGCACAGGGCGTGGATCGAGGTCGGCCAAGAGACCCAGTACTTC	CASSLWHRAWIEVGQETQYF	TRBV6-2	TRBJ2-5
TGTGCCACCAGTGATTTGGCCAAGCGTAAGGGGGAAAAACTGTTTTTT	CATSDLAKRKGEKLFF	TRBV24-1	TRBJ1-4
TGCGCCAGCAGTGAGGCCCCCGACAAGGCGGGCACAGATACGCAGTATTTT	CASSEAPDKAGTDTQYF	TRBV10-2	TRBJ2-3
TGTGCCACCAGCAGAGTCAAGCAGGACTCCTACGAGCAGTACTTC	CATSRVKQDSYEQYF	TRBV15	TRBJ2-7
TGCAGCGTTGAAGGGCTCCGGGACCTTAGGGCGAGGGCCTACGAGCAGTACTTC	CSVEGLRDLRARAYEQYF	TRBV29-1	TRBJ2-7
TGTGCCAGCTCTCCGCCGGGACTAGCGGGAGACACCGGGGAGCCCCAGCATTTT	CASSPPGLAGDTGEPQHF	TRBV18	TRBJ1-5
TGTGCCAGTAGTATAGATCCACGGAGACCCTACTATGGCTACACCTTC	CASSIDPRRPYYGYTF	TRBV19	TRBJ1-2
TGCGCCAGCTGGACTAATGAAAAACTGTTTTTT	CASWTNEKLFF	TRBV5-1	TRBJ1-4
TGTGCCAGCAGCTTTCGTTCAGCCATCAGGAACACTGAAGCTTTCTTT	CASSFRSAIRNTEAFF	TRBV7-3	TRBJ1-1
TGCAGTTCACCGGGACAGTCAACTAATGAAAAACTGTTTTTT	CSSPGQSTNEKLFF	TRBV20-1	TRBJ1-4
TGTGCCAGCAGCTTAGTAAGGGACAGGGGTGATTCACCCCTCCACTTT	CASSLVRDRGDSPLHF	TRBV7-6	TRBJ1-6
TGTGCCTGGCAACCCCCCGCGGCCGGGACAACTGGAAACACCATATATTTT	CAWQPPAAGTTGNTIYF	TRBV30	TRBJ1-3
TGTGCCAGCATCCCTCCCCGGTCGGGACGCTACGAGCAGTACTTC	CASIPPRSGRYEQYF	TRBV6-4	TRBJ2-7
TGCAGTGCAACACACAGAATCGAAAAACTGTTTTTT	CSATHRIEKLFF	TRBV20-1	TRBJ1-4
TGTGCCAGCAGCAAGCTAGGGGGCACAGATACGCAGTATTTT	CASSKLGGTDTQYF	TRBV3-1	TRBJ2-3
TGTGCCAGCTCGGGGGGACCCGGCCTAAAATTCGAGCAGTACTTC	CASSGGPGLKFEQYF	TRBV28	TRBJ2-7
TGTGCCAGTACAAATCCTGGACAGGGCGAGCAGTACTTC	CASTNPGQGEQYF	TRBV19	TRBJ2-7
TGTGCCAGCAGCCGAGCGAGAGGACAAGAGACCCAGTACTTC	CASSRARGQETQYF	TRBV9	TRBJ2-5
TGCGCCAGCAGCTCGGGGAGGACAGGGGAGACCCAGTACTTC	CASSSGRTGETQYF	TRBV5-1	TRBJ2-5
TGCGCCAGCAGCTTGGGAACTGGTGCTGGAGAGACCCAGTACTTC	CASSLGTGAGETQYF	TRBV5-1	TRBJ2-5
TGTGCCAGCAGCTTGGCGGGACTAGCGGGAGGGCCCCTCTACGAGCAGTACTTC	CASSLAGLAGGPLYEQYF	TRBV7-9	TRBJ2-7
TGTGCCAGCCCCTCCAGTTTCCGCTACGAGCAGTACTTC	CASPSSFRYEQYF	TRBV6-2	TRBJ2-7
TGTGCCAGCAGCTTCAGCCGACAGGGGGAAAGTTCACCCCTCCACTTT	CASSFSRQGESSPLHF	TRBV5-5	TRBJ1-6
TGTGCCACCGAGGGAGGAAATCAGCCCCAGCATTTT	CATEGGNQPQHF	TRBV24-1	TRBJ1-5
TGCGCCAGCAGCCAGACCCAGCCCCAGCATTTT	CASSQTQPQHF	TRBV4-1	TRBJ1-5
TGTGCCAGCAGGACAGGGCCGAACCCGATGTCTAATGAAAAACTGTTTTTT	CASRTGPNPMSNEKLFF	TRBV2	TRBJ1-4
TGTGCCATCAGATGGTCAGGGGCGGGGAACACTGAAGCTTTCTTT	CAIRWSGAGNTEAFF	TRBV10-3	TRBJ1-1
TGCGCCAGCAGCCAAGATGCCCAACAGCGGGAGGTTCATGAGCAGTTCTTC	CASSQDAQQREVHEQFF	TRBV4-3	TRBJ2-1
TGTGCCAGCAGCTTAGTTTTAAAGCTAGCGGGGACCTACAATGAGCAGTTCTTC	CASSLVLKLAGTYNEQFF	TRBV7-9	TRBJ2-1
TGTGCCACCAGTGATTTGGGGACGTATAAAGGCTACACCTTC	CATSDLGTYKGYTF	TRBV24-1	TRBJ1-2
TGTGCCAGCAGTGACCCCCACAAAAAGCAGCCCCAGCATTTT	CASSDPHKKQPQHF	TRBV6-4	TRBJ1-5
TGTGCCAGCAGCCAAGCGGTTGGGAGTGGGGGGAGCTACGAGCAGTACTTC	CASSQAVGSGGSYEQYF	TRBV4-2	TRBJ2-7
TGTGCCAGCAGTGAACAGCGGGTTAATGAGCAGTTCTTC	CASSEQRVNEQFF	TRBV25-1	TRBJ2-1
TGTGCCACCAGTGAATCAGGACAGGGAGCCTCGCTTTACTACGAGCAGTACTTC	CATSESGQGASLYYEQYF	TRBV24-1	TRBJ2-7
TGTGCCAGCAGACGGCCTCGCCAGTATTTT	CASRRPRQYF	TRBV28	TRBJ2-3
TGCGCCAGCAGCCAAGACCTCTCTAGCGGGTGGTTAAACATTCAGTACTTC	CASSQDLSSGWLNIQYF	TRBV4-3	TRBJ2-4
TGTGCCAGCAAGGATTACGAGCAGTACTTC	CASKDYEQYF	TRBV27	TRBJ2-7
TGTGCCAGCAGCGTTAACACACACAGGGGGCGAGGGGGCTACGAGCAGTACTTC	CASSVNTHRGRGGYEQYF	TRBV7-3	TRBJ2-7
TGTGCCACGGCCGTGGGACAGGGGCCCTCACCCCTCCACTTT	CATAVGQGPSPLHF	TRBV24-1	TRBJ1-6
TGCGCCAGCAGCTTGTCACCACAGGGTTTAAAGAATCAGCCCCAGCATTTT	CASSLSPQGLKNQPQHF	TRBV5-1	TRBJ1-5
TGTGCCATCAGTTGCCCTCTCAGATGGGGTTCCTACGAGCAGTACTTC	CAISCPLRWGSYEQYF	TRBV10-3	TRBJ2-7
TGTGCCAGCAGTCTTGACAGCGGCTACACCTTC	CASSLDSGYTF	TRBV11-3	TRBJ1-2
TGCAGTGGTCCTTTAACCTACGAGCAGTACTTC	CSGPLTYEQYF	TRBV20-1	TRBJ2-7
TGTGCCAGCAGTGGGGCAGGGGGCACCGGGGAGCTGTTTTTT	CASSGAGGTGELFF	TRBV28	TRBJ2-2
TGTGCCAGCAGCTGTCCCGTAGTGTCACCCCTCCACTTT	CASSCPVVSPLHF	TRBV5-5	TRBJ1-6
TGTGCCAGCAGTGAAATATGGGCGGCCTACGAGCAGTACTTC	CASSEIWAAYEQYF	TRBV2	TRBJ2-7
TGCAGTGCTAGAGATTTAGTAGACAGACGGTTGACCCAGTACTTC	CSARDLVDRRLTQYF	TRBV20-1	TRBJ2-5
TGCGCCAGCAGTGGGGATAGGGACCACACTGAAGCTTTCTTT	CASSGDRDHTEAFF	TRBV10-1	TRBJ1-1
TGCAGTGCTAAGGATTTGGGGAGGTTATGGAATGAGCAGTTCTTC	CSAKDLGRLWNEQFF	TRBV20-1	TRBJ2-1
TGTGCCAATAACCCAGAACTAGCGGGAGGGGGGCCCCAGCATTTT	CANNPELAGGGPQHF	TRBV10-3	TRBJ1-5
TGTGCCAGCAGGCGGGAGAACGAGCAGTACTTC	CASRRENEQYF	TRBV6-5	TRBJ2-7
TGTGCCATCAGTGACGCCGCATCCGGGGTGGAAAAACTGTTTTTT	CAISDAASGVEKLFF	TRBV10-3	TRBJ1-4
TGCAGTGCAAAGCAGTACGACACAGATACGCAGTATTTT	CSAKQYDTDTQYF	TRBV20-1	TRBJ2-3
TGTGCCAGCAGCCTCGGATGTGACAGGGGAGCGAACACTGAAGCTTTCTTT	CASSLGCDRGANTEAFF	TRBV14	TRBJ1-1
TGTGCCAGCAGCTCAGGTGAAAAACTGTTTTTT	CASSSGEKLFF	TRBV11-3	TRBJ1-4
TGTGCCAGCAGCTTAACGATGGGGGGAGGCACAGATACGCAGTATTTT	CASSLTMGGGTDTQYF	TRBV11-2	TRBJ2-3
TGTGCCAGCCCACAGGGAACGTTGGGGGGGGACGAGCAGTACTTC	CASPQGTLGGDEQYF	TRBV11-3	TRBJ2-7
TGCGCCAGCAGCTCTAGAGAGACCCAGTACTTC	CASSSRETQYF	TRBV5-1	TRBJ2-5
TGTGCCAGCGTTAAGCTCAGCTCCTACGAGCAGTACTTC	CASVKLSSYEQYF	TRBV2	TRBJ2-7
TGTGCCAGTAGTATAGCACCCGCAGGGGGCTACGACACTGAAGCTTTCTTT	CASSIAPAGGYDTEAFF	TRBV19	TRBJ1-1
TGTGCCAGGGGGGGCGGAGAGACCCAGTACTTC	CARGGGETQYF	TRBV11-3	TRBJ2-5
TGTGCCAGCAGGGGGACAGGGGGCGAGGCCTACGAGCAGTACTTC	CASRGTGGEAYEQYF	TRBV6-2	TRBJ2-7
TGCGCCAGCAGCCAACAACAAATGAACACTGAAGCTTTCTTT	CASSQQQMNTEAFF	TRBV4-1	TRBJ1-1
TGTGCCAGCAGTGACCCTACTGAAGCTTTCTTT	CASSDPTEAFF	TRBV6-4	TRBJ1-1
TGTGCCAGCAGCCCGGGACAGGGGCGCTGGTACGATGGCTACACCTTC	CASSPGQGRWYDGYTF	TRBV6-3	TRBJ1-2
TGTGCCAGCAGCTTAGATCAGGGCACCTCTGGAAACACCATATATTTT	CASSLDQGTSGNTIYF	TRBV11-2	TRBJ1-3
TGTGCCAGCAGCCAACGGGACATGGCCTCTGGAAACACCATATATTTT	CASSQRDMASGNTIYF	TRBV14	TRBJ1-3
TGTGCCACCAGTGATTTAAACGGCCAAAAAGCCAATCAGCCCCAGCATTTT	CATSDLNGQKANQPQHF	TRBV24-1	TRBJ1-5
TGCGCCAGCAGTGAGCTGGGGGCCAGCAATCAGCCCCAGCATTTT	CASSELGASNQPQHF	TRBV10-1	TRBJ1-5
TGTGCCAGCAGCAGGGCCGGGACAGGGAATTGGCAACTAGACTCCTACGAGCAGTACTTC	CASSRAGTGNWQLDSYEQYF	TRBV13	TRBJ2-7
TGCGCCAGCAGTCCACCAACCCAAGAGGCCACCGGGGAGCTGTTTTTT	CASSPPTQEATGELFF	TRBV10-1	TRBJ2-2
TGTGCCAGCAGCCCTGGGGAGCGACAGGCGGGAAGGTATAGCAATCAGCCCCAGCATTTT	CASSPGERQAGRYSNQPQHF	TRBV6-5	TRBJ1-5
TGTGCCAGCAGTGTCGGGTGGGACAGGGGGCGAGTGTGGGGAGAGACCCAGTACTTC	CASSVGWDRGRVWGETQYF	TRBV6-4	TRBJ2-5
TGTGCCAGCAGTGTAGGACAGGAGAGGGCGCAGTACTTC	CASSVGQERAQYF	TRBV27	TRBJ2-7
TGTGCCAGCAGATTCCAGTGGCTGAAGGGCAATGAGCAGTTCTTC	CASRFQWLKGNEQFF	TRBV27	TRBJ2-1
TGTGCCAGTAGTCTGGACCCACAGCCCCAGCATTTT	CASSLDPQPQHF	TRBV19	TRBJ1-5
TGCGCCAGCAGTGAGTCGCCAGCTTCCAGCGGGGAAGAGACCCAGTACTTC	CASSESPASSGEETQYF	TRBV10-1	TRBJ2-5
TGTGCCAGCAGCTTGGGGGGAATCTACAATGAGCAGTTCTTC	CASSLGGIYNEQFF	TRBV5-6	TRBJ2-1
TGCAGTGCTAGCCGCAGCCACTCTGGAAACACCATATATTTT	CSASRSHSGNTIYF	TRBV20-1	TRBJ1-3
TGTGCCAGCAGCGAGACAGGGTCCGGAGATGAAAAACTGTTTTTT	CASSETGSGDEKLFF	TRBV7-6	TRBJ1-4
TGTGCCAGCAGCGTATCCTTCGGGGACAGGACCCCCTACGAGCAGTACTTC	CASSVSFGDRTPYEQYF	TRBV9	TRBJ2-7
TGCAGTGCCCTAGGGACAAACGACACAGATACGCAGTATTTT	CSALGTNDTDTQYF	TRBV20-1	TRBJ2-3
TGTGCCACGATGAATCCAGTTCACAGACAGGGGGTAGAGAGCCCTGAAGCTTTCTTT	CATMNPVHRQGVESPEAFF	TRBV11-2	TRBJ1-1
TGTGCCAGCAGTCCGGGACTAGCCCGAGTCTTC	CASSPGLARVF	TRBV25-1	TRBJ2-1
TGTGCCAGCAGCTTTAAGATGGGACTGGACACCTTC	CASSFKMGLDTF	TRBV5-5	TRBJ1-2
TGCGCCAGCAGTTCTAGGAATGAGCAGTTCTTC	CASSSRNEQFF	TRBV10-1	TRBJ2-1
TGCAGCGTTGAGGTGGGGGCAGCTTTCTTT	CSVEVGAAFF	TRBV29-1	TRBJ1-1
TGTGCCAGCAGCATGGGGGCCTCTGAAGCTTTCTTT	CASSMGASEAFF	TRBV9	TRBJ1-1
TGCAGTGCTAAGGGGGAGGAGCCAACTAATGAAAAACTGTTTTTT	CSAKGEEPTNEKLFF	TRBV20-1	TRBJ1-4
TGTGCCTCGAGAGGTAGGTATGGCTACACCTTC	CASRGRYGYTF	TRBV24-1	TRBJ1-2
TGTGCCAGCAGAGCGATAACTCTGGCTCCGGGCGCCAAAAACATTCAGTACTTC	CASRAITLAPGAKNIQYF	TRBV2	TRBJ2-4
TGTGCCAGCAGCGGAATCTACTGGAAGAACTTGAACACTGAAGCTTTCTTT	CASSGIYWKNLNTEAFF	TRBV7-2	TRBJ1-1
TGTGCCAGCAGCTTAGCTGGACAGGGGGCTAGCTACGAGCAGTACTTC	CASSLAGQGASYEQYF	TRBV7-4	TRBJ2-7
TGCGCCAGCAGCCAAGATCTCCCGCGGACGAAATACACCTTC	CASSQDLPRTKYTF	TRBV4-1	TRBJ1-2
TGTGCCAGCCGGAATGGTTCAGGGGACCGGATCTTTACTGAAGCTTTCTTT	CASRNGSGDRIFTEAFF	TRBV27	TRBJ1-1
TGTGCCAGCTCACCCATTGGGTCAACAGGAAGGGGAAATTCACCCCTCCACTTT	CASSPIGSTGRGNSPLHF	TRBV18	TRBJ1-6
TGCGCCAGCAGCCCAAGTCCAAGTAAGGGGAATAACTACGAGCAGTACTTC	CASSPSPSKGNNYEQYF	TRBV5-1	TRBJ2-7
TGCAGCGTCGGTATACGAAAACACGAAGCTTTCTTT	CSVGIRKHEAFF	TRBV29-1	TRBJ1-1
TGTGCCAGCAGCGGAGAACACCCAGGTACGTATGGCTACACCTTC	CASSGEHPGTYGYTF	TRBV11-2	TRBJ1-2
TGCGCCAGCAGCTTAATCCGCTGGACAGAGCATGGGGACAATGAGCAGTTCTTC	CASSLIRWTEHGDNEQFF	TRBV5-1	TRBJ2-1
TGTGCCAGTGGTAAAGCCGGGACGAAAGATACGCAGTATTTT	CASGKAGTKDTQYF	TRBV11-3	TRBJ2-3
TGCGCCAGCCTAAGGGACAGGGGGTGGAACGAAGCTTTCTTT	CASLRDRGWNEAFF	TRBV5-1	TRBJ1-1
TGTGCCAGCAGCTTACGTTCAGCGGGAGACACGGGCCAAGAGACCCAGTACTTC	CASSLRSAGDTGQETQYF	TRBV7-7	TRBJ2-5
TGTGCCAGCAGCTTGCCGCCGAGGACAGGGACCAGAGGGGCCAACGTCCTGACTTTC	CASSLPPRTGTRGANVLTF	TRBV5-6	TRBJ2-6
TGTGCCAGCAGCCAAGAAGACTTAGTATTGGGTATTCAGCCCCAGCATTTT	CASSQEDLVLGIQPQHF	TRBV3-1	TRBJ1-5
TGCAGTGCTTCTACCTCTGACAGAGGAACTGAAGCTTTCTTT	CSASTSDRGTEAFF	TRBV20-1	TRBJ1-1
TGCGCCAGTACCGGGACAGGGGGAGGTTTCCAGAACACCGGGGAGCTGTTTTTT	CASTGTGGGFQNTGELFF	TRBV5-1	TRBJ2-2
TGTGCCAGCAGCTCCCTACGGTGGCACTACGAGCAGTACTTC	CASSSLRWHYEQYF	TRBV5-4	TRBJ2-7
TGTGCCAGCAGCGGGGTACACAGAATAGCCTACGAGCAGTACTTC	CASSGVHRIAYEQYF	TRBV7-3	TRBJ2-7
TGTGCCAGCAAAGGGACAGGGATGGGGGGTGTCGAAAAACTGTTTTTT	CASKGTGMGGVEKLFF	TRBV27	TRBJ1-4
TGTGCTAGTGGTTCCCACCCAAGCGGAGGCCAGCCGTCCCAGCATTTT	CASGSHPSGGQPSQHF	TRBV12-5	TRBJ1-5
TGCAGCCTCCTCTTTAACACCGGGGAGCTGTTTTTT	CSLLFNTGELFF	TRBV29-1	TRBJ2-2
TGCAGCGTTGGACGGGTTTGCTACGAGCAGTACTTC	CSVGRVCYEQYF	TRBV29-1	TRBJ2-7
TGCGCCAGCAGCTACAGGTGCGAAGCCTACGAGCAGTACTTC	CASSYRCEAYEQYF	TRBV5-1	TRBJ2-7
TGTGCCAGCAGCGCCCCTCTTAGAGCAGGGGTAGTACGTACTAACTACGAGCAGTACTTC	CASSAPLRAGVVRTNYEQYF	TRBV28	TRBJ2-7
TGTGCCAGCAGCCAAGATTTGGGGTCGCCTAGCGGGGACAGCTACGAGCAGTACTTC	CASSQDLGSPSGDSYEQYF	TRBV3-1	TRBJ2-7
TGTGCCAGCAGCCATCCTTGGGGTGGGGGGGGGTATTTGGGGGACCCCATTTATCAAGAGACCCAGTACTTC	CASSHPWGGGGYLGDPIYQETQYF	TRBV14	TRBJ2-5
TGTGCCAGCAGCTTCCGACTAGCGGGATTGTACTTC	CASSFRLAGLYF	TRBV7-7	TRBJ2-7
TGCAGTGCTAGTCTGGGAAGGACACCCCCTTCGCGGGGGGACAAGTTCACTGAAGCTTTCTTT	CSASLGRTPPSRGDKFTEAFF	TRBV20-1	TRBJ1-1
TGTGCCAGCAGCCGCTCCGGGACACCCGTCAATCAGCCCCAGCATTTT	CASSRSGTPVNQPQHF	TRBV11-2	TRBJ1-5
TGTGCCACCAGTCAGGTAGGGGGGTATAGCAATCAGCCCCAGCATTTT	CATSQVGGYSNQPQHF	TRBV24-1	TRBJ1-5
TGTGCCAGCAGTGGACAACACCAGTGGCAAGAGACCCAGTACTTC	CASSGQHQWQETQYF	TRBV7-3	TRBJ2-5
TGTGCCAGCAGTGACAGCAATGAAAAACTGTTTTTT	CASSDSNEKLFF	TRBV6-4	TRBJ1-4
TGTGCCAGCACGGGATCGGGACAGGGTTCCACACCCCTCCACTTT	CASTGSGQGSTPLHF	TRBV6-4	TRBJ1-6
TGCGCCAGCAGCTTGGCTTCAGGCAAAAAGGGCCCGGAAAAACTGTTTTTT	CASSLASGKKGPEKLFF	TRBV5-1	TRBJ1-4
TGTGCTAGTATTGACAGGGGGCGGAGCGAGCAGTACTTC	CASIDRGRSEQYF	TRBV12-5	TRBJ2-7
TGCGCCAGCAGTGGCCCAAGGAGGACCGGGGAGCTGTTTTTT	CASSGPRRTGELFF	TRBV10-1	TRBJ2-2
TGTGCCAGCAGCGCCTGGGGGGCGAGAGTAGGCGTAGAGACCCAGTACTTC	CASSAWGARVGVETQYF	TRBV9	TRBJ2-5
TGTGCCAGCAGTTCGGGGGGCTGCAGGGACGGAGGAACTGAAGCTTTCTTT	CASSSGGCRDGGTEAFF	TRBV12-4	TRBJ1-1
TGCGCCAGCAAACAGGGGCACGAGGATAGCAATCAGCCCCAGCATTTT	CASKQGHEDSNQPQHF	TRBV10-1	TRBJ1-5
TGCGCCAGCAGCCAAGCCTACGGGCCACTGGGCACTGAAGCTTTCTTT	CASSQAYGPLGTEAFF	TRBV4-1	TRBJ1-1
TGTGCCAGCAGCTTGGGGGCGTCAACAGGGAACACTGAAGCTTTCTTT	CASSLGASTGNTEAFF	TRBV5-6	TRBJ1-1
TGTGCCAGCAGTTTTATGACAGGGCGGGAGAGGAGCTCCTATAATTCACCCCTCCACTTT	CASSFMTGRERSSYNSPLHF	TRBV27	TRBJ1-6
TGCGCCAGCAGCTTGGGGGTCAAGATCGAGCGGGATCAACCGACCGGGGAGCTGTTTTTT	CASSLGVKIERDQPTGELFF	TRBV5-1	TRBJ2-2
TGTGCCAGCAGCTTAGGAAAAGCCGGACAGAGCCACACTGAAGCTTTCTTT	CASSLGKAGQSHTEAFF	TRBV7-8	TRBJ1-1
TGTGCCAGCAGCCATGGACTAACAGTTAACACTGAAGCTTTCTTT	CASSHGLTVNTEAFF	TRBV14	TRBJ1-1
TGTGCCAGCAGCGTAGCCGGGGACTGCGGCTTTCCTGAGCAGTTCTTC	CASSVAGDCGFPEQFF	TRBV9	TRBJ2-1
TGTGCCAGCCTTCCGGGGGCAGGGGGAATAAAGGCGGGGTTCGGCAATCAGCCCCAGCATTTT	CASLPGAGGIKAGFGNQPQHF	TRBV19	TRBJ1-5
TGTGCCAGCAGTGAGAGGAAAGAAAAACTGTTTTTT	CASSERKEKLFF	TRBV6-4	TRBJ1-4
TGTGCCAGCAAGGGGACACCAACGACTGAGCAGTTCTTC	CASKGTPTTEQFF	TRBV27	TRBJ2-1
TGTGCCATAGCCTCCGGGACAGACAATGAGCAGTTCTTC	CAIASGTDNEQFF	TRBV9	TRBJ2-1
TGTGCCACCAGTGATCCCCCCAGGCAAGAAGAGACCCAGTACTTC	CATSDPPRQEETQYF	TRBV24-1	TRBJ2-5
TGCAGTCTCTCATCGATTCCGAGGGGCCAGTACTTC	CSLSSIPRGQYF	TRBV20-1	TRBJ2-5
TGCGCCAGCAGTGAGCTGTCACGCGGTGCCCTCCACTTT	CASSELSRGALHF	TRBV10-2	TRBJ1-6
TGTGCCAGCAGTGATCACGTGGAGACTGAAGCTTTCTTT	CASSDHVETEAFF	TRBV12-4	TRBJ1-1
TGTATCGGCCGTCAGGTGAGGTTGGGCACAGATACGCAGTATTTT	CIGRQVRLGTDTQYF	TRBV30	TRBJ2-3
TGTGCAGATGTCGAAGGGGTGCTAAACTATGGCTACACCTTC	CADVEGVLNYGYTF	TRBV15	TRBJ1-2
TGCGCCAGTACCGGGACTAGAGTTCGCCGAGGAAATGAGCAGTTCTTC	CASTGTRVRRGNEQFF	TRBV10-1	TRBJ2-1
TGTGCCAGCAGAGGGGCTAGCGGGGACAATGAGCAGTTCTTC	CASRGASGDNEQFF	TRBV5-6	TRBJ2-1
TGTGCCAAGGGACAACAGCGGGAGCTGTTTTTT	CAKGQQRELFF	TRBV7-6	TRBJ1-4
TGTGCCAGCATTCAGGGCTACGAGCAGTACTTC	CASIQGYEQYF	TRBV2	TRBJ2-7
TGTGCCAGCAAGAATATAGTTACCCCCGGGGAGCTGTTTTTT	CASKNIVTPGELFF	TRBV6-5	TRBJ2-2
TGTGCCAGCAGCGGCGGACAGGGGAACGATGCCTACGAGCAGTACTTC	CASSGGQGNDAYEQYF	TRBV7-3	TRBJ2-7
TGTGCCAGCAGACCTATTGGCTTTAGCTCCTACAATGAGCAGTTCTTC	CASRPIGFSSYNEQFF	TRBV9	TRBJ2-1
TGTGCCACCAGTGTGGGGGGTGTTCCGAATAGCAATCAGCCCCAGCATTTT	CATSVGGVPNSNQPQHF	TRBV24-1	TRBJ1-5
TGTGCCAGCAGGGACACCCCCCTACACCCTTCCAGGGGGCGAGGCGCTGAAGCTTTCTTT	CASRDTPLHPSRGRGAEAFF	TRBV12-3	TRBJ1-1
TGCAGCGTTGAGATTCCGGGCTCCAAGGGGGAGCTGTTTTTT	CSVEIPGSKGELFF	TRBV29-1	TRBJ2-2
TGTGCCACCAGCAGAGGAGGGGAGGACAATGAGCAGTTCTTC	CATSRGGEDNEQFF	TRBV15	TRBJ2-1
TGTGCCAGCAGTATGGTTAGAAGTTCGGTGAGAAAGTCCGGGACAGGGAACTCTGGAAACACCATATATTTT	CASSMVRSSVRKSGTGNSGNTIYF	TRBV27	TRBJ1-3
TGTGCCAGCAGTTATGTATGCGGGGAGCTGTTTTTT	CASSYVCGELFF	TRBV12-3	TRBJ2-2
TGTGCACGCCTCCGACTAGCGGGGGGGGGCTTCTTACAAGAGACCCAGTACTTC	CARLRLAGGGFLQETQYF	TRBV7-2	TRBJ2-5
TGTGCCTGGCCCTTCCTAGCGGGTTCCCAAGAGACCCAGTACTTC	CAWPFLAGSQETQYF	TRBV30	TRBJ2-5
TGCGCCAGCAGTGAGTCGACGGGTGTAGGAGGGACCAATTGCAGCAATCAGCCCCAGCATTTT	CASSESTGVGGTNCSNQPQHF	TRBV10-1	TRBJ1-5
TGTGCCACCATTCGGACGACCCAGTACTTC	CATIRTTQYF	TRBV24-1	TRBJ2-5
TGCGCCAGGACCCGGGACAGCCTCGCTAATGCTTTCTTT	CARTRDSLANAFF	TRBV4-1	TRBJ1-1
TGTGCCAGGGAGCCGGGACAATGTGAAGCTTTCTTT	CAREPGQCEAFF	TRBV25-1	TRBJ1-1
TGTGCCAGCAGCAGGCGGGACAGGGGCTACGAGCAGTACTTC	CASSRRDRGYEQYF	TRBV7-3	TRBJ2-7
TGCGCCAGCAGCCTGTCGAAGGTAAGGCTTAGCAATCAGCCCCAGCATTTT	CASSLSKVRLSNQPQHF	TRBV4-3	TRBJ1-5
TGTGCCAGCAGTGACATCGACAGGCCGGGCGAGCAGTACTTC	CASSDIDRPGEQYF	TRBV6-4	TRBJ2-7
TGTGCCAGCAGCGTCCCGCTAGTAACCGTCTACGAGCAGTACTTC	CASSVPLVTVYEQYF	TRBV13	TRBJ2-7
TGTGCCATCACCGCCGGGACAGGGTCTGATGACTATGGCTACACCTTC	CAITAGTGSDDYGYTF	TRBV10-3	TRBJ1-2
TGTGCCAGCAGTCCCCTCCATAACCCCAATCAGCCCCAGCATTTT	CASSPLHNPNQPQHF	TRBV6-3	TRBJ1-5
TGCGCCAGACGGGGAGGGCCCTACAATGAGCAGTTCTTC	CARRGGPYNEQFF	TRBV5-1	TRBJ2-1
TGTGCCAGCAAAGGGACCTCGGATGGACTCTACGAGCAGTACTTC	CASKGTSDGLYEQYF	TRBV9	TRBJ2-7
TGTGCCAGCAGCTTAGTGCCGACGAGACCTAATGAAAAACTGTTTTTT	CASSLVPTRPNEKLFF	TRBV11-3	TRBJ1-4
TGCAGCGTAACGGCTAGCGGCAGCTCCTACAATGAGCAGTTCTTC	CSVTASGSSYNEQFF	TRBV29-1	TRBJ2-1
TGTGCCAGCAGCCAGAACGAGCAGTACTTC	CASSQNEQYF	TRBV14	TRBJ2-7
TGTGCCAGCAGCTTAGTATACGAGCAGTACTTC	CASSLVYEQYF	TRBV7-2	TRBJ2-7
TGCGCCAGCAGTCCAGAAAAGGAGAAGAGAGGCAATTCACCCCTCCACTTT	CASSPEKEKRGNSPLHF	TRBV10-2	TRBJ1-6
TGTGCCAGCAGCTTAGGGATGGGGGGGCCCGAGCAGTACTTC	CASSLGMGGPEQYF	TRBV7-6	TRBJ2-7
TGTGCCAGCAGCCACAGAGGTGCCTACGAGCAGTACTTC	CASSHRGAYEQYF	TRBV14	TRBJ2-7
TGTGCCACCAGTGAAGGTAGCGGGAGCTGCGAGCAGTACTTC	CATSEGSGSCEQYF	TRBV24-1	TRBJ2-7
TGTGCCAGCAGCTTGGGGCCCTACGAGCAGTACTTC	CASSLGPYEQYF	TRBV5-5	TRBJ2-7
TGTGCCAGCAGCACGTCTTACGAGCAGTACTTC	CASSTSYEQYF	TRBV6-5	TRBJ2-7
TGCAGTGCTAGGGAGACAGGGCGGATGATCGAAAAACTGTTTTTT	CSARETGRMIEKLFF	TRBV20-1	TRBJ1-4
TGTGCCAGCAGGGTCAGCGGGATTTTGTTGAGCACAGATACGCAGTATTTT	CASRVSGILLSTDTQYF	TRBV5-8	TRBJ2-3
TGTGCCAGCTCATTCCGGGGGGGGAGGTTCTCAGATACGCAGTATTTT	CASSFRGGRFSDTQYF	TRBV18	TRBJ2-3
TGCGCCAGCAGCAAGGAACCTAAGAGACAGGGATCCCCCTACAATGAGCAGTTCTTC	CASSKEPKRQGSPYNEQFF	TRBV5-1	TRBJ2-1
TGTGCCAGCACTCGGGAGGCTGAAGCTTTCTTT	CASTREAEAFF	TRBV7-9	TRBJ1-1
TGTGCCAGCAGTTACTCGCCTCACCAGGGGTGCATGAACACTGAAGCTTTCTTT	CASSYSPHQGCMNTEAFF	TRBV6-5	TRBJ1-1
TGCAGTGCTAGACTCAGGGGAAATCAGCCCCAGCATTTT	CSARLRGNQPQHF	TRBV20-1	TRBJ1-5
TGTGCCAGCAGCTGCTACCAGTGCTTAAACTACGAGCAGTACTTC	CASSCYQCLNYEQYF	TRBV14	TRBJ2-7
TGTGCCAGCATCGGCCAGGGTTATTCCTCGGGATCCGGCCTAGCCAAAAACATTCAGTACTTC	CASIGQGYSSGSGLAKNIQYF	TRBV27	TRBJ2-4
TGTGCCTTGTCTAGGGCCATTCAGTACTTC	CALSRAIQYF	TRBV30	TRBJ2-4
TGCGCCAGCAGCCATCTAGCCGGGCCGGGGGAGCTGTTTTTT	CASSHLAGPGELFF	TRBV4-1	TRBJ2-2
TGTGCCAGCTCACCATGCTGTAGGGACAGTTGGGCCTACACTGAAGCTTTCTTT	CASSPCCRDSWAYTEAFF	TRBV18	TRBJ1-1
TGTGCCAGCAGCATTGGACAGGTGAACAATTCACCCCTCCACTTT	CASSIGQVNNSPLHF	TRBV7-3	TRBJ1-6
TGCGCCAGCAGCCATCCCCAGATTACTTACACTGAAGCTTTCTTT	CASSHPQITYTEAFF	TRBV4-3	TRBJ1-1
TGTGCCAGCAAAGGGGGACAGAAAGGACCCGACTATGGCTACACCTTC	CASKGGQKGPDYGYTF	TRBV7-2	TRBJ1-2
TGTGCCAGCACGGGGGGGGGGATAGAGACCCAGTACTTC	CASTGGGIETQYF	TRBV6-4	TRBJ2-5
TGTGCCAGCAGTCAAGTCGCACAGGTAGGATCCAGGGGCACCGGGGAGCTGTTTTTT	CASSQVAQVGSRGTGELFF	TRBV28	TRBJ2-2
TGTGCCAGCATGGGGGACATGTCCTATGGCTACACCTTC	CASMGDMSYGYTF	TRBV27	TRBJ1-2
TGTGCCAGCAGCTTCGGGAGTGATAGCAATCAGCCCCAGCATTTT	CASSFGSDSNQPQHF	TRBV7-6	TRBJ1-5
TGTGCCAACGTAACGGACAGGGGGAATGAGCAGTTCTTC	CANVTDRGNEQFF	TRBV6-5	TRBJ2-1
TGTGCCAGCAGTGACTCCTCTTGGGACGGGGGCTACACCTTC	CASSDSSWDGGYTF	TRBV6-4	TRBJ1-2
TGCGCCAGCTATCCGGGACAGTACACTGAAGCTTTCTTT	CASYPGQYTEAFF	TRBV10-1	TRBJ1-1
TGTGCCTGGTTTTCCGGGCTTGGGTACGAGCAGTACTTC	CAWFSGLGYEQYF	TRBV30	TRBJ2-7
TGTGCCAGCTACAAGTATAGCAATCAGCCCCAGCATTTT	CASYKYSNQPQHF	TRBV7-2	TRBJ1-5
TGTGCCACCCACCCCCATCGGGAGGACACCGACGAGCAGTACTTC	CATHPHREDTDEQYF	TRBV15	TRBJ2-7
TGTGCCAGTAGTATAGTCTGTGAAGCTTTCTTT	CASSIVCEAFF	TRBV19	TRBJ1-1
TGTGCCAGCAGCCCCGAGTCCCAGGGACTAGCGGGTCCCCCCTACGAGCAGTACTTC	CASSPESQGLAGPPYEQYF	TRBV7-4	TRBJ2-7
TGTGCCAGCAGCTTATGGTTAGGGGCACCGTCGAACGGCTACACCTTC	CASSLWLGAPSNGYTF	TRBV13	TRBJ1-2
TGCAGTGCTACCGGGCCAAATGGCTACACCTTC	CSATGPNGYTF	TRBV20-1	TRBJ1-2
TGTGCCAGCAGCCAAGATTGCTGGAACACGGGTAATCAGCCCCAGCATTTT	CASSQDCWNTGNQPQHF	TRBV4-2	TRBJ1-5
TGTGCCAGCAGCTATGACAGGGGGCGGTGTCGCTATTTT	CASSYDRGRCRYF	TRBV7-3	TRBJ1-3
TGTGCCAGCAGAATGACTAGCGGGAGGGCGACAGATACGCAGTATTTT	CASRMTSGRATDTQYF	TRBV6-3	TRBJ2-3
TGTGCCAGCAGCCAAGATGCTCCCAGGGGGTTCCAAGAGACCCAGTACTTC	CASSQDAPRGFQETQYF	TRBV14	TRBJ2-5
TGTGCCAGCAGTGAACCAACCCCCCGGAATACCGCAGATACGCAGTATTTT	CASSEPTPRNTADTQYF	TRBV6-1	TRBJ2-3
TGTGCCAGCAGCTATACCCGCTCTAACTATGGCTACACCTTC	CASSYTRSNYGYTF	TRBV11-3	TRBJ1-2
TGTGCCATCAGTCCCAACCGCGGACTAGCGGAGAGTTACAATGAGCAGTTCTTC	CAISPNRGLAESYNEQFF	TRBV10-3	TRBJ2-1
TGTGCCAGCAGTAAACGAAGGGCTGGAAACACCATATATTTT	CASSKRRAGNTIYF	TRBV6-3	TRBJ1-3
TGTGCCAGCAGTAGTCTAATGTCCCATGCTTTCTTT	CASSSLMSHAFF	TRBV12-3	TRBJ1-1
TGTGCCAGGTGGTCCCGACAGGGGAACCAAAAACACACTGAAGCTTTCTTT	CARWSRQGNQKHTEAFF	TRBV9	TRBJ1-1
TGCGCCAGCAGCCACCGGTGGAGGGAGGAGAGGGAGCTGTTTTTT	CASSHRWREERELFF	TRBV4-1	TRBJ2-2
TGTGCCATCAGGAAGCGACAGGGGGACAATCAGCCCCAGCATTTT	CAIRKRQGDNQPQHF	TRBV10-3	TRBJ1-5
TGTGCCAGCAGCCACACCGGGACAGGGGGAGGGGGCTACGAGCAGTACTTC	CASSHTGTGGGGYEQYF	TRBV14	TRBJ2-7
TGTGCCAGCAGCGTCCCAGAAATACCCTACGAGCAGTACTTC	CASSVPEIPYEQYF	TRBV7-6	TRBJ2-7
TGTGCCAGCAGAAGGGGTTGTGACGCAGATACGCAGTATTTT	CASRRGCDADTQYF	TRBV13	TRBJ2-3
TGTGCCAGCAGCCTTTCCGCTGAAGGGGGGGAGTACGAGCAGTACTTC	CASSLSAEGGEYEQYF	TRBV7-7	TRBJ2-7
TGCGCCAGCCACGAGGGGTGCTACGAGCAGTACTTC	CASHEGCYEQYF	TRBV4-3	TRBJ2-7
TGTGCCACCAGGCGCGAACCAGGGGACAGGGCGGTTAACGGCACTGAAGCTTTCTTT	CATRREPGDRAVNGTEAFF	TRBV24-1	TRBJ1-1
TGTGCCAGCAGTTTACCGCCAACTGGACAGAGGTACGAGCAGTACTTC	CASSLPPTGQRYEQYF	TRBV12-4	TRBJ2-7
TGCAGCGTTGAGAGGGGGGTCAGGGGGGGGGAGACCCAGTACTTC	CSVERGVRGGETQYF	TRBV29-1	TRBJ2-5
TGTGCCAGCAGCCAAGATTGGGGACAGGGTGGCTACACCTTC	CASSQDWGQGGYTF	TRBV3-1	TRBJ1-2
TGTGCCATGGGGACACGCAAAGCTTTCTTT	CAMGTRKAFF	TRBV7-8	TRBJ1-1
TGTGCCAGTAAACTGGCCGAGACCCAGTACTTC	CASKLAETQYF	TRBV19	TRBJ2-5
TGTGCCAGCAGCAAACCGGGGAGTTCTGGAAACACCATATATTTT	CASSKPGSSGNTIYF	TRBV7-9	TRBJ1-3
TGTGCCAGCAGCTTTAAGCTCAGGGGGGAGCCTGACTCTGGGGCCAACGTCCTGACTTTC	CASSFKLRGEPDSGANVLTF	TRBV11-2	TRBJ2-6
TGTGCCACTCAGACCGCGGGAGGAAGGGATAGCAATCAGCCCCAGCATTTT	CATQTAGGRDSNQPQHF	TRBV6-1	TRBJ1-5
TGTGCCAGCAGCTTGCGCCTGGGACAGGACAATGAAGCTTTCTTT	CASSLRLGQDNEAFF	TRBV5-6	TRBJ1-1
TGTGCCAGCAGTGCGGGACAGGGATGGGTTGCTTACAGCAATCAGCCCCAGCATTTT	CASSAGQGWVAYSNQPQHF	TRBV27	TRBJ1-5
TGTGCCAGCAGCTTAGGATTGAGCGGGACACAGAATGAAAAACTGTTTTTT	CASSLGLSGTQNEKLFF	TRBV11-3	TRBJ1-4
TGTGCCAGCATCGGGTACCATGGCTACACCTTC	CASIGYHGYTF	TRBV9	TRBJ1-2
TGTGCCAGCACGTGTCTACGGGACAGGGTAAAGCGGGGAGCTAACTATGGCTACACCTTC	CASTCLRDRVKRGANYGYTF	TRBV6-5	TRBJ1-2
TGTGCCTGGATCGCGGGGGGAAACTTC	CAWIAGGNF	TRBV30	TRBJ2-7
TGTGCCAGTAGTAAGCCCTTGTTACTACCTAGTGCCTACAATGAGCAGTTCTTC	CASSKPLLLPSAYNEQFF	TRBV19	TRBJ2-1
TGCAGTGCCTCCTTTCCGGGACAGGTGGTAGCCAAAAACATTCAGTACTTC	CSASFPGQVVAKNIQYF	TRBV20-1	TRBJ2-4
TGCAGTGCTGGGATGGAAAACACCGGGGAGCTGTTTTTT	CSAGMENTGELFF	TRBV20-1	TRBJ2-2
TGTGCCAGCAGTTACTCACTCGGCTACACAGATACGCAGTATTTT	CASSYSLGYTDTQYF	TRBV6-5	TRBJ2-3
TGTGCCACCAGTGATTGGACAGTTACCGGGGAGCTGTTTTTT	CATSDWTVTGELFF	TRBV24-1	TRBJ2-2
TGCGCCAGCAGTGAAACCCAGATCTATGGCTACACCTTC	CASSETQIYGYTF	TRBV10-2	TRBJ1-2
TGTGCCACCAGTGGGGACAAACCTGAAGCTTTCTTT	CATSGDKPEAFF	TRBV24-1	TRBJ1-1
TGCAGCGTCCAGTCTTCCAAAGGGGGGGGCGGGAGCACAGATACGCAGTATTTT	CSVQSSKGGGGSTDTQYF	TRBV29-1	TRBJ2-3
TGTGCCAGCAAAGCAGGGGATGATGGGGAGACCCAGTACTTC	CASKAGDDGETQYF	TRBV27	TRBJ2-5
TGTGAGGGGGCCCTGAGCCGCCAACGAAAACTGTTTTTT	CEGALSRQRKLFF	TRBV12-3	TRBJ1-4
TGCAGCGTGGCCAGACGCTCCCCCCGCAAAAACATTCAGTACTTC	CSVARRSPRKNIQYF	TRBV29-1	TRBJ2-4
TGCGCCAGCAGCCACGGGACAGGGCCAGATCAGCCCCAGCATTTT	CASSHGTGPDQPQHF	TRBV4-1	TRBJ1-5
TGTGCCAGCAGTTTTAAACTGACAGGGGAACAGCCCCAGCATTTT	CASSFKLTGEQPQHF	TRBV12-4	TRBJ1-5
TGCGCCAGCAGCCAAGATTCTTATACCCGGGACAGGGATCAAGAGACCCAGTACTTC	CASSQDSYTRDRDQETQYF	TRBV4-1	TRBJ2-5
TGTGCCAGCAGCATTCACCGGGACAGGGCTCAGCCCCAGCATTTT	CASSIHRDRAQPQHF	TRBV28	TRBJ1-5
TGTGCCAGTAGTATAAACGGACACGACCGCGACTTC	CASSINGHDRDF	TRBV19	TRBJ2-7
TGCAGTGCTAGAGATCCCAAAAATAGCGGGGGATTGAATGAGCAGTTCTTC	CSARDPKNSGGLNEQFF	TRBV20-1	TRBJ2-1
TGTGCCAGCAGCTCTCGCTCGCGAAATCAAGAGACCCAGTACTTC	CASSSRSRNQETQYF	TRBV7-9	TRBJ2-5
TGCGGTCGACTAGCGGGCTCCTACGAGCAGTACTTC	CGRLAGSYEQYF	TRBV5-1	TRBJ2-7
TGTGCCAGCATACAGGGTGGGAACTATGGCTACACCTTC	CASIQGGNYGYTF	TRBV12-4	TRBJ1-2
TGTGCCAGCAGTTTTAGGGCCATGAGAGATACGCAGTATTTT	CASSFRAMRDTQYF	TRBV28	TRBJ2-3
TGCGCCAGCAGCTTGGTAAGATCACGGGAGCAGTACTTC	CASSLVRSREQYF	TRBV5-1	TRBJ2-7
TGTGCCAGCAGTCGGACCGTTGGGCTAGCGGAGACCCAGTACTTC	CASSRTVGLAETQYF	TRBV28	TRBJ2-5
TGTGCCAGCAGTTACTCGACTCCCCGGGACAGGGGGCGTTACGAGCAGTACTTC	CASSYSTPRDRGRYEQYF	TRBV6-5	TRBJ2-7
TGTGCCAGCAGCTCGATAAAGTCCGGGACGTCCGTTTGGGCGCAGTATTTT	CASSSIKSGTSVWAQYF	TRBV11-2	TRBJ2-3
TGTGCCAGCAGATGGGGGACGGAGGCCGGGGAGCTGTTTTTT	CASRWGTEAGELFF	TRBV11-2	TRBJ2-2
TGCGCCAGACCAGCGGGATTCGAGTCTGGAAACACCATATATTTT	CARPAGFESGNTIYF	TRBV10-1	TRBJ1-3
TGTGCCAGTAGTATAGAAATAGGCCACATGGCCTACAATGAGCAGTTCTTC	CASSIEIGHMAYNEQFF	TRBV19	TRBJ2-1
TGCAGTGAACCAACCGGGGGGGAGGTGAACACTGAAGCTTTCTTT	CSEPTGGEVNTEAFF	TRBV20-1	TRBJ1-1
TGCAGTGCTAGAGATCCCGGCGGACAGGGTAATTTTCCCGATAACTATGGCTACACCTTC	CSARDPGGQGNFPDNYGYTF	TRBV20-1	TRBJ1-2
TGTGCCAGCTCACCCCTGCCAGGGACAGCCTGTGCAACTAATGAAAAACTGTTTTTT	CASSPLPGTACATNEKLFF	TRBV18	TRBJ1-4
TGTGCCAGCAGCTTGGCCAGAGGGATCAGGGGGAGCTACGAGCAGTACTTC	CASSLARGIRGSYEQYF	TRBV5-4	TRBJ2-7
TGTGCCAGCACTCGGGGGACGACAGCACTCCCTTCACCCCTCCACTTT	CASTRGTTALPSPLHF	TRBV11-3	TRBJ1-6
TGTGCCAGCAGCTTACCTGGACTCTACAATGAAAAACTGTTTTTT	CASSLPGLYNEKLFF	TRBV7-9	TRBJ1-4
TGTGCCAGCAGCTTGAGGGTGCATTCAGGGCAGGTCACCGGGGAGCTGTTTTTT	CASSLRVHSGQVTGELFF	TRBV7-9	TRBJ2-2
TGCAGTGCTTTTCAGTCAGCGGCCTATGGCTACACCTTC	CSAFQSAAYGYTF	TRBV20-1	TRBJ1-2
TGTGCCAGCAGTTTATACCCCCGGGACAGATTAAGGAATCAGCCCCAGCATTTT	CASSLYPRDRLRNQPQHF	TRBV27	TRBJ1-5
TGTGCCAGCAGTGACTCAACATCCCCAGACAGGAAGACTGAAGCTTTCTTT	CASSDSTSPDRKTEAFF	TRBV6-4	TRBJ1-1
TGTGCCAGCAGCAGGGTGAGCAATCAGCCCCAGCATTTT	CASSRVSNQPQHF	TRBV27	TRBJ1-5
TGTGCCAGCAGTGAATCTATGGAGACGCGCACCGGGGAGCTGTTTTTT	CASSESMETRTGELFF	TRBV25-1	TRBJ2-2
TGTGCCATTACAGGGTTGTGCTACAATGAGCAGTTCTTC	CAITGLCYNEQFF	TRBV10-3	TRBJ2-1
TGTGCCAGCAGTGAGCACGGGACGAGCTATGGCTACACCTTC	CASSEHGTSYGYTF	TRBV25-1	TRBJ1-2
TGTGCCAGCAGACATAGCGGCATAACTTCCTACACTGAAGCTTTCTTT	CASRHSGITSYTEAFF	TRBV6-1	TRBJ1-1
TGTGCCAGCAGCTTGCCAGGGAATCAGCCCCAGCATTTT	CASSLPGNQPQHF	TRBV7-2	TRBJ1-5
TGCAGTGCTAGAGGGACTGGGGCCTACGAGCAGTACTTC	CSARGTGAYEQYF	TRBV20-1	TRBJ2-7
TGTGCCAGCAGCCTCGTACTAGCGGGCGAACACGAGCAGTACTTC	CASSLVLAGEHEQYF	TRBV13	TRBJ2-7
TGTGCCAGCAGTTGTGCCCTTTCGCCCGGGACAAGCTCCTACGAGCAGTACTTC	CASSCALSPGTSSYEQYF	TRBV27	TRBJ2-7
TGCGCCAGCAGTAGTGGAGCAGGGGTGAAAGGGAAGTCACCCCTCCACTTT	CASSSGAGVKGKSPLHF	TRBV10-1	TRBJ1-6
TGTGCCACCAGTGAAGGCGACAGGGGGTCAGGGCCCCAGCATTTT	CATSEGDRGSGPQHF	TRBV24-1	TRBJ1-5
TGTGCCCCCACAGGGGAACACAATGAGCAGTTCTTC	CAPTGEHNEQFF	TRBV19	TRBJ2-1
TGTGCCACCAGCAGAGCTATAGAGGCCTACGAGCAGTACTTC	CATSRAIEAYEQYF	TRBV15	TRBJ2-7
TGTGCCAGCAGTGACAGAGTGGAGTCCGAGCAGTACTTC	CASSDRVESEQYF	TRBV27	TRBJ2-7
TGTGCCAGCAGTTACTCGACTATCGGACAGGGCCCCGGCAATGAGCAGTTCTTC	CASSYSTIGQGPGNEQFF	TRBV6-6	TRBJ2-1
TGTGCCATCAGTGAGTATATTCGCCGGGAAAGAGAGACCCAGTACTTC	CAISEYIRRERETQYF	TRBV10-3	TRBJ2-5
TGTGCCAGCAGTTCCCGGTTATCGACAGGGGCGAGGAACACCGGGGAGCTGTTTTTT	CASSSRLSTGARNTGELFF	TRBV12-3	TRBJ2-2
TGTGCCAGCAGCTTAGGCCGGGGGCCAGCTGAAGCTTTCTTT	CASSLGRGPAEAFF	TRBV11-3	TRBJ1-1
TGTGCCAGCAGCAGAAAGACAGGGCCCTGGTTGTACCAAGAGACCCAGTACTTC	CASSRKTGPWLYQETQYF	TRBV5-6	TRBJ2-5
TGTGCCAGCACCTCGGGACACGGCTACGAGCAGTACTTC	CASTSGHGYEQYF	TRBV6-1	TRBJ2-7
TGTGCCAGCAGTGATAGACAGTACGAGCAGTACTTC	CASSDRQYEQYF	TRBV6-1	TRBJ2-7
TGTGCCAGCACCCGGTGGGGAGGGGCCCTTCCCAGACCGTCTGGGGCCAACGTCCTGACTTTC	CASTRWGGALPRPSGANVLTF	TRBV12-3	TRBJ2-6
TGCGCCAGCAGCCAAGACCCCAGGGCCTACGAGCAGTACTTC	CASSQDPRAYEQYF	TRBV4-1	TRBJ2-7
TGTGCCAGCGCGGGGTACAATGAGCAGTTCTTC	CASAGYNEQFF	TRBV9	TRBJ2-1
TGTGCCAGCAGCCCCAGTACCCCGGACAGGGGTCCCAGGAACACCGGGGAGCTGTTTTTT	CASSPSTPDRGPRNTGELFF	TRBV7-3	TRBJ2-2
TGTGCCAGCAGCTTAACGCCCGGGGGGGGCGGCCTTCCCCTCTTGGATACGCAGTATTTT	CASSLTPGGGGLPLLDTQYF	TRBV7-3	TRBJ2-3
TGTGCCAGCAGCTCCCAGGTGTTCAATTCACCCCTCCACTTT	CASSSQVFNSPLHF	TRBV7-2	TRBJ1-6
TGTGCCAGCAGCTTAGCAAAGGGACAAAGGCTAGCCAAAAACATTCAGTACTTC	CASSLAKGQRLAKNIQYF	TRBV7-9	TRBJ2-4
TGTGCCAGCCAACGGAGGGGACAGACTAGCTACGAGCAGTACTTC	CASQRRGQTSYEQYF	TRBV6-5	TRBJ2-7
TGTGCCAGCAGCCATAACAGGCGAACCTACGAGCAGTACTTC	CASSHNRRTYEQYF	TRBV9	TRBJ2-7
TGTGCCACCAGCAGATTCAGACTAGGACGCGGGTGTAGATCAGATACGCAGTATTTT	CATSRFRLGRGCRSDTQYF	TRBV15	TRBJ2-3
TGCGCCAGCCAAGCATTCTGCTATGGCTACACCTTC	CASQAFCYGYTF	TRBV10-1	TRBJ1-2
TGTGCCAGCAGCTTAGCGAGAGACCCTCTAGGGTCTGAGCAGTTCTTC	CASSLARDPLGSEQFF	TRBV7-9	TRBJ2-1
TGTGCCAGCAGTGAGAGGGTGGGGAGCTCCTACAATGAGCAGTTCTTC	CASSERVGSSYNEQFF	TRBV27	TRBJ2-1
TGTGCCAGCAGTGTTCACTTAAGGGACATCCATGCGCGGGGCTACACCTTC	CASSVHLRDIHARGYTF	TRBV27	TRBJ1-2
TGCAGCGTTGAAGTCACGGGGTTGGAGGGAAACACCATATATTTT	CSVEVTGLEGNTIYF	TRBV29-1	TRBJ1-3
TGTGCCAGCAGTTTCGATATCGGGGGGAGGGAGCAGTTCTTC	CASSFDIGGREQFF	TRBV28	TRBJ2-1
TGTGCCAGCAGCCTACATCCGACAGGGGTTAGAGAGGACACCGGGGAGCTGTTTTTT	CASSLHPTGVREDTGELFF	TRBV9	TRBJ2-2
TGCGCCAGCAGCTTTAAGACAGGGGGAGAACTAGCCAAAAACATTCAGTACTTC	CASSFKTGGELAKNIQYF	TRBV5-1	TRBJ2-4
TGCGCCAGCAGCCAAGATGAAAACAGGGCCTCCTACGAGCAGTACTTC	CASSQDENRASYEQYF	TRBV4-3	TRBJ2-7
TGTGCCAGAGGGGGGGAGCAGTTCTTC	CARGGEQFF	TRBV3-1	TRBJ2-1
TGTGCCAGCAGTTACTCGAATCCTCGGGGGGTGGAATACCAAGAGACCCAGTACTTC	CASSYSNPRGVEYQETQYF	TRBV6-5	TRBJ2-5
TGCGCCAGCAGCTCACAGGGTCGCGGGGGCACAGATACGCAGTATTTT	CASSSQGRGGTDTQYF	TRBV5-1	TRBJ2-3
TGTGCCAGCAGCTTACCGGGACAGGTCACAGATACGCAGTATTTT	CASSLPGQVTDTQYF	TRBV7-2	TRBJ2-3
TGTGCCAGCAGCTCCCCAACACAGTCTCCCTCCCTCCACTTT	CASSSPTQSPSLHF	TRBV7-9	TRBJ1-6
TGTGCCAGCAGCCAAGGGAGGGGAGGGAACATTCAGTACTTC	CASSQGRGGNIQYF	TRBV14	TRBJ2-4
TGTGCCATCAGTGAGAGTACGGCAGGCTACAATGAGCAGTTCTTC	CAISESTAGYNEQFF	TRBV10-3	TRBJ2-1
TGTGCCAGCAGGAACGCGGGACAGGGGGCTTTGACTGGCTACAATGAGCAGTTCTTC	CASRNAGQGALTGYNEQFF	TRBV7-9	TRBJ2-1
TGTGCCAGCAGCTTAGAAATAGCGGGATTTGAGCAGTTCTTC	CASSLEIAGFEQFF	TRBV7-9	TRBJ2-1
TGTGCCACCAGTGATTTTCGCAAGGGACAGGGGATGAGGCCTTATGGCTACACCTTC	CATSDFRKGQGMRPYGYTF	TRBV24-1	TRBJ1-2
TGTGCCAGCAGCTGGTCAACGCGGAGCTCCTACGAGCAGTACTTC	CASSWSTRSSYEQYF	TRBV7-6	TRBJ2-7
TGCAGTGCTCGGTTACAGGTAGAGACCCAGTACTTC	CSARLQVETQYF	TRBV20-1	TRBJ2-5
TGTGCCAGTCTAGGCGAGCAGTACTTC	CASLGEQYF	TRBV19	TRBJ2-7
TGTGCCAGTAGTATAGCCCCCAGGCACTACGAGCAGTACTTC	CASSIAPRHYEQYF	TRBV19	TRBJ2-7
TGTGCCAGCAGCTTAGTGGGAGTTAGCACAGATACGCAGTATTTT	CASSLVGVSTDTQYF	TRBV7-6	TRBJ2-3
TGTGCCAGCAGCGTACGGGGGAGTGCAGATACGCAGTATTTT	CASSVRGSADTQYF	TRBV9	TRBJ2-3
