TGTGCCAGCAGCGAGCTTTGTTCTAGCGGGCTTCCCGATACGCAGTATTTT	CASSELCSSGLPDTQYF	TRBV6-4	TRBJ2-3
TGTGCCAGCAGCCAAGGTACCGGGACAGGGGCGGGGCACAATGAGCAGTTCTTC	CASSQGTGTGAGHNEQFF	TRBV3-1	TRBJ2-1
TGTGCCAGTAGTGGCAACAACGGACAGGGATTAGCTTTCTTT	CASSGNNGQGLAFF	TRBV19	TRBJ1-1
TGCGCCAGCAGCGCCCGGGACAGGGGTTCGATGAACACTGAAGCTTTCTTT	CASSARDRGSMNTEAFF	TRBV5-1	TRBJ1-1
TGCAGTGCTTTGATCATGGGACAGGGCTGGTCCGAGCAGTACTTC	CSALIMGQGWSEQYF	TRBV20-1	TRBJ2-7
TGCGCCAGCAGCGTCGGGACAGGGACCAACAATGAGCAGTTCTTC	CASSVGTGTNNEQFF	TRBV5-1	TRBJ2-1
TGCGCCAGCAGTTCCGGGGGGCCGAATCAGCCCCAGCATTTT	CASSSGGPNQPQHF	TRBV10-1	TRBJ1-5
TGCAGTGCTAGAACCGACAGGGAGGACTATGGCTACACCTTC	CSARTDREDYGYTF	TRBV20-1	TRBJ1-2
TGTGCCAGCAGTTACCTCCCCGCGGGAGGCCCGAACACCGGGGAGCTGTTTTTT	CASSYLPAGGPNTGELFF	TRBV6-5	TRBJ2-2
TGTGCCAGCAGCCCCCTTGAGGGCAGGCCTGGGAACGCTGAAGCTTTCTTT	CASSPLEGRPGNAEAFF	TRBV5-6	TRBJ1-1
TGCAGTGCTAGAGATCCCGGGTCTGGGCGGAGACGGAAAACCGAGCAGTACTTC	CSARDPGSGRRRKTEQYF	TRBV20-1	TRBJ2-7
TGTGCCAGCAGCTGCCCCGGACAGACCCAGCCCCAGCATTTT	CASSCPGQTQPQHF	TRBV5-4	TRBJ1-5
TGTGCCAGCAGTGAAGGAGGACAAACCCTTTTCCCGGGACTAGCGGGGGGGCGTAACACCGGGGAGCTGTTTTTT	CASSEGGQTLFPGLAGGRNTGELFF	TRBV6-1	TRBJ2-2
TGTGCCAGCAGTAGGTGGAGAAGGGGCTACACCTTC	CASSRWRRGYTF	TRBV6-1	TRBJ1-2
TGTGCCAGCAGCTTAGGTCCACTGTATTTT	CASSLGPLYF	TRBV7-4	TRBJ2-3
TGCGCCAGCAGACTGACAGGCGACTCCTACGAGCAGTACTTC	CASRLTGDSYEQYF	TRBV4-1	TRBJ2-7
TGTGCCACCAGCAGAGATGATCACCTAGCGGGGGGGCCAAGAGAGTCGGGGGGGGATGAGCAGTTCTTC	CATSRDDHLAGGPRESGGDEQFF	TRBV15	TRBJ2-1
TGTGCCAGCAGTGGTTTCATGGATCGCAATGAGCAGTTCTTC	CASSGFMDRNEQFF	TRBV2	TRBJ2-1
TGCAGTGCTAGCCACTACAGGGAGCCCGAGCAGTACTTC	CSASHYREPEQYF	TRBV20-1	TRBJ2-7
TGTGCCAGCAGTCTCCAGTTTTCCTACTACGAGCAGTACTTC	CASSLQFSYYEQYF	TRBV6-6	TRBJ2-7
TGCAGTGCTAGGGTGTCCTCTAGCGGGGTTTGGTACAATGAGCAGTTCTTC	CSARVSSSGVWYNEQFF	TRBV20-1	TRBJ2-1
TGTGCCATCTGCGAAAATTACAATGAGCAGTTCTTC	CAICENYNEQFF	TRBV28	TRBJ2-1
TGTGCCAGCAGCCAGCAGGGGGGGGATCAGCCCCAGCATTTT	CASSQQGGDQPQHF	TRBV14	TRBJ1-5
TGTGCCAGCAGCTTGGAGACTAGCGGCGCTTGGGCTGAGCAGTACTTC	CASSLETSGAWAEQYF	TRBV5-6	TRBJ2-7
TGTGCCAGCTCACCGATAAGCAGGGTTATCTTCCTTGTCATGAACACTGAAGCTTTCTTT	CASSPISRVIFLVMNTEAFF	TRBV18	TRBJ1-1
TGTGCCAGCAGGCAGCCAAGACCGGGACAACACTCAGATACGCAGTATTTT	CASRQPRPGQHSDTQYF	TRBV6-1	TRBJ2-3
TGTGCCAGCAGTTCCGGGGGGTACGAGCAGTACTTC	CASSSGGYEQYF	TRBV27	TRBJ2-7
TGTGCCAGCAGCAGACGACAGGGTAACGGCGAAGCTTTCTTT	CASSRRQGNGEAFF	TRBV7-4	TRBJ1-1
TGTGCCAGCTCACCACCGGGACTAGCGGGCCCCATGGGGCCACCCCAGTACTTC	CASSPPGLAGPMGPPQYF	TRBV18	TRBJ2-5
TGTGCCAGCAGCGGTGCGGGACAGCCGCGGAATTCACCCCTCCACTTT	CASSGAGQPRNSPLHF	TRBV27	TRBJ1-6
TGTGCCTGGATGCCCCGGGCTATAGCTAACTATGGCTACACCTTC	CAWMPRAIANYGYTF	TRBV30	TRBJ1-2
TGCGCCAGCGGAGGCGGCACAGGACTCCAGCCCCAGCATTTT	CASGGGTGLQPQHF	TRBV5-1	TRBJ1-5
TGTGCCAGCAGCTCTCTAGCGGGGCAGTACTTC	CASSSLAGQYF	TRBV5-5	TRBJ2-7
TGTGCCAGCAGTTGTACGGGGTACAATGAGCAGTTCTTC	CASSCTGYNEQFF	TRBV6-1	TRBJ2-1
TGTGCCACCAGTGATTGTCCGGGGAATCGGGGGCGAAACACCATATATTTT	CATSDCPGNRGRNTIYF	TRBV24-1	TRBJ1-3
TGCAGTGCTAGAAAAATCAGGGAGTGGCCCGGGGAGCTGTTTTTT	CSARKIREWPGELFF	TRBV20-1	TRBJ2-2
TGTGCCAGCAGCGTTTCAACCTCCGCGGGAGGACCCGAGCAGTACTTC	CASSVSTSAGGPEQYF	TRBV13	TRBJ2-7
TGTGCCAGCAGCGCTCAGGGGGCAGTGTATAATTCACCCCTCCACTTT	CASSAQGAVYNSPLHF	TRBV9	TRBJ1-6
TGCAGTGCTAGAACGGGGGATAATCAGCCCCAGCATTTT	CSARTGDNQPQHF	TRBV20-1	TRBJ1-5
TGTGCCAGCAGCCAAGAAACCCAGGGGGTACTAAATCAGCCCCAGCATTTT	CASSQETQGVLNQPQHF	TRBV14	TRBJ1-5
TGTGCCAGCAGTGTTACTAGCGGGGGGCACGACCAAGAGACCCAGTACTTC	CASSVTSGGHDQETQYF	TRBV6-4	TRBJ2-5
TGTGCCAGCAGGCTGGACAGATTCGGTCACAATGAGCAGTTCTTC	CASRLDRFGHNEQFF	TRBV6-2	TRBJ2-1
TGTGCCAGGGACAGCGGGAGGAAAAACGGCTACGAGCAGTACTTC	CARDSGRKNGYEQYF	TRBV4-2	TRBJ2-7
TGTGCCAGCAGCCAAGATTCGACGGTATACGAGCAGTACTTC	CASSQDSTVYEQYF	TRBV4-2	TRBJ2-7
TGTGCCAGCAGCCGAGGGGCCGACAGGGCTTCACCCCTCCACTTT	CASSRGADRASPLHF	TRBV7-4	TRBJ1-6
TGTGCCAGCAGCACCAGGGACCTATTCGAGCAGTACTTC	CASSTRDLFEQYF	TRBV13	TRBJ2-7
TGTGCCAGCAGCCGGGGGAGATGCACAGATACGCAGTATTTT	CASSRGRCTDTQYF	TRBV5-5	TRBJ2-3
TGTGCCAGCAGCCAGACACCCGACAGGGGCTGGGGCTACACCTTC	CASSQTPDRGWGYTF	TRBV13	TRBJ1-2
TGTGCCAGCAGCCCAGGTTGGGGATGTATCTACGAGCAGTACTTC	CASSPGWGCIYEQYF	TRBV27	TRBJ2-7
TGCGCCAGCAGCGAAGGGCCCCCCGGGACAGGGGGCGGGGACAACACCGGGGAGCTGTTTTTT	CASSEGPPGTGGGDNTGELFF	TRBV5-1	TRBJ2-2
TGTGCCACCCAAATTAAACCCCCTTGCGGGGGGGACACAGATACGCAGTATTTT	CATQIKPPCGGDTDTQYF	TRBV24-1	TRBJ2-3
TGTGCCAGCAGGGCAGGGGACCATAGCAATCAGCCCCAGCATTTT	CASRAGDHSNQPQHF	TRBV9	TRBJ1-5
TGTGCCAGCAGTTACGAGGGTTGGGGCTACGAGCAGTACTTC	CASSYEGWGYEQYF	TRBV6-6	TRBJ2-7
TGCGCCAGCAGCCAAGGTCGGGGGGGCCAAGGGCAGTACTTC	CASSQGRGGQGQYF	TRBV4-1	TRBJ2-7
TGCAGTGCTAGGGACATGGACGGTTATCAGCCCCAGCATTTT	CSARDMDGYQPQHF	TRBV20-1	TRBJ1-5
TGTGCCACCAGTGATGGGACAGGGGGGAGCACAGATACGCAGTATTTT	CATSDGTGGSTDTQYF	TRBV24-1	TRBJ2-3
TGTGCCAGCTCACCCGGGCCGGGGTTCTATGGCTACACCTTC	CASSPGPGFYGYTF	TRBV18	TRBJ1-2
TGTGCCAGCATGAGAAGACTCGACAGAGTGTACCAAGAGACCCAGTACTTC	CASMRRLDRVYQETQYF	TRBV2	TRBJ2-5
TGTGCCAGCACAGACAGAGACACTGAAGCTTTCTTT	CASTDRDTEAFF	TRBV6-5	TRBJ1-1
TGTGCCAGCAGCACCCGGGGGGCAACTAATGAAAAACTGTTTTTT	CASSTRGATNEKLFF	TRBV13	TRBJ1-4
TGTGCCAGCAGTTACTTCGGGACAGGTGGACATGAAAAACTGTTTTTT	CASSYFGTGGHEKLFF	TRBV6-2	TRBJ1-4
TGTGCCAGCGTCCAACGGGCCAGGGGAAATGGCTACACCTTC	CASVQRARGNGYTF	TRBV7-9	TRBJ1-2
TGTGCCAGCAGCTCAGCGGTACATGAGCAGTTCTTC	CASSSAVHEQFF	TRBV11-2	TRBJ2-1
TGCGCCAGCAGGGAGGGGCGGGCAACTAATGAAAAACTGTTTTTT	CASREGRATNEKLFF	TRBV10-1	TRBJ1-4
TGCAGTGCAGGCGAATTCAGGGACAGACCGAACACTGAAGCTTTCTTT	CSAGEFRDRPNTEAFF	TRBV20-1	TRBJ1-1
TGTGCCAGCAGCTCTAAGGATCTCTTTAGCAATCAGCCCCAGCATTTT	CASSSKDLFSNQPQHF	TRBV5-5	TRBJ1-5
TGTGCCAGCAGCTTGGGAAGGATACAGGGGTCCTCCTACGAGCAGTACTTC	CASSLGRIQGSSYEQYF	TRBV5-6	TRBJ2-7
TGCGCCAGATGCCGAAAAGAGAGGATGCAGTTCTTC	CARCRKERMQFF	TRBV4-1	TRBJ2-1
TGTGCCAGCGTAAAGGGACAGGGTCAGCCCCAGCATTTT	CASVKGQGQPQHF	TRBV25-1	TRBJ1-5
TGTGCCAGCAGTGAGTCCACCACTCACACTGAAGCTTTCTTT	CASSESTTHTEAFF	TRBV6-4	TRBJ1-1
TGCGCCAGCAGCAGTGCCGCGTCCCATATGGGGACCCAGTACTTC	CASSSAASHMGTQYF	TRBV5-1	TRBJ2-5
TGTGCCAGCAGAGCCTGGGACAGGGAGTGGATCTCTGGAAACACCATATATTTT	CASRAWDREWISGNTIYF	TRBV6-5	TRBJ1-3
TGTGCCAGCAGCTTAGTACAGGGCCCTGGCTACACCTTC	CASSLVQGPGYTF	TRBV7-2	TRBJ1-2
TGTGCCAGCAGCGTAGGGGACAGCTTGGAAGCTTTCTTT	CASSVGDSLEAFF	TRBV9	TRBJ1-1
TGTGCCAGCATAGGGCGTAGGAGGTTCACGCAGTATTTT	CASIGRRRFTQYF	TRBV6-5	TRBJ2-3
TGCGCCAGCAGCCCCACCCTCCACTCGGACATTGAGAACACTGAAGCTTTCTTT	CASSPTLHSDIENTEAFF	TRBV5-1	TRBJ1-1
TGTGCCAGCAGCTTAATTGAGGGGAGAGGGGCTTTCTTT	CASSLIEGRGAFF	TRBV7-3	TRBJ1-1
TGTGCCAGCAGCGTCCCCATGGGGCAGCCCCAGCATTTT	CASSVPMGQPQHF	TRBV9	TRBJ1-5
TGCGCCAGTTTTATAGGACCGGGTGGCTACACCTTC	CASFIGPGGYTF	TRBV10-2	TRBJ1-2
TGTGCCAGCAGTTTGAGCCGGGACATTTCGGAGGAGAATAATGAAAAACTGTTTTTT	CASSLSRDISEENNEKLFF	TRBV27	TRBJ1-4
TGTGCCAGCAGGTCTCCAACAGGAAGGAACACTGAAGCTTTCTTT	CASRSPTGRNTEAFF	TRBV6-4	TRBJ1-1
TGTGCCAGCTCCCGATCGGGGTTCTCCTACGAGCAGTACTTC	CASSRSGFSYEQYF	TRBV2	TRBJ2-7
TGTGCCAGCAGCGTAGCTCGGAGCTTAAACGAGCAGTACTTC	CASSVARSLNEQYF	TRBV9	TRBJ2-7
TGTGCCACCAGTGGACATGACAGGGGGGAAGATACGCAGTATTTT	CATSGHDRGEDTQYF	TRBV24-1	TRBJ2-3
TGTGCCAGCGCGATAGAGCAGTACTTC	CASAIEQYF	TRBV6-1	TRBJ2-7
TGTGCCAGCAGCTTGCCCTATCGTATCGACACTGAAGCTTTCTTT	CASSLPYRIDTEAFF	TRBV5-6	TRBJ1-1
TGCGCCAGCAGCCAAGGGGGGGTCCGGGGGTTGGGCTATGGCTACACCTTC	CASSQGGVRGLGYGYTF	TRBV4-1	TRBJ1-2
TGCGCCAGCAGCCAAGCCTCTCCGTTCAGATCAAGCACCCAGTACTTC	CASSQASPFRSSTQYF	TRBV4-3	TRBJ2-5
TGTGCCAGCAGTTACAAGCTTGGACTACCAGAGACCCAGTACTTC	CASSYKLGLPETQYF	TRBV6-5	TRBJ2-5
TGCAGTGCTCCGCTGGATTCACCCCTCCACTTT	CSAPLDSPLHF	TRBV20-1	TRBJ1-6
TGCAGTGCCTGTGGGGGCCCTTTTCCCGGGGAGCTGTTTTTT	CSACGGPFPGELFF	TRBV20-1	TRBJ2-2
TGTGCCAGCAGCTTCCCCGGGGGGGGGTCCTACGAGCAGTACTTC	CASSFPGGGSYEQYF	TRBV5-5	TRBJ2-7
TGCAGCGTGATGAGGGGGGACAATCAGCCCCAGCATTTT	CSVMRGDNQPQHF	TRBV29-1	TRBJ1-5
TGTGCCAGCAGCTTAGAGGTTAGGATTAGCGGGACTTTCTACGAGCAGTACTTC	CASSLEVRISGTFYEQYF	TRBV11-3	TRBJ2-7
TGCAGTGCACGAGAATTGAGGCGCCGTTGGCCCATGACCCAGTACTTC	CSARELRRRWPMTQYF	TRBV20-1	TRBJ2-5
TGTGCCAGCAGCGCTGAAACAGGGGGTTCCGGGGAGCTGTTTTTT	CASSAETGGSGELFF	TRBV11-1	TRBJ2-2
TGTGCCAGCAGCCAAGTGGCCTCCCTAGGGACAAACTATGGCTACACCTTC	CASSQVASLGTNYGYTF	TRBV14	TRBJ1-2
TGCGCCAGGGAATCGGGACAGGGGGGGCAAGCTTTCTTT	CARESGQGGQAFF	TRBV4-1	TRBJ1-1
TGCGCCAGCAGCCAAGAGCGGGAATTGAACACTGAAGCTTTCTTT	CASSQERELNTEAFF	TRBV4-3	TRBJ1-1
TGTGCCAGCAGTTTACGGTCTACAGGCCGACACGAGCAGTACTTC	CASSLRSTGRHEQYF	TRBV28	TRBJ2-7
TGTGCCAGCAGCCATAGCGGGCCGGACATTCAGTACTTC	CASSHSGPDIQYF	TRBV11-2	TRBJ2-4
TGTGCCAGTAGACTGGACAGGACACAAGAGACCCAGTACTTC	CASRLDRTQETQYF	TRBV19	TRBJ2-5
TGCAGTGCTAGAGATCTTTTAAAACAGCAAAGCCTTGGCTATGGCTACACCTTC	CSARDLLKQQSLGYGYTF	TRBV20-1	TRBJ1-2
TGTGCCAGCACGAGAGACCCGGGCTCCTACGAGCAGTACTTC	CASTRDPGSYEQYF	TRBV12-3	TRBJ2-7
TGTGCCAGTAGGACAGGGATGAACACTGAAGCTTTCTTT	CASRTGMNTEAFF	TRBV2	TRBJ1-1
TGTGCCAGCGTTCAGCCGAACACTGAAGCTTTCTTT	CASVQPNTEAFF	TRBV6-1	TRBJ1-1
TGTGCCAGCAGTGAGGGGGCCTCGCAATACTTC	CASSEGASQYF	TRBV6-1	TRBJ2-7
TGTGCCAGCAGCGTAGCTAGCAGCCCGAGGTCTCGCTACGAGCAGTACTTC	CASSVASSPRSRYEQYF	TRBV9	TRBJ2-7
TGCGCCATCCGGGACATGGGCTATGGCTACACCTTC	CAIRDMGYGYTF	TRBV10-1	TRBJ1-2
TGTGCCAGTAATGCTAGAGGGGCCTACGAGCAGTACTTC	CASNARGAYEQYF	TRBV19	TRBJ2-7
TGTGCCAGCAGTTACAACCCGGGACAGGGTATAGCCGGGGAGCTGTTTTTT	CASSYNPGQGIAGELFF	TRBV6-5	TRBJ2-2
TGTGCCACCCGGGGGGGGGACTACAATGAGCAGTTCTTC	CATRGGDYNEQFF	TRBV25-1	TRBJ2-1
TGTGCCAGCAGCCCCCGGTCCACTGGGGATCAGCCCCAGCATTTT	CASSPRSTGDQPQHF	TRBV13	TRBJ1-5
TGTGCCACCAGCCGAGGACCGGTGCAGGGCACTGAAGCTTTCTTT	CATSRGPVQGTEAFF	TRBV15	TRBJ1-1
TGTGCCAGTAGTTTCGGCACTAGCCCAATTAAAGAGCAGTTCTTC	CASSFGTSPIKEQFF	TRBV19	TRBJ2-1
TGTGCCAGCAGGCCAGTAGCGGGTCACGATTCCTACAATGAGCAGTTCTTC	CASRPVAGHDSYNEQFF	TRBV6-1	TRBJ2-1
TGTGCCAGCAGTTCCCGGGGGGGCCAAGGAACCTATGAGCAGTTCTTC	CASSSRGGQGTYEQFF	TRBV28	TRBJ2-1
TGTGACGCCGGTAGCGGGGAACACATAAGGGGGAGCTCCTACAATGAGCAGTTCTTC	CDAGSGEHIRGSSYNEQFF	TRBV3-1	TRBJ2-1
TGTGCCAGCTCACCACGGGACCGAGGGTTAGTCGGGCAGCCCCAGCATTTT	CASSPRDRGLVGQPQHF	TRBV18	TRBJ1-5
TGCAGTGCTAGAGCCGACAAACTGAACACTGAAGCTTTCTTT	CSARADKLNTEAFF	TRBV20-1	TRBJ1-1
TGTGCCAGCAGCTTACCTCTAGCCTCTCAGACAGATACGCAGTATTTT	CASSLPLASQTDTQYF	TRBV7-8	TRBJ2-3
TGCAGCGACGACCCAGGGGCTCAGCCCCAGCATTTT	CSDDPGAQPQHF	TRBV29-1	TRBJ1-5
TGTGCCAGCAGTGAGGTCAAGACTAGCGGGGGAGCCTACGAGCAGTACTTC	CASSEVKTSGGAYEQYF	TRBV25-1	TRBJ2-7
TGCGCCAGCCCGATAGGCGGTGGCTACGAGCAGTACTTC	CASPIGGGYEQYF	TRBV10-1	TRBJ2-7
TGTGCCAGCAGAGACAGGGGGGGGGGAGATACGCAGTATTTT	CASRDRGGGDTQYF	TRBV4-2	TRBJ2-3
TGTGCCAGCAAACCTAGCGGGACGGGGAACTATGGCTACACCTTC	CASKPSGTGNYGYTF	TRBV7-6	TRBJ1-2
TGTGCCAGCAGGAACACACAGGTGGAGTATTTCACAGAGACCCAGTACTTC	CASRNTQVEYFTETQYF	TRBV28	TRBJ2-5
TGTGCCTGGAGAGGGTATATGCAAGACAGAGTCACTGAAGCTTTCTTT	CAWRGYMQDRVTEAFF	TRBV30	TRBJ1-1
TGTGCCACCAGTGACTTACGTGGGGTAAGTAATCAGCCCCAGCATTTT	CATSDLRGVSNQPQHF	TRBV24-1	TRBJ1-5
TGCGCCAGCAGTGGACAGGGGAGCGTCTGCTACGAGCAGTACTTC	CASSGQGSVCYEQYF	TRBV10-1	TRBJ2-7
TGTGCCACCAGTGTAGGCAGAGGGGGTCCCAGCTCCTACGAGCAGTACTTC	CATSVGRGGPSSYEQYF	TRBV24-1	TRBJ2-7
TGTGCCAGCAGTTTAAAATCTAGCGGGTTTGAGAGCACAGATACGCAGTATTTT	CASSLKSSGFESTDTQYF	TRBV12-4	TRBJ2-3
TGTGCCAGCAGCTTGCGGGCCCTTTCCTATAATTCACCCCTCCACTTT	CASSLRALSYNSPLHF	TRBV11-3	TRBJ1-6
TGTGCCAGTAGTATCCCAGCTCTGGATGAGCAGTTCTTC	CASSIPALDEQFF	TRBV19	TRBJ2-1
TGCGCCAGCAGCATCCCTAGCGGCCCGGCCGGCACAGATACGCAGTATTTT	CASSIPSGPAGTDTQYF	TRBV5-1	TRBJ2-3
TGCAGCGGAATGGGGCCTAATGAAAAACTGTTTTTT	CSGMGPNEKLFF	TRBV29-1	TRBJ1-4
TGTGCCACCACACAAGAGGGCTACGAGCAGTACTTC	CATTQEGYEQYF	TRBV15	TRBJ2-7
TGTGCCAGCAGTGACTCGTGGATCGGACAGGGGTCAAGGACTGAAGCTTTCTTT	CASSDSWIGQGSRTEAFF	TRBV6-4	TRBJ1-1
TGTGCCAGCAGCTTGAGGACAGGGGGCAGCGCCCAGCCCCAGCATTTT	CASSLRTGGSAQPQHF	TRBV11-3	TRBJ1-5
TGTGCCAGCGGTCCGGGACTAGCCTACGAGCAGTACTTC	CASGPGLAYEQYF	TRBV19	TRBJ2-7
TGTGCCAGCAGCCAAGGTAGGAGGGTGGTTGACGAGCAGTACTTC	CASSQGRRVVDEQYF	TRBV4-2	TRBJ2-7
TGCGCCAGCAGCTTGGCGACGCACTACGAGCAGTACTTC	CASSLATHYEQYF	TRBV5-1	TRBJ2-7
TGTGCCAGCAGCACCGGGTCGACCTCAGTGGATAACACTGAAGCTTTCTTT	CASSTGSTSVDNTEAFF	TRBV2	TRBJ1-1
TGTGCCAGCAGTTACCCCCGGGACAGGGGGCGTTGGCACGAGCAGTACTTC	CASSYPRDRGRWHEQYF	TRBV6-3	TRBJ2-7
TGCAGTGCTCACACGGTGGGGAATGAGCAGTTCTTC	CSAHTVGNEQFF	TRBV20-1	TRBJ2-1
TGTGCCTGGAGTTCCCGAACCCGCTCGTATGAAAAACTGTTTTTT	CAWSSRTRSYEKLFF	TRBV30	TRBJ1-4
TGTGCCAGCAGCGAGAGTGACGGCGAGCAGTACTTC	CASSESDGEQYF	TRBV9	TRBJ2-7
TGTGCCAGCAGTTACGAAGGCCCTACAGGGATAGGGGGCTACACCTTC	CASSYEGPTGIGGYTF	TRBV6-5	TRBJ1-2
TGTGCCAGTATTCCCACAGGGGCCTTTGAGCAGTTCTTC	CASIPTGAFEQFF	TRBV19	TRBJ2-1
TGCAGTGCTAGAGATCCCAGCTACCGGGCGGGCTACACCTTC	CSARDPSYRAGYTF	TRBV20-1	TRBJ1-2
TGTGCCAGCAGCCAGTATAGCGGGAGGGGCCGGCCGAGCTCCTACGAGCAGTACTTC	CASSQYSGRGRPSSYEQYF	TRBV3-1	TRBJ2-7
TGTGCCAGCAGCCAGCTCGAGGTTGGCTCCTACAATGAGCAGTTCTTC	CASSQLEVGSYNEQFF	TRBV7-9	TRBJ2-1
TGTGCCAGCAGTGGAACGATTGGACGGGAGCAGTACTTC	CASSGTIGREQYF	TRBV27	TRBJ2-7
TGTGCCATCAGTGTTGGACAGGGGGTTGGTGATGCAACTAATGAAAAACTGTTTTTT	CAISVGQGVGDATNEKLFF	TRBV10-3	TRBJ1-4
TGTGCCAGCAGCTCCGGGACAGGGGGGAATGAGCAGTTCTTC	CASSSGTGGNEQFF	TRBV7-9	TRBJ2-1
TGTGCCAGCAGTAGCTCCGGGGGGCAATATCCCGGGGAGCTGTTTTTT	CASSSSGGQYPGELFF	TRBV27	TRBJ2-2
TGTGCCAGCAGTTTCGTTCTCGCGGTATCGTGGGAGGAAGGGGGGTACAATGAGCAGTTCTTC	CASSFVLAVSWEEGGYNEQFF	TRBV28	TRBJ2-1
TGCAGCGGTCCCAGTAGCGGTCAGCCCCAGCATTTT	CSGPSSGQPQHF	TRBV29-1	TRBJ1-5
TGTGCCAGCAGTGAATATCCGACAGGGGATATGAACACTGAAGCTTTCTTT	CASSEYPTGDMNTEAFF	TRBV25-1	TRBJ1-1
TGTGCCAGCAGCCACGGGACAGGGGACCTAGCTGAAGCTTTCTTT	CASSHGTGDLAEAFF	TRBV3-1	TRBJ1-1
TGTGCCAGCAGCTTATTCCGCAGGATGGACGAGGACAATGAGCAGTTCTTC	CASSLFRRMDEDNEQFF	TRBV13	TRBJ2-1
TGCGCCAGCAGCTATTGGCTTTCCGTCACTGAAGCTTTCTTT	CASSYWLSVTEAFF	TRBV5-1	TRBJ1-1
TGTGCCAGCAGCTCCCCAAAGGTGAACACTGAAGCTTTCTTT	CASSSPKVNTEAFF	TRBV7-9	TRBJ1-1
TGTGCCAGCAGTTTATCCTCGCTCCCCTCCCCATCCACAGATACGCAGTATTTT	CASSLSSLPSPSTDTQYF	TRBV27	TRBJ2-3
TGCGGGAGGCTAGCGGGTCCACACGACAATGAGCAGTTCTTC	CGRLAGPHDNEQFF	TRBV20-1	TRBJ2-1
TGCAGTGCTAGGGTCGGGGGCGGGACGGGACAAGATGAGCAGTTCTTC	CSARVGGGTGQDEQFF	TRBV20-1	TRBJ2-1
TGTGCCAGCAGCTTGGGGCAGGGAAAGAACTATGGCTACACCTTC	CASSLGQGKNYGYTF	TRBV5-4	TRBJ1-2
TGTGCCAGCAGTGACTCACTGAAATTCATTACCGACCCCTACAATGAGCAGTTCTTC	CASSDSLKFITDPYNEQFF	TRBV6-4	TRBJ2-1
TGTGCCAGCAGTGAAGAGTTGTACGAGCAGTACTTC	CASSEELYEQYF	TRBV12-4	TRBJ2-7
TGCAGCGTTGACCGGGACAGGGCACCTGCAACTAATGAAAAACTGTTTTTT	CSVDRDRAPATNEKLFF	TRBV29-1	TRBJ1-4
TGTGCCAGCAGTGACTCACAGGGGGCTCATCAGTACTTC	CASSDSQGAHQYF	TRBV6-4	TRBJ2-7
TGTGCCAGCAGCAGGGGGCTGGGGAAAGTCAATCAGCCCCAGCATTTT	CASSRGLGKVNQPQHF	TRBV9	TRBJ1-5
TGTGCCAGCAGCCAAGATACCGCGAGGGGTTTTGTTCCCGAGCAGTACTTC	CASSQDTARGFVPEQYF	TRBV4-2	TRBJ2-7
TGTGCCAGCAGCCGGATCGGAAACACCATATATTTT	CASSRIGNTIYF	TRBV7-3	TRBJ1-3
TGCGCCACTCCTCAGGGGGTCATACGGGGGGTAAGGTCCTCGCGCTATGGCTACACCTTC	CATPQGVIRGVRSSRYGYTF	TRBV5-1	TRBJ1-2
TGTGCCAGCAGCCAGGGGGCTACCTCCTACAATGAGCAGTTCTTC	CASSQGATSYNEQFF	TRBV27	TRBJ2-1
TGTGCCATCAGGTCCAGGACAGAGCAGTACTTC	CAIRSRTEQYF	TRBV10-3	TRBJ2-7
TGTGCCACCAGTGGATGGGGCGAGGTCTATGGCTACACCTTC	CATSGWGEVYGYTF	TRBV24-1	TRBJ1-2
TGTCAGAGCACAGATACGCAGTATTTT	CQSTDTQYF	TRBV30	TRBJ2-3
TGTGCCAGCAGCTTAGACACGACAGCTTTCTTT	CASSLDTTAFF	TRBV5-6	TRBJ1-1
TGTGCCAGCAGCTCCGCACTAGCGGGAGGGCTGACTCACTTCACTGAAGCTTTCTTT	CASSSALAGGLTHFTEAFF	TRBV7-9	TRBJ1-1
TGCAGCGTTGAAAGGGCGGAGAATCAGCCCCAGCATTTT	CSVERAENQPQHF	TRBV29-1	TRBJ1-5
TGCAGTGCTCAATTTGGGGACGGTAGTAATTCACCCCTCCACTTT	CSAQFGDGSNSPLHF	TRBV20-1	TRBJ1-6
TGTGCCATCAGTGGTGGGACAGCCCAATCTCAGCCCCAGCATTTT	CAISGGTAQSQPQHF	TRBV10-3	TRBJ1-5
TGTGCCAGCAGCCTGATGGGCTCCGGGGGAGCTGACATTCAGTACTTC	CASSLMGSGGADIQYF	TRBV7-2	TRBJ2-4
TGTGCCAGCAGGCCGGGGGAGAAGGGCTACACCTTC	CASRPGEKGYTF	TRBV6-2	TRBJ1-2
TGCAGTGCTTGGACCTCCTACGAGCAGTACTTC	CSAWTSYEQYF	TRBV20-1	TRBJ2-7
TGTGCCAGCAGTGATCGACTAGGGGAAGGTGCCAAAAACATTCAGTACTTC	CASSDRLGEGAKNIQYF	TRBV6-4	TRBJ2-4
TGCGCCAGCAGCTGCAGCTATGGCTACACCTTC	CASSCSYGYTF	TRBV5-1	TRBJ1-2
TGTGCCAGCAGCTCAGGGCCCGGCACAGATACGCAGTATTTT	CASSSGPGTDTQYF	TRBV11-3	TRBJ2-3
TGCGCCAGCAGACTCCCTCCGGGACAGGCCTATACCTACGAGCAGTACTTC	CASRLPPGQAYTYEQYF	TRBV5-1	TRBJ2-7
TGCGCCAGCAGCCAAGCAGGGGCCCACTACAATGAGCAGTTCTTC	CASSQAGAHYNEQFF	TRBV4-3	TRBJ2-1
TGTGCCAGCAGCGTCCGTGACAGGTTCGGACGCCCTGGAAACACCATATATTTT	CASSVRDRFGRPGNTIYF	TRBV7-9	TRBJ1-3
TGTGCCAGCCGTCCCCACCGGGACTCGCCCCTGGGACCCTACGAGCAGTACTTC	CASRPHRDSPLGPYEQYF	TRBV6-5	TRBJ2-7
TGTGCCAGCAGCCGGCCTTACTACGAGCAGTACTTC	CASSRPYYEQYF	TRBV9	TRBJ2-7
TGCGCCAGCAGCTTGGGAGTGGGGGGGCCCAACACCGGGGAGCTGTTTTTT	CASSLGVGGPNTGELFF	TRBV5-1	TRBJ2-2
TGTGCTAGTGGATCCGGGAACACTGAAGCTTTCTTT	CASGSGNTEAFF	TRBV12-5	TRBJ1-1
TGTGCCAGCACCTGCTGTTCAGCTCCTCACTATGGCTACACCTTC	CASTCCSAPHYGYTF	TRBV12-3	TRBJ1-2
TGTGCCGTAGTAAGGAGACTAGCGGGGGCCGACCATGAGCAGTTCTTC	CAVVRRLAGADHEQFF	TRBV10-3	TRBJ2-1
TGTGCCAGCAGGACGGGAGAAACCTATGGCTACACCTTC	CASRTGETYGYTF	TRBV25-1	TRBJ1-2
TGCAGTGCTAGAGATCTCTCGGAGGGTCAAGAGACCCAGTACTTC	CSARDLSEGQETQYF	TRBV20-1	TRBJ2-5
TGCGCCAGCCCCGGGTGGCCACAGGGGCGACAGGTGGGCTACACCTTC	CASPGWPQGRQVGYTF	TRBV4-1	TRBJ1-2
TGCGCCAGCAGCGCGCGGGTGACAGATACGCAGTATTTT	CASSARVTDTQYF	TRBV5-1	TRBJ2-3
TGTGCCAGCAGCCGAAGGGAGTGTCAGCCCCAGCATTTT	CASSRRECQPQHF	TRBV6-4	TRBJ1-5
TGCGCCAGCAGCTCCTTCCGAGAGGGGGGCCCCAGGGATACGCAGTATTTT	CASSSFREGGPRDTQYF	TRBV5-1	TRBJ2-3
TGTGCCAGCAGCCACGGGACACAGACAGATACGCAGTATTTT	CASSHGTQTDTQYF	TRBV14	TRBJ2-3
TGTGCCAGCAGCTTGGGAACCGGGACAGGGCCCTACGAGCAGTACTTC	CASSLGTGTGPYEQYF	TRBV5-8	TRBJ2-7
TGTGCCAGCAGCATGCGGACTAGCGGGGGGGCGAATATCACAGATACGCAGTATTTT	CASSMRTSGGANITDTQYF	TRBV5-4	TRBJ2-3
TGCGCCAGCAGCTTGGCCTCAGGGAATCAGCCCCAGCATTTT	CASSLASGNQPQHF	TRBV5-1	TRBJ1-5
TGTGCCAAGGTGGGACGACTCGTGAACACTGAAGCTTTCTTT	CAKVGRLVNTEAFF	TRBV10-3	TRBJ1-1
TGTGCCAGCAGCCGGACTAGCGGGCTTGGAAGGGACTGGGGCACAGATACGCAGTATTTT	CASSRTSGLGRDWGTDTQYF	TRBV7-3	TRBJ2-3
TGCGCCAGCAGCTTGGCCGGGGGTACGGGACAGGGTAGTAGCAATCAGCCCCAGCATTTT	CASSLAGGTGQGSSNQPQHF	TRBV5-1	TRBJ1-5
TGTGCCAGCAGCGCGGGGGTACCGGAACACACAGATACGCAGTATTTT	CASSAGVPEHTDTQYF	TRBV13	TRBJ2-3
TGTGCCAGCAGTTACATTGACAGGGACACTGAAGCTTTCTTT	CASSYIDRDTEAFF	TRBV6-5	TRBJ1-1
TGTGCCAGCAGCCCTTGGGCATCCCACTATGGCTACACCTTC	CASSPWASHYGYTF	TRBV13	TRBJ1-2
TGTGCCCCTGGGACAGGGGAGCAGTTCTTC	CAPGTGEQFF	TRBV10-3	TRBJ2-1
TGTGCCAGCAGATTCTCAGAGCGCAATTCACCCCTCCACTTT	CASRFSERNSPLHF	TRBV6-8	TRBJ1-6
TGCAGCGTTGGGGAAAGGGGGACAACTAATGAAAAACTGTTTTTT	CSVGERGTTNEKLFF	TRBV29-1	TRBJ1-4
TGTGCCAGCAGCTTCCCTGGTCAGATGAACACTGAAGCTTTCTTT	CASSFPGQMNTEAFF	TRBV7-8	TRBJ1-1
TGTGCCAGCAGACCTAGCGGGGACAGGAAAGGAGATACGCAGTATTTT	CASRPSGDRKGDTQYF	TRBV27	TRBJ2-3
TGTGCCAGCTGCGCCGTAACACTAGCGGGTGAGCAGTTCTTC	CASCAVTLAGEQFF	TRBV13	TRBJ2-1
TGTGCTAGTGGTTTGGTAACGGGGCATCCTACCGGGGAGCTGTTTTTT	CASGLVTGHPTGELFF	TRBV12-5	TRBJ2-2
TGTGCCTGGAGTACCGATACCACAGGGGAGATGAGAACCTACGAGCAGTACTTC	CAWSTDTTGEMRTYEQYF	TRBV30	TRBJ2-7
TGCAGTGCTCCCCGGCCTTTCCCAAATGAGCAGTTCTTC	CSAPRPFPNEQFF	TRBV20-1	TRBJ2-1
TGTGCCAGCGAGATGGGCACGTATATCTCCTACAATGAGCAGTTCTTC	CASEMGTYISYNEQFF	TRBV7-9	TRBJ2-1
TGTGCCAGCAGCTATGGGGAGTCTGAAGCTTTCTTT	CASSYGESEAFF	TRBV13	TRBJ1-1
TGTGCCAGCAGCTTCACGGGGACAGGGACCTACGAGCAGTACTTC	CASSFTGTGTYEQYF	TRBV5-4	TRBJ2-7
TGTGCCAGCAGCTTAGCCGGGGGGAATACTGAAGCTTTCTTT	CASSLAGGNTEAFF	TRBV7-9	TRBJ1-1
TGTGCCTGGAGCTTGCCGGGGAGCAGCAATCAGCCCCAGCATTTT	CAWSLPGSSNQPQHF	TRBV30	TRBJ1-5
TGTGCCAGCAGCCGAACCGGGAGCACAGATACGCAGTATTTT	CASSRTGSTDTQYF	TRBV27	TRBJ2-3
TGTGCCAGCAGTGAGCAGGCGGGGGAGGACCAAGCCGGGGAGCTGTTTTTT	CASSEQAGEDQAGELFF	TRBV6-4	TRBJ2-2
TGCAGCGGGCGTCCAGGGGGGGCCACCCGGGTCACCGGGGAGCTGTTTTTT	CSGRPGGATRVTGELFF	TRBV29-1	TRBJ2-2
TGTGCCAGCAGTGCCGCCGGGAAGACTGGAAACACCATATATTTT	CASSAAGKTGNTIYF	TRBV6-5	TRBJ1-3
TGCAGTGCTAGAGTCCCAAGCGGGAGCCGGCCGCAGGAGCAGTACTTC	CSARVPSGSRPQEQYF	TRBV20-1	TRBJ2-7
TGTGCCAGCTCACCGGCCCCCGGACGGTCGGGGGGCAATCAGCCCCAGCATTTT	CASSPAPGRSGGNQPQHF	TRBV18	TRBJ1-5
TGTGCCAGCAGTTTATACTTGTGTACTTCGAGGGGGAGGGACGAGCAGTACTTC	CASSLYLCTSRGRDEQYF	TRBV27	TRBJ2-7
TGCGCCAGCAGGGGGGGGTATTGGATTGGAAACACCATATATTTT	CASRGGYWIGNTIYF	TRBV10-1	TRBJ1-3
TGTGCCAGCAGAGGGGCGGCCTATGGCTACACCTTC	CASRGAAYGYTF	TRBV2	TRBJ1-2
TGCAGCGGGACAGGGCGGGTCTATGGCTACACCTTC	CSGTGRVYGYTF	TRBV29-1	TRBJ1-2
TGTGCCAGCACCAAGGGGGGGCCCTCGTGGAAGAATGACATTCAGTACTTC	CASTKGGPSWKNDIQYF	TRBV6-1	TRBJ2-4
TGTGCCAGCAGTGAGCGGGGGCCAGAACCCTACGAGCAGTACTTC	CASSERGPEPYEQYF	TRBV6-1	TRBJ2-7
TGTGCCAGCAGCTTAGGAGGGGGACAGGGGGGAAAACTGTTTTTT	CASSLGGGQGGKLFF	TRBV7-9	TRBJ1-4
TGTGCCCGGGGACTAGCGGGCGGTAGCTCCTACAATGAGCAGTTCTTC	CARGLAGGSSYNEQFF	TRBV24-1	TRBJ2-1
TGTGCCAGCAGACCTCGGAGCAGGGGAAGCGGGGGCAATCAGCCCCAGCATTTT	CASRPRSRGSGGNQPQHF	TRBV11-3	TRBJ1-5
TGTGCCAGCAGTTTCACAAAGGTGCGCTCTGGGGCCAACGTCCTGACTTTC	CASSFTKVRSGANVLTF	TRBV27	TRBJ2-6
TGTGCTAGCAGCTTAACACTAGCGGGTAATTATGAGCAGTTCTTC	CASSLTLAGNYEQFF	TRBV7-7	TRBJ2-1
TGTGCCAGCAGCATTAGTCGACTAGCGGTCTACAATGAGCAGTTCTTC	CASSISRLAVYNEQFF	TRBV13	TRBJ2-1
TGCGCCAGCAGGGGCGCGGCCTACGAGCAGTACTTC	CASRGAAYEQYF	TRBV4-3	TRBJ2-7
TGTGCCTGGAGTTGTCCCTTGGGACGGGTTGAAAAACTGTTTTTT	CAWSCPLGRVEKLFF	TRBV30	TRBJ1-4
TGCAGCGTTGCCGAAAGGGTCACCTTC	CSVAERVTF	TRBV29-1	TRBJ1-2
TGCAGTGCTAGAGGCACAGCAGGAGCTCAGCTCTACGAGCAGTACTTC	CSARGTAGAQLYEQYF	TRBV20-1	TRBJ2-7
TGTGCCAGCAGCTCGCTCGAGGATTACTACGAGCAGTACTTC	CASSSLEDYYEQYF	TRBV11-2	TRBJ2-7
TGTGCCAGCAGCCACCTGGCCTACGAGCAGTACTTC	CASSHLAYEQYF	TRBV14	TRBJ2-7
TGCGCCAGCAGCCGATGGCAAGCGGGGACGCAGTATTTT	CASSRWQAGTQYF	TRBV5-1	TRBJ2-3
TGTGCCACCTGCTTTGCCAGGGCAGATACGCAGTATTTT	CATCFARADTQYF	TRBV24-1	TRBJ2-3
TGTGCCAGCAGCCCGCGGCAGGTGCCACTCCAGACAGGGGGCGGCGGACAGCCCCAGCATTTT	CASSPRQVPLQTGGGGQPQHF	TRBV5-4	TRBJ1-5
TGTGCCACCTGGGTTACCGGGGAGCTGTTTTTT	CATWVTGELFF	TRBV9	TRBJ2-2
TGTGCCAGCAGTTCCCCCGGGACAGGGGGTGGGGATGAAAAACTGTTTTTT	CASSSPGTGGGDEKLFF	TRBV27	TRBJ1-4
TGTGCCAGCAGCCATCACATGCCGAAGTGGGACTATGGCTACACCTTC	CASSHHMPKWDYGYTF	TRBV14	TRBJ1-2
TGTGCCAGCAGCCCAAGTGGACGTAACACAGATACGCAGTATTTT	CASSPSGRNTDTQYF	TRBV7-3	TRBJ2-3
TGCGCCAGCAGCAGCCGGACAGGGGGCCATAGATTCTATGGCTACACCTTC	CASSSRTGGHRFYGYTF	TRBV5-1	TRBJ1-2
TGTGCCAGCACCTTCCGGGTTTTATCTGGGGCCAACGTCCTGACTTTC	CASTFRVLSGANVLTF	TRBV5-4	TRBJ2-6
TGTGCCAGCAGCCAAGAGGATACTAGCGGGAGGAAAGCAAGTGAGCAGTTCTTC	CASSQEDTSGRKASEQFF	TRBV14	TRBJ2-1
TGTGCCAGCAGTTTATCGCGGACCCGGGACACTCTCCCAGGCACCGGGGAGCTGTTTTTT	CASSLSRTRDTLPGTGELFF	TRBV27	TRBJ2-2
TGTGCCAGCAGCTTTGCGTCCCGCGGATCGGGGGCGGGGAACACTGAAGCTTTCTTT	CASSFASRGSGAGNTEAFF	TRBV7-2	TRBJ1-1
TGCAGCGTGCAGGGTCCGTACGAGCAGTACTTC	CSVQGPYEQYF	TRBV29-1	TRBJ2-7
TGTGCCAGCAGTCCCGGGACCGGTACCTACAATGAGCAGTTCTTC	CASSPGTGTYNEQFF	TRBV2	TRBJ2-1
TGTGCCAGCAGTTTACCACAAACGGAGAACCTAGAAGGCTACGAGCAGTACTTC	CASSLPQTENLEGYEQYF	TRBV27	TRBJ2-7
TGTGCCACCCGATGGGGACGGGGCCCACCTTACGAGCAGTACTTC	CATRWGRGPPYEQYF	TRBV24-1	TRBJ2-7
TGTGCCAGCAGTTTATGTTGGATTGGTGCAAGACAGGTTGCTGAAGCTTTCTTT	CASSLCWIGARQVAEAFF	TRBV27	TRBJ1-1
TGCGCCAGCAGGTCGCAGGGGGCGGTGCCCCTCCACTTT	CASRSQGAVPLHF	TRBV5-1	TRBJ1-6
TGTGCCAGCAATCCCGAGGACAGGACCCATGGCTACACCTTC	CASNPEDRTHGYTF	TRBV6-4	TRBJ1-2
TGTGCCAGCAGTTTGAAACCACTAGCGAATCCTGAGACCCAGTACTTC	CASSLKPLANPETQYF	TRBV12-3	TRBJ2-5
TGTGCCAGCAGTTTGCCCGACAGGGTTCTGGTTAATGAAAAACTGTTTTTT	CASSLPDRVLVNEKLFF	TRBV27	TRBJ1-4
TGTGCCAGCACTAATCTGGGACAGGGGACCCTAGAGACCCAGTACTTC	CASTNLGQGTLETQYF	TRBV5-4	TRBJ2-5
TGCGCCAGCAGCTTGCCGGGGGAGTACAATGAGCAGTTCTTC	CASSLPGEYNEQFF	TRBV5-1	TRBJ2-1
TGCAGTGCTAGATTCTGCGACGAGGGCTACACCTTC	CSARFCDEGYTF	TRBV20-1	TRBJ1-2
TGTGCCGAAACAGAAGTCGGCTACACCTTC	CAETEVGYTF	TRBV9	TRBJ1-2
TGTGCCAGCAGTGAAGGTACCAGGGAAGTGCCCTACGAGCAGTACTTC	CASSEGTREVPYEQYF	TRBV6-1	TRBJ2-7
TGTGCCAGCAGCGTAGGACCCGGGATCAGTCAGCCCCAGCATTTT	CASSVGPGISQPQHF	TRBV9	TRBJ1-5
TGTGCCAGCAGCTTAACCGGGCCGAACACCGGGGAGCTGTTTTTT	CASSLTGPNTGELFF	TRBV11-2	TRBJ2-2
TGTGCCAGCAGTTACGTTGACAGGAGTTGTGGGGGAGAGACCCAGTACTTC	CASSYVDRSCGGETQYF	TRBV6-3	TRBJ2-5
TGTGCCAGCAGCAAGGAGGGAGGTTACAATCAGCCCCAGCATTTT	CASSKEGGYNQPQHF	TRBV11-3	TRBJ1-5
TGTGCCAGCAGTGAATCCTCGTGGAGGGGTCCGAACACCGGGGAGCTGTTTTTT	CASSESSWRGPNTGELFF	TRBV6-1	TRBJ2-2
TGTGCCAGCATAGACAACCAAGAGACCCAGTACTTC	CASIDNQETQYF	TRBV27	TRBJ2-5
TGTGCCAGCTCACCCGCGGGAGTCTATATGGGCTACACCTTC	CASSPAGVYMGYTF	TRBV18	TRBJ1-2
TGTGCCAGCAGGGAGGCCGAAGATACGCAGTATTTT	CASREAEDTQYF	TRBV28	TRBJ2-3
TGTGCCACACGACAGGGGGCCGTATTTATCGCCAAAAACATTCAGTACTTC	CATRQGAVFIAKNIQYF	TRBV24-1	TRBJ2-4
TGTGCCAGCAGTTCCGTGAGGGGCAATCAGCCCCAGCATTTT	CASSSVRGNQPQHF	TRBV27	TRBJ1-5
TGTGCCAGCAGCTCCTGCGCACAGGGTTACACAGATACGCAGTATTTT	CASSSCAQGYTDTQYF	TRBV11-1	TRBJ2-3
TGCGCCAGCAATCCTGGCTCCACAGATACGCAGTATTTT	CASNPGSTDTQYF	TRBV4-1	TRBJ2-3
TGTGCCACCAGCAGCGCCGGACAGGGATTCCTAGGTCTGAACACTGAAGCTTTCTTT	CATSSAGQGFLGLNTEAFF	TRBV15	TRBJ1-1
TGCAGTGCTTTAACACCCAGGGCTGATCAGCCCCAGCATTTT	CSALTPRADQPQHF	TRBV20-1	TRBJ1-5
TGTGCCAGCAGCCTCCTAGCCTGCCGGACAGGGGGGGGGGGGTCCTACGAGCAGTACTTC	CASSLLACRTGGGGSYEQYF	TRBV14	TRBJ2-7
TGTGCCAGCAGATGGGGGGAGGAGCAGTACTTC	CASRWGEEQYF	TRBV6-1	TRBJ2-7
TGTGCCAGCAGTTACGCTAGGACAGGGGTTGAAGCCTATGAAAAACTGTTTTTT	CASSYARTGVEAYEKLFF	TRBV27	TRBJ1-4
TGTGCCAGCAGTTACTCGAAATTGGGAGGGATGAACACTGAAGCTTTCTTT	CASSYSKLGGMNTEAFF	TRBV6-3	TRBJ1-1
TGTGCCATCAGTGAGCCCGACAGGGGGCGGACCCCTAATTCACCCCTCCACTTT	CAISEPDRGRTPNSPLHF	TRBV10-3	TRBJ1-6
TGTGCCAGCAATTATACATTAGACAATCAGCCCCAGCATTTT	CASNYTLDNQPQHF	TRBV6-4	TRBJ1-5
TGTGCCAGCAGCGTAGCTGGGACAGGGGGCGAGCAGTACTTC	CASSVAGTGGEQYF	TRBV9	TRBJ2-7
TGTGCCAGCATGCCCCCAAGACTAGAAGAGACCCAGTACTTC	CASMPPRLEETQYF	TRBV6-3	TRBJ2-5
TGCAGCGCGGAAAGCCGGTCGACAGCAGATACGCAGTATTTT	CSAESRSTADTQYF	TRBV29-1	TRBJ2-3
TGTGCCAGCAGCGTTCCTTGCCGGGACAGGGTACTGTATGGCTACACCTTC	CASSVPCRDRVLYGYTF	TRBV9	TRBJ1-2
TGTGCCAGCAGCTTAGGGGGACTAGACAGGGTTGCCACCGGGGAGCTGTTTTTT	CASSLGGLDRVATGELFF	TRBV7-9	TRBJ2-2
TGTGCCAGCAGCGGCCTCGAGCAGTACTTC	CASSGLEQYF	TRBV13	TRBJ2-7
TGTGCCAGCAGGGGGGGGGGTTCTAAGCCCTACAATGAGCAGTTCTTC	CASRGGGSKPYNEQFF	TRBV12-4	TRBJ2-1
TGTGCCAGCAGTGAAGCCAGGCGAGCCTACAATGAGCAGTTCTTC	CASSEARRAYNEQFF	TRBV2	TRBJ2-1
TGTGCCAGCAGGATCTTCTTAAATGAGGGGGGTCATCAGCCCCAGCATTTT	CASRIFLNEGGHQPQHF	TRBV28	TRBJ1-5
TGTGCCAGCCAGGATCGAGGTGGCTACACCTTC	CASQDRGGYTF	TRBV2	TRBJ1-2
TGTGCCAGCAGCGAGGACGGTACGCAGTATTTT	CASSEDGTQYF	TRBV7-8	TRBJ2-3
TGCAGCGCTCTTTCACCTGTCGAGCAGTACTTC	CSALSPVEQYF	TRBV29-1	TRBJ2-7
TGTGCCAGCAGTCACCGAATAATTACAGGGTCTAACTATGGCTACACCTTC	CASSHRIITGSNYGYTF	TRBV6-5	TRBJ1-2
TGTGCCAGCAGGATTTCACCGCCCAGGGGAGGCTACACCTTC	CASRISPPRGGYTF	TRBV6-5	TRBJ1-2
TGTGCCAGCAGTCCCCTTAGGGCCCAGCATTTT	CASSPLRAQHF	TRBV6-4	TRBJ1-5
TGTGCCAGCAGCTCGAGGGGCAATCAGCCCCAGCATTTT	CASSSRGNQPQHF	TRBV13	TRBJ1-5
TGTGCCAGCAGCTTTGGTCTCAGCGGGAAAAGGGTGGGCCACAATGAGCAGTTCTTC	CASSFGLSGKRVGHNEQFF	TRBV7-3	TRBJ2-1
TGTGCCAGCAGCCCTTTTACCCAGGGCTACACCTTC	CASSPFTQGYTF	TRBV9	TRBJ1-2
TGTGCCAGAGGGGGGGGCCATGAGCAGTTCTTC	CARGGGHEQFF	TRBV6-1	TRBJ2-1
TGTGCCAGTAGTGACCGGACAGGTCGAGGGGAGCTGTTTTTT	CASSDRTGRGELFF	TRBV19	TRBJ2-2
TGTGCCAGCAGTGAATCTCGACAGGGGGAGAACACTGAAGCTTTCTTT	CASSESRQGENTEAFF	TRBV2	TRBJ1-1
TGCGCCAGTCCGCAGGGGGCGTCGATGGGAAACACCATATATTTT	CASPQGASMGNTIYF	TRBV4-1	TRBJ1-3
TGTGCCATCAGTGACAGGTTATTTGGTGGCTACACCTTC	CAISDRLFGGYTF	TRBV10-3	TRBJ1-2
TGTGCCAGCAGCTTGGTGGACAGGAACAATGAGCAGTTCTTC	CASSLVDRNNEQFF	TRBV7-7	TRBJ2-1
TGTGCCAGCAGCATGGACCCGGGCGAGAACACTGAAGCTTTCTTT	CASSMDPGENTEAFF	TRBV7-3	TRBJ1-1
TGCGCCAGCATCTCGATCCGGGACAGGGGCCCCCCCTACAATGAGCAGTTCTTC	CASISIRDRGPPYNEQFF	TRBV10-1	TRBJ2-1
TGTGCCAGCAGCCAAGATAACGGGGGGCAGACAGATACGCAGTATTTT	CASSQDNGGQTDTQYF	TRBV14	TRBJ2-3
TGTGCCAGCAGCCCATGTACGCCAGCCAGGGGTCTTGATAATAGCAATCAGCCCCAGCATTTT	CASSPCTPARGLDNSNQPQHF	TRBV7-3	TRBJ1-5
TGTGCCTGGAGTCCACGTTGGTCCACTGAAGCTTTCTTT	CAWSPRWSTEAFF	TRBV30	TRBJ1-1
TGCGCCAGCAGCTTACGGGTAAAGAAAACAGATACGCAGTATTTT	CASSLRVKKTDTQYF	TRBV5-1	TRBJ2-3
TGTGCCACCATATTAGCGGGTCCGAGCACAGATACGCAGTATTTT	CATILAGPSTDTQYF	TRBV24-1	TRBJ2-3
TGCAGTGCTAGAGATCTTTGCAGCGGGAAGCACAATGAGCAGTTCTTC	CSARDLCSGKHNEQFF	TRBV20-1	TRBJ2-1
TGTGCCAGCAGCGGGAGATTAGGGGACGGGGATACGCAGTATTTT	CASSGRLGDGDTQYF	TRBV7-3	TRBJ2-3
TGTGCCAGCAAACCATCCGGGACTAATAAGACCGGGGAGCTGTTTTTT	CASKPSGTNKTGELFF	TRBV11-3	TRBJ2-2
TGTGCCAGCAGCCGTGATCGGGGAAGAAAAAGCTCTGGGGCCAACGTCCTGACTTTC	CASSRDRGRKSSGANVLTF	TRBV5-8	TRBJ2-6
TGTGCCAGCAGCGCGGCCAGGGAGGAAAAACTGTTTTTT	CASSAAREEKLFF	TRBV9	TRBJ1-4
TGTGCCACCTCAGGACAGGGGGACACTGAAGCTTTCTTT	CATSGQGDTEAFF	TRBV24-1	TRBJ1-1
TGTGCCAGCAGCGTAGTCCCTCTGGCGGGACAGGGGCCTGGAAACACCATATATTTT	CASSVVPLAGQGPGNTIYF	TRBV9	TRBJ1-3
TGTGCCAGCAGCTTAATGGCACCCTTCTGGGTTGAGTACCAAGAGACCCAGTACTTC	CASSLMAPFWVEYQETQYF	TRBV7-8	TRBJ2-5
TGTGCCAGCAGTAGATTGCTTAACTATGGCTACACCTTC	CASSRLLNYGYTF	TRBV6-3	TRBJ1-2
TGTGCCACCAGGGAACAGGGGGGGAGAAACACTGAAGCTTTCTTT	CATREQGGRNTEAFF	TRBV11-3	TRBJ1-1
TGCGCCAGCTTGGAGGGGCGTGGCAATCAGCCCCAGCATTTT	CASLEGRGNQPQHF	TRBV10-1	TRBJ1-5
TGCAGCGTTGTAGACAGGCCGGAAGAGACCCAGTACTTC	CSVVDRPEETQYF	TRBV29-1	TRBJ2-5
TGTGCCAGCGATCCCACCCTTAGCGGTTCCTTGCACAATGAGCAGTTCTTC	CASDPTLSGSLHNEQFF	TRBV2	TRBJ2-1
TGTGCCAGCAGCGTAGTGACCCCGCAGGTGAGCTCTGGAAACACCATATATTTT	CASSVVTPQVSSGNTIYF	TRBV9	TRBJ1-3
TGTGCCAGCAGTTTAGAAGGGGGAATGAACTATGGCTACACCTTC	CASSLEGGMNYGYTF	TRBV12-4	TRBJ1-2
TGTGCCATCAAAATGACAGGGGGTCCCTACGAGCAGTACTTC	CAIKMTGGPYEQYF	TRBV10-3	TRBJ2-7
TGCGCCAGCGACTACAATGAGCAGTTCTTC	CASDYNEQFF	TRBV10-1	TRBJ2-1
TGTGCCTGGAGTGTACTTGACGCCGGGGAGCTGTTTTTT	CAWSVLDAGELFF	TRBV30	TRBJ2-2
TGTGCCAGTCCCCAGGGGGTCAGGATGTATGGCTACACCTTC	CASPQGVRMYGYTF	TRBV19	TRBJ1-2
TGTGCCAGCAGTGAGAAAAGAGATGACGGCTACGAGCAGTACTTC	CASSEKRDDGYEQYF	TRBV2	TRBJ2-7
TGTGCCAGCAGCTTGGCACCGGGGGGAGATGTGAACACTGAAGCTTTCTTT	CASSLAPGGDVNTEAFF	TRBV5-4	TRBJ1-1
TGTGCCAGCAGTGAAAAGACCCAGCCCAGACGGGGGAGAGACTATGGCTACACCTTC	CASSEKTQPRRGRDYGYTF	TRBV25-1	TRBJ1-2
TGTGCCAGCAGTTTAGATTACGGGACAGTTATATACGAGCAGTACTTC	CASSLDYGTVIYEQYF	TRBV12-4	TRBJ2-7
TGTGCCAGCAGTTACGATCGTTTAGGTACCGGGGAGCTGTTTTTT	CASSYDRLGTGELFF	TRBV6-6	TRBJ2-2
TGTGCCAGCAGTTTTCCAGAGGCTTTGGAAGATGAGCAGTTCTTC	CASSFPEALEDEQFF	TRBV28	TRBJ2-1
TGTGCCAGCAGAAGGGAGCCCTACGAGCAGTACTTC	CASRREPYEQYF	TRBV6-5	TRBJ2-7
TGTGCCAGCAGCGGGGGGGGGCGCTCGACCGGGGAGCTGTTTTTT	CASSGGGRSTGELFF	TRBV13	TRBJ2-2
TGTGCCAGCAGTTTCAGGGGGAGGCAAGAGACCCAGTACTTC	CASSFRGRQETQYF	TRBV27	TRBJ2-5
TGTGCCAGCAGCTCGTGGGCACCTAGGGGCAATCAGCCCCAGCATTTT	CASSSWAPRGNQPQHF	TRBV5-6	TRBJ1-5
TGTGCCAGCAGTCCACCGTCGACAGGCAATCAGCCCCAGCATTTT	CASSPPSTGNQPQHF	TRBV6-1	TRBJ1-5
TGTGCCAGCAGCAACCTCCAGCATTCCAGCTACACCTTC	CASSNLQHSSYTF	TRBV7-9	TRBJ1-2
TGTGCCAGCAGCGGGCGGTCTAGCGGGCGAGGTAGCAATCAGCCCCAGCATTTT	CASSGRSSGRGSNQPQHF	TRBV5-6	TRBJ1-5
TGTGCCAGCAGATTAGGCACAGATACGCAGTATTTT	CASRLGTDTQYF	TRBV6-4	TRBJ2-3
TGTGCCTGGAGGGATAGGCAGGGGGTAGTGATTTCCAAACCGAACACCGGGGAGCTGTTTTTT	CAWRDRQGVVISKPNTGELFF	TRBV30	TRBJ2-2
TGTGCCAGCAGCAATCACTCATATCTCGGGACTTTACCCAACTACAATGAGCAGTTCTTC	CASSNHSYLGTLPNYNEQFF	TRBV6-3	TRBJ2-1
TGTGCCACCAGTGATTTTAGCTCAGATACGCAGTATTTT	CATSDFSSDTQYF	TRBV24-1	TRBJ2-3
TGTGCCAGCAGCTGTGGGACTAGCGGGGGGTTTCAAGAGACCCAGTACTTC	CASSCGTSGGFQETQYF	TRBV5-8	TRBJ2-5
TGTGCCAGCAGCACCCACCCCCCGGGGTCGGGCCAAGCTTTCTTT	CASSTHPPGSGQAFF	TRBV13	TRBJ1-1
TGTGCCAGCAGATCCGCGGTCCATCGACCGAACACTGAAGCTTTCTTT	CASRSAVHRPNTEAFF	TRBV7-9	TRBJ1-1
TGTGCCAGCAGCGGTGGGGGGGAGGTCAATGAGCAGTTCTTC	CASSGGGEVNEQFF	TRBV13	TRBJ2-1
TGCGCCAGCAGCTTGGTGTACCCCTCCTACGAGCAGTACTTC	CASSLVYPSYEQYF	TRBV5-1	TRBJ2-7
TGTGCCATCAAGAAGGTCCGGACAGGTCTGGGCCAAGCTTTCTTT	CAIKKVRTGLGQAFF	TRBV10-3	TRBJ1-1
TGTGCCAGCAGCGAAGGGGAGGGGGCCTACGAGCAGTACTTC	CASSEGEGAYEQYF	TRBV7-9	TRBJ2-7
TGTGCCAGCAGAGCAAAATTGACGGCAACTAATGAAAAACTGTTTTTT	CASRAKLTATNEKLFF	TRBV7-3	TRBJ1-4
TGTGCCAGCAGCGGCGGACTAGCGGGCGGGATAGAGGTATACGAGCAGTACTTC	CASSGGLAGGIEVYEQYF	TRBV13	TRBJ2-7
TGTGCCACGGGGACCAAGGTACAAAAAGGGGGTTACGAGCAGTACTTC	CATGTKVQKGGYEQYF	TRBV18	TRBJ2-7
TGTGCCAGCAGCCAAGGCCTCGAGGCTAAGGGGTATCAGCCCCAGCATTTT	CASSQGLEAKGYQPQHF	TRBV4-2	TRBJ1-5
TGTGCTAGTGGTTTTCGACGACTAGCGGGGAGAGAGACCCAGTACTTC	CASGFRRLAGRETQYF	TRBV12-5	TRBJ2-5
TGTGCCAGCAGTTCTATGGGACTAGGTTGGTACCAAGAGACCCAGTACTTC	CASSSMGLGWYQETQYF	TRBV12-4	TRBJ2-5
TGTGCCAGCAGCGTACGGCTGCGGGAGACAGATACGCAGTATTTT	CASSVRLRETDTQYF	TRBV9	TRBJ2-3
TGTGCCAGCAGTGAAGTTCCGAGTGAAAACTACGAGCAGTACTTC	CASSEVPSENYEQYF	TRBV25-1	TRBJ2-7
TGTGCCTGGAGTATGAACATCACAGGGGGCGGGAATGAAAAACTGTTTTTT	CAWSMNITGGGNEKLFF	TRBV30	TRBJ1-4
TGTGCCAGCAGAAACGGGACTTCCTACGAGCAGTACTTC	CASRNGTSYEQYF	TRBV6-2	TRBJ2-7
TGTGCCAGCAGGTTGAAGGCCACTCGGCCACACGAGCAGTACTTC	CASRLKATRPHEQYF	TRBV6-3	TRBJ2-7
TGTGCCAGCAGCTTCCCCCAGACATCGTATTCCAGATATTCGCAGTATTTT	CASSFPQTSYSRYSQYF	TRBV5-6	TRBJ2-3
TGTGCCAGCAGTGACTCGTTCCAATCGATCACAGATACGCAGTATTTT	CASSDSFQSITDTQYF	TRBV6-4	TRBJ2-3
TGTGCCAGCAGTGGTGGGGGACGCCCCGAGCAGTACTTC	CASSGGGRPEQYF	TRBV28	TRBJ2-7
TGCGCCAGCAAGTTGCCACAGGGGCAGCCCCAGCATTTT	CASKLPQGQPQHF	TRBV10-1	TRBJ1-5
TGTGCCAGCAGCATCGGACTAGATTCCACAGATACGCAGTATTTT	CASSIGLDSTDTQYF	TRBV5-4	TRBJ2-3
TGTGCCAGCAGCCCGGATCCTATCCTAGACACCGGGGAGCTGTTTTTT	CASSPDPILDTGELFF	TRBV11-2	TRBJ2-2
TGTGCCAGCAGAAGGCCAAACCCGGGACAGGGGGGGGAGCTGTTTTTT	CASRRPNPGQGGELFF	TRBV6-4	TRBJ2-2
TGTGCCAGCACGGCCCTGGACGGGAGCTACACTGAAGCTTTCTTT	CASTALDGSYTEAFF	TRBV27	TRBJ1-1
TGTGCCAGCAGCCTGACAGGGCAGCCCCAGCATTTT	CASSLTGQPQHF	TRBV7-8	TRBJ1-5
TGTGCCAGCAGTTTAACCGGGACTAGCGGGAGACAAGAGACCCAGTACTTC	CASSLTGTSGRQETQYF	TRBV28	TRBJ2-5
TGCAGCGTTGAAGACCGGGACAGGGGTAGGACCGGGGAGCTGTTTTTT	CSVEDRDRGRTGELFF	TRBV29-1	TRBJ2-2
TGTGCCAGCAGCGATACGGGACTAGCCCGCGGGGAGCTGTTTTTT	CASSDTGLARGELFF	TRBV9	TRBJ2-2
TGCGCCAGCAGCCAAGTAGTCAGGGGGCGACTAAATGAGCAGTACTTC	CASSQVVRGRLNEQYF	TRBV4-3	TRBJ2-7
TGTGCCAGCAGCCGCAACGCCGGGGAGCTGTTTTTT	CASSRNAGELFF	TRBV6-1	TRBJ2-2
TGTGCCAGCAGCGGGAACCCTCATGGGGGTCCGGGGATGAACACTGAAGCTTTCTTT	CASSGNPHGGPGMNTEAFF	TRBV13	TRBJ1-1
TGTGCCAGCAGTTTACATCGCACAGACCGTCGGCGAACTAACTATGGCTACACCTTC	CASSLHRTDRRRTNYGYTF	TRBV28	TRBJ1-2
TGTGCCAGCAGCGTAGCAAATTCAAGGGCCGGGGAGCTGTTTTTT	CASSVANSRAGELFF	TRBV9	TRBJ2-2
TGTGCCAGCAGTTTGACCGACAGGGGGCACCGGGGCTACGAGCAGTACTTC	CASSLTDRGHRGYEQYF	TRBV27	TRBJ2-7
TGTGCCAGCAGTTTCCAGGGCACTGAAGCTTTCTTT	CASSFQGTEAFF	TRBV27	TRBJ1-1
TGCAGTGCTAGGTCCGGGACGAGCTACGAGCAGTACTTC	CSARSGTSYEQYF	TRBV20-1	TRBJ2-7
TGTGCCAGCAGCTTGGCCAACCCGGGACAGGGTCGGGAGACCCAGTACTTC	CASSLANPGQGRETQYF	TRBV5-4	TRBJ2-5
TGTGCCAGCAGTCGGAGGGGACCGGATACGCAGTATTTT	CASSRRGPDTQYF	TRBV12-4	TRBJ2-3
TGTGCCAGCAGCTTACAGTTAATACGCAATCAGCCCCAGCATTTT	CASSLQLIRNQPQHF	TRBV11-2	TRBJ1-5
TGCAAGCCGGGACAGGGGTACTCCTACGAGCAGTACTTC	CKPGQGYSYEQYF	TRBV20-1	TRBJ2-7
TGTGCCAGCAGTTTGACAGGGGGGGCCCATCAGCCCCAGCATTTT	CASSLTGGAHQPQHF	TRBV27	TRBJ1-5
TGTGCCAGCAGCTTGTGGGGGGGGGGGATCGGGGAGCTGTTTTTT	CASSLWGGGIGELFF	TRBV11-2	TRBJ2-2
TGTGCCAGCAGTGACGTTTGCACAGATACGCAGTATTTT	CASSDVCTDTQYF	TRBV6-4	TRBJ2-3
TGTGCCAGCAGTTGCGGGAGAGATACGCAGTATTTT	CASSCGRDTQYF	TRBV6-5	TRBJ2-3
TGTGCCAGCAGTCCTAGCGGGGTCACCTACGAGCAGTACTTC	CASSPSGVTYEQYF	TRBV12-4	TRBJ2-7
TGTGCCAGCAGCTACCGGACGTCTAACTATGGCTACACCTTC	CASSYRTSNYGYTF	TRBV13	TRBJ1-2
TGTGCCAGCACCGGTGTTAGCTCGGGAGGGGTTCGACTGTTTTTT	CASTGVSSGGVRLFF	TRBV6-1	TRBJ1-4
TGTGCCAGCAGGGGGACAGGGCCCAACGAGCAGTACTTC	CASRGTGPNEQYF	TRBV6-3	TRBJ2-7
TGTGCCAGGTTGGGACTAGCGGGTGGAAATGAGCAGTTCTTC	CARLGLAGGNEQFF	TRBV27	TRBJ2-1
TGTGCCAGCAGTGCCGACCTCACAGGGGGCTCCCATGGCTACACCTTC	CASSADLTGGSHGYTF	TRBV2	TRBJ1-2
TGCGCCAGCAGTGAACTCCTCGGACTAGCGGGTACGCAGTATTTT	CASSELLGLAGTQYF	TRBV10-1	TRBJ2-3
TGTGCCACCAGTGATACCCCGGCGGGGCTTTGCACTGAAGCTTTCTTT	CATSDTPAGLCTEAFF	TRBV24-1	TRBJ1-1
TGTGCCAGCAGCTTAGTAGCGTTCAATGAGCAGTTCTTC	CASSLVAFNEQFF	TRBV7-4	TRBJ2-1
TGTGCCAGTAGTATGGGGGCACTTTCGGAGAGGATTAGCACAGATACGCAGTATTTT	CASSMGALSERISTDTQYF	TRBV19	TRBJ2-3
TGTGCCAGCAGCCCCATTGGACAGGGAGAACAGCCCCAGCATTTT	CASSPIGQGEQPQHF	TRBV13	TRBJ1-5
TGTGCCAGCAGTTTATCGCAGGTCAACAGACAGGATCCGGGGAACACTGAAGCTTTCTTT	CASSLSQVNRQDPGNTEAFF	TRBV27	TRBJ1-1
TGTGCCATCAGCCTGGTACACGGGCGGCGGGGTTTTTCCTACGAGCAGTACTTC	CAISLVHGRRGFSYEQYF	TRBV10-3	TRBJ2-7
TGCAGTGCTAGCCGACAGGGGACCGGGGAGCTGTTTTTT	CSASRQGTGELFF	TRBV20-1	TRBJ2-2
TGCGCCAGCAGCCAAGTCGAGAAGGAAAGGGGCTCGACCGGGGAGCTGTTTTTT	CASSQVEKERGSTGELFF	TRBV4-1	TRBJ2-2
TGTGCCAGCACCGCCCGGGACAGTCACACTGAAGCTTTCTTT	CASTARDSHTEAFF	TRBV9	TRBJ1-1
TGCAGTGCTAGAGCGGGCTATGGCTACACCTTC	CSARAGYGYTF	TRBV20-1	TRBJ1-2
TGTGCCAGCAGTTTCCAAGCCCGGTGCCGGGACAGGGGGGGCGGTGTCAACACCGGGGAGCTGTTTTTT	CASSFQARCRDRGGGVNTGELFF	TRBV28	TRBJ2-2
TGTGCCAGCAGTGAAAGCGGGGGTAACTCATGGGTTCTTGTCTACGAGCAGTACTTC	CASSESGGNSWVLVYEQYF	TRBV6-1	TRBJ2-7
TGTGCCAGCAGTACCCCCATTGACAGATTGGAATCCGGTCCCACTGAAGCTTTCTTT	CASSTPIDRLESGPTEAFF	TRBV2	TRBJ1-1
TGTGCCAGCAGTCCGCGGGAGTGGCGCAATCAGCCCCAGCATTTT	CASSPREWRNQPQHF	TRBV6-2	TRBJ1-5
TGTGCCAGCAGCAAGCTCATTGGGGAAGGGGGTGGAAACACCATATATTTT	CASSKLIGEGGGNTIYF	TRBV11-3	TRBJ1-3
TGCGCCAGCAGTGAGTGGGGCGCAGGACAATCACGGGCCTACGAGCAGTACTTC	CASSEWGAGQSRAYEQYF	TRBV10-1	TRBJ2-7
TGTGCCATCAGAGTTCAAACTTATCGCGAGCAGTACTTC	CAIRVQTYREQYF	TRBV10-3	TRBJ2-7
TGTGCCAGCAGCATAGGCGGGACAGGGTTGAATAGCAATCAGCCCCAGCATTTT	CASSIGGTGLNSNQPQHF	TRBV5-4	TRBJ1-5
TGTGCCAGCAGCCGCTTTGACAGGGGTAGGCAGTACTTC	CASSRFDRGRQYF	TRBV11-2	TRBJ2-7
TGTGCTAGCAGCTTATCTATTCGGACGAGGGACGTGAACACTGAAGCTTTCTTT	CASSLSIRTRDVNTEAFF	TRBV7-7	TRBJ1-1
TGTGCCAGCTTTCCAGAGCAGCCCCAGCATTTT	CASFPEQPQHF	TRBV27	TRBJ1-5
TGTGCCAGCAGTTTATTAGGGGTGGCTGAAAAACTGTTTTTT	CASSLLGVAEKLFF	TRBV12-4	TRBJ1-4
TGTGCCTGGACCCTCTCGGGGCCTGGGACGGGGATGGGCAATCAGCCCCAGCATTTT	CAWTLSGPGTGMGNQPQHF	TRBV30	TRBJ1-5
TGTGCCAGCAGTTCGGTCTCTGGGGCCAACGTCCTGACTTTC	CASSSVSGANVLTF	TRBV27	TRBJ2-6
TGTGCCAGCAGTTACTCCACTAGCGGGGAGTATTTT	CASSYSTSGEYF	TRBV25-1	TRBJ2-3
TGTGCCAGCAGCCAAGACCCCACAGTCCTAGCCAAAAACATTCAGTACTTC	CASSQDPTVLAKNIQYF	TRBV14	TRBJ2-4
TGCGCCAGCAGCTACGGGGGCAGTAGGGGCTGTAAAGGGTGGACTAGCGGTAAAGCCAAAAACATTCAGTACTTC	CASSYGGSRGCKGWTSGKAKNIQYF	TRBV5-1	TRBJ2-4
TGTGCCAGCAGCGTAGTATTCGGGGTTGTTTCGGAGCAGTACTTC	CASSVVFGVVSEQYF	TRBV9	TRBJ2-7
TGTGCCAGCATAGCGAGGGGCGACCCCTACGAGCAGTACTTC	CASIARGDPYEQYF	TRBV2	TRBJ2-7
TGTGCCAGCAGCGTTCCCAGAGAGTATAATTCACCCCTCCACTTT	CASSVPREYNSPLHF	TRBV13	TRBJ1-6
TGTGCCAGCAGCCGGGGTCGTGCGACTGAAGCTTTCTTT	CASSRGRATEAFF	TRBV7-4	TRBJ1-1
TGTGCCAGCAAAAGAACCGCCGGGACAGGTGGCCCCTACGAGCAGTACTTC	CASKRTAGTGGPYEQYF	TRBV6-4	TRBJ2-7
TGTGCCAGCAGTTTATCGCTGGACAGGGTGGGGCATGAGCAGTTCTTC	CASSLSLDRVGHEQFF	TRBV27	TRBJ2-1
TGCAGTGCTTGGGAGGTCATCCTGGACACATCCCTATACAATGAGCAGTTCTTC	CSAWEVILDTSLYNEQFF	TRBV20-1	TRBJ2-1
TGTGCCAGCAGCCAAGATGGGACTAGCGGGAGAACTAGCACAGATACGCAGTATTTT	CASSQDGTSGRTSTDTQYF	TRBV3-1	TRBJ2-3
TGTGCCAGTAGTATTAGGAGGGGTGATACGCAGTATTTT	CASSIRRGDTQYF	TRBV19	TRBJ2-3
TGTGCCAGCAGCGACAGGGGGGGGGGGGGGGGCTACACCTTC	CASSDRGGGGGYTF	TRBV9	TRBJ1-2
TGTGCCAGCAGCTTAACAAGGACTAGCGGGATTTCAGATACGCAGTATTTT	CASSLTRTSGISDTQYF	TRBV7-3	TRBJ2-3
TGTGCCAGCAGTTACGACAGGGGTACCGGGGAGCTGTTTTTT	CASSYDRGTGELFF	TRBV6-5	TRBJ2-2
TGCAGTGCTAGACATTGGGGACTAGCGGGTATGGAATACGAGCAGTACTTC	CSARHWGLAGMEYEQYF	TRBV20-1	TRBJ2-7
TGTGCCTGGAGTGTTTCCTCCGGGGTGTCAGGGCGCTGGGGCAATCAGCCCCAGCATTTT	CAWSVSSGVSGRWGNQPQHF	TRBV30	TRBJ1-5
TGCAGCGGGGGGTTTAGCAATCAGCCCCAGCATTTT	CSGGFSNQPQHF	TRBV29-1	TRBJ1-5
TGTGCCACCCCGACGGATAGCGGAGTAATGGAGACCCAGTACTTC	CATPTDSGVMETQYF	TRBV24-1	TRBJ2-5
TGCAGTGCGCGGGAGGGCGCGGACGAGCAGTACTTC	CSAREGADEQYF	TRBV20-1	TRBJ2-7
TGTGCCAGGGCAGCGGAAAAACTGTTTTTT	CARAAEKLFF	TRBV7-4	TRBJ1-4
TGTGCCAGCAGTGATTCATCCTGTCCCAAGCGGGAGAGGGACGAGCAGTACTTC	CASSDSSCPKRERDEQYF	TRBV6-4	TRBJ2-7
TGTGCCAGCAGCCAACGCCGGGACAGGGGGCATGGCTACACCTTC	CASSQRRDRGHGYTF	TRBV14	TRBJ1-2
TGCGCCAGCGCCTGCCGTCGTAAGGGACAGGGGGATGAAAAACTGTTTTTT	CASACRRKGQGDEKLFF	TRBV4-3	TRBJ1-4
TGTGCCAGCAGTTTCCCGACCGAAGAGATATTGGAACCCCGACTAGCGGGGCCCGAGACCCAGTACTTC	CASSFPTEEILEPRLAGPETQYF	TRBV28	TRBJ2-5
TGTGCCAGCAGTCTAGTCTCGTATTTT	CASSLVSYF	TRBV6-3	TRBJ2-3
TGTGCCAGCAGAGGGATTGACGCGGCCCTCCACTTT	CASRGIDAALHF	TRBV6-2	TRBJ1-6
TGCAGGTCATTATGGGGGGCGGGAACCGAGACCCAGTACTTC	CRSLWGAGTETQYF	TRBV20-1	TRBJ2-5
TGTGCCAGCAGTGTAGTCGGGGGTAGACTGAACACTGAAGCTTTCTTT	CASSVVGGRLNTEAFF	TRBV6-1	TRBJ1-1
TGTGCCAGCAGTTACCCGGGACAGGGGGGAAACGGTAATGAAAAACTGTTTTTT	CASSYPGQGGNGNEKLFF	TRBV6-6	TRBJ1-4
TGTGCCATGGGACCCACACATCCGGGACAGGTTGGCTACACCTTC	CAMGPTHPGQVGYTF	TRBV10-3	TRBJ1-2
TGTGCCAGTAGTATGGGGGGGGAACCGAATCAGCCCCAGCATTTT	CASSMGGEPNQPQHF	TRBV19	TRBJ1-5
TGTGCCATCACCCAGACAGGTTCGCACTCCTACGAGCAGTACTTC	CAITQTGSHSYEQYF	TRBV10-3	TRBJ2-7
TGCGCCAGCAGCTTGACCGACAGCGGAGGGGGGGTACCTGATGGCTACACCTTC	CASSLTDSGGGVPDGYTF	TRBV5-1	TRBJ1-2
TGCGCCAGCGAGGACGAAAATTCACCCCTCCACTTT	CASEDENSPLHF	TRBV5-1	TRBJ1-6
TGTGCCAGCAGCTGGGCAAAGGGGGGGCACGAGCAGTACTTC	CASSWAKGGHEQYF	TRBV11-2	TRBJ2-7
TGTGCCAGCAGAGTTCGCGGGGGGGGCAATGAGCAGTTCTTC	CASRVRGGGNEQFF	TRBV12-4	TRBJ2-1
TGTGCCAGCAGCAAGTTTGGACAGCAGGGGGCAAATACTGAAGCTTTCTTT	CASSKFGQQGANTEAFF	TRBV7-4	TRBJ1-1
TGCAGTGCTGGGGAAGGACAGGGGAATTCACCCCTCCACTTT	CSAGEGQGNSPLHF	TRBV20-1	TRBJ1-6
TGTGCCAGCTCACCACCCAGCGGGAGTATCTACGAGCAGTACTTC	CASSPPSGSIYEQYF	TRBV18	TRBJ2-7
TGTGCCATCCTCCGACTAGCGAGGTTGGCTAGCACAGATACGCAGTATTTT	CAILRLARLASTDTQYF	TRBV19	TRBJ2-3
TGTGCCAGCAGCCCGATGAACAATCAGCCCCAGCATTTT	CASSPMNNQPQHF	TRBV6-5	TRBJ1-5
TGCGCCAGCATAGGGCCCGTTCGTTCAGATACGCAGTATTTT	CASIGPVRSDTQYF	TRBV5-1	TRBJ2-3
TGCGCCAGCAGTGGGACCGTTCCCTGGACGAGTGAAAAACTGTTTTTT	CASSGTVPWTSEKLFF	TRBV10-1	TRBJ1-4
TGTGCCAGCAGCCCGACAGGGGCCGATGGCTACACCTTC	CASSPTGADGYTF	TRBV7-3	TRBJ1-2
TGTGCCGGGGACTGGGGTGGGGAGGGGGACCTCCAAGAGACCCAGTACTTC	CAGDWGGEGDLQETQYF	TRBV2	TRBJ2-5
TGTGCCAGCAGCGTAGAAAATCCTCACACGCCACCTAACACCGGGGAGCTGTTTTTT	CASSVENPHTPPNTGELFF	TRBV9	TRBJ2-2
TGTGCCATCAGTGAGGACAGGGAACTTGGCTACACCTTC	CAISEDRELGYTF	TRBV10-3	TRBJ1-2
TGTGCCAGCAACCCAGAGATTGCGCCCCTCACCGGGGAGCTGTTTTTT	CASNPEIAPLTGELFF	TRBV27	TRBJ2-2
TGTGCCAGCTCACCGTGGGGGGGCCGGGTTAAGGAGACCCAGTACTTC	CASSPWGGRVKETQYF	TRBV18	TRBJ2-5
TGTGCCAGAGGGTGGGGGCCGCCGGAAGCTTTCTTT	CARGWGPPEAFF	TRBV6-5	TRBJ1-1
TGTGCCAGCAGCTTAGTTAGAGGATCAGCCTCTAGGAACACTGAAGCTTTCTTT	CASSLVRGSASRNTEAFF	TRBV7-9	TRBJ1-1
TGTGCCAGCAGCTCCCTGCCGCGGGGTCCCGAGAACACTGAAGCTTTCTTT	CASSSLPRGPENTEAFF	TRBV7-2	TRBJ1-1
TGTGCCAGCAGCTTCACAACTCTCAACACCGGGGAGCTGTTTTTT	CASSFTTLNTGELFF	TRBV7-4	TRBJ2-2
TGTGCCACCAGTGTGCCGACAGGGTTCTACGAGCAGTACTTC	CATSVPTGFYEQYF	TRBV24-1	TRBJ2-7
TGTGCCACGTACGGACCAGGGGGGATTCCGGGACATGAAGCTTTCTTT	CATYGPGGIPGHEAFF	TRBV15	TRBJ1-1
TGTGCCAGCAGCGTAATCAGCCGGGACAGGGCTTTGGGGATAAACACCATATATTTT	CASSVISRDRALGINTIYF	TRBV7-3	TRBJ1-3
TGCGCCACGCCCTATATAGCGGGTAGGTACTACAATGAGCAGTTCTTC	CATPYIAGRYYNEQFF	TRBV4-3	TRBJ2-1
TGTGCCAGCAGCAGATTCGTAAATATAGCGGGCACGAAGAGCTCCTACAATGAGCAGTTCTTC	CASSRFVNIAGTKSSYNEQFF	TRBV9	TRBJ2-1
TGTGCCAGCAGCTGGCTAGGGGACGAGCAGTACTTC	CASSWLGDEQYF	TRBV11-2	TRBJ2-7
TGTGCCAGCAGCGTAGGCCGACGGACAGATGAGCAGTTCTTC	CASSVGRRTDEQFF	TRBV9	TRBJ2-1
TGTGCCAGCAGCTTAAAACCATGCGATCAGCCCCAGCATTTT	CASSLKPCDQPQHF	TRBV11-3	TRBJ1-5
TGTGCCAGCAGCACCCCAGGGGAGTCGGGAAACACCGGGGAGCTGTTTTTT	CASSTPGESGNTGELFF	TRBV7-3	TRBJ2-2
TGTGCCAGCAGCTTGGGGACAGGGAATGGGAGGTACGAGCAGTACTTC	CASSLGTGNGRYEQYF	TRBV11-3	TRBJ2-7
TGTGCCAGCAGCTTTGTAGCGGGAGGCCAAGAGACCCAGTACTTC	CASSFVAGGQETQYF	TRBV11-3	TRBJ2-5
TGTGCCACCAGTGTAAAGGACCAAACCGGGGAGCTGTTTTTT	CATSVKDQTGELFF	TRBV24-1	TRBJ2-2
TGTGCCAGCAGCCCAGACCCCGGGACAGGGGGGGACGAGCAGTACTTC	CASSPDPGTGGDEQYF	TRBV11-2	TRBJ2-7
TGTGCCAGCATGGGGGGCCCCACTAATTGTGAGCAGTTCTTC	CASMGGPTNCEQFF	TRBV6-1	TRBJ2-1
TGTGCCACCAGTGCCCGGGGGTGTTATTACACCGGGGAGCTGTTTTTT	CATSARGCYYTGELFF	TRBV24-1	TRBJ2-2
TGTGCCAGATTCCATGAACGTATAATCAGCAATCAGCCCCAGCATTTT	CARFHERIISNQPQHF	TRBV27	TRBJ1-5
TGTGCCAGCAGTGACTCTAGCACGTCCCGGAGACAGGGTACCGGGGAGCTGTTTTTT	CASSDSSTSRRQGTGELFF	TRBV6-4	TRBJ2-2
TGTGCTAGTGGTCCAGCCCCAAGGCATCTTTCTGAGACCCAGTACTTC	CASGPAPRHLSETQYF	TRBV12-5	TRBJ2-5
TGTGCCAGCAGTTACTCCCGAAAGGAGGGACAGGGGCCAATGGGTTCTACTACTGAAGCTTTCTTT	CASSYSRKEGQGPMGSTTEAFF	TRBV6-5	TRBJ1-1
TGTGCCAGTAGGGTCAACACGTGGGCCAATGAGCAGTTCTTC	CASRVNTWANEQFF	TRBV19	TRBJ2-1
TGTGCCAGCAGAACCTCAGGGTGGGGCTCTCTCACTGAAGCTTTCTTT	CASRTSGWGSLTEAFF	TRBV27	TRBJ1-1
TGTGCCAGCAGCTTACCGAGCTGGCATCTAGGGTACGAGCAGTACTTC	CASSLPSWHLGYEQYF	TRBV11-3	TRBJ2-7
TGCAGTGCTAGACGACCCAAATTACCCCACAGGGAAGAGACCCAGTACTTC	CSARRPKLPHREETQYF	TRBV20-1	TRBJ2-5
TGTGCCAGCAGCATGGGACAGAGATCCTACGAGCAGTACTTC	CASSMGQRSYEQYF	TRBV6-5	TRBJ2-7
TGTGCCAGCAGCTTAGGCGGGAGGACGGGTTATGGCTACACCTTC	CASSLGGRTGYGYTF	TRBV11-2	TRBJ1-2
TGTGCCACCAGAACGGCAGGGTCAAATGGTGGGTATGGCTACACCTTC	CATRTAGSNGGYGYTF	TRBV24-1	TRBJ1-2
TGCAGCGTTGACCCTAGCGGTCATGAGCAGTTCTTC	CSVDPSGHEQFF	TRBV29-1	TRBJ2-1
TGTGCCAGCAGATCGGTCACTGAGACCCAGTACTTC	CASRSVTETQYF	TRBV12-3	TRBJ2-5
TGCAGTGCTGCCGGGGGGTTCTCCTACGAGCAGTACTTC	CSAAGGFSYEQYF	TRBV20-1	TRBJ2-7
TGTGCCAGCAGCCAAGGTGCTATGGGAGGGGCAGGGCTTGAAAAACTGTTTTTT	CASSQGAMGGAGLEKLFF	TRBV14	TRBJ1-4
TGTGCCAGCAGTTTTATTAGCGGGGGTATCAAAAACATTCAGTACTTC	CASSFISGGIKNIQYF	TRBV27	TRBJ2-4
TGTGCTAGGTGGACAGGGGTAACCCAGCATTTT	CARWTGVTQHF	TRBV6-4	TRBJ1-5
TGTGCCAGCAGCCCCCCGGTCTACAAAAACATTCAGTACTTC	CASSPPVYKNIQYF	TRBV13	TRBJ2-4
TGTGCCAGCAGTTATTACGAGATTGGATACAATGAGCAGTTCTTC	CASSYYEIGYNEQFF	TRBV6-9	TRBJ2-1
TGTGCGCCGACGCGGACGGGTCAGCCCCAGCATTTT	CAPTRTGQPQHF	TRBV7-6	TRBJ1-5
TGTGCCAGCAGGGGGTCTTCAGGGGCCTATCAGCCCCAGCATTTT	CASRGSSGAYQPQHF	TRBV7-3	TRBJ1-5
TGTGCCAGCAGTGAAGGACCGGAGACCCAGTACTTC	CASSEGPETQYF	TRBV2	TRBJ2-5
TGTGCCAGCAGCGCATCCGAAGGGGCCTGGAACTATGGCTACACCTTC	CASSASEGAWNYGYTF	TRBV9	TRBJ1-2
TGCGCCAGCAGCGAGTCGAGGATACTCGACACCATATATTTT	CASSESRILDTIYF	TRBV5-1	TRBJ1-3
TGTGCCACCAGTGATCGGGCCTACACTGAAGCTTTCTTT	CATSDRAYTEAFF	TRBV24-1	TRBJ1-1
TGTGCCAGCAGTGACTCGACCATGGGACAAGGCTTCACCGAGCAGTACTTC	CASSDSTMGQGFTEQYF	TRBV6-4	TRBJ2-7
TGTGCCAGACCTTTCTCGAGCACAGATACGCAGTATTTT	CARPFSSTDTQYF	TRBV4-2	TRBJ2-3
TGTGCCAGCAGCCCCAAGGGACAGGAGGCCTACGAGCAGTACTTC	CASSPKGQEAYEQYF	TRBV13	TRBJ2-7
TGTGCCAGCCAGAATACGGGACAGGGCAGGCGAAGAGAGACCCAGTACTTC	CASQNTGQGRRRETQYF	TRBV2	TRBJ2-5
TGTGCCAGCAGTCCTATGGGGACAAGGTACTTC	CASSPMGTRYF	TRBV28	TRBJ2-4
TGTGCCAGCAGTGAAATAGAGGTGGACAGGGCTACAGATACGCAGTATTTT	CASSEIEVDRATDTQYF	TRBV25-1	TRBJ2-3
TGCGCCAGCAGTGAAACGACAGTGGGGGCCAACGTCCTGACTTTC	CASSETTVGANVLTF	TRBV10-1	TRBJ2-6
TGTGCCAGCAGCTCGCTCGAGAGGAGCCTTAACAATGAGCAGTTCTTC	CASSSLERSLNNEQFF	TRBV7-3	TRBJ2-1
TGCGCCAGCAGCCATGCCCACAGGGGGCGTGGGGCCAACGTCCTGACTTTC	CASSHAHRGRGANVLTF	TRBV5-1	TRBJ2-6
TGTGCCAGCAGCTTAGAGTTCAGGGTTAGGAAAAACATTCAGTACTTC	CASSLEFRVRKNIQYF	TRBV7-9	TRBJ2-4
TGTGCCAGCAGTTTGGCGGTTCATACGCAGTATTTT	CASSLAVHTQYF	TRBV27	TRBJ2-3
TGTGCCAGCAGTAGCCGGGCCATCACTGAAGCTTTCTTT	CASSSRAITEAFF	TRBV6-5	TRBJ1-1
TGCAGTGCTAGAGCCTGTCTATCCGATCAGCCCCAGCATTTT	CSARACLSDQPQHF	TRBV20-1	TRBJ1-5
TGTGCCAGCAGTGAATACAGCGGGTCCACAGATACGCAGTATTTT	CASSEYSGSTDTQYF	TRBV25-1	TRBJ2-3
TGTGCCAGCCGCGAAGCCCTCTCATTGAAACAGGGAGGCCATGAGCAGTTCTTC	CASREALSLKQGGHEQFF	TRBV6-2	TRBJ2-1
TGTGCCAGCGGGAGGACATCCGGACTGGAGGGAGGCACAGATACGCAGTATTTT	CASGRTSGLEGGTDTQYF	TRBV6-4	TRBJ2-3
TGTGCCAGCAGTGAAGATCCACCTTCACCGGGGGGCCCTAGCACAGATACGCAGTATTTT	CASSEDPPSPGGPSTDTQYF	TRBV2	TRBJ2-3
TGCGCCAGCAGCGGACCTATGGACAGCCCACTTCAGCCCCAGCATTTT	CASSGPMDSPLQPQHF	TRBV5-1	TRBJ1-5
TGCGCCAGCAGTTCCGACAGGGACTACTACGAGCAGTACTTC	CASSSDRDYYEQYF	TRBV5-1	TRBJ2-7
TGTGCCAGCAGCATCACACTAGCGGGAGGGCCTTTCCTCAGAGATACGCAGTATTTT	CASSITLAGGPFLRDTQYF	TRBV11-1	TRBJ2-3
TGTGCCAGCAGCTACCGACAGTACGAAGGGGCTTTGCAAGAGACCCAGTACTTC	CASSYRQYEGALQETQYF	TRBV13	TRBJ2-5
TGTGCCAGCAGTACGAAGGTGGGGGACAGGGCTGGCAATCAGCCCCAGCATTTT	CASSTKVGDRAGNQPQHF	TRBV28	TRBJ1-5
TGTGCCAGCAGTTTAGCGGGAATCGGGGCGGAAAAAAACATTCAGTACTTC	CASSLAGIGAEKNIQYF	TRBV27	TRBJ2-4
TGTGCCAGCGGGTTCCGGACAGGAGGGGCCAACTGTTTCTCTGGAAACACCATATATTTT	CASGFRTGGANCFSGNTIYF	TRBV27	TRBJ1-3
TGTGCCAGCAGCTTCATGTTAAGGGGGTACTGGGCCAATCAGCCCCAGCATTTT	CASSFMLRGYWANQPQHF	TRBV7-8	TRBJ1-5
TGTGCCAGCAGCTTAGCCCTCAGTGCGGGAGCGGGACGAGAGACCCAGTACTTC	CASSLALSAGAGRETQYF	TRBV7-8	TRBJ2-5
TGCGCCAGCAGCTTGACACTCACTGAAGCTTTCTTT	CASSLTLTEAFF	TRBV5-1	TRBJ1-1
TGCAGTGCTAGAGATAGAGATCAGCCCCAGCATTTT	CSARDRDQPQHF	TRBV20-1	TRBJ1-5
TGTGCCAGCAGCTTAGTGGGGGGCGATAGCAATCAGCCCCAGCATTTT	CASSLVGGDSNQPQHF	TRBV7-4	TRBJ1-5
TGTGCCTGGAGTGTACGGACTAGCGGTAGGTTAGTTTTCTACGAGCAGTACTTC	CAWSVRTSGRLVFYEQYF	TRBV30	TRBJ2-7
TGTGCCAGCAGCCAAATTGACGGGACTAGCGGGGGGCAAAGGGCGGGGTGCACAGATACGCAGTATTTT	CASSQIDGTSGGQRAGCTDTQYF	TRBV4-2	TRBJ2-3
TGCAGTGCTCAGGGCCTTCGTGGGAGGATTACGAGCTCCTACGAGCAGTACTTC	CSAQGLRGRITSSYEQYF	TRBV20-1	TRBJ2-7
TGTGCCAGTAGTCTGACACAGGGCCCATGGAACACTGAAGCTTTCTTT	CASSLTQGPWNTEAFF	TRBV19	TRBJ1-1
TGCGCCAGCAGTGAGGGGTTAAGAAGCTGGGACAATGAGCAGTTCTTC	CASSEGLRSWDNEQFF	TRBV10-1	TRBJ2-1
TGTGCCAGCACTGGAGGGGGCCGTTATGAGCAGTTCTTC	CASTGGGRYEQFF	TRBV7-4	TRBJ2-1
TGTGCCACAGGCCAATGGAGGGGGGGCAATCAGCCCCAGCATTTT	CATGQWRGGNQPQHF	TRBV24-1	TRBJ1-5
TGCGCCAGCAGTGACGTTTTTATGTACATGCTACAGTACGAGCAGTACTTC	CASSDVFMYMLQYEQYF	TRBV10-2	TRBJ2-7
TGCAGTGCTAGAGATGACAGGGGGGGCAATGAGCAGTTCTTC	CSARDDRGGNEQFF	TRBV20-1	TRBJ2-1
TGTGCCGCCGCGAGCAATCAGCCCCAGCATTTT	CAAASNQPQHF	TRBV6-1	TRBJ1-5
TGTGCCAGCAGCCTCCCGGGACCTGCTTGTGGGTACGAGCAGTACTTC	CASSLPGPACGYEQYF	TRBV7-3	TRBJ2-7
TGTGCCAGCAGTGGGCCTAGGGCTGAGCAGTTCTTC	CASSGPRAEQFF	TRBV6-4	TRBJ2-1
TGTGCCAGCAGTGATAGGGGGAAAGGCACCTACGAGCAGTACTTC	CASSDRGKGTYEQYF	TRBV25-1	TRBJ2-7
TGTGCCAGCAGTTTCGCGCACACAGATACGCAGTATTTT	CASSFAHTDTQYF	TRBV27	TRBJ2-3
TGCAGTGCTAGTCCGTCAGGGAGGGAGCCAGCCTCAGAGACCCAGTACTTC	CSASPSGREPASETQYF	TRBV20-1	TRBJ2-5
TGCGCCAGCAGGTTAGATTGCGGCGGCAGGATCGACTCTGGAAACACCATATATTTT	CASRLDCGGRIDSGNTIYF	TRBV10-1	TRBJ1-3
TGTGCCACCAGCAGAGCTTTCACAGATACGCAGTATTTT	CATSRAFTDTQYF	TRBV15	TRBJ2-3
TGCGCCAGCAGTGATAGGTCCCCCGGGACAGGGGGCCCGCTGTTTTTT	CASSDRSPGTGGPLFF	TRBV10-1	TRBJ1-4
TGTGCCACCAGTGATATGGGGGGCACAGATACGCAGTATTTT	CATSDMGGTDTQYF	TRBV24-1	TRBJ2-3
TGTGCCAGCATGTATTGGACAGGGTTAGGCTCCTACGAGCAGTACTTC	CASMYWTGLGSYEQYF	TRBV6-3	TRBJ2-7
TGTGCCAGCAGTTTAACCTCGGGGAGCGGAAACTACGAGCAGTACTTC	CASSLTSGSGNYEQYF	TRBV28	TRBJ2-7
TGTGCCAGTAGTATTCGGATGGGCTCCTACAATGAGCAGTTCTTC	CASSIRMGSYNEQFF	TRBV19	TRBJ2-1
TGTGCCAGCAGCCCAGCTGGGGAAGAGACCCAGTACTTC	CASSPAGEETQYF	TRBV6-3	TRBJ2-5
TGTGCCAGCAGCGTAGCCGGGACTAGCGGGAAACCCTCTGGGGCCAACGTCCTGACTTTC	CASSVAGTSGKPSGANVLTF	TRBV9	TRBJ2-6
TGTGCCAGCAGCCCCCCCCGCATCTGTTCACCCCTCCACTTT	CASSPPRICSPLHF	TRBV7-9	TRBJ1-6
TGTGCCAGCAGGGGCGGAGGGGGGACGTACTATGGCTACACCTTC	CASRGGGGTYYGYTF	TRBV6-1	TRBJ1-2
TGTGCCAGCAAAAACATGAAGGACACTGAAGCTTTCTTT	CASKNMKDTEAFF	TRBV6-8	TRBJ1-1
TGTGCCAGCAGCCAAGATCCCCGGGACAGGGAAACCTACGAGCAGTACTTC	CASSQDPRDRETYEQYF	TRBV3-1	TRBJ2-7
TGTGCCAGCAGCCCAGACAGGGCCTACGAGCAGTACTTC	CASSPDRAYEQYF	TRBV13	TRBJ2-7
TGCGCCAGCCATAACTCCCTAGCGGGCGTCAATGAGCAGTTCTTC	CASHNSLAGVNEQFF	TRBV10-1	TRBJ2-1
TGTGCCACGGGACAGGGAGACACCGGGGAGCTGTTTTTT	CATGQGDTGELFF	TRBV6-1	TRBJ2-2
TGTGCCAGCAGTTACTCGGGGTTCCGGACAGAAAATCAGCCCCAGCATTTT	CASSYSGFRTENQPQHF	TRBV6-5	TRBJ1-5
TGTGCCAGCAGCGTAGTCCCCCTCGGCGCCCAGTACTTC	CASSVVPLGAQYF	TRBV9	TRBJ2-4
TGTGCCAGCAGTCCCCCCGTGGGGGTGAGGCCCCTACTCAATCAGCCCCAGCATTTT	CASSPPVGVRPLLNQPQHF	TRBV6-2	TRBJ1-5
TGTGCCAGCAGCACCACAAACATTCAGTACTTC	CASSTTNIQYF	TRBV9	TRBJ2-4
TGTGCTATAAGGTTCTCTTACGAGCAGTACTTC	CAIRFSYEQYF	TRBV9	TRBJ2-7
TGTGCCAGCAGCTTAGCGAAAACTGCAAGTTGGGATTCACCCCTCCACTTT	CASSLAKTASWDSPLHF	TRBV7-2	TRBJ1-6
TGTGCCAGCAGTTTTCCCTTCGGACGACCGGCAGAGCAGTACTTC	CASSFPFGRPAEQYF	TRBV12-3	TRBJ2-7
TGTGCCAGCAGCTGGTTTGGACAGGGCTTTGAGGGTGACAATGAGCAGTTCTTC	CASSWFGQGFEGDNEQFF	TRBV7-8	TRBJ2-1
TGTGCCGGGGGTCCCGGGACGATGTTTGAGCAGTTCTTC	CAGGPGTMFEQFF	TRBV9	TRBJ2-1
TGTGCCAGCGGGGGCGGGTACGAGCAGTACTTC	CASGGGYEQYF	TRBV6-4	TRBJ2-7
TGTGCCAGCAGCAACCACAGTGGCTACACCTTC	CASSNHSGYTF	TRBV7-3	TRBJ1-2
TGTGCCAGCAGTCACGGAGGTAAAGAGCAGTACTTC	CASSHGGKEQYF	TRBV6-1	TRBJ2-7
TGCGCCAGCAGCCATGGGTTGAGGACAGATACGCAGTATTTT	CASSHGLRTDTQYF	TRBV4-3	TRBJ2-3
TGTGCCAGCTCACCAAGGGACAGGTACAATGAGCAGTTCTTC	CASSPRDRYNEQFF	TRBV18	TRBJ2-1
TGCGCCAGCAGCTTGGGGGGGGCTCAGAAGGGGTTTCCTTCAAACTATGGCTACACCTTC	CASSLGGAQKGFPSNYGYTF	TRBV5-1	TRBJ1-2
TGTGCCAGCAGCCAAGGCCCTCTTTACAACCCCGGGACAGGCCGGCGTGGCTACACCTTC	CASSQGPLYNPGTGRRGYTF	TRBV3-1	TRBJ1-2
TGCGCCAGCAGTGAGCAGGCGGGCACGGTCTACGAGCAGTACTTC	CASSEQAGTVYEQYF	TRBV10-1	TRBJ2-7
TGTGCCAGCGCCCGAGTTGTTAACCCGACTAGCGGGGGGGCAGGTTCGGAGACCCAGTACTTC	CASARVVNPTSGGAGSETQYF	TRBV6-5	TRBJ2-5
TGTGCCAGCAGCCAGGGCTATAGCAATCAGCCCCAGCATTTT	CASSQGYSNQPQHF	TRBV9	TRBJ1-5
TGTGCCAGCAGGCCACTGCGGGGGGGGCGGGGCACAGATACGCAGTATTTT	CASRPLRGGRGTDTQYF	TRBV2	TRBJ2-3
TGCAGTGCTAGCCAGGGCCTTTTGGGGTTCTCCTACAATGAGCAGTTCTTC	CSASQGLLGFSYNEQFF	TRBV20-1	TRBJ2-1
TGTGCCAGCAGTGACCTACAGGTACGGAGGGACAGGGGGCCGGGAGGTTACAATCAGCCCCAGCATTTT	CASSDLQVRRDRGPGGYNQPQHF	TRBV2	TRBJ1-5
TGCAGTGCTAGACGCAGGCACAGGGGGGAAGAAAAACTGTTTTTT	CSARRRHRGEEKLFF	TRBV20-1	TRBJ1-4
TGTGCCAGCAGCGATTCGTTGGAAAAGACCCAGTACTTC	CASSDSLEKTQYF	TRBV7-2	TRBJ2-5
TGTGCCATCACCTCTTGGGCCACGGGACAGCCCCTTAGTAGAGATGGCTACACCTTC	CAITSWATGQPLSRDGYTF	TRBV10-3	TRBJ1-2
TGCAGACCTACTAGCGGGAGGGCTCTGTACCGAGGCACAGATACGCAGTATTTT	CRPTSGRALYRGTDTQYF	TRBV20-1	TRBJ2-3
TGTGCCACCAGTGATTCCCATAGAATCGAGGGAAACTCTAACTATGGCTACACCTTC	CATSDSHRIEGNSNYGYTF	TRBV24-1	TRBJ1-2
TGTGCCAGCAGCGTAGAAGAAGTGCTAGCGGGATGGAGCCAAGAGACCCAGTACTTC	CASSVEEVLAGWSQETQYF	TRBV9	TRBJ2-5
TGTGCTAGTGGTTTGCCGACAGGGGGTTCCTCCTACGAGCAGTACTTC	CASGLPTGGSSYEQYF	TRBV12-5	TRBJ2-7
TGTGCCAGCAGTTTGCCGACTAGCCTGGGAGAGACCCAGTACTTC	CASSLPTSLGETQYF	TRBV12-4	TRBJ2-5
TGTGCCAGCAGCACACAGGGAAGGTTCTGCCGAAACACCATATATTTT	CASSTQGRFCRNTIYF	TRBV7-8	TRBJ1-3
TGTGCCAGCAGTTACTCGAGTCGAGGGATCTCAAATGAGCAGTTCTTC	CASSYSSRGISNEQFF	TRBV6-5	TRBJ2-1
TGCATTTTGTGGACTAGCGGGGGAGATACGCAGTATTTT	CILWTSGGDTQYF	TRBV20-1	TRBJ2-3
TGTGCCACCAGTGCGTGGGGGCACGTCCGCTACGAGCAGTACTTC	CATSAWGHVRYEQYF	TRBV24-1	TRBJ2-7
TGTGCCAGCAGCGTTGAGGGTCCCTACGAGCAGTACTTC	CASSVEGPYEQYF	TRBV9	TRBJ2-7
TGTGCCAGCAAAGGCAGGGTGTATAGCAATCAGCCCCAGCATTTT	CASKGRVYSNQPQHF	TRBV6-4	TRBJ1-5
TGTGCCAGCAGTGAGAACAAAGGGGTCGGGAACTATGGCTACACCTTC	CASSENKGVGNYGYTF	TRBV6-2	TRBJ1-2
TGTGCCAGCAGCTGGGCGGGGGCCTCCTACGAGCAGTACTTC	CASSWAGASYEQYF	TRBV7-3	TRBJ2-7
TGTGCCAGCAGTGAAGAAAGCGGCTCCAATCAGCCCCAGCATTTT	CASSEESGSNQPQHF	TRBV25-1	TRBJ1-5
TGTGCCAGCAGTTTACCTCGCTACGAGCAGTACTTC	CASSLPRYEQYF	TRBV27	TRBJ2-7
TGTGCCAGCAGTTACGATATCCCTATTTCCTACGAGCAGTACTTC	CASSYDIPISYEQYF	TRBV6-5	TRBJ2-7
TGTGCCAGCAGCAGGGTCGGGACAGGGAGGACCGGGGAGCTGTTTTTT	CASSRVGTGRTGELFF	TRBV5-4	TRBJ2-2
TGTGCCAGCAGCTCTCCAGGGAGCTGGTTCGGGGAGCTGTTTTTT	CASSSPGSWFGELFF	TRBV7-3	TRBJ2-2
TGTGCCAGCACCACAGGGGGCGGCACTGAAGCTTTCTTT	CASTTGGGTEAFF	TRBV2	TRBJ1-1
TGCAGCGTTGTGCCTGATGACACCGGGGAGCTGTTTTTT	CSVVPDDTGELFF	TRBV29-1	TRBJ2-2
TGTGCCAGCAGCCGCCCACCTGACAGGGTTTTTGGCTACACCTTC	CASSRPPDRVFGYTF	TRBV3-1	TRBJ1-2
TGTGCCAGCAGCGGCCCTATTTGGGGGGGGCAAGCTAACACCGGGGAGCTGTTTTTT	CASSGPIWGGQANTGELFF	TRBV9	TRBJ2-2
TGTGCCAGCAGCTTCACAGACCGGGGAGATACGCAGTATTTT	CASSFTDRGDTQYF	TRBV5-6	TRBJ2-3
TGCGCCAGCACTCAAGGGGGCCCATTGCAGCCCCAGCATTTT	CASTQGGPLQPQHF	TRBV10-2	TRBJ1-5
TGTGCCAGCACAATGGGGGCTTTCTTT	CASTMGAFF	TRBV28	TRBJ1-1
TGCGCCAGCAGCAAGGTCGATTGCCCATTTAGGGGTACAGGGGATCAGCCCCAGCATTTT	CASSKVDCPFRGTGDQPQHF	TRBV5-1	TRBJ1-5
TGTGCCAGCAGCCGGTGCGGGAAGACCGAGACCCAGTACTTC	CASSRCGKTETQYF	TRBV7-4	TRBJ2-5
TGTGCCAGCAGCCACCTCTACAATGAGCAGTTCTTC	CASSHLYNEQFF	TRBV6-1	TRBJ2-1
TGTGCCAGGGAGGCCTACGAGCAGTACTTC	CAREAYEQYF	TRBV27	TRBJ2-7
TGTGCCACCAGTGATTACCGTAAACCGACGGTAAAAATTACTGCACCCAGAGAGACCCAGTACTTC	CATSDYRKPTVKITAPRETQYF	TRBV24-1	TRBJ2-5
TGTGCCAGCAGCCAACACTGGGACACCGGGGAGCTGTTTTTT	CASSQHWDTGELFF	TRBV3-1	TRBJ2-2
TGTGCCAGCAGCTTGGGGCCTGAGACCCCCTACGAGCAGTACTTC	CASSLGPETPYEQYF	TRBV5-6	TRBJ2-7
TGCACTCCAGGGGGGATAAAGATGGGATGCAATCAGCCCCAGCATTTT	CTPGGIKMGCNQPQHF	TRBV20-1	TRBJ1-5
TGTGCCAGCAAGCAGGGGACGGTGTTTGGCGGGCGTCCCTCTGGAAACACCATATATTTT	CASKQGTVFGGRPSGNTIYF	TRBV12-3	TRBJ1-3
TGTGCCACCAGTGAACGTATACGATCTTCTGGGGCCAACGTCCTGACTTTC	CATSERIRSSGANVLTF	TRBV24-1	TRBJ2-6
TGTGCCAGCAGTTACTCATACCGGGGCATGACCGGGGAGCTGTTTTTT	CASSYSYRGMTGELFF	TRBV6-5	TRBJ2-2
TGCAGTGCCAGGAAGGAAAATTCACCCCTCCACTTT	CSARKENSPLHF	TRBV20-1	TRBJ1-6
TGTGCCAGCAGCCAGGGACCGGGACTCTGCAATGAGCAGTTCTTC	CASSQGPGLCNEQFF	TRBV14	TRBJ2-1
TGCGCCAGCAGCTCACAGGGGGCACACACTGAAGCTTTCTTT	CASSSQGAHTEAFF	TRBV5-1	TRBJ1-1
TGTGCCAGACTAGCCACCGGGGAGCTGTTTTTT	CARLATGELFF	TRBV19	TRBJ2-2
TGCGCCAGCAGTGAGTCCAAAGCTTGGGGGCCCCCCGGAGATACGCAGTATTTT	CASSESKAWGPPGDTQYF	TRBV10-2	TRBJ2-3
TGTGCCAGCAGTGACCGGACAGTTGGCGAGCAGTACTTC	CASSDRTVGEQYF	TRBV6-4	TRBJ2-7
TGTGCCAGCAGAAGACCGGGACTTGAATGGGTTCTCCACTTT	CASRRPGLEWVLHF	TRBV11-2	TRBJ1-6
TGTGCCAGCAGCCAAGATATCTTAAAGTTTGCGGGATCCGGCTATAGCAATCAGCCCCAGCATTTT	CASSQDILKFAGSGYSNQPQHF	TRBV14	TRBJ1-5
TGTGCCAGCAGCGCCCCGCGACCAGCGGGCACGAACAATGAGCAGTTCTTC	CASSAPRPAGTNNEQFF	TRBV9	TRBJ2-1
TGTGGCAGACTAGCGGGAGCCTACGAGCAGTACTTC	CGRLAGAYEQYF	TRBV28	TRBJ2-7
TGTGCCAGCATTCCTCCCAAGACCGGGACTAGCGGGAGCAGTAGAGATACGCAGTATTTT	CASIPPKTGTSGSSRDTQYF	TRBV25-1	TRBJ2-3
TGTGCCAGCAGAAGATGTAGGCTCATTAGAAGTAATCAGCCCCAGCATTTT	CASRRCRLIRSNQPQHF	TRBV14	TRBJ1-5
TGTGCCAGCCCACAGGGGTCCTACGAGCAGTACTTC	CASPQGSYEQYF	TRBV12-4	TRBJ2-7
TGTGCCACCAGCATTTCTTTCTTCTACGAGCAGTACTTC	CATSISFFYEQYF	TRBV15	TRBJ2-7
TGTGCCAGCAGCCAAGCCCCACTAGCGGGTGATAATGAGCAGTTCTTC	CASSQAPLAGDNEQFF	TRBV3-1	TRBJ2-1
TGTGCCACCAGTGCAGCGGGTCCCTACGAGCAGTACTTC	CATSAAGPYEQYF	TRBV24-1	TRBJ2-7
TGCAGTGCTAGGACGGGAAGGGTTGTAAGTGAAGCTTTCTTT	CSARTGRVVSEAFF	TRBV20-1	TRBJ1-1
TGTGCCAGCGCCCAGGGGCAGCCCCAGCATTTT	CASAQGQPQHF	TRBV27	TRBJ1-5
TGTGCCAGCAGCTTAGACCCCAGGACAGATACGCAGTATTTT	CASSLDPRTDTQYF	TRBV7-4	TRBJ2-3
TGTGCCAGCAGCCAATCTTCGACAGGGGGCAATTCACCCCTCCACTTT	CASSQSSTGGNSPLHF	TRBV3-1	TRBJ1-6
TGCGCCGAATATAGCAATCAGCCCCAGCATTTT	CAEYSNQPQHF	TRBV10-2	TRBJ1-5
TGTGCCAAGGGGACAGGGGTCTACGAGCAGTACTTC	CAKGTGVYEQYF	TRBV14	TRBJ2-7
TGCGCCAGCAGCTTGCCACTAGCGGGAGCTAACGAGCAGTACTTC	CASSLPLAGANEQYF	TRBV5-1	TRBJ2-7
TGTGCCAGCAGTCTTGCCGGGACTAGCGGGAGCTCTGGGGCCAACGTCCTGACTTTC	CASSLAGTSGSSGANVLTF	TRBV6-1	TRBJ2-6
TGTGCCAGCAGTTTAGTGCCTATCGGCTACACCTTC	CASSLVPIGYTF	TRBV27	TRBJ1-2
TGTGCCAGCAGCTGGAGGAATCAGCCCCAGCATTTT	CASSWRNQPQHF	TRBV7-2	TRBJ1-5
TGTGCCAGCAGCTTTAGAAGGACAGACCGGTACAATGAGCAGTTCTTC	CASSFRRTDRYNEQFF	TRBV13	TRBJ2-1
TGTGCCAGCAGTGCCCTAGCGGGCCGCACAGATACGCAGTATTTT	CASSALAGRTDTQYF	TRBV6-8	TRBJ2-3
TGTGCCAGCAGTTATTACTGGGGGTCCTACAATGAGCAGTTCTTC	CASSYYWGSYNEQFF	TRBV6-2	TRBJ2-1
TGTGCCAGCACCGCGGGGGGCCCTTGCGGGGAGCTGTTTTTT	CASTAGGPCGELFF	TRBV28	TRBJ2-2
TGTGCCAGGGTTAAGCAGGAAGGCAATGAGCAGTTCTTC	CARVKQEGNEQFF	TRBV13	TRBJ2-1
TGTGCCAGCAGCGTAGAACTAGCGGGAGGAAGAAGCAATCAGCCCCAGCATTTT	CASSVELAGGRSNQPQHF	TRBV9	TRBJ1-5
TGTGCCAGCAGCCTAGCGGGAAATGAGCAGTTCTTC	CASSLAGNEQFF	TRBV13	TRBJ2-1
TGCGCCAGCAGCGACAGGCTTAGGAACACTGAAGCTTTCTTT	CASSDRLRNTEAFF	TRBV4-1	TRBJ1-1
TGTGCCAGCTCACCACAAGACCCAGGGAACTATGGCTACACCTTC	CASSPQDPGNYGYTF	TRBV18	TRBJ1-2
TGTGCCAGCTCCGGACTTTCTGAAGCTTTCTTT	CASSGLSEAFF	TRBV18	TRBJ1-1
TGTGCCAGCAGTTTTTTCGTTCGACAGGAATGCGAGACCCAGTACTTC	CASSFFVRQECETQYF	TRBV28	TRBJ2-5
TGTGCCAGCTCACCACCCCCCGACAGAGCGGGTTTCAGTCAGCCCCAGCATTTT	CASSPPPDRAGFSQPQHF	TRBV18	TRBJ1-5
TGTGCCAGCAGAAACAGACTCAATAGGCCATCTGGAAACACCATATATTTT	CASRNRLNRPSGNTIYF	TRBV6-4	TRBJ1-3
TGTGCCAGTAGTCATAGTGAAAACAGGGGTCGCAATCAGCCCCAGCATTTT	CASSHSENRGRNQPQHF	TRBV19	TRBJ1-5
TGTGCCAGCAGCTTAGCAAGCACTATGGGGCCTTACGAGCAGTACTTC	CASSLASTMGPYEQYF	TRBV7-9	TRBJ2-7
TGTGCCAGCAGCCGGAGGAACTTCGGGGACAGGGTTGCAACTAATGAAAAACTGTTTTTT	CASSRRNFGDRVATNEKLFF	TRBV5-6	TRBJ1-4
TGTGCCAGCAGTTGGGTGCATGGTTCCTATAACTATGGCTACACCTTC	CASSWVHGSYNYGYTF	TRBV27	TRBJ1-2
TGTGCCAGCTCCACAGGGCTGTGGACGGGATACGAGCAGTACTTC	CASSTGLWTGYEQYF	TRBV18	TRBJ2-7
TGCGCCAGCAGCTTGCCCCCTTTCCCGGACGAGACCCAGTACTTC	CASSLPPFPDETQYF	TRBV5-1	TRBJ2-5
TGTGCCAGCAGTTTGGGGTCGACTAGCTCTGGGGCCAACGTCCTGACTTTC	CASSLGSTSSGANVLTF	TRBV27	TRBJ2-6
TGTGCCAGCAGTTATTGGGACAGACCCTATGGCTACACCTTC	CASSYWDRPYGYTF	TRBV6-5	TRBJ1-2
TGTGCCAGCAGGACACTTGAGCAGTTCTTC	CASRTLEQFF	TRBV5-6	TRBJ2-1
TGTGCCAGAGGGAAGAAGGAGCAGTACTTC	CARGKKEQYF	TRBV10-3	TRBJ2-7
TGTGCCTGGCCAGGAACCCGACAGGGGGCGGTAGCTGGGGCCAACGTCCTGACTTTC	CAWPGTRQGAVAGANVLTF	TRBV30	TRBJ2-6
TGCAGTGCGGGGCCCGGGACTAGCGGCGAAGATGAGCAGTTCTTC	CSAGPGTSGEDEQFF	TRBV20-1	TRBJ2-1
TGTGCCAGCAGCTTAGCCAGGACAGGTTACTATGGCTACACCTTC	CASSLARTGYYGYTF	TRBV11-2	TRBJ1-2
TGTGCCAGCAGCTGGGGGATCAACTCCTACAATGAGCAGTTCTTC	CASSWGINSYNEQFF	TRBV13	TRBJ2-1
TGTGCCATCAGAAGACAGGGGGTGGGTGAAAAACTGTTTTTT	CAIRRQGVGEKLFF	TRBV10-3	TRBJ1-4
TGCGCCAGCAGCTTGCCCGAAAACTATGGCTACACCTTC	CASSLPENYGYTF	TRBV5-1	TRBJ1-2
TGTGCTAGCAGCTCATGCAGGGAGGAGTGGGAGACCCAGTACTTC	CASSSCREEWETQYF	TRBV7-7	TRBJ2-5
TGCAGCGTTGAAGCATTAGGAGGCTGCTCCTACAATGAGCAGTTCTTC	CSVEALGGCSYNEQFF	TRBV29-1	TRBJ2-1
TGTGCCAGCAGTTTAGGTCGGGGCTATAATTCACCCCTCCACTTT	CASSLGRGYNSPLHF	TRBV6-5	TRBJ1-6
TGTGCCACCAGTGATTTGGGGGGACAGGGTGGAGAGAACACCGGGGAGCTGTTTTTT	CATSDLGGQGGENTGELFF	TRBV24-1	TRBJ2-2
TGTGCCACCAGTGATCCTGGGGAGCCCCAGCATTTT	CATSDPGEPQHF	TRBV24-1	TRBJ1-5
TGTGCTAGCAGCTTAGAGGACAGGGGGCCGCATCAGCCCCAGCATTTT	CASSLEDRGPHQPQHF	TRBV7-7	TRBJ1-5
TGTGCCAGCAGCTTGGGGGGGGCCATCTCTGAAGCTTTCTTT	CASSLGGAISEAFF	TRBV5-4	TRBJ1-1
TGTGCCAGCAGGACAGGGGAGGGTACAGATACGCAGTATTTT	CASRTGEGTDTQYF	TRBV6-5	TRBJ2-3
TGTGCCAGCAGCGTTACAGGGGGCCTTGGCCGCACTGAAGCTTTCTTT	CASSVTGGLGRTEAFF	TRBV13	TRBJ1-1
TGTGCCAGCAGTGACGATCTTCAATTGGACAGGTGCCGGAACACTGAAGCTTTCTTT	CASSDDLQLDRCRNTEAFF	TRBV6-1	TRBJ1-1
TGTGCCAGTACAACCAGCGGGAGGAATATGAACACTGAAGCTTTCTTT	CASTTSGRNMNTEAFF	TRBV19	TRBJ1-1
TGTGCCAGCAGTTTAAAGGGGACCTACACTGAAGCTTTCTTT	CASSLKGTYTEAFF	TRBV27	TRBJ1-1
TGTGCCAGCAGCGTAGGCGAGGTAGGACCGCTTGAGCAGTTCTTC	CASSVGEVGPLEQFF	TRBV9	TRBJ2-1
TGTGCCACCAGCCGCCGGAAACGCAATGAAAAACTGTTTTTT	CATSRRKRNEKLFF	TRBV24-1	TRBJ1-4
TGTGCCAGCAGTTTTGTGGGTACGCAGTATTTT	CASSFVGTQYF	TRBV12-4	TRBJ2-3
TGTGCCAGCAGCGAACAAGGCAGGGTATTATATGGCTACACCTTC	CASSEQGRVLYGYTF	TRBV5-4	TRBJ1-2
TGTGCTAAGGGGCGATCCTACGAGCAGTACTTC	CAKGRSYEQYF	TRBV2	TRBJ2-7
TGTGCCAGCAGTTTAGGGGGCGGGGAGCATAGCAATCAGCCCCAGCATTTT	CASSLGGGEHSNQPQHF	TRBV28	TRBJ1-5
TGTGCCAGCAGGAATTTCGAGACTTACGGGGAGCTGTTTTTT	CASRNFETYGELFF	TRBV6-5	TRBJ2-2
TGTGCCAGCAGCCAAGCCCGAGGAAGGGGGGAAATTCGGTGTAGCTACGAGCAGTACTTC	CASSQARGRGEIRCSYEQYF	TRBV14	TRBJ2-7
TGTGCCAGCAAAAAACTAGCGGGAGGGCGTATTAGGTTTTTCACCTACGAGCAGTACTTC	CASKKLAGGRIRFFTYEQYF	TRBV5-6	TRBJ2-7
TGTGCCAGCAGTTACCTCACTAGACACTACGAGCAGTACTTC	CASSYLTRHYEQYF	TRBV6-5	TRBJ2-7
TGTGATGATTCCACTAGGCGCGACAATGAGCAGTTCTTC	CDDSTRRDNEQFF	TRBV9	TRBJ2-1
TGTGCCAGCCGGATGGACGGCTATGGCTACACCTTC	CASRMDGYGYTF	TRBV6-6	TRBJ1-2
TGTGCCAGCAGTGACCGCCAACGAACGGGCGAAGAGACCCAGTACTTC	CASSDRQRTGEETQYF	TRBV6-4	TRBJ2-5
TGTGCCAGCAGTTTAAGCTGCATGAACACTGAAGCTTTCTTT	CASSLSCMNTEAFF	TRBV12-3	TRBJ1-1
TGTGCCAGCAGAACCTCCTACAGAGGGGGCATATTCAATCAGCCCCAGCATTTT	CASRTSYRGGIFNQPQHF	TRBV6-1	TRBJ1-5
TGTGCCAGCAGCCTCCGGACTAGCGGCGCCTACGAGCAGTACTTC	CASSLRTSGAYEQYF	TRBV7-3	TRBJ2-7
TGCAGTGCTTACAAGGCAAGAACAGATGGCTACACCTTC	CSAYKARTDGYTF	TRBV20-1	TRBJ1-2
TGTGCCAGCAGTGACGCAGGGATGTACTACGGGGATAGCTCCTACGAGCAGTACTTC	CASSDAGMYYGDSSYEQYF	TRBV6-4	TRBJ2-7
TGCGCCAGCAGCCCCGGACATTCACCCCTCCACTTT	CASSPGHSPLHF	TRBV4-1	TRBJ1-6
TGTGCCAGCTCACCACGCGCGGGGCGCTGCGGGTATGGCTACACCTTC	CASSPRAGRCGYGYTF	TRBV18	TRBJ1-2
TGTGCCAGCAGTGACTCGACAACAGGGAGGAGGTCATCAGAAGCACCCCGATACGAGCAGTACTTC	CASSDSTTGRRSSEAPRYEQYF	TRBV6-4	TRBJ2-7
TGCGCCAGCAGCCATAGCGGGACATTAGCTTTCTTT	CASSHSGTLAFF	TRBV5-1	TRBJ1-1
TGTGCCTGGCTCCGTAGGGGAACCCACGAGCAGTACTTC	CAWLRRGTHEQYF	TRBV30	TRBJ2-7
TGCAGTGCTACCCCGTGCCAGGGGTCGAGGGTCTATGGCTACACCTTC	CSATPCQGSRVYGYTF	TRBV20-1	TRBJ1-2
TGTGCCAGCAGTGACTCGAAAAGGAAGGGAGGGTTCGTCTACGAGCAGTACTTC	CASSDSKRKGGFVYEQYF	TRBV6-4	TRBJ2-7
TGTGCCACCAGCATTGGGGGGGTGACTGAAGCTTTCTTT	CATSIGGVTEAFF	TRBV15	TRBJ1-1
TGTGCCAGCAGCAGCACTCGTGCTAATGGCTACACCTTC	CASSSTRANGYTF	TRBV7-3	TRBJ1-2
TGTGCCAGCCCCCACGGGAGTCGCTACGAGCAGTACTTC	CASPHGSRYEQYF	TRBV6-1	TRBJ2-7
TGCAGTGCTAGAGGGTTCAGGAGGCTCTTC	CSARGFRRLF	TRBV20-1	TRBJ2-1
TGTGCCAGCAGGGGGGGGTCTCTGGGTGAGCAGTTCTTC	CASRGGSLGEQFF	TRBV7-9	TRBJ2-1
TGCGCCAGCAGTGTCCCCAGACAGGTGGAGACCCAGTACTTC	CASSVPRQVETQYF	TRBV10-1	TRBJ2-5
TGCGCCAGCAGCCCCGGGCGGGTTCGGCATGAGCAGTTCTTC	CASSPGRVRHEQFF	TRBV4-1	TRBJ2-1
TGTGCCAGCAGTGAAGCGCCACGTGCCCGGAAACTAGCGGGAGGGCTACGCGAGCAGTACTTC	CASSEAPRARKLAGGLREQYF	TRBV6-1	TRBJ2-7
TGTGCCAGCAGTGAAGCGCGGACGGGGGGGAAGACCCAAGAGACCCAGTACTTC	CASSEARTGGKTQETQYF	TRBV6-1	TRBJ2-5
TGTGCCAGCAGAGGACAGCGGCAAGAGACCCAGTACTTC	CASRGQRQETQYF	TRBV6-5	TRBJ2-5
TGTGCCAGCAGTGACACAGGGGGGGAGCATTACAATGAGCAGTTCTTC	CASSDTGGEHYNEQFF	TRBV25-1	TRBJ2-1
TGTGCCAGTAGTGAAGCTCCGGACAGGGGGATCTCATACGAGCAGTACTTC	CASSEAPDRGISYEQYF	TRBV19	TRBJ2-7
TGTGCCAGCAGCTTACATAGGGGTGTTGGCGCGAACACCGGGGAGCTGTTTTTT	CASSLHRGVGANTGELFF	TRBV11-2	TRBJ2-2
TGTGCCATTGCGGGACAGGGCCGCTTGTCCTACGAGCAGTACTTC	CAIAGQGRLSYEQYF	TRBV9	TRBJ2-7
TGTGCCAGCAGGGGAATTGAACCCGGGACAGGGGGCCACCAAGAGACCCAGTACTTC	CASRGIEPGTGGHQETQYF	TRBV27	TRBJ2-5
TGTGCCAGCAGGATGACAGGGACCTTC	CASRMTGTF	TRBV6-1	TRBJ1-2
TGTGCCAGCACCGCGACGGGGGGATGCGAGCAGTACTTC	CASTATGGCEQYF	TRBV28	TRBJ2-7
TGCAGTGCAACGTGGGCCCATTTCTATGAGCAGTTCTTC	CSATWAHFYEQFF	TRBV20-1	TRBJ2-1
TGTGCCAGCAGATGGGGCGGGACAGGGGAAGGTAACACTGAAGCTTTCTTT	CASRWGGTGEGNTEAFF	TRBV6-1	TRBJ1-1
TGCGCCAGCAGCAAACCGGGACATGGCTACACCTTC	CASSKPGHGYTF	TRBV5-1	TRBJ1-2
TGTGCCACCAGCAGAGATAACCCAACACTCGGGGGCAAAAACATTCAGTACTTC	CATSRDNPTLGGKNIQYF	TRBV15	TRBJ2-4
TGTGCCAGCAGCGTAGCGGGACTAGATACGCAGTATTTT	CASSVAGLDTQYF	TRBV13	TRBJ2-3
TGTGCCAGCAGTGACAACCTGTGGGAGAAATATCAGCCCCAGCATTTT	CASSDNLWEKYQPQHF	TRBV6-4	TRBJ1-5
TGTGCCATAGGACTAGCGAGCCCTGACGAGCAGTACTTC	CAIGLASPDEQYF	TRBV6-1	TRBJ2-7
TGTGCCAGCAGCGCCCCGGGACTAGCGGGAGGAAATACAGATACGCAGTATTTT	CASSAPGLAGGNTDTQYF	TRBV7-6	TRBJ2-3
TGCGCCAGCACCGGGGTGAACTCCTATAATTCACCCCTCCACTTT	CASTGVNSYNSPLHF	TRBV10-1	TRBJ1-6
TGTGCCAGCAGCTGCTGGAACCCAGAACCGGGACAGGGGCTCGTTTACGAGCAGTACTTC	CASSCWNPEPGQGLVYEQYF	TRBV7-8	TRBJ2-7
TGCGCCAGCAGCTTGGAACTAGTATCGGACTCTGGGGCCAACGTCCTGACTTTC	CASSLELVSDSGANVLTF	TRBV5-1	TRBJ2-6
TGTGCCAGCAGCCCCGGTGGCCCCGTCTTC	CASSPGGPVF	TRBV7-9	TRBJ2-1
TGCGCCAGCAATCCGGGGACTGGGAGGGGGAAAGAGACCCAGTACTTC	CASNPGTGRGKETQYF	TRBV10-1	TRBJ2-5
TGTGCCAGCAGCCCATCAGATAATCAGCCCCAGCATTTT	CASSPSDNQPQHF	TRBV13	TRBJ1-5
TGTGCCAGCAGCCGCCCGGTAACAAAAAGACAGGGAAAACTGTTTTTT	CASSRPVTKRQGKLFF	TRBV7-9	TRBJ1-4
TGTGCCAGTGGGGGCCTGGCGTCTGGGGCCAACGTCCTGACTTTC	CASGGLASGANVLTF	TRBV6-4	TRBJ2-6
TGTGCCAGCAGCCGTACGGCGGGATGGAACACTGAAGCTTTCTTT	CASSRTAGWNTEAFF	TRBV7-3	TRBJ1-1
TGTGCCAGCAGTTACTCGACAGGGGTCTTCTACGAGCAGTACTTC	CASSYSTGVFYEQYF	TRBV6-6	TRBJ2-7
TGTGCCAGCTCACCATCCGACGCAACATTAGCCGTTGGGCGGGACGAGCAGTACTTC	CASSPSDATLAVGRDEQYF	TRBV18	TRBJ2-7
TGCAGTGCGTACGGGGGGGTATGCAATCAGCCCCAGCATTTT	CSAYGGVCNQPQHF	TRBV20-1	TRBJ1-5
TGTGCCAGCATTAGGACGGAGTACGAGCAGTACTTC	CASIRTEYEQYF	TRBV6-1	TRBJ2-7
TGTGCCAGTCCCCGCAGAAGCGATCTGGGATCAGCGGGCTACACCTTC	CASPRRSDLGSAGYTF	TRBV19	TRBJ1-2
TGTGCTAGTGGTAGACCCAGGGGGATTCTTCGAAGGTTAAGAAACACTGAAGCTTTCTTT	CASGRPRGILRRLRNTEAFF	TRBV12-5	TRBJ1-1
TGTGCCAGCAGTTATTCAACCAGGGGGGGTAGCACAGATACGCAGTATTTT	CASSYSTRGGSTDTQYF	TRBV6-9	TRBJ2-3
TGTGCCAGCAGCCAAGAGGAGGGAATGCCAGATACGCAGTATTTT	CASSQEEGMPDTQYF	TRBV3-1	TRBJ2-3
TGTGCCAGCAGCCCGGGACGATACAATGAGCAGTTCTTC	CASSPGRYNEQFF	TRBV9	TRBJ2-1
TGTGCCACCAGCCCGGTCCCCAGGGCCTACGAGCAGTACTTC	CATSPVPRAYEQYF	TRBV15	TRBJ2-7
TGTGCCAGCAGTTACGCCGAGGGGTTAAGCAATCAGCCCCAGCATTTT	CASSYAEGLSNQPQHF	TRBV6-2	TRBJ1-5
TGTGCCAGCAACAGGGGCAGAAGGGCTTTCTTT	CASNRGRRAFF	TRBV6-8	TRBJ1-1
TGTGCCAGCAGTTACGCTCCGTTTTCACAGGGGGGGAATCAGCCCCAGCATTTT	CASSYAPFSQGGNQPQHF	TRBV6-5	TRBJ1-5
TGTGCCATCAGTGAGGGGGGGCCTAATGGCTACACCTTC	CAISEGGPNGYTF	TRBV10-3	TRBJ1-2
TGCGCCAGCAGCCTACGGGGGGGAGTTGGAAACACCGGGGAGCTGTTTTTT	CASSLRGGVGNTGELFF	TRBV10-1	TRBJ2-2
TGTGCCAGCAGCTTGGACTCTGGGCCGATAACACGAAGGGGGGACGAGCAGTACTTC	CASSLDSGPITRRGDEQYF	TRBV5-4	TRBJ2-7
TGTGCCACCAGTGATTTCGGGCAGGGGGCTATTGGCACAAATGAGCAGTTCTTC	CATSDFGQGAIGTNEQFF	TRBV24-1	TRBJ2-1
TGTGCCACCTCGCCGCGACGGCGGGATCAGTTTGGCTACACCTTC	CATSPRRRDQFGYTF	TRBV15	TRBJ1-2
TGTGCCAGTAGGCCGGGGTACTGGCATAATCAGCCCCAGCATTTT	CASRPGYWHNQPQHF	TRBV19	TRBJ1-5
TGTGCCAGCAGTTCCCGAGACAGGGGTATTAGCAATCAGCCCCAGCATTTT	CASSSRDRGISNQPQHF	TRBV6-6	TRBJ1-5
TGTGCCAGCTCACCGAACCGGGACAGGGGCGCCCACACCTTC	CASSPNRDRGAHTF	TRBV18	TRBJ1-2
TGTGCCAGCAGTTACGCCAGGGCCCTTGCAAATGAAGCTTTCTTT	CASSYARALANEAFF	TRBV28	TRBJ1-1
TGTGCCACTCGGACTAGCGGGTGGGACGAGCAGTACTTC	CATRTSGWDEQYF	TRBV6-5	TRBJ2-7
TGTGCCAGCAGGGGACCAAGAGGGTTGGAGACCCAGTACTTC	CASRGPRGLETQYF	TRBV6-5	TRBJ2-5
TGTGCCAGCAGTTTACGCCCTCCATTCGGTGCTTTCAAGATGGACAGTGGTGCTTTCTTT	CASSLRPPFGAFKMDSGAFF	TRBV12-3	TRBJ1-1
TGTGCCAGCAGCGGGGGAGCGGGAGTGACCACAGATACGCAGTATTTT	CASSGGAGVTTDTQYF	TRBV7-9	TRBJ2-3
TGTGCCTGGAGGGAGAAAGCGGGGGGATCTGCCTACAATGAGCAGTTCTTC	CAWREKAGGSAYNEQFF	TRBV30	TRBJ2-1
TGTGCCAGCAGTTACTCCTTATTAGCGGGGGGGCAGGATACGCAGTATTTT	CASSYSLLAGGQDTQYF	TRBV6-3	TRBJ2-3
TGTGCCAGCAGCGCACGGTTGCCTTTCAATCAGCCCCAGCATTTT	CASSARLPFNQPQHF	TRBV9	TRBJ1-5
TGTGCCAGCAGCTTGGAGGGCCGCACCGGGGAGCTGTTTTTT	CASSLEGRTGELFF	TRBV5-6	TRBJ2-2
TGTGCCAGCGATGACCTAGGGGGTGAGCAGTACTTC	CASDDLGGEQYF	TRBV28	TRBJ2-7
TGTGCCAGCAGTTACTCGGGGAACCCCCGAATGAACACTGAAGCTTTCTTT	CASSYSGNPRMNTEAFF	TRBV6-5	TRBJ1-1
TGTGCCAGCAGTTACCTATCTAAAGAGATTGAAGCTTTCTTT	CASSYLSKEIEAFF	TRBV6-5	TRBJ1-1
TGTGCCAGCAGCCTACAGGACAATGAGCAGTTCTTC	CASSLQDNEQFF	TRBV13	TRBJ2-1
TGTGCCAGCAGTTTGACAGGCGTCGGCTATGGCTACACCTTC	CASSLTGVGYGYTF	TRBV6-1	TRBJ1-2
TGTGCCAGCAGTGAACTAAATGGACTAGGGTTGCTGCACGGGGAGCTGTTTTTT	CASSELNGLGLLHGELFF	TRBV6-4	TRBJ2-2
TGTGCCTGGAGTCGGACAGCGGAGACCCAGTACTTC	CAWSRTAETQYF	TRBV30	TRBJ2-5
TGCGCCAGCAGCTCGGTTGGCAGGGCGAACACCGGGGAGCTGTTTTTT	CASSSVGRANTGELFF	TRBV5-1	TRBJ2-2
TGTGCCAGCAGTACCCAAGGGACTAGCGGACACGAGCAGTACTTC	CASSTQGTSGHEQYF	TRBV6-5	TRBJ2-7
TGTGCCAGCAGTATCATTGGGGGACGGAGTCAGGAGACCCAGTACTTC	CASSIIGGRSQETQYF	TRBV27	TRBJ2-5
TGTGCCAGCAGTGCCCAAGGGGGTGGCTACACCTTC	CASSAQGGGYTF	TRBV6-1	TRBJ1-2
TGCAGTGCTAGAGCAGGACATGGGGTCGACGAGCAGTACTTC	CSARAGHGVDEQYF	TRBV20-1	TRBJ2-7
TGTGCCAGCAGCCAGGGAGATAGCAATCAGCCCCAGCATTTT	CASSQGDSNQPQHF	TRBV13	TRBJ1-5
TGTGCCACCGCCCAATACTTAATTCGTAATGAGCAGTACTTC	CATAQYLIRNEQYF	TRBV24-1	TRBJ2-7
TGTGCCAGCAGCTTCTGGGGAGATACGCAGTATTTT	CASSFWGDTQYF	TRBV7-9	TRBJ2-3
TGTGCCAAACTAATACACGGCGGGAATGAGCAGTTCTTC	CAKLIHGGNEQFF	TRBV6-2	TRBJ2-1
TGTGCCAGCAGCCTTCCATGTCCGGGACAGGGCGCGAATGGTAATGAAAAACTGTTTTTT	CASSLPCPGQGANGNEKLFF	TRBV9	TRBJ1-4
TGTGCCAGCAGCCAAGTTGAAACCGGGACGGGAAACACCATATATTTT	CASSQVETGTGNTIYF	TRBV3-1	TRBJ1-3
TGTGCCCCTAGAGGAAGCTCCTACAATGAGCAGTTCTTC	CAPRGSSYNEQFF	TRBV19	TRBJ2-1
TGTGCCAGCAGCTTGGGACAGGGTCAGAGGGAGCTGTTTTTT	CASSLGQGQRELFF	TRBV11-2	TRBJ2-2
TGTGCCAGCAGCCCCCGGACAGGGAAAATAGATACGCAGTATTTT	CASSPRTGKIDTQYF	TRBV5-4	TRBJ2-3
TGTGCCAGCAGCCAAGAGGGTAGCTACGAGCAGTACTTC	CASSQEGSYEQYF	TRBV4-2	TRBJ2-7
TGTGCCAGCAGTCCGGGACAGGGGGCACTAGATACGCAGTATTTT	CASSPGQGALDTQYF	TRBV27	TRBJ2-3
TGTGCCAGCAGCTTGGAGCAAGGGGTCTACGGGGGAAACACTGAAGCTTTCTTT	CASSLEQGVYGGNTEAFF	TRBV5-6	TRBJ1-1
TGTGCCACGGCATCCGGGACAGAGAGCTCTAACTATGGCTACACCTTC	CATASGTESSNYGYTF	TRBV24-1	TRBJ1-2
TGTGCCAGCAGCATCGGGGGGCACACTGAAGCTTTCTTT	CASSIGGHTEAFF	TRBV11-2	TRBJ1-1
TGTGCCGCTAGAAAGGGGGGGTACCACACTGAAGCTTTCTTT	CAARKGGYHTEAFF	TRBV11-3	TRBJ1-1
TGTGCCAGCAGTGATGTTGGGACAGGCTGGGGATACTACGAGCAGTACTTC	CASSDVGTGWGYYEQYF	TRBV27	TRBJ2-7
TGTGCCAGCAGCATTAGTTGGACTAGCGGGGACACAGATACGCAGTATTTT	CASSISWTSGDTDTQYF	TRBV7-4	TRBJ2-3
TGTGCCAGAACCGAAGCCGTCGCGGAAGAGGATTCACCCCTCCACTTT	CARTEAVAEEDSPLHF	TRBV25-1	TRBJ1-6
TGTGCCAGCAGGGAGGGCTGGAGCTACAATGAGCAGTTCTTC	CASREGWSYNEQFF	TRBV27	TRBJ2-1
TGTGCCAGCAGGACTAGCGCAACCTACGAGCAGTACTTC	CASRTSATYEQYF	TRBV25-1	TRBJ2-7
TGTGCCAGCAGTCCCTATCGGTACGAGCAGTACTTC	CASSPYRYEQYF	TRBV6-1	TRBJ2-7
TGTGCCAGCAGTCTCCTGGGCGAGAACTATGGCTACACCTTC	CASSLLGENYGYTF	TRBV5-6	TRBJ1-2
TGTGCCAGCAGCTTAAAGCGACAGGGGGCCCGCTCCTACGAGCAGTACTTC	CASSLKRQGARSYEQYF	TRBV7-3	TRBJ2-7
TGTGCCAGCAGTTTCCAGGGGGCCGGGGGGGGAGAGACCCAGTACTTC	CASSFQGAGGGETQYF	TRBV12-3	TRBJ2-5
TGTGCCACCAGAAATGGGGGCAGGTACTACGAGCAGTACTTC	CATRNGGRYYEQYF	TRBV24-1	TRBJ2-7
TGTGCCAGCAGCCCTTTGGCGAGGGAGTATTTT	CASSPLAREYF	TRBV13	TRBJ2-3
TGTGCCAGCAAGGGACAGGTGAGCTACGAGCAGTACTTC	CASKGQVSYEQYF	TRBV6-3	TRBJ2-7
TGTGCCAGCTCACCATTTACGGGGGGCGATGCAACTAATGAAAAACTGTTTTTT	CASSPFTGGDATNEKLFF	TRBV18	TRBJ1-4
TGTGCCAGCAGCAAATGGTACGGAAGGACAGGGGGAGACTACGAGCAGTACTTC	CASSKWYGRTGGDYEQYF	TRBV7-4	TRBJ2-7
TGTGCCACCAGTGATTCCCCCCCGGGGACAGGGGCCTCTGGGCACCCTGAATATAGCAATCAGCCCCAGCATTTT	CATSDSPPGTGASGHPEYSNQPQHF	TRBV24-1	TRBJ1-5
TGCAGTGCCGGACCCCCCGACAAGAACACAGATACGCAGTATTTT	CSAGPPDKNTDTQYF	TRBV20-1	TRBJ2-3
TGTGCCAGCAGCTTAGGTCGGACCGAGCAGTACTTC	CASSLGRTEQYF	TRBV7-2	TRBJ2-7
TGTGCCAGCAGCTCGGCCCCCTTCCCGGGACAGGGGGCGGGTAAACTGTTTTTT	CASSSAPFPGQGAGKLFF	TRBV7-2	TRBJ1-4
TGCGCCAGCAGCAAGGGCCCGGAGACAGATACGCAGTATTTT	CASSKGPETDTQYF	TRBV5-1	TRBJ2-3
TGTGCTAGTGGTTTGGCTCCCGCTAGATGGAAGTTCTACGAGCAGTACTTC	CASGLAPARWKFYEQYF	TRBV12-5	TRBJ2-7
TGTGCCAGCAGGGCTCTGGGGCGTAAAGAGACCCAGTACTTC	CASRALGRKETQYF	TRBV27	TRBJ2-5
TGTGCCATTTCTTTAAAACTAGCGGTACCAAAAGAGACCCAGTACTTC	CAISLKLAVPKETQYF	TRBV6-6	TRBJ2-5
TGCAGCGTTGAACCGACAGGGGTCATTAATCTTCCAAAAAGAGGATATAGCAATCAGCCCCAGCATTTT	CSVEPTGVINLPKRGYSNQPQHF	TRBV29-1	TRBJ1-5
TGCAGCGTTCCGTATGTTCGGGGCTACGAGCAGTACTTC	CSVPYVRGYEQYF	TRBV29-1	TRBJ2-7
TGTGCCAGCAGTTACAAAAGACAGGATCCTAACTATGGCTACACCTTC	CASSYKRQDPNYGYTF	TRBV6-5	TRBJ1-2
TGTGCCAGCAGTGGACAGCGAAATCAGCCCCAGCATTTT	CASSGQRNQPQHF	TRBV6-2	TRBJ1-5
TGTGCCAGCAGGCGGAGCTATGGCTACACCTTC	CASRRSYGYTF	TRBV12-3	TRBJ1-2
TGTGCCAGCAGCCAAGGAAGAATGCAGACCAATGAAAAACTGTTTTTT	CASSQGRMQTNEKLFF	TRBV14	TRBJ1-4
TGTGCCAGCAGTTTCCATTGGACTAGCGGGGGGGCGGCGTACTCTGGGGCCAACGTCCTGACTTTC	CASSFHWTSGGAAYSGANVLTF	TRBV6-1	TRBJ2-6
TGTGCCAGCAGCCCAGTCAGGGGGGCCTACGAGCAGTACTTC	CASSPVRGAYEQYF	TRBV7-4	TRBJ2-7
TGTGCCAGCACTCCACGGGAACGTTATGCAACTAATGAAAAACTGTTTTTT	CASTPRERYATNEKLFF	TRBV6-5	TRBJ1-4
TGCAGTGCTGCAGGGCCAGTAGATACGCAGTATTTT	CSAAGPVDTQYF	TRBV20-1	TRBJ2-3
TGCGCCAGCAGCTTGTGGGGGGGGTACCCTTTCTTC	CASSLWGGYPFF	TRBV5-1	TRBJ2-1
TGCAGTGCGTCAGGGGGCACCCATGAGCAGTTCTTC	CSASGGTHEQFF	TRBV20-1	TRBJ2-1
TGTGCCACCAGTGGGAATACGAGCAATCAGCCCCAGCATTTT	CATSGNTSNQPQHF	TRBV24-1	TRBJ1-5
TGTGCCAGCAGTGGCCGGGGGGGGTACGAGCAGTACTTC	CASSGRGGYEQYF	TRBV2	TRBJ2-7
TGTGCCAGCAGTTTGGCCCATGGGGGGTATGATAATCAGCCCCAGCATTTT	CASSLAHGGYDNQPQHF	TRBV12-4	TRBJ1-5
TGTGCCTGGAACTCGATAGGAAGCTCCTACAATGAGCAGTTCTTC	CAWNSIGSSYNEQFF	TRBV30	TRBJ2-1
TGTGCCAGCAGGGCACTTGTAAATGAGCAGTTCTTC	CASRALVNEQFF	TRBV6-5	TRBJ2-1
TGTGCCAGCATACGCCGGGACAAGGACGAGCAGTACTTC	CASIRRDKDEQYF	TRBV6-5	TRBJ2-7
TGCGCCAGCCAGTGCGACAGGTCAGGCTACACCTTC	CASQCDRSGYTF	TRBV10-1	TRBJ1-2
TGTGCCAGCAGTAATCGGACTAGCGATCGCTACAATGAGCAGTTCTTC	CASSNRTSDRYNEQFF	TRBV28	TRBJ2-1
TGTGCCAGCATCGCGGGACAGGGCATCTATGGCTACACCTTC	CASIAGQGIYGYTF	TRBV11-3	TRBJ1-2
TGTGCCAGTAAGAGCGGACAGGGTCGAACTGGGGCCAACGTCCTGACTTTC	CASKSGQGRTGANVLTF	TRBV19	TRBJ2-6
TGCAGTGCGCAACCGGGACAGGGGATCCTAAACTATGGCTACACCTTC	CSAQPGQGILNYGYTF	TRBV20-1	TRBJ1-2
TGTGCCAGCAGTGACAAAGGGGCTGGACAAGAGACCCAGTACTTC	CASSDKGAGQETQYF	TRBV2	TRBJ2-5
TGTGCCAGCAGTTATCTACTTAGACCAGATACGCAGTATTTT	CASSYLLRPDTQYF	TRBV6-5	TRBJ2-3
TGTGCCAGCAGCGTAGTTAGCGGGAGCAACTACGAGCAGTACTTC	CASSVVSGSNYEQYF	TRBV9	TRBJ2-7
TGTGCGCCGGGACTAGCGGGGGGAGTGAAACCCTATGAGCAGTTCTTC	CAPGLAGGVKPYEQFF	TRBV7-9	TRBJ2-1
TGCAGCGTTGCGCGGGACAGTGAAGCTTTCTTT	CSVARDSEAFF	TRBV29-1	TRBJ1-1
TGTGCCAGTGGACAGGGCGAGCAGTACTTC	CASGQGEQYF	TRBV7-9	TRBJ2-7
TGTGCCTCCGCGGGGGGTCAAGCCTACGAGCAGTACTTC	CASAGGQAYEQYF	TRBV27	TRBJ2-7
TGCAGCGTTCGCGGGAGAGGCGAGCAGTACTTC	CSVRGRGEQYF	TRBV29-1	TRBJ2-7
TGTGCCATGAAGGGGGGGGGTTATGAGCAGTTCTTC	CAMKGGGYEQFF	TRBV7-7	TRBJ2-1
TGTGCCAGCAGTGCCATCCGGGATATCGAAAAACTGTTTTTT	CASSAIRDIEKLFF	TRBV25-1	TRBJ1-4
TGCAGTGCTTGTAGTGGCGACGGGACACCGGAAAAACTGTTTTTT	CSACSGDGTPEKLFF	TRBV20-1	TRBJ1-4
TGCAGCGTTGACACGGGGGGACATGAGCAGTTCTTC	CSVDTGGHEQFF	TRBV29-1	TRBJ2-1
TGCGCCAGCAGCTTGGGGGCGGCCGACAGGGGAGTCTCTGGGGCCAACGTCCTGACTTTC	CASSLGAADRGVSGANVLTF	TRBV5-1	TRBJ2-6
TGTGCCACCAGCTCGGACAACGAGTGCCTTTTGCAGCCCCAGCATTTT	CATSSDNECLLQPQHF	TRBV15	TRBJ1-5
TGTGCCAGTAGTAGGACAGGACTGTCCAAGAACACTGAAGCTTTCTTT	CASSRTGLSKNTEAFF	TRBV19	TRBJ1-1
TGTGCCAGCAGCTCCCGTCGATTGGATACGCAGTATTTT	CASSSRRLDTQYF	TRBV7-3	TRBJ2-3
TGTGCCAGCAGACCACTAGCGGGAGGGCTCTTTGGTCTTTACGAGCAGTACTTC	CASRPLAGGLFGLYEQYF	TRBV6-5	TRBJ2-7
TGCTACGACAGGAACACTGAAGCTTTCTTT	CYDRNTEAFF	TRBV20-1	TRBJ1-1
TGCAGTGCTAACAGCGCAGGGGGGACGCAGTTCTTC	CSANSAGGTQFF	TRBV20-1	TRBJ2-1
TGCGGCCCGGGCACAGATACGCAGTATTTT	CGPGTDTQYF	TRBV5-1	TRBJ2-3
TGCAGTGCTGCACGGACAGGGCGGGGTTGCAATCAGCCCCAGCATTTT	CSAARTGRGCNQPQHF	TRBV20-1	TRBJ1-5
TGTGCCAGCAGTTTCTGGGGCGTTCCTAATTCACCCCTCCACTTT	CASSFWGVPNSPLHF	TRBV12-3	TRBJ1-6
TGTGCCAGCAGTTCTCCTAGGGGGCCACGCTACGAGCAGTACTTC	CASSSPRGPRYEQYF	TRBV6-6	TRBJ2-7
TGTGCTAGAGACAGGGAAGGGCGGAGCACAGATACGCAGTATTTT	CARDREGRSTDTQYF	TRBV30	TRBJ2-3
TGTGCCAGCAGGCTCACCTCAGGGAGGCTAGCCAAAAACATTCAGTACTTC	CASRLTSGRLAKNIQYF	TRBV6-4	TRBJ2-4
TGTGCCAGCAGCTTAGGGTGGAGCCACGTCTCCTACAATGAGCAGTTCTTC	CASSLGWSHVSYNEQFF	TRBV7-9	TRBJ2-1
TGTGCCAGCAGCTTGTCCGGGACAGGGGGGCCCTATGGCTACACCTTC	CASSLSGTGGPYGYTF	TRBV5-5	TRBJ1-2
TGTGCCGTAGAGGGGCGAGGTAAGGCAGGCTACACCTTC	CAVEGRGKAGYTF	TRBV28	TRBJ1-2
TGTGCCTGGTTCTATCAGGGACAGGCCAGGCGCACAGATACGCAGTATTTT	CAWFYQGQARRTDTQYF	TRBV30	TRBJ2-3
TGCAGTGCACCCCTATCGAAGGGCTCCTACGAGCAGTACTTC	CSAPLSKGSYEQYF	TRBV20-1	TRBJ2-7
TGTGCCAGCAATACAGGGTATCCTCGGACGGGATCCTCTGGAAACACCATATATTTT	CASNTGYPRTGSSGNTIYF	TRBV5-5	TRBJ1-3
TGTGCCTGGAGTGTACCCCAGCTGGGAGCCCGCTACGAGCAGTACTTC	CAWSVPQLGARYEQYF	TRBV30	TRBJ2-7
TGTGCCAGCAGCTTGGCGGTGACAGGGCCAAGCAATCAGCCCCAGCATTTT	CASSLAVTGPSNQPQHF	TRBV5-6	TRBJ1-5
TGTGCCACCAGTGATTCATTTTTACCCCTTCTGGATAACTATGGCTACACCTTC	CATSDSFLPLLDNYGYTF	TRBV24-1	TRBJ1-2
TGCAGTGCTGGTCGGGGCCCCACCAATGAGCAGTTCTTC	CSAGRGPTNEQFF	TRBV20-1	TRBJ2-1
TGTGCCAGCAGCAGCGAAGGGGGCCTCAATGAGCAGTTCTTC	CASSSEGGLNEQFF	TRBV9	TRBJ2-1
TGCGCCAGCAGCCAAGAGGGAGACAGGGAATGCAATCAGCCCCAGCATTTT	CASSQEGDRECNQPQHF	TRBV4-3	TRBJ1-5
TGTGCCAGCAGCGTTCCAGGGGGCCCTCGTGGAAACACCATATATTTT	CASSVPGGPRGNTIYF	TRBV5-8	TRBJ1-3
TGTGCCAGCAGCCAAGACCTTGACAGGCAAGGCACTGAAGCTTTCTTT	CASSQDLDRQGTEAFF	TRBV14	TRBJ1-1
TGTGCCAGCAGTTCCCGGGCCCGAGATACGCAGTATTTT	CASSSRARDTQYF	TRBV27	TRBJ2-3
TGTGCCAGCAGTGACTCAGAAGGGACTAGCGGGTCGATGACCTACGAGCAGTACTTC	CASSDSEGTSGSMTYEQYF	TRBV6-4	TRBJ2-7
TGTGCTAGTGGTTGGCCAGGGGGGGCGTCCCTTGAGCAGTACTTC	CASGWPGGASLEQYF	TRBV12-5	TRBJ2-7
TGCAGCGTTGACCAGGGAGGCTACACCTTC	CSVDQGGYTF	TRBV29-1	TRBJ1-2
TGTGCCTGGAGTGCAAATAAGAGGCCCGGATATAGCAATCAGCCCCAGCATTTT	CAWSANKRPGYSNQPQHF	TRBV30	TRBJ1-5
TGTGGCGATCGGTCCGTCAATTCAGCGTGTCAGCCCCAGCATTTT	CGDRSVNSACQPQHF	TRBV6-4	TRBJ1-5
TGCAGCGTTCTCCAAGCAGGGGGGGACTCCTACGAGCAGTACTTC	CSVLQAGGDSYEQYF	TRBV29-1	TRBJ2-7
TGTGCCAGCTCACCACGTGGGCTCGGCTACACCTTC	CASSPRGLGYTF	TRBV18	TRBJ1-2
TGTGCCAGCAGCTTGCTCTTCGGCTGTATGAACACTGAAGCTTTCTTT	CASSLLFGCMNTEAFF	TRBV5-6	TRBJ1-1
TGTGCCAGCAGAAGAGACAGGGTTCTTAGCAATCAGCCCCAGCATTTT	CASRRDRVLSNQPQHF	TRBV6-1	TRBJ1-5
TGTGCCAGCAGCTTAGAAGGAAACATGAGTGGCTACACCTTC	CASSLEGNMSGYTF	TRBV7-2	TRBJ1-2
TGCAGTGCTAGAGGGATAAACAGGGCAGTCACAGATACGCAGTATTTT	CSARGINRAVTDTQYF	TRBV20-1	TRBJ2-3
TGTGCCAGCAGCAATAGCGGGACAGGCACAGATACGCAGTATTTT	CASSNSGTGTDTQYF	TRBV5-8	TRBJ2-3
TGTGCCAGCACAGAGCAGTACTTC	CASTEQYF	TRBV11-3	TRBJ2-7
TGTGCCAGCAGTTCCCAAGGGGACGGACTAGCGGGCGGGTATTTT	CASSSQGDGLAGGYF	TRBV12-4	TRBJ2-3
TGTGCCAGCAGTTTATCAAGCGGTCCCCCCCACGAGGGGGCACAAGAGACCCAGTACTTC	CASSLSSGPPHEGAQETQYF	TRBV27	TRBJ2-5
TGTGCCAGCGAAAGTCCTGTAGCGGGCGGGGCCTACAATGAGCAGTTCTTC	CASESPVAGGAYNEQFF	TRBV6-4	TRBJ2-1
TGTGCCAGCAGCTTACCGGGACAGGGGAACTACGAGCAGTACTTC	CASSLPGQGNYEQYF	TRBV11-3	TRBJ2-7
TGTGCCAGCAGCCATGGAGGGCAGGGTACGGAAAAACTGTTTTTT	CASSHGGQGTEKLFF	TRBV5-5	TRBJ1-4
TGTGCCAGTGGTGGGTTATCTTTCAGGGGCGGGTTAGGATACACTGAAGCTTTCTTT	CASGGLSFRGGLGYTEAFF	TRBV19	TRBJ1-1
TGTGCCACCGAACGGGACAGGGACCCGGATCGCTCTGGAAACACCATATATTTT	CATERDRDPDRSGNTIYF	TRBV7-9	TRBJ1-3
TGTGCCAGCAGTGATGTAGGGACCAAAGCCAAAAACATTCAGTACTTC	CASSDVGTKAKNIQYF	TRBV6-1	TRBJ2-4
TGCGCCAGCAGGAGGCGAGAGGGGTTGGGCACCGGGGAGCTGTTTTTT	CASRRREGLGTGELFF	TRBV10-1	TRBJ2-2
TGCGCCAGCAGCCTAGTGGGACAGGGGACTGAAGCTTTCTTT	CASSLVGQGTEAFF	TRBV4-1	TRBJ1-1
TGTGCCAGCAGCTCCTTCGCCAGACAGGGTCGTAACATTCAGTACTTC	CASSSFARQGRNIQYF	TRBV7-3	TRBJ2-4
TGTGCCAGCAGCTCAATAAAACAGGACTCCTACAATGAGCAGTTCTTC	CASSSIKQDSYNEQFF	TRBV11-2	TRBJ2-1
TGTGCCACCAGTGATGGAGGGCCAGTGGATAGCAATCAGCCCCAGCATTTT	CATSDGGPVDSNQPQHF	TRBV24-1	TRBJ1-5
TGTGCCAGCAGCTTAACGCGGACAGGGGCCGAGACCCAGTACTTC	CASSLTRTGAETQYF	TRBV7-3	TRBJ2-5
TGTGCCACCAGTGATACGGGACTAGGTTTCCAAGAGACCCAGTACTTC	CATSDTGLGFQETQYF	TRBV24-1	TRBJ2-5
TGTGCCAGCCTAGTGACGTATACAGGGAACTACGAGCAGTACTTC	CASLVTYTGNYEQYF	TRBV7-9	TRBJ2-7
TGTGCCAGCAGCTCCCCAGGGCAAGGCCCCACTGAAGCTTTCTTT	CASSSPGQGPTEAFF	TRBV13	TRBJ1-1
TGTGCCAGCAGACGGGACACTGCTAACTATGGCTACACCTTC	CASRRDTANYGYTF	TRBV12-4	TRBJ1-2
TGTGCCAGCAGCAGGGGTGGAAAGGGGGGCTACGAGCAGTACTTC	CASSRGGKGGYEQYF	TRBV13	TRBJ2-7
TGTGCTCGCGGCTCTAACCAAGAGACCCAGTACTTC	CARGSNQETQYF	TRBV6-2	TRBJ2-5
TGTGCCAGCAGCTCTCTAACGGGGGGGCCCGGTTTTAGCTCGTCCCGCAATGAGCAGTTCTTC	CASSSLTGGPGFSSSRNEQFF	TRBV5-5	TRBJ2-1
TGTGCCAGCAGCTTAGAGAGACAGAGCAATAGCAATCAGCCCCAGCATTTT	CASSLERQSNSNQPQHF	TRBV11-2	TRBJ1-5
TGTGCCAGCAGCCTTTGGGGGGCTGGGACCCAGTACTTC	CASSLWGAGTQYF	TRBV7-2	TRBJ2-5
TGTGCTAGTGGTGCTACGGGACAGTACGAGCAGTACTTC	CASGATGQYEQYF	TRBV12-5	TRBJ2-7
TGTGCCAGCAGCCCGGACAGAAAAAATGAGCAGTTCTTC	CASSPDRKNEQFF	TRBV7-9	TRBJ2-1
TGTGCCAGCAGTGTACGGACGACAGGGGCGAAAGAGACCCAGTACTTC	CASSVRTTGAKETQYF	TRBV6-1	TRBJ2-5
TGTGCCAGCCCGATAAGGGTTGAGGGTTGCTACGAGCAGTACTTC	CASPIRVEGCYEQYF	TRBV6-1	TRBJ2-7
TGTGCCAGCAGTGACCCAACGGAGGAATCCTCCTATAATTCACCCCTCCACTTT	CASSDPTEESSYNSPLHF	TRBV6-4	TRBJ1-6
TGCGCCAGCAGCCCCGCCGACGCGAGGCAAGAGACCCAGTACTTC	CASSPADARQETQYF	TRBV5-1	TRBJ2-5
TGTGCCAGCAGCCCGGACAGGGAGGGACTGAGGTCTAGCACAGATACGCAGTATTTT	CASSPDREGLRSSTDTQYF	TRBV3-1	TRBJ2-3
TGTGCCAGCAGCTTGGTGTTGGCGGACAGGGGGACTGAAGCTTTCTTT	CASSLVLADRGTEAFF	TRBV5-4	TRBJ1-1
TGTGCCAGCAGTTACGCAGGGAGGTATGAAGCTTTCTTT	CASSYAGRYEAFF	TRBV6-2	TRBJ1-1
TGCAGTGCCGAAAGAAGCAAAGAGTCCCGGACAGGGGATCTGGGTCAGAGCAATCAGCCCCAGCATTTT	CSAERSKESRTGDLGQSNQPQHF	TRBV20-1	TRBJ1-5
TGTGCCAGCAGCCTGGATGGGACACGGGAAAACATTCAGTACTTC	CASSLDGTRENIQYF	TRBV27	TRBJ2-4
TGTGCCAGCAGCAATGGCCGGGACAGGGGGCGGTGTGAAAAACTGTTTTTT	CASSNGRDRGRCEKLFF	TRBV13	TRBJ1-4
TGTGCCAGCAGTGACTGCCGGACCGAGCAGTACTTC	CASSDCRTEQYF	TRBV6-4	TRBJ2-7
TGTGCCAGCAGCTATATCATGGCGGGAGTCGGGGGACAAGAGACCCAGTACTTC	CASSYIMAGVGGQETQYF	TRBV11-2	TRBJ2-5
TGTGCCAGCCCAGGGGGGTTGAACACTGAAGCTTTCTTT	CASPGGLNTEAFF	TRBV2	TRBJ1-1
TGTGCCAGCAGCCCAGGCCGGGACATGAGTGAGCAGTTCTTC	CASSPGRDMSEQFF	TRBV5-5	TRBJ2-1
TGTGCCAGCAGCGCCCCCCAACAGGGGCATGAAGCTTTCTTT	CASSAPQQGHEAFF	TRBV9	TRBJ1-1
TGCAGCGTGGGAGCTTTAAATGAGCAGTTCTTC	CSVGALNEQFF	TRBV29-1	TRBJ2-1
TGTGCCAGTAGTAGTTTAGCGAGGAGCCACAGGGGGAAGGGGCCCCCCGGGGAGAGAGAGACCCAGTACTTC	CASSSLARSHRGKGPPGERETQYF	TRBV19	TRBJ2-5
TGTGCCAGCAGCTGGAACAGCTACGAGCAGTACTTC	CASSWNSYEQYF	TRBV7-9	TRBJ2-7
TGTGCCAGCAGTTACACCAAAGGGCAAGCCAATGAAAAACTGTTTTTT	CASSYTKGQANEKLFF	TRBV6-5	TRBJ1-4
TGTGCCAGCAGCTTAGGGAACCCCTGGGGCTGCGGCAATCAGCCCCAGCATTTT	CASSLGNPWGCGNQPQHF	TRBV7-2	TRBJ1-5
TGTGCCAGCAGCCCACTTCAGGTAAGTCCCTACGAGCAGTACTTC	CASSPLQVSPYEQYF	TRBV13	TRBJ2-7
TGTGCCAGGGCAGGGGGCTCCCTAAATCAGCCCCAGCATTTT	CARAGGSLNQPQHF	TRBV19	TRBJ1-5
TGCGCCAGCAGCTTACCCGGGTCGGGAGCGCATGACTCCTACAATGAGCAGTTCTTC	CASSLPGSGAHDSYNEQFF	TRBV5-1	TRBJ2-1
TGTGCCTGGAGCCCGGAAGCCGGACAGGTCACTGAAGCTTTCTTT	CAWSPEAGQVTEAFF	TRBV30	TRBJ1-1
TGTGCCAGCAGCCCCGGGACAGGGACCGGGGAGCTGTTTTTT	CASSPGTGTGELFF	TRBV7-3	TRBJ2-2
TGTGCCTGGAGTGTATCGTTGAGTAGGGACACGAATGAGCAGTTCTTC	CAWSVSLSRDTNEQFF	TRBV30	TRBJ2-1
TGTGCCAGCAGCGAAGAACGGACAGGGGGGGATTATAATTCACCCCTCCACTTT	CASSEERTGGDYNSPLHF	TRBV5-5	TRBJ1-6
TGTGCCGAACGGACAGGGGACACCGGGGAGCTGTTTTTT	CAERTGDTGELFF	TRBV24-1	TRBJ2-2
TGTGCCAGCAGCGACAATCTAGCGGGTGGGACAGATACGCAGTATTTT	CASSDNLAGGTDTQYF	TRBV13	TRBJ2-3
TGTGCCAGCACCCTAGTAGATACGCAGTATTTT	CASTLVDTQYF	TRBV27	TRBJ2-3
TGTGCCACCAGCCCTACGTTTAACGTCACTGAAGCTTTCTTT	CATSPTFNVTEAFF	TRBV24-1	TRBJ1-1
TGCAGCGGGCGCCGAAGAAGACAGGGGAACAATCAGCCCCAGCATTTT	CSGRRRRQGNNQPQHF	TRBV29-1	TRBJ1-5
TGTGCCAGCAGAGCTCTAGCGGGTAAACCAAACACCGGGGAGCTGTTTTTT	CASRALAGKPNTGELFF	TRBV6-4	TRBJ2-2
TGCGCCAGCACGGGGACGACAGGGAGATCACCCAATCAGCCCCAGCATTTT	CASTGTTGRSPNQPQHF	TRBV10-1	TRBJ1-5
TGTGCCAGCAGTCCCGTCGAGGACTATGGCTACACCTTC	CASSPVEDYGYTF	TRBV27	TRBJ1-2
TGTGCCAGCAGCCTGGGGACAGGGGGCCACTATGGCTACACCTTC	CASSLGTGGHYGYTF	TRBV6-1	TRBJ1-2
