TGTGCCAGCAGCGGGACAGGGCGGTCTGAAGCTTTCTTT	CASSGTGRSEAFF	TRBV4-2	TRBJ1-1
TGCGCCAGCAGTGACTACCTCAGGGGGCAGCCCCAGCATTTT	CASSDYLRGQPQHF	TRBV10-1	TRBJ1-5
TGCAGTGCTAGAGAAGGTGATCCTAGACAACCCCAGTCACCCCTCCACTTT	CSAREGDPRQPQSPLHF	TRBV20-1	TRBJ1-6
TGCAGTGCTAGAGATACCACTTCCCAGGGAGGGCCGGAAGCTGAAGCTTTCTTT	CSARDTTSQGGPEAEAFF	TRBV20-1	TRBJ1-1
TGTGCCAGCAAACGAGTGCAGGCTGGAAACACCATATATTTT	CASKRVQAGNTIYF	TRBV27	TRBJ1-3
TGTGCCAGCAGGTCGGTCCAGGGGTACAATCAGCCCCAGCATTTT	CASRSVQGYNQPQHF	TRBV6-4	TRBJ1-5
TGTGCCAGTTTGAAAAGGGCCCTGTACAATGAGCAGTTCTTC	CASLKRALYNEQFF	TRBV12-4	TRBJ2-1
TGTGCCAGCAGTTTATCGTCCTCCGGGAGCTGGGATTCTGGGGCCAACGTCCTGACTTTC	CASSLSSSGSWDSGANVLTF	TRBV27	TRBJ2-6
TGCAGTGCTAGACCGAAAGGACCCGGATCACGGAAGGACGAGCAGTACTTC	CSARPKGPGSRKDEQYF	TRBV20-1	TRBJ2-7
TGCAGCTGGGGGAGCGACGAGCAGTACTTC	CSWGSDEQYF	TRBV29-1	TRBJ2-7
TGTGCCACCAGCAGATTTTTATTTTCACGCTCGAAAGACCCTCCGTCCAACACTGAAGCTTTCTTT	CATSRFLFSRSKDPPSNTEAFF	TRBV15	TRBJ1-1
TGCAGCGTTCGGCCCCGAGGGAATAGCAAACTGTTTTTT	CSVRPRGNSKLFF	TRBV29-1	TRBJ1-4
TGTGCCAGCAGTGACTCACTAAAGCTTTACAATGAGCAGTTCTTC	CASSDSLKLYNEQFF	TRBV6-4	TRBJ2-1
TGTGCCGGGGGGGGCGGGGCTAATGAGCAGTTCTTC	CAGGGGANEQFF	TRBV6-1	TRBJ2-1
TGTGGGACACGGGCCGGAACTTATGGCTACACCTTC	CGTRAGTYGYTF	TRBV7-9	TRBJ1-2
TGCAGGGTGCAGGGCTATGGCTACACCTTC	CRVQGYGYTF	TRBV20-1	TRBJ1-2
TGTGCCAGCTCACCACCGCAGGGGGACAGGACGAGCAATCAGCCCCAGCATTTT	CASSPPQGDRTSNQPQHF	TRBV18	TRBJ1-5
TGTGCCAGCAGCGATGTGGGGTTGAATTCACCCCTCCACTTT	CASSDVGLNSPLHF	TRBV5-4	TRBJ1-6
TGCGCCAGCAGCTTGGCGTGGGGCCGACGCTCCTACAATGAGCAGTTCTTC	CASSLAWGRRSYNEQFF	TRBV5-1	TRBJ2-1
TGCAGTGCTAGCCGAGGGGACACCAAGAACACTGAAGCTTTCTTT	CSASRGDTKNTEAFF	TRBV20-1	TRBJ1-1
TGTGCCAGCAGCCTTCCCACAGGGGGGTCCTACAATGAGCAGTTCTTC	CASSLPTGGSYNEQFF	TRBV9	TRBJ2-1
TGTGCCAGCAGCCTTCCGGTACCCCCTAACTATGGCTACACCTTC	CASSLPVPPNYGYTF	TRBV11-2	TRBJ1-2
TGCGCCGGGGGTAAAGGAAACACCATATATTTT	CAGGKGNTIYF	TRBV10-1	TRBJ1-3
TGTGCCATAAACAGGGGAACGGAAAAACTGTTTTTT	CAINRGTEKLFF	TRBV6-8	TRBJ1-4
TGTGCCACCAGGGCAGGGACAGTAAACACTGAAGCTTTCTTT	CATRAGTVNTEAFF	TRBV24-1	TRBJ1-1
TGCACATGGGGGGGCGCCTACGAGCAGTACTTC	CTWGGAYEQYF	TRBV29-1	TRBJ2-7
TGCAGTGCTAGTCACGAGCAGTACTTC	CSASHEQYF	TRBV20-1	TRBJ2-7
TGTGCCAGCAGCTTGGGGGGGGCGATGGGGTGCTTCCCCTACGAGCAGTACTTC	CASSLGGAMGCFPYEQYF	TRBV7-8	TRBJ2-7
TGTGCCAGCATTCCCTTTCCGACCTTAAGGACCCAGTACTTC	CASIPFPTLRTQYF	TRBV6-5	TRBJ2-4
TGTGCCAGCAGTGACGCTCTGGCCCAGACTAAACCTGAGACCCAGTACTTC	CASSDALAQTKPETQYF	TRBV25-1	TRBJ2-5
TGTGCCTGGCTCGGGCTCAACACTGAAGCTTTCTTT	CAWLGLNTEAFF	TRBV30	TRBJ1-1
TGTGCCAGCAGTAGGGACAGGGTATCCTCCTACGAGCAGTACTTC	CASSRDRVSSYEQYF	TRBV28	TRBJ2-7
TGTGCCAGCTCATTCCCAGCCAGCACTGGGGCCAACGTCCTGACTTTC	CASSFPASTGANVLTF	TRBV18	TRBJ2-6
TGTGCCATGGGGGGTCGTCGAGAGACCCAGTACTTC	CAMGGRRETQYF	TRBV6-4	TRBJ2-5
TGCGCCAGCAGTGCCAGTAGACATGAGCAGTTCTTC	CASSASRHEQFF	TRBV10-1	TRBJ2-1
TGTGCCAGCAGCTTCCCCATGCTCCATTCCCGGGGGGAGACTGAAGCTTTCTTT	CASSFPMLHSRGETEAFF	TRBV5-5	TRBJ1-1
TGTGCCAGCAGTGGTACAGGGGGCAAAGATAGCAATCAGCCCCAGCATTTT	CASSGTGGKDSNQPQHF	TRBV6-5	TRBJ1-5
TGTGCCAGCAGTGGCCCAGGGGGCCGGAATGAGCAGTTCTTC	CASSGPGGRNEQFF	TRBV12-3	TRBJ2-1
TGTGCCAGCAGACGGGACAGATTCGGCTATGGCTACACCTTC	CASRRDRFGYGYTF	TRBV7-9	TRBJ1-2
TGTGCCAGTAAGGGTGACAGGAACTATGGCTACACCTTC	CASKGDRNYGYTF	TRBV19	TRBJ1-2
TGTGCCAGCAGCCCTCCTACAAGCCCCACCCCTTTGGGGTACGAGCAGTACTTC	CASSPPTSPTPLGYEQYF	TRBV7-4	TRBJ2-7
TGTGCCAGCAGCTTGGCGAGGGGGTACGAGCAGTACTTC	CASSLARGYEQYF	TRBV5-6	TRBJ2-7
TGTGCCAGCAGAGGACCCGGCATTCAGTACTTC	CASRGPGIQYF	TRBV11-2	TRBJ2-4
TGTGCCAGCAGCCTGGGGGCGGCAGTAGACTACGAGCAGTACTTC	CASSLGAAVDYEQYF	TRBV6-4	TRBJ2-7
TGTGCCAGCAGCCGAGCACGATCCTATGGCTACACCTTC	CASSRARSYGYTF	TRBV13	TRBJ1-2
TGTGCCAGCAGCGGGGTCTCCCTAGGGCGCAACTTAGCAGACAATGAGCAGTTCTTC	CASSGVSLGRNLADNEQFF	TRBV5-4	TRBJ2-1
TGCGCCAGCAGCTTGAGGCGAGGGGGCCGAGTGGGGTCTGGAGCCTACGAGCAGTACTTC	CASSLRRGGRVGSGAYEQYF	TRBV5-1	TRBJ2-7
TGTGCCACCAGTGACCGACAGAGGGGGTATGGCTACACCTTC	CATSDRQRGYGYTF	TRBV24-1	TRBJ1-2
TGCGCCAGCAGCCAAGAGACTAGCGCCTACGAGCAGTACTTC	CASSQETSAYEQYF	TRBV4-1	TRBJ2-7
TGTGCCAGCGATACTTACAATGAGCAGTTCTTC	CASDTYNEQFF	TRBV7-3	TRBJ2-1
TGCGCCAGCAGCCCAAGGACAGGGGGCAACACTGAAGCTTTCTTT	CASSPRTGGNTEAFF	TRBV4-1	TRBJ1-1
TGTGCCACCATGGGGAGTTGGGGTATAAACTATGGCTACACCTTC	CATMGSWGINYGYTF	TRBV24-1	TRBJ1-2
TGCGCCAGCAGCTACCGGGACAGTGTGAGAGCTAACTATGGCTACACCTTC	CASSYRDSVRANYGYTF	TRBV5-1	TRBJ1-2
TGCAGTGCAGGACAGGGGGGGATAGAGGGCTACACCTTC	CSAGQGGIEGYTF	TRBV20-1	TRBJ1-2
TGTGCCAGCAGTGAAAGCCAGGGCCTGAACACTGAAGCTTTCTTT	CASSESQGLNTEAFF	TRBV2	TRBJ1-1
TGCGCCAGCAGCCATCACCGCGGGCGCCTCCTGAGCTCCTACGAGCAGTACTTC	CASSHHRGRLLSSYEQYF	TRBV4-1	TRBJ2-7
TGTGCCAGCAGCGAGGGAGGGGCCGGTCAGAACGAGACTAATGAAAAACTGTTTTTT	CASSEGGAGQNETNEKLFF	TRBV6-3	TRBJ1-4
TGTGCCAGCAGCTCCCAAAAATGTAGGGGGTTTGAGACCCAGTACTTC	CASSSQKCRGFETQYF	TRBV13	TRBJ2-5
TGTGCCAGCAGGGGGAACACCGGGGAGCTGTTTTTT	CASRGNTGELFF	TRBV28	TRBJ2-2
TGCAGTGCTAGAGGACAGGGGGCCGAGGAGGGGTACCAAGAGACCCAGTACTTC	CSARGQGAEEGYQETQYF	TRBV20-1	TRBJ2-5
TGTGCCACCAGCCACTCAGGTGAAGGATCAGCCAAAAACATTCAGTACTTC	CATSHSGEGSAKNIQYF	TRBV15	TRBJ2-4
TGTGGGGAGCGGAAGGGGATCACTGAAGCTTTCTTT	CGERKGITEAFF	TRBV7-9	TRBJ1-1
TGCGCCAGCAGCCTACGGAGCGGGAGGGGGGATCAGCCCCAGCATTTT	CASSLRSGRGDQPQHF	TRBV4-1	TRBJ1-5
TGTGCCAGCAGTGACACCGTTCCCTTCTGCTACGAGCAGTACTTC	CASSDTVPFCYEQYF	TRBV6-4	TRBJ2-7
TGTGCCAGCAGCTTATTCTCCGGGACACCCATTAACACCGGGGAGCTGTTTTTT	CASSLFSGTPINTGELFF	TRBV11-3	TRBJ2-2
TGTGCTAGTGGTTATCCAGACACTACTGAAGCTTTCTTT	CASGYPDTTEAFF	TRBV12-5	TRBJ1-1
TGTGCCAGCAGCTTAGTCTGGACCAACGTGAGGGGTCGGAAGAACACAGATACGCAGTATTTT	CASSLVWTNVRGRKNTDTQYF	TRBV7-6	TRBJ2-3
TGTGCCAGCAGACGCCGGGCTAGTAAGCAGCCCCAGCATTTT	CASRRRASKQPQHF	TRBV27	TRBJ1-5
TGTGCCAGACGCAGGGACCTGATGAACACTGAAGCTTTCTTT	CARRRDLMNTEAFF	TRBV6-2	TRBJ1-1
TGTGCCAGCAGCCCGCTAGCGGGAGAAGAGACCCAGTACTTC	CASSPLAGEETQYF	TRBV7-2	TRBJ2-5
TGTGCCAGCAGCTTTTTAGTAGCAGGGGGGTCTAACTATGGCTACACCTTC	CASSFLVAGGSNYGYTF	TRBV5-6	TRBJ1-2
TGTGCCAGCAGCTTAGCGAGCAAGGACGAGTATACTCCCCTCCACTTT	CASSLASKDEYTPLHF	TRBV11-2	TRBJ1-6
TGTGCCAGCAGCGTAGGGGTTTCTGTGAACACCGGGGAGCTGTTTTTT	CASSVGVSVNTGELFF	TRBV9	TRBJ2-2
TGTGCCTCTAGCGGGTATGAGCAGTTCTTC	CASSGYEQFF	TRBV7-3	TRBJ2-1
TGTGCCAGCGCACAGGGGATAATCGCAGATACGCAGTATTTT	CASAQGIIADTQYF	TRBV5-6	TRBJ2-3
TGTGCCAGCAGAAGAGCGGGAGAAGAGACCCAGTACTTC	CASRRAGEETQYF	TRBV7-3	TRBJ2-5
TGCAGTGGAGGGGTCACTAGCGGGAGAAAGACGGTCTTC	CSGGVTSGRKTVF	TRBV20-1	TRBJ2-7
TGTGAGATTCCCCCGGTTGGCAAAGGGCTCTACGAGCAGTACTTC	CEIPPVGKGLYEQYF	TRBV6-2	TRBJ2-7
TGCGCCAGCAGCAGTGGGACAGGGTGTTGCACTGAAGCTTTCTTT	CASSSGTGCCTEAFF	TRBV10-1	TRBJ1-1
TGTGCCAGCAGCGACAGGGCTGAAGCTTTCTTT	CASSDRAEAFF	TRBV13	TRBJ1-1
TGTGCCAGCAGCATCGGGACAGGAAAAATTCACTATGGCTACACCTTC	CASSIGTGKIHYGYTF	TRBV13	TRBJ1-2
TGTGCCAGCAGCAGTCCTTCGACAGGGGCCCTAAGTGAAAAACTGTTTTTT	CASSSPSTGALSEKLFF	TRBV11-2	TRBJ1-4
TGTGCCACCAGTGATTTGAGACGAATTACGGGACAGGGGGCACCAGATGGCTACACCTTC	CATSDLRRITGQGAPDGYTF	TRBV24-1	TRBJ1-2
TGTGCCAGCAGTTTTGGCGTTGAGACCCAGTACTTC	CASSFGVETQYF	TRBV28	TRBJ2-5
TGCGCCAGCAGCTTCTGCGGGGAGCTTGGGTATGGCTACACCTTC	CASSFCGELGYGYTF	TRBV5-1	TRBJ1-2
TGTGCCAGCAGTGATCCAGAGGGGGCTGGCTATGGCTACACCTTC	CASSDPEGAGYGYTF	TRBV6-1	TRBJ1-2
TGTGAGGCCCGGGACAGGGCTGAAGCTTTCTTT	CEARDRAEAFF	TRBV3-1	TRBJ1-1
TGTGCCAGCAGCTTAGTGGCCCGGCCAGAGACCCAGTACTTC	CASSLVARPETQYF	TRBV13	TRBJ2-5
TGTGCCAGCACCACGCCGGGACCTTATGGTGAGCGGGGGTTCGAGCAGTACTTC	CASTTPGPYGERGFEQYF	TRBV2	TRBJ2-7
TGTGCCATAAAGACAGGGGGCCGGTTCGGCTACACCTTC	CAIKTGGRFGYTF	TRBV7-3	TRBJ1-2
TGTGCCAGCAGTTACGTCCACCGCTATGGCTACACCTTC	CASSYVHRYGYTF	TRBV6-5	TRBJ1-2
TGTGCCAGCAGCTCCTACAGCTGGGGACAGAACACCGGGGAGCTGTTTTTT	CASSSYSWGQNTGELFF	TRBV13	TRBJ2-2
TGTGCCAGCAGCCGGTCTAAGAACCAAGAGACCCAGTACTTC	CASSRSKNQETQYF	TRBV7-6	TRBJ2-5
TGCAGGGACAGAAGGTCTGAAGCTTTCTTT	CRDRRSEAFF	TRBV20-1	TRBJ1-1
TGTGCCGGAAAGTGGACAGGGGCAAGTTGGAATGAAGCTTTCTTT	CAGKWTGASWNEAFF	TRBV30	TRBJ1-1
TGTGCCAGCAGCAGGGGGGGCTACAATGAGCAGTTCTTC	CASSRGGYNEQFF	TRBV11-1	TRBJ2-1
TGTGCCAGCAGCGAAAAAGGGATGCCAGAGACAGATACGCAGTATTTT	CASSEKGMPETDTQYF	TRBV9	TRBJ2-3
TGTGCCAGCAGCGAAGACGCCTCCTACGAGCAGTACTTC	CASSEDASYEQYF	TRBV11-2	TRBJ2-7
TGTGCCAGCAGTTTAATTCGGACAGGGCAGAATGATGGCTACACCTTC	CASSLIRTGQNDGYTF	TRBV27	TRBJ1-2
TGTGCCAGCAGCGTGTACGGGACGGGCTATGGCTACACCTTC	CASSVYGTGYGYTF	TRBV9	TRBJ1-2
TGCAGTGATGAATACTATGGCTACACCTTC	CSDEYYGYTF	TRBV20-1	TRBJ1-2
TGTGCCAGCAGTTTGCACGAGCCTGTTAAGGTCTACAATGAGCAGTTCTTC	CASSLHEPVKVYNEQFF	TRBV28	TRBJ2-1
TGTGCCAGCATGCAGGGACCGCGAAAGAGAAACTACGAGCAGTACTTC	CASMQGPRKRNYEQYF	TRBV7-3	TRBJ2-7
TGTGCCAGCAGTTTAGGAGATCCTGAGCAGTTCTTC	CASSLGDPEQFF	TRBV28	TRBJ2-1
TGTGCCACCAGTGATTTCTCAGGGGACTACGAGCAGTACTTC	CATSDFSGDYEQYF	TRBV24-1	TRBJ2-7
TGTGCCAGCAGCTACGGTCAGGGGACTGAAGCTTTCTTT	CASSYGQGTEAFF	TRBV13	TRBJ1-1
TGTGCCACCAGCAGGTTTCTAGCTGGGACAACTAATGAAAAACTGTTTTTT	CATSRFLAGTTNEKLFF	TRBV15	TRBJ1-4
TGTGCCACCAGTGATTTAGGGCGTAGACACACCATATATTTT	CATSDLGRRHTIYF	TRBV24-1	TRBJ1-3
TGTGCCAGCAGCTTACCCCGGGACAGGCTTGGCTACGAGCAGTACTTC	CASSLPRDRLGYEQYF	TRBV7-4	TRBJ2-7
TGTGCCAGCAGTTTATCCTCCCAACGGGAGGGGCCACGTGAAAAACTGTTTTTT	CASSLSSQREGPREKLFF	TRBV28	TRBJ1-4
TGTGCCATCACCCTGACTAGGACCCAAGAGACCCAGTACTTC	CAITLTRTQETQYF	TRBV10-3	TRBJ2-5
TGTGCCAGCAGCCGTTGCCGGGCAGGGGGGGGGCATTTT	CASSRCRAGGGHF	TRBV4-2	TRBJ1-5
TGTGCCAGCAACCCCCCGGACACTGAAGCTTTCTTT	CASNPPDTEAFF	TRBV27	TRBJ1-1
TGTGCCAGCAGCCAAGAAGGGGGATGCGACTATGGCTACACCTTC	CASSQEGGCDYGYTF	TRBV4-2	TRBJ1-2
TGTGCCAGCAGTTGTTTACCCGGGACTAGCGGGGGGGCTTTTCGACCCAGAGATACGCAGTATTTT	CASSCLPGTSGGAFRPRDTQYF	TRBV2	TRBJ2-3
TGCAGCGTCCGGGACAGTGCGACTGAAGCTTTCTTT	CSVRDSATEAFF	TRBV29-1	TRBJ1-1
TGTGCCACCAGTGATTTGTCCAACGGGGGGACACACCTGAGACCAACTGAAGCTTTCTTT	CATSDLSNGGTHLRPTEAFF	TRBV24-1	TRBJ1-1
TGTGCCAGCTCACCAGGGGGCAATAACAATGAGCAGTTCTTC	CASSPGGNNNEQFF	TRBV18	TRBJ2-1
TGTGCCAGCAGCTGCAGTGGACTATGGGTGTACCAAGAGACCCAGTACTTC	CASSCSGLWVYQETQYF	TRBV7-8	TRBJ2-5
TGTGCCACCAGTGATTCACAAGAAAGGAGAGGCTTCGGGGGCACTGAAAAACTGTTTTTT	CATSDSQERRGFGGTEKLFF	TRBV24-1	TRBJ1-4
TGCGCCAGCAGCCACCTAGCGGGGACCTACAATGAGCAGTTCTTC	CASSHLAGTYNEQFF	TRBV4-3	TRBJ2-1
TGCAGTGCTAGTGGAAGACTAGCGGGGGTACAAGAGACCCAGTACTTC	CSASGRLAGVQETQYF	TRBV20-1	TRBJ2-5
TGTGCCAGCAGATCCGAGGACGAGCAGTACTTC	CASRSEDEQYF	TRBV6-5	TRBJ2-7
TGCGCCAGCAGTCAGGATGCCCCGAACACTGAAGCTTTCTTT	CASSQDAPNTEAFF	TRBV10-2	TRBJ1-1
TGTGCCAGCAGCCCTGTTCAATGGGGTGGTTCACCCCTCCACTTT	CASSPVQWGGSPLHF	TRBV13	TRBJ1-6
TGTGCCAGCAGCCCAGGGACAGGGTCAGGAAACACGAACACCGGGGAGCTGTTTTTT	CASSPGTGSGNTNTGELFF	TRBV13	TRBJ2-2
TGCAGTGCTGCGCGCCTGGGAGCCTACGAGCAGTACTTC	CSAARLGAYEQYF	TRBV20-1	TRBJ2-7
TGTGCCATTGACAGGGGGAGAAGCCAGCCCCAGCATTTT	CAIDRGRSQPQHF	TRBV6-4	TRBJ1-5
TGTGCCAGCAGCTTACCTAGCGGGTACAATGAGCAGTTCTTC	CASSLPSGYNEQFF	TRBV7-2	TRBJ2-1
TGTGCCAGCAGCTTGGCCCCCGCCCGTGAATACGATTCACCCCTCCACTTT	CASSLAPAREYDSPLHF	TRBV5-6	TRBJ1-6
TGTGCCAGCAGCCAAGCTTCTGGCGGTCGGGCGAACACCGGGGAGCTGTTTTTT	CASSQASGGRANTGELFF	TRBV3-1	TRBJ2-2
TGTGCCAGCAGCCAAGATTGTCAGAGAACCTCCTACGAGCAGTACTTC	CASSQDCQRTSYEQYF	TRBV4-2	TRBJ2-7
TGCGCCAGCAGCTTGGGAGGTCATGGGGATTCACCCCTCCACTTT	CASSLGGHGDSPLHF	TRBV5-1	TRBJ1-6
TGTGCCTGGAGTGGGCCCAAAGACAGGGATCAGCCCCAGCATTTT	CAWSGPKDRDQPQHF	TRBV30	TRBJ1-5
TGTGCTAGTGGTAGACCCATCTTACCGTACGAGCAGTACTTC	CASGRPILPYEQYF	TRBV12-5	TRBJ2-7
TGTGCCAGCAGGGGAAATCCTAACTATGGCTACACCTTC	CASRGNPNYGYTF	TRBV7-6	TRBJ1-2
TGTGCCACCAGCAGAGGGAGCGGGAGGGCCGGGGAGCCCCAGCATTTT	CATSRGSGRAGEPQHF	TRBV15	TRBJ1-5
TGTGCCAGCAGCTGGACTAGCGTCTTCACCGGGGAGCTGTTTTTT	CASSWTSVFTGELFF	TRBV12-3	TRBJ2-2
TGTGCCAGCAGCCGGGGTAGTCGACAGGGCTCCTACGAGCAGTACTTC	CASSRGSRQGSYEQYF	TRBV7-7	TRBJ2-7
TGCGCCAGCAGCTTGGAGGGCCGACAGCCCCAGCATTTT	CASSLEGRQPQHF	TRBV5-1	TRBJ1-5
TGCGCCAGCAGCTTCGAAGGGGGGGGCACAGATACGCAGTATTTT	CASSFEGGGTDTQYF	TRBV5-1	TRBJ2-3
TGTGCCAGCAGCCCAGGGACACGCTACAATGAGCAGTTCTTC	CASSPGTRYNEQFF	TRBV9	TRBJ2-1
TGTGCCAGTAGTCAACTGCGCCGAGAGACCCAGTACTTC	CASSQLRRETQYF	TRBV19	TRBJ2-5
TGTGCCAGCAGCTTACCGGGACTTGTAGAAAGGGCCTACGAGCAGTACTTC	CASSLPGLVERAYEQYF	TRBV11-3	TRBJ2-7
TGTGCCAGGCCGATGACGCAGTATTTT	CARPMTQYF	TRBV6-3	TRBJ2-3
TGCAGTGCTTCCGGTCTATTGGGGGCCCGGTTAAGTGAAGCTTTCTTT	CSASGLLGARLSEAFF	TRBV20-1	TRBJ1-1
TGTGCCAGCAGTCGGCTACGAAACACCGGGGAGCTGTTTTTT	CASSRLRNTGELFF	TRBV28	TRBJ2-2
TGTGCCGAGGTGGCTTCGGGGGGGGTTCGTGATACGCAGTATTTT	CAEVASGGVRDTQYF	TRBV6-2	TRBJ2-3
TGCGCCAGCAGCTTCCTAGCAGACAGAGAGACCCAGTACTTC	CASSFLADRETQYF	TRBV5-1	TRBJ2-5
TGCAGTCGGGGCGGAGCTTTCTTT	CSRGGAFF	TRBV20-1	TRBJ1-1
TGTGCCAGCAGCTTCAATACTAGCGGGAGCTCCTACGAGCAGTACTTC	CASSFNTSGSSYEQYF	TRBV7-6	TRBJ2-7
TGTGCCAGCAGTTTCACTCGGCCTCAGGGGGCAGCAACTAATGAAAAACTGTTTTTT	CASSFTRPQGAATNEKLFF	TRBV27	TRBJ1-4
TGTGCCAGTGTTCCTAGCAATCAGCCCCAGCATTTT	CASVPSNQPQHF	TRBV27	TRBJ1-5
TGTGCCAGCAGCGGAAGGGGACAGGGACTGGGCCCAGGACAGCCCCAGCATTTT	CASSGRGQGLGPGQPQHF	TRBV7-4	TRBJ1-5
TGTGCCAGCAGCCCCAGAGATCAGCCCCAGCATTTT	CASSPRDQPQHF	TRBV14	TRBJ1-5
TGTGCCTGGAGTGTCCCCGTCGGGCGACAGACCCAGTACTTC	CAWSVPVGRQTQYF	TRBV30	TRBJ2-5
TGTGCCAGCAGCTCCACAGGGGTCAGCACAGATACGCAGTATTTT	CASSSTGVSTDTQYF	TRBV6-1	TRBJ2-3
TGTGCCATCAGTGAGTCGAACCACCGGGACCGGTATAGCAATCAGCCCCAGCATTTT	CAISESNHRDRYSNQPQHF	TRBV10-3	TRBJ1-5
TGTGCCAGCAGTCACTTCTCAGGGGGGGGTAATACTGAAGCTTTCTTT	CASSHFSGGGNTEAFF	TRBV27	TRBJ1-1
TGTGCCACGGGACTAGCGACGGACTCCTACAATGAGCAGTTCTTC	CATGLATDSYNEQFF	TRBV6-4	TRBJ2-1
TGTGGGGCCCTTAGGATATACAATGAGCAGTTCTTC	CGALRIYNEQFF	TRBV28	TRBJ2-1
TGTGCCAGCAGTTTATGCCGGGAGGGGATTTATGGCTACACCTTC	CASSLCREGIYGYTF	TRBV28	TRBJ1-2
TGCCTATACCCACTACTCCCCTACAATGAGCAGTTCTTC	CLYPLLPYNEQFF	TRBV10-1	TRBJ2-1
TGCAGTGCTAGAGATGGACCGAGCGGGAGCGGCTCTGAAGCTTTCTTT	CSARDGPSGSGSEAFF	TRBV20-1	TRBJ1-1
TGTGCCAGCAGTGTGGCGCTTAAGCCGACAGTTAAATATGGCTACACCTTC	CASSVALKPTVKYGYTF	TRBV6-1	TRBJ1-2
TGTGCCCCACTAGCGGGAGGAGGGTACCCCCACACCGGGGAGCTGTTTTTT	CAPLAGGGYPHTGELFF	TRBV27	TRBJ2-2
TGTGCCATAGCGGGGGTGGGGACGCAGTATTTT	CAIAGVGTQYF	TRBV6-5	TRBJ2-3
TGCGCCAGCATTCAAAAGCGGGAGGTCTCAGATACGCAGTATTTT	CASIQKREVSDTQYF	TRBV10-2	TRBJ2-3
TGTGCCAGTAGTATGTTGCCCGGGACAGGGTTGGGGTACAACCCAAATGAAAAACTGTTTTTT	CASSMLPGTGLGYNPNEKLFF	TRBV19	TRBJ1-4
TGCGCCAGCAGCTTGCGGCCGGGACACAGGGGTCGGTGTACTCCCGACTGCAATCAGCCCCAGCATTTT	CASSLRPGHRGRCTPDCNQPQHF	TRBV5-1	TRBJ1-5
TGCAGTGCGATTGGACATGGGAGCTCTGGGGCCAACGTCCTGACTTTC	CSAIGHGSSGANVLTF	TRBV20-1	TRBJ2-6
TGTGCCAGTAGGAATAGCGGGCTAGAGCAGTACTTC	CASRNSGLEQYF	TRBV6-5	TRBJ2-7
TGTGCCAGTAAGACTGGGGAAATCAGGGAGGGTCTTAACTATGGCTACACCTTC	CASKTGEIREGLNYGYTF	TRBV19	TRBJ1-2
TGCAGGAGCTGGGTCTTTCCCAATGAGCAGTTCTTC	CRSWVFPNEQFF	TRBV20-1	TRBJ2-1
TGTGCCAGCAGCAGGGGGGCAGGAAACATTCAGTACTTC	CASSRGAGNIQYF	TRBV7-2	TRBJ2-4
TGCGCCAGCAGCCAAGAAGCCAGGGAGTACTACGAGCAGTACTTC	CASSQEAREYYEQYF	TRBV4-3	TRBJ2-7
TGCGCCAGCAGCCAAGATAGGGACAGGGCGGATGATACGCAGTATTTT	CASSQDRDRADDTQYF	TRBV4-3	TRBJ2-3
TGCAGCGTTGAAGACTTCGACAGAGAGACCCAGTACTTC	CSVEDFDRETQYF	TRBV29-1	TRBJ2-5
TGCAGCGTCAGCTGGCAAGAGACCCAGTACTTC	CSVSWQETQYF	TRBV29-1	TRBJ2-5
TGTGCCAGCAGCTCCTCCCCGATCATGAACACTGAAGCTTTCTTT	CASSSSPIMNTEAFF	TRBV5-4	TRBJ1-1
TGTGCCAGCAGTTTAGCGCGTCCCTCTGGTAAATCCAGGGTTCCAGAGACCCAGTACTTC	CASSLARPSGKSRVPETQYF	TRBV12-3	TRBJ2-5
TGCGCCAGCAGCGAATGCGAACAGAACACTGAAGCTTTCTTT	CASSECEQNTEAFF	TRBV5-1	TRBJ1-1
TGTGCCAGCAGCGGAGGGGACAGGCCGGACTACACCTTC	CASSGGDRPDYTF	TRBV13	TRBJ1-2
TGTGCCAGGGGGGGGGACACAGATACGCAGTATTTT	CARGGDTDTQYF	TRBV6-6	TRBJ2-3
TGCGCCAGCAGCTCCCCGAGGGACAGGGGGTTAAGGGTCTACAATGAGCAGTTCTTC	CASSSPRDRGLRVYNEQFF	TRBV5-1	TRBJ2-1
TGTGCCAGCAGTGAATACGGGGCGGGTAGCACAGATACGCAGTATTTT	CASSEYGAGSTDTQYF	TRBV6-1	TRBJ2-3
TGTGCCAGCAGGAGAGGCAGAGGGGGGCACAGCACAGATACGCAGTATTTT	CASRRGRGGHSTDTQYF	TRBV11-3	TRBJ2-3
TGCGCCACCGTGGGACAGGGGCCAGATACGCAGTATTTT	CATVGQGPDTQYF	TRBV10-1	TRBJ2-3
TGTGCCATCATCCAAACAGGGGGTGCCTACGAGCAGTACTTC	CAIIQTGGAYEQYF	TRBV10-3	TRBJ2-7
TGTGCCAGCAGCGGCGCCGAGCAGTACTTC	CASSGAEQYF	TRBV9	TRBJ2-7
TGTGCCAGCAGTTGCCCCACCGGACAGGAGGTCGGAAACACCATATATTTT	CASSCPTGQEVGNTIYF	TRBV6-5	TRBJ1-3
TGCGCCAGCAGCTCCGGGACAGGGGGCTACGAGCAGTACTTC	CASSSGTGGYEQYF	TRBV5-1	TRBJ2-7
TGTGCCTGGAGTACCCGGGGGTCTACTGAAGCTTTCTTT	CAWSTRGSTEAFF	TRBV30	TRBJ1-1
TGTGCCAGCTCACCACTGGAGCGCTCCGGGACAGATGGGGCCAACGTCCTGACTTTC	CASSPLERSGTDGANVLTF	TRBV18	TRBJ2-6
TGTGCCAGCAGCGGCGGCAGGGGACTAGCGGGGCTCTCCTACGAGCAGTACTTC	CASSGGRGLAGLSYEQYF	TRBV9	TRBJ2-7
TGTGCCAGGGTGGACGAATATGGCTACACCTTC	CARVDEYGYTF	TRBV6-3	TRBJ1-2
TGTGCCAGCAGCCACCCTCATATTGAGACCCAGTACTTC	CASSHPHIETQYF	TRBV7-7	TRBJ2-5
TGCAGTGCTGCGGGAGATGGGGCCAACGTCCTGACTTTC	CSAAGDGANVLTF	TRBV20-1	TRBJ2-6
TGCGCCAGCAGCAATGAATCCAGAGGTAATGAAAAACTGTTTTTT	CASSNESRGNEKLFF	TRBV5-1	TRBJ1-4
TGTGCCAGCAGTTACAGTGGACGTGGCTCCTACGAGCAGTACTTC	CASSYSGRGSYEQYF	TRBV6-5	TRBJ2-7
TGTGCTTACCCCTGGAAAACCCCTGAGCAGTACTTC	CAYPWKTPEQYF	TRBV6-2	TRBJ2-7
TGTGCCACCAGCATTAACGACAATGAGCAGTTCTTC	CATSINDNEQFF	TRBV15	TRBJ2-1
TGTGAAAACCCCGGGACAGAGGTTCAGGAGACCCAGTACTTC	CENPGTEVQETQYF	TRBV5-4	TRBJ2-5
TGTGCCACCAGCAGAGCTATAATGGGGACTAGCGGAAGCCCGCAACACACAGATACGCAGTATTTT	CATSRAIMGTSGSPQHTDTQYF	TRBV15	TRBJ2-3
TGTGCCACCAGTGATTTGCAAGTTAACGACAGGGGGGGAGAGACCCAGTACTTC	CATSDLQVNDRGGETQYF	TRBV24-1	TRBJ2-5
TGTGCCAGCAGTTTATCCACCAGGGCGGAGAACACTGAAGCTTTCTTT	CASSLSTRAENTEAFF	TRBV12-3	TRBJ1-1
TGCGCCAGCAGCCCTTACACCTGGGAGGCAACTAATGAAAAACTGTTTTTT	CASSPYTWEATNEKLFF	TRBV4-3	TRBJ1-4
TGTGCCATCAGTGAGGGAAATTACACTGAAGCTTTCTTT	CAISEGNYTEAFF	TRBV10-3	TRBJ1-1
TGTGCCACCAACAGCCTCAAATTCGTCATAACCACAGAACCCCCCTACGAGCAGTACTTC	CATNSLKFVITTEPPYEQYF	TRBV24-1	TRBJ2-7
TGTGCCAGCAGCCAGGGACAGCCATCCAATCAGCCCCAGCATTTT	CASSQGQPSNQPQHF	TRBV9	TRBJ1-5
TGTGCCAGCAGCCATGAGGGGCTTTCCTATAATTCACCCCTCCACTTT	CASSHEGLSYNSPLHF	TRBV14	TRBJ1-6
TGTGCCAGCACGGCCCCGGGACGGCCTGCGTACAATGAGCAGTTCTTC	CASTAPGRPAYNEQFF	TRBV25-1	TRBJ2-1
TGTGCCACCAGTGATTTGCAGGGTTCTTCCCAGAGAGGGGGGGCAGAGACCCAGTACTTC	CATSDLQGSSQRGGAETQYF	TRBV24-1	TRBJ2-5
TGCGCCAGCAGCCAAGTTGGACCCCCGCACAGGGAAAAAGAGACCCAGTACTTC	CASSQVGPPHREKETQYF	TRBV4-1	TRBJ2-5
TGCAGCGTTGATCGGGGGACAGAAAAAGGTCAGCCCCAGCATTTT	CSVDRGTEKGQPQHF	TRBV29-1	TRBJ1-5
TGCGCCAGCGCAATGATCGAGAGTTCACATAGCAATCAGCCCCAGCATTTT	CASAMIESSHSNQPQHF	TRBV10-2	TRBJ1-5
TGCAGTGCTAGACGGGAGGGTTATCCATCCGAGCAGTTCTTC	CSARREGYPSEQFF	TRBV20-1	TRBJ2-1
TGTGCCACCAGTGAGAAAGACGTATCCCGGCTAGTTTTACAAAACATTCAGTACTTC	CATSEKDVSRLVLQNIQYF	TRBV24-1	TRBJ2-4
TGTGCCAGCAGCGCCGACAGGAGGGGTAGTCTCTTTCCCGAGACCCAGTACTTC	CASSADRRGSLFPETQYF	TRBV13	TRBJ2-5
TGCGCCAGCAGCTTGAATAATGACAGGGACTCCAACGTTGAGCAGTTCTTC	CASSLNNDRDSNVEQFF	TRBV5-1	TRBJ2-1
TGTGCCAGCAGCGGCCCGATCAGCCAGGGGGGGGTTGCCTACAATGAGCAGTTCTTC	CASSGPISQGGVAYNEQFF	TRBV7-9	TRBJ2-1
TGCAGTGCTATCAAGAGAGAAAAGGGAAACACCATATATTTT	CSAIKREKGNTIYF	TRBV20-1	TRBJ1-3
TGTGCCACCAGCAGAAAACTAGCGGGAGGCATGAACACCGGGGAGCTGTTTTTT	CATSRKLAGGMNTGELFF	TRBV15	TRBJ2-2
TGTGCCAGCAGCCCCCCAGGCCTCTCCAATGAGCAGTTCTTC	CASSPPGLSNEQFF	TRBV11-2	TRBJ2-1
TGTGCCAGCAGCGCGACCGGGACTAGCGGGAGAGTCTACGAGCAGTACTTC	CASSATGTSGRVYEQYF	TRBV11-3	TRBJ2-7
TGTGCCATCATGGCCGCCAGGGGGCAAAGGAGCAATCAGCCCCAGCATTTT	CAIMAARGQRSNQPQHF	TRBV10-3	TRBJ1-5
TGTGCCAGCAGTTTGTCCAGGCCTCCCGGACTAGGGTTTAACACCGGGGAGCTGTTTTTT	CASSLSRPPGLGFNTGELFF	TRBV28	TRBJ2-2
TGTGCCAGTAGTATTTTCGTGGGCTACACCTTC	CASSIFVGYTF	TRBV19	TRBJ1-2
TGCGCCAGCAGCCAAGACGATGTACGGACAGGTTCACCCCTCCACTTT	CASSQDDVRTGSPLHF	TRBV4-1	TRBJ1-6
TGCGCCAGCAACTCTCCACGGGTGACCTACGAGCAGTACTTC	CASNSPRVTYEQYF	TRBV10-1	TRBJ2-7
TGTGCCAGCAGCTTGGGACGGACAGGGGGTCCCTACAATGAGCAGTTCTTC	CASSLGRTGGPYNEQFF	TRBV5-5	TRBJ2-1
TGTGCCACCTTCACTGGTCGGACAGAGTACAATGAGCAGTTCTTC	CATFTGRTEYNEQFF	TRBV24-1	TRBJ2-1
TGTGCCAGCAGCTGGACATCCTATGGCTACACCTTC	CASSWTSYGYTF	TRBV11-3	TRBJ1-2
TGTGCCACCAGTGATTCCGGGACAGTGGGTACTGAAGCTTTCTTT	CATSDSGTVGTEAFF	TRBV24-1	TRBJ1-1
TGTGCTAGTGAGCTTGCAGAGAATCAGCCCCAGCATTTT	CASELAENQPQHF	TRBV12-5	TRBJ1-5
TGTGCCCCCGGGAGGGCCCTTTGGAGCAATCAGCCCCAGCATTTT	CAPGRALWSNQPQHF	TRBV12-3	TRBJ1-5
TGTGCCAGCAGGGGGCAGGCCGACACTGAAGCTTTCTTT	CASRGQADTEAFF	TRBV28	TRBJ1-1
TGTGCCAGCTCACCACAAAAGGGACTCTTCTACGAGCAGTACTTC	CASSPQKGLFYEQYF	TRBV18	TRBJ2-7
TGTGCCAGCATTCCCAGGGGGGGTGCGTACGAGCAGTACTTC	CASIPRGGAYEQYF	TRBV7-9	TRBJ2-7
TGTGCCAGCAGCGGGGGGCGCATACGCTACGAGCAGTACTTC	CASSGGRIRYEQYF	TRBV7-3	TRBJ2-7
TGCTTTAATCCACAGGGTGGGGAGAACACTGAAGCTTTCTTT	CFNPQGGENTEAFF	TRBV10-1	TRBJ1-1
TGTGCCAGCAGTGACCCCACGTACGACAGGGTGCGTTGCTCCTACGAGCAGTACTTC	CASSDPTYDRVRCSYEQYF	TRBV6-4	TRBJ2-7
TGTGCCAGTAGTAGGGAGTATGAATTCTACGAGCAGTACTTC	CASSREYEFYEQYF	TRBV19	TRBJ2-7
TGCAGTGCTAGCGTGGCGATCGACTGCTCTGGAAACACCATATATTTT	CSASVAIDCSGNTIYF	TRBV20-1	TRBJ1-3
TGTGCCAGCAGCCAACTCGGGGTGGCTTTCTTT	CASSQLGVAFF	TRBV7-3	TRBJ1-1
TGTTCTAGTCATGGGGGCGGGGTGAGAGAGACCCAGTACTTC	CSSHGGGVRETQYF	TRBV20-1	TRBJ2-5
TGTGCCAGCAGCCCCACCACAGGGTTACCGAAGGGGGAAAAACTGTTTTTT	CASSPTTGLPKGEKLFF	TRBV12-3	TRBJ1-4
TGTGCCAGCTACCGTGGGCCCACCACAGATACGCAGTATTTT	CASYRGPTTDTQYF	TRBV6-5	TRBJ2-3
TGTGCCAGCAGTTTAGGCCTCCGTCGAGACAATGAGCAGTTCTTC	CASSLGLRRDNEQFF	TRBV28	TRBJ2-1
TGTGCCAGCAGGCGAGGGACGCAGGGGTACCAAGAGACCCAGTACTTC	CASRRGTQGYQETQYF	TRBV6-1	TRBJ2-5
TGTGCCAGCAGTGACCGCCTAGCGTTCACGGTCTATAAAGAGACCCAGTACTTC	CASSDRLAFTVYKETQYF	TRBV2	TRBJ2-5
TGTGCCAGCAGCGGGACAGGGCTGAAGCTTGGAAACACCATATATTTT	CASSGTGLKLGNTIYF	TRBV28	TRBJ1-3
TGCAGTGCTAGAGATCTCGTCTGGGGGGTGTACCAGCCCCAGCATTTT	CSARDLVWGVYQPQHF	TRBV20-1	TRBJ1-5
TGCAGTGCTAGGAGCCTGGGGGAACCCAGCTCCTACGAGCAGTACTTC	CSARSLGEPSSYEQYF	TRBV20-1	TRBJ2-7
TGTGCCAGTAGTATGGCAGTCCTCAAGGGTCAGCCCCAGCATTTT	CASSMAVLKGQPQHF	TRBV19	TRBJ1-5
TGTGCCAGCAACCGGGGGGGGTGCTCCTACGAGCAGTACTTC	CASNRGGCSYEQYF	TRBV28	TRBJ2-7
TGTGCCAGCAGCAACTTTTGGTGCGAGCAGTACTTC	CASSNFWCEQYF	TRBV7-6	TRBJ2-7
TGTGCCAGCAGCACGGTAACCATGGACTATTCACCCCTCCACTTT	CASSTVTMDYSPLHF	TRBV7-9	TRBJ1-6
TGTGCCAGCAGCTACCGAGGTTTGGGCCCTCGGAAGCTAGCCGAGACCCAGTACTTC	CASSYRGLGPRKLAETQYF	TRBV11-2	TRBJ2-5
TGTGCCAGCAGTACGGGACGTCCGAACGACCGGTACTTC	CASSTGRPNDRYF	TRBV27	TRBJ2-7
TGTGCCAGCAGAGAGGCAGGCACTGAAGCTTTCTTT	CASREAGTEAFF	TRBV13	TRBJ1-1
TGTGCCAGCAGTTTATCAACAGACAACAGCTCCTACGAGCAGTACTTC	CASSLSTDNSSYEQYF	TRBV27	TRBJ2-7
TGCAGTGCTAGACTCGGCGACATCACCACCGGGGAGCTGTTTTTT	CSARLGDITTGELFF	TRBV20-1	TRBJ2-2
TGCAGTGCTAGTGGGACGGTGGATAATTCACCCCTCCACTTT	CSASGTVDNSPLHF	TRBV20-1	TRBJ1-6
TGTGCCACCAGCCTCATGGGACAGGGGACTCTGAACACTGAAGCTTTCTTT	CATSLMGQGTLNTEAFF	TRBV24-1	TRBJ1-1
TGTGCTAGTGGTTTGACAGGGGTAAAAAACATTCAGTACTTC	CASGLTGVKNIQYF	TRBV12-5	TRBJ2-4
TGTGCCAGCAGCCACTCGGGGGGGATTAATGAGCAGTTCTTC	CASSHSGGINEQFF	TRBV3-1	TRBJ2-1
TGTGCCAGCAGTTACCGCTACCGGGGGGGGACCAATGAGCAGTTCTTC	CASSYRYRGGTNEQFF	TRBV6-2	TRBJ2-1
TGTGCCAGCAGCCTTTCCACGGGACAGGGGAGAAGTGAGCAGTTCTTC	CASSLSTGQGRSEQFF	TRBV7-2	TRBJ2-1
TGTGCCCGTTGTAATCAGCCCCAGCATTTT	CARCNQPQHF	TRBV24-1	TRBJ1-5
TGTGCCAGCAGCTTAGGGCGTATCAACGGGACAGGTTACAATGAGCAGTTCTTC	CASSLGRINGTGYNEQFF	TRBV7-8	TRBJ2-1
TGTGCCACCAGCAGAGGACTAGCGGGGGGGTACACCGGGGAGCTGTTTTTT	CATSRGLAGGYTGELFF	TRBV15	TRBJ2-2
TGTGCCAGCAGCTATTCTAACGGGACAGGGGAGTCTGGGGCCAACGTCCTGACTTTC	CASSYSNGTGESGANVLTF	TRBV4-2	TRBJ2-6
TGTGCCAGCAGCCCCGCGCAGACTCAGCCCCAGCATTTT	CASSPAQTQPQHF	TRBV7-8	TRBJ1-5
TGTGCCAGCAGCGGACAGTCCTCTGGGGCCAACGTCCTGACTTTC	CASSGQSSGANVLTF	TRBV13	TRBJ2-6
TGTGCCAGCATGTTGGGACTAGGGAGAACGAACACCGGGGAGCTGTTTTTT	CASMLGLGRTNTGELFF	TRBV6-4	TRBJ2-2
TGTGCCAGCAGCTTGGACGCAGGGATTTCCGAAAAACTGTTTTTT	CASSLDAGISEKLFF	TRBV5-6	TRBJ1-4
TGTGCCAGCAGCCCACAGGGAGCTAACTATGGCTACACCTTC	CASSPQGANYGYTF	TRBV7-3	TRBJ1-2
TGTGCCAGCAGCTTGTCCGGGACAGTCCCCACTGAAGCTTTCTTT	CASSLSGTVPTEAFF	TRBV5-6	TRBJ1-1
TGCAGTGCTAGATTCGGCTTAGACACCATATATTTT	CSARFGLDTIYF	TRBV20-1	TRBJ1-3
TGTGCCAGCAGCGTTAGGGACAGGGGGGACGAGCAGTACTTC	CASSVRDRGDEQYF	TRBV9	TRBJ2-7
TGTGCCAGCAGTTTGTGGGGGAAAGAGCAGTACTTC	CASSLWGKEQYF	TRBV28	TRBJ2-7
TGTGCCAGCAGCATGGATTCCAGGGGGGGAAGTCCTCGCACAGATACGCAGTATTTT	CASSMDSRGGSPRTDTQYF	TRBV7-2	TRBJ2-3
TGTGCCACCCACAGGGGTCCGTCTTACGAGCAGTACTTC	CATHRGPSYEQYF	TRBV28	TRBJ2-7
TGTGCCACCCTCTCTCAGGACGGCGAGTACTATGGCTACACCTTC	CATLSQDGEYYGYTF	TRBV24-1	TRBJ1-2
TGTGCTAGTGGTTCGCGGGACGATGAAAAACTGTTTTTT	CASGSRDDEKLFF	TRBV12-5	TRBJ1-4
TGTGCCAGCAGTTCCCAACAGGGTCGCCGGGTCTACGAGCAGTACTTC	CASSSQQGRRVYEQYF	TRBV27	TRBJ2-7
TGTGCCAGCAGCTTGCGCCGCGGGGCTGAAGCTTTCTTT	CASSLRRGAEAFF	TRBV7-9	TRBJ1-1
TGTGCCAGCAGCTTGCTTAGGATCTACTGGGATGCCAAAAACATTCAGTACTTC	CASSLLRIYWDAKNIQYF	TRBV5-6	TRBJ2-4
TGTGCCATCAGTGAGTCGGGGGACCCCACTGGGGCCAACGTCCTGACTTTC	CAISESGDPTGANVLTF	TRBV10-3	TRBJ2-6
TGTGCCAGCAGCTTCACGGGACCGTGCAGCTCCTACGAGCAGTACTTC	CASSFTGPCSSYEQYF	TRBV7-3	TRBJ2-7
TGTGCTAGTGGTTACCTATCAACGGGGAATGAGCAGTTCTTC	CASGYLSTGNEQFF	TRBV12-5	TRBJ2-1
TGTGCCAGCAGTTTACAGATCGAAACGGGGCGATCCTACAATGAGCAGTTCTTC	CASSLQIETGRSYNEQFF	TRBV12-3	TRBJ2-1
TGTGCCAGCAGATGCCGGGACATAGACGTATATGGCTACACCTTC	CASRCRDIDVYGYTF	TRBV6-4	TRBJ1-2
TGCAGTGCGAAACAGGGGGTCCCCTATGGCTACACCTTC	CSAKQGVPYGYTF	TRBV20-1	TRBJ1-2
TGTGCCAGCAGTGGACTAACGGGGCGGATCCGTAACTATGGCTACACCTTC	CASSGLTGRIRNYGYTF	TRBV27	TRBJ1-2
TGTGCCACCTATGGGCACCGGGTTGGATGGTGGGGCTACACCTTC	CATYGHRVGWWGYTF	TRBV24-1	TRBJ1-2
TGTGCCAGCAGTTTTGAGGGAGAGACCCAGTACTTC	CASSFEGETQYF	TRBV12-3	TRBJ2-5
TGCGCCAGCAGTACCCTGACGAGAATCCTCTACGAGCAGTACTTC	CASSTLTRILYEQYF	TRBV10-1	TRBJ2-7
TGTGCCAGCAGTGAGTCTGGTGACGCGGGACCGGGTTATTATTCACCCCTCCACTTT	CASSESGDAGPGYYSPLHF	TRBV25-1	TRBJ1-6
TGTGCCAGCAGTTTATTTTGGGGTCCAAGGGGTGAAGCTTTCTTT	CASSLFWGPRGEAFF	TRBV27	TRBJ1-1
TGCGCCAGCAGCTTGGCCGGGACAGAGACCCAGTACTTC	CASSLAGTETQYF	TRBV5-1	TRBJ2-5
TGTGCCAGCAGTTTACCCCCCCCAGGGAAAGGACAGGGACGGGTAAATCAGCCCCAGCATTTT	CASSLPPPGKGQGRVNQPQHF	TRBV28	TRBJ1-5
TGTGCCAGCATGGGACAGGGATGCCAAGAGACCCAGTACTTC	CASMGQGCQETQYF	TRBV12-4	TRBJ2-5
TGTGCCAGCAGCTTAAAGATAGCGCTACGCTGCGAGCAGTACTTC	CASSLKIALRCEQYF	TRBV11-1	TRBJ2-7
TGTGCCAGCAGCGGCAGGGAAGAGACCCAGTACTTC	CASSGREETQYF	TRBV11-2	TRBJ2-5
TGTGCCAGCGCACGGGACTACGAGCAGTACTTC	CASARDYEQYF	TRBV28	TRBJ2-7
TGCGCCAGCAGCCAAGATGCAAGGATATATAAGGGGGAGCAGTACTTC	CASSQDARIYKGEQYF	TRBV4-1	TRBJ2-7
TGTGGGACAGACGAGCAGTACTTC	CGTDEQYF	TRBV10-3	TRBJ2-7
TGTGCCGGGACTAGCGGGTCTCAAGAGACCCAGTACTTC	CAGTSGSQETQYF	TRBV27	TRBJ2-5
TGTGCCAGCAGTGACGGGACAGGAACCTACGAGCAGTACTTC	CASSDGTGTYEQYF	TRBV6-4	TRBJ2-7
TGTGCCAGCAGTTCCACCGGGGCTAGGTATGAGCAGTTCTTC	CASSSTGARYEQFF	TRBV27	TRBJ2-1
TGTGCCACCAGCAGGCCCCGACTAGCGGGGGGGCCCGTGTCCTACGAGCAGTACTTC	CATSRPRLAGGPVSYEQYF	TRBV15	TRBJ2-7
TGTGCCAGCTCACAGGTTGGGACAGGATACGAGCAGTACTTC	CASSQVGTGYEQYF	TRBV18	TRBJ2-7
TGTGCCCAGGCGCGAAACACTGAAGCTTTCTTT	CAQARNTEAFF	TRBV6-4	TRBJ1-1
TGCGCCAGCACGCATGGAAACACCATATATTTT	CASTHGNTIYF	TRBV5-1	TRBJ1-3
TGTGCCACCAGTGATTGGGGGCCCATAGCCTACGAGCAGTACTTC	CATSDWGPIAYEQYF	TRBV24-1	TRBJ2-7
TGTGCTAGTGGTTTGTTTTTGAACCGATGTAATCAGCCCCAGCATTTT	CASGLFLNRCNQPQHF	TRBV12-5	TRBJ1-5
TGTGCCAGCAGCAGAGCCCCAGGGAGGGTGAACACTGAAGCTTTCTTT	CASSRAPGRVNTEAFF	TRBV13	TRBJ1-1
TGTGCCAGCACGTCCCCCGCCACAGATACGCAGTATTTT	CASTSPATDTQYF	TRBV11-3	TRBJ2-3
TGTGCCTGGAGCCCAATAGGAACAGAGCAGTTCTTC	CAWSPIGTEQFF	TRBV30	TRBJ2-1
TGTGCCAGCAGCGGGGAGCGCCTACCGGGGGGCGAGAACAATGAGCAGTTCTTC	CASSGERLPGGENNEQFF	TRBV6-4	TRBJ2-1
TGTGCCAGCAGGGGCTGGAGCCCGGAGGACGTTGGGCATTTT	CASRGWSPEDVGHF	TRBV6-5	TRBJ1-5
TGCAGTGCTAGAGATTGGACTAGCGGGGCGGACTCCTACAATGAGCAGTTCTTC	CSARDWTSGADSYNEQFF	TRBV20-1	TRBJ2-1
TGCAGTGCTGAAGCGAGAGATGGCTACACCTTC	CSAEARDGYTF	TRBV20-1	TRBJ1-2
TGTGCCAGCAGTGATACCCGGACTAGCGTTGAGACCCAGTACTTC	CASSDTRTSVETQYF	TRBV25-1	TRBJ2-5
TGCAGCGCCAGGGACAGCAATCAGCCCCAGCATTTT	CSARDSNQPQHF	TRBV29-1	TRBJ1-5
TGTGCCAGCAGTTATCCCTCGAGGGCCAACCAAGAGACCCAGTACTTC	CASSYPSRANQETQYF	TRBV6-5	TRBJ2-5
TGTGCCAGCAGCGTAGCCGGGGTATTAACGGGCTACACCTTC	CASSVAGVLTGYTF	TRBV9	TRBJ1-2
TGTGCTAGTGGTATATACGTGACTAGGTGGAGGGAGACCCAGTACTTC	CASGIYVTRWRETQYF	TRBV12-5	TRBJ2-5
TGTGCCAGCAGCGAGGTTCATGGTACCGACAGCACCTTAAATGAAAAACTGTTTTTT	CASSEVHGTDSTLNEKLFF	TRBV7-9	TRBJ1-4
TGCATAGTAATCTTC	CIVIF	TRBV29-1	TRBJ2-1
TGCAGTGCTAGAATCCAGATGGGGTATGACAACTCGGGTCATCAGCCCCAGCATTTT	CSARIQMGYDNSGHQPQHF	TRBV20-1	TRBJ1-5
TGTGCCAGCATAAGCGAAAAACCACTAGCGGGCCATGAGCAGTTCTTC	CASISEKPLAGHEQFF	TRBV6-5	TRBJ2-1
TGTGCCAGCAGCCAAGATCTTGAGTTAGAAGCTTTCTTT	CASSQDLELEAFF	TRBV14	TRBJ1-1
TGCGCCAGCAGCCTACCTGGCCCCACAGATACGCAGTATTTT	CASSLPGPTDTQYF	TRBV5-1	TRBJ2-3
TGTGCCAGCTCACGTGGCAAAAGCCTCAATCAGCCCCAGCATTTT	CASSRGKSLNQPQHF	TRBV18	TRBJ1-5
TGCCCTGCGCCGGGGGTCACCTCGACTTGGGCTATGGAGCCCCAGCATTTT	CPAPGVTSTWAMEPQHF	TRBV6-1	TRBJ1-5
TGTGCCAGCAGTTGTGGGATCCGTCTAAAGGTAGCAGCTAACTATGGCTACACCTTC	CASSCGIRLKVAANYGYTF	TRBV6-5	TRBJ1-2
TGTGCCAGCAGCTTGGACCAGGACAGGGGGTACTCTGGAAACACCATATATTTT	CASSLDQDRGYSGNTIYF	TRBV5-6	TRBJ1-3
TGTGCCAGCAGCATTTGGGGCGGGTTGAACACCGGGGAGCTGTTTTTT	CASSIWGGLNTGELFF	TRBV7-4	TRBJ2-2
TGTGCCAGCAGCCAACGAGGGACTAGCGGGACCTACGAGCAGTACTTC	CASSQRGTSGTYEQYF	TRBV14	TRBJ2-7
TGTGCCAGCATGTACAGGGGGCAACTAGAAGCTTTCTTT	CASMYRGQLEAFF	TRBV27	TRBJ1-1
TGCGCCAGCAGCCAAGATCTAGGGTGGCGGTCTAGCACAGATACGCAGTATTTT	CASSQDLGWRSSTDTQYF	TRBV4-1	TRBJ2-3
TGTGCCAGTCATCTGGGGGAGGGTTCGGATCAGCCCCAGCATTTT	CASHLGEGSDQPQHF	TRBV6-4	TRBJ1-5
TGCAGCCATACAGCGATGAACACTGAAGCTTTCTTT	CSHTAMNTEAFF	TRBV29-1	TRBJ1-1
TGTGCCACCAGTGCCGAGGGGGGGACACAAGAGACCCAGTACTTC	CATSAEGGTQETQYF	TRBV24-1	TRBJ2-5
TGTGCCAGCAAAACTAGCGGGAGGGCGCAGCCCCAGCATTTT	CASKTSGRAQPQHF	TRBV6-5	TRBJ1-5
TGTGCCAGCAGACAGGGGTGGCGAATCTTCTTT	CASRQGWRIFF	TRBV25-1	TRBJ1-1
TGTGCCAGCAGCCCCAGACAACCCGGCGGGTCTGGAAACACCATATATTTT	CASSPRQPGGSGNTIYF	TRBV7-2	TRBJ1-3
TGTGCCAGCAGCTTAGCGCAAGGACTAGCGGGAGGTGAGACCCAGTACTTC	CASSLAQGLAGGETQYF	TRBV7-7	TRBJ2-5
TGTGCCAGCACTGAGACCGAGAACACCGGGGAGCTGTTTTTT	CASTETENTGELFF	TRBV28	TRBJ2-2
TGTGCCAGCAGTGAAGTAACGAGGGTCTACAATGAGCAGTTCTTC	CASSEVTRVYNEQFF	TRBV6-1	TRBJ2-1
TGTGCCAGCAGCGTCAGACTAGCGGGAGGGACCGGGGAGCTGTTTTTT	CASSVRLAGGTGELFF	TRBV13	TRBJ2-2
TGCGCCAGCAGCTTACTGCGCGGGAACAGAGAGACCCAGTACTTC	CASSLLRGNRETQYF	TRBV5-1	TRBJ2-5
TGTGCCAGCAGCTTAGCGGGGACCGGGACAGATACGCAGTATTTT	CASSLAGTGTDTQYF	TRBV7-9	TRBJ2-3
TGTGCCAGCAGTGAATCTAGAATACTCCGGTGGGGGGGATGGTTTTTGTATTTCACAGATACGCAGTATTTT	CASSESRILRWGGWFLYFTDTQYF	TRBV25-1	TRBJ2-3
TGTGCCACGGCCGAGGACCGTCAGCCCCAGCATTTT	CATAEDRQPQHF	TRBV12-3	TRBJ1-5
TGCGCCAGCAGCTTGTCGGGACAGGGTAGCCAAGAGACCCAGTACTTC	CASSLSGQGSQETQYF	TRBV5-1	TRBJ2-5
TGCGCCAGCAGCGAAACAGGGCCAGGTTACGAGCAGTACTTC	CASSETGPGYEQYF	TRBV5-1	TRBJ2-7
TGTGCCAGTAGTATTCAGTGCGGGACGGGGAGGGGGGGCAATGAAAAACTGTTTTTT	CASSIQCGTGRGGNEKLFF	TRBV19	TRBJ1-4
TGTGCCAGCAGACGACCCGAGGTTTTACGGTCGAACACCGGGGAGCTGTTTTTT	CASRRPEVLRSNTGELFF	TRBV6-6	TRBJ2-2
TGTGCCACCAGTGATAATTGGGGGCAGCAATATGGCTACACCTTC	CATSDNWGQQYGYTF	TRBV24-1	TRBJ1-2
TGTGCCAGCAGTGACGGGTCGGAAAGCTACAATGAGCAGTTCTTC	CASSDGSESYNEQFF	TRBV6-4	TRBJ2-1
TGTGCCAGCAGCACGGTGGAGGGCCAGGTATTCGGTTATAGCAATCAGCCCCAGCATTTT	CASSTVEGQVFGYSNQPQHF	TRBV7-3	TRBJ1-5
TGTGCCAGCAGCTTTGGACAGCCCACTGGAAACACCATATATTTT	CASSFGQPTGNTIYF	TRBV7-3	TRBJ1-3
TGTGCCAGCAGTCTCTCACCAGCGTTAGGGGCCACCGGGGAGCTGTTTTTT	CASSLSPALGATGELFF	TRBV6-4	TRBJ2-2
TGTGCCAGCAGCCCCAATTCCGGACAGGGAGTGAACACTGAAGCTTTCTTT	CASSPNSGQGVNTEAFF	TRBV11-2	TRBJ1-1
TGTGCCAGTAGTACCGGACAGGGGTTGACCTATGGCTACACCTTC	CASSTGQGLTYGYTF	TRBV19	TRBJ1-2
TGTGCTAGTGGTAACTCCGGGACAGGGGGACCCTCTAGCAATCAGCCCCAGCATTTT	CASGNSGTGGPSSNQPQHF	TRBV12-5	TRBJ1-5
TGTGCCAGCAGACAGGGGAAAAGCAATCAGCCCCAGCATTTT	CASRQGKSNQPQHF	TRBV5-6	TRBJ1-5
TGTGCCAGCAAGGGGGGGGCCGGGGATACGCAGTATTTT	CASKGGAGDTQYF	TRBV12-4	TRBJ2-3
TGTGCCAGCAGCCAGTGGTCTAGAGGTTTCTCCGGGGAGAGCACAGATACGCAGTATTTT	CASSQWSRGFSGESTDTQYF	TRBV14	TRBJ2-3
TGTGCCAGCAGTTACGGGAGGGAGTCCGGGACAGGGGGAACTTTCTTCAGAGTGGAGGAGCAGTACTTC	CASSYGRESGTGGTFFRVEEQYF	TRBV6-5	TRBJ2-7
TGCGCCAGCAGCCAAGACTGGGGAGGGGGGGAGGTGAATTCACCCCTCCACTTT	CASSQDWGGGEVNSPLHF	TRBV4-1	TRBJ1-6
TGTGCCAGCAGTGAAGTCTCGGACCGACACCAAGAGACCCAGTACTTC	CASSEVSDRHQETQYF	TRBV6-1	TRBJ2-5
TGTGCCACCAGTGGTTCTCCGGGACAATCTGAGCAGTTCTTC	CATSGSPGQSEQFF	TRBV24-1	TRBJ2-1
TGTGCCAGCAGTTTGACAGGGTTGGCCTACAATGAGCAGTTCTTC	CASSLTGLAYNEQFF	TRBV27	TRBJ2-1
TGTGCCAGCAAACGATCGGATCAGCCCCAGCATTTT	CASKRSDQPQHF	TRBV7-2	TRBJ1-5
TGTGCCAGCAGCAAAGAGCGGGAGATATTGGCCTACAATGAGCAGTTCTTC	CASSKEREILAYNEQFF	TRBV7-3	TRBJ2-1
TGTGCCTGGAGAAGGCCCGGGGGGGGACTAGCGGGGCAAAGCACAGATACGCAGTATTTT	CAWRRPGGGLAGQSTDTQYF	TRBV30	TRBJ2-3
TGTGCCAGCAGTTACTCGACCAGAAACACCATATATTTT	CASSYSTRNTIYF	TRBV6-6	TRBJ1-3
TGTGCCAGCAGCGCGAGGGGGACAGATACGCAGTATTTT	CASSARGTDTQYF	TRBV11-2	TRBJ2-3
TGTGCCACCAGCCAACCGAAGGGGGTACCCTACGAGCAGTACTTC	CATSQPKGVPYEQYF	TRBV15	TRBJ2-7
TGTGCCTGGAGGGGGGGGATAGCAGATACGCAGTATTTT	CAWRGGIADTQYF	TRBV30	TRBJ2-3
TGCGCCAGCAGCCAAGATGTTGACGCTTTGCAAGAGACCCAGTACTTC	CASSQDVDALQETQYF	TRBV4-3	TRBJ2-5
TGTGCCAGCAGACCGGGACTAGCGGCTGGGGGTTTCGAGCAGTTCTTC	CASRPGLAAGGFEQFF	TRBV10-3	TRBJ2-1
TGTGCCTGGAGCCTCCCCAGGGGAGGGAGGGCCTCTTCTAGCACAGATACGCAGTATTTT	CAWSLPRGGRASSSTDTQYF	TRBV10-3	TRBJ2-3
TGTGCCAGCAGTGAAGTGGGGACGTCGAATTCTGCTAGCTCCTACGAGCAGTACTTC	CASSEVGTSNSASSYEQYF	TRBV6-1	TRBJ2-7
TGCAGTGCTACAGGGGGCGATGCGAACACTGAAGCTTTCTTT	CSATGGDANTEAFF	TRBV20-1	TRBJ1-1
TGTGCCAGCAGTGAACCAGGGGCCACGAGCTACGAGCAGTACTTC	CASSEPGATSYEQYF	TRBV2	TRBJ2-7
TGTGCCAGCAGCCAATTAGCGGGACAAGTCAGCACAGATACGCAGTATTTT	CASSQLAGQVSTDTQYF	TRBV3-1	TRBJ2-3
TGTGCCAGCAGCCAGGACAGGGAACAGCCTAAAGACCGTAATGAAAAACTGTTTTTT	CASSQDREQPKDRNEKLFF	TRBV7-2	TRBJ1-4
TGTGCCAGCAGCGTAGCTGTGCATTACAGGGCGATCAATGAGCAGTTCTTC	CASSVAVHYRAINEQFF	TRBV9	TRBJ2-1
TGTGCCTGGAGTGTAGAGGGGGGCTCAGATACGCAGTATTTT	CAWSVEGGSDTQYF	TRBV30	TRBJ2-3
TGTGCCACCAGCAGGGGCTCCACTAGCGGGTCCAGGCGTAGGCAGTGCTACAATGAGCAGTTCTTC	CATSRGSTSGSRRRQCYNEQFF	TRBV15	TRBJ2-1
TGTGCCAGCAGGTTCCGCACAGTTGCTAGCGGGGGGAGAAGCTCCTACAATGAGCAGTTCTTC	CASRFRTVASGGRSSYNEQFF	TRBV7-9	TRBJ2-1
TGTATGTCTCAGGACAGGGGATATGGCTACACCTTC	CMSQDRGYGYTF	TRBV27	TRBJ1-2
TGTGCCAGCAGCTCTAGGGCAAAAGAGACCCAGTACTTC	CASSSRAKETQYF	TRBV3-1	TRBJ2-5
TGCAGTGCTAGAGATACTAGCGGTAATGAGCAGTTCTTC	CSARDTSGNEQFF	TRBV20-1	TRBJ2-1
TGTGCCAGCATATCGGAGTCGGGGGAGACCCAGTACTTC	CASISESGETQYF	TRBV27	TRBJ2-5
TGTGCCAGCAGTTACTCGGAGGGGGGAAGATCCGAGCAGTACTTC	CASSYSEGGRSEQYF	TRBV6-5	TRBJ2-7
TGTGCCAGTCTGATGGTCTACTACGAGCAGTACTTC	CASLMVYYEQYF	TRBV27	TRBJ2-7
TGTGCCAGCAGCCCTATCCGACCGGGACAGGGAAGGCTCAATGAGCAGTTCTTC	CASSPIRPGQGRLNEQFF	TRBV6-5	TRBJ2-1
TGTGCCAGGCTTGGGGGCTCGCTTAATGAAAAACTGTTTTTT	CARLGGSLNEKLFF	TRBV10-3	TRBJ1-4
TGCAGTGCTAGTGTCCCCCCGAGGTCGGACACCTACAATGAGCAGTTCTTC	CSASVPPRSDTYNEQFF	TRBV20-1	TRBJ2-1
TGTGCCAGCAGTTTAAGAAGACAGGGACACACTGAAGCTTTCTTT	CASSLRRQGHTEAFF	TRBV27	TRBJ1-1
TGTGCCAGCAGCCATCCAGGGAGGGACTACGAGCAGTACTTC	CASSHPGRDYEQYF	TRBV14	TRBJ2-7
TGTGCCAGCAGCTGGGGGGGAAACACCATATATTTT	CASSWGGNTIYF	TRBV6-4	TRBJ1-3
TGTGCCAGGTCAGGGTGCCACTACGAGCAGTACTTC	CARSGCHYEQYF	TRBV6-4	TRBJ2-7
TGTGCCAGCAGCTTAGCGGGTTCGGACGAGCAGTACTTC	CASSLAGSDEQYF	TRBV7-9	TRBJ2-7
TGTGCCAGCAGTTACTCTAATTCGGGTCCAGCCGCCTACGAGCAGTACTTC	CASSYSNSGPAAYEQYF	TRBV6-2	TRBJ2-7
TGTGCCAGCAGCCAAGATGTTCGGACAGGGAAAGGCTACACCTTC	CASSQDVRTGKGYTF	TRBV4-2	TRBJ1-2
TGCAGTGCTAGGCCCCCGGAGGTAGAGCAGTTCTTC	CSARPPEVEQFF	TRBV20-1	TRBJ2-1
TGTGCCAGCAGCACCGGGGCCCTAAATTCACCCCTCCACTTT	CASSTGALNSPLHF	TRBV5-4	TRBJ1-6
TGTGCCAGCAGCTTTCCCGGGGGGCGAGCGATGGAAAGGGCCAAAAACATTCAGTACTTC	CASSFPGGRAMERAKNIQYF	TRBV5-4	TRBJ2-4
TGCGCCAGCACCAGGGCTGAGCGTGAAAGAGAGACCCAGTACTTC	CASTRAERERETQYF	TRBV5-1	TRBJ2-5
TGCGCCAGCAGCTTGCGCTACCCGGGACAGGGCGACTATGGCTACACCTTC	CASSLRYPGQGDYGYTF	TRBV5-1	TRBJ1-2
TGTGCCAGCACCCTCGAGGACAGGGTCGTGGATAACACTGAAGCTTTCTTT	CASTLEDRVVDNTEAFF	TRBV6-2	TRBJ1-1
TGTGCCAGCAGCTTTAAAAAGGCGACTGTTAGTTCACCCCTCCACTTT	CASSFKKATVSSPLHF	TRBV7-9	TRBJ1-6
TGTGCTAGTGGGTCTAGCACAGATACGCAGTATTTT	CASGSSTDTQYF	TRBV12-5	TRBJ2-3
TGCGCCAGCAAGCCCGGGGAAGATCAGTACAATGAGCAGTTCTTC	CASKPGEDQYNEQFF	TRBV5-1	TRBJ2-1
TGTGCCAGCAGTTTACTCCGGGACAGGGTCGAGCAGTACTTC	CASSLLRDRVEQYF	TRBV12-4	TRBJ2-7
TGTGCCAGCAGCGGTAGGGGCTTAGCCTACGAGCAGTACTTC	CASSGRGLAYEQYF	TRBV13	TRBJ2-7
TGCGCCAGCAGGAGGACTCCGTCCCGCGAGCAGTACTTC	CASRRTPSREQYF	TRBV10-1	TRBJ2-7
TGTGCCAGCAGTCTGACAGGGGGTGGGGAAGAGACCCAGTACTTC	CASSLTGGGEETQYF	TRBV6-2	TRBJ2-5
TGTGCCAGCAGCGCCTCGTGGAAAATTTCTCGACACACTGAAGCTTTCTTT	CASSASWKISRHTEAFF	TRBV11-3	TRBJ1-1
TGCAGCGGGACAGGGAGCACAGATACGCAGTATTTT	CSGTGSTDTQYF	TRBV29-1	TRBJ2-3
TGTGCTAGCAGCTGCGGGAAAGAGACCCAGTACTTC	CASSCGKETQYF	TRBV7-7	TRBJ2-5
TGCAGTGCGCCGGGACCAAGACAGGGGATCGGGCCGGTTTTGAGAGGCGGGAACACTGAAGCTTTCTTT	CSAPGPRQGIGPVLRGGNTEAFF	TRBV20-1	TRBJ1-1
TGCGCCAGCAGTGAGCACAGGGATGAGACCCAGTACTTC	CASSEHRDETQYF	TRBV10-2	TRBJ2-5
TGTGCCAGCAGTGGCTCAGGGGTAAACACTGAAGCTTTCTTT	CASSGSGVNTEAFF	TRBV6-1	TRBJ1-1
TGTGCCATCAGTGAGTATAGGGAGGGGTATTACAATGAGCAGTTCTTC	CAISEYREGYYNEQFF	TRBV10-3	TRBJ2-1
TGTGCCAAGGGCCCTCTTCTTGAGCAGTACTTC	CAKGPLLEQYF	TRBV6-4	TRBJ2-7
TGTGCCAGCAGTGAGACGGGGATTGGGGTCTATGAGCAGTTCTTC	CASSETGIGVYEQFF	TRBV6-4	TRBJ2-1
TGTGCCAGCAAGACCCGCGTCCGTTGGGACGCGGAGGAAAGCTCCTACAATGAGCAGTTCTTC	CASKTRVRWDAEESSYNEQFF	TRBV6-3	TRBJ2-1
TGTGCTAGTGACGGACAGGGATTAATTGAAAAACTGTTTTTT	CASDGQGLIEKLFF	TRBV12-5	TRBJ1-4
TGTGCCAGCAGCTTCTGGACTAGACAGAGCACAGATACGCAGTATTTT	CASSFWTRQSTDTQYF	TRBV5-6	TRBJ2-3
TGTGCCAGCAGCTTAGTACAGGTATCTGAAGCTTTCTTT	CASSLVQVSEAFF	TRBV7-9	TRBJ1-1
TGTGCCACCCTCCGTCAGGTTGGCTACACCTTC	CATLRQVGYTF	TRBV24-1	TRBJ1-2
TGTGCCAGCAGCTATCCAGCGCAGGGATGGGAAAAACTGTTTTTT	CASSYPAQGWEKLFF	TRBV5-5	TRBJ1-4
TGCGCCAGCAGCCGGCGGACAGGGGGCGGAACGGATGGCTACACCTTC	CASSRRTGGGTDGYTF	TRBV4-3	TRBJ1-2
TGTGCCAGCAGCGGCCGGCGGGAGGGAGACTATGGCTACACCTTC	CASSGRREGDYGYTF	TRBV9	TRBJ1-2
TGTGCCAGCAGTGAAGAGGAGGACAGGGTTTCCCAGCATTTT	CASSEEEDRVSQHF	TRBV7-9	TRBJ1-5
TGTGCCAACAGCACAAACTATGGCTACACCTTC	CANSTNYGYTF	TRBV19	TRBJ1-2
TGTGCCAGGGTCCAGAGTACCTATAATTCACCCCTCCACTTT	CARVQSTYNSPLHF	TRBV6-1	TRBJ1-6
TGTGCCATCAGTGAGTCGACCACTAGCGGGAGAGGTGAAAAACTGTTTTTT	CAISESTTSGRGEKLFF	TRBV10-3	TRBJ1-4
TGTGCCAGTGCAAAAATCCGTGGCTACACCTTC	CASAKIRGYTF	TRBV6-4	TRBJ1-2
TGTGCCAGCACCCCGAAGGGACGGGAGGACGAGCAGTACTTC	CASTPKGREDEQYF	TRBV6-8	TRBJ2-7
TGCAGCCCGAGGGACAGGGGGCGGGATGTAGGAAACACCATATATTTT	CSPRDRGRDVGNTIYF	TRBV29-1	TRBJ1-3
TGCGCCACTACGGACAGGGGCTACAATGAGCAGTTCTTC	CATTDRGYNEQFF	TRBV10-1	TRBJ2-1
TGTGCCACCAACTACATGCCCGGACTAGCCCGGTGTACGCAGTATTTT	CATNYMPGLARCTQYF	TRBV24-1	TRBJ2-3
TGTGCCAGCAGCCAGTCACAGAGCCAAGAGACCCAGTACTTC	CASSQSQSQETQYF	TRBV7-7	TRBJ2-5
TGTGCCAGCAGCGGACAGGGGCGGGAGAATCAGCCCCAGCATTTT	CASSGQGRENQPQHF	TRBV7-9	TRBJ1-5
TGTGCCAGCCCAGGGGGGCCCGTTGACACTGAAGCTTTCTTT	CASPGGPVDTEAFF	TRBV2	TRBJ1-1
TGTGCCACCAGCAGACACAGCCAATCCTATGGCTACACCTTC	CATSRHSQSYGYTF	TRBV15	TRBJ1-2
TGTGCCAGCAGTTACACTGTAACGGAGCGAGTGGCAGCCAAAAACATTCAGTACTTC	CASSYTVTERVAAKNIQYF	TRBV6-6	TRBJ2-4
TGTGCCATCATTCTATGCGACAGATTAGCCTACGAGCAGTACTTC	CAIILCDRLAYEQYF	TRBV10-3	TRBJ2-7
TGTGCCAGCAGCCAAGGAAATATAGCTGGGTCACCCGAGACCCAGTACTTC	CASSQGNIAGSPETQYF	TRBV5-8	TRBJ2-5
TGTGCCAGCAGCCAGGACGGCTGTTCACCCCTCCACTTT	CASSQDGCSPLHF	TRBV14	TRBJ1-6
TGTGCCAGCAGTGACTCGGCTCTAGGACAGGGTTATGAAGCTTTCTTT	CASSDSALGQGYEAFF	TRBV6-4	TRBJ1-1
TGTGCCAGCAGCACGACTAGTTCCTACGAGCAGTACTTC	CASSTTSSYEQYF	TRBV13	TRBJ2-7
TGTGCCAGCAGTTTTAAGACCCTCAAATACAATGAGCAGTTCTTC	CASSFKTLKYNEQFF	TRBV27	TRBJ2-1
TGTGCCAGCAGTGAACCGAATGGGCCAAAGAGAATAAGGTTTTACGAGCAGTACTTC	CASSEPNGPKRIRFYEQYF	TRBV2	TRBJ2-7
TGCGCCAGCAGCTTCTATTCGAGGGGGCCCGGGGAGCTGTTTTTT	CASSFYSRGPGELFF	TRBV5-1	TRBJ2-2
TGTGCCAGCATCTGGGACAATGCTAACTATGGCTACACCTTC	CASIWDNANYGYTF	TRBV7-3	TRBJ1-2
TGTGCCAGCACGCTGGTCAACTGGTTGGGCTACACCTTC	CASTLVNWLGYTF	TRBV6-5	TRBJ1-2
TGTGCCAGCAGTTACATCACTGAGCTCTACGAGCAGTACTTC	CASSYITELYEQYF	TRBV6-5	TRBJ2-7
TGTGCCAGCAGTCCGGCGAGGGGCCATCAGCCCCAGCATTTT	CASSPARGHQPQHF	TRBV6-2	TRBJ1-5
TGTGCCAGCAGCTTAGCGGTGGCGCCGGACAGGGGGGGAGGCTACACCTTC	CASSLAVAPDRGGGYTF	TRBV7-6	TRBJ1-2
TGCGCCAGCAGTGAACGCGGGGGCAAAAACATTCAGTACTTC	CASSERGGKNIQYF	TRBV10-1	TRBJ2-4
TGTGCCATCAAAACAGGAGGGGTAGCTAACTATGGCTACACCTTC	CAIKTGGVANYGYTF	TRBV10-3	TRBJ1-2
TGTGCCAGCGAGGGGGGGAACACCTTC	CASEGGNTF	TRBV6-4	TRBJ1-2
TGTGCCAGCAGAGCAACAGGACTTACCTACGAGCAGTACTTC	CASRATGLTYEQYF	TRBV18	TRBJ2-7
TGTGCCAGCAGGATACAGGGCTATGGCTACACCTTC	CASRIQGYGYTF	TRBV5-6	TRBJ1-2
TGTGCCAGCAGTTCCCCTGGACAGGGGTCAACTAATGAAAAACTGTTTTTT	CASSSPGQGSTNEKLFF	TRBV27	TRBJ1-4
TGTGCCAGCAGCGTTTACCGGGCTAACTATGGCTACACCTTC	CASSVYRANYGYTF	TRBV9	TRBJ1-2
TGTGCCAGCAGCTTGGAGTCCTTCCTGCGGAAGACCCAGTACTTC	CASSLESFLRKTQYF	TRBV5-4	TRBJ2-5
TGTGCCAGCAGCCCGTGCCCGGGACTATATGAGCAGTTCTTC	CASSPCPGLYEQFF	TRBV5-6	TRBJ2-1
TGCGCCAGCAGCTTGCCCGGGACAGATACGCAGTATTTT	CASSLPGTDTQYF	TRBV5-1	TRBJ2-3
TGCAGCGTTGCGAGGACCCCTGGAAACACCATATATTTT	CSVARTPGNTIYF	TRBV29-1	TRBJ1-3
TGTGCCAGCAGTTGGGGGATCTATGGCTACACCTTC	CASSWGIYGYTF	TRBV6-5	TRBJ1-2
TGTGCCACCAGTGTCGACAAGTTATCTGAGCAGTACTTC	CATSVDKLSEQYF	TRBV24-1	TRBJ2-7
TGTGCCAGCAGCCTCAATGGGGGCCCGTCGACCTACGAGCAGTACTTC	CASSLNGGPSTYEQYF	TRBV7-3	TRBJ2-7
TGTGCCAGCAGCTTAGGTCTTAGGGAGGGGTTATATAATTCACCCCTCCACTTT	CASSLGLREGLYNSPLHF	TRBV11-2	TRBJ1-6
TGTGCCAGCCTTTATCGCATTATGGGCTTC	CASLYRIMGF	TRBV6-5	TRBJ1-2
TGTGCCAGCAGTGAAGCGCCCGGGGACTTGCTTGGAAACACCATATATTTT	CASSEAPGDLLGNTIYF	TRBV6-1	TRBJ1-3
TGTGCCAGCATCGGGGGGGGCAGGACGAACACCGGGGAGCTGTTTTTT	CASIGGGRTNTGELFF	TRBV11-3	TRBJ2-2
TGTGCCAGCAGCCAGACAGGTAAGTATCAGCCCCAGCATTTT	CASSQTGKYQPQHF	TRBV3-1	TRBJ1-5
TGTGCCACCAGTGATTCCAGCTGGGGCTACACCTTC	CATSDSSWGYTF	TRBV24-1	TRBJ1-2
TGTGCCAGCAGAAACCGGGAGGAGGTTGTCCCTAACTATGGCTACACCTTC	CASRNREEVVPNYGYTF	TRBV6-5	TRBJ1-2
TGTGCCAGCAGTCTTTGGGACAGGGGTGAAGAGACCCAGTACTTC	CASSLWDRGEETQYF	TRBV28	TRBJ2-5
TGTGCCAGCAGCATAGGAGAGTGGGTCGAAGAGCAGTTCTTC	CASSIGEWVEEQFF	TRBV7-9	TRBJ2-1
TGTGCCAGCAGTTTTCCCGAACGGACTCTGGGCGATTACACCGGGGAGCTGTTTTTT	CASSFPERTLGDYTGELFF	TRBV27	TRBJ2-2
TGTGCCAGCAGCCATGCGGAGACCCAGTACTTC	CASSHAETQYF	TRBV7-8	TRBJ2-5
TGTGCCAGTAGCATAGCGGGCGGCGATACGCAGTATTTT	CASSIAGGDTQYF	TRBV19	TRBJ2-3
TGTGCCAGCAGTATGACGGGCCAAGAGACCCAGTACTTC	CASSMTGQETQYF	TRBV27	TRBJ2-5
TGCAGTGCTAGTCGAAGATCCCCAGGGCCTCAGGGGATGAGCTCCTACGAGCAGTACTTC	CSASRRSPGPQGMSSYEQYF	TRBV20-1	TRBJ2-7
TGTGCCAGCAAGGGACAGGGGGCCAAATCCTACGAGCAGTACTTC	CASKGQGAKSYEQYF	TRBV6-6	TRBJ2-7
TGCGCCAGCAGCTTGCCGGCGGGCCAAGAGACCCAGTACTTC	CASSLPAGQETQYF	TRBV5-1	TRBJ2-5
TGTGCCAGCAGCTTAGCGGACAGGGATATGAGCTCCAATCAGCCCCAGCATTTT	CASSLADRDMSSNQPQHF	TRBV7-9	TRBJ1-5
TGTGCTAGTGGCCCCCATCCGGGACAGGGTTCATATGGCTACACCTTC	CASGPHPGQGSYGYTF	TRBV12-5	TRBJ1-2
TGTGCCAGCTCACCCTTAGGGGTAGCGGGAATGGATGAAAAACTGTTTTTT	CASSPLGVAGMDEKLFF	TRBV18	TRBJ1-4
TGTGCCAGCAGCCTTGGTAGCGGGCTGGTGAAAGAGACCCAGTACTTC	CASSLGSGLVKETQYF	TRBV3-1	TRBJ2-5
TGCAGTGCTAGAGGACTGGGACAGTTCCCACAAGAGACCCAGTACTTC	CSARGLGQFPQETQYF	TRBV20-1	TRBJ2-5
TGCGCCAGCAGCTTGGAGGCGGGAGGCACTGAAGCTTTCTTT	CASSLEAGGTEAFF	TRBV5-1	TRBJ1-1
TGTGCCAGCAGGGGACTAGCGGGGTCGGCGAACACCGGGGAGCTGTTTTTT	CASRGLAGSANTGELFF	TRBV6-1	TRBJ2-2
TGTGCCACCAGTGATGCGGGAGTGGACTTC	CATSDAGVDF	TRBV24-1	TRBJ2-7
TGTGCCAGCAGCTTAGATTCGGGGGCGAACACCGGGGAGCTGTTTTTT	CASSLDSGANTGELFF	TRBV11-3	TRBJ2-2
TGTGCCAGCAAGTTGGACAGGGTCCCGGTCGCTCAGCCCCAGCATTTT	CASKLDRVPVAQPQHF	TRBV9	TRBJ1-5
TGCAGTGCCCCCAGGGCCTCTGAGACCCAGTACTTC	CSAPRASETQYF	TRBV20-1	TRBJ2-5
TGTGCCAGCAGCTTACCAATTGCCCGGTTTGACAGGCCAGAGGTGAACACTGAAGCTTTCTTT	CASSLPIARFDRPEVNTEAFF	TRBV11-1	TRBJ1-1
TGTGCCAGCAGCCAAGCGAAGAATTCTCGACGCGAGGAGGCTTTCTTT	CASSQAKNSRREEAFF	TRBV14	TRBJ1-1
TGTGCCAGCAGTTTTTGCCCCCTTCCTAGCATCAGAGTGTTGACCCAGTACTTC	CASSFCPLPSIRVLTQYF	TRBV27	TRBJ2-5
TGTGCCAGCAGCTTAGTAAACGGATCATACTCCTACGAGCAGTACTTC	CASSLVNGSYSYEQYF	TRBV11-3	TRBJ2-7
TGTGCCAGCAGCGAACCCGCGTCTGAAACAGATACGCAGTATTTT	CASSEPASETDTQYF	TRBV9	TRBJ2-3
TGTGCCAGCCGATACTCTGGAAACACCATATATTTT	CASRYSGNTIYF	TRBV6-2	TRBJ1-3
TGTGCCAGCAGCCTTGTCCCGGGGGGACGAAGCTCCTATAATTCACCCCTCCACTTT	CASSLVPGGRSSYNSPLHF	TRBV7-9	TRBJ1-6
TGTGCCAGCAGCGGTTTCCATGACAGGGGCTATGGCTACACCTTC	CASSGFHDRGYGYTF	TRBV9	TRBJ1-2
TGTGCCAGCAGCTCCGGACTAGCGCTCGTGGAGACCCAGTACTTC	CASSSGLALVETQYF	TRBV27	TRBJ2-5
TGCAGTGCTAGGGGACAGGTTTGGTTTGAGACCCAGTACTTC	CSARGQVWFETQYF	TRBV20-1	TRBJ2-5
TGCGCCAGCAGCCAAAGGACCAGACTAGCGGGAGAGGAAGCTTTCTTT	CASSQRTRLAGEEAFF	TRBV4-3	TRBJ1-1
TGTGCCAGCAGTTTAAATTACAGGATGGAGGGGAGGGCAAAACTGTTTTTT	CASSLNYRMEGRAKLFF	TRBV28	TRBJ1-4
TGTGCCAGCAGCAGGGACCGACTCAATGAGCAGTTCTTC	CASSRDRLNEQFF	TRBV7-9	TRBJ2-1
TGTGCCAGCAGCTTCCCGTCTCTCGGGACGACGTACGAGCAGTACTTC	CASSFPSLGTTYEQYF	TRBV7-3	TRBJ2-7
TGTGCCAGCAGCCAAGATGGGGGTTCCCGGACCCGCTCCTACGAGCAGTACTTC	CASSQDGGSRTRSYEQYF	TRBV3-1	TRBJ2-7
TGTGCCAGTAGACCTTACAGTGAGCAGTTCTTC	CASRPYSEQFF	TRBV19	TRBJ2-1
TGTGCCACCAGTGATTTGCAGTCACAGGGTGAGTCAACCGGAAACACCATATATTTT	CATSDLQSQGESTGNTIYF	TRBV24-1	TRBJ1-3
TGTGCCAGCAGTTTATGGTCCAGCCTAGGCTACACCTTC	CASSLWSSLGYTF	TRBV27	TRBJ1-2
TGTGCCAGTAGTGCCAGCGGGAACGAGCAGTACTTC	CASSASGNEQYF	TRBV19	TRBJ2-7
TGTGCCAGCAGTCGGGGGGGGAGACCCTACGAGCAGTACTTC	CASSRGGRPYEQYF	TRBV27	TRBJ2-7
TGTGCCTGGACCCGGGCCCGGCCCTACGAGCAGTACTTC	CAWTRARPYEQYF	TRBV30	TRBJ2-7
TGTGCCAGCAGCGGACAGACGGCGGGGCTCGAGCAGTACTTC	CASSGQTAGLEQYF	TRBV7-4	TRBJ2-7
TGTGCCAGCACCCCGTGTCGGGCCCCAAGGGCGGTAGTGGAGACCCAGTACTTC	CASTPCRAPRAVVETQYF	TRBV25-1	TRBJ2-5
TGTGCCAGCAGCTTCACTTCGGTTGGGCCGGGACAGGGGTCCCAATACGAGCAGTACTTC	CASSFTSVGPGQGSQYEQYF	TRBV7-4	TRBJ2-7
TGTGCCAGCAGTTCCCCCAGCGAATCCTACGAGCAGTACTTC	CASSSPSESYEQYF	TRBV28	TRBJ2-7
TGCGCCAGCAGCAAGCCGGGGAGGGGCCTCTCCGACTCCTACGAGCAGTACTTC	CASSKPGRGLSDSYEQYF	TRBV5-1	TRBJ2-7
TGCGCCAGCAGCCAGGGGGGTTCAAAACTGTTTTTT	CASSQGGSKLFF	TRBV4-1	TRBJ1-4
TGTGCCACCTCCTCTTTGGCGGGACAGGGTTCGCAAGAGACCCAGTACTTC	CATSSLAGQGSQETQYF	TRBV24-1	TRBJ2-5
TGCGCCAGCAGCTCGGCCCCGGTTGACGCCAAAAACATTCAGTACTTC	CASSSAPVDAKNIQYF	TRBV5-1	TRBJ2-4
TGTGCCAGCCAGGGACTAGCGGGGTTTTGCGAGCAGTACTTC	CASQGLAGFCEQYF	TRBV7-9	TRBJ2-7
TGTGCCAGCACCTACTGGGGAGAGACCCAGTACTTC	CASTYWGETQYF	TRBV28	TRBJ2-5
TGTGCCAGCAGCTACGGCGGGAGTGCGCAGTATTTT	CASSYGGSAQYF	TRBV11-3	TRBJ2-3
TGTGCCAGCAGGTGCCGACCGGACCCAAACACCATATATTTT	CASRCRPDPNTIYF	TRBV6-4	TRBJ1-3
TGTGCCAGCTCCCCCAACGGCCCAGGTCCTAGCTCCTATAATTCACCCCTCCACTTT	CASSPNGPGPSSYNSPLHF	TRBV6-1	TRBJ1-6
TGTGCCAGCAGCTTAGAGGCTCAGGGGAGAGCTTTCTTT	CASSLEAQGRAFF	TRBV11-3	TRBJ1-1
TGTGCCAGCAGTGGGAAATGCGAGCAGTACTTC	CASSGKCEQYF	TRBV28	TRBJ2-7
TGTGCCAGACTAGTCGACAGGGGGCGAGCGAACACTGAAGCTTTCTTT	CARLVDRGRANTEAFF	TRBV9	TRBJ1-1
TGTGCCAGCAGCTTAGGGCTATCCTTGACAGTAGAGACCCAGTACTTC	CASSLGLSLTVETQYF	TRBV13	TRBJ2-5
TGTGCCAGCAGCTTGTCTGGGACTAGCGGGCCAGCTTACAATGAGCAGTTCTTC	CASSLSGTSGPAYNEQFF	TRBV5-4	TRBJ2-1
TGTGCCAGCAGTTACTCAAGACAGAACGATGAGCAGTTCTTC	CASSYSRQNDEQFF	TRBV6-2	TRBJ2-1
TGTGCCAGCAGTTACTCGTCGACGAATAGCTCCTACGAGCAGTACTTC	CASSYSSTNSSYEQYF	TRBV6-6	TRBJ2-7
TGTGCCAGCAGCAAAGAGGGGGGAGTCCCTAATGAAAAACTGTTTTTT	CASSKEGGVPNEKLFF	TRBV11-3	TRBJ1-4
TGTGCTAGTGGTTTGGTATTCGACAGATGTAACTATGGCTACACCTTC	CASGLVFDRCNYGYTF	TRBV12-5	TRBJ1-2
TGCGCCAGCAGCTGTCATGGACAGGGACGAAACTATGGCTACACCTTC	CASSCHGQGRNYGYTF	TRBV5-1	TRBJ1-2
TGTGCCATATCTCCCTATTTTCAAAGGACCCAGTACTTC	CAISPYFQRTQYF	TRBV28	TRBJ2-5
TGCGCCAAGCGAACAGGGGTCAGCAATCAGCCCCAGCATTTT	CAKRTGVSNQPQHF	TRBV10-1	TRBJ1-5
TGTGCCAGCAGTCACCCACATCGACACGATTATGGCTACACCTTC	CASSHPHRHDYGYTF	TRBV12-3	TRBJ1-2
TGTGCCAGCAGTTTCCGGGACTCTGGGGCCAACGTCCTGACTTTC	CASSFRDSGANVLTF	TRBV27	TRBJ2-6
TGTGCCAGCAGGGGATCAGATACGCAGTATTTT	CASRGSDTQYF	TRBV2	TRBJ2-3
TGTGGGGAGGGGCAGGCTGTTGAAAAACTGTTTTTT	CGEGQAVEKLFF	TRBV27	TRBJ1-4
TGCGCCAGCAGAGGGGGTGCTAACTATGGCTACACCTTC	CASRGGANYGYTF	TRBV5-1	TRBJ1-2
TGTGCCAGTAGTATTGGAACCTACGAGCAGTACTTC	CASSIGTYEQYF	TRBV19	TRBJ2-7
TGTGCCCAACCCCTGAATACTGAAGCTTTCTTT	CAQPLNTEAFF	TRBV25-1	TRBJ1-1
TGTGCCAGGGTCAACGAGCAGTACTTC	CARVNEQYF	TRBV6-2	TRBJ2-7
TGTGCCAGCAGCAGCCAACGGACTAGCGGGTGGAAAGATACGCAGTATTTT	CASSSQRTSGWKDTQYF	TRBV12-3	TRBJ2-3
TGTGCCAGCAGGCCACTGACAGATTCCTATGGCTACACCTTC	CASRPLTDSYGYTF	TRBV6-3	TRBJ1-2
TGTGCCAGCAGCTACAGGAGGGGGAACACTGAAGCTTTCTTT	CASSYRRGNTEAFF	TRBV7-3	TRBJ1-1
TGCAGCGTTGAAGGAGAGGACGAGCAGTACTTC	CSVEGEDEQYF	TRBV29-1	TRBJ2-7
TGCGCCAGCAGCTTGAACGGAAGACTAGCGGGTAGCACAGATACGCAGTATTTT	CASSLNGRLAGSTDTQYF	TRBV5-1	TRBJ2-3
TGTGCCAGCAGCTTATGTCACCACGCTTCCTACAATGAGCAGTTCTTC	CASSLCHHASYNEQFF	TRBV5-4	TRBJ2-1
TGTGCCAGCATTGCGGGACTAGCCAAAAACATTCAGTACTTC	CASIAGLAKNIQYF	TRBV27	TRBJ2-4
TGTGCCAGCAGCCTGGAGAAGACAGTTATTAACTATGGCTACACCTTC	CASSLEKTVINYGYTF	TRBV7-9	TRBJ1-2
TGTGCCATCACTCCGACTAGCGCCTCCTACAATGAGCAGTTCTTC	CAITPTSASYNEQFF	TRBV10-3	TRBJ2-1
TGCGCCAGCAGCCAAGATGGCCGGCCCGTTTCAAGGACAGGGCCTACGCAGTATTTT	CASSQDGRPVSRTGPTQYF	TRBV4-1	TRBJ2-3
TGTGCCAGCAGCACACAGGGCACAGATACGCAGTATTTT	CASSTQGTDTQYF	TRBV13	TRBJ2-3
TGTGCCAGCAGTTCCGGGACAGGGAGTCGGAACACTGAAGCTTTCTTT	CASSSGTGSRNTEAFF	TRBV27	TRBJ1-1
TGTGCCACCAGCAGTAGGGGGGCAACCGGCTACAATGAGCAGTTCTTC	CATSSRGATGYNEQFF	TRBV15	TRBJ2-1
TGCGCCAGCAGCTTGACACTAGCGGGAGCGAACTATGGCTACACCTTC	CASSLTLAGANYGYTF	TRBV5-1	TRBJ1-2
TGTGCCAGCAGCCGACAGGGTAGTTCACCCCTCCACTTT	CASSRQGSSPLHF	TRBV27	TRBJ1-6
TGTGCCAGCAGCAGGAACTACGAGCAGTACTTC	CASSRNYEQYF	TRBV6-1	TRBJ2-7
TGTGCCAGCAGTGGGAAGGCGGCCAGGGACTATGGCTACACCTTC	CASSGKAARDYGYTF	TRBV7-6	TRBJ1-2
TGTGCCAGCAGCTTGTCCCAGGGGTATAATGAAAAACTGTTTTTT	CASSLSQGYNEKLFF	TRBV13	TRBJ1-4
TGTGCCAGCATCTCGGGACGAGAAGCTTTCTTT	CASISGREAFF	TRBV6-4	TRBJ1-1
TGCGCCAGCAGCAAGAGGGACGGCTATAATTCACCCCTCCACTTT	CASSKRDGYNSPLHF	TRBV10-1	TRBJ1-6
TGTGCCATCAGGTCCCTGTTCCGAGAAGCTTACCATAGCAATCAGCCCCAGCATTTT	CAIRSLFREAYHSNQPQHF	TRBV10-3	TRBJ1-5
TGCGCCAGCAGCTTGGCCCGTACTGGGACATTCTACGAGCAGTACTTC	CASSLARTGTFYEQYF	TRBV5-1	TRBJ2-7
TGTGCCAGCAGTGAGGACTTTTCTAGCGGTGAGCAGTTCTTC	CASSEDFSSGEQFF	TRBV6-1	TRBJ2-1
TGTGCCAGCAGCTTATGGACGACACAGCCTTGGTCTCAGCCCCAGCATTTT	CASSLWTTQPWSQPQHF	TRBV7-9	TRBJ1-5
TGTGCCAGCAGCTTAGCTATATGGACAGGGAGTGAAAAACTGTTTTTT	CASSLAIWTGSEKLFF	TRBV7-4	TRBJ1-4
TGTGCCGAATACAGAAGGGGACAGTATGATCAGCCCCAGCATTTT	CAEYRRGQYDQPQHF	TRBV12-3	TRBJ1-5
TGTGCCAGCAGCTTGGCCCTCCTACAGGTCGGCAATCAGCCCCAGCATTTT	CASSLALLQVGNQPQHF	TRBV5-6	TRBJ1-5
TGTGCCAGCAGCCCTCGGTCCCTCGACAGGGTGGATAGCAATCAGCCCCAGCATTTT	CASSPRSLDRVDSNQPQHF	TRBV13	TRBJ1-5
TGTGCCAGCACCTGCGATGAAAAACTGTTTTTT	CASTCDEKLFF	TRBV27	TRBJ1-4
TGTGCCAGCAGCTTAACACCGCATCACAGGGCCTTCAAGTATGAAAAACTGTTTTTT	CASSLTPHHRAFKYEKLFF	TRBV5-6	TRBJ1-4
TGTGCCAGCTCACCCCCATCAGGGGGGCTTCTACGGTGCTACGAGCAGTACTTC	CASSPPSGGLLRCYEQYF	TRBV18	TRBJ2-7
TGTGCCAGCAGCTTGGACATTGGGGGCCCGACCGGGGAGCTGTTTTTT	CASSLDIGGPTGELFF	TRBV5-4	TRBJ2-2
TGTGCCAGCAGCTTAGGAGGGGCGGGTATCGACACTGAAGCTTTCTTT	CASSLGGAGIDTEAFF	TRBV7-6	TRBJ1-1
TGTGCCAGCAGCCAAGATACCCAGGGAGATGGCTACACCTTC	CASSQDTQGDGYTF	TRBV14	TRBJ1-2
TGCGCTCAAGGACAGGAAGTAAACACTGAAGCTTTCTTT	CAQGQEVNTEAFF	TRBV10-1	TRBJ1-1
TGTGATATAGGGGGACAATTCAATGAGCAGTTCTTC	CDIGGQFNEQFF	TRBV7-4	TRBJ2-1
TGCAGTGCGGGACGTCGTTTAATCCGGAAGAGTATTGAGCAGTTCTTC	CSAGRRLIRKSIEQFF	TRBV20-1	TRBJ2-1
TGCGCCAGCAGCCCGAGGAAATCTGAGGAACACATTAGCAATCAGCCCCAGCATTTT	CASSPRKSEEHISNQPQHF	TRBV4-1	TRBJ1-5
TGTGCCATCAAAGGACAGGACGGACCTGGCTACACCTTC	CAIKGQDGPGYTF	TRBV24-1	TRBJ1-2
TGTGCCAGTAGTTGGGAGGGATTAGACCTGAAGAGCTCCTACGAGCAGTACTTC	CASSWEGLDLKSSYEQYF	TRBV19	TRBJ2-7
TGCAGTGCTAGGGTGGCTGGGAGCTCCTACGAGCAGTACTTC	CSARVAGSSYEQYF	TRBV20-1	TRBJ2-7
TGTGCCAGCAGCCTCCGGGACAGGGTGGCCGCTGAAGCTTTCTTT	CASSLRDRVAAEAFF	TRBV13	TRBJ1-1
TGTGCCAGCACAAAGACAGGGCATAAGGCGGGTAATCAGCCCCAGCATTTT	CASTKTGHKAGNQPQHF	TRBV25-1	TRBJ1-5
TGTGCCAGCAGTGAAGCGCTTAGCGGGGCGCCGTACGAGCAGTACTTC	CASSEALSGAPYEQYF	TRBV2	TRBJ2-7
TGCAGTGCTAGTTACCTTTGGGGGGTGGATGGGTCCTACAATGAGCAGTTCTTC	CSASYLWGVDGSYNEQFF	TRBV20-1	TRBJ2-1
TGTGCCACCAGCACGGGACAGGGAGGATACTATGGCTACACCTTC	CATSTGQGGYYGYTF	TRBV15	TRBJ1-2
TGTGCCAGCAGCCCCCGGATTAACTATGGCTACACCTTC	CASSPRINYGYTF	TRBV13	TRBJ1-2
TGCGCCAGCAGCCAAGATGGAGCTCGGGCACCCCTCCACTTT	CASSQDGARAPLHF	TRBV4-3	TRBJ1-6
TGTGCCACAACATGCTATGGCTACACCTTC	CATTCYGYTF	TRBV25-1	TRBJ1-2
TGCAGTAGGACAGGGTATGGCTACACCTTC	CSRTGYGYTF	TRBV20-1	TRBJ1-2
TGCAGCGTTGAAGATCTTGTGGAGGGCTATAATTCACCCCTCCACTTT	CSVEDLVEGYNSPLHF	TRBV29-1	TRBJ1-6
TGTGCCAGCAGCCGTCAACTTCATCTGGACTATGGCTACACCTTC	CASSRQLHLDYGYTF	TRBV3-1	TRBJ1-2
TGTGCCAGCAGCCCCGATGCCCCCCTGACCCGGGCCTACGAGCAGTACTTC	CASSPDAPLTRAYEQYF	TRBV3-1	TRBJ2-7
TGTGCCAGCAGTTTAGTCGCGTCAGGGTTGTCCACTGAAGCTTTCTTT	CASSLVASGLSTEAFF	TRBV12-3	TRBJ1-1
TGTGCCAGCCCGGGACAGGGGGGTTCTTTCGTGAGAGCGAACTATGGCTACACCTTC	CASPGQGGSFVRANYGYTF	TRBV6-1	TRBJ1-2
TGTGCCAGCAGCTGGACAGGGCCAATAATGAACACTGAAGCTTTCTTT	CASSWTGPIMNTEAFF	TRBV7-9	TRBJ1-1
TGTGCCATCAAGCTGGGACAGGTCATGAACACTGAAGCTTTCTTT	CAIKLGQVMNTEAFF	TRBV10-3	TRBJ1-1
TGTGCCTGGAGGTACGGACAGCCTCAGCCCCAGCATTTT	CAWRYGQPQPQHF	TRBV30	TRBJ1-5
TGTGCCAGCAGCCACCTCCTCCACAGGGAGGACAACACTGAAGCTTTCTTT	CASSHLLHREDNTEAFF	TRBV3-1	TRBJ1-1
TGTGCCAGCAGCCCCGTTTACAGGGGGCTCTACGAGCAGTACTTC	CASSPVYRGLYEQYF	TRBV7-2	TRBJ2-7
TGTGCCAGCGGATACAGGGCCTACGAGCAGTACTTC	CASGYRAYEQYF	TRBV6-1	TRBJ2-7
TGTGCCAGCAGCCAAGTCGGGACAGGGGCCGATGCCTACGAGCAGTACTTC	CASSQVGTGADAYEQYF	TRBV3-1	TRBJ2-7
TGTGCCAGCAGTTTTTTTTGGGAGGGCGGGCGAGGCTACACCTTC	CASSFFWEGGRGYTF	TRBV27	TRBJ1-2
TGTGCCAGCAGTGCTTTTGCAGATACGCAGTATTTT	CASSAFADTQYF	TRBV6-4	TRBJ2-3
TGCGCCAGCACCCTCGCTAGTGTCCCAGGGGTAGATACGCAGTATTTT	CASTLASVPGVDTQYF	TRBV10-1	TRBJ2-3
TGTGCCAGCGAGGGGATAACCTACGAGCAGTACTTC	CASEGITYEQYF	TRBV27	TRBJ2-7
TGCAGTGCAAGAGGGACAGGGCGTAGGGCTTTCTTT	CSARGTGRRAFF	TRBV20-1	TRBJ1-1
TGTGCCAGCAGCCCAAGTGGACTAGAGTACAATGAGCAGTTCTTC	CASSPSGLEYNEQFF	TRBV13	TRBJ2-1
TGTGCCAGCAGCCTTTCGCTAAGCAATCAGCCCCAGCATTTT	CASSLSLSNQPQHF	TRBV14	TRBJ1-5
TGCGCCAGCAGCTTTAAGTATCAGCCCCAGCATTTT	CASSFKYQPQHF	TRBV5-1	TRBJ1-5
TGTGCCAGCAGTGAACAGCGGGAGAGAAGAAACACCATATATTTT	CASSEQRERRNTIYF	TRBV2	TRBJ1-3
TGCGCCAGCAGCGTCGACAGGGCTCCGAGCGAGCAGTACTTC	CASSVDRAPSEQYF	TRBV5-1	TRBJ2-7
TGTGCCAGCCCTTTGGTCGCCCGGGACAGGGGGCATTCTGAGACCCAGTACTTC	CASPLVARDRGHSETQYF	TRBV2	TRBJ2-5
TGTGCCAGTAGTGGGACATGCTATCCAAACTATGGCTACACCTTC	CASSGTCYPNYGYTF	TRBV19	TRBJ1-2
TGTGCCAGCAGCCGGGAAGGGAGCTCACCTAAACCTAGGCTGGACTACGAGCAGTACTTC	CASSREGSSPKPRLDYEQYF	TRBV13	TRBJ2-7
TGTGCCAGCAGCTTAAGGCCCCGGGACAGCCACGGGGGTCAGCAACCAGATGGGACTGAAGCTTTCTTT	CASSLRPRDSHGGQQPDGTEAFF	TRBV7-4	TRBJ1-1
TGTGCCAGCAGTTTATGTTCCCCCGGGACAGGGGGGGTTACCTACGAGCAGTACTTC	CASSLCSPGTGGVTYEQYF	TRBV27	TRBJ2-7
TGCGCCAGCAGTAGGGGGGCGTTCGTTTATGAGCAGTTCTTC	CASSRGAFVYEQFF	TRBV5-1	TRBJ2-1
TGTGCCATCACCACTACCGCCCCACCCGGAGCAGGGAGTCCTGGGAGTGGCTACACCTTC	CAITTTAPPGAGSPGSGYTF	TRBV10-3	TRBJ1-2
TGTGCCATGCTCAGCTTTAATGAAAAACTGTTTTTT	CAMLSFNEKLFF	TRBV28	TRBJ1-4
TGTGCCAGCAGTGTCCTCCCCCAGCCCCAGCATTTT	CASSVLPQPQHF	TRBV6-3	TRBJ1-5
TGTGCTAGTGATCCCCAATGGGGAACAGGGGGGGGGGAGCTGTTTTTT	CASDPQWGTGGGELFF	TRBV12-5	TRBJ2-2
TGTGCCAGCAGTGGGACATGCCATGAGCAGTTCTTC	CASSGTCHEQFF	TRBV6-4	TRBJ2-1
TGTGCCAGCAGTTCCCGAGGTTTATACAATGAGCAGTTCTTC	CASSSRGLYNEQFF	TRBV6-3	TRBJ2-1
TGTGCCAGCAGGTGGAGGGACAGAAGGGGCGAGCAGTACTTC	CASRWRDRRGEQYF	TRBV5-6	TRBJ2-7
TGTGCCCCCCAACGGGACCCGGCAGATACGCAGTATTTT	CAPQRDPADTQYF	TRBV24-1	TRBJ2-3
TGTGCCACCAGTGATAGTCAGGAACCCCAGTACTTC	CATSDSQEPQYF	TRBV24-1	TRBJ2-5
TGCGCCAGCAGCAGAGGGAATCAGCCCCAGCATTTT	CASSRGNQPQHF	TRBV5-1	TRBJ1-5
TGTGCCAGCAGAGTCCAAGAAGAGTATAAAAACCAGGGCACCAACTATGGCTACACCTTC	CASRVQEEYKNQGTNYGYTF	TRBV6-1	TRBJ1-2
TGCGCCAGCAGCCAGGGGGACAACACCGGGGAGCTGTTTTTT	CASSQGDNTGELFF	TRBV4-3	TRBJ2-2
TGCAGCGAAGGCAGGGGGCACACCCAGTACTTC	CSEGRGHTQYF	TRBV29-1	TRBJ2-5
TGTGCCAGGCCACTCTGCTCTGGGGCCAACGTCCTGACTTTC	CARPLCSGANVLTF	TRBV5-4	TRBJ2-6
TGTGCCAGCAGTTACGGGGACAGTTACAATGAGCAGTTCTTC	CASSYGDSYNEQFF	TRBV6-5	TRBJ2-1
TGTGCCACCAGCAGAGATAAAGGGCTACAGGGGGTATGTAACTATGGCTACACCTTC	CATSRDKGLQGVCNYGYTF	TRBV15	TRBJ1-2
TGTGCCAGCAACGAGACCCAGTACTTC	CASNETQYF	TRBV12-3	TRBJ2-5
TGTGCCACCAGTGTCATTCTGACAGCCCGAAGCTACGAGCAGTACTTC	CATSVILTARSYEQYF	TRBV24-1	TRBJ2-7
TGTGCCAGCAGTTTGTGTGACTTCCGGTATGGCTACACCTTC	CASSLCDFRYGYTF	TRBV27	TRBJ1-2
TGTGCCAGCACCGGGACAGGGTGTAGCAATCAGCCCCAGCATTTT	CASTGTGCSNQPQHF	TRBV6-4	TRBJ1-5
TGTGCCAGCAGCACCGAGGGCCCCGTCTATGGCTACACCTTC	CASSTEGPVYGYTF	TRBV12-3	TRBJ1-2
TGTGCCACCAGCAGAGAAGAAGGGGGTGGAAGAGATGGCTACACCTTC	CATSREEGGGRDGYTF	TRBV15	TRBJ1-2
TGTGCCAGCAGTTACTCTCTAGGGCAGCCCCAGCATTTT	CASSYSLGQPQHF	TRBV6-2	TRBJ1-5
TGTGCCAGCAAGCGGGACATTTTCGACGAGCAGTACTTC	CASKRDIFDEQYF	TRBV2	TRBJ2-7
TGCGCCAGCAGCCAAGATCCAAAGGACAGGGGGCAAGAGACCCAGTACTTC	CASSQDPKDRGQETQYF	TRBV4-1	TRBJ2-5
TGTGCCAGCGCCAAGGTAACGGGGTTGAACACTGAAGCTTTCTTT	CASAKVTGLNTEAFF	TRBV9	TRBJ1-1
TGTGCCTGGGGACGGAGAGTTTCACCCCTCCACTTT	CAWGRRVSPLHF	TRBV30	TRBJ1-6
TGTGCCAGCAGTGGAGAAACACAGGGGAACCGCACTGAAGCTTTCTTT	CASSGETQGNRTEAFF	TRBV6-1	TRBJ1-1
TGCGCCAGCAGCTCGCCAGGTCACGGGCTGAGGGAGTGCACAGATACGCAGTATTTT	CASSSPGHGLRECTDTQYF	TRBV5-1	TRBJ2-3
TGTGCCAGCAGCCAAGACGGGGGGACAGGGGTCCTCATCTACGAGCAGTACTTC	CASSQDGGTGVLIYEQYF	TRBV3-1	TRBJ2-7
TGTGCCAGCAGTGAAAAAGGGGGTGCTTACGAGCAGTACTTC	CASSEKGGAYEQYF	TRBV6-1	TRBJ2-7
TGTGCCAGCAGCCGGTACCAGACGGACAGGGCCCTCTACTATGGCTACACCTTC	CASSRYQTDRALYYGYTF	TRBV3-1	TRBJ1-2
TGCGCCAGCAGCGGTGCCGGTTACGAGCAGTACTTC	CASSGAGYEQYF	TRBV10-1	TRBJ2-7
TGCAGTGGGGGACAGTCTGGGGCCAACGTCCTGACTTTC	CSGGQSGANVLTF	TRBV20-1	TRBJ2-6
TGCGCCAGCAGCCAGGCCCAGTTGGTTAATCAGCCCCAGCATTTT	CASSQAQLVNQPQHF	TRBV5-1	TRBJ1-5
TGCGCCAGCAGTGATGGGACTAGCGGGGTTCACTCTCGGAACGAGCAGTACTTC	CASSDGTSGVHSRNEQYF	TRBV10-1	TRBJ2-7
TGTGCCAGGAGGAGGGACAGGGTCACGGGTGGTCAGCCCCAGCATTTT	CARRRDRVTGGQPQHF	TRBV2	TRBJ1-5
TGTGCCAGCAGCTTAGCGGGGGGATCTCTCTATGGCTACACCTTC	CASSLAGGSLYGYTF	TRBV11-3	TRBJ1-2
TGTGCCAGCAGTGAGGGGGCGCAGCCCCAGCATTTT	CASSEGAQPQHF	TRBV25-1	TRBJ1-5
TGTGCCAGCAGCTTACGGGGACGGGAGTGGATAAACGGGGAGCTGTTTTTT	CASSLRGREWINGELFF	TRBV7-2	TRBJ2-2
TGTGCCTGGCAGTCAGGGACAGTTGAAGCTTTCTTT	CAWQSGTVEAFF	TRBV30	TRBJ1-1
TGTGCCAGCAGTGAATCCATGTCATATAACTATGGCTACACCTTC	CASSESMSYNYGYTF	TRBV2	TRBJ1-2
TGTGCCAGCAACCCCGACAGGGGCGACCACGGCTACACCTTC	CASNPDRGDHGYTF	TRBV6-1	TRBJ1-2
TGCGCCAGCAGCTTGAAAGAAGGGGACCGGTTAATGAGCTCCTACGAGCAGTACTTC	CASSLKEGDRLMSSYEQYF	TRBV5-1	TRBJ2-7
TGCAGTGTAGACAGGGTCTACTCCTACGAGCAGTACTTC	CSVDRVYSYEQYF	TRBV20-1	TRBJ2-7
TGTGCCAGCAGTTTATCGCGAACACGAAAGCCCCAGCATTTT	CASSLSRTRKPQHF	TRBV27	TRBJ1-5
TGTGCACGCGGGAGTCTTATGAACACTGAAGCTTTCTTT	CARGSLMNTEAFF	TRBV2	TRBJ1-1
TGTGCCAGCAGCTCCGGATCTAGCACAGATACGCAGTATTTT	CASSSGSSTDTQYF	TRBV7-9	TRBJ2-3
TGCGTACAGGGGGCGTTAGGATCTTGGAGCAATCAGCCCCAGCATTTT	CVQGALGSWSNQPQHF	TRBV5-1	TRBJ1-5
TGTGCCAGGGGCCGGGACACGACTAAAAGCAATCAGCCCCAGCATTTT	CARGRDTTKSNQPQHF	TRBV27	TRBJ1-5
TGTGCCAGATATAGCACAACGTCTTCTTTCCGGGACGAGTCATCTACCACAGATACGCAGTATTTT	CARYSTTSSFRDESSTTDTQYF	TRBV6-1	TRBJ2-3
TGTGCCAGCAGCTTATCAGGCTTGGAGACTGAAGCTTTCTTT	CASSLSGLETEAFF	TRBV11-2	TRBJ1-1
TGTGCCAGCAGGGGCCGGACGAAGTACTTC	CASRGRTKYF	TRBV12-3	TRBJ2-7
TGTGCCAGCAGGGGGAGGGGACCTGACACAGATACGCAGTATTTT	CASRGRGPDTDTQYF	TRBV6-5	TRBJ2-3
TGTGCCAGCAGCCGGTACCGGGGGCAAAAGAACACTGAAGCTTTCTTT	CASSRYRGQKNTEAFF	TRBV7-2	TRBJ1-1
TGTGCCAGCAGCTGGAGGGGGACTGGAAACACCATATATTTT	CASSWRGTGNTIYF	TRBV9	TRBJ1-3
TGCGCCAGCAGCTCTTATACTAGAAAGAAGATAACAGATACGCAGTATTTT	CASSSYTRKKITDTQYF	TRBV5-1	TRBJ2-3
TGTGCCAGCAGCGACGCCGACAGAACCAAAAACATTCAGTACTTC	CASSDADRTKNIQYF	TRBV9	TRBJ2-4
TGCGCCCACTACCGGGGCTGGGGGGCCTCTGGGGCCAACGTCCTGACTTTC	CAHYRGWGASGANVLTF	TRBV5-1	TRBJ2-6
TGCAGTGCGGACGAGACCAATCAGCCCCAGCATTTT	CSADETNQPQHF	TRBV20-1	TRBJ1-5
TGTGCCAGCAGCTTCCGTGACCTGGACAGGGGGGTAATGGATACGCAGTATTTT	CASSFRDLDRGVMDTQYF	TRBV7-2	TRBJ2-3
TGCGCCAGCAGTGACAGGGCTGGGGCCAACGTCCTGACTTTC	CASSDRAGANVLTF	TRBV10-1	TRBJ2-6
TGTGCCAGCTCACCTTTGTGCCGGGTATTTGGCTACACCTTC	CASSPLCRVFGYTF	TRBV18	TRBJ1-2
TGCGCCAGCCAGCCGCCAGCCAAAAACATTCAGTACTTC	CASQPPAKNIQYF	TRBV5-1	TRBJ2-4
TGTGCCAGCAGCCGGCAGTTCGGGGGGGTAGCTGGAAACACCATATATTTT	CASSRQFGGVAGNTIYF	TRBV3-1	TRBJ1-3
TGTGCCAGCAGCGGGACTAGCGGCAATGAGCAGTTCTTC	CASSGTSGNEQFF	TRBV13	TRBJ2-1
TGTGCCAGCAGCCTGTCAGGGAACACTGAAGCTTTCTTT	CASSLSGNTEAFF	TRBV11-2	TRBJ1-1
TGTGCCAGCAGTTCCGAAGGACTAGCGGGTGCGGACAATGAGCAGTTCTTC	CASSSEGLAGADNEQFF	TRBV28	TRBJ2-1
TGTGCCAGCAGCGCCGCGACTAGAGATACGCAGTATTTT	CASSAATRDTQYF	TRBV9	TRBJ2-3
TGTGCCAGCAGCATCTGGGAAGGATCCAGGGGTGGGCAGTACTTC	CASSIWEGSRGGQYF	TRBV9	TRBJ2-7
TGTGCCAGCAGCGTAGCAATAAAAGCGGACACCGGGGAGCTGTTTTTT	CASSVAIKADTGELFF	TRBV9	TRBJ2-2
TGTGCCAGCAGCGTAGTATTGGGACAGGGGAGTCTTGAAAAACTGTTTTTT	CASSVVLGQGSLEKLFF	TRBV9	TRBJ1-4
TGTGCCAGTAGTTGGAGGAACAGGGCGGGCTATGGCTACACCTTC	CASSWRNRAGYGYTF	TRBV19	TRBJ1-2
TGTGCCAGCAGCCAAGTGGGGCCCCTAGCCGATACGCAGTATTTT	CASSQVGPLADTQYF	TRBV3-1	TRBJ2-3
TGCGCCAGCAGCTTGGGGCAAACCGGCTACACCTTC	CASSLGQTGYTF	TRBV5-1	TRBJ1-2
TGTGCCAGCAGCCACTCAAATCAGGGAAGTTCCGAGCCCTCTTACCCCTACAATGAGCAGTTCTTC	CASSHSNQGSSEPSYPYNEQFF	TRBV14	TRBJ2-1
TGTGCCAGTACGCCAGGGCTCCGTACAACTAATGAAAAACTGTTTTTT	CASTPGLRTTNEKLFF	TRBV19	TRBJ1-4
TGTGCCAGCAGCCTTTGTGGGGGGCCAATAGAGACCCAGTACTTC	CASSLCGGPIETQYF	TRBV13	TRBJ2-5
TGTGCCAGTAGTATAGGACAGGGGTTCTCCTACGAGCAGTACTTC	CASSIGQGFSYEQYF	TRBV19	TRBJ2-7
TGCAGTGCTAGAGATGAGGTTCCCCTGAAATTGATGATTAATGAAAAACTGTTTTTT	CSARDEVPLKLMINEKLFF	TRBV20-1	TRBJ1-4
TGTGCCAGCAATGAGCGTCTCGAAAAACTGTTTTTT	CASNERLEKLFF	TRBV27	TRBJ1-4
TGTGCCTGGTACAGCGGGATATACAATGAGCAGTTCTTC	CAWYSGIYNEQFF	TRBV30	TRBJ2-1
TGTGCCAGCAGGGGGGGAGTTACAGATACGCAGTATTTT	CASRGGVTDTQYF	TRBV28	TRBJ2-3
TGTGCCAGCCCTCCTCTAGCGGGAAGCTCCCCTCCCCAGTACTTC	CASPPLAGSSPPQYF	TRBV9	TRBJ2-5
TGTGCCAGCAGTTACCCAGGAACGGACTCCTACGAGCAGTACTTC	CASSYPGTDSYEQYF	TRBV6-5	TRBJ2-7
TGTGCCAGCTCACCTAAGTTAGCGGGTTCCTACAATGAGCAGTTCTTC	CASSPKLAGSYNEQFF	TRBV18	TRBJ2-1
TGTGCCAGCAGGACTCGGTCCTCCTACGAGCAGTACTTC	CASRTRSSYEQYF	TRBV2	TRBJ2-7
TGCGCCAGCAGCCAGAGGACAGACTTAGGCAATCAGCCCCAGCATTTT	CASSQRTDLGNQPQHF	TRBV4-1	TRBJ1-5
TGCGCCAGCACCCCTTACAGGGGCGTGGATTCTGCAACTAATGAAAAACTGTTTTTT	CASTPYRGVDSATNEKLFF	TRBV10-2	TRBJ1-4
TGTGCCACCAGTGATCTGATACAGGGGCTGGACCATCAGCCCCAGCATTTT	CATSDLIQGLDHQPQHF	TRBV24-1	TRBJ1-5
TGTGCCAGCAGCTTCCCCCCTGTGGACAGGGCTATCCAGCCCCAGCATTTT	CASSFPPVDRAIQPQHF	TRBV7-9	TRBJ1-5
TGTGCCAGCGCGGAGAACACTGAAGCTTTCTTT	CASAENTEAFF	TRBV6-2	TRBJ1-1
TGCGCCAGCAGTCCTGGGACGTACGAAGACGAGCAGTACTTC	CASSPGTYEDEQYF	TRBV10-1	TRBJ2-7
TGTGCCAGCAGTTTATCCAATGCTACTGGTAGCAATCAGCCCCAGCATTTT	CASSLSNATGSNQPQHF	TRBV27	TRBJ1-5
TGTGCCAGCAGTGAATTGCTAGGCCGCATCGAGACCCAGTACTTC	CASSELLGRIETQYF	TRBV25-1	TRBJ2-5
TGTGCCTGGAGGATGCAGGTCAATCAGCCCCAGCATTTT	CAWRMQVNQPQHF	TRBV30	TRBJ1-5
TGTGCCAGTAGTTCCCAATCCGGACAGAATTCACCCCTCCACTTT	CASSSQSGQNSPLHF	TRBV19	TRBJ1-6
TGTGCCAGCAGCGGTAGCTACCCGACCGGGGTCACAGATACGCAGTATTTT	CASSGSYPTGVTDTQYF	TRBV9	TRBJ2-3
TGTGCCAGGCCCCGGGGCTACAATGAGCAGTTCTTC	CARPRGYNEQFF	TRBV19	TRBJ2-1
TGTGCCACGTGGGGGCTACTCGAGCAGTACTTC	CATWGLLEQYF	TRBV6-2	TRBJ2-7
TGTGCCAGCAGCTCGGCCTCAGGGGGCTGCTCTGGAAACACCATATATTTT	CASSSASGGCSGNTIYF	TRBV7-9	TRBJ1-3
TGTGCCAGCAGAACCTTTAGCGGGTTCGCCTACGAGCAGTACTTC	CASRTFSGFAYEQYF	TRBV7-2	TRBJ2-7
TGTGCCAGCAGTTTAGCCTCCGGGACAGGGGATCACTACGAGCAGTACTTC	CASSLASGTGDHYEQYF	TRBV28	TRBJ2-7
TGTGCCAGCAGCTTTTACAGGGGGCGGGGCAATCAGCCCCAGCATTTT	CASSFYRGRGNQPQHF	TRBV13	TRBJ1-5
TGTGCCAGCAGCGGTAATAACGTGGGACAGCCAACCCCAGTCAATCAGCCCCAGCATTTT	CASSGNNVGQPTPVNQPQHF	TRBV7-2	TRBJ1-5
TGTGCCAGCAGTTTACTGCTGGGCGCAACTAATGAAAAACTGTTTTTT	CASSLLLGATNEKLFF	TRBV28	TRBJ1-4
TGTGCCAGCTCGGGCGAGGACTATGGCTACACCTTC	CASSGEDYGYTF	TRBV25-1	TRBJ1-2
TGTGCCACCAGCAGAGCTAGGCTCAAGAGGGGATTAGAAGACTATGGCTACACCTTC	CATSRARLKRGLEDYGYTF	TRBV15	TRBJ1-2
TGTGCCATCAGCCCAGACAGGAGGCAAGAGACCCAGTACTTC	CAISPDRRQETQYF	TRBV10-3	TRBJ2-5
TGTGCCAGCAGACTCGGGGACAAGCGCACAGATACGCAGTATTTT	CASRLGDKRTDTQYF	TRBV6-4	TRBJ2-3
TGTGCCAGCAGTTTAAGACGGTACGAGCAGTACTTC	CASSLRRYEQYF	TRBV28	TRBJ2-7
TGCAGTGCTCGTATCGGCGGGGTGATAAAAGCGGAAGGCTACACCTTC	CSARIGGVIKAEGYTF	TRBV20-1	TRBJ1-2
TGTGCCAGCAGCTTAGGCCCGTTTGTTATGAACACTGAAGCTTTCTTT	CASSLGPFVMNTEAFF	TRBV7-9	TRBJ1-1
TGTGCCAGCAGAGGGACTAGCGGGAGAAGGGAAGCGACCCAGGCGAACACCGGGGAGCTGTTTTTT	CASRGTSGRREATQANTGELFF	TRBV27	TRBJ2-2
TGTGCCAGCAGCCCGGGACAGGGGAGGGCTTTCTTT	CASSPGQGRAFF	TRBV7-2	TRBJ1-1
TGTGCCAGCAGTAGCTACCTAGAAAAACTGTTTTTT	CASSSYLEKLFF	TRBV6-1	TRBJ1-4
TGTGCCAGCAGAAGGCCGGGGTGCTCTGGAAACACCATATATTTT	CASRRPGCSGNTIYF	TRBV6-2	TRBJ1-3
TGTGCCAGCAGCCAAGTTGGACAGGTACGTCTAACTGAAGCTTTCTTT	CASSQVGQVRLTEAFF	TRBV14	TRBJ1-1
TGTGCCAGCAGCTTGACCTCCGATCCGGGACAGGGGTCCCGGTGCCACAATCAGCCCCAGCATTTT	CASSLTSDPGQGSRCHNQPQHF	TRBV5-6	TRBJ1-5
TGTGCCACCAGCTTCGGGGAGCCCTTGTTGCATTTT	CATSFGEPLLHF	TRBV15	TRBJ1-5
TGTGCCATCCCCGATGAGGTCGCTAGCACAGATACGCAGTATTTT	CAIPDEVASTDTQYF	TRBV19	TRBJ2-3
TGTGCCAGCAGTGAAGTCCCCCTCAGGGTGATCTACGAGCAGTACTTC	CASSEVPLRVIYEQYF	TRBV2	TRBJ2-7
TGTGCCAGCAGTGGTACAATCCCCCCTCCCGACAGCCTATTGCCCCAGCATTTT	CASSGTIPPPDSLLPQHF	TRBV6-5	TRBJ1-5
TGTGCCTGGAGTGTCTCCTCCAGTCCCACTGAAGCTTTCTTT	CAWSVSSSPTEAFF	TRBV30	TRBJ1-1
TGTGCCAGCAGCGAGGCGGGGAATCAGCCCCAGCATTTT	CASSEAGNQPQHF	TRBV13	TRBJ1-5
TGCGCCAGCAGCTCCGGGACCATTTCTACTTCGTCCATTCCCTACGAGCAGTACTTC	CASSSGTISTSSIPYEQYF	TRBV5-1	TRBJ2-7
TGTGCCAGCAGCTTAGATACCTACGGGTATCCCTACGAGCAGTACTTC	CASSLDTYGYPYEQYF	TRBV7-9	TRBJ2-7
TGTGCCAGCAGCTTCAAGGGGGAGATTACCCCCGAGCAGTACTTC	CASSFKGEITPEQYF	TRBV7-9	TRBJ2-7
TGCACCCTTTGGCAGGGCAATCAGCCCCAGCATTTT	CTLWQGNQPQHF	TRBV20-1	TRBJ1-5
TGTGCCAGCAGACTCCAGCCCCAGCATTTT	CASRLQPQHF	TRBV28	TRBJ1-5
TGTGCCAGCAGCGTTTCGGAGACAGATACGCAGTATTTT	CASSVSETDTQYF	TRBV7-4	TRBJ2-3
TGTGCCAGAAGGACTAGCCAGAACTACGAGCAGTACTTC	CARRTSQNYEQYF	TRBV27	TRBJ2-7
TGTGCCAGCAGCCAAGATCTCAGCCCGACAGGGGTAAGGGGGTACACTGAAGCTTTCTTT	CASSQDLSPTGVRGYTEAFF	TRBV14	TRBJ1-1
TGCGCCAGCAGTGACCCTCGTTCCGCGGGGACAGATACGCAGTATTTT	CASSDPRSAGTDTQYF	TRBV10-1	TRBJ2-3
TGCGCCAGCAGTTTCAAGCTAGCGGGAAGTGAGCAGTTCTTC	CASSFKLAGSEQFF	TRBV5-1	TRBJ2-1
TGTGCCAGCAGCCCATCCCCTATCCTAGCGTTTGGAACAGATACGCAGTATTTT	CASSPSPILAFGTDTQYF	TRBV12-4	TRBJ2-3
TGCAGCGTTGAAGGACGGGGGGGGACCCTTCCCGGTAACTATGGCTACACCTTC	CSVEGRGGTLPGNYGYTF	TRBV29-1	TRBJ1-2
TGTGCCAGCAGCTTAAGACGAAAGACCAAAAACATTCAGTACTTC	CASSLRRKTKNIQYF	TRBV7-3	TRBJ2-4
TGTGCCAGCAGCGTAGCCCCCCCAGGGTACGTTAGCACAGATACGCAGTATTTT	CASSVAPPGYVSTDTQYF	TRBV9	TRBJ2-3
TGCGCCAGCGCTAGCGGGGGTTGCGAGTACAATGAGCAGTTCTTC	CASASGGCEYNEQFF	TRBV10-1	TRBJ2-1
TGTGCCAGCAGCGTAGGGGCCCGGGGGTTAGAGACCCAGTACTTC	CASSVGARGLETQYF	TRBV9	TRBJ2-5
TGTGCCACCAGTCCCTTAGGCGGGGAGCAGTTCTTC	CATSPLGGEQFF	TRBV24-1	TRBJ2-1
TGTGCCAGCAGCGTTACAGGGGGGGGGGTATGTTCCTACGAGCAGTACTTC	CASSVTGGGVCSYEQYF	TRBV9	TRBJ2-7
TGCGCCAGCAGCAACAGCATCCACGAGCAGTACTTC	CASSNSIHEQYF	TRBV5-1	TRBJ2-7
TGTGCCAGCACAAGATCCGGGACAGCGTATGGGCACGAGCAGTACTTC	CASTRSGTAYGHEQYF	TRBV6-3	TRBJ2-7
TGTGCCAGCAGCCAGGACAGGAGGGGGCGAGATCAGCCCCAGCATTTT	CASSQDRRGRDQPQHF	TRBV11-2	TRBJ1-5
TGTGCCAGTAGCAGGGTATTCGAGCAGTACTTC	CASSRVFEQYF	TRBV19	TRBJ2-7
TGTGCCAGCAGCATACATATCACCGGGGAGCTGTTTTTT	CASSIHITGELFF	TRBV7-2	TRBJ2-2
TGTGCCAGCAGCCAATTGACAGGGGGAGCATCACCCCTCCACTTT	CASSQLTGGASPLHF	TRBV3-1	TRBJ1-6
TGTGCCAGCAGCTTAGCGCTCCAAAAGGGACTAGGCACAGATACGCAGTATTTT	CASSLALQKGLGTDTQYF	TRBV7-2	TRBJ2-3
TGCAGTGCTAGTTTGCCGGGGCGGAATTCACCCCTCCACTTT	CSASLPGRNSPLHF	TRBV20-1	TRBJ1-6
TGTGCCAGCAGCTTAGTCGTAGGCGGTCTAGCGGGGGCATTAGAGACCCAGTACTTC	CASSLVVGGLAGALETQYF	TRBV11-3	TRBJ2-5
TGTGCCAGCAGCCGGACAACGATCAATCAGCCCCAGCATTTT	CASSRTTINQPQHF	TRBV7-3	TRBJ1-5
TGTGCCAGCAGTGAACGCCAGGACAAATTTCCTTACAATGAGCAGTTCTTC	CASSERQDKFPYNEQFF	TRBV2	TRBJ2-1
TGTGCCAGCAGTGGCAGGGCCTGGGCTTTCTTT	CASSGRAWAFF	TRBV27	TRBJ1-1
TGTGCCAGCAGCTTATCCCGGATACAGGGATTGAACACCGGGGAGCTGTTTTTT	CASSLSRIQGLNTGELFF	TRBV7-6	TRBJ2-2
TGTGCCAGCTCACCAATCTTACTAGCGCACACAGATACGCAGTATTTT	CASSPILLAHTDTQYF	TRBV18	TRBJ2-3
TGTGCCAGCAGCTGGGGGTTACAGGGACTAGCGGGATACTCCTACAATGAGCAGTTCTTC	CASSWGLQGLAGYSYNEQFF	TRBV7-3	TRBJ2-1
TGTGCCAGCAGCGGGGTAATCCTAGGAGAGGAATACGAGCAGTACTTC	CASSGVILGEEYEQYF	TRBV7-9	TRBJ2-7
TGTGCCAGCAGTCTATGGGGGGCGGTGACCTACGAGCAGTACTTC	CASSLWGAVTYEQYF	TRBV7-9	TRBJ2-7
TGTGCCAGCAGCTCCTCAAACAGGGGACCAGAAGCTAATGAAAAACTGTTTTTT	CASSSSNRGPEANEKLFF	TRBV5-6	TRBJ1-4
TGCGCCACCCTGGTGACGCGGGAGAAGCAAGAGACCCAGTACTTC	CATLVTREKQETQYF	TRBV10-1	TRBJ2-5
TGTGCCAGCAGGGGGGCGATTTATTACGGCTACACCTTC	CASRGAIYYGYTF	TRBV6-3	TRBJ1-2
TGTGCCAGCAGGACTAGCGGGGATCCCGTCACAGATACGCAGTATTTT	CASRTSGDPVTDTQYF	TRBV5-6	TRBJ2-3
TGTGCCAGCAGCAGGATTCATGGAAGCAATCAGCCCCAGCATTTT	CASSRIHGSNQPQHF	TRBV13	TRBJ1-5
TGTGCCATCAGTGCGCGTACTAGAGGGGGCCAAGAGACCCAGTACTTC	CAISARTRGGQETQYF	TRBV10-3	TRBJ2-5
TGTGCGTGGACAGGGGGGATCGGCTACACCTTC	CAWTGGIGYTF	TRBV7-3	TRBJ1-2
TGTGCCAGCAGCGTAGCGGGGAAAAGTTCACCCCTCCACTTT	CASSVAGKSSPLHF	TRBV9	TRBJ1-6
TGTGCTAGCAGCTTAGCGATGTTGGCCGGGACAGAACTTTACGAGCAGTACTTC	CASSLAMLAGTELYEQYF	TRBV7-7	TRBJ2-7
TGCAGTGCTAGCCACTCTCGGAGTACGGGCGGGGGGGAAAAGTCAGATACGCAGTATTTT	CSASHSRSTGGGEKSDTQYF	TRBV20-1	TRBJ2-3
TGTGCCAGCAGCCCCACAGGGAGGGATGGCTACACCTTC	CASSPTGRDGYTF	TRBV14	TRBJ1-2
TGTGCCAGCAGTTACGATAGCCCATCTAATGAAAAACTGTTTTTT	CASSYDSPSNEKLFF	TRBV6-6	TRBJ1-4
TGCGCCAGCAGCTCTCTTCGGATCTACACAGATACGCAGTATTTT	CASSSLRIYTDTQYF	TRBV5-1	TRBJ2-3
TGTGCCAGCAGCCGGAGGGACCATGGAACCGAGCAGTACTTC	CASSRRDHGTEQYF	TRBV13	TRBJ2-7
TGTGCCAGCAGTCCGGGGCGCTACGAGCAGTACTTC	CASSPGRYEQYF	TRBV27	TRBJ2-7
TGTGCCTGGAGCAAGACCAGCGGAGGAGAGACCCAGTACTTC	CAWSKTSGGETQYF	TRBV30	TRBJ2-5
TGTGCCAGCAGTTACCCGGGGGAAGCCACAGATACGCAGTATTTT	CASSYPGEATDTQYF	TRBV6-5	TRBJ2-3
TGTGCCATCAGTTACAGACTCGGGAGGAGGACCACTGAAGCTTTCTTT	CAISYRLGRRTTEAFF	TRBV10-3	TRBJ1-1
TGTGCCAGCACCGGGCGCCCCACTAGCGGGAGGGGCGTTGAGTATTTT	CASTGRPTSGRGVEYF	TRBV7-3	TRBJ2-3
TGTGCCACCAACGGCTTGCGGCCCGAAAAACTGTTTTTT	CATNGLRPEKLFF	TRBV24-1	TRBJ1-4
TGTGCCAGCAGGACAGAGGACCCATGGGGGGTTTGGGAAGGGTACGAGCAGTACTTC	CASRTEDPWGVWEGYEQYF	TRBV6-1	TRBJ2-7
TGTGCCAGCAGCTTCCAGGGGGGGAGCTCCTACGAGCAGTACTTC	CASSFQGGSSYEQYF	TRBV5-4	TRBJ2-7
TGTGCCAGCAGCGGGGTCGGACACGGGGCGGGGGAAGCTTTCTTT	CASSGVGHGAGEAFF	TRBV7-4	TRBJ1-1
TGTGCCAGCAGTGTTGACGGATATACCGTCCGGGGGAATCAGCCCCAGCATTTT	CASSVDGYTVRGNQPQHF	TRBV6-5	TRBJ1-5
TGCGCCAGCAGCCGTCGACAGGGGAAAGAGACCCAGTACTTC	CASSRRQGKETQYF	TRBV5-1	TRBJ2-5
TGCGCCAGCAGCTTGGTCCGGGGGGGCCACCCCTACGAGCAGTACTTC	CASSLVRGGHPYEQYF	TRBV5-1	TRBJ2-7
TGTGCTAGTGGTTTGGATCCAGGGCTCGGGGGAAAGAGCAATCAGCCCCAGCATTTT	CASGLDPGLGGKSNQPQHF	TRBV12-5	TRBJ1-5
TGTGCCAGCAGCCAAAGCTTTCCGACAGGGAAAGACGAGCAGTACTTC	CASSQSFPTGKDEQYF	TRBV4-2	TRBJ2-7
TGTGCCAGCAGCCATTCCACAGGGGGGTTCTACGGGGAGCTGTTTTTT	CASSHSTGGFYGELFF	TRBV14	TRBJ2-2
TGTGCCAGCAGTTTATCCAAACTGGTAATGGGACAGGGGGCGAGAGCAACTAATGAAAAACTGTTTTTT	CASSLSKLVMGQGARATNEKLFF	TRBV28	TRBJ1-4
TGTGCCAGCAGTTACTCGCTAGCGGGAGAGGGAGTTTACGAGCAGTACTTC	CASSYSLAGEGVYEQYF	TRBV6-2	TRBJ2-7
TGTGCCAGTAGTATAGATTGGGACGCCTATAGCAATCAGCCCCAGCATTTT	CASSIDWDAYSNQPQHF	TRBV19	TRBJ1-5
TGCGCCAGCTATAGGGACAGCTCCTACGAGCAGTACTTC	CASYRDSSYEQYF	TRBV10-1	TRBJ2-7
TGTGCCAGCAGCACTACAGGCGGGTTAGGGATCACGAACACTGAAGCTTTCTTT	CASSTTGGLGITNTEAFF	TRBV13	TRBJ1-1
TGCGCCAGCAGCCAGCCGGGACAGGGACACACTGAAGCTTTCTTT	CASSQPGQGHTEAFF	TRBV4-3	TRBJ1-1
TGTGCCAGCAGCCGGCTTTGGGACACCGAGACCCAGTACTTC	CASSRLWDTETQYF	TRBV7-3	TRBJ2-5
TGCGCCACGCGGTGTGCAGGGGGCGCCGGGGAGCTGTTTTTT	CATRCAGGAGELFF	TRBV10-1	TRBJ2-2
TGTGCCAGCAGCATTCCGGGTAGTCCGGGACAGTGGGTCCGGTACTATGGCTACACCTTC	CASSIPGSPGQWVRYYGYTF	TRBV7-9	TRBJ1-2
TGCGCCAAGGGGATCTCCTACGAGCAGTACTTC	CAKGISYEQYF	TRBV10-1	TRBJ2-7
TGTGCCAGCCCTTCGGACAGCCGGGGTAGCAATCAGCCCCAGCATTTT	CASPSDSRGSNQPQHF	TRBV6-4	TRBJ1-5
TGCGCCAGCAGCTTGGTGAACTCAGGGCTGAAGGGAAACACCATATATTTT	CASSLVNSGLKGNTIYF	TRBV5-1	TRBJ1-3
TGTGCCATCAGTGAGTTTAGGGGGACTCGCAATCAGCCCCAGCATTTT	CAISEFRGTRNQPQHF	TRBV10-3	TRBJ1-5
TGTGCCAAGGTAAGGGAGCGACAGAGAAACTACAATGAGCAGTTCTTC	CAKVRERQRNYNEQFF	TRBV27	TRBJ2-1
TGTGCCAGCAGCTTATTAGGGGCCTTTGAAAAACTGTTTTTT	CASSLLGAFEKLFF	TRBV13	TRBJ1-4
TGTGCCAGCAGCTCGGTTGACAGGGGCGGGCAACGGCGCTATGGCTACACCTTC	CASSSVDRGGQRRYGYTF	TRBV7-4	TRBJ1-2
TGCGCCAGGCCCTCCCGGCTTACAGGGGCGGAGGCCGGGGAGCTGTTTTTT	CARPSRLTGAEAGELFF	TRBV5-1	TRBJ2-2
TGCGCCAGCAGCTACCTAAGGAGACAGGGGGCCACCGGGGAGCTGTTTTTT	CASSYLRRQGATGELFF	TRBV5-1	TRBJ2-2
TGTGCCACCAGTGATTTAGGCACATACGAGCAGTACTTC	CATSDLGTYEQYF	TRBV24-1	TRBJ2-7
TGTGCCAGCAGCTTGATCAAGGGGATGGGCGGCTACACCTTC	CASSLIKGMGGYTF	TRBV5-6	TRBJ1-2
TGTGCCAGCAGCTATTACGTTCAGCCCCAGCATTTT	CASSYYVQPQHF	TRBV11-2	TRBJ1-5
TGTGCCACCCCATTTCTTTTAACAGCTTTCTTT	CATPFLLTAFF	TRBV24-1	TRBJ1-1
TGTGCCAGCAGCGCTGGGGACAGGGGAGGGAAAGTTCACACTGAAGCTTTCTTT	CASSAGDRGGKVHTEAFF	TRBV9	TRBJ1-1
TGCGCCAGCGCGCCGGGACACGGGGTCTCCTACGAGCAGTACTTC	CASAPGHGVSYEQYF	TRBV4-1	TRBJ2-7
TGTGCCAGCAGCCCTACAGATCAGCCCCAGCATTTT	CASSPTDQPQHF	TRBV7-3	TRBJ1-5
TGTGCCAGCAGCACACCCTCTCCACCCGGGATCTGTACAGATACGCAGTATTTT	CASSTPSPPGICTDTQYF	TRBV7-6	TRBJ2-3
TGTGCCAGCAGCTACCCCCCAGGGGTCAACGAGCAGTACTTC	CASSYPPGVNEQYF	TRBV5-4	TRBJ2-7
TGTGCCAGCAGCCAAGAGGGGGCCGCCCGGGTAGGGACAGGGCGGCACCTAGCTTTCTTT	CASSQEGAARVGTGRHLAFF	TRBV14	TRBJ1-1
TGTGCCAGCAGTCAGGGGGGGCCCGGAAAAGTGGCCTACGAGCAGTACTTC	CASSQGGPGKVAYEQYF	TRBV12-3	TRBJ2-7
TGTGCCAGCAGCGAGGACTGGAGAGTCTCCTACAATGAGCAGTTCTTC	CASSEDWRVSYNEQFF	TRBV7-8	TRBJ2-1
TGTGCCAGCAGCGGGGGCCGCGGGACAGGGGGCTGGTTGAACACTGAAGCTTTCTTT	CASSGGRGTGGWLNTEAFF	TRBV13	TRBJ1-1
TGTGCCATCAGTGCTTGGGGGCGGGGTTCACCCCTCCACTTT	CAISAWGRGSPLHF	TRBV10-3	TRBJ1-6
TGTGCCAGCAGCGAGGGACCTAGCAATCAGCCCCAGCATTTT	CASSEGPSNQPQHF	TRBV5-6	TRBJ1-5
TGTGCCAGCAGCTTGGAGGAGGGTTGGGGGGGAATCATGAACACTGAAGCTTTCTTT	CASSLEEGWGGIMNTEAFF	TRBV5-4	TRBJ1-1
TGTGCCAGCAGCTTCACCGAGCGCAAACCCTCTGGAAACACCATATATTTT	CASSFTERKPSGNTIYF	TRBV7-6	TRBJ1-3
TGTGCCACCGGTATTGGGACAGCGGATACGCAGTATTTT	CATGIGTADTQYF	TRBV15	TRBJ2-3
TGTGCCACCAGTGATTTACCTCACAGGGGGGCGCCAGATACGCAGTATTTT	CATSDLPHRGAPDTQYF	TRBV24-1	TRBJ2-3
TGTGCCAGCAGCATTCCAGGGGGAGGGAATCAGCCCCAGCATTTT	CASSIPGGGNQPQHF	TRBV7-4	TRBJ1-5
TGTGCCAGCAGGGGACCAACCCCCACAGATACGCAGTATTTT	CASRGPTPTDTQYF	TRBV28	TRBJ2-3
TGTGCCAGCATTAGGAATCCAAGGGAAGCCGGCTACGAGCAGTACTTC	CASIRNPREAGYEQYF	TRBV6-4	TRBJ2-7
TGTGCCAGCAGTGGCCCGGGACAGCAGCCCCAGCATTTT	CASSGPGQQPQHF	TRBV12-4	TRBJ1-5
TGTGCCAGCAGCCGCCGCCCTCGAACAGGGCAGGCCTGGTATGCCTACGAGCAGTACTTC	CASSRRPRTGQAWYAYEQYF	TRBV9	TRBJ2-7
TGTGCCAGCAGCCAAGACCCCTTCCGCCCAGGCTATGGCTACACCTTC	CASSQDPFRPGYGYTF	TRBV3-1	TRBJ1-2
TGCAGTGCTTCTAGCCAGGGACGCACAGATACGCAGTATTTT	CSASSQGRTDTQYF	TRBV20-1	TRBJ2-3
TGCGCCAGCAGCTTGGGGCGGAGAAAGTCGTCGCAGTATTTT	CASSLGRRKSSQYF	TRBV5-1	TRBJ2-3
TGTGCCAGCAGCTTGGCCTTCTCATCAGCCAATCAGCCCCAGCATTTT	CASSLAFSSANQPQHF	TRBV5-4	TRBJ1-5
TGTGCCAGCCGACCCCAGGGGTGGGAGCAGTACTTC	CASRPQGWEQYF	TRBV28	TRBJ2-7
TGCGCCAGCAAGAATACAAGAGGGAATGGCTACACCTTC	CASKNTRGNGYTF	TRBV5-1	TRBJ1-2
TGTGCCAGCCAGATGAGGTTGACCCAGTACTTC	CASQMRLTQYF	TRBV6-1	TRBJ2-5
TGTGCCAGCAGCTTAGTTGCAGGGACCGGGGAGCTGTTTTTT	CASSLVAGTGELFF	TRBV7-7	TRBJ2-2
TGTGCCAGTAGTCCGGGTTTCCTAGGGGAGACCGGGGAGCTGTTTTTT	CASSPGFLGETGELFF	TRBV19	TRBJ2-2
TGCAGCGTTAACGGATACAATGAGCAGTTCTTC	CSVNGYNEQFF	TRBV29-1	TRBJ2-1
TGCGCCAGCAGTGACCCGGGACAGACAGATACGCAGTATTTT	CASSDPGQTDTQYF	TRBV10-2	TRBJ2-3
TGTGCTAGTGGTTACAGGGGGCGCTCTGAAGCTTTCTTT	CASGYRGRSEAFF	TRBV12-5	TRBJ1-1
TGTGCCACCACACCCGCCCCAGGCGTTGATAGCAATCAGCCCCAGCATTTT	CATTPAPGVDSNQPQHF	TRBV24-1	TRBJ1-5
TGTGCCAGCAGTAGACAGGGGGGCGGGGAGCTGTTTTTT	CASSRQGGGELFF	TRBV12-3	TRBJ2-2
TGTGCCAGCAGCCAGCCTAGCGGGGGGCGCGATACGCAGTATTTT	CASSQPSGGRDTQYF	TRBV14	TRBJ2-3
TGTGCCAGCAGTGAACCCGGGAGGGGGGTCTACGAGCAGTACTTC	CASSEPGRGVYEQYF	TRBV6-1	TRBJ2-7
TGTGCCAGCCCGGGTTTGGGGGGAGGTTTATGCTATGGCTACACCTTC	CASPGLGGGLCYGYTF	TRBV6-1	TRBJ1-2
TGTGCCAGCAGCTCTCCACAGGGACGCTGCCAAGAGACCCAGTACTTC	CASSSPQGRCQETQYF	TRBV7-3	TRBJ2-5
TGTGCCAGCAGCCAAGATCTCCCGGGGGCACTAGAAAAACTGTTTTTT	CASSQDLPGALEKLFF	TRBV4-2	TRBJ1-4
TGTGCCAGCAGCTTAACAGTGGGAGGGAGCTCCTACGAGCAGTACTTC	CASSLTVGGSSYEQYF	TRBV7-3	TRBJ2-7
TGTGCCAGCAGTGACTTGGGTACCGGGACAGTGCATTTT	CASSDLGTGTVHF	TRBV6-4	TRBJ1-5
TGTGCCAGCAGTTACCGAAGAGGGAACGGGGTAACTGCTAACTATGGCTACACCTTC	CASSYRRGNGVTANYGYTF	TRBV6-2	TRBJ1-2
TGTGCCAGCAGCTTAGATCGGCACGACTGGTATGGCTACACCTTC	CASSLDRHDWYGYTF	TRBV11-3	TRBJ1-2
TGTGCCAGCAGAACAGGGGTCATGGTAATGAACACTGAAGCTTTCTTT	CASRTGVMVMNTEAFF	TRBV27	TRBJ1-1
TGTGCCAGCAGCGCGCAGGGATATGGCTACACCTTC	CASSAQGYGYTF	TRBV7-9	TRBJ1-2
TGTGCCAGCAGCCGTGGCAGGGGAACCCATGAGCAGTACTTC	CASSRGRGTHEQYF	TRBV11-2	TRBJ2-7
TGCAGCGTTTTAAGCAGTCCCTATAATTCACCCCTCCACTTT	CSVLSSPYNSPLHF	TRBV29-1	TRBJ1-6
TGTGCAGGCGGGGGCAGGGCGGAAGGGGCCCATTATGGCTACACCTTC	CAGGGRAEGAHYGYTF	TRBV7-7	TRBJ1-2
TGTGCCAGCAGTGATCAATGTAGCGCGGTGTACAATGAGCAGTTCTTC	CASSDQCSAVYNEQFF	TRBV6-1	TRBJ2-1
TGTGCCAGCAGTGACGTTCCGGGACTAGCGGGTCCCGGGGAGCTGTTTTTT	CASSDVPGLAGPGELFF	TRBV6-4	TRBJ2-2
TGTGCCACCAGTGATTACAGGCGGGAGGCTTATGAAAAACTGTTTTTT	CATSDYRREAYEKLFF	TRBV24-1	TRBJ1-4
TGTGCCAGCGTAACCGGGACTGAATACGAGCAGTACTTC	CASVTGTEYEQYF	TRBV6-2	TRBJ2-7
TGTGCCAGTAGTATCCGGAGGGAGTATTACGAGCAGTACTTC	CASSIRREYYEQYF	TRBV19	TRBJ2-7
TGTGCTAGTGGTTCAAAGGGGGGGACCTACAATGAGCAGTTCTTC	CASGSKGGTYNEQFF	TRBV12-5	TRBJ2-1
TGTGCCAGCAGCCGGACTAGCGGGTACAACACAGATACGCAGTATTTT	CASSRTSGYNTDTQYF	TRBV7-3	TRBJ2-3
TGTGCCAGCAACCTAACAACGGGGGGAGGCGAGCAGTACTTC	CASNLTTGGGEQYF	TRBV6-2	TRBJ2-7
TGCGCCAGCAGCCGCCGACGAAGGTCTGGAAACACCATATATTTT	CASSRRRRSGNTIYF	TRBV5-1	TRBJ1-3
TGCAGTGCTAGAGGGGCGAACACTGAAGCTTTCTTT	CSARGANTEAFF	TRBV20-1	TRBJ1-1
TGTGCCATCCCCGCGGGAGTCTTCTTC	CAIPAGVFF	TRBV5-4	TRBJ2-1
TGTGCCACCCGCTCAGGCTATCTGAAGAACTACGAGCAGTACTTC	CATRSGYLKNYEQYF	TRBV7-8	TRBJ2-7
TGTGCCAGCAGACTAGGGGGACAGACTGAAGCTTTCTTT	CASRLGGQTEAFF	TRBV28	TRBJ1-1
TGTGCCAGCAGTGAGACCCGCGAAGGGGGAGAACCATTTGCGAACGAGCAGTACTTC	CASSETREGGEPFANEQYF	TRBV6-4	TRBJ2-7
TGTGCCAGCAGCCCCCCCCCGAGGGATGGCTACACCTTC	CASSPPPRDGYTF	TRBV13	TRBJ1-2
TGTGCCAGCAGTGATGGGACTTCTACAGATACGCAGTATTTT	CASSDGTSTDTQYF	TRBV6-4	TRBJ2-3
TGTGCCAGCAGTCCTAGCGGGAAGTGTGCAACTAATGAAAAACTGTTTTTT	CASSPSGKCATNEKLFF	TRBV27	TRBJ1-4
TGCGCCAGCACGGGCTTGGACGCATTCGGAATTCGCTATGGCTACACCTTC	CASTGLDAFGIRYGYTF	TRBV10-1	TRBJ1-2
TGTGCCAGCAGGACAGGGGGTACTGAGAACACTGAAGCTTTCTTT	CASRTGGTENTEAFF	TRBV7-9	TRBJ1-1
TGTGCTAGTGGTTTGAGGGAGGGACAGGGTGAAAAACTGTTTTTT	CASGLREGQGEKLFF	TRBV12-5	TRBJ1-4
TGCAGTGCTGGGGCGTGCACTGAAGCTTTCTTT	CSAGACTEAFF	TRBV20-1	TRBJ1-1
TGTGCTAGTGGTTTGGTACGGAAACCGGGGACAGGCACGTTCCGGGATACGCAGTATTTT	CASGLVRKPGTGTFRDTQYF	TRBV12-5	TRBJ2-3
TGTGCCACCGGTTCGCACTTAAGGGGGGGGGGAGATGGCTACACCTTC	CATGSHLRGGGDGYTF	TRBV24-1	TRBJ1-2
TGCAGTGCTTTCCGGGCAGCGGACACTGAAGCTTTCTTT	CSAFRAADTEAFF	TRBV20-1	TRBJ1-1
TGTGCCAGCAGTTTATTTCCTCCGGGAGCTAGAGAAAAGACGCTGTTTTTT	CASSLFPPGAREKTLFF	TRBV28	TRBJ2-2
TGTGCCAGCAGTGGTCGAGCGGGGGTTGAGCAGTTCTTC	CASSGRAGVEQFF	TRBV25-1	TRBJ2-1
TGTGCCAGTTGCGGGGGTGGAGCCAAAAACATTCAGTACTTC	CASCGGGAKNIQYF	TRBV28	TRBJ2-4
TGTAAAGCTCGGGGTACGGGGATAGGTAGCTCCTACGAGCAGTACTTC	CKARGTGIGSSYEQYF	TRBV7-9	TRBJ2-7
TGCAGCGTGTCCCGGGGGGCTGGCGTACATACGCAGTATTTT	CSVSRGAGVHTQYF	TRBV29-1	TRBJ2-3
TGTGCCAGCCAAACCCTAGCGGGGACGATACAAGAGACCCAGTACTTC	CASQTLAGTIQETQYF	TRBV19	TRBJ2-5
TGTGCCAGCAGTTCCTCTATGGCAACTAATGAAAAACTGTTTTTT	CASSSSMATNEKLFF	TRBV27	TRBJ1-4
TGTGCCAGCAGCTTGATGCCAGAACCGGGACAGGGGGATCAAGAGACCCAGTACTTC	CASSLMPEPGQGDQETQYF	TRBV5-8	TRBJ2-5
TGTGCCACAACGCAGGAATTAAATGAAAAACTGTTTTTT	CATTQELNEKLFF	TRBV24-1	TRBJ1-4
TGCAGTGCTAGAGTTCCGGGACAGGGAAGCCAAGAGACCCAGTACTTC	CSARVPGQGSQETQYF	TRBV20-1	TRBJ2-5
TGCGCCAGCAGTGACGAGGAAGGACAGGGGGCCCTGGCTAATGAAAAACTGTTTTTT	CASSDEEGQGALANEKLFF	TRBV10-1	TRBJ1-4
TGTGCCAGCAGCCAAGATCGTCCGGACAGGGGGCCCCAGCATTTT	CASSQDRPDRGPQHF	TRBV14	TRBJ1-5
TGTGCCACCAGTGATTTGTCCAAACGCTATGGCTACACCTTC	CATSDLSKRYGYTF	TRBV24-1	TRBJ1-2
TGTGCCAGCAGTTACTCGGTAGGGCCTTATAGCAATCAGCCCCAGCATTTT	CASSYSVGPYSNQPQHF	TRBV6-5	TRBJ1-5
TGTGCCAGCAGTGTGACAGCGCGCCGGAACACCATATATTTT	CASSVTARRNTIYF	TRBV28	TRBJ1-3
TGTGCCAGCAGCGGGGACAGAGTAGATAGCAATCAGCCCCAGCATTTT	CASSGDRVDSNQPQHF	TRBV13	TRBJ1-5
TGTGCCAGCAGTCCGCCGGGGGCGTTGATGAACACTGAAGCTTTCTTT	CASSPPGALMNTEAFF	TRBV6-1	TRBJ1-1
TGTGCCAGCAGTCTCCGCGAGTCGGCGAACACCGGGGAGCTGTTTTTT	CASSLRESANTGELFF	TRBV27	TRBJ2-2
TGTGCCAGCAGTGATAGGACTAGCGGGTCGGGCACCGGGGAGCTGTTTTTT	CASSDRTSGSGTGELFF	TRBV12-4	TRBJ2-2
TGTGCCAGCAGCCCGGGGGGGGATCCCTACGAGCAGTACTTC	CASSPGGDPYEQYF	TRBV7-4	TRBJ2-7
TGCAGTGCTAGTGGGACTAGCGGGGGGGAGGGCTACGAGCAGTACTTC	CSASGTSGGEGYEQYF	TRBV20-1	TRBJ2-7
TGTGAAAGAGGGGTGAATGGCTACACCTTC	CERGVNGYTF	TRBV12-3	TRBJ1-2
TGTGCCAGCAGCCGGGACCCTAATGAAAAACTGTTTTTT	CASSRDPNEKLFF	TRBV12-4	TRBJ1-4
TGCGCCAGCAGTGATCGGACCCACACAGATACGCAGTATTTT	CASSDRTHTDTQYF	TRBV10-2	TRBJ2-3
TGTGCCAGCACCAGCAGGGGGGGAGATACGCAGTATTTT	CASTSRGGDTQYF	TRBV7-2	TRBJ2-3
TGTCCAGGGGGACCGGATCAGCCCCAGCATTTT	CPGGPDQPQHF	TRBV14	TRBJ1-5
TGTGCCAGCAGTGTGCGGGGGCATAGAGCCTATGGCTACACCTTC	CASSVRGHRAYGYTF	TRBV6-5	TRBJ1-2
TGTGCCACCAGGCGAGGGGCCGGGGAGCTGTTTTTT	CATRRGAGELFF	TRBV24-1	TRBJ2-2
TGTGCCAGCAGCACCGTAGAGGTGTACAATGAGCAGTTCTTC	CASSTVEVYNEQFF	TRBV28	TRBJ2-1
TGTGCCAGCAGCGGATCCCGGTCCGGACAGGGAATAGCTAATTCACCCCTCCACTTT	CASSGSRSGQGIANSPLHF	TRBV7-3	TRBJ1-6
TGTGCCAGCAGCAAGCCGGAAACCAATAACACTGAAGCTTTCTTT	CASSKPETNNTEAFF	TRBV5-8	TRBJ1-1
TGTGCCAGCAGCCAAAATCGGAGCGGGAGGGATTCACCCCTCCACTTT	CASSQNRSGRDSPLHF	TRBV3-1	TRBJ1-6
TGTGCCAGCAGTGACTGTGAGACTAGCGGAGGACTAAACACCGGGGAGCTGTTTTTT	CASSDCETSGGLNTGELFF	TRBV6-4	TRBJ2-2
TGTGCCAGCAAAAGGGGCCCATTGAACACCGGGGAGCTGTTTTTT	CASKRGPLNTGELFF	TRBV7-3	TRBJ2-2
TGTGCCAGCAGTTACTTGGATAATCAGCTGGGGGGGATTGGCGCAGATACGCAGTATTTT	CASSYLDNQLGGIGADTQYF	TRBV6-5	TRBJ2-3
TGTGCCAGCAGCGGCCTCCGGGATCGCAATCAGCCCCAGCATTTT	CASSGLRDRNQPQHF	TRBV13	TRBJ1-5
TGCGCCAGCAGCCAAGGTTCGGGACAGGGGGCATTCGGGCAGCCCCAGCATTTT	CASSQGSGQGAFGQPQHF	TRBV4-1	TRBJ1-5
TGTGCTAGTGGTTTGAAGCAGGGGCGAGCCTACGAGCAGTACTTC	CASGLKQGRAYEQYF	TRBV12-5	TRBJ2-7
TGTGCCAGCAGCCAAGCACACCGGACGCGTTTGGCTCAGCCCCAGCATTTT	CASSQAHRTRLAQPQHF	TRBV3-1	TRBJ1-5
TGTGCCAGCAGTCTACCCGGCCCTGTAAGGTTGAACACTGAAGCTTTCTTT	CASSLPGPVRLNTEAFF	TRBV27	TRBJ1-1
TGTGCTAGTGGTTTGCATTCCTTATCACAGGGGAGGATACATAGCAATCAGCCCCAGCATTTT	CASGLHSLSQGRIHSNQPQHF	TRBV12-5	TRBJ1-5
TGTGCCATCACGACCTCGGGGGGAAAGCGGCAGTTCTTC	CAITTSGGKRQFF	TRBV10-3	TRBJ2-1
TGTGCCAGCAGTGTCCCCCCCTGGACAGGGAATCAGCCCCAGCATTTT	CASSVPPWTGNQPQHF	TRBV6-1	TRBJ1-5
TGTGCCAGCAGCCAAGAAGGCTGCTCCAGTAGTGAGGCGGGCACAGATACGCAGTATTTT	CASSQEGCSSSEAGTDTQYF	TRBV14	TRBJ2-3
TGTGCCAGCAGCTCATCCGGGACAGGGGGCGCGTCTGGAAACACCATATATTTT	CASSSSGTGGASGNTIYF	TRBV5-4	TRBJ1-3
TGTGCCAGCAGCTTAACTGCCTACGAGCAGTACTTC	CASSLTAYEQYF	TRBV7-9	TRBJ2-7
TGTGCCAGCAGCTCTGGACAGGACCCCAAAGAGACCCAGTACTTC	CASSSGQDPKETQYF	TRBV13	TRBJ2-5
TGCAGTGCTAGCTGGGACAGGGAGTTACCATTTTACTTC	CSASWDRELPFYF	TRBV20-1	TRBJ2-5
TGTGCCACCAGTGACGTCAGGACAGGGGGCGGCGCCTACGAGCAGTACTTC	CATSDVRTGGGAYEQYF	TRBV24-1	TRBJ2-7
TGTGCCAGCAGCTTCAATTTGGGGACTAGGGAGACCCAGTACTTC	CASSFNLGTRETQYF	TRBV7-9	TRBJ2-5
TGTGCCAGCAGCTTAGCGCTCCCCACTAGCGGGAGGTCCTCCTACGAGCAGTACTTC	CASSLALPTSGRSSYEQYF	TRBV7-4	TRBJ2-7
TGTGCCAGCAGCTGGGGGGTTGGTGATTCTAACATTCAGTACTTC	CASSWGVGDSNIQYF	TRBV5-4	TRBJ2-4
TGTGCCAGCAGCGGGGACAGGGACTACGAGCAGTACTTC	CASSGDRDYEQYF	TRBV7-6	TRBJ2-7
TGTGCCAGCATCAGATTTGGGAGGGCTAATGAGCAGTTCTTC	CASIRFGRANEQFF	TRBV27	TRBJ2-1
TGTGCCAGCAGACCCCCCGCAGGCTGTGAGCAGTTCTTC	CASRPPAGCEQFF	TRBV2	TRBJ2-1
TGCGCCAGCGAGGTATTATACTCCTACAATGAGCAGTTCTTC	CASEVLYSYNEQFF	TRBV5-1	TRBJ2-1
TGCAGTGCCCGCCACCGGACCCCTCGAGGGCCCCCTGTAACTAATGAAAAACTGTTTTTT	CSARHRTPRGPPVTNEKLFF	TRBV20-1	TRBJ1-4
TGTGCCAGCAGTTTATGCGGAGGATTGTATGGCTACACCTTC	CASSLCGGLYGYTF	TRBV28	TRBJ1-2
TGTGCCAGCAGTGAAGTAGGGGGCCCGATCTACGAGCAGTACTTC	CASSEVGGPIYEQYF	TRBV6-1	TRBJ2-7
TGTGCCAGCAGCCTAGCTTGTTGGGGGGAAACGTACCAAGAGACCCAGTACTTC	CASSLACWGETYQETQYF	TRBV5-8	TRBJ2-5
TGTGCCAAGAGGCCCCCCCCTTACCGGGGCAATTCACCCCTCCACTTT	CAKRPPPYRGNSPLHF	TRBV19	TRBJ1-6
TGTGCCAGCAGCCCCCGAGGTACCTACGAGCAGTACTTC	CASSPRGTYEQYF	TRBV5-4	TRBJ2-7
TGTGCCAGCAGCCGGCCAGACAGGGGAGATAGCAATCAGCCCCAGCATTTT	CASSRPDRGDSNQPQHF	TRBV9	TRBJ1-5
TGTGCCACCAGGGCATTTAGGGATAGCAATCAGCCCCAGCATTTT	CATRAFRDSNQPQHF	TRBV24-1	TRBJ1-5
TGCGCCAGCAGCGTGCCCAGAAACTCTGGAAACACCATATATTTT	CASSVPRNSGNTIYF	TRBV5-1	TRBJ1-3
TGTGCCAGCAGCTTGGGACAGCTCTCCTACGAGCAGTACTTC	CASSLGQLSYEQYF	TRBV5-6	TRBJ2-7
TGTGCCAGCAGTTTACCTGGGGGGCCGGACGACGAGCAGTACTTC	CASSLPGGPDDEQYF	TRBV27	TRBJ2-7
TGCGCCAGCAGCTTGGCCCCACACAGCTGGAATTGGGGCTCCTACGAGCAGTACTTC	CASSLAPHSWNWGSYEQYF	TRBV5-1	TRBJ2-7
TGTGCCAGCAGCCTAGGGGGCATGGCCTACGAGCAGTACTTC	CASSLGGMAYEQYF	TRBV7-7	TRBJ2-7
TGCAGTGCTTCCCCTCCTTACGGGGTGCTAAGGGTCACAGATACGCAGTATTTT	CSASPPYGVLRVTDTQYF	TRBV20-1	TRBJ2-3
TGTGCCAGCAGTGCCCACTTTCTAGCGGGGGGGCCAAACAATGAGCAGTTCTTC	CASSAHFLAGGPNNEQFF	TRBV2	TRBJ2-1
TGTGCCAGCAGCGTCGGCATCCGCAATCAGCCCCAGCATTTT	CASSVGIRNQPQHF	TRBV9	TRBJ1-5
TGCAGTGCTCTGAGCTCCCGGAGGGGGGGTGGGCTGAAGCCCACAGATACGCAGTATTTT	CSALSSRRGGGLKPTDTQYF	TRBV20-1	TRBJ2-3
TGCAGCGTTGAGACACAGCCCTCCCATCAGCCCCAGCATTTT	CSVETQPSHQPQHF	TRBV29-1	TRBJ1-5
