TGTGCCAGCAGCTCGGACTATTGGCGGCGACAAGAGACCCAGTACTTC	CASSSDYWRRQETQYF	TRBV3-1	TRBJ2-5
TGTGCCAGCAGCGGCAGACAGGGGAATATTGGATCGAACACTGAAGCTTTCTTT	CASSGRQGNIGSNTEAFF	TRBV9	TRBJ1-1
TGTGCCAGCAGTGCCTCCCCGGAGGGGCCCCCCGAGCAGTACTTC	CASSASPEGPPEQYF	TRBV28	TRBJ2-7
TGTGCCAGCAGCCTTAGTTTTCGGGACAGTAGGAATCAGCCCCAGCATTTT	CASSLSFRDSRNQPQHF	TRBV7-2	TRBJ1-5
TGTGCTAGTGGTTTGGCCGACCGATCCCGGGACCGAGGAAAGTCCGGATACAATGAGCAGTTCTTC	CASGLADRSRDRGKSGYNEQFF	TRBV12-5	TRBJ2-1
TGCGCCAGCAGTGAGCACGGGCCCCCGAACGGGATTTTCGACGAGCAGTACTTC	CASSEHGPPNGIFDEQYF	TRBV10-2	TRBJ2-7
TGTGCCAGCTCACCCTTGGGAGGGTGTACCTACGAGCAGTACTTC	CASSPLGGCTYEQYF	TRBV18	TRBJ2-7
TGCAGTGCACGGGACAGGGACCTAGCCAAAAACATTCAGTACTTC	CSARDRDLAKNIQYF	TRBV20-1	TRBJ2-4
TGTGCCAGCAGCAGTAGGGACGGCCATAATGAAAAACTGTTTTTT	CASSSRDGHNEKLFF	TRBV6-4	TRBJ1-4
TGTGCCAGCAGTCAGGGGGGGCCCGAGCAGTACTTC	CASSQGGPEQYF	TRBV5-5	TRBJ2-7
TGTGCCAGCAGTTTCCCCGAGGGGCTCCGCTATGGCTACACCTTC	CASSFPEGLRYGYTF	TRBV28	TRBJ1-2
TGTGCCAAAAGGGACTGTTCCCTCTTC	CAKRDCSLF	TRBV6-2	TRBJ2-1
TGCAGTGCCTATAGCGGGATTTATACGCAGTATTTT	CSAYSGIYTQYF	TRBV20-1	TRBJ2-3
TGTGCCAGCAGCATAGAGGGGTCGGAAAACACCATATATTTT	CASSIEGSENTIYF	TRBV11-2	TRBJ1-3
TGTGCCAGCAGCCACCCCGGACAGAAAACGGAGACCCAGTACTTC	CASSHPGQKTETQYF	TRBV14	TRBJ2-5
TGTGCCAGCAGCAGCGGGGCCGTTGGCTACACCTTC	CASSSGAVGYTF	TRBV11-2	TRBJ1-2
TGTGCCAGACGACCGCAGGTATGGACCCAGTACTTC	CARRPQVWTQYF	TRBV19	TRBJ2-5
TGTGCCAGCAGTTACCGGAATCCGGCTACTGAAGCTTTCTTT	CASSYRNPATEAFF	TRBV6-5	TRBJ1-1
TGTGCCAGCAGTTACATTACGGAATTGGGTGAGCAGTTCTTC	CASSYITELGEQFF	TRBV12-4	TRBJ2-1
TGTGCCAGCAGCTCGAGTCCCGGGACACTGAACTATGGCTACACCTTC	CASSSSPGTLNYGYTF	TRBV7-9	TRBJ1-2
TGTGCCAGCAGCCAAGATGATGACAGGGGCGAGGCTTTCTTT	CASSQDDDRGEAFF	TRBV14	TRBJ1-1
TGTGCCAGCAGCGCGGACTCTCTAGAGACCCAGTACTTC	CASSADSLETQYF	TRBV9	TRBJ2-5
TGTGCCAGCAGCCCCCTTGGGCCCTTATCGAAAAACACTGAAGCTTTCTTT	CASSPLGPLSKNTEAFF	TRBV7-9	TRBJ1-1
TGTGCCAGCAGCTACTACCGGATGACTAGTGACCAGGGTGAGCAGTTCTTC	CASSYYRMTSDQGEQFF	TRBV7-8	TRBJ2-1
TGTGCCAGCAGCCCCGGGACAGGCTACGAGCAGTACTTC	CASSPGTGYEQYF	TRBV11-3	TRBJ2-7
TGTGCCAGCAGGGCGGTGTGGGACAGGGGTCACTCTAATGGCTACACCTTC	CASRAVWDRGHSNGYTF	TRBV7-6	TRBJ1-2
TGTGCCACCAGTGATTTGTTGAACCAGGTTCAAGAGACCCAGTACTTC	CATSDLLNQVQETQYF	TRBV24-1	TRBJ2-5
TGCAGTGAACAGTTTCTAGCGGGAGCCAGCCAAGAGACCCAGTACTTC	CSEQFLAGASQETQYF	TRBV20-1	TRBJ2-5
TGTGCCAGCAGCTGGACAGCGGTACCCTACGAGCAGTACTTC	CASSWTAVPYEQYF	TRBV9	TRBJ2-7
TGTGCCAGCAGTGTCGCGGTAGGGAGGGAGGAGTCCTACGAGCAGTACTTC	CASSVAVGREESYEQYF	TRBV6-4	TRBJ2-7
TGTGCTAGCAGCTTACGAGTCACGCAAGAGACCCAGTACTTC	CASSLRVTQETQYF	TRBV7-7	TRBJ2-5
TGTGCCAGCAGCCAAGGGCCGACTAGCGGAGACAACACCGGGGAGCTGTTTTTT	CASSQGPTSGDNTGELFF	TRBV3-1	TRBJ2-2
TGTGCCAGCAGTGCTCCCCGCCGTGAGGTGGGAGGTGAGCAGTTCTTC	CASSAPRREVGGEQFF	TRBV27	TRBJ2-1
TGTGCCAGCAGTGGGCCGTCTAGCGGGGGACAAGAGACCCAGTACTTC	CASSGPSSGGQETQYF	TRBV6-4	TRBJ2-5
TGTGCCGGATTATTCCTCCGACAGGGCAGCACCGGGGAGCTGTTTTTT	CAGLFLRQGSTGELFF	TRBV6-2	TRBJ2-2
TGTGCCAGCAGCTGTCCGGGACTAGCGGGAGACGGAACGGAGACCCAGTACTTC	CASSCPGLAGDGTETQYF	TRBV11-3	TRBJ2-5
TGCAGCGTTGCCGACTTTGGGGATACTGAAGCTTTCTTT	CSVADFGDTEAFF	TRBV29-1	TRBJ1-1
TGCGCCAGCAGCCAGCGACTCGGGGCGGGAATGCCTAACTTTGATGAGCAGTTCTTC	CASSQRLGAGMPNFDEQFF	TRBV5-1	TRBJ2-1
TGCGCCAGCAGCTCTGCGGCGAGACGGGGCCCTTGGAACACTGAAGCTTTCTTT	CASSSAARRGPWNTEAFF	TRBV5-1	TRBJ1-1
TGTGCCAGTAGTACGAGAACAGATACGCAGTATTTT	CASSTRTDTQYF	TRBV19	TRBJ2-3
TGTGCCAGCAGGGAGTTTCGGCGGGAAGTCTCTGGAAACACCATATATTTT	CASREFRREVSGNTIYF	TRBV6-1	TRBJ1-3
TGTGCCAGCAGCGTAATAACTAGCGGACACAATGAGCAGTTCTTC	CASSVITSGHNEQFF	TRBV9	TRBJ2-1
TGTGCCAGCTGGGGACTAGCGGGGGGGGACGAGCAGTACTTC	CASWGLAGGDEQYF	TRBV6-1	TRBJ2-7
TGCGCCAGCAGCTTGGGTGCGGGAGTTGAGACCCAGTACTTC	CASSLGAGVETQYF	TRBV5-1	TRBJ2-5
TGTGCCAGCAATTGGGGCATCCCCCTCTCTGGAAACACCATATATTTT	CASNWGIPLSGNTIYF	TRBV28	TRBJ1-3
TGCGCCAGCAGTGAGTCGACTGCCCGGGACAGGGGAACTTCCTACGAGCAGTACTTC	CASSESTARDRGTSYEQYF	TRBV10-1	TRBJ2-7
TGCGCCAGCAGCGGAGGACAGGGGGGACTGAACACTGAAGCTTTCTTT	CASSGGQGGLNTEAFF	TRBV5-1	TRBJ1-1
TGTGCTAGTCCCCTTCCCGGGACTAGCGGGAGGGGGACCTCTGAAGCTTTCTTT	CASPLPGTSGRGTSEAFF	TRBV12-5	TRBJ1-1
TGCGCCAGCAGCTTGCAATTCCCTGGGGGCTATAAAACCGGGGAGCTGTTTTTT	CASSLQFPGGYKTGELFF	TRBV5-1	TRBJ2-2
TGTGCCAGCAGTCTGACCGACGCTGAAGCTTTCTTT	CASSLTDAEAFF	TRBV6-4	TRBJ1-1
TGTGCCACCAGTGATTTTGGTTATTTGGACCTTGACAGGGCCAGGAGAAATCCCTCCTACAATGAGCAGTTCTTC	CATSDFGYLDLDRARRNPSYNEQFF	TRBV24-1	TRBJ2-1
TGTGCCTGGAGTGTACAGGGGGATACGCAGTATTTT	CAWSVQGDTQYF	TRBV30	TRBJ2-3
TGTGCCAGCAGCTTATCTCCCCTGGACAGGGGCTACACCTTC	CASSLSPLDRGYTF	TRBV7-9	TRBJ1-2
TGTGCCTGGAGTGTTGTAGGGGGGGGGGTCTACAATGAGCAGTTCTTC	CAWSVVGGGVYNEQFF	TRBV30	TRBJ2-1
TGTGACGCTAGGGTCTTCAATCAGCCCCAGCATTTT	CDARVFNQPQHF	TRBV11-3	TRBJ1-5
TGCGCCAGCAGCTTGGGGAAAAATCCAGACAGGGGCCTTCATATGAACACTGAAGCTTTCTTT	CASSLGKNPDRGLHMNTEAFF	TRBV5-1	TRBJ1-1
TGTGCCAGCAGTTTACTTCCGTGCGGGACAGACGACAGGATCCCTTTTGAGACCCAGTACTTC	CASSLLPCGTDDRIPFETQYF	TRBV27	TRBJ2-5
TGTGCCAGCAGCTGCAGAATCCCTGTATTATTAGCGGGGCTGCAGTTCTTC	CASSCRIPVLLAGLQFF	TRBV11-2	TRBJ2-1
TGTGCCAGCAGCCCCCGCATGCACAGGGTGAACACTGAAGCTTTCTTT	CASSPRMHRVNTEAFF	TRBV14	TRBJ1-1
TGTGCCAGTAGTCCGCGACAGGGCAATGAAAAACTGTTTTTT	CASSPRQGNEKLFF	TRBV19	TRBJ1-4
TGTGCCAGCAGTGACTCCCAACCAACGGGGATTAAAAATTCACCCCTCCACTTT	CASSDSQPTGIKNSPLHF	TRBV6-4	TRBJ1-6
TGTGCCAGCAGCTCCGTTAACAGGGGCCCGTTTATCTATAGCAATCAGCCCCAGCATTTT	CASSSVNRGPFIYSNQPQHF	TRBV7-9	TRBJ1-5
TGCAGTGCTAAGCGGGAAGACAATGAGCAGTTCTTC	CSAKREDNEQFF	TRBV20-1	TRBJ2-1
TGTGCCACCAGGTCCTGGGCAAGCTCCTACAATGAGCAGTTCTTC	CATRSWASSYNEQFF	TRBV24-1	TRBJ2-1
TGCAGCGTTCGTAGAATAGAGGGGCAGATGAACACTGAAGCTTTCTTT	CSVRRIEGQMNTEAFF	TRBV29-1	TRBJ1-1
TGTGCCAGCAGTTTTGGTATGTGGGGGAGCTCCTACGAGCAGTACTTC	CASSFGMWGSSYEQYF	TRBV12-4	TRBJ2-7
TGTGCCAGCAGCCCCCGGGGGGGGACTGAGCAGTTCTTC	CASSPRGGTEQFF	TRBV14	TRBJ2-1
TGCGCCAGCAGCATCGACAGGGGCTCTGGAAACACCATATATTTT	CASSIDRGSGNTIYF	TRBV5-1	TRBJ1-3
TGCAGTGCTAAACCCGACAGGGTATTGACCCAGTACTTC	CSAKPDRVLTQYF	TRBV20-1	TRBJ2-5
TGCAGTGCAAACGGACAGGGGATAAATTCACCCCTCCACTTT	CSANGQGINSPLHF	TRBV20-1	TRBJ1-6
TGTGCCAGCAGCGGCAGGGGCCAAGACGACAATGAGCAGTTCTTC	CASSGRGQDDNEQFF	TRBV6-6	TRBJ2-1
TGCAGTGCTGCCGACGGGGCAGACAATGAGCAGTTCTTC	CSAADGADNEQFF	TRBV20-1	TRBJ2-1
TGTGCCAGCAGTGACTCCCTAGCGGGGTGGGAGGATACGCAGTATTTT	CASSDSLAGWEDTQYF	TRBV6-4	TRBJ2-3
TGTGCCAGCAGCTTACCTTCAAGGGCGACAGGGAAGCCCCAGCATTTT	CASSLPSRATGKPQHF	TRBV11-2	TRBJ1-5
TGTGCCACCAGCAGATTTCCCGGGACAGGGGAGAGCACTGAAGCTTTCTTT	CATSRFPGTGESTEAFF	TRBV15	TRBJ1-1
TGTGCCAGCAGTGACGAACAGGGGGCCTACGAGCAGTACTTC	CASSDEQGAYEQYF	TRBV6-4	TRBJ2-7
TGTGCCAGCAGCTTAGAAGGAGGAGATACGCAGTATTTT	CASSLEGGDTQYF	TRBV7-9	TRBJ2-3
TGTGCCAGCAGTGGTCCGGCCTACAATGAGCAGTTCTTC	CASSGPAYNEQFF	TRBV25-1	TRBJ2-1
TGTGCCAGCAGTGACATTTCACAGGGGGCGCCAGCCGCTGATGAAAAACTGTTTTTT	CASSDISQGAPAADEKLFF	TRBV25-1	TRBJ1-4
TGTGCCAGCAGCTTAGGGAGGACAGGGGATCAGCCCCAGCATTTT	CASSLGRTGDQPQHF	TRBV13	TRBJ1-5
TGTGCCAGCAGACCGCTATGCTCTGGGGCCAACGTCCTGACTTTC	CASRPLCSGANVLTF	TRBV6-3	TRBJ2-6
TGTGCCATCACCAACCGGGACAAGAGGTCCCATTCACCCCTCCACTTT	CAITNRDKRSHSPLHF	TRBV10-3	TRBJ1-6
TGTGCCAGCAGCTTACGGCTAAGTCAGGGTACAGATACGCAGTATTTT	CASSLRLSQGTDTQYF	TRBV11-3	TRBJ2-3
TGCAGTGGGACAGGTGAAAAACTGTTTTTT	CSGTGEKLFF	TRBV20-1	TRBJ1-4
TGTGCCAGCAGCTTAGGAGTGACGGCGGGGCCCAACTACGAGCAGTACTTC	CASSLGVTAGPNYEQYF	TRBV7-9	TRBJ2-7
TGTGCCAGCAGCGACCCAGTCAGGGCGGCCGTTAGGAAGAGCTCTGGAAACACCATATATTTT	CASSDPVRAAVRKSSGNTIYF	TRBV13	TRBJ1-3
TGCGCCAGCAGCCAAGAACCAACAGGTGGCTATGGCTACACCTTC	CASSQEPTGGYGYTF	TRBV4-3	TRBJ1-2
TGCGCCAGCAGCTTGGGACAGGGTAACTACGAGCAGTACTTC	CASSLGQGNYEQYF	TRBV5-1	TRBJ2-7
TGTGCCAGCAGGGAACTAGCGGGCTCCTACGAGCAGTACTTC	CASRELAGSYEQYF	TRBV12-3	TRBJ2-7
TGTGCCAGCAGTCGCTCCCAGGGGGATTACGAGCAGTACTTC	CASSRSQGDYEQYF	TRBV28	TRBJ2-7
TGTGCCAGCAGCGGCACCCCCCTCCGGGACAGCAAGCACACCATATATTTT	CASSGTPLRDSKHTIYF	TRBV11-1	TRBJ1-3
TGTGCCAGCAGTTTAGGGACAGGGTCTAATGGCTACACCTTC	CASSLGTGSNGYTF	TRBV27	TRBJ1-2
TGTGCCAGCAGCGAGGGACAGTTTAGAACTAATGAAAAACTGTTTTTT	CASSEGQFRTNEKLFF	TRBV7-3	TRBJ1-4
TGTGCCACCAGTGACCAGGACTCCTACGAGCAGTACTTC	CATSDQDSYEQYF	TRBV24-1	TRBJ2-7
TGTGCCAGCAGCGGACCTAGGGAAGATACGCAGTATTTT	CASSGPREDTQYF	TRBV9	TRBJ2-3
TGTGCCAGCAGTTACCCCTCCCCGGGACAGGCCTATGGCTACACCTTC	CASSYPSPGQAYGYTF	TRBV6-5	TRBJ1-2
TGTGCCAGCAGATTGGCCCGGACAGGGGGGGGTCGGTACTATGGCTACACCTTC	CASRLARTGGGRYYGYTF	TRBV7-2	TRBJ1-2
TGTGCCAGCAGTGTAAGACGACTAGCGGGAAGAGAGACCCAGTACTTC	CASSVRRLAGRETQYF	TRBV6-4	TRBJ2-5
TGTGCCAGCAGTTTACAACCGATTCGACTTGACAGGGACAATGAGCAGTTCTTC	CASSLQPIRLDRDNEQFF	TRBV27	TRBJ2-1
TGTGCCAGCAGCCTCCGATCCTATAGCAATCAGCCCCAGCATTTT	CASSLRSYSNQPQHF	TRBV13	TRBJ1-5
TGCAGTCCCGCGGGAGTTTGGACTGAGACCCAGTACTTC	CSPAGVWTETQYF	TRBV20-1	TRBJ2-5
TGTGCCAGCGGGACAGGGGGGAATGAAAAACTGTTTTTT	CASGTGGNEKLFF	TRBV19	TRBJ1-4
TGTGCCAGCAGTTCTCCGGGACTAGCGGGTAAGGACAATGAGCAGTTCTTC	CASSSPGLAGKDNEQFF	TRBV27	TRBJ2-1
TGTGCCAGCAGCACATGGACAGGGGAAGAGACCCAGTACTTC	CASSTWTGEETQYF	TRBV7-3	TRBJ2-5
TGTGCCAGCAGTGCCTGGGGGAACACTGAAGCTTTCTTT	CASSAWGNTEAFF	TRBV2	TRBJ1-1
TGTGCCACCAGTATCGGGGCTTACCGGAGCACAGATACGCAGTATTTT	CATSIGAYRSTDTQYF	TRBV24-1	TRBJ2-3
TGCGCCAGCAGCTGTAGTGGGACAGGGGGCTCCTACAATGAGCAGTTCTTC	CASSCSGTGGSYNEQFF	TRBV5-1	TRBJ2-1
TGTGCCAGCACGAGACCGGGACAGGAGTCTTACACCGGGGAGCTGTTTTTT	CASTRPGQESYTGELFF	TRBV6-5	TRBJ2-2
TGTGCCAGCAGCCCCCGGGGGGTTGGGCTCTACGAGCAGTACTTC	CASSPRGVGLYEQYF	TRBV7-4	TRBJ2-7
TGTGCCAGCATTGACCCGGTGGACACGACAGATACGCAGTATTTT	CASIDPVDTTDTQYF	TRBV9	TRBJ2-3
TGTGCCAGCAGCGTAGCGGGGACAGGCAAAAACATTCAGTACTTC	CASSVAGTGKNIQYF	TRBV9	TRBJ2-4
TGTGCCAGCAGGAGGGCCCGACAGTGGACAGGAAACACCATATATTTT	CASRRARQWTGNTIYF	TRBV11-2	TRBJ1-3
TGCGCCAGCAGCTTGCCGAGGGTCCCCGGCAACTATGGCTACACCTTC	CASSLPRVPGNYGYTF	TRBV5-1	TRBJ1-2
TGTGCCAGCAGCCAAGAAATACCCGACACTCTTTACCAGTCCTACGAGCAGTACTTC	CASSQEIPDTLYQSYEQYF	TRBV3-1	TRBJ2-7
TGTGCCAGCAGCCAGAGGAACGGGGAGGTAAAACACCAAGAGACCCAGTACTTC	CASSQRNGEVKHQETQYF	TRBV7-2	TRBJ2-5
TGTGCCAGCAGCTTCAGCGGGAGTAGATACAATGAGCAGTTCTTC	CASSFSGSRYNEQFF	TRBV11-3	TRBJ2-1
TGTGCCAGCAGGGGACCAGTAAGCTCTGGGGCCAACGTCCTGACTTTC	CASRGPVSSGANVLTF	TRBV27	TRBJ2-6
TGTTTCCGGAGACCCGCTACTGAAGCTTTCTTT	CFRRPATEAFF	TRBV6-6	TRBJ1-1
TGTGTCGTTAGGAGGGGACTAGCTCGTTTCGAGCAGTACTTC	CVVRRGLARFEQYF	TRBV27	TRBJ2-7
TGTGCCAGCAGCCGTCCCCGGGACAGGGGCGGGGCTCGGTATGGCTACACCTTC	CASSRPRDRGGARYGYTF	TRBV5-4	TRBJ1-2
TGTGCCAGCAGCTGTGGATCCAGGTTACCCCCCCAGCATTTT	CASSCGSRLPPQHF	TRBV13	TRBJ1-5
TGTGCCAGCAGTGGGAAATCCCAAGCAGGAGGGAACACTGAAGCTTTCTTT	CASSGKSQAGGNTEAFF	TRBV6-1	TRBJ1-1
TGCAGTGCTTTGTCCCGAGGTGATGAGGGAAGGGGCATTCAGTACTTC	CSALSRGDEGRGIQYF	TRBV20-1	TRBJ2-4
TGCGCCAGCAGCTTCGCGGAGGGACAAGACAGCTCCTACGAGCAGTACTTC	CASSFAEGQDSSYEQYF	TRBV5-1	TRBJ2-7
TGTGCCAGCAGCAGGACAGGCGCTTTCTATAGCAATCAGCCCCAGCATTTT	CASSRTGAFYSNQPQHF	TRBV7-2	TRBJ1-5
TGCAGTGCTAGAGATAACGGCCTGTGTAGCGGGAGTTTAGGCTATAATTCACCCCTCCACTTT	CSARDNGLCSGSLGYNSPLHF	TRBV20-1	TRBJ1-6
TGTGCCAGCAGTAAGTTCCATAACTATGGCTACACCTTC	CASSKFHNYGYTF	TRBV6-1	TRBJ1-2
TGCAGCGTTTACCCCCCTTTACCAGGTGTCCAAGAGACCCAGTACTTC	CSVYPPLPGVQETQYF	TRBV29-1	TRBJ2-5
TGTGCCAGCAGCTTCGAGGCATGCATCTCCTACAATGAGCAGTTCTTC	CASSFEACISYNEQFF	TRBV11-2	TRBJ2-1
TGTGCCAGCAGTCCCCAAGACAGCGGGAGGTTTAACTGCCAGAGAAGCACAGATACGCAGTATTTT	CASSPQDSGRFNCQRSTDTQYF	TRBV27	TRBJ2-3
TGTGCCAGCAGCGAGATGGGACATCCCGCCTGTTATGGCTACACCTTC	CASSEMGHPACYGYTF	TRBV28	TRBJ1-2
TGCGCCAGCAGCTTGTGCGAGACTAGCTACGAGCAGTACTTC	CASSLCETSYEQYF	TRBV5-1	TRBJ2-7
TGTGCCAGCAGCCTGGGCGGAGGGGGGTTGGAAAATGAAAAACTGTTTTTT	CASSLGGGGLENEKLFF	TRBV3-1	TRBJ1-4
TGTGCCAGCAAAGTAGGAGGCGGCGAGCAGTACTTC	CASKVGGGEQYF	TRBV5-5	TRBJ2-7
TGTGCCAGTAGTATAGATAGCGGTGAGCAGTTCTTC	CASSIDSGEQFF	TRBV19	TRBJ2-1
TGTGCCAGCTGCAAACAGGGCCCTAACTCAGATACGCAGTATTTT	CASCKQGPNSDTQYF	TRBV5-6	TRBJ2-3
TGTGCCAGCAGTCGAACAGGGAAGGAGCCAGCTGTCCGGGCTCGGGGAAAACTGTTTTTT	CASSRTGKEPAVRARGKLFF	TRBV6-6	TRBJ1-4
TGTGCCAGCAGCAATGGACAGGGGCGTCTCTACGAGCAGTACTTC	CASSNGQGRLYEQYF	TRBV7-9	TRBJ2-7
TGCAGTGCTAGCCCTCGGGCCCCAGATACGCAGTATTTT	CSASPRAPDTQYF	TRBV20-1	TRBJ2-3
TGTGCCAGCAGCCATGCAACGAGGCGGCCCGGGTCCTACGAGCAGTACTTC	CASSHATRRPGSYEQYF	TRBV5-6	TRBJ2-7
TGTGCCAGCAGCTTTACGGACAGGGGAGTCGAGCAGTACTTC	CASSFTDRGVEQYF	TRBV5-4	TRBJ2-7
TGTGCCAGTAGTATAGTCTCCAGGACAGGAATGGAGAAATACAATGAGCAGTTCTTC	CASSIVSRTGMEKYNEQFF	TRBV19	TRBJ2-1
TGTGCGCGGAGGGGGGGTACAGATACGCAGTATTTT	CARRGGTDTQYF	TRBV28	TRBJ2-3
TGTGCCAGCACCTGCTGTGGCGACAGGAGGTCCTACGAGCAGTACTTC	CASTCCGDRRSYEQYF	TRBV27	TRBJ2-7
TGTGCCAGCAGCGGACAGGGCATGAGCTCTGGAAACACCATATATTTT	CASSGQGMSSGNTIYF	TRBV7-3	TRBJ1-3
TGTGCCACCAGCAGAGATTACCCCCACCTAATGGGGGGGTTCACAGATACGCAGTATTTT	CATSRDYPHLMGGFTDTQYF	TRBV15	TRBJ2-3
TGTGCCAGCAGTCCCCTAGCGGTAGATACGCAGTATTTT	CASSPLAVDTQYF	TRBV12-4	TRBJ2-3
TGCGCCAGCAGCTCTGGAGGACAAGAGACCCAGTACTTC	CASSSGGQETQYF	TRBV4-1	TRBJ2-5
TGTGCCAGCTTACAGGGGACCCGCCCGGCCTACGAGCAGTACTTC	CASLQGTRPAYEQYF	TRBV18	TRBJ2-7
TGTGCCACCAGTGACAGGGAATGTTGGTCATATGAGCAGTTCTTC	CATSDRECWSYEQFF	TRBV24-1	TRBJ2-1
TGTGCCAGCTGGCTTCCAGATACGCAGTATTTT	CASWLPDTQYF	TRBV27	TRBJ2-3
TGCAGTGCTAGAGGGCCCGGACAGAACTTCTACGAGCAGTACTTC	CSARGPGQNFYEQYF	TRBV20-1	TRBJ2-7
TGTGCCCTAGGGGAGAACTACGAGCAGTACTTC	CALGENYEQYF	TRBV10-3	TRBJ2-7
TGTGCCAGCAGCCGGCGGACAGGGATGAACACTGAAGCTTTCTTT	CASSRRTGMNTEAFF	TRBV3-1	TRBJ1-1
TGTGCCAGCAGTTTATGGGGGGCGGACCGTCGTCAGCCCCAGCATTTT	CASSLWGADRRQPQHF	TRBV27	TRBJ1-5
TGTGCCAGCAGTTTACCTGGCGGGGGGGGAAGCAATCAGCCCCAGCATTTT	CASSLPGGGGSNQPQHF	TRBV12-3	TRBJ1-5
TGTGCCAGCAGGGGGGCATCAATGGGGGGAAACACCATATATTTT	CASRGASMGGNTIYF	TRBV5-6	TRBJ1-3
TGTGCCAGCAGTGATCCCCAGGCCGGGGGACAGGGAATCTTC	CASSDPQAGGQGIF	TRBV25-1	TRBJ2-1
TGTGCCAGCAGTTACATGCATCGACAGAGTGACGAGCAGTACTTC	CASSYMHRQSDEQYF	TRBV6-5	TRBJ2-7
TGTGCCAGCAGACAGGGTGGCTACACCTTC	CASRQGGYTF	TRBV12-4	TRBJ1-2
TGTGCCAGCAGTTTCCGAGGACTAGCGGGAGGGCCCAACTATAACACTGAAGCTTTCTTT	CASSFRGLAGGPNYNTEAFF	TRBV28	TRBJ1-1
TGTGCCAGCACCCCGACTAGCGGCCACCACAATGAGCAGTTCTTC	CASTPTSGHHNEQFF	TRBV28	TRBJ2-1
TGTGCCACGGGTGGCACAGATACGCAGTATTTT	CATGGTDTQYF	TRBV7-9	TRBJ2-3
TGTGCCAAGTTGGACTACGGACTACCCTCTGGAAACACCATATATTTT	CAKLDYGLPSGNTIYF	TRBV6-3	TRBJ1-3
TGTGCCAGCAGCGTTCCACGCGACCCCCGACTAGCGGGTTTCACAGATACGCAGTATTTT	CASSVPRDPRLAGFTDTQYF	TRBV6-4	TRBJ2-3
TGTGCCTGGACTGGGGGGGAATACGAGCAGTACTTC	CAWTGGEYEQYF	TRBV30	TRBJ2-7
TGTGCCAGCAGCGGGCCAGTCGGGACAGGTAAAGGTCCATACTACGAGCAGTACTTC	CASSGPVGTGKGPYYEQYF	TRBV7-6	TRBJ2-7
TGTGCTAGTGGTTCGCCCCGGGGGGTGGCCGCTTTCTTT	CASGSPRGVAAFF	TRBV12-5	TRBJ1-1
TGTGCCAGCAGCGGTCCGCGGAACTCTGAAGCTTTCTTT	CASSGPRNSEAFF	TRBV9	TRBJ1-1
TGTGCCAGCATTCCGGGGGATAGCAATCAGCCCCAGCATTTT	CASIPGDSNQPQHF	TRBV9	TRBJ1-5
TGTGCCAGCAGTTTACAAGGGTTCCCCGGGGAGCTGTTTTTT	CASSLQGFPGELFF	TRBV27	TRBJ2-2
TGTGCCAGCAGCTTAGCGAGACCCCGAGACAGGGGGAATAATTCACCCCTCCACTTT	CASSLARPRDRGNNSPLHF	TRBV7-4	TRBJ1-6
TGTGCCAGCAGCGGGACAGACTCTGGAAACACCATATATTTT	CASSGTDSGNTIYF	TRBV6-4	TRBJ1-3
TGTGCCAGCAGCCAAGGGACTTTCCACGAGCAGTACTTC	CASSQGTFHEQYF	TRBV14	TRBJ2-7
TGCAGTGCTAGAGCGAACCCTCCTGGACAGATAATTAAAGCTTTCTTT	CSARANPPGQIIKAFF	TRBV20-1	TRBJ1-1
TGTGCCAGCAGCAAAGGGACTAGACGGAAAGAGACCCAGTACTTC	CASSKGTRRKETQYF	TRBV7-3	TRBJ2-5
TGTGCCAGCAGTGAATACCCCGTCCGGGGCCGGCCCTACAATGAGCAGTTCTTC	CASSEYPVRGRPYNEQFF	TRBV25-1	TRBJ2-1
TGCGCCATTTCCCTCGAGAACACTGAAGCTTTCTTT	CAISLENTEAFF	TRBV5-1	TRBJ1-1
TGTGCCAGCAGCTGGCCGCTCCTCTGTGCTGAAGCTTTCTTT	CASSWPLLCAEAFF	TRBV7-3	TRBJ1-1
TGTGCCAGCCACAGGGGCGTGGAGGGGGGCCGTGGCTACACCTTC	CASHRGVEGGRGYTF	TRBV27	TRBJ1-2
TGTGCTAGTGATACCCCCGGGACAGGGGTCGAATTCTCGGGGGACATTCAGTACTTC	CASDTPGTGVEFSGDIQYF	TRBV12-5	TRBJ2-4
TGTGCCACGGGGGGCGGAAGGGAAAGGGGGGGCTACACCTTC	CATGGGRERGGYTF	TRBV24-1	TRBJ1-2
TGTGCCAGCTCACACGGGACTAGCAAGGTGGAACAGTTCTACGAGCAGTACTTC	CASSHGTSKVEQFYEQYF	TRBV18	TRBJ2-7
TGTGCCAGCAACGCAGGGAGGTTCTACAATGAGCAGTTCTTC	CASNAGRFYNEQFF	TRBV6-2	TRBJ2-1
TGTGCCAGCAGTGAATACGGGACTAGCGGGTCCCCGGACACAGATACGCAGTATTTT	CASSEYGTSGSPDTDTQYF	TRBV25-1	TRBJ2-3
TGTGCCAGCAGCTTAGGTCTATTCCGGGGCCCCTTGAACACTGAAGCTTTCTTT	CASSLGLFRGPLNTEAFF	TRBV7-2	TRBJ1-1
TGTGCCACCAGTGATGGAAAACCGGCGCAGGGTAATGAAAAACTGTTTTTT	CATSDGKPAQGNEKLFF	TRBV24-1	TRBJ1-4
TGTGCCAGCAGCTTCGAAGGGAAGGCCCTGCGGAACACTGAAGCTTTCTTT	CASSFEGKALRNTEAFF	TRBV7-6	TRBJ1-1
TGTGCCAGCAGCGGTCCGAGAGCAGGACTAGCGGGCACTAAGGTCACAGATACGCAGTATTTT	CASSGPRAGLAGTKVTDTQYF	TRBV11-2	TRBJ2-3
TGTGCCAGCAGCTTGGCTATTGACAGGGGGCAAGAGACCCAGTACTTC	CASSLAIDRGQETQYF	TRBV5-5	TRBJ2-5
TGTGCCAGCAGCTTAGATCCCCGGGACCGGGGCGCGAACACCGGGGAGCTGTTTTTT	CASSLDPRDRGANTGELFF	TRBV11-3	TRBJ2-2
TGTGCCACCAGTGATTTGTTATCTCCGGCAGGCAACGCCTCTGGGGCCAACGTCCTGACTTTC	CATSDLLSPAGNASGANVLTF	TRBV24-1	TRBJ2-6
TGTGCCAGCAGCTATAAAGACAGGGGTAACACCATATATTTT	CASSYKDRGNTIYF	TRBV7-2	TRBJ1-3
TGTGCCAGCAGCCAAAGTTCCCAGCCTGGGGGGGCCATTGATACGCAGTATTTT	CASSQSSQPGGAIDTQYF	TRBV14	TRBJ2-3
TGTGCCAGCAGCGACTACAAAGGGTCCGGACGGACCACTGAAGCTTTCTTT	CASSDYKGSGRTTEAFF	TRBV7-3	TRBJ1-1
TGCAGTGCTAGCAGGGGGACAGATACGCAGTATTTT	CSASRGTDTQYF	TRBV20-1	TRBJ2-3
TGCAGTGCCCCCTGGTATAACTATGGCTACACCTTC	CSAPWYNYGYTF	TRBV20-1	TRBJ1-2
TGTGCCAGTAGTGGTACAAGCACCGGGGAGCTGTTTTTT	CASSGTSTGELFF	TRBV19	TRBJ2-2
TGCGCCAGCAGCTTCCGGAAGACCCAGTACTTC	CASSFRKTQYF	TRBV5-1	TRBJ2-5
TGCAGTGCTAGAGATCTCTCAAAGGGACAGGGGGCATTCACCCTCCACTTT	CSARDLSKGQGAFTLHF	TRBV20-1	TRBJ1-6
TGTGCCAGCAGTGCTAATTGGGACAGGGGGACGACTTTTTCACCCCTCCACTTT	CASSANWDRGTTFSPLHF	TRBV6-1	TRBJ1-6
TGTGCCACGAGTTCCTGCGGGAGAATTGAAGATACGCAGTATTTT	CATSSCGRIEDTQYF	TRBV12-3	TRBJ2-3
TGTGCCAGCAGCTCTTCCTACCGTTATCACTCCTACAATGAGCAGTTCTTC	CASSSSYRYHSYNEQFF	TRBV7-3	TRBJ2-1
TGTGCCAGCAAAACAGGGGGCTCCACTGAAGCTTTCTTT	CASKTGGSTEAFF	TRBV28	TRBJ1-1
TGTGCCATCAAACCTATACCGGAAGATGAGCAGTTCTTC	CAIKPIPEDEQFF	TRBV10-3	TRBJ2-1
TGTGCCAGCAGCGTAGACCATCAGCGGGACAGCACTGAAGCTTTCTTT	CASSVDHQRDSTEAFF	TRBV9	TRBJ1-1
TGTGCCAGCAGTTTATGGGGACAGGGATGCCAGCCCCAGCATTTT	CASSLWGQGCQPQHF	TRBV28	TRBJ1-5
TGCGCCAGCAGCCAACGGAGGGGACAGGGGAACACCGGGGAGCTGTTTTTT	CASSQRRGQGNTGELFF	TRBV4-1	TRBJ2-2
TGTGCCAGCAGGTGGGGGGACAGGGAAGTTAGGTATGGCTACACCTTC	CASRWGDREVRYGYTF	TRBV5-6	TRBJ1-2
TGTGCCAGCAGCGACGAGGGACCGTGCTCACAGCCCCAGCATTTT	CASSDEGPCSQPQHF	TRBV9	TRBJ1-5
TGTGCCACCAGCAGAGAAGCTCAGGGGGACGAGCAGTACTTC	CATSREAQGDEQYF	TRBV15	TRBJ2-7
TGTGCCATTCGTGGGGGCGGGTACAATGAGCAGTTCTTC	CAIRGGGYNEQFF	TRBV7-9	TRBJ2-1
TGTGCCCGAGGGACAGATAGTGCCACCGGGGAGCTGTTTTTT	CARGTDSATGELFF	TRBV24-1	TRBJ2-2
TGTGCCAGCAGCTCCCCAGGGTATAGCAATCAGCCCCAGCATTTT	CASSSPGYSNQPQHF	TRBV11-2	TRBJ1-5
TGTGCCAGCAGCCTAAAGACTAGCGGGCGCGACACCGGGGAGCTGTTTTTT	CASSLKTSGRDTGELFF	TRBV14	TRBJ2-2
TGTGCCACCAGTGATTTGCAGTCCCTCATTCCGGGACAGGGGGAATGTGCAACTAATGAAAAACTGTTTTTT	CATSDLQSLIPGQGECATNEKLFF	TRBV24-1	TRBJ1-4
TGTGCCAGCAGCTTCTCAACTAATGAAAAACTGTTTTTT	CASSFSTNEKLFF	TRBV7-9	TRBJ1-4
TGTGCCAGCAGCCCGGGGACCTCTGGGAAAGCTTTCTTT	CASSPGTSGKAFF	TRBV11-1	TRBJ1-1
TGTGCCAGTAGTATCCCAATTGGTCCACTAGTGTCCAATGAGCAGTTCTTC	CASSIPIGPLVSNEQFF	TRBV19	TRBJ2-1
TGTGCCAGCAGCGGCCCCCGGGGGGGCGTGACTTTGGACGAGCAGTACTTC	CASSGPRGGVTLDEQYF	TRBV7-3	TRBJ2-7
TGTGCCACCCCGTCGGTCATGAGCTCCTACGAGCAGTACTTC	CATPSVMSSYEQYF	TRBV24-1	TRBJ2-7
TGTGCCAGCAGCCAAGACACGGGGCGCGTAACCACCTTC	CASSQDTGRVTTF	TRBV14	TRBJ1-2
TGCAGTGCTAGGAGCCCCTATAATTCACCCCTCCACTTT	CSARSPYNSPLHF	TRBV20-1	TRBJ1-6
TGCGCCAGCAAGGGGGCGCCCAGCAATCAGCCCCAGCATTTT	CASKGAPSNQPQHF	TRBV5-1	TRBJ1-5
TGTGCCATCAGGCCCCAGAGGGGGCATTCACCCCTCCACTTT	CAIRPQRGHSPLHF	TRBV10-3	TRBJ1-6
TGTGCCAGCAGCTTGGAACAAGGTGGCACTGAAGCTTTCTTT	CASSLEQGGTEAFF	TRBV7-2	TRBJ1-1
TGTGCCAGTAGTACGGGAGGACAGGGGTCATGGGGCCTATACGAGCAGTACTTC	CASSTGGQGSWGLYEQYF	TRBV19	TRBJ2-7
TGCGCCAGCAGTGATCGCCACAGGGGGAGCAATAGCAATCAGCCCCAGCATTTT	CASSDRHRGSNSNQPQHF	TRBV10-1	TRBJ1-5
TGTGCCAGCAGCTTAAGGGTATCGGGGTTCCATGAAGAGACCCAGTACTTC	CASSLRVSGFHEETQYF	TRBV11-3	TRBJ2-5
TGCGCCAGCAGTCCTCGGGACAGGGGCCCAGCTAACTATGGCTACACCTTC	CASSPRDRGPANYGYTF	TRBV10-1	TRBJ1-2
TGTGCCAGCAGTACGCGGTACGAGCAGTACTTC	CASSTRYEQYF	TRBV28	TRBJ2-7
TGTGCCAGCAGTTATCCGAAGACAGTCAGAGATACGCAGTATTTT	CASSYPKTVRDTQYF	TRBV6-2	TRBJ2-3
TGTGCCAGCAGCCAAGCCCTTGAAAACTATGAGCAGTTCTTC	CASSQALENYEQFF	TRBV3-1	TRBJ2-1
TGCAGTGCTAGAAATACTAGCGGGGGAACGTACCAAGAGACCCAGTACTTC	CSARNTSGGTYQETQYF	TRBV20-1	TRBJ2-5
TGTGCCAGCAGCTTAACACAGGGCAATCAGCCCCAGCATTTT	CASSLTQGNQPQHF	TRBV11-3	TRBJ1-5
TGTGCCAGCCCTGGACAGAGCGCCTCCTACGAGCAGTACTTC	CASPGQSASYEQYF	TRBV6-3	TRBJ2-7
TGCGCCAGCAGCTTGCTAAGACTACGTGGGCCCGGTGGCTACGAGCAGTACTTC	CASSLLRLRGPGGYEQYF	TRBV5-1	TRBJ2-7
TGTGCCAGCAGCCTAATAGGGTCCTACGAGCAGTACTTC	CASSLIGSYEQYF	TRBV3-1	TRBJ2-7
TGTGCCAGCAGCTTAGCGGGGTCTACGGGGGGGCCGCAAGAGACCCAGTACTTC	CASSLAGSTGGPQETQYF	TRBV11-2	TRBJ2-5
TGTGCCAGCAGTCTCACAGGGGACTCTGCTTTCTTT	CASSLTGDSAFF	TRBV27	TRBJ1-1
TGCAGTGCTAGATACAGTTATGGCTACACCTTC	CSARYSYGYTF	TRBV20-1	TRBJ1-2
TGTGCCAGCAGCTTGAACAGGGGGCGCGATGGCTACACCTTC	CASSLNRGRDGYTF	TRBV5-5	TRBJ1-2
TGCGCCAGCAGCTTGTCGTTTGGGACATCGTTCAACACCGGGGAGCTGTTTTTT	CASSLSFGTSFNTGELFF	TRBV5-1	TRBJ2-2
TGTGCCAGCAAACGACACACCTCTGGAAACACCATATATTTT	CASKRHTSGNTIYF	TRBV6-2	TRBJ1-3
TGTGCCAGCAGCCTCCCGGACAGGGCTCTGAAGAACACTGAAGCTTTCTTT	CASSLPDRALKNTEAFF	TRBV3-1	TRBJ1-1
TGTGCCAGCAGCTTGGTCGACGGGGAGCTGTTTTTT	CASSLVDGELFF	TRBV7-9	TRBJ2-2
TGTGCCACCAGAAACAGGGGTTTCAGAACTCACTATGGCTACACCTTC	CATRNRGFRTHYGYTF	TRBV24-1	TRBJ1-2
TGTGCCAGCAGCTTAAATAGCGATACGCAGTATTTT	CASSLNSDTQYF	TRBV11-2	TRBJ2-3
TGTGCCACCAGTGATTACACTAGCGGGAGCGGGGGGCACGAGCAGTACTTC	CATSDYTSGSGGHEQYF	TRBV24-1	TRBJ2-7
TGTGCCTTGCCCCCGCCTTGGTCCAAGGGCAGCAATCAGCCCCAGCATTTT	CALPPPWSKGSNQPQHF	TRBV30	TRBJ1-5
TGTAGGACAGGGACTGGGAACACTGAAGCTTTCTTT	CRTGTGNTEAFF	TRBV7-2	TRBJ1-1
TGTGCCAGCAGCGCATTAAAGGGGGCCACTGAAGCTTTCTTT	CASSALKGATEAFF	TRBV7-9	TRBJ1-1
TGTGCCACCGTACCCCTTGCCCCCTGTAGGACCAGGTTTGCAACTAATGAAAAACTGTTTTTT	CATVPLAPCRTRFATNEKLFF	TRBV24-1	TRBJ1-4
TGCGCCAGCAGCTTGGAACGGCGGACAGGGGCGACCGGGGAGCTGTTTTTT	CASSLERRTGATGELFF	TRBV5-1	TRBJ2-2
TGTGCCACCAGCAGAGGGGAGGGCCAGCAGTTCTTC	CATSRGEGQQFF	TRBV15	TRBJ2-1
TGTGCCAGGCTATCGTTTTACGAGCAGTACTTC	CARLSFYEQYF	TRBV7-4	TRBJ2-7
TGTGCCAGCAGGGTAGCGGGTTTGTGCACAGATACGCAGTATTTT	CASRVAGLCTDTQYF	TRBV19	TRBJ2-3
TGTGCCAGCAGCCCGGGAACTAGCGGGGGAATTACGTCCTACGAGCAGTACTTC	CASSPGTSGGITSYEQYF	TRBV3-1	TRBJ2-7
TGTGCCAGCAGCCCCCCAGGAGCGGAGGGGTCCTACGAGCAGTACTTC	CASSPPGAEGSYEQYF	TRBV11-3	TRBJ2-7
TGTGCCAGCTCACCTAACCCCCAGCCCCAGCATTTT	CASSPNPQPQHF	TRBV18	TRBJ1-5
TGTGCCAGCAGGAGGCAAGGTGAAAAACTGTTTTTT	CASRRQGEKLFF	TRBV7-2	TRBJ1-4
TGTGCCAGCAGTTTACTGTTCACAGGTGGGAATCAGCCCCAGCATTTT	CASSLLFTGGNQPQHF	TRBV28	TRBJ1-5
TGTGCCAGCAGTGGGCACAGGGAGCTGAACACTGAAGCTTTCTTT	CASSGHRELNTEAFF	TRBV6-6	TRBJ1-1
TGTGCCAGCAGCTTTTCCGGGCCCGAGCAGTACTTC	CASSFSGPEQYF	TRBV11-2	TRBJ2-7
TGTGCCAGCCAACCCTGGGACAGGGCGCCCCTTTCTCTCACCTTC	CASQPWDRAPLSLTF	TRBV7-6	TRBJ1-2
TGCACCCAAACCGGGACAGGGGCGAACACTGAAGCTTTCTTT	CTQTGTGANTEAFF	TRBV20-1	TRBJ1-1
TGTGCCAGCAGCGGATTCATAGGGGGTGAGCAGTTCTTC	CASSGFIGGEQFF	TRBV13	TRBJ2-1
TGTGCCAGCAGCCGGCCGGGATCCAGCTCCTACGAGCAGTACTTC	CASSRPGSSSYEQYF	TRBV7-2	TRBJ2-7
TGTGCCAGCAGCTTGGGATTACAGCCCCAGCATTTT	CASSLGLQPQHF	TRBV5-4	TRBJ1-5
TGTGCCAGCAGTGAAGGGACAGAGACCCAGTACTTC	CASSEGTETQYF	TRBV6-4	TRBJ2-5
TGTGCCAGCAGTTTTCAGGGGGCTTTCTTT	CASSFQGAFF	TRBV12-4	TRBJ1-1
TGTGCCAGCAAAGGAGGGACCTACGAGCAGTACTTC	CASKGGTYEQYF	TRBV6-1	TRBJ2-7
TGTGCCAGCAGCTTATTTAGGAACCGGGACATGAACACTGAAGCTTTCTTT	CASSLFRNRDMNTEAFF	TRBV7-8	TRBJ1-1
TGTGCCAGCAGCCGAACCCGGGACTCATCCCAGTACTTC	CASSRTRDSSQYF	TRBV7-9	TRBJ2-5
TGTGCCAGCAGTCTACAGGGAGAGAGCCGAAGCTCCTACGAGCAGTACTTC	CASSLQGESRSSYEQYF	TRBV25-1	TRBJ2-7
TGTGCCAGCAGTTACGCAATCGGGACAGATCATAATGAAAAACTGTTTTTT	CASSYAIGTDHNEKLFF	TRBV6-5	TRBJ1-4
TGTGCCAGCAGCAGTTCCGGGACGTTCACTGAAGCTTTCTTT	CASSSSGTFTEAFF	TRBV14	TRBJ1-1
TGTGCCAGCGAGTGGGATCCCAAAAACATTCAGTACTTC	CASEWDPKNIQYF	TRBV19	TRBJ2-4
TGCAGTGCTATTGTAGGACAGGGATCTGAGCAGTTCTTC	CSAIVGQGSEQFF	TRBV20-1	TRBJ2-1
TGTGCCAGCAGCATGATCCGCCAGACCGGGACAGCAACTAATGAAAAACTGTTTTTT	CASSMIRQTGTATNEKLFF	TRBV13	TRBJ1-4
TGTGCCAGCAGCGAGGAGTGTATAAATCCCCGATACAATGAGCAGTTCTTC	CASSEECINPRYNEQFF	TRBV3-1	TRBJ2-1
TGTGCCAGCTCACCACAATACACGACTAGCGGGAGGGGACATGAGACCCAGTACTTC	CASSPQYTTSGRGHETQYF	TRBV18	TRBJ2-5
TGCAGTGCCACTAGGCTAGCGGGACTCGAGCAGTACTTC	CSATRLAGLEQYF	TRBV20-1	TRBJ2-7
TGTGCCAGGCCGAATCGATCACCCCTCCACTTT	CARPNRSPLHF	TRBV6-6	TRBJ1-6
TGTGCCAGCAGCTTAGACCGGATAAGCACAGATACGCAGTATTTT	CASSLDRISTDTQYF	TRBV7-9	TRBJ2-3
TGTGCCAGCAGCTTAGCCTCCCGGGGGGTCAATGAGCAGTTCTTC	CASSLASRGVNEQFF	TRBV7-2	TRBJ2-1
TGTGCCACCAGCAGAGATAGACTAGGAGTCTACGAGCAGTACTTC	CATSRDRLGVYEQYF	TRBV15	TRBJ2-7
TGTGCCATCAGTGAGGTTAAAGGACTAGCGGGCGAGCAGTACTTC	CAISEVKGLAGEQYF	TRBV10-3	TRBJ2-7
TGTGCCAGCAGCTGGGGACTCTACAATGAGCAGTTCTTC	CASSWGLYNEQFF	TRBV7-7	TRBJ2-1
TGTGCCACCTCTTGGGGACAGGGCAATCAGCCCCAGCATTTT	CATSWGQGNQPQHF	TRBV24-1	TRBJ1-5
TGTGCCAGCAGTTTATTTTCCGACAGGCCTTATAGCAATCAGCCCCAGCATTTT	CASSLFSDRPYSNQPQHF	TRBV28	TRBJ1-5
TGTGCCACCAGTGAAGGCCGGAGGGGTAATTACGAGCAGTACTTC	CATSEGRRGNYEQYF	TRBV24-1	TRBJ2-7
TGTGCCTGTAGACAGGATTATAATTCACCCCTCCACTTT	CACRQDYNSPLHF	TRBV30	TRBJ1-6
TGTGCTAGTGGAGTGAGGGGGATGAACACTGAAGCTTTCTTT	CASGVRGMNTEAFF	TRBV12-5	TRBJ1-1
TGCGCCAGCAGCCCGGTCCACGGGGACGTTGCCACCTGGGAAGAGACCCAGTACTTC	CASSPVHGDVATWEETQYF	TRBV5-1	TRBJ2-5
TGTGCCAGCAGCGTCCACAGGGGCCGGTTTCATAGCAATCAGCCCCAGCATTTT	CASSVHRGRFHSNQPQHF	TRBV9	TRBJ1-5
TGTGCCAGCAGGTATGACAGCGGCAACTCTGGAAACACCATATATTTT	CASRYDSGNSGNTIYF	TRBV7-9	TRBJ1-3
TGTGCCAGCAGCTTAGGCAAGTCGGGACTAGCGGGGGTTATCGAGCAGTACTTC	CASSLGKSGLAGVIEQYF	TRBV7-4	TRBJ2-7
TGCGCCAGCAGTGATAAGGAATTGTCTGGAAAAATCACTGGAAACACCATATATTTT	CASSDKELSGKITGNTIYF	TRBV10-1	TRBJ1-3
TGTGCCAGCAGTTTAGTGCCTGAGGACAGGGGAGTCGGGTTTAATGAAGCTTTCTTT	CASSLVPEDRGVGFNEAFF	TRBV12-4	TRBJ1-1
TGTGCCAGCAGTGTAGACGCACGGAGCGTAGCCAAAAACATTCAGTACTTC	CASSVDARSVAKNIQYF	TRBV25-1	TRBJ2-4
TGTGCCAGCAGCGAAAAACCGAGGTCGGAAGAGACCCAGTACTTC	CASSEKPRSEETQYF	TRBV9	TRBJ2-5
TGTGCCAGCAGCCAAGCGGTTTCTTCACCCCTCCACTTT	CASSQAVSSPLHF	TRBV4-2	TRBJ1-6
TGTGCCACCAGTGACCTCACTGCCAAAAACATTCAGTACTTC	CATSDLTAKNIQYF	TRBV24-1	TRBJ2-4
TGTGCCAGCAGTTACTGCGGGGGTACTGAAGCTTTCTTT	CASSYCGGTEAFF	TRBV6-3	TRBJ1-1
TGTGCCAGCAGCCCTATCCCGGGACAGGGCTTAGGGGGGACAACTAATGAAAAACTGTTTTTT	CASSPIPGQGLGGTTNEKLFF	TRBV3-1	TRBJ1-4
TGCAGTGCTAGAGGCCGAGGGCATGAGCAGTTCTTC	CSARGRGHEQFF	TRBV20-1	TRBJ2-1
TGCAGTGCCCCCAAGGCCTTGGGACTAGCGGGAGCTGAGCAGTTCTTC	CSAPKALGLAGAEQFF	TRBV20-1	TRBJ2-1
TGTGCCAGCAGCCCGAGAGGCGGGGAGCTGTTTTTT	CASSPRGGELFF	TRBV11-3	TRBJ2-2
TGTGCCAGCAGTTACTCGATGTTCTGGCGGGCATGTATTCAGCCCCAGCATTTT	CASSYSMFWRACIQPQHF	TRBV6-6	TRBJ1-5
TGTGCCAGCAGCTTTACCCCGGGGGGGAAACACGAGCAGTACTTC	CASSFTPGGKHEQYF	TRBV5-4	TRBJ2-7
TGCGCCAGCAGCCAAGGCAGCAACTCCTACGAGCAGTACTTC	CASSQGSNSYEQYF	TRBV4-3	TRBJ2-7
TGTGCCAGCAGCGGACAGGCAGGGACTGAAGCTTTCTTT	CASSGQAGTEAFF	TRBV9	TRBJ1-1
TGTGCCAGCAGCCTACGTCACGGCTACGAGCAGTACTTC	CASSLRHGYEQYF	TRBV7-3	TRBJ2-7
TGTGCCTGGGAGTCCGGCTCCTACGAGCAGTACTTC	CAWESGSYEQYF	TRBV30	TRBJ2-7
TGTGCCAGCGTGGGAAAGTCGGGCCGCTACGAGCAGTACTTC	CASVGKSGRYEQYF	TRBV6-1	TRBJ2-7
TGTGCCAGCAGCCCCCACCGGTACTATGGCTACACCTTC	CASSPHRYYGYTF	TRBV9	TRBJ1-2
TGTGCCAGCAGTCCTGAGGGGCCAGACAATGAGCAGTTCTTC	CASSPEGPDNEQFF	TRBV27	TRBJ2-1
TGTGCCACCAGTGATTTCATCAGGACAGGGTTGAGCTCCTATAATTCACCCCTCCACTTT	CATSDFIRTGLSSYNSPLHF	TRBV24-1	TRBJ1-6
TGTGCCAGCTCCGGGACATTTCAAGGCTACGAGCAGTACTTC	CASSGTFQGYEQYF	TRBV27	TRBJ2-7
TGTGCCAGCAGCTTAGAGTGCGGGCCTATTTTTCAGCCCCAGCATTTT	CASSLECGPIFQPQHF	TRBV7-8	TRBJ1-5
TGCGCCAGCAGCCAGGGGATCTTC	CASSQGIF	TRBV4-1	TRBJ2-1
TGCGCCAGCAGCTTGGCCAGGGCGGGGGCTGGAGGCTCCTACGAGCAGTACTTC	CASSLARAGAGGSYEQYF	TRBV5-1	TRBJ2-7
TGTGCCAGCAGTGATAACCGAGCTGGGGGCGAAAAACTGTTTTTT	CASSDNRAGGEKLFF	TRBV27	TRBJ1-4
TGCACAGTGGTGGGATTAGTTGGTACCTACAATGAGCAGTTCTTC	CTVVGLVGTYNEQFF	TRBV20-1	TRBJ2-1
TGTGCCAGCCCCCGCTACAGGGGGCTATCTAGCACAGATACGCAGTATTTT	CASPRYRGLSSTDTQYF	TRBV7-3	TRBJ2-3
TGTGCCAGCAGTGATCGGGGAGGAAACACCATATATTTT	CASSDRGGNTIYF	TRBV6-1	TRBJ1-3
TGTGCCAGCAGTCCCTGTTCAAGGGGGAGGGGAGGCAATCAGCCCCAGCATTTT	CASSPCSRGRGGNQPQHF	TRBV27	TRBJ1-5
TGTGCCAGTAGTATTGGACAAGTGTGGAGGGTCGGGGAGCTGTTTTTT	CASSIGQVWRVGELFF	TRBV19	TRBJ2-2
TGTGCCATCATCCACAGAGCTGAAGCTTTCTTT	CAIIHRAEAFF	TRBV10-3	TRBJ1-1
TGTGCCAGCAGCTGGACAGGGACGAACACTGAAGCTTTCTTT	CASSWTGTNTEAFF	TRBV7-3	TRBJ1-1
TGTGCCAACGAACTGACAGGGCCGATGAACACTGAAGCTTTCTTT	CANELTGPMNTEAFF	TRBV6-4	TRBJ1-1
TGTGCCAGCAGGGGGGGGGGGTCCTACAATGAGCAGTTCTTC	CASRGGGSYNEQFF	TRBV6-2	TRBJ2-1
TGTGCCAGCAGCTTTAAGCCTAGAAACTCCTACAATGAGCAGTTCTTC	CASSFKPRNSYNEQFF	TRBV11-2	TRBJ2-1
TGTGCCAGCAGTTTACAGAAGACACACAATCAGCCCCAGCATTTT	CASSLQKTHNQPQHF	TRBV27	TRBJ1-5
TGTGCCAGCAGCTCTGGGTTTTCCTGGGACAGGGTTTACCTGGGAAACACCATATATTTT	CASSSGFSWDRVYLGNTIYF	TRBV9	TRBJ1-3
TGTGCCAGCAGTTACCTAAGGAGACAGGGGGCCTCTGGGGCCAACGTCCTGACTTTC	CASSYLRRQGASGANVLTF	TRBV6-2	TRBJ2-6
TGTGCCAGCAGCCAAGGCATTCCACAGCCCCAGCATTTT	CASSQGIPQPQHF	TRBV6-4	TRBJ1-5
TGTGCCAGCAGTCCCAGAATAAACACTGAAGCTTTCTTT	CASSPRINTEAFF	TRBV27	TRBJ1-1
TGTGCCAGCAGCTTGATGACGGGACTCGTCCGGCCGCCTAGCACAGATACGCAGTATTTT	CASSLMTGLVRPPSTDTQYF	TRBV5-6	TRBJ2-3
TGTGCCAGCAGCGCCGGGCGGCTGGGAGGGAGGAAGGGTAGCAATCAGCCCCAGCATTTT	CASSAGRLGGRKGSNQPQHF	TRBV9	TRBJ1-5
TGTGCCAGCAGCACGGCCGAGCCCCAGCATTTT	CASSTAEPQHF	TRBV11-3	TRBJ1-5
TGTGCTAGCAGCAGAGACAGTACCTCTGGAAACACCATATATTTT	CASSRDSTSGNTIYF	TRBV7-7	TRBJ1-3
TGTGCCAGCAGTCCGGGCCGCGATGCTAACTATGGCTACACCTTC	CASSPGRDANYGYTF	TRBV6-5	TRBJ1-2
TGCAGTGCTATTCTAACAGATACGCAGTATTTT	CSAILTDTQYF	TRBV20-1	TRBJ2-3
TGCAGTGCTTTAGATAAAGAGACCCAGTACTTC	CSALDKETQYF	TRBV20-1	TRBJ2-5
TGTGCCAGCAGCTTACTACCGCCAGGGACTAACTACAATGAGCAGTTCTTC	CASSLLPPGTNYNEQFF	TRBV11-2	TRBJ2-1
TGTGCCAGCAGTTCCCCCTCCGGACTAGATCGTCGCTTCGAGCAGTACTTC	CASSSPSGLDRRFEQYF	TRBV27	TRBJ2-7
TGTGCCAGCAGCCAACCTTCGGTGGAGGGGATACAGGCTGGAAACACCATATATTTT	CASSQPSVEGIQAGNTIYF	TRBV14	TRBJ1-3
TGCGCCGGGAAGCGGGAGAGCAATCAGCCCCAGCATTTT	CAGKRESNQPQHF	TRBV10-1	TRBJ1-5
TGTGCCAGCAACATAAGCCTAGCGGGCATTTCCAGCACAGATACGCAGTATTTT	CASNISLAGISSTDTQYF	TRBV9	TRBJ2-3
TGTGCCAGCAGGGTATACTACGAGCAGTACTTC	CASRVYYEQYF	TRBV6-4	TRBJ2-7
TGCGCCAGCAGTGCTATAGCGGGCGACAATGAGCAGTTCTTC	CASSAIAGDNEQFF	TRBV10-1	TRBJ2-1
TGTGCCAGCATCCCGAGGGACAGGGATAGGGCCACAGATACGCAGTATTTT	CASIPRDRDRATDTQYF	TRBV12-3	TRBJ2-3
TGTGCCAGCAGCTTAGCAGTTCGGAATGGTTTAGGGGACCGAGGCTACACCTTC	CASSLAVRNGLGDRGYTF	TRBV6-3	TRBJ1-2
TGTGCCAGCAGTGGGAGGGCGGGGCCCACCGGGGAGCTGTTTTTT	CASSGRAGPTGELFF	TRBV6-2	TRBJ2-2
TGTGCCAGCACACGGACCAGGATTTTCTACGAGCAGTACTTC	CASTRTRIFYEQYF	TRBV28	TRBJ2-7
TGTGCCAGCAGCCCGATAGTCAGGGGTAGCACAGATACGCAGTATTTT	CASSPIVRGSTDTQYF	TRBV3-1	TRBJ2-3
TGCAGTGCTAGAGGGCCGGGCTACGAGCAGTACTTC	CSARGPGYEQYF	TRBV20-1	TRBJ2-7
TGTGCCAGCAGTTCCGTCAGATGGCCCGCTACTAGCGGGAGTGAACCATATTCACCCCTCCACTTT	CASSSVRWPATSGSEPYSPLHF	TRBV6-5	TRBJ1-6
TGCAGCGTTGGACTAGCGGGTTACACCGGGGAGCTGTTTTTT	CSVGLAGYTGELFF	TRBV29-1	TRBJ2-2
TGTGCCAGCAGTTTTTTGGACTGGAGGGAATGGGCAATGACTGAAGCTTTCTTT	CASSFLDWREWAMTEAFF	TRBV12-3	TRBJ1-1
TGTGCCAGGCGGGAGGGAGGGGGGGGAGGGTGGTTTACAGCGAACACTGAAGCTTTCTTT	CARREGGGGGWFTANTEAFF	TRBV3-1	TRBJ1-1
TGTGCCAGCAGCTTAGAAGGGCCGTGGACTAGGCACGAGCAGTACTTC	CASSLEGPWTRHEQYF	TRBV7-6	TRBJ2-7
TGTGCCACCAGCAGAGATCCCCAGGACGAGCAGTACTTC	CATSRDPQDEQYF	TRBV15	TRBJ2-7
TGTGCCAGCAGCGGCAGGTTCGAGCAGTACTTC	CASSGRFEQYF	TRBV6-2	TRBJ2-7
TGCGCCAGCAGCCAAGATCCTCGGACTAGCGCCAACAATGAGCAGTTCTTC	CASSQDPRTSANNEQFF	TRBV4-1	TRBJ2-1
TGCAGTGCTGGAAGGGGCAAGGTAAGAGGGTCTGGCTACACCTTC	CSAGRGKVRGSGYTF	TRBV20-1	TRBJ1-2
TGTGCCAGCAGCTTCGGAACGGGTCAGGGGGCCAAGTTCACAGATACGCAGTATTTT	CASSFGTGQGAKFTDTQYF	TRBV7-9	TRBJ2-3
TGTGCCAGCAGATACTTTAAACTAGCGGGAGGGCCCCTCCATTCTATTTTGGGAGAAAATAGCAATCAGCCCCAGCATTTT	CASRYFKLAGGPLHSILGENSNQPQHF	TRBV6-4	TRBJ1-5
TGTGCCAGCAGCACGGGGCCCTCCTACGAGCAGTACTTC	CASSTGPSYEQYF	TRBV7-4	TRBJ2-7
TGTGCCAGCAGCTTAGGCCAGGGACAGAGCACTGGAAACACCATATATTTT	CASSLGQGQSTGNTIYF	TRBV7-4	TRBJ1-3
TGTGCCAGCAGCACGCCGGACTCGGTTATGAACACTGAAGCTTTCTTT	CASSTPDSVMNTEAFF	TRBV6-1	TRBJ1-1
TGTGCCAGCAGTTACTCGCGGCACTGGAAGGGCTCCTACAATGAGCAGTTCTTC	CASSYSRHWKGSYNEQFF	TRBV6-2	TRBJ2-1
TGTGCCAGCAACGGCCTGGCGACCCAGTACTTC	CASNGLATQYF	TRBV28	TRBJ2-5
TGTGCCAGCAGCTTGGCCTGGAATTTTGGAGTAACACCCCAAGAGACCCAGTACTTC	CASSLAWNFGVTPQETQYF	TRBV5-6	TRBJ2-5
TGTGCCAGCAGATCCGGATCCGGGACAGGGCCTGGCTACACCTTC	CASRSGSGTGPGYTF	TRBV12-4	TRBJ1-2
TGTGCCAGGGAGACCGCTAGCACAGATACGCAGTATTTT	CARETASTDTQYF	TRBV27	TRBJ2-3
TGTGCCAGCAGCCAGGAGATAACGGGACAGAACACCGGGGAGCTGTTTTTT	CASSQEITGQNTGELFF	TRBV3-1	TRBJ2-2
TGTGCCACGGGGGAACGCGTGACAGGGGGGGGCATGAACACTGAAGCTTTCTTT	CATGERVTGGGMNTEAFF	TRBV6-4	TRBJ1-1
TGTGCCAGCAGCTGGGGGGGTCACGGTCAGCCCCAGCATTTT	CASSWGGHGQPQHF	TRBV11-2	TRBJ1-5
TGTGCCAGCAGCTTAGGCAGCCATAACGCTGAAGGAGGAAACACCATATATTTT	CASSLGSHNAEGGNTIYF	TRBV7-9	TRBJ1-3
TGTGCCACCGGGACTGATTGGTTCTCCTACGAGCAGTACTTC	CATGTDWFSYEQYF	TRBV28	TRBJ2-7
TGTGCCAGCAGTAGGGAGGGGCGTTCTGATCAGCCCCAGCATTTT	CASSREGRSDQPQHF	TRBV27	TRBJ1-5
TGTGCCCTATTTACCGAGTCCTACAATGAGCAGTTCTTC	CALFTESYNEQFF	TRBV9	TRBJ2-1
TGCAGTGCTAGGGACCCCCCTTGGCATGAGCAGTTCTTC	CSARDPPWHEQFF	TRBV20-1	TRBJ2-1
TGTGCCAGCAGCGCTATCAGAATCGATCAGCCCCAGCATTTT	CASSAIRIDQPQHF	TRBV7-3	TRBJ1-5
TGTGCCAGCAGCTTAGCGCCCGCAGGGTCTGAGGAGAATTCACCCCTCCACTTT	CASSLAPAGSEENSPLHF	TRBV7-9	TRBJ1-6
TGTGCCAGCAGTTCGGTCAGGGAGGGAGTCTATGGCTACACCTTC	CASSSVREGVYGYTF	TRBV6-9	TRBJ1-2
TGCGCCAGCAGCCTACTTTTGACTAGCGGGGAGACCCAGTACTTC	CASSLLLTSGETQYF	TRBV4-1	TRBJ2-5
TGCGCCAGCAGCCAAGAGGGCCCTAGCTACGAGCAGTACTTC	CASSQEGPSYEQYF	TRBV4-3	TRBJ2-7
TGTGCCACCAGTAATGGGGGGAATCAGCCCCAGCATTTT	CATSNGGNQPQHF	TRBV24-1	TRBJ1-5
TGTGCCAGCAGTCGACGGGGGGGCCGTTACACTGAAGCTTTCTTT	CASSRRGGRYTEAFF	TRBV28	TRBJ1-1
TGTGCCAGCCTTACGAATGAGCAGTTCTTC	CASLTNEQFF	TRBV10-3	TRBJ2-1
TGTGCCAGCCAGGGGGCGTGGGCGGAGACCCAGTACTTC	CASQGAWAETQYF	TRBV25-1	TRBJ2-5
TGTGCCTGGAGTGTATTAGGGGGGAACTATGGCTACACCTTC	CAWSVLGGNYGYTF	TRBV30	TRBJ1-2
TGCGCCAGCAGAATCGGGTTGGACAGGGACTCCTACGAGCAGTACTTC	CASRIGLDRDSYEQYF	TRBV4-1	TRBJ2-7
TGTGCCAGCAGTTTTACGGGGGACAGGGCTTCCGGGAACACTGAAGCTTTCTTT	CASSFTGDRASGNTEAFF	TRBV12-3	TRBJ1-1
TGTGCCAGCAGCCAATCGGTACTCGGGACGTACCACTATGGCTACACCTTC	CASSQSVLGTYHYGYTF	TRBV16	TRBJ1-2
TGTGCGGGTCGGGGGCGGAACACCGGGGAGCTGTTTTTT	CAGRGRNTGELFF	TRBV6-4	TRBJ2-2
TGCAGCTCCTGTACGACGGACAGCAGCTACGAGCAGTACTTC	CSSCTTDSSYEQYF	TRBV29-1	TRBJ2-7
TGTGCTAGCAGCTTACAGTGGACTAGCGGGGGGCCTCAAGAGACCCAGTACTTC	CASSLQWTSGGPQETQYF	TRBV7-7	TRBJ2-5
TGCAGTGCTACCAGGGGGAACAGGTACTATGGCTACACCTTC	CSATRGNRYYGYTF	TRBV20-1	TRBJ1-2
TGTGCCAGCAGCCAAGACCGACACGGGGAGCAGTACTTC	CASSQDRHGEQYF	TRBV3-1	TRBJ2-7
TGTGCCAGCATAGACCGACAGGGCAGGAAGGCGTGCTCTGGAAACACCATATATTTT	CASIDRQGRKACSGNTIYF	TRBV28	TRBJ1-3
TGTGCCACCAGTGATCCAGGAGGGTTCTACAATGAGCAGTTCTTC	CATSDPGGFYNEQFF	TRBV24-1	TRBJ2-1
TGTGCCAGTAGTGGCCACACTAGCGGGAGAGCAGACGGGGAGCTGTTTTTT	CASSGHTSGRADGELFF	TRBV19	TRBJ2-2
TGTGCCAGCAGCTTAGAAAGGGACTCGGAAGGTACGGGATGGGCCAACAATGAGCAGTTCTTC	CASSLERDSEGTGWANNEQFF	TRBV7-9	TRBJ2-1
TGTGCCACCAGTGAAGGGAGGCCCCGGGGGGTGGCCAAAAACATTCAGTACTTC	CATSEGRPRGVAKNIQYF	TRBV24-1	TRBJ2-4
TGTGCCTGGCGCCAGGGGGGGGGCAAAGAGACCCAGTACTTC	CAWRQGGGKETQYF	TRBV30	TRBJ2-5
TGCGCCAGCAACCGCGGTTTACAGGGGTCGTTAGCTTTCTTT	CASNRGLQGSLAFF	TRBV10-1	TRBJ1-1
TGTGCCAGCAGCCCCGGGACTAGCGGGATAATAGAGGGTAGGGACACCGGGGAGCTGTTTTTT	CASSPGTSGIIEGRDTGELFF	TRBV3-1	TRBJ2-2
TGTGCCACCCAGCGTCCTGCCCGGGGGTACCTTGGCTACACCTTC	CATQRPARGYLGYTF	TRBV15	TRBJ1-2
TGCAGTGCTAGAGATAGCGAACAGGCAGAGCAGTACTTC	CSARDSEQAEQYF	TRBV20-1	TRBJ2-7
TGTGCCAGCAGTTTAGAGAGTCTAGCGGGTGCCCAGTACTTC	CASSLESLAGAQYF	TRBV27	TRBJ2-5
TGCGCCAGCAGCGCCCCGGGCTTCACTGAAGCTTTCTTT	CASSAPGFTEAFF	TRBV10-1	TRBJ1-1
TGTGCCAGCAGCTTAGATAGCGGGTTTCATGAAAAACTGTTTTTT	CASSLDSGFHEKLFF	TRBV11-3	TRBJ1-4
TGTGCCAGCAGACCTAGCGGACCACCCAAAAACATTCAGTACTTC	CASRPSGPPKNIQYF	TRBV7-3	TRBJ2-4
TGTGCCAGCAGCTTGGCGGGAGGTGCAACTAATGAAAAACTGTTTTTT	CASSLAGGATNEKLFF	TRBV6-5	TRBJ1-4
TGTGCCATCACCCTTTGGTTAAGAGCAGGGGGCGCATCGCACTATGGCTACACCTTC	CAITLWLRAGGASHYGYTF	TRBV10-3	TRBJ1-2
TGTGCCAGCAGCTCCTCCGGGACAGGTTGTTACGAGCAGTACTTC	CASSSSGTGCYEQYF	TRBV13	TRBJ2-7
TGTGCCAGCAGATTGACAGGGTCCCGGCACAGGTATAGCAATCAGCCCCAGCATTTT	CASRLTGSRHRYSNQPQHF	TRBV7-9	TRBJ1-5
TGTGCCAGCAGCGTAAAGGAAGGTTGGACAGGCGCGGGGTACGAGCAGTACTTC	CASSVKEGWTGAGYEQYF	TRBV9	TRBJ2-7
TGTGCCACCAGTGCGGGTACGGTTTACGAGCAGTACTTC	CATSAGTVYEQYF	TRBV24-1	TRBJ2-7
TGTGCCACCAATGGACAGTCGGAAGACGTGGGCAGAAGGGGCTACGAGCAGTACTTC	CATNGQSEDVGRRGYEQYF	TRBV24-1	TRBJ2-7
TGTGCCAGCAGCGGGGGTGGACAGGATGGGAACACCGGGGAGCTGTTTTTT	CASSGGGQDGNTGELFF	TRBV7-9	TRBJ2-2
TGCAGTGCTACCAGCGGGACCCTTATGGCCTATCGTAGCACAGATACGCAGTATTTT	CSATSGTLMAYRSTDTQYF	TRBV20-1	TRBJ2-3
TGTGCCAGCAGCTTAGGGCCGAAAATACCGGACTCTGGAAACACCATATATTTT	CASSLGPKIPDSGNTIYF	TRBV11-2	TRBJ1-3
TGTGCCACCAGTGTAGCGGGGGACGGGAATCAGCCCCAGCATTTT	CATSVAGDGNQPQHF	TRBV24-1	TRBJ1-5
TGTGCCAGCAGCTTCGGCCCAAAGCGGTCCAGGGCTGTGACCCAGTACTTC	CASSFGPKRSRAVTQYF	TRBV5-5	TRBJ2-5
TGTGCCAGCAGCTGGGAGTCTCCTCAAGAGACCCAGTACTTC	CASSWESPQETQYF	TRBV7-2	TRBJ2-5
TGTGCCAGCACCAGGAGGGAAGGGGGGTCTCCGACCCAGTACTTC	CASTRREGGSPTQYF	TRBV27	TRBJ2-5
TGTGCCAGCAGCTTAGCACCCCGTGGAGGGAGGTGCTCCTACGAGCAGTACTTC	CASSLAPRGGRCSYEQYF	TRBV7-2	TRBJ2-7
TGTGCCAGTAGTTATAGGACAATCGGATTCCGGGTAACCTCCACAGATACGCAGTATTTT	CASSYRTIGFRVTSTDTQYF	TRBV19	TRBJ2-3
TGTGCCAGCAGCCGGCTCGAGAGCACAGATACGCAGTATTTT	CASSRLESTDTQYF	TRBV14	TRBJ2-3
TGTGCCCTTAGCAGGGTTGACAATCAGCCCCAGCATTTT	CALSRVDNQPQHF	TRBV6-5	TRBJ1-5
TGTGCCAGCAGCACTAGCGGGGGACCTGAGCAGTTCTTC	CASSTSGGPEQFF	TRBV7-3	TRBJ2-1
TGTGCCAGCAGGGGGGCCTACCCCAGGACAGATACGCAGTATTTT	CASRGAYPRTDTQYF	TRBV6-4	TRBJ2-3
TGTGCCAGCAGCGTAGGGGACAGGAAATTCCTTAGCGAGCAGTACTTC	CASSVGDRKFLSEQYF	TRBV9	TRBJ2-7
TGTGCCAGCAGTGACAACAGGGTATCTAGCAATCAGCCCCAGCATTTT	CASSDNRVSSNQPQHF	TRBV6-4	TRBJ1-5
TGCGCCAGCAGTGAGTCGTCTTGGAAGTGGGACAGGGTACGAGAGACCCAGTACTTC	CASSESSWKWDRVRETQYF	TRBV10-1	TRBJ2-5
TGTGCCACCAAACGGCCGGGACAGTCTATGAACACTGAAGCTTTCTTT	CATKRPGQSMNTEAFF	TRBV24-1	TRBJ1-1
TGTGCCATCGGAAACAGCGGGAAGTTTGAGCAGTTCTTC	CAIGNSGKFEQFF	TRBV10-3	TRBJ2-1
TGTGCCAGTCATCCGTGGGACAGTGAGAATGAGCAGTTCTTC	CASHPWDSENEQFF	TRBV19	TRBJ2-1
TGTGCCAGCAGTGTGAGGACAGAGTCGCCTGAAAAACTGTTTTTT	CASSVRTESPEKLFF	TRBV27	TRBJ1-4
TGTGCCAGCAGTGGGCGGACCCCCTACGAGCAGTACTTC	CASSGRTPYEQYF	TRBV12-4	TRBJ2-7
TGTGCCAGCAGCGAAGAGGATAGGGGGGAGACCCAGTACTTC	CASSEEDRGETQYF	TRBV7-4	TRBJ2-5
TGTGCCAGCAGTTTATGGGGCAGTCCTAGATGGAACACTGAAGCTTTCTTT	CASSLWGSPRWNTEAFF	TRBV27	TRBJ1-1
TGTGCCAGCAGTGACTCGGTGCGCCGGGACAGGGTATATTACGAGCAGTACTTC	CASSDSVRRDRVYYEQYF	TRBV6-4	TRBJ2-7
TGTGCCAGCAGCGGGGCGACAGGGGGCGCACGCTCCCGCTACGAGCAGTACTTC	CASSGATGGARSRYEQYF	TRBV7-6	TRBJ2-7
TGTGCCAGCAGCCAAAGGGATGACAGGAGCCCGATCTACGAGCAGTACTTC	CASSQRDDRSPIYEQYF	TRBV3-1	TRBJ2-7
TGTGCCAGCAGTGTAGGACCCAGGGCCAGCCAAGAGACCCAGTACTTC	CASSVGPRASQETQYF	TRBV2	TRBJ2-5
TGCGCCAGCAGTGAGTCGCGTCGGACAGTGAACACTGAAGCTTTCTTT	CASSESRRTVNTEAFF	TRBV10-2	TRBJ1-1
TGTGCCAGCATTCTAACACCCCGGAGCAATCAGCCCCAGCATTTT	CASILTPRSNQPQHF	TRBV28	TRBJ1-5
TGCGCCAGCAGCGCTGGCCGGGACAGTAACACTGAAGCTTTCTTT	CASSAGRDSNTEAFF	TRBV5-1	TRBJ1-1
TGTGCCAGCAGCGGATCATCAGAATGGTCCTACAATGAGCAGTTCTTC	CASSGSSEWSYNEQFF	TRBV6-1	TRBJ2-1
TGCAGCGTTGAAGATCATGGACAGGGAACCTACGAGCAGTACTTC	CSVEDHGQGTYEQYF	TRBV29-1	TRBJ2-7
TGCAGTGCTAGGGACAGGGGTGTTTATAATTCACCCCTCCACTTT	CSARDRGVYNSPLHF	TRBV20-1	TRBJ1-6
TGTGCCAGCAGCAGGGAGAATGAAAAACTGTTTTTT	CASSRENEKLFF	TRBV11-3	TRBJ1-4
TGCGCCAGCAGTGCGGGAAGAAGGGTGGTCACCATATATTTT	CASSAGRRVVTIYF	TRBV10-1	TRBJ1-3
TGTGCCACCCACAGGGCGCTCTCCTACGAGCAGTACTTC	CATHRALSYEQYF	TRBV15	TRBJ2-7
TGTGCCAGCAGTGAAGGCGGGACAGGGACTGAAGCTTTCTTT	CASSEGGTGTEAFF	TRBV2	TRBJ1-1
TGTGCCAGCAGCACCTCACAGGGCTACGAGCAGTACTTC	CASSTSQGYEQYF	TRBV13	TRBJ2-7
TGTGCCAGCGTCCGGGACAGGGGGCGTATCTCTGGAAACACCATATATTTT	CASVRDRGRISGNTIYF	TRBV6-4	TRBJ1-3
TGTGCCAGCAGGCAGCAGGAGCAGTACTTC	CASRQQEQYF	TRBV2	TRBJ2-7
TGTGCCAGCAGCTTAGATTCAGGCTTACCCACTGAAGCTTTCTTT	CASSLDSGLPTEAFF	TRBV7-9	TRBJ1-1
TGTGCCAGCAGTTTAGGACAGGACAATCAGCCCCAGCATTTT	CASSLGQDNQPQHF	TRBV27	TRBJ1-5
TGTGCCAGCAGGACTGGCCGCGGTTGCACAGATACGCAGTATTTT	CASRTGRGCTDTQYF	TRBV7-7	TRBJ2-3
TGCGCCAGCAGCCCCTGGGGGGCGGAAGGACGAACGTCCTACAATGAGCAGTTCTTC	CASSPWGAEGRTSYNEQFF	TRBV10-1	TRBJ2-1
TGCAGTGCACGGAAGCGGGAGCCTAAAGAGACCCAGTACTTC	CSARKREPKETQYF	TRBV20-1	TRBJ2-5
TGTGCCAGCAGCTCGGGGGCATCTAGGGATGACACTGAAGCTTTCTTT	CASSSGASRDDTEAFF	TRBV5-6	TRBJ1-1
TGTGCCAGCAGCTGGGGAGTGTCGAGGAACACTGAAGCTTTCTTT	CASSWGVSRNTEAFF	TRBV5-6	TRBJ1-1
TGTGCCAGAGGGCCGGGACAGATGGCAGCTAACTATGGCTACACCTTC	CARGPGQMAANYGYTF	TRBV27	TRBJ1-2
TGCAGTGCTAGAGGTAACGGCAGGGCGGAGACCCAGTACTTC	CSARGNGRAETQYF	TRBV20-1	TRBJ2-5
TGTGCCAGCATTCTCAGGGCATGCAATCAGCCCCAGCATTTT	CASILRACNQPQHF	TRBV6-1	TRBJ1-5
TGTGCCAGCTCACCGCAGAAAGGGAAGGGGAGCTACGAGCAGTACTTC	CASSPQKGKGSYEQYF	TRBV18	TRBJ2-7
TGTGCCAGCAGTTTGAACCTAACCGCTTTGCCCGCTAACTATGGCTACACCTTC	CASSLNLTALPANYGYTF	TRBV28	TRBJ1-2
TGCGCCAGCAGCCACGCAGGGTTTAACATGAACACTGAAGCTTTCTTT	CASSHAGFNMNTEAFF	TRBV4-1	TRBJ1-1
TGTGCCAGCAGCTCTAGGGAAAATAGGGACCAAGGACCCTCCTACAATGAGCAGTTCTTC	CASSSRENRDQGPSYNEQFF	TRBV13	TRBJ2-1
TGTGCCAGCAGTTATCCGGTGGAGGGATGGGACCGTCCTGGCTACACCTTC	CASSYPVEGWDRPGYTF	TRBV6-5	TRBJ1-2
TGTGGTCGACAGGGGGTTGAGACCCAGTACTTC	CGRQGVETQYF	TRBV12-3	TRBJ2-5
TGTGCCAGCAGCCCCGGGACAGGGAACACTGAAGCTTTCTTT	CASSPGTGNTEAFF	TRBV13	TRBJ1-1
TGTGCCAGCAGCTACAAGGGCGGACCCGTCTCCTACGAGCAGTACTTC	CASSYKGGPVSYEQYF	TRBV13	TRBJ2-7
TGTGCCATCAGTGAGGGGGCGTATCTGAACACTGAAGCTTTCTTT	CAISEGAYLNTEAFF	TRBV10-3	TRBJ1-1
TGTGCCAGCAGCTGTCGCTGGAGGGGGAAGGATGAGCAGTACTTC	CASSCRWRGKDEQYF	TRBV7-2	TRBJ2-7
TGTGCCAGCAGCCCCGCGGGACATCAGCCCCAGCATTTT	CASSPAGHQPQHF	TRBV7-3	TRBJ1-5
TGCAGTGCTCCACCACTTAACTACAATGAGCAGTTCTTC	CSAPPLNYNEQFF	TRBV20-1	TRBJ2-1
TGTTTTAAGCCAGGACAATTTTACCACGAGCAGTACTTC	CFKPGQFYHEQYF	TRBV30	TRBJ2-7
TGTGCCAGCAGCGACGGGACTTCCTATGGCTACACCTTC	CASSDGTSYGYTF	TRBV7-4	TRBJ1-2
TGTGCCGAGGGACAGAGCATGGAAGCTTTCTTT	CAEGQSMEAFF	TRBV7-2	TRBJ1-1
TGTGCTAGTGGTTTGGGAGATCCAGGACACTTC	CASGLGDPGHF	TRBV12-5	TRBJ1-2
TGTGCCAGCCCTAGCCTCTCCTACGAGCAGTACTTC	CASPSLSYEQYF	TRBV6-3	TRBJ2-7
TGTGCCAGCAGTTACCCCTCTTTGGGAGGGTCCTCCGGAAACAATGAGCAGTTCTTC	CASSYPSLGGSSGNNEQFF	TRBV6-5	TRBJ2-1
TGTGCCAGCAGCGTAAAAGTTTTAGGGGTTGACGAGCAGTACTTC	CASSVKVLGVDEQYF	TRBV3-1	TRBJ2-7
TGTGCCAGCAGCTGTGTCCAGGGCTACAATGAGCAGTTCTTC	CASSCVQGYNEQFF	TRBV5-6	TRBJ2-1
TGTGCCATCAGTGATTCCGACCACGGGGAGCTGTTTTTT	CAISDSDHGELFF	TRBV10-3	TRBJ2-2
TGTGCCAGCAGTCTGACTGGGCTAAGGCGAAACACCATATATTTT	CASSLTGLRRNTIYF	TRBV27	TRBJ1-3
TGTGCCAGCCCGGACAGGGAGGGAGGCGAGCAGTACTTC	CASPDREGGEQYF	TRBV27	TRBJ2-7
TGTGCCAGCAGAAGAGACATACTGGACAGAGGTACTTGGAACACTGAAGCTTTCTTT	CASRRDILDRGTWNTEAFF	TRBV6-3	TRBJ1-1
TGTGCCAGCAGGGACAGGGAGGAGGCTTTCTTT	CASRDREEAFF	TRBV27	TRBJ1-1
TGTGCCAGCTCGAAGGGTGTACAGGTAGCCATGAACACTGAAGCTTTCTTT	CASSKGVQVAMNTEAFF	TRBV18	TRBJ1-1
TGCAGTGCTAGAGATCAGGGACAGGGGAACAGCAATCAGCCCCAGCATTTT	CSARDQGQGNSNQPQHF	TRBV20-1	TRBJ1-5
TGTGCCAGCAGCCCGGGACACACAGATACGCAGTATTTT	CASSPGHTDTQYF	TRBV6-5	TRBJ2-3
TGCAGCGTAGAAGGACAGAAAACGACTAGCGGGGGGAATGAGCAGTTCTTC	CSVEGQKTTSGGNEQFF	TRBV29-1	TRBJ2-1
TGTGCCACGTGGACCGGGACTAGTATCACAGATACGCAGTATTTT	CATWTGTSITDTQYF	TRBV6-5	TRBJ2-3
TGTGCCAGCAGCTTAGCAGGGGACAATGAGCAGTTCTTC	CASSLAGDNEQFF	TRBV7-8	TRBJ2-1
TGTGCCAGAGTACGCGTACTAGCGGTGGGTGCGGAGACCCAGTACTTC	CARVRVLAVGAETQYF	TRBV19	TRBJ2-5
TGCGCCAGCAGCTTGATCACTTTACAGGGGGTGGGCTATGGCTACACCTTC	CASSLITLQGVGYGYTF	TRBV5-1	TRBJ1-2
TGTGCCAGCAGCGTAGCGGGCCTAGGTGAGACCCAGTACTTC	CASSVAGLGETQYF	TRBV9	TRBJ2-5
TGTGCCAGCAGCGAAGCCGGGACTAGCGGGAGGGGAACCTACAATGAGCAGTTCTTC	CASSEAGTSGRGTYNEQFF	TRBV7-4	TRBJ2-1
TGTGCCAGCAGCTTTACCCCGAGGGGGGGGGGGGAGACCCAGTACTTC	CASSFTPRGGGETQYF	TRBV5-4	TRBJ2-5
TGTGCCAGCAGTGACGGTGCAAAAAGGCTCAGGGCGGATGGGGCAAACAACAATGAGCAGTTCTTC	CASSDGAKRLRADGANNNEQFF	TRBV6-4	TRBJ2-1
TGTGCCAGCAGAGAGTTAGGCAGTGTTCTCTTACCGACCGGGGAGCTGTTTTTT	CASRELGSVLLPTGELFF	TRBV3-1	TRBJ2-2
TGTGCCGCTCAGTATACGGGACAGGGTAGGACCCAGTACTTC	CAAQYTGQGRTQYF	TRBV24-1	TRBJ2-5
TGTGCCAGCAGCTTGTGCCACCAGACTGAGACCCAGTACTTC	CASSLCHQTETQYF	TRBV5-6	TRBJ2-5
TGCGCCAGCAGCAGACAGGGGAAACGCTACGAGCAGTACTTC	CASSRQGKRYEQYF	TRBV5-1	TRBJ2-7
TGCGCCAGCAGCAAAGGTAGCAGGGTATGTGGGTACGAGCAGTACTTC	CASSKGSRVCGYEQYF	TRBV4-1	TRBJ2-7
TGTGCCAGCAGCGAGGACGGGACTTACAATGAGCAGTTCTTC	CASSEDGTYNEQFF	TRBV13	TRBJ2-1
TGTGCTAGTGGTTTGCGGGGGAACCCGGGACTAGCGGCAAGGTCCTACAATGAGCAGTTCTTC	CASGLRGNPGLAARSYNEQFF	TRBV12-5	TRBJ2-1
TGTGCCAGCAGCTTAGGGACAGCCGAGCAGTACTTC	CASSLGTAEQYF	TRBV7-4	TRBJ2-7
TGTGCTAGTGGTTTGTCCCACAGGGGTGGGCACGATGAAAAACTGTTTTTT	CASGLSHRGGHDEKLFF	TRBV12-5	TRBJ1-4
TGTGCCAGTAGTGCCGCGGGGGGCTACAATGAGCAGTTCTTC	CASSAAGGYNEQFF	TRBV19	TRBJ2-1
TGTGCCAGCACGATAGGGGGAAGCTTCTACGAGCAGTACTTC	CASTIGGSFYEQYF	TRBV7-2	TRBJ2-7
TGTGCCAGCAGCTTAGCGCATGAACTAGCGGGAGGATACAATGAGCAGTTCTTC	CASSLAHELAGGYNEQFF	TRBV7-7	TRBJ2-1
TGTGCCAGCAGTTACGGTAGGCACGCCTACGAGCAGTACTTC	CASSYGRHAYEQYF	TRBV6-3	TRBJ2-7
TGTGCCACCAGCCCTGGTTCCTACGAGCAGTACTTC	CATSPGSYEQYF	TRBV24-1	TRBJ2-7
TGCGCCAGCAGCGAGTTTCAAGGGACAGGGGGCACCTACAATGAGCAGTTCTTC	CASSEFQGTGGTYNEQFF	TRBV5-1	TRBJ2-1
TGTGCCAGCGACAGGGTTTCTAATAACTATGGCTACACCTTC	CASDRVSNNYGYTF	TRBV19	TRBJ1-2
TGTGCCAGCAGCTGTGGACGGGTTGAGCAGTTCTTC	CASSCGRVEQFF	TRBV5-6	TRBJ2-1
TGTGCCAGCAGCAGGGATATACCAGGGGACTCCTACGAGCAGTACTTC	CASSRDIPGDSYEQYF	TRBV11-2	TRBJ2-7
TGTGCCAGCAGCTCACCCCCAAGGGGGCGGGAGGTCACCGGGGAGCTGTTTTTT	CASSSPPRGREVTGELFF	TRBV7-2	TRBJ2-2
TGCAGTGCTCGTAGGGGGAACGAAGACTACGAGCAGTACTTC	CSARRGNEDYEQYF	TRBV20-1	TRBJ2-7
TGTGCCAGCAGCCATGGCGGCGAGCAAGGGGAAGCTTTCTTT	CASSHGGEQGEAFF	TRBV6-4	TRBJ1-1
TGCGCCAGCAGCTTAGGCATGTCACAGCCCCAGCATTTT	CASSLGMSQPQHF	TRBV5-1	TRBJ1-5
TGTGCCAGCAGCTTGCACCAGTCCCCCGCATGTACGGGCGAGACCCAGTACTTC	CASSLHQSPACTGETQYF	TRBV5-4	TRBJ2-5
TGTGCCAGCAAAGGTCCTCCGGGACAGGGCACCTACGAGCAGTACTTC	CASKGPPGQGTYEQYF	TRBV28	TRBJ2-7
TGTGCCGGGAGGGACAGGGGCGGGGAGCTGTTTTTT	CAGRDRGGELFF	TRBV28	TRBJ2-2
TGTGCCAGTCGAGGGGAAAGCTCCTATAATTCACCCCTCCACTTT	CASRGESSYNSPLHF	TRBV27	TRBJ1-6
TGTGCCAGCAGAAGTTTCGCCCCAGGGGGCTACGAGCAGTACTTC	CASRSFAPGGYEQYF	TRBV7-9	TRBJ2-7
TGCGCCAGCAGTGAGTCTTCGACACAGGGTGAGGGCTACACCTTC	CASSESSTQGEGYTF	TRBV10-1	TRBJ1-2
TGTGCCAGCAGCACGAGACAGACAGATGATGAGCAGTTCTTC	CASSTRQTDDEQFF	TRBV7-9	TRBJ2-1
TGTGCCAGGACCGGGGACAGGCGAAGGGAATACGAGCAGTACTTC	CARTGDRRREYEQYF	TRBV7-2	TRBJ2-7
TGTGCCAGTACCTCAGGTTATGGGGACAGGGAAAAGCCAAATGGTAATGAAAAACTGTTTTTT	CASTSGYGDREKPNGNEKLFF	TRBV19	TRBJ1-4
TGTGCCAGCAGTTTCGTGGTAACCTACGAGCAGTACTTC	CASSFVVTYEQYF	TRBV28	TRBJ2-7
TGCGCCAGCAGCGGGGCGGAGCAAGAGACCCAGTACTTC	CASSGAEQETQYF	TRBV5-1	TRBJ2-5
TGCAGCCGATTTCCCGGGGGGCGTTCCGAGCAGTACTTC	CSRFPGGRSEQYF	TRBV29-1	TRBJ2-7
TGTGCCAGCAGCGGGGGACAGGGGGGAGATCAGCCCCAGCATTTT	CASSGGQGGDQPQHF	TRBV13	TRBJ1-5
TGTGCCAGCGTGGACAGGGTAGGCTACGAGCAGTACTTC	CASVDRVGYEQYF	TRBV25-1	TRBJ2-7
TGTGCCAGCAGAGCGGCGGAGACCCAGTACTTC	CASRAAETQYF	TRBV28	TRBJ2-5
TGTGCCAGCGGGGGAACAGGGTTCTTGTACGATAGCAATCAGCCCCAGCATTTT	CASGGTGFLYDSNQPQHF	TRBV19	TRBJ1-5
TGTGCCAGCAGCTTGTCCGGGACTAGCGGGAGCTGCTACGAGCAGTACTTC	CASSLSGTSGSCYEQYF	TRBV7-6	TRBJ2-7
TGCGCCAGCAGGGAATTTGTAAAGGGGGATTCCCAGGAATACGAGCAGTACTTC	CASREFVKGDSQEYEQYF	TRBV5-1	TRBJ2-7
TGTGCCAGCAGTTTATCAGGGTGGGGGCGGCCTAGCTCCTACGAGCAGTACTTC	CASSLSGWGRPSSYEQYF	TRBV27	TRBJ2-7
TGTGCCAGCCCAACTAATCTTGCGAACACTGAAGCTTTCTTT	CASPTNLANTEAFF	TRBV27	TRBJ1-1
TGTGCCAGCAGCTCTCGGTTTCCCAGGAAAGAGCAGTACTTC	CASSSRFPRKEQYF	TRBV5-5	TRBJ2-7
TGTGCCAGCAGCTTACCCTTACAGGGTGTTGAAAAACTGTTTTTT	CASSLPLQGVEKLFF	TRBV7-9	TRBJ1-4
TGCAGCGTTGAAGGCTCCGTACAGCTTTATATCGATGAGCAGTTCTTC	CSVEGSVQLYIDEQFF	TRBV29-1	TRBJ2-1
TGTGCCAGCAGTGATAGGCTTGCAACTAATGAAAAACTGTTTTTT	CASSDRLATNEKLFF	TRBV6-4	TRBJ1-4
TGCAGTAAGGAGCCCGGGTCAGGGCTCGCTAGCTCCTACGAGCAGTACTTC	CSKEPGSGLASSYEQYF	TRBV20-1	TRBJ2-7
TGCGCCAGCAGCTTGTACCGGGTAGGAAACACTGAAGCTTTCTTT	CASSLYRVGNTEAFF	TRBV5-1	TRBJ1-1
TGTGCCATCAGTGAGTCCCAAATAAGGGTCTACGAGCAGTACTTC	CAISESQIRVYEQYF	TRBV10-3	TRBJ2-7
TGTGCCAGCAACATCACCCCCGGGACTAGCGGGTCCGAGACCCAGTACTTC	CASNITPGTSGSETQYF	TRBV12-3	TRBJ2-5
TGTGCCAGCAGGCGTAGCGGGAGGCAATGGAGAGAGACCCAGTACTTC	CASRRSGRQWRETQYF	TRBV11-3	TRBJ2-5
TGTGCCAGCGAGGACAGGGCGGAAAACATTCAGTACTTC	CASEDRAENIQYF	TRBV7-9	TRBJ2-4
TGTGCCAGCAGCTTGCCAGGGGGGTATAATGAAAAACTGTTTTTT	CASSLPGGYNEKLFF	TRBV5-5	TRBJ1-4
TGCAGCGTTGAGGGGATACAACGTTACAATGAGCAGTTCTTC	CSVEGIQRYNEQFF	TRBV29-1	TRBJ2-1
TGCGCCAGCAGCCAAGTCCGACCCCGGCTTAGTAAAGAGACCCAGTACTTC	CASSQVRPRLSKETQYF	TRBV4-3	TRBJ2-5
TGCAGCGTTGAAAAGAGGGACGAATTCTGGAGCGAGCAGTTCTTC	CSVEKRDEFWSEQFF	TRBV29-1	TRBJ2-1
TGTGCCAGCATCCGCGAGCAGTACTTC	CASIREQYF	TRBV9	TRBJ2-7
TGCGCCAGCAGCTTGGTAGGGGGGGGCACCCTCGATACGCAGTATTTT	CASSLVGGGTLDTQYF	TRBV5-1	TRBJ2-3
TGCAGCGTTGAAGATCGGGACCGGGACAGGGCGAATGGGGCCAACGTCCTGACTTTC	CSVEDRDRDRANGANVLTF	TRBV29-1	TRBJ2-6
TGTGCCAGTACCCCCCCGGGACAGTTGGGCTGCGCCCGAACCTACGAGCAGTACTTC	CASTPPGQLGCARTYEQYF	TRBV7-9	TRBJ2-7
TGCGCCAGCAGCGGACTACACTTGACCGGGGAGCTGTTTTTT	CASSGLHLTGELFF	TRBV5-1	TRBJ2-2
TGTGCCAGCAGCGCAGGGGGACCCCTCACGAACACCGGGGAGCTGTTTTTT	CASSAGGPLTNTGELFF	TRBV14	TRBJ2-2
TGTGCCAGCAGTTACGGGGGCCCCGACAGCAGGGACTATGGCTACACCTTC	CASSYGGPDSRDYGYTF	TRBV6-9	TRBJ1-2
TGTGCCACCAGCAGAGACGACACAATACGGGGCTCTGGAAACACCATATATTTT	CATSRDDTIRGSGNTIYF	TRBV15	TRBJ1-3
TGTGCCAGCAGTACCCCGACGGACAGGGGATGGCTCGTTGTTCAAGAGACCCAGTACTTC	CASSTPTDRGWLVVQETQYF	TRBV12-3	TRBJ2-5
TGTGCCAGCAGTAGGGGGGGTGGGGTGTACAATGAGCAGTTCTTC	CASSRGGGVYNEQFF	TRBV6-4	TRBJ2-1
TGTGCCAGCATCCGGGGGCCCCACAGGGGCTATAGCAATCAGCCCCAGCATTTT	CASIRGPHRGYSNQPQHF	TRBV12-3	TRBJ1-5
TGCAGTGCTAGAGTGACCTCCCGGCCGGGACGCGGGTTTAGCAATCAGCCCCAGCATTTT	CSARVTSRPGRGFSNQPQHF	TRBV20-1	TRBJ1-5
TGTGCCAGCAGTACCGCGGGAGGAGATACGCAGTATTTT	CASSTAGGDTQYF	TRBV6-4	TRBJ2-3
TGTGCCAGCAGTGAATGGGGACACGGCAATGAAAAACTGTTTTTT	CASSEWGHGNEKLFF	TRBV25-1	TRBJ1-4
TGCAGTGCTAGAGATGACCAGGTCGGACAGGGCCCTAACTATGGCTACACCTTC	CSARDDQVGQGPNYGYTF	TRBV20-1	TRBJ1-2
TGCGCCAGCAGCTTGACGAGTGATGAGCAGTTCTTC	CASSLTSDEQFF	TRBV5-1	TRBJ2-1
TGTGCCAGCTTGGGGGAAGGCACTGAAGCTTTCTTT	CASLGEGTEAFF	TRBV27	TRBJ1-1
TGCGCCAGCAGCCAAGACCCGGAACGATGGCGTGAAAAACTGTTTTTT	CASSQDPERWREKLFF	TRBV4-3	TRBJ1-4
TGTGCCAGCAGCGTCCGTCGCCTAGCGGGGGGGCAAAGTCATGAGCAGTTCTTC	CASSVRRLAGGQSHEQFF	TRBV13	TRBJ2-1
TGTGCCAGCAGCCATGATCCCCAGGGGCATAATGAAAAACTGTTTTTT	CASSHDPQGHNEKLFF	TRBV6-1	TRBJ1-4
TGTGCCATCACGGGACTAGCATTCGGGGAGCTGTTTTTT	CAITGLAFGELFF	TRBV10-3	TRBJ2-2
TGTGCCAGCAGAGTGGAGACCGACACTGAAGCTTTCTTT	CASRVETDTEAFF	TRBV2	TRBJ1-1
TGTGCCAGCAGCCAAGTCTGCGGACAGGGGCCCGAAAAACTGTTTTTT	CASSQVCGQGPEKLFF	TRBV4-2	TRBJ1-4
TGTGAGGCCAGGGGGAATCAGCCCCAGCATTTT	CEARGNQPQHF	TRBV12-3	TRBJ1-5
TGCGCCAGCAGCTACCCAGGGGGCCTTGCGGCGAACACCGGGGAGCTGTTTTTT	CASSYPGGLAANTGELFF	TRBV5-1	TRBJ2-2
TGTGCCAGCAGTTCCCCGGGAATTGGGGACAGGGGGGTGACTGTAGCCTACGAGCAGTACTTC	CASSSPGIGDRGVTVAYEQYF	TRBV6-6	TRBJ2-7
TGCGCCAGCAAACCGGGACAGGGTCGAGAGGATACGCAGTATTTT	CASKPGQGREDTQYF	TRBV5-1	TRBJ2-3
TGTGCCAGCAGGGGGAAGGAGGCTTTCTTT	CASRGKEAFF	TRBV11-2	TRBJ1-1
TGTGCCAGCAGTTACGTCCCGGGACAGGGACAGTACTTC	CASSYVPGQGQYF	TRBV6-8	TRBJ2-5
TGCGCCAGCAGCCCTGCCTCATCCCGACTAGCATCCTACGAGCAGTACTTC	CASSPASSRLASYEQYF	TRBV5-1	TRBJ2-7
TGTGCCAGCAGCGATGGGGGGGCCCATATTCAGGAGACCCAGTACTTC	CASSDGGAHIQETQYF	TRBV7-9	TRBJ2-5
TGTGCCAGCAACCCCAGACAGGGGGCAACTATGAATGAAGCTTTCTTT	CASNPRQGATMNEAFF	TRBV9	TRBJ1-1
TGTGCCAGCAGCTTAGAATTCAGACACACTGAAGCTTTCTTT	CASSLEFRHTEAFF	TRBV11-2	TRBJ1-1
TGTGCCAGCTCACCACCCGGTCCAGGGAATCAGCCCCAGCATTTT	CASSPPGPGNQPQHF	TRBV18	TRBJ1-5
TGTGCCAGCAGCGGGCAGACTTGGGTTGAAAAACTGTTTTTT	CASSGQTWVEKLFF	TRBV13	TRBJ1-4
TGTGCCAGCAGCCAAGATGACCCAGATACGCAGTATTTT	CASSQDDPDTQYF	TRBV14	TRBJ2-3
TGTGCCAGCAGTTACACAGGGCCGCCGCCGTATGGAGCTTTCTTT	CASSYTGPPPYGAFF	TRBV27	TRBJ1-1
TGTGCCACGCTAGCGGGACGCGAGCAGTACTTC	CATLAGREQYF	TRBV24-1	TRBJ2-7
TGTGCCAGCAGCTTGTATTCCCACAGGGGCGGGGAGCTGTTTTTT	CASSLYSHRGGELFF	TRBV5-6	TRBJ2-2
TGTGCCAGCAGAATAGGGACAGGGGAGGATCAGCCCCAGCATTTT	CASRIGTGEDQPQHF	TRBV27	TRBJ1-5
TGCAGTGCTATAGTCCCCGGGGGTGGAGGGGAGGGCCCCGACTACACAGATACGCAGTATTTT	CSAIVPGGGGEGPDYTDTQYF	TRBV20-1	TRBJ2-3
TGTGCCAGCAGCCAAAGCGGGCCCTCTGGAAACACCATATATTTT	CASSQSGPSGNTIYF	TRBV3-1	TRBJ1-3
TGTGCCAGCAGTTTATTACCTTCTTTTGGGACAGGGGGTGACTACAATGAGCAGTTCTTC	CASSLLPSFGTGGDYNEQFF	TRBV28	TRBJ2-1
TGCAGTGCTAGAGATCAGCAGGCGGTCAATCAGCCCCAGCATTTT	CSARDQQAVNQPQHF	TRBV20-1	TRBJ1-5
TGTGCCAGCAGCCCCATTGGGGGTAGGTTTGTGCTTGAAGCTTTCTTT	CASSPIGGRFVLEAFF	TRBV7-6	TRBJ1-1
TGTGCCATCAGTGTTTATTATACTAGCGGGAGGGCGAGGGTAAATGAAAAACTGTTTTTT	CAISVYYTSGRARVNEKLFF	TRBV10-3	TRBJ1-4
TGTGCCAGCAGTTACCTGGGGGGACAGGGGAACTCCTACGAGCAGTACTTC	CASSYLGGQGNSYEQYF	TRBV6-5	TRBJ2-7
TGTGCCAGCAGCGTAGGCTCGACAGGCCGCACAGATACGCAGTATTTT	CASSVGSTGRTDTQYF	TRBV9	TRBJ2-3
TGTGCCATCACTCGGGGACGCACCGGGGAGCTGTTTTTT	CAITRGRTGELFF	TRBV10-3	TRBJ2-2
TGTGCCATCTATACCGGGACAGGGTCCCACGAGCAGTACTTC	CAIYTGTGSHEQYF	TRBV6-1	TRBJ2-7
TGTGCCACCAGTGACCAGGACAGGGATATCAATGGCTACACCTTC	CATSDQDRDINGYTF	TRBV24-1	TRBJ1-2
TGTGCCAGCAGCTACGGATCCAGGGGGCGAGGGAATCAGCCCCAGCATTTT	CASSYGSRGRGNQPQHF	TRBV5-4	TRBJ1-5
TGTGCCAGCAGCTTAGCGTTCGGGACTAGCGGGAAATACGAGCAGTACTTC	CASSLAFGTSGKYEQYF	TRBV7-9	TRBJ2-7
TGTGCCACCAGTGATTTGCGAACGGCCGGGACGACAGATACGCAGTATTTT	CATSDLRTAGTTDTQYF	TRBV24-1	TRBJ2-3
TGTGCCAGATATTTTCCCGAATCCTACGAGCAGTACTTC	CARYFPESYEQYF	TRBV6-4	TRBJ2-7
TGCGCCAGCAGGTTGGACAGGGTGGCTAATGAAAAACTGTTTTTT	CASRLDRVANEKLFF	TRBV5-1	TRBJ1-4
TGTGCCAGCAGCCCGGGACAGGGGACAATAGTTTACAACTATGGCTACACCTTC	CASSPGQGTIVYNYGYTF	TRBV7-9	TRBJ1-2
TGTGCCAGCAGACCCCGTGGGACAGCCCAATGCTATGGCTACACCTTC	CASRPRGTAQCYGYTF	TRBV6-3	TRBJ1-2
TGCGCCACGGTCCGTCCGGGCGATACGCAGTATTTT	CATVRPGDTQYF	TRBV10-1	TRBJ2-3
TGTGCCAGCAGGGGACAGGTTCGACCGCTAGCCAAAAACATTCAGTACTTC	CASRGQVRPLAKNIQYF	TRBV9	TRBJ2-4
TGTGCCAGCAGTGACGGGGGATTCAGGGCCGACACTGAAGCTTTCTTT	CASSDGGFRADTEAFF	TRBV6-4	TRBJ1-1
TGTGCCAGTAGTATATCGCGGCCCAATGAGCAGTTCTTC	CASSISRPNEQFF	TRBV19	TRBJ2-1
TGTGCCTGGCCGATTCCCATGGACAGGGACTGGGTTGGTAGCAATCAGCCCCAGCATTTT	CAWPIPMDRDWVGSNQPQHF	TRBV30	TRBJ1-5
TGTGCCAGCAGCTCGAGACAGGAGGAAAAACTGTTTTTT	CASSSRQEEKLFF	TRBV13	TRBJ1-4
TGTGCCTGGAGTGTAATTATACGGGGGGGGGAAGCTTTCTTT	CAWSVIIRGGEAFF	TRBV30	TRBJ1-1
TGTGCCACCAGAGGCGAGGGAGACTACGAGCAGTACTTC	CATRGEGDYEQYF	TRBV24-1	TRBJ2-7
TGTGCCAGCAGCCCCCCGGGGGGTCCGCAGTACTTC	CASSPPGGPQYF	TRBV13	TRBJ2-7
TGCGCCAGCAGCCAAGAGATCAGCGGGAGTCCCAAGGATCAGCCCCAGCATTTT	CASSQEISGSPKDQPQHF	TRBV4-1	TRBJ1-5
TGTGCCAGCAGTGGCTGCGCGGTGAATGGCTACACCTTC	CASSGCAVNGYTF	TRBV2	TRBJ1-2
TGCAGTGCCCCAGCATATCTGAACACTGAAGCTTTCTTT	CSAPAYLNTEAFF	TRBV20-1	TRBJ1-1
TGTGCCAGCAGTGATCCTAACGCTCTCCCCGGGACTAGCGGGATCGAGCAGTACTTC	CASSDPNALPGTSGIEQYF	TRBV6-4	TRBJ2-7
TGTGCCAGCATTCCGAGGGGCGAGGAAAAACTGTTTTTT	CASIPRGEEKLFF	TRBV7-9	TRBJ1-4
TGTGCCAGCAGATACGCTCAAGAGACCCAGTACTTC	CASRYAQETQYF	TRBV28	TRBJ2-5
TGTGCCAGCAGCCTGGACAGGGTTGGCAATCAGCCCCAGCATTTT	CASSLDRVGNQPQHF	TRBV6-4	TRBJ1-5
TGTGCCAGCAGCTTGGGGACCGCGGGAGAAGAGCAGTACTTC	CASSLGTAGEEQYF	TRBV5-6	TRBJ2-7
TGTGCCAGCAGCGGGTCGGGGGAGCAGTACTTC	CASSGSGEQYF	TRBV7-9	TRBJ2-7
TGCGCCAGCAGTGATCGACTGGACAGGGGGCCACCGGGTCCCAATCAGCCCCAGCATTTT	CASSDRLDRGPPGPNQPQHF	TRBV10-1	TRBJ1-5
TGTGCCACCCATGACAGTGGTAATGAAAAACTGTTTTTT	CATHDSGNEKLFF	TRBV7-9	TRBJ1-4
TGTGCCAGCAGCCCCCTCAACCGGGGATTTTGCTCAAATTCACCCCTCCACTTT	CASSPLNRGFCSNSPLHF	TRBV13	TRBJ1-6
TGTGCCTGGAACCGGTTTGGGGGCTCCGGGGGGGCTAAAGAAAAACTGTTTTTT	CAWNRFGGSGGAKEKLFF	TRBV30	TRBJ1-4
TGTGCCAGCAGCTTCCAGCGGGAGTGGGATGCCAAAAACATTCAGTACTTC	CASSFQREWDAKNIQYF	TRBV11-2	TRBJ2-4
TGTGCCAGCAGTTACAAGCTAGGGGGGGTAATGAACACTGAAGCTTTCTTT	CASSYKLGGVMNTEAFF	TRBV6-6	TRBJ1-1
TGTGCCAGCAGCTTAACAGCTGAAAAACTGTTTTTT	CASSLTAEKLFF	TRBV7-3	TRBJ1-4
TGTGCCAGCGATTCAGCAGCGACCGAGCAGTACTTC	CASDSAATEQYF	TRBV6-1	TRBJ2-7
TGTGCCACTTCACAGGGCTCCTACGAGCAGTACTTC	CATSQGSYEQYF	TRBV7-2	TRBJ2-7
TGTGCCAGCAGCTGGGAGGGGAACTCTGGAAACACCATATATTTT	CASSWEGNSGNTIYF	TRBV7-9	TRBJ1-3
TGTGCCAGCAGCTTGGCTCGTGGGCGTCAAGAGACCCAGTACTTC	CASSLARGRQETQYF	TRBV5-4	TRBJ2-5
TGTGCCAGCAGCTGGGTAACCGGGGGGGTTCCAGATACGCAGTATTTT	CASSWVTGGVPDTQYF	TRBV11-2	TRBJ2-3
TGCGCCAGCAGCTGGGGTAGGCCGAGGAGCAATCAGCCCCAGCATTTT	CASSWGRPRSNQPQHF	TRBV5-1	TRBJ1-5
TGTGCCAGCAGCTTGAAATCGTACAGGGCATGGTCTGGAAACACCATATATTTT	CASSLKSYRAWSGNTIYF	TRBV5-6	TRBJ1-3
TGCGCCAGCAACGAAGTACAGGGATTCAGAAACACCATATATTTT	CASNEVQGFRNTIYF	TRBV5-1	TRBJ1-3
TGTGCCAGCAGCTTAGCGTACAAAACGGGCCGACTGAACACTGAAGCTTTCTTT	CASSLAYKTGRLNTEAFF	TRBV7-8	TRBJ1-1
TGTGCCAGCTCACCAGGACGAGGGGGGGAAGAGACCCAGTACTTC	CASSPGRGGEETQYF	TRBV18	TRBJ2-5
TGTGTTTTACCGAGGATAAATCAGCCCCAGCATTTT	CVLPRINQPQHF	TRBV28	TRBJ1-5
TGTGCCAGCAGTGTGGGAGGGGGAGATACATATAGCAATCAGCCCCAGCATTTT	CASSVGGGDTYSNQPQHF	TRBV6-4	TRBJ1-5
TGTGCCAGCAGCTTAGCGCTAGCAACCGGGACAGGGAGTTGCAATCAGCCCCAGCATTTT	CASSLALATGTGSCNQPQHF	TRBV5-5	TRBJ1-5
TGTGCCTGGAGTCGAGTGGACAGCAATCAGCCCCAGCATTTT	CAWSRVDSNQPQHF	TRBV30	TRBJ1-5
TGTGCCAGCAGCCAAGATAGGACGGGTGATGAAAAACTGTTTTTT	CASSQDRTGDEKLFF	TRBV3-1	TRBJ1-4
TGCGCCAGCAGCCAACTAGATGAGGGGCCATGTAGCTCCTACGAGCAGTACTTC	CASSQLDEGPCSSYEQYF	TRBV4-3	TRBJ2-7
TGTGCCAGCAGCTTCGAGTTTCCCGGGCCAGAGACCCAGTACTTC	CASSFEFPGPETQYF	TRBV5-4	TRBJ2-5
TGTGCCAGCAGCTTGGTTCTGGGACTAGCGGGAGGATCCCCCAGCTCTGGAAACACCATATATTTT	CASSLVLGLAGGSPSSGNTIYF	TRBV5-4	TRBJ1-3
TGTGCTAGTGCGCGTGCGGGAGGATACGGCCCGACCCAGTACTTC	CASARAGGYGPTQYF	TRBV12-5	TRBJ2-5
TGTGCCAGCTCACCAACCACGAGAAATGGATACCGTAGCAATCAGCCCCAGCATTTT	CASSPTTRNGYRSNQPQHF	TRBV18	TRBJ1-5
TGTGCCAGCGTTCAGGCTTACGAGCAGTACTTC	CASVQAYEQYF	TRBV25-1	TRBJ2-7
TGTGCCAGCAGCTTGCCCCCGTCCGGGACAGCACATGCGAACACCGGGGAGCTGTTTTTT	CASSLPPSGTAHANTGELFF	TRBV7-7	TRBJ2-2
TGTGCCAGCAGCTTAAGGAACCCCCGGGGGTCGAGCGATGAGCAGTTCTTC	CASSLRNPRGSSDEQFF	TRBV7-9	TRBJ2-1
TGCAGTGCTAGAGCACGGAGGGTCCCCTACGAGCAGTACTTC	CSARARRVPYEQYF	TRBV20-1	TRBJ2-7
TGCGCCAGCAGCTTCGACTATGTTGAAGTGGATGACGAGCAGTACTTC	CASSFDYVEVDDEQYF	TRBV5-1	TRBJ2-7
TGCAGTGCTAGAGTGGGGGTTGGTCCAGACGAGCAGTACTTC	CSARVGVGPDEQYF	TRBV20-1	TRBJ2-7
TGTGCCAGCAGCCGAGCCGAGCGTATTAATTCACCCCTCCACTTT	CASSRAERINSPLHF	TRBV3-1	TRBJ1-6
TGTGCCAGTGACAGGGCCATGAACACTGAAGCTTTCTTT	CASDRAMNTEAFF	TRBV19	TRBJ1-1
TGCGCCAGCAGCATTGTTGGGAGCGGGAAATGTGCCTCTGGAAACACCATATATTTT	CASSIVGSGKCASGNTIYF	TRBV5-1	TRBJ1-3
TGTGCCAGCAGCCAAGTACCAGACGGGCGGATATGCTACGAGCAGTACTTC	CASSQVPDGRICYEQYF	TRBV3-1	TRBJ2-7
TGTGCCAGCAGTGAAGAAGGAGCCTCCGGGACAGGTATACTCATTCAGTACTTC	CASSEEGASGTGILIQYF	TRBV25-1	TRBJ2-4
TGTGCCAGCAGCGGCAACCTACAGGGGAGCAATCAGCCCCAGCATTTT	CASSGNLQGSNQPQHF	TRBV13	TRBJ1-5
TGTGCCAGCAGTGGACATGTAGGGCAGGCCGAGCAGTACTTC	CASSGHVGQAEQYF	TRBV25-1	TRBJ2-7
TGTGCCAGCAGTGATTGGACAGAGGGTGCAAGGGTCTATGGCTACACCTTC	CASSDWTEGARVYGYTF	TRBV27	TRBJ1-2
TGTGCCAGCACAGGAGGAGAGACCCAGTACTTC	CASTGGETQYF	TRBV6-5	TRBJ2-5
TGTGCCAGCAGCCACAGGGAAGAGGGGGAGACCCAGTACTTC	CASSHREEGETQYF	TRBV5-4	TRBJ2-5
TGTGCCTTTTACCCCAGGGAGGAGTCTGCAACTAATGAAAAACTGTTTTTT	CAFYPREESATNEKLFF	TRBV30	TRBJ1-4
TGCAGCGTTCGGCAACAAGAATCTGAAGCTTTCTTT	CSVRQQESEAFF	TRBV29-1	TRBJ1-1
TGTGCCAGCAGCCAACAGGGGGGGGAAGGCGTAAATGAGCAGTTCTTC	CASSQQGGEGVNEQFF	TRBV3-1	TRBJ2-1
TGTGCCAGTGGGAGGACAGGGAGGGGTGACAATGAGCAGTTCTTC	CASGRTGRGDNEQFF	TRBV19	TRBJ2-1
TGTGCTAGTGGTTTGTCATTGCGGGGAGGCAATCAGCCCCAGCATTTT	CASGLSLRGGNQPQHF	TRBV12-5	TRBJ1-5
TGTGCCAGCAGCAATACGGAACAGCCCCAGCATTTT	CASSNTEQPQHF	TRBV13	TRBJ1-5
TGCGCCAGCAGCCAATTTAGAGGAAGCGGGGCAGTGTACCAAGAGACCCAGTACTTC	CASSQFRGSGAVYQETQYF	TRBV4-3	TRBJ2-5
TGTGCCTGGAGTGTATTAGGGGGGGCTACCGAGCAGTACTTC	CAWSVLGGATEQYF	TRBV30	TRBJ2-7
TGTGCCAGCAGCCTGGCCCGGCTAGGCTACACCTTC	CASSLARLGYTF	TRBV11-3	TRBJ1-2
TGTGCCAGCAGTTCGGGACAGACCACGAACACTGAAGCTTTCTTT	CASSSGQTTNTEAFF	TRBV6-5	TRBJ1-1
TGTGCCAGCAGCTGGAAATACGGGACAGAGGGCAATCAGCCCCAGCATTTT	CASSWKYGTEGNQPQHF	TRBV5-6	TRBJ1-5
TGTGCCTGGAGTTCGAGAAAGGGGACAGGCCTCTCCTACGAGCAGTACTTC	CAWSSRKGTGLSYEQYF	TRBV30	TRBJ2-7
TGTGCCAGCAGCTCCACAGGGGGGGTTTCCTACGAGCAGTACTTC	CASSSTGGVSYEQYF	TRBV7-2	TRBJ2-7
TGTGCCAGCAGGAGCCAGAAGGAGGGGAGTAACGAGCAGTACTTC	CASRSQKEGSNEQYF	TRBV7-7	TRBJ2-7
TGTGCCAGCAGTCCCGAGAGAGACCTGGACTCCTACGAGCAGTACTTC	CASSPERDLDSYEQYF	TRBV27	TRBJ2-7
TGTGCCAGCAGTTTAGGGTCAGGGAACACGTCCTACGAGCAGTACTTC	CASSLGSGNTSYEQYF	TRBV27	TRBJ2-7
TGTGCCAGGAGCGGACAGGGGGCTGAAGCTTTCTTT	CARSGQGAEAFF	TRBV25-1	TRBJ1-1
TGTGCCAGCAGCCACTGGGGGCTCTACACAGATACGCAGTATTTT	CASSHWGLYTDTQYF	TRBV6-4	TRBJ2-3
TGTGCCATCATCTCTCACTCGTACTCCTATAATTCACCCCTCCACTTT	CAIISHSYSYNSPLHF	TRBV10-3	TRBJ1-6
TGTGCCAGCAGTGGCGGGAGTCGGGACCATGAAAAACTGTTTTTT	CASSGGSRDHEKLFF	TRBV6-5	TRBJ1-4
TGTGCCAGCAGCCAAGAAGGACCGGGACTAGCGGGCAAAGATACGCAGTATTTT	CASSQEGPGLAGKDTQYF	TRBV3-1	TRBJ2-3
TGTGCCAGCCGTTGGTGGGGGGGACGGAATTCACCCCTCCACTTT	CASRWWGGRNSPLHF	TRBV11-2	TRBJ1-6
TGTGCCAGCAGCTGTCATAGGGAGACCCAGTACTTC	CASSCHRETQYF	TRBV11-3	TRBJ2-5
TGTGCCAGCAGTTACTTTTCCAGGGGGTACAATGAGCAGTTCTTC	CASSYFSRGYNEQFF	TRBV6-2	TRBJ2-1
TGTGCCACCAGTCAGGAGGTTTACAATGAGCAGTTCTTC	CATSQEVYNEQFF	TRBV24-1	TRBJ2-1
TGTGCCAGCAGCTCAAAACCGGGCGACAGCTCTGGAAACACCATATATTTT	CASSSKPGDSSGNTIYF	TRBV3-1	TRBJ1-3
TGTGCCACGGGGGCCGGGACAGGAGGGGCCACCTACAATGAGCAGTTCTTC	CATGAGTGGATYNEQFF	TRBV24-1	TRBJ2-1
TGTGCCACCAGATTACTAGCGGGAGGGCATAGCACAGATACGCAGTATTTT	CATRLLAGGHSTDTQYF	TRBV24-1	TRBJ2-3
TGTGCCAGCATAAAGGACGAAGCCCAGCATTTT	CASIKDEAQHF	TRBV11-3	TRBJ1-5
TGCGCCACTCCTCGACGGCCGGGTGAGCAGTACTTC	CATPRRPGEQYF	TRBV5-1	TRBJ2-7
TGTGCCAGCAATCCGTTCCGGGGGGAGGAGACCCAGTACTTC	CASNPFRGEETQYF	TRBV6-2	TRBJ2-5
TGTGCCAGCAGCCGCGAGAACACCGGGGAGCTGTTTTTT	CASSRENTGELFF	TRBV7-2	TRBJ2-2
TGTGCCTGTTCCCGGACGGGGCTTGCAACTAATGAAAAACTGTTTTTT	CACSRTGLATNEKLFF	TRBV27	TRBJ1-4
TGTGCCAGCAGTCCGACAGGGGAGCCCCAGCATTTT	CASSPTGEPQHF	TRBV27	TRBJ1-5
TGTGCCAGCAGCCAAGATGGCAGGGACTTCAATGAGCAGTTCTTC	CASSQDGRDFNEQFF	TRBV14	TRBJ2-1
TGCAGCGTTGAGCGGGACCGATACACTGAAGCTTTCTTT	CSVERDRYTEAFF	TRBV29-1	TRBJ1-1
TGTGCCAGCAAGGGGCAGGGGGCAGATACGCAGTATTTT	CASKGQGADTQYF	TRBV12-3	TRBJ2-3
TGCGCCAGCAGTGAGGGTGGGGGGTCTAATGAAAAACTGTTTTTT	CASSEGGGSNEKLFF	TRBV10-1	TRBJ1-4
TGCAGTGCTAGAGATGGGCCAACACGGGACGGGGAGCTGTTTTTT	CSARDGPTRDGELFF	TRBV20-1	TRBJ2-2
TGTGCCAGTACGGTGCCGGGACCCGCCAAAAACATTCAGTACTTC	CASTVPGPAKNIQYF	TRBV19	TRBJ2-4
TGTGCCAGTAGACATACCTTCCGCGGGAGCTTGTCACTGAACACTGAAGCTTTCTTT	CASRHTFRGSLSLNTEAFF	TRBV19	TRBJ1-1
TGTGCCAGCAGTTATGGGGCGGGGCAGTTCTTC	CASSYGAGQFF	TRBV12-3	TRBJ2-1
TGTGCCAGCAGCTCTAGCAATGAGCAGTTCTTC	CASSSSNEQFF	TRBV11-3	TRBJ2-1
TGTGCCAGCAGTGGTTCGACCGGGGAGCTGTTTTTT	CASSGSTGELFF	TRBV27	TRBJ2-2
TGTGCCACCAGCAGCCCGGGACGGAACTATGGCTACACCTTC	CATSSPGRNYGYTF	TRBV15	TRBJ1-2
TGCGCCAGCAGCGGGGACTCAGGCTACACCTTC	CASSGDSGYTF	TRBV5-1	TRBJ1-2
TGTGCCAGCAGTTACTCATCAGGGGGGTATAATTCACCCCTCCACTTT	CASSYSSGGYNSPLHF	TRBV6-5	TRBJ1-6
TGCGCCAGCGGGACAGTGGGGAAGACTGAAGCTTTCTTT	CASGTVGKTEAFF	TRBV5-1	TRBJ1-1
TGCAGTGCCACAGAAGATTTCGAGCAGTACTTC	CSATEDFEQYF	TRBV20-1	TRBJ2-7
TGTGCCAGCAGTTTACGAGATAGTTTCGAGCAGTACTTC	CASSLRDSFEQYF	TRBV28	TRBJ2-7
TGTGCCAGCAGTTACCGCCGTAACACTGAAGCTTTCTTT	CASSYRRNTEAFF	TRBV6-2	TRBJ1-1
TGTGCCAGCAGTGGTGCGGGACATTTCTTGAACTACAATGAGCAGTTCTTC	CASSGAGHFLNYNEQFF	TRBV12-4	TRBJ2-1
TGTGCCAAGGGTGGACTAGCGGAGCCAACTGGGGCCAACGTCCTGACTTTC	CAKGGLAEPTGANVLTF	TRBV13	TRBJ2-6
TGTGCCAGCAGCCCTCGGACATGGACAGAGACCCAGTACTTC	CASSPRTWTETQYF	TRBV7-4	TRBJ2-5
TGCAGTGCTAGAGACTCGTTTACTAGCGGGAGAACAACCGGGGAGCTGTTTTTT	CSARDSFTSGRTTGELFF	TRBV20-1	TRBJ2-2
TGTGCCACCAGTGACTTTCAGCCCCAGCATTTT	CATSDFQPQHF	TRBV24-1	TRBJ1-5
TGTGCCAGCAGTTTACCGGGCACCCCGAGCGGGAGTTGCGCCCTCCACTTT	CASSLPGTPSGSCALHF	TRBV27	TRBJ1-6
TGTGCCACCAGCAGAGATAGAGGGACAGCGGCGGAGACCTCTGGGGCCAACGTCCTGACTTTC	CATSRDRGTAAETSGANVLTF	TRBV15	TRBJ2-6
TGTGCCAGCAGGCCCCAAGGACAGGCGAACACCGGGGAGCTGTTTTTT	CASRPQGQANTGELFF	TRBV12-4	TRBJ2-2
TGTGCGCGACAGGGAATCCGGAACACTGAAGCTTTCTTT	CARQGIRNTEAFF	TRBV5-6	TRBJ1-1
TGTGCCAGCAGTTTGGCACCGATAACGCTTGCGGAGCAGTACTTC	CASSLAPITLAEQYF	TRBV27	TRBJ2-7
TGCGCCAGCAGCGCACGTTCTGCGGCGGATACTAAGACCCAGTACTTC	CASSARSAADTKTQYF	TRBV5-1	TRBJ2-5
TGTGCCAGCTGGGGGGATCAGCCCCAGCATTTT	CASWGDQPQHF	TRBV6-5	TRBJ1-5
TGCGCCAGCAGCTTATCCCTAGCGGATGACAATGAGCAGTTCTTC	CASSLSLADDNEQFF	TRBV5-1	TRBJ2-1
TGCGCCAGACCTTCGGGGGGCGAGCAGTACTTC	CARPSGGEQYF	TRBV5-1	TRBJ2-7
TGTGCCAGCAGCAGACAGGGGGGGTACGAGCAGTACTTC	CASSRQGGYEQYF	TRBV27	TRBJ2-7
TGTGCCACCAGCACCCCGGGACAGGGGGGCGGGAAAAAAGTCGCTAATGAAAAACTGTTTTTT	CATSTPGQGGGKKVANEKLFF	TRBV15	TRBJ1-4
TGTGCCATCCCAGGAGCCCTAATCTGGAGGACAGATACGCAGTATTTT	CAIPGALIWRTDTQYF	TRBV10-3	TRBJ2-3
TGCGCCAGCAGTGGTAGTCAGCGGGACACTGAAGCTTTCTTT	CASSGSQRDTEAFF	TRBV10-1	TRBJ1-1
TGTGCCAGCAGTTTCACAGCACCACCTGTCACAGATACGCAGTATTTT	CASSFTAPPVTDTQYF	TRBV28	TRBJ2-3
TGCAGTGCTAGAGATGGTAAGGCGCCCCAGGATAGCAATCAGCCCCAGCATTTT	CSARDGKAPQDSNQPQHF	TRBV20-1	TRBJ1-5
TGCAGTGCCTTGAGGGATTGGGGCCTAGTGGGCTACCAAGAGACCCAGTACTTC	CSALRDWGLVGYQETQYF	TRBV20-1	TRBJ2-5
TGTGCCAGCAGCTCTCCTGACCACACCGGGGAGCTGTTTTTT	CASSSPDHTGELFF	TRBV9	TRBJ2-2
TGTGCCAGCAGCTTGGCGCAGTGCTTAAAATTTTTTTACGAGCAGTACTTC	CASSLAQCLKFFYEQYF	TRBV5-6	TRBJ2-7
TGTGCCAGCAGCAGGGGTAGATGGATGAACACTGAAGCTTTCTTT	CASSRGRWMNTEAFF	TRBV9	TRBJ1-1
TGTGCCAGCAGCTTAACAGGGGGCGCGTACGAGCAGTACTTC	CASSLTGGAYEQYF	TRBV7-3	TRBJ2-7
TGTGCCACGACTAGCGGGGGCAATGAGCAGTTCTTC	CATTSGGNEQFF	TRBV24-1	TRBJ2-1
TGCGCCACCGCCGGGACAGGGGAAGGGGTTAATGAAAAACTGTTTTTT	CATAGTGEGVNEKLFF	TRBV5-1	TRBJ1-4
TGCGCCAGCAGGGCGACTGGGGGGGCCAACGTCCTGACTTTC	CASRATGGANVLTF	TRBV10-2	TRBJ2-6
TGTGTGGGCATCAGAGGGCAAGAGACCCAGTACTTC	CVGIRGQETQYF	TRBV28	TRBJ2-5
TGTGCCAGCAGCCTGAGCGGGAGAGGAGACGAGCAGTACTTC	CASSLSGRGDEQYF	TRBV7-3	TRBJ2-7
TGTGCCAGCAGCTACATAAGCGGGATATGGGACTATGGCTACACCTTC	CASSYISGIWDYGYTF	TRBV5-6	TRBJ1-2
TGTGCCAGCAGCCAAGCCCGGTGGGACGAGCAGTACTTC	CASSQARWDEQYF	TRBV3-1	TRBJ2-7
TGCGCCAGCTTAGCAGGGGGCGGTTTTGAGCAGTTCTTC	CASLAGGGFEQFF	TRBV10-1	TRBJ2-1
TGTGCCAGTAACCCGCGGGAGGTCTCCTACGAGCAGTACTTC	CASNPREVSYEQYF	TRBV27	TRBJ2-7
TGTGCCAGCAGTTACTCGGGGAAAGGTGGACAGATGAACACTGAAGCTTTCTTT	CASSYSGKGGQMNTEAFF	TRBV6-5	TRBJ1-1
TGTGCCAGCAGCTTTAGCAACGGGGACAGGGGTACCTACGAGCAGTACTTC	CASSFSNGDRGTYEQYF	TRBV11-3	TRBJ2-7
TGTGCCAGCAGCCTGACTGGGGGGGGGGGGTCTGGGGTTGAGACCCAGTACTTC	CASSLTGGGGSGVETQYF	TRBV13	TRBJ2-5
TGTGCCAGCAGCCAAGACGTAGGAACTGAAGCTTTCTTT	CASSQDVGTEAFF	TRBV3-1	TRBJ1-1
TGTGCCAGCAGCTCCCAACAGGGGCGGAGCTCCTATAATTCACCCCTCCACTTT	CASSSQQGRSSYNSPLHF	TRBV11-3	TRBJ1-6
TGCAGCGTTGAAGACCTGGGATGCAAAGAGACCCAGTACTTC	CSVEDLGCKETQYF	TRBV29-1	TRBJ2-5
TGTGCCACCAGCAGAGATGACGGTGGTGAGAGGAACACCGGGGAGCTGTTTTTT	CATSRDDGGERNTGELFF	TRBV15	TRBJ2-2
TGTGCCAGCAGCGGAGGGACAGGTTACAATCAGCCCCAGCATTTT	CASSGGTGYNQPQHF	TRBV7-3	TRBJ1-5
TGTGCCAGCAGCCAAGCAAAGTCAATTCGGACCAGGGTTTACACGGTCGGGGAGCTGTTTTTT	CASSQAKSIRTRVYTVGELFF	TRBV3-1	TRBJ2-2
TGTGCCAGTAGTATAAATAAAGGGCAGCTTGAAGCTTTCTTT	CASSINKGQLEAFF	TRBV19	TRBJ1-1
TGTGCCAGCAGTGCCGGGACAGGGCTCTATGGCTACACCTTC	CASSAGTGLYGYTF	TRBV25-1	TRBJ1-2
TGTGCCATCAGTGAGTCCCGGGACAGGGACACCGGGGAGCTGTTTTTT	CAISESRDRDTGELFF	TRBV10-3	TRBJ2-2
TGTGCCAGCAGTGACTCGACCATGACAGGATGCTCGAACACCGGGGAGCTGTTTTTT	CASSDSTMTGCSNTGELFF	TRBV6-4	TRBJ2-2
TGTGCCAGCAGCCACCCCCGGAATCAGGGTAAACTAGCCAAAAACATTCAGTACTTC	CASSHPRNQGKLAKNIQYF	TRBV3-1	TRBJ2-4
TGTGCCAGCAGTTTATGGACTAGGCTTGGCACAGATACGCAGTATTTT	CASSLWTRLGTDTQYF	TRBV28	TRBJ2-3
TGTGCCAGCAGTGAACGGGGCTACGAGCAGTACTTC	CASSERGYEQYF	TRBV12-3	TRBJ2-7
TGCGCCAGCAGCCAAGAGACTAGCGGGGGGGCCCTAGACAATGAGCAGTTCTTC	CASSQETSGGALDNEQFF	TRBV4-1	TRBJ2-1
TGTGCCAAGGGGGCCGGGACAGTCTGCTACGAGCAGTACTTC	CAKGAGTVCYEQYF	TRBV6-3	TRBJ2-7
TGCGCCAGCAGCTCATCGCCCAGCTCCTATAATTCACCCCTCCACTTT	CASSSSPSSYNSPLHF	TRBV5-1	TRBJ1-6
TGTGCCAGCAGCGAGGTTGACAGGAGTGGCTACACCTTC	CASSEVDRSGYTF	TRBV13	TRBJ1-2
TGTGCCAGCAGTTCCCCCCATACCCGTACAGGGGGCTACACCTTC	CASSSPHTRTGGYTF	TRBV27	TRBJ1-2
TGTGCCAGCAGCTTGTCCCAGGGGGGGCGGCTCTTCTTGGGGGCCAACGTCCTGACTTTC	CASSLSQGGRLFLGANVLTF	TRBV11-3	TRBJ2-6
TGTGCTAGTGGTTTGTCCCCGGGACAGGGGGGCGAGGACACAGATACGCAGTATTTT	CASGLSPGQGGEDTDTQYF	TRBV12-5	TRBJ2-3
TGTGCCAGCAGCGGGGCGGGCTACACCTTC	CASSGAGYTF	TRBV13	TRBJ1-2
TGTGCCAGCAGCTCCCGCATTGCGAACACTGAAGCTTTCTTT	CASSSRIANTEAFF	TRBV7-8	TRBJ1-1
TGTGCCAGCAGTGCAGGGAACTACGAGCAGTACTTC	CASSAGNYEQYF	TRBV6-4	TRBJ2-7
TGTGCCAGCAGCACGCCGACAGACTCCTACGAGCAGTACTTC	CASSTPTDSYEQYF	TRBV7-3	TRBJ2-7
TGCGCCAGCATTCGGATGTGGCCTAGCTCCTACGAGCAGTACTTC	CASIRMWPSSYEQYF	TRBV5-1	TRBJ2-7
TGTGCCAGCAGCCTTAGAATAACCGTTTGGACAGGGAGAGCCTCCTACGAGCAGTACTTC	CASSLRITVWTGRASYEQYF	TRBV7-9	TRBJ2-7
TGTGCCAGCAGGTGGGGGGGCGCCCGCACAGATACGCAGTATTTT	CASRWGGARTDTQYF	TRBV5-4	TRBJ2-3
TGTGCCAGCTCACCACCCGGGGGGTTCGCGAACACCGGGGAGCTGTTTTTT	CASSPPGGFANTGELFF	TRBV18	TRBJ2-2
TGTGCCAGCAGCCTCCTAGCGGTTTCACCGCTGCAAGAGACCCAGTACTTC	CASSLLAVSPLQETQYF	TRBV13	TRBJ2-5
TGTGCCAGCAGTACCCGCCTTGGGTATAACGGACAGGAGGTGAGGAACCCAACTAATGAAAAACTGTTTTTT	CASSTRLGYNGQEVRNPTNEKLFF	TRBV12-4	TRBJ1-4
TGTGCCAGCAGCTTACGGGCCGAATGTAACACTGAAGCTTTCTTT	CASSLRAECNTEAFF	TRBV5-4	TRBJ1-1
TGTGCCAGCAGTTTCCGGACAGGGTCCCGTCACACTGAAGCTTTCTTT	CASSFRTGSRHTEAFF	TRBV28	TRBJ1-1
TGTGCCAGCACGGGCACAGATACGCAGTATTTT	CASTGTDTQYF	TRBV9	TRBJ2-3
TGTGCCAGCATCGTCTCCGGACAGGGCTTC	CASIVSGQGF	TRBV28	TRBJ2-7
TGTGCCAGCAGCTCCTCTTTGAGGCCTGAAGCTTTCTTT	CASSSSLRPEAFF	TRBV6-1	TRBJ1-1
TGTGCCAGCAGTTGCGTCCACCGGGACAGAGGAGGAAACACCATATATTTT	CASSCVHRDRGGNTIYF	TRBV6-5	TRBJ1-3
TGCGCCAGCAGCAGTGGGACAGATCAGCCCCAGCATTTT	CASSSGTDQPQHF	TRBV5-1	TRBJ1-5
TGCGCCAGCAGCTTGGGTATCAGCAAAGGGAGGGAGCAGTACTTC	CASSLGISKGREQYF	TRBV5-1	TRBJ2-7
TGCGCCAGCCGGCCGGGGGGTGACCAGTACTTC	CASRPGGDQYF	TRBV10-1	TRBJ2-7
TGTGCCAGCAGGGGTGGTACCGGGACAGGGGTATGGGAGAACACTGAAGCTTTCTTT	CASRGGTGTGVWENTEAFF	TRBV27	TRBJ1-1
TGCGCCAGCAGCATTCTGGAATACGAGCAGTACTTC	CASSILEYEQYF	TRBV5-1	TRBJ2-7
TGTGCCAGCACCCCAGGATTGCCTGGGGCCAACGTCCTGACTTTC	CASTPGLPGANVLTF	TRBV28	TRBJ2-6
TGTGCCAGCAGTTCCCGACGGGACAGGAATCAGCCCCAGCATTTT	CASSSRRDRNQPQHF	TRBV2	TRBJ1-5
TGTGCCACCAGTACGAAACCTTACGAGCAGTACTTC	CATSTKPYEQYF	TRBV24-1	TRBJ2-7
TGCAGTGCTAGTGGCCAGGGACGCACAGATACGCAGTATTTT	CSASGQGRTDTQYF	TRBV20-1	TRBJ2-3
TGTGCCAGCAGGGGGGCCCTCCAAGAGACCCAGTACTTC	CASRGALQETQYF	TRBV28	TRBJ2-5
TGCGCCAGCAGCCAAGAGTACAGGGGGCTAGCTTTCTTT	CASSQEYRGLAFF	TRBV4-1	TRBJ1-1
TGTGCCAGCAGCTCCCCGGGACAAAATGGCTATGGCTACACCTTC	CASSSPGQNGYGYTF	TRBV5-6	TRBJ1-2
TGTGCTAGCAGCCGGAGACCGGGGGTGTACGAGCAGTACTTC	CASSRRPGVYEQYF	TRBV7-7	TRBJ2-7
TGTGCCAGCAGTGAAGCGCCAAAATACTCCGGCGAGCAGTACTTC	CASSEAPKYSGEQYF	TRBV6-1	TRBJ2-7
TGTGCCAGCAGCCTGGGACGTGGCGGAACCTACGAGCAGTACTTC	CASSLGRGGTYEQYF	TRBV7-3	TRBJ2-7
TGTGCCAGCAGCTTGGGACATCCATTAAAACAGCTGAATCAGCCCCAGCATTTT	CASSLGHPLKQLNQPQHF	TRBV5-4	TRBJ1-5
TGTGCCAGCAGCTTAACAGGTGGGGGGGGGGGCTCCATCAATGAGCAGTTCTTC	CASSLTGGGGGSINEQFF	TRBV7-2	TRBJ2-1
TGTGCCAGCGGACAGGGGAGGGCTAATGAAAAACTGTTTTTT	CASGQGRANEKLFF	TRBV9	TRBJ1-4
TGCAGTGCATCCCTCGCGGCCTACGAGCAGTACTTC	CSASLAAYEQYF	TRBV20-1	TRBJ2-7
TGTGCCAGCAGCCCGGGACTAGCGGTAGTTTACAATGAGCAGTTCTTC	CASSPGLAVVYNEQFF	TRBV9	TRBJ2-1
TGCAGCGTTGAAGATCCGAGACAGGGGCCCGAGCAGTACTTC	CSVEDPRQGPEQYF	TRBV29-1	TRBJ2-7
TGTGCCAGCAGAAATGATAGCGGGAATTCAGATACGCAGTATTTT	CASRNDSGNSDTQYF	TRBV6-6	TRBJ2-3
TGTGCCACCAGCAGGGCGCTCGAGCAGTACTTC	CATSRALEQYF	TRBV15	TRBJ2-7
TGTGCCAGTAGTACTTCGGGTGGGATAACCTACGAGCAGTACTTC	CASSTSGGITYEQYF	TRBV19	TRBJ2-7
TGCGCCAGCAGGTTAGGGGTTCTAAGCAGTGCTTTCTTT	CASRLGVLSSAFF	TRBV4-1	TRBJ1-1
TGTGCTAGTGGTTTGCCGGATCCAATGGGGTTTCGCAATCAGCCCCAGCATTTT	CASGLPDPMGFRNQPQHF	TRBV12-5	TRBJ1-5
TGCGCCAGCTCTACCCGGCCCGAGCAGTACTTC	CASSTRPEQYF	TRBV5-1	TRBJ2-7
TGCGCCAGCCGAAGTGGCGATCGTCAGCCCCAGCATTTT	CASRSGDRQPQHF	TRBV10-1	TRBJ1-5
TGTGCCAGCAGTGACAGGGGGCTTGGAAACACCATATATTTT	CASSDRGLGNTIYF	TRBV6-1	TRBJ1-3
TGTGCCAGCAGTGCCTACGTCGTCGGGATAAGAGATACGCAGTATTTT	CASSAYVVGIRDTQYF	TRBV25-1	TRBJ2-3
TGCGCCAGCAGCTCTAGGGGGACCTATCAGCCCCAGCATTTT	CASSSRGTYQPQHF	TRBV5-1	TRBJ1-5
TGTGCCAGCACTGACAGGGCCCACAATCAGCCCCAGCATTTT	CASTDRAHNQPQHF	TRBV6-2	TRBJ1-5
TGTGCCAGCAGCCCCCCCAGACAGCTTAGCAATCAGCCCCAGCATTTT	CASSPPRQLSNQPQHF	TRBV7-9	TRBJ1-5
TGTGCCAGTAGTATAGCAGTGGACAGGGGCTATTCGAACACTGAAGCTTTCTTT	CASSIAVDRGYSNTEAFF	TRBV19	TRBJ1-1
TGTGCCAGCTCACCCCAGGATCCAGAGGCTTCAGTGAACACTGAAGCTTTCTTT	CASSPQDPEASVNTEAFF	TRBV18	TRBJ1-1
TGTGCCAGCAGGAGGGGGGGCACAGATACGCAGTATTTT	CASRRGGTDTQYF	TRBV6-3	TRBJ2-3
TGTGCCAGCAGTTTATGTAGGTCCAACACCGGGGAGCTGTTTTTT	CASSLCRSNTGELFF	TRBV28	TRBJ2-2
TGTGCCAGCAGCTTGTGGACAGAGATGAATGAGCAGTTCTTC	CASSLWTEMNEQFF	TRBV5-6	TRBJ2-1
TGCAGCTTCGTAGCGGGAGCCTACAATGAGCAGTTCTTC	CSFVAGAYNEQFF	TRBV29-1	TRBJ2-1
TGTGCCAGCAGCTACGCTAGCGGCTCCTACAATGAGCAGTTCTTC	CASSYASGSYNEQFF	TRBV7-9	TRBJ2-1
TGTGCCAGCGCGACTCCCGAGACCCAGTACTTC	CASATPETQYF	TRBV9	TRBJ2-5
TGTGCCAGCAGCATCAATTGTTTAGGGAAAAGTACCGGGGAGCTGTTTTTT	CASSINCLGKSTGELFF	TRBV5-6	TRBJ2-2
TGTGCCAGCAGTCAGGACAGGGCAAGGAGAGAGACCCAGTACTTC	CASSQDRARRETQYF	TRBV2	TRBJ2-5
TGTGCCAGCAGCCTCCCAGGCACTGAAGCTTTCTTT	CASSLPGTEAFF	TRBV7-9	TRBJ1-1
TGTGCCAGCAGCAGTGGACAGGGAGACACTGAAGCTTTCTTT	CASSSGQGDTEAFF	TRBV9	TRBJ1-1
TGTGCCTGGATCAATGGCTCACCGGCGGACGAACCCCTCCACTTT	CAWINGSPADEPLHF	TRBV30	TRBJ1-6
TGCAGTGCTATAAGGACGGTAAAGGCTCGGGCTGAAGCTTTCTTT	CSAIRTVKARAEAFF	TRBV20-1	TRBJ1-1
TGTGCCAGCAGCTTACCACAGGGGAGAAACGGGGAGCTGTTTTTT	CASSLPQGRNGELFF	TRBV7-9	TRBJ2-2
TGTGCCAGAGGTGCAGGGAGGGCGGCTTACAATGAGCAGTTCTTC	CARGAGRAAYNEQFF	TRBV12-4	TRBJ2-1
TGTGCCAGCAGCGACCCAGGGCTAGGGGGCGAAATTAATAAACTCTCCTACGAGCAGTACTTC	CASSDPGLGGEINKLSYEQYF	TRBV9	TRBJ2-7
TGCAGCGTTGAAGAGGGCCAGAGGGACTCCTACAATGAGCAGTTCTTC	CSVEEGQRDSYNEQFF	TRBV29-1	TRBJ2-1
TGCAGTGCTAAAGCCTACAGGGGAGCCTTGAACACTGAAGCTTTCTTT	CSAKAYRGALNTEAFF	TRBV20-1	TRBJ1-1
TGTGCTAGTGGTTTGGGCCAATGGATGATCCGGACCACCGGGGAGCTGTTTTTT	CASGLGQWMIRTTGELFF	TRBV12-5	TRBJ2-2
TGTGCCAGCAGCTTGTCGGGCCTTCCCAATCAGCCCCAGCATTTT	CASSLSGLPNQPQHF	TRBV5-5	TRBJ1-5
TGTGCCAGCAGTAAAGCACTAGCGGGAGGCTACGAGCAGTACTTC	CASSKALAGGYEQYF	TRBV2	TRBJ2-7
TGTGCCAGCAGCGAGGGAGGGGGGAATGGCTACACCTTC	CASSEGGGNGYTF	TRBV11-3	TRBJ1-2
TGCAGCGTTGACAGGGACATAGGCAATCAGCCCCAGCATTTT	CSVDRDIGNQPQHF	TRBV29-1	TRBJ1-5
TGTGCCAGCAGGCCTAACGGCGGTGGACAGGGGGTGTTGGAAGCTTTCTTT	CASRPNGGGQGVLEAFF	TRBV6-1	TRBJ1-1
TGTGCCAGCAGCGTTCGGACTAGCGGGAATGAGCAGTTCTTC	CASSVRTSGNEQFF	TRBV7-4	TRBJ2-1
TGTGCCAGCAGTGAATCAGGGGGGAGAGTCTTC	CASSESGGRVF	TRBV25-1	TRBJ2-1
TGCAGCGTTGAATTGGAGAGCCGGGAGATCACTGAAGCTTTCTTT	CSVELESREITEAFF	TRBV29-1	TRBJ1-1
TGTGCCAGCCCGGGGATGGGAGGGGACAGGGGGCAGCCCCAGCATTTT	CASPGMGGDRGQPQHF	TRBV6-4	TRBJ1-5
TGTGCCAGCGTATACATTCGGACTCGGGCTCCAACAGATTATGGCGACCCAACCTACGAGCAGTACTTC	CASVYIRTRAPTDYGDPTYEQYF	TRBV27	TRBJ2-7
TGCAGTGCTAGAGAGGGACTAGTGGAAACAGATACGCAGTATTTT	CSAREGLVETDTQYF	TRBV20-1	TRBJ2-3
TGTGCCAGCAGATTCCCTCGGGGCTATGGCTACACCTTC	CASRFPRGYGYTF	TRBV6-6	TRBJ1-2
TGTGCCAGCCGACCGGGAAACACCATATATTTT	CASRPGNTIYF	TRBV11-3	TRBJ1-3
TGTGCCAGCAGCGGTTACCGGGGGACAGGGGGCAGGAGGGGGAGCTCCTACGAGCAGTACTTC	CASSGYRGTGGRRGSSYEQYF	TRBV7-9	TRBJ2-7
TGTGCCCGACTAGCGGACCCCTACGAGCAGTACTTC	CARLADPYEQYF	TRBV24-1	TRBJ2-7
TGTGCCAGCAAATTTCTAATCGACGGGTACGAGCAGTACTTC	CASKFLIDGYEQYF	TRBV6-1	TRBJ2-7
TGTGCCAGCAGCGGTCCCAGGATGAACCAAGAGACCCAGTACTTC	CASSGPRMNQETQYF	TRBV7-3	TRBJ2-5
TGTGCCAGCAGCCCTAGCGGGTTTACCCCAGATACGCAGTATTTT	CASSPSGFTPDTQYF	TRBV7-3	TRBJ2-3
TGTGCCAGCACCACAACAGGGAAGGATGGCTACACCTTC	CASTTTGKDGYTF	TRBV6-4	TRBJ1-2
TGTGCCAGCAGGCAGCGGGATCAGCCCCAGCATTTT	CASRQRDQPQHF	TRBV6-1	TRBJ1-5
TGTGCCAGCACTGGACCCGGGACAGGGAGGGTGCATGGCTACACCTTC	CASTGPGTGRVHGYTF	TRBV7-4	TRBJ1-2
TGTGCCAGCAGCCAAGATATCGGCCTCCGGGGGGGACGCTACGAGCAGTACTTC	CASSQDIGLRGGRYEQYF	TRBV3-1	TRBJ2-7
TGTGCCAGCAGTCGGGGTACTTGGGGTGGGCCGAACACTGAAGCTTTCTTT	CASSRGTWGGPNTEAFF	TRBV7-8	TRBJ1-1
TGTGCCAGCAGTTTAACGAGCCTGTGGGAGACCCAGTACTTC	CASSLTSLWETQYF	TRBV27	TRBJ2-5
TGTGCCACCAAAACCAGAGGATTACAGGGGCGGAACACTGAAGCTTTCTTT	CATKTRGLQGRNTEAFF	TRBV24-1	TRBJ1-1
TGTGCCAGCAGCGGAGGGACGGACCAAGAGACCCAGTACTTC	CASSGGTDQETQYF	TRBV9	TRBJ2-5
TGTGCCAGCAATGGACGCGCCAAAAACATTCAGTACTTC	CASNGRAKNIQYF	TRBV27	TRBJ2-4
TGCGCCAGGATCTGGGAGGGTCGCTCCTACGAGCAGTACTTC	CARIWEGRSYEQYF	TRBV10-1	TRBJ2-7
TGTGCCAGCAGTGAGCGGGAGGTGTTAGAGACCCAGTACTTC	CASSEREVLETQYF	TRBV2	TRBJ2-5
TGTGCCAACCGTAGTACCTCGAACACCGGGGAGCTGTTTTTT	CANRSTSNTGELFF	TRBV19	TRBJ2-2
TGTGCCACATGGACAGATGGCTACACCTTC	CATWTDGYTF	TRBV6-4	TRBJ1-2
TGTGCCAGCAGATTGACTAGCGGGGAAAAGAATGAGCAGTTCTTC	CASRLTSGEKNEQFF	TRBV7-3	TRBJ2-1
TGTGCCAGCGTGACAGCCACTAATGAAAAACTGTTTTTT	CASVTATNEKLFF	TRBV4-2	TRBJ1-4
TGCGCCAGCAGCCAAGGGCAGGGGCGGAGTGAGCAGTACTTC	CASSQGQGRSEQYF	TRBV4-1	TRBJ2-7
TGTGCCAGCCGGCAAGCCATCCCCCAATCCACGACTCGAAGGACAGATACGCAGTATTTT	CASRQAIPQSTTRRTDTQYF	TRBV5-6	TRBJ2-3
TGTGCCAGCAAGACAAAGGATACGCAGTATTTT	CASKTKDTQYF	TRBV2	TRBJ2-3
TGTGCCAGTGCGGATGGGGGTTCTCACCTAGATCAGCCCCAGCATTTT	CASADGGSHLDQPQHF	TRBV19	TRBJ1-5
TGTGCCAGCAGAAAGTGCACCGGGGGGACCTACGAGCAGTACTTC	CASRKCTGGTYEQYF	TRBV6-1	TRBJ2-7
TGTGCCACCAGTAGTCACGGGGGGGCAGACACCGGGGAGCTGTTTTTT	CATSSHGGADTGELFF	TRBV24-1	TRBJ2-2
TGTGCCAGCAGCTTAGCCCCGGGGGTGTCTAGCACAGATACGCAGTATTTT	CASSLAPGVSSTDTQYF	TRBV7-4	TRBJ2-3
TGCAGCGTTGAAGATGTCGAGTTCGGGACGTCCTATGGCTACACCTTC	CSVEDVEFGTSYGYTF	TRBV29-1	TRBJ1-2
TGTGCCAGCAGTTTCAGATCTGATTCAGACGCTCAGCCCCAGCATTTT	CASSFRSDSDAQPQHF	TRBV12-3	TRBJ1-5
TGTGCCAATACAGGCCTAGATACGCAGTATTTT	CANTGLDTQYF	TRBV12-3	TRBJ2-3
TGTGCCAGCAGCTGTTCTAGCGGGCACGGGGTGGGGAGCACAGATACGCAGTATTTT	CASSCSSGHGVGSTDTQYF	TRBV7-4	TRBJ2-3
TGTGCCAGCTCACCAGGTAAAGCAGGGAAGTATAGCAATCAGCCCCAGCATTTT	CASSPGKAGKYSNQPQHF	TRBV18	TRBJ1-5
TGCGCCAGCAGCTGGGAAAACCGCCGGGACAGGGCTTTCTTT	CASSWENRRDRAFF	TRBV4-3	TRBJ1-1
TGCGCCAGCAGGGGGACAGTGTATTTCGAAAAACTGTTTTTT	CASRGTVYFEKLFF	TRBV10-1	TRBJ1-4
TGCAGTGCTAGTAGCGCCCCTAGGGTAGACAGTTCACCCCTCCACTTT	CSASSAPRVDSSPLHF	TRBV20-1	TRBJ1-6
TGTGCCAGCAGTGGGCCTTACCATGGCTACACCTTC	CASSGPYHGYTF	TRBV6-1	TRBJ1-2
TGTGCCAGCAGCCCGCCGGGACACGAGCAGTACTTC	CASSPPGHEQYF	TRBV14	TRBJ2-7
TGTGCCAGCAGCCGGCCGGACAGTTCCGAAAAACTGTTTTTT	CASSRPDSSEKLFF	TRBV7-3	TRBJ1-4
TGTGCCAGCAGCCCCAGGGGCGAGCAGTACTTC	CASSPRGEQYF	TRBV7-3	TRBJ2-7
TGCGCCAGCAGATTCGGACAGGCCCACTATGGCTACACCTTC	CASRFGQAHYGYTF	TRBV5-1	TRBJ1-2
TGTGCCAGCAGCTTGTCGCTGCCCCATGAGCAGTTCTTC	CASSLSLPHEQFF	TRBV7-9	TRBJ2-1
TGCGCCAGCAGTGAGGGCCAAGGCGGGACTAGCGTTGTCTACGAGCAGTACTTC	CASSEGQGGTSVVYEQYF	TRBV10-1	TRBJ2-7
TGTGCCACCAGTGAAAGGCGGCACATTGGAAACACCATATATTTT	CATSERRHIGNTIYF	TRBV24-1	TRBJ1-3
TGTGCTAGTGGTTGTATCCCCAAGGGGGGGGTCAACACTGAAGCTTTCTTT	CASGCIPKGGVNTEAFF	TRBV12-5	TRBJ1-1
TGCGCCAGCAGCTCAGCGGGACACCTAGCTTTCTTT	CASSSAGHLAFF	TRBV5-1	TRBJ1-1
TGTGCCAGCAGCCCCACGAATGAGCAGTTCTTC	CASSPTNEQFF	TRBV27	TRBJ2-1
TGCGCCAGCAGCTTGGACGGTAAAGGGGCGAATACCATAGAAAACACTGAAGCTTTCTTT	CASSLDGKGANTIENTEAFF	TRBV5-1	TRBJ1-1
TGTGCCAGCATTCATATCTATGGCTACACCTTC	CASIHIYGYTF	TRBV7-3	TRBJ1-2
TGTGCCAGTGGTCTTTCCCGACTAGCGGGAAATGAGCAGTTCTTC	CASGLSRLAGNEQFF	TRBV19	TRBJ2-1
TGTGCCAGCATGCCGGAGATACTAGAAGGGTATAGCTCCTACAATGAGCAGTTCTTC	CASMPEILEGYSSYNEQFF	TRBV11-2	TRBJ2-1
TGTGCTAGTGGTACACGGCTAGCCAACGAGCAGTACTTC	CASGTRLANEQYF	TRBV12-5	TRBJ2-7
TGCGCCAGCAGTGAGCCCCCCGGAAAGGGGGCAGGGAACACTGAAGCTTTCTTT	CASSEPPGKGAGNTEAFF	TRBV10-1	TRBJ1-1
TGTGCCAGCAGCCAAGGGTCCTGCCTAGCGAACACCGGGGAGCTGTTTTTT	CASSQGSCLANTGELFF	TRBV4-2	TRBJ2-2
TGTGCCCAATTCGACAGGGCCTTTTACACTGAAGCTTTCTTT	CAQFDRAFYTEAFF	TRBV19	TRBJ1-1
TGTGCCAGCAGCTTTAGTCTGGACCGTCATAGCAATCAGCCCCAGCATTTT	CASSFSLDRHSNQPQHF	TRBV13	TRBJ1-5
TGTGCCAGCAGCTTTCCCAGACGGGTGAACACTGAAGCTTTCTTT	CASSFPRRVNTEAFF	TRBV7-9	TRBJ1-1
TGTGCCAGCATAAGGACAAGAACTGGCTACACCTTC	CASIRTRTGYTF	TRBV6-3	TRBJ1-2
TGTGCCAGCAGCGTAGCCGCGCGGGGGATAGTAGTAGCCAAAAACATTCAGTACTTC	CASSVAARGIVVAKNIQYF	TRBV9	TRBJ2-4
TGTCATCCCGGGACTAGCGGGAGCTCTGTTTACGAGCAGTACTTC	CHPGTSGSSVYEQYF	TRBV19	TRBJ2-7
TGTGCCACCAGTGGGTCGGACAGGGGGCCAGATACGCAGTATTTT	CATSGSDRGPDTQYF	TRBV24-1	TRBJ2-3
TGTGCCAGCAGTCGACGTAGGGAGAAGTATAGCAATCAGCCCCAGCATTTT	CASSRRREKYSNQPQHF	TRBV25-1	TRBJ1-5
TGTGCCACCTCAGGCCCTAGGGTGGAAAGATTTAATCAGGATCGGGATACGCAGTATTTT	CATSGPRVERFNQDRDTQYF	TRBV15	TRBJ2-3
TGTGCCAGCAGCCACAGTGACCGCAATCAGCCCCAGCATTTT	CASSHSDRNQPQHF	TRBV7-6	TRBJ1-5
TGCAGTGGTAAATCGGCAGGGAGAGGCACTGAAGCTTTCTTT	CSGKSAGRGTEAFF	TRBV20-1	TRBJ1-1
TGTGCCAGCAGCTCATGCACAGGGGATACGCAGTATTTT	CASSSCTGDTQYF	TRBV7-3	TRBJ2-3
TGTGCTAGCAGCTTCGGACTAGTCTTAAATGAGCAGTTCTTC	CASSFGLVLNEQFF	TRBV7-7	TRBJ2-1
TGTGCCAGCAGTTACGCCGGGACTAGGCAGGCAGATACGCAGTATTTT	CASSYAGTRQADTQYF	TRBV6-5	TRBJ2-3
TGTGCCATCTATCCGCCGGGGCGTCCCCCTTTTGAGCAGTTCTTC	CAIYPPGRPPFEQFF	TRBV6-5	TRBJ2-1
TGCAGTGCTAGCAGGGGCAATCACGAGCAGTACTTC	CSASRGNHEQYF	TRBV20-1	TRBJ2-7
TGTGCCACCAGTGTCCGGTCCACTGATCGTATCGATACGCAGTATTTT	CATSVRSTDRIDTQYF	TRBV24-1	TRBJ2-3
TGCGCCAGCAGCGACAGGGGGCAGGATGGATGGGGCCCTGCGGGAATGAACACTGAAGCTTTCTTT	CASSDRGQDGWGPAGMNTEAFF	TRBV5-1	TRBJ1-1
TGTGCCAGCAGTGAACGGTGGCCAGACAAGAATTCACCCCTCCACTTT	CASSERWPDKNSPLHF	TRBV2	TRBJ1-6
TGTGCCAGCAGCGTAGGGGGTTATCGTGAGCAGTTCTTC	CASSVGGYREQFF	TRBV9	TRBJ2-1
TGCGCCAGCAGCCCTCAGGGTTCATTCCCCTATGGCTACACCTTC	CASSPQGSFPYGYTF	TRBV4-3	TRBJ1-2
TGTGCCAGCAGCGAAGTATCGACAGGGCTGAGCTCCTATAATTCACCCCTCCACTTT	CASSEVSTGLSSYNSPLHF	TRBV7-6	TRBJ1-6
TGTGCCAGCAGTACAGGGACCGGGGAGCTGTTTTTT	CASSTGTGELFF	TRBV6-1	TRBJ2-2
TGTGCCAGCAGCTTGACAGGACCAGGAGCGTGGCATCAGCCCCAGCATTTT	CASSLTGPGAWHQPQHF	TRBV5-6	TRBJ1-5
TGTGCCAGTAGTAGGGTAGCGGGAGACGACCTTACTGAAGCTTTCTTT	CASSRVAGDDLTEAFF	TRBV19	TRBJ1-1
TGTGCCAGCAGCTTACCTGCATCACATGAGCAGTTCTTC	CASSLPASHEQFF	TRBV7-9	TRBJ2-1
TGTGCCACCAGTGATTTTCGCACAGGGAAGCCCCAGCATTTT	CATSDFRTGKPQHF	TRBV24-1	TRBJ1-5
TGTGCCAGCATACCCGTAAACAGCTCCTATAATTCACCCCTCCACTTT	CASIPVNSSYNSPLHF	TRBV27	TRBJ1-6
TGCAGTGCCCGGCGCCGGGCTAGGGGCAAAAACATTCAGTACTTC	CSARRRARGKNIQYF	TRBV20-1	TRBJ2-4
TGCGCCACGTCCGGGACTAGGGTACCCGAGACCCAGTACTTC	CATSGTRVPETQYF	TRBV5-1	TRBJ2-5
TGTGCCAGTAGTATTTACAATGGTGCTGGGACAGCGCGGAACACTGAAGCTTTCTTT	CASSIYNGAGTARNTEAFF	TRBV19	TRBJ1-1
TGTGCCGGGGCAGGGACTAATGAAAAACTGTTTTTT	CAGAGTNEKLFF	TRBV24-1	TRBJ1-4
TGTGCCAGCAGCGAGTTGAGGACAGGGGGAAACCTCGATAACACTTTTGGCTACACCTTC	CASSELRTGGNLDNTFGYTF	TRBV7-3	TRBJ1-2
TGTGCCAGCATCTTAGGGGTAAACTACGAGCAGTACTTC	CASILGVNYEQYF	TRBV6-2	TRBJ2-7
TGTGCCACCAGTGACTGGGTGCTGTCGGACAGATCGGGGAACACTGAAGCTTTCTTT	CATSDWVLSDRSGNTEAFF	TRBV24-1	TRBJ1-1
TGCAGTGCTCGACCTGAGGGCCAAGAAGATTGCTCCTACAATGAGCAGTTCTTC	CSARPEGQEDCSYNEQFF	TRBV20-1	TRBJ2-1
TGTGCCAGCAGCCATCCCAGGACAGACTATGGCTACACCTTC	CASSHPRTDYGYTF	TRBV3-1	TRBJ1-2
TGTGCCAGCAGCTTAGGGGGGGCGAAAAAAGGCTCTGGGGCCAACGTCCTGACTTTC	CASSLGGAKKGSGANVLTF	TRBV7-9	TRBJ2-6
TGCAGCGGAGGACATCAGTCCCAAGAGACCCAGTACTTC	CSGGHQSQETQYF	TRBV29-1	TRBJ2-5
TGCGCCAGCAGCCCCTATGCCAGGGTCTTGTCCGCTCATCCCAATGAAAAACTGTTTTTT	CASSPYARVLSAHPNEKLFF	TRBV4-3	TRBJ1-4
TGTGCCAGCAGCTCTACAGGGAAGCGCTACGAGCAGTACTTC	CASSSTGKRYEQYF	TRBV11-3	TRBJ2-7
TGTGCCAGCAGCTTAGACCCGGACAGGGGAAACACCATATATTTT	CASSLDPDRGNTIYF	TRBV7-9	TRBJ1-3
TGTGCCAGGCGGACGAACACTGAAGCTTTCTTT	CARRTNTEAFF	TRBV27	TRBJ1-1
TGTGCCAGCAGGGGCACGTGCTACGAGCAGTACTTC	CASRGTCYEQYF	TRBV7-2	TRBJ2-7
TGTGCCAGCAGGACAGGGGGCAAGCTCCAGCCCCAGCATTTT	CASRTGGKLQPQHF	TRBV5-6	TRBJ1-5
TGTGCCACCAGCCCAGAGGGAACCGTTAATTCACCCCTCCACTTT	CATSPEGTVNSPLHF	TRBV15	TRBJ1-6
TGTGCCAGCAGGATAGACCCGGCTTATAGCAATCAGCCCCAGCATTTT	CASRIDPAYSNQPQHF	TRBV7-8	TRBJ1-5
TGTGCCAGCAGCCAAGATATAGTGACAGGGGAGGAGACCCAGTACTTC	CASSQDIVTGEETQYF	TRBV14	TRBJ2-5
TGTGCCAGTCCGGGGGGGCCCTACGAGCAGTACTTC	CASPGGPYEQYF	TRBV5-6	TRBJ2-7
TGTGCCAGCAGCTTAACGGGGGCGGAAGCTTTCTTT	CASSLTGAEAFF	TRBV11-3	TRBJ1-1
TGCGCCAGCAGCTTGTCAGTCCGGGGGGGCCTACTTAAAGAGACCCAGTACTTC	CASSLSVRGGLLKETQYF	TRBV5-1	TRBJ2-5
TGTGCCAGCAGCTTATATAGTGGCTACACCTTC	CASSLYSGYTF	TRBV7-3	TRBJ1-2
TGTGCCAGCAGCGTTACGGGGGGGCTCAGGGGAAGCTCCTATAATTCACCCCTCCACTTT	CASSVTGGLRGSSYNSPLHF	TRBV9	TRBJ1-6
TGTGCCAGCAGCTTGGGCGGGGCCCATAATTCACCCCTCCACTTT	CASSLGGAHNSPLHF	TRBV5-8	TRBJ1-6
TGCGCCAGCAGCTTCGGGGGGGACGAGCAGTACTTC	CASSFGGDEQYF	TRBV5-1	TRBJ2-7
TGCAGTGCTAGTCAAAGGGGCCCATCCTACGAGCAGTACTTC	CSASQRGPSYEQYF	TRBV20-1	TRBJ2-7
TGTGCCAGCAGCGTGACTAGCGGGAGGGCCCGGGCATTAGGGAAAAACATTCAGTACTTC	CASSVTSGRARALGKNIQYF	TRBV13	TRBJ2-4
TGTGCCAGCAGTGACGACAAGAGAAGACAGGGATCCTACGAGCAGTACTTC	CASSDDKRRQGSYEQYF	TRBV6-4	TRBJ2-7
TGTGCCAGCAGCTTATGGGGGGGGGGGGATGGGTGGCATAAAGATACGCAGTATTTT	CASSLWGGGDGWHKDTQYF	TRBV5-8	TRBJ2-3
TGTGCCAGCAGTTTATCGAGGGGGGGTAGGGGGCAAAATGGCTACACCTTC	CASSLSRGGRGQNGYTF	TRBV27	TRBJ1-2
TGTGCTACCGTGGGAGGGAAACAGCCCCAGCATTTT	CATVGGKQPQHF	TRBV12-5	TRBJ1-5
TGTGCCAGCAGTTACTCGGGACAGGCAATCTACGAGCAGTACTTC	CASSYSGQAIYEQYF	TRBV6-6	TRBJ2-7
TGCGCCAGCAGATATAACCGGGACAAAGTTTACTATGGCTACACCTTC	CASRYNRDKVYYGYTF	TRBV10-1	TRBJ1-2
TGTGCCAGCAGCCAAGTGGAAACGATGGAGGAAACCTACGAGCAGTACTTC	CASSQVETMEETYEQYF	TRBV3-1	TRBJ2-7
TGTGCTATAGAGGGGACAGCTGCCGGAGGGTATGGCTACACCTTC	CAIEGTAAGGYGYTF	TRBV2	TRBJ1-2
TGCGCCAGCAGCGCTAGCGGGGCCTACGAGCAGTACTTC	CASSASGAYEQYF	TRBV5-1	TRBJ2-7
TGCAGCGTTGATGGGCGGGACTCACATGGAAACACCATATATTTT	CSVDGRDSHGNTIYF	TRBV29-1	TRBJ1-3
TGTGCCAGCAGTGCGACGGATAGCGGGCGACCCACAGATACGCAGTATTTT	CASSATDSGRPTDTQYF	TRBV12-4	TRBJ2-3
TGTGCTAGTTCCTGGCATGAGCAGTTCTTC	CASSWHEQFF	TRBV12-5	TRBJ2-1
TGTGCCAGCTCACCACCAGTTTTTTCCACTGAAGCTTTCTTT	CASSPPVFSTEAFF	TRBV18	TRBJ1-1
