TGTGCCACCAGTGGGTACCGACAGGGCGAGAGGGCCTATGGCTACACCTTC	CATSGYRQGERAYGYTF	TRBV24-1	TRBJ1-2
TGTGCCAGCAGTTCAATTGGGGGGCAGGTTGAGCAGTTCTTC	CASSSIGGQVEQFF	TRBV27	TRBJ2-1
TGTGCCAGCAGCTTTTGGGACAGGGTAGACGAGCAGTACTTC	CASSFWDRVDEQYF	TRBV4-2	TRBJ2-7
TGTGCCAGCAGCCCCGAACAGGGTTTTCGGTCGTCCGATGGCTACACCTTC	CASSPEQGFRSSDGYTF	TRBV28	TRBJ1-2
TGTGCCAGCAGTTTTCTACCCGACGAGCAGTACTTC	CASSFLPDEQYF	TRBV27	TRBJ2-7
TGTGCCAGCAGAGAGGGTGAGACCCAGTACTTC	CASREGETQYF	TRBV6-6	TRBJ2-5
TGCGCCAGCAGGTTTGGGGACAGGGGGGGACCCTATGGCTACACCTTC	CASRFGDRGGPYGYTF	TRBV10-1	TRBJ1-2
TGTGCCAGCAGCGCGGGGGGGGACAGGGTACCCTTAAGTAGCAATCAGCCCCAGCATTTT	CASSAGGDRVPLSSNQPQHF	TRBV7-3	TRBJ1-5
TGTGCCAGCAGTTTTTGTCTCCGGGACAGGGGGCGCATTCAGGCTGGAAACACCATATATTTT	CASSFCLRDRGRIQAGNTIYF	TRBV28	TRBJ1-3
TGTGCCAGCAGTGCATTGGGACAGGGCTACACCTTC	CASSALGQGYTF	TRBV25-1	TRBJ1-2
TGCGCCAGCAGCACATCAGGAGGAAACACCATATATTTT	CASSTSGGNTIYF	TRBV5-1	TRBJ1-3
TGCAGCGTAGACTTTGGACAGGTAGCCTATGGCTACACCTTC	CSVDFGQVAYGYTF	TRBV29-1	TRBJ1-2
TGTGCCAGCAGCTTCGAGTACCTACCTTCTATCCTGTTACCCACCGACACTGAAGCTTTCTTT	CASSFEYLPSILLPTDTEAFF	TRBV5-4	TRBJ1-1
TGTGCCAGCAGACCCTTGGACAGGTCCGGGGAGCTGTTTTTT	CASRPLDRSGELFF	TRBV2	TRBJ2-2
TGTGCTAGTGGTTTGCAACCCCCTCCCGGGACAGGGGTCTCTGAAAAACTGTTTTTT	CASGLQPPPGTGVSEKLFF	TRBV12-5	TRBJ1-4
TGTGCCAGTAGGCTAGGGAGCTATGAGCAGTTCTTC	CASRLGSYEQFF	TRBV19	TRBJ2-1
TGTGCCAGCAGCGCATTAGGGCAAAACACTAATGAAAAACTGTTTTTT	CASSALGQNTNEKLFF	TRBV7-3	TRBJ1-4
TGCGCCAGCGGCAGGGGCGACACTGAAGCTTTCTTT	CASGRGDTEAFF	TRBV4-3	TRBJ1-1
TGTGCCAGCAGCACACTAGCGGCGAGGGCGTACAATGAGCAGTTCTTC	CASSTLAARAYNEQFF	TRBV5-4	TRBJ2-1
TGTGCCACCAGCAGAGATGGTTTACGGACAGGGGGGGGCACCGGGGAGCTGTTTTTT	CATSRDGLRTGGGTGELFF	TRBV15	TRBJ2-2
TGTGCCACCAGTGATCCAGGGCCCGTTGACGCCTACGAGCAGTACTTC	CATSDPGPVDAYEQYF	TRBV24-1	TRBJ2-7
TGTGCCAGCAGTCAGGGGCCAGACTTTGAGAGCACAGATACGCAGTATTTT	CASSQGPDFESTDTQYF	TRBV12-3	TRBJ2-3
TGTGCCAGCAGCTTAACGAGGTGGGGCCCCGTCCAGCCCCAGCATTTT	CASSLTRWGPVQPQHF	TRBV7-3	TRBJ1-5
TGCAGTGCTGGGGACACCTCTGGGGCCAACGTCCTGACTTTC	CSAGDTSGANVLTF	TRBV20-1	TRBJ2-6
TGTGCCAGCAGCTTATCCTTAAGGACAGGAGGTGACTATGGCTACACCTTC	CASSLSLRTGGDYGYTF	TRBV7-6	TRBJ1-2
TGTGCCAGCACTAGCGGGGGGTTCGAGCAGTACTTC	CASTSGGFEQYF	TRBV9	TRBJ2-7
TGTGCCAGCAGTGGAGGGGGGGGCATAATCAAAGAGACCCAGTACTTC	CASSGGGGIIKETQYF	TRBV12-4	TRBJ2-5
TGTGCCAGCAGCTTGGACAGGGGCCCTGGAAACACCATATATTTT	CASSLDRGPGNTIYF	TRBV5-4	TRBJ1-3
TGTGCCTTGGGGGCGGTCTCTGGGGCCAACGTCCTGACTTTC	CALGAVSGANVLTF	TRBV30	TRBJ2-6
TGTGCCAGCAGCCAAGGGTCGGGGACAGGGAGGGACTTC	CASSQGSGTGRDF	TRBV3-1	TRBJ2-7
TGTGCCACCAGTATTGGGACAGGGTGGACCTACGAGCAGTACTTC	CATSIGTGWTYEQYF	TRBV24-1	TRBJ2-7
TGTGCCAGCAGGACAGACAGGGCCCACTATGGCTACACCTTC	CASRTDRAHYGYTF	TRBV6-2	TRBJ1-2
TGCAGGGGGATAATAGTTAGTAATGAGCAGTTCTTC	CRGIIVSNEQFF	TRBV20-1	TRBJ2-1
TGTGCCAGCAGCCCATTAGTCCAGGAGGCGAACACCGGGGAGCTGTTTTTT	CASSPLVQEANTGELFF	TRBV7-9	TRBJ2-2
TGTGCCAGTAGTAGGGCAAGGACAGGGTTTGTCATGAACACTGAAGCTTTCTTT	CASSRARTGFVMNTEAFF	TRBV19	TRBJ1-1
TGTGCCAGCAGTGGCTCAAGGAGGGGGGATCAGCCCCAGCATTTT	CASSGSRRGDQPQHF	TRBV6-4	TRBJ1-5
TGTGCCAGCAGTAAGACTCCACCAGCCCCGCCCGGAGAAATCCGGGGCTACGAGCAGTACTTC	CASSKTPPAPPGEIRGYEQYF	TRBV6-4	TRBJ2-7
TGTGCCAGGAGGGTACAGCGGGGCGCGGAGACCATATATTTT	CARRVQRGAETIYF	TRBV6-2	TRBJ1-3
TGTGCCATCAGTCCCAGGGACTTCCATTCGGGCTACACCTTC	CAISPRDFHSGYTF	TRBV10-3	TRBJ1-2
TGTGCCAGCACAGGGCCAAATGACAGGTCAGCCCGACCCTCTGGAAACACCATATATTTT	CASTGPNDRSARPSGNTIYF	TRBV12-3	TRBJ1-3
TGTGCCAGCAGTCCCCCAGGGGGCCACAATCAGCCCCAGCATTTT	CASSPPGGHNQPQHF	TRBV6-5	TRBJ1-5
TGTGCCAGCACCGGGACAGGGAGGGGGTACGAGCAGTACTTC	CASTGTGRGYEQYF	TRBV13	TRBJ2-7
TGTGCCAGCAGTGACAACAAGCGGGACGGAGGAAACACCATATATTTT	CASSDNKRDGGNTIYF	TRBV6-4	TRBJ1-3
TGTGCCAGCAGCCTCGAGCAGGTCTCTGGCCAGTACTTC	CASSLEQVSGQYF	TRBV7-2	TRBJ2-5
TGCGCCAGCAGCCCGGGGGCGAGGTCTGGAAACACCATATATTTT	CASSPGARSGNTIYF	TRBV4-1	TRBJ1-3
TGTGCCAGCAGCAGGACATTGGCCCAGCATTTT	CASSRTLAQHF	TRBV13	TRBJ1-5
TGTGCCAGCACCCTAGAAAGAGCCCAGTACTTC	CASTLERAQYF	TRBV28	TRBJ2-5
TGTGCCAGCAGCTTGGACAGGGTCTCTGGGGCCAACGTCCTGACTTTC	CASSLDRVSGANVLTF	TRBV6-2	TRBJ2-6
TGTGCCAGCAGCCCCCGGGACTTGACAGCTAATGAAAAACTGTTTTTT	CASSPRDLTANEKLFF	TRBV6-1	TRBJ1-4
TGTGCCAGCAGTGTCTCAGGTAGCTCCTACAATGAGCAGTTCTTC	CASSVSGSSYNEQFF	TRBV12-3	TRBJ2-1
TGTGCCAGCAGCTTACGCGGAGAAAACGAGACCCAGTACTTC	CASSLRGENETQYF	TRBV7-2	TRBJ2-5
TGTGCCAGCAGCCTCCCGACAGGGGACTCTGGAAACACCATATATTTT	CASSLPTGDSGNTIYF	TRBV9	TRBJ1-3
TGTGCCACCAGTGGGAGCGTAGCGGGCTCAGATACGCAGTATTTT	CATSGSVAGSDTQYF	TRBV24-1	TRBJ2-3
TGCGCCAGCAGCTTGGTGATTAAACAGGGGGTGGCGCTCCATGAGACCCAGTACTTC	CASSLVIKQGVALHETQYF	TRBV5-1	TRBJ2-5
TGTGCCAGTAGTATCGTCGGACAGGGAACGAACACTGAAGCTTTCTTT	CASSIVGQGTNTEAFF	TRBV19	TRBJ1-1
TGTGCCAGCAGCGGCCCCGGACTAGCGCTCTGCTACGAGCAGTACTTC	CASSGPGLALCYEQYF	TRBV4-2	TRBJ2-7
TGTGCCAGCAGCTCCAGGGACGAGCAGTACTTC	CASSSRDEQYF	TRBV7-8	TRBJ2-7
TGCGCCAGCAGCAAAGCAGGGGGAATCCAAGCTTTCTTT	CASSKAGGIQAFF	TRBV10-2	TRBJ1-1
TGTGCCAGCAGCCCAGGGGGAGTACCTGGAAACACCATATATTTT	CASSPGGVPGNTIYF	TRBV7-3	TRBJ1-3
TGTGCCAGCAGTAGGGGGCTCTCTGGAAACACCATATATTTT	CASSRGLSGNTIYF	TRBV27	TRBJ1-3
TGTGCCAGCACGGGGGATTGCGTCAATCAGCCCCAGCATTTT	CASTGDCVNQPQHF	TRBV25-1	TRBJ1-5
TGTGCCAGCAGCCGTACGTTGACATCCCCCAATCAGCCCCAGCATTTT	CASSRTLTSPNQPQHF	TRBV11-1	TRBJ1-5
TGTGCCTGGAGTCCCGGGACAGGGCCCGAGCAGTACTTC	CAWSPGTGPEQYF	TRBV30	TRBJ2-7
TGTGCCAGCAGCTTGGGGGAGTACACTGAAGCTTTCTTT	CASSLGEYTEAFF	TRBV5-4	TRBJ1-1
TGTGCCAGCAGTGAAAAGACAGGGGAGACCCAGTACTTC	CASSEKTGETQYF	TRBV6-5	TRBJ2-5
TGCGCCAGCAGCTTGGACAGGGGGACAGGGAGCGGCTCCTACGAGCAGTACTTC	CASSLDRGTGSGSYEQYF	TRBV5-1	TRBJ2-7
TGCGCCAGCAGGACAGGTCAGCCCCAGCATTTT	CASRTGQPQHF	TRBV5-1	TRBJ1-5
TGTGCCAACGCAATGGGGACCTCTGACCAAGAGACCCAGTACTTC	CANAMGTSDQETQYF	TRBV6-5	TRBJ2-5
TGTGCCTGGAGTGGGGATGGACCTGAAGCTTTCTTT	CAWSGDGPEAFF	TRBV30	TRBJ1-1
TGTGCCAGCAGCTTAGCCCAAGGGGTCGCCAAAAACATTCAGTACTTC	CASSLAQGVAKNIQYF	TRBV7-2	TRBJ2-4
TGTGCCAGCAGCCAAATAGCGGGCAACTCCACAGATACGCAGTATTTT	CASSQIAGNSTDTQYF	TRBV7-3	TRBJ2-3
TGTGCCAGCAGCGTAACAGCGCCAGGGGGGATCCCTGAGACCCAGTACTTC	CASSVTAPGGIPETQYF	TRBV9	TRBJ2-5
TGCGCCAGCAGCCAAGATGTCCGGCTAAAACCCACTAGGACCCAGTACTTC	CASSQDVRLKPTRTQYF	TRBV4-1	TRBJ2-5
TGTGCCAGCATAGCCTCCAGGGGCTTGGGTGAAAGCTCCTATAATTCACCCCTCCACTTT	CASIASRGLGESSYNSPLHF	TRBV6-5	TRBJ1-6
TGTGCCAGCAGCGCCCCCCTAGGAAGAGAGACCCAGTACTTC	CASSAPLGRETQYF	TRBV9	TRBJ2-5
TGTGCCAGCAGCTTAGACTCTCCGGGACAGGGCGGGAATGAAAAACTGTTTTTT	CASSLDSPGQGGNEKLFF	TRBV7-9	TRBJ1-4
TGTGCCAGCAACAGGTCGCAGGGTCGGGAAGCTTTCTTT	CASNRSQGREAFF	TRBV12-4	TRBJ1-1
TGTGCCAGCAGTTTTGGGGAAAACCGCACAGATACGCAGTATTTT	CASSFGENRTDTQYF	TRBV27	TRBJ2-3
TGTGCCAGCTACTGTTCAGGGAGGACTGAAGCTTTCTTT	CASYCSGRTEAFF	TRBV7-9	TRBJ1-1
TGTGCCAGCAGTTACACCCCCTCCGGGGGCAACACTGAAGCTTTCTTT	CASSYTPSGGNTEAFF	TRBV6-6	TRBJ1-1
TGTGCCAGCAGCTGCCGGGGGGTTGGGTCCTACAATGAGCAGTTCTTC	CASSCRGVGSYNEQFF	TRBV5-6	TRBJ2-1
TGTGCCAGCACATGGGACAGAATTTACCAAGAGACCCAGTACTTC	CASTWDRIYQETQYF	TRBV6-1	TRBJ2-5
TGTGCCAGCAGCTTGGGTATCAGGGACAGGGGAGCTTTCTTT	CASSLGIRDRGAFF	TRBV5-6	TRBJ1-1
TGCGCCAGCAGCCAAGAGAGACAGGGCTCGGACACTGAAGCTTTCTTT	CASSQERQGSDTEAFF	TRBV4-1	TRBJ1-1
TGTGCCAGCAGCGACAGTCAGCCCCAGCATTTT	CASSDSQPQHF	TRBV7-9	TRBJ1-5
TGTGCCAGCAGCCTTGGGACCGGGGTTTCATTTGATGAGCAGTTCTTC	CASSLGTGVSFDEQFF	TRBV3-1	TRBJ2-1
TGTGCCAGCAGGAGAGGAACCTACGAGCAGTACTTC	CASRRGTYEQYF	TRBV6-5	TRBJ2-7
TGTGCCAGCAGCAGGCGCAAAGAGCAGTTCTTC	CASSRRKEQFF	TRBV7-9	TRBJ2-1
TGTGCCAGCAGCGGACCCGGGACAGGGGTTCCACGAAAGAGCAATCAGCCCCAGCATTTT	CASSGPGTGVPRKSNQPQHF	TRBV5-6	TRBJ1-5
TGTGCCAGCAGCTACCCCAATAGCGGGTCTAGCCAAGAGACCCAGTACTTC	CASSYPNSGSSQETQYF	TRBV11-3	TRBJ2-5
TGTGCCAGCGGAGCCATCAGGCTGCGAAATGAGCAGTTCTTC	CASGAIRLRNEQFF	TRBV7-3	TRBJ2-1
TGTGCCACCAGCAGAGATCGCAGGTGCCCGGGCCGCTACAATGAGCAGTTCTTC	CATSRDRRCPGRYNEQFF	TRBV15	TRBJ2-1
TGTGCCAGCAGCCCGACGCACCCGGGGGTTGGCAATCAGCCCCAGCATTTT	CASSPTHPGVGNQPQHF	TRBV13	TRBJ1-5
TGCGCCAGCAGCTTGGTTTGTCGGGAGGGGATTTATAATGAGCAGTTCTTC	CASSLVCREGIYNEQFF	TRBV5-1	TRBJ2-1
TGTGCCAGCAGTTTCTGGCTTCGGCCTGGCGGGGAGCTGTTTTTT	CASSFWLRPGGELFF	TRBV12-3	TRBJ2-2
TGTGCCAGCAGTGAAGCTACCGGGACTAGCGGGAGGGGCGGGATTTTGAACACTGAAGCTTTCTTT	CASSEATGTSGRGGILNTEAFF	TRBV6-1	TRBJ1-1
TGTGCCAGCAGCCAAGATCACACAATGGTACAAGAGACCCAGTACTTC	CASSQDHTMVQETQYF	TRBV14	TRBJ2-5
TGTGCCAGTAGTAACACGAAACGGAGATATGGCTACACCTTC	CASSNTKRRYGYTF	TRBV19	TRBJ1-2
TGTGCCAGTAGTATTTGCGCTAGCGGGCAGCTAGCCAAAAACATTCAGTACTTC	CASSICASGQLAKNIQYF	TRBV19	TRBJ2-4
TGTGCCAGCAGCTTGGGGACAGGGAGAAATAATTCACCCCTCCACTTT	CASSLGTGRNNSPLHF	TRBV5-5	TRBJ1-6
TGTGCCTGGAGTGTCACCGGGCGAGGGAGCACAGATACGCAGTATTTT	CAWSVTGRGSTDTQYF	TRBV30	TRBJ2-3
TGTGCCAGCTCACACACGACAGGGGGCGAACCACAGCCCCAGCATTTT	CASSHTTGGEPQPQHF	TRBV18	TRBJ1-5
TGTGCCAGCAGAAGTTTTCTGGGACATTCACCCCTCCACTTT	CASRSFLGHSPLHF	TRBV6-5	TRBJ1-6
TGTGCCAGCAGTGAATTACTCGGGCGGGACAACAATGAGCAGTTCTTC	CASSELLGRDNNEQFF	TRBV25-1	TRBJ2-1
TGTGCCAGCAGACAAGTACTAGCGTGGTGTGCCAATGAGCAGTTCTTC	CASRQVLAWCANEQFF	TRBV6-2	TRBJ2-1
TGTGCCAGCAGCTTGTGGGGGGGGGATAAACCGGACCAAGAGACCCAGTACTTC	CASSLWGGDKPDQETQYF	TRBV5-5	TRBJ2-5
TGTGCCAGCAGCGCAGGGATCCCCGAGCAGTACTTC	CASSAGIPEQYF	TRBV7-3	TRBJ2-7
TGTGCCAGCCCCCGGGACAGGGACTTTACCGACAAAAACATTCAGTACTTC	CASPRDRDFTDKNIQYF	TRBV2	TRBJ2-4
TGCAGTGCGGGCAGACAGGAAAAACTGTTTTTT	CSAGRQEKLFF	TRBV20-1	TRBJ1-4
TGTGCCAGCAGCTGCCGACCCGGGACAGACACTGAAGCTTTCTTT	CASSCRPGTDTEAFF	TRBV5-5	TRBJ1-1
TGCGCCAGCAGTGCGCCGGGGGGGGGGTCCTGGTCCTACGAGCAGTACTTC	CASSAPGGGSWSYEQYF	TRBV10-1	TRBJ2-7
TGTGCCACCAGTGACCGTAGGATCGCGGAAAGTGACTACAATGAGCAGTTCTTC	CATSDRRIAESDYNEQFF	TRBV24-1	TRBJ2-1
TGTGCCGAGGATGCCGCAAGACAGGAGACCCAGTACTTC	CAEDAARQETQYF	TRBV9	TRBJ2-5
TGTGCCAGCAGCTCCCCCACGGGACAGGGCCGACCGGAAAATGAAAAACTGTTTTTT	CASSSPTGQGRPENEKLFF	TRBV5-5	TRBJ1-4
TGCAGTGCTTCTCCTTTGGGGGAGGACACCGGGGAGCTGTTTTTT	CSASPLGEDTGELFF	TRBV20-1	TRBJ2-2
TGTGCCAGCAGCGACAGGGAGGGGTTAAACACCATATATTTT	CASSDREGLNTIYF	TRBV13	TRBJ1-3
TGCGCCAGCAGTATAACCCAGGGTTATCAGCCCCAGCATTTT	CASSITQGYQPQHF	TRBV5-1	TRBJ1-5
TGTGCCAGCGGGTACGCGGGGTCCCTCCACTTT	CASGYAGSLHF	TRBV4-2	TRBJ1-6
TGTGCCAGCAGCTTAGTGGACAGCTACGAGCAGTACTTC	CASSLVDSYEQYF	TRBV7-9	TRBJ2-7
TGTGCCAGCAGAAGGACAGGGCCGCTGTTTTTT	CASRRTGPLFF	TRBV27	TRBJ2-2
TGTGCCAGCAGCCCAAGGGACAGGGGGGGTAATGAAAAACTGTTTTTT	CASSPRDRGGNEKLFF	TRBV3-1	TRBJ1-4
TGTGCCAGCAGTTTAGTGGGACCATGGGAATTGAACACTGAAGCTTTCTTT	CASSLVGPWELNTEAFF	TRBV28	TRBJ1-1
TGTGCCAGCAACAACTCTGAAAAACTGTTTTTT	CASNNSEKLFF	TRBV11-1	TRBJ1-4
TGTGCTAGTAACGGACAGGGACTGGTCACGAGCAATCAGCCCCAGCATTTT	CASNGQGLVTSNQPQHF	TRBV12-5	TRBJ1-5
TGTGCCAGCAGTCCCCGGGGACAGTTGTCACCCCTCCACTTT	CASSPRGQLSPLHF	TRBV14	TRBJ1-6
TGTGCCAGCAGAGTGCGGGGGGGGGCCACGAGCGACTCCTACAATGAGCAGTTCTTC	CASRVRGGATSDSYNEQFF	TRBV6-5	TRBJ2-1
TGCAGTGCGAGCTCCAGGGTTAGGAGAAGGGATGAGCAGTTCTTC	CSASSRVRRRDEQFF	TRBV20-1	TRBJ2-1
TGTGCCAGCAGTTACATTAGCCCTAGCACAGATACGCAGTATTTT	CASSYISPSTDTQYF	TRBV6-3	TRBJ2-3
TGTGCCAGCAAAAGTCGGGGGGGGGGGGAAAACATTCAGTACTTC	CASKSRGGGENIQYF	TRBV27	TRBJ2-4
TGTGCCTGGTATTCGGTGGTTGTGGGAAGAGGCTACGAGCAGTACTTC	CAWYSVVVGRGYEQYF	TRBV30	TRBJ2-7
TGTGCCAGCACGGTACTGGCCGGGGAGCTGTTTTTT	CASTVLAGELFF	TRBV9	TRBJ2-2
TGTGCCAGCAGCCGGAACCGGGTAACCCGCACTGAAGCTTTCTTT	CASSRNRVTRTEAFF	TRBV3-1	TRBJ1-1
TGTGCCAGCGGAGGAAACACCGGGGAGCTGTTTTTT	CASGGNTGELFF	TRBV5-8	TRBJ2-2
TGTGCCAGCAGCCGTCGGGGCGGAGATACGCAGTATTTT	CASSRRGGDTQYF	TRBV5-6	TRBJ2-3
TGTGCCAGCACCCCTCATGGGACAGGGGAGGGGCCAACTAATGAAAAACTGTTTTTT	CASTPHGTGEGPTNEKLFF	TRBV27	TRBJ1-4
TGTGCCTGTCCTGGTTCACAGGGGTGCTGTGATAGCAATCAGCCCCAGCATTTT	CACPGSQGCCDSNQPQHF	TRBV30	TRBJ1-5
TGTGCCAGCAGCTTCCGGGGACAGGGGGCTAGCAATCAGCCCCAGCATTTT	CASSFRGQGASNQPQHF	TRBV5-6	TRBJ1-5
TGTGCCAGCAGCTGGCCGAGGGAAGGTGGCCAGGACACCGGGGAGCTGTTTTTT	CASSWPREGGQDTGELFF	TRBV7-6	TRBJ2-2
TGTGCCAGCCGCAACTGGACCCATGAGCAGTTCTTC	CASRNWTHEQFF	TRBV2	TRBJ2-1
TGCGCCAGCAGTGAGCGCGCCGACCGGGGGAGATCTGATGAGCAGTTCTTC	CASSERADRGRSDEQFF	TRBV10-1	TRBJ2-1
TGTGCCAGCAGCGCTTGTCTGCAGGGCGGGAGGGTACATGGCTACACCTTC	CASSACLQGGRVHGYTF	TRBV13	TRBJ1-2
TGCAGTGCTAGAGTGGAAAGGGGGATGGGCACAGATACGCAGTATTTT	CSARVERGMGTDTQYF	TRBV20-1	TRBJ2-3
TGCAGTGGGGTTGCAACTAGCGGGAGTCAGTACTTC	CSGVATSGSQYF	TRBV20-1	TRBJ2-7
TGCGCCATGCGTTGTGGGTGGGGGACAGGGGGCTCCTACGAGCAGTACTTC	CAMRCGWGTGGSYEQYF	TRBV5-1	TRBJ2-7
TGTGCCAGCAGTCAGGGACAGCAGATCCGTAGCAATCAGCCCCAGCATTTT	CASSQGQQIRSNQPQHF	TRBV6-1	TRBJ1-5
TGTGCCAGCAGCAGTCCACTAGCGGCGGTCGGGTGCACAGATACGCAGTATTTT	CASSSPLAAVGCTDTQYF	TRBV13	TRBJ2-3
TGCGCCAGCAGTGAGCTCCCAGGGGGGAGCACAGATACGCAGTATTTT	CASSELPGGSTDTQYF	TRBV10-1	TRBJ2-3
TGCAGTGCTAGAGGCAACAGGGGCTACACCTTC	CSARGNRGYTF	TRBV20-1	TRBJ1-2
TGTGCCACCAGTGAGGACAGGGGTGAGTCCTACGAGCAGTACTTC	CATSEDRGESYEQYF	TRBV24-1	TRBJ2-7
TGTGCCAGCAGCTTGGCTTGGACGGACAATGAGCAGTTCTTC	CASSLAWTDNEQFF	TRBV5-6	TRBJ2-1
TGTGCCAGCATAGTGTTAGCGGTTGAGCGGGAGGCTCCCACCAACTATGGCTACACCTTC	CASIVLAVEREAPTNYGYTF	TRBV7-2	TRBJ1-2
TGTGCCAGCAGCCAAGAGATAACCCGGGCGGTCGGTACGCAGTATTTT	CASSQEITRAVGTQYF	TRBV4-2	TRBJ2-3
TGTGCCAGCAGCCCTTCCGGAGGGGAGACCCAGTACTTC	CASSPSGGETQYF	TRBV14	TRBJ2-5
TGTGCCAGCAGGGATATTCCGGGACAGGGGACCTACGAGCAGTACTTC	CASRDIPGQGTYEQYF	TRBV6-6	TRBJ2-7
TGTGCCACCAGTGATTGGCGACAGGGTGACTACGAGCAGTACTTC	CATSDWRQGDYEQYF	TRBV24-1	TRBJ2-7
TGCAGTGCTAGAGATAAAGGACCGAATGAAAAACTGTTTTTT	CSARDKGPNEKLFF	TRBV20-1	TRBJ1-4
TGCAGCGTTGGGGGGCCTTGCAATCAGCCCCAGCATTTT	CSVGGPCNQPQHF	TRBV29-1	TRBJ1-5
TGTGCCAGCAGCCCAGGGTCCTATAATTCACCCCTCCACTTT	CASSPGSYNSPLHF	TRBV7-7	TRBJ1-6
TGTGCCACCAGTACCAACGGAGGGGTCTGCTACGAGCAGTACTTC	CATSTNGGVCYEQYF	TRBV24-1	TRBJ2-7
TGTGCCAGCAGCCAGCCAATTAAGCGGGCATTGAACACCGGGGAGCTGTTTTTT	CASSQPIKRALNTGELFF	TRBV3-1	TRBJ2-2
TGTGCCAGCCAGCTAACCGGGGGAGGACGAGGCGCCGGGGAGCTGTTTTTT	CASQLTGGGRGAGELFF	TRBV7-3	TRBJ2-2
TGCAGTGCTAGAGGGCGGGGAGATCAGCCCCAGCATTTT	CSARGRGDQPQHF	TRBV20-1	TRBJ1-5
TGCAGTGCTCCCCTTGCAGGGGACAGGGGGTTCTACGAGCAGTACTTC	CSAPLAGDRGFYEQYF	TRBV20-1	TRBJ2-7
TGTGCCAGCAGCCCCGGCGTACCTGCTCAACATCAGCCCCAGCATTTT	CASSPGVPAQHQPQHF	TRBV11-2	TRBJ1-5
TGTGCCAGCAGTGAACCCCGAAAAATGGACCTGGGGTCGAACACTGAAGCTTTCTTT	CASSEPRKMDLGSNTEAFF	TRBV6-1	TRBJ1-1
TGTGCCAGCCGGGGGTCCTACGAGCAGTACTTC	CASRGSYEQYF	TRBV27	TRBJ2-7
TGTGCCAGCAGCTTAGCGGGACAGTACACCTTC	CASSLAGQYTF	TRBV5-6	TRBJ1-2
TGTGCCTGGAGTGTACGGTTAGCGGGCACCGGGGAGCTGTTTTTT	CAWSVRLAGTGELFF	TRBV30	TRBJ2-2
TGCAGTGCTAGACTGACTAGGGAGGAGGAGAGCACAGATACGCAGTATTTT	CSARLTREEESTDTQYF	TRBV20-1	TRBJ2-3
TGTGCCAGCAGTGTGACAGGGGGAAACACTGAAGCTTTCTTT	CASSVTGGNTEAFF	TRBV27	TRBJ1-1
TGTGCCAGCAGTGTCGGGACAGAAGAGACCCAGTACTTC	CASSVGTEETQYF	TRBV6-1	TRBJ2-5
TGTGCCACCAGTGGGTCCCCTGGAATTTCCTCCTACGAGCAGTACTTC	CATSGSPGISSYEQYF	TRBV24-1	TRBJ2-7
TGTGCCAGCAGTAAAGAGCTGGGCGAACTGAACACTGAAGCTTTCTTT	CASSKELGELNTEAFF	TRBV6-5	TRBJ1-1
TGTGCCACCAGCATTCAGGGGCGCGTCTCCTACGAGCAGTACTTC	CATSIQGRVSYEQYF	TRBV15	TRBJ2-7
TGTGCCAGCAGACGAGGGGGCGCTGAAGCTTTCTTT	CASRRGGAEAFF	TRBV12-3	TRBJ1-1
TGTGCCACCAGCGGGTGGGACTCTCACACTGAAGCTTTCTTT	CATSGWDSHTEAFF	TRBV15	TRBJ1-1
TGTGCCAGCAGTTACGAGGATAGGTTTAGAGAACCAAGTGGGAACACTGAAGCTTTCTTT	CASSYEDRFREPSGNTEAFF	TRBV6-8	TRBJ1-1
TGCGCCAGCAGCTTGGCCGTGACAGGCTACGAGCAGTACTTC	CASSLAVTGYEQYF	TRBV5-1	TRBJ2-7
TGTGCCAGCAGCTTGGGGGCCCTCCCCGGACAGGGAAATGGCTACACCTTC	CASSLGALPGQGNGYTF	TRBV5-5	TRBJ1-2
TGTGCCAGCAGCTTAGATACGACAGGGAGAGCGAGGCTAAATGAAAAACTGTTTTTT	CASSLDTTGRARLNEKLFF	TRBV13	TRBJ1-4
TGTGCCAGCAGTTACTCGGGGCCGGGGCATGACAATCAGCCCCAGCATTTT	CASSYSGPGHDNQPQHF	TRBV6-5	TRBJ1-5
TGCAGTGCCCCAGACAGGTCTAACACCGGGGAGCTGTTTTTT	CSAPDRSNTGELFF	TRBV20-1	TRBJ2-2
TGCAGTGCTAGAGAACCCGGAGGTCCTAAAGAAAACATTCAGTACTTC	CSAREPGGPKENIQYF	TRBV20-1	TRBJ2-4
TGTGCCAGCAGCTTAGTCTCATTAGCAAGCCCCATGGGGCTTAATTCCTACGAGCAGTACTTC	CASSLVSLASPMGLNSYEQYF	TRBV11-2	TRBJ2-7
TGTGCCTGGAGTCTCCCAGGGGAGGTCTCTGGAAACACCATATATTTT	CAWSLPGEVSGNTIYF	TRBV30	TRBJ1-3
TGTGCCACCAGTCTTAACCGACTTCACCCTACGGCTTTCTTT	CATSLNRLHPTAFF	TRBV24-1	TRBJ1-1
TGTGCCAGCAGCCAAGCGGATTGGGGGTATTTT	CASSQADWGYF	TRBV3-1	TRBJ2-3
TGTGCCAGCAGCCAAGACCCTGGGAGACACGGCGAGCAGTACTTC	CASSQDPGRHGEQYF	TRBV14	TRBJ2-7
TGTGCCAGCAGTTTATCCCTCTTGATTCTTGACTATGGCTACACCTTC	CASSLSLLILDYGYTF	TRBV27	TRBJ1-2
TGCGCCAGCAGCCAAGCTTCCTGGTCCACAGAGTCCTATGGCTACACCTTC	CASSQASWSTESYGYTF	TRBV4-1	TRBJ1-2
TGCGCCAGCAGTGCAGAGGGCACCGGGGAGCTGTTTTTT	CASSAEGTGELFF	TRBV10-2	TRBJ2-2
TGTGCCAGCAGTGAGAGGTCGGGACAGGACACAGATACGCAGTATTTT	CASSERSGQDTDTQYF	TRBV6-4	TRBJ2-3
TGTGCCAGCAGCGTAGAGAGACTAGCGGGGCAGTTCTTC	CASSVERLAGQFF	TRBV9	TRBJ2-1
TGTGCCACCGCCGGCTACGACAATGAGCAGTTCTTC	CATAGYDNEQFF	TRBV24-1	TRBJ2-1
TGTGCCAGCAGTTACGGGACAGGGGACCCCCATCAGCCCCAGCATTTT	CASSYGTGDPHQPQHF	TRBV6-5	TRBJ1-5
TGTGCCAGCAGCCCCCGCAGGGGGCCTGGGGCCAACGTCCTGACTTTC	CASSPRRGPGANVLTF	TRBV7-2	TRBJ2-6
TGTGCCAGCAGTTTAAGGCCTTGGACAGCTTTCTTT	CASSLRPWTAFF	TRBV28	TRBJ1-1
TGTGCCAGCAGTTACTCTGACTCAAGGGACCTCCGAGGCTACACCTTC	CASSYSDSRDLRGYTF	TRBV6-3	TRBJ1-2
TGCGCCAGCAGCTTACCTGGACAGCCAGCCTACTATGGCTACACCTTC	CASSLPGQPAYYGYTF	TRBV5-1	TRBJ1-2
TGTGCCAGTCAGGTAACTGCAACTAATGAAAAACTGTTTTTT	CASQVTATNEKLFF	TRBV19	TRBJ1-4
TGTGCCAGCTCACATCTAGCGGGCCACGAGCAGTACTTC	CASSHLAGHEQYF	TRBV18	TRBJ2-7
TGTGCCAGCAGTGGGAAACCGGCCCAACGGCGGGGTGTTAGGTATAGCAATCAGCCCCAGCATTTT	CASSGKPAQRRGVRYSNQPQHF	TRBV6-1	TRBJ1-5
TGTGCCAGCGGACTAACCCAGTACTTC	CASGLTQYF	TRBV6-1	TRBJ2-5
TGTGCCAGCAGTTTAGCGGCATCCTATCCACTAGCGGGGCCCGCCTACAATGAGCAGTTCTTC	CASSLAASYPLAGPAYNEQFF	TRBV28	TRBJ2-1
TGTGCCAGCAGCGTAGCCTCGGGACACGGAAGGTCGCGCTCCTACAATGAGCAGTTCTTC	CASSVASGHGRSRSYNEQFF	TRBV9	TRBJ2-1
TGCGCCAGCAGCCGACCGGACAGGGGAAACAGGAACACTGAAGCTTTCTTT	CASSRPDRGNRNTEAFF	TRBV4-3	TRBJ1-1
TGCAGTGCCGGGCTGGTGGGTTACAATGAGCAGTTCTTC	CSAGLVGYNEQFF	TRBV20-1	TRBJ2-1
TGCAGTGCCGGGACAGGGAACAGCAATCAGCCCCAGCATTTT	CSAGTGNSNQPQHF	TRBV20-1	TRBJ1-5
TGTGCCAGCAGCCAAGATAACGAGATAGCGGGCGTTAACGAGACCCAGTACTTC	CASSQDNEIAGVNETQYF	TRBV14	TRBJ2-5
TGTGCCAGCAGCTTAGTCCGGGACAGGGGCATGGAGGACAATCAGCCCCAGCATTTT	CASSLVRDRGMEDNQPQHF	TRBV7-9	TRBJ1-5
TGTGCCAGCAGCCCGGGACTAGCGGGCAACGGCTCCTACGAGCAGTACTTC	CASSPGLAGNGSYEQYF	TRBV4-2	TRBJ2-7
TGTGCCACCAGTGAAGGGACTGAGACCCAGTACTTC	CATSEGTETQYF	TRBV24-1	TRBJ2-5
TGTGCCAGCAAGCGGGGGAACCATAGCAATCAGCCCCAGCATTTT	CASKRGNHSNQPQHF	TRBV6-1	TRBJ1-5
TGTGCCAGCAGCCTCCGCGGGACCCCTTACGAGCAGTACTTC	CASSLRGTPYEQYF	TRBV13	TRBJ2-7
TGTGCTAGTGGTTTGGTACAGCTCGTGGGATTCTCCTACGAGCAGTACTTC	CASGLVQLVGFSYEQYF	TRBV12-5	TRBJ2-7
TGTGCCAGCAGCCACCCGGGACAGGGGGTACTGGACAATGAGCAGTTCTTC	CASSHPGQGVLDNEQFF	TRBV6-4	TRBJ2-1
TGTGCCAGCAGTTCTGACAGCGAGCAGTACTTC	CASSSDSEQYF	TRBV28	TRBJ2-7
TGTGCCAGCAGCTCCGTCTACCCACCTAAGTTGACGACAGGGTCACCCCTCCACTTT	CASSSVYPPKLTTGSPLHF	TRBV9	TRBJ1-6
TGTGCTAGTGGCCCCACTAGCGGGGAGCAGTACTTC	CASGPTSGEQYF	TRBV12-5	TRBJ2-7
TGTGCCAGCTCGGGGGCTCTCTACGAGCAGTACTTC	CASSGALYEQYF	TRBV5-6	TRBJ2-7
TGTGCCACCAGTTGGCTGCACTGGAACACTGAAGCTTTCTTT	CATSWLHWNTEAFF	TRBV24-1	TRBJ1-1
TGCGCCAGCAGCCCGAGGGCAGGGGGAAACACCATATATTTT	CASSPRAGGNTIYF	TRBV4-1	TRBJ1-3
TGTGCCAGCAGCTTCGGGGGCCTCTTT	CASSFGGLF	TRBV7-2	TRBJ1-1
TGCGCCAGCAGCAGGACAGGGGGCCTGGAATCACCCCTCCACTTT	CASSRTGGLESPLHF	TRBV5-1	TRBJ1-6
TGTGCCAGCAGCCGACCCGAGGTATCCACTGAAGCTTTCTTT	CASSRPEVSTEAFF	TRBV4-2	TRBJ1-1
TGTGCCAGCAGCAGGGCCCGAGAGACCCAGTACTTC	CASSRARETQYF	TRBV7-6	TRBJ2-5
TGTGCCAGCAGCCCGTCCCCCGGGACAGGGGTAAAGAGTTGTCCTGAAGCTTTCTTT	CASSPSPGTGVKSCPEAFF	TRBV9	TRBJ1-1
TGTGCCAGCGGGGGGCCCCTGGGAGGGGGTGGAAACACCATATATTTT	CASGGPLGGGGNTIYF	TRBV27	TRBJ1-3
TGTGCCAGCAGCTACCGGGCAAGGTATGGCTACACCTTC	CASSYRARYGYTF	TRBV5-6	TRBJ1-2
TGCGCCAGCAGCCAGGGAGGGACAGGGCTGTTGGAGACCCAGTACTTC	CASSQGGTGLLETQYF	TRBV4-1	TRBJ2-5
TGTGCCAGCAGTGGTAAACCGACAGGCAACTGCTATGGCTACACCTTC	CASSGKPTGNCYGYTF	TRBV6-1	TRBJ1-2
TGCGCCAGCACCCAAGAAGGGTACTTC	CASTQEGYF	TRBV10-1	TRBJ2-7
TGTGCCAGCAAACGGGGGTACCAAGAGACCCAGTACTTC	CASKRGYQETQYF	TRBV6-4	TRBJ2-5
TGCAGTGCTAGAGCCCCAAAAAGGACTAGCGTCGAGAGACATTCCTACGAGCAGTACTTC	CSARAPKRTSVERHSYEQYF	TRBV20-1	TRBJ2-7
TGTGCCAGCAACCGGGGGCGCTTAGACACTGAAGCTTTCTTT	CASNRGRLDTEAFF	TRBV6-4	TRBJ1-1
TGTGCCAGCAGTTTATATAAGAGGGGACCCCCCCAAACCAGGGCAAGGAACACTGAAGCTTTCTTT	CASSLYKRGPPQTRARNTEAFF	TRBV27	TRBJ1-1
TGCGCCAGCAGCTGTCTACCCTACGAGCAGTACTTC	CASSCLPYEQYF	TRBV5-1	TRBJ2-7
TGTGCCATCAGCCACCTAGCGGGGGGGGCCAATGAGCAGTTCTTC	CAISHLAGGANEQFF	TRBV10-3	TRBJ2-1
TGTGCCGAGGGACAAGAAACTGAGACCGGGGAGCTGTTTTTT	CAEGQETETGELFF	TRBV6-4	TRBJ2-2
TGCGCCAGCAGTGGGTCGGATAGAGGACAGGCGTGTGAAAAACTGTTTTTT	CASSGSDRGQACEKLFF	TRBV10-1	TRBJ1-4
TGCGCCAGCAACCCCACCGCACGGGGGGGGGGGAACGAGCAGTACTTC	CASNPTARGGGNEQYF	TRBV5-1	TRBJ2-7
TGTGCCAGCAGTAACCCCCCCCAGGGGTCCTACGAGCAGTACTTC	CASSNPPQGSYEQYF	TRBV6-1	TRBJ2-7
TGTGCCAGCAGTGGCATTCGGTATCAGGGCGGTCAGCCCCAGCATTTT	CASSGIRYQGGQPQHF	TRBV2	TRBJ1-5
TGTGCCAGCAGTGAAGCGACAGGAGAGGGTAAGCAGTACTTC	CASSEATGEGKQYF	TRBV2	TRBJ2-7
TGCGCCAGCCCCAACCTCTCCAGTCCAAACTACGAGCAGTACTTC	CASPNLSSPNYEQYF	TRBV10-2	TRBJ2-7
TGTGCCAGCAGCCGTCAGAGACAGAATCTTAATGAAAAACTGTTTTTT	CASSRQRQNLNEKLFF	TRBV13	TRBJ1-4
TGTGCCAGTCATGGAGGGAGATGCTGCTCTGGAAACACCATATATTTT	CASHGGRCCSGNTIYF	TRBV6-6	TRBJ1-3
TGTGCCTGTTTACTAGACCACACAGATACGCAGTATTTT	CACLLDHTDTQYF	TRBV30	TRBJ2-3
TGTGCCAGCAGTGGGCCGGGACTGTCGAGGAGCTACACCGGGGAGCTGTTTTTT	CASSGPGLSRSYTGELFF	TRBV6-4	TRBJ2-2
TGTGCCAGCAGCATGGCAGGGAAACTGGAAGCTTTCTTT	CASSMAGKLEAFF	TRBV5-4	TRBJ1-1
TGTGCCAGCCGGGACAGGGGGGCTTGCAATCAGCCCCAGCATTTT	CASRDRGACNQPQHF	TRBV12-4	TRBJ1-5
TGTGCCAGCAGCGCGGTTGGGGGAGTGAACACTGAAGCTTTCTTT	CASSAVGGVNTEAFF	TRBV9	TRBJ1-1
TGTGCCACCCGGCCCTCGGGACAGACCATCTATGAGCAGTTCTTC	CATRPSGQTIYEQFF	TRBV15	TRBJ2-1
TGTGCCAGCAGCTTAGTGGGCCGCGGGAGGGGCGACGAGCAGTACTTC	CASSLVGRGRGDEQYF	TRBV7-2	TRBJ2-7
TGTGCCAGCAGAAACTCTAGGTATACCTGGAACACCTTC	CASRNSRYTWNTF	TRBV27	TRBJ1-2
TGTGCCAGCAGCGTAGGACGAGGGACAGGGGGAAACACTGAAGCTTTCTTT	CASSVGRGTGGNTEAFF	TRBV9	TRBJ1-1
TGTGCCAGCAGCACAGGATACAGGGACTTGTGTTCCTGGCTAACCGGGGAGCTGTTTTTT	CASSTGYRDLCSWLTGELFF	TRBV6-5	TRBJ2-2
TGTGCGCTCCAGACAGGGGGCGACCTCCACACTGAAGCTTTCTTT	CALQTGGDLHTEAFF	TRBV7-3	TRBJ1-1
TGTGCCAGCAGCATGACAACCGGGACTAGCGGGCGCCTAGCCAAAAACATTCAGTACTTC	CASSMTTGTSGRLAKNIQYF	TRBV5-6	TRBJ2-4
TGTGCGTCCGCAATCAGGGGGCCTAGTGGCTACGAGCAGTACTTC	CASAIRGPSGYEQYF	TRBV24-1	TRBJ2-7
TGCAGTGCTAGAGATCTCTCAGTTAACGAGCAGTACTTC	CSARDLSVNEQYF	TRBV20-1	TRBJ2-7
TGTGCTAGTGGTTTGGGGGGCGCAAAGGGCATTCAGTACTTC	CASGLGGAKGIQYF	TRBV12-5	TRBJ2-4
TGTGCCAGCAGCCCGGGGCAAGAGACCCAGTACTTC	CASSPGQETQYF	TRBV13	TRBJ2-5
TGTGCCACCAGCAGTAGGACAGGGGGGGCCAACGTCCTGACTTTC	CATSSRTGGANVLTF	TRBV15	TRBJ2-6
TGCAGTGCTAGAGCCACAGGGAGCTTCACTGAAGCTTTCTTT	CSARATGSFTEAFF	TRBV20-1	TRBJ1-1
TGTGCCAGCAGTTGGGGGGGGCGTTTCTCCTACGAGCAGTACTTC	CASSWGGRFSYEQYF	TRBV27	TRBJ2-7
TGTGCCACCGCGGAGCCCAGCAATCAGCCCCAGCATTTT	CATAEPSNQPQHF	TRBV24-1	TRBJ1-5
TGTGCCAGCAGCCTGCCCGGGACTAGTTTCCTAAATGAGCAGTTCTTC	CASSLPGTSFLNEQFF	TRBV9	TRBJ2-1
TGTGCCAGCAGTAAGACAGGGAGCAATCAGCCCCAGCATTTT	CASSKTGSNQPQHF	TRBV6-1	TRBJ1-5
TGTGCCAGCACAGGCAATCAGCCCCAGCATTTT	CASTGNQPQHF	TRBV25-1	TRBJ1-5
TGTGCCACCACGGGTGGACAGGGGTTCTATGGCTACACCTTC	CATTGGQGFYGYTF	TRBV24-1	TRBJ1-2
TGTGCCAGCAGTTACTCCAGCGGGGGTCCCTATAATTCACCCCTCCACTTT	CASSYSSGGPYNSPLHF	TRBV6-5	TRBJ1-6
TGTGCCAGCGACCGGGGCCAGTGGGTTAGGTTTAGCAATCAGCCCCAGCATTTT	CASDRGQWVRFSNQPQHF	TRBV28	TRBJ1-5
TGTGCCAGCAGCTTAGGACAGATGAACACTGAAGCTTTCTTT	CASSLGQMNTEAFF	TRBV7-3	TRBJ1-1
TGTGCCAGCAGGCCAGGGGGGGAGAACTATGGCTACACCTTC	CASRPGGENYGYTF	TRBV2	TRBJ1-2
TGTGCCAGCAGCGCAGGACAGGGGGGCTACGAGCAGTACTTC	CASSAGQGGYEQYF	TRBV13	TRBJ2-7
TGTGCCAGCAGCCCTCCGGGGACCGGGGAGCTGTTTTTT	CASSPPGTGELFF	TRBV6-5	TRBJ2-2
TGCAGTGCTAGCCGGACAGGGAATACCCCCGGGGGAACAGATACGCAGTATTTT	CSASRTGNTPGGTDTQYF	TRBV20-1	TRBJ2-3
TGTGCCAGCTCACCACCGGACAGGGGGCCTGGGGCCAACGTCCTGACTTTC	CASSPPDRGPGANVLTF	TRBV18	TRBJ2-6
TGTGCCAGCCCTACAGATAGCAATCAGCCCCAGCATTTT	CASPTDSNQPQHF	TRBV6-1	TRBJ1-5
TGCAGTGCTAGGGGAACTACACAGGGGTGCGGTAATGAAAAACTGTTTTTT	CSARGTTQGCGNEKLFF	TRBV20-1	TRBJ1-4
TGTGCCAGCCGCCAGGGGGGCAATCAGCCCCAGCATTTT	CASRQGGNQPQHF	TRBV28	TRBJ1-5
TGCGCCAGCAGCAATACCAAGGGTGGACTAGCTGGGAACACCGGGGAGCTGTTTTTT	CASSNTKGGLAGNTGELFF	TRBV10-2	TRBJ2-2
TGTGCCACCAGGGGGGGGTTACAAAACACCGGGGAGCTGTTTTTT	CATRGGLQNTGELFF	TRBV24-1	TRBJ2-2
TGTGCCAGCAGCGCGGGACAGCAAACCTACGAGCAGTACTTC	CASSAGQQTYEQYF	TRBV28	TRBJ2-7
TGCAGTGCTAGTAAGGGCGAGCAGTACTTC	CSASKGEQYF	TRBV20-1	TRBJ2-7
TGCGCCAGCAGTGAGGAAGACACCTCTGGAAACACCATATATTTT	CASSEEDTSGNTIYF	TRBV10-1	TRBJ1-3
TGTGCCAGCAGTAGATTAGCGGGCTTGTGGTCCTACGAGCAGTACTTC	CASSRLAGLWSYEQYF	TRBV6-4	TRBJ2-7
TGTGCCAGCAGCTTCCTAAAGAGCCCGGGACAGGGGAACTCTGGAAACACCATATATTTT	CASSFLKSPGQGNSGNTIYF	TRBV11-1	TRBJ1-3
TGTGCCAGCCCTAGGACAGGTAGGGTGAATCAAGAGACCCAGTACTTC	CASPRTGRVNQETQYF	TRBV28	TRBJ2-5
TGTGCTAGTGGTGGTCCAAGGCGGGGAAACACCGGGGAGCTGTTTTTT	CASGGPRRGNTGELFF	TRBV12-5	TRBJ2-2
TGTGCCAGCAGTTACCGCCGGACTGAAGCTTTCTTT	CASSYRRTEAFF	TRBV6-5	TRBJ1-1
TGTGCCAGCAGCTTACTCAGCGGCCCGAACACCGGGGAGCTGTTTTTT	CASSLLSGPNTGELFF	TRBV7-9	TRBJ2-2
TGTGCCAGCAAGAGAAAAACCTACAATGAGCAGTTCTTC	CASKRKTYNEQFF	TRBV12-4	TRBJ2-1
TGTGCCAGCAGCCGGCTGCTCCTAAGAGCTAACTATGGCTACACCTTC	CASSRLLLRANYGYTF	TRBV7-4	TRBJ1-2
TGTGCCAGCAGTTACCTCGGGCAGGGATTGGTGTATGGCGAGCAGTACTTC	CASSYLGQGLVYGEQYF	TRBV6-9	TRBJ2-7
TGTGCCAGCAGTTACTATTCCCGAGCGGGAACCGGGGAGCTGTTTTTT	CASSYYSRAGTGELFF	TRBV6-5	TRBJ2-2
TGTGCCAGCAGTTTAAGGGGGGAGGCCTATGGCTACACCTTC	CASSLRGEAYGYTF	TRBV28	TRBJ1-2
TGTGCCAGCAGCTTGCAGGGGGGACTACGGCAGTATTTT	CASSLQGGLRQYF	TRBV5-6	TRBJ2-3
TGCAGTAGACAGGGCCAAAGAGGCGCCAAAAACATTCAGTACTTC	CSRQGQRGAKNIQYF	TRBV20-1	TRBJ2-4
TGTGCCAGTAGTATCAGGGGGCCCTACGAGCAGTACTTC	CASSIRGPYEQYF	TRBV19	TRBJ2-7
TGTGCCAGTACATCAGGGTTCAGCAGCAATCAGCCCCAGCATTTT	CASTSGFSSNQPQHF	TRBV19	TRBJ1-5
TGCAGTTCAAAATTTTCCCACAGGGCTAACAATGAGCAGTTCTTC	CSSKFSHRANNEQFF	TRBV20-1	TRBJ2-1
TGTGCCAGCATTCTCCAACCTAAGAAAAACCACACCGGGGAGCTGTTTTTT	CASILQPKKNHTGELFF	TRBV6-5	TRBJ2-2
TGCAGTGCTAGAAATCCGGCCCCGCGGGGGAATGAAAAACTGTTTTTT	CSARNPAPRGNEKLFF	TRBV20-1	TRBJ1-4
TGTGCCAGCAGTGAGGGGTTCGACCAGTACAATGAGCAGTTCTTC	CASSEGFDQYNEQFF	TRBV6-5	TRBJ2-1
TGCGCCAGCAGCCAAGGAAGTCTGGTGGATGGGACTAGCGGGACATTGGGGCAAGAGACCCAGTACTTC	CASSQGSLVDGTSGTLGQETQYF	TRBV4-1	TRBJ2-5
TGTGCCAGCAGCCAAGGGACTAGCGGGAGTGGTGCAACTAATGAAAAACTGTTTTTT	CASSQGTSGSGATNEKLFF	TRBV4-2	TRBJ1-4
TGTGCCTGGAGCCAAGACAGTAAGGGTGCCACAGATACGCAGTATTTT	CAWSQDSKGATDTQYF	TRBV30	TRBJ2-3
TGCAGTGCGGCAGGGAAGCAAGGGAGCACAGATACGCAGTATTTT	CSAAGKQGSTDTQYF	TRBV20-1	TRBJ2-3
TGTGCCAGCAGCCCACCCTTGAATGAGCAGTTCTTC	CASSPPLNEQFF	TRBV7-8	TRBJ2-1
TGTGCCAGCAGTTACCCCCCTAGTCGACCAGCGGGATTGGGCTACGAGCAGTACTTC	CASSYPPSRPAGLGYEQYF	TRBV6-5	TRBJ2-7
TGTGCCAGCAGGTACTTTGACGCGACAGTGCCCCAGCATTTT	CASRYFDATVPQHF	TRBV6-2	TRBJ1-5
TGTGCCTCACTAGGTAGCCAAGAGACCCAGTACTTC	CASLGSQETQYF	TRBV6-1	TRBJ2-5
TGCAGTGCTAGGACAGGGGACTACGAGCAGTACTTC	CSARTGDYEQYF	TRBV20-1	TRBJ2-7
TGCAGCGTTGACCGAAAGGGAGGTCACACCATATATTTT	CSVDRKGGHTIYF	TRBV29-1	TRBJ1-3
TGTGCCACCAGCTCGGAGCAGCGGCTTTCCTACGAGCAGTACTTC	CATSSEQRLSYEQYF	TRBV15	TRBJ2-7
TGTGCCAGCAGTTTCCGCCAGGGCTTGAATCAGCCCCAGCATTTT	CASSFRQGLNQPQHF	TRBV27	TRBJ1-5
TGTGCCACCTCTAACTTGGGGGTGGGGGTCAATTCACCCCTCCACTTT	CATSNLGVGVNSPLHF	TRBV24-1	TRBJ1-6
TGCGCCAGCAGCCAGAGACAGGCCGGACAGGGTTATTTAACCAAGTCTAATGGCTACACCTTC	CASSQRQAGQGYLTKSNGYTF	TRBV4-1	TRBJ1-2
TGCGCCAGCAGCTTGGCTGGGGGCCCCGAAAAACTGTTTTTT	CASSLAGGPEKLFF	TRBV5-1	TRBJ1-4
TGTGCCTGGAGTGTAGGGGACAGGGTTATGAACACTGAAGCTTTCTTT	CAWSVGDRVMNTEAFF	TRBV30	TRBJ1-1
TGCAGTCGGGGGGGCCTCCGTGAAAAACTGTTTTTT	CSRGGLREKLFF	TRBV20-1	TRBJ1-4
TGTGCCAGTAGCCCACGGGCGGCCGGGACATTGTTACAGTTGGGCAATCAGCCCCAGCATTTT	CASSPRAAGTLLQLGNQPQHF	TRBV19	TRBJ1-5
TGTGCCAGCAGTTTAATGGGACAGGGGAAAAATCAGCCCCAGCATTTT	CASSLMGQGKNQPQHF	TRBV12-3	TRBJ1-5
TGCGCCAGCAGTGAGTCTGGGACAGCAGAATACGAGCAGTACTTC	CASSESGTAEYEQYF	TRBV10-1	TRBJ2-7
TGTGCCAGCAGTGACCTGGGACTACCAGGGCCCTACGAGCAGTACTTC	CASSDLGLPGPYEQYF	TRBV6-4	TRBJ2-7
TGCAGTACGACGGAGGTCAGTGAAGCTTTCTTT	CSTTEVSEAFF	TRBV29-1	TRBJ1-1
TGTGCCAGCAGCGTACCAGGGGGGAGCAATCAGCCCCAGCATTTT	CASSVPGGSNQPQHF	TRBV9	TRBJ1-5
TGTGGGACATTGTATGGCTACACCTTC	CGTLYGYTF	TRBV7-9	TRBJ1-2
TGTGCCAGCAGCCGCGGGAACCTCACTGAAGCTTTCTTT	CASSRGNLTEAFF	TRBV11-3	TRBJ1-1
TGCAGTGCTTCAGGGCAACGCACCGGGGAGCTGTTTTTT	CSASGQRTGELFF	TRBV20-1	TRBJ2-2
TGTGCCAGCAGTTACCGAAAGCGGGGCACCCCGACATACGAGCAGTACTTC	CASSYRKRGTPTYEQYF	TRBV6-5	TRBJ2-7
TGTGCCAGCCCCTACGAGCAGTACTTC	CASPYEQYF	TRBV27	TRBJ2-7
TGTGCCACCTCCGGGACTAGCGGGCCGGGCTCCTACGAGCAGTACTTC	CATSGTSGPGSYEQYF	TRBV24-1	TRBJ2-7
TGTGCCAGCAGGAAGGGGGGAAAGGACAAGAACAATGAGCAGTTCTTC	CASRKGGKDKNNEQFF	TRBV6-5	TRBJ2-1
TGCGCCAGCAGCTCTCTTTATAGCTTTCCAGCCAAAAACATTCAGTACTTC	CASSSLYSFPAKNIQYF	TRBV5-1	TRBJ2-4
TGTGCCAGCATTTTAATAACGAACACTGAAGCTTTCTTT	CASILITNTEAFF	TRBV6-4	TRBJ1-1
TGTGCCAGCAAAGGACAGGGCCTCTATGGCTACACCTTC	CASKGQGLYGYTF	TRBV9	TRBJ1-2
TGTGCCAGCAGCTTGGAAAACAGGGTGATACAGCTCTCTGGAAACACCATATATTTT	CASSLENRVIQLSGNTIYF	TRBV5-4	TRBJ1-3
TGCAGTGCCCCGTCCCGGCCGGGGGGTCCTTACAATGAGCAGTTCTTC	CSAPSRPGGPYNEQFF	TRBV20-1	TRBJ2-1
TGTGCCACCAGCCGCAGAAATCAGCCCCAGCATTTT	CATSRRNQPQHF	TRBV15	TRBJ1-5
TGTGCCAGCTCACCAATGTGGGCCTCAAAGATGAACACTGAAGCTTTCTTT	CASSPMWASKMNTEAFF	TRBV18	TRBJ1-1
TGCGCCAGCAGCTTCATTAGTAAGTCCTACGAGCAGTACTTC	CASSFISKSYEQYF	TRBV5-1	TRBJ2-7
TGTGTACAGCGGGGTAGTTACGAGCAGTACTTC	CVQRGSYEQYF	TRBV9	TRBJ2-7
TGTGCCAGCTCACGGGGATCGCTCGGTAACACCGGGGAGCTGTTTTTT	CASSRGSLGNTGELFF	TRBV18	TRBJ2-2
TGTGCCAGTAGTATAGCCCTGTCCCCAGGACAGGGGATGCACGAGCAGTACTTC	CASSIALSPGQGMHEQYF	TRBV19	TRBJ2-7
TGTGCCACCAGTACTGAGCGGGTAGATCAGCCCCAGCATTTT	CATSTERVDQPQHF	TRBV15	TRBJ1-5
TGCGCCAGCAGCGGAACTGTCACCTTTGCTAGCACAGATACGCAGTATTTT	CASSGTVTFASTDTQYF	TRBV5-1	TRBJ2-3
TGTGCCATCAGTGAGCCACTTGGGACACAGGAGTACTTC	CAISEPLGTQEYF	TRBV10-3	TRBJ2-4
TGTGCCAGCAGCCAAGCCCTAGCGGGAGGTGAGCAGTTCTTC	CASSQALAGGEQFF	TRBV4-2	TRBJ2-1
TGCGCCAGCAGCCCAGGTGAGCAGTACTTC	CASSPGEQYF	TRBV5-1	TRBJ2-7
TGTCCCGCTCGGCTTGACGAGCAGTACTTC	CPARLDEQYF	TRBV30	TRBJ2-7
TGCGCCAGCAGCAACCGGGGGGCGGAAAACACCGGGGAGCTGTTTTTT	CASSNRGAENTGELFF	TRBV5-1	TRBJ2-2
TGTGCCAGCAGCGCACCCAGGGGGCCCTATGGCTACACCTTC	CASSAPRGPYGYTF	TRBV9	TRBJ1-2
TGTGCCAGCAGCTTACCAGGGGAGCAGCCCCAGCATTTT	CASSLPGEQPQHF	TRBV7-2	TRBJ1-5
TGTGCCAGCAGGCGGAACAGGGCGGTTCAAGATTTAGGACATGAGCAGTTCTTC	CASRRNRAVQDLGHEQFF	TRBV2	TRBJ2-1
TGTGCCACCAGTGATTTTAGAAGACAGAGGAACTACGAGCAGTACTTC	CATSDFRRQRNYEQYF	TRBV24-1	TRBJ2-7
TGTGCCAGCAGTGATCCGACTAGCGGGTCAGGCGGCACCGGGGAGCTGTTTTTT	CASSDPTSGSGGTGELFF	TRBV7-2	TRBJ2-2
TGTGCCAGCAGCATTTATCCAGGGGGGGCGGAAGCTTTCTTT	CASSIYPGGAEAFF	TRBV11-2	TRBJ1-1
TGCGCCAGCAGCTATCTGGGCGTGTATCGGGACAGTGGAACGGAGGGGAACACTGAAGCTTTCTTT	CASSYLGVYRDSGTEGNTEAFF	TRBV5-1	TRBJ1-1
TGTGCCAGCAGCGTGGACCGGACTAGCCCGGAGGCAGATACGCAGTATTTT	CASSVDRTSPEADTQYF	TRBV13	TRBJ2-3
TGTGCCACCACCCGCATTGGGACAGGGCTCTACAATGAGCAGTTCTTC	CATTRIGTGLYNEQFF	TRBV24-1	TRBJ2-1
TGTGCCAGCAGCTTCCGGACCGAACAGCCGGATACAGATACGCAGTATTTT	CASSFRTEQPDTDTQYF	TRBV11-3	TRBJ2-3
TGTGCCATCAGTGTCCCCGAGGAAAATAACTATGGCTACACCTTC	CAISVPEENNYGYTF	TRBV10-3	TRBJ1-2
TGCAGTGCGGGAGGGAGGGCAAATTTCGGCACAGATACGCAGTATTTT	CSAGGRANFGTDTQYF	TRBV20-1	TRBJ2-3
TGTGCCAGCAGCCCGGGCAATCAGCCCCAGCATTTT	CASSPGNQPQHF	TRBV13	TRBJ1-5
TGTGCCAGCAGGCTTGAGGGTATTCCTCCGAATTCACCCCTCCACTTT	CASRLEGIPPNSPLHF	TRBV6-2	TRBJ1-6
TGTGCCAGCAGCTTTCCGGGACAGGTACCTTACACCTTC	CASSFPGQVPYTF	TRBV7-9	TRBJ1-2
TGTGCCAGCAGCTGCCTCCCTTCTGGGGGTGAGACCCAGTACTTC	CASSCLPSGGETQYF	TRBV13	TRBJ2-5
TGTGCCAGCAGCCAGCACACCTACGAGCAGTACTTC	CASSQHTYEQYF	TRBV14	TRBJ2-7
TGTGCCAGCAGCTTTCACCCGACCAGACAGGCTCTTTACAATGAGCAGTTCTTC	CASSFHPTRQALYNEQFF	TRBV13	TRBJ2-1
TGCAGTGCTAGTCCTAAGGGTGGGAACACCGGGGAGCTGTTTTTT	CSASPKGGNTGELFF	TRBV20-1	TRBJ2-2
TGCGCCAGCAGCTTGGGCGAGACAGGCTCGGACTTGAACACTGAAGCTTTCTTT	CASSLGETGSDLNTEAFF	TRBV5-1	TRBJ1-1
TGTGCCAGCTCACCGATCTCTATAGTCAACGCCAATCAGCCCCAGCATTTT	CASSPISIVNANQPQHF	TRBV18	TRBJ1-5
TGTGCCAGCAGTTTATTGGGACCCGAGGATGCCTACAATGAGCAGTTCTTC	CASSLLGPEDAYNEQFF	TRBV28	TRBJ2-1
TGTGCCAGCAGCCGGGGGGCAAACAATGAGCAGTTCTTC	CASSRGANNEQFF	TRBV7-9	TRBJ2-1
TGTGCCAGCAGCTACCCCCCGCGGGAGCGTGACTACGAGCAGTACTTC	CASSYPPRERDYEQYF	TRBV5-4	TRBJ2-7
TGTGCCAGCAGTTACGTGGGACAGGGGGCAGGAGGTATGGATGGCACTTCACCCCTCCACTTT	CASSYVGQGAGGMDGTSPLHF	TRBV27	TRBJ1-6
TGCAGTCACCTAGCGCGAGAATTTACCGGGGAGCTGTTTTTT	CSHLAREFTGELFF	TRBV20-1	TRBJ2-2
TGTGCCAGCAGCGTTAGAAGGGACTATGGCTACACCTTC	CASSVRRDYGYTF	TRBV11-3	TRBJ1-2
TGTGCTAGCAGTGCCGGTAATAAGCACTCTGACTGGAGCTCCTACGAGCAGTACTTC	CASSAGNKHSDWSSYEQYF	TRBV7-7	TRBJ2-7
TGTGCCAGCAGTTTAAACAGGGCCGATACAGAGACCCAGTACTTC	CASSLNRADTETQYF	TRBV6-1	TRBJ2-5
TGTGCCAGCAGTGACTCGAACCAGGGGGCGCCCCAGCATTTT	CASSDSNQGAPQHF	TRBV6-4	TRBJ1-5
TGCAGTGCTAGAGATAATGGGACTAGGGAGCAGTTCTTC	CSARDNGTREQFF	TRBV20-1	TRBJ2-1
TGTGCCAGCAGATCACTGAATGAGCAGTTCTTC	CASRSLNEQFF	TRBV6-6	TRBJ2-1
TGTGCCAGCAGCTTAGCACAGGGGCTGGGCAATCAGCCCCAGCATTTT	CASSLAQGLGNQPQHF	TRBV11-3	TRBJ1-5
TGTGCCAGCAGCCCCAAGGTCGTTGGAACCTACGAGCAGTACTTC	CASSPKVVGTYEQYF	TRBV9	TRBJ2-7
TGTGCCAGCAGCGGTCCGGACCTAGATACGCAGTATTTT	CASSGPDLDTQYF	TRBV7-8	TRBJ2-3
TGTGCCAGCAGCCACGGACAGGATCTAGCCAAAAACATTCAGTACTTC	CASSHGQDLAKNIQYF	TRBV14	TRBJ2-4
TGTGCCAGTAGTATAGACCCAGCCGGGGATGAGCAGTTCTTC	CASSIDPAGDEQFF	TRBV19	TRBJ2-1
TGTGCCAGCAGCTTTACCGACAGGGAATGCAATCAAGAGACCCAGTACTTC	CASSFTDRECNQETQYF	TRBV7-6	TRBJ2-5
TGTGCCAGCCACCCCGGGGATAGCAATCAGCCCCAGCATTTT	CASHPGDSNQPQHF	TRBV9	TRBJ1-5
TGTGCCAGCAGTCCCTTGAATATAGTAGGTACCCCTCCTTGCACAGATACGCAGTATTTT	CASSPLNIVGTPPCTDTQYF	TRBV27	TRBJ2-3
TGTGCCAGCAGCTACCCGGGACTAGCTCTCCTGTACGAGCAGTACTTC	CASSYPGLALLYEQYF	TRBV13	TRBJ2-7
TGTGCCAGCAGTGATCGGGAGTGTAGACAGTACGAGCAGTACTTC	CASSDRECRQYEQYF	TRBV6-4	TRBJ2-7
TGCGCCAGCAGCCCCCAGGAGGCAGAAAAACTGTTTTTT	CASSPQEAEKLFF	TRBV5-1	TRBJ1-4
TGTGCCAGCAGGCCATTTAGGCTGGGAAACACCATATATTTT	CASRPFRLGNTIYF	TRBV5-4	TRBJ1-3
TGCAGCGTTGACTCTTCGATGGGGGGAAGGCAAGAGACCCAGTACTTC	CSVDSSMGGRQETQYF	TRBV29-1	TRBJ2-5
TGTGCCAGCAGCCAAGATAGACTAGCGGGTAACTCCTACAATGAGCAGTTCTTC	CASSQDRLAGNSYNEQFF	TRBV14	TRBJ2-1
TGCGCCAGCAGCCCGGGACAGGAGGAGACCCAGTACTTC	CASSPGQEETQYF	TRBV5-1	TRBJ2-5
TGTGCCAGCAGCGATACTAGCGGAACGGGTGAGCAGTTCTTC	CASSDTSGTGEQFF	TRBV7-2	TRBJ2-1
TGCGCCAGCAGAGTGGCCAACGGGGAGCAGTTCTTC	CASRVANGEQFF	TRBV5-1	TRBJ2-1
TGCGCCAGCAGCTTGGAGCAACAGGGGATCGGGACTGAAGCTTTCTTT	CASSLEQQGIGTEAFF	TRBV5-1	TRBJ1-1
TGCAGCGGGGACCGGGACAGGCCCCAGCATTTT	CSGDRDRPQHF	TRBV29-1	TRBJ1-5
TGTGCCAGCACTAGCGGGGGGGGGTACAATGAGCAGTTCTTC	CASTSGGGYNEQFF	TRBV25-1	TRBJ2-1
TGTGCCAGAAGAGACAGGAGATTCTACGAGCAGTACTTC	CARRDRRFYEQYF	TRBV9	TRBJ2-7
TGTGCCACCAGCAGGTACCTCGGCCGGCAGGGGGGGCAAGAGACCCAGTACTTC	CATSRYLGRQGGQETQYF	TRBV15	TRBJ2-5
TGTGCCAGCAGGGGACTAGCAGACTACGAGCAGTACTTC	CASRGLADYEQYF	TRBV12-3	TRBJ2-7
TGCGCCAGCAGCCAAGGAGGGGGCCCGGTCTTC	CASSQGGGPVF	TRBV4-1	TRBJ2-1
TGTGCCAGCAGTTTCTGTCCCAGGGCTGACGAGCAGTACTTC	CASSFCPRADEQYF	TRBV12-4	TRBJ2-7
TGTGCCAGCAGGGACCGGGGGCTTTATAATGAAAAACTGTTTTTT	CASRDRGLYNEKLFF	TRBV27	TRBJ1-4
TGTGCCAGCAGCGTACCCTCTCCAGACAGGGGGACTTCCTATGGCTACACCTTC	CASSVPSPDRGTSYGYTF	TRBV7-9	TRBJ1-2
TGTGCCAGCTGCCTTCGAAGGAGGGGCCCGGTAACCAGATACAATGAGCAGTTCTTC	CASCLRRRGPVTRYNEQFF	TRBV11-3	TRBJ2-1
TGTGCCGTCGGGACAGACCCTAACGGGGGAAACACCATATATTTT	CAVGTDPNGGNTIYF	TRBV24-1	TRBJ1-3
TGTGCCAGTAGTATAGTAGCTACAGGGCCACAAGAGACCCAGTACTTC	CASSIVATGPQETQYF	TRBV19	TRBJ2-5
TGTGCCAGCAGCTTGCTAGCGCGAACCGGGGAGCTGTTTTTT	CASSLLARTGELFF	TRBV11-2	TRBJ2-2
TGTGCCACCAGTGAACCACCTAAAAAACGGGAAACTGAAGCTTTCTTT	CATSEPPKKRETEAFF	TRBV24-1	TRBJ1-1
TGTGCCAGCAGCCAAGAGGTGACAGACCGGTGCTACAATGAGCAGTTCTTC	CASSQEVTDRCYNEQFF	TRBV3-1	TRBJ2-1
TGCGCCAGCAGCCAAGAGAGTCGTCAGGACACCATATATTTT	CASSQESRQDTIYF	TRBV4-1	TRBJ1-3
TGTGCCAGCAGTTTGATCGGGGGCGGCTACACCTTC	CASSLIGGGYTF	TRBV27	TRBJ1-2
TGCGCCAGCCGGATGCCGGGGGGCACCTACGAGCAGTACTTC	CASRMPGGTYEQYF	TRBV10-1	TRBJ2-7
TGCGCCAGCAGTGCGGGACAGATGGAGGGGATGAGTAGCTCCTACGAGCAGTACTTC	CASSAGQMEGMSSSYEQYF	TRBV5-1	TRBJ2-7
TGTGCCCCGGGACAGGGAGACACTGAAGCTTTCTTT	CAPGQGDTEAFF	TRBV24-1	TRBJ1-1
TGTGCCAGCAGCGGGCGGGTCATAAATGTTAAGGAGACCCAGTACTTC	CASSGRVINVKETQYF	TRBV7-4	TRBJ2-5
TGCGCCAGCAGTGCAGGACTAGAGAGAAGCTACGAGCAGTACTTC	CASSAGLERSYEQYF	TRBV5-1	TRBJ2-7
TGTGCCAGCAGTTACTCCGCGGGACAGGGGGAAGACACTGAAGCTTTCTTT	CASSYSAGQGEDTEAFF	TRBV6-3	TRBJ1-1
TGTGCCAATAAAAGTGGACGGGCGATAGCGGAAGATGAGCAGTTCTTC	CANKSGRAIAEDEQFF	TRBV28	TRBJ2-1
TGTGCCACCGACCCGGGGGGGGCGGAGCACTTC	CATDPGGAEHF	TRBV24-1	TRBJ2-7
TGCAGTGCTAGAGATCAACGTGGGACCCCAGGCTACGAGCAGTACTTC	CSARDQRGTPGYEQYF	TRBV20-1	TRBJ2-7
TGTGCTTTCCAGGGCGACGAGCAGTACTTC	CAFQGDEQYF	TRBV30	TRBJ2-7
TGTGCCAGCAGCTTAGGGAACTATAGCAATCAGCCCCAGCATTTT	CASSLGNYSNQPQHF	TRBV7-2	TRBJ1-5
TGTGCCAGCAGTGCGACTAGCCGGTATTCCTACAATGAGCAGTTCTTC	CASSATSRYSYNEQFF	TRBV28	TRBJ2-1
TGTGCCAGCACTAGCGGGACTCGGAGCTCCTACGAGCAGTACTTC	CASTSGTRSSYEQYF	TRBV7-3	TRBJ2-7
TGTGCCTGGAGCCCACAGGGCCGACCTAATCAGCCCCAGCATTTT	CAWSPQGRPNQPQHF	TRBV30	TRBJ1-5
TGTGCCTGGAGGGACAGAGACTCTAAGGAGACCCAGTACTTC	CAWRDRDSKETQYF	TRBV30	TRBJ2-5
TGTGCCAGCAGCGCGGGGACGTGCGACGGTACGCAGTATTTT	CASSAGTCDGTQYF	TRBV6-2	TRBJ2-3
TGCAGTGCTAGAGCCAAGGGGGTGTATTTCCCTACTGAAGCTTTCTTT	CSARAKGVYFPTEAFF	TRBV20-1	TRBJ1-1
TGTGCCAGCAGCTTGGGGGGGGGGAGCTCCTACAATGAGCAGTTCTTC	CASSLGGGSSYNEQFF	TRBV5-6	TRBJ2-1
TGTGCCAGCAGCTATTCAGGGTTCAATCAGCCCCAGCATTTT	CASSYSGFNQPQHF	TRBV7-2	TRBJ1-5
TGTGCTAGTGCTCCCAGGGGGCGATACAATGAGCAGTTCTTC	CASAPRGRYNEQFF	TRBV12-5	TRBJ2-1
TGTGCCAGCGGCGGGAGACCCGACGAGCAGTACTTC	CASGGRPDEQYF	TRBV27	TRBJ2-7
TGTGCCAGCAGCACCGGGACTATAGGCACAGATACGCAGTATTTT	CASSTGTIGTDTQYF	TRBV7-3	TRBJ2-3
TGTGCCTGGAGCCCCCGGACAGGGACACAGCCCCAGCATTTT	CAWSPRTGTQPQHF	TRBV30	TRBJ1-5
TGTGCCAGCAGCCTTTCCCGGGACAGGGTGAATCAGCCCCAGCATTTT	CASSLSRDRVNQPQHF	TRBV14	TRBJ1-5
TGTGCCTGGAGTGCCCGGACAGGTGAAGCTTTCTTT	CAWSARTGEAFF	TRBV30	TRBJ1-1
TGTGCCAGCGTGTTCTCCTATCTAGCGGGCGGGAATGGGAGCACAGATACGCAGTATTTT	CASVFSYLAGGNGSTDTQYF	TRBV25-1	TRBJ2-3
TGTGCCAGCAGCTTGCCTGCCGGGGGCCAAGAAATAGAGCAGTACTTC	CASSLPAGGQEIEQYF	TRBV5-4	TRBJ2-7
TGTGCCAGAAGGCAAGGCTACAATGAGCAGTTCTTC	CARRQGYNEQFF	TRBV27	TRBJ2-1
TGTGCCAGCAGCCCCCGACTCGGGACTGAAGCTTTCTTT	CASSPRLGTEAFF	TRBV5-6	TRBJ1-1
TGTGCCAGCAGCTACACGAGGGACAGCCAAGAGACCCAGTACTTC	CASSYTRDSQETQYF	TRBV7-3	TRBJ2-5
TGTGCCAGCAGTGAAGGTAAGGACAGGTCCGAGACCCAGTACTTC	CASSEGKDRSETQYF	TRBV6-1	TRBJ2-5
TGTGCCAGCAGGGGTCAGGGGAGTTATCAGCCCCAGCATTTT	CASRGQGSYQPQHF	TRBV6-1	TRBJ1-5
TGTGCCAGCAGTGAATCCGGACCCGAAGGGACCGACAGGGTGACGAACACCGGGGAGCTGTTTTTT	CASSESGPEGTDRVTNTGELFF	TRBV2	TRBJ2-2
TGCGCCAGCAGTCCCAGGGGACAGGGAGGCGATAGCAATCAGCCCCAGCATTTT	CASSPRGQGGDSNQPQHF	TRBV10-1	TRBJ1-5
TGTGCCAGCAGCTTAGATCGCGAGACCCAGTACTTC	CASSLDRETQYF	TRBV11-3	TRBJ2-5
TGCGCCAGCAGCCAAGTTTCGGACAGGGGGAGGGAGAAGTGGGGCTCCTACGAGCAGTACTTC	CASSQVSDRGREKWGSYEQYF	TRBV4-3	TRBJ2-7
TGTGCCACCAGCAGAGGCGCTAGGGGGCCAAATCAGCCCCAGCATTTT	CATSRGARGPNQPQHF	TRBV15	TRBJ1-5
TGCGCCAGCAGCCAGGGGTCTGTTCCAGGGGGGGGCTATGGCTACACCTTC	CASSQGSVPGGGYGYTF	TRBV4-1	TRBJ1-2
TGTGCCAGCAGCTCCCGGGCCCCGAATGAGCAGTTCTTC	CASSSRAPNEQFF	TRBV13	TRBJ2-1
TGTGCCAGCACCCCCTACAGGGGATCTTCCTATAATTCACCCCTCCACTTT	CASTPYRGSSYNSPLHF	TRBV6-2	TRBJ1-6
TGTGCCAGCAGCCCCCACGGGAGTGTTGATACGCAGTATTTT	CASSPHGSVDTQYF	TRBV5-4	TRBJ2-3
TGTGCCACGGACTTGGGGGACACCCGTTCAAACATTCAGTACTTC	CATDLGDTRSNIQYF	TRBV12-4	TRBJ2-4
TGTGCCAGCAGCTATACCAGGGGGGGGCATGCCTACGAGCAGTACTTC	CASSYTRGGHAYEQYF	TRBV7-6	TRBJ2-7
TGTGCCAGCAGTGAAGCCGCTATAGCTAGCGGGGGGGCCAGGGCGCGGTGGCTAGCCAAAAACATTCAGTACTTC	CASSEAAIASGGARARWLAKNIQYF	TRBV2	TRBJ2-4
TGTGCCATCACTCCTTCCTACAATGAGCAGTTCTTC	CAITPSYNEQFF	TRBV10-3	TRBJ2-1
TGTGCCAGCTCACCCTTGCGGGTTAGGCACGGGGTTGATACGCAGTATTTT	CASSPLRVRHGVDTQYF	TRBV18	TRBJ2-3
TGTGCCCCCGGGACTAGCGGGAGGACAGATACGCAGTATTTT	CAPGTSGRTDTQYF	TRBV30	TRBJ2-3
TGTGCCAGCAGTTACTCGAGGTGGACAGGGGCAGAATACGAGCAGTACTTC	CASSYSRWTGAEYEQYF	TRBV6-6	TRBJ2-7
TGTGCCAGCGTGACTAATGAAAAACTGTTTTTT	CASVTNEKLFF	TRBV9	TRBJ1-4
TGCGCCAGCAGCCAAGATGGTGGGGCTAATGAAAAACTGTTTTTT	CASSQDGGANEKLFF	TRBV4-1	TRBJ1-4
TGTGCCAGCAGCTATTTACCTAGCGGGACTCCCTCCTACAATGAGCAGTTCTTC	CASSYLPSGTPSYNEQFF	TRBV13	TRBJ2-1
TGTGCCAGCAGTGACTCGAAGGACTATAAGGGGGAGGGAGTCTTC	CASSDSKDYKGEGVF	TRBV6-4	TRBJ2-1
TGTGCCAGCAGCCAAGATACTCTTACCCCGGGGAACACCGGGGAGCTGTTTTTT	CASSQDTLTPGNTGELFF	TRBV4-2	TRBJ2-2
TGTGCCAGGACTAGCGGGCGTTTCAATGAGCAGTTCTTC	CARTSGRFNEQFF	TRBV18	TRBJ2-1
TGTGCCAGCAGTTTATGTAATCACGGGGGTTCCGACACCGGGGAGCTGTTTTTT	CASSLCNHGGSDTGELFF	TRBV28	TRBJ2-2
TGTGCCAGCAGCCACAGGGACTATAATTCACCCCTCCACTTT	CASSHRDYNSPLHF	TRBV5-8	TRBJ1-6
TGTGCCAGCAGCGGACAGGGGGGAACCGAGCAGTACTTC	CASSGQGGTEQYF	TRBV7-3	TRBJ2-7
TGCAGTGCTAGAGATCCCCCTGACCCCTCGTTAAGCTACGAGCAGTACTTC	CSARDPPDPSLSYEQYF	TRBV20-1	TRBJ2-7
TGCGCCAGCAGTGGGGTCCCCTCCTACGAGCAGTACTTC	CASSGVPSYEQYF	TRBV10-1	TRBJ2-7
TGTGCCAGCAGCTTAGAACGACAGGGAACTGAAGCTTTCTTT	CASSLERQGTEAFF	TRBV7-2	TRBJ1-1
TGCGCCAGCAGCCAAGAGTGTTTGGAGGATACGCAGTATTTT	CASSQECLEDTQYF	TRBV4-1	TRBJ2-3
TGCAGTGCTAAAAACCGGGGCACCCGGACGTCCTACGAGCAGTACTTC	CSAKNRGTRTSYEQYF	TRBV20-1	TRBJ2-7
TGCAGCGTTGACCCCGCGGGACTAGCCTACATAAGTACCTACGAGCAGTACTTC	CSVDPAGLAYISTYEQYF	TRBV29-1	TRBJ2-7
TGTGCCAGCAGCGAGGAAAAACTGTTTTTT	CASSEEKLFF	TRBV6-6	TRBJ1-4
TGTGCCACGCCACAGGGAGGAAACTCGAACACTGAAGCTTTCTTT	CATPQGGNSNTEAFF	TRBV10-3	TRBJ1-1
TGTGCCAGCAGCCCTCTGCCAGGGGGCGGCGGGCCGGGGGGCTTGGCAACTAATGAAAAACTGTTTTTT	CASSPLPGGGGPGGLATNEKLFF	TRBV14	TRBJ1-4
TGCGCCAGCCGGGGAAACTATGGCTACACCTTC	CASRGNYGYTF	TRBV10-1	TRBJ1-2
TGCGCCAGCAGACAGGGGGCCCAGCTTAGCTCCTATAATTCACCCCTCCACTTT	CASRQGAQLSSYNSPLHF	TRBV5-1	TRBJ1-6
TGTGCCAGCAGCACCCTTAAGGATGAAGCTTTCTTT	CASSTLKDEAFF	TRBV13	TRBJ1-1
TGTGCCAGCAGCCCCACCACAGGGGATAGGGAAGAGACCCAGTACTTC	CASSPTTGDREETQYF	TRBV13	TRBJ2-5
TGTGCCAGCAGCCAACACAGGACTAGCGGGAGGGTCAGCTCCTACGAGCAGTACTTC	CASSQHRTSGRVSSYEQYF	TRBV4-2	TRBJ2-7
TGTGCCAGCAGAGAGCAGAATTTCCTAGGGCCCTACGAGCAGTACTTC	CASREQNFLGPYEQYF	TRBV14	TRBJ2-7
TGCGCCAGCAGTCCCGGTGGTACCGGGGAGCTGTTTTTT	CASSPGGTGELFF	TRBV10-1	TRBJ2-2
TGCGCCAGTAGACAGGGGAAACAAGAGACCCAGTACTTC	CASRQGKQETQYF	TRBV5-1	TRBJ2-5
TGTGCCAGCAGCGGCCCTATTTGGACATTGATTGAAAAACTGTTTTTT	CASSGPIWTLIEKLFF	TRBV5-6	TRBJ1-4
TGTGCCAGCAGCTCTTTCGCTAGCGGAGGGGAGCTGTTTTTT	CASSSFASGGELFF	TRBV7-7	TRBJ2-2
TGTGCCAGCAGCTGTAGTCCTCTAGCCAAAAACATTCAGTACTTC	CASSCSPLAKNIQYF	TRBV11-2	TRBJ2-4
TGTGCCAGCAGAGCAGGTCAGCCCCAGCATTTT	CASRAGQPQHF	TRBV6-5	TRBJ1-5
TGTGCCAGCAGTCGGGGACAAGAGACCCAGTACTTC	CASSRGQETQYF	TRBV25-1	TRBJ2-5
TGTGCCAGCAGGGTGTCAACCCGGGACTCTTGGGCATGTTACGAGCAGTACTTC	CASRVSTRDSWACYEQYF	TRBV6-4	TRBJ2-7
TGCGCCAGCAGGGGGGGCCAAAAGTCTAATGAAAAACTGTTTTTT	CASRGGQKSNEKLFF	TRBV5-1	TRBJ1-4
TGTGCCAGCATGTGGAAAGTACGGGGACGGAGACGGAGGGAGCAGTTCTTC	CASMWKVRGRRRREQFF	TRBV7-9	TRBJ2-1
TGTGCCAGCAGACCCGGAGACAGGGGGTCAGGATCTAATCAGCCCCAGCATTTT	CASRPGDRGSGSNQPQHF	TRBV6-3	TRBJ1-5
TGTGCCAGTAGTTCCCAGGCGGGGAACACCGGGGAGCTGTTTTTT	CASSSQAGNTGELFF	TRBV19	TRBJ2-2
TGTGCCAGCAGTTTCCGGGACCTAGGACCTTTGAACACTGAAGCTTTCTTT	CASSFRDLGPLNTEAFF	TRBV6-1	TRBJ1-1
TGTGCCAGCAGTTCACAGGAGGAAAAAGAGACCCAGTACTTC	CASSSQEEKETQYF	TRBV27	TRBJ2-5
TGTGCCAGCAGCTTAGACACGACAGGGTTCGAGCAGTACTTC	CASSLDTTGFEQYF	TRBV7-9	TRBJ2-7
TGTGCCAGCAGGGGGATCCCTTCAGGGATAGGGTTTTTTTATCAGCCCCAGCATTTT	CASRGIPSGIGFFYQPQHF	TRBV2	TRBJ1-5
TGCGCCAGCAGCCAAGTGGCGAAAGGGGGGTTTCAGAACGAGCAGTACTTC	CASSQVAKGGFQNEQYF	TRBV4-3	TRBJ2-7
TGTGCCACTCAGGACAGACAGGAGTTAGGGGAATCGGGGGACACTGAAGCTTTCTTT	CATQDRQELGESGDTEAFF	TRBV27	TRBJ1-1
TGTGCCCAGCACCGGATTGGACATGCCAAAAACATTCAGTACTTC	CAQHRIGHAKNIQYF	TRBV27	TRBJ2-4
TGCGCCAGCAGTGAGGACTCAGGTGGGCCTGGAAGGAGCAATCAGCCCCAGCATTTT	CASSEDSGGPGRSNQPQHF	TRBV10-1	TRBJ1-5
TGTGCCAGCAGCTCTGAGAAGGGGGACTATAGCAATCAGCCCCAGCATTTT	CASSSEKGDYSNQPQHF	TRBV7-7	TRBJ1-5
TGCAGCGTAAAAGCGGGAGGGGGCTCCTACGAGCAGTACTTC	CSVKAGGGSYEQYF	TRBV29-1	TRBJ2-7
TGTGCAACTTACCCGCGGGAGTGGGACGAGCAGTACTTC	CATYPREWDEQYF	TRBV12-5	TRBJ2-7
TGTGCCAGCAGCTTAGACAGAGGAGCCCCAGTAGGGTCCACCGGGGAGCTGTTTTTT	CASSLDRGAPVGSTGELFF	TRBV7-4	TRBJ2-2
TGTGCCAGCAGCTTATTGGCCGCTCACCACAGGGTCTATGGCTACACCTTC	CASSLLAAHHRVYGYTF	TRBV13	TRBJ1-2
TGTGCCATGCACCCCTGGCCTTTGACGGAGAACTATGGCTACACCTTC	CAMHPWPLTENYGYTF	TRBV10-3	TRBJ1-2
TGTGCCAGCAGTTTCCGGGACAGGGTAGCCAAAAACATTCAGTACTTC	CASSFRDRVAKNIQYF	TRBV12-3	TRBJ2-4
TGTGCCAGCAGCGTTGCGGGAGGGGGCTACGAGCAGTACTTC	CASSVAGGGYEQYF	TRBV11-2	TRBJ2-7
TGTGCCAGCAGCTCCCTGACAGGCAGCGCATGCAATCAGCCCCAGCATTTT	CASSSLTGSACNQPQHF	TRBV7-2	TRBJ1-5
TGTGCCAGCAGTCCCACAGGGGGCGGGTGGTGGGAGACCCAGTACTTC	CASSPTGGGWWETQYF	TRBV27	TRBJ2-5
TGCGCCAGCAGCGGACTGTACGGGTGCACAGATACGCAGTATTTT	CASSGLYGCTDTQYF	TRBV5-1	TRBJ2-3
TGTGCCAGCAGCAGGGTAAAAGGCAATCAGCCCCAGCATTTT	CASSRVKGNQPQHF	TRBV28	TRBJ1-5
TGCGCCAGCAGCCAAGAGGGAGGGTACTTT	CASSQEGGYF	TRBV4-3	TRBJ1-1
TGCAGTGCTAGAATGTCGAGGACTAGCGGGTTCCCCTACAATGAGCAGTTCTTC	CSARMSRTSGFPYNEQFF	TRBV20-1	TRBJ2-1
TGCGCCAGCAGCCCAGAAGGACAGGGCTACCACTATGGCTACACCTTC	CASSPEGQGYHYGYTF	TRBV4-3	TRBJ1-2
TGTGCCAGCAGCGCCATACTAGCGGGAGGAGCCTCAGATACGCAGTATTTT	CASSAILAGGASDTQYF	TRBV5-8	TRBJ2-3
TGTGCCATCACAGCCCCACAGCAGGGGGGTTATTTGGAGCTGTTTTTT	CAITAPQQGGYLELFF	TRBV10-3	TRBJ2-2
TGCAGCGTTGCCTCAGGAGAAAAAGCTTTCTTT	CSVASGEKAFF	TRBV29-1	TRBJ1-1
TGTGCCAGCAGCGCGCGAGGGGCACAGGGCCCTAACACTGAAGCTTTCTTT	CASSARGAQGPNTEAFF	TRBV9	TRBJ1-1
TGCGCCAGCATCGGGATACATGCCAAAAACATTCAGTACTTC	CASIGIHAKNIQYF	TRBV5-1	TRBJ2-4
TGTGCCTGGAGTCGGCACAGACGAGGGCGCACTGAAGCTTTCTTT	CAWSRHRRGRTEAFF	TRBV30	TRBJ1-1
TGTGCCAGCGCCCTACGTACAGGCCTCCATACTGAAGCTTTCTTT	CASALRTGLHTEAFF	TRBV27	TRBJ1-1
TGTGCCAGCAGCGACTGCAGTCCAGATCGGCCCCAGCATTTT	CASSDCSPDRPQHF	TRBV7-3	TRBJ1-5
TGCAGTGCTCGTGCAACAGGGGATTCACCCCTCCACTTT	CSARATGDSPLHF	TRBV20-1	TRBJ1-6
TGTGCCATCAGTGATCAGTCCTACGAGCAGTACTTC	CAISDQSYEQYF	TRBV10-3	TRBJ2-7
TGTGCCAGCAGGACAGTAACACAGGGACAGAATCAGCCCCAGCATTTT	CASRTVTQGQNQPQHF	TRBV28	TRBJ1-5
TGCAGCCCTGGACAGGGGGCGACTGAAGCTTTCTTT	CSPGQGATEAFF	TRBV29-1	TRBJ1-1
TGTGCCAGCAGTGACCCTAACAATCAGCCCCAGCATTTT	CASSDPNNQPQHF	TRBV2	TRBJ1-5
TGCGCCAGCAGGAACACGACAGGGGGCGCGGGGGATAATGAAAAACTGTTTTTT	CASRNTTGGAGDNEKLFF	TRBV10-2	TRBJ1-4
TGTGCCAGCAGCTCTCGAAAGGACAGGGGGCTTCTGAACACTGAAGCTTTCTTT	CASSSRKDRGLLNTEAFF	TRBV7-3	TRBJ1-1
TGCAGCGCAGGGAACACCGGGGAGCTGTTTTTT	CSAGNTGELFF	TRBV29-1	TRBJ2-2
TGTGCCAGCATCCCAAGAGACCAGGGACACTGGGCTGAAGCTTTCTTT	CASIPRDQGHWAEAFF	TRBV6-1	TRBJ1-1
TGTGCCAGCCAGGGTAACATGAACACTGAAGCTTTCTTT	CASQGNMNTEAFF	TRBV6-1	TRBJ1-1
TGCCGGGCACAATCCCCTTGGCCATATCAGCCCCAGCATTTT	CRAQSPWPYQPQHF	TRBV20-1	TRBJ1-5
TGCAGTGCTAGAGCTACAGGGGGCGAGCAGTACTTC	CSARATGGEQYF	TRBV20-1	TRBJ2-7
TGCGCCAGCAGCTTGGAGCACCGGGGGATGGAAGTGCAGCCCCAGCATTTT	CASSLEHRGMEVQPQHF	TRBV5-1	TRBJ1-5
TGTGCCAGTAGTATCGGGACAGCCGGTGGCTACACCTTC	CASSIGTAGGYTF	TRBV19	TRBJ1-2
TGCAGTGCTAGCGGACAACGTTACTATGGCTACACCTTC	CSASGQRYYGYTF	TRBV20-1	TRBJ1-2
TGCGCCAGCAAACAGGGCTGGGGAACCGAAAAACTGTTTTTT	CASKQGWGTEKLFF	TRBV4-3	TRBJ1-4
TGTGCCACGTCCAGGGGTCGGATCGACGAGCAGTACTTC	CATSRGRIDEQYF	TRBV6-6	TRBJ2-7
TGTGCCAGCAGATGCTTGGAAGGGGGGGCCTTTCGCACAGATACGCAGTATTTT	CASRCLEGGAFRTDTQYF	TRBV7-3	TRBJ2-3
TGTGCCAGTAGTACCGGGACTAGCGGAAAATCAGATACGCAGTATTTT	CASSTGTSGKSDTQYF	TRBV19	TRBJ2-3
TGTGCCAGCAGTAGGCGGGGAGGAGTCTCCTACGAGCAGTACTTC	CASSRRGGVSYEQYF	TRBV7-3	TRBJ2-7
TGTGCCCACCACGGGGGAGAAAACATTCAGTACTTC	CAHHGGENIQYF	TRBV11-3	TRBJ2-4
TGTGCCAGCAGTCCCCACAGGGGATTCAACTATGGCTACACCTTC	CASSPHRGFNYGYTF	TRBV6-4	TRBJ1-2
TGTGCCAGCAGTGTACGAGTCCATAGCAATCAGCCCCAGCATTTT	CASSVRVHSNQPQHF	TRBV2	TRBJ1-5
TGTGCCAGCACGAGGTGCCGGGAGGTTAGCACAGATACGCAGTATTTT	CASTRCREVSTDTQYF	TRBV7-2	TRBJ2-3
TGTGCCAGCAGTAGGAGGACAGGGAACACCGGGGAGCTGTTTTTT	CASSRRTGNTGELFF	TRBV28	TRBJ2-2
TGTGCCAGCAGGGGGCCCGGCACTGAAGCTTTCTTT	CASRGPGTEAFF	TRBV6-5	TRBJ1-1
TGTGCCAGCAGCCCACCCCACCGGGACGTAAGGTCTGGGGCCAACGTCCTGACTTTC	CASSPPHRDVRSGANVLTF	TRBV13	TRBJ2-6
TGTGCCAGCGGACGGGACAGCGGTGGGGGAAGGCTGTTTTTT	CASGRDSGGGRLFF	TRBV6-5	TRBJ1-4
TGCAGTGCCGCAGGGGGGGATGAAAAACTGTTTTTT	CSAAGGDEKLFF	TRBV20-1	TRBJ1-4
TGCAGTGCGAGCAGGACGGACTATGGCTACACCTTC	CSASRTDYGYTF	TRBV20-1	TRBJ1-2
TGTGCCAGCAGTTACTCGATGTTTAGGGACAGAGAGAGGAGAGAGACCCAGTACTTC	CASSYSMFRDRERRETQYF	TRBV6-5	TRBJ2-5
TGTGCCACGGGCGGTGCAGATACGCAGTATTTT	CATGGADTQYF	TRBV24-1	TRBJ2-3
TGTGCCAGCAGCACCTTGACCAGCACTGAAGCTTTCTTT	CASSTLTSTEAFF	TRBV14	TRBJ1-1
TGCAGTGCTAGAGGTTCCGGGACAGGGAGGAACACTGAAGCTTTCTTT	CSARGSGTGRNTEAFF	TRBV20-1	TRBJ1-1
TGTGCCAGCAGGGGGGGCGCCTTC	CASRGGAF	TRBV6-5	TRBJ1-2
TGTGCCAGCAGCAGAAGGGGGCCCCTGAATGAGCAGTTCTTC	CASSRRGPLNEQFF	TRBV13	TRBJ2-1
TGTGCCAGCAGCTTCATTAGCGGGAAAGTCACCGGGGAGCTGTTTTTT	CASSFISGKVTGELFF	TRBV9	TRBJ2-2
TGTGCCAGCAGCTTCCCCAAGGTAATCGCAGGGAACTACGAGCAGTACTTC	CASSFPKVIAGNYEQYF	TRBV7-6	TRBJ2-7
TGTGCCAGCAGCAGACCCCTTTCCAGGATCCACACTGAAGCTTTCTTT	CASSRPLSRIHTEAFF	TRBV7-9	TRBJ1-1
TGTGCCACCGAAAATCGGACTAGCGACTACGAGCAGTACTTC	CATENRTSDYEQYF	TRBV24-1	TRBJ2-7
TGTGCCAGCAGTTTTCGGAGAGACAGGGGGGCTGCTTTCTTT	CASSFRRDRGAAFF	TRBV28	TRBJ1-1
TGTGCCAGCAACAGGACGGTCACAGATACGCAGTATTTT	CASNRTVTDTQYF	TRBV11-2	TRBJ2-3
TGTGCCAGGCACCACGGCATAGACGGGAAGAACACCGGGGAGCTGTTTTTT	CARHHGIDGKNTGELFF	TRBV10-3	TRBJ2-2
TGTGCCAGCAGCCTCAAAGAAGGGCTAGGGACAGAGCCCCAGCATTTT	CASSLKEGLGTEPQHF	TRBV14	TRBJ1-5
TGCGCCAGCAGCACTCAGGGGGACTATGGCTACACCTTC	CASSTQGDYGYTF	TRBV5-1	TRBJ1-2
TGCAGTGCTAGAGACGGGCAAGGGACCAGGACATCCTATAATTCACCCCTCCACTTT	CSARDGQGTRTSYNSPLHF	TRBV20-1	TRBJ1-6
TGCAGTGCTAGAAAGGACTCCCAGGGTCCGGCCTACGAGCAGTACTTC	CSARKDSQGPAYEQYF	TRBV20-1	TRBJ2-7
TGCAGTGCTAGAGATGTACAGGGGCCCCGGGGTACTGAAGCTTTCTTT	CSARDVQGPRGTEAFF	TRBV20-1	TRBJ1-1
TGTGCCAGCAGGCTGCCGGGACAGGGTGGGCCGGACCGGACTTTCTCCTACGAGCAGTACTTC	CASRLPGQGGPDRTFSYEQYF	TRBV7-6	TRBJ2-7
TGCGCCAGCAGCCCAGCCTGCGGGAGCAGGACTGAAGCTTTCTTT	CASSPACGSRTEAFF	TRBV5-1	TRBJ1-1
TGTGCCAGCAGCCCCTTCTCTAGCGCCTACAATGAGCAGTTCTTC	CASSPFSSAYNEQFF	TRBV7-9	TRBJ2-1
TGTGCCAGCAGCCAGGGTTGGGACGGCTACGAGCAGTACTTC	CASSQGWDGYEQYF	TRBV5-6	TRBJ2-7
TGTGCCAGCAGCCAAGAGTTAGAAATCTGCCCCCCCCCGACTAGCGGGGATTCTGAGACCCAGTACTTC	CASSQELEICPPPTSGDSETQYF	TRBV14	TRBJ2-5
TGTGCCAGCAGCTTAACCAAAGGAGGGACAGGGCTCCGGGATGGCTACACCTTC	CASSLTKGGTGLRDGYTF	TRBV11-1	TRBJ1-2
TGCGCCAGCAGTTCCCCATTCGTTCTAGACAGCGATGAAAAACTGTTTTTT	CASSSPFVLDSDEKLFF	TRBV5-1	TRBJ1-4
TGTGCCAGCAGCAGAGATAATACAGTTCTTCGTAGGGAGCAGTACTTC	CASSRDNTVLRREQYF	TRBV9	TRBJ2-7
TGCGCCAAACGAACCCCTAGAAGGAGTGAGCAGTTCTTC	CAKRTPRRSEQFF	TRBV4-3	TRBJ2-1
TGTGCCAGCAGCTCCCACTCTAGCGGGACGCTTGAGCAGTTCTTC	CASSSHSSGTLEQFF	TRBV7-9	TRBJ2-1
TGTGCCAGCAGTAGGGTACAGGGTAGGTACGAGCAGTACTTC	CASSRVQGRYEQYF	TRBV6-5	TRBJ2-7
TGCAATTTTGCCGGACTAGACACCGGGGAGCTGTTTTTT	CNFAGLDTGELFF	TRBV20-1	TRBJ2-2
TGTGCCAGCAGTTACCCGGATTACAGGGCTGAAGCTTTCTTT	CASSYPDYRAEAFF	TRBV6-3	TRBJ1-1
TGTGCCAGCAGCGGGGACAGGCCATGCTATGTGAACACTGAAGCTTTCTTT	CASSGDRPCYVNTEAFF	TRBV9	TRBJ1-1
TGTGCCAGCAGTGAATACCCCGTAGGGGGACTAGCGGGGGGGCCGACAGATACGCAGTATTTT	CASSEYPVGGLAGGPTDTQYF	TRBV6-1	TRBJ2-3
TGTGCCAGCTCCTCAGGGACAGGGGGAGCCATTCTTTATTCCCAGCATTTT	CASSSGTGGAILYSQHF	TRBV18	TRBJ1-5
TGTGCCAGCAGCTTAGATCCACAGGGGACGTATGAGCAGTTCTTC	CASSLDPQGTYEQFF	TRBV7-3	TRBJ2-1
TGTGCCAGCAGCTTAGATGGGGGGGGGCTCCCAGATACGCAGTATTTT	CASSLDGGGLPDTQYF	TRBV11-2	TRBJ2-3
TGTGCCAGCAGCATTAGACAGCCAGCGGAGACCCAGTACTTC	CASSIRQPAETQYF	TRBV5-6	TRBJ2-5
TGTGCCAGCAGTGATCGAACCTTTGAGCAGTTCTTC	CASSDRTFEQFF	TRBV6-4	TRBJ2-1
TGTGCCAGAAAACCAGCCGGGACAGGGAGTGATAGCAATCAGCCCCAGCATTTT	CARKPAGTGSDSNQPQHF	TRBV11-3	TRBJ1-5
TGTGCCAGGGATAACCCGGGACAGGGGTGTTACGAGCAGTACTTC	CARDNPGQGCYEQYF	TRBV7-2	TRBJ2-7
TGCAGTGCTAGTAATGCTGTTTCACCCCTCCACTTT	CSASNAVSPLHF	TRBV20-1	TRBJ1-6
TGTGCCAGCACCCTAGCGGGATTGATCCCGGTGGCGCAGTACTTC	CASTLAGLIPVAQYF	TRBV6-1	TRBJ2-7
TGTGCCAGCAGTCTAAGGACAGATAATTCACCCCTCCACTTT	CASSLRTDNSPLHF	TRBV28	TRBJ1-6
TGTGCCAGCACCGGAGACAACGAGCAGTACTTC	CASTGDNEQYF	TRBV6-4	TRBJ2-7
TGTGCCAGCAGCTACCCAATGACTAGCGGGCTCGAGCAGTACTTC	CASSYPMTSGLEQYF	TRBV5-6	TRBJ2-7
TGCGCCAGCACCGCCGGGACAAAGGGGGCAACTAATGAAAAACTGTTTTTT	CASTAGTKGATNEKLFF	TRBV10-2	TRBJ1-4
TGTGCCAGCAGCCTTCAGGGGGCCCCCGAGGCTGAAGCTTTCTTT	CASSLQGAPEAEAFF	TRBV11-3	TRBJ1-1
TGTGCCAGCAGTTACAGTCTTATTTCTACAGGGTACACTGAAGCTTTCTTT	CASSYSLISTGYTEAFF	TRBV6-5	TRBJ1-1
TGTGCCAGCAGCTCACCCACAGGGGGGAACTATGGCTACACCTTC	CASSSPTGGNYGYTF	TRBV13	TRBJ1-2
TGCGCCAGCAGCCAGATTTGCCGGACTAGCGGGGGCTACGAGCAGTACTTC	CASSQICRTSGGYEQYF	TRBV4-1	TRBJ2-7
TGTGCCAGCAGTTGGGGACCGGGACAGGTCTCACCCCTCCACTTT	CASSWGPGQVSPLHF	TRBV6-6	TRBJ1-6
TGTGCCAGCAGTTTGCTGGACCTTTATAATTCACCCCTCCACTTT	CASSLLDLYNSPLHF	TRBV12-3	TRBJ1-6
TGTGCCAGCAGCTTTTCTGATGTAATAAGCAATCAGCCCCAGCATTTT	CASSFSDVISNQPQHF	TRBV7-2	TRBJ1-5
TGTGCCAGCAGTTTACTAGCGGGTCTCACAGATACGCAGTATTTT	CASSLLAGLTDTQYF	TRBV27	TRBJ2-3
TGTGCCAGCATGAATATCCTCGATGAGCAGTTCTTC	CASMNILDEQFF	TRBV7-3	TRBJ2-1
TGTGCCAGCAGCAGCCAGGGGGCAGAGCGCAATCAGCCCCAGCATTTT	CASSSQGAERNQPQHF	TRBV13	TRBJ1-5
TGTGCCAGCATGGCTGTGTCCTACGAGCAGTACTTC	CASMAVSYEQYF	TRBV6-3	TRBJ2-7
TGTGCCAGCAGCGAGGCTCCGGGACAGGGAAGAAACTATGGCTACACCTTC	CASSEAPGQGRNYGYTF	TRBV9	TRBJ1-2
TGTGCCAGCAGTTTCTTCTGGGACATGGGGAATCAGCCCCAGCATTTT	CASSFFWDMGNQPQHF	TRBV28	TRBJ1-5
TGTGCCAGCAGTATATCCCAGGATGACAGGGCCGGGGAGCTGTTTTTT	CASSISQDDRAGELFF	TRBV6-5	TRBJ2-2
TGTGCCAGCAGCACGAAGTGGACAGGGGGCTGTGAGCCCCAGCATTTT	CASSTKWTGGCEPQHF	TRBV7-6	TRBJ1-5
TGTGCCAGCAGGGTACGTGGACTAGTGACAATCCGAGACGAGCAGTACTTC	CASRVRGLVTIRDEQYF	TRBV11-3	TRBJ2-7
TGTGCCAGCAGTTTTTGCGGGAGACCCAGCTCTGGAAACACCATATATTTT	CASSFCGRPSSGNTIYF	TRBV28	TRBJ1-3
TGTGCCAGTAGTCCACGGGACTCGACAAACGAGCAGTACTTC	CASSPRDSTNEQYF	TRBV19	TRBJ2-7
TGCAGCGTTCCGTGCGGTTTCCCTGGCTACACCTTC	CSVPCGFPGYTF	TRBV29-1	TRBJ1-2
TGTGCCAGCAGTTACTTTAGTAAATCTTATTACAATGAGCAGTTCTTC	CASSYFSKSYYNEQFF	TRBV6-6	TRBJ2-1
TGTGCCAGCAGTCTAACAGGGGGCGCTATCGGTGAAAAACTGTTTTTT	CASSLTGGAIGEKLFF	TRBV6-6	TRBJ1-4
TGTGCCAGCAGTTTATTTGGGGCCTCCTACGAGCAGTACTTC	CASSLFGASYEQYF	TRBV12-3	TRBJ2-7
TGTGCCAGCAGCTTATATTCAGATACGCAGTATTTT	CASSLYSDTQYF	TRBV7-9	TRBJ2-3
TGCGCCAGCAGCCAAGATAGGGGGATAGGAGCCAGTGGGGATCAGCCCCAGCATTTT	CASSQDRGIGASGDQPQHF	TRBV4-1	TRBJ1-5
TGTGCCACCAGTGAGAACCTAGCGGGTCCCGAGCAGTACTTC	CATSENLAGPEQYF	TRBV24-1	TRBJ2-7
TGTGCCAGCAGCCTACTAGCGGGAGAGACCCAGTACTTC	CASSLLAGETQYF	TRBV9	TRBJ2-5
TGTGCCACCAGTGCAAGCCTCATATCGCTGGACTACGAGCAGTACTTC	CATSASLISLDYEQYF	TRBV24-1	TRBJ2-7
TGTGCCAGTAGAACTGAGGGACAAAAGGATGAAGCTTTCTTT	CASRTEGQKDEAFF	TRBV19	TRBJ1-1
TGCAGCGTTGAAGATTGGGGAGCCGTAGGAAGGGGAAGGGGATTGAGCTCCTACAATGAGCAGTTCTTC	CSVEDWGAVGRGRGLSSYNEQFF	TRBV29-1	TRBJ2-1
TGTGCCAGCAGTGCCACCAAGGGTAGCAATCAGCCCCAGCATTTT	CASSATKGSNQPQHF	TRBV6-4	TRBJ1-5
TGCGCCAGCAGCCAAGGCGGGATCTACGAGCAGTACTTC	CASSQGGIYEQYF	TRBV4-1	TRBJ2-7
TGCGCCAGCAGCTTGAAAATCCTCACTAGCGGGAGGGCGGTCCCCTTGAACACTGAAGCTTTCTTT	CASSLKILTSGRAVPLNTEAFF	TRBV5-1	TRBJ1-1
TGTGCCAGCAGTTATTCCCTACGAGCGGATTGCTACGAGCAGTACTTC	CASSYSLRADCYEQYF	TRBV6-9	TRBJ2-7
TGTGCCAGCAGTACAGGGGCTTTCTTT	CASSTGAFF	TRBV13	TRBJ1-1
TGTGCCAGCAGTGATAGGGACAGTTCTGACGAGCAGTACTTC	CASSDRDSSDEQYF	TRBV6-4	TRBJ2-7
TGTGCCAGCTCTCGGACAGATGCCTACGAGCAGTACTTC	CASSRTDAYEQYF	TRBV18	TRBJ2-7
TGTGCCAGCAGCCCCGGGGGAGGGAAACTGTTTTTT	CASSPGGGKLFF	TRBV11-3	TRBJ1-4
TGTGCCAGCAGCGGCCGTGAGGGGGGGACTGAAGCTTTCTTT	CASSGREGGTEAFF	TRBV7-3	TRBJ1-1
TGTGCCAGCAGCTGCGTAGAGGAGAGGGGGAGTGCCAAAAACATTCAGTACTTC	CASSCVEERGSAKNIQYF	TRBV5-6	TRBJ2-4
TGTGCCAGCAGCATCCCGTCGTCTAGCGGGGCCGCCAAAAACATTCAGTACTTC	CASSIPSSSGAAKNIQYF	TRBV13	TRBJ2-4
TGTGCCAGCAGCTTAGCGGGGACGGCCGAGCAGTACTTC	CASSLAGTAEQYF	TRBV7-2	TRBJ2-7
TGTGCCAGCAGCTTGGGCACCCGCGGACAGGGGGGGGCGGGCTACACCTTC	CASSLGTRGQGGAGYTF	TRBV5-6	TRBJ1-2
TGCAGTGCTAGCCCTGGCCTGTTACGGGGGCTTAAAGAGCAGTACTTC	CSASPGLLRGLKEQYF	TRBV20-1	TRBJ2-7
TGCGCCAGCATTATCCGATTTAGACATAGAGCGGCCTACGAGCAGTACTTC	CASIIRFRHRAAYEQYF	TRBV10-1	TRBJ2-7
TGTGCCAGCAGTGCTGCCCACGCCGCGGGACTAGCGGGGGGGGCAGAGACCCAGTACTTC	CASSAAHAAGLAGGAETQYF	TRBV6-4	TRBJ2-5
TGCGCCAGCAGAGGACTAGCCAGTTTAGAGGGGAGTAGCACAGATACGCAGTATTTT	CASRGLASLEGSSTDTQYF	TRBV4-1	TRBJ2-3
TGCGCCAGCGGACAGGGGGACACTGAAGCTTTCTTT	CASGQGDTEAFF	TRBV10-1	TRBJ1-1
TGCAGTGCTAGAGAACATGGGGAAAGAGCGTTGCACTACGAGCAGTACTTC	CSAREHGERALHYEQYF	TRBV20-1	TRBJ2-7
TGTGCCAGCAGCTACAAGGGACAGGGGAATCCAGAAGGGCTGAACACTGAAGCTTTCTTT	CASSYKGQGNPEGLNTEAFF	TRBV7-9	TRBJ1-1
TGCAGTGCTAGAGATCTGCTGCGGGGGGCCCAGTACTTC	CSARDLLRGAQYF	TRBV20-1	TRBJ2-5
TGCAGTGCTCACAGGGGGGATCAGCCCCAGCATTTT	CSAHRGDQPQHF	TRBV20-1	TRBJ1-5
TGCAGTGCTAGAAAGCCCGACCAAGAGACCCAGTACTTC	CSARKPDQETQYF	TRBV20-1	TRBJ2-5
TGTGCCAGTAGTATAGAGGGAGCGGGACTCCCCTATGAGCAGTTCTTC	CASSIEGAGLPYEQFF	TRBV19	TRBJ2-1
TGTGCCACCCCCACCACTACTAGTGTACGAGTGAGCTCCTACAATGAGCAGTTCTTC	CATPTTTSVRVSSYNEQFF	TRBV7-9	TRBJ2-1
TGCAGTGCTAGAGCAGATCCCCGGGGTCGCTACGAGCAGTACTTC	CSARADPRGRYEQYF	TRBV20-1	TRBJ2-7
TGTGCCAGCAGACAGGGGGGGCCGACCGGGGCCTACAATGAGCAGTTCTTC	CASRQGGPTGAYNEQFF	TRBV9	TRBJ2-1
TGCAGCGTTGAAGATACGACGGACAGGACTGAGCAGTACTTC	CSVEDTTDRTEQYF	TRBV29-1	TRBJ2-7
TGCGCCAGCAGTGGGAGACAGGGAGGTTCACCCCTCCACTTT	CASSGRQGGSPLHF	TRBV10-1	TRBJ1-6
TGTGCCAGTAGTAGCTCGGCGCGCAATCAGCCCCAGCATTTT	CASSSSARNQPQHF	TRBV19	TRBJ1-5
TGTGCCAGCAGCTCCGAGGGACAGGGATCCTCCTACGAGCAGTACTTC	CASSSEGQGSSYEQYF	TRBV7-9	TRBJ2-7
TGCGCCAGCAGCAGTTTTAATGGTGCAGGGGGATCGGACATTCAGTACTTC	CASSSFNGAGGSDIQYF	TRBV5-1	TRBJ2-4
TGCGCCAGCAGCCAGTACCCCAGGGATACTGGGGCCAACGTCCTGACTTTC	CASSQYPRDTGANVLTF	TRBV5-1	TRBJ2-6
TGTGACAGCGGTTTCTACGAGCAGTACTTC	CDSGFYEQYF	TRBV27	TRBJ2-7
TGTGCCAGCAGCTTCCGAGGGGGCCAAGAGACCCAGTACTTC	CASSFRGGQETQYF	TRBV7-2	TRBJ2-5
TGTGCCAGCAGTTGCAGACCCATTAGCTCCTATAATTCACCCCTCCACTTT	CASSCRPISSYNSPLHF	TRBV6-5	TRBJ1-6
TGTGCCAGCAGCAGCCGGGACAATCTGAAATCCAATGAGCAGTTCTTC	CASSSRDNLKSNEQFF	TRBV7-4	TRBJ2-1
TGCAGTGCTAGAGACGGGTCACGGTACTTC	CSARDGSRYF	TRBV20-1	TRBJ2-5
TGTGCCAGCAGCGTCAGTCTCCTGGGACTCTGCTCTGGGACCCAGTACTTC	CASSVSLLGLCSGTQYF	TRBV7-9	TRBJ2-5
TGTGCCAGCAGCGACCCCGAGGACATTCTCTACGAGCAGTACTTC	CASSDPEDILYEQYF	TRBV13	TRBJ2-7
TGTGCCAGCAGTGGGGGTTTACTTGAAAAACTGTTTTTT	CASSGGLLEKLFF	TRBV6-4	TRBJ1-4
TGTGCCATTAGGACAGGTCACTGGGACTACGAGCAGTACTTC	CAIRTGHWDYEQYF	TRBV18	TRBJ2-7
TGTAAGGGGCAGAACAATTCACCCCTCCACTTT	CKGQNNSPLHF	TRBV6-1	TRBJ1-6
TGCAAGCCGACCCGGACAGCTTATGGCTACACCTTC	CKPTRTAYGYTF	TRBV20-1	TRBJ1-2
TGTGCCAGCAGACGGGAGGGTTTTACCGGGGAGCTGTTTTTT	CASRREGFTGELFF	TRBV3-1	TRBJ2-2
TGTGCCAGCTGGTGGGACAGATGCCAGACTAACTATGGCTACACCTTC	CASWWDRCQTNYGYTF	TRBV4-2	TRBJ1-2
TGTGCCAGCAGTTACTCCCACGTGACAGGAGGATATAACTATGGCTACACCTTC	CASSYSHVTGGYNYGYTF	TRBV6-2	TRBJ1-2
TGTGCCACCAGTGACGCTATGGGCTACGAGCAGTACTTC	CATSDAMGYEQYF	TRBV24-1	TRBJ2-7
TGCGCCAGCAGCAGGGGCCTACCTCAGCCCCAGCATTTT	CASSRGLPQPQHF	TRBV5-1	TRBJ1-5
TGTGCCAGCTCACCAATACACTCCAGTCCCGGGACAGTCCCCACCGGGGAGCTGTTTTTT	CASSPIHSSPGTVPTGELFF	TRBV18	TRBJ2-2
TGTGCCCTGGTAGATACGCAGTATTTT	CALVDTQYF	TRBV10-3	TRBJ2-3
TGTGCCATTCGATTTAGGAATGAGCAGTTCTTC	CAIRFRNEQFF	TRBV6-5	TRBJ2-1
TGTGCTAGTGCTCAGGGGCTCGGTAACTATGGCTACACCTTC	CASAQGLGNYGYTF	TRBV12-5	TRBJ1-2
TGTGCCAGCAGCTTACGATCCTACGAGCAGTACTTC	CASSLRSYEQYF	TRBV11-2	TRBJ2-7
TGTGCCAGCAGCCGGGGAGCCACTGAAGCTTTCTTT	CASSRGATEAFF	TRBV6-2	TRBJ1-1
TGTGCCTGGGCGCACCTTCTTTACAATGAGCAGTTCTTC	CAWAHLLYNEQFF	TRBV30	TRBJ2-1
TGTGCCAGCAGCCCGCCCGGGACAGGACTACGCAATCAGCCCCAGCATTTT	CASSPPGTGLRNQPQHF	TRBV7-6	TRBJ1-5
TGTGCCAGCAGTTTATCCGACAGGGACCCCAATCAGCCCCAGCATTTT	CASSLSDRDPNQPQHF	TRBV12-3	TRBJ1-5
TGTGCCAGCAGCGTCATTAGAACTAGCGGGGAGGCCTGGCAGTACTTC	CASSVIRTSGEAWQYF	TRBV7-3	TRBJ2-7
TGTGCCAGCAGCCCGCCGACAGGGGCCCAGCCCCAGCATTTT	CASSPPTGAQPQHF	TRBV7-3	TRBJ1-5
TGCGCCAGCGATTGGACAGGGTGGCTCTACGAGCAGTACTTC	CASDWTGWLYEQYF	TRBV5-1	TRBJ2-7
TGTGCCAGCAGTTGGGGGGGATATGGCTACACCTTC	CASSWGGYGYTF	TRBV12-4	TRBJ1-2
TGTGCCAGCAGCCCGGGCCTCCCAGGACAGACAGATACGCAGTATTTT	CASSPGLPGQTDTQYF	TRBV7-3	TRBJ2-3
TGTGCCAGCAGCGGACTAGCGGGAACAGTCTACGAGCAGTACTTC	CASSGLAGTVYEQYF	TRBV11-2	TRBJ2-7
TGTGCCAGCAGTCGACCCGGTTCGAATGGCTACACCTTC	CASSRPGSNGYTF	TRBV27	TRBJ1-2
TGCAGTGCACCGGCCTCGAAAGCTTTCTTT	CSAPASKAFF	TRBV20-1	TRBJ1-1
TGTGCCAGCACCACCGGGGAGGGCGAAAAACTGTTTTTT	CASTTGEGEKLFF	TRBV6-1	TRBJ1-4
TGTGCCAGCAGATTGGGAGATTTCCTAGGTTGGTACGAGCAGTACTTC	CASRLGDFLGWYEQYF	TRBV6-1	TRBJ2-7
TGTGCCAGCAGTCCTACCAAGCAGCCCCAGCATTTT	CASSPTKQPQHF	TRBV5-6	TRBJ1-5
TGTGCCAGCAGCTTCCAGGGGGCCCAGTACTTC	CASSFQGAQYF	TRBV13	TRBJ2-5
TGTGCCAGTAGTACTGGGTGGGAAAGCGGGAGAAATCAGCCCCAGCATTTT	CASSTGWESGRNQPQHF	TRBV19	TRBJ1-5
TGTGCCAGCAGTCATCGGGATCATGAGCAGTTCTTC	CASSHRDHEQFF	TRBV27	TRBJ2-1
TGCGCCAGCGGAGGACCTCCGTGGAACACTGAAGCTTTCTTT	CASGGPPWNTEAFF	TRBV5-1	TRBJ1-1
TGTGCCAGCAGCTACACCCCTCGCCCGGGGAGTTACGAGCAGTACTTC	CASSYTPRPGSYEQYF	TRBV7-9	TRBJ2-7
TGTGCCAGCAGCTACGAGAGCTCCTACGAGCAGTACTTC	CASSYESSYEQYF	TRBV13	TRBJ2-7
TGCAGTGCTCCCAGTTCACCCCTCCACTTT	CSAPSSPLHF	TRBV20-1	TRBJ1-6
TGTGCCAGCAGTTGCCGACAGAATAGCAATCAGCCCCAGCATTTT	CASSCRQNSNQPQHF	TRBV6-5	TRBJ1-5
TGTGCCAGCAGTGTCCGGGACTTAGAGAGGAACCTCCACTTT	CASSVRDLERNLHF	TRBV27	TRBJ1-6
TGTGCCAGCAGCTTACGAGGCGGACATCAGCCCCAGCATTTT	CASSLRGGHQPQHF	TRBV11-2	TRBJ1-5
TGTGCCAGCGGGCCGGATGGCTACACCTTC	CASGPDGYTF	TRBV6-1	TRBJ1-2
TGTGCCAGCAGCAAAGCCCGTGAGAGCCGAGGGCAGTTAGATACGCAGTATTTT	CASSKARESRGQLDTQYF	TRBV6-3	TRBJ2-3
TGTGCCAGCAGCGAGGAGGGGAATAGCAGCAATCAGCCCCAGCATTTT	CASSEEGNSSNQPQHF	TRBV11-3	TRBJ1-5
TGTGCCAGCAGTGACTCAGCTCCACCTAGTCTCCACTATGGCTACACCTTC	CASSDSAPPSLHYGYTF	TRBV6-4	TRBJ1-2
TGCGCCAGCAGCCAAGTCCGCGGACGGGGAAACGAGCAGTACTTC	CASSQVRGRGNEQYF	TRBV4-3	TRBJ2-7
TGCTACGACGCGACCAATGAGCAGTTCTTC	CYDATNEQFF	TRBV20-1	TRBJ2-1
TGTGCCAGCAGCAGGAAACCACAAATGTTGAGGGTTAGTGATACGCAGTATTTT	CASSRKPQMLRVSDTQYF	TRBV7-3	TRBJ2-3
TGTGCCAGCAGAGGGACATGTGAGGGGTACGAGCAGTACTTC	CASRGTCEGYEQYF	TRBV7-9	TRBJ2-7
TGCGCCAGCAGCCAAGAGGCGGGCTCTGGAAACACCATATATTTT	CASSQEAGSGNTIYF	TRBV4-3	TRBJ1-3
TGTGCCAGCAGTCAACCCCCGGGACAGCAGCCCCAGCATTTT	CASSQPPGQQPQHF	TRBV6-4	TRBJ1-5
TGCAGTGCTAGACGGTGGGACAATGAAAAACTGTTTTTT	CSARRWDNEKLFF	TRBV20-1	TRBJ1-4
TGTGCCAGCAGCGACGAGAACACTGAAGCTTTCTTT	CASSDENTEAFF	TRBV7-9	TRBJ1-1
TGTGCCAGTAGAACCAGGGAGGTTTTCTACCGCGACGCTCACGAGCAGTACTTC	CASRTREVFYRDAHEQYF	TRBV19	TRBJ2-7
TGTGCCAGCAGCTTGGACAAGGGGGATTACTCTGGAAACACCATATATTTT	CASSLDKGDYSGNTIYF	TRBV7-9	TRBJ1-3
TGTGCCACCAGTGATCATCGAGGGGGAGGGCGATATAACCCCCAGCCCCAGCATTTT	CATSDHRGGGRYNPQPQHF	TRBV24-1	TRBJ1-5
TGTGCCACCAGTGGAGGCTCCTGGAGGGTTAGCAATCAGCCCCAGCATTTT	CATSGGSWRVSNQPQHF	TRBV24-1	TRBJ1-5
TGTGCCAGTCCAAAGGGAGGACAGCCCCAGCATTTT	CASPKGGQPQHF	TRBV7-9	TRBJ1-5
TGTGCCTGGAGTGGCGGGGGCAATGAGCAGTTCTTC	CAWSGGGNEQFF	TRBV30	TRBJ2-1
TGTGCCAGCAGCCAAGCGCACACCGGGACAGGGTCGGAAAAACTGTTTTTT	CASSQAHTGTGSEKLFF	TRBV14	TRBJ1-4
TGCAGTGCTAGCCAGGCCGGGACTAGTTTTGCACGAGACGAGACCCAGTACTTC	CSASQAGTSFARDETQYF	TRBV20-1	TRBJ2-5
TGTGCCAGCAGTAAGAAGCGGACAGGGTTCATTTTAAACATTCAGTACTTC	CASSKKRTGFILNIQYF	TRBV2	TRBJ2-4
TGCGCCAGCAAAACCAAACGGGGGGTGGAGACCCAGTACTTC	CASKTKRGVETQYF	TRBV10-1	TRBJ2-5
TGTGCCAGCAGCTTCGTGGGGGTTCTAGGAGGCACAGATACGCAGTATTTT	CASSFVGVLGGTDTQYF	TRBV11-3	TRBJ2-3
TGTGCCAGCAGTACGAGTAAAAGGACTGCCAAAAACATTCAGTACTTC	CASSTSKRTAKNIQYF	TRBV27	TRBJ2-4
TGCAGTGCTAGTGAAATCGGGGCTGAAAAACTGTTTTTT	CSASEIGAEKLFF	TRBV20-1	TRBJ1-4
TGTGCCAGCAGTGGCGGGGCGGGAACCGTCACTGAAGCTTTCTTT	CASSGGAGTVTEAFF	TRBV28	TRBJ1-1
TGCAGCGTTGAAACTCTAGGAGGGGGAAAGAGCTCTGGAAACACCATATATTTT	CSVETLGGGKSSGNTIYF	TRBV29-1	TRBJ1-3
TGTGCCAGTAGCGAAACTAGCGGGAGGAGAGGCTACACCTTC	CASSETSGRRGYTF	TRBV19	TRBJ1-2
TGTGCCAGCAGTAAGACTACCTGGGGACTCTTT	CASSKTTWGLF	TRBV9	TRBJ1-1
TGTGCCAGCAGCGACCACAGATCTTCGAAAGAGGTTCTTGAGCAGTTCTTC	CASSDHRSSKEVLEQFF	TRBV9	TRBJ2-1
TGTGCCAGCAGAGGTAGTACGGGGGGGGCCCTGGATGAGCAGTTCTTC	CASRGSTGGALDEQFF	TRBV27	TRBJ2-1
TGTGCCAGCAGTGCCTTCCCTCCCGGACAGCCCATTACGAACACTGAAGCTTTCTTT	CASSAFPPGQPITNTEAFF	TRBV6-1	TRBJ1-1
TGCGCCAGCAGCTTGGGGACAGGTTTGGAAAACACTGAAGCTTTCTTT	CASSLGTGLENTEAFF	TRBV5-1	TRBJ1-1
TGCAGTGCTATGCCAGGGGAAAGGACAGATACGCAGTATTTT	CSAMPGERTDTQYF	TRBV20-1	TRBJ2-3
TGTGCCACCAGTGATTTTTCGGGACAGGTACAGCCCCAGCATTTT	CATSDFSGQVQPQHF	TRBV24-1	TRBJ1-5
TGTGCCATCAGTGACGCCAAGGCCAAGGAGGGTCAGTTCGAGCAGTACTTC	CAISDAKAKEGQFEQYF	TRBV10-3	TRBJ2-7
TGTGCCTTTGGGGACAGCTTGCAGTTCTTC	CAFGDSLQFF	TRBV30	TRBJ2-1
TGTGCCAGTAGTAAGGTACGGTTAAAGGGGGAGACCCAGTACTTC	CASSKVRLKGETQYF	TRBV19	TRBJ2-5
TGTGCCAGCAGTTTAAGAGGACAGGTTGTTAACACTGAAGCTTTCTTT	CASSLRGQVVNTEAFF	TRBV28	TRBJ1-1
TGTGCCAGCAATCAAACGGTGGGACAGGGTGAAGATCAGCCCCAGCATTTT	CASNQTVGQGEDQPQHF	TRBV2	TRBJ1-5
TGTGCCAGCAGCTGTATAGCTAAGCAGTACTTC	CASSCIAKQYF	TRBV7-2	TRBJ2-7
TGTGCTAGCAGCTGGGGGGCCCGACAAGAGACCCAGTACTTC	CASSWGARQETQYF	TRBV7-7	TRBJ2-5
TGTGCCAGCAGTGGGTCCCGGGACTTAAGGACCCAGTACTTC	CASSGSRDLRTQYF	TRBV6-4	TRBJ2-5
TGTGCCAGCAGCTTAACTCGGGGATTTACAGAGACCCAGTACTTC	CASSLTRGFTETQYF	TRBV11-3	TRBJ2-5
TGTGCCAGCTCCTCGGGCCAGGGGGGGCGATACGAGCAGTACTTC	CASSSGQGGRYEQYF	TRBV18	TRBJ2-7
TGCAGTGCATTAGGGGGCGTCAAGGAGCAGTACTTC	CSALGGVKEQYF	TRBV20-1	TRBJ2-7
TGTGCCAGCGAAAGACACGGGCAAGAGACCCAGTACTTC	CASERHGQETQYF	TRBV9	TRBJ2-5
TGTGCCAGCAGAGACCCCCAGAGACCCCTACGTGAAGCTTTCTTT	CASRDPQRPLREAFF	TRBV5-4	TRBJ1-1
TGTGCCAGCAGCTTAGTCAACGGACAGGGGATCTATGGCTACACCTTC	CASSLVNGQGIYGYTF	TRBV11-1	TRBJ1-2
TGTGCCAGCAGCTGCGGGGGGGGCGGAGTATGCCAAGAGACCCAGTACTTC	CASSCGGGGVCQETQYF	TRBV5-6	TRBJ2-5
TGTGCCAGCAGCTTAGCCAGCTGCCTTAATGAAAAACTGTTTTTT	CASSLASCLNEKLFF	TRBV7-3	TRBJ1-4
TGTGCTAGTGGTTCCTGGGACACTGAAGCTTTCTTT	CASGSWDTEAFF	TRBV12-5	TRBJ1-1
TGTGCCACCAGCAGAGGGCGCGGGCGGGAATGCTACGAGCAGTACTTC	CATSRGRGRECYEQYF	TRBV15	TRBJ2-7
TGTGCCAGCAGTTCTAGCAGGCTGCGAACTAATGAAAAACTGTTTTTT	CASSSSRLRTNEKLFF	TRBV28	TRBJ1-4
TGTGCCAGCAGCTTAGGCGGCTACACCTTC	CASSLGGYTF	TRBV11-2	TRBJ1-2
TGCGCCAGCAGCTTCTCCCCAAACCCTTCGGGTAGCAATCAGCCCCAGCATTTT	CASSFSPNPSGSNQPQHF	TRBV5-1	TRBJ1-5
TGTGGTGCGGTGATCGGGACAGGGCTAGGCTATGGCTACACCTTC	CGAVIGTGLGYGYTF	TRBV6-4	TRBJ1-2
TGTGCCAGCAGGGTGCACCCCCGGGGGGACAGGGGGCACAATGAGCAGTTCTTC	CASRVHPRGDRGHNEQFF	TRBV6-3	TRBJ2-1
TGTGCCAGCAGCCGGAAGTGCCCTCCGGGACACTTCTACGAGCAGTACTTC	CASSRKCPPGHFYEQYF	TRBV5-4	TRBJ2-7
TGCGCCAGCAAGATGCCCTCACTCAGAGAGGGTCTTTATAGCAATCAGCCCCAGCATTTT	CASKMPSLREGLYSNQPQHF	TRBV10-1	TRBJ1-5
TGCAGCGGTCGATCCTACGAGCAGTACTTC	CSGRSYEQYF	TRBV29-1	TRBJ2-7
TGTGCCTGGAGATGGGGTTTTATTATCTACGAGCAGTACTTC	CAWRWGFIIYEQYF	TRBV30	TRBJ2-7
TGTGCTAGTGGTTTGCTACTTATAATTGGGACAGGGCCGGACGAGCAGTACTTC	CASGLLLIIGTGPDEQYF	TRBV12-5	TRBJ2-7
TGCAGTGCTAGATTAACACGGACGAACACCGGGGAGCTGTTTTTT	CSARLTRTNTGELFF	TRBV20-1	TRBJ2-2
TGTGCCAGCACGAAGTACGAGCAGTACTTC	CASTKYEQYF	TRBV6-4	TRBJ2-7
TGTGCCAGCAGCGTCCCGGGACACACCGGGGAGCTGTTTTTT	CASSVPGHTGELFF	TRBV9	TRBJ2-2
TGTGCCAGCAGCTTGGCCTATCGGCGGGAGGCCCCCCGCTCCTACGAGCAGTACTTC	CASSLAYRREAPRSYEQYF	TRBV5-6	TRBJ2-7
TGTGCCAGCAGTTGGCGACAGAAGGGCACACACGAGCAGTACTTC	CASSWRQKGTHEQYF	TRBV28	TRBJ2-7
TGTGCCAGCAGCTTAGGGCGGGGGCGCGGAGGAGCTTTCTTT	CASSLGRGRGGAFF	TRBV7-2	TRBJ1-1
TGTGCCGGCGGGAACAGGGGGCGCGAGCGGGGAAAGAATGAAAAACTGTTTTTT	CAGGNRGRERGKNEKLFF	TRBV10-3	TRBJ1-4
TGCAGTGCTAGAACCTGGACTAGGGTGGCCTACAATGAGCAGTTCTTC	CSARTWTRVAYNEQFF	TRBV20-1	TRBJ2-1
TGTGCCAGCAGTTTAGCCGGGACAGGGACCCGCACAGATACGCAGTATTTT	CASSLAGTGTRTDTQYF	TRBV12-4	TRBJ2-3
TGTGCCAGCAGCGCCCGGACAGGATATGAAGCTTTCTTT	CASSARTGYEAFF	TRBV7-9	TRBJ1-1
TGCGCCAGCAGCCAAGATGTCGGACAGGGGGCATCAAACTCTGGGGCCAACGTCCTGACTTTC	CASSQDVGQGASNSGANVLTF	TRBV4-1	TRBJ2-6
TGTGCCAGCAGCACTCCGGAGAGCTTCAACACCGGGGAGCTGTTTTTT	CASSTPESFNTGELFF	TRBV7-6	TRBJ2-2
TGCAGCGTTGAAGATCCCAGTTTTTCGGCCGGGCCCCCTGCAACTAATGAAAAACTGTTTTTT	CSVEDPSFSAGPPATNEKLFF	TRBV29-1	TRBJ1-4
TGTGCCAGCAGGCCCCCGGATTTCCGGATAGGGAGCGCGAACACCGGGGAGCTGTTTTTT	CASRPPDFRIGSANTGELFF	TRBV6-5	TRBJ2-2
TGTGCCAGTAGTATGGGCGGAGACAGGGCCTATAATTCACCCCTCCACTTT	CASSMGGDRAYNSPLHF	TRBV19	TRBJ1-6
TGCGCCAGCAAACCGTACAAACTAGCGGGAGGAATGAGCTCCTACAATGAGCAGTTCTTC	CASKPYKLAGGMSSYNEQFF	TRBV5-1	TRBJ2-1
TGTGCTAGTGGTTTCCACAGCAAGACAGGGCCGGACGAGCAGTACTTC	CASGFHSKTGPDEQYF	TRBV12-5	TRBJ2-7
TGTGCCAGCAGCCACCCCCCTAGCGGGGGATACCAAGAGACCCAGTACTTC	CASSHPPSGGYQETQYF	TRBV14	TRBJ2-5
TGTGCTAGTGGTTTGGTCGGCTTCGGGGCGATTTGCTACGAGCAGTACTTC	CASGLVGFGAICYEQYF	TRBV12-5	TRBJ2-7
TGTGAAAAGGACAGTAATGAAAAACTGTTTTTT	CEKDSNEKLFF	TRBV4-2	TRBJ1-4
TGTGCCAGCTGGGGTCTCTTATACGAGCAGTACTTC	CASWGLLYEQYF	TRBV19	TRBJ2-7
TGTGCCAGCAGCGTAGGGGGGGCTTACTCTGGAAACACCATATATTTT	CASSVGGAYSGNTIYF	TRBV9	TRBJ1-3
TGTGCCAGCGGACAGGACCGTGGAAACACCATATATTTT	CASGQDRGNTIYF	TRBV9	TRBJ1-3
TGTGCCAGCAGCGGCAGACAGGGTGAGAACACTGAAGCTTTCTTT	CASSGRQGENTEAFF	TRBV11-2	TRBJ1-1
TGTGCCAGCAGTTTGTATACCCGGGACACCCGCTACACCTTC	CASSLYTRDTRYTF	TRBV12-3	TRBJ1-2
TGTGCCAGCAGCTTAGAAAGCCACAGGGGGCGACATCAGCCCCAGCATTTT	CASSLESHRGRHQPQHF	TRBV11-1	TRBJ1-5
TGTGCCATCAGTGAGTGGGGACAGAGACAGGGTCCTCTCGAGACCCAGTACTTC	CAISEWGQRQGPLETQYF	TRBV10-3	TRBJ2-5
TGTGCCAGCAGTTACCCGCGGGAGCAAAACGAGCAGTACTTC	CASSYPREQNEQYF	TRBV6-5	TRBJ2-7
TGTGCCAGCAGTTACGCACCCCGGGACAGGGGATCTGAAGCTTTCTTT	CASSYAPRDRGSEAFF	TRBV6-5	TRBJ1-1
TGTGCCAGCAGCCAAGCAGGGGGGGATTTGGGAGAGACCCAGTACTTC	CASSQAGGDLGETQYF	TRBV3-1	TRBJ2-5
TGTGCCAATAGACTTAAGCATGCGTACACTGAAGCTTTCTTT	CANRLKHAYTEAFF	TRBV30	TRBJ1-1
TGCGCCAGCAGCTCCCTCGTATGGGGACGGCACAATGAGCAGTTCTTC	CASSSLVWGRHNEQFF	TRBV5-1	TRBJ2-1
TGTGCCAGCAGCCTAGAACGGGAGATGAAGACAGATACGCAGTATTTT	CASSLEREMKTDTQYF	TRBV7-9	TRBJ2-3
TGTGCCAGCAGTGACAAATCTATCAACAGGGCTGTCGAGTATAGCAATCAGCCCCAGCATTTT	CASSDKSINRAVEYSNQPQHF	TRBV6-4	TRBJ1-5
TGTGCCACTCAACCTATTACTAGGGGGTACCAAGAGACCCAGTACTTC	CATQPITRGYQETQYF	TRBV11-3	TRBJ2-5
TGTGCCAGCAGCTTAACCGGGGGGGGGGGTCTGTACAATGAGCAGTTCTTC	CASSLTGGGGLYNEQFF	TRBV7-3	TRBJ2-1
TGTGCCAGCAGTGACAGTCCCCCGGCTGCGAGCAATCAGCCCCAGCATTTT	CASSDSPPAASNQPQHF	TRBV6-4	TRBJ1-5
TGTGCCAGCAGCGAGTCGGACTCAGGAAACACTGAAGCTTTCTTT	CASSESDSGNTEAFF	TRBV13	TRBJ1-1
TGTGCCAGCAGTTTGGACGAGGGACAAGGCTACGAGCAGTACTTC	CASSLDEGQGYEQYF	TRBV27	TRBJ2-7
TGCCACTCTACAGCGGCTGAAGCTTTCTTT	CHSTAAEAFF	TRBV18	TRBJ1-1
TGCGCCAGCAGCCGTAACTTTAGTAAACTAGCGGGAGACCAAGAGACCCAGTACTTC	CASSRNFSKLAGDQETQYF	TRBV5-1	TRBJ2-5
TGCAGTGCTAGAGATCGCGGCCGCGGGAAACCGGGCTCTGGGGCCAACGTCCTGACTTTC	CSARDRGRGKPGSGANVLTF	TRBV20-1	TRBJ2-6
TGTGCCAGCAGTGAATCAACAAAAAAGCAAACGAACACCGGGGAGCTGTTTTTT	CASSESTKKQTNTGELFF	TRBV25-1	TRBJ2-2
TGCAGTGCTCTGGCGCAGACAGGTGATCAGCCCCAGCATTTT	CSALAQTGDQPQHF	TRBV20-1	TRBJ1-5
TGTGCCAGCAGCCAGGAAGGAAGAGAGACCCAGTACTTC	CASSQEGRETQYF	TRBV25-1	TRBJ2-5
TGTGCCAGTAGTATCTGGGTACCTTCTTTCTTT	CASSIWVPSFF	TRBV19	TRBJ1-1
TGTGCCTGGGCCGCTGGCGAGGAGACCCAGTACTTC	CAWAAGEETQYF	TRBV30	TRBJ2-5
TGCAGCGTTGAACGAACCCACAGTCCTGGGGCCAACGTCCTGACTTTC	CSVERTHSPGANVLTF	TRBV29-1	TRBJ2-6
TGCGCCAGCAGTCCAGACAGGGACGATCCTCCAACTGAAGCTTTCTTT	CASSPDRDDPPTEAFF	TRBV10-1	TRBJ1-1
TGCGCCAGCAGCTTGCCCCAGGGGATGAACACTGAAGCTTTCTTT	CASSLPQGMNTEAFF	TRBV5-1	TRBJ1-1
TGCAGTGCTAGAGAGGGATCTGGCTATGGCTACACCTTC	CSAREGSGYGYTF	TRBV20-1	TRBJ1-2
TGTGCCAGCAGAAAGGCGCTGGGGAGAATTTACCTAGAGACCCAGTACTTC	CASRKALGRIYLETQYF	TRBV7-3	TRBJ2-5
TGTGCCACTAGCGGGACTGAAGCTTTCTTT	CATSGTEAFF	TRBV6-6	TRBJ1-1
TGTGCCACCAGTGACCCTACCCGGGACAGGGGGGGTTCTGGGGCCAACGTCCTGACTTTC	CATSDPTRDRGGSGANVLTF	TRBV24-1	TRBJ2-6
TGTGCCAGCAGCTTGAAAAGGGTCAAAGCTTTCTTT	CASSLKRVKAFF	TRBV5-6	TRBJ1-1
TGTGCCAGCAGCAGACGGGGGGAATACAATGAGCAGTTCTTC	CASSRRGEYNEQFF	TRBV7-3	TRBJ2-1
TGTGCCAGCAGTCCCACAACTGGGGAAAGCAATCAGCCCCAGCATTTT	CASSPTTGESNQPQHF	TRBV28	TRBJ1-5
TGTGCCAGCTTCCGGATGATATTGCGGCTTACCGCTTTCTTT	CASFRMILRLTAFF	TRBV6-4	TRBJ1-1
TGCGCCAGCAGTGTGGTGAAACTAGCGGGGGTAAGCACAGATACGCAGTATTTT	CASSVVKLAGVSTDTQYF	TRBV10-1	TRBJ2-3
TGTGCCACCACCGGCCCGGGACAGCCTAATGAAAAACTGTTTTTT	CATTGPGQPNEKLFF	TRBV24-1	TRBJ1-4
TGTGCCAGCAGCTTAGCGGGTATGGTCCAAGAGACCCAGTACTTC	CASSLAGMVQETQYF	TRBV7-9	TRBJ2-5
TGTGCCAGCAGTTGTACCCGGGACACCCGGCCCAATGAAAAACTGTTTTTT	CASSCTRDTRPNEKLFF	TRBV27	TRBJ1-4
TGTGCCAGCAGCCACTGGCGGGCTGAAAAACTGTTTTTT	CASSHWRAEKLFF	TRBV3-1	TRBJ1-4
TGTGCCAGCAGTTTAAATGGGGACGAGACCCAGTACTTC	CASSLNGDETQYF	TRBV28	TRBJ2-5
TGTGCCAGCAGCCGGGACTGGGGGGGTGAAGCTTTCTTT	CASSRDWGGEAFF	TRBV13	TRBJ1-1
TGCGCCAGCAGCTTAGCTCGGACGTTTATGGAAGAGACCCAGTACTTC	CASSLARTFMEETQYF	TRBV5-1	TRBJ2-5
TGTGCCGGGTCCATGGCGGGGCTTAACACCGGGGAGCTGTTTTTT	CAGSMAGLNTGELFF	TRBV6-1	TRBJ2-2
TGTGCCAGCAGCTTACCAAGGGGCGATGCGTCACCCCTCCACTTT	CASSLPRGDASPLHF	TRBV7-9	TRBJ1-6
TGTGCCAGCAGCTTTCGGACAGGGAGAGAGACCCAGTACTTC	CASSFRTGRETQYF	TRBV7-9	TRBJ2-5
TGTGCCAGCAGCCAAGGTTTCACAGGGTGGGTCAATGAGCAGTTCTTC	CASSQGFTGWVNEQFF	TRBV4-2	TRBJ2-1
TGTGCCAGCAGTTTACAGGGCTGCTATGGCTACACCTTC	CASSLQGCYGYTF	TRBV28	TRBJ1-2
TGTGCCAGCTGGGTGACTAGCGGTGGACGGAACGAGCAGTACTTC	CASWVTSGGRNEQYF	TRBV6-1	TRBJ2-7
TGTGCCATCAGTACAACAGCCTACAATGAGCAGTTCTTC	CAISTTAYNEQFF	TRBV10-3	TRBJ2-1
TGTGCCAGCAGTGACTCGATCGGGGAACGACGGGGACAGGGTCTTTACGAGCAGTACTTC	CASSDSIGERRGQGLYEQYF	TRBV6-4	TRBJ2-7
TGTGCCAGCAGCTTCTGCGGAGAGGAGAAGTCCTCCTATGGCTACACCTTC	CASSFCGEEKSSYGYTF	TRBV7-3	TRBJ1-2
TGTGCCAGCAGCAACGAGGACAGGGGCTACGAGCAGTACTTC	CASSNEDRGYEQYF	TRBV5-5	TRBJ2-7
TGTGCCAGCTCAGGGTCAGGGGGTCCTAACTATGGCTACACCTTC	CASSGSGGPNYGYTF	TRBV18	TRBJ1-2
TGCGCCAGCAGTGAGTCTGGGATAGATTCCTCCTACGAGCAGTACTTC	CASSESGIDSSYEQYF	TRBV10-1	TRBJ2-7
TGTGCCAGCAGCAGGGACAGGGGGTCCCATCAAGAGACCCAGTACTTC	CASSRDRGSHQETQYF	TRBV13	TRBJ2-5
TGTGCCAGCATGCCTCAGGGAGGCTCCTACGAGCAGTACTTC	CASMPQGGSYEQYF	TRBV6-5	TRBJ2-7
TGTGCCAGCAGCTTGACGCGCGGGAGAGGCAACCAAGAGACCCAGTACTTC	CASSLTRGRGNQETQYF	TRBV5-8	TRBJ2-5
TGTGCCAGCTCTGGGGATCCAAAAGCTGAAGCTTTCTTT	CASSGDPKAEAFF	TRBV13	TRBJ1-1
TGTGCCAGCAAGAGAACCCAGGGAGGAGCTTTCTTT	CASKRTQGGAFF	TRBV28	TRBJ1-1
TGTGCCAGCAGATCGACAGGGTACAATCAGCCCCAGCATTTT	CASRSTGYNQPQHF	TRBV7-3	TRBJ1-5
TGTGCCAGCTCACCCCTGCCACTGGGACAGGCCGACGAGCAGTACTTC	CASSPLPLGQADEQYF	TRBV18	TRBJ2-7
TGTGCCAGCAGTACCGGGACTAGCGGGAGGGGGTACGAGCAGTACTTC	CASSTGTSGRGYEQYF	TRBV12-3	TRBJ2-7
TGTGCCAGTCGAGCTAGAGGGGGGAGGCGAGATCAGCCCCAGCATTTT	CASRARGGRRDQPQHF	TRBV24-1	TRBJ1-5
TGTGCCAGCAACTTAAGAGGGGGGGGAGAGACCCAGTACTTC	CASNLRGGGETQYF	TRBV7-2	TRBJ2-5
TGCAGTGCTAGAGATGAGGCGACAATTTACATTCAGCCCCAGCATTTT	CSARDEATIYIQPQHF	TRBV20-1	TRBJ1-5
TGTGCCAGCAGCTCCCCAGGGGCCGACAATGAGCAGTTCTTC	CASSSPGADNEQFF	TRBV7-2	TRBJ2-1
TGTGCCAGCAGCTTGGGGACAGGGGTTACCTACGAGCAGTACTTC	CASSLGTGVTYEQYF	TRBV13	TRBJ2-7
TGCAGTGCTAGGGTACCCCGACAAGAGACCCAGTACTTC	CSARVPRQETQYF	TRBV20-1	TRBJ2-5
TGTGCCAGCAGCTTAAGACCAACGGGACTAGCGGGTTCCACAGATACGCAGTATTTT	CASSLRPTGLAGSTDTQYF	TRBV7-8	TRBJ2-3
TGTGCCAGCAGCGTAGACTGCCGGGACAGGGCCCTCTATGGCTACACCTTC	CASSVDCRDRALYGYTF	TRBV9	TRBJ1-2
TGTGCCAGCAGCAGCCGACCATCGATAGAGCAGTACTTC	CASSSRPSIEQYF	TRBV7-2	TRBJ2-7
TGTGCCAGCAGTACCGGGACAGGGTTACCTAACTATGGCTACACCTTC	CASSTGTGLPNYGYTF	TRBV6-8	TRBJ1-2
TGCGCCAGCAGCACAGGGCCAGAGACCCAGTACTTC	CASSTGPETQYF	TRBV5-1	TRBJ2-5
TGTGCCAGCAGTTACTCGAGTCGGTGTCCCCAATCGTACAATGAGCAGTTCTTC	CASSYSSRCPQSYNEQFF	TRBV6-6	TRBJ2-1
TGTGCCAGCAGCTTGGCAGGGACACCCACTAATGAAAAACTGTTTTTT	CASSLAGTPTNEKLFF	TRBV5-6	TRBJ1-4
TGCGCCAGCAGTGACCCGCCCCAAGGGGGGGCTAGTCCCGCCGGGGAGCTGTTTTTT	CASSDPPQGGASPAGELFF	TRBV10-1	TRBJ2-2
TGTGCCAGTAGTATAGGAGGACTAGCGGGATCAGATACGCAGTATTTT	CASSIGGLAGSDTQYF	TRBV19	TRBJ2-3
TGTGCCAGCAGTATTGGACCTGAGTCCGGTGGCTACACCTTC	CASSIGPESGGYTF	TRBV6-5	TRBJ1-2
TGCGCCAGCGGGGGGCGCCGCTCTGGGGCCAACGTCCTGACTTTC	CASGGRRSGANVLTF	TRBV5-1	TRBJ2-6
TGTGCCAGCAGACCGGGACAGGGGTCAAATCAGCCCCAGCATTTT	CASRPGQGSNQPQHF	TRBV27	TRBJ1-5
TGTGCCAGCAGTGGGGAGGACAGGGGGCATTGCTACGAGCAGTACTTC	CASSGEDRGHCYEQYF	TRBV6-4	TRBJ2-7
TGTGCCAGCAGTTTACTCAAAGGCGGGGATAAAAGCTCCTACAATGAGCAGTTCTTC	CASSLLKGGDKSSYNEQFF	TRBV12-4	TRBJ2-1
TGTGCCAGCAGCGGTACGGAACCGAGCTCCTATAATTCACCCCTCCACTTT	CASSGTEPSSYNSPLHF	TRBV7-3	TRBJ1-6
TGTGAAACGTCAATCCGGCGGGGCTACGAGCAGTACTTC	CETSIRRGYEQYF	TRBV28	TRBJ2-7
TGTGCCAGCAGCTTAGTGTGGTCGTCGCGGGAGAGCACTGAAGCTTTCTTT	CASSLVWSSRESTEAFF	TRBV7-9	TRBJ1-1
TGCGCCAGCAGCACGGGGGGGTCTACCAACACTGAAGCTTTCTTT	CASSTGGSTNTEAFF	TRBV5-1	TRBJ1-1
TGTGCCAGCAGCCTGCTTGTACAGGGAGGGCTGGTAATCTACGAGCAGTACTTC	CASSLLVQGGLVIYEQYF	TRBV7-3	TRBJ2-7
TGTGCCAGCAGCCAAGAGCTTTACTTCGATCCCGACACTGAAGCTTTCTTT	CASSQELYFDPDTEAFF	TRBV3-1	TRBJ1-1
TGTGCCAGCAGTAGACTAACATTGGGGGCTTTCTTT	CASSRLTLGAFF	TRBV6-4	TRBJ1-1
TGTGCCACCAGTGATTTGACAGGGGGAGGTTACACTGAAGCTTTCTTT	CATSDLTGGGYTEAFF	TRBV24-1	TRBJ1-1
TGTGCCAGCAGTGAGACAGTGGGGGACTCCTATAATTCACCCCTCCACTTT	CASSETVGDSYNSPLHF	TRBV25-1	TRBJ1-6
TGTGCCAGCAGTTACTCCATTAGTAGCGGGTGCGGCTACGAGCAGTACTTC	CASSYSISSGCGYEQYF	TRBV6-3	TRBJ2-7
TGCAGCGTTGCGGTGGCTCAGGGGTTGTGGAAGTATGGCTACACCTTC	CSVAVAQGLWKYGYTF	TRBV29-1	TRBJ1-2
TGTGCCAGCAGGATACCGCTCCGGGACACGGCCCAGTACTTC	CASRIPLRDTAQYF	TRBV6-2	TRBJ2-5
TGTGCCAGCAGCCAAGATGGGTTTCCTTTCGGGACAGACCATCGCAATCAGCCCCAGCATTTT	CASSQDGFPFGTDHRNQPQHF	TRBV14	TRBJ1-5
TGTGCCAGCAGTTACCCGAGGGACCGTTACTTC	CASSYPRDRYF	TRBV6-6	TRBJ2-5
TGCGCCAGCAGTGAGTCGAAAGGGGGCTATTCGTACGAGCAGTACTTC	CASSESKGGYSYEQYF	TRBV10-2	TRBJ2-7
TGTGCCAGCAGCGTTGTACAGGGGAGTACGCAGTATTTT	CASSVVQGSTQYF	TRBV9	TRBJ2-3
TGCGCCAGCAGCTTGGCATTTTTGCGGGCAGATGATACGCAGTATTTT	CASSLAFLRADDTQYF	TRBV5-1	TRBJ2-3
TGTGCTAGTGGCCCCAGCGTAAATGAGCAGTTCTTC	CASGPSVNEQFF	TRBV12-5	TRBJ2-1
TGTGCCAGCAGCGTAGCTCCCCGTCTCTATGGCTACACCTTC	CASSVAPRLYGYTF	TRBV9	TRBJ1-2
TGTGCTAGTGGTTGGCCCCCCCGACCCGAGGCGAACACCGGGGAGCTGTTTTTT	CASGWPPRPEANTGELFF	TRBV12-5	TRBJ2-2
TGCAGCGCTCAAAACCCAAGGGAGCCCCAGCATTTT	CSAQNPREPQHF	TRBV29-1	TRBJ1-5
TGTGCCAGCAGTCCTAGATCGCCCAGGGGAACCACAGATACGCAGTATTTT	CASSPRSPRGTTDTQYF	TRBV27	TRBJ2-3
TGTGCCAGTTGGACAGCACAAGAGACCCAGTACTTC	CASWTAQETQYF	TRBV7-2	TRBJ2-5
TGCGCCAGCAGCTGTGGGGGGGGACGCCGGCCCTACGAGCAGTACTTC	CASSCGGGRRPYEQYF	TRBV5-1	TRBJ2-7
TGTGCCAGCAGTCTTTTGAGAGTCGGGACTAGCGGGGGGGCCCCTTACGAGCAGTACTTC	CASSLLRVGTSGGAPYEQYF	TRBV6-3	TRBJ2-7
TGTGCCAGCAGCGTAGGCCTGGGGACATTAAATCAGCCCCAGCATTTT	CASSVGLGTLNQPQHF	TRBV9	TRBJ1-5
TGTGCTAGCAGCTTAAACCGGGGGGCCAAAAACATTCAGTACTTC	CASSLNRGAKNIQYF	TRBV7-7	TRBJ2-4
TGTGCCATGGATAGGACTAGCGGGGGGGGACCGAGCTCCTACAATGAGCAGTTCTTC	CAMDRTSGGGPSSYNEQFF	TRBV10-3	TRBJ2-1
TGCGCCAGCAGCTTACCCTTACAGGTAGAGACCCAGTACTTC	CASSLPLQVETQYF	TRBV5-1	TRBJ2-5
TGTGCCACCAGTGACCCTAACAAGGACAGGAAGAATGAAAAACTGTTTTTT	CATSDPNKDRKNEKLFF	TRBV24-1	TRBJ1-4
TGTGCCAGCAGTGAAAGGGGACGGGTTGAAAAACTGTTTTTT	CASSERGRVEKLFF	TRBV25-1	TRBJ1-4
TGCGCCAGAAAAAATGAGCAGTACTTC	CARKNEQYF	TRBV10-1	TRBJ2-7
TGTGCCAGTCAGGGTGAAAAACTGTTTTTT	CASQGEKLFF	TRBV19	TRBJ1-4
TGTGCCAGCAGCTGTTCTCGGGACAGGGGGGAGGAAGAGACCCAGTACTTC	CASSCSRDRGEEETQYF	TRBV13	TRBJ2-5
TGTGCCAGCGTAAAAAGACCTGATGAGCAGTTCTTC	CASVKRPDEQFF	TRBV7-9	TRBJ2-1
TGCGCCAGCAGCTTGTTTCGGGAGCAGTTCTTC	CASSLFREQFF	TRBV5-1	TRBJ2-1
TGTGCCAGCGTTCCGCCTAAACTAGGAGGGAACAATGAGCAGTTCTTC	CASVPPKLGGNNEQFF	TRBV7-3	TRBJ2-1
TGTGCCAGCAGCGGGTCGCGGGAGGACCATACGCAGTATTTT	CASSGSREDHTQYF	TRBV7-3	TRBJ2-3
TGCAGTGGAGGGCTCCGGGCCTTTTACAATGAGCAGTTCTTC	CSGGLRAFYNEQFF	TRBV20-1	TRBJ2-1
TGTGCCAGCACACCGGACAGGCCTGAAGCTTTCTTT	CASTPDRPEAFF	TRBV28	TRBJ1-1
TGCGCCAGCAGCCAAGAGAGCAGGCTAAGGGCCTCTGGAAACACCATATATTTT	CASSQESRLRASGNTIYF	TRBV4-1	TRBJ1-3
TGTGCCAGCAGAGGTTCTCGGGGTTTTTCACCCCTCCACTTT	CASRGSRGFSPLHF	TRBV11-3	TRBJ1-6
TGTGCCAGCAGGAGAGACGAGCAGTACTTC	CASRRDEQYF	TRBV14	TRBJ2-7
TGTGCCAGCAGTGAGTTTGACAGGTCTTCCGGGGAGCTGTTTTTT	CASSEFDRSSGELFF	TRBV6-4	TRBJ2-2
TGTGCCAGCAGTCGGGCAGAGAACACTGAAGCTTTCTTT	CASSRAENTEAFF	TRBV27	TRBJ1-1
TGCAGTGCTAGCAGGACAGGGGGCGGGGGAGGACCCTACGAGCAGTACTTC	CSASRTGGGGGPYEQYF	TRBV20-1	TRBJ2-7
TGTGCCAGCAGCCTCTGGCTTCGGCGAGACACGGATCCGGGTGAAAGCAATCAGCCCCAGCATTTT	CASSLWLRRDTDPGESNQPQHF	TRBV7-4	TRBJ1-5
TGCAGTGCCATGAAACTAGCGGGAGGCGCCTACGAGCAGTACTTC	CSAMKLAGGAYEQYF	TRBV20-1	TRBJ2-7
TGCAGTGCAGATAACAGGGTCCGAGATAATGAAAAACTGTTTTTT	CSADNRVRDNEKLFF	TRBV20-1	TRBJ1-4
TGTGCCAGTAGACTAGCGGGGGGGCGGGGGAAATTGACCTACGAGCAGTACTTC	CASRLAGGRGKLTYEQYF	TRBV6-6	TRBJ2-7
TGTGCCAGCAAAGGCGGTGGCTACACCTTC	CASKGGGYTF	TRBV6-5	TRBJ1-2
TGTGCCAGCAGCTTAGATCCATGCAGTAGGAACACTGAAGCTTTCTTT	CASSLDPCSRNTEAFF	TRBV11-3	TRBJ1-1
TGTGCCAGCAGCCGGCCGGGGCAAGACCGGACCGGGGAGCTGTTTTTT	CASSRPGQDRTGELFF	TRBV7-9	TRBJ2-2
TGTGCCTGGAGCAAGACGTTAAACAGCCGGACATATGGCTACACCTTC	CAWSKTLNSRTYGYTF	TRBV30	TRBJ1-2
TGTGCCAGCAGCCAACACCGGGCGGGACAGAATCATGAGCAGTTCTTC	CASSQHRAGQNHEQFF	TRBV3-1	TRBJ2-1
TGTGCCAGCAGTTTATACGAGACGGTTGAAAAACTGTTTTTT	CASSLYETVEKLFF	TRBV27	TRBJ1-4
TGTGCCAGCAGCGTGGACAGGCCAATACTTAGCAATCAGCCCCAGCATTTT	CASSVDRPILSNQPQHF	TRBV13	TRBJ1-5
TGTGCCAGCAGTGACTCGAGGAGGGGGCCTGAAGCTTTCTTT	CASSDSRRGPEAFF	TRBV6-4	TRBJ1-1
TGCGCCAGCAGTGAGAGGGGGGGAGGTGGCTACACCTTC	CASSERGGGGYTF	TRBV10-2	TRBJ1-2
TGTGCCAGCAGTGAAGCGCTTCAAAAACAGGGTGATTTGGGCTCTGGGGCCAACGTCCTGACTTTC	CASSEALQKQGDLGSGANVLTF	TRBV2	TRBJ2-6
TGTGCCAGCACGAAGGTCGGCCCCGGGACAGGGGTGCATCGGGAGTCTAACTATGGCTACACCTTC	CASTKVGPGTGVHRESNYGYTF	TRBV12-4	TRBJ1-2
TGTGCCAGCAGCTTAGGGGAGGGACAGGGGGGGGATACGCAGTATTTT	CASSLGEGQGGDTQYF	TRBV11-2	TRBJ2-3
TGCGCCAGCAGGGTACCGGCCCCGAACACCGGGGAGCTGTTTTTT	CASRVPAPNTGELFF	TRBV5-1	TRBJ2-2
TGTGCCAGCAGCTTGCCACGCTCCCTTGACAGGGCACAAGAGACCCAGTACTTC	CASSLPRSLDRAQETQYF	TRBV5-6	TRBJ2-5
TGCAGTGCTAGAGGGGACTTTGAAACAGATACGCAGTATTTT	CSARGDFETDTQYF	TRBV20-1	TRBJ2-3
TGTGCCAGCAGTGACAAACATAGGACAGGGGGCCTTAGCTCTGGAAACACCATATATTTT	CASSDKHRTGGLSSGNTIYF	TRBV2	TRBJ1-3
TGCGCCAGCAATTCCGGGGGGGACCTTCCCTACGAGCAGTACTTC	CASNSGGDLPYEQYF	TRBV5-1	TRBJ2-7
TGTGCCAGCAGCCAAGGAGGGTCTCGCAATCAGCCCCAGCATTTT	CASSQGGSRNQPQHF	TRBV6-5	TRBJ1-5
TGTGCCACCGTGGGGAGGGGTCACGAGCAGTACTTC	CATVGRGHEQYF	TRBV24-1	TRBJ2-7
TGTGCCAGCAGTTTGGCAGATAGAGAGAACCCCTACGAGCAGTACTTC	CASSLADRENPYEQYF	TRBV12-4	TRBJ2-7
TGTGCCAGCAGTACTAGCGGGAGGGCCACAGAGACCCAGTACTTC	CASSTSGRATETQYF	TRBV27	TRBJ2-5
TGTGCCAGCAGCGCGGAGGAGACAGGGAAAAATGAAAAACTGTTTTTT	CASSAEETGKNEKLFF	TRBV11-3	TRBJ1-4
TGCAGTGCTAGTCCCCCTACTTGCTACGAGCAGTACTTC	CSASPPTCYEQYF	TRBV20-1	TRBJ2-7
TGCAGCGTTGATCAGAAGACAGGGCGTTCCTATGGCTACACCTTC	CSVDQKTGRSYGYTF	TRBV29-1	TRBJ1-2
TGCAGTGAGCCGGGACAGGGTGGCTACACCTTC	CSEPGQGGYTF	TRBV20-1	TRBJ1-2
TGTGCCATCACCCTGTTGGGGGGAAAGTGTGAGCAGTTCTTC	CAITLLGGKCEQFF	TRBV10-3	TRBJ2-1
TGTGCCAGTAGTACGACAGGGCCTGGGCCCCAGCATTTT	CASSTTGPGPQHF	TRBV19	TRBJ1-5
TGTGCCAGCAGCGAGGGACTAGCACTCACAGATACGCAGTATTTT	CASSEGLALTDTQYF	TRBV5-4	TRBJ2-3
TGCAGTGGGTCCCTTTTGGGTGGGGGGGGAAATGAGCAGTTCTTC	CSGSLLGGGGNEQFF	TRBV20-1	TRBJ2-1
TGTGCCAGCAGCCAATTACTTGGGCCTGGCTCCTCCTACGAGCAGTACTTC	CASSQLLGPGSSYEQYF	TRBV14	TRBJ2-7
TGTGCCAGCAGCCAAGGGGCTCAAATGGACAGGGAGGGTCAGCCCCAGCATTTT	CASSQGAQMDREGQPQHF	TRBV4-2	TRBJ1-5
TGTGCCAGCAGCCAAGCCCCGTGTCTCGGGAGTTCCAACTATGGCTACACCTTC	CASSQAPCLGSSNYGYTF	TRBV14	TRBJ1-2
TGCGCCAGCAGTGGTTGGGGGCTTTTCTTT	CASSGWGLFF	TRBV10-1	TRBJ1-1
TGTGCCAGCAGCCCCCCAGTCCACACCGGGGAGCTGTTTTTT	CASSPPVHTGELFF	TRBV5-6	TRBJ2-2
TGTGCCAGCAGCGCCCGCCGATGTTACAATGAGCAGTTCTTC	CASSARRCYNEQFF	TRBV13	TRBJ2-1
TGTGCCAGCAGCAATCCGGGACAGGGCTACACCTTC	CASSNPGQGYTF	TRBV9	TRBJ1-2
TGTGCCAGCAGGCAGAACACCGGGGAGCTGTTTTTT	CASRQNTGELFF	TRBV27	TRBJ2-2
TGTGCCAGCACCGCCCGGGGGGCAGAGGGGGCCAACGTCCTGACTTTC	CASTARGAEGANVLTF	TRBV27	TRBJ2-6
TGTGCCAGCAGCCAAGTCGGGGACAGGGCTAATGAAAAACTGTTTTTT	CASSQVGDRANEKLFF	TRBV3-1	TRBJ1-4
TGTGCCAGCAGAAGGGGGGCCGATGAGCAGTTCTTC	CASRRGADEQFF	TRBV12-3	TRBJ2-1
TGTGCCAGCAGTCCAGTCGGCTACGAGCAGTACTTC	CASSPVGYEQYF	TRBV12-4	TRBJ2-7
TGTGCCAGCCTATCGGGACAGGGAAAGGCCCATCCCCTGAACACCGGGGAGCTGTTTTTT	CASLSGQGKAHPLNTGELFF	TRBV27	TRBJ2-2
TGTGCCAGCAGTTGGGACAGGGGCACTTCGTACGAGCAGTACTTC	CASSWDRGTSYEQYF	TRBV6-1	TRBJ2-7
TGTGCCAGCAGCTTGTCCGGGACATTGCCTGTTGAGCAGTTCTTC	CASSLSGTLPVEQFF	TRBV5-5	TRBJ2-1
TGTGCCACCAGTGTCCAGGACAGGGCCGGCTCTGGAAACACCATATATTTT	CATSVQDRAGSGNTIYF	TRBV24-1	TRBJ1-3
TGTGCCAGCTTCTGGCGGCTGGAAGAGACCCAGTACTTC	CASFWRLEETQYF	TRBV25-1	TRBJ2-5
TGCATACGACTAGCGGGGGGCAGCTCCTACAATGAGCAGTTCTTC	CIRLAGGSSYNEQFF	TRBV20-1	TRBJ2-1
TGTGCCAGCAGCCCGACGAGGAACTACAATGAGCAGTTCTTC	CASSPTRNYNEQFF	TRBV6-5	TRBJ2-1
TGTGCCAGCAGGACACCGGCAGGGGTAGATCAGCCCCAGCATTTT	CASRTPAGVDQPQHF	TRBV6-2	TRBJ1-5
TGTGCCAGCACCCGGGTTCAGGGCGGAGGTAATGAAAAACTGTTTTTT	CASTRVQGGGNEKLFF	TRBV27	TRBJ1-4
TGTGCCACCAGCAGATCCACAGGGGGCACCCTCCACTTT	CATSRSTGGTLHF	TRBV15	TRBJ1-6
TGCGCCAGCAGTGAGTCCCCCTGGGACCCAGGCTACAATGAGCAGTTCTTC	CASSESPWDPGYNEQFF	TRBV10-1	TRBJ2-1
TGTGCCGGGACAGCCCGCTCCTACGAGCAGTACTTC	CAGTARSYEQYF	TRBV10-3	TRBJ2-7
TGTGCCATCAGTCTGGAAAGTAGGACTAGATATGTCTGCACAGATACGCAGTATTTT	CAISLESRTRYVCTDTQYF	TRBV10-3	TRBJ2-3
TGTGCCAGCAGGGGACAGGGGAGTGATAGGGCATTCAGCTCTGGAAACACCATATATTTT	CASRGQGSDRAFSSGNTIYF	TRBV5-6	TRBJ1-3
TGTGCCAGCAGCTTAGGCCTACATGGTGGGGGGGTACAGACCCAGTACTTC	CASSLGLHGGGVQTQYF	TRBV7-4	TRBJ2-5
TGTGCCAGCAGACGTTCGGAACTCCCGGGACTAGCAGATACGCAGTATTTT	CASRRSELPGLADTQYF	TRBV28	TRBJ2-3
TGTGCCAGCAGTTTACCCTCCCTAAGCCTCCGACTAGCTAACAATTCAGAGACCCAGTACTTC	CASSLPSLSLRLANNSETQYF	TRBV12-3	TRBJ2-5
TGTGCCAGCAGCATTTTTCCGGCTAACACTGAAGCTTTCTTT	CASSIFPANTEAFF	TRBV7-3	TRBJ1-1
TGTGCCAGCAGCCGGGGACCCTGTCGTTCCTACGAGCAGTACTTC	CASSRGPCRSYEQYF	TRBV14	TRBJ2-7
TGTGCCAGCAGTTTACCGGGCGGCCGATACGAGCAGTACTTC	CASSLPGGRYEQYF	TRBV27	TRBJ2-7
