TGTGCCACCGGGAGCGGAGTGTACGAGCAGTACTTC	CATGSGVYEQYF	TRBV24-1	TRBJ2-7
TGTGCCAGCAGCTTGGGAGTATGTCCGGCGTGTCTCCCAAGTTACGAGCAGTACTTC	CASSLGVCPACLPSYEQYF	TRBV5-6	TRBJ2-7
TGCGCCAGCAGCCAAGAGGAGGGACTAGCGGGCAGGCTAGAGACCCAGTACTTC	CASSQEEGLAGRLETQYF	TRBV4-1	TRBJ2-5
TGTGCCAGCAGCTCCCGTGGGGATGAGCAGTTCTTC	CASSSRGDEQFF	TRBV7-3	TRBJ2-1
TGTGCCAGCAGCTTAGGACAGTTAAGGTTGGGCACCGGGGAGCTGTTTTTT	CASSLGQLRLGTGELFF	TRBV7-3	TRBJ2-2
TGCAGTGCTAGAGATCTGAGGGGACCCTCCTACAATGAGCAGTTCTTC	CSARDLRGPSYNEQFF	TRBV20-1	TRBJ2-1
TGTGCCAGCAGCTTAAGGCCGAGGGGCTCAAGCTCCTACGAGCAGTACTTC	CASSLRPRGSSSYEQYF	TRBV7-7	TRBJ2-7
TGTGCTCGGACTAGGATAACCTCCTACGAGCAGTACTTC	CARTRITSYEQYF	TRBV7-7	TRBJ2-7
TGTGCCAGCCCTTCCGGGACAGATTACACTGAAGCTTTCTTT	CASPSGTDYTEAFF	TRBV5-8	TRBJ1-1
TGTGCCAGCAGCTTAGGGACGGTGGAGGAGGAGGATAATTCACCCCTCCACTTT	CASSLGTVEEEDNSPLHF	TRBV11-3	TRBJ1-6
TGCGCCAGCAGTGACCCCACGGAAAAACTGTTTTTT	CASSDPTEKLFF	TRBV10-1	TRBJ1-4
TGCGCCAGCAGCCAAGATGGCGGGCCTCCGCACTACAATGAGCAGTTCTTC	CASSQDGGPPHYNEQFF	TRBV4-3	TRBJ2-1
TGCGCCAGCAGCCAAGCCCTCTTGGGACAGGGAGGCACTGAAGCTTTCTTT	CASSQALLGQGGTEAFF	TRBV4-3	TRBJ1-1
TGTGCCAGCAGCAGTGGGGGGGCGGGGATGAACACTGAAGCTTTCTTT	CASSSGGAGMNTEAFF	TRBV7-3	TRBJ1-1
TGTGCCAGCAGTTTAGACATGCAGGGTGAGCAGTACTTC	CASSLDMQGEQYF	TRBV12-4	TRBJ2-7
TGCGCCAGCAGCCAACCTACAGGGGCCGGGTCTAGCTCCTACGAGCAGTACTTC	CASSQPTGAGSSSYEQYF	TRBV4-1	TRBJ2-7
TGTGCCAGCAGCTTATTTCCGGGGGACAGACGCACGCACACTGAAGCTTTCTTT	CASSLFPGDRRTHTEAFF	TRBV11-3	TRBJ1-1
TGTGCCAGCAATCTGAGACCGGCGGGCGAGCAGTACTTC	CASNLRPAGEQYF	TRBV6-2	TRBJ2-7
TGTGCCACCACGGGCGGAGCTAACTATGGCTACACCTTC	CATTGGANYGYTF	TRBV24-1	TRBJ1-2
TGTGCCAGCAGAGTGCTCCTGGGGTACGAGCAGTACTTC	CASRVLLGYEQYF	TRBV6-3	TRBJ2-7
TGTGCCAGCAGCTTAGAGACAGGGGGCGGTTACGAGCAGTACTTC	CASSLETGGGYEQYF	TRBV7-9	TRBJ2-7
TGTGCCAGCAGGCACTGGACTACCCAAGAGACCCAGTACTTC	CASRHWTTQETQYF	TRBV14	TRBJ2-5
TGTGCCAGCAGCTTGGCCGTCAGAGTGTACTTC	CASSLAVRVYF	TRBV5-4	TRBJ2-5
TGCGCCAGCAGCCTTACTAGCGGGAGACCCGCAGATACGCAGTATTTT	CASSLTSGRPADTQYF	TRBV5-1	TRBJ2-3
TGTGCCGCCGGGAGGGAGCATGAGCAGTTCTTC	CAAGREHEQFF	TRBV24-1	TRBJ2-1
TGTGCCAGCATTGGGGGAAACACCATATATTTT	CASIGGNTIYF	TRBV25-1	TRBJ1-3
TGTGCCAGCGAGGGAAGGGTGGAAGACACCGGGGAGCTGTTTTTT	CASEGRVEDTGELFF	TRBV9	TRBJ2-2
TGTGCCAGCAGCCCCCAGGGAGACACTTACTCTGGGGCCAACGTCCTGACTTTC	CASSPQGDTYSGANVLTF	TRBV13	TRBJ2-6
TGCAGTGCTAGCTGGGACAGGAACACTGAAGCTTTCTTT	CSASWDRNTEAFF	TRBV20-1	TRBJ1-1
TGCAGTGCTAGAAGGGGATACGAGCAGTACTTC	CSARRGYEQYF	TRBV20-1	TRBJ2-7
TGTGCCAGCAGCATAACAGGGCGGGGGAGCCCCCGGAGGAACTATGGCTACACCTTC	CASSITGRGSPRRNYGYTF	TRBV13	TRBJ1-2
TGTGCCAGCAGCGTTCGGGACAGGGGGGATACGCAGTATTTT	CASSVRDRGDTQYF	TRBV7-3	TRBJ2-3
TGCAGTGCAGAGAGTCGACTAGCGCTAGCCGGGGAGCTGTTTTTT	CSAESRLALAGELFF	TRBV20-1	TRBJ2-2
TGCGCCAGCAGCTTGGGGGGGTCGGGACAGGGCGTTAAGCTTTATGGCTACACCTTC	CASSLGGSGQGVKLYGYTF	TRBV5-1	TRBJ1-2
TGTGCCAGCAGTTTAGAACCGGACAGGGCGGACGGCTATGGCTACACCTTC	CASSLEPDRADGYGYTF	TRBV28	TRBJ1-2
TGTGCCAGCACTTGGGGACATGAGCCCCTCCACTTT	CASTWGHEPLHF	TRBV6-5	TRBJ1-6
TGTGCCAGCAGCCCTCCGGGACAGGGGTTAAAGACCGGGGAGCTGTTTTTT	CASSPPGQGLKTGELFF	TRBV7-3	TRBJ2-2
TGTGCCAGCAGTTTGTCCACGACAGGCGATGGGGAACTTGAAAAACTGTTTTTT	CASSLSTTGDGELEKLFF	TRBV12-3	TRBJ1-4
TGCGCCAGCATTAGGTCCCGGGGGGGAGATGAGCAGTTCTTC	CASIRSRGGDEQFF	TRBV5-1	TRBJ2-1
TGTGCCAGCAGCCCGGGGGCGGGGGGAACTGAAAAACTGTTTTTT	CASSPGAGGTEKLFF	TRBV16	TRBJ1-4
TGCAGTCACAGGACAGCTGGTAATGAAAAACTGTTTTTT	CSHRTAGNEKLFF	TRBV20-1	TRBJ1-4
TGTGCCAGCAGCAGGGGGATAGTAGGCTATGGCTACACCTTC	CASSRGIVGYGYTF	TRBV6-4	TRBJ1-2
TGCGCCAGCAGCGAGAGGGGGCGCTCCTACGAGCAGTACTTC	CASSERGRSYEQYF	TRBV5-1	TRBJ2-7
TGCGCCAGCAGTGAGCCGGAAGAGTACAATGAGCAGTTCTTC	CASSEPEEYNEQFF	TRBV10-1	TRBJ2-1
TGTGCCAGCAGCCAAGAGGGGATACATAGCGTCACAGATACGCAGTATTTT	CASSQEGIHSVTDTQYF	TRBV14	TRBJ2-3
TGCGCCAGCAGCTTGAGGGGCATCGACTATGGCTACACCTTC	CASSLRGIDYGYTF	TRBV5-1	TRBJ1-2
TGTGCCAGCAAGAAGGGGGCACGGGAACCCCAAGAGACCCAGTACTTC	CASKKGAREPQETQYF	TRBV6-1	TRBJ2-5
TGTGCCACCAGTGATGACCACGGCTACAAAAACATTCAGTACTTC	CATSDDHGYKNIQYF	TRBV24-1	TRBJ2-4
TGTGCCAGCAGCCTTAGGGCAGCTAACTTT	CASSLRAANF	TRBV27	TRBJ1-1
TGTGCCAGCAGCCAAGGAAACGCCCAGCCAGACAGAGTCTGGAACACTGAAGCTTTCTTT	CASSQGNAQPDRVWNTEAFF	TRBV14	TRBJ1-1
TGCAGTGCCACCTGTGGATATAGCAATCAGCCCCAGCATTTT	CSATCGYSNQPQHF	TRBV20-1	TRBJ1-5
TGTGCCAGCAGCTCGGTCGGGGCTAACTATGGCTACACCTTC	CASSSVGANYGYTF	TRBV7-7	TRBJ1-2
TGCAGTGCTAGAGATCTAAAGAAACCACAGGGGCGCTCCTACGAGCAGTACTTC	CSARDLKKPQGRSYEQYF	TRBV20-1	TRBJ2-7
TGTCCGGGGGGGGAGAACGAGCAGTACTTC	CPGGENEQYF	TRBV7-9	TRBJ2-7
TGTGCCAGCAGCGTAGGAGGGGGCTTATTCTATGGCTACACCTTC	CASSVGGGLFYGYTF	TRBV9	TRBJ1-2
TGTGCCCTAGCCTACAATGAGCAGTTCTTC	CALAYNEQFF	TRBV19	TRBJ2-1
TGTGCCAGTTTTTATGAGGGGGCGCTCTATGGCTACACCTTC	CASFYEGALYGYTF	TRBV19	TRBJ1-2
TGCGCCAGCAGCCAAAAGGTCGCAACGGGGACAGGGGGGGTACAGATGCATGGCTACACCTTC	CASSQKVATGTGGVQMHGYTF	TRBV4-1	TRBJ1-2
TGCAGTGCCTTCTTCCCGGGGGTGTTAAACGGGGCAGCTCTGAACACTGAAGCTTTCTTT	CSAFFPGVLNGAALNTEAFF	TRBV20-1	TRBJ1-1
TGTGCCAGCCCTGGTAGCAATCAGCCCCAGCATTTT	CASPGSNQPQHF	TRBV14	TRBJ1-5
TGCGCCAGCAGTGAGCACTGGACCAGACAGGGAGGAAACATTCAGTACTTC	CASSEHWTRQGGNIQYF	TRBV10-2	TRBJ2-4
TGCAGTGCTAGCCAGACAGGGTTTGAAAAACTGTTTTTT	CSASQTGFEKLFF	TRBV20-1	TRBJ1-4
TGTGCCAGCAGCCAAGATCGTCCGACAGGGGGTCGATCTTCCAACTCGGATACGCAGTATTTT	CASSQDRPTGGRSSNSDTQYF	TRBV14	TRBJ2-3
TGCAGTGCCCCCAGGGACAGTCTTTGCAATCAGCCCCAGCATTTT	CSAPRDSLCNQPQHF	TRBV20-1	TRBJ1-5
TGTGCCACGAAGGGGCGCATGAACACTGAAGCTTTCTTT	CATKGRMNTEAFF	TRBV7-6	TRBJ1-1
TGTGCCATCAGAGTACCCAGGTGCACAGATACGCAGTATTTT	CAIRVPRCTDTQYF	TRBV10-3	TRBJ2-3
TGTGCCTGGAGTCGCGGACAGACACCAAATCAGCCCCAGCATTTT	CAWSRGQTPNQPQHF	TRBV30	TRBJ1-5
TGTGCCAGCAGTGACGGGATGGTCGCCCAGCATTTT	CASSDGMVAQHF	TRBV6-4	TRBJ1-5
TGCGCCAGCAGCTTGGCAGGAGGACGAACTGGGAACACTGAAGCTTTCTTT	CASSLAGGRTGNTEAFF	TRBV5-1	TRBJ1-1
TGCAGTGCTAGAGTTACCGGGACAGGGTACGAGCAGTACTTC	CSARVTGTGYEQYF	TRBV20-1	TRBJ2-7
TGTGCCAGCAGCTCACCCCCAGAATCAACTGAAGCTTTCTTT	CASSSPPESTEAFF	TRBV7-2	TRBJ1-1
TGTGCCACCACACCTCCCGGACTAGCGGGTTTCACAGATACGCAGTATTTT	CATTPPGLAGFTDTQYF	TRBV24-1	TRBJ2-3
TGCAGTGCTGGGGGGGCCGGGTTTAACTATGGCTACACCTTC	CSAGGAGFNYGYTF	TRBV20-1	TRBJ1-2
TGTGCCTGGACCGGGACAGGGGGTGCCTGGCCCTATGGCTACACCTTC	CAWTGTGGAWPYGYTF	TRBV30	TRBJ1-2
TGTGCCAGCAGCTTGCCCACTTCTGTCTGGAGCAATCAGCCCCAGCATTTT	CASSLPTSVWSNQPQHF	TRBV5-4	TRBJ1-5
TGTGCCAGTAGTCCCCCGATCGAGACCCAGTACTTC	CASSPPIETQYF	TRBV19	TRBJ2-5
TGTGCCAGCAGCTTACTCCGGGACGGAAGTTTAGGGAACACTGAAGCTTTCTTT	CASSLLRDGSLGNTEAFF	TRBV11-2	TRBJ1-1
TGTGCTAGCAGCCTCAGGTGGTCCTATAATTCACCCCTCCACTTT	CASSLRWSYNSPLHF	TRBV7-7	TRBJ1-6
TGCGCCAGCAGTGAGGCGGACATAAATGAGCAGTTCTTC	CASSEADINEQFF	TRBV10-2	TRBJ2-1
TGTGCCAGCCCGCGGGCCGGCTACACCTTC	CASPRAGYTF	TRBV6-5	TRBJ1-2
TGTGCCAGCAGCTTAGCACAGAGAGACAATGAGCAGTTCTTC	CASSLAQRDNEQFF	TRBV13	TRBJ2-1
TGTGCCGTCCTAGCGGGTTCCAAGAGAAGGAACACCGGGGAGCTGTTTTTT	CAVLAGSKRRNTGELFF	TRBV27	TRBJ2-2
TGTGCCAGCAGCCAAGGCCCGAGATGTCTCGGGGAGCTGTTTTTT	CASSQGPRCLGELFF	TRBV3-1	TRBJ2-2
TGTGCCAGCAGCGTAGTCGGACTATTGCATGAGCAGTTCTTC	CASSVVGLLHEQFF	TRBV9	TRBJ2-1
TGTGCCAGCAGCAGTCTGGCCGAGAATGAGCAGTTCTTC	CASSSLAENEQFF	TRBV9	TRBJ2-1
TGTGCCAGCAGCCAAGCCCGGATCGCTTGGACAGGGAATGGACCTGTCGGCTCCTACGAGCAGTACTTC	CASSQARIAWTGNGPVGSYEQYF	TRBV3-1	TRBJ2-7
TGTGCCAGCAGTTGCGGGAGCTCTGGAAACACCATATATTTT	CASSCGSSGNTIYF	TRBV5-4	TRBJ1-3
TGTGCCAGTACCACCGGAAACGAGCAGTACTTC	CASTTGNEQYF	TRBV19	TRBJ2-7
TGTGCCAGCTCCAGGTATAACTCCAGGGGATTTGCTTTCTTT	CASSRYNSRGFAFF	TRBV18	TRBJ1-1
TGTGCCAGCAGCAGGTCAGGCAGGGGGCGTGAAAAACTGTTTTTT	CASSRSGRGREKLFF	TRBV11-1	TRBJ1-4
TGTGCCAGCAGGGGGGCCTATAATTCACCCCTCCACTTT	CASRGAYNSPLHF	TRBV6-6	TRBJ1-6
TGTGCCAGCAGTCCATGTAGCAATCAGCCCCAGCATTTT	CASSPCSNQPQHF	TRBV6-1	TRBJ1-5
TGTGCCAGCAGCCGGGACCCTTTTGAAAAACTGTTTTTT	CASSRDPFEKLFF	TRBV5-6	TRBJ1-4
TGTGCCAGCAGCCTTAGCAGGGATAGCAATCAGCCCCAGCATTTT	CASSLSRDSNQPQHF	TRBV7-3	TRBJ1-5
TGTGCCAGCAGCGGCATTTGGGTTATGGAGACCCAGTACTTC	CASSGIWVMETQYF	TRBV11-3	TRBJ2-5
TGTGCCAGCAGCCGGGACAGGGCCAGCTATAATTCACCCCTCCACTTT	CASSRDRASYNSPLHF	TRBV5-4	TRBJ1-6
TGCAGCGTTGACTCGGCTCCGCCGGGAGATACGCAGTATTTT	CSVDSAPPGDTQYF	TRBV29-1	TRBJ2-3
TGTGCCAGCAGTTACCCTCTCCGGACCGATCCCTATAATTCACCCCTCCACTTT	CASSYPLRTDPYNSPLHF	TRBV6-5	TRBJ1-6
TGTGCCATCAGTGAGTATCCGGGGACTAGCGGCTCCTACAATGAGCAGTTCTTC	CAISEYPGTSGSYNEQFF	TRBV10-3	TRBJ2-1
TGTGCCAGCAGCGGGTCTAGCGGGTCTAACACCGGGGAGCTGTTTTTT	CASSGSSGSNTGELFF	TRBV7-3	TRBJ2-2
TGTGCCAGCAGTTTGAAAGACAGTGTGGCTGGTCCGGATACGCAGTATTTT	CASSLKDSVAGPDTQYF	TRBV12-4	TRBJ2-3
TGTGCCAGTAGTTCCCGGGTTGACCAAGAGACCCAGTACTTC	CASSSRVDQETQYF	TRBV19	TRBJ2-5
TGTGCCAGCAGCGACAGGGTACAGCCCCAGCATTTT	CASSDRVQPQHF	TRBV7-7	TRBJ1-5
TGTGCCAGCGGTACTGGCGGGCCTAATCAGCCCCAGCATTTT	CASGTGGPNQPQHF	TRBV6-1	TRBJ1-5
TGTGCCTGGTGCAGGCGGTCCCGGAATTCACCCCTCCACTTT	CAWCRRSRNSPLHF	TRBV30	TRBJ1-6
TGCGCCATCTCGACCGCTACGGGGGGGGGCTACTATGGCTACACCTTC	CAISTATGGGYYGYTF	TRBV10-2	TRBJ1-2
TGTGCCGGGTATCCCGGACATCAGCCCCAGCATTTT	CAGYPGHQPQHF	TRBV19	TRBJ1-5
TGTGCCACCAGTGAGGATCTCCCCACAGGGGGTCCGAACACTGAAGCTTTCTTT	CATSEDLPTGGPNTEAFF	TRBV24-1	TRBJ1-1
TGTGCCAGCAGAATCGTCACAGGGGCTTCCTACGAGCAGTACTTC	CASRIVTGASYEQYF	TRBV7-8	TRBJ2-7
TGTGCCAGCTCACCCTCAGCGGGATTCAATCAGCCCCAGCATTTT	CASSPSAGFNQPQHF	TRBV18	TRBJ1-5
TGCGCCAGCGCTCTCCGAGACACAGGGAGGTCTCACACTGAAGCTTTCTTT	CASALRDTGRSHTEAFF	TRBV10-1	TRBJ1-1
TGTGCCACCAGTGATTTATCGTGGACAGCAGATGGCTACACCTTC	CATSDLSWTADGYTF	TRBV24-1	TRBJ1-2
TGTGCCAGCAGTGGGGGCAGGTGTTACGAGCAGTACTTC	CASSGGRCYEQYF	TRBV6-4	TRBJ2-7
TGCAGTGCTAGAAACAGGGATGGCTACACCTTC	CSARNRDGYTF	TRBV20-1	TRBJ1-2
TGTGCCAGCAGTGCGGGGGTGGAGGGGCTGTGTCAGTATGGCTACACCTTC	CASSAGVEGLCQYGYTF	TRBV6-5	TRBJ1-2
TGTGCCATCAGTGTCGCCCGGGACAGCTACAATGAGCAGTTCTTC	CAISVARDSYNEQFF	TRBV10-3	TRBJ2-1
TGTGCCAGCAGCTCGACGGGGGCCAACGTCCTGACTTTC	CASSSTGANVLTF	TRBV27	TRBJ2-6
TGCGCCAGCAGCTTGACAGGGGTCTCGGAAAAACTGTTTTTT	CASSLTGVSEKLFF	TRBV5-1	TRBJ1-4
TGTGCCAGCAGTGAGTCGGGGGGGGGTTACGAGCAGTACTTC	CASSESGGGYEQYF	TRBV6-1	TRBJ2-7
TGTGCCAGCAGCTTGCTTCCAGCTACCGGTTCGGGAATTGAGCAGTTCTTC	CASSLLPATGSGIEQFF	TRBV5-4	TRBJ2-1
TGTGCCAGCAGCAACAGAGAGCCAACTGAAGCTTTCTTT	CASSNREPTEAFF	TRBV13	TRBJ1-1
TGTGCCACCCTCACGGAAAAGAAGCCGGGGGCAACTAATGAAAAACTGTTTTTT	CATLTEKKPGATNEKLFF	TRBV24-1	TRBJ1-4
TGTGCCAGCCTTCCGGAGTCCCTAGCCAAAAACATTCAGTACTTC	CASLPESLAKNIQYF	TRBV2	TRBJ2-4
TGTGCCAGCAGCGGCACTAGCGGGAGAAGGTCCTACGAGCAGTACTTC	CASSGTSGRRSYEQYF	TRBV7-3	TRBJ2-7
TGCAGCGTTGGGCCCGAGGGACAGGGGGGGGATAGCAATCAGCCCCAGCATTTT	CSVGPEGQGGDSNQPQHF	TRBV29-1	TRBJ1-5
TGTGCCAGCAGTGCCGGTCCACTAGCGGGAGATGACTACGAGCAGTACTTC	CASSAGPLAGDDYEQYF	TRBV6-1	TRBJ2-7
TGTGCCAGCAGCCGAAGGAACGACAGGTCCCTCACTGAAGCTTTCTTT	CASSRRNDRSLTEAFF	TRBV9	TRBJ1-1
TGCAGTGCTAGAACCCACAGGGGCTATGGCTACACCTTC	CSARTHRGYGYTF	TRBV20-1	TRBJ1-2
TGTGCCAGCAGTTGGGCCCGACAGGGCGCGGCGCCCTTGAACACTGAAGCTTTCTTT	CASSWARQGAAPLNTEAFF	TRBV6-9	TRBJ1-1
TGCGCCAGCAGCCAAGATGACGCTTACTCCTACGAGCAGTACTTC	CASSQDDAYSYEQYF	TRBV4-3	TRBJ2-7
TGTGCCCGCGCACGGAGCACAGATACGCAGTATTTT	CARARSTDTQYF	TRBV6-2	TRBJ2-3
TGTGCCAGCAGCTTGGGGACCCGGGACAGGGATCGAGGTGAAAAACTGTTTTTT	CASSLGTRDRDRGEKLFF	TRBV5-6	TRBJ1-4
TGTGCCACCAGTTTGAGGGTGTCAGATACGCAGTATTTT	CATSLRVSDTQYF	TRBV24-1	TRBJ2-3
TGCGCCAGCATCGCCGGGTACGAGCAGTACTTC	CASIAGYEQYF	TRBV10-1	TRBJ2-7
TGTGCCACCAGTGATTCGGCCGGGGAGCAAGCCTACGAGCAGTACTTC	CATSDSAGEQAYEQYF	TRBV24-1	TRBJ2-7
TGTGCCAGCAGCTGGGATGGGGATCGTGCCGGGGAGCTGTTTTTT	CASSWDGDRAGELFF	TRBV11-2	TRBJ2-2
TGTGCCAGCAGCCAAGGTTTGGGACTAGGTTTGTCCTACGAGCAGTACTTC	CASSQGLGLGLSYEQYF	TRBV3-1	TRBJ2-7
TGTGCCAGCTCGACGAGAGACACTGAAGCTTTCTTT	CASSTRDTEAFF	TRBV28	TRBJ1-1
TGCGCCAGCAGCCAAACCCCTAGGTTAGCTGGCGGAGATACGCAGTATTTT	CASSQTPRLAGGDTQYF	TRBV4-1	TRBJ2-3
TGTGCCAGCAGAGGGGGCAGTGGGACAATTATAGGGTATGGCTACACCTTC	CASRGGSGTIIGYGYTF	TRBV6-5	TRBJ1-2
TGTGCCAGCAGTTACAAAGGAGACAGGGAGGAAAATCAGCCCCAGCATTTT	CASSYKGDREENQPQHF	TRBV6-3	TRBJ1-5
TGTGCTAGTGGTTTGAAGAGCCGACCGTTTTGCAAAAACATTCAGTACTTC	CASGLKSRPFCKNIQYF	TRBV12-5	TRBJ2-4
TGTGCCACCGCGGGGAGCGGGAATGGGTCCTCTGGCTTC	CATAGSGNGSSGF	TRBV24-1	TRBJ1-2
TGTGCCAGCAGTGGAGCCCGGGTGTTAGTCCTTAACCCCTTAAACACTGAAGCTTTCTTT	CASSGARVLVLNPLNTEAFF	TRBV28	TRBJ1-1
TGTGCCAGCAGCTTAGTCTTATCTGGGACGTACTTC	CASSLVLSGTYF	TRBV11-3	TRBJ2-5
TGCAGTGCTAGAGCACCCCAAGGACTTGCCACCGGGGAGCTGTTTTTT	CSARAPQGLATGELFF	TRBV20-1	TRBJ2-2
TGTGCCTGGAGTGGTATAAATTGGGGGGGACACACGGACCTCTATGGCTACACCTTC	CAWSGINWGGHTDLYGYTF	TRBV30	TRBJ1-2
TGTGCCAGCAGCCCGGGGGGGAAAGAGACCCAGTACTTC	CASSPGGKETQYF	TRBV11-3	TRBJ2-5
TGTGCCACCAGCAGTGTGGACAGGGCGGGGCATTATAGCAATCAGCCCCAGCATTTT	CATSSVDRAGHYSNQPQHF	TRBV15	TRBJ1-5
TGTGCCAGGGTCCCCGGGACTAGCGGGGGGGCCCGAACTAGCACAGATACGCAGTATTTT	CARVPGTSGGARTSTDTQYF	TRBV6-3	TRBJ2-3
TGTGCCAAACCATCGGGACACTACGAGCAGTACTTC	CAKPSGHYEQYF	TRBV28	TRBJ2-7
TGTGCCAGCAGCGCTCCACAGGGCGGAAGCTATGGCTACACCTTC	CASSAPQGGSYGYTF	TRBV9	TRBJ1-2
TGTGCCATCAGATATCGGCGGGCGGTGCCCTACGAGCAGTACTTC	CAIRYRRAVPYEQYF	TRBV10-3	TRBJ2-7
TGCAGTGCTAGAGACACAGCAGGGAACTATGGCTACACCTTC	CSARDTAGNYGYTF	TRBV20-1	TRBJ1-2
TGTGCCAGCTCACCACCGAGCGGCGGGGGGGAGGAGCAGTACTTC	CASSPPSGGGEEQYF	TRBV18	TRBJ2-7
TGTGCCAGCAGCGTAGCCTCTCTGGGGGCGGGCCCTGAAGCTTTCTTT	CASSVASLGAGPEAFF	TRBV9	TRBJ1-1
TGTGCCAGCAGCATCAGGGACTATGGCTACACCTTC	CASSIRDYGYTF	TRBV7-9	TRBJ1-2
TGTGCCAGCAGTGCGGACTGGGCCTTCTCCGGCTACGAGCAGTACTTC	CASSADWAFSGYEQYF	TRBV6-1	TRBJ2-7
TGTGCCATCAAAGCGGGATACGAGCAGTACTTC	CAIKAGYEQYF	TRBV10-3	TRBJ2-7
TGTGCCAGCAAGCCTAACGGCTTGGGGGGCTACGAGCAGTACTTC	CASKPNGLGGYEQYF	TRBV6-1	TRBJ2-7
TGTGCCAGCAGCCAGACAGGGCAGAACACCGGGGAGCTGTTTTTT	CASSQTGQNTGELFF	TRBV5-5	TRBJ2-2
TGTGCCAGATGGGACAGGGGGCTAACACAAGAGACCCAGTACTTC	CARWDRGLTQETQYF	TRBV27	TRBJ2-5
TGTGCCTCGGAGTTCCCTTTGACTAGCTCCTACAATGAGCAGTTCTTC	CASEFPLTSSYNEQFF	TRBV28	TRBJ2-1
TGTGCCACCAGTGTAATTCCCGGGACAGGGCTAATCAATCAGCCCCAGCATTTT	CATSVIPGTGLINQPQHF	TRBV24-1	TRBJ1-5
TGCGCCAGCAGCTGGGGGCCCCAAGAGACCCAGTACTTC	CASSWGPQETQYF	TRBV5-1	TRBJ2-5
TGCGCCAGCAGCTTGTTACAGTCAGGGGGCGCACTATCACCCCTCCACTTT	CASSLLQSGGALSPLHF	TRBV5-1	TRBJ1-6
TGTGCCAGCAGCTTAACCCAGGAATCTAGCGGAAACTACGAGCAGTACTTC	CASSLTQESSGNYEQYF	TRBV7-3	TRBJ2-7
TGCGCCAGCAGATGGACACCCTACACCTTC	CASRWTPYTF	TRBV10-1	TRBJ1-2
TGTGCCAGAGCGGGACAGGGATCGGAGCAGTACTTC	CARAGQGSEQYF	TRBV11-3	TRBJ2-7
TGTGCCAGCAGCTCCGGGGCGGGACAGGACTATGGCTACACCTTC	CASSSGAGQDYGYTF	TRBV5-6	TRBJ1-2
TGTGCCAGTATCCGAACCGGGACAGGACAGTGGGAACAGCCCCAGCATTTT	CASIRTGTGQWEQPQHF	TRBV19	TRBJ1-5
TGCAGTTTTCCCGACAGGGGGGACTATGGCTACACCTTC	CSFPDRGDYGYTF	TRBV20-1	TRBJ1-2
TGTGCCAGCAGTGAAGCAGCAGTAGAGTACAGACAGGGGGCCCAAAGGAATCAGCCCCAGCATTTT	CASSEAAVEYRQGAQRNQPQHF	TRBV6-1	TRBJ1-5
TGTGCCAGCAGCCAAGCACCAAGCGGACTGATCAATGAAAAACTGTTTTTT	CASSQAPSGLINEKLFF	TRBV3-1	TRBJ1-4
TGTGCCAGCAGCCCAGAGCCTGACTGGGCCTACGAGCAGTACTTC	CASSPEPDWAYEQYF	TRBV7-4	TRBJ2-7
TGTGCCAGCAGCATCACGCCACAGGGAATTCCCCATCGGAAAGCTTTCTTT	CASSITPQGIPHRKAFF	TRBV7-8	TRBJ1-1
TGTGCCAGCAGCTTAGATAGACACGGGGGGGGCCAAGAGACCCAGTACTTC	CASSLDRHGGGQETQYF	TRBV11-2	TRBJ2-5
TGTGCCGATAGACAGGTGTCAAACACTGAAGCTTTCTTT	CADRQVSNTEAFF	TRBV11-2	TRBJ1-1
TGCGCCAGCAGCTATCCACTAGCGGGAGGACTCTACGAGCAGTACTTC	CASSYPLAGGLYEQYF	TRBV4-1	TRBJ2-7
TGTAAGGTCGCGGGACAGGGCCTTTCTGAAGCTTTCTTT	CKVAGQGLSEAFF	TRBV29-1	TRBJ1-1
TGTGCCAGCTCACCACCATGGGACAGGGATCGGGGCAATGAGCAGTTCTTC	CASSPPWDRDRGNEQFF	TRBV18	TRBJ2-1
TGTGCCAGCAGCCTGTATCCGGGGGGGGAGTCCTTATTACCCTACGAGCAGTACTTC	CASSLYPGGESLLPYEQYF	TRBV14	TRBJ2-7
TGTGCCAGCAGCTGGTCGGACAGGGACGGGAACTCCTACGAGCAGTACTTC	CASSWSDRDGNSYEQYF	TRBV7-3	TRBJ2-7
TGCGCCAGCAGCGCGGGTCATTCATTCTTC	CASSAGHSFF	TRBV5-1	TRBJ2-1
TGCGCCAGCAGCTTGGTGTCTAGCGGGCGTGTATCAATTCAGTACTTC	CASSLVSSGRVSIQYF	TRBV5-1	TRBJ2-4
TGTGCCAGCACGTTATTGGGGGGGCAGCCCCAGCATTTT	CASTLLGGQPQHF	TRBV9	TRBJ1-5
TGTGCCATAGCATTAGGGAGAAATGGGGAGCTGTTTTTT	CAIALGRNGELFF	TRBV12-4	TRBJ2-2
TGTGCCAGCAGTGGGAGGAAAGCCCCCTATGGCTACACCTTC	CASSGRKAPYGYTF	TRBV6-6	TRBJ1-2
TGCAGTGCTCGGGGAGGAAACACCATATATTTT	CSARGGNTIYF	TRBV20-1	TRBJ1-3
TGTGCCAGCAGCGTAGAAAGACAGTACTTC	CASSVERQYF	TRBV9	TRBJ2-5
TGTGCCAGCAGCCAAGATGCTTCCCCCCGGGACAGAGATCAGCCCCAGCATTTT	CASSQDASPRDRDQPQHF	TRBV14	TRBJ1-5
TGCAGTGCTAGAGAGAGGACTAGCCGGGAGGGCACAGATACGCAGTATTTT	CSARERTSREGTDTQYF	TRBV20-1	TRBJ2-3
TGTGCCAGCAGTATCAGGGGGACTGAAGCTTTCTTT	CASSIRGTEAFF	TRBV6-2	TRBJ1-1
TGTGCCAGCATTGGGACTAGCGGCACGCAGTATTTT	CASIGTSGTQYF	TRBV12-4	TRBJ2-3
TGTGCCAGCAGTTACAAGGGACCGCAGAACACTGAAGCTTTCTTT	CASSYKGPQNTEAFF	TRBV6-5	TRBJ1-1
TGTGCCAGCAGCCAAGATAGGTGCATGGTGACTGAAGCTTTCTTT	CASSQDRCMVTEAFF	TRBV3-1	TRBJ1-1
TGTGCCAGCAGCTTAGACCCCCTCGTCGCGGCAGATACGCAGTATTTT	CASSLDPLVAADTQYF	TRBV7-2	TRBJ2-3
TGTGCCAGCAGCCTTTCGGGACAGATTTCACAGAACACTGAAGCTTTCTTT	CASSLSGQISQNTEAFF	TRBV7-4	TRBJ1-1
TGTGCCAGCAGTGATTTTATGTCTAGCACAGATACGCAGTATTTT	CASSDFMSSTDTQYF	TRBV6-4	TRBJ2-3
TGTGCCAGCATATCGCTGGGCCATAACACTGAAGCTTTCTTT	CASISLGHNTEAFF	TRBV6-1	TRBJ1-1
TGTGCCAGTTGGGGGCAGGAACTCAAAAACATTCAGTACTTC	CASWGQELKNIQYF	TRBV7-3	TRBJ2-4
TGTGCCAGCATCTGGGGGGGACGCTATGGCTACACCTTC	CASIWGGRYGYTF	TRBV7-9	TRBJ1-2
TGCAGTGCCCAGGGGGTGTACGAGCAGTACTTC	CSAQGVYEQYF	TRBV20-1	TRBJ2-7
TGTGCCAGCAGCAAAAGGGGGGGAGGGCATGAGAGGCCCCAGCATTTT	CASSKRGGGHERPQHF	TRBV7-4	TRBJ1-5
TGTGCCAGCAGCAAGTTGAGTCAGCGGGACGTGAACACTGAAGCTTTCTTT	CASSKLSQRDVNTEAFF	TRBV5-6	TRBJ1-1
TGCGCCAGCAGCCAAGACCAGTTGGCACTCTGGCAAGAGACCCAGTACTTC	CASSQDQLALWQETQYF	TRBV4-3	TRBJ2-5
TGTGCCAGCAGCTTAAGTGCAGGGCATTCTGGAACTAATGAAAAACTGTTTTTT	CASSLSAGHSGTNEKLFF	TRBV7-2	TRBJ1-4
TGTGCCAGCAGTTTCGAACCGGAGACCCAGTACTTC	CASSFEPETQYF	TRBV27	TRBJ2-5
TGCGCCAGCGTTTCCCGATATGCGCGAAGGCAAGAGACCCAGTACTTC	CASVSRYARRQETQYF	TRBV5-1	TRBJ2-5
TGTGCCAGCACAAAGACAGCAAACGGCTACACCTTC	CASTKTANGYTF	TRBV6-1	TRBJ1-2
TGTGCTAGTGGTTTGGTACCCGTGTTGCGGAATCCCCCGTTTAGGGGGCATCATGAGCAGTTCTTC	CASGLVPVLRNPPFRGHHEQFF	TRBV12-5	TRBJ2-1
TGTGCCAGCAGGGACGGCTATTATGAGCAGTTCTTC	CASRDGYYEQFF	TRBV6-5	TRBJ2-1
TGTGCCAGCAGTGCACTACTCGGACAGGAATGCGGAAACACCATATATTTT	CASSALLGQECGNTIYF	TRBV2	TRBJ1-3
TGTGCCAGCAGTTTCGGATCGGGGGAAGATGAGACCCAGTACTTC	CASSFGSGEDETQYF	TRBV12-4	TRBJ2-5
TGTGCCAGCAGCCAAGATCCAATAGGGGGGGGCCGGGGGAAGGAGCAGTTCTTC	CASSQDPIGGGRGKEQFF	TRBV4-2	TRBJ2-1
TGTGCCAGCAGCCAAGAGAATCAGGGGACGGCCTATGGCTACACCTTC	CASSQENQGTAYGYTF	TRBV4-2	TRBJ1-2
TGTGCCAGCAGCGATCAGTTGATTCGCCACAATGAGCAGTTCTTC	CASSDQLIRHNEQFF	TRBV7-9	TRBJ2-1
TGTGCCATCAGTGATCAGCTAATTAACAATGAGCAGTTCTTC	CAISDQLINNEQFF	TRBV10-3	TRBJ2-1
TGTGCCAGCAGTGAGAGGGGGGGCGGGGGGGAGCTGTTTTTT	CASSERGGGGELFF	TRBV6-1	TRBJ2-2
TGTGCCAGCAGCCCCCTGGTAAGCGAGCAGTACTTC	CASSPLVSEQYF	TRBV7-4	TRBJ2-7
TGTGCCAGCAGCTTAGTTCGCGGACCTGGGGCCAACGTCCTGACTTTC	CASSLVRGPGANVLTF	TRBV7-2	TRBJ2-6
TGCGCCAGCAGCCAACGGAGGGTCCAGCCCCAGCATTTT	CASSQRRVQPQHF	TRBV4-1	TRBJ1-5
TGTGCCACCCTATTTTCAGCAGATACGCAGTATTTT	CATLFSADTQYF	TRBV24-1	TRBJ2-3
TGTGCCAGCAGCGACAGGGCGGAGGTGACCCAGTACTTC	CASSDRAEVTQYF	TRBV7-8	TRBJ2-5
TGTGCTAGTGGAATAGGGGGGGCTGAAGCTTTCTTT	CASGIGGAEAFF	TRBV12-5	TRBJ1-1
TGTGCCAGCAGCACCGAAATATGTAAATGGGCCTACGAGCAGTACTTC	CASSTEICKWAYEQYF	TRBV7-9	TRBJ2-7
TGTGCCAGCAGAAAGGAGCGGGATGTCCACTACGAGCAGTACTTC	CASRKERDVHYEQYF	TRBV6-1	TRBJ2-7
TGTGCCAAGACTAGGCGGAGGGACAATGAGCAGTTCTTC	CAKTRRRDNEQFF	TRBV10-3	TRBJ2-1
TGTGCCAGCAGCTTAATCCGCTGGAGGGCCAGTCAGCCCCAGCATTTT	CASSLIRWRASQPQHF	TRBV7-9	TRBJ1-5
TGCAGTGCGTTGAAGAAGCGGTCCTACGAGCAGTACTTC	CSALKKRSYEQYF	TRBV20-1	TRBJ2-7
TGTGCCAGCAGCTTAGTTCCCTCGGGGTATCTCAATGAGCAGTTCTTC	CASSLVPSGYLNEQFF	TRBV7-9	TRBJ2-1
TGTGCCAGAAAGGGACAGGGTTGCTATGATAGCAATCAGCCCCAGCATTTT	CARKGQGCYDSNQPQHF	TRBV3-1	TRBJ1-5
TGTGCCAGCAGCTTAGAGGGGTTGAATCAGCCCCAGCATTTT	CASSLEGLNQPQHF	TRBV11-2	TRBJ1-5
TGTGCCAGCAGCTTAGGTAAAAGGAAATCCGGGACATTGCAATCCTACAATGAGCAGTTCTTC	CASSLGKRKSGTLQSYNEQFF	TRBV7-9	TRBJ2-1
TGTGCCAGCAGTGAACGCAACCCCACTAGCGGGCCGGAGACCCAGTACTTC	CASSERNPTSGPETQYF	TRBV6-1	TRBJ2-5
TGTGCCAGGCAGGGGGCAAAGGGAAGAGCCAAAAACATTCAGTACTTC	CARQGAKGRAKNIQYF	TRBV7-9	TRBJ2-4
TGCGCCAGCAGCCCCGGGACAGGAGGGGCCTACGAGCAGTACTTC	CASSPGTGGAYEQYF	TRBV5-1	TRBJ2-7
TGTGCCATCGTGCCGGGACGCTACGAGCAGTACTTC	CAIVPGRYEQYF	TRBV7-6	TRBJ2-7
TGCGCCAGCACAAGACTAGCATACTACAATGAGCAGTTCTTC	CASTRLAYYNEQFF	TRBV10-1	TRBJ2-1
TGTGCCACCATAGGCCGGGGACTCGAGACCCAGTACTTC	CATIGRGLETQYF	TRBV24-1	TRBJ2-5
TGTGCCACAAATCCGGGACAGGGGGCTTATGGCTACACCTTC	CATNPGQGAYGYTF	TRBV12-3	TRBJ1-2
TGTGCCAGCAGCTTAGGAAGTGGACAGGGCCTTTTTCAGCCCCAGCATTTT	CASSLGSGQGLFQPQHF	TRBV7-6	TRBJ1-5
TGTGCCAGCAGCCCTGACAGACTTGTTGCCCACGAGAACACTGAAGCTTTCTTT	CASSPDRLVAHENTEAFF	TRBV7-3	TRBJ1-1
TGTGCCAGCAGACCACTAGCTTCGGCCAATGAGCAGTTCTTC	CASRPLASANEQFF	TRBV6-4	TRBJ2-1
TGCAGTGCTAGAGATGTGCAGGGATCTAGGCAGCCCCAGCATTTT	CSARDVQGSRQPQHF	TRBV20-1	TRBJ1-5
TGTGCCAGCAGCGTTGTTTCACGGGACGTAAATGAGCAGTTCTTC	CASSVVSRDVNEQFF	TRBV13	TRBJ2-1
TGTGCCAGCAGTTTTCCCTGGGAGGGGAGCTCCTACGAGCAGTACTTC	CASSFPWEGSSYEQYF	TRBV28	TRBJ2-7
TGTGCCAGCAGCTCATACCTAACCCGGGACAGAGCGGTAGAAAAACTGTTTTTT	CASSSYLTRDRAVEKLFF	TRBV7-4	TRBJ1-4
TGCGCCGCAAGGCGCAGGGGGCTGGCAGAGACCCAGTACTTC	CAARRRGLAETQYF	TRBV5-1	TRBJ2-5
TGTGCCAGCAGCGTAGCCCTAGGGGGTCAAATGCAGCCCCAGCATTTT	CASSVALGGQMQPQHF	TRBV9	TRBJ1-5
TGTGCCTGGAGTGTAAAGTCCTACGAGCAGTACTTC	CAWSVKSYEQYF	TRBV30	TRBJ2-7
TGTGCCAGCAGCAAGGCCGGACAGGGGGGGAAGGGCACTGAAGCTTTCTTT	CASSKAGQGGKGTEAFF	TRBV7-3	TRBJ1-1
TGCGCCAGCAGCACTAGCGGCTACGAGCAGTACTTC	CASSTSGYEQYF	TRBV10-1	TRBJ2-7
TGTGCCAGCAGCTTAGAGCCGGGACAGGGCGATCAGCCCCAGCATTTT	CASSLEPGQGDQPQHF	TRBV5-4	TRBJ1-5
TGTGCCAGCTCACCATCTCGGGATAGGGACAGGGACTGCGGAAACACCATATATTTT	CASSPSRDRDRDCGNTIYF	TRBV18	TRBJ1-3
TGTGCCAGCAGTGACTCATCACCAGGGGGCTACGAGCAGTACTTC	CASSDSSPGGYEQYF	TRBV6-4	TRBJ2-7
TGTGCCAACGACCTCCGGGAATCCTACAATGAGCAGTTCTTC	CANDLRESYNEQFF	TRBV6-1	TRBJ2-1
TGTGCCAGCGTACGGGGGGATTACGAGCAGTACTTC	CASVRGDYEQYF	TRBV2	TRBJ2-7
TGTGCCAGCAGATCCCGGGCTAGCGGGGAGGACCGTCACAACTGCAGCGGGGAGCTGTTTTTT	CASRSRASGEDRHNCSGELFF	TRBV12-4	TRBJ2-2
TGTGCCAGCACCCGTACCAGGGGCTACGAGCAGTACTTC	CASTRTRGYEQYF	TRBV12-3	TRBJ2-7
TGCGCCATTTCGTCCCCGGGCCGAGACGAGCAGTACTTC	CAISSPGRDEQYF	TRBV5-1	TRBJ2-7
TGTGCCAGCAGTTTCTTATTAAAAGTCACAGATACGCAGTATTTT	CASSFLLKVTDTQYF	TRBV12-3	TRBJ2-3
TGTGCCAGCAAGATGACCTGTGTCCACTACGAGCAGTACTTC	CASKMTCVHYEQYF	TRBV2	TRBJ2-7
TGTGCCACCCCCGGGGGAGACACTGAAGCTTTCTTT	CATPGGDTEAFF	TRBV24-1	TRBJ1-1
TGTGCCAGCAGTGACGCCCGGGCCAGGAGCTACACTGAAGCTTTCTTT	CASSDARARSYTEAFF	TRBV25-1	TRBJ1-1
TGCAGTGCTAGTAATCGGGGGGGAAACTTC	CSASNRGGNF	TRBV20-1	TRBJ2-7
TGCAGCGTTGAACCGGGACTAGCGGGGGGTTCCTACGAGCAGTACTTC	CSVEPGLAGGSYEQYF	TRBV29-1	TRBJ2-7
TGCAGTGCGGGGTGGATTGAAGCTTTCTTT	CSAGWIEAFF	TRBV20-1	TRBJ1-1
TGTGCCAGCAGCCAAGATATGGGCCCGACAGAGGGGATCCACGAGCAGTACTTC	CASSQDMGPTEGIHEQYF	TRBV3-1	TRBJ2-7
TGTGCCAGCAGCCAATCCCAGCGGTCTTGCACAGATACGCAGTATTTT	CASSQSQRSCTDTQYF	TRBV3-1	TRBJ2-3
TGTGCCAGCAGCCAAGCTAAGCGGGAGATATACGAGCAGTACTTC	CASSQAKREIYEQYF	TRBV4-2	TRBJ2-7
TGCGCCAGCAGCGTCAGGGGAGGGGACTACGAGCAGTACTTC	CASSVRGGDYEQYF	TRBV5-1	TRBJ2-7
TGTGCCTGGACAGACAGGACCAACACCGGGGAGCTGTTTTTT	CAWTDRTNTGELFF	TRBV30	TRBJ2-2
TGTGCCAGCAGTTTATATCGAAGGGTAATTCCAACGACCGGGGAGCTGTTTTTT	CASSLYRRVIPTTGELFF	TRBV12-4	TRBJ2-2
TGTGCCTGGAGTGTTATAGGTCAGACTAGCGGGAGAGTAACAGGTTACGAGCAGTACTTC	CAWSVIGQTSGRVTGYEQYF	TRBV30	TRBJ2-7
TGTGCCAGCAGTTTACCGGTACTACTCGACAGTAGGCCATTAGGCTCCTACGAGCAGTACTTC	CASSLPVLLDSRPLGSYEQYF	TRBV28	TRBJ2-7
TGTGCCAGCAGTGATCGGGCGAATGAGCAGTTCTTC	CASSDRANEQFF	TRBV6-4	TRBJ2-1
TGTGCCACCAGTGATTGCCGGGACCGTCGGCATGGCTACACCTTC	CATSDCRDRRHGYTF	TRBV24-1	TRBJ1-2
TGCGCCAGCCATCATACAGGGGGGAATGAAAACAATGAGCAGTTCTTC	CASHHTGGNENNEQFF	TRBV5-1	TRBJ2-1
TGTGCCAGCAGCTTAGAAGGGAGGTCCCTCCACTTT	CASSLEGRSLHF	TRBV7-2	TRBJ1-6
TGTGCCAGCAGGGGGGAGAAACTTACTGAAGCTTTCTTT	CASRGEKLTEAFF	TRBV11-2	TRBJ1-1
TGTGCCAGCAGTTACTCGATGAGACCCCTGTTAGGGGAGTCCTACGAGCAGTACTTC	CASSYSMRPLLGESYEQYF	TRBV6-5	TRBJ2-7
TGTGCCAGCAGTTACTCCCAGGGGGAGATCACTGAAGCTTTCTTT	CASSYSQGEITEAFF	TRBV6-3	TRBJ1-1
TGTGCCAGCAGCCAAGATGGTCTAGCGGGGGGGATACCGATTGAGCAGTTCTTC	CASSQDGLAGGIPIEQFF	TRBV14	TRBJ2-1
TGCAGTGCTAAGGCCCGGGGTAACACTAATGAAAAACTGTTTTTT	CSAKARGNTNEKLFF	TRBV20-1	TRBJ1-4
TGTGCCAGCAGCTTGATCGGTCCAGGGGGCAAAGAGACCCAGTACTTC	CASSLIGPGGKETQYF	TRBV5-5	TRBJ2-5
TGTGCCACCAGTGACCGTCCGGGACCAAGAAACATTCAGTACTTC	CATSDRPGPRNIQYF	TRBV24-1	TRBJ2-4
TGTGCCAGCAGCGAGGACAGGACTTGCACAGATACGCAGTATTTT	CASSEDRTCTDTQYF	TRBV9	TRBJ2-3
TGTGCCAGCAGCCGCAGGGGGTACGAGCAGTACTTC	CASSRRGYEQYF	TRBV27	TRBJ2-7
TGCAGTGCTAGTAACTACGACAGGGAGGGGAAAAATTCACCCCTCCACTTT	CSASNYDREGKNSPLHF	TRBV20-1	TRBJ1-6
TGTGCCAGCAGTTGTGCTGTCGAGCAGTACTTC	CASSCAVEQYF	TRBV6-5	TRBJ2-7
TGTGCCAGCAGCGGAATCTCGCCAGACAGGGGTAGGCCTCACACCGGGGAGCTGTTTTTT	CASSGISPDRGRPHTGELFF	TRBV7-3	TRBJ2-2
TGCGCCAGCAGCTACGACAGGGAGGCCGGCTCTGAGCAGTTCTTC	CASSYDREAGSEQFF	TRBV5-1	TRBJ2-1
TGTGCCAGCAGAATTAGGGGACAGGAGTACTTC	CASRIRGQEYF	TRBV12-3	TRBJ2-7
TGCGCCAGCAGAGACCTTCTAGCGGGCACTTGCACCTACGAGCAGTACTTC	CASRDLLAGTCTYEQYF	TRBV10-1	TRBJ2-7
TGTGCCAGCAGAGGGCTAGACCGTGGGTACGAGCAGTACTTC	CASRGLDRGYEQYF	TRBV25-1	TRBJ2-7
TGTGCCAGCAGCTACGGCGATGGTTATGAAGCTTTCTTT	CASSYGDGYEAFF	TRBV7-3	TRBJ1-1
TGCGCCAGCAGCATGAGAGGGTCGACCCAGTACTTC	CASSMRGSTQYF	TRBV10-1	TRBJ2-5
TGTGCCAGCAGTAGGGACCCTGGTACAGATACGCAGTATTTT	CASSRDPGTDTQYF	TRBV28	TRBJ2-3
TGCAGTGCTAGAGCTCAGCGGGATAGGGGGGAGCAGTTCTTC	CSARAQRDRGEQFF	TRBV20-1	TRBJ2-1
TGTGCCAGCTCACTACAGAATGGACAGGCCGTTCCCAACACTGAAGCTTTCTTT	CASSLQNGQAVPNTEAFF	TRBV18	TRBJ1-1
TGTGCCAGCAGCTCCCCGGGCTTAGAGCAGTACTTC	CASSSPGLEQYF	TRBV7-2	TRBJ2-7
TGTGCCAGCAGCTCATTTCCCCCTAGCGCCGGGGAGCTGTTTTTT	CASSSFPPSAGELFF	TRBV11-3	TRBJ2-2
TGTGCCCTCGTGGCTAGATTACATTCACCCCTCCACTTT	CALVARLHSPLHF	TRBV11-2	TRBJ1-6
TGTGCCAGCAGTGACGAGGGCCCATACAATGAGCAGTTCTTC	CASSDEGPYNEQFF	TRBV6-5	TRBJ2-1
TGTGCCAGCAGCTTAGATCACCCGGGGTCTAAGACTCAGATTGAAGCTTTCTTT	CASSLDHPGSKTQIEAFF	TRBV11-3	TRBJ1-1
TGTGCCAGCATCCGCCTCCCGATGTCCGAAAGGGGGGTGGCTGAAGCTTTCTTT	CASIRLPMSERGVAEAFF	TRBV27	TRBJ1-1
TGTGCCAGCCCTGCTAGGGGGCCCTACGAGCAGTACTTC	CASPARGPYEQYF	TRBV7-8	TRBJ2-7
TGCAGTGCCGTTACTAGCTGTAAAACAGATACGCAGTATTTT	CSAVTSCKTDTQYF	TRBV20-1	TRBJ2-3
TGTGCCATCAGGTATCGGGACAGGGGGCGCAATCAGCCCCAGCATTTT	CAIRYRDRGRNQPQHF	TRBV10-3	TRBJ1-5
TGTGCCAGTCGACAGCAAATCTCGACCCAGTACTTC	CASRQQISTQYF	TRBV19	TRBJ2-5
TGCGCCAGCACGACGCTCAGGAGGTTGAACACAGATACGCAGTATTTT	CASTTLRRLNTDTQYF	TRBV10-2	TRBJ2-3
TGTGCCAGCAGCGTATCCGACAGGAGGTGCAATCAGCCCCAGCATTTT	CASSVSDRRCNQPQHF	TRBV9	TRBJ1-5
TGTGCCAGCAGCGCGTCGAACAGGGTGAACTACGAGCAGTACTTC	CASSASNRVNYEQYF	TRBV7-7	TRBJ2-7
TGTGCCAGCAGCTCCTCGAAGGCGGCCTATGGCTACACCTTC	CASSSSKAAYGYTF	TRBV13	TRBJ1-2
TGTGCCAGCAGCTTAGCCGGGACAGGGCTTGCTGGCTACACCTTC	CASSLAGTGLAGYTF	TRBV11-3	TRBJ1-2
TGTGCCAGCAGTAGACCCGCGGGACACAGTCTGAACACTGAAGCTTTCTTT	CASSRPAGHSLNTEAFF	TRBV6-4	TRBJ1-1
TGTGCCAGCAGCTGTAGCGGCTACGAGCAGTACTTC	CASSCSGYEQYF	TRBV11-2	TRBJ2-7
TGTGCCAGTAGTATTTCCCGGACAGGAGAGGTTAGCCAAGAGACCCAGTACTTC	CASSISRTGEVSQETQYF	TRBV19	TRBJ2-5
TGTGCCAGCGTTGCAGGGGGGCATAATGAAAAACTGTTTTTT	CASVAGGHNEKLFF	TRBV9	TRBJ1-4
TGTGCCAGCGGCAAAGGGGTGGAGGGAACGGGGGAGCTGTTTTTT	CASGKGVEGTGELFF	TRBV5-6	TRBJ2-2
TGTGCCAATTCGAGGGAATATAGCAATCAGCCCCAGCATTTT	CANSREYSNQPQHF	TRBV19	TRBJ1-5
TGTGCCAGCAGGTGGACTAGCGGGTCCTCGTACAATGAGCAGTTCTTC	CASRWTSGSSYNEQFF	TRBV28	TRBJ2-1
TGTGCCAGCAGTTTAACCCTCTGGGGAGGTACTGAAGCTTTCTTT	CASSLTLWGGTEAFF	TRBV12-3	TRBJ1-1
TGTGCCAGCAGCGCCCCCCAAACGGTAGCCAAAAACATTCAGTACTTC	CASSAPQTVAKNIQYF	TRBV7-4	TRBJ2-4
TGTGCCAGTAGTATCCCCCGCGGACAAGAGCAGTACTTC	CASSIPRGQEQYF	TRBV19	TRBJ2-7
TGTGCCAGCAGTGACTCTAGGGGGGGGGCTGGTGATCAGTACTTC	CASSDSRGGAGDQYF	TRBV6-4	TRBJ2-5
TGTGCCAGCAGTTTAAGCGGAGCTGATAGCTCCTACAATGAGCAGTTCTTC	CASSLSGADSSYNEQFF	TRBV12-4	TRBJ2-1
TGTGCCAAGGGACAGGGGCTGAGTTCACCCCTCCACTTT	CAKGQGLSSPLHF	TRBV27	TRBJ1-6
TGCAGTGCTAAAGGACATCAGCCCCAGCATTTT	CSAKGHQPQHF	TRBV20-1	TRBJ1-5
TGTGCCAGCAGCCAGAAATTCCGGGACAGGGATGTTGAGACCCAGTACTTC	CASSQKFRDRDVETQYF	TRBV14	TRBJ2-5
TGTGCCACCAAACTGGGGACGGCCAAAAACATTCAGTACTTC	CATKLGTAKNIQYF	TRBV24-1	TRBJ2-4
TGTGCCAGGGTTAGGAACACTGAAGCTTTCTTT	CARVRNTEAFF	TRBV6-1	TRBJ1-1
TGTGCCAGCAGCCAAGAGCCGCCGACAGGGAGCACAGATACGCAGTATTTT	CASSQEPPTGSTDTQYF	TRBV3-1	TRBJ2-3
TGTGCCAGCAGCTTTGCTGCAGATGAGACCCAGTACTTC	CASSFAADETQYF	TRBV7-2	TRBJ2-5
TGTGCCAGCAGTTTAATTAACGAGCAGTTCTTC	CASSLINEQFF	TRBV28	TRBJ2-1
TGCGCCAGCAGCCACCCCGATGGTGAATATGGAAACACCATATATTTT	CASSHPDGEYGNTIYF	TRBV4-3	TRBJ1-3
TGCGCCAGCAGCAGTTCCGTTAGGAAACAGCCCCAGCATTTT	CASSSSVRKQPQHF	TRBV5-1	TRBJ1-5
TGTGCCAGCAGTAACTATGGCTACACCTTC	CASSNYGYTF	TRBV25-1	TRBJ1-2
TGTGCCAGCAGCGTACCATCCTCGGGGCCCTTATGGCACATTCAGTACTTC	CASSVPSSGPLWHIQYF	TRBV9	TRBJ2-4
TGTGCCAGCCCCCGCGCGGACAGGGGGCAAGGCTACACCTTC	CASPRADRGQGYTF	TRBV25-1	TRBJ1-2
TGTGCCAGCAGCTTGGCCCGGCAGGGTCCTGAAGCTTTCTTT	CASSLARQGPEAFF	TRBV5-6	TRBJ1-1
TGTGCCAGCAGCTTATCCAGGGGATGGTTAGCTAACTATGGCTACACCTTC	CASSLSRGWLANYGYTF	TRBV7-9	TRBJ1-2
TGCGCCAGCAGTGACCTGTCAGGGTCGGAAAAACTGTTTTTT	CASSDLSGSEKLFF	TRBV10-1	TRBJ1-4
TGTGCCTGGAGGGGATTCAATGAGCAGTTCTTC	CAWRGFNEQFF	TRBV30	TRBJ2-1
TGTGCCACCAGTGACCGGGGCTATCACACCATATATTTT	CATSDRGYHTIYF	TRBV24-1	TRBJ1-3
TGTGCCAGCAGTTACAGACAATATCCCCGGCAATCCACTGAAGCTTTCTTT	CASSYRQYPRQSTEAFF	TRBV6-6	TRBJ1-1
TGTGCCAGAACAGACTATGGCTACACCTTC	CARTDYGYTF	TRBV30	TRBJ1-2
TGTGCCAGCAGTGACCAAAGGGGGGGCCTCTCCTACGAGCAGTACTTC	CASSDQRGGLSYEQYF	TRBV6-4	TRBJ2-7
TGTGCCAGCAGCATTTCAACAGCGACAGGTCCGCAGCCCCAGCATTTT	CASSISTATGPQPQHF	TRBV11-3	TRBJ1-5
TGTGCCACCAGCCCCAGGACTGGCTTTGGCTACACCTTC	CATSPRTGFGYTF	TRBV24-1	TRBJ1-2
TGTGCCAGCAGACACCAGAGGACAGGTAATCAGCCCCAGCATTTT	CASRHQRTGNQPQHF	TRBV6-2	TRBJ1-5
TGCGCCAGCAGACCGGGGACAGGGCTAACCTACGAGCAGTACTTC	CASRPGTGLTYEQYF	TRBV4-1	TRBJ2-7
TGTGCCAGCAGCTTAGCGCTCACCTCTCCCCGGGGTGGCTACACCTTC	CASSLALTSPRGGYTF	TRBV7-9	TRBJ1-2
TGTGCCAGCAGCGTGGGGCCCCGGCAGTTCTTC	CASSVGPRQFF	TRBV13	TRBJ2-1
TGTGCCAGCAGCTTCCGACAGGGTGAAGCTTTCTTT	CASSFRQGEAFF	TRBV7-3	TRBJ1-1
TGTGCCAGCAGAAAGACAGGGACCAGCTCTGGGGCCAACGTCCTGACTTTC	CASRKTGTSSGANVLTF	TRBV7-8	TRBJ2-6
TGTGCCAGCAGTCCCGTCCTTTGGGGCTACGAGCAGTACTTC	CASSPVLWGYEQYF	TRBV27	TRBJ2-7
TGTGCCAGCAGTAACAGACAGGGCTATGGCTACACCTTC	CASSNRQGYGYTF	TRBV6-4	TRBJ1-2
TGCAGCCAATGGGACAGGCCAGCTAACTATGGCTACACCTTC	CSQWDRPANYGYTF	TRBV29-1	TRBJ1-2
TGTGCCAGCAGTAGACTCAGGGGGCTTGAGCAGTACTTC	CASSRLRGLEQYF	TRBV6-1	TRBJ2-7
TGTGCCAGCACACGGGGGGGGCTTCAAGAGACCCAGTACTTC	CASTRGGLQETQYF	TRBV27	TRBJ2-5
TGTGCCAGCAGGCCGACTAGAAAGGAAAACATTCAGTACTTC	CASRPTRKENIQYF	TRBV12-3	TRBJ2-4
TGTGCCAGCTCACCAGAGCCGGGACAAGACTACGAGCAGTACTTC	CASSPEPGQDYEQYF	TRBV18	TRBJ2-7
TGTGCCAGCTCACCACCCAGGGCCCAAGAGACCCAGTACTTC	CASSPPRAQETQYF	TRBV18	TRBJ2-5
TGTGCCAGCAGTTTGTATCCCGGGACAGGGGGCTCCTACGAGCAGTACTTC	CASSLYPGTGGSYEQYF	TRBV6-4	TRBJ2-7
TGTGCCAGCAGCCGTAGAGACAGGGGGGGACTTATGAACACCGGGGAGCTGTTTTTT	CASSRRDRGGLMNTGELFF	TRBV3-1	TRBJ2-2
TGTGCCAGCCCCCCTAGCGGGGGGGCCGCTGGGGCCAACGTCCTGACTTTC	CASPPSGGAAGANVLTF	TRBV27	TRBJ2-6
TGTGCCAGCAGTGGACAAGGAGATCTTCAAACAAACACCGGGGAGCTGTTTTTT	CASSGQGDLQTNTGELFF	TRBV2	TRBJ2-2
TGTGCCAGCAGAGAAGGGGGGGTGGAATCCTACGAGCAGTACTTC	CASREGGVESYEQYF	TRBV9	TRBJ2-7
TGTGCCAGCAGCGGGGGAATAACCTACGAGCAGTACTTC	CASSGGITYEQYF	TRBV7-4	TRBJ2-7
TGTGCCACCAGTGCGACAGGGGCCAAAGTACGTCAGCCCCAGCATTTT	CATSATGAKVRQPQHF	TRBV24-1	TRBJ1-5
TGTGCCAGCACGGGGCTTAGCTCCTACAATGAGCAGTTCTTC	CASTGLSSYNEQFF	TRBV9	TRBJ2-1
TGTGCCAGCAGCTTAGATATTCCCCACCGACTGGGGACAGTTAACGAGCAGTACTTC	CASSLDIPHRLGTVNEQYF	TRBV11-3	TRBJ2-7
TGCGCCAGCAGCTTGCCCCTAGCGGCTCTAATTGAGCAGTACTTC	CASSLPLAALIEQYF	TRBV5-1	TRBJ2-7
TGTGCCAGCAGTTCTCTGGGAGACTTGGAGAGACGCACAGATACGCAGTATTTT	CASSSLGDLERRTDTQYF	TRBV28	TRBJ2-3
TGCGCCACAATTAAGGGAATGAACACTGAAGCTTTCTTT	CATIKGMNTEAFF	TRBV5-1	TRBJ1-1
TGTGCCAGCAGTCCATGGGAGGGCAATCAGCCCCAGCATTTT	CASSPWEGNQPQHF	TRBV27	TRBJ1-5
TGTGCCACCGCGGGGGGTTACGGCGCCACCATATATTTT	CATAGGYGATIYF	TRBV24-1	TRBJ1-3
TGTGCTAGTAAGACGGGACAGAACATTCAGTACTTC	CASKTGQNIQYF	TRBV12-5	TRBJ2-4
TGTGCCAGGGGTTGGGATGGCTACACCTTC	CARGWDGYTF	TRBV19	TRBJ1-2
TGTGCCAGCGGATACCGGGACAGGGGTGGTAACTATGGCTACACCTTC	CASGYRDRGGNYGYTF	TRBV2	TRBJ1-2
TGTGCCAGTAGTATAAATTGCAGACAGGAGACCCAGTACTTC	CASSINCRQETQYF	TRBV19	TRBJ2-5
TGTGCCAGCACAGGGTACACTGAAGCTTTCTTT	CASTGYTEAFF	TRBV6-4	TRBJ1-1
TGTGCCGCCTGTAGGGTGCAGTTCTTC	CAACRVQFF	TRBV6-5	TRBJ2-1
TGTGCCAGCAGCCAAGCGGGGGGGGAATCCTACGAGCAGTACTTC	CASSQAGGESYEQYF	TRBV14	TRBJ2-7
TGTGCCAGCAGCTTGTTGGGGGGGACGGACACCGGGGAGCTGTTTTTT	CASSLLGGTDTGELFF	TRBV7-9	TRBJ2-2
TGCGCCAGCAGTGATCCCCGGACAACTGAAGCTTTCTTT	CASSDPRTTEAFF	TRBV10-1	TRBJ1-1
TGTGCCAGCAGCTTAACCCAGGGGGCCGGCAATGAGCAGTTCTTC	CASSLTQGAGNEQFF	TRBV7-9	TRBJ2-1
TGTGCCAGCAGCTCAGGGGCGGACAGGGACGGAGGAAACACCATATATTTT	CASSSGADRDGGNTIYF	TRBV5-5	TRBJ1-3
TGTGCCAGCAGCTTGGCCAACCGGAGCGCGGAGCTGTTTTTT	CASSLANRSAELFF	TRBV5-8	TRBJ2-2
TGTGCCAGCAGCGCCCCAAATCCAACTTTACTCGGGGGGGGTAGCCAAGAGACCCAGTACTTC	CASSAPNPTLLGGGSQETQYF	TRBV9	TRBJ2-5
TGTGCCAGCAGCCAGCAGGGACAAAGTTCGTATTTT	CASSQQGQSSYF	TRBV3-1	TRBJ2-3
TGCACAAGCAATGTCGAGGAGACCCAGTACTTC	CTSNVEETQYF	TRBV20-1	TRBJ2-5
TGTGCCAGCAGTCCACGTAGGGGGCTCGGCTACGAGCAGTACTTC	CASSPRRGLGYEQYF	TRBV6-2	TRBJ2-7
TGCGCCAGCAGCTTCCCATCTGCAGGGCATGACTATGGCTACACCTTC	CASSFPSAGHDYGYTF	TRBV5-1	TRBJ1-2
TGTGCCAGCAGTTTACCCAGTGGGGGACTGGAAAAACTGTTTTTT	CASSLPSGGLEKLFF	TRBV12-4	TRBJ1-4
TGTGCCAGCAGCGGACTGGGGTGGGCCAACACCGGGGAGCTGTTTTTT	CASSGLGWANTGELFF	TRBV7-4	TRBJ2-2
TGTGCCAGCAGTTTATGCAGGGGGCGGGGAAACTATGGCTACACCTTC	CASSLCRGRGNYGYTF	TRBV27	TRBJ1-2
TGTGCCAGCAGTCGCCAGCCAGGGACAGAAGCTTTCTTT	CASSRQPGTEAFF	TRBV2	TRBJ1-1
TGTGCCAGCAGCTTACAGGGGGGCTCTGGAAACACCATATATTTT	CASSLQGGSGNTIYF	TRBV7-2	TRBJ1-3
TGTGCCAGCAGCTTAACGGGACAGGGCGCCTACGAGCAGTACTTC	CASSLTGQGAYEQYF	TRBV7-3	TRBJ2-7
TGTGCCAGCAGTGGTCCCGTGGGGACCCAGTACTTC	CASSGPVGTQYF	TRBV25-1	TRBJ2-5
TGTGCCACAGAACAGGAGTGGAACACTGAAGCTTTCTTT	CATEQEWNTEAFF	TRBV13	TRBJ1-1
TGTGCCAGCAGTTTTACAGGGAGTTTGAACACTGAAGCTTTCTTT	CASSFTGSLNTEAFF	TRBV28	TRBJ1-1
TGTGCCAGCAGGACAGGGGAAGAATTAGTGGACACTGAAGCTTTCTTT	CASRTGEELVDTEAFF	TRBV6-4	TRBJ1-1
TGTGCCAGCAGTTGGACAGGGGCGGGGGTTGAGCAGTTCTTC	CASSWTGAGVEQFF	TRBV28	TRBJ2-1
TGTGCCAGCAGCGTAGAGAACACAGCGGCTAATCCTCCAGATACGCAGTATTTT	CASSVENTAANPPDTQYF	TRBV9	TRBJ2-3
TGTGCCAGCAGCTCCCCGGGGGACAGGGCACATAATTCACCCCTCCACTTT	CASSSPGDRAHNSPLHF	TRBV7-9	TRBJ1-6
TGTGCCAGCTCGGGACAGGGGTCGGGGGGAAATTCACCCCTCCACTTT	CASSGQGSGGNSPLHF	TRBV18	TRBJ1-6
TGTGCCAGCAGTTTATTCACTAGCGGGAGGGGCTACGAGCAGTACTTC	CASSLFTSGRGYEQYF	TRBV28	TRBJ2-7
TGTGCCAATACCGGTTTAATTGGAAACACCATATATTTT	CANTGLIGNTIYF	TRBV10-3	TRBJ1-3
TGCGCCAGTCAGGGGGCTTACCCCTACGAGCAGTACTTC	CASQGAYPYEQYF	TRBV5-1	TRBJ2-7
TGCGCCAGCAGTTTAGTAAGGGGGGGGGCTGAAGCTTTCTTT	CASSLVRGGAEAFF	TRBV10-2	TRBJ1-1
TGTGCCAGTAGACGGAGGGAGGGATCGGCCTCCTACGAGCAGTACTTC	CASRRREGSASYEQYF	TRBV19	TRBJ2-7
TGTGCCACCAGTGATTTGCAAAGTCACAGGGTCAATGAGCAGTTCTTC	CATSDLQSHRVNEQFF	TRBV24-1	TRBJ2-1
TGCAGTGCTAGAGGGGGTGGACAGGGCTACGAGCAGTACTTC	CSARGGGQGYEQYF	TRBV20-1	TRBJ2-7
TGTGCCACCAGGGAGCAGTACTTC	CATREQYF	TRBV10-3	TRBJ2-7
TGTGCCAGCCGTCGTGGGGGGGGACCTCGAGAAAACAATGAGCAGTTCTTC	CASRRGGGPRENNEQFF	TRBV9	TRBJ2-1
TGCGCCAGCAGCTTACCTCGTAGCAACGAGCAGTACTTC	CASSLPRSNEQYF	TRBV5-1	TRBJ2-7
TGTGCTAGTGGCCTCGGGAATATACTAGAGACCCAGTACTTC	CASGLGNILETQYF	TRBV12-5	TRBJ2-5
TGTGCCTGGAGTTCCGAGCCTCGAGAAACCTACAATGAGCAGTTCTTC	CAWSSEPRETYNEQFF	TRBV30	TRBJ2-1
TGTGCCAGCAGCTTACAACTAGCGCAGATGAGAACCTACAATGAGCAGTTCTTC	CASSLQLAQMRTYNEQFF	TRBV11-2	TRBJ2-1
TGTGCCAGCAGCCAAAAACCCCCAGGGGCTTCACCCCTCCACTTT	CASSQKPPGASPLHF	TRBV13	TRBJ1-6
TGTGCCAGGTTCCGGGACAGTGCAAATCAGCCCCAGCATTTT	CARFRDSANQPQHF	TRBV7-2	TRBJ1-5
TGTGCCACCAGTGAACAACAGACCTTACGCGGGGAGCTGTTTTTT	CATSEQQTLRGELFF	TRBV24-1	TRBJ2-2
TGTGCCAGCAGCTTACAAACTAGCGGGAGGGCAGGTAACACTGAAGCTTTCTTT	CASSLQTSGRAGNTEAFF	TRBV7-2	TRBJ1-1
TGTGCCAGCGGACAGGGCAGGGACAATTCACCCCTCCACTTT	CASGQGRDNSPLHF	TRBV6-5	TRBJ1-6
TGTGCCAGCAGCGCTATACCGGTTGGCTACACCTTC	CASSAIPVGYTF	TRBV9	TRBJ1-2
TGTGCCAACAGGGGGGGAGTAGGCCGTAACGAGCAGTACTTC	CANRGGVGRNEQYF	TRBV6-1	TRBJ2-7
TGTGCCAGCAGTAACCTAGCGGGACCCCGGACCCAGTACTTC	CASSNLAGPRTQYF	TRBV27	TRBJ2-5
TGTGCCAGCAGCCGGCCTCTTACCGGGACCAAAAACTATGGCTACACCTTC	CASSRPLTGTKNYGYTF	TRBV6-4	TRBJ1-2
TGTGCCAGCAGTTACTCTGGACCCTGCAGTCTCCACATTCAGTACTTC	CASSYSGPCSLHIQYF	TRBV6-5	TRBJ2-4
TGTGCCAGCAGCTTAGGCTCCACGTTACAGGGGGCGTCGAACTATGGCTACACCTTC	CASSLGSTLQGASNYGYTF	TRBV7-2	TRBJ1-2
TGTGCCAGCAGTTCGACGGGGGGGGGCTCTGGAAACACCATATATTTT	CASSSTGGGSGNTIYF	TRBV27	TRBJ1-3
TGTGCCACCCTAGGGGCCTACTCCTACGAGCAGTACTTC	CATLGAYSYEQYF	TRBV24-1	TRBJ2-7
TGTGCCACCAGGCCGGCAAACGAGCAGTACTTC	CATRPANEQYF	TRBV24-1	TRBJ2-7
TGCGCCAGCAAAGGGCACATGGGCTCCTACGAGCAGTACTTC	CASKGHMGSYEQYF	TRBV10-1	TRBJ2-7
TGTGCCAGCAGCGCGCCGGGGCCCCGATCCTACGAGCAGTACTTC	CASSAPGPRSYEQYF	TRBV7-2	TRBJ2-7
TGTGCCAGCAGGGATCTAGCGGGCTACGAGCAGTACTTC	CASRDLAGYEQYF	TRBV27	TRBJ2-7
TGCAGTGAAGGGAATCAGCCCCAGCATTTT	CSEGNQPQHF	TRBV20-1	TRBJ1-5
TGTGCCAGCAGTCTACCCGACAGGTGCTCTGGAAACACCATATATTTT	CASSLPDRCSGNTIYF	TRBV6-1	TRBJ1-3
TGTGCCAGCAGAGCCACGGGGGAGCAAGAGACCCAGTACTTC	CASRATGEQETQYF	TRBV12-4	TRBJ2-5
TGTGCCAGTAGTTTAGGAGCTTTGGCTAGCACAGATACGCAGTATTTT	CASSLGALASTDTQYF	TRBV19	TRBJ2-3
TGTGCCAGCAGCACGTCAGGGGGCGAGACCCAGTACTTC	CASSTSGGETQYF	TRBV13	TRBJ2-5
TGTGCTAGTGGTTTGGTATTTGATCGTGGGGGACAGCGGCGGCCCCAGCATTTT	CASGLVFDRGGQRRPQHF	TRBV12-5	TRBJ1-5
TGCGCCAGCAGCCGGGCCGGGTACAATGAGCAGTTCTTC	CASSRAGYNEQFF	TRBV5-1	TRBJ2-1
TGTGCCAGCAGCCCCACGACAGGGCCGAACGAGCAGTACTTC	CASSPTTGPNEQYF	TRBV13	TRBJ2-7
TGTGCCAGTAGTATAGAGTTTGTGATTTCCCACACCGGGGAGCTGTTTTTT	CASSIEFVISHTGELFF	TRBV19	TRBJ2-2
TGTGCCACCAGTGAAGATAGCGGACTGCCCACAGATACGCAGTATTTT	CATSEDSGLPTDTQYF	TRBV24-1	TRBJ2-3
TGCAGCGTAGTTTATCACTCCTACGAGCAGTACTTC	CSVVYHSYEQYF	TRBV29-1	TRBJ2-7
TGTGCCAGCAGCTTGTCTTTAGTAGGGGACACAGATACGCAGTATTTT	CASSLSLVGDTDTQYF	TRBV5-5	TRBJ2-3
TGTGCCAGCAGCTGGACTTCGGTTGGTAATGAGCAGTTCTTC	CASSWTSVGNEQFF	TRBV7-4	TRBJ2-1
TGCGCCAGCAGCCAGAGGGCTATTCAGGGGGACGAGCAGTACTTC	CASSQRAIQGDEQYF	TRBV5-1	TRBJ2-7
TGTGCCATCAGGGCCGAGACCCAGTACTTC	CAIRAETQYF	TRBV10-3	TRBJ2-5
TGTGCCTGGAGTGTACCCCCGAGCGGCGGGAGGTCTCTCTACGAGCAGTACTTC	CAWSVPPSGGRSLYEQYF	TRBV30	TRBJ2-7
TGTGCCACCAGCGGCACAGGGTTGGTTTCTGGGGCCAACGTCCTGACTTTC	CATSGTGLVSGANVLTF	TRBV15	TRBJ2-6
TGTGCCAGCAGGTCCGCCGTATTTAGGGGGGGGGAGCAGTTCTTC	CASRSAVFRGGEQFF	TRBV27	TRBJ2-1
TGTGCCAGCGTCTGGTTCTACCCCCCGGACGAGCAGTACTTC	CASVWFYPPDEQYF	TRBV6-1	TRBJ2-7
TGTGCCATCAGCCCACTAGCGGGAGCGGAAGCTTTCTTT	CAISPLAGAEAFF	TRBV10-3	TRBJ1-1
TGTGCCAGCAGCCAAGATAGAAAGGGGGGAAGTGAGGGCACTGAAGCTTTCTTT	CASSQDRKGGSEGTEAFF	TRBV14	TRBJ1-1
TGTGCCAGCAGCTTAGGTCCCGGGACTAGCGGGCATGGTACCGGGGAGCTGTTTTTT	CASSLGPGTSGHGTGELFF	TRBV7-2	TRBJ2-2
TGCAGCGTTGCGGTTACGATGGATCAGTACTTC	CSVAVTMDQYF	TRBV29-1	TRBJ2-5
TGTGCCAGCAGTAACGGCTTGTCAAGGACAGGGCAGCCCCAGCATTTT	CASSNGLSRTGQPQHF	TRBV6-1	TRBJ1-5
TGTGCCAGCAGCCCGGTAGCCAACGAGCAGTACTTC	CASSPVANEQYF	TRBV13	TRBJ2-7
TGTGCCAGCAGCGGGGGCGGGAGGCAATTAATGGGCTATGGCTACACCTTC	CASSGGGRQLMGYGYTF	TRBV7-9	TRBJ1-2
TGTGCCACTCGCTACGCCCCGGGACAAATCCGGGAGCAGTACTTC	CATRYAPGQIREQYF	TRBV15	TRBJ2-7
TGTGCCAGCAGGGAATTCAATGAGCAGTTCTTC	CASREFNEQFF	TRBV6-5	TRBJ2-1
TGTGCCAGCAGTTACCCTGGCACAGGGGCTGAAGCTTTCTTT	CASSYPGTGAEAFF	TRBV6-2	TRBJ1-1
TGTGCCAGCAGCCTTGGGGGATGGAATCGGTCCAATGAGCAGTTCTTC	CASSLGGWNRSNEQFF	TRBV5-4	TRBJ2-1
TGTGCCAGCAGCAGGGGGACAGCCTATAATTCACCCCTCCACTTT	CASSRGTAYNSPLHF	TRBV13	TRBJ1-6
TGTGCCAAAGGCCGGGACAGCTACCCCCGCAATCAGCCCCAGCATTTT	CAKGRDSYPRNQPQHF	TRBV6-5	TRBJ1-5
TGTGCCAGTAGTATACAGGCTGGGGCCAACGTCCTGACTTTC	CASSIQAGANVLTF	TRBV19	TRBJ2-6
TGCGCCAGCAGTTACCGGGACCGGACCCAAGAGACCCAGTACTTC	CASSYRDRTQETQYF	TRBV10-1	TRBJ2-5
TGTGCCAGCAGTGAAGGGAGCGCGATACCGAACACTGAAGCTTTCTTT	CASSEGSAIPNTEAFF	TRBV6-1	TRBJ1-1
TGTGCCAGCAGTGAAATCCCGAGGCATGGGGAGACCCAGTACTTC	CASSEIPRHGETQYF	TRBV2	TRBJ2-5
TGTGCCAGCAGCCAATATTCCGAACTAGACAGGGAAGGGTTGTACTATGGCTACACCTTC	CASSQYSELDREGLYYGYTF	TRBV16	TRBJ1-2
TGCGCCAGCACCCCCCACGGCGTCTCGAACACTGAAGCTTTCTTT	CASTPHGVSNTEAFF	TRBV10-2	TRBJ1-1
TGTGCCAGCAGTTACCCGGTCGGGGGGTCTTGCGACAATGAGCAGTTCTTC	CASSYPVGGSCDNEQFF	TRBV6-5	TRBJ2-1
TGTGCCGCCAGGGTGCACTACGAGCAGTACTTC	CAARVHYEQYF	TRBV24-1	TRBJ2-7
TGTGCCTGGAGTGTGAAAAAACAGAGGGGTACCTACAATGAGCAGTTCTTC	CAWSVKKQRGTYNEQFF	TRBV30	TRBJ2-1
TGTGCCAGTAGTATCAGGCAGAGCTCCTACAATGAGCAGTTCTTC	CASSIRQSSYNEQFF	TRBV19	TRBJ2-1
TGCGCCAGCAGGCGTTCCCGAGCGATAGCCCGAAGCCAAGAGACCCAGTACTTC	CASRRSRAIARSQETQYF	TRBV5-1	TRBJ2-5
TGTGCCAGCAGCCAACCTGGGGACAGGGCTGGGGCCAACGTCCTGACTTTC	CASSQPGDRAGANVLTF	TRBV4-2	TRBJ2-6
TGTGCCAGCGATATCAGATCGCCCTACGAGCAGTACTTC	CASDIRSPYEQYF	TRBV6-5	TRBJ2-7
TGTGCCAGCAGCGAATTTACCGGGACCGGGTTGAACACTGAAGCTTTCTTT	CASSEFTGTGLNTEAFF	TRBV7-3	TRBJ1-1
TGTGCCAGCAGTCTGACTAGCGGGACTGATGAGCAGTTCTTC	CASSLTSGTDEQFF	TRBV6-1	TRBJ2-1
TGCGCCAGCAGCTCTAGCGGGCCCTACGAGCAGTACTTC	CASSSSGPYEQYF	TRBV5-1	TRBJ2-7
TGTGCCAGCAGTGAGAGTAAAGGGACAGGGTTATGGGGTGGGGGGGGGAATGAAAAACTGTTTTTT	CASSESKGTGLWGGGGNEKLFF	TRBV6-4	TRBJ1-4
TGTGCCAGCAGCCAAGATAGTTCGGGCGGCTACACCTTC	CASSQDSSGGYTF	TRBV3-1	TRBJ1-2
TGTGCCAGCAGCTTAACCGATGTGACGCTAAACCATGGCTACACCTTC	CASSLTDVTLNHGYTF	TRBV11-2	TRBJ1-2
TGTGCCACCAGCAGAGATCCGTTCAGGGAAGGCTACACCTTC	CATSRDPFREGYTF	TRBV15	TRBJ1-2
TGTGCCAGCAGTGGGACAGGTTTTCAGCCCCAGCATTTT	CASSGTGFQPQHF	TRBV27	TRBJ1-5
TGCGCCAGCAGCTTACATTCAGGGGGTCCTTCAAAACTGTTTTTT	CASSLHSGGPSKLFF	TRBV5-1	TRBJ1-4
TGTGCCACCAGTGATTCCACGGGAAACAGGTATCTTGGTGAAAAACTGTTTTTT	CATSDSTGNRYLGEKLFF	TRBV24-1	TRBJ1-4
TGCGCCAGCAGCCAGAATTCCGATAGAAGAAGCAGGCCTCCAGTGCAAGAGACCCAGTACTTC	CASSQNSDRRSRPPVQETQYF	TRBV4-1	TRBJ2-5
TGTGCCAGTAGTCTAGTTCCGGGACAGGCGGTCAACACCTTC	CASSLVPGQAVNTF	TRBV19	TRBJ1-2
TGCGCCAGCAGCCAAGGACGAACCCGGGACAGGGGGCGGACCTATGGCTACACCTTC	CASSQGRTRDRGRTYGYTF	TRBV4-3	TRBJ1-2
TGTGCCAGCAGTGGGTCCAGGGTAGGGACGCACTACGAGCAGTACTTC	CASSGSRVGTHYEQYF	TRBV6-6	TRBJ2-7
TGTGCCAGCAGCGGATCTAGACTAGCGTACGGCACAGATACGCAGTATTTT	CASSGSRLAYGTDTQYF	TRBV13	TRBJ2-3
TGCAGTGGCCCTAGCGGGAAGTACAATGAGCAGTTCTTC	CSGPSGKYNEQFF	TRBV20-1	TRBJ2-1
TGCGCCAGCAGTGCCTTCCTGGGTGTCGAGACCCAGTACTTC	CASSAFLGVETQYF	TRBV10-1	TRBJ2-5
TGTGCCATCGGTAGGAAGTCTAGCACAGATACGCAGTATTTT	CAIGRKSSTDTQYF	TRBV6-5	TRBJ2-3
TGTGTGGCCGGGACCGATATGAACACTGAAGCTTTCTTT	CVAGTDMNTEAFF	TRBV2	TRBJ1-1
TGCAGCGGCAGACTACAGGGGAACACCGGGGAGCTGTTTTTT	CSGRLQGNTGELFF	TRBV29-1	TRBJ2-2
TGTGCCAGCAGTGACAACTTTGGGGCTGGTACTGGGGCCAACGTCCTGACTTTC	CASSDNFGAGTGANVLTF	TRBV6-4	TRBJ2-6
TGTGCCAGCATTCAGGGTACTCAGCCCCAGCATTTT	CASIQGTQPQHF	TRBV6-5	TRBJ1-5
TGCAGTGCTAGAGAGGGCCGCGGGACTAGCGGGAATAAATTTGATGAGCAGTTCTTC	CSAREGRGTSGNKFDEQFF	TRBV20-1	TRBJ2-1
TGTGCCAGCAGCCGAAGACGCGGGAGGAACTTTCTAGACGAGCAGTACTTC	CASSRRRGRNFLDEQYF	TRBV11-3	TRBJ2-7
TGTGCCAGCAGTGCAGCTCCAGGGACAGGGACTTACGAGCAGTACTTC	CASSAAPGTGTYEQYF	TRBV6-1	TRBJ2-7
TGTGCCAGCAGCTTGGAGGTCATGGGGCAGCCCCAGCATTTT	CASSLEVMGQPQHF	TRBV5-4	TRBJ1-5
TGTGCCAGTAGTATCCACAAGGGACAGGGAACAACCTACAATGAGCAGTTCTTC	CASSIHKGQGTTYNEQFF	TRBV19	TRBJ2-1
TGTGCCAGCAGCTGGGAGGGGGGGTGGTACAATGAGCAGTTCTTC	CASSWEGGWYNEQFF	TRBV7-9	TRBJ2-1
TGTGCCAGCTCGGGCACCCTAATGGGGCACTATGGCTACACCTTC	CASSGTLMGHYGYTF	TRBV7-6	TRBJ1-2
TGTGCCAGCAGTTTATGGGGGGTTCACGAGCAGTACTTC	CASSLWGVHEQYF	TRBV28	TRBJ2-7
TGTGCCAGCAGTGAATTGGGGACTATCATTCAGTACTTC	CASSELGTIIQYF	TRBV25-1	TRBJ2-4
TGTGCCAGCAGCTATACCTTGGGGAGCGTACTATTACAGCCCCAGCATTTT	CASSYTLGSVLLQPQHF	TRBV5-6	TRBJ1-5
TGTGCCAGCAGCTATCTGAGGGCGGTCGACTCCTATAATTCACCCCTCCACTTT	CASSYLRAVDSYNSPLHF	TRBV11-2	TRBJ1-6
TGCGCCAGCAGCTTACAGGTACAGGGAAGGGAGACCCAGTACTTC	CASSLQVQGRETQYF	TRBV5-1	TRBJ2-5
TGTGCCAGCAGCCGGGTTTGGACCTCCTACGAGCAGTACTTC	CASSRVWTSYEQYF	TRBV6-5	TRBJ2-7
TGTGGGCCCGGGACATCACCCCTCCACTTT	CGPGTSPLHF	TRBV27	TRBJ1-6
TGTGCCAGCAGATGGACGACCGTAGGGGGAACCCAAGAGACCCAGTACTTC	CASRWTTVGGTQETQYF	TRBV6-5	TRBJ2-5
TGTGCCAGCAAGAAAGGAGCCACTAGCGACTACGAGCAGTACTTC	CASKKGATSDYEQYF	TRBV27	TRBJ2-7
TGTGCCACCGGTGGACAGGGACCTGTGAACACTGAAGCTTTCTTT	CATGGQGPVNTEAFF	TRBV24-1	TRBJ1-1
TGTGCCAGCAGTCGACAGGGAGCGTATGGCTACACCTTC	CASSRQGAYGYTF	TRBV28	TRBJ1-2
TGCAGCGCACCCTTCCCTAACTATGGCTACACCTTC	CSAPFPNYGYTF	TRBV29-1	TRBJ1-2
TGTGCCACCAGTGCTCTAACTACAGGGGGAGAAGCCAAAAACATTCAGTACTTC	CATSALTTGGEAKNIQYF	TRBV24-1	TRBJ2-4
TGTGCCAGGGGGCGGAGCTACGAGCAGTACTTC	CARGRSYEQYF	TRBV19	TRBJ2-7
TGCGCCAGCAGCCAAGCGACAGGGCCCTACGAGCAGTACTTC	CASSQATGPYEQYF	TRBV4-1	TRBJ2-7
TGTGCCACCAGTGATTTGCCTCCTAGGACAGGTCAAGAGACCCAGTACTTC	CATSDLPPRTGQETQYF	TRBV24-1	TRBJ2-5
TGTGCCAGCAGTCCTAGGGACAGGGGGGCCCATCAGCCCCAGCATTTT	CASSPRDRGAHQPQHF	TRBV25-1	TRBJ1-5
TGTGCCAATGGACAGGGTGGGGCGGAGACCCAGTACTTC	CANGQGGAETQYF	TRBV7-9	TRBJ2-5
TGTGCCAGCAGCTTAGGTAAGAGGGTGGATCAGCCCCAGCATTTT	CASSLGKRVDQPQHF	TRBV7-6	TRBJ1-5
TGTGCCAGCTCGGCCCGACAGGGACATGACACTGAAGCTTTCTTT	CASSARQGHDTEAFF	TRBV27	TRBJ1-1
TGTGCCAGCAGCGCAAAGGGGACTGAAGCTTTCTTT	CASSAKGTEAFF	TRBV13	TRBJ1-1
TGTGCCAGCAGCACGGGACAGGATAATGAAAAACTGTTTTTT	CASSTGQDNEKLFF	TRBV7-9	TRBJ1-4
TGCAGTGCTAGGAATAGCGGGAGAGTTCGAGTTGAGACCCAGTACTTC	CSARNSGRVRVETQYF	TRBV20-1	TRBJ2-5
TGTGCCAGTAAGGATTCCTATGGCTACACCTTC	CASKDSYGYTF	TRBV19	TRBJ1-2
TGTGCCAGCAGCGTAGAACCAGGTCAGGGGAGCTATGGCTACACCTTC	CASSVEPGQGSYGYTF	TRBV9	TRBJ1-2
TGTGCCATACGGGACAGGGCGGGGGGCTATGGCTACACCTTC	CAIRDRAGGYGYTF	TRBV6-5	TRBJ1-2
TGTGCCACGGGCAGCAGGTATGGCTACACCTTC	CATGSRYGYTF	TRBV24-1	TRBJ1-2
TGTGCCAGCCCGCACGGACAGGGGGCGGCGGGTAATGAAAAACTGTTTTTT	CASPHGQGAAGNEKLFF	TRBV28	TRBJ1-4
TGTGCCAGCAGTGGGGGGACAGCGGCCGGCCCACAGCCCCAGCATTTT	CASSGGTAAGPQPQHF	TRBV12-3	TRBJ1-5
TGTGCCAGCAGCGTAGAGTGGAGGTACGAGCAGTACTTC	CASSVEWRYEQYF	TRBV9	TRBJ2-7
TGTGCCACGGACCAGGGACTAGCAGTAGATACGCAGTATTTT	CATDQGLAVDTQYF	TRBV24-1	TRBJ2-3
TGTGCCAGCAGCACACCCCACATCAGCTCTGGGGCCAACGTCCTGACTTTC	CASSTPHISSGANVLTF	TRBV9	TRBJ2-6
TGTGCCAGCAGCGTATACCCCTTCCCAGGGTCCGAGCAGTACTTC	CASSVYPFPGSEQYF	TRBV9	TRBJ2-7
TGTGCCAGCAGCCCCGAGGACGGGGGAGCCACTGAAGCTTTCTTT	CASSPEDGGATEAFF	TRBV7-3	TRBJ1-1
TGTGCCAGCAGCAGGAGGGAAGCCAAAAACATTCAGTACTTC	CASSRREAKNIQYF	TRBV13	TRBJ2-4
TGTGCCAGCGCCCCAGCGCCGACTGAAGCTTTCTTT	CASAPAPTEAFF	TRBV27	TRBJ1-1
TGTGCCAGTTCCTCGACAGGGTCGAACACTGAAGCTTTCTTT	CASSSTGSNTEAFF	TRBV25-1	TRBJ1-1
TGTGCCAGCAGACAGGTCCGGACTCGAGCCAAAAACATTCAGTACTTC	CASRQVRTRAKNIQYF	TRBV11-3	TRBJ2-4
TGTGCCAGCGGGGGACAGGGGATCGAGCAGTTCTTC	CASGGQGIEQFF	TRBV6-2	TRBJ2-1
TGTGCCACCAGTGTAACGACCGAGCAGTACTTC	CATSVTTEQYF	TRBV24-1	TRBJ2-7
TGCGCCAGCAGCCAGTTGGCGGGGTTGTCCAATCAGCCCCAGCATTTT	CASSQLAGLSNQPQHF	TRBV10-1	TRBJ1-5
TGTGCCAGCTCACCACTCAGGCCCGAGGACTCTTACAATGAGCAGTTCTTC	CASSPLRPEDSYNEQFF	TRBV18	TRBJ2-1
TGTGCCAGCAGCTTGAACGAGCGGGTCCGCACAGATACGCAGTATTTT	CASSLNERVRTDTQYF	TRBV5-5	TRBJ2-3
TGTGCTAGTGGTTATCGGGGGGGGGGGGAGCTGTTTTTT	CASGYRGGGELFF	TRBV12-5	TRBJ2-2
TGCGCCAGCCAGGCGATGAAGTCGTCTGGGGCCAACGTCCTGACTTTC	CASQAMKSSGANVLTF	TRBV10-1	TRBJ2-6
TGTGCCAGCAGAGGGGACAGGGGTGGCTACACCTTC	CASRGDRGGYTF	TRBV27	TRBJ1-2
TGCGCCAACACTACGTATCGCACAGATACGCAGTATTTT	CANTTYRTDTQYF	TRBV5-1	TRBJ2-3
TGTGCCAGCAGCTTAAGGACCTGCTACGAGCAGTACTTC	CASSLRTCYEQYF	TRBV7-9	TRBJ2-7
TGTGCCAGCAGCTTACCAGAACGCCCTAATGAAAAACTGTTTTTT	CASSLPERPNEKLFF	TRBV7-9	TRBJ1-4
TGTGCCAGCAGCAAGAAGGGCGGCAGCGCTGAAAAACTGTTTTTT	CASSKKGGSAEKLFF	TRBV9	TRBJ1-4
TGTGCCACCAGTGATTTGTTGCGACAGGGGACGGCCCAAGAGACCCAGTACTTC	CATSDLLRQGTAQETQYF	TRBV24-1	TRBJ2-5
TGTGCCAGCAGCCGGACAGATCATAGATATGGCTACACCTTC	CASSRTDHRYGYTF	TRBV12-3	TRBJ1-2
TGTGCCAGCAGTTACTCCCCCCGCAGGATCACCGGGGAGCTGTTTTTT	CASSYSPRRITGELFF	TRBV6-2	TRBJ2-2
TGTGCCAGCAGCCCGTCGGTCCGGCTATGCGGCAATCAGCCCCAGCATTTT	CASSPSVRLCGNQPQHF	TRBV14	TRBJ1-5
TGTGCCAGCAGCTTAGACCCGAAAGACCAAGGAGGAGAGACCCAGTACTTC	CASSLDPKDQGGETQYF	TRBV7-2	TRBJ2-5
TGCGCCAGCAGTGAGCACCGAAGGGCCCGGCAGCCCCAGCATTTT	CASSEHRRARQPQHF	TRBV10-1	TRBJ1-5
TGTGCCAGCAGCCGGACCGCGGACAGGGGGGTCACTGAAGCTTTCTTT	CASSRTADRGVTEAFF	TRBV5-8	TRBJ1-1
TGTGCCAGCAGCTTTCCGGGACAGGGGGGCAATCAGCCCCAGCATTTT	CASSFPGQGGNQPQHF	TRBV7-3	TRBJ1-5
TGTGCCAGCAGTTCGACTGGTGACACTGAAGCTTTCTTT	CASSSTGDTEAFF	TRBV25-1	TRBJ1-1
TGTGCTAGTTCTAAAAAGACAGGGCGGGCTTGCAATCAGCCCCAGCATTTT	CASSKKTGRACNQPQHF	TRBV12-5	TRBJ1-5
TGTGCCAGCGGCCTTTTAAAGAACCCGGGCGGGAGCTCTGGAAACACCATATATTTT	CASGLLKNPGGSSGNTIYF	TRBV9	TRBJ1-3
TGTGCCACCAGTGATCAAGCAGGGGGCCCGAATTACGAGCAGTACTTC	CATSDQAGGPNYEQYF	TRBV24-1	TRBJ2-7
TGTGCCAGCAGTTTGCCAGGGGGGAGCTCTGGAAACACCATATATTTT	CASSLPGGSSGNTIYF	TRBV27	TRBJ1-3
TGTGCCAGCAGCATAAACGGTCCGGGACAACAGAATGAGCAGTTCTTC	CASSINGPGQQNEQFF	TRBV7-3	TRBJ2-1
TGTGCCAGCAGGAGTCAAGGCCTCAGGGCGCAAAATCATAGCAATCAGCCCCAGCATTTT	CASRSQGLRAQNHSNQPQHF	TRBV6-5	TRBJ1-5
TGTGCCACCAGTGAGTCGACACAGCAGCCCCAGCATTTT	CATSESTQQPQHF	TRBV24-1	TRBJ1-5
TGTGCCAGCAGCACAGAAGGCGCCGGGGAGCTGTTTTTT	CASSTEGAGELFF	TRBV9	TRBJ2-2
TGTGCCAGCAGCCCTCAGGGTGGGCTAGCCAAAAACATTCAGTACTTC	CASSPQGGLAKNIQYF	TRBV7-7	TRBJ2-4
TGTGCCAGCAGCTTGTTAAGTTTCCGTACCGGCGGGGAGACCCAGTACTTC	CASSLLSFRTGGETQYF	TRBV5-5	TRBJ2-5
TGTGCCAGCAGCTTAACCACCCGGTGGGGCCCAGAAACCTCCTACGAGCAGTACTTC	CASSLTTRWGPETSYEQYF	TRBV7-9	TRBJ2-7
TGTGCCAGCAGAGTCGAAAGAGCCCCGTCTATGAACACTGAAGCTTTCTTT	CASRVERAPSMNTEAFF	TRBV27	TRBJ1-1
TGTGCCAGCAGCCGGTCACCAAACAGGGGGCGTTCTACCTATGGCTACACCTTC	CASSRSPNRGRSTYGYTF	TRBV3-1	TRBJ1-2
TGCAGCGTTGCTGACGGGGGGATACATGGCTACACCTTC	CSVADGGIHGYTF	TRBV29-1	TRBJ1-2
TGCGCCGGGGGCCTCAGATTAGGAACTCGATGCACTGAAGCTTTCTTT	CAGGLRLGTRCTEAFF	TRBV10-1	TRBJ1-1
TGTGCCACAGCGGCTGTGGTCACCGGGGAGCTGTTTTTT	CATAAVVTGELFF	TRBV10-3	TRBJ2-2
TGCAGCGTTGAGTCTACCACAGGGGGCAATTGGCTGAGCGAGCAGTACTTC	CSVESTTGGNWLSEQYF	TRBV29-1	TRBJ2-7
TGTGCCAGCAGCGTAAAGGTCCGAGGGAAAGCCCTCCACTTT	CASSVKVRGKALHF	TRBV9	TRBJ1-6
TGTGCCAGCCATAGCGGGAGCTACGAGACCCAGTACTTC	CASHSGSYETQYF	TRBV7-3	TRBJ2-5
TGTGCCAGCAGCTCCGGCCGCCTAGCCTCCTACGAGCAGTACTTC	CASSSGRLASYEQYF	TRBV12-3	TRBJ2-7
TGTGCCAGCTCGACAGGACCGGAGACCCAGTACTTC	CASSTGPETQYF	TRBV18	TRBJ2-5
TGTGCCAGCAAGGCTAGCGGGAAGGGGGCCTACAATGAGCAGTTCTTC	CASKASGKGAYNEQFF	TRBV5-4	TRBJ2-1
TGTGCCAGCACTAGGGCTGCTGGTGGAGGCTACACCTTC	CASTRAAGGGYTF	TRBV6-5	TRBJ1-2
TGTGCCAGCAGCTTCAGGAGGGCTACCCGGGAGAACACTGAAGCTTTCTTT	CASSFRRATRENTEAFF	TRBV7-3	TRBJ1-1
TGTGCCAGCAGCCAAGGACAGGGCGAGCCCCAGCATTTT	CASSQGQGEPQHF	TRBV4-2	TRBJ1-5
TGTGCCAAACGAGTAATACCGGGACAGGGGTGTAATGAAAAACTGTTTTTT	CAKRVIPGQGCNEKLFF	TRBV11-2	TRBJ1-4
TGTGCCAGCCCTGACAGCTCTGGGGCCAACGTCCTGACTTTC	CASPDSSGANVLTF	TRBV6-6	TRBJ2-6
TGTGCCAGCAGGCCCGGGACAGGCTCCTACAATGAGCAGTTCTTC	CASRPGTGSYNEQFF	TRBV6-4	TRBJ2-1
TGTGCTAGTGGTTTTAGGGATAATGAGCAGTTCTTC	CASGFRDNEQFF	TRBV12-5	TRBJ2-1
TGTGCCGCTAGCGGGGAGGATCCCGGGGAGCTGTTTTTT	CAASGEDPGELFF	TRBV5-6	TRBJ2-2
TGTGCCAGCAGCCACCGCCTCCCTAGCGACAGGGGCGATTCACCCCTCCACTTT	CASSHRLPSDRGDSPLHF	TRBV7-3	TRBJ1-6
TGTGCCACCACGGGAGGATTCCGACTAGCGGGAGGTGGGGTCACCGGGGAGCTGTTTTTT	CATTGGFRLAGGGVTGELFF	TRBV24-1	TRBJ2-2
TGTGCCACCAGTGAGGGGCCTCTGAATTCACCCCTCCACTTT	CATSEGPLNSPLHF	TRBV24-1	TRBJ1-6
TGTGCCAGCAGCGTGGTAGTGGACAGGGGGGCCTCCCATGAGCAGTTCTTC	CASSVVVDRGASHEQFF	TRBV7-3	TRBJ2-1
TGCAGTGCTAAACGGGGGTTGACAGGGGGCAACAATCAGCCCCAGCATTTT	CSAKRGLTGGNNQPQHF	TRBV20-1	TRBJ1-5
TGTGCCAGCAGTGTACCGTACACGGGGACAGGGGGGAGGGCAAAACTGTTTTTT	CASSVPYTGTGGRAKLFF	TRBV6-5	TRBJ1-4
TGCAGTGCTAGGCCCGGGACAGGGGCTGCTGAAAAACTGTTTTTT	CSARPGTGAAEKLFF	TRBV20-1	TRBJ1-4
TGTGCCAGCAGTTACAACGGACTAGCAAGGCCCTACGAGCAGTACTTC	CASSYNGLARPYEQYF	TRBV6-5	TRBJ2-7
TGTGCCAGCAGCAACACTAGCGGGAGTGTAAGGAATGAAAAACTGTTTTTT	CASSNTSGSVRNEKLFF	TRBV7-4	TRBJ1-4
TGTGCCAGCAGTTACCTGTATCGAGCTTTCTTT	CASSYLYRAFF	TRBV6-5	TRBJ1-1
TGTGCCAGCAGTATCTACAGTCGCACTGAAGCTTTCTTT	CASSIYSRTEAFF	TRBV25-1	TRBJ1-1
TGTGCCAGAAAGGGGACAGGCCGTCCGGAAGCTTTCTTT	CARKGTGRPEAFF	TRBV30	TRBJ1-1
TGTGCCAGCAGCACCTGGGGCCCTGGAAACACCATATATTTT	CASSTWGPGNTIYF	TRBV7-9	TRBJ1-3
TGTGCCAGCAGCGGGGGGAACTATGGCTACACCTTC	CASSGGNYGYTF	TRBV11-2	TRBJ1-2
TGCGCCAGCAGCCAAGGGCCCAGGGACACAGATGGCTTT	CASSQGPRDTDGF	TRBV4-1	TRBJ1-1
TGTGCCAGCAGTTGGAGTGCCCTACTCGGGAGCTACGAGCAGTACTTC	CASSWSALLGSYEQYF	TRBV28	TRBJ2-7
TGCGCCAGCAGCCAAAACTGGGGGGAGCACAGGAATTCCTACGAGCAGTACTTC	CASSQNWGEHRNSYEQYF	TRBV4-1	TRBJ2-7
TGTGCCAGCAGTTTATCGGACAGGGGGCTGGAAGGGGGGGAAAAACTGTTTTTT	CASSLSDRGLEGGEKLFF	TRBV27	TRBJ1-4
TGTGCCAGCAGCTTCATTAGGGGAGCCGCCGGGGAGCTGTTTTTT	CASSFIRGAAGELFF	TRBV7-9	TRBJ2-2
TGTGCCAGCAGAGGCTCCACAGGGGGCAACTATTATAGCAATCAGCCCCAGCATTTT	CASRGSTGGNYYSNQPQHF	TRBV6-4	TRBJ1-5
TGTGCCAGCGAACAGGGCAAGACCTACGAGCAGTACTTC	CASEQGKTYEQYF	TRBV6-4	TRBJ2-7
TGTGCCAGCACCAAATCCGTGGACGGTCGTAATCAGCCCCAGCATTTT	CASTKSVDGRNQPQHF	TRBV6-1	TRBJ1-5
TGTGCCCCAGACGACCGTCAAGAGACCCAGTACTTC	CAPDDRQETQYF	TRBV6-4	TRBJ2-5
TGTGCCCCTCCGACAAGGAGTGGCTACGAGCAGTACTTC	CAPPTRSGYEQYF	TRBV10-3	TRBJ2-7
TGCAGCGTTGCACAGGGTTATCCTGCCTACAATGAGCAGTTCTTC	CSVAQGYPAYNEQFF	TRBV29-1	TRBJ2-1
TGTGCCACCAGCAGGGGGCCCAATTCACCCCTCCACTTT	CATSRGPNSPLHF	TRBV24-1	TRBJ1-6
TGTGCCAGCAGACTAGGGGGGGCGAGCACCTACGAGCAGTACTTC	CASRLGGASTYEQYF	TRBV6-1	TRBJ2-7
TGTGCCAGCAGCTTGTTAAGGGGGCCCAATCAGCCCCAGCATTTT	CASSLLRGPNQPQHF	TRBV5-4	TRBJ1-5
TGTGCCAGCAGCGGCTGGGGGACAGGGGGCACCTCTGGAAACACCATATATTTT	CASSGWGTGGTSGNTIYF	TRBV5-4	TRBJ1-3
TGTGCCAGCACCTCTAGCGAGCAGTTCTTC	CASTSSEQFF	TRBV6-6	TRBJ2-1
TGCGCCAGCAGCTTGGCTTACAGGGGCATTTATAGCAATCAGCCCCAGCATTTT	CASSLAYRGIYSNQPQHF	TRBV5-1	TRBJ1-5
TGTGCCAGCAGTTACTCAGTAGGGAGGGCCACCTATGGCTACACCTTC	CASSYSVGRATYGYTF	TRBV6-5	TRBJ1-2
TGTGCCAGCAGCTTAGATACTAGCGGGGACTCCTACAATGAGCAGTTCTTC	CASSLDTSGDSYNEQFF	TRBV7-2	TRBJ2-1
TGTGCCAGCACGAGGGGGTCTGGAGGGGGAGCATACGAGCAGTACTTC	CASTRGSGGGAYEQYF	TRBV12-3	TRBJ2-7
TGTGCCAGCAGCTGGGACAGGGGGTCCTACGAGCAGTACTTC	CASSWDRGSYEQYF	TRBV7-7	TRBJ2-7
TGTGCCAGCAGAGCCGGGGGGCGGGGGCACCCCACAGATACGCAGTATTTT	CASRAGGRGHPTDTQYF	TRBV13	TRBJ2-3
TGTGCCAGCAGTTGGGACAGCGGTCGCGTGAACACTGAAGCTTTCTTT	CASSWDSGRVNTEAFF	TRBV28	TRBJ1-1
TGTGCCAGTAGTATACCATGTGGGGGGGGCTACGAGCAGTACTTC	CASSIPCGGGYEQYF	TRBV19	TRBJ2-7
TGTGCCACGACAGGGGATTGTCAGCCCCAGCATTTT	CATTGDCQPQHF	TRBV24-1	TRBJ1-5
TGTGCCAGCAGCCACAGACTGCGGGACTGTACAGAGACCCAGTACTTC	CASSHRLRDCTETQYF	TRBV14	TRBJ2-5
TGTGCCAGCAGCTTGGAAAGTGGACCTGTATTTTTCTGTACGCAGTATTTT	CASSLESGPVFFCTQYF	TRBV7-8	TRBJ2-3
TGCAGTGCTCCTCCGGGGATCTTCTCTTACGAGCAGTACTTC	CSAPPGIFSYEQYF	TRBV20-1	TRBJ2-7
TGTGCCACAATGGGGGGGCCCCGCGAGCAGTACTTC	CATMGGPREQYF	TRBV24-1	TRBJ2-7
TGTGCCAGCAGCAGTGGGCGACGCGGCTCCTACGAGCAGTACTTC	CASSSGRRGSYEQYF	TRBV7-3	TRBJ2-7
TGTGCCAGCAGTCGCAGGTTGGGGGGCTACACCTTC	CASSRRLGGYTF	TRBV2	TRBJ1-2
TGCAGTGCTACATACCACGTGGGTAGGGTTAACTATGGCTACACCTTC	CSATYHVGRVNYGYTF	TRBV20-1	TRBJ1-2
TGTGCCACCGGCGGGACAGACCGCTACACCTTC	CATGGTDRYTF	TRBV24-1	TRBJ1-2
TGCAGTGCTAGCCCTACGGCTAGGAATGAAAAACTGTTTTTT	CSASPTARNEKLFF	TRBV20-1	TRBJ1-4
TGCAGTGCTAGCACAGGGAACCCTTCCTACGAGCAGTACTTC	CSASTGNPSYEQYF	TRBV20-1	TRBJ2-7
TGTGCCAGCAGCAGCACAGGGCAGGAGACCCAGTACTTC	CASSSTGQETQYF	TRBV7-3	TRBJ2-5
TGTGCCAGCAAATCTTCACTAGCGGGCAGCTCCTACGAGCAGTACTTC	CASKSSLAGSSYEQYF	TRBV9	TRBJ2-7
TGCAGTGCTAGCAGCAGGGGCCCTGAAGCTTTCTTT	CSASSRGPEAFF	TRBV20-1	TRBJ1-1
TGTGCCAGCAGTTTGCAGGACAGGGCCACTGAAGCTTTCTTT	CASSLQDRATEAFF	TRBV12-3	TRBJ1-1
TGTGCCATCAGGGACAGGGGGATACCTGAAGCTTTCTTT	CAIRDRGIPEAFF	TRBV10-3	TRBJ1-1
TGTGCCAGCAGCCCACCCCCACAGGGGGAAGAGTATAGCAATCAGCCCCAGCATTTT	CASSPPPQGEEYSNQPQHF	TRBV11-3	TRBJ1-5
TGTGCCAGCAGCTTAGATTCTCTCGTCCTGGACAGGTGGTACTATGGCTACACCTTC	CASSLDSLVLDRWYYGYTF	TRBV11-3	TRBJ1-2
TGTGCCAGCAGCCAATGGATGCTAGCGGGAGTGCCCTTTGCGAACACCGGGGAGCTGTTTTTT	CASSQWMLAGVPFANTGELFF	TRBV14	TRBJ2-2
TGTGCCAGCCCAGTTGGACAGGGTGCTGCAAAAGAGACCCAGTACTTC	CASPVGQGAAKETQYF	TRBV9	TRBJ2-5
TGTGCCAGCAGTTTTCCGGGACAGGGGCTACACGAGCAGTACTTC	CASSFPGQGLHEQYF	TRBV12-4	TRBJ2-7
TGTGCCAGCAGTGCTTCGGTTCACAGGGCCTCCTACGAGCAGTACTTC	CASSASVHRASYEQYF	TRBV6-4	TRBJ2-7
TGTGCCAGCAGCGTGCGGAAATCTAACTATGGCTACACCTTC	CASSVRKSNYGYTF	TRBV7-7	TRBJ1-2
TGTGCCAGCAGCCCCGGGACTAGAGTCGAAGATACGCAGTATTTT	CASSPGTRVEDTQYF	TRBV6-4	TRBJ2-3
TGTGCCAGCACACGGACCTACGAGCAGTACTTC	CASTRTYEQYF	TRBV12-3	TRBJ2-7
TGTGCCAGTTACAGGGGTACAATATGGACAACAACTAATGAAAAACTGTTTTTT	CASYRGTIWTTTNEKLFF	TRBV9	TRBJ1-4
TGTGCCAGCAGCAAAACGTGGGGAGCTTTCTTT	CASSKTWGAFF	TRBV7-9	TRBJ1-1
TGTGCCAGCAGCTTATGGGACAGGGGGCATGGCTACACCTTC	CASSLWDRGHGYTF	TRBV7-9	TRBJ1-2
TGTGCCAGCAGCTGTCCCGGACTTTCCTACGAGCAGTACTTC	CASSCPGLSYEQYF	TRBV11-3	TRBJ2-7
TGCGCCAGCAGCTTGCTCCAGTATATCTATGGCTACACCTTC	CASSLLQYIYGYTF	TRBV5-1	TRBJ1-2
TGTGCCACCGACAGGGATTTGAATCAGCCCCAGCATTTT	CATDRDLNQPQHF	TRBV24-1	TRBJ1-5
TGTGCCATCAGTGTCCCGGAGAGGGGGACATACGAGCAGTACTTC	CAISVPERGTYEQYF	TRBV10-3	TRBJ2-7
TGTGCCAGCAGTGAAAGAAACCGGGACAGGGGAGGGAACACTGAAGCTTTCTTT	CASSERNRDRGGNTEAFF	TRBV25-1	TRBJ1-1
TGTGCCAGCAGCCCCCTAGCGGGTGGGGTTTACGAGCAGTACTTC	CASSPLAGGVYEQYF	TRBV7-3	TRBJ2-7
TGTGCCAGCAGCTTAGGTGCCCTAGGTGAGCAGTTCTTC	CASSLGALGEQFF	TRBV7-9	TRBJ2-1
TGTGCCACCAAAAAGGACAGAGCCAAAAACATTCAGTACTTC	CATKKDRAKNIQYF	TRBV24-1	TRBJ2-4
TGTGCCAGCAGCGTAGGGAAACTAGCGGGAGGGCGAGATAGAGTTGTCTACGAGCAGTACTTC	CASSVGKLAGGRDRVVYEQYF	TRBV11-3	TRBJ2-7
TGTGCCAGCAGCCTCGAGCTTAACGTTTGGTCCTACGAGCAGTACTTC	CASSLELNVWSYEQYF	TRBV7-3	TRBJ2-7
TGTGCCCTTCGGGGATACTCACGGGAGAAACTTAGCAATCAGCCCCAGCATTTT	CALRGYSREKLSNQPQHF	TRBV24-1	TRBJ1-5
TGTGCCAGCAGCTGGATGGGGGGGGTTAGCTACAATGAGCAGTTCTTC	CASSWMGGVSYNEQFF	TRBV5-6	TRBJ2-1
TGTGCCAGAACACCCCTCTACAATGAGCAGTTCTTC	CARTPLYNEQFF	TRBV19	TRBJ2-1
TGTGCCAGCAGCCCCCGGGGTACCTACGAGCAGTACTTC	CASSPRGTYEQYF	TRBV13	TRBJ2-7
TGTGCCAGCAGTGCTGACAGGGTCGAAGGCTACACCTTC	CASSADRVEGYTF	TRBV27	TRBJ1-2
TGTGCCAGCAGCCAAGGGGGGGGGGTTTACGAGCAGTACTTC	CASSQGGGVYEQYF	TRBV3-1	TRBJ2-7
TGTGCCACCAGTCCGGAGGTGCCGAGGTCGCCTAGCACAGATACGCAGTATTTT	CATSPEVPRSPSTDTQYF	TRBV24-1	TRBJ2-3
TGTGCCAGCAGCCAACGAGGGACAGATTGGGGGTGGGGAACAGGCTACACCTTC	CASSQRGTDWGWGTGYTF	TRBV4-2	TRBJ1-2
TGTGTGACAGGGTGTACTAATGAAAAACTGTTTTTT	CVTGCTNEKLFF	TRBV7-9	TRBJ1-4
TGTGCCAGCAATATTCACACACTAGCGGTCGAGAACAAGATGGAGACCCAGTACTTC	CASNIHTLAVENKMETQYF	TRBV27	TRBJ2-5
TGTGCCAGCAGTGGAGAGGGGGATTACTATGGCTACACCTTC	CASSGEGDYYGYTF	TRBV11-3	TRBJ1-2
TGTGCCAGTACCCACCCGGGACTAGCCAACTCCTACGAGCAGTACTTC	CASTHPGLANSYEQYF	TRBV19	TRBJ2-7
TGTGCCAGCATCCGGGACAGAAGTCAGGAAGCTTTCTTT	CASIRDRSQEAFF	TRBV7-4	TRBJ1-1
TGTGCCAGCAGTTACTGCCAGGGAGGGACCCTCGAGGTGCGTTGCAATCAGCCCCAGCATTTT	CASSYCQGGTLEVRCNQPQHF	TRBV6-5	TRBJ1-5
TGCGCCAGCAGCTTGACGACCGAGCAGTACTTC	CASSLTTEQYF	TRBV5-1	TRBJ2-7
TGTGCCAGCAGATACGTTCCAGATACGCAGTATTTT	CASRYVPDTQYF	TRBV6-5	TRBJ2-3
TGTGCCAGCAGCGAAGGGGGCTTTTTTGGCTACACCTTC	CASSEGGFFGYTF	TRBV13	TRBJ1-2
TGCGCCAGCAGCTCACGAGATCCCGGGGAGCTGTTTTTT	CASSSRDPGELFF	TRBV5-1	TRBJ2-2
TGTGCCAGCAGCCATCCCCTAGTATGGGATGAGCAGTTCTTC	CASSHPLVWDEQFF	TRBV3-1	TRBJ2-1
TGTGCCAGCAGCTTTCTAGCGGACAAAAACAATGAGCAGTTCTTC	CASSFLADKNNEQFF	TRBV11-2	TRBJ2-1
TGTGCCAGCAGCAGAGTAAGGTCCGGGACAGGGGCCGGAAACACCATATATTTT	CASSRVRSGTGAGNTIYF	TRBV7-4	TRBJ1-3
TGTGCCACCCAGACTAGCGGGCCAGAGACCCAGTACTTC	CATQTSGPETQYF	TRBV24-1	TRBJ2-5
TGTGCCAGCAGTTCCGGGACCGGTTCCAAGTACGAGCAGTACTTC	CASSSGTGSKYEQYF	TRBV27	TRBJ2-7
TGTGCCAGCAGTTCGCAGAGGGAACTTGGAGAAAGCTCCTACGAGCAGTACTTC	CASSSQRELGESSYEQYF	TRBV28	TRBJ2-7
TGTGCCAGCAGCCAAGCATTCCCCAGGACAGGGGGGGCGTCTGTGGAACCCTCTGGAAACACCATATATTTT	CASSQAFPRTGGASVEPSGNTIYF	TRBV4-2	TRBJ1-3
TGTGCCACCGGAGACCCGGGACAGGGTTTGCCGCCCCAGCATTTT	CATGDPGQGLPPQHF	TRBV24-1	TRBJ1-5
TGTGCCACGGAAGGGGCTGAAGCTTTCTTT	CATEGAEAFF	TRBV12-3	TRBJ1-1
TGTGCCAGCAGCCGGGATCGGACTAGCGGGAGGGCCCAGGGGACCGGGGACAATGAGCAGTTCTTC	CASSRDRTSGRAQGTGDNEQFF	TRBV7-3	TRBJ2-1
TGTGCCAGCACCTTAGAGGGGAGGGGCTGCACAGATACGCAGTATTTT	CASTLEGRGCTDTQYF	TRBV12-3	TRBJ2-3
TGTGCCACCAGTGATTCTAGAGACACAGCCGGGGAGCTGTTTTTT	CATSDSRDTAGELFF	TRBV24-1	TRBJ2-2
TGCAGTGCAAGGGTGGGGCTAGCGGGTACGTACAATGAGCAGTTCTTC	CSARVGLAGTYNEQFF	TRBV20-1	TRBJ2-1
TGTGCCAGCACAGGCCCGGAGACCCAGTACTTC	CASTGPETQYF	TRBV7-2	TRBJ2-5
TGCGCCAGCAGCTTGGCTAGGACCTACGAGCAGTACTTC	CASSLARTYEQYF	TRBV5-1	TRBJ2-7
TGCAGTGCTAGAGCGTGGCAAAGAATCCGGGACAGATCTAGGGGCATGAACACTGAAGCTTTCTTT	CSARAWQRIRDRSRGMNTEAFF	TRBV20-1	TRBJ1-1
TGTGCCAGCAGCCAAGACAGCAGGTGGACGGGGGGCCAAGAGACCCAGTACTTC	CASSQDSRWTGGQETQYF	TRBV4-2	TRBJ2-5
TGTGCCAGCAGACACGCCCCGGGGGGCAATGAAGCTTTCTTT	CASRHAPGGNEAFF	TRBV6-2	TRBJ1-1
TGTGCCAGCAGTCGGAGAATAGACCATGGCTACACCTTC	CASSRRIDHGYTF	TRBV12-3	TRBJ1-2
TGTGCCAGCAAGGCCCACAGGGGTATAAATTACACTGAAGCTTTCTTT	CASKAHRGINYTEAFF	TRBV6-1	TRBJ1-1
TGTGCCAGCAGAACAGGGGGCATGAACACTGAAGCTTTCTTT	CASRTGGMNTEAFF	TRBV6-5	TRBJ1-1
TGCGCCAGCAGTGGGGACAGGGGGGCTAACTATGGCTACACCTTC	CASSGDRGANYGYTF	TRBV10-1	TRBJ1-2
TGTGCCAGCAGCGTAAGGACAGGGGGCCATTTCTCGTATTCCTACGAGCAGTACTTC	CASSVRTGGHFSYSYEQYF	TRBV9	TRBJ2-7
TGTGCCAGCAGCGCCGGGAAAAACCAAGAGACCCAGTACTTC	CASSAGKNQETQYF	TRBV9	TRBJ2-5
TGTGCCAGCAGCTCGGGGCGGGAGCGAAATGGCTACACCTTC	CASSSGRERNGYTF	TRBV7-2	TRBJ1-2
TGCGCCAGCAGCGGGGTATCCAGGGGATACTATGGCTACACCTTC	CASSGVSRGYYGYTF	TRBV4-3	TRBJ1-2
TGCGCCAGCAGCTGTCAGGAGCCCCCAACTAATGAAAAACTGTTTTTT	CASSCQEPPTNEKLFF	TRBV5-1	TRBJ1-4
TGCAGTGCAGGACTGAAGGACTATGGCTACACCTTC	CSAGLKDYGYTF	TRBV20-1	TRBJ1-2
TGTGCCAGCAGTTTCGTGACAGGGGCCAAAGGTCGGTACGAGCAGTACTTC	CASSFVTGAKGRYEQYF	TRBV12-3	TRBJ2-7
TGTGCCAGCAGTTTAATTGGGACTTTTCCGCGGGGAACTAATGAAAAACTGTTTTTT	CASSLIGTFPRGTNEKLFF	TRBV12-4	TRBJ1-4
TGTGCCACCAGTGAGACAGGGTGGATCGTCACCTTC	CATSETGWIVTF	TRBV24-1	TRBJ1-2
TGTGCCACCAGCCCCCGAGGGGGGGAACGTAACCAGCCCCAGCATTTT	CATSPRGGERNQPQHF	TRBV24-1	TRBJ1-5
TGCAGCGTTGAAGATGAATGGAGGGCTGACAACTATGGCTACACCTTC	CSVEDEWRADNYGYTF	TRBV29-1	TRBJ1-2
TGTGCCAGCAGTGGGTGGGGGACCTCCTACGAGCAGTACTTC	CASSGWGTSYEQYF	TRBV12-4	TRBJ2-7
TGCGCCAGTGCGGGACAGGGCGTTACACTGAACACTGAAGCTTTCTTT	CASAGQGVTLNTEAFF	TRBV5-1	TRBJ1-1
TGTGCCAGCAGCCCCGACTCCTACAATGAGCAGTTCTTC	CASSPDSYNEQFF	TRBV14	TRBJ2-1
TGTGCCAATCCTCCGTCCTATAATTCACCCCTCCACTTT	CANPPSYNSPLHF	TRBV10-3	TRBJ1-6
TGCGCCAGCAGTGATCCTCTAGCGGGGGGCGAACCCTACAATGAGCAGTTCTTC	CASSDPLAGGEPYNEQFF	TRBV10-1	TRBJ2-1
TGCGCCAGCAGCTTGGGGGGGACCGGGACCGGGACAGCAGGCTACGAGCAGTACTTC	CASSLGGTGTGTAGYEQYF	TRBV5-1	TRBJ2-7
TGTGCCAGCAGCCATCCCCGGGACAGGGCGTCACCCCTCCACTTT	CASSHPRDRASPLHF	TRBV3-1	TRBJ1-6
TGTGCCAAGGACGAGTACTACGAGCAGTACTTC	CAKDEYYEQYF	TRBV28	TRBJ2-7
TGTGCCAGCAGGATGTCAGATATTGATTACAATGAGCAGTTCTTC	CASRMSDIDYNEQFF	TRBV11-2	TRBJ2-1
TGTGCCTGGAGTCCCTCTTGGGACAGGGCGACTAATGAAAAACTGTTTTTT	CAWSPSWDRATNEKLFF	TRBV30	TRBJ1-4
TGCAGCGTGTTTTCAGCACTAGCGGGAGCTGAGCAGTTCTTC	CSVFSALAGAEQFF	TRBV29-1	TRBJ2-1
TGTGCCAGCAGTGACCGGGGGGGGCGGGTCAATGAGCAGTTCTTC	CASSDRGGRVNEQFF	TRBV28	TRBJ2-1
TGTGCCAGCAGTCAAAGGTGGGGGGGCGGAAGGGGAAGCAACACCGGGGAGCTGTTTTTT	CASSQRWGGGRGSNTGELFF	TRBV5-4	TRBJ2-2
TGCAGGGATATAGAGGGGAACACTGAAGCTTTCTTT	CRDIEGNTEAFF	TRBV20-1	TRBJ1-1
TGTGCCAGCATGATGGGACAGCCCTATGGCTACACCTTC	CASMMGQPYGYTF	TRBV25-1	TRBJ1-2
TGCGCCAGCAGCCAAGTGGGCGATGACAGGGTACGGAACACTGAAGCTTTCTTT	CASSQVGDDRVRNTEAFF	TRBV4-3	TRBJ1-1
TGTGCCAGCAGCAGAAATGAAGCTAGAACCTCCTACAATGAGCAGTTCTTC	CASSRNEARTSYNEQFF	TRBV7-2	TRBJ2-1
TGTGCCAGCAGCGCGAGGGCTGAAACCAAAAACATTCAGTACTTC	CASSARAETKNIQYF	TRBV7-9	TRBJ2-4
TGTGCCAGCAGGTCGGGGCGCGGAAGCTACGAGCAGTACTTC	CASRSGRGSYEQYF	TRBV9	TRBJ2-7
TGTGCCAGCAGTTACTTTTGGGGCACTAATGAAAAACTGTTTTTT	CASSYFWGTNEKLFF	TRBV6-5	TRBJ1-4
TGTGCCAGCAGCCAAGATTCAACCCCGCAGCAAGAGACCCAGTACTTC	CASSQDSTPQQETQYF	TRBV4-2	TRBJ2-5
TGCAGTGCTAGCGCGGTGGGACCCTCTGAAGCTTTCTTT	CSASAVGPSEAFF	TRBV20-1	TRBJ1-1
TGCAGTGCGGTACCCGTCCTCCAAGAGACCCAGTACTTC	CSAVPVLQETQYF	TRBV20-1	TRBJ2-5
TGTGCCAGCAGCTACAAGGGGCAACTAGCGGGAGGGCTCTTCTACAATGAGCAGTTCTTC	CASSYKGQLAGGLFYNEQFF	TRBV7-6	TRBJ2-1
TGTGCCACCAGCTCCCTGGACAGAGACCCTCAAGGTAGCAATCAGCCCCAGCATTTT	CATSSLDRDPQGSNQPQHF	TRBV15	TRBJ1-5
TGTGCCAGCAACTTGGACAGGGGGGGGGAGCAGTACTTC	CASNLDRGGEQYF	TRBV28	TRBJ2-7
TGTGCCAGTAGTATTATTGGGACAGGGTACAATGAGCAGTTCTTC	CASSIIGTGYNEQFF	TRBV19	TRBJ2-1
TGTGCCAGCTCACGGACGAAGGTTGTAAACATTCAGTACTTC	CASSRTKVVNIQYF	TRBV18	TRBJ2-4
TGCAGTGCTAACGGGAGTCTCTACGAGCAGTACTTC	CSANGSLYEQYF	TRBV20-1	TRBJ2-7
TGTGCCATCAGTGACGGCAGGGGTAGGGACGAGCAGTACTTC	CAISDGRGRDEQYF	TRBV10-3	TRBJ2-7
TGTGCCAGCAGCGTAGTCTGCACCCCGGGTAGACAAGTCCCCCAGGTCTATAATTCACCCCTCCACTTT	CASSVVCTPGRQVPQVYNSPLHF	TRBV9	TRBJ1-6
TGTGCCACCAACCGGGGGCGTGAAGCTTTCTTT	CATNRGREAFF	TRBV24-1	TRBJ1-1
TGTGCCAGCAGCACCAGGAGGAACACTGAAGCTTTCTTT	CASSTRRNTEAFF	TRBV13	TRBJ1-1
TGTGCCAGCAGCCGGGCGGGGACGAATCAGCCCCAGCATTTT	CASSRAGTNQPQHF	TRBV13	TRBJ1-5
TGTGCCAGCAGTTTGGGAGGTTACACTGAAGCTTTCTTT	CASSLGGYTEAFF	TRBV12-3	TRBJ1-1
TGCGCCAGGGAGGGGGCTGACACTGAAGCTTTCTTT	CAREGADTEAFF	TRBV5-1	TRBJ1-1
TGTGCCAGCACCCTGGGAGGGCATGAGCAGTTCTTC	CASTLGGHEQFF	TRBV28	TRBJ2-1
TGTGCCAGCAGTGACCTGCGGGAGCCCTACACCGGGGAGCTGTTTTTT	CASSDLREPYTGELFF	TRBV6-4	TRBJ2-2
TGTGCCAGTAGTATCGAGGGACAACGGGGGTCCACTGAAGCTTTCTTT	CASSIEGQRGSTEAFF	TRBV19	TRBJ1-1
TGCGCCAGCAGCCAAGATGCTCCGGAGGAGGGCCAAGGGAATGAAAAACTGTTTTTT	CASSQDAPEEGQGNEKLFF	TRBV4-1	TRBJ1-4
TGCGCCAGCAGAGAACCCGGACAGGGTCAGGCCTACGAGCAGTACTTC	CASREPGQGQAYEQYF	TRBV4-1	TRBJ2-7
TGTGCCAGCAGCTTGCCATCGGGACAGGGGGCGGGGGCTCCCTATAATTCACCCCTCCACTTT	CASSLPSGQGAGAPYNSPLHF	TRBV7-9	TRBJ1-6
TGTGCCAGCAGCCAAAGCGGGAGAAGGAGCACAGATACGCAGTATTTT	CASSQSGRRSTDTQYF	TRBV7-9	TRBJ2-3
TGCGCCAGCAGCCATACTTCCTGGAAGAGCACTGAAGCTTTCTTT	CASSHTSWKSTEAFF	TRBV5-1	TRBJ1-1
TGTGCCAGCAGCCCCGTGGGGGGGGGGGCGCCGGAGCTGTTTTTT	CASSPVGGGAPELFF	TRBV7-4	TRBJ2-2
TGCGCCAGCAGCCTGGGGTATGAGCACTTC	CASSLGYEHF	TRBV5-1	TRBJ2-7
TGTGCCAGCAGTTATGGAACAGGGCCGGGTGAGCAGTTCTTC	CASSYGTGPGEQFF	TRBV6-5	TRBJ2-1
TGTGTCCAGAGCGTTCCGAGGAAAAGTGAAAAACTGTTTTTT	CVQSVPRKSEKLFF	TRBV14	TRBJ1-4
TGTGCCAGCAGCCGTTGGCTAGCGGGGAAGAGCCCCGGGGAGCTGTTTTTT	CASSRWLAGKSPGELFF	TRBV7-7	TRBJ2-2
TGTGCCAGCACCACTGCCCCGGCGAAGGCGAACACTGAAGCTTTCTTT	CASTTAPAKANTEAFF	TRBV6-5	TRBJ1-1
TGCAGCGAACGGCCGCCCGGGACTAGCGAAACTAGCACAGATACGCAGTATTTT	CSERPPGTSETSTDTQYF	TRBV29-1	TRBJ2-3
TGTGCCAGCAGCTTGCAGGGGGACACCGGGGAGCTGTTTTTT	CASSLQGDTGELFF	TRBV7-8	TRBJ2-2
TGTGCCAGCAGATCCCGACAGGGGAACACTGAAGCTTTCTTT	CASRSRQGNTEAFF	TRBV12-3	TRBJ1-1
TGTGCCAGCAGCCAGGGAACCTCATCCTATAATTCACCCCTCCACTTT	CASSQGTSSYNSPLHF	TRBV14	TRBJ1-6
TGTGCCCGGGACAGGGGGCCCCAAGCTTTCTTT	CARDRGPQAFF	TRBV15	TRBJ1-1
TGTGCCAGCAGTTCAAGTGGCCGGGACAGAATGTGCAACGAGCAGTACTTC	CASSSSGRDRMCNEQYF	TRBV6-3	TRBJ2-7
TGTGCCAGTAGTACCGGACTAGGGGGCCGATGGGCCTACGAGCAGTACTTC	CASSTGLGGRWAYEQYF	TRBV19	TRBJ2-7
TGTGCCAGCAGCGTAGACCGTCCGGGACAGGGGGGGAAGCAGTATGGCTACACCTTC	CASSVDRPGQGGKQYGYTF	TRBV9	TRBJ1-2
TGTGCCAGCAGTGCTCTTTCCGGGAACAATGAGCAGTTCTTC	CASSALSGNNEQFF	TRBV2	TRBJ2-1
TGCGCCAGCAGCCACAGTAGGGGGCGGTCAGTCTATGGCTACACCTTC	CASSHSRGRSVYGYTF	TRBV4-1	TRBJ1-2
TGTGCCAGCAGCCTGCGGGACAGTCGGCACGAGCAGTACTTC	CASSLRDSRHEQYF	TRBV7-3	TRBJ2-7
TGTGCCAGCAGACAGGGGGGCCTCTTC	CASRQGGLF	TRBV27	TRBJ2-1
TGTGCTAGCCCTGGGCAGCCCCAGCATTTT	CASPGQPQHF	TRBV12-5	TRBJ1-5
TGTGCCAGCAGCTTGGGCCTGGGTGTTGAAGCTTTCTTT	CASSLGLGVEAFF	TRBV5-5	TRBJ1-1
TGTGCCAGCAGCCACCGACAGGGGGCAGAGAGCTACGAGCAGTACTTC	CASSHRQGAESYEQYF	TRBV5-5	TRBJ2-7
TGTGCCAGCAGTCAATCGGGGACCGGCTACACCTTC	CASSQSGTGYTF	TRBV6-1	TRBJ1-2
TGTGCCAGCAGTTCCTGGTCGGGACAGGGTGAAGCTTTCTTT	CASSSWSGQGEAFF	TRBV6-9	TRBJ1-1
TGTGCCACCAGTGATTTGCACAACAGGACCCCTAATGAAAAACTGTTTTTT	CATSDLHNRTPNEKLFF	TRBV24-1	TRBJ1-4
TGTGCCAGTAGTACAGGGGGCTGGGGGAGGACCGGGGAGCTGTTTTTT	CASSTGGWGRTGELFF	TRBV19	TRBJ2-2
TGCGCCAGCAGCCAAGTCCCAGGGGGTAGCAATCAGCCCCAGCATTTT	CASSQVPGGSNQPQHF	TRBV4-1	TRBJ1-5
TGTGCCAGCAGCCAAGGAACTAGCGGGGTAGTCTCCTACGAGCAGTACTTC	CASSQGTSGVVSYEQYF	TRBV3-1	TRBJ2-7
TGCAGTGCTTTCAGGGGGTTAAACTACAATGAGCAGTTCTTC	CSAFRGLNYNEQFF	TRBV20-1	TRBJ2-1
TGTGCCAGCAGCCATCAGCGGACTAGCGGGGAGTCCTACGAGCAGTACTTC	CASSHQRTSGESYEQYF	TRBV5-6	TRBJ2-7
TGTGCCTGGAGGTTCGTCTTAGCGGGAGGCCAAGAGACCCAGTACTTC	CAWRFVLAGGQETQYF	TRBV30	TRBJ2-5
TGTCAAGAGGTTTCACTAGCTCCTTTCGACAATGAGCAGTTCTTC	CQEVSLAPFDNEQFF	TRBV7-2	TRBJ2-1
TGCGCCAGCACCTTCGGTAAGTTTGATGAGCAGTTCTTC	CASTFGKFDEQFF	TRBV10-1	TRBJ2-1
TGTGCCAGCAGCATCCTAACAGGGATCCATGGCTACACCTTC	CASSILTGIHGYTF	TRBV9	TRBJ1-2
TGTGCCACCGACAGTGGGGCCAACGTCCTGACTTTC	CATDSGANVLTF	TRBV24-1	TRBJ2-6
TGTGCCAGCAGCCGATGGGGGCGCGGCGCAAAACTGTTTTTT	CASSRWGRGAKLFF	TRBV14	TRBJ1-4
TGTGCCAGCAGTGAATATCCCAGTCCGAGGGCACGAGGCTCCTACGAGCAGTACTTC	CASSEYPSPRARGSYEQYF	TRBV25-1	TRBJ2-7
TGTGCCAGCAGCCCGAGGGGTCAGCCCCAGCATTTT	CASSPRGQPQHF	TRBV7-3	TRBJ1-5
TGTGCCAGCAGCGTGTCGACAGATGAAAAACTGTTTTTT	CASSVSTDEKLFF	TRBV7-3	TRBJ1-4
TGTGCCAGCAGCTTCGTGGGAGGGGAGACCCAGTACTTC	CASSFVGGETQYF	TRBV7-8	TRBJ2-5
TGTGCCAGCAGCGCGACGCGGATTAATTCACCCCTCCACTTT	CASSATRINSPLHF	TRBV9	TRBJ1-6
TGTGCCAGCAGCGTCCAGAATAATCAGCCCCAGCATTTT	CASSVQNNQPQHF	TRBV28	TRBJ1-5
TGCGCCAGCAGCTTGAGTCGGGGAAAGTCTCATGGGACTAGCTCCTATAATTCACCCCTCCACTTT	CASSLSRGKSHGTSSYNSPLHF	TRBV5-1	TRBJ1-6
TGTGCCAGCACAAAGCACGGTTGGCGATGCAATCAGCCCCAGCATTTT	CASTKHGWRCNQPQHF	TRBV6-4	TRBJ1-5
TGTGCCAGCAGCCAAGCCGACGGGGGCTCCCAGGAGCAGTTCTTC	CASSQADGGSQEQFF	TRBV4-2	TRBJ2-1
TGTGCCAGCAGTGGGACAGCCCTAGGAAACACCATATATTTT	CASSGTALGNTIYF	TRBV2	TRBJ1-3
TGCGCCAGCAGGACTCAAGACAGGGTCTCTGGGGCCAACGTCCTGACTTTC	CASRTQDRVSGANVLTF	TRBV10-2	TRBJ2-6
TGTGCCAGCAGTAGAGTGAACAGGGTTAGCTCCTACGAGCAGTACTTC	CASSRVNRVSSYEQYF	TRBV12-3	TRBJ2-7
TGTGCCAGCAGTTCTCGCTGGGGGACAGGGGCCTATGGCTACACCTTC	CASSSRWGTGAYGYTF	TRBV28	TRBJ1-2
TGTGCCAGCAGTTTCGGAGTACCGGAAAAACTGTTTTTT	CASSFGVPEKLFF	TRBV27	TRBJ1-4
TGTGCCAGCAGCCCTACCAGGGGGGGACGCTTAATTTATCAGCCCCAGCATTTT	CASSPTRGGRLIYQPQHF	TRBV12-3	TRBJ1-5
TGTGCCAGCAAGGAGGCCTCAAATGAGCAGTTCTTC	CASKEASNEQFF	TRBV12-3	TRBJ2-1
TGCAGTGCTAGACCGGGACTAGCGGGTCGACCTGATACGCAGTATTTT	CSARPGLAGRPDTQYF	TRBV20-1	TRBJ2-3
TGTGCCAGCAGTCCTGGGACCGACAGGAGCTCTGGAAACACCATATATTTT	CASSPGTDRSSGNTIYF	TRBV12-4	TRBJ1-3
TGCAGTGCTAGCGGAGCGGGAAACACTGAAGCTTTCTTT	CSASGAGNTEAFF	TRBV20-1	TRBJ1-1
TGTGCCAGCAGAGAAGACGAGGGGAGGGGCCCCTACGAGCAGTACTTC	CASREDEGRGPYEQYF	TRBV11-3	TRBJ2-7
TGTGCCAGCAGCCCCGAGGGGGGGCACATTCAGTACTTC	CASSPEGGHIQYF	TRBV7-9	TRBJ2-4
TGTGCCAGTAGTATAGGTTCCGGGGAAAATGGCTACACCTTC	CASSIGSGENGYTF	TRBV19	TRBJ1-2
TGCGCCAGCAGCTTAGGAAAGGGGGGGAACACCGGGGAGCTGTTTTTT	CASSLGKGGNTGELFF	TRBV5-1	TRBJ2-2
TGTGCCAGCACCAGAAACACCATATATTTT	CASTRNTIYF	TRBV6-6	TRBJ1-3
TGTGCCACCAGTGATTTAGGCACAGGGGGCCTCCACACCATATATTTT	CATSDLGTGGLHTIYF	TRBV24-1	TRBJ1-3
TGTGCCAGTCGCCAACTCCCCTATCAGCCCCAGCATTTT	CASRQLPYQPQHF	TRBV19	TRBJ1-5
TGTGCCAGCAGCCAAGAGACGGGACAGGGGGGGCATTGGTATAGCAATCAGCCCCAGCATTTT	CASSQETGQGGHWYSNQPQHF	TRBV3-1	TRBJ1-5
TGTGCCAGCAGCATTTACAGATACAATGAGCAGTTCTTC	CASSIYRYNEQFF	TRBV7-4	TRBJ2-1
TGCAGTGCTATCAGATTCGAGGGAGATAAGGGGAATGAGAAGCGCTATGGCTACACCTTC	CSAIRFEGDKGNEKRYGYTF	TRBV20-1	TRBJ1-2
TGCGCCAGCAGCTTGGCCTTCTCGGACAGGGGCAATCAGCCCCAGCATTTT	CASSLAFSDRGNQPQHF	TRBV5-1	TRBJ1-5
TGTGCCACCCAAAGGGGGTTCACATGTGACGGTGGAAACACCATATATTTT	CATQRGFTCDGGNTIYF	TRBV24-1	TRBJ1-3
TGCGCCAGCAGCTTGTGGAGAAGCAATATCTATGGCTACACCTTC	CASSLWRSNIYGYTF	TRBV5-1	TRBJ1-2
TGTGCCACCAGTGGGGTTTTATGGGACAGGGATGGCTACACCTTC	CATSGVLWDRDGYTF	TRBV24-1	TRBJ1-2
TGCTGGTCGAGGGGTATGGAGGGAGGCTATGGCTACACCTTC	CWSRGMEGGYGYTF	TRBV20-1	TRBJ1-2
TGTGCCAGCACAGGGTTCCACCAGAATGCCTACGAGCAGTACTTC	CASTGFHQNAYEQYF	TRBV12-3	TRBJ2-7
TGCAGTGCGGGGAGCCACACTGAAGCTTTCTTT	CSAGSHTEAFF	TRBV20-1	TRBJ1-1
TGTGCCAGTAAGTCGGACAGGGGGCGGGGGGAAAAACTGTTTTTT	CASKSDRGRGEKLFF	TRBV19	TRBJ1-4
TGTGCCAGCGTGACAGGGCTTGTTGGGCGGCAGCCCCAGCATTTT	CASVTGLVGRQPQHF	TRBV5-6	TRBJ1-5
TGTGCCAGCAGTTGGGAGAGTCACACTGAAGCTTTCTTT	CASSWESHTEAFF	TRBV12-3	TRBJ1-1
TGTGCCAGCAGCCGAGATAAGCCCTACGAGCAGTACTTC	CASSRDKPYEQYF	TRBV3-1	TRBJ2-7
TGTGCCAGCATCCGCGGGAGCCTCCCCACTGAAGCTTTCTTT	CASIRGSLPTEAFF	TRBV14	TRBJ1-1
TGCAGTGCTACGGGAGGGCCGACCCAGTACTTC	CSATGGPTQYF	TRBV20-1	TRBJ2-5
TGTGCCAGCAGTGAAGGGGCAGGTCACTATGGCTACACCTTC	CASSEGAGHYGYTF	TRBV6-1	TRBJ1-2
TGTGCCAGGAGGGACAGGAACAGCTACGAGCAGTACTTC	CARRDRNSYEQYF	TRBV28	TRBJ2-7
TGCAGTGCTAGAGATCTCACGCGGGGAGGTGAGGGGCCATACGAGCAGTACTTC	CSARDLTRGGEGPYEQYF	TRBV20-1	TRBJ2-7
TGCGCCAGCAGCCCGGACAGGGACCTTAACTATGGCTACACCTTC	CASSPDRDLNYGYTF	TRBV4-1	TRBJ1-2
TGTGCCAGCAGCCAAGATACACCGACCTTAAACAGGGGTGAAGCTTTCTTT	CASSQDTPTLNRGEAFF	TRBV3-1	TRBJ1-1
TGCAGTGCATGGGACAGGATACCCGGAAATCAGCCCCAGCATTTT	CSAWDRIPGNQPQHF	TRBV20-1	TRBJ1-5
TGTGCCAGCAGCTGCCATAGCAGGAACACCGGGGAGCTGTTTTTT	CASSCHSRNTGELFF	TRBV7-2	TRBJ2-2
TGCGCCAGCAGTGCTACACAGGGGGATTCACCCCTCCACTTT	CASSATQGDSPLHF	TRBV10-1	TRBJ1-6
TGTGCCAGCGCCGTCCCCTGGGGGGGCAGGGAAGAGACCCAGTACTTC	CASAVPWGGREETQYF	TRBV27	TRBJ2-5
TGCGCCAGTCGTCAGACAGAGAGTCAGCCCCAGCATTTT	CASRQTESQPQHF	TRBV5-1	TRBJ1-5
TGTGCCAGCAGCTGGCTGGGTTTTTACTCCTACGAGCAGTACTTC	CASSWLGFYSYEQYF	TRBV7-9	TRBJ2-7
TGTGCCAGCAGCTTGGGCCGCCTCTTC	CASSLGRLF	TRBV7-2	TRBJ2-1
TGTGCCAGTAGTACCCGTCTGAGGGATTACACCGGGGAGCTGTTTTTT	CASSTRLRDYTGELFF	TRBV19	TRBJ2-2
TGCGCCAGCAGTGAGTCCCAGGCCCTGAGACAAGAGACCCAGTACTTC	CASSESQALRQETQYF	TRBV10-2	TRBJ2-5
TGCGCCAGCAGCCAAGAACAGCGGCAGGGCGAGCAGTACTTC	CASSQEQRQGEQYF	TRBV4-1	TRBJ2-7
TGCAACTCAGAGAGGGTTATTGAGACCCAGTACTTC	CNSERVIETQYF	TRBV20-1	TRBJ2-5
TGTGCCAGCACCCCCCAGCCGAATAGGGGTTGCACTGAAGCTTTCTTT	CASTPQPNRGCTEAFF	TRBV7-3	TRBJ1-1
TGTGCCAGCAGTTGTGGGGGGGGAACTGAAGCTTTCTTT	CASSCGGGTEAFF	TRBV6-6	TRBJ1-1
TGTGCCAGCAGAGTTGGACAGGGGATACGGTATAGCAATCAGCCCCAGCATTTT	CASRVGQGIRYSNQPQHF	TRBV6-4	TRBJ1-5
TGTGCCAGCAGCCAAGTAAGTCCGACATTCCAATTCCCTAATTCAGGGAACACAGATACGCAGTATTTT	CASSQVSPTFQFPNSGNTDTQYF	TRBV3-1	TRBJ2-3
TGTGCCAGCAGCTTACAGGGGAACGAGAACACTGAAGCTTTCTTT	CASSLQGNENTEAFF	TRBV7-2	TRBJ1-1
TGTGCCAGCACCGCGGGAGTTACCTACGAGCAGTACTTC	CASTAGVTYEQYF	TRBV9	TRBJ2-7
TGTGCCAGCACAATCGCCGGGACGGTCAATGAAAAACTGTTTTTT	CASTIAGTVNEKLFF	TRBV6-1	TRBJ1-4
TGTGCCAGCAGTTTATCGGGACCTCGACTGAGGGAGGTCCACTACGAGCAGTACTTC	CASSLSGPRLREVHYEQYF	TRBV28	TRBJ2-7
TGTGCCACCAGGGAGAATGAGCAGTTCTTC	CATRENEQFF	TRBV24-1	TRBJ2-1
TGTGCCAGCAGCGGGGGGACAGTCGTCACCGGGGAGCTGTTTTTT	CASSGGTVVTGELFF	TRBV7-4	TRBJ2-2
TGTGCCAGGCCTCTAAAGGGCCTCTATGGCTACACCTTC	CARPLKGLYGYTF	TRBV6-4	TRBJ1-2
TGTGCCAGCAGCTTGGGACGGGCTGAAGCTTTCTTT	CASSLGRAEAFF	TRBV7-4	TRBJ1-1
TGTGCCAGCTCACGTATCAGGACTGGCCCAAGGGTCTATGGCTACACCTTC	CASSRIRTGPRVYGYTF	TRBV18	TRBJ1-2
TGTGCCAGCAGTTACTCGAACCTGGGGGGGAGACTCCAAGTTCAAGAGACCCAGTACTTC	CASSYSNLGGRLQVQETQYF	TRBV6-5	TRBJ2-5
TGCAGCGTACGCAGGGCTGGGGCCAACGTCCTGACTTTC	CSVRRAGANVLTF	TRBV29-1	TRBJ2-6
TGTGCCAGCAGCCTTTTAGGCGGGAGGGGGGACTTC	CASSLLGGRGDF	TRBV14	TRBJ2-7
TGTGCCAGCAGTTTTGTTCCACTAGCGGGAGGGCTAAGTGGCTACACCTTC	CASSFVPLAGGLSGYTF	TRBV6-5	TRBJ1-2
TGTGCCAGATCAACAGGGCGTGGCTACACCTTC	CARSTGRGYTF	TRBV6-4	TRBJ1-2
TGCGCCAGCAGGTATCCAACGGGGGGAAACAATGAGCAGTTCTTC	CASRYPTGGNNEQFF	TRBV10-1	TRBJ2-1
TGTGCCAGCAGCTTAAGTTGGATTAGGGGGGTGGGCAATCAGCCCCAGCATTTT	CASSLSWIRGVGNQPQHF	TRBV7-4	TRBJ1-5
TGTGCCAGCATTACAGGACACAAAGGGGTAGAGAACACTGAAGCTTTCTTT	CASITGHKGVENTEAFF	TRBV27	TRBJ1-1
TGTGCCACCAGTGAGGGAGGGACAGGGACGGCGTCTGGCTACACCTTC	CATSEGGTGTASGYTF	TRBV24-1	TRBJ1-2
TGTGCCAGCAGCCGGTTCGGGGATGAGCAGTTCTTC	CASSRFGDEQFF	TRBV3-1	TRBJ2-1
TGCGCCAGCAGCTTACCCCCGGGACAGTCCTACGAGCAGTACTTC	CASSLPPGQSYEQYF	TRBV5-1	TRBJ2-7
TGCGCCAGCAGCTTGGCATTCCGAGCTTCCGACAGGAGGGATAAGTCCAATATGAGGACTGAAGCTTTCTTT	CASSLAFRASDRRDKSNMRTEAFF	TRBV5-1	TRBJ1-1
TGTGCCAGCAGACAAGATAGACGGGACCGTCTCTATGGCTACACCTTC	CASRQDRRDRLYGYTF	TRBV7-3	TRBJ1-2
TGTGCCAGCAAAAGCCATGGGCGGGGGGTCCCAGATACGCAGTATTTT	CASKSHGRGVPDTQYF	TRBV6-5	TRBJ2-3
TGTGCCAAAACTGTGGACACCGGGGGCTCCTACGAGCAGTACTTC	CAKTVDTGGSYEQYF	TRBV28	TRBJ2-7
TGTGCCAGCAAAAGAGAGACCCAGTACTTC	CASKRETQYF	TRBV6-4	TRBJ2-5
TGCGCCAGCAGCCGACGTAAAAGGGGGCAGACCGGAGATACGCAGTATTTT	CASSRRKRGQTGDTQYF	TRBV5-1	TRBJ2-3
TGTGCCAGCAGACAGGGATTTTTAACAACGCTAAGGCAGAACACTGAAGCTTTCTTT	CASRQGFLTTLRQNTEAFF	TRBV27	TRBJ1-1
TGTGCCAGCAGTGAAGCGCTTTCGTCCACAGCAACCTACGAGCAGTACTTC	CASSEALSSTATYEQYF	TRBV6-1	TRBJ2-7
TGTGCCAGCAGCTGGTATCGACTAGCGCCAAACACCGGGGAGCTGTTTTTT	CASSWYRLAPNTGELFF	TRBV13	TRBJ2-2
TGTGCCAGCAGCGGAAGTACTAGCGGCTACGAGCAGTACTTC	CASSGSTSGYEQYF	TRBV7-9	TRBJ2-7
TGTGCCAGCAGTGAAGCAGATCGGGGAGAGGAGGGACCTGGCTACACCTTC	CASSEADRGEEGPGYTF	TRBV6-1	TRBJ1-2
TGTGCCAGCAGCGTCCACCGACAGGCCAACTACGAGCAGTACTTC	CASSVHRQANYEQYF	TRBV9	TRBJ2-7
TGTGCCAGCAGCTTGTTTCGGACAGGACATTCACCCCTCCACTTT	CASSLFRTGHSPLHF	TRBV5-4	TRBJ1-6
TGCAGTGCTTCTCCCGGGACTAGCGGGCAGTCCTACGAGCAGTACTTC	CSASPGTSGQSYEQYF	TRBV20-1	TRBJ2-7
TGTGCCAGCAGCTTGGAGCGAAGAGGGGGGAGGAACACCGGGGAGCTGTTTTTT	CASSLERRGGRNTGELFF	TRBV5-6	TRBJ2-2
TGTGCCAGCAGCTTACTTCGAGAGACCCAGTACTTC	CASSLLRETQYF	TRBV13	TRBJ2-5
TGCGCCAGCAGCCAAGGACAGGTCGGGGGGGAGGGAGGGTCCTACAATGAGCAGTTCTTC	CASSQGQVGGEGGSYNEQFF	TRBV4-1	TRBJ2-1
TGTGCCAGCAGCCGGGTGGGACAGGGGACACAACCTAGCTACGAGCAGTACTTC	CASSRVGQGTQPSYEQYF	TRBV11-2	TRBJ2-7
TGTGCCACCAGGGGGGGCGAAAAACTGTTTTTT	CATRGGEKLFF	TRBV24-1	TRBJ1-4
TGTGCCAGCAGTCGGGGATGCAATCAGCCCCAGCATTTT	CASSRGCNQPQHF	TRBV6-5	TRBJ1-5
TGTGCCACCAGTGACCGGGACCCTCGGTACACCGGGGAGCTGTTTTTT	CATSDRDPRYTGELFF	TRBV24-1	TRBJ2-2
TGCGCCAGCAGCTTGGTGAACAGGGGGTCTAATGAAAAACTGTTTTTT	CASSLVNRGSNEKLFF	TRBV5-1	TRBJ1-4
TGTGCCAGGTATTCCGGGGAGCTGTTTTTT	CARYSGELFF	TRBV7-9	TRBJ2-2
TGTGCCATCACTCGGGACAAGCAAGAGACCCAGTACTTC	CAITRDKQETQYF	TRBV10-3	TRBJ2-5
TGCGCCAGCAGCTTGGCCAATGACAGGGTAAGCCCAGCTAACTATGGCTACACCTTC	CASSLANDRVSPANYGYTF	TRBV5-1	TRBJ1-2
TGCATGTGGGGCCCACGAAGCTCCTACAATGAGCAGTTCTTC	CMWGPRSSYNEQFF	TRBV20-1	TRBJ2-1
TGTGCCACCCAGGGACAGGAGAATGAAAAACTGTTTTTT	CATQGQENEKLFF	TRBV6-5	TRBJ1-4
TGTGCCAGCAGCGGACGCGGGGGCGCTACATATGAGCAGTTCTTC	CASSGRGGATYEQFF	TRBV7-4	TRBJ2-1
TGTGCCAGCACCCTAGCCAATGAGCAGTTCTTC	CASTLANEQFF	TRBV2	TRBJ2-1
TGTGCCAGCAGCAGGTCCGCGGACAGGGAAGCTTTCTTT	CASSRSADREAFF	TRBV5-5	TRBJ1-1
TGTGCCAGCAACCACAGGGGAGCAGACGAGCAGTACTTC	CASNHRGADEQYF	TRBV6-1	TRBJ2-7
TGCGCCAGCAGTGAGAGTCGTGAGGGCGACGATAATGAAAAACTGTTTTTT	CASSESREGDDNEKLFF	TRBV10-1	TRBJ1-4
TGTGCCAGCAGCAAAGGGAGGGCCTCAATGAACAATGAGCAGTTCTTC	CASSKGRASMNNEQFF	TRBV5-5	TRBJ2-1
TGCAGTGCTCTCTCACCTAATGAAAAACTGTTTTTT	CSALSPNEKLFF	TRBV20-1	TRBJ1-4
TGCAGTCAAGTCTTGGACTATAGCAATCAGCCCCAGCATTTT	CSQVLDYSNQPQHF	TRBV20-1	TRBJ1-5
TGTGCCAGCAGTTATCCTAGCGGGCCAGAAGAAGAGACCCAGTACTTC	CASSYPSGPEEETQYF	TRBV6-6	TRBJ2-5
TGTGCCAGCAGCCAGGATAGGGGGCCTAATCAGCCCCAGCATTTT	CASSQDRGPNQPQHF	TRBV4-2	TRBJ1-5
TGTGCCAGCAGTGACATTGAGGAAGGGACCCTAACTGAAGCTTTCTTT	CASSDIEEGTLTEAFF	TRBV6-4	TRBJ1-1
TGCGCCAGCAGCCAAGAGGGGACAGCGAGCAATCAGCCCCAGCATTTT	CASSQEGTASNQPQHF	TRBV4-1	TRBJ1-5
TGTGCCAGCAGTTACCACCAGGGACAAGGCAATCAGCCCCAGCATTTT	CASSYHQGQGNQPQHF	TRBV6-6	TRBJ1-5
TGTGCCAGCAGCACAGGGGGCAGAAACTTCAGTCAGCCCCAGCATTTT	CASSTGGRNFSQPQHF	TRBV7-9	TRBJ1-5
TGTGCCAGCAGCGTAGGCGCGGGAGTCAAAGAGACCCAGTACTTC	CASSVGAGVKETQYF	TRBV9	TRBJ2-5
TGCACCTTGATAGCGGCGGAACCCGGAACCTACAATGAGCAGTTCTTC	CTLIAAEPGTYNEQFF	TRBV20-1	TRBJ2-1
TGCACTATACTTCCCCCCTACGAGCAGTACTTC	CTILPPYEQYF	TRBV20-1	TRBJ2-7
TGCACCGGGGCTCAGCCCCAGCATTTT	CTGAQPQHF	TRBV29-1	TRBJ1-5
TGTGCCAGCAGCTTAGATACCCCGGGACAGGATGGCTATGGCTACACCTTC	CASSLDTPGQDGYGYTF	TRBV11-2	TRBJ1-2
TGCGCCAGCAGCTCAGGACGCCGAAGCAATCAGCCCCAGCATTTT	CASSSGRRSNQPQHF	TRBV5-1	TRBJ1-5
TGCGCCAGCAGGGGTAAGCCTATCGAGCAGTACTTC	CASRGKPIEQYF	TRBV5-1	TRBJ2-7
TGTGCCAGCAGTCCTGACAGGGTCCAGCCCCAGCATTTT	CASSPDRVQPQHF	TRBV28	TRBJ1-5
TGTGCCAGCAGCTTCAAGGGGGCGGGAGGGACTGAAGCTTTCTTT	CASSFKGAGGTEAFF	TRBV11-3	TRBJ1-1
TGTGCCAGCACTAACGACAGGGGGCGGAAGCGTGAGCAGTACTTC	CASTNDRGRKREQYF	TRBV5-4	TRBJ2-4
TGTGCCAGCAGCCAGATCATCACAGGCTCTCCCTACAATGAGCAGTTCTTC	CASSQIITGSPYNEQFF	TRBV5-4	TRBJ2-1
TGCGCCAGCAGCTGCCAATCAGGGGTGCTTCCCTACGAGCAGTACTTC	CASSCQSGVLPYEQYF	TRBV5-1	TRBJ2-7
TGTGCCAGCAGCCAAGATCCCGGACAGGAACCTGAAGCTAACTATGGCTACACCTTC	CASSQDPGQEPEANYGYTF	TRBV4-2	TRBJ1-2
TGTGCCAGCTATAAAGGACTAACCAATGAAAAACTGTTTTTT	CASYKGLTNEKLFF	TRBV11-1	TRBJ1-4
TGTGCCAGCAGCCCCCCGGGACAGGGGAGAGCGAGGGAAACCCTCCACTTT	CASSPPGQGRARETLHF	TRBV14	TRBJ1-6
TGTGCCAGCAGCTTAGTTGAAAAGCGGGACTCGACTTATAATTCACCCCTCCACTTT	CASSLVEKRDSTYNSPLHF	TRBV7-4	TRBJ1-6
TGTGCCAGCCGAACGGTCCATCAGCCCCAGCATTTT	CASRTVHQPQHF	TRBV6-1	TRBJ1-5
TGTGCCAGTAAAGTCTTCTACGAGCAGTACTTC	CASKVFYEQYF	TRBV19	TRBJ2-7
TGTGCCAGCTCACCAGGGACAGGGGAGGGGGAGCAGTTCTTC	CASSPGTGEGEQFF	TRBV18	TRBJ2-1
TGTGCCAGCAGCTTAAGGGTAGACTCTGGAAACACCATATATTTT	CASSLRVDSGNTIYF	TRBV7-9	TRBJ1-3
TGTGCCAGCATGTTGTCGCAGGGGAGATTGAACACTGAAGCTTTCTTT	CASMLSQGRLNTEAFF	TRBV7-8	TRBJ1-1
TGTGCCAGCAGCCAAACATCCTCTATTCTACAACATGAGCAGTTCTTC	CASSQTSSILQHEQFF	TRBV3-1	TRBJ2-1
TGTGCCAGCAGTTTAGCGCTAGGTAGCGGGGCCCCGGGACGCACAGATACGCAGTATTTT	CASSLALGSGAPGRTDTQYF	TRBV12-4	TRBJ2-3
TGTGCCAGCAGCCCCGCAGGGGACAGGGCCTGCCCCGAGCTGTTTTTT	CASSPAGDRACPELFF	TRBV5-4	TRBJ2-2
TGTGCCAGCTCCCTTAACAGGGGGGAGCCCCAGCATTTT	CASSLNRGEPQHF	TRBV27	TRBJ1-5
TGTGCCTGGAGTAATGACAGGGTGGGCTACGAGCAGTACTTC	CAWSNDRVGYEQYF	TRBV30	TRBJ2-7
TGTGCCAGCAGCCACACCCCAGCCCGGGAGGACAATCGTGAGACCCAGTACTTC	CASSHTPAREDNRETQYF	TRBV4-2	TRBJ2-5
TGCGCCAGCAGTGACGTGAACGCGGGAGCCAGCTCCTATAATTCACCCCTCCACTTT	CASSDVNAGASSYNSPLHF	TRBV10-1	TRBJ1-6
TGTGCCAGCAGCACAGGGGTGACAGGGGTAAGCACAGATACGCAGTATTTT	CASSTGVTGVSTDTQYF	TRBV9	TRBJ2-3
TGTGCCATAGGGTCGCAAGAATTAGGAGATACGCAGTATTTT	CAIGSQELGDTQYF	TRBV24-1	TRBJ2-3
TGTGCCAGCAGCGACGTTAGAGTCGGACTAGCGGGCGGAGAGCAGTTCTTC	CASSDVRVGLAGGEQFF	TRBV9	TRBJ2-1
TGTGCCAGCAGCACGTGGGGGGCCCCGTCCTACGAGCAGTACTTC	CASSTWGAPSYEQYF	TRBV14	TRBJ2-7
TGTGCCAGCAGAAGTAGGACCTACGAGCAGTACTTC	CASRSRTYEQYF	TRBV6-4	TRBJ2-7
TGTGCCATGAGGACAGGGCGGCAGAGGAACTATGGCTACACCTTC	CAMRTGRQRNYGYTF	TRBV28	TRBJ1-2
TGCAGTGAGACCGTTCCCCCGGGACAGGGGACTGAAGCTTTCTTT	CSETVPPGQGTEAFF	TRBV20-1	TRBJ1-1
TGTGCCAGCTCACCGGTTTGGGACAGGGGGTACTATGGCTACACCTTC	CASSPVWDRGYYGYTF	TRBV18	TRBJ1-2
TGTGCCAAGTCCGACAGGAGCGTCACTGAAGCTTTCTTT	CAKSDRSVTEAFF	TRBV6-1	TRBJ1-1
TGTGCCAGCAGCTCTAGTTTACATGGGTACGAGCAGTACTTC	CASSSSLHGYEQYF	TRBV5-5	TRBJ2-7
TGTGCCAGCGGGGAATCAAGGACGCGGGCCTACGAGCAGTACTTC	CASGESRTRAYEQYF	TRBV6-6	TRBJ2-7
TGTGCCAGCAGTTTCAAGAGTAATCAGCCCCAGCATTTT	CASSFKSNQPQHF	TRBV28	TRBJ1-5
TGTGCTAGTGTCTTCTCGCCCAGGGAGATTGGCTACACCTTC	CASVFSPREIGYTF	TRBV12-5	TRBJ1-2
TGTGCCAGCAGTGAGTCAAGTTGGACCTACAATGAGCAGTTCTTC	CASSESSWTYNEQFF	TRBV6-1	TRBJ2-1
TGTGCCAGCAGCTTATCCCCCGGGACTAGCGAGCAGTACTTC	CASSLSPGTSEQYF	TRBV7-9	TRBJ2-7
TGTGCCAGCAGCGTAGGCTATTCTTCGAAAATGAACACTGAAGCTTTCTTT	CASSVGYSSKMNTEAFF	TRBV9	TRBJ1-1
TGTGCCAGCCCCGGGCGGGACAGGGGGGTGGACCTTCAGCCCCAGCATTTT	CASPGRDRGVDLQPQHF	TRBV7-6	TRBJ1-5
TGTGCCAGCAGCATCCCCCCTCCCTTAGCCAAAAACATTCAGTACTTC	CASSIPPPLAKNIQYF	TRBV7-2	TRBJ2-4
TGTGCCAGGGATTTCACACAGGGTGGGAACACTGAAGCTTTCTTT	CARDFTQGGNTEAFF	TRBV9	TRBJ1-1
TGTGCCAGCAGCAAAAGCGAAGGGACTGGGGCCAACGTCCTGACTTTC	CASSKSEGTGANVLTF	TRBV6-5	TRBJ2-6
TGTGCCAGCAGCCCCTGCGGGAGCAGCACCGGGGAGCTGTTTTTT	CASSPCGSSTGELFF	TRBV7-4	TRBJ2-2
TGTGCCAGCAGCTTATGGAAATTCAGGGCGTCCGGGACTAGGAGGTCTAGGAGGGGGGAGGGCTACAATGAGCAGTTCTTC	CASSLWKFRASGTRRSRRGEGYNEQFF	TRBV11-3	TRBJ2-1
TGTGCCAGCAGCAGGAGGGGGACAGGGAGAGGCTACACCTTC	CASSRRGTGRGYTF	TRBV11-3	TRBJ1-2
TGTGCCAGCAGTTCAGGGGCTGAAGCTTTCTTT	CASSSGAEAFF	TRBV6-4	TRBJ1-1
TGTGCCAGCAGTGAGACCTCAGGTGACGAGCAGTACTTC	CASSETSGDEQYF	TRBV2	TRBJ2-7
TGTGCCAGCAGCCTCGGGCCCCAAAGGGGCCACCGGGGTCAGCCCCAGCATTTT	CASSLGPQRGHRGQPQHF	TRBV3-1	TRBJ1-5
TGTGCCAGCAGCGTCGGACAGGGAGTTTTGCCCGATAATGAAAAACTGTTTTTT	CASSVGQGVLPDNEKLFF	TRBV13	TRBJ1-4
TGTGCCAGCAGCGGGTCCCGGACAAGTGAAGCTTTCTTT	CASSGSRTSEAFF	TRBV7-9	TRBJ1-1
TGTGCCACCAGTGATTTTAGCGGGGGGAAATTAAGCCAGTACAATGAGCAGTTCTTC	CATSDFSGGKLSQYNEQFF	TRBV24-1	TRBJ2-1
TGTGCCAGCAGATTTCTGGACAGGGGGGAATTCAGGAACACTGAAGCTTTCTTT	CASRFLDRGEFRNTEAFF	TRBV6-2	TRBJ1-1
TGTGCCAGCAGATACCCGGGACAGGGGCTATATAGCAATCAGCCCCAGCATTTT	CASRYPGQGLYSNQPQHF	TRBV6-2	TRBJ1-5
TGTGCCAGCAGTGATCGGGGCTTGAACACTGAAGCTTTCTTT	CASSDRGLNTEAFF	TRBV27	TRBJ1-1
TGTGCCAGCAGGGTCACCACGGACACTGAAGCTTTCTTT	CASRVTTDTEAFF	TRBV27	TRBJ1-1
TGTGCCAGTAGGGACAGGGCTGGAAACACCATATATTTT	CASRDRAGNTIYF	TRBV19	TRBJ1-3
TGCGCCAGCAGCCGAGACCACGTACTCGACGAGCAGTACTTC	CASSRDHVLDEQYF	TRBV4-1	TRBJ2-7
TGTGCCAGCAGTCCCCCGGGGCCCCCAAGAGATCAGCCCCAGCATTTT	CASSPPGPPRDQPQHF	TRBV6-4	TRBJ1-5
TGCAGTGCTATCCATACGAGCTCCTACGAGCAGTACTTC	CSAIHTSSYEQYF	TRBV20-1	TRBJ2-7
TGTGCCAGCAGCTTAGGCAACACAAACGCGCGTAGCACAGATACGCAGTATTTT	CASSLGNTNARSTDTQYF	TRBV11-2	TRBJ2-3
TGTGCCAGTAGTAAGAACGATACAGGGGTGAAACGAGATCAGCCCCAGCATTTT	CASSKNDTGVKRDQPQHF	TRBV19	TRBJ1-5
TGTGCCAGCAGCTTGGAAAGATGGGGGGGACGTCCTAATAACAATCAGCCCCAGCATTTT	CASSLERWGGRPNNNQPQHF	TRBV5-6	TRBJ1-5
