TGTGCCAGCAGCTCCCAGGACTCGTCCTCCTACGAGCAGTACTTC	CASSSQDSSSYEQYF	TRBV13	TRBJ2-7
TGTGCCAGCAGTGCTACAGATACGCAGTATTTT	CASSATDTQYF	TRBV6-1	TRBJ2-3
TGTGCCAGCAGCACTCCCCCGGCGGGCACAGATACGCAGTATTTT	CASSTPPAGTDTQYF	TRBV13	TRBJ2-3
TGTGCCAGCAGTTTCACCGGGACTGGGGACACGAACACCGGGGAGCTGTTTTTT	CASSFTGTGDTNTGELFF	TRBV27	TRBJ2-2
TGTGCCAGCTCATGGGCGGAGCTAGCCAAAAACATTCAGTACTTC	CASSWAELAKNIQYF	TRBV18	TRBJ2-4
TGTGCCAGCAGCGCGGAGAATCAGCCCCAGCATTTT	CASSAENQPQHF	TRBV6-4	TRBJ1-5
TGTGCCGTTTTAGAGACCCAGTACTTC	CAVLETQYF	TRBV27	TRBJ2-5
TGTGCCAGCACAGGGTGCCGAGGCTACGAGCAGTACTTC	CASTGCRGYEQYF	TRBV9	TRBJ2-7
TGTGCCACCAGTGATTTGTCTTGGACAGGGAGCTACGAGCAGTACTTC	CATSDLSWTGSYEQYF	TRBV24-1	TRBJ2-7
TGTGCCAGCAGCTTACAACTTTCCACGCTGGGGGGGGAAAACAATGAGCAGTTCTTC	CASSLQLSTLGGENNEQFF	TRBV11-3	TRBJ2-1
TGTGCCAGCAGCGGCCCAGGGGCCTACCACTACGAGCAGTACTTC	CASSGPGAYHYEQYF	TRBV7-3	TRBJ2-7
TGCGCCAGTACAAGGGGTAACTATGGCTACACCTTC	CASTRGNYGYTF	TRBV10-1	TRBJ1-2
TGTGCCAGCAGTTCAAGATCCCGGGGGCCGGGGGGAGACGAGCAGTACTTC	CASSSRSRGPGGDEQYF	TRBV6-4	TRBJ2-7
TGCGCCAGCAGCTTGGGGGGGAGAACTGAAGCTTTCTTT	CASSLGGRTEAFF	TRBV5-1	TRBJ1-1
TGTGCCAGCACCAGCCGGGGGGGTGGGCTTGCCTACGAGCAGTACTTC	CASTSRGGGLAYEQYF	TRBV6-5	TRBJ2-7
TGCAGGGGGGGCGCGCAGTACTTC	CRGGAQYF	TRBV20-1	TRBJ2-7
TGTGCCAGCAGTTACGATAGTAGTGTGGTACGGGATGAGCAGTTCTTC	CASSYDSSVVRDEQFF	TRBV6-6	TRBJ2-1
TGTGCCATCAGTGAGTCAGTTCACGGACTGAGCTACGAGCAGTACTTC	CAISESVHGLSYEQYF	TRBV10-3	TRBJ2-7
TGCGCCAGCACTAGCGGGCGCTACGAGCAGTACTTC	CASTSGRYEQYF	TRBV10-2	TRBJ2-7
TGCAGTGCTTGGGGCTCGAACAGCACCTTCTCCTACGAGCAGTACTTC	CSAWGSNSTFSYEQYF	TRBV20-1	TRBJ2-7
TGTGCCACCAGTGAGTCGGAGGGGGGACTAGGATACAATGAGCAGTTCTTC	CATSESEGGLGYNEQFF	TRBV24-1	TRBJ2-1
TGTGCCAGCAGCTTAACGAAACTAGGTGATACGCAGTATTTT	CASSLTKLGDTQYF	TRBV7-3	TRBJ2-3
TGCGCCAGCAGCCGGTCACCGAAAGTACAGGGGGACGGCTCCTACGAGCAGTACTTC	CASSRSPKVQGDGSYEQYF	TRBV4-1	TRBJ2-7
TGTGCCAGCAGCTTAGTCTCAAGTCGGTCGATCTGGGGCTACACCTTC	CASSLVSSRSIWGYTF	TRBV11-1	TRBJ1-2
TGTGCCAGTAGTATTAGGGGGCTTGCCTTCTACGAGCAGTACTTC	CASSIRGLAFYEQYF	TRBV19	TRBJ2-7
TGTGCCAGCAGCTTGACACAGGGTTGGAGGCCCCAGCATTTT	CASSLTQGWRPQHF	TRBV7-3	TRBJ1-5
TGCGCCAGCAGGGGGGGTAACACCGGGGAGCTGTTTTTT	CASRGGNTGELFF	TRBV5-1	TRBJ2-2
TGTGCCAGCAGCGAGGAGTGCGGGATACACTACAATGAGCAGTTCTTC	CASSEECGIHYNEQFF	TRBV11-2	TRBJ2-1
TGTGCCAGCAGTTGCTGGGTTGGGAATGAAAAACTGTTTTTT	CASSCWVGNEKLFF	TRBV27	TRBJ1-4
TGCAGTGCTATTCCTCTATGGTTCTGCTATGGCTACACCTTC	CSAIPLWFCYGYTF	TRBV20-1	TRBJ1-2
TGCGCCAGCAGTGATAAGGGGGCCGAGGACACTGAAGCTTTCTTT	CASSDKGAEDTEAFF	TRBV10-2	TRBJ1-1
TGTGCCAGCAGTGCTACCACCTACCGAAAGGAGACCCAGTACTTC	CASSATTYRKETQYF	TRBV6-1	TRBJ2-5
TGCGCCAGCAGCTTAAACCAGGGCTTTTACGAGCAGTACTTC	CASSLNQGFYEQYF	TRBV5-1	TRBJ2-7
TGTGCCAGCAGTCGCGGGGGGGAGGAGGGTGGTGAGTGCAATCAGCCCCAGCATTTT	CASSRGGEEGGECNQPQHF	TRBV2	TRBJ1-5
TGTGCCAGCAGCCCGGGAGGGGGTCCGTATGGCTACACCTTC	CASSPGGGPYGYTF	TRBV28	TRBJ1-2
TGCGCCAGCAGCTTGCCCCCTGACAGAAAGCCCCAGCATTTT	CASSLPPDRKPQHF	TRBV5-1	TRBJ1-5
TGTGCCAGCAGTGATCCCCCAGCGGACACCTACGAGCAGTACTTC	CASSDPPADTYEQYF	TRBV2	TRBJ2-7
TGTGCCAGCAGCAAAACCCGCGGGGATGGCTACACCTTC	CASSKTRGDGYTF	TRBV13	TRBJ1-2
TGCGCCAGGTCAAACCCCGGGAGGACCTATGGCTACACCTTC	CARSNPGRTYGYTF	TRBV5-1	TRBJ1-2
TGTGCCAGCAGTGAGACTAGCGGGAGAGGGGTTGAGCAGTTCTTC	CASSETSGRGVEQFF	TRBV6-1	TRBJ2-1
TGTGCCAGCAGCGTAGGGAGGAGAGAGTCGTGCTCCTACAATGAGCAGTTCTTC	CASSVGRRESCSYNEQFF	TRBV9	TRBJ2-1
TGTGCCAGCAGCGTCCCCCCGGGTAGCGGTGAGTACTTC	CASSVPPGSGEYF	TRBV5-6	TRBJ2-7
TGTGCCAGCAGTAGAAGGGGCACCGGGGAGCTGTTTTTT	CASSRRGTGELFF	TRBV27	TRBJ2-2
TGCAGTGCTAGAGATCCAGGGCGGGAAGGATCCTACGAGCAGTACTTC	CSARDPGREGSYEQYF	TRBV20-1	TRBJ2-7
TGTGCCAGGACAGGGGGCGACTATGGCTACACCTTC	CARTGGDYGYTF	TRBV7-9	TRBJ1-2
TGTGCCAGCAGCATTGGGGGGGGATCGGCCTACGAGCAGTACTTC	CASSIGGGSAYEQYF	TRBV13	TRBJ2-7
TGTGCCACGTTTAGGACCGGGGAGCTGTTTTTT	CATFRTGELFF	TRBV6-4	TRBJ2-2
TGTGCCCTTGGCGGTTGGAGAGAGACCCAGTACTTC	CALGGWRETQYF	TRBV9	TRBJ2-5
TGTGCCAGCATTCGCCGGGATTTCGGCTACACCTTC	CASIRRDFGYTF	TRBV7-9	TRBJ1-2
TGTGCCAGCGCGGGGGAACAGAAAAGATACAATGAGCAGTTCTTC	CASAGEQKRYNEQFF	TRBV7-9	TRBJ2-1
TGTGCCAGCAGTGGGGGGCCAATGTGGGGCTTATTAAATACGCAGTATTTT	CASSGGPMWGLLNTQYF	TRBV6-1	TRBJ2-3
TGCAGTGCTCCTGGGGTTTGGCCCGGGGAGCTGTTTTTT	CSAPGVWPGELFF	TRBV20-1	TRBJ2-2
TGTGCCAGCAGCTCCAGGGGGGCGAGCTCCTACAATGAGCAGTTCTTC	CASSSRGASSYNEQFF	TRBV11-2	TRBJ2-1
TGTGCCAGCAGTTTAACTGTAGTGGGCCCGGGAGATACGCAGTATTTT	CASSLTVVGPGDTQYF	TRBV27	TRBJ2-3
TGTGCCAGCAGGACCAGCGGGAAATTCTACGAGCAGTACTTC	CASRTSGKFYEQYF	TRBV6-1	TRBJ2-7
TGTGCCAGTAGTTCCCCCCCGGGACGGCTCTATGGCTACACCTTC	CASSSPPGRLYGYTF	TRBV19	TRBJ1-2
TGTGCCAGCAGCCCTGGGAGGACAGGGAACCAAGAGACCCAGTACTTC	CASSPGRTGNQETQYF	TRBV9	TRBJ2-5
TGTGCCAGCAGTTACTCGAAACTCCTTTGGGAGGCGAACCATGGCTACACCTTC	CASSYSKLLWEANHGYTF	TRBV6-3	TRBJ1-2
TGTGCCAGCAGCCGAAAGGGGAACAATCAGCCCCAGCATTTT	CASSRKGNNQPQHF	TRBV3-1	TRBJ1-5
TGTGCCAGCAGCTTGGTAAGGGGGGCCACGAACACCGGGGAGCTGTTTTTT	CASSLVRGATNTGELFF	TRBV5-6	TRBJ2-2
TGCGCCAGCAGCGCTGTTTCCCAGCGGGAGTTCGGTAGCAATCAGCCCCAGCATTTT	CASSAVSQREFGSNQPQHF	TRBV5-1	TRBJ1-5
TGCAGTAGTACCTGGATGGGGGGAACCTACGAGCAGTACTTC	CSSTWMGGTYEQYF	TRBV20-1	TRBJ2-7
TGCAGCACCTACCCGGACAGGGCACTGATTTCCTACGAGCAGTACTTC	CSTYPDRALISYEQYF	TRBV29-1	TRBJ2-7
TGTGCCAGCAGCGAGTACTCGTTGGTTGGCTACACCTTC	CASSEYSLVGYTF	TRBV6-4	TRBJ1-2
TGCAGTGCTAGAGATGAGACTTCCCTACCCTACGAGCAGTACTTC	CSARDETSLPYEQYF	TRBV20-1	TRBJ2-7
TGTGCCAGCCGGGGCCGGGGCCAATACGAGCAGTACTTC	CASRGRGQYEQYF	TRBV6-1	TRBJ2-7
TGTGCCAGCAGAACGGGGACTGAAGCTTTCTTT	CASRTGTEAFF	TRBV6-2	TRBJ1-1
TGCGCCAGCAGCCGGGAGGTGTCAGATACGCAGTATTTT	CASSREVSDTQYF	TRBV5-1	TRBJ2-3
TGCGCCAGAGGCGGGGAGACCCAGTACTTC	CARGGETQYF	TRBV10-2	TRBJ2-5
TGTGCCAGCAGTTACGGGCGGGATAGCGAGCAGTACTTC	CASSYGRDSEQYF	TRBV27	TRBJ2-7
TGTGCCACCATGAGGAATTGCGGGGCTGGAAACACCATATATTTT	CATMRNCGAGNTIYF	TRBV24-1	TRBJ1-3
TGTGCCAATGAGACGTGCAGTGTGCATGGCTACACCTTC	CANETCSVHGYTF	TRBV7-8	TRBJ1-2
TGTGCCAGCAGCCTTGGGGGGTTTATGAACACTGAAGCTTTCTTT	CASSLGGFMNTEAFF	TRBV5-6	TRBJ1-1
TGTGCCAGCACGCGGGACAGGGGTCTCGAGCAGTACTTC	CASTRDRGLEQYF	TRBV6-5	TRBJ2-7
TGCGCCAGCAGCTTACTTCATCTACCCTACGAGCAGTACTTC	CASSLLHLPYEQYF	TRBV5-1	TRBJ2-7
TGTGCCAGCAGTGGTAGTGGGGGCTCGGCGACCCAGCATTTT	CASSGSGGSATQHF	TRBV6-4	TRBJ1-5
TGTGCCAGCAGCGTAGGCGTAGGGCCAGGATTTTTTAATGAAAAACTGTTTTTT	CASSVGVGPGFFNEKLFF	TRBV9	TRBJ1-4
TGTGCCAGCATCCTTGATCGACTTTATGAGCAGTTCTTC	CASILDRLYEQFF	TRBV6-1	TRBJ2-1
TGCATAGGGACGAACCGTGAAGCTTTCTTT	CIGTNREAFF	TRBV20-1	TRBJ1-1
TGTGCCAAGGGATCGGGGGGGCTAGGAAAAAACACCGGGGAGCTGTTTTTT	CAKGSGGLGKNTGELFF	TRBV25-1	TRBJ2-2
TGCAGTGCGCAGTGGGGGCCTGAGAACACTGAAGCTTTCTTT	CSAQWGPENTEAFF	TRBV20-1	TRBJ1-1
TGTGCCAGTAGTAGGGGTACCAAAAACATTCAGTACTTC	CASSRGTKNIQYF	TRBV19	TRBJ2-4
TGCAGCGCCGTCCAACTTAGGCGGCCATACTATGGCTACACCTTC	CSAVQLRRPYYGYTF	TRBV29-1	TRBJ1-2
TGCAGCGCCGCACCGGGACTAGCGGGAAGCACCGGGGAGCTGTTTTTT	CSAAPGLAGSTGELFF	TRBV29-1	TRBJ2-2
TGTGCCAGCAGCTTAACGCTAAAGTCCTCTGGAAACACCATATATTTT	CASSLTLKSSGNTIYF	TRBV7-3	TRBJ1-3
TGTGCCAGCAGCGTCCCGGGGATCTCTGGGGCCAACGTCCTGACTTTC	CASSVPGISGANVLTF	TRBV11-3	TRBJ2-6
TGTGCCAGCAGTCCTCCCGGACAGGGCTACACCTTC	CASSPPGQGYTF	TRBV27	TRBJ1-2
TGCAGCGAACCGAAGGGAGGGTCTTCAAGCTACAATGAGCAGTTCTTC	CSEPKGGSSSYNEQFF	TRBV29-1	TRBJ2-1
TGTGCCAGCAGCCGGCGTAAACAGGGCTTTCCGGACTCACCCCTCCACTTT	CASSRRKQGFPDSPLHF	TRBV11-3	TRBJ1-6
TGTGCCAGCAGCTTAGCGGGAATTAGGAATCAGCCCCAGCATTTT	CASSLAGIRNQPQHF	TRBV7-8	TRBJ1-5
TGTGCCAGCACGGCGGGGGCGGGCAATCAGCCCCAGCATTTT	CASTAGAGNQPQHF	TRBV6-8	TRBJ1-5
TGTGCCAGTAGTATGCGAGGGATACCTACTAACACAGATACGCAGTATTTT	CASSMRGIPTNTDTQYF	TRBV19	TRBJ2-3
TGCAGTGCTAGAAGGGGACAGGGAGGAGATGAAAAACTGTTTTTT	CSARRGQGGDEKLFF	TRBV20-1	TRBJ1-4
TGTGCCAGCACGGGGGGCGGGGAGAATCCCCCCGCCTATGGCTACACCTTC	CASTGGGENPPAYGYTF	TRBV12-4	TRBJ1-2
TGTGCCACCAGTGATTTGCATTTCTCTATGAAGGGAGCCAAAAACATTCAGTACTTC	CATSDLHFSMKGAKNIQYF	TRBV24-1	TRBJ2-4
TGTGCCAGCAGGTTAAAGTGGCGGGAGGGGATAAAGAACACTGAAGCTTTCTTT	CASRLKWREGIKNTEAFF	TRBV5-5	TRBJ1-1
TGTGCCTGGAGTGCCCCATGGCCGGGGGCGGGCCCTTTATACGAGCAGTACTTC	CAWSAPWPGAGPLYEQYF	TRBV30	TRBJ2-7
TGCGCCATCCGGTCTAAGCGGAGGGGCAACACCGGGGAGCTGTTTTTT	CAIRSKRRGNTGELFF	TRBV10-1	TRBJ2-2
TGCGCCAGCAGCCAAGATAATTACAGGGAAGTGAATACGGATCAGCCCCAGCATTTT	CASSQDNYREVNTDQPQHF	TRBV4-3	TRBJ1-5
TGCAGTGCTAGCGTAGCCGGGGTCCCTACCTATAATTCACCCCTCCACTTT	CSASVAGVPTYNSPLHF	TRBV20-1	TRBJ1-6
TGCGCCAGCAGCTTTGATCTGGGGCAGGCGGGAGATACGCAGTATTTT	CASSFDLGQAGDTQYF	TRBV5-1	TRBJ2-3
TGTGCCAGCAGTGAGGACGGCTATGGCTACACCTTC	CASSEDGYGYTF	TRBV6-4	TRBJ1-2
TGTGCCAGCAGCTTAGCCCCGGGCTTCTACGAGCAGTACTTC	CASSLAPGFYEQYF	TRBV7-8	TRBJ2-7
TGTGCCAGCAGCGAGGCGGCACGGTACGAGCAGTACTTC	CASSEAARYEQYF	TRBV13	TRBJ2-7
TGCGCCAGCAGAGGGGGGGCGGGGCAGCAGTTCTTC	CASRGGAGQQFF	TRBV5-1	TRBJ2-1
TGTGCCAGCTTTTTTCACCAGGGCAAACTGTTTTTT	CASFFHQGKLFF	TRBV12-3	TRBJ1-4
TGTGCCAGCTCACCCTCTGGACAGGTGACCGGTCCCCATTGGGACGAGCAGTACTTC	CASSPSGQVTGPHWDEQYF	TRBV18	TRBJ2-7
TGCGCCAGCCGGGGGGTCCCGGACAGGGTTTATATGGGTGAAGCTTTCTTT	CASRGVPDRVYMGEAFF	TRBV4-1	TRBJ1-1
TGCGCCAGCAGTCTAGGGGGGGGAGAAGACACAGATACGCAGTATTTT	CASSLGGGEDTDTQYF	TRBV4-1	TRBJ2-3
TGTGCCAGCAGTTACTTCTGGGGGGCTAGGGGGGGGACCTATAATTCACCCCTCCACTTT	CASSYFWGARGGTYNSPLHF	TRBV6-5	TRBJ1-6
TGTGCCAGCAGTGCGGCCGAGGGATTAGACAATGAGCAGTTCTTC	CASSAAEGLDNEQFF	TRBV6-5	TRBJ2-1
TGTGCCAGCAGCTTGGCCACGGGGGGCCTCGAGCAGTACTTC	CASSLATGGLEQYF	TRBV5-6	TRBJ2-7
TGTGCCAGCAGGCCTAGCGGGGGGGCCGCGGATGACAATGAGCAGTTCTTC	CASRPSGGAADDNEQFF	TRBV5-4	TRBJ2-1
TGTGCCATCAGTGAAGCGCGCCGGGGACTACGTAGCACAGATACGCAGTATTTT	CAISEARRGLRSTDTQYF	TRBV10-3	TRBJ2-3
TGTGCCAGCAGCACCGAGGGGGGCGGGAGCTCCTACAATGAGCAGTTCTTC	CASSTEGGGSSYNEQFF	TRBV13	TRBJ2-1
TGCGCCAGCAGTGAGGAGGGGTCCACGGTAGATACGCAGTATTTT	CASSEEGSTVDTQYF	TRBV10-1	TRBJ2-3
TGCGCCAGCAGTCTTCTCCCAGGAGGGGGGAGCTACGAGCAGTACTTC	CASSLLPGGGSYEQYF	TRBV4-3	TRBJ2-7
TGTGCCAGCAGCCAACCCCCCAGCCCGGGGCTGGGGGGGTTCACAGATACGCAGTATTTT	CASSQPPSPGLGGFTDTQYF	TRBV7-9	TRBJ2-3
TGTGCCAGCAGTGCCGGGGGGCGCTACGAGCAGTACTTC	CASSAGGRYEQYF	TRBV2	TRBJ2-7
TGTGCCACAAGGACTAGCGAGGCGCTGGAGACCCAGTACTTC	CATRTSEALETQYF	TRBV24-1	TRBJ2-5
TGCGCCAGCAGTGAGATTAGCGGGTGGGATGAGCAGTTCTTC	CASSEISGWDEQFF	TRBV10-1	TRBJ2-1
TGTGCCAGAGGGTGTATCCGGACTAGCACCACAGATACGCAGTATTTT	CARGCIRTSTTDTQYF	TRBV6-1	TRBJ2-3
TGTGCCAGTACGGCGACAGGGGCAGGCCTCACTGAAGCTTTCTTT	CASTATGAGLTEAFF	TRBV19	TRBJ1-1
TGCGCCAGCAGCCAAGAGGGGGCAATAATGAGCTACGAGCAGTACTTC	CASSQEGAIMSYEQYF	TRBV4-1	TRBJ2-7
TGTGCCAGAGTTAACTCCCCTAGCGGGTGCTCCTACAATGAGCAGTTCTTC	CARVNSPSGCSYNEQFF	TRBV25-1	TRBJ2-1
TGTGCCAGCCGCCGTGGCTCCTACGAGCAGTACTTC	CASRRGSYEQYF	TRBV6-2	TRBJ2-7
TGTGCCAGCAGGAGGACAGGGCATGTCCATCAGCCCCAGCATTTT	CASRRTGHVHQPQHF	TRBV6-4	TRBJ1-5
TGTGCCAGCAGCAACAGGGGGGATACGCAGTATTTT	CASSNRGDTQYF	TRBV14	TRBJ2-3
TGCGCCAGCAGCCACAGGCCAGCAAAACTGTTTTTT	CASSHRPAKLFF	TRBV5-1	TRBJ1-4
TGTGCCAGCAGCCAAGAACTAGCGGGTAACGACGAGCAGTACTTC	CASSQELAGNDEQYF	TRBV14	TRBJ2-7
TGTGCCAGCAGTGAACTGGGGGTGGCGACCCAGTACTTC	CASSELGVATQYF	TRBV25-1	TRBJ2-5
TGTGCCACCAGTGACAGGGGGCGGACCCGCTATGGCTACACCTTC	CATSDRGRTRYGYTF	TRBV24-1	TRBJ1-2
TGTGCCAGCAGTTCCCCCCCCCTACCGTCCTCCTACGAGCAGTACTTC	CASSSPPLPSSYEQYF	TRBV6-5	TRBJ2-7
TGTGCCAGCAGCTTAGCGTTACTGCACCTGACTGGGGGCACTGAAGCTTTCTTT	CASSLALLHLTGGTEAFF	TRBV7-9	TRBJ1-1
TGTGCCAGCAGCGGACAGGGCTCAACGACTAGCAATCAGCCCCAGCATTTT	CASSGQGSTTSNQPQHF	TRBV7-9	TRBJ1-5
TGTGCCACCCGCAGGGGAGGATACGGCTACGAGCAGTACTTC	CATRRGGYGYEQYF	TRBV24-1	TRBJ2-7
TGTGCCAGCAGCCGGGACGGGCAGAACACCGGGGAGCTGTTTTTT	CASSRDGQNTGELFF	TRBV2	TRBJ2-2
TGTGCCAGCTCCGGACCTCCCCTTGAGCAGTTCTTC	CASSGPPLEQFF	TRBV6-6	TRBJ2-1
TGTGCCCCCGGACGGGTAGTTAATGAGCAGTTCTTC	CAPGRVVNEQFF	TRBV30	TRBJ2-1
TGTGCCAGCAGCCTGGGGACTAGCGGGTACGAGCAGTACTTC	CASSLGTSGYEQYF	TRBV5-8	TRBJ2-7
TGCGCCAGCAGTGAAGTCGACAGGTTTCAGCCCCAGCATTTT	CASSEVDRFQPQHF	TRBV10-1	TRBJ1-5
TGCGCCAGCAGCTTGGGGACTGCGGGAGCCCGAGGTAGGGGCTGGACCGGGGAGCTGTTTTTT	CASSLGTAGARGRGWTGELFF	TRBV5-1	TRBJ2-2
TGTGCCAGCAGCTTAGCCCGCCAGAATGGCTACACCTTC	CASSLARQNGYTF	TRBV11-1	TRBJ1-2
TGTGCCAGGGCACCTTCCTACGAGCAGTACTTC	CARAPSYEQYF	TRBV6-2	TRBJ2-7
TGTGCCACCAGCAGTCATGGGGAGGCTCAGCCCCAGCATTTT	CATSSHGEAQPQHF	TRBV15	TRBJ1-5
TGCGCCAGCAGAGAACGTACAGGGGTTTATGAGCAGTTCTTC	CASRERTGVYEQFF	TRBV10-1	TRBJ2-1
TGTGCCAGCAGCGAAACCCGAGCAGATACGCAGTATTTT	CASSETRADTQYF	TRBV6-5	TRBJ2-3
TGCAGTGCTACAGGGAAAAGTCCCAAAAACATTCAGTACTTC	CSATGKSPKNIQYF	TRBV20-1	TRBJ2-4
TGTGCCAGCAGCGAATGGCCTAGCGCCCTCACCGGGGAGCTGTTTTTT	CASSEWPSALTGELFF	TRBV11-3	TRBJ2-2
TGTGCCAGCAAAAAACAGGGGGAACTGTACGAGCAGTACTTC	CASKKQGELYEQYF	TRBV7-9	TRBJ2-7
TGTGCCACCGACCTCCGGGACAGCTTGCTTCACACTGAAGCTTTCTTT	CATDLRDSLLHTEAFF	TRBV24-1	TRBJ1-1
TGTGCCAGCACCGTTTCGGAAGAAGAGGTCACAGATACGCAGTATTTT	CASTVSEEEVTDTQYF	TRBV2	TRBJ2-3
TGTGCCAGCTCCCTCGGGAACAGGGGGCGAAACACTGAAGCTTTCTTT	CASSLGNRGRNTEAFF	TRBV19	TRBJ1-1
TGTGCCAGCAGTCCCTCTATGGGGGGACAGGCGGTGGAAAAACTGTTTTTT	CASSPSMGGQAVEKLFF	TRBV27	TRBJ1-4
TGTGCCCGTTGGTTCACAGGGGGCCCCGCGAAAACTGAAGCTTTCTTT	CARWFTGGPAKTEAFF	TRBV7-9	TRBJ1-1
TGCGCCAGCAGCTTGGGGGGATGGGGCAGTGAAAAACTGTTTTTT	CASSLGGWGSEKLFF	TRBV5-1	TRBJ1-4
TGTGCCAGCAGCCACTGGACAGGAACGATGAACACTGAAGCTTTCTTT	CASSHWTGTMNTEAFF	TRBV3-1	TRBJ1-1
TGTGCCAGCAGTTTGACAGGGGGCGCCCCCTATAATTCACCCCTCCACTTT	CASSLTGGAPYNSPLHF	TRBV28	TRBJ1-6
TGTGCCAGCAGCCACCGTGACAGGGAGACCCAGTACTTC	CASSHRDRETQYF	TRBV9	TRBJ2-5
TGTGCCAGCAGCTGGCGTGAGCGGCCCTACACTGAAGCTTTCTTT	CASSWRERPYTEAFF	TRBV7-3	TRBJ1-1
TGTGCCAGCAGTGCAAAAAGGGGGTACTTC	CASSAKRGYF	TRBV6-4	TRBJ2-7
TGTGCCAGCAGCTTCAAAAATTCGGGACAGTCCCGGTTGTCCTACAATGAGCAGTTCTTC	CASSFKNSGQSRLSYNEQFF	TRBV5-5	TRBJ2-1
TGTGCCAGCAGCCAGGATCTTCCCATCTACGAGCAGTACTTC	CASSQDLPIYEQYF	TRBV13	TRBJ2-7
TGTGCCAGCATTGGACAGGGGGGTACTGGAAACACCATATATTTT	CASIGQGGTGNTIYF	TRBV6-4	TRBJ1-3
TGTGCCAGCAGTCGCCTCAGGGGGAAAAGGGCCCCTGAAGCTTTCTTT	CASSRLRGKRAPEAFF	TRBV6-5	TRBJ1-1
TGTGCCTGGCTCCCCAGACATGGGGGACAGGGACGCGGCTACACCTTC	CAWLPRHGGQGRGYTF	TRBV30	TRBJ1-2
TGTGCCACCAGTGGATCCGGGACAGGGGTGCGCATTCAGTACTTC	CATSGSGTGVRIQYF	TRBV24-1	TRBJ2-4
TGTGCCAGCAGTGACTCGACCGTAGGTTGGACAGGTGACCTTTATTTGAACACTGAAGCTTTCTTT	CASSDSTVGWTGDLYLNTEAFF	TRBV6-4	TRBJ1-1
TGTGCCAGCAGTTTAGTAAATTCGGGAGCCTATAATTCACCCCTCCACTTT	CASSLVNSGAYNSPLHF	TRBV27	TRBJ1-6
TGTGCCATACTCTCCCTTTCGACGGGACATAACTATGGCTACACCTTC	CAILSLSTGHNYGYTF	TRBV6-5	TRBJ1-2
TGCGCCAGCAGCTGCGGAGGGATGCGGTCCCAGGGCCCTGGAAACACCATATATTTT	CASSCGGMRSQGPGNTIYF	TRBV5-1	TRBJ1-3
TGTGCCACTACAGCAAGACCGAACACTGAAGCTTTCTTT	CATTARPNTEAFF	TRBV18	TRBJ1-1
TGTGCCAGCAGCGAAAAAAGAGGGCTCACAGATACGCAGTATTTT	CASSEKRGLTDTQYF	TRBV5-6	TRBJ2-3
TGCGCCAGTATACAGGGGGGGTCTGGAAACACCATATATTTT	CASIQGGSGNTIYF	TRBV5-1	TRBJ1-3
TGCGCCAGCAGCGTGACTAGCGGGCGAGGCTACGAGCAGTACTTC	CASSVTSGRGYEQYF	TRBV5-1	TRBJ2-7
TGTGCCATCAGTGGGGGGGGTACTTTAGATACGCAGTATTTT	CAISGGGTLDTQYF	TRBV10-3	TRBJ2-3
TGTGCCAGCGTCCCGGGACTAGCAAGCTCCTACAATGAGCAGTTCTTC	CASVPGLASSYNEQFF	TRBV9	TRBJ2-1
TGTGCCAAAACATCACGGAGAAAGACAGGGTGTGCCTCTGACGAGCAGTACTTC	CAKTSRRKTGCASDEQYF	TRBV27	TRBJ2-7
TGTGCCAGCAGCCCTGGGGGGGGCTACACCTTC	CASSPGGGYTF	TRBV12-3	TRBJ1-2
TGTGCCAGTAGTATAGATCCGGGACTAGGGCAGCAGAACACCGGGGAGCTGTTTTTT	CASSIDPGLGQQNTGELFF	TRBV19	TRBJ2-2
TGTGCCAGCAGCCAGCTCAATCTCAGTCAGCCCCAGCATTTT	CASSQLNLSQPQHF	TRBV6-8	TRBJ1-5
TGCGCCAGCAGGGCGGAGGGGGGGGAAACCGGGGAGCTGTTTTTT	CASRAEGGETGELFF	TRBV10-1	TRBJ2-2
TGTGCCAGCAGTTGGCTTACAAGCGGGAGTGTTGAAGCTTTCTTT	CASSWLTSGSVEAFF	TRBV6-9	TRBJ1-1
TGTGCTAGCAGCTATGGTCGGGACAGGGTGGGAAGCGGGTGTAATGAAAAACTGTTTTTT	CASSYGRDRVGSGCNEKLFF	TRBV7-7	TRBJ1-4
TGTGCCAGCAGGTGGGCGGCACAGGGAAAGCGGACTAATGAAAAACTGTTTTTT	CASRWAAQGKRTNEKLFF	TRBV27	TRBJ1-4
TGTGCCAGCAGCGAAAAAACGAAACACGGGGCTGGCAAGGAGCAGTTCTTC	CASSEKTKHGAGKEQFF	TRBV7-9	TRBJ2-1
TGTGCCACCAGTGATTTTCGGGACAGGGCCTTGAACACTGAAGCTTTCTTT	CATSDFRDRALNTEAFF	TRBV24-1	TRBJ1-1
TGCAGTGCTAGTAACCTAGGGGTACAGGGCCGGGTCTCCTATAATTCACCCCTCCACTTT	CSASNLGVQGRVSYNSPLHF	TRBV20-1	TRBJ1-6
TGTGCCAGCAGCTGGTATCAAGAGACCCAGTACTTC	CASSWYQETQYF	TRBV5-6	TRBJ2-5
TGCGCCAGCAGTGCCCCCCAGACAGGGGTTTTTCAAGAGACCCAGTACTTC	CASSAPQTGVFQETQYF	TRBV10-1	TRBJ2-5
TGTGCCAGAGCAGGGGGGGATTCACCCCTCCACTTT	CARAGGDSPLHF	TRBV6-1	TRBJ1-6
TGTGCCATCAGTGTGCCCCAGGGCCCGGAGGAAAAACTGTTTTTT	CAISVPQGPEEKLFF	TRBV10-3	TRBJ1-4
TGTGCCAGCAGCAAGGGCCTCCGGGACAGGTTCACAAACATTCAGTACTTC	CASSKGLRDRFTNIQYF	TRBV11-3	TRBJ2-4
TGCAGTGCTAGAGGCAGGGGGCGAGGGGAAAAACTGTTTTTT	CSARGRGRGEKLFF	TRBV20-1	TRBJ1-4
TGCGCCCCGGACAGGAGCCAAGAGACCCAGTACTTC	CAPDRSQETQYF	TRBV20-1	TRBJ2-5
TGCGCCAGCATTCGCCCATCCCCTAAGTACAGGGGTTCACCCCTCCACTTT	CASIRPSPKYRGSPLHF	TRBV10-2	TRBJ1-6
TGCAGCGTTGCAGAAACTGCTGTTGGGTATACGCAGTATTTT	CSVAETAVGYTQYF	TRBV29-1	TRBJ2-3
TGCGCCAGCAGTGCAGTCCATTACAGCCCTGGAAACACCATATATTTT	CASSAVHYSPGNTIYF	TRBV10-2	TRBJ1-3
TGTGCCAGCAGCGTACTTCAGGGGTATGAGCAGTTCTTC	CASSVLQGYEQFF	TRBV13	TRBJ2-1
TGTGCCAGCAGCCCAGACGCGGCCGGATCCCTGGGCTACGAGCAGTACTTC	CASSPDAAGSLGYEQYF	TRBV14	TRBJ2-7
TGTGCCAGCAGTAAGGGCTATCAGCCCCAGCATTTT	CASSKGYQPQHF	TRBV27	TRBJ1-5
TGTGCCAGCAGTTACAGCGGACAGAATGAAAAACTGTTTTTT	CASSYSGQNEKLFF	TRBV6-6	TRBJ1-4
TGCCTTACGGGCCCGAATGAGCAGTTCTTC	CLTGPNEQFF	TRBV5-1	TRBJ2-1
TGCAGTGCTAGAGACGGCCACACCGGGGAGCTGTTTTTT	CSARDGHTGELFF	TRBV20-1	TRBJ2-2
TGTGCCAGCAGTGAACTCCGGGGGTTTGAGACAGATACGCAGTATTTT	CASSELRGFETDTQYF	TRBV6-1	TRBJ2-3
TGCGCCAGCAGCTTGGCGCTTCTGAACACTGAAGCTTTCTTT	CASSLALLNTEAFF	TRBV5-1	TRBJ1-1
TGTGCCAGCAGCTTAAAAAACACTAGTGAGCAGTACTTC	CASSLKNTSEQYF	TRBV7-3	TRBJ2-7
TGCGCCAGCAGCCAAGTAGGCTCAGGGGAGCGGAACACTGAAGCTTTCTTT	CASSQVGSGERNTEAFF	TRBV4-3	TRBJ1-1
TGCGCCAGCAGCCCGCCCCAAAAGGGGACGGTGACCGGGGAGCTGTTTTTT	CASSPPQKGTVTGELFF	TRBV5-1	TRBJ2-2
TGCAGTGCTGGCGGGGGTCGCGATAGCTCCTACGAGCAGTACTTC	CSAGGGRDSSYEQYF	TRBV20-1	TRBJ2-7
TGCGCCAGCAACGTAGAGACAGGGACATACAATGAGCAGTTCTTC	CASNVETGTYNEQFF	TRBV5-1	TRBJ2-1
TGTGCCAGCAGTTTATACGAGAAAGGAGGGACGGGAGGGTCCGGTGAAGCTTTCTTT	CASSLYEKGGTGGSGEAFF	TRBV28	TRBJ1-1
TGTGCCAGCAGCTGGGATAACGAGCAGTACTTC	CASSWDNEQYF	TRBV11-3	TRBJ2-7
TGTGCCAGCACCCTGACAGGGCTACTCCCGGCCCAGCCCCAGCATTTT	CASTLTGLLPAQPQHF	TRBV27	TRBJ1-5
TGTGCCAGCAGTTTATCGGGGGGAGAGGATGAAAAACTGTTTTTT	CASSLSGGEDEKLFF	TRBV27	TRBJ1-4
TGTGCTAGTGTCCTGACAGGGGGCGAGGATTACTATGGCTACACCTTC	CASVLTGGEDYYGYTF	TRBV12-5	TRBJ1-2
TGTGCCAGCAGGGCTCGACAGGGCACTAGCTCCTACGAGCAGTACTTC	CASRARQGTSSYEQYF	TRBV5-8	TRBJ2-7
TGCGCCAGCAGCCACGAGGTGCAGGAACCTGGAAACACCATATATTTT	CASSHEVQEPGNTIYF	TRBV4-1	TRBJ1-3
TGTGCCAGCAGCTTAATTGAGAATAATGAAAAACTGTTTTTT	CASSLIENNEKLFF	TRBV7-3	TRBJ1-4
TGTGCCAGCAGCCCGTTCCCTGACAGCTCCTACAATGAGCAGTTCTTC	CASSPFPDSSYNEQFF	TRBV6-5	TRBJ2-1
TGTGCCAGCCAGGTCCATCAGCCCCAGCATTTT	CASQVHQPQHF	TRBV6-5	TRBJ1-5
TGTGCCAGCAGGGGACAGGGGAGTAGCAATCAGCCCCAGCATTTT	CASRGQGSSNQPQHF	TRBV6-3	TRBJ1-5
TGTGCCACCAGTGATTTTTCGCAAGGGGAGGCGGGCCACTATGGCTACACCTTC	CATSDFSQGEAGHYGYTF	TRBV24-1	TRBJ1-2
TGTGCCAGCAGTTTGATATTAACAGGGGAGACCCAGTACTTC	CASSLILTGETQYF	TRBV12-3	TRBJ2-5
TGTGCCCAGCCTAATAGCTATGGCTACACCTTC	CAQPNSYGYTF	TRBV12-3	TRBJ1-2
TGCAGTGCGAGCGACGGGCCCAGGAACACCGGGGAGCTGTTTTTT	CSASDGPRNTGELFF	TRBV20-1	TRBJ2-2
TGTGCCAGCAGGACTAGGACCGGGGAGCTGTTTTTT	CASRTRTGELFF	TRBV11-3	TRBJ2-2
TGTGCTAGTGGTTTTCAGGGTAGCAATCAGCCCCAGCATTTT	CASGFQGSNQPQHF	TRBV12-5	TRBJ1-5
TGTGCCAGCAGCCAAGGAAAACACAGGGGAGATAATCAGCCCCAGCATTTT	CASSQGKHRGDNQPQHF	TRBV14	TRBJ1-5
TGTGCCACCAGCAGACACACCATCCTTCTGGGGGGTGAAAAACTGTTTTTT	CATSRHTILLGGEKLFF	TRBV15	TRBJ1-4
TGCAGTGCCAGGGGGGCGGGATACTACAATGAGCAGTTCTTC	CSARGAGYYNEQFF	TRBV20-1	TRBJ2-1
TGTGCCAGCAGCAGAGGGAACACTGATAGCAATCAGCCCCAGCATTTT	CASSRGNTDSNQPQHF	TRBV6-2	TRBJ1-5
TGCGCCAGCAGCTTTCGGACAGAGGGGAACACTGAAGCTTTCTTT	CASSFRTEGNTEAFF	TRBV5-1	TRBJ1-1
TGTGCTAGTGGTGGGGGGGCTGTAACAGATACGCAGTATTTT	CASGGGAVTDTQYF	TRBV12-5	TRBJ2-3
TGTGCCAGCAGCCAAGATGCTGGAACGGGAGGCGCCAACACTGAAGCTTTCTTT	CASSQDAGTGGANTEAFF	TRBV3-1	TRBJ1-1
TGTGCCAGCAGCAGGGGGCTGGACACTGAAGCTTTCTTT	CASSRGLDTEAFF	TRBV28	TRBJ1-1
TGTGCCAGCATCTGGGGGGCCCAGCCCCAGCATTTT	CASIWGAQPQHF	TRBV12-3	TRBJ1-5
TGTGCCAGCAGCTTGGGGGGGGGCCCGACAGATACGCAGTATTTT	CASSLGGGPTDTQYF	TRBV13	TRBJ2-3
TGTGCCAGCAGTGGGACTGCTCGGACAGGCGAGACCCAGTACTTC	CASSGTARTGETQYF	TRBV6-4	TRBJ2-5
TGTGCCAGCAGTGAAGTCCATCGGGTGAATCAGCCCCAGCATTTT	CASSEVHRVNQPQHF	TRBV6-1	TRBJ1-5
TGTGCCAGCAGCCCCCTGGGGCCAAAATTCTATGGCTACACCTTC	CASSPLGPKFYGYTF	TRBV3-1	TRBJ1-2
TGTGCCAGCAGCTTAAGAGTGGCTAGCGGGTTGGTTGGGTACGAGCAGTACTTC	CASSLRVASGLVGYEQYF	TRBV7-3	TRBJ2-7
TGTGCCAGCAGTCGGTGTCCCAAAGGGCTAGCGGGATACGGGGCCAAAAACATTCAGTACTTC	CASSRCPKGLAGYGAKNIQYF	TRBV6-5	TRBJ2-4
TGTGCCAGCAGCGTAGGGAGGAGAAGTGATTCAATAAAACTGTTTTTT	CASSVGRRSDSIKLFF	TRBV9	TRBJ1-4
TGTGCCAGCAGGACAGGGCGGCATTTGGTCGAAAAACTGTTTTTT	CASRTGRHLVEKLFF	TRBV7-6	TRBJ1-4
TGCAGCGTTACCCTCGAGAAGCCGGGACAGGGAGGGTCACCCCTCCACTTT	CSVTLEKPGQGGSPLHF	TRBV29-1	TRBJ1-6
TGCAGCGTCGCCGGGCATGAGGCAAACGAGACTGGAAACACCATATATTTT	CSVAGHEANETGNTIYF	TRBV29-1	TRBJ1-3
TGTGCCAGCAAATGGACTTCAGAGACCCAGTACTTC	CASKWTSETQYF	TRBV6-8	TRBJ2-5
TGTGCCAGCATACCTATCCGGGACAGGGTTAGAAACTACGAGCAGTACTTC	CASIPIRDRVRNYEQYF	TRBV6-2	TRBJ2-7
TGTGCCAGCAGTTACCGCGGGACAGGCTCAGGAGTAGACGAGCAGTACTTC	CASSYRGTGSGVDEQYF	TRBV6-6	TRBJ2-7
TGCGCCAGCAGGAGTGGGACAGGGGTTAGCAGTTTGGAGGCGAACACCGGGGAGCTGTTTTTT	CASRSGTGVSSLEANTGELFF	TRBV5-1	TRBJ2-2
TGTGCCAGGGTTCCCGGGACAGGGGGTTTCTATGGCTACACCTTC	CARVPGTGGFYGYTF	TRBV2	TRBJ1-2
TGTGCCAGCAGTGAGGGTAGGCACTATGGCTACACCTTC	CASSEGRHYGYTF	TRBV6-4	TRBJ1-2
TGTGCCAGCAGCCAACGTCACTCTGGGGCCAACGTCCTGACTTTC	CASSQRHSGANVLTF	TRBV14	TRBJ2-6
TGTGCCAGCAGCGTAGTACCGGAAGGCTACACCTTC	CASSVVPEGYTF	TRBV9	TRBJ1-2
TGTGCCAGCAGCCTCCTAAGGGACACCGGTGGGGCCAACGTCCTGACTTTC	CASSLLRDTGGANVLTF	TRBV6-5	TRBJ2-6
TGTGCCAGCAGATCCTTATTTTGGGGGGAGGGCGGAGAGCAGTACTTC	CASRSLFWGEGGEQYF	TRBV2	TRBJ2-7
TGTGCCAGCAAGGGACCACAGGGCGACTATGGCTACACCTTC	CASKGPQGDYGYTF	TRBV6-1	TRBJ1-2
TGCAGTGCGGGACAGGGCTGCTTT	CSAGQGCF	TRBV20-1	TRBJ1-1
TGTGCCAGCAGCTTAGTAACTAGCGGGAGTTTGAGACTTTCAGATACGCAGTATTTT	CASSLVTSGSLRLSDTQYF	TRBV7-2	TRBJ2-3
TGTGCCAGCAGCATACCGGGGTGCTACGAGCAGTACTTC	CASSIPGCYEQYF	TRBV7-3	TRBJ2-7
TGTGCCAGTGGACAGGGGTGGGGCTACACCTTC	CASGQGWGYTF	TRBV7-2	TRBJ1-2
TGTGCCAGCAGCAGACAGAATTCACCCCTCCACTTT	CASSRQNSPLHF	TRBV13	TRBJ1-6
TGTGCCAGTAGTATAAAGGAGGGCTACCACAATGAGCAGTTCTTC	CASSIKEGYHNEQFF	TRBV19	TRBJ2-1
TGCAGTGCTTGGCTTGACAGGGGGGAGAACACTGAAGCTTTCTTT	CSAWLDRGENTEAFF	TRBV20-1	TRBJ1-1
TGTGCCAGCAGCTTAGGCGTGGCGGTCTCTGGAAACACCATATATTTT	CASSLGVAVSGNTIYF	TRBV7-9	TRBJ1-3
TGTGCCAGCAGCACACACCGGGACGGTACCTACGAGCAGTACTTC	CASSTHRDGTYEQYF	TRBV7-9	TRBJ2-7
TGTGCCAGCAGACAATGGGTGGAAGGGGGCCACATCTCCTACGAGCAGTACTTC	CASRQWVEGGHISYEQYF	TRBV27	TRBJ2-7
TGTGCCAGCAGTGAAAGACCATCAAGAAACAGGGATGCCTCTAACTATGGCTACACCTTC	CASSERPSRNRDASNYGYTF	TRBV2	TRBJ1-2
TGTGCCAGCGGGAACCGCGGCACAGATACGCAGTATTTT	CASGNRGTDTQYF	TRBV7-3	TRBJ2-3
TGTGCCATCAGTGAGAGCGCCGGGGGCAGTACTGAAGCTTTCTTT	CAISESAGGSTEAFF	TRBV10-3	TRBJ1-1
TGCGCCAGCAGCTTGACCCCGGGACGGAATCAGCCCCAGCATTTT	CASSLTPGRNQPQHF	TRBV5-1	TRBJ1-5
TGTGCCAGCAGCCAAGACCGGCCCCCGCCTACCATGCGACAGGGGGCTACCGGGGAGCTGTTTTTT	CASSQDRPPPTMRQGATGELFF	TRBV3-1	TRBJ2-2
TGTGCCAGCAGTTATTTTAAGACCAGAGGACGGGAAAAACTGTTTTTT	CASSYFKTRGREKLFF	TRBV6-2	TRBJ1-4
TGTGCCAGCAGTGTAATGACAGGGAACGAGCAGTACTTC	CASSVMTGNEQYF	TRBV6-5	TRBJ2-7
TGTGCCAGCAGTGAAGGGGCAACAGCCTACGAGCAGTACTTC	CASSEGATAYEQYF	TRBV25-1	TRBJ2-7
TGTGCCAGCAGCTTCAGAACACTCTATGGCTACACCTTC	CASSFRTLYGYTF	TRBV7-2	TRBJ1-2
TGCGCCAGCAGTCCGGGACAGGGACCGCTTCGGCATTTT	CASSPGQGPLRHF	TRBV10-2	TRBJ1-5
TGCGCCAGCGAAGTTGGGACAGGGAAGTATACGCAGTATTTT	CASEVGTGKYTQYF	TRBV10-2	TRBJ2-3
TGCAGTGCTAGTCCCACGCTAGGCGTGAATTCACCCCTCCACTTT	CSASPTLGVNSPLHF	TRBV20-1	TRBJ1-6
TGTGCCAGCTCACCTGGGGGGGATACTGGAAACACCATATATTTT	CASSPGGDTGNTIYF	TRBV18	TRBJ1-3
TGTGCCAGCAGCCAAGATCTGGGCTATGGCTACACCTTC	CASSQDLGYGYTF	TRBV14	TRBJ1-2
TGTGCCAGCAGTGAAGGGATCGGGAGAGGCTATGGCTACACCTTC	CASSEGIGRGYGYTF	TRBV6-1	TRBJ1-2
TGTGGGGGGGTAAACTCCTACGAGCAGTACTTC	CGGVNSYEQYF	TRBV12-3	TRBJ2-7
TGCAGTGCTAACAGGGCCAATCAGCCCCAGCATTTT	CSANRANQPQHF	TRBV20-1	TRBJ1-5
TGTGCCAGCAGCTGTTCAAGTGCGGGATCTATCAGCTCCTACGAGCAGTACTTC	CASSCSSAGSISSYEQYF	TRBV7-2	TRBJ2-7
TGTGCCAGCAGTTACTCGAGGGGATACAGGGGGCTGGGAGACTATGGCTACACCTTC	CASSYSRGYRGLGDYGYTF	TRBV6-5	TRBJ1-2
TGTGCCAGCAGGGTACAGTACTATGGCTACACCTTC	CASRVQYYGYTF	TRBV9	TRBJ1-2
TGTGCCAGCACGAGGGACAGGGGTCGGGGACATCAGCCCCAGCATTTT	CASTRDRGRGHQPQHF	TRBV6-4	TRBJ1-5
TGTGCCAGCAGCCATTGCGCGCGAAGGGTGATGAACACTGAAGCTTTCTTT	CASSHCARRVMNTEAFF	TRBV4-2	TRBJ1-1
TGCGCCAGCAGTGGGGACAAAAACATTCAGTACTTC	CASSGDKNIQYF	TRBV10-1	TRBJ2-4
TGTGCCAGCAGTGGGGCCGGGGAGGGCTACGAGCAGTACTTC	CASSGAGEGYEQYF	TRBV27	TRBJ2-7
TGTGCCAGTAGTATACCGACTAGCGGCGGGCCGAGCTCCTACAATGAGCAGTTCTTC	CASSIPTSGGPSSYNEQFF	TRBV19	TRBJ2-1
TGTGCCAGTAGTATTAACCGGAAGGCTGGAAACACCATATATTTT	CASSINRKAGNTIYF	TRBV19	TRBJ1-3
TGTGCCAGCAGCGACAGGGGGCCAGGATTCAACTATGGCTACACCTTC	CASSDRGPGFNYGYTF	TRBV5-4	TRBJ1-2
TGTGCCAGCAGCTTGGCATTAAACCTCGGGTACGAGCAGTACTTC	CASSLALNLGYEQYF	TRBV5-5	TRBJ2-7
TGTGCCAGTAGTAGTCGGGGCTACACCTTC	CASSSRGYTF	TRBV19	TRBJ1-2
TGCGCCAGCAGCTTGGGACCGGGGGAAAGGGCCCCTGAAAAACTGTTTTTT	CASSLGPGERAPEKLFF	TRBV5-1	TRBJ1-4
TGCGCCAGCAGCTTGCCTGCGGCGGGAAACACCGGGGAGCTGTTTTTT	CASSLPAAGNTGELFF	TRBV5-1	TRBJ2-2
TGTGCCAGCAGAACCAATACATTAAGCTCCTACGAGCAGTACTTC	CASRTNTLSSYEQYF	TRBV28	TRBJ2-7
TGCGCCAGTATCGGGGGAGCTTTCTTT	CASIGGAFF	TRBV5-1	TRBJ1-1
TGTGCCAGCAGTGGGTTTCCGGGTCGAGGACAGGGGGAAGAAAAACTGTTTTTT	CASSGFPGRGQGEEKLFF	TRBV6-1	TRBJ1-4
TGTGCTGATTGTGCAGGCTACAATGAGCAGTTCTTC	CADCAGYNEQFF	TRBV11-3	TRBJ2-1
TGTGCCAGCAGCCAAGACAGGGACAGGGGGAGCCCATCGAACACCGGGGAGCTGTTTTTT	CASSQDRDRGSPSNTGELFF	TRBV3-1	TRBJ2-2
TGTGCCAGCAGCCAAGGGGCTAGCCGAGCGAGCTCCTACAATGAGCAGTTCTTC	CASSQGASRASSYNEQFF	TRBV14	TRBJ2-1
TGTGCCAGCAGCTTAGTCAACGGGGGGGGACAGAGTTACAATGAGCAGTTCTTC	CASSLVNGGGQSYNEQFF	TRBV7-6	TRBJ2-1
TGTGCCAGCAGCCCGGGACTAGCGGTCAATGAGCAGTTCTTC	CASSPGLAVNEQFF	TRBV13	TRBJ2-1
TGTGCCAGCAGCCACACCCAAGTGCAGTACTTC	CASSHTQVQYF	TRBV14	TRBJ2-7
TGCGCCAAAACAGGGGGAAAAGGAGATGAAAAACTGTTTTTT	CAKTGGKGDEKLFF	TRBV5-1	TRBJ1-4
TGTGCCAGCCTCCGGGACAGGGGAGCACACTCTGGGGCCAACGTCCTGACTTTC	CASLRDRGAHSGANVLTF	TRBV19	TRBJ2-6
TGTGCCAGCAGCTTGACCGCTCGGGACTCTAATGAAAAACTGTTTTTT	CASSLTARDSNEKLFF	TRBV5-5	TRBJ1-4
TGCAGTGCTAGACGGTCCTCGGGGGGCAGACATCGCTACAATGAGCAGTTCTTC	CSARRSSGGRHRYNEQFF	TRBV20-1	TRBJ2-1
TGTGCCATCGTGTCGTACGATAAGAGTAAATACGAGCAGTACTTC	CAIVSYDKSKYEQYF	TRBV10-3	TRBJ2-7
TGTGCCAGCAGCCAAGTCATCCTGACAGGGAGCCCCGGAGGCACAGATACGCAGTATTTT	CASSQVILTGSPGGTDTQYF	TRBV3-1	TRBJ2-3
TGCAGCGTGGCTCCTGGGGCCAACGTCCTGACTTTC	CSVAPGANVLTF	TRBV29-1	TRBJ2-6
TGCAGTGCTACCTTAAGACCGTACGAGCAGTACTTC	CSATLRPYEQYF	TRBV20-1	TRBJ2-7
TGCGCCAGCAGCTTCGCCTCACTGAGGGACAATGAGCAGTTCTTC	CASSFASLRDNEQFF	TRBV5-1	TRBJ2-1
TGCAGTGCTAGAGATTGTCCCGATGGGGGGGCGGGCCCCTACGAGCAGTACTTC	CSARDCPDGGAGPYEQYF	TRBV20-1	TRBJ2-7
TGTGCCAGCAGTATCAGTCGTGTTAGGGGGGGATGCCCCTACGAGCAGTACTTC	CASSISRVRGGCPYEQYF	TRBV27	TRBJ2-7
TGTGCCAGCAGCTTCCAGAACAGGGGCTGGGGCAATCAGCCCCAGCATTTT	CASSFQNRGWGNQPQHF	TRBV11-1	TRBJ1-5
TGTGCCAGGACAGCTGCAACTAATGAAAAACTGTTTTTT	CARTAATNEKLFF	TRBV27	TRBJ1-4
TGTGCCAGCTCACCAACCGGGACAGTTAACGGCGGGGAGCTGTTTTTT	CASSPTGTVNGGELFF	TRBV18	TRBJ2-2
TGCGCCAGCAGCCAGCCGCGAGGAGGGGAGTACTTC	CASSQPRGGEYF	TRBV4-1	TRBJ2-7
TGTGCCAGCAGGACGGGATCCGGGACTAGCGGGAGGAGGTCCAATCAGCCCCAGCATTTT	CASRTGSGTSGRRSNQPQHF	TRBV12-4	TRBJ1-5
TGTGCCCTACTGCCCTGCGGGGGGGTATACAATGAGCAGTTCTTC	CALLPCGGVYNEQFF	TRBV28	TRBJ2-1
TGCAGTGCAGGGCCCTCACCAGGCCCCTACGAGCAGTACTTC	CSAGPSPGPYEQYF	TRBV20-1	TRBJ2-7
TGTGCCAGCAGCCGGGCGGACGGGGGCAATGAGCAGTTCTTC	CASSRADGGNEQFF	TRBV27	TRBJ2-1
TGTGCCACCAGCCTGGGGGGGACGGGATATGCCAAAAACATTCAGTACTTC	CATSLGGTGYAKNIQYF	TRBV24-1	TRBJ2-4
TGTGCCAGCAGCCTCAAGGGGCCCAATAATGAAAAACTGTTTTTT	CASSLKGPNNEKLFF	TRBV3-1	TRBJ1-4
TGTGGGGGGACAGGGGGAGCTACGCAGTATTTT	CGGTGGATQYF	TRBV7-3	TRBJ2-3
TGTGCCAGCAGTCGATACGGTGACAGTTGCTATGGCTACACCTTC	CASSRYGDSCYGYTF	TRBV6-5	TRBJ1-2
TGCAGTGCCGGTCAGGGTGCTGGGGCCAACGTCCTGACTTTC	CSAGQGAGANVLTF	TRBV20-1	TRBJ2-6
TGTGCCAGTAGTGTGGAGGACAATGAGCAGTTCTTC	CASSVEDNEQFF	TRBV19	TRBJ2-1
TGTGCCAGCAGTAGCGGGAACTACGAGCAGTACTTC	CASSSGNYEQYF	TRBV11-3	TRBJ2-7
TGTGCCAGCTCAACAGGGACAGATACGCAGTATTTT	CASSTGTDTQYF	TRBV18	TRBJ2-3
TGTGCCAGCAGTGGGGACAGGGTCACTGAAGCTTTCTTT	CASSGDRVTEAFF	TRBV6-4	TRBJ1-1
TGCGCCAGTTCTCGAAGAGGGGGCATGAAGACCCAGTACTTC	CASSRRGGMKTQYF	TRBV5-1	TRBJ2-5
TGTGCCAGCAGCGGGGGACAGGGGGCGGGTACCTACGAGCAGTACTTC	CASSGGQGAGTYEQYF	TRBV7-9	TRBJ2-7
TGTGCCACGTCTAGCTCCTACAATGAGCAGTTCTTC	CATSSSYNEQFF	TRBV12-4	TRBJ2-1
TGTGCCAGCAGCTTACCCACCAAGTTAGACTCTGGGGCCAACGTCCTGACTTTC	CASSLPTKLDSGANVLTF	TRBV7-9	TRBJ2-6
TGTGCCAGCAGATGGGACCGGTGCTCCTACGAGCAGTACTTC	CASRWDRCSYEQYF	TRBV6-3	TRBJ2-7
TGTGCCAGCAGCCCTGTAATTAGGGGCAACAACACTGAAGCTTTCTTT	CASSPVIRGNNTEAFF	TRBV7-3	TRBJ1-1
TGTGCCAGCAGCGTAATTTATGGACTAGCGGGTCCCTACGAGCAGTACTTC	CASSVIYGLAGPYEQYF	TRBV9	TRBJ2-7
TGTGCCAGCCTGAGGGAAAACGCAGGTGACACCGGGGAGCTGTTTTTT	CASLRENAGDTGELFF	TRBV12-3	TRBJ2-2
TGTGCCAGCATTCAGTCGACAGGGCGGACGGAGACCCAGTACTTC	CASIQSTGRTETQYF	TRBV25-1	TRBJ2-5
TGTGCCAGCAGCTTAGGGGGACAGGAGGGAAAAAATGAGCAGTTCTTC	CASSLGGQEGKNEQFF	TRBV7-3	TRBJ2-1
TGCGCCAGCAGCCATCCCCCTACAGGGAGTACCTACGAGCAGTACTTC	CASSHPPTGSTYEQYF	TRBV4-1	TRBJ2-7
TGCGCCAGCAGGGGGAGGACAGGCGCCGGGTTCTACGAGCAGTACTTC	CASRGRTGAGFYEQYF	TRBV5-1	TRBJ2-7
TGTGCCAGCAGCGCCAACAGGGTTATCACAGATACGCAGTATTTT	CASSANRVITDTQYF	TRBV7-4	TRBJ2-3
TGTGCCAGCAGCAGTTCCGGGACAGGGGCGCATGGCTACGAGCAGTACTTC	CASSSSGTGAHGYEQYF	TRBV11-2	TRBJ2-7
TGTGCCAGTAACCCATCCCCTGAAGCTTTCTTT	CASNPSPEAFF	TRBV19	TRBJ1-1
TGTGCCAGCATCACCCTAAAACCAGCCGGGGAAAAACTGTTTTTT	CASITLKPAGEKLFF	TRBV27	TRBJ1-4
TGTGCCATCAGTGGCGACAGGACAGATCAGCCCCAGCATTTT	CAISGDRTDQPQHF	TRBV10-3	TRBJ1-5
TGTGCCAGCAGCATTACAGGGGGCATTAATGGCTACACCTTC	CASSITGGINGYTF	TRBV13	TRBJ1-2
TGTGCCAGTCAGTGCCCGGGGATGTTGTTCGGTAGCACAGATACGCAGTATTTT	CASQCPGMLFGSTDTQYF	TRBV12-4	TRBJ2-3
TGTGCCAGCGGGGGTGCAGGGGGCGCGAACACTGAAGCTTTCTTT	CASGGAGGANTEAFF	TRBV28	TRBJ1-1
TGCGCCAGCAGCCGGTCCGGGACTAGCAGCCTCCAAGAGACCCAGTACTTC	CASSRSGTSSLQETQYF	TRBV5-1	TRBJ2-5
TGTGCCAGAGGGGAACCGAGACAGCTCAAACACGAGCAGTACTTC	CARGEPRQLKHEQYF	TRBV27	TRBJ2-7
TGCAGTGCAAAACGCTTGAAGGGGCGGGAGCACATGAACACTGAAGCTTTCTTT	CSAKRLKGREHMNTEAFF	TRBV20-1	TRBJ1-1
TGCGCCAGCAGCAATACCTTAGCCCATTCGGGACATTGGCATGAGCAGTTCTTC	CASSNTLAHSGHWHEQFF	TRBV5-1	TRBJ2-1
TGTGCCAGCAGTTACAATGGGGGGCATTACAATGAGCAGTTCTTC	CASSYNGGHYNEQFF	TRBV6-2	TRBJ2-1
TGTGCCAGCAGCCAAGTACGAGGACTCCCGAGGACCGGGGAGCTGTTTTTT	CASSQVRGLPRTGELFF	TRBV3-1	TRBJ2-2
TGCGCCAGCAGTGAGTCGCCACTCACGTGCAGCACAGATACGCAGTATTTT	CASSESPLTCSTDTQYF	TRBV10-1	TRBJ2-3
TGCAGTGCTGTCGGGACAGAAGGGGGTGAGCAGTACTTC	CSAVGTEGGEQYF	TRBV20-1	TRBJ2-7
TGCACCCCCCTCGGGGGGGCCTCCAATGAGCAGTTCTTC	CTPLGGASNEQFF	TRBV20-1	TRBJ2-1
TGTGCCAGCAGTTCTAAACGAACAGCTCAAGAGACCCAGTACTTC	CASSSKRTAQETQYF	TRBV27	TRBJ2-5
TGTGCCAGCAGGTCTCCCAGGGTAGAAAACTATGGCTACACCTTC	CASRSPRVENYGYTF	TRBV12-4	TRBJ1-2
TGTGCCAGCAGTGACAGGGAAGAGACCCAGTACTTC	CASSDREETQYF	TRBV5-4	TRBJ2-5
TGTGCTAGCAGTCGGAGGGGGGGGGCCTACAATGAGCAGTTCTTC	CASSRRGGAYNEQFF	TRBV7-7	TRBJ2-1
TGTGCCACTGGGAAAACGGGACAGTATCAGCCCCAGCATTTT	CATGKTGQYQPQHF	TRBV9	TRBJ1-5
TGTGCCAGGCCAGGGATCGCCGGGACTAGAAACACCGGGGAGCTGTTTTTT	CARPGIAGTRNTGELFF	TRBV6-5	TRBJ2-2
TGTGCCAGCAGTTGGGGGCGAGAGAAGGAAAAACTGTTTTTT	CASSWGREKEKLFF	TRBV16	TRBJ1-4
TGCGCCACATGGGGGCGCCCGGGGCAGAACTTC	CATWGRPGQNF	TRBV5-1	TRBJ2-7
TGTGCCAGCAGCTTAGCAGGGATCTCACCCCTCCACTTT	CASSLAGISPLHF	TRBV7-2	TRBJ1-6
TGTGCCACCAGTGAGTTAACTTGGACTTCAGGTCAGCCCCAGCATTTT	CATSELTWTSGQPQHF	TRBV24-1	TRBJ1-5
TGTGCCAGCAGTTTATCCGACCAATCAGACTCCTCTGGGGCCAACGTCCTGACTTTC	CASSLSDQSDSSGANVLTF	TRBV27	TRBJ2-6
TGTGCCAGCAGTTACTTTCAGGGGGGGCCGTCCTACGAGCAGTACTTC	CASSYFQGGPSYEQYF	TRBV6-2	TRBJ2-7
TGTGCCAGCAGCGGTGTCCTAGGGTTGACAGAGGTGAGCACTGAAGCTTTCTTT	CASSGVLGLTEVSTEAFF	TRBV13	TRBJ1-1
TGTGCCATCAGTGAGCGGGCTAGCAATCAGCCCCAGCATTTT	CAISERASNQPQHF	TRBV10-3	TRBJ1-5
TGTGCCAGCAGTACCGGGACTAGTAAAGATACGCAGTATTTT	CASSTGTSKDTQYF	TRBV13	TRBJ2-3
TGTGCCAGTACGGTGGGGGGCTATAACTATGGCTACACCTTC	CASTVGGYNYGYTF	TRBV19	TRBJ1-2
TGTGCCAGCAGCTTAGGAAGTGCCCCCTACAATGAGCAGTTCTTC	CASSLGSAPYNEQFF	TRBV11-1	TRBJ2-1
TGTGCCAGCAACCCCCGGGGACAGGATCAGCCCCAGCATTTT	CASNPRGQDQPQHF	TRBV6-4	TRBJ1-5
TGTGCCAGCAGCCAAGCCAACCACGGGAGGGTCTACGAGCAGTACTTC	CASSQANHGRVYEQYF	TRBV3-1	TRBJ2-7
TGTGCCAGTAGTATACCGACAGGCTCCAATGAAAAACTGTTTTTT	CASSIPTGSNEKLFF	TRBV19	TRBJ1-4
TGTGCCAGCAGCGGGGGCTCTGGGGGAACCTACGAGCAGTACTTC	CASSGGSGGTYEQYF	TRBV5-8	TRBJ2-7
TGTGCCAGCAGCATGTGGGGGGTTGTACCGGAGCTGTTTTTT	CASSMWGVVPELFF	TRBV13	TRBJ2-2
TGTGCCAGAGTGTTGACAGGACAGACCGGGGAGCTGTTTTTT	CARVLTGQTGELFF	TRBV10-3	TRBJ2-2
TGTGCCAGCAGTTACATTCATCGGACAGGGAGCAATCAGCCCCAGCATTTT	CASSYIHRTGSNQPQHF	TRBV6-5	TRBJ1-5
TGTGCCAGCAGTCCGGGGGGGTGCTACGAGCAGTACTTC	CASSPGGCYEQYF	TRBV9	TRBJ2-7
TGTGCCAGCAGTTACGTCGAGGGCCCTATGGTCTCCTACGAGCAGTACTTC	CASSYVEGPMVSYEQYF	TRBV6-5	TRBJ2-7
TGTGCCAGTGGAGCGCTCTGGTATAGCAATCAGCCCCAGCATTTT	CASGALWYSNQPQHF	TRBV2	TRBJ1-5
TGTGCCAGCAGCTTAGATGGTCAACCCGCATACGAGCAGTACTTC	CASSLDGQPAYEQYF	TRBV11-3	TRBJ2-7
TGTGCCAGCCATGTAACAGGGCTAGGATGCAATCAGCCCCAGCATTTT	CASHVTGLGCNQPQHF	TRBV25-1	TRBJ1-5
TGTGCCATGTTCGATAATGGGGGCGATGGGGGCAATCAGCCCCAGCATTTT	CAMFDNGGDGGNQPQHF	TRBV10-3	TRBJ1-5
TGTGCCAGCAGTTACTCCCTCAGGGGTTATGATTCACCCCTCCACTTT	CASSYSLRGYDSPLHF	TRBV6-5	TRBJ1-6
TGTGCCAGCAGCTTGAAACTTGGGGGGGCAGGCTACGAGCAGTACTTC	CASSLKLGGAGYEQYF	TRBV5-5	TRBJ2-7
TGCAGCGTTGAGGGCGGCCTCTATGGCTACACCTTC	CSVEGGLYGYTF	TRBV29-1	TRBJ1-2
TGCGCCAGCAGCTTGATCGGGTGGCGGGAATCGTACGAGCAGTACTTC	CASSLIGWRESYEQYF	TRBV5-1	TRBJ2-7
TGCAGCGCCTCCAAGCCCTCCAGGGGGTTCGAGACCAACGTCCTGACTTTC	CSASKPSRGFETNVLTF	TRBV29-1	TRBJ2-6
TGTGCCACAAGAAATGAGCAGTTCTTC	CATRNEQFF	TRBV24-1	TRBJ2-1
TGTGCCAGCAGCTTGATCCATAACAGCGAGGGGGGTAATCAGCCCCAGCATTTT	CASSLIHNSEGGNQPQHF	TRBV7-4	TRBJ1-5
TGTGCCAGTACCCCCGAATTACTGTTGGGTGGCTACACCTTC	CASTPELLLGGYTF	TRBV19	TRBJ1-2
TGTGCCAGCAGTCTTTGGACAGGGCGCCAAGAGACCCAGTACTTC	CASSLWTGRQETQYF	TRBV6-2	TRBJ2-5
TGTGCCAGCAGCGTGTCTCCTAACGGTGACTACGAGCAGTACTTC	CASSVSPNGDYEQYF	TRBV6-3	TRBJ2-7
TGTGCCAGCAGTTTCTGGACGGGGCAGCCCCAGCATTTT	CASSFWTGQPQHF	TRBV7-9	TRBJ1-5
TGCGCCAGCACCACAGGGGGCGGGGACTACGAGCAGTACTTC	CASTTGGGDYEQYF	TRBV10-1	TRBJ2-7
TGCGCCAGCAGAATAACGATTACAGGGGCCCAGCCCCAGCATTTT	CASRITITGAQPQHF	TRBV10-1	TRBJ1-5
TGTGCCAGCAGCCGGACTAGCGGGCCTGGGAACACCGGGGAGCTGTTTTTT	CASSRTSGPGNTGELFF	TRBV13	TRBJ2-2
TGTGCCAGCAGCGTAGGGGGGGCTAACTATGGCTACACCTTC	CASSVGGANYGYTF	TRBV9	TRBJ1-2
TGTGCCACTGGGGGGGGGCGTGAGACCCAGTACTTC	CATGGGRETQYF	TRBV12-3	TRBJ2-5
TGTGCCAGCAGTTACACGACAGGGGAGCCCGTTGAGACCCAGTACTTC	CASSYTTGEPVETQYF	TRBV6-6	TRBJ2-5
TGTGCCAGCAGCGACAGGGGTGACGACTCCTACGAGCAGTACTTC	CASSDRGDDSYEQYF	TRBV7-9	TRBJ2-7
TGTGCCAGCAGCCAGCGAACGGACAGGGGGCTCCCCGAGACCCAGTACTTC	CASSQRTDRGLPETQYF	TRBV3-1	TRBJ2-5
TGCGCCAGCAGCGAGGGGGAGCTGTTTTTT	CASSEGELFF	TRBV5-1	TRBJ2-2
TGCGCCAGCAGCCTGGATTTCCCGTCCTGGTACAATGAGCAGTTCTTC	CASSLDFPSWYNEQFF	TRBV4-1	TRBJ2-1
TGTGCCAGCAGTTGTCGAGGAGACTCACCGTACCAAGAGACCCAGTACTTC	CASSCRGDSPYQETQYF	TRBV6-4	TRBJ2-5
TGTGCCAGCGAGCAGAAAGACACCGGGGAGCTGTTTTTT	CASEQKDTGELFF	TRBV5-6	TRBJ2-2
TGCAGTGCTAGCCATCTACAGGGGGCGAACACCGGGGAGCTGTTTTTT	CSASHLQGANTGELFF	TRBV20-1	TRBJ2-2
TGTGCTAGCAGCGCGGAGGTTGGGGCTTTCTTT	CASSAEVGAFF	TRBV7-7	TRBJ1-1
TGTGCCAGCAGCACCCTAGCTGGGATTTCAGATACGCAGTATTTT	CASSTLAGISDTQYF	TRBV13	TRBJ2-3
TGTGCGCGGTCGAGCCCGGAGACATACAATGAGCAGTTCTTC	CARSSPETYNEQFF	TRBV6-5	TRBJ2-1
TGTGCCAGCAGCCAAGCTACCGAGGAATACGAAGCTTTCTTT	CASSQATEEYEAFF	TRBV3-1	TRBJ1-1
TGTGCCGACCCGGGACGGACCTACAATGAGCAGTTCTTC	CADPGRTYNEQFF	TRBV6-4	TRBJ2-1
TGTGCCAGCAGTGACAGGGATTTGAACACCGGGGAGCTGTTTTTT	CASSDRDLNTGELFF	TRBV27	TRBJ2-2
TGTGCCAGCAGCTATCGGAGGATACCCCCCTGTTCGGGAGCGGGCATGAACACTGAAGCTTTCTTT	CASSYRRIPPCSGAGMNTEAFF	TRBV6-1	TRBJ1-1
TGTGCCAGCAGTTACTCGAAATTCGGCGGCTATGGCTACACCTTC	CASSYSKFGGYGYTF	TRBV6-5	TRBJ1-2
TGTGCCAGCAGCCAAGATCTAGGGGGGGGAGTATCGGGTACTAATGAAAAACTGTTTTTT	CASSQDLGGGVSGTNEKLFF	TRBV4-2	TRBJ1-4
TGTGCCAGCAGTTTGTCAGACGGCGAGCAGTACTTC	CASSLSDGEQYF	TRBV27	TRBJ2-7
TGCGCCAGCACCCCTGCCGGAGGGAAGGCCCTCCACTTT	CASTPAGGKALHF	TRBV5-1	TRBJ1-6
TGTGCCAGCAGCCAATCGGGACAGGGTCGGGCCAACACCGGGGAGCTGTTTTTT	CASSQSGQGRANTGELFF	TRBV3-1	TRBJ2-2
TGTGCTAGTGGTTTGGTACCTGCGGAACCGCTTCCAGATACGCAGTATTTT	CASGLVPAEPLPDTQYF	TRBV12-5	TRBJ2-3
TGTGCCAGCAGTTATTCGGAACAAGGGACAGAACCCTACGAGCAGTACTTC	CASSYSEQGTEPYEQYF	TRBV6-9	TRBJ2-7
TGTGCCAGCAGCTTGGACCCGCCGGGACAGGGGCGGTGGCCTTTCTACGAGCAGTACTTC	CASSLDPPGQGRWPFYEQYF	TRBV5-5	TRBJ2-7
TGTGCCAGCAGCATGGACAGGAGGAACACTGAAGCTTTCTTT	CASSMDRRNTEAFF	TRBV13	TRBJ1-1
TGCAGTGCTTGCCCGAGCATTTCGGGACGTAACACCGGGGAGCTGTTTTTT	CSACPSISGRNTGELFF	TRBV20-1	TRBJ2-2
TGTGCCAGCAGTGAATCACCCCACAGGGGCCCCGAGCAGTACTTC	CASSESPHRGPEQYF	TRBV2	TRBJ2-7
TGTGCCAGCAGCGTGGCCGGGACAGGGGGGGTTCCGGCTAACTATGGCTACACCTTC	CASSVAGTGGVPANYGYTF	TRBV9	TRBJ1-2
TGTGCCAGCAGCCAAAGAGTGGAACTATACGTAGGACAGCGGCTAGCCAAAAACATTCAGTACTTC	CASSQRVELYVGQRLAKNIQYF	TRBV3-1	TRBJ2-4
TGTGCCAGCAGCTCCCCCACGAGGCAAACGGATGGAAACACTGAAGCTTTCTTT	CASSSPTRQTDGNTEAFF	TRBV7-3	TRBJ1-1
TGTGCCAGCAGCTGGGTGGGCTACACCTTC	CASSWVGYTF	TRBV7-7	TRBJ1-2
TGTGCTAGTGGTTTGGTACCGCTACTGACGCATAGCAATCAGCCCCAGCATTTT	CASGLVPLLTHSNQPQHF	TRBV12-5	TRBJ1-5
TGTGCCAGCAGTGACTGGAACAACAGAGGACTAGCGGGCGGAGTTGGGACCGGGGAGCTGTTTTTT	CASSDWNNRGLAGGVGTGELFF	TRBV6-4	TRBJ2-2
TGTGCCTCCGGCAAACGAACCTACGAGCAGTACTTC	CASGKRTYEQYF	TRBV30	TRBJ2-7
TGCGCCACCGGGCCGACCGGGGAGCTGTTTTTT	CATGPTGELFF	TRBV10-1	TRBJ2-2
TGTGCCAGCAGTTACTCGCAGCGGACGGACACTGAAGCTTTCTTT	CASSYSQRTDTEAFF	TRBV6-6	TRBJ1-1
TGTGCCAGCAGGACAGGGGACGAGCAGTACTTC	CASRTGDEQYF	TRBV7-9	TRBJ2-7
TGTGCCAGTAGTATAGATCAAGACAGGGAGGGGTGGGGTAACTATGGCTACACCTTC	CASSIDQDREGWGNYGYTF	TRBV19	TRBJ1-2
TGTGCCAGCACCGGAGGTGCGGGACAAGCCGAGCAGTACTTC	CASTGGAGQAEQYF	TRBV6-1	TRBJ2-7
TGTGCTAGTGGTTTGAGTTCCTCCATCGGGTCCTATAATTCACCCCTCCACTTT	CASGLSSSIGSYNSPLHF	TRBV12-5	TRBJ1-6
TGTGCCAGCAGCTTAGGGGGGGGGGGCTATCCATTGAACACTGAAGCTTTCTTT	CASSLGGGGYPLNTEAFF	TRBV11-3	TRBJ1-1
TGTGCCAGCAGTGGCAATTATCCCAACAGGGGGCAGGACACAGATACGCAGTATTTT	CASSGNYPNRGQDTDTQYF	TRBV6-4	TRBJ2-3
TGCGCCAGCAGCCAAGGCGACGGACTAAAAAACATTCAGTACTTC	CASSQGDGLKNIQYF	TRBV4-1	TRBJ2-4
TGCGCCAGGCTAGCGGGGCATCCCTACAATGAGCAGTTCTTC	CARLAGHPYNEQFF	TRBV5-1	TRBJ2-1
TGTGCCAGCAGTACGGGGCCCTCACGAAGCTCCTACGAGCAGTACTTC	CASSTGPSRSSYEQYF	TRBV27	TRBJ2-7
TGTGCCAGCAGTCGGAGTTCAGCAGGGGGATGGCAGGACGGGGGAAACACCATATATTTT	CASSRSSAGGWQDGGNTIYF	TRBV12-3	TRBJ1-3
TGTGCCAGCAGTTGTGTACAGGTCAATCAGCCCCAGCATTTT	CASSCVQVNQPQHF	TRBV27	TRBJ1-5
TGTGCCAGCAGCTTCTGGGGGAACACTGAAGCTTTCTTT	CASSFWGNTEAFF	TRBV9	TRBJ1-1
TGTGCCAGCAGCTTAGATTTCGGCTCCTACGAGCAGTACTTC	CASSLDFGSYEQYF	TRBV11-2	TRBJ2-7
TGTGCAGAAGGCGGGGATTCACCCCTCCACTTT	CAEGGDSPLHF	TRBV30	TRBJ1-6
TGTGCCAGCAGCTTAGGGGACAGGGGATGCTATAATTCACCCCTCCACTTT	CASSLGDRGCYNSPLHF	TRBV5-6	TRBJ1-6
TGTGCCTGGAGTGGCAAGAGGTTCAAGAACACTGAAGCTTTCTTT	CAWSGKRFKNTEAFF	TRBV30	TRBJ1-1
TGTGCCAGCAGCTTAACGATGACAGGGGGCTACACCTTC	CASSLTMTGGYTF	TRBV7-3	TRBJ1-2
TGCGCCAGCAGCTATCAATCCGACCTCCTCTATGGCTACACCTTC	CASSYQSDLLYGYTF	TRBV5-1	TRBJ1-2
TGTGCCAGCAGTTCCCCCGGGACACCCCGGCAGCGGGGCTACACCTTC	CASSSPGTPRQRGYTF	TRBV27	TRBJ1-2
TGCGCCAGCAGCCGACAGTTTGATGGCTACACCTTC	CASSRQFDGYTF	TRBV5-1	TRBJ1-2
TGTGCCAGCATTACCGCGGGAGGTTCCACTGGAAACACCATATATTTT	CASITAGGSTGNTIYF	TRBV6-2	TRBJ1-3
TGTGCCAGCAGCTACACATCCGGGTATCAGCCCCAGCATTTT	CASSYTSGYQPQHF	TRBV13	TRBJ1-5
TGTGCCAGGGGGGAGAATCCCCCAGGGGTGCCTCAGCCCCAGCATTTT	CARGENPPGVPQPQHF	TRBV7-2	TRBJ1-5
TGCGCCAGCAGCTTGGGGAGCAGGACGCTACTGGAGGGCTCCTACGAGCAGTACTTC	CASSLGSRTLLEGSYEQYF	TRBV5-1	TRBJ2-7
TGTGCCTGGCCCGCAAGGGGTAAACAGAGCTATCAGCCCCAGCATTTT	CAWPARGKQSYQPQHF	TRBV30	TRBJ1-5
TGTGCCAGCAGTTTATGCTGTTCCCGACTAGCGGGTTACGAGCAGTACTTC	CASSLCCSRLAGYEQYF	TRBV28	TRBJ2-7
TGTGCCACACAGGGACGCGTGGCCTCCTACAATGAGCAGTTCTTC	CATQGRVASYNEQFF	TRBV24-1	TRBJ2-1
TGCAGTGCTAGCAGGGGGTTCCCGTCTGGCTACACCTTC	CSASRGFPSGYTF	TRBV20-1	TRBJ1-2
TGTGCCAGCAGTGAACCACCGGCCCGCGGGAGCTCTGGAAACACCATATATTTT	CASSEPPARGSSGNTIYF	TRBV6-1	TRBJ1-3
TGTGCCAGCACAGTGGAGGATACTAGCACAGATACGCAGTATTTT	CASTVEDTSTDTQYF	TRBV6-4	TRBJ2-3
TGTGCCAGCAGCCAAGTCGTGCGCCGAGGGCCTGCACTACGCTACGAGCAGTACTTC	CASSQVVRRGPALRYEQYF	TRBV14	TRBJ2-7
TGCGCCAGCAGCCGTATTCCCCTTAGAGGAGTTCGAGGTCCCTCCTATAATTCACCCCTCCACTTT	CASSRIPLRGVRGPSYNSPLHF	TRBV4-3	TRBJ1-6
TGTGCCAGCAATTTACGTGGGCGCTATGGCTACACCTTC	CASNLRGRYGYTF	TRBV6-5	TRBJ1-2
TGTGCCAGCAGCTTAGACCAATTACCCAGGCAGGGGGCTGAAGCTTTCTTT	CASSLDQLPRQGAEAFF	TRBV11-3	TRBJ1-1
TGCAGTGCTAGGTTTCAGGGGAAGTTAGTAGAGACCCAGTACTTC	CSARFQGKLVETQYF	TRBV20-1	TRBJ2-5
TGTGCCAGCAGCTTGGGGGCAGATTCCGGGGAGCTGTTTTTT	CASSLGADSGELFF	TRBV7-2	TRBJ2-2
TGTGCCAGCAGCAGCCCTCGGACAGCCGGTTCCTATGGCTACACCTTC	CASSSPRTAGSYGYTF	TRBV9	TRBJ1-2
TGTGCTAGTGGTTTGGTACCCCCTTGCATGGACATTAGCCCGGAAGAATACGAGCAGTACTTC	CASGLVPPCMDISPEEYEQYF	TRBV12-5	TRBJ2-7
TGCAGTGCTAGAGATTACAGGAAGGCCTACGAGCAGTACTTC	CSARDYRKAYEQYF	TRBV20-1	TRBJ2-7
TGTGCCAGCAGCCCCGGGGCGGGACTAGCAGCTAGCAATGAGCAGTTCTTC	CASSPGAGLAASNEQFF	TRBV6-6	TRBJ2-1
TGTGCCAGCAGCCGGCTTCCCCCGGACAGGGGGCGTGAGAACACTGAAGCTTTCTTT	CASSRLPPDRGRENTEAFF	TRBV11-2	TRBJ1-1
TGTGCCAGCAGGGGGCTGAGAGTTTACAATGAGCAGTTCTTC	CASRGLRVYNEQFF	TRBV25-1	TRBJ2-1
TGTGCCAGCAGGGTTGGGACAGCTAACTATGGCTACACCTTC	CASRVGTANYGYTF	TRBV27	TRBJ1-2
TGTGCCAGCAGCGTACTAGCGGGAGCCGGACCGAAGCTCTCCTACGAGCAGTACTTC	CASSVLAGAGPKLSYEQYF	TRBV9	TRBJ2-7
TGTGCCAGCCGTTTTCTGACAGGTCCCTTCAATCAGCCCCAGCATTTT	CASRFLTGPFNQPQHF	TRBV11-3	TRBJ1-5
TGTGCCAGCAGTGTGCGTAGGGAACGTCGCCCTGGGGGGGAGCTGTTTTTT	CASSVRRERRPGGELFF	TRBV28	TRBJ2-2
TGCGCCAGCAGACCCGCAGGGGGGTCGGGCACCGGGGAGCTGTTTTTT	CASRPAGGSGTGELFF	TRBV4-1	TRBJ2-2
TGTGCCAGCAGCACCGGGATTCGGGTCCTTGGGGAGCTGTTTTTT	CASSTGIRVLGELFF	TRBV5-6	TRBJ2-2
TGTGCCACCCGGGCAGGAGGGCAGGGCTATGGCTACACCTTC	CATRAGGQGYGYTF	TRBV15	TRBJ1-2
TGTGCCAGGTCTACAAGTCAGCCCCAGCATTTT	CARSTSQPQHF	TRBV6-1	TRBJ1-5
TGTGCTAGCAGCTTACCGGAGACAGGCATGACCTGGGATGGCTACACCTTC	CASSLPETGMTWDGYTF	TRBV7-7	TRBJ1-2
TGTGCCAGCAGCGGATCACAGGGGGCTTTGGTATGCTACGAGCAGTACTTC	CASSGSQGALVCYEQYF	TRBV7-2	TRBJ2-7
TGTGCCAGCAGGACTAGCGGGGAGACCCAGTACTTC	CASRTSGETQYF	TRBV28	TRBJ2-5
TGTGCCAGCAGCTCTATACGGCGGAGATGGTCCTACAATGAGCAGTTCTTC	CASSSIRRRWSYNEQFF	TRBV7-9	TRBJ2-1
TGTGCCAGCAGTTTCAAGGGGGGGTACGAGCAGTACTTC	CASSFKGGYEQYF	TRBV28	TRBJ2-7
TGCGCCAGCATGGGACAGGGGGCCGATTCACCCCTCCACTTT	CASMGQGADSPLHF	TRBV5-1	TRBJ1-6
TGTGCCAGCAGTGAAGGCAGGGGGCCCTCTGGGGCCAACGTCCTGACTTTC	CASSEGRGPSGANVLTF	TRBV6-1	TRBJ2-6
TGTGCCAGCAGCGAGGGTAGAGGCTACGAGCAGTACTTC	CASSEGRGYEQYF	TRBV7-6	TRBJ2-7
TGTGCCAGCAAGGTAAACAGGGAAGCTGGGGCCAACGTCCTGACTTTC	CASKVNREAGANVLTF	TRBV6-4	TRBJ2-6
TGTGCCTGGAGTGTCAAGGACAGGGCAGATACGCAGTATTTT	CAWSVKDRADTQYF	TRBV30	TRBJ2-3
TGTGCCAGCAGCCAAGGTCGTATAAACTCCGGGACAATCGAACTAAGGTTAGCTAACTATGGCTACACCTTC	CASSQGRINSGTIELRLANYGYTF	TRBV4-2	TRBJ1-2
TGTGCCAGCAGTGGGGGACAACAAGCCAAAAACATTCAGTACTTC	CASSGGQQAKNIQYF	TRBV6-5	TRBJ2-4
TGTGCCAGCAGCGTAGCCTGGCCTACTCAACCGCCCCAGCATTTT	CASSVAWPTQPPQHF	TRBV9	TRBJ1-5
TGCAGTGCCCCTCGGGAGGAGAATGAGCAGTTCTTC	CSAPREENEQFF	TRBV20-1	TRBJ2-1
TGTGCCAGCAGCCGTAGGACGGGAATCTTC	CASSRRTGIF	TRBV27	TRBJ2-1
TGTGCCAGCAGCTTAATAGGGACAGGTATGGACGAGCAGTACTTC	CASSLIGTGMDEQYF	TRBV7-2	TRBJ2-7
TGTGCCAGCTCACCAAGGGACAGGGATGAAAAACTGTTTTTT	CASSPRDRDEKLFF	TRBV18	TRBJ1-4
TGCAACACCTCCAGCCCCCAGGACTGTAGTCCTGGAAACACCATATATTTT	CNTSSPQDCSPGNTIYF	TRBV20-1	TRBJ1-3
TGTGCCAGCAGCCTCGCGGTTAGCCAAGAGACCCAGTACTTC	CASSLAVSQETQYF	TRBV13	TRBJ2-5
TGTGCCAGCAGCTTACCAGGTCTCTGGGGTCCCTATAGCTCCTACAATGAGCAGTTCTTC	CASSLPGLWGPYSSYNEQFF	TRBV7-9	TRBJ2-1
TGTGCCAGCACCGGACAGGGTGGTCACTATGGCTACACCTTC	CASTGQGGHYGYTF	TRBV7-9	TRBJ1-2
TGTGCCACCAGTGGCGGGGACGGAAACAATGAGCAGTTCTTC	CATSGGDGNNEQFF	TRBV24-1	TRBJ2-1
TGTGCCAGCAGTGAAGCAGACACTGAAGCTTTCTTT	CASSEADTEAFF	TRBV6-1	TRBJ1-1
TGCAGTGCTAGGGTAGGGACGAAGCCGGACTACGAGCAGTACTTC	CSARVGTKPDYEQYF	TRBV20-1	TRBJ2-7
TGTGCCAGCACCCTTCCGGACAGTTATTACTATGGCTACACCTTC	CASTLPDSYYYGYTF	TRBV27	TRBJ1-2
TGCAGCAACCCAGGGGGGAGGCTCAATCAGCCCCAGCATTTT	CSNPGGRLNQPQHF	TRBV29-1	TRBJ1-5
TGTGCCAGCAGAAACCCCCGAACTAGCGGGAGATTTGTGCAGTACTTC	CASRNPRTSGRFVQYF	TRBV28	TRBJ2-7
TGTGCCACCAGTGATTTTGGGGACGATAGACGGAAAAACACTGAAGCTTTCTTT	CATSDFGDDRRKNTEAFF	TRBV24-1	TRBJ1-1
TGTGCCAGCAGCCAAGTAAGCTTCCCCAGGGGTCAGCCCCAGCATTTT	CASSQVSFPRGQPQHF	TRBV3-1	TRBJ1-5
TGTGCCAGCAGCTTAGCACGGACTAGTTCTGGAGATGAGCAGTTCTTC	CASSLARTSSGDEQFF	TRBV7-2	TRBJ2-1
TGCAGTGCTAGAGATCACCAGACAGGGGACTACGAGCAGTACTTC	CSARDHQTGDYEQYF	TRBV20-1	TRBJ2-7
TGTGCCAGCAGTTACTCGACGAGACCGGATCCACAGGGCTACGAGCAGTACTTC	CASSYSTRPDPQGYEQYF	TRBV6-2	TRBJ2-7
TGTGCCAGCAGTTACAAGAGGGCAGAGGTCTATGGCTACACCTTC	CASSYKRAEVYGYTF	TRBV28	TRBJ1-2
TGTGCCAGCAGCCCTACAGAAGAAGGGGCATTCCTCCAAGAGACCCAGTACTTC	CASSPTEEGAFLQETQYF	TRBV13	TRBJ2-5
TGTGCCAGCAGCTTACGGTCCGGGTTTGCGAACTATGGCTACACCTTC	CASSLRSGFANYGYTF	TRBV11-2	TRBJ1-2
TGTGCCTGGAGGTTGGAGGTTCCGAGGGCGAATGAAAAACTGTTTTTT	CAWRLEVPRANEKLFF	TRBV30	TRBJ1-4
TGTGCCACAGGGTACCGGGACGCCGGGGACAATGAGCAGTTCTTC	CATGYRDAGDNEQFF	TRBV25-1	TRBJ2-1
TGTGCCAGCATCAAAGGGGGAAATCAGCCCCAGCATTTT	CASIKGGNQPQHF	TRBV27	TRBJ1-5
TGTGCCAGCAGCCAGAGCAACACCTTC	CASSQSNTF	TRBV13	TRBJ1-2
TGTGCCAGCAGCTTAGAGCCCCCAGGCTACACAGATACGCAGTATTTT	CASSLEPPGYTDTQYF	TRBV11-2	TRBJ2-3
TGCAGTGCTAGAGATAACCAACGGGGGGGACCCAATGAGCAGTTCTTC	CSARDNQRGGPNEQFF	TRBV20-1	TRBJ2-1
TGTGCCAGCAGCCGAGGGGGGGCGGTAGTTGCCGGGGAGCTGTTTTTT	CASSRGGAVVAGELFF	TRBV9	TRBJ2-2
TGTGCCAGCAGTTCCCCAGGTATCCCGTGGGGGGGCTATGAGCAGTTCTTC	CASSSPGIPWGGYEQFF	TRBV27	TRBJ2-1
TGCGCCAGCAGAATGGGAGAGGAAAGGGGCACAGATACGCAGTATTTT	CASRMGEERGTDTQYF	TRBV10-1	TRBJ2-3
TGCGCCAGCAGCCAAGCTCCCTCGTTGGCTAGCACAGATACGCAGTATTTT	CASSQAPSLASTDTQYF	TRBV4-1	TRBJ2-3
TGTGCCAGCAGCGGGACTAGCGTCACCGGGGAGCTGTTTTTT	CASSGTSVTGELFF	TRBV13	TRBJ2-2
TGTGCCAGGCGGGACAGGGGGCTGAACACTGAAGCTTTCTTT	CARRDRGLNTEAFF	TRBV6-4	TRBJ1-1
TGTGCCAGCAGCTTCCGACAGTTTGCGAACACTGAAGCTTTCTTT	CASSFRQFANTEAFF	TRBV5-5	TRBJ1-1
TGTGCCAGCAGCCAAGATATATTATGGGGGCCGAACACTGAAGCTTTCTTT	CASSQDILWGPNTEAFF	TRBV3-1	TRBJ1-1
TGTGCCAGCCACCCGGGACATGGGGCCAACGTCCTGACTTTC	CASHPGHGANVLTF	TRBV2	TRBJ2-6
TGTGCCAGTATGAGGGGGCGCCTAGGCTACACCTTC	CASMRGRLGYTF	TRBV19	TRBJ1-2
TGTGCCAACAGATGGAACACTGAAGCTTTCTTT	CANRWNTEAFF	TRBV7-7	TRBJ1-1
TGCGCCAGCAGCCCCCCACAGGGGGCGAGACGCGCTGAAGCTTTCTTT	CASSPPQGARRAEAFF	TRBV5-1	TRBJ1-1
TGCGCCAGCAGCCGCCTCCGGGACAGTCACTATGGCTACACCTTC	CASSRLRDSHYGYTF	TRBV5-1	TRBJ1-2
TGTGCCAGCAGCGAGAGGAGAGACACTGAAGCTTTCTTT	CASSERRDTEAFF	TRBV7-3	TRBJ1-1
TGCAGTGATCTTTCTGTACCGACAGGGGAAGGAGATAATGGCTACACCTTC	CSDLSVPTGEGDNGYTF	TRBV20-1	TRBJ1-2
TGTGCCAGCAGCACACTGGCGGGGACGAACACCGGGGAGCTGTTTTTT	CASSTLAGTNTGELFF	TRBV5-4	TRBJ2-2
TGTGCCCCTTCTAACTTGAGCCGACAGTCAACCTACGAGCAGTACTTC	CAPSNLSRQSTYEQYF	TRBV5-6	TRBJ2-7
TGTGCCAGCTCTTTAGGGACAAGCACCGGGGAGCTGTTTTTT	CASSLGTSTGELFF	TRBV18	TRBJ2-2
TGCGCCAGCTTCCCATGGACAGGGGAGCAGTACTTC	CASFPWTGEQYF	TRBV5-1	TRBJ2-7
TGTGCCAGTAGTATAGAGTTAAAGACAGGGTCCGGCGAGCAGTACTTC	CASSIELKTGSGEQYF	TRBV19	TRBJ2-7
TGTGCCAGCAGCTTCGACAGGTGGTTAGAGACCCAGTACTTC	CASSFDRWLETQYF	TRBV5-4	TRBJ2-5
TGCAGTGCCGGGGACGTACTAGGGATTTCACCCCTCCACTTT	CSAGDVLGISPLHF	TRBV20-1	TRBJ1-6
TGTGCCAGCAGCGCCCTTGGCGACCCTGGAAACACCATATATTTT	CASSALGDPGNTIYF	TRBV9	TRBJ1-3
TGTGCCATCATTGGGGGAGGGAGCTCCTATAATTCACCCCTCCACTTT	CAIIGGGSSYNSPLHF	TRBV10-3	TRBJ1-6
TGTGCCTGGAAAGGGAGGGACAGGGGCCTGGTAATTGGCTACACCTTC	CAWKGRDRGLVIGYTF	TRBV30	TRBJ1-2
TGCGCCAGCGGGCGGGGGCGGGGCCTCTACGAGCAGTACTTC	CASGRGRGLYEQYF	TRBV10-1	TRBJ2-7
TGTGCCAGCAGCGGCTGGGGGGGAGGGTCTGACTATGGCTACACCTTC	CASSGWGGGSDYGYTF	TRBV13	TRBJ1-2
TGTGCTGACAGGGGGGACAATCAGCCCCAGCATTTT	CADRGDNQPQHF	TRBV2	TRBJ1-5
TGTGCCAGCAGTTACGCACTTTCCGAGCAGTACTTC	CASSYALSEQYF	TRBV6-5	TRBJ2-7
TGTGCCAGCAGACCTAGCGGGTGGATCCGAGGCTACAATGAGCAGTTCTTC	CASRPSGWIRGYNEQFF	TRBV28	TRBJ2-1
TGTGCCAGCAGGACTAGAAGGCAGTACTTC	CASRTRRQYF	TRBV28	TRBJ2-7
TGTGCCAGCAGAGCGGGGAGAAAGGGCACAGATACGCAGTATTTT	CASRAGRKGTDTQYF	TRBV12-3	TRBJ2-3
TGTGCCAGCAGCCAAGAGGGTCGGTTAATGGGACAGTTAAAAAACATTCAGTACTTC	CASSQEGRLMGQLKNIQYF	TRBV3-1	TRBJ2-4
TGTGCCAGCAGCAAACTGGGACAGCGTCAGCCCCAGCATTTT	CASSKLGQRQPQHF	TRBV11-3	TRBJ1-5
TGTGCCAGCAGCGAGGGAGGGGGCGGTCCCTCCACCTTC	CASSEGGGGPSTF	TRBV12-3	TRBJ1-2
TGTGCCAGCAGTGACTCGAGTCGGGAGTCCTACGAGCAGTACTTC	CASSDSSRESYEQYF	TRBV6-4	TRBJ2-7
TGCAGTGCTAGAGATCGGGGGACCTCCAACTATGGCTACACCTTC	CSARDRGTSNYGYTF	TRBV20-1	TRBJ1-2
TGTGCCAGCAGCACACACAAGGGGCCCTATGAGCAGTTCTTC	CASSTHKGPYEQFF	TRBV13	TRBJ2-1
TGTGCTAGTGGTTTGAAACAACAGGGTTTGCCCCAGCATTTT	CASGLKQQGLPQHF	TRBV12-5	TRBJ1-5
TGCGCCAGCAGTGCAATGGGCCAGATCTACGAGCAGTACTTC	CASSAMGQIYEQYF	TRBV10-1	TRBJ2-7
TGTGCCACCAGTGACCCATTCCACGGCCTGGGACAGTCAGAGCCTGAAGCTTTCTTT	CATSDPFHGLGQSEPEAFF	TRBV24-1	TRBJ1-1
TGTGCCAGCAGGCAAGGGGGCGGAACCACGAATCAGCCCCAGCATTTT	CASRQGGGTTNQPQHF	TRBV27	TRBJ1-5
TGTGCCAGCAGTCGGCAAAGGTACAATGAGCAGTTCTTC	CASSRQRYNEQFF	TRBV7-9	TRBJ2-1
TGTGCCAGCAGCCAAGAGCCCGGCGATTCTACCTACGAGCAGTACTTC	CASSQEPGDSTYEQYF	TRBV14	TRBJ2-7
TGTGCCATCAGTGTTGAGGGAGGAGATACGCAGTATTTT	CAISVEGGDTQYF	TRBV10-3	TRBJ2-3
TGTGCCAGCAGCTTACGGAGTCGCAGGGTCTACGAGCAGTACTTC	CASSLRSRRVYEQYF	TRBV7-8	TRBJ2-7
TGTGCTAGTGGTTTCCATATCCACGGCCGCAGGGGTCAGAGCTCTGGAAACACCATATATTTT	CASGFHIHGRRGQSSGNTIYF	TRBV12-5	TRBJ1-3
TGTGCCAGCAAAAGGGACAGGGGTTTGTTTCATCAGCCCCAGCATTTT	CASKRDRGLFHQPQHF	TRBV9	TRBJ1-5
TGTGCCAGCAGCTTAGACGTAGTGGCCTACGAGCAGTACTTC	CASSLDVVAYEQYF	TRBV7-9	TRBJ2-7
TGTGCCAGCAGTTGGATTCTTAGGGCCATCACCGGGGAGCTGTTTTTT	CASSWILRAITGELFF	TRBV6-9	TRBJ2-2
TGTGCCAATTTCGACGGACCAGACACTGAAGCTTTCTTT	CANFDGPDTEAFF	TRBV10-3	TRBJ1-1
TGTGCTAGTGGTTTGGGCTCAGGGGGCGCCGTTCCTGAAGCTTTCTTT	CASGLGSGGAVPEAFF	TRBV12-5	TRBJ1-1
TGTGCCAGCAGCTTTCCATTTAGCGGGACAGATACGCAGTATTTT	CASSFPFSGTDTQYF	TRBV5-8	TRBJ2-3
TGCAGTGCCGTCTTCGGGAGGGGGTCAAAACTGTTTTTT	CSAVFGRGSKLFF	TRBV20-1	TRBJ1-4
TGTGCCAGCAGCCTAAAAGAGACGGGGGCCTACTCCACTGAAGCTTTCTTT	CASSLKETGAYSTEAFF	TRBV7-2	TRBJ1-1
TGTGCCAATCCGGGACGCGCAGATACGCAGTATTTT	CANPGRADTQYF	TRBV10-3	TRBJ2-3
TGTGCCAGCAAGAGGCTCCGACAGGGGGAATCAACCCTTTACGAGCAGTACTTC	CASKRLRQGESTLYEQYF	TRBV27	TRBJ2-7
TGTGCCAGCAGCTTAGCGCCCGGTCTCTCAGGAAACACCATATATTTT	CASSLAPGLSGNTIYF	TRBV7-9	TRBJ1-3
TGTGCCAGCAGAAAATACCGAAGCGGGCAAGAGACCCAGTACTTC	CASRKYRSGQETQYF	TRBV6-6	TRBJ2-5
TGTGCCACCAGTGATTTGGGGGACAGGGGACATCGTATCAATCAGCCCCAGCATTTT	CATSDLGDRGHRINQPQHF	TRBV24-1	TRBJ1-5
TGTGCCAGCAGCTTGGGTCTGAGACTAGCGGGGACACCCCCGCTCCCCTACGAGCAGTACTTC	CASSLGLRLAGTPPLPYEQYF	TRBV5-6	TRBJ2-7
TGTGCCACCAGTGATTACGCGGGGGTTCCTAACTATGGCTACACCTTC	CATSDYAGVPNYGYTF	TRBV24-1	TRBJ1-2
TGTGCCATCCGACCTGGGAGGTATGAGCAGTTCTTC	CAIRPGRYEQFF	TRBV6-5	TRBJ2-1
TGCGCCAGCAGCTTGCCCGGAGGATACAATGAGCAGTTCTTC	CASSLPGGYNEQFF	TRBV5-1	TRBJ2-1
TGTGCCAGCAGCCCAAGGGAAACGGGCGGCCAAGAGACCCAGTACTTC	CASSPRETGGQETQYF	TRBV5-6	TRBJ2-5
TGTGCCAGCAGCTTCCCGTCGGACAGGGCTAGGGAGATTGGCTACACCTTC	CASSFPSDRAREIGYTF	TRBV5-5	TRBJ1-2
TGCAGCGTTGGGGACCAGAGGAACTATGGCTACACCTTC	CSVGDQRNYGYTF	TRBV29-1	TRBJ1-2
TGTGCCGAGCCCACCGGGACTAGTAGCCGGTACTTC	CAEPTGTSSRYF	TRBV6-3	TRBJ2-4
TGTGCCAGCAGCGTTGGGACGCGGTACTCCTACGAGCAGTACTTC	CASSVGTRYSYEQYF	TRBV5-6	TRBJ2-7
TGTGCCAGCAGCTCCCCTAGAGCCTACAATGAGCAGTTCTTC	CASSSPRAYNEQFF	TRBV7-9	TRBJ2-1
TGTGCCAGCAGTGTTGTTACCGACAGCCGGACTGAAGCTTTCTTT	CASSVVTDSRTEAFF	TRBV2	TRBJ1-1
TGCGCCAGCAACGAGGGATGGTACGAGCAGTACTTC	CASNEGWYEQYF	TRBV10-1	TRBJ2-7
TGCGCCAGCCAACCCTATAGACTAGAGGGGGTCTTC	CASQPYRLEGVF	TRBV5-1	TRBJ2-1
TGTGCCAGCAGTGAGCTGGGGACCTACGAGCAGTACTTC	CASSELGTYEQYF	TRBV6-1	TRBJ2-7
TGCAGTGCTAGTACTCGGACAGGAAAATACCCAACCCAGTACTTC	CSASTRTGKYPTQYF	TRBV20-1	TRBJ2-5
TGTGCTAGTGGTTCACAGGGTGAAGCTTTCTTT	CASGSQGEAFF	TRBV12-5	TRBJ1-1
TGTGCGCGGCGGGACAGGGCTAATGAAGCTTTCTTT	CARRDRANEAFF	TRBV7-3	TRBJ1-1
TGTGCCAGCAAACGACAGGGACAGTCGGCCTACAATGAGCAGTTCTTC	CASKRQGQSAYNEQFF	TRBV11-3	TRBJ2-1
TGTGCTAGTGCTAGACAGGGTACCATGAACACTGAAGCTTTCTTT	CASARQGTMNTEAFF	TRBV12-5	TRBJ1-1
TGTGCTAGTGGTTTGGTAGCTCTGAGTGGAAACACCATATATTTT	CASGLVALSGNTIYF	TRBV12-5	TRBJ1-3
TGTGCCAGCAGTACGAGGGGATTCTTCCCCTCTGGAAACACCATATATTTT	CASSTRGFFPSGNTIYF	TRBV28	TRBJ1-3
TGTGCCAGCAGCAATATGGCGCCCTCCGGGACAGGGGTGGTTTATACGTACAATGAGCAGTTCTTC	CASSNMAPSGTGVVYTYNEQFF	TRBV7-9	TRBJ2-1
TGCGCCAGCAGCTTGATTGATCCTGTACAGGGGGGGCGTGGCTACACCTTC	CASSLIDPVQGGRGYTF	TRBV5-1	TRBJ1-2
TGTGCCAGCAGGCGAATCAGTGTGGGGGGTTTGGGAAACTATGGCTACACCTTC	CASRRISVGGLGNYGYTF	TRBV28	TRBJ1-2
TGTGCCTACGACAGGGCGAGAGAATGCACCGGGGAGCTGTTTTTT	CAYDRARECTGELFF	TRBV14	TRBJ2-2
TGCAGCGTTGACGACTGTGAAGCTTTCTTT	CSVDDCEAFF	TRBV29-1	TRBJ1-1
TGTGCCAGCAGCTTATTCACCGGGACTAGCGGGCACGGGGAGCAGTACTTC	CASSLFTGTSGHGEQYF	TRBV7-4	TRBJ2-7
TGTGCCAGCAGTACCGACTGTACAGATACGCAGTATTTT	CASSTDCTDTQYF	TRBV12-4	TRBJ2-3
TGTGCCAGCAGTACCTGGGGGCCCGTAGGCGCTTTCTTT	CASSTWGPVGAFF	TRBV6-5	TRBJ1-1
TGCAGTGGAGCTTACAGGGCAGCGGCCTACGAGCAGTACTTC	CSGAYRAAAYEQYF	TRBV20-1	TRBJ2-7
TGCGCCAGCAGCCACCCCGGGGTGGGCCAGTACTTC	CASSHPGVGQYF	TRBV4-3	TRBJ2-5
TGTGCCAGTAGTATAGGTGTCGCCGTGCCAACCCAGGGGGCGCGGTGGCAGCCCCAGCATTTT	CASSIGVAVPTQGARWQPQHF	TRBV19	TRBJ1-5
TGTGCCAGCAGCCGGCAGGGGAGGGGTCCCACCGGGGAGCTGTTTTTT	CASSRQGRGPTGELFF	TRBV7-4	TRBJ2-2
TGTGCCAGCAGTTTATGTTGCGGAAGCTCTGGGGCCAACGTCCTGACTTTC	CASSLCCGSSGANVLTF	TRBV28	TRBJ2-6
TGTGCCTGGAGGACTCAAGGGAGGGGGTCATTGTTTAAATACGAGCAGTACTTC	CAWRTQGRGSLFKYEQYF	TRBV30	TRBJ2-7
TGTGCCTGGAGTCAACAAAAAAAAACGAGGGGGCAGGGCGGTAACTATGGCTACACCTTC	CAWSQQKKTRGQGGNYGYTF	TRBV30	TRBJ1-2
TGCAGCGTTGAACTCACAGGGTGGGGCTACGAGCAGTACTTC	CSVELTGWGYEQYF	TRBV29-1	TRBJ2-7
TGTGCCTGGAGGTTCTATGGCTACACCTTC	CAWRFYGYTF	TRBV30	TRBJ1-2
TGTGCCACCCCCGCAGGGGGCCCACCTCTTTGCAATCAGCCCCAGCATTTT	CATPAGGPPLCNQPQHF	TRBV24-1	TRBJ1-5
TGTGCCAGCAGTAAAAGGACATTTAATGAAAAACTGTTTTTT	CASSKRTFNEKLFF	TRBV6-5	TRBJ1-4
TGTGCCAGCAGTGCAGGGACAGAGACCCAGTACTTC	CASSAGTETQYF	TRBV27	TRBJ2-5
TGTGCCTGGAACTGGGGGGGGGGGACTGAAGCTTTCTTT	CAWNWGGGTEAFF	TRBV30	TRBJ1-1
TGCAGTGCTAGAGGGTGGATCCGGGACAGGGAGGGGGGCGGCTACACCTTC	CSARGWIRDREGGGYTF	TRBV20-1	TRBJ1-2
TGTGCCAGCGTAAGAGGGCCTAACTATGGCTACACCTTC	CASVRGPNYGYTF	TRBV27	TRBJ1-2
TGTGCCTGGAGCGGGTTAGGACAGGGGGACACTGAAGCTTTCTTT	CAWSGLGQGDTEAFF	TRBV30	TRBJ1-1
TGTGCCAGCAGCCACTGGGCTCAGGGAAACGCTGAAGCTTTCTTT	CASSHWAQGNAEAFF	TRBV3-1	TRBJ1-1
TGTGCCAGCGAACAGGGGGGGGGAATGAAATGTATTCTCACTGGGGTCTACGAGCAGTACTTC	CASEQGGGMKCILTGVYEQYF	TRBV6-5	TRBJ2-7
TGTGCCAGCAGCTCCCTTCGTCTAGAGAATGAGCAGTTCTTC	CASSSLRLENEQFF	TRBV5-4	TRBJ2-1
TGTGCCACTTCCGGGGCCTGGAACACTGAAGCTTTCTTT	CATSGAWNTEAFF	TRBV24-1	TRBJ1-1
TGCGCCAGCAGCTTTTCCTGGGAAGGGGAGCTGTTTTTT	CASSFSWEGELFF	TRBV5-1	TRBJ2-2
TGTGCCAGCAGGCCACACTTCGTCCAGGAGGGCTACGAGCAGTACTTC	CASRPHFVQEGYEQYF	TRBV2	TRBJ2-7
TGTGCCAGCAGTGGATGGGACAGACACTATAATTCACCCCTCCACTTT	CASSGWDRHYNSPLHF	TRBV6-4	TRBJ1-6
TGTGCCTGGAGTCAGGGACCAACTAATGAAAAACTGTTTTTT	CAWSQGPTNEKLFF	TRBV30	TRBJ1-4
TGTGCCAGCAGCAGGAGGAACACTGAAGCTTTCTTT	CASSRRNTEAFF	TRBV9	TRBJ1-1
TGTGCCAGCAGCACGAAGAACTCCTACGAGCAGTACTTC	CASSTKNSYEQYF	TRBV5-6	TRBJ2-7
TGTGCCAGCAGCGGCCTAGAAAAAGATACGCAGTATTTT	CASSGLEKDTQYF	TRBV9	TRBJ2-3
TGCAGTCTCCGTCCTGGGGGGAATCCTTACAATGAGCAGTTCTTC	CSLRPGGNPYNEQFF	TRBV20-1	TRBJ2-1
TGTGCCAGCTCGGGAAGTGGGCCCTCATACTACAATGAGCAGTTCTTC	CASSGSGPSYYNEQFF	TRBV18	TRBJ2-1
TGTGCCAGCAGGTTGGGGGTCTCTTGGAACACCGGGGAGCTGTTTTTT	CASRLGVSWNTGELFF	TRBV27	TRBJ2-2
TGTGCCAGCAGCCAAGATTTCCGGATCCAGGACAGTCATAGCAATCAGCCCCAGCATTTT	CASSQDFRIQDSHSNQPQHF	TRBV14	TRBJ1-5
TGTGCCAGTAGTATAGAACTATTGGGGGGCACAGATACGCAGTATTTT	CASSIELLGGTDTQYF	TRBV19	TRBJ2-3
TGTGCCAAGGTAGGGGGGACAGGGGGCAAAAGCTATGGCTACACCTTC	CAKVGGTGGKSYGYTF	TRBV27	TRBJ1-2
TGTGCCAGCAGCAGATTGCCAAGACCAGCTTTCTTT	CASSRLPRPAFF	TRBV28	TRBJ1-1
TGTGCCAGCAGCGGCGGGGGGGCTACAGATACGCAGTATTTT	CASSGGGATDTQYF	TRBV13	TRBJ2-3
TGCGCCAGCAGCTTGGAAGGAATGGGACTAGCGGGGCGCACAGATACGCAGTATTTT	CASSLEGMGLAGRTDTQYF	TRBV5-1	TRBJ2-3
TGTGCCAGCAGTTTGAAAGGGCGCATTGTCACTGAAGCTTTCTTT	CASSLKGRIVTEAFF	TRBV27	TRBJ1-1
TGTGCCAGCAGCAGGAATGGGGGGGCAATCAATGAGCAGTTCTTC	CASSRNGGAINEQFF	TRBV13	TRBJ2-1
TGTGCCAGCAGTGGGACTGGGTTTAGACCGAACACTGAAGCTTTCTTT	CASSGTGFRPNTEAFF	TRBV2	TRBJ1-1
TGTGCCAGCAGCTTAGATCAAGCAGGGGACTACGAGCAGTACTTC	CASSLDQAGDYEQYF	TRBV11-3	TRBJ2-7
TGCGCCAGCAGCTTGGTGGACAAGCATTTT	CASSLVDKHF	TRBV5-1	TRBJ1-5
TGTGCCAGCAGCCCACTCGGGAGGGGAGGAGAGACCCAGTACTTC	CASSPLGRGGETQYF	TRBV3-1	TRBJ2-5
TGCGCCAGCAGCCAAGAAACTCAACTACCACCCAGGGGGCCTGCCTACGAGCAGTACTTC	CASSQETQLPPRGPAYEQYF	TRBV4-1	TRBJ2-7
TGCAGCGTTGAAGGGTGTCCGACAGGCTTACATCAGCCCCAGCATTTT	CSVEGCPTGLHQPQHF	TRBV29-1	TRBJ1-5
TGTGCCAGCAGGGAAAGGGGGCAAAGAGAAAAACTGTTTTTT	CASRERGQREKLFF	TRBV11-2	TRBJ1-4
TGCAGCGTTGGGGGGGCCTACGAGCAGTACTTC	CSVGGAYEQYF	TRBV29-1	TRBJ2-7
TGTGCCAGCGTCCAGGGGGGCGGTGAAGCTTTCTTT	CASVQGGGEAFF	TRBV9	TRBJ1-1
TGTGCCAGCAGCTTTATCAGGTGGCTATTAAACACCGGGGAGCTGTTTTTT	CASSFIRWLLNTGELFF	TRBV11-2	TRBJ2-2
TGCGCCAGCAGCTCCAGCAGGTGTGAGCCCCAGCATTTT	CASSSSRCEPQHF	TRBV5-1	TRBJ1-5
TGTGCCAGCAGTGCGGACAGCTCTGGAAACACCATATATTTT	CASSADSSGNTIYF	TRBV6-1	TRBJ1-3
TGTGCCAGCAGCCGAGCGGGAAGCTCCTACAATGAGCAGTTCTTC	CASSRAGSSYNEQFF	TRBV7-9	TRBJ2-1
TGTGCCAGCAGCTCCTTATCCAGGGGAATCCCCTACGAGCAGTACTTC	CASSSLSRGIPYEQYF	TRBV9	TRBJ2-7
TGTGCCATCTATCCCCACAGGGCGTCTGAAGCTTTCTTT	CAIYPHRASEAFF	TRBV19	TRBJ1-1
TGCAGTGCGAGGGCGGCTGAAGCTTTCTTT	CSARAAEAFF	TRBV20-1	TRBJ1-1
TGTGCCAGCTCGGGACAGGGACAAGAGACCCAGTACTTC	CASSGQGQETQYF	TRBV12-3	TRBJ2-5
TGTGCCAGCAGCCAAGAACGAGGATTCATGAACACTGAAGCTTTCTTT	CASSQERGFMNTEAFF	TRBV4-2	TRBJ1-1
TGTGCCAGCAGTTTTCACTCGTGGGGCACAGATACGCAGTATTTT	CASSFHSWGTDTQYF	TRBV12-3	TRBJ2-3
TGTGCCTGGCCAGGCGGGACCTACGAGCAGTACTTC	CAWPGGTYEQYF	TRBV30	TRBJ2-7
TGCGCCAGCAGTGGACTAGCGGGTCGTCACACCCAGTACTTC	CASSGLAGRHTQYF	TRBV5-1	TRBJ2-5
TGTGCCAGCAGCGGGACTAGCGGGTCCAGCTACGAGCAGTACTTC	CASSGTSGSSYEQYF	TRBV11-3	TRBJ2-7
TGCGCCAGCAGTACAGTTTACCACACAGATACGCAGTATTTT	CASSTVYHTDTQYF	TRBV10-1	TRBJ2-3
TGTGCCAGCAGCTTGAGTGGACTAGCGGGAAGCACAGATACGCAGTATTTT	CASSLSGLAGSTDTQYF	TRBV7-3	TRBJ2-3
TGCACCAGCTACGGCTCCTACGAGCAGTACTTC	CTSYGSYEQYF	TRBV20-1	TRBJ2-7
TGTGCCAGCAGCCTACCGGACAGGGGCACCAGCAATCAGCCCCAGCATTTT	CASSLPDRGTSNQPQHF	TRBV11-2	TRBJ1-5
TGTGCCAGCAGCTTGGTTTGCAGGGCGGAGAACACTGAAGCTTTCTTT	CASSLVCRAENTEAFF	TRBV5-4	TRBJ1-1
TGTGCCAGCAGTAACGCTGAAGCTTTCTTT	CASSNAEAFF	TRBV28	TRBJ1-1
TGTGCCAGCAGCGGTGCAGGGAGAGAAGCTTTCTTT	CASSGAGREAFF	TRBV13	TRBJ1-1
TGTGCCTTGACGTGTGAAGCTTTCTTT	CALTCEAFF	TRBV11-2	TRBJ1-1
TGTGCCACCGAAGGGCTGACCTACGAGCAGTACTTC	CATEGLTYEQYF	TRBV24-1	TRBJ2-7
TGTGCCGATCGGGACAGGGGCTCCTACGAGCAGTACTTC	CADRDRGSYEQYF	TRBV19	TRBJ2-7
TGCAGTGCGAAACCAGGGAAGAAGGGGGGGAACTATGGCTACACCTTC	CSAKPGKKGGNYGYTF	TRBV20-1	TRBJ1-2
TGTGCCAGCAGAGTCCAGAAGGGGGCCAACTACGAGCAGTACTTC	CASRVQKGANYEQYF	TRBV6-4	TRBJ2-7
TGTGCTAGTGGCGGGACTAGCGGGAGCTACAATGAGCAGTTCTTC	CASGGTSGSYNEQFF	TRBV12-5	TRBJ2-1
TGTGCCAGCGGGGATCGGGATCCAGGGGGCCTGTCTCACCTCTATGGCTACACCTTC	CASGDRDPGGLSHLYGYTF	TRBV7-9	TRBJ1-2
TGTGCTAGTGGTTTGGTGTCAGTCCCGGTCAGGGCCAATTCACCCCTCCACTTT	CASGLVSVPVRANSPLHF	TRBV12-5	TRBJ1-6
TGTGCCAGCAGATGCTTGGTCAATGAGCAGTTCTTC	CASRCLVNEQFF	TRBV12-3	TRBJ2-1
TGTGCCACCAGCAACTCGACCCCTCGGAAGGATTCACCCCTCCACTTT	CATSNSTPRKDSPLHF	TRBV15	TRBJ1-6
TGCGCCAGCAGCAGCCACAGGGCGAGATACGAGCAGTACTTC	CASSSHRARYEQYF	TRBV5-1	TRBJ2-7
TGCGCCAGCAGTGATCCTCGAGTCCAGGAAGATAGCAATCAGCCCCAGCATTTT	CASSDPRVQEDSNQPQHF	TRBV10-1	TRBJ1-5
TGTGCCCCCCCCAGCTCTATACTGAGCACAGATACGCAGTATTTT	CAPPSSILSTDTQYF	TRBV24-1	TRBJ2-3
TGTGCCAGCAGCTTAGGAAAGGAAAAGATGACAGGGGCTCCCGGTGAAAATTCACCCCTCCACTTT	CASSLGKEKMTGAPGENSPLHF	TRBV7-9	TRBJ1-6
TGTGCAACAGGAGGACATGGCTACACCTTC	CATGGHGYTF	TRBV24-1	TRBJ1-2
TGCGCCAGCAGCTTGCCCAGGGAAAACGGGACAGATACGCAGTATTTT	CASSLPRENGTDTQYF	TRBV5-1	TRBJ2-3
TGTGCCCGCCGCCTTTTTGAGCAGTTCTTC	CARRLFEQFF	TRBV6-5	TRBJ2-1
TGTGCCAGCAGCCCCGGGACTAGCGGGCGATACGAGCAGTACTTC	CASSPGTSGRYEQYF	TRBV13	TRBJ2-7
TGCGCCAGCAGTGGTTCGGGAGGGAATGGTGGTAAAGAGACCCAGTACTTC	CASSGSGGNGGKETQYF	TRBV10-1	TRBJ2-5
TGTGCCAGCAGCTTACGGCGGCGAACCACCTACAATGAGCAGTTCTTC	CASSLRRRTTYNEQFF	TRBV11-3	TRBJ2-1
TGTGCCAGCAGTTACGGGCCATGGACCTACGAGCAGTACTTC	CASSYGPWTYEQYF	TRBV6-5	TRBJ2-7
TGTGCCAGCAGTCAAAGGGGGGGTGGGTCCGTCTACAATGAGCAGTTCTTC	CASSQRGGGSVYNEQFF	TRBV12-3	TRBJ2-1
TGTGCCAGCAGGCTCTTGGACAGGGTGACCCATAGCAATCAGCCCCAGCATTTT	CASRLLDRVTHSNQPQHF	TRBV27	TRBJ1-5
TGTGCCAGCTCACCAAGGGACAGGGTCACTGAAGCTTTCTTT	CASSPRDRVTEAFF	TRBV18	TRBJ1-1
TGTGCCAGCAGTTCATGTTATGAAAAACTGTTTTTT	CASSSCYEKLFF	TRBV6-4	TRBJ1-4
TGTGCCACCAAGGGACTCCCTGTAGAGACTCGCTACAATGAGCAGTTCTTC	CATKGLPVETRYNEQFF	TRBV24-1	TRBJ2-1
TGTGCCAGCGCCCGCGGTGTGGGGGCGCCGGGTATCTACGAGCAGTACTTC	CASARGVGAPGIYEQYF	TRBV12-3	TRBJ2-7
TGTGCCAGCTCGATCCAGGGAGGGAGTCAAACGGAGACCCAGTACTTC	CASSIQGGSQTETQYF	TRBV7-6	TRBJ2-5
TGTGCCAGCAGCTTAGTGGCCGACAGGGCCTGCACTGGGGCCAACGTCCTGACTTTC	CASSLVADRACTGANVLTF	TRBV7-2	TRBJ2-6
TGTGCCAGCAGCCGGACAGGCAAAAATAATTCACCCCTCCACTTT	CASSRTGKNNSPLHF	TRBV11-2	TRBJ1-6
TGTGCCAGCAGGGGGGGACCCTCCTACAATGAGCAGTTCTTC	CASRGGPSYNEQFF	TRBV27	TRBJ2-1
TGTGCCAGCTACCATTGGATAGGGTGTTACACTGAAGCTTTCTTT	CASYHWIGCYTEAFF	TRBV2	TRBJ1-1
TGTGCCAGCACACTGACTCGTTGGGGGGTAGAGGAGAACACCGGGGAGCTGTTTTTT	CASTLTRWGVEENTGELFF	TRBV27	TRBJ2-2
TGTGCCAGCAGTCGGGGGGGCAGCCGAACCGGGGAGCTGTTTTTT	CASSRGGSRTGELFF	TRBV6-5	TRBJ2-2
TGTGCCAGCAGCCCCCCCTGGGAGCTCCGAGCCAAAAACATTCAGTACTTC	CASSPPWELRAKNIQYF	TRBV6-5	TRBJ2-4
TGCAGCGTTGGACAGAATCTAGCTGGGGCCAACGTCCTGACTTTC	CSVGQNLAGANVLTF	TRBV29-1	TRBJ2-6
TGTGCCAGCAGCATTCGGGGGGACTACGAGCAGTACTTC	CASSIRGDYEQYF	TRBV11-2	TRBJ2-7
TGTGCCAGCCCAACTAGCGGGAGCCCGAATGAGCAGTTCTTC	CASPTSGSPNEQFF	TRBV6-1	TRBJ2-1
TGTGCCAGCAGTTACGGGATACAGGCGCCGGGCTACACCTTC	CASSYGIQAPGYTF	TRBV6-5	TRBJ1-2
TGTGCCAGCAGCTCGTACAGGGGGGGAGAGACCCAGTACTTC	CASSSYRGGETQYF	TRBV7-9	TRBJ2-5
TGTGCCAGCAGAGTTTCCGGGACAGGGGGACCTAGTTCACCCCTCCACTTT	CASRVSGTGGPSSPLHF	TRBV28	TRBJ1-6
TGTGCCTCCTTCGGGCGGAATTCACCCCTCCACTTT	CASFGRNSPLHF	TRBV30	TRBJ1-6
TGCAGTGCTGAGGGGGACCTTACTGTCGAGCAGTACTTC	CSAEGDLTVEQYF	TRBV20-1	TRBJ2-7
TGTGCCAGCAGCTTAGTGAGGCCCGGGACGCTCAATCAGCCCCAGCATTTT	CASSLVRPGTLNQPQHF	TRBV11-3	TRBJ1-5
TGTGCCAGCAGTGAATTCTGTCAGGGTGTCAGCTCCTACGAGCAGTACTTC	CASSEFCQGVSSYEQYF	TRBV25-1	TRBJ2-7
TGTGCCAGCAGGAATTTACTAGCGAAGATTGAGCAGTTCTTC	CASRNLLAKIEQFF	TRBV6-8	TRBJ2-1
TGTGCCAGTAGTAGGGACAGGTCCTACGAGCAGTACTTC	CASSRDRSYEQYF	TRBV19	TRBJ2-7
TGTGCCATGACCGTCGGGTTGTTCGAGGAATGGTCGACTGGGGCCAACGTCCTGACTTTC	CAMTVGLFEEWSTGANVLTF	TRBV6-4	TRBJ2-6
TGCGCCAGCAGCCAAAAAGGGACTAGCGCCCAAATCTACGAGCAGTACTTC	CASSQKGTSAQIYEQYF	TRBV4-1	TRBJ2-7
TGTGCCTGGAGCGGACCCCCTACGGTTAACATTCAGTACTTC	CAWSGPPTVNIQYF	TRBV30	TRBJ2-4
TGTGCCACCAGGGGAAGTGGCAGGGAGTACGAGCAGTACTTC	CATRGSGREYEQYF	TRBV24-1	TRBJ2-7
TGTGCCCCCCCGCAGGGGCCTGGGGGGGATCAGCCCCAGCATTTT	CAPPQGPGGDQPQHF	TRBV7-9	TRBJ1-5
TGTGCCAGCAGCTCGGAGTTCACTGAAGCTTTCTTT	CASSSEFTEAFF	TRBV7-3	TRBJ1-1
TGTGCCAGCAGCTTAGGGGTCCCCTACGAGCAGTACTTC	CASSLGVPYEQYF	TRBV7-2	TRBJ2-7
TGTGCCAGCGTGCCACCGAGGGGGCTTCCAGAGACCCAGTACTTC	CASVPPRGLPETQYF	TRBV6-4	TRBJ2-5
TGTGCCAGCAGGCGGGGGGTGGACTACATGACGGACGAGCAGTACTTC	CASRRGVDYMTDEQYF	TRBV11-3	TRBJ2-7
TGTGCCAGCAGCCACCCCTACCTAGGGTTTTACAATGAGCAGTTCTTC	CASSHPYLGFYNEQFF	TRBV4-2	TRBJ2-1
TGTGCCACCACAGGCGGGGGGGCTGGGGCCAACGTCCTGACTTTC	CATTGGGAGANVLTF	TRBV24-1	TRBJ2-6
TGTGCCAGCAGCGATCCTGTCTATATAAATGGTACCGGGGAGCTGTTTTTT	CASSDPVYINGTGELFF	TRBV9	TRBJ2-2
TGCAGTGCTAGAGATAGTCTGGCCGAGCAGTACTTC	CSARDSLAEQYF	TRBV20-1	TRBJ2-7
TGCAGTGCTAGAGGACATACCTATGAAGCTTTCTTT	CSARGHTYEAFF	TRBV20-1	TRBJ1-1
TGTGCCAGCAGTGAATCGTGCGGGGCACCGAGCAATCAGCCCCAGCATTTT	CASSESCGAPSNQPQHF	TRBV25-1	TRBJ1-5
TGTGCCATCCTCTTGCGTGGGAGGAACATGAACACTGAAGCTTTCTTT	CAILLRGRNMNTEAFF	TRBV5-4	TRBJ1-1
TGTGCCAGCAGGGGAACGGGGGCCCTTAACACAGATACGCAGTATTTT	CASRGTGALNTDTQYF	TRBV6-4	TRBJ2-3
TGTGCCATCAGTTCCAACCCGGGACCCTGCTACGAGCAGTACTTC	CAISSNPGPCYEQYF	TRBV10-3	TRBJ2-7
TGTGCCAGCAGTCAACAGCGGAAAAATTCACCCCTCCACTTT	CASSQQRKNSPLHF	TRBV6-3	TRBJ1-6
TGTGCCAGCAGCTTAGGTCTCATACAGGGGGGGGGCTACACCTTC	CASSLGLIQGGGYTF	TRBV11-1	TRBJ1-2
TGTGCCAGCAGCCAAGACGAGGCCGGGACAGGCGACTTC	CASSQDEAGTGDF	TRBV14	TRBJ2-7
TGTGCCAGCAGCAGCTCACCCGGGGAAAGCTCCTACGAGCAGTACTTC	CASSSSPGESSYEQYF	TRBV7-9	TRBJ2-7
TGTGCCAGCAGTGGCCCAGGGGTTGCTGAAGCTTTCTTT	CASSGPGVAEAFF	TRBV6-6	TRBJ1-1
TGTGCCAGCAGCGCTTCCCGACTAGCGGGGCCGAGCTACGAGCAGTACTTC	CASSASRLAGPSYEQYF	TRBV9	TRBJ2-7
TGTGCCAGCAGCCGAATGACTCACACTGAAGCTTTCTTT	CASSRMTHTEAFF	TRBV6-4	TRBJ1-1
TGCAGTGAACCACGGGACAGGAAGCGGGCTAATGAAAAACTGTTTTTT	CSEPRDRKRANEKLFF	TRBV20-1	TRBJ1-4
TGCATCAGGCAAGCGTCAACTAATGAAAAACTGTTTTTT	CIRQASTNEKLFF	TRBV29-1	TRBJ1-4
TGTGCCAGGGGGGACAGGGGGTACTTT	CARGDRGYF	TRBV10-3	TRBJ1-1
TGTGCCAGCAGTTTATCCGTAGGGTACAATGAGCAGTTCTTC	CASSLSVGYNEQFF	TRBV28	TRBJ2-1
TGTGCCAGCATACTCCGGGACAGCAGTAATGAAAAACTGTTTTTT	CASILRDSSNEKLFF	TRBV11-2	TRBJ1-4
TGTGCCTGGAGTGTCCCGGGACTAGAGAGCAATGAGCAGTTCTTC	CAWSVPGLESNEQFF	TRBV30	TRBJ2-1
TGCAGTGCTAGGGACCCCGGACAGGAAATGAACACTGAAGCTTTCTTT	CSARDPGQEMNTEAFF	TRBV20-1	TRBJ1-1
TGTGCCAGCAGCAGCCCAACCCTAGCGGGCCACTACGAGCAGTACTTC	CASSSPTLAGHYEQYF	TRBV13	TRBJ2-7
TGTGCCAGCAGCCAAGATCGGGACAGGGATGGTAACTATGGCTACACCTTC	CASSQDRDRDGNYGYTF	TRBV4-2	TRBJ1-2
TGTGCCAGCAGCACTTCCCAGGGGGCTAAAGGTAATGAAAAACTGTTTTTT	CASSTSQGAKGNEKLFF	TRBV7-2	TRBJ1-4
TGTGCCAGCAGCTTGGCCACGATGGGGGGCCGAAATTCACCCCTCCACTTT	CASSLATMGGRNSPLHF	TRBV13	TRBJ1-6
TGTGCAATTGGCGCCCGGGACGCCTACAATGAGCAGTTCTTC	CAIGARDAYNEQFF	TRBV27	TRBJ2-1
TGTGCCAGGTCACCGGGACTAGCGGGGGGGCTTTCCTACAATGAGCAGTTCTTC	CARSPGLAGGLSYNEQFF	TRBV19	TRBJ2-1
TGTGCCAGCAGCCGTCGGGGGGTTCATGAGCAGTTCTTC	CASSRRGVHEQFF	TRBV9	TRBJ2-1
TGCGCCAGCAGCCGGGGACAGTACACCGGGGAGCTGTTTTTT	CASSRGQYTGELFF	TRBV4-1	TRBJ2-2
TGCGCCAGGAACCTGCCGGGACAGGGGTGTTCGCCGCAAGAGACCCAGTACTTC	CARNLPGQGCSPQETQYF	TRBV5-1	TRBJ2-5
TGCAGCATCGTCCCACCAGGGGGGAATAGCTCCTACGAGCAGTACTTC	CSIVPPGGNSSYEQYF	TRBV29-1	TRBJ2-7
TGCGCCAGCAGCCAAGGTGGTACTACCGGGATTCCAGGGGACTATGGCTACACCTTC	CASSQGGTTGIPGDYGYTF	TRBV4-1	TRBJ1-2
TGTGCCAGCAGCTTGAGGGGGTTCTCCTACGAGCAGTACTTC	CASSLRGFSYEQYF	TRBV7-7	TRBJ2-7
TGTGCCAGCAGTTGCGGACTAGGAAATGAGCAGTTCTTC	CASSCGLGNEQFF	TRBV6-5	TRBJ2-1
TGTGCCAGCAGCCAAGTAAGGGATGATACGCAGTATTTT	CASSQVRDDTQYF	TRBV9	TRBJ2-3
TGTGCCAGCAGGAAAGAGAAGGGGCCAAACACTGAAGCTTTCTTT	CASRKEKGPNTEAFF	TRBV12-4	TRBJ1-1
TGTGCCAGCAGTGCACACCCCGGGACTAGCGGGGGGACAGATACGCAGTATTTT	CASSAHPGTSGGTDTQYF	TRBV12-3	TRBJ2-3
TGTGCCAGCAGGGTCGACGGTAAGGCTACGTACACTGAAGCTTTCTTT	CASRVDGKATYTEAFF	TRBV6-1	TRBJ1-1
TGTGCCAGTAGACTAGGGCAGTTCTTC	CASRLGQFF	TRBV19	TRBJ2-1
TGTGCCAGCCCTATTACTTGTGGGGGGGTAAGCTACAATGAGCAGTTCTTC	CASPITCGGVSYNEQFF	TRBV14	TRBJ2-1
TGTGCCAGCAGCGTAGCTTCCGGGGAGCTGTTTTTT	CASSVASGELFF	TRBV9	TRBJ2-2
TGCGCCAGCAGCGGGCTAGGGATCATGAACACTGAAGCTTTCTTT	CASSGLGIMNTEAFF	TRBV5-1	TRBJ1-1
TGTGCTAGTGGTTGTGCAGGGGCCTCTGGAAACACCATATATTTT	CASGCAGASGNTIYF	TRBV12-5	TRBJ1-3
TGTGCCAGCTCACGGACAGGTGGGTATAATTCACCCCTCCACTTT	CASSRTGGYNSPLHF	TRBV18	TRBJ1-6
TGTGCCAGGGTCACTGGTTACACCGGGGAGCTGTTTTTT	CARVTGYTGELFF	TRBV19	TRBJ2-2
TGTGCCACCAGCAGGGATCGCCTTCTTTATAATCATGAGCAGTTCTTC	CATSRDRLLYNHEQFF	TRBV15	TRBJ2-1
TGTGCTAGTGGTTTGGTTGGGGGCTATAGATCAGCTTTCTTT	CASGLVGGYRSAFF	TRBV12-5	TRBJ1-1
TGTGCCAGTAAGTCCCCAGGGTCGTCAACTAATGAAAAACTGTTTTTT	CASKSPGSSTNEKLFF	TRBV19	TRBJ1-4
TGCGCCAGCAGCTTCACCCCTAGCGGGTCCTACGAGCAGTACTTC	CASSFTPSGSYEQYF	TRBV5-1	TRBJ2-7
TGTGCCAGCAGCTTAGGGCCCGGCACAGATACGCAGTATTTT	CASSLGPGTDTQYF	TRBV13	TRBJ2-3
TGCAGCGCTTGGACAGAAGACTCCGGCTACACCTTC	CSAWTEDSGYTF	TRBV29-1	TRBJ1-2
TGTGCCAGCAGCCGAACTGGACAGGGGACAGAGGCCTACGAGCAGTACTTC	CASSRTGQGTEAYEQYF	TRBV13	TRBJ2-7
TGCAGTGCTCACGGACAGGGAGGGGCCAACACCGGGGAGCTGTTTTTT	CSAHGQGGANTGELFF	TRBV20-1	TRBJ2-2
TGCGCCAGCAGCCAGGGACGAGTAATTTCCCAGTACTTC	CASSQGRVISQYF	TRBV4-3	TRBJ2-5
TGTGCCAGCAGTGACCTCTCCAAAAGGGGACGGGAAAAACTGTTTTTT	CASSDLSKRGREKLFF	TRBV6-4	TRBJ1-4
TGTGCTAGTGGCAAGGGCCAAACCTACAATGAGCAGTTCTTC	CASGKGQTYNEQFF	TRBV12-5	TRBJ2-1
TGTGCCAGCAGCTTTCCCTCCAGGGGGGGACTAGAGACCCAGTACTTC	CASSFPSRGGLETQYF	TRBV7-8	TRBJ2-5
TGCAGTGCTAGAGATAGGGGACAGGGGGACACTGAAGCTTTCTTT	CSARDRGQGDTEAFF	TRBV20-1	TRBJ1-1
TGTGCCAGCAGCCATAGCGGGAAGGACAATGAGCAGTTCTTC	CASSHSGKDNEQFF	TRBV13	TRBJ2-1
TGTGCCAGCTCACCACGACAGGGCCATCGGGGAACTAATGAAAAACTGTTTTTT	CASSPRQGHRGTNEKLFF	TRBV18	TRBJ1-4
TGTGCCAGCTCACTAGCGGGTGGCACAGATACGCAGTATTTT	CASSLAGGTDTQYF	TRBV9	TRBJ2-3
TGTGCCACCATCCTTGTTTCAGGGGGCTTGACCCAGTACTTC	CATILVSGGLTQYF	TRBV24-1	TRBJ2-5
TGTGCCAGCAGTGACGGGCCAGAGACCCAGTACTTC	CASSDGPETQYF	TRBV6-1	TRBJ2-5
TGCGCCAGCAGTCCAGGACCAGGATACGAGCAGTACTTC	CASSPGPGYEQYF	TRBV10-1	TRBJ2-7
TGTGCCAGCAGCCTGCAACCCACTGATAACTATGGCTACACCTTC	CASSLQPTDNYGYTF	TRBV13	TRBJ1-2
TGTGCCAGCTCACCACACCTCCCAGCCAGGGCGGGCTCCTATGGCTACACCTTC	CASSPHLPARAGSYGYTF	TRBV18	TRBJ1-2
TGCAGTGCTAGAGAGGGCCTCTCTGGGGCCAACGTCCTGACTTTC	CSAREGLSGANVLTF	TRBV20-1	TRBJ2-6
TGTGCCACCAGGGTGAGACGGGATGAGGACGAGCAGTACTTC	CATRVRRDEDEQYF	TRBV24-1	TRBJ2-7
TGTGCCAGCAGTTACCTAGGCACCAGGGCTGTCTCTGGAAACACCATATATTTT	CASSYLGTRAVSGNTIYF	TRBV6-5	TRBJ1-3
TGTGCCAGCAGCTGGCGGGACCCCTTCGCCTCTGGGGCCAACGTCCTGACTTTC	CASSWRDPFASGANVLTF	TRBV5-6	TRBJ2-6
TGCGCCAGCAGTGGTGGGACTGCCGGGGAGCTGTTTTTT	CASSGGTAGELFF	TRBV10-2	TRBJ2-2
TGCAGTGCTACCCAGAAAGACGCCTACGAGCAGTACTTC	CSATQKDAYEQYF	TRBV20-1	TRBJ2-7
TGTGCCAGCAGCGCTCTTGGGACTAGCGTCCCAGAGACCCAGTACTTC	CASSALGTSVPETQYF	TRBV7-9	TRBJ2-5
TGTGCCAGCAGGTTCAGGGCGAATCATAGCAATCAGCCCCAGCATTTT	CASRFRANHSNQPQHF	TRBV12-3	TRBJ1-5
TGTGCCAGCAGTCGAACTCTTACTGGGGCCAACGTCCTGACTTTC	CASSRTLTGANVLTF	TRBV6-1	TRBJ2-6
TGTGCCAGCAGCAACAGGGGTTGGGAAGAAGCTTTCTTT	CASSNRGWEEAFF	TRBV13	TRBJ1-1
TGTGCCAGCAGCTTGCTTGGGGGGAGCTCCTACAATGAGCAGTTCTTC	CASSLLGGSSYNEQFF	TRBV7-4	TRBJ2-1
TGTGCCAGCAGCGCCCCAGGGTACGAGCAGTACTTC	CASSAPGYEQYF	TRBV13	TRBJ2-7
TGTGCCAGCTACCGGGGACAGGGGAGTCCCTACGAGCAGTACTTC	CASYRGQGSPYEQYF	TRBV12-3	TRBJ2-7
TGTGCCAGCAGCTTTAAACGGGACAGGGGCTCCCCCGGCTCTGGGGCCAACGTCCTGACTTTC	CASSFKRDRGSPGSGANVLTF	TRBV9	TRBJ2-6
TGTGCCACCCCCGCGGGGGGGGTAGAGAGCAATCAGCCCCAGCATTTT	CATPAGGVESNQPQHF	TRBV24-1	TRBJ1-5
TGTGCCAGGCTAGCGGGTTATGAGCAGTTCTTC	CARLAGYEQFF	TRBV7-3	TRBJ2-1
TGTGCCAGCAGGCCCCTAGACAGGGCACGGGTGTCGGACGGCAATCAGCCCCAGCATTTT	CASRPLDRARVSDGNQPQHF	TRBV2	TRBJ1-5
TGCGCCAGCGGGGGGGAGACCCAGTACTTC	CASGGETQYF	TRBV10-2	TRBJ2-5
TGTGCCAGCAGCTTGGCCACGACAGGGGGGCTCCCTGAGTGTAACTATGGCTACACCTTC	CASSLATTGGLPECNYGYTF	TRBV5-6	TRBJ1-2
TGTGGGAGGGGGGCCCTAGCAGCCAAAAACATTCAGTACTTC	CGRGALAAKNIQYF	TRBV27	TRBJ2-4
TGTGCCAGCAGCAAGTTTGTTGGGGACCTCCTCGGCCGGAATGAAAAACTGTTTTTT	CASSKFVGDLLGRNEKLFF	TRBV7-3	TRBJ1-4
TGTGCCACCATATCCAAAACAGGGAGGGACGGCCAGGGCAATCAGCCCCAGCATTTT	CATISKTGRDGQGNQPQHF	TRBV24-1	TRBJ1-5
TGCGCCAGCAGTGAGTCGTTGGCACACCAAACAGGGCCAAACTATGGCTACACCTTC	CASSESLAHQTGPNYGYTF	TRBV10-1	TRBJ1-2
TGTGCCAGCAGGTGCTTGGACATAGCCTACGAGCAGTACTTC	CASRCLDIAYEQYF	TRBV27	TRBJ2-7
TGCGCCGGAGGACAGGGTGCCAGCTATGGCTACACCTTC	CAGGQGASYGYTF	TRBV10-1	TRBJ1-2
TGTGCCACCAGTGATTGGCGAAAAGCCAAAAACATTCAGTACTTC	CATSDWRKAKNIQYF	TRBV24-1	TRBJ2-4
TGCGCCAGCAGCTTGCAGCCTGAGAGGGGAAACACCATATATTTT	CASSLQPERGNTIYF	TRBV5-1	TRBJ1-3
TGTGCCAGCAGCTTGGGCAACAGGGGGCTCCCTGAAAAACTGTTTTTT	CASSLGNRGLPEKLFF	TRBV5-6	TRBJ1-4
TGTGCCACCAGTGTCAGGGGCAGGCAAGAGACCCAGTACTTC	CATSVRGRQETQYF	TRBV24-1	TRBJ2-5
TGCAGTGCTAGCCCGCGGCGGGGGGTAAACGAGGGCACAGATACGCAGTATTTT	CSASPRRGVNEGTDTQYF	TRBV20-1	TRBJ2-3
TGTGCCAGCAGCCCGGAGCTCTACGAGCAGTACTTC	CASSPELYEQYF	TRBV7-4	TRBJ2-7
TGTGCCAGCAGTTCCGCCACCCGCCGGGACGGGGAGCTGTTTTTT	CASSSATRRDGELFF	TRBV6-3	TRBJ2-2
TGTGCCAGCAGCGGTCAGGGACTTTATGGCTACACCTTC	CASSGQGLYGYTF	TRBV13	TRBJ1-2
TGCGCCAGCAGCTTGGTCCACCGACTTGGGAGGGCTGGCTACACCTTC	CASSLVHRLGRAGYTF	TRBV5-1	TRBJ1-2
TGTGCCAGCAGCCGGGGGACCTCTGGAAACACCATATATTTT	CASSRGTSGNTIYF	TRBV5-8	TRBJ1-3
TGTGCCATCAGTGAGTCGATCGGGGGTTTCGGCTACGAGCAGTACTTC	CAISESIGGFGYEQYF	TRBV10-3	TRBJ2-7
TGTGCCAGCAGCGGGGGGGACAGGGAAAGACAGCATTTT	CASSGGDRERQHF	TRBV9	TRBJ1-5
TGCGCCAGCAGCTTGGCCGGGGGGAGAGGGTGCCAAGAGACCCAGTACTTC	CASSLAGGRGCQETQYF	TRBV5-1	TRBJ2-5
TGTGCCAGCTTTGTGGACAGTAACATCTATGGCTACACCTTC	CASFVDSNIYGYTF	TRBV2	TRBJ1-2
TGTGCCATTGGGGCTAACTATGGCTACACCTTC	CAIGANYGYTF	TRBV6-4	TRBJ1-2
TGTGCCAGCAGTTCCGCGGACCTAGGGGATACGCAGTATTTT	CASSSADLGDTQYF	TRBV6-9	TRBJ2-3
TGCGCCAGCAGCTTGCCGGGGGGGCACAGAATGTCAGATACGCAGTATTTT	CASSLPGGHRMSDTQYF	TRBV5-1	TRBJ2-3
TGTGCCAGCAGCCCGAGGGCCGCTGGGGCCAACGTCCTGACTTTC	CASSPRAAGANVLTF	TRBV28	TRBJ2-6
TGTGCCATCAGCGCGAGTTGCTCCTACGAGCAGTACTTC	CAISASCSYEQYF	TRBV10-3	TRBJ2-7
TGTGCCAGCAGCGTAGCGACTAGGGCGTCCTACAATGAGCAGTTCTTC	CASSVATRASYNEQFF	TRBV9	TRBJ2-1
TGTGGGCAATGGGACAACAACACTGAAGCTTTCTTT	CGQWDNNTEAFF	TRBV25-1	TRBJ1-1
TGTGCCAGCACCTCCTCCTGGACAGACTACGAGCAGTACTTC	CASTSSWTDYEQYF	TRBV7-3	TRBJ2-7
TGTGCCAGCAAACGCAGGGGGCAGGCCACTGAAGCTTTCTTT	CASKRRGQATEAFF	TRBV6-1	TRBJ1-1
TGTGCCAGCAGCTTCCTGGGGCATGAGCAGTTCTTC	CASSFLGHEQFF	TRBV7-3	TRBJ2-1
TGTGCCAGCAGCTTGGCCGAGTTTCGCGGGACAGGGGCGGTGTGGATAGCTTTCTTT	CASSLAEFRGTGAVWIAFF	TRBV5-5	TRBJ1-1
TGCAGTGAACAGGGCGGTACGGAGTACGAGCAGTACTTC	CSEQGGTEYEQYF	TRBV20-1	TRBJ2-7
TGTGCCAGCAGGGCTAGCCCGGGCGCGGTTAATGAGCAGTTCTTC	CASRASPGAVNEQFF	TRBV7-9	TRBJ2-1
TGTGCCAGCAGCCGAGCCGGGAACAATGAGCAGTTCTTC	CASSRAGNNEQFF	TRBV14	TRBJ2-1
TGTGCCCCCCGGCAGGGACAGGAGACCCAGTACTTC	CAPRQGQETQYF	TRBV19	TRBJ2-5
TGTGCCAGCAGCCGGGGTCGATATAGCAATCAGCCCCAGCATTTT	CASSRGRYSNQPQHF	TRBV5-4	TRBJ1-5
TGCGCCAGCATGGTGGGGGCAGAGACCCAGTACTTC	CASMVGAETQYF	TRBV4-3	TRBJ2-5
TGTGCCGGGACAGGGGGGACTAATGAAAAACTGTTTTTT	CAGTGGTNEKLFF	TRBV7-9	TRBJ1-4
TGTGCCACCAGTGATTTGCCCCGGGACAGGGACTATGGCTACACCTTC	CATSDLPRDRDYGYTF	TRBV24-1	TRBJ1-2
TGTGCCAGCAGCTTAGGAACCCTGAGGGCGCCTTTAAGGACCGCTTTCTTT	CASSLGTLRAPLRTAFF	TRBV11-2	TRBJ1-1
TGTGCCAGCAGCTTGGAGAACCACGGCAGGGGGGTGGATCAGCCCCAGCATTTT	CASSLENHGRGVDQPQHF	TRBV9	TRBJ1-5
TGTGCCAGCAGCTTATGCATCTCTCGGCAGTTTCAGCCCCAGCATTTT	CASSLCISRQFQPQHF	TRBV11-3	TRBJ1-5
TGTGCCACCAGCCTAAGCTACAAAAACATTCAGTACTTC	CATSLSYKNIQYF	TRBV24-1	TRBJ2-4
TGCGCCAGCACAGTAAGTAAGGAAGAGACCCAGTACTTC	CASTVSKEETQYF	TRBV10-1	TRBJ2-5
TGTGCCAGCAGCTTAGAAGGGGCAGATACGCAGTATTTT	CASSLEGADTQYF	TRBV7-8	TRBJ2-3
TGTGCCAGCAGCTCCGTTGGGGACAGGGGGGCCTATCAGCCCCAGCATTTT	CASSSVGDRGAYQPQHF	TRBV9	TRBJ1-5
TGTGCCAGCAGAGTTTCACGGGGGCCCCGCCGGGCCAATGAGCAGTTCTTC	CASRVSRGPRRANEQFF	TRBV6-1	TRBJ2-1
TGCAGTGCTCGGACAGGGGAGGGGTCGTACTACACCTTC	CSARTGEGSYYTF	TRBV20-1	TRBJ1-2
TGCGCCAGACTCAGGCCGACGGGATTGATCTCTGGGGCCAACGTCCTGACTTTC	CARLRPTGLISGANVLTF	TRBV10-1	TRBJ2-6
TGTGCCAGCAGGAAGTGCAGGGGGGAGACCCAGTACTTC	CASRKCRGETQYF	TRBV2	TRBJ2-5
TGTGCCAGCCGCACAGACAGCCTAACTTCACCCCTCCACTTT	CASRTDSLTSPLHF	TRBV28	TRBJ1-6
TGTGCTAGTGGGAGTTCAAAAGAGGGAGATACGCAGTATTTT	CASGSSKEGDTQYF	TRBV12-5	TRBJ2-3
TGTCCCCACCGAGGGCGCCAGACCAATGAGCAGTTCTTC	CPHRGRQTNEQFF	TRBV7-9	TRBJ2-1
TGTGCCAGTAGATATTACCTGGGACTAGATCTTGATGAGCAGTTCTTC	CASRYYLGLDLDEQFF	TRBV19	TRBJ2-1
TGTGCTAAGGGGGGGGGGGCCCCTGGAACGAACACCGGGGAGCTGTTTTTT	CAKGGGAPGTNTGELFF	TRBV12-5	TRBJ2-2
TGTGCCAGCAGCAAGTGGGACAGCCCCCATAATTCACCCCTCCACTTT	CASSKWDSPHNSPLHF	TRBV13	TRBJ1-6
TGTGCCAGTAAAGGGGGCGGGGGAGCCGGGATACAGAACACTGAAGCTTTCTTT	CASKGGGGAGIQNTEAFF	TRBV19	TRBJ1-1
TGTGCCAGCAGCTTGACGGGGGCTAGGGGTAGTGGCTACACCTTC	CASSLTGARGSGYTF	TRBV5-8	TRBJ1-2
TGTGCCACCAGTGGAATCCCAGCAGGGGCTTTCTTT	CATSGIPAGAFF	TRBV24-1	TRBJ1-1
TGTGCCACCAGTGCATCCTGGACAGGACCGTCCGAGCAGTACTTC	CATSASWTGPSEQYF	TRBV24-1	TRBJ2-7
TGCGCCAGCAGCCCGACGTATGGCTACACCTTC	CASSPTYGYTF	TRBV4-1	TRBJ1-2
TGCAGCGTAGCTCCCCGTATCAGGTCCTACGAGCAGTACTTC	CSVAPRIRSYEQYF	TRBV29-1	TRBJ2-7
TGCAGTGCCCGGGGGGAGAACACTGAAGCTTTCTTT	CSARGENTEAFF	TRBV20-1	TRBJ1-1
TGTGCCAGCAGCGTAGTCCCGGGGGGGACTGCGGACACCGGGGAGCTGTTTTTT	CASSVVPGGTADTGELFF	TRBV9	TRBJ2-2
TGCGCCAGCAGCTTGGCCGGAGGACAGAGCGCAAGCAACACCGGGGAGCTGTTTTTT	CASSLAGGQSASNTGELFF	TRBV5-1	TRBJ2-2
TGTGCCAGCAGTATCCCGGTTTGTCATAGCAATCAGCCCCAGCATTTT	CASSIPVCHSNQPQHF	TRBV6-3	TRBJ1-5
TGTGCCAGCAGCTGCCCGGGACAGTGGGAGTGGAGCTCCTACAATGAGCAGTTCTTC	CASSCPGQWEWSSYNEQFF	TRBV11-3	TRBJ2-1
TGTGCCAGCAGCGTCCCGAAGTATTATGGCTACACCTTC	CASSVPKYYGYTF	TRBV9	TRBJ1-2
TGTGCCAGCAGTACCCAGGGGGCCCTTGATGGCTACACCTTC	CASSTQGALDGYTF	TRBV25-1	TRBJ1-2
TGCAGCGTCCGCTCAGATTTTAACACCGGGGAGCTGTTTTTT	CSVRSDFNTGELFF	TRBV29-1	TRBJ2-2
TGTGCCAGCAGCCACCCTCGCAAAAGGGACTGCTACGAGCAGTACTTC	CASSHPRKRDCYEQYF	TRBV4-2	TRBJ2-7
TGTGCCAGCAGTTACAGAGCGGGAGAGCTTCACACCGGGGAGCTGTTTTTT	CASSYRAGELHTGELFF	TRBV27	TRBJ2-2
TGCGCCAGCAGCCAACCCCCGGGAGGGGTCGAAAACATTCAGTACTTC	CASSQPPGGVENIQYF	TRBV4-3	TRBJ2-4
TGCGCCAGCAGCTTGGGTCAGCTGCCCTATGGCTACACCTTC	CASSLGQLPYGYTF	TRBV5-1	TRBJ1-2
TGCGCCAGCAGAATGGAGGGATCTACGATCTCAACTAATGAAAAACTGTTTTTT	CASRMEGSTISTNEKLFF	TRBV10-1	TRBJ1-4
TGTGCCAGCAGCTTAAATGCGACTAGCGGGGGGAAGCAGACCCAGTACTTC	CASSLNATSGGKQTQYF	TRBV7-3	TRBJ2-5
TGTGCCAGCAGCTATGCTAGGGGGGGGGGCGAGCAGTTCTTC	CASSYARGGGEQFF	TRBV7-9	TRBJ2-1
TGTGCCTGGCCTCTCTTGGGACGCTCCTATAATTCACCCCTCCACTTT	CAWPLLGRSYNSPLHF	TRBV30	TRBJ1-6
TGTGCCTGGAGTGGAAACCGGAGTGAGTTTTTGGCCAACGTCCTGACTTTC	CAWSGNRSEFLANVLTF	TRBV30	TRBJ2-6
TGCGCCAGCAGCTCCCCCACGGAGGGCCCACCGCCGTGGGGGGCAACTAATGAAAAACTGTTTTTT	CASSSPTEGPPPWGATNEKLFF	TRBV5-1	TRBJ1-4
TGTGCCAGCAGCTGTACGCCACGGGACACTGAAGCTTTCTTT	CASSCTPRDTEAFF	TRBV6-4	TRBJ1-1
TGTGCCAGCAGTGAAGCGGTTGAGACCCAGTACTTC	CASSEAVETQYF	TRBV2	TRBJ2-5
TGTGCCTGGGACGCGGACAGGGCTAGGCCGACTAGCACAGATACGCAGTATTTT	CAWDADRARPTSTDTQYF	TRBV30	TRBJ2-3
TGTGCCTGGAGTGTCGGGTCCTCCAATGAGCAGTTCTTC	CAWSVGSSNEQFF	TRBV30	TRBJ2-1
TGTGCCAGCAGCGTTGCCCGAACACGAATGAACGCCCATACGCAGTATTTT	CASSVARTRMNAHTQYF	TRBV5-4	TRBJ2-3
TGCGCCAGCACTAGCGGGGGTAGAGTAGGAGATACGCAGTATTTT	CASTSGGRVGDTQYF	TRBV5-1	TRBJ2-3
TGTGCCAGCAGTGAGCGGGCCTTAATCTATAGCAATCAGCCCCAGCATTTT	CASSERALIYSNQPQHF	TRBV6-1	TRBJ1-5
TGTGCCAAAGGGACTAGCGGGGGGGCCGGCTACGAGCAGTACTTC	CAKGTSGGAGYEQYF	TRBV9	TRBJ2-7
TGTGCCAGCAAACGGACTAGCGGAAGGCAGTTCTTC	CASKRTSGRQFF	TRBV27	TRBJ2-1
TGCAGTGCTAGAGCCAGGAAGCGGGACAGGGATTGTCGCGGGGAGCTGTTTTTT	CSARARKRDRDCRGELFF	TRBV20-1	TRBJ2-2
TGTGCCAGCAGCATTCGACTAGCGGGGGAGGGCACAGATACGCAGTATTTT	CASSIRLAGEGTDTQYF	TRBV13	TRBJ2-3
TGTGCCAGCAGTTTATCGGGGGGGGCCGAGGATGCAACTAATGAAAAACTGTTTTTT	CASSLSGGAEDATNEKLFF	TRBV28	TRBJ1-4
TGTGCCAGAGTACCCGGGACAGGGGGCTATGCTGCTTTCTTT	CARVPGTGGYAAFF	TRBV30	TRBJ1-1
TGTGCCAGCAGCCACCGACTAGCGGCAGATACGCAGTATTTT	CASSHRLAADTQYF	TRBV7-2	TRBJ2-3
TGTGCCAGCAGTTGGAGGGACAGGGTTATGAACACTGAAGCTTTCTTT	CASSWRDRVMNTEAFF	TRBV27	TRBJ1-1
TGCGCCAGGCCCGATAGCGGGTACGAGCAGTACTTC	CARPDSGYEQYF	TRBV10-2	TRBJ2-7
TGTGCCAGGGAAGGGGGCCAAGGCTCCTATAATTCACCCCTCCACTTT	CAREGGQGSYNSPLHF	TRBV19	TRBJ1-6
TGTGCCAGCAGTTGGACTAGCGGGGGTACAGATACGCAGTATTTT	CASSWTSGGTDTQYF	TRBV6-1	TRBJ2-3
TGCGCCAGCAGCCACCATCCCGAGAGGAAAAGCTCCTATAATTCACCCCTCCACTTT	CASSHHPERKSSYNSPLHF	TRBV4-1	TRBJ1-6
TGTGCCAGCAGCCGAATTGTGGGGGCAGCTAGCACAGATACGCAGTATTTT	CASSRIVGAASTDTQYF	TRBV13	TRBJ2-3
TGTGCCAGCAGCTTAGGGGAAAGGACAGGGGGTCCTAGCACAGATACGCAGTATTTT	CASSLGERTGGPSTDTQYF	TRBV7-6	TRBJ2-3
TGTGCCAGCAGTCCTACTAGGACCTACGAGCAGTACTTC	CASSPTRTYEQYF	TRBV27	TRBJ2-7
TGTGCCAGCAGTTACTCGGGGAGGGGGGTTAACACCGGGGAGCTGTTTTTT	CASSYSGRGVNTGELFF	TRBV6-6	TRBJ2-2
TGTGCCAGCAGGCCCGGGGGCACAGATACGCAGTATTTT	CASRPGGTDTQYF	TRBV7-3	TRBJ2-3
TGTGCCAGAGAGGGGGGGCGAGCCACCGGGGAGCTGTTTTTT	CAREGGRATGELFF	TRBV19	TRBJ2-2
TGCACCCGAGGAGGAGAGCAGTACTTC	CTRGGEQYF	TRBV20-1	TRBJ2-7
TGTGATGGGGGAGACAGGGGGCTAGCCAAAAACATTCAGTACTTC	CDGGDRGLAKNIQYF	TRBV6-4	TRBJ2-4
TGTGCCTCCCACAGGGGATCCAACTATGGCTACACCTTC	CASHRGSNYGYTF	TRBV28	TRBJ1-2
TGCAGTGCAGGCGGCCCAAAGGACATTTTAGGGGGCAACTACGAGCAGTACTTC	CSAGGPKDILGGNYEQYF	TRBV20-1	TRBJ2-7
TGCGCCAGCAGCTTGCCCCAGGGGCTAGACTATGGCTACACCTTC	CASSLPQGLDYGYTF	TRBV5-1	TRBJ1-2
TGTGCCAGCAGCCCCGTCCCCGGGACTTTCTCCTACGAGCAGTACTTC	CASSPVPGTFSYEQYF	TRBV7-6	TRBJ2-7
TGTGCCAGCAGCAAAGGGGGCTTTGAGCAGTTCTTC	CASSKGGFEQFF	TRBV9	TRBJ2-1
TGTGCCAGCAGCTTGCCCCTAGCGGGCCTGAGAATGAGAGTACGGGGCTACGAGCAGTACTTC	CASSLPLAGLRMRVRGYEQYF	TRBV5-6	TRBJ2-7
TGTGCCAGCAGCTTACCCTCTGAGAGTACAGGGAACACTGAAGCTTTCTTT	CASSLPSESTGNTEAFF	TRBV7-9	TRBJ1-1
TGTGCCAGCAGTTATTGGAGGACGGAGCCGAACTATGGCTACACCTTC	CASSYWRTEPNYGYTF	TRBV6-3	TRBJ1-2
TGTGCCACCAGTCCCCGTGCGGTCAGTATCTTC	CATSPRAVSIF	TRBV24-1	TRBJ2-1
TGTGCCAGCAGTGAAGTGCAGGGCAGCTCCTACGAGCAGTACTTC	CASSEVQGSSYEQYF	TRBV6-1	TRBJ2-7
TGTGCCAGTAGACCTATCGGGGACGAGCAGTACTTC	CASRPIGDEQYF	TRBV19	TRBJ2-7
TGTGCCACCAGCAGAGGATGGGGGATGGGCACGAGTGGCTACACCTTC	CATSRGWGMGTSGYTF	TRBV15	TRBJ1-2
TGCAGTGCTAGCTTCGTCCGAGAGGGGGGGACCGGGGAGCTGTTTTTT	CSASFVREGGTGELFF	TRBV20-1	TRBJ2-2
TGTGCCAGCAGCGGGGCCCCCGGTCGGCAGTTCTTC	CASSGAPGRQFF	TRBV13	TRBJ2-1
TGTGCCAGCAGTGGACGGCTAAAGATGAACACTGAAGCTTTCTTT	CASSGRLKMNTEAFF	TRBV6-1	TRBJ1-1
TGTGCCAGCAGTTACTCGGGAGGGGGAGATGGCTACACCTTC	CASSYSGGGDGYTF	TRBV6-6	TRBJ1-2
TGTGCCATACACCGTACGCCCTACGAGCAGTACTTC	CAIHRTPYEQYF	TRBV10-3	TRBJ2-7
TGTGCCAGCAGTGGTTTAGGGGTCCGCGAGCAGTACTTC	CASSGLGVREQYF	TRBV27	TRBJ2-7
TGTGCCAGCAGTAGCTTCGCAGACCAGAGCTACGAGCAGTACTTC	CASSSFADQSYEQYF	TRBV7-8	TRBJ2-7
TGTGCCAGCAGTTACTCCCGGGACAGGGAGTTGAGTTCACCCCTCCACTTT	CASSYSRDRELSSPLHF	TRBV6-2	TRBJ1-6
TGTGCCAGCAGCCACAGGATGAGCACTGAAGCTTTCTTT	CASSHRMSTEAFF	TRBV5-4	TRBJ1-1
TGCAGTGCTATCTTCTGGGACAGGGTATATCAGCCCCAGCATTTT	CSAIFWDRVYQPQHF	TRBV20-1	TRBJ1-5
TGCAGTGCTAAGAGGGGCTACACTGAAGCTTTCTTT	CSAKRGYTEAFF	TRBV20-1	TRBJ1-1
TGTGCCAGCAGCCAAGCGGGGGTTGCCGGGGAGCTGTTTTTT	CASSQAGVAGELFF	TRBV3-1	TRBJ2-2
TGCAGCGTAGACCTAGGGCCCCCCTATGGCTACACCTTC	CSVDLGPPYGYTF	TRBV29-1	TRBJ1-2
TGCGCCAGCAGCAGACCCCCCCCCGGGCCCAACTATAATTCACCCCTCCACTTT	CASSRPPPGPNYNSPLHF	TRBV5-1	TRBJ1-6
TGTGCCAGCAGCTTAGGAGGGAGGGGGACAACTTCACCCCTCCACTTT	CASSLGGRGTTSPLHF	TRBV7-3	TRBJ1-6
TGTGCAGGTATGAGCCGGGGGACTGAAGCTTTCTTT	CAGMSRGTEAFF	TRBV25-1	TRBJ1-1
TGTGCCAGCATGGGTGTCAGGGGGCGGAACACTGAAGCTTTCTTT	CASMGVRGRNTEAFF	TRBV27	TRBJ1-1
TGCAGCCCGCCGACCTACGAGCAGTACTTC	CSPPTYEQYF	TRBV20-1	TRBJ2-7
TGTGCCAGCAGCTCTCATCAAGCATCCGGGGGAGGTTCCGATAGCAATCAGCCCCAGCATTTT	CASSSHQASGGGSDSNQPQHF	TRBV11-3	TRBJ1-5
TGTGCCAGCAGCTTGAGGACGCAGTACGAGCAGTACTTC	CASSLRTQYEQYF	TRBV5-4	TRBJ2-7
TGTGCCAGTAGTATCAAACAGGGGTTAGTGAACACTGAAGCTTTCTTT	CASSIKQGLVNTEAFF	TRBV19	TRBJ1-1
TGTGCCACGCCGGGCCTGTGTCCGCGTGAGACCCAGTACTTC	CATPGLCPRETQYF	TRBV6-4	TRBJ2-5
TGTGCTAGTGGTTTGTCGACAGGGAGCTACGAGCAGTACTTC	CASGLSTGSYEQYF	TRBV12-5	TRBJ2-7
TGTGCCAGCAGTGACTCCCGGGACGGGGGGGAAGGCACAGATACGCAGTATTTT	CASSDSRDGGEGTDTQYF	TRBV6-4	TRBJ2-3
TGTGCCACCAGCAGAGATCATCTCCTGGGACTTGGGGCCAACGTCCTGACTTTC	CATSRDHLLGLGANVLTF	TRBV15	TRBJ2-6
TGCAGTGCTAAGAAGAGCGAGGTGACTGAAGCTTTCTTT	CSAKKSEVTEAFF	TRBV20-1	TRBJ1-1
TGTGCCAGCAGGGGACAGGGTCGGATGAACACTGAAGCTTTCTTT	CASRGQGRMNTEAFF	TRBV12-4	TRBJ1-1
TGTGCCAGCAGCCCTTGCGGACTAGCTGGCACAGATACGCAGTATTTT	CASSPCGLAGTDTQYF	TRBV7-3	TRBJ2-3
TGCGCCAGCAGCAGGGACAGGGGATTGCAGCCCCAGCATTTT	CASSRDRGLQPQHF	TRBV5-1	TRBJ1-5
TGCGCCAGCAGTGAGTCTAGCGTTAACGGTTACGCTAGCACAGATACGCAGTATTTT	CASSESSVNGYASTDTQYF	TRBV10-1	TRBJ2-3
TGTGCCAGCAGTTTCTCGCGGGACAGACGCTATGGCTACACCTTC	CASSFSRDRRYGYTF	TRBV12-4	TRBJ1-2
TGTGCCTGGGAAGACCCCGGGCTCCGTATTAGCAATCAGCCCCAGCATTTT	CAWEDPGLRISNQPQHF	TRBV30	TRBJ1-5
TGCAGCGTTGCAACAGGGGGATATTACGAGCAGTACTTC	CSVATGGYYEQYF	TRBV29-1	TRBJ2-7
TGTGCCAGCAGGCCAGAACGGGACAGCTACGAGCAGTACTTC	CASRPERDSYEQYF	TRBV12-4	TRBJ2-7
TGTGCCAGCAGCGGGGGCGCGACGAGCAATCAGCCCCAGCATTTT	CASSGGATSNQPQHF	TRBV9	TRBJ1-5
TGTGCCTGGATCTCCCCCCGGGGGGGGGGGGATGACGAGCAGTACTTC	CAWISPRGGGDDEQYF	TRBV30	TRBJ2-7
TGTGCCAGCAGTGACCGATCGCTGTTTCTCGACAGACCAGATACGCAGTATTTT	CASSDRSLFLDRPDTQYF	TRBV6-1	TRBJ2-3
TGTGCCAGCAGCTTAGTGGGAGACAGGCGGTACCAAGAGACCCAGTACTTC	CASSLVGDRRYQETQYF	TRBV7-7	TRBJ2-5
TGTGCCAGCAGTGAATCATCAAAAATTGGACTACCGGATGAGCAGTTCTTC	CASSESSKIGLPDEQFF	TRBV25-1	TRBJ2-1
TGTGCCAGCAGCTTAGTTCGTAGGGGCACTGAAGCTTTCTTT	CASSLVRRGTEAFF	TRBV7-2	TRBJ1-1
TGCAGTGCCGAGGGCCCAGGGGGTCGGATGGGCATTGATCAGCCCCAGCATTTT	CSAEGPGGRMGIDQPQHF	TRBV20-1	TRBJ1-5
TGCAGTGCTAGAGATTGGCCGGGACTAGCGGGGACCACAGATACGCAGTATTTT	CSARDWPGLAGTTDTQYF	TRBV20-1	TRBJ2-3
TGTGCCAGCAGCAGATTGCCCCCCACAGGTTCGAACACTGAAGCTTTCTTT	CASSRLPPTGSNTEAFF	TRBV7-9	TRBJ1-1
TGCGCCAGCAGCCAAGGGGACGACGGACGTTCTACGTACGAGCAGTACTTC	CASSQGDDGRSTYEQYF	TRBV4-1	TRBJ2-7
TGCGCCAGCAGCCAAGATAAAGGGGAGGTGGTTCCTGAAAAACTGTTTTTT	CASSQDKGEVVPEKLFF	TRBV4-1	TRBJ1-4
