TGCGCCAGCAGCTTGGCTATCGGTTTGAATGCAGGGTCTTACGAGCAGTACTTC	CASSLAIGLNAGSYEQYF	TRBV5-1	TRBJ2-7
TGTGCCAGCACGAAACTAGCTCTCACAGATACGCAGTATTTT	CASTKLALTDTQYF	TRBV6-1	TRBJ2-3
TGTGCCAGCACCGGGAAGTACTTC	CASTGKYF	TRBV13	TRBJ2-7
TGTGCCTGGAGTAATTGCGACAGGGCTAGGGGTTACGAGCAGTACTTC	CAWSNCDRARGYEQYF	TRBV30	TRBJ2-7
TGCAGCGGGGCACTCCCCCGGACGGGTAACACCGGGGAGCTGTTTTTT	CSGALPRTGNTGELFF	TRBV29-1	TRBJ2-2
TGTGCCAGCTCAAACCGCCCGGCCCTCGGTTCCTACGAGCAGTACTTC	CASSNRPALGSYEQYF	TRBV18	TRBJ2-7
TGTGCCAGCAGCGGCCATTTCTCCTATAATTCACCCCTCCACTTT	CASSGHFSYNSPLHF	TRBV7-4	TRBJ1-6
TGTGCCAGCAGTGAGACCACAGGGGTATATGAAAAACTGTTTTTT	CASSETTGVYEKLFF	TRBV6-4	TRBJ1-4
TGCGCCAGCAGCCAAGGGAGCCCGGGTCACTCTGGAAACACCATATATTTT	CASSQGSPGHSGNTIYF	TRBV4-1	TRBJ1-3
TGTGCCAGCAGTAGGGGCTCCTACGAGCAGTACTTC	CASSRGSYEQYF	TRBV27	TRBJ2-7
TGCGCCAGCAGCCAAGAGTTAAAACAACGCACGGGCTACACCTTC	CASSQELKQRTGYTF	TRBV4-1	TRBJ1-2
TGTGCCAGCAGTGCCCGGGGGAGGGACTTCGACCTGAACACTGAAGCTTTCTTT	CASSARGRDFDLNTEAFF	TRBV6-5	TRBJ1-1
TGTGCCAGCAGCCACGGGACTAGCGGGTATGAGACCCAGTACTTC	CASSHGTSGYETQYF	TRBV5-8	TRBJ2-5
TGTGCCAGCAGCCAAGATACGACGAGCGGGGAGCTGTTTTTT	CASSQDTTSGELFF	TRBV3-1	TRBJ2-2
TGTGCCAGCAGCTTAGGGCGGGGGTCAGGGGAACCCTACAATGAGCAGTTCTTC	CASSLGRGSGEPYNEQFF	TRBV7-4	TRBJ2-1
TGTGCCAGCAGCCAAGCCCCTAGCGGGGCCCGTCATGAGCAGTTCTTC	CASSQAPSGARHEQFF	TRBV4-2	TRBJ2-1
TGTGCCAGCAGTCCTAGACACGGCTACGAGCAGTACTTC	CASSPRHGYEQYF	TRBV25-1	TRBJ2-7
TGTGCCAGCAGCCATGTTCTCTATGGGGCTTTAGTTCAGACTAATTCACCCCTCCACTTT	CASSHVLYGALVQTNSPLHF	TRBV4-2	TRBJ1-6
TGTGCAGAGTTCCTCAGGGGGACAGGGCCATTAGCAAGGCCCCAGCATTTT	CAEFLRGTGPLARPQHF	TRBV7-6	TRBJ1-5
TGTGCCAGCAGCTTCGATGTGAGTACTAACTATGGCTACACCTTC	CASSFDVSTNYGYTF	TRBV7-6	TRBJ1-2
TGTGCCAGCAGTTTTTCACTAGGGACCTACGAGCAGTACTTC	CASSFSLGTYEQYF	TRBV12-3	TRBJ2-7
TGCAGTGCTAGAGTCCGGCTAAGTCACACCGGGGAGCTGTTTTTT	CSARVRLSHTGELFF	TRBV20-1	TRBJ2-2
TGCAGTGCTAGGGGAGGGGAAGAAAAGCTATCACACCCTGAGTACTTC	CSARGGEEKLSHPEYF	TRBV20-1	TRBJ2-7
TGCGCCAGCAGTGAGACCGGACCCACATCCCCCTACGAGCAGTACTTC	CASSETGPTSPYEQYF	TRBV10-1	TRBJ2-7
TGCGCCAGCAGCTGGGGGCGCCTCAAGTACCAAGAGACCCAGTACTTC	CASSWGRLKYQETQYF	TRBV5-1	TRBJ2-5
TGCGCCAGCAGCCCTAGGGGTAGAAATTCACCCCTCCACTTT	CASSPRGRNSPLHF	TRBV5-1	TRBJ1-6
TGTGCCAGCAGTTCAAGCTCGAGGGCAACTGAAGCTTTCTTT	CASSSSSRATEAFF	TRBV27	TRBJ1-1
TGCGCCAGGTCAGGGGGCGTCCAGCCCCAGCATTTT	CARSGGVQPQHF	TRBV5-1	TRBJ1-5
TGTGCCACCAGTGATATCCGGGAGAACAAAATGGGCGAGCAGTACTTC	CATSDIRENKMGEQYF	TRBV24-1	TRBJ2-7
TGTGCCAGCAGCCGCCCCCAGAGGGCGAATGAAAAACTGTTTTTT	CASSRPQRANEKLFF	TRBV13	TRBJ1-4
TGTGCCAGCCTAGGGGGGGCCGGAAAATGGGGAGAGCAGTACTTC	CASLGGAGKWGEQYF	TRBV6-2	TRBJ2-7
TGTGCCAGCAGTTTACCGACAAGGGGGCGGAACCTTAGAGGCTATAATTCACCCCTCCACTTT	CASSLPTRGRNLRGYNSPLHF	TRBV12-3	TRBJ1-6
TGTGCCAGCTCACTAACGGGACAGGGATTAACTAATGAAAAACTGTTTTTT	CASSLTGQGLTNEKLFF	TRBV18	TRBJ1-4
TGTGCCAGCAGCTATGGGGGGGTACCCGGAGAGACCCAGTACTTC	CASSYGGVPGETQYF	TRBV13	TRBJ2-5
TGTGCCAGCAGCCAGCACAGGTCCTGCACAGATACGCAGTATTTT	CASSQHRSCTDTQYF	TRBV7-3	TRBJ2-3
TGTGCCAGCAGTTTGAGGACTAGCGAGCGCACGCAGTATTTT	CASSLRTSERTQYF	TRBV28	TRBJ2-3
TGTGCCAGCAGTGGTCTGGTCGGTTTGAACACTGAAGCTTTCTTT	CASSGLVGLNTEAFF	TRBV27	TRBJ1-1
TGTGCCAGCAGGGATATGAACCAAAGGACAGGTTGGGGTAACACTGAAGCTTTCTTT	CASRDMNQRTGWGNTEAFF	TRBV6-5	TRBJ1-1
TGTGCCAGCAGTGACCGGGAAACGGGAGCTTTCTTT	CASSDRETGAFF	TRBV27	TRBJ1-1
TGCAGCGGGACAGGCGGCAATCAGCCCCAGCATTTT	CSGTGGNQPQHF	TRBV29-1	TRBJ1-5
TGCAGTGCTAGAGTAGCGGACAATAACGGTACGCAGTATTTT	CSARVADNNGTQYF	TRBV20-1	TRBJ2-3
TGTGCAAATCGGAGTAACGTACCGCTTGGGCCCTACCAAGAGACCCAGTACTTC	CANRSNVPLGPYQETQYF	TRBV6-2	TRBJ2-5
TGTGCCAGCAGCGTCAGAGTGTTCCCCCGGGGGAGGGGCAATCAGCCCCAGCATTTT	CASSVRVFPRGRGNQPQHF	TRBV9	TRBJ1-5
TGTGCCAGCAGCTTAGGCGACAGGGGGCATAAAGAGACCCAGTACTTC	CASSLGDRGHKETQYF	TRBV7-4	TRBJ2-5
TGTGCCAGCAGAGAGGACAGGGTGCCCTACGAGCAGTACTTC	CASREDRVPYEQYF	TRBV11-2	TRBJ2-7
TGTGCCAGCAGTTACTTACGGTCTAGCGGCCACCAGACCTTAAATGAGCAGTTCTTC	CASSYLRSSGHQTLNEQFF	TRBV6-2	TRBJ2-1
TGTGCCAGCATGGATGGGGCCGCGCTGAGGTACTCAGAGACCCAGTACTTC	CASMDGAALRYSETQYF	TRBV6-3	TRBJ2-5
TGTGCCACCAGTGATTTGCGAGCCTTCTCCTACGAGCAGTACTTC	CATSDLRAFSYEQYF	TRBV24-1	TRBJ2-7
TGTGCCCGACGTCCCGGGTCCTACGAGCAGTACTTC	CARRPGSYEQYF	TRBV7-9	TRBJ2-7
TGTGCCAGCAGCAACCGGGACAGGGGCACAGATACGCAGTATTTT	CASSNRDRGTDTQYF	TRBV7-4	TRBJ2-3
TGCAGTGCTAGCCCCCCAGGGGCAGATACGCAGTATTTT	CSASPPGADTQYF	TRBV20-1	TRBJ2-3
TGCGCCAGCAGTCTCAGGCCTAACTATGGCTACACCTTC	CASSLRPNYGYTF	TRBV10-1	TRBJ1-2
TGTGCCAGCAGTTACCCTAGGCAGGGGGCAGTCACTGAAGCTTTCTTT	CASSYPRQGAVTEAFF	TRBV6-3	TRBJ1-1
TGTGCCAGCAGTTCTCGGCGGGAGCCGTTATGGATTAGGACTCAGCCCCAGCATTTT	CASSSRREPLWIRTQPQHF	TRBV28	TRBJ1-5
TGTGCCTGGAAGTGTCCCGGGGTATATGGCTACACCTTC	CAWKCPGVYGYTF	TRBV30	TRBJ1-2
TGTGCCAGGGACCTTTCGTACGAGCAGTACTTC	CARDLSYEQYF	TRBV19	TRBJ2-7
TGTGCCAGCAGCGCCCGACAGGGGGTGACAGATACGCAGTATTTT	CASSARQGVTDTQYF	TRBV7-4	TRBJ2-3
TGTGCCAAAGGGTTAATATTTACAGGAACAAACACCGGGGAGCTGTTTTTT	CAKGLIFTGTNTGELFF	TRBV10-3	TRBJ2-2
TGTGCCAGCAGCTTGGAGCGGGAGCAGTACTTC	CASSLEREQYF	TRBV5-6	TRBJ2-7
TGTGCCAGCAGCAGCCGCGGAACAAAGTCCAATGAGCAGTTCTTC	CASSSRGTKSNEQFF	TRBV13	TRBJ2-1
TGTGCCAGCAAATTCGGGCCCAGAAATGAAAAACTGTTTTTT	CASKFGPRNEKLFF	TRBV12-3	TRBJ1-4
TGCGCCAGCAGCCAAGACAATTCGGGCCAATGGGACACTGAAGCTTTCTTT	CASSQDNSGQWDTEAFF	TRBV4-1	TRBJ1-1
TGTGCCAGCAGCAGCCCTTCCGGGGGGGCTAAGACCGGGGAGCTGTTTTTT	CASSSPSGGAKTGELFF	TRBV11-2	TRBJ2-2
TGCGCCAGCAGTTTTCGGACGCGGAAGGACAATGAAAAACTGTTTTTT	CASSFRTRKDNEKLFF	TRBV10-1	TRBJ1-4
TGTGCCAGTAGGAAGGGACAAGACGAAAAACTGTTTTTT	CASRKGQDEKLFF	TRBV19	TRBJ1-4
TGTGCCAGCAGCGGGGCCGACGAGCAGTACTTC	CASSGADEQYF	TRBV13	TRBJ2-7
TGTGCCAGCAGCTTAGGTACGGAGGGAGATCTCATCACTGAAGCTTTCTTT	CASSLGTEGDLITEAFF	TRBV7-6	TRBJ1-1
TGTGCCAGCAGCCGGGGGACACCGGCCGGGGAGCTGTTTTTT	CASSRGTPAGELFF	TRBV7-2	TRBJ2-2
TGTGCCACCGACAAACGCGATGAGCAGTACTTC	CATDKRDEQYF	TRBV27	TRBJ2-7
TGTGCCAGCAGCCTGGAAATTACGAACACCGGGGAGCTGTTTTTT	CASSLEITNTGELFF	TRBV27	TRBJ2-2
TGTGCCAGCAGCTTAGGGGTCGGGACAGTGGAAGGCTCTGGGGCCAACGTCCTGACTTTC	CASSLGVGTVEGSGANVLTF	TRBV11-2	TRBJ2-6
TGTATTAGGACAGGGGGGGGTTCTGGAAACACCATATATTTT	CIRTGGGSGNTIYF	TRBV11-2	TRBJ1-3
TGCGCCAGCAGCTTCGTAAGGAGCAGCTCCTACAATGAGCAGTTCTTC	CASSFVRSSSYNEQFF	TRBV5-1	TRBJ2-1
TGCGCCAGCAGCTTCGTGCGGGAGAACACCGGGGAGCTGTTTTTT	CASSFVRENTGELFF	TRBV5-1	TRBJ2-2
TGTGCCAGCAAACATGTCGGGACAGGGGGCCGCGTACCAGATACGCAGTATTTT	CASKHVGTGGRVPDTQYF	TRBV5-4	TRBJ2-3
TGTGCCAGTAGTGAGGGGGCTCTACCTGGTCGGACTAGCGGGTTATACTCCTACGAGCAGTACTTC	CASSEGALPGRTSGLYSYEQYF	TRBV19	TRBJ2-7
TGTGCCAGCAGTCGTAGACAGCCCCCACTAGCGGGAGTATCCTACGAGCAGTACTTC	CASSRRQPPLAGVSYEQYF	TRBV6-2	TRBJ2-7
TGTGCCAGCCAAAGTGTCATCAGGAAAAACATGGACGGGGGGAGCTCTGGGGCCAACGTCCTGACTTTC	CASQSVIRKNMDGGSSGANVLTF	TRBV13	TRBJ2-6
TGCGCCAGCCAATTCAGGGACCCTGCCTACGAGCAGTACTTC	CASQFRDPAYEQYF	TRBV5-1	TRBJ2-7
TGTGCCAGCAGGGAATCTGGCCAGGATGGTAACTATGGCTACACCTTC	CASRESGQDGNYGYTF	TRBV9	TRBJ1-2
TGTGCCAGCAGCAGGTTAGCGGGAGAGCAGTTCTTC	CASSRLAGEQFF	TRBV13	TRBJ2-1
TGCAGCGTTGAGCTGCCAGGGGGCTCTCACAATCAGCCCCAGCATTTT	CSVELPGGSHNQPQHF	TRBV29-1	TRBJ1-5
TGTGCCAGCAGTTTATGGCAGGAAACGTTACCAAGAAATGGCTACACCTTC	CASSLWQETLPRNGYTF	TRBV27	TRBJ1-2
TGTGCCAGCAGCGTGAGCCTGGGGGGGCCCCGCGTCAATGAGCAGTTCTTC	CASSVSLGGPRVNEQFF	TRBV9	TRBJ2-1
TGTGCCAGCCCTTCAGCGGGGGGGCGCTCCTACGAGCAGTACTTC	CASPSAGGRSYEQYF	TRBV6-5	TRBJ2-7
TGTGCCAGCCCCATATTGGCCTACGAGCAGTACTTC	CASPILAYEQYF	TRBV5-6	TRBJ2-7
TGTGCCAGCAGCTTTAGACAGATAGTTTGTAATCAGCCCCAGCATTTT	CASSFRQIVCNQPQHF	TRBV5-4	TRBJ1-5
TGTGCCAGCAGCCCCCTCAACAGAGGCAATCAGCCCCAGCATTTT	CASSPLNRGNQPQHF	TRBV9	TRBJ1-5
TGTGCCAGCAGCGGTTCAACTGAAGCTTTCTTT	CASSGSTEAFF	TRBV11-3	TRBJ1-1
TGTGCCATAAATGAAGTAGGGGATTGTCCCTACGAGCAGTACTTC	CAINEVGDCPYEQYF	TRBV19	TRBJ2-7
TGTGCCAGCAGCTTAGTGCACAGGGAAGGGCTCCACCGCTACGAGCAGTACTTC	CASSLVHREGLHRYEQYF	TRBV11-2	TRBJ2-7
TGTGCCACCAGCGGGGGGACCTACGAGCAGTACTTC	CATSGGTYEQYF	TRBV24-1	TRBJ2-7
TGTGCCAGCAGTTTTCCGGGGGGCGGGTCGGATGGACCCTACGAGCAGTACTTC	CASSFPGGGSDGPYEQYF	TRBV28	TRBJ2-7
TGTGCCACCAGTGATCGGGAAGTACCTTCCTACGAGCAGTACTTC	CATSDREVPSYEQYF	TRBV24-1	TRBJ2-7
TGTGCCAGCAGCTTGGGGGGGGAAGAGACCCAGTACTTC	CASSLGGEETQYF	TRBV5-4	TRBJ2-5
TGTGCCAGCAGTGAGACATTTACACGGGGGAGGTCGCATCAGCCCCAGCATTTT	CASSETFTRGRSHQPQHF	TRBV6-4	TRBJ1-5
TGCAGTGCAGGAGGGGCCTACGAGCAGTACTTC	CSAGGAYEQYF	TRBV20-1	TRBJ2-7
TGTGCCAGCAATAAGCGATCGGGAAACTACGAGCAGTACTTC	CASNKRSGNYEQYF	TRBV28	TRBJ2-7
TGTGCCAGCCTTTTGTACGAGCAGTACTTC	CASLLYEQYF	TRBV9	TRBJ2-7
TGTGCCAGCAGCAGGATACTGAGCCGTGAGTTCAATCAGCCCCAGCATTTT	CASSRILSREFNQPQHF	TRBV7-4	TRBJ1-5
TGTGCCAGCAGCTTAGCGAAGGAGCGGGAGTTAGATGAAAAACTGTTTTTT	CASSLAKERELDEKLFF	TRBV11-2	TRBJ1-4
TGTGCCAGCAGCCCAAGGGGGGGGGCCACAGATACGCAGTATTTT	CASSPRGGATDTQYF	TRBV9	TRBJ2-3
TGTGCCAGCAGTTTACTCGGCGGGCAGCAAACAGAGACCCAGTACTTC	CASSLLGGQQTETQYF	TRBV28	TRBJ2-5
TGTGCCAGCAGCTTGAACAGGGGGCGAAAGCACTTGAACACTGAAGCTTTCTTT	CASSLNRGRKHLNTEAFF	TRBV5-6	TRBJ1-1
TGTGCCAGCAGTAAGCCCAGGTCGGGCAAGAACGAGCAGTACTTC	CASSKPRSGKNEQYF	TRBV6-4	TRBJ2-7
TGTGCCAGCAGTCAACCAGAGATCGGCTCTGGAAACACCATATATTTT	CASSQPEIGSGNTIYF	TRBV7-9	TRBJ1-3
TGTGCCAGCAGCTTATATGGACAGGGGGCGCAGTTCAATCAGCCCCAGCATTTT	CASSLYGQGAQFNQPQHF	TRBV7-3	TRBJ1-5
TGTGCCAGCAGCGGCCTGGGACAGACGGGTAGGTTTGAAAAACTGTTTTTT	CASSGLGQTGRFEKLFF	TRBV7-9	TRBJ1-4
TGTGCCAGCAGCGAATCTACCCGGGGTGGACGTAGGTCCCAGCATTTT	CASSESTRGGRRSQHF	TRBV5-6	TRBJ1-5
TGTGCCAGCAGCAGTAACGCAACACTGTACGAGCAGTACTTC	CASSSNATLYEQYF	TRBV5-4	TRBJ2-7
TGTGCCAGCAGCCCCCCGGGAGAGAAAGGTATAAACTATGGCTACACCTTC	CASSPPGEKGINYGYTF	TRBV6-5	TRBJ1-2
TGTGCCCCTTCCGGGGGGAGGGTCACTGAAGCTTTCTTT	CAPSGGRVTEAFF	TRBV19	TRBJ1-1
TGCAGCGTGTTTGGACAGGGGGAGGAGAATCAGCCCCAGCATTTT	CSVFGQGEENQPQHF	TRBV29-1	TRBJ1-5
TGCGCCAGCAGCTCCTACACTGAAGCTTTCTTT	CASSSYTEAFF	TRBV5-1	TRBJ1-1
TGTGCCAGCAGCGTAGTTAACTATGGACGCGGGAATTCACCCCTCCACTTT	CASSVVNYGRGNSPLHF	TRBV9	TRBJ1-6
TGTGCCTGGATTGTGGGGCCAGTAAATGAGCAGTTCTTC	CAWIVGPVNEQFF	TRBV30	TRBJ2-1
TGTGCCAGCAGCCACGGCGACAGGGTCCTGCGCAATCAGCCCCAGCATTTT	CASSHGDRVLRNQPQHF	TRBV7-3	TRBJ1-5
TGTGCCAGCAGCTTGGCGAACAGGGACACTGAAGCTTTCTTT	CASSLANRDTEAFF	TRBV11-2	TRBJ1-1
TGCGCCAGCAGCTTGCATTTAGGGACAGTAAACTCCTACGAGCAGTACTTC	CASSLHLGTVNSYEQYF	TRBV5-1	TRBJ2-7
TGCGCCAGCAGCTCGGCCGGGGGCAGGACTAGGGGCTACGAGCAGTACTTC	CASSSAGGRTRGYEQYF	TRBV5-1	TRBJ2-7
TGTGCCAGCAGGCAGACTACAGGGTACGAGCAGTACTTC	CASRQTTGYEQYF	TRBV25-1	TRBJ2-7
TGTGCCAGCAGGCTGGCCCTACATCTGAAGAAAGCTTTCTTT	CASRLALHLKKAFF	TRBV6-3	TRBJ1-1
TGTGCCACCAGTGATCGGAGGGCCGACCATTCACCCCTCCACTTT	CATSDRRADHSPLHF	TRBV24-1	TRBJ1-6
TGCGCCAGCAGAGCCCCCTTAGCGGGTCGACGCTCCTACGAGCAGTACTTC	CASRAPLAGRRSYEQYF	TRBV5-1	TRBJ2-7
TGTGCCTGGTCCTATGACAGCCCGGCCTACGAGCAGTACTTC	CAWSYDSPAYEQYF	TRBV30	TRBJ2-7
TGTGCCAGCAGTTGGACAGCCCTCCCGGTGAACACTGAAGCTTTCTTT	CASSWTALPVNTEAFF	TRBV6-6	TRBJ1-1
TGTGCCAGCAACAGGACCTACGAGCAGTACTTC	CASNRTYEQYF	TRBV14	TRBJ2-7
TGTGCCAGCAGTGACCCAGGGGAGCAGTTCTTC	CASSDPGEQFF	TRBV2	TRBJ2-1
TGTGCCAGCAGCTGTCGGGAGGGCCCTGGTAACAATGAGCAGTTCTTC	CASSCREGPGNNEQFF	TRBV5-4	TRBJ2-1
TGCGCCAGCAGCCACATCAGGCAGCCCCAGCATTTT	CASSHIRQPQHF	TRBV4-1	TRBJ1-5
TGTGCCAGCAGCTTAAACGCCCGCCACAATGAGCAGTTCTTC	CASSLNARHNEQFF	TRBV7-8	TRBJ2-1
TGTGCCAGCAGCTTACCCCCCGGGACTAGGTTCTACGGGGAGCTGTTTTTT	CASSLPPGTRFYGELFF	TRBV7-3	TRBJ2-2
TGTGCCAGTAGTATTCCAGGGCCTGACACTGAAGCTTTCTTT	CASSIPGPDTEAFF	TRBV19	TRBJ1-1
TGTGCCAGCAGCACGAACACTGAAGCTTTCTTT	CASSTNTEAFF	TRBV7-3	TRBJ1-1
TGTGCCAGCAGCAACGAGGCCCGGAACTACGAGCAGTACTTC	CASSNEARNYEQYF	TRBV5-6	TRBJ2-7
TGTGCCAGCAGCTTAGGTGTGGAAGGCACAGATACGCAGTATTTT	CASSLGVEGTDTQYF	TRBV11-2	TRBJ2-3
TGTGCCAGCAGGAAGAAGGGCTACACCTTC	CASRKKGYTF	TRBV3-1	TRBJ1-2
TGTGCCAGCAGCCAAGGAGGACAGGGAACCCTTGCTGAAGCTTTCTTT	CASSQGGQGTLAEAFF	TRBV3-1	TRBJ1-1
TGTGCCAGCAGCTTCCCGCCCCTAATAACAGGGGAGTATCAGCCCCAGCATTTT	CASSFPPLITGEYQPQHF	TRBV11-2	TRBJ1-5
TGTGCCAGCAGCGATAGGGGGGAGGGCTTAAAGAACGATGAAAAACTGTTTTTT	CASSDRGEGLKNDEKLFF	TRBV9	TRBJ1-4
TGTGCCAGCCCTGGCAATGGGGGTGAACCCAATCAGCCCCAGCATTTT	CASPGNGGEPNQPQHF	TRBV6-3	TRBJ1-5
TGCGCCAGCAGCCAAGATCCGACCTATACCCCGGGAATTGGTCAGCCCCAGCATTTT	CASSQDPTYTPGIGQPQHF	TRBV4-3	TRBJ1-5
TGCGCCAGCAGCCACCCGACGGCTAGCGGGGGGGAGCAGTACTTC	CASSHPTASGGEQYF	TRBV4-3	TRBJ2-7
TGCAGTGCTCACCAAGGACGTATCCAAAATAGCAATCAGCCCCAGCATTTT	CSAHQGRIQNSNQPQHF	TRBV20-1	TRBJ1-5
TGCGCCAGAAAACCCCAGGCCTACGAGCAGTACTTC	CARKPQAYEQYF	TRBV5-1	TRBJ2-7
TGTGCCAGCAGCCTCTACCACCTCCCGGACAGGGGAATGGTTAATCAGCCCCAGCATTTT	CASSLYHLPDRGMVNQPQHF	TRBV13	TRBJ1-5
TGTGCCAGCAGCAGCTCGGGGGCAGGGGGCGGCTATGGCTACACCTTC	CASSSSGAGGGYGYTF	TRBV25-1	TRBJ1-2
TGTGCCAGCAGCTCAGGAGGGTCCTACGAGCAGTACTTC	CASSSGGSYEQYF	TRBV7-4	TRBJ2-7
TGTGCCACCAGTGAAATAATCCGGGACAGGGAAGCCTACGAGCAGTACTTC	CATSEIIRDREAYEQYF	TRBV24-1	TRBJ2-7
TGCAGTGCTAGCTATCCTGGCACCTTC	CSASYPGTF	TRBV20-1	TRBJ1-2
TGTGCCAGCTCACTAGACGCAGGGTCCCACACTGAAGCTTTCTTT	CASSLDAGSHTEAFF	TRBV18	TRBJ1-1
TGTGCCAGCAGTGAAGCGCGGCAGGACTACGAGCAGTACTTC	CASSEARQDYEQYF	TRBV6-1	TRBJ2-7
TGTGCCAGCACCGACCCGGGACAGTGGACTCACAGCAATCAGCCCCAGCATTTT	CASTDPGQWTHSNQPQHF	TRBV27	TRBJ1-5
TGTGCCAGCAGCGTAGTTAAGGGACAGGATCAGCCCCAGCATTTT	CASSVVKGQDQPQHF	TRBV9	TRBJ1-5
TGTGCCAGCAGCTTAGTGCCGACAGGGGCTAGCAATCAGCCCCAGCATTTT	CASSLVPTGASNQPQHF	TRBV7-2	TRBJ1-5
TGTGCCAGCAGCCGGGGGCCCCGGGACCGCTACAATGAGCAGTTCTTC	CASSRGPRDRYNEQFF	TRBV3-1	TRBJ2-1
TGTGCCAGCAGTAAGCGGGGGAGGAAAAGATACGAGCAGTACTTC	CASSKRGRKRYEQYF	TRBV2	TRBJ2-7
TGTGCCAGCACCCATCCGAGGACTAGGGGGAGAGATACGCAGTATTTT	CASTHPRTRGRDTQYF	TRBV6-5	TRBJ2-3
TGTGCCAGCAGCCCCCGGGACAGTGAAAACATTCAGTACTTC	CASSPRDSENIQYF	TRBV13	TRBJ2-4
TGTGCCAGCAGCTTAGAAAAGGGGGGAGGAACCCAAGAGACCCAGTACTTC	CASSLEKGGGTQETQYF	TRBV7-6	TRBJ2-5
TGTGCCAGCAGTTTAAACCGCTCAACAACCCAGGACAGGGTCTGTTCCAGCAATCAGCCCCAGCATTTT	CASSLNRSTTQDRVCSSNQPQHF	TRBV28	TRBJ1-5
TGTGCCAGCAGTGGGGGGACAGCCGGCGAGCAGTACTTC	CASSGGTAGEQYF	TRBV6-4	TRBJ2-7
TGTGCCAGCAGCTTAAGCCCTAGCGGGCTAGCCAAAAACATTCAGTACTTC	CASSLSPSGLAKNIQYF	TRBV7-3	TRBJ2-4
TGTGCCAGCCCGTTGACAGGGGGCTACGGGGAGCTGTTTTTT	CASPLTGGYGELFF	TRBV7-3	TRBJ2-2
TGTGCCAGCAGCCTTCTAGGGGGGTTCTATGGCTACACCTTC	CASSLLGGFYGYTF	TRBV14	TRBJ1-2
TGCGCCAGCAGCCAAGCAGGGAAAGAGACCCAGTACTTC	CASSQAGKETQYF	TRBV4-3	TRBJ2-5
TGTGCCACTCCAACTAATGAAAAACTGTTTTTT	CATPTNEKLFF	TRBV12-4	TRBJ1-4
TGTGCCAGCAGTGTGACTAGCGGATCCTACGAGCAGTACTTC	CASSVTSGSYEQYF	TRBV27	TRBJ2-7
TGTGCCAGCAGCGATCGGGGGAGGGTTACTAATTCACCCCTCCACTTT	CASSDRGRVTNSPLHF	TRBV13	TRBJ1-6
TGTGCCAGCAGGCCCCACGCTAGAGACTTGGGGGACACCGGGGAGCTGTTTTTT	CASRPHARDLGDTGELFF	TRBV2	TRBJ2-2
TGTGCCAGCAGCCCGACTAGGCCGGCCGGGGAGCTGTTTTTT	CASSPTRPAGELFF	TRBV13	TRBJ2-2
TGCGCAACTTCAGGCCAAATAACTAATGAAAAACTGTTTTTT	CATSGQITNEKLFF	TRBV10-1	TRBJ1-4
TGCAGCGTTTGTCTTGCAAAAAGCGCGCACTACGAGCAGTACTTC	CSVCLAKSAHYEQYF	TRBV29-1	TRBJ2-7
TGTGCCAGCAGTAACAAGGCCTACGAGCAGTACTTC	CASSNKAYEQYF	TRBV28	TRBJ2-7
TGTGCCAGATCCCATGGGGACATGAACACTGAAGCTTTCTTT	CARSHGDMNTEAFF	TRBV19	TRBJ1-1
TGTGCCAGTCTAACCGGCATACATGAGCAGTTCTTC	CASLTGIHEQFF	TRBV19	TRBJ2-1
TGTGCCAGTAGGCGCGCATGCATGAACACTGAAGCTTTCTTT	CASRRACMNTEAFF	TRBV19	TRBJ1-1
TGCAGTGCTAGCCCCGCGGACGGCTCCTACAATGAGCAGTTCTTC	CSASPADGSYNEQFF	TRBV20-1	TRBJ2-1
TGTGCCAGCAGTTTACTCGGGACAGTTGTTGAAAAACTGTTTTTT	CASSLLGTVVEKLFF	TRBV12-4	TRBJ1-4
TGCAGTGCTGTCGGGGGACAGGGCTACACCTTC	CSAVGGQGYTF	TRBV20-1	TRBJ1-2
TGTGCCAGCAGCGGGAGGGGGAGGGCGGAGACTGAAGCTTTCTTT	CASSGRGRAETEAFF	TRBV7-9	TRBJ1-1
TGCGCCAGCACATGGGGCTTCCATAATTCACCCCTCCACTTT	CASTWGFHNSPLHF	TRBV10-1	TRBJ1-6
TGTGCCAGCAGCCAAGGGTACAGGGGCGAGCAGTACTTC	CASSQGYRGEQYF	TRBV14	TRBJ2-7
TGTGCCAGCAGTGAAACAAAAAGGGCGGGGCCATCTGACTCCTACGAGCAGTACTTC	CASSETKRAGPSDSYEQYF	TRBV6-1	TRBJ2-7
TGCAGTACTAGACGGGGCTTCGAGCAGTACTTC	CSTRRGFEQYF	TRBV20-1	TRBJ2-7
TGTGCCAGCAGCTTAGATTCCGTGCGGACTTCCAACACCGGGGAGCTGTTTTTT	CASSLDSVRTSNTGELFF	TRBV11-2	TRBJ2-2
TGTGCCAGTAGTCCGATGGTCGGGGAGCTGTTTTTT	CASSPMVGELFF	TRBV19	TRBJ2-2
TGTGCCAGCAGCCAACCACCAGGTCAAGAGACCCAGTACTTC	CASSQPPGQETQYF	TRBV4-2	TRBJ2-5
TGTGCCAGCAGCACGGTACCTTTGGACAGGAAATCAGGGAGCGACTACGAGCAGTACTTC	CASSTVPLDRKSGSDYEQYF	TRBV7-6	TRBJ2-7
TGTGCCAGCAGCCTCACCGGGCGGGAGAGCAGCCTCTATGGCTACACCTTC	CASSLTGRESSLYGYTF	TRBV13	TRBJ1-2
TGTGCCTCCTCGACAAACAGAGCGTTTACGAACACTGAAGCTTTCTTT	CASSTNRAFTNTEAFF	TRBV6-5	TRBJ1-1
TGTGCCTGGAGTGTAGGGAGCGGGACAAGGGGAGAGCAGTACTTC	CAWSVGSGTRGEQYF	TRBV30	TRBJ2-7
TGTGCCAGCAGCCCGACTAGGCGGACCTACAATGAGCAGTTCTTC	CASSPTRRTYNEQFF	TRBV14	TRBJ2-1
TGTGCCAGCAGCTTCTGGAGGGGAAAAAACATTCAGTACTTC	CASSFWRGKNIQYF	TRBV7-2	TRBJ2-4
TGCAGTGTTGTAAGAAGGGGAGATACGCAGTATTTT	CSVVRRGDTQYF	TRBV20-1	TRBJ2-3
TGTGCCAGTAGGGGAATGATAGGGGAGGGCCACTATGGCTACACCTTC	CASRGMIGEGHYGYTF	TRBV19	TRBJ1-2
TGTGCCAGCAGTTTTTACCCATCCCCTGAAGCTTTCTTT	CASSFYPSPEAFF	TRBV6-5	TRBJ1-1
TGTGCCAAAAGGCGGCCCTATGGCTACACCTTC	CAKRRPYGYTF	TRBV10-3	TRBJ1-2
TGTGCCAGTAGTATAGAACCCCGGGACAGCATTGAGACCCAGTACTTC	CASSIEPRDSIETQYF	TRBV19	TRBJ2-5
TGTGCCAGCAGCCAAGGCCTGGGGCCGGAACCTAGGAACACTGAAGCTTTCTTT	CASSQGLGPEPRNTEAFF	TRBV4-2	TRBJ1-1
TGCAGCGTTGAAGGGTTGGGGGGGTACTACGAGCAGTACTTC	CSVEGLGGYYEQYF	TRBV29-1	TRBJ2-7
TGCAGTGCTGGGGGACCTAGACCCTGCGCGGACGAGCAGTACTTC	CSAGGPRPCADEQYF	TRBV20-1	TRBJ2-7
TGTGCCAGCAGCGTAGAAATAGTCTCAACTAATGAAAAACTGTTTTTT	CASSVEIVSTNEKLFF	TRBV9	TRBJ1-4
TGTGCCAGCTCACCGGATCCAGGGCCCTCTCACGTTCTGACCACAGATACGCAGTATTTT	CASSPDPGPSHVLTTDTQYF	TRBV18	TRBJ2-3
TGTGCCAGTAGTATCGTTGGGGGGACGGGTTACGAGCAGTACTTC	CASSIVGGTGYEQYF	TRBV19	TRBJ2-7
TGTGCTAGTTTCACTCCATCGGGGGGGGGCAATGAGCAGTTCTTC	CASFTPSGGGNEQFF	TRBV12-5	TRBJ2-1
TGTGCCAGCAGCACTGGGGAACGGATGAACACTGAAGCTTTCTTT	CASSTGERMNTEAFF	TRBV5-5	TRBJ1-1
TGTGCCAGCAGCGACTACTATGGCTACACCTTC	CASSDYYGYTF	TRBV9	TRBJ1-2
TGTGCCAGCAGGGTGGCGGGACAGGGGGGGCCAAGCGCATTACAGCCCCAGCATTTT	CASRVAGQGGPSALQPQHF	TRBV9	TRBJ1-5
TGCGCCAGCAGCTCCCGGCCCTCGAACGGTCCGGAGCAGTTCTTC	CASSSRPSNGPEQFF	TRBV5-1	TRBJ2-1
TGTGCCAGCAGTTATTTGACAGGGGGCAATCAGCCCCAGCATTTT	CASSYLTGGNQPQHF	TRBV6-2	TRBJ1-5
TGTGCCAGCATCCCGGGGGCCGAGACCCAGTACTTC	CASIPGAETQYF	TRBV6-4	TRBJ2-5
TGTGCCAGCAGCTTATGCAACCCCACAGGGGGCAAGGTCTGGGTACCCGAGACCCAGTACTTC	CASSLCNPTGGKVWVPETQYF	TRBV5-8	TRBJ2-5
TGTGCCAGCAGCCGTCCCGTGGGGGGGCCGATTGCTGGGGCCAACGTCCTGACTTTC	CASSRPVGGPIAGANVLTF	TRBV7-3	TRBJ2-6
TGTGGTAGTGACTGCCCCTCCTACGAGCAGTACTTC	CGSDCPSYEQYF	TRBV7-3	TRBJ2-7
TGTGCCACCTACAGCGGGAGGAAGCACACCTTC	CATYSGRKHTF	TRBV24-1	TRBJ1-2
TGTGCCAGCAGCTCCACCCGACGGATAGGTTGGCCCCAGCATTTT	CASSSTRRIGWPQHF	TRBV3-1	TRBJ1-5
TGTGCCCCCGATCGACAGGCGAATAGGGAGACCCAGTACTTC	CAPDRQANRETQYF	TRBV30	TRBJ2-5
TGTGCTAGTGGTCCCCACCTTTTGGAGTACAATGAGCAGTTCTTC	CASGPHLLEYNEQFF	TRBV12-5	TRBJ2-1
TGTGCCAGCAGTTACCGCGGCAGCAGGGGGCGAGAAACCCTCCACTTT	CASSYRGSRGRETLHF	TRBV6-9	TRBJ1-6
TGTGCCAGCAGCCGGGGTGCGGGGATAGCCTCTGAAGCTTTCTTT	CASSRGAGIASEAFF	TRBV7-2	TRBJ1-1
TGTGCGAAGGGACAGTCGACTCACGAGCAGTACTTC	CAKGQSTHEQYF	TRBV11-3	TRBJ2-7
TGTGCCAGCAGCGGGTACAGGGGGCATTTGTCCTATAATTCACCCCTCCACTTT	CASSGYRGHLSYNSPLHF	TRBV5-6	TRBJ1-6
TGTGCCAGCAGCTTAGAAACCCCAGGGTTCCCCGGAACTTATGGCTACACCTTC	CASSLETPGFPGTYGYTF	TRBV7-9	TRBJ1-2
TGTGCCAGCAGCCAGGCTACAGGGGAGAGTCAAGCTAACTATGGCTACACCTTC	CASSQATGESQANYGYTF	TRBV5-6	TRBJ1-2
TGTGCCAGCAGTTTACGGACTAGGGGCGGGGAGCTGTTTTTT	CASSLRTRGGELFF	TRBV27	TRBJ2-2
TGCAGCGTCCCCCCTCCCGGGACTAGTTACAATGAGCAGTTCTTC	CSVPPPGTSYNEQFF	TRBV29-1	TRBJ2-1
TGTGCCAGCAGCACCCCGCGGACAGGCTACGAGCAGTACTTC	CASSTPRTGYEQYF	TRBV5-4	TRBJ2-7
TGTGCCACCAGTGATTTGCAGTACAGTGTCACTGAAGCTTTCTTT	CATSDLQYSVTEAFF	TRBV24-1	TRBJ1-1
TGTGCCAGCAGCTTGCCGTCGACAGTATATAATTCACCCCTCCACTTT	CASSLPSTVYNSPLHF	TRBV5-8	TRBJ1-6
TGTGCCTGGGACTCCTACGAGCAGTACTTC	CAWDSYEQYF	TRBV6-5	TRBJ2-7
TGTGCCAGCAGCGTCCCCGGGACAGAAGGGTATGGCTACACCTTC	CASSVPGTEGYGYTF	TRBV9	TRBJ1-2
TGTGCCAGCAGGCGACGGGGAGATACGCAGTATTTT	CASRRRGDTQYF	TRBV6-6	TRBJ2-3
TGTGCCAGCGCAGGGGCTCAACGGGCCAATCAGCCCCAGCATTTT	CASAGAQRANQPQHF	TRBV14	TRBJ1-5
TGTGCCAGCAGCTTCAGCCCGGGAGAGAAGCAGGCCGAGCAGTACTTC	CASSFSPGEKQAEQYF	TRBV14	TRBJ2-7
TGCAGTGCTAGATCAGGGACAGGGGGCCCGGGCAACACCATATATTTT	CSARSGTGGPGNTIYF	TRBV20-1	TRBJ1-3
TGTGCCAGTATCCGGGGCCCTTACGAGCAGTACTTC	CASIRGPYEQYF	TRBV19	TRBJ2-7
TGTGCCAGCAGCTTAGTATTTGGAGAGCAGTACTTC	CASSLVFGEQYF	TRBV7-9	TRBJ2-7
TGCAGTGCTATGCGCTCCGAGGGGGGAGGGCGAGTAATTAGCACAGATACGCAGTATTTT	CSAMRSEGGGRVISTDTQYF	TRBV20-1	TRBJ2-3
TGTGCCAGCAGCGGAACCGGGAGGGTCGACACCTACAATGAGCAGTTCTTC	CASSGTGRVDTYNEQFF	TRBV5-6	TRBJ2-1
TGTGCCAGCTCCCGCTTCACCACCTACAATGAGCAGTTCTTC	CASSRFTTYNEQFF	TRBV2	TRBJ2-1
TGTGCCAGCAGCATAGGAGGCGGGGGACCGAACACTGAAGCTTTCTTT	CASSIGGGGPNTEAFF	TRBV7-3	TRBJ1-1
TGCGCCAGCAGAGGGCCGACTAGCGGCAGGCAAGAGACCCAGTACTTC	CASRGPTSGRQETQYF	TRBV10-1	TRBJ2-5
TGTGCCAGCAGTTATGGCGACAATGAGCAGTTCTTC	CASSYGDNEQFF	TRBV12-3	TRBJ2-1
TGTGCCAGCAGCCAAGACAGTGGCGAGGCCCCCTACGAGCAGTACTTC	CASSQDSGEAPYEQYF	TRBV14	TRBJ2-7
TGTGCCAGCAGCTTAGCAGGGGAGGTAAGTCTTGGCTACACCTTC	CASSLAGEVSLGYTF	TRBV7-2	TRBJ1-2
TGCGCCAGCAGCTTGGATCAGCGAGCCCATCAGCCCCAGCATTTT	CASSLDQRAHQPQHF	TRBV5-1	TRBJ1-5
TGTGCCAGCAGCTTACACTGTGATCCGGGACTAGCGGGGGGGACCGTCAACAATGAGCAGTTCTTC	CASSLHCDPGLAGGTVNNEQFF	TRBV13	TRBJ2-1
TGTGCCACCAGTGGGGACCGGGGGCCGTATGGCTACACCTTC	CATSGDRGPYGYTF	TRBV24-1	TRBJ1-2
TGTGCCAGCAGTTGCCGCTTACAGGGTAACGAGCAGTACTTC	CASSCRLQGNEQYF	TRBV6-6	TRBJ2-7
TGTGCCAGTAGTTCGAGACAGGGGGGGGGCAATCAGCCCCAGCATTTT	CASSSRQGGGNQPQHF	TRBV19	TRBJ1-5
TGTGCCAGCAGTTACCGCAGAGGTTTCTACGAGCAGTACTTC	CASSYRRGFYEQYF	TRBV6-2	TRBJ2-7
TGTGCCGAAGAAGGGGCCTACGAGCAGTACTTC	CAEEGAYEQYF	TRBV30	TRBJ2-7
TGCAGCGTTGTAATATCCAGGAGGGGCTCACCCCTCCACTTT	CSVVISRRGSPLHF	TRBV29-1	TRBJ1-6
TGTGCCAGCAGCGGGGGCCTTTTCTATGGCTACACCTTC	CASSGGLFYGYTF	TRBV7-3	TRBJ1-2
TGTGAGAATAGACACGAGCAGTACTTC	CENRHEQYF	TRBV24-1	TRBJ2-7
TGTGCTAGTGGTTTGGTAACAGAAGTTAGTTATAATTCACCCCTCCACTTT	CASGLVTEVSYNSPLHF	TRBV12-5	TRBJ1-6
TGTGCCAGCGTCCCAGAGGGACAGGGAAATGAGCAGTTCTTC	CASVPEGQGNEQFF	TRBV6-4	TRBJ2-1
TGTGCCAGTAAGATTTTACAGCCCAATTGGGGCCGTTACGAGCAGTACTTC	CASKILQPNWGRYEQYF	TRBV19	TRBJ2-7
TGCGCCAGCAGCCTTCCGGACAATCCCTACGAGCAGTACTTC	CASSLPDNPYEQYF	TRBV10-1	TRBJ2-7
TGTGCCAGCAGGGATTGGGACAGTGAGCGCTATGGCTACACCTTC	CASRDWDSERYGYTF	TRBV2	TRBJ1-2
TGTGCCAGTAAGGGGCTTTACTCTTACGAGCAGTACTTC	CASKGLYSYEQYF	TRBV28	TRBJ2-7
TGTGCCAGCAGGACTAGCGGGCAGGCAGATACGCAGTATTTT	CASRTSGQADTQYF	TRBV12-3	TRBJ2-3
TGTGCCAGCAGTGAACGGGGAGTCACTGAAGCTTTCTTT	CASSERGVTEAFF	TRBV28	TRBJ1-1
TGTGCCAGCAGTTCGTCCAGGGGGCGGGACGTCTCCTACGAGCAGTACTTC	CASSSSRGRDVSYEQYF	TRBV6-2	TRBJ2-7
TGTGCCAGCAGCATGCGACTAGCGGGCTCCTACAATGAGCAGTTCTTC	CASSMRLAGSYNEQFF	TRBV27	TRBJ2-1
TGTGCCAGCAGCCAAGCCCGTCGCAGGGGGCGGGTCTCAGCCTACGAGCAGTACTTC	CASSQARRRGRVSAYEQYF	TRBV14	TRBJ2-7
TGTGCCAGCAGTTTCAAATATAGGAATTCACCCCTCCACTTT	CASSFKYRNSPLHF	TRBV28	TRBJ1-6
TGTGCCAGCAGCGCACGGGACCCCTACGAGCAGTACTTC	CASSARDPYEQYF	TRBV13	TRBJ2-7
TGTGCCAGTACCGGGGGTGAGACCCAGTACTTC	CASTGGETQYF	TRBV3-1	TRBJ2-5
TGCGCCAGCATGGGGCTGGGGTACGAGCAGTACTTC	CASMGLGYEQYF	TRBV10-1	TRBJ2-7
TGCGCCAGCAGCCAAGATAACGGCGACTACGAGCAGTACTTC	CASSQDNGDYEQYF	TRBV4-3	TRBJ2-7
TGTGCCACCAGCAGGCGTTCACTAGCTGGATACGAGCAGTACTTC	CATSRRSLAGYEQYF	TRBV15	TRBJ2-7
TGTGCCAGCAGGGGGACAGGGTACAATGAGCAGTTCTTC	CASRGTGYNEQFF	TRBV6-5	TRBJ2-1
TGTGCCGCAGGGGGTCCCTCGGCGGGGAAACTGTTTTTT	CAAGGPSAGKLFF	TRBV6-1	TRBJ1-4
TGTGCCAGCAGCCGGACGGTCTACGAGCAGTACTTC	CASSRTVYEQYF	TRBV7-3	TRBJ2-7
TGTGCCAGCAGTTACTCGAGGCAGGGGGATCAGCCCCAGCATTTT	CASSYSRQGDQPQHF	TRBV6-2	TRBJ1-5
TGTGCCACCAGACTGGGGGGGGAAGGCACAGATACGCAGTATTTT	CATRLGGEGTDTQYF	TRBV24-1	TRBJ2-3
TGTGCCATCAGTGAGTTCCTGGGGGGGCTCTACAATGAGCAGTTCTTC	CAISEFLGGLYNEQFF	TRBV10-3	TRBJ2-1
TGTGCCACCAGTGATGCCGGGACAGGGGCCTACAATGAGCAGTTCTTC	CATSDAGTGAYNEQFF	TRBV24-1	TRBJ2-1
TGTGCCAGCAGTGTGAGAAACTGGGGGTACGAGCAGTACTTC	CASSVRNWGYEQYF	TRBV25-1	TRBJ2-7
TGTGCCAGCTTGACAGGAAGGGCACAGGAGCTGTTTTTT	CASLTGRAQELFF	TRBV6-4	TRBJ2-2
TGTGCCAGCAGCCGTCGGGAACTCGAGACCCAGTACTTC	CASSRRELETQYF	TRBV7-3	TRBJ2-5
TGTGCCATCAGTCCGTACTCGTACCCGGGGGCTCTTGGCTACACCTTC	CAISPYSYPGALGYTF	TRBV10-3	TRBJ1-2
TGTGCCAGCAGCGACGGGCCAGACAGGGCTTTCGAGCAGTACTTC	CASSDGPDRAFEQYF	TRBV7-9	TRBJ2-7
TGTGCCAGCAGTGAACAGAAGAATGCCGGGACAGGCCCGGGGGTCTCTGGAAACACCATATATTTT	CASSEQKNAGTGPGVSGNTIYF	TRBV6-1	TRBJ1-3
TGTGCCAGCAGCTTGACTGGATACAATGAGCAGTTCTTC	CASSLTGYNEQFF	TRBV14	TRBJ2-1
TGTGCCAGCAGTGACCCCTATCAGCATCAGCCCCAGCATTTT	CASSDPYQHQPQHF	TRBV6-4	TRBJ1-5
TGCAGTGCTAGAGATCCGTCCGTGGACAGTAGTGCAGATACGCAGTATTTT	CSARDPSVDSSADTQYF	TRBV20-1	TRBJ2-3
TGTGCCAGCAGCCTCAGACCTAGCAGCACAGATACGCAGTATTTT	CASSLRPSSTDTQYF	TRBV6-2	TRBJ2-3
TGTGCCAGCAGTTACTCGATGGGGGGCGATAGGAGCACAGATACGCAGTATTTT	CASSYSMGGDRSTDTQYF	TRBV6-5	TRBJ2-3
TGTGCCAGCAGTTTCCAGAGGGTGGGATACGAGCAGTACTTC	CASSFQRVGYEQYF	TRBV27	TRBJ2-7
TGTGCCAGCAGCTCGTGGGGGCGCTACGAGCAGTACTTC	CASSSWGRYEQYF	TRBV11-2	TRBJ2-7
TGTGCCAGCAGTGACCCGCTAGCGGACCATACGCAGTATTTT	CASSDPLADHTQYF	TRBV6-4	TRBJ2-3
TGTGCCAGTAGTGGCGCAGGGTTCTCGGGAGAGGGGAGCTCTGGGGCCAACGTCCTGACTTTC	CASSGAGFSGEGSSGANVLTF	TRBV19	TRBJ2-6
TGTGCCAGCAGCCGGGACCCCTACGAGCAGTACTTC	CASSRDPYEQYF	TRBV12-3	TRBJ2-7
TGTGCCTGGAGTTCCTGGGGGCCAAATGAGCAGTTCTTC	CAWSSWGPNEQFF	TRBV30	TRBJ2-1
TGCAGTGGGAGGGATGAGCAGTTCTTC	CSGRDEQFF	TRBV20-1	TRBJ2-1
TGTGCCAGCAGTGAGAGACCAAAGGGGGGGGAGCGCCTGTTCACAGATACGCAGTATTTT	CASSERPKGGERLFTDTQYF	TRBV6-1	TRBJ2-3
TGTGCCAGTAGTATCCCCGGGACAGTCACCGGGGAGCTGTTTTTT	CASSIPGTVTGELFF	TRBV19	TRBJ2-2
TGTGCCACGGCTAGCGGGTCCCAGTACTTC	CATASGSQYF	TRBV24-1	TRBJ2-5
TGCGCCAGCAGCCAAGAACCCCTTGAGGACGAGCAGTACTTC	CASSQEPLEDEQYF	TRBV4-3	TRBJ2-7
TGCGCCAGCAGCCAGAGTAGCCAGATATACAATGAGCAGTTCTTC	CASSQSSQIYNEQFF	TRBV4-1	TRBJ2-1
TGTGCCAGCATCTTCCCTAGACAGGGGACGCAGTACTTC	CASIFPRQGTQYF	TRBV25-1	TRBJ2-7
TGTGCCTGGAGACGCAGCCTCGGCTACACCTTC	CAWRRSLGYTF	TRBV30	TRBJ1-2
TGTGCCAGCAGCAAGGACAGGTGGAACACTGAAGCTTTCTTT	CASSKDRWNTEAFF	TRBV11-3	TRBJ1-1
TGTGCCAGCAGGCTTTCCCAAGAGACCCAGTACTTC	CASRLSQETQYF	TRBV5-4	TRBJ2-5
TGTGCCAGCAGTATGAAGGGGGGGGGCTACGAGCAGTACTTC	CASSMKGGGYEQYF	TRBV27	TRBJ2-7
TGTGCCAGCAGGTGGGGAGGGCCCGACTCCTACGAGCAGTACTTC	CASRWGGPDSYEQYF	TRBV12-3	TRBJ2-7
TGCAGTGCTAGGCACATTGAGGGGCGTCCTGATACGCAGTATTTT	CSARHIEGRPDTQYF	TRBV20-1	TRBJ2-3
TGTGCCAGCAGCGAGGAGGGCTCCTACGAGCAGTACTTC	CASSEEGSYEQYF	TRBV9	TRBJ2-7
TGCGCCAGCAGTACGATTATGCGAGTGAATAATTCACCCCTCCACTTT	CASSTIMRVNNSPLHF	TRBV10-1	TRBJ1-6
TGTGCTAGAACGGGACTAGCCACCGGGGAGCTGTTTTTT	CARTGLATGELFF	TRBV12-5	TRBJ2-2
TGTGCCAGCAGTGACTCGGTACGGAAGGGGGGGGACACTGAAGCTTTCTTT	CASSDSVRKGGDTEAFF	TRBV6-4	TRBJ1-1
TGTGCCAGCAGCTTTAGGGACAGGGATAGCAATCAGCCCCAGCATTTT	CASSFRDRDSNQPQHF	TRBV7-4	TRBJ1-5
TGTGCCAGCAGCTTGAAGGGACTAGCGGGACGAAGGATCGAGCAGTACTTC	CASSLKGLAGRRIEQYF	TRBV7-4	TRBJ2-7
TGTGCCAGCAGCTCGAGTTGGAACAGGGGGCTAAACTATGGCTACACCTTC	CASSSSWNRGLNYGYTF	TRBV7-8	TRBJ1-2
TGCAGTGCTATCGCGAGGACGATTTCTTTTGCCTACAATGAGCAGTTCTTC	CSAIARTISFAYNEQFF	TRBV20-1	TRBJ2-1
TGTGCCATCAGTGCGAGGGGACTAGCCAAAAACATTCAGTACTTC	CAISARGLAKNIQYF	TRBV10-3	TRBJ2-4
TGCGCCAGCAGCTTGAACAAAATGGGCCAAGGGAACACCGGGGAGCTGTTTTTT	CASSLNKMGQGNTGELFF	TRBV5-1	TRBJ2-2
TGTGCCAGCATCTGGGGGAGGGGTTCACCCCTCCACTTT	CASIWGRGSPLHF	TRBV28	TRBJ1-6
TGTGCCAGCAGCCAGGCGGTCTTGCTGCCCGCCTACGAGCAGTACTTC	CASSQAVLLPAYEQYF	TRBV5-6	TRBJ2-7
TGTGCCAGCAGCCGTCCCCGGGACAAAGGGAGGGGAAAAGCTTTCTTT	CASSRPRDKGRGKAFF	TRBV11-3	TRBJ1-1
TGTGCCAGCAGTTCCTCGGGACACTATGGCTACACCTTC	CASSSSGHYGYTF	TRBV28	TRBJ1-2
TGCGCCAGCAGCAAACGACAGGGCGATGCAACTAATGAAAAACTGTTTTTT	CASSKRQGDATNEKLFF	TRBV5-1	TRBJ1-4
TGTGCCAGCAGTTTGAAGGGCCGGGGTTTGGCCTACGAGCAGTACTTC	CASSLKGRGLAYEQYF	TRBV27	TRBJ2-7
TGCAGTGCTAGGGGTGGGACAGGGGGCGCTTACACCCGCAGGAATCAGCCCCAGCATTTT	CSARGGTGGAYTRRNQPQHF	TRBV20-1	TRBJ1-5
TGTGCCCCCCCGGCCTACGAGCAGTACTTC	CAPPAYEQYF	TRBV30	TRBJ2-7
TGTGCCAGCAGTTTTAACGGGACGTTGACTGAAAAACTGTTTTTT	CASSFNGTLTEKLFF	TRBV27	TRBJ1-4
TGTGCCAGCAGCCAAGATCAGACTAGCGGGAGGGTCTCCTACAATGAGCAGTTCTTC	CASSQDQTSGRVSYNEQFF	TRBV14	TRBJ2-1
TGTGCCAGCAGTGTGGGAGGGACCAGTCATGGCTACACCTTC	CASSVGGTSHGYTF	TRBV25-1	TRBJ1-2
TGCAGTGCTAGGGGGGGGCGCACAGATACGCAGTATTTT	CSARGGRTDTQYF	TRBV20-1	TRBJ2-3
TGTGCCAGACGGGGGAAGTCCTACGAGCAGTACTTC	CARRGKSYEQYF	TRBV13	TRBJ2-7
TGTGCCAGCAGCCAGAGTTCGAATGTGGGCGGCTACGCTGGCTACACCTTC	CASSQSSNVGGYAGYTF	TRBV3-1	TRBJ1-2
TGTGCCAGCAGCTCCAGGACCCGCAAGGATGAAGCTTTCTTT	CASSSRTRKDEAFF	TRBV7-3	TRBJ1-1
TGCGCCAGAATCTTAACAGGCAAGGGAGGGGGGGAACACTCTGGAAACACCATATATTTT	CARILTGKGGGEHSGNTIYF	TRBV5-1	TRBJ1-3
TGCAGTGCTTTGCAGGGTGGGGCCAACGTCCTGACTTTC	CSALQGGANVLTF	TRBV20-1	TRBJ2-6
TGCGCCATCCTGCGGGGACCGTTTTATCAGCCCCAGCATTTT	CAILRGPFYQPQHF	TRBV10-1	TRBJ1-5
TGTGCCAGCGGTTCGCGTATGGCCTACGAGCAGTACTTC	CASGSRMAYEQYF	TRBV28	TRBJ2-7
TGTGCCAGCAGTTACGACAGGGATGAAAAACTGTTTTTT	CASSYDRDEKLFF	TRBV6-8	TRBJ1-4
TGCGCCAGCAGCGGACGGCGACCGGTTCAGCCCCAGCATTTT	CASSGRRPVQPQHF	TRBV5-1	TRBJ1-5
TGTGCCAGCAGTTATCGGAGACAGGGACCTGCCGGCACAGATACGCAGTATTTT	CASSYRRQGPAGTDTQYF	TRBV6-5	TRBJ2-3
TGTGCCAGCAGCCGGACTAGCCAAAACGAGACCCAGTACTTC	CASSRTSQNETQYF	TRBV7-2	TRBJ2-5
TGTGCCAGCATCGAGGCTTCCGCCTACGAGCAGTACTTC	CASIEASAYEQYF	TRBV6-1	TRBJ2-7
TGTGCCAGTTCTCGCGGGACAGCTGGTCTTGGCTACACCTTC	CASSRGTAGLGYTF	TRBV19	TRBJ1-2
TGTGCCAGCAGCTCGGATAGGGTCTGCACCAACATTCAGTACTTC	CASSSDRVCTNIQYF	TRBV7-4	TRBJ2-4
TGTGCCAGCAGCCAAGATCCTGGGGGGGGCCCCAATGAGCAGTTCTTC	CASSQDPGGGPNEQFF	TRBV4-2	TRBJ2-1
TGTGCCACCAGTTACGAGGGGGCTCGCAATCAGCCCCAGCATTTT	CATSYEGARNQPQHF	TRBV15	TRBJ1-5
TGTGCCAGCAGTGGGAAGACAGGGTCTGAAGCTTTCTTT	CASSGKTGSEAFF	TRBV6-1	TRBJ1-1
TGTGCCAGCAGCTTCCCTGACAGGGGGCTCACGTCCTCCTATAATTCACCCCTCCACTTT	CASSFPDRGLTSSYNSPLHF	TRBV11-3	TRBJ1-6
TGTGCCTGGCCCTTCCCCGACAGGGACTCTGGAAACACCATATATTTT	CAWPFPDRDSGNTIYF	TRBV30	TRBJ1-3
TGTGCCAGCAGCTTAGGCGAGCCAAAGCGGGACAGATCGGGGAACACTGAAGCTTTCTTT	CASSLGEPKRDRSGNTEAFF	TRBV11-2	TRBJ1-1
TGTGCCAGCAGCCTTTGGGACAGGGGCTCCTATTCACCCCTCCACTTT	CASSLWDRGSYSPLHF	TRBV13	TRBJ1-6
TGTGCCAGCAGTTGCGGCGAAAGGGGGCGCCAGAGGCCCCTCCACTTT	CASSCGERGRQRPLHF	TRBV25-1	TRBJ1-6
TGTGCCAGCAGTTTTGGGGGAAAAGCCAAAAACATTCAGTACTTC	CASSFGGKAKNIQYF	TRBV27	TRBJ2-4
TGCAGCGTTGTAGAGGAGTTAGCGGGCGGGAATGAGCAGTTCTTC	CSVVEELAGGNEQFF	TRBV29-1	TRBJ2-1
TGTGCCAGCAGCTCTGTAGATACAGATTCCGAGCAGTACTTC	CASSSVDTDSEQYF	TRBV5-5	TRBJ2-7
TGTGCCAGCAGTCGGGACAGCGGACCAGTGGTTTATAGCAATCAGCCCCAGCATTTT	CASSRDSGPVVYSNQPQHF	TRBV12-4	TRBJ1-5
TGTGCCATCAGTGAGTCCCCTCGAGCGGGAGAGTACGAGCAGTACTTC	CAISESPRAGEYEQYF	TRBV10-3	TRBJ2-7
TGTGCCATCAGTGAAGACCCCGGGAGGCTGTTGGCTAACTATGGCTACACCTTC	CAISEDPGRLLANYGYTF	TRBV10-3	TRBJ1-2
TGTGCCAGCAGCCAAAACAGGAGTTTTCACAGATATGAGCAGTTCTTC	CASSQNRSFHRYEQFF	TRBV3-1	TRBJ2-1
TGTGCCAGCAGCCAAGGGGTCTCGAAGCGGGACGTAGTCACAGATACGCAGTATTTT	CASSQGVSKRDVVTDTQYF	TRBV3-1	TRBJ2-3
TGTGCCATCAGTGATTCCAGTGGGACAGGGAACTATGGCTACACCTTC	CAISDSSGTGNYGYTF	TRBV10-3	TRBJ1-2
TGTGCCAGCACTCAGCGGGAGAACACTGAAGCTTTCTTT	CASTQRENTEAFF	TRBV6-2	TRBJ1-1
TGTGCCACCAGTGATAGGCTAGGCAATGGGTCGGTAAACCAAGAGACCCAGTACTTC	CATSDRLGNGSVNQETQYF	TRBV24-1	TRBJ2-5
TGCGCCAGCAGCTTGGTTCGGAAGACAGGGGCTCCTCGCGAGCAGTACTTC	CASSLVRKTGAPREQYF	TRBV5-1	TRBJ2-7
TGTGCCACCTCGAACCATGGGATGAGGGTCTCAAACACTGAAGCTTTCTTT	CATSNHGMRVSNTEAFF	TRBV24-1	TRBJ1-1
TGTGCCAGCAGTTCCCGGAACAGGGGGGAGACCCAGTACTTC	CASSSRNRGETQYF	TRBV27	TRBJ2-5
TGTGCCAGCAGCCGAGGCCGGGGCTCCTGTGAAAAACTGTTTTTT	CASSRGRGSCEKLFF	TRBV11-3	TRBJ1-4
TGTGCCAGCAGGGGGCATTCCAGGGGGCGGCTCGCCAAAAACATTCAGTACTTC	CASRGHSRGRLAKNIQYF	TRBV7-9	TRBJ2-4
TGTGCCAGCAGTGATCCGCCCGGGGAACACACCGGGGAGCTGTTTTTT	CASSDPPGEHTGELFF	TRBV6-1	TRBJ2-2
TGCGCCAGCAGTAAGCGAGTAGACGGGGAGCTGTTTTTT	CASSKRVDGELFF	TRBV10-1	TRBJ2-2
TGTGCCATCCGGACGGTTCGACATGCCTACGAGCAGTACTTC	CAIRTVRHAYEQYF	TRBV24-1	TRBJ2-7
TGTGCCAGCCTGAAAAGGCGGGGGACTCGGTGCGAGACCCAGTACTTC	CASLKRRGTRCETQYF	TRBV27	TRBJ2-5
TGTGCCAGCAGCCCTAGGGGACAGGGTGGTCCCGGGGAGCTGTTTTTT	CASSPRGQGGPGELFF	TRBV6-5	TRBJ2-2
TGTATCCCCCCGCTTGGGCTGATGAACACTGAAGCTTTCTTT	CIPPLGLMNTEAFF	TRBV19	TRBJ1-1
TGTGCCAGCAGCTTAGGATGGACAGGGTCAAACACTGAAGCTTTCTTT	CASSLGWTGSNTEAFF	TRBV5-5	TRBJ1-1
TGTGCCAGCAGCGATGCACCGATAAGGGGCGGCGGCCAAGGGAGGGCGGCCTATCCTGAAGCTTTCTTT	CASSDAPIRGGGQGRAAYPEAFF	TRBV9	TRBJ1-1
TGTGCCAGCAGTTTCATCCGGACTAGCGGGCCTCCCGGGGAGCTGTTTTTT	CASSFIRTSGPPGELFF	TRBV28	TRBJ2-2
TGCATTGGGCCCTTACAGTGTGGCTACACCTTC	CIGPLQCGYTF	TRBV29-1	TRBJ1-2
TGTGCCAGCAGTTTAGTCTGTGGGACAGGGAACACTGAAGCTTTCTTT	CASSLVCGTGNTEAFF	TRBV28	TRBJ1-1
TGCGCCAGCAGCCACTACTTCTTC	CASSHYFF	TRBV4-1	TRBJ2-5
TGTGCCAGCAGCTACGGACGGTACTTC	CASSYGRYF	TRBV7-4	TRBJ2-7
TGCGCCAGCAGCACCTACCTTAAGGGAATGAACACTGAAGCTTTCTTT	CASSTYLKGMNTEAFF	TRBV5-1	TRBJ1-1
TGTGCCAGCAGCTGGCTTTACGGAGGGACAGGGGTTATCTACGAGCAGTACTTC	CASSWLYGGTGVIYEQYF	TRBV5-5	TRBJ2-7
TGTGCTAGTGTGGGAGGGGGGCCGGAAAACAAACGCGAGACCCAGTACTTC	CASVGGGPENKRETQYF	TRBV12-5	TRBJ2-5
TGTGCCAGTACCCACCGGCCGGCCCGGGACAGGGCCGACACCGGGGAGCTGTTTTTT	CASTHRPARDRADTGELFF	TRBV19	TRBJ2-2
TGTGCCAGCAGACATCCCTCGACCTTGAACACTGAAGCTTTCTTT	CASRHPSTLNTEAFF	TRBV28	TRBJ1-1
TGCGCCAGCAGCTTGGAGGGACGGACAAGTAGGTACGAGCAGTACTTC	CASSLEGRTSRYEQYF	TRBV5-1	TRBJ2-7
TGTGCCAGCAGTGAGGGGGGGAGGTCCGAGCAGTACTTC	CASSEGGRSEQYF	TRBV6-4	TRBJ2-7
TGTGCCAGCAGCGGGCGATTGCCCCAGCATTTT	CASSGRLPQHF	TRBV5-4	TRBJ1-5
TGTGCCAGTAGTATCAACGGGTCCGGACAGGGGAAAACACCCCTCCACTTT	CASSINGSGQGKTPLHF	TRBV19	TRBJ1-6
TGTGCTAGTGGTTTGCTCCTCATCAGGGGACGGGCCCAGTACTTC	CASGLLLIRGRAQYF	TRBV12-5	TRBJ2-5
TGCGCCAGCAGGGACAGGAGGGGAGCTGGGGCCAACGTCCTGACTTTC	CASRDRRGAGANVLTF	TRBV4-3	TRBJ2-6
TGCGCCCCAGGGGGTGACACTGAAGCTTTCTTT	CAPGGDTEAFF	TRBV10-2	TRBJ1-1
TGTGCCAGCAGCCCCGGGACGGTGGTTAAGACCCAGTACTTC	CASSPGTVVKTQYF	TRBV13	TRBJ2-5
TGTGCCAGCAGCGTGGTTAGAACCGAGACCCAGTACTTC	CASSVVRTETQYF	TRBV7-9	TRBJ2-5
TGTGCCAGCAGCTGGGCGGACTATGGCTACACCTTC	CASSWADYGYTF	TRBV5-6	TRBJ1-2
TGTGCCAGCAGCTTTTCCGAGGGTAGGCTCAATCAGCCCCAGCATTTT	CASSFSEGRLNQPQHF	TRBV11-3	TRBJ1-5
TGTGCCAGCAGTACCAAAGAACCGGGGGGCTACACCTTC	CASSTKEPGGYTF	TRBV6-1	TRBJ1-2
TGTGCCAGCAGGGCCAAACGCAGGGTTATTCAGGGAAATTCACCCCTCCACTTT	CASRAKRRVIQGNSPLHF	TRBV12-3	TRBJ1-6
TGTGCCAGCAGCTTAACGGGGGAGGTTCGGTACGGAGGCTACACCTTC	CASSLTGEVRYGGYTF	TRBV13	TRBJ1-2
TGTGCCAGCAGAAACTTTGAGCAGTACTTC	CASRNFEQYF	TRBV7-9	TRBJ2-7
TGCGCCAGCAGCATCACAGAGGGGAATGAAAAACTGTTTTTT	CASSITEGNEKLFF	TRBV5-1	TRBJ1-4
TGTGCCAGCAGTACATGCGACAGGAACCCTCGATCACCCCTCCACTTT	CASSTCDRNPRSPLHF	TRBV12-3	TRBJ1-6
TGTGCCAGCAGCTTAGAAGCAATCGGACAGATGAACACTGAAGCTTTCTTT	CASSLEAIGQMNTEAFF	TRBV13	TRBJ1-1
TGTGCCAGCAGTGAAGCCGGGACTAGAGAGACCCAGTACTTC	CASSEAGTRETQYF	TRBV6-1	TRBJ2-5
TGTGCCAGCAGGCTTAGGAGTAACTATGGCTACACCTTC	CASRLRSNYGYTF	TRBV6-1	TRBJ1-2
TGCGCCAGCAGCGGCCAGGGGCTCCTGAGCGCTTCCTACAATGAGCAGTTCTTC	CASSGQGLLSASYNEQFF	TRBV5-1	TRBJ2-1
TGTGCCAGTAGTCTCAACAGGGACTGCTATGGCTACACCTTC	CASSLNRDCYGYTF	TRBV19	TRBJ1-2
TGTGCCAGCAGTGGACTGGGGTGGTCCCTAAATCAGCCCCAGCATTTT	CASSGLGWSLNQPQHF	TRBV25-1	TRBJ1-5
TGTGCCAGCAGCTCGGACGACGAGCAGTACTTC	CASSSDDEQYF	TRBV9	TRBJ2-7
TGCAGTGCGCAGGGCCACTATGGCTACACCTTC	CSAQGHYGYTF	TRBV20-1	TRBJ1-2
TGTGCCAGCAGCACGCTAAATACGCAGTATTTT	CASSTLNTQYF	TRBV11-3	TRBJ2-3
TGCAGTGCTAGAGCTTACGCCTTGCAGGTCTACGAGCAGTACTTC	CSARAYALQVYEQYF	TRBV20-1	TRBJ2-7
TGTGCCAGCAGCTTGCACGGGACTCCCTACAATGAGCAGTTCTTC	CASSLHGTPYNEQFF	TRBV5-5	TRBJ2-1
TGTGCCAGCAGCCGTAGGGGGGACACTGAAGCTTTCTTT	CASSRRGDTEAFF	TRBV3-1	TRBJ1-1
TGTGCCAGCAGCACTCACAGGGGGGCAGATACGCAGTATTTT	CASSTHRGADTQYF	TRBV5-8	TRBJ2-3
TGTGCCAGCAGAATCCGACCGGGGATAGAGACCCAGTACTTC	CASRIRPGIETQYF	TRBV12-4	TRBJ2-5
TGTGCCAGCAGCCAGCTCCAGGTAAAGGTAGGGGGGAGAAGGGAGCAGTACTTC	CASSQLQVKVGGRREQYF	TRBV28	TRBJ2-7
TGTGCCAGCAGCTTAGAACAGGCAGGGCGAGCTGAAGCTTTCTTT	CASSLEQAGRAEAFF	TRBV7-9	TRBJ1-1
TGTGCCAGCAGCTTGACCGAAGGAGTCTATAGCAATCAGCCCCAGCATTTT	CASSLTEGVYSNQPQHF	TRBV7-9	TRBJ1-5
TGTGCCATCAGTGGGGGTGGTTACGAGCAGTACTTC	CAISGGGYEQYF	TRBV10-3	TRBJ2-7
TGTGCCAGCAAGGGTTACAAACAGGATTACGAGCAGTACTTC	CASKGYKQDYEQYF	TRBV6-8	TRBJ2-7
TGTGAGTGTGGAAGACAGGGGGTCACAGATACGCAGTATTTT	CECGRQGVTDTQYF	TRBV24-1	TRBJ2-3
TGTGCCAGCAGCTTGCCCTGTAAACTAGCGGGAGACTTACTCTTC	CASSLPCKLAGDLLF	TRBV5-5	TRBJ1-2
TGTGCCAGCAGCTCCCTAGCGGAGCCACTCAGGACAGATACGCAGTATTTT	CASSSLAEPLRTDTQYF	TRBV11-2	TRBJ2-3
TGTGCCTGGGGACAGATTTTCTCTGGAAACACCATATATTTT	CAWGQIFSGNTIYF	TRBV30	TRBJ1-3
TGTGCCAGCAGCTCCGTGACTAGCGGCCCTTCCTACGAGCAGTACTTC	CASSSVTSGPSYEQYF	TRBV9	TRBJ2-7
TGTGCCAGCAGTACCAATCTCCGATGGACAGGCACTGAAGCTTTCTTT	CASSTNLRWTGTEAFF	TRBV25-1	TRBJ1-1
TGCAGCGCCGGGAATCTAGCCAAAAACATTCAGTACTTC	CSAGNLAKNIQYF	TRBV29-1	TRBJ2-4
TGTGCCAGCAGCGATAGCGGGAGCGGGCCCAGAACAACTAATGAAAAACTGTTTTTT	CASSDSGSGPRTTNEKLFF	TRBV7-8	TRBJ1-4
TGCAGTGCTAGATGGACAGGGCGATGTTCCTACGAGCAGTACTTC	CSARWTGRCSYEQYF	TRBV20-1	TRBJ2-7
TGCGCCAGCAGCTTGGAACTTTCCGGGGGCTACCAGCCCCAGCATTTT	CASSLELSGGYQPQHF	TRBV5-1	TRBJ1-5
TGTGCCAGCAGCAGAAGGGCTCTCTCTGGAAACACCATATATTTT	CASSRRALSGNTIYF	TRBV13	TRBJ1-3
TGCGCCAGCAGCCACCAGGGGAACCGCACCGGGGAGCTGTTTTTT	CASSHQGNRTGELFF	TRBV4-3	TRBJ2-2
TGTGCCAGCAGCCAAGGGGACAGAGACCACTATGGCTACACCTTC	CASSQGDRDHYGYTF	TRBV4-2	TRBJ1-2
TGTGCCAGCAGTTATGAACAGGGGCCAGGCAAAAACATTCAGTACTTC	CASSYEQGPGKNIQYF	TRBV6-5	TRBJ2-4
TGTGCCAGCAGCCTCAAATCTTCTCCGAGCGGGAGGCAAGGTGAAAAACTGTTTTTT	CASSLKSSPSGRQGEKLFF	TRBV7-6	TRBJ1-4
TGTGCCAGCAGCCCACTGGGGGGAGGAGTGCGGAGATACGAGCAGTACTTC	CASSPLGGGVRRYEQYF	TRBV13	TRBJ2-7
TGTGGAAGCCAGGGCCCTTGGGCCCTCCACTTT	CGSQGPWALHF	TRBV5-4	TRBJ1-6
TGCAGTGCATCCTCAGTGCAAACAGTTAACGAGCAGTACTTC	CSASSVQTVNEQYF	TRBV20-1	TRBJ2-7
TGTGCCAGCAGCTCGCTTCGGGGGGCCGCCCAAGAGACCCAGTACTTC	CASSSLRGAAQETQYF	TRBV9	TRBJ2-5
TGCAGTCAATGGGGTTCGGTTAACACCGGGGAGCTGTTTTTT	CSQWGSVNTGELFF	TRBV20-1	TRBJ2-2
TGTGCCAGCAGCCATGGACGACCGGGACAGCCCCAGCATTTT	CASSHGRPGQPQHF	TRBV14	TRBJ1-5
TGTGCCAGCAGCAAACAGGGTTTCACGTTGAACACTGAAGCTTTCTTT	CASSKQGFTLNTEAFF	TRBV4-2	TRBJ1-1
TGTGCCAGCAGTGACTACGAAAACTTGCCCGGAGAAAACAATGAGCAGTTCTTC	CASSDYENLPGENNEQFF	TRBV6-4	TRBJ2-1
TGTGCCACCAGTGATTTGGTCGAGCGGAACAATGAGCAGTTCTTC	CATSDLVERNNEQFF	TRBV24-1	TRBJ2-1
TGTGCCAGCAGCCAAGGTCCTGTCATTTGTCAGCCCCAGCATTTT	CASSQGPVICQPQHF	TRBV3-1	TRBJ1-5
TGTGCCAGCAGCTCAGGCGGGGGGGCCTACGAGCAGTACTTC	CASSSGGGAYEQYF	TRBV5-6	TRBJ2-7
TGTGCCAGCAGGGATAGCGGGACAGGGCAGCCTGACGAGCAGTTCTTC	CASRDSGTGQPDEQFF	TRBV6-1	TRBJ2-1
TGCGCCAGCAGCCAAGATGATCTCCCGGGACATGTGAACACTGAAGCTTTCTTT	CASSQDDLPGHVNTEAFF	TRBV4-1	TRBJ1-1
TGTGCCACCTTCGCAGGGCCCCAAGAGACCCAGTACTTC	CATFAGPQETQYF	TRBV24-1	TRBJ2-5
TGCACCCTGAATGGGAGGGTCCCATCAGATAGCTCCTACAATGAGCAGTTCTTC	CTLNGRVPSDSSYNEQFF	TRBV20-1	TRBJ2-1
TGTGCCAGCAGCGTATTAGGTTCAACTAATGAAAAACTGTTTTTT	CASSVLGSTNEKLFF	TRBV13	TRBJ1-4
TGCGCCAGCAAAAAAAAGGAGTGGGGACTAGCGGGAGGGCTCGCCTACGAGCAGTACTTC	CASKKKEWGLAGGLAYEQYF	TRBV5-1	TRBJ2-7
TGCGCCAGCAGCATGGAGGCGAGACCCGAGCAGTACTTC	CASSMEARPEQYF	TRBV5-1	TRBJ2-7
TGTGCCAGCAGCAAGGCTAGGGGTGGCTACACCTTC	CASSKARGGYTF	TRBV7-3	TRBJ1-2
TGTGCCAGCACCTGCAGGGGGGGCACTGAAGCTTTCTTT	CASTCRGGTEAFF	TRBV6-5	TRBJ1-1
TGTGCCACCAGTGATTTAGAACCTCGAATAGCCTACAATGAGCAGTTCTTC	CATSDLEPRIAYNEQFF	TRBV24-1	TRBJ2-1
TGTGCCAGCAGCCAAGAGCGTGGGACAGAAGAAGGGGAGACCCAGTACTTC	CASSQERGTEEGETQYF	TRBV3-1	TRBJ2-5
TGTGCCAGCAGTTGGTCCTCGGGACAGTTCGGCTACACCTTC	CASSWSSGQFGYTF	TRBV27	TRBJ1-2
TGTGCCACCGGACTAACCGGGGAGCTGTTTTTT	CATGLTGELFF	TRBV27	TRBJ2-2
TGTGCCAGCGGGGAATGTAAAGTTGCTAGCGGGACGGGCCCAGATACGCAGTATTTT	CASGECKVASGTGPDTQYF	TRBV7-3	TRBJ2-3
TGTGCCAGCAGTAATCGAGGGGGACTACCTTTCGGCGAGCAGTACTTC	CASSNRGGLPFGEQYF	TRBV6-4	TRBJ2-7
TGTGCCAGCAGTTACCGGCCGGGACAGGGTGCTCTCTGGAAGTATTTT	CASSYRPGQGALWKYF	TRBV6-5	TRBJ1-3
TGTGCCAGTAGTATAGAAATGATGGGCCCAACGTCACCCCTCCACTTT	CASSIEMMGPTSPLHF	TRBV19	TRBJ1-6
TGCGCCAGCAGTCCAGTCTACTACGAGCAGTACTTC	CASSPVYYEQYF	TRBV10-1	TRBJ2-7
TGCAGTGCTCCCACTGGGGGGATATGGGTCAATGAGCAGTTCTTC	CSAPTGGIWVNEQFF	TRBV20-1	TRBJ2-1
TGTGCCAGCAGCTTGCACAGGTACAATGAGCAGTTCTTC	CASSLHRYNEQFF	TRBV5-4	TRBJ2-1
TGTGCCAGCAGTTACTCGCTTGGACAGGGAAGAGAGAGGAATGAGCAGTTCTTC	CASSYSLGQGRERNEQFF	TRBV6-2	TRBJ2-1
TGTGCCACCAGGGCTCGAACTAGAGCCTACGAGCAGTACTTC	CATRARTRAYEQYF	TRBV24-1	TRBJ2-7
TGTGCCAGCAGTGAAGCGCTCCGGACTAGCGTAGAGACCCAGTACTTC	CASSEALRTSVETQYF	TRBV6-1	TRBJ2-5
TGCAGTGCGTCGGCAAAGGGGGAAAAACTGTTTTTT	CSASAKGEKLFF	TRBV20-1	TRBJ1-4
TGCGCCAGCAGCTCACGATCCGCATATGGCTACACCTTC	CASSSRSAYGYTF	TRBV5-1	TRBJ1-2
TGCAGTGAGGAGGGGAATTATAACTATGGCTACACCTTC	CSEEGNYNYGYTF	TRBV20-1	TRBJ1-2
TGTGCCACTGTTGGGGAGCAGGGTCGATCCTATGGCTACACCTTC	CATVGEQGRSYGYTF	TRBV2	TRBJ1-2
TGTGCCAGCAGCTCGAGACCGGGACAGGGGCCCACAGATACGCAGTATTTT	CASSSRPGQGPTDTQYF	TRBV13	TRBJ2-3
TGTGCCAGCAGGACTCTAACCATATACGAGCAGTACTTC	CASRTLTIYEQYF	TRBV3-1	TRBJ2-7
TGTGCCACCAGTGATTCAGGGGACGGGGGGAATTCACCCCTCCACTTT	CATSDSGDGGNSPLHF	TRBV24-1	TRBJ1-6
TGCGCCAGCAGCTGCGCGGGAGAGGAAGAGACCCAGTACTTC	CASSCAGEEETQYF	TRBV5-1	TRBJ2-5
TGTGCCAGCAGAGGGGGGACAGGAGAGTCAGATACGCAGTATTTT	CASRGGTGESDTQYF	TRBV25-1	TRBJ2-3
TGTGCCAGCAGCATTAGGGGGTGCTCTGGGGCCAACGTCCTGACTTTC	CASSIRGCSGANVLTF	TRBV5-5	TRBJ2-6
TGTGCCAGCAGGCCCCCAGACAAAAACATTCAGTACTTC	CASRPPDKNIQYF	TRBV6-2	TRBJ2-4
TGTGCCAGCAGCAACTCAGGGCCCTCCGACAACTATGGCTACACCTTC	CASSNSGPSDNYGYTF	TRBV11-3	TRBJ1-2
TGTGCCAGCAGTCTGGACTGTCGCTTCTTAAATGAAAAACTGTTTTTT	CASSLDCRFLNEKLFF	TRBV12-3	TRBJ1-4
TGTGCCAGCAGCCAAGACGAAGGGGATGAAAAACTGTTTTTT	CASSQDEGDEKLFF	TRBV14	TRBJ1-4
TGTGCCAGACCCCTCGACGGTGATCAGCCCCAGCATTTT	CARPLDGDQPQHF	TRBV11-3	TRBJ1-5
TGTGCCAGCAGCCAAGAAGTGGGGGGAACTGAAGCTTTCTTT	CASSQEVGGTEAFF	TRBV14	TRBJ1-1
TGCAGTGCGACCTCCCGACAGGGGGAAGTGGGACGAAGCTCCTACGAGCAGTACTTC	CSATSRQGEVGRSSYEQYF	TRBV20-1	TRBJ2-7
TGTGCCAGCAGTGGGGCGCTTTCAGAGCGGGAGACCCAGTACTTC	CASSGALSERETQYF	TRBV12-4	TRBJ2-5
TGCGCCAGCCCATATACAGGGAGCAATAACTATGGCTACACCTTC	CASPYTGSNNYGYTF	TRBV10-1	TRBJ1-2
TGTGCCAGCAGCTTAAGACCGCTCCGGGCGCCGAGGTCCAACTATGGCTACACCTTC	CASSLRPLRAPRSNYGYTF	TRBV11-3	TRBJ1-2
TGTGCCGGTCATGGGGGATACTACGAGCAGTACTTC	CAGHGGYYEQYF	TRBV19	TRBJ2-7
TGTGCCAGCAGATCAGGGTTAGCTAACTATGGCTACACCTTC	CASRSGLANYGYTF	TRBV6-5	TRBJ1-2
TGTGCCAGCAGCGGACCTACGGGCGAGCAGTACTTC	CASSGPTGEQYF	TRBV13	TRBJ2-7
TGCAGTGCTAGAAGGGGATCCCCGAACACCGGGGAGCTGTTTTTT	CSARRGSPNTGELFF	TRBV20-1	TRBJ2-2
TGTGCCATCAAGAAGGCCGGGACAGCAGATACGCAGTATTTT	CAIKKAGTADTQYF	TRBV10-3	TRBJ2-3
TGTGCCAGCAGCGCGTCAGGGATCCTCCCGGGCTACGAGCAGTACTTC	CASSASGILPGYEQYF	TRBV9	TRBJ2-7
TGTGCCAGCAGCCAAGGCCCAAAACAGCACTACGAGCAGTACTTC	CASSQGPKQHYEQYF	TRBV4-2	TRBJ2-7
TGTGCCAGCAGTCCGGGACTAGCGGGAGGGGGCACAGATACGCAGTATTTT	CASSPGLAGGGTDTQYF	TRBV27	TRBJ2-3
TGTGCCAGCAGTAACCCCCACAGGGGGCGGGTCAACACCGAAGCTTTCTTT	CASSNPHRGRVNTEAFF	TRBV27	TRBJ1-1
TGCGCCAGCCCCGATCTAGGGGACTACGAGCAGTACTTC	CASPDLGDYEQYF	TRBV5-1	TRBJ2-7
TGTGCCAGCAGCAAATTTACAGGGCATGAAGCTTTCTTT	CASSKFTGHEAFF	TRBV27	TRBJ1-1
TGTGCCACCAGTAACGGAGGCACAGATACGCAGTATTTT	CATSNGGTDTQYF	TRBV24-1	TRBJ2-3
TGCGCCAGCAGCCAAGATTCGACAGATACGCAGTATTTT	CASSQDSTDTQYF	TRBV4-1	TRBJ2-3
TGTGCCAGCAGCCCCCCACAGGGTAAGGCTTTGCTTGAAGCTTTCTTT	CASSPPQGKALLEAFF	TRBV7-3	TRBJ1-1
TGTGCCAGCACTATGAGGAGGGGGTTGCCCCTAAATTCACCCCTCCACTTT	CASTMRRGLPLNSPLHF	TRBV3-1	TRBJ1-6
TGTGCCATCAGCCCTATACAGGGGGAGGACTCCTACAATGAGCAGTTCTTC	CAISPIQGEDSYNEQFF	TRBV10-3	TRBJ2-1
TGTGCCACCAGTGACCGAACAGGGAGTTATGGCTACACCTTC	CATSDRTGSYGYTF	TRBV24-1	TRBJ1-2
TGTGCCAGCAGCTTGGACTCCGGAATGCTCACCGGGGAGCTGTTTTTT	CASSLDSGMLTGELFF	TRBV5-6	TRBJ2-2
TGTGCCAGCAGCCCACAGGGTGCTTGTAAGCAAGCCTACAATGAGCAGTTCTTC	CASSPQGACKQAYNEQFF	TRBV11-2	TRBJ2-1
TGTGCCAGCAGCTTGGCAGGGAGGGTAACCTATAGCAATCAGCCCCAGCATTTT	CASSLAGRVTYSNQPQHF	TRBV5-4	TRBJ1-5
TGTGCCAGCAGCTTACGGGCGGGGGGCAATCAGCCCCAGCATTTT	CASSLRAGGNQPQHF	TRBV5-4	TRBJ1-5
TGTGCCAGCAGCGGGGGGCGAGGTCAAGAGACCCAGTACTTC	CASSGGRGQETQYF	TRBV5-6	TRBJ2-5
TGTGCCAGCAGCCTTAATGGGGGCGCCAGGAAAGAGACCCAGTACTTC	CASSLNGGARKETQYF	TRBV9	TRBJ2-5
TGTGCCAGCAGACCCGGGACTAGCGGTATTTACAATGAGCAGTTCTTC	CASRPGTSGIYNEQFF	TRBV28	TRBJ2-1
TGTGCCAGCAGTGAAGCGATAGGGGGCTTGGAAGCTTTCTTT	CASSEAIGGLEAFF	TRBV6-1	TRBJ1-1
TGTGCCAGCCTAGCGGGGTGGACAGATACGCAGTATTTT	CASLAGWTDTQYF	TRBV9	TRBJ2-3
TGCAGTGCTAGAGATCCCAGGAATGGCGAGCAGTACTTC	CSARDPRNGEQYF	TRBV20-1	TRBJ2-7
TGTGCCAGCAGCGTAGGTGGGGGGGACAGCGATTACGAGCAGTACTTC	CASSVGGGDSDYEQYF	TRBV9	TRBJ2-7
TGTGCCAGCAGTGCACCTGTAGCGGGAATACAAGAGACCCAGTACTTC	CASSAPVAGIQETQYF	TRBV6-4	TRBJ2-5
TGTGCCAGCAGCGTAGACTTGTTTGGGGGGGCTCAGGGATTCTCTGGGGCCAACGTCCTGACTTTC	CASSVDLFGGAQGFSGANVLTF	TRBV9	TRBJ2-6
TGTGCCTGGATGCTTGCGGGGTCCACCTACGAGCAGTACTTC	CAWMLAGSTYEQYF	TRBV30	TRBJ2-7
TGTGCCAGGGGCGGAGAGAAGAATGAAAAACTGTTTTTT	CARGGEKNEKLFF	TRBV6-6	TRBJ1-4
TGTGCCAGCAGCTTAGCCGACCGGGACAGGGGGTCGAACACTGAAGCTTTCTTT	CASSLADRDRGSNTEAFF	TRBV7-4	TRBJ1-1
TGTGCCAGCAGTTTCGACCTCACTCCTCCCTATATCCTTCGCACAGATACGCAGTATTTT	CASSFDLTPPYILRTDTQYF	TRBV6-5	TRBJ2-3
TGTGCCAGCAGCCAACAGGGCTTCTACGAGCAGTACTTC	CASSQQGFYEQYF	TRBV14	TRBJ2-7
TGTGCCAGCAGCCAAGATGTTGACGAGGGTGAGCAGTTCTTC	CASSQDVDEGEQFF	TRBV3-1	TRBJ2-1
TGCAGTGCTCCCCTTACGGCACTAGCGGGGGGGCCGACCTCCCCGGTAGCCAAAAACATTCAGTACTTC	CSAPLTALAGGPTSPVAKNIQYF	TRBV20-1	TRBJ2-4
TGTGCCAGCCTTGCACTTAATGAAAAACTGTTTTTT	CASLALNEKLFF	TRBV7-2	TRBJ1-4
TGCGCCAGCAGCTACCCGGGGCTCGAGCAGTACTTC	CASSYPGLEQYF	TRBV5-1	TRBJ2-7
TGTGCCAGCAGCATAAGGGACAGGAGGGTGAACACTGAAGCTTTCTTT	CASSIRDRRVNTEAFF	TRBV11-3	TRBJ1-1
TGCGCCAGCAGCACCGAGGGGATTCGCAATCAGCCCCAGCATTTT	CASSTEGIRNQPQHF	TRBV4-3	TRBJ1-5
TGTGCCAGCAGCCAAGTGGGACTAGCGGGTGAGCAGTTCTTC	CASSQVGLAGEQFF	TRBV3-1	TRBJ2-1
TGCGCCAGCAGCCTCCATCGGGACCTCAGGGGTAGCTCCTACGAGCAGTACTTC	CASSLHRDLRGSSYEQYF	TRBV4-1	TRBJ2-7
TGTGCCAGCACCTATATCGGGGCCTCCGTGACAGTTAGTGAAAAACTGTTTTTT	CASTYIGASVTVSEKLFF	TRBV7-2	TRBJ1-4
TGTGCCAGCAGCTGTACTAGAAGGACTGCGAACTACGAGCAGTACTTC	CASSCTRRTANYEQYF	TRBV7-9	TRBJ2-7
TGTGCCAGCAGTCCGGGACAGCCCCTCCACTTT	CASSPGQPLHF	TRBV6-4	TRBJ1-6
TGTGCTAGTGGTTTGGTCAGATCCACAATGACTGAAGCTTTCTTT	CASGLVRSTMTEAFF	TRBV12-5	TRBJ1-1
TGTGCCAGCAGCCGACAGGGGGCTATGAATTGTCCTTATGGCTACACCTTC	CASSRQGAMNCPYGYTF	TRBV7-7	TRBJ1-2
TGTGCCAGCAGCCAGTTTGGACCAACAGTAGCGATCCATCAGCCCCAGCATTTT	CASSQFGPTVAIHQPQHF	TRBV9	TRBJ1-5
TGTGCCAGCAGCCAGAGGTTAGAGACCCAGTACTTC	CASSQRLETQYF	TRBV27	TRBJ2-5
TGTGCCACCAGTGCAGATAACGAGCAGTACTTC	CATSADNEQYF	TRBV24-1	TRBJ2-7
TGTGCCAGCTCACCCCTAGCCAGATCGTCTTGGCCCTCCTATAATTCACCCCTCCACTTT	CASSPLARSSWPSYNSPLHF	TRBV18	TRBJ1-6
TGTGCCAGCAGCTTTCGGGGGCGCAAGGGGGTTTACAGCTCTGGAAACACCATATATTTT	CASSFRGRKGVYSSGNTIYF	TRBV7-8	TRBJ1-3
TGCGCCAGCAGCCAAGTGGGGCAGGCCGGGGAGCTGTTTTTT	CASSQVGQAGELFF	TRBV4-3	TRBJ2-2
TGTGCCAGCAGGGTGACCAATAGGGCCTCTGGGGCCAACGTCCTGACTTTC	CASRVTNRASGANVLTF	TRBV6-5	TRBJ2-6
TGTGCCAGCAGCCTTTACGGGGTGCAGCCCCAGCATTTT	CASSLYGVQPQHF	TRBV7-9	TRBJ1-5
TGCGCCAGCAGCCAAGATCGGACAGCCTACGAGCAGTACTTC	CASSQDRTAYEQYF	TRBV4-3	TRBJ2-7
TGTGCCAGCAGCTTAGTACATCGATCAGGGACAGGGCTGCGCCGGGCTTTCTTT	CASSLVHRSGTGLRRAFF	TRBV7-2	TRBJ1-1
TGCGCCATCATGCTCCGGGACAGGGGGCACACCGGGGAGCTGTTTTTT	CAIMLRDRGHTGELFF	TRBV10-1	TRBJ2-2
TGTGCCAGCAGCCCGAGGTGGACAGACGCTGGGGCCAACGTCCTGACTTTC	CASSPRWTDAGANVLTF	TRBV3-1	TRBJ2-6
TGTGCCAGCAGCTCAGACGTTTCCCGGTTAAACACCGGGGAGCTGTTTTTT	CASSSDVSRLNTGELFF	TRBV7-8	TRBJ2-2
TGTGCCAGCAGCCAAGTGGGACAGGACTACGAGCAGTACTTC	CASSQVGQDYEQYF	TRBV3-1	TRBJ2-7
TGTGCCAGCAGTTTTCCGACAGGGCGTGGCTACACCTTC	CASSFPTGRGYTF	TRBV27	TRBJ1-2
TGCGCCAGCAGCCAAGATCCAGACCCCAGGCAGTACTTC	CASSQDPDPRQYF	TRBV4-1	TRBJ2-7
TGTGCCAGCAGCACGGGAGGCTACGAGCAGTACTTC	CASSTGGYEQYF	TRBV11-3	TRBJ2-7
TGTGCCAGCAGCCAAAAGGGAATACGGAACAATGAGCAGTTCTTC	CASSQKGIRNNEQFF	TRBV3-1	TRBJ2-1
TGTGCCAGCAGCGGACTAGGGGACAATGAGCAGTTCTTC	CASSGLGDNEQFF	TRBV9	TRBJ2-1
TGTGCCAGCAGCCATCTAGCGGGCAGTTACAATGAGCAGTTCTTC	CASSHLAGSYNEQFF	TRBV7-9	TRBJ2-1
TGTGCCAGCAGTCGTGCTCCCCTGACTGGGTCCCAGTCCCAGCATTTT	CASSRAPLTGSQSQHF	TRBV6-8	TRBJ1-5
TGTGCCAGTAACATTAAGCACAGGGGCCGTCAGCCCCAGCATTTT	CASNIKHRGRQPQHF	TRBV19	TRBJ1-5
TGTGCCAGCAGCTGCAGGGGGGGGGGGAACACTGAAGCTTTCTTT	CASSCRGGGNTEAFF	TRBV7-2	TRBJ1-1
TGTGCCCCCGGACAGGAAACTGAAGCTTTCTTT	CAPGQETEAFF	TRBV10-3	TRBJ1-1
TGTGCCAGCAGCTCCTTTCCCCAGGGGGCACTAGGCTACAATGAGCAGTTCTTC	CASSSFPQGALGYNEQFF	TRBV11-3	TRBJ2-1
TGTGCCAGCATCGAGGTGTATTCGAGGGCAAGGGAGCAGTACTTC	CASIEVYSRAREQYF	TRBV7-3	TRBJ2-7
TGTGCCAGCAGTCTGGGGGGCAGGGAGCAGCCCCAGCATTTT	CASSLGGREQPQHF	TRBV6-1	TRBJ1-5
TGCAGCGTGAAGAGGGAATGCGGAGGGGGCCGTACTAATGAAAAACTGTTTTTT	CSVKRECGGGRTNEKLFF	TRBV29-1	TRBJ1-4
TGTGCCAGCAGCTTAGTCACCCCCAGGGGGCGACAGCCAAATTCACCCCTCCACTTT	CASSLVTPRGRQPNSPLHF	TRBV7-3	TRBJ1-6
TGTGCCAGCAGTTACTCGATTGACAACACTGAAGCTTTCTTT	CASSYSIDNTEAFF	TRBV6-5	TRBJ1-1
TGTGCCCAGCTCACGAAATTAGGGACAGATACGCAGTATTTT	CAQLTKLGTDTQYF	TRBV27	TRBJ2-3
TGTGCCACCAGTGATTTCTCACCGGCGGGGTACACTGAAGCTTTCTTT	CATSDFSPAGYTEAFF	TRBV24-1	TRBJ1-1
TGTGCCAGCTCGATGGGGGATCTAGCCAAAAACATTCAGTACTTC	CASSMGDLAKNIQYF	TRBV6-4	TRBJ2-4
TGTGCCATCAGTGAAACCATGTTACTAGCGGCGACCTACGAGCAGTACTTC	CAISETMLLAATYEQYF	TRBV10-3	TRBJ2-7
TGCGCCAGCAGCTTCCCCTCAGGCCCACTAGCGCCGCAGGACACCGGGGAGCTGTTTTTT	CASSFPSGPLAPQDTGELFF	TRBV5-1	TRBJ2-2
TGTGCCAGCAACGTCCGGTCCTACGAGCAGTACTTC	CASNVRSYEQYF	TRBV12-3	TRBJ2-7
TGTGCCAGCAGTTTCCCAAAGGAGAGGGTACTCGAAAAACTGTTTTTT	CASSFPKERVLEKLFF	TRBV28	TRBJ1-4
TGTGCCAGCAGCTGGACTTCAATTAGTCAGCCCCAGCATTTT	CASSWTSISQPQHF	TRBV5-6	TRBJ1-5
TGCGCCAGCCCGGGGCATAGCAATCAGCCCCAGCATTTT	CASPGHSNQPQHF	TRBV5-1	TRBJ1-5
TGCAGTGCTCACACTTCGGGGGGGCTGAATAGCACAGATACGCAGTATTTT	CSAHTSGGLNSTDTQYF	TRBV20-1	TRBJ2-3
TGTGCCTGGAGTGTAGAAAGTCCCGGGACTAGTGAGACCCAGTACTTC	CAWSVESPGTSETQYF	TRBV30	TRBJ2-5
TGTGCCAGCAGTGTTTGCGGGGGAAACTGTCAGCCCCAGCATTTT	CASSVCGGNCQPQHF	TRBV28	TRBJ1-5
TGTGCCAGTAGTATCCGACAGGCCTGCAATCAGCCCCAGCATTTT	CASSIRQACNQPQHF	TRBV19	TRBJ1-5
TGTGCTGAATCTTGGGGGCTCGTCGGGATGGTCAGCTCCTACGAGCAGTACTTC	CAESWGLVGMVSSYEQYF	TRBV6-2	TRBJ2-7
TGTGCCACCTACCAAACGCGACAGGGGGGGGGAAACACCATATATTTT	CATYQTRQGGGNTIYF	TRBV24-1	TRBJ1-3
TGTGCCAGTTCTCATGCGTACGAGCAGTACTTC	CASSHAYEQYF	TRBV7-4	TRBJ2-7
TGTGCCACCAGTGTATTGGGGGGCTACGAGCAGTACTTC	CATSVLGGYEQYF	TRBV24-1	TRBJ2-7
TGTGCCAGCACCGACAGGGACGGTAGCAATCAGCCCCAGCATTTT	CASTDRDGSNQPQHF	TRBV28	TRBJ1-5
TGTGCCAGCAGTTTCAAAACGGACGACCCGGCAACTAATGAAAAACTGTTTTTT	CASSFKTDDPATNEKLFF	TRBV28	TRBJ1-4
TGCGCCAGGTCCCGAGGGGAGCAGTACTTC	CARSRGEQYF	TRBV4-1	TRBJ2-7
TGTGCCAGCAGCCACAGGGGTCAAGAGCAGTACTTC	CASSHRGQEQYF	TRBV7-3	TRBJ2-7
TGTGCCAGCAGCCCTGGACAGGGAAAGTCAGGCCCCCGGGGCTACACCTTC	CASSPGQGKSGPRGYTF	TRBV3-1	TRBJ1-2
TGTGCCCGAGGTAAGGTAAATTCCATACCCGAGCAGTACTTC	CARGKVNSIPEQYF	TRBV6-2	TRBJ2-7
TGTGCCAGCAGCGTAAAGGGGGACAGGGGCTGCTATGGCTACACCTTC	CASSVKGDRGCYGYTF	TRBV9	TRBJ1-2
TGTGCCAGCAGTGACCCCAGGGGTCCCCAGTACTTC	CASSDPRGPQYF	TRBV6-4	TRBJ2-5
TGTGCCAGCATGAAGACTAGCGGGGTCCAGGGCACAGATACGCAGTATTTT	CASMKTSGVQGTDTQYF	TRBV12-4	TRBJ2-3
TGTGCCAGCAGCCGGGGGGGACTAGTCGAACTTAACGACCCGGAGCTGTTTTTT	CASSRGGLVELNDPELFF	TRBV7-9	TRBJ2-2
TGTGCCAGCAATGAGGGAGTCTGCTACGAGCAGTACTTC	CASNEGVCYEQYF	TRBV27	TRBJ2-7
TGCAGTGCTAGAGCCTTAGGCTGCCTTTGTCCCTACGAGCAGTACTTC	CSARALGCLCPYEQYF	TRBV20-1	TRBJ2-7
TGTGCCAGCGAGCCGAGGGAAGCTGAGCAGTTCTTC	CASEPREAEQFF	TRBV11-2	TRBJ2-1
TGTGCCAGCGAACGGACAGGGAACACCGGGGAGCTGTTTTTT	CASERTGNTGELFF	TRBV7-7	TRBJ2-2
TGTGCCAGCAGTGACCTGCAGGATGCCTACGAGCAGTACTTC	CASSDLQDAYEQYF	TRBV6-4	TRBJ2-7
TGTGCCAGCAGCTTAGGAACAGAGATCGCGTGGGATGGCTACACCTTC	CASSLGTEIAWDGYTF	TRBV7-9	TRBJ1-2
TGTGCCAGCAGCGAACATTCCGGGGCCAACGTCCTGACTTTC	CASSEHSGANVLTF	TRBV9	TRBJ2-6
TGCGCCAGCAGTGAGTCGCAACCACCCGGCTACAATGAGCAGTTCTTC	CASSESQPPGYNEQFF	TRBV10-1	TRBJ2-1
TGTGCCAGCAGCTTGTGCTTTGCTAGCGGGGGCTACGAGCAGTACTTC	CASSLCFASGGYEQYF	TRBV5-6	TRBJ2-7
TGTGCCAGCAGCTTACGAGAAAGGGACCCGGGGAGCTCCTACGAGCAGTACTTC	CASSLRERDPGSSYEQYF	TRBV7-6	TRBJ2-7
TGTGCCAGCAACGCCGGGGGCCTCTACTACGAGCAGTACTTC	CASNAGGLYYEQYF	TRBV4-2	TRBJ2-7
TGCAGTGCTAGAGCCTATGGAGCTGCGGGACCCAAAATGAGCTCCTACAATGAGCAGTTCTTC	CSARAYGAAGPKMSSYNEQFF	TRBV20-1	TRBJ2-1
TGTGCCAGCCTAGCGGGGAGTGTAAAGGGACCTAGTAGTGGAGAGCAGTTCTTC	CASLAGSVKGPSSGEQFF	TRBV7-6	TRBJ2-1
TGCGCCACCGAACCAGGACAGGGTGGGGATCAGCCCCAGCATTTT	CATEPGQGGDQPQHF	TRBV5-1	TRBJ1-5
TGCGCCAGCAGCTTCCGTCGCGGGAGCGTAAATCAGCCCCAGCATTTT	CASSFRRGSVNQPQHF	TRBV5-1	TRBJ1-5
TGTGCCTGGAGCTCCACTGTCAGCGTAGCCAAAAACATTCAGTACTTC	CAWSSTVSVAKNIQYF	TRBV30	TRBJ2-4
TGTGCCATCAGTGGCCGGGAGCGTTTAAGCTATGGCTACACCTTC	CAISGRERLSYGYTF	TRBV10-3	TRBJ1-2
TGTGCCAGCAGTGAAGCCCTTTTTAAACATGAGCAGTTCTTC	CASSEALFKHEQFF	TRBV6-1	TRBJ2-1
TGTGCCAGCAGTCCGCGTTACAGTAGGAACACCGGGGAGCTGTTTTTT	CASSPRYSRNTGELFF	TRBV2	TRBJ2-2
TGCAGTGCTAGCGACAAACACTGCCGGGACAGGGGGGGGAACACTGAAGCTTTCTTT	CSASDKHCRDRGGNTEAFF	TRBV20-1	TRBJ1-1
TGTGCCAGCAGCGTTAGCCCAGGTGCCCCTAGCACAGATACGCAGTATTTT	CASSVSPGAPSTDTQYF	TRBV5-5	TRBJ2-3
TGCGCCAGCAGCTTTACCGGGACAGCTAATGAAAAACTGTTTTTT	CASSFTGTANEKLFF	TRBV5-1	TRBJ1-4
TGTGCCACCAGTGATTTCGAAGTAAGCTCCTACAATGAGCAGTTCTTC	CATSDFEVSSYNEQFF	TRBV24-1	TRBJ2-1
TGTGCCAGCCCGGAGGGAAGGAGTGGCGAGCCCCAGCATTTT	CASPEGRSGEPQHF	TRBV28	TRBJ1-5
TGCGCCAGACCCAGGTTGCCTTCCCCCCTCAGCTCCTATAATTCACCCCTCCACTTT	CARPRLPSPLSSYNSPLHF	TRBV5-1	TRBJ1-6
TGTGCCAGCAGAATTGGAGGACGAGTCGGGGAGCTGTTTTTT	CASRIGGRVGELFF	TRBV2	TRBJ2-2
TGTGCCAGCAGTTACGGAGTCTTGAGGGTGTATGGCTACACCTTC	CASSYGVLRVYGYTF	TRBV6-6	TRBJ1-2
TGTGCCAGCTTACTGGTAGAAGGGTGCTATAATTCACCCCTCCACTTT	CASLLVEGCYNSPLHF	TRBV6-3	TRBJ1-6
TGTGCCAGCAAGGGTGCGACTAGCGCAGGGCCCCAAGAGACCCAGTACTTC	CASKGATSAGPQETQYF	TRBV6-4	TRBJ2-5
TGTGCCAGCAGCCCCCGACAGGGGGGGTTATGCGTGGGACCACCCCTCCACTTT	CASSPRQGGLCVGPPLHF	TRBV3-1	TRBJ1-6
TGTGCCAGCAGAAGGGAGGGTCCAAATGAGCAGTTCTTC	CASRREGPNEQFF	TRBV2	TRBJ2-1
TGTGCCAGCAGTTCCAGGCCGCGGAGGGACTCTGGAAACACCATATATTTT	CASSSRPRRDSGNTIYF	TRBV6-5	TRBJ1-3
TGCGCCAGCAGCTTCTTAGGACTAGCGGGAGGGGATGAGACCCAGTACTTC	CASSFLGLAGGDETQYF	TRBV5-1	TRBJ2-5
TGTGCCGTAGACCAATTCGGATCTGACAGGGTCCATCAGCCCCAGCATTTT	CAVDQFGSDRVHQPQHF	TRBV27	TRBJ1-5
TGCGCCAGCAGTGATCGTGGCCACCCCGGACAGCCGAGCTCTGGAAACACCATATATTTT	CASSDRGHPGQPSSGNTIYF	TRBV10-1	TRBJ1-3
TGCAGCGAGTGTGACAGGGGGGGATACCAGCCCCAGCATTTT	CSECDRGGYQPQHF	TRBV29-1	TRBJ1-5
TGTGCCAGCAGTTACCGGTTCAGTTCAACAAACACCGGGGAGCTGTTTTTT	CASSYRFSSTNTGELFF	TRBV6-2	TRBJ2-2
TGCGCCAGCAGCTTGGCCCCTTCCCCGGGACTAGCGGGAGGAGCGAACACCGGGGAGCTGTTTTTT	CASSLAPSPGLAGGANTGELFF	TRBV5-1	TRBJ2-2
TGCGCCAGCAGCCTATTGAACGAGCAGTACTTC	CASSLLNEQYF	TRBV5-1	TRBJ2-7
TGCCCCCGCGAGGGGACAGGTGAGCCTGCTTTCTTT	CPREGTGEPAFF	TRBV20-1	TRBJ1-1
TGTGCCAGCAGTTACTCGCCTATAGCGGGGCCAGATACGCAGTATTTT	CASSYSPIAGPDTQYF	TRBV6-5	TRBJ2-3
TGTGCCAGCAGTAGGGGAGCTCCAGCTAACTATGGCTACACCTTC	CASSRGAPANYGYTF	TRBV2	TRBJ1-2
TGTGCCAGCAGCCAAGATCTAGGACAGATCCGAGGGGTCACTGAAGCTTTCTTT	CASSQDLGQIRGVTEAFF	TRBV14	TRBJ1-1
TGCAGCGTTGCAGACAGGGCAACGATCGAGCAGTACTTC	CSVADRATIEQYF	TRBV29-1	TRBJ2-7
TGTGCCAGCAGCGGACTAGCGGGTTGGGCGCGCTCCTACGAGCAGTACTTC	CASSGLAGWARSYEQYF	TRBV6-5	TRBJ2-7
TGTGCCACCAGCAGCCCTCGGCAGTCTCCGGACAATCAGCCCCAGCATTTT	CATSSPRQSPDNQPQHF	TRBV15	TRBJ1-5
TGCAGTGCTAGAGAGACTGGCTACGAGCAGTACTTC	CSARETGYEQYF	TRBV20-1	TRBJ2-7
TGTGCCAGCAGCCTTGACAGTTGGAGTAGCAATCAGCCCCAGCATTTT	CASSLDSWSSNQPQHF	TRBV7-4	TRBJ1-5
TGCGCCAGCAGCCCTCTAGCGGGTTGCGGGGAGCTGTTTTTT	CASSPLAGCGELFF	TRBV4-3	TRBJ2-2
TGTGCCAGCAGCACCGGGACAGGCTACGAGCAGTACTTC	CASSTGTGYEQYF	TRBV7-2	TRBJ2-7
TGTGCCAGCACCCACAGGGGGGGTAGGCCCCAGCATTTT	CASTHRGGRPQHF	TRBV6-2	TRBJ1-5
TGTGCCAGCAGCTTAGCAGGGCGGTTAGAGACCCAGTACTTC	CASSLAGRLETQYF	TRBV11-3	TRBJ2-5
TGTGCCAGCAGCTTGGTCTGTCAACCTGGGGTCCAGAGGTTGTGGGGCTACACCTTC	CASSLVCQPGVQRLWGYTF	TRBV5-4	TRBJ1-2
TGCAGTGCTTTGGACACGGACCCCAGGCATCAGCCCCAGCATTTT	CSALDTDPRHQPQHF	TRBV20-1	TRBJ1-5
TGTGCCAGCAGCCCGAGGGAAAAACTGTTTTTT	CASSPREKLFF	TRBV12-4	TRBJ1-4
TGTGCCAGCAGTTTGCGGGAGACAACCTACGAGCAGTACTTC	CASSLRETTYEQYF	TRBV28	TRBJ2-7
TGCGCCAGCAGCTTGGTTGGGCGGAACGGGGAGCTGTTTTTT	CASSLVGRNGELFF	TRBV5-1	TRBJ2-2
TGTGCCAGCAGTTTAACTATAGGAGAGACCCAGTACTTC	CASSLTIGETQYF	TRBV12-4	TRBJ2-5
TGTGCCATCAGTATTAGGCATGACACTGAAGCTTTCTTT	CAISIRHDTEAFF	TRBV10-3	TRBJ1-1
TGTGCCAGCAGCCGAAAGGAGCGACTAGCGGTCGAAAACATTCAGTACTTC	CASSRKERLAVENIQYF	TRBV7-3	TRBJ2-4
TGTGCCAGCAGCGTAGAGGACTATAAGGATGAGCAGTTCTTC	CASSVEDYKDEQFF	TRBV9	TRBJ2-1
TGCGCCAGCCCCATAGCGGAGCAGTTCTTC	CASPIAEQFF	TRBV5-1	TRBJ2-1
TGTGCCAGCAGCTGGACCCCGCCCCAGCATTTT	CASSWTPPQHF	TRBV7-9	TRBJ1-5
TGTGCCACCAGTGATACAGAAGCGGGAAGCAATCAGCCCCAGCATTTT	CATSDTEAGSNQPQHF	TRBV24-1	TRBJ1-5
TGTGCCAGCAGCCTCACTTACACCACCGGGGAGCTGTTTTTT	CASSLTYTTGELFF	TRBV7-4	TRBJ2-2
TGTGCCAGTAGTATAGTCTATAGGGCGGGAGACCCAAACAATGAGCAGTTCTTC	CASSIVYRAGDPNNEQFF	TRBV19	TRBJ2-1
TGTGCCAGCAGCAACCGTAGAAATCACCAAGAGACCCAGTACTTC	CASSNRRNHQETQYF	TRBV7-9	TRBJ2-5
TGTGCCTGGAGGCGGATGAGGTCCCCCACTGAAGCTTTCTTT	CAWRRMRSPTEAFF	TRBV30	TRBJ1-1
TGTGCCAGCAGTTTTACATATCAGCCCCAGCATTTT	CASSFTYQPQHF	TRBV12-4	TRBJ1-5
TGTGCCAGCAGTGACCGGGACAGGGAGTGGGACTATGGCTACACCTTC	CASSDRDREWDYGYTF	TRBV2	TRBJ1-2
TGTGCCAGCAGTTACCCAGGGGGACTAGACACGAGCTCCTACAATGAGCAGTTCTTC	CASSYPGGLDTSSYNEQFF	TRBV6-6	TRBJ2-1
TGTGCCAGCAGCCAGGGGGGGGATCAGCCCCAGCATTTT	CASSQGGDQPQHF	TRBV11-3	TRBJ1-5
TGCAGTGCTTCTGGGGACAGGACCTACGAGCAGTACTTC	CSASGDRTYEQYF	TRBV20-1	TRBJ2-7
TGTGCCAGCAGCGTATCCGCAACCCTTGAGACCCAGTACTTC	CASSVSATLETQYF	TRBV9	TRBJ2-5
TGTGCCAGCAGCGTACTTCCATCAGCGGCCACCTACAATGAGCAGTTCTTC	CASSVLPSAATYNEQFF	TRBV9	TRBJ2-1
TGCGCCAGCGTCAGTTCGGACAGGGCTTCTAATGAAAAACTGTTTTTT	CASVSSDRASNEKLFF	TRBV10-1	TRBJ1-4
TGTGCCAGCAGCTTCCACCAGAGGGACACCGGGGAGCTGTTTTTT	CASSFHQRDTGELFF	TRBV7-4	TRBJ2-2
TGTGCCAGCAGTGGGGGCCGACAGGGGCATTGTATTGTAGCAACTAAAGATGAGCAGTTCTTC	CASSGGRQGHCIVATKDEQFF	TRBV27	TRBJ2-1
TGCGCCAGCAGCTTGGCCCAGAGGAATGAGCAGTTCTTC	CASSLAQRNEQFF	TRBV5-1	TRBJ2-1
TGTGCCAGCAGCCCGAACCTAGCGGGGGGTGAGCAGTTCTTC	CASSPNLAGGEQFF	TRBV7-3	TRBJ2-1
TGTGCCAGCAGCTCGAGGGCCAACAGGGAGCTGTTTTTT	CASSSRANRELFF	TRBV13	TRBJ2-2
TGTGCCAGCAGTTACGGACTAGCAAAAAACTACAATGAGCAGTTCTTC	CASSYGLAKNYNEQFF	TRBV6-5	TRBJ2-1
TGTGGGGATCAGCCCCAGCATTTT	CGDQPQHF	TRBV30	TRBJ1-5
TGTGCCAGCAGCTCTCAAAGGTCCCGGGACAGACAGTCACCCCTCCACTTT	CASSSQRSRDRQSPLHF	TRBV11-3	TRBJ1-6
TGCAGTGTAGCAGGGCACTACGAGCAGTACTTC	CSVAGHYEQYF	TRBV20-1	TRBJ2-7
TGCGCCAGCATATGTCAACAGGGCCTAATCTTGACCTACAATGAGCAGTTCTTC	CASICQQGLILTYNEQFF	TRBV4-3	TRBJ2-1
TGTGCCAGCAGTGCCGTGACAGGGCTCTATGGCTACACCTTC	CASSAVTGLYGYTF	TRBV6-1	TRBJ1-2
TGTGCCAGCAGTAGGGGGGACCACTATGGCTACACCTTC	CASSRGDHYGYTF	TRBV6-5	TRBJ1-2
TGTCCACCCGGGACCCCCTCCTACGAGCAGTACTTC	CPPGTPSYEQYF	TRBV30	TRBJ2-7
TGCGCCAGCAGCACTCGGGGTAGGGACACCGGGGAGCTGTTTTTT	CASSTRGRDTGELFF	TRBV5-1	TRBJ2-2
TGTGCCAGCAGCAGTAACAGGGTCAGGTACGAGCAGTACTTC	CASSSNRVRYEQYF	TRBV13	TRBJ2-7
TGTGCCAGCAGTTTGGACAGCTTGAGGTTAAACATTCAGTACTTC	CASSLDSLRLNIQYF	TRBV27	TRBJ2-4
TGTGCCAGCAGCCAAGATCGGGAGGGGCTGTCGAACACTGAAGCTTTCTTT	CASSQDREGLSNTEAFF	TRBV14	TRBJ1-1
TGTGCCAGCAGCGCCAACACCCTTACTAGCGGGAGGGACTACAATGAGCAGTTCTTC	CASSANTLTSGRDYNEQFF	TRBV5-4	TRBJ2-1
TGTGCCAGCAGTTACTGGGTTTCCAGGCGAGGGTATAATTCACCCCTCCACTTT	CASSYWVSRRGYNSPLHF	TRBV6-2	TRBJ1-6
TGCACCGGTACCCCTAGCGGTCGAGTTTCACGGACAGATACGCAGTATTTT	CTGTPSGRVSRTDTQYF	TRBV29-1	TRBJ2-3
TGTGCCAGCTGGGGGCAGGAGACTGAAGCTTTCTTT	CASWGQETEAFF	TRBV6-5	TRBJ1-1
TGTGCCACCAGTGACCCCGTCCTTGAAAAACTGTTTTTT	CATSDPVLEKLFF	TRBV24-1	TRBJ1-4
TGTGCCAGCAGCTTAGAGAGGGACAGGGTATGGGCCGAGCAGTACTTC	CASSLERDRVWAEQYF	TRBV11-3	TRBJ2-7
TGTGCCAGCAGTTACTCGAAAGGACAGAGCTCGGCTAGCACAGATACGCAGTATTTT	CASSYSKGQSSASTDTQYF	TRBV6-5	TRBJ2-3
TGCGCCAGCAGCTTGCTGAGGGGCGTGACGAACACTGAAGCTTTCTTT	CASSLLRGVTNTEAFF	TRBV5-1	TRBJ1-1
TGTGCCAGCAGAGTCACATTAAGAGGGAGGGAGTACCAAGAGACCCAGTACTTC	CASRVTLRGREYQETQYF	TRBV27	TRBJ2-5
TGTGCCAGCAGTCCCAGAGTCAGGGCCTCTGAAGCTTTCTTT	CASSPRVRASEAFF	TRBV2	TRBJ1-1
TGTGCCAGCAGGCGGTTCGATCCGGGACAGGGGCTCCAAGGATGCAATCAGCCCCAGCATTTT	CASRRFDPGQGLQGCNQPQHF	TRBV11-2	TRBJ1-5
TGTGCCAGCAGTTTTCTCCCAGGGCGCAATGAGCAGTTCTTC	CASSFLPGRNEQFF	TRBV27	TRBJ2-1
TGTGCCAGTAGTAGCTGGGAAAAGGGACTATACAATGAGCAGTTCTTC	CASSSWEKGLYNEQFF	TRBV19	TRBJ2-1
TGTGCCAGCAGCAATCGAGCCCAGGGCTATGGCTACACCTTC	CASSNRAQGYGYTF	TRBV5-4	TRBJ1-2
TGTGCCAGCGTGGAGAAGGGGACCGGGAATCAGCCCCAGCATTTT	CASVEKGTGNQPQHF	TRBV6-1	TRBJ1-5
TGTGCCAGCAGTGAGGGTCAGATTGGTCATGAGGGGACGAACACCGGGGAGCTGTTTTTT	CASSEGQIGHEGTNTGELFF	TRBV6-4	TRBJ2-2
TGTGCCAGCAGTGAGGAGGACACTGAAGCTTTCTTT	CASSEEDTEAFF	TRBV27	TRBJ1-1
TGCGCCAGCAGCTCCTGGGACAGGGAAGCTTTCTTT	CASSSWDREAFF	TRBV5-1	TRBJ1-1
TGTGCCCCGGTGGCGGAGAAGGGCACAGATACGCAGTATTTT	CAPVAEKGTDTQYF	TRBV6-4	TRBJ2-3
TGCAGTGGGAAGGGGGGGGGAGGGGCCAAAAACATTCAGTACTTC	CSGKGGGGAKNIQYF	TRBV20-1	TRBJ2-4
TGTGCCAGCAGCGTAGGCGCTCCTAGAATGGTTAACGAGCAGTACTTC	CASSVGAPRMVNEQYF	TRBV9	TRBJ2-7
TGCAGTGCTAGAGGTTGTAGACTAGAGGTTTACGAGCAGTACTTC	CSARGCRLEVYEQYF	TRBV20-1	TRBJ2-7
TGTGCCAGCTTTCTGGGGAATTCACCCCTCCACTTT	CASFLGNSPLHF	TRBV27	TRBJ1-6
TGTGCCAGCAGCCAACGAACGACTAGCGGGGGGGCGGAGGGGAGCTCCTACGAGCAGTACTTC	CASSQRTTSGGAEGSSYEQYF	TRBV4-2	TRBJ2-7
TGTGCCAGTAGTAACCCTAGGATTCTTGCTAACTATGGCTACACCTTC	CASSNPRILANYGYTF	TRBV19	TRBJ1-2
TGTGCCAGCAGCAAATTTCTAAATAACTCCTACGAGCAGTACTTC	CASSKFLNNSYEQYF	TRBV5-4	TRBJ2-7
TGTGCCAGCAGCCAGGGGGTTTCTGGTGAAGCTTTCTTT	CASSQGVSGEAFF	TRBV14	TRBJ1-1
TGTGCCAGCAGTTCCCCAGAAAAGGGACAGGGCAGAAGCAATCAGCCCCAGCATTTT	CASSSPEKGQGRSNQPQHF	TRBV27	TRBJ1-5
TGTGCCAGCAGCTTGTGTACTCCCCCCCGGGAGGGAACAGCGGACACCGGGGAGCTGTTTTTT	CASSLCTPPREGTADTGELFF	TRBV5-4	TRBJ2-2
TGTGCCAGCAGCCTTCAGGGGAACGGGCTCTACGAGCAGTACTTC	CASSLQGNGLYEQYF	TRBV13	TRBJ2-7
TGTGCCATCAGGTCACTAGCGAGGGAGACCCAGTACTTC	CAIRSLARETQYF	TRBV10-3	TRBJ2-5
TGTGCCAGCAGCTTCTCAGGCCGAAACTCGCGTTGGCGTCGCACAGATACGCAGTATTTT	CASSFSGRNSRWRRTDTQYF	TRBV7-9	TRBJ2-3
TGTGCCAGCAGCCACTCTCTCAGGGGAGGGGCTGGGTCGACTGAAGCTTTCTTT	CASSHSLRGGAGSTEAFF	TRBV14	TRBJ1-1
TGCGTAGAGGTCGATGGGAGAGAGACCCAGTACTTC	CVEVDGRETQYF	TRBV5-1	TRBJ2-5
TGTGCCAGCAGTGAAGACTACCTGACAGGGGAGTGCTCCTATAATTCACCCCTCCACTTT	CASSEDYLTGECSYNSPLHF	TRBV6-1	TRBJ1-6
TGTGCCAGCAGCTGGTCCCCACAGGGGGACTATGGCTACACCTTC	CASSWSPQGDYGYTF	TRBV11-2	TRBJ1-2
TGTGCCAGTGCAGGCCCTGAAGCTTTCTTT	CASAGPEAFF	TRBV6-5	TRBJ1-1
TGTGCCAGCAGCTCACGGGGCTTGGAGCGCCATGAAAAACTGTTTTTT	CASSSRGLERHEKLFF	TRBV11-3	TRBJ1-4
TGCGCCAGCAGCCAAGCTGGCTGGGAGGACTACGAGCAGTACTTC	CASSQAGWEDYEQYF	TRBV4-1	TRBJ2-7
TGTGCCAGCATTTCGACGGGACTCCACTTT	CASISTGLHF	TRBV7-9	TRBJ1-6
TGTGCCAGCAGTGACTCGAGTCCCAGGCTGGAGAACACTGAAGCTTTCTTT	CASSDSSPRLENTEAFF	TRBV6-4	TRBJ1-1
TGCAGTGCTCGGAAGATAGGGGCCAATCAGCCCCAGCATTTT	CSARKIGANQPQHF	TRBV20-1	TRBJ1-5
TGCGCCAGCAGCCGGGGGTGGGGTGCTAACTATGGCTACACCTTC	CASSRGWGANYGYTF	TRBV4-3	TRBJ1-2
TGTGCCAGCAGCTTAGCCCCAGGACAGGGAAGAAATAGCAATCAGCCCCAGCATTTT	CASSLAPGQGRNSNQPQHF	TRBV7-8	TRBJ1-5
TGCGCCAGCAGCTCTAGGGCGGAGTTAGGACAAGAGACCCAGTACTTC	CASSSRAELGQETQYF	TRBV5-1	TRBJ2-5
TGTGCCAGCTGTGGAAAGGAGCGGCTAAGGTTTTTGGATGTAGAGACCCAGTACTTC	CASCGKERLRFLDVETQYF	TRBV9	TRBJ2-5
TGCAGTGCTAGAGATTCCCTGGACCCGGGACAGGGGTCTGAGAACAATGAGCAGTTCTTC	CSARDSLDPGQGSENNEQFF	TRBV20-1	TRBJ2-1
TGTGCCAGCAGAATAGGGTTTGATGGCTACACCTTC	CASRIGFDGYTF	TRBV6-6	TRBJ1-2
TGTGCCAGCAGTTACTCGATGGACAGTGCTAACACAGATACGCAGTATTTT	CASSYSMDSANTDTQYF	TRBV6-5	TRBJ2-3
TGTGCCAGCAGACGGTTGGGACTAGCGGATGTCTTC	CASRRLGLADVF	TRBV3-1	TRBJ2-1
TGCGCCAGCAGCCTTAGGGGGCTGGGGCAGTACTTC	CASSLRGLGQYF	TRBV4-3	TRBJ2-7
TGTGCCAGCAGACCCCGGGACAGGGAGGACTCCTATGGCTACACCTTC	CASRPRDREDSYGYTF	TRBV3-1	TRBJ1-2
TGTGCCAGCAGTGGAAGGGGGCGCGCCGACTCTAACTATGGCTACACCTTC	CASSGRGRADSNYGYTF	TRBV6-5	TRBJ1-2
TGTGCCAGCAGTGCCCCAGCGGGATACGAGCAGTACTTC	CASSAPAGYEQYF	TRBV6-4	TRBJ2-7
TGTGCCAGCAGTGGGGGACAGGAAAAAGGCTACACCTTC	CASSGGQEKGYTF	TRBV12-4	TRBJ1-2
TGTGCCAGCAGCTTAAAGGGGACAGCTTTCTTT	CASSLKGTAFF	TRBV5-4	TRBJ1-1
TGTGCCAGCAGTTCTTCTATGGGCTACAATGAGCAGTTCTTC	CASSSSMGYNEQFF	TRBV28	TRBJ2-1
TGTGCCAGCAGCTTGCTAATTACAGGGCTGTGCACCTATGGCTACACCTTC	CASSLLITGLCTYGYTF	TRBV5-4	TRBJ1-2
TGTGCCAGCCTCCAACTAGGGGAGACCCAGTACTTC	CASLQLGETQYF	TRBV6-1	TRBJ2-5
TGTGCCAGCAGCATCCCCCCTTCCGAGACTTCTTCCTATAATTCACCCCTCCACTTT	CASSIPPSETSSYNSPLHF	TRBV5-4	TRBJ1-6
TGCGCCAGCAGCCAAGATGGGACTTGGGGGGACAATGAGCAGTTCTTC	CASSQDGTWGDNEQFF	TRBV4-1	TRBJ2-1
TGCAGCGTCAGCTACGAGCAGTACTTC	CSVSYEQYF	TRBV29-1	TRBJ2-7
TGTGCCAGCAGCTTACGCGCCAGTACCTACGAGCAGTACTTC	CASSLRASTYEQYF	TRBV5-4	TRBJ2-7
TGTGCCAGCAGTTACAACAGGGGTCGGAAGGCGAACACTGAAGCTTTCTTT	CASSYNRGRKANTEAFF	TRBV6-5	TRBJ1-1
TGCAGTGCTAGAGATTTCACCGGCCTCACGAAGGGCGTGGGCCGGGAGAGCCCCAACACCGGGGAGCTGTTTTTT	CSARDFTGLTKGVGRESPNTGELFF	TRBV20-1	TRBJ2-2
TGTGCCAGCAGCCAAGCCGCAGGGGGGACTGAAGCTTTCTTT	CASSQAAGGTEAFF	TRBV14	TRBJ1-1
TGTGCCAGCTCACATGGACTTCAGCCCCAGCATTTT	CASSHGLQPQHF	TRBV18	TRBJ1-5
TGTGGAACATTCGGGACAGCGGCCTATGGCTACACCTTC	CGTFGTAAYGYTF	TRBV6-4	TRBJ1-2
TGTGCCAGCAGTTTCTTGCGAGAGGGACTAGCGGGAAGAGAGCAGTACTTC	CASSFLREGLAGREQYF	TRBV12-4	TRBJ2-7
TGTGCCAGCAGCTGGCCTAAGAAAGAGACCCAGTACTTC	CASSWPKKETQYF	TRBV14	TRBJ2-5
TGTGCCAGCAGTTTCGATGACTCCAGGGGGCCGAACCCTAACACCGGGGAGCTGTTTTTT	CASSFDDSRGPNPNTGELFF	TRBV27	TRBJ2-2
TGTGCCAGCAGTTTGACCCCAGGGACAGTCAAACCCCTGGTAGGGGCCAACGTCCTGACTTTC	CASSLTPGTVKPLVGANVLTF	TRBV28	TRBJ2-6
TGTGCCAGCAGCATACCCCCGGGACAGGACCTCTACGAGCAGTACTTC	CASSIPPGQDLYEQYF	TRBV6-1	TRBJ2-7
TGTGCCAGCAGCCCCGGGGATGAGAATTCACCCCTCCACTTT	CASSPGDENSPLHF	TRBV12-4	TRBJ1-6
TGCAGTCTGTTGAGGGGGAGAACCACCCTCCACTTT	CSLLRGRTTLHF	TRBV20-1	TRBJ1-6
TGTGCCAGCAGTAAGGACAGGGCTTGGAGCTCCTACAATGAGCAGTTCTTC	CASSKDRAWSSYNEQFF	TRBV6-1	TRBJ2-1
TGCGCCAGCAAGGGAGTTTTAGGGACTAGCGCCGGGGAGCAGTACTTC	CASKGVLGTSAGEQYF	TRBV10-1	TRBJ2-7
TGCAGTGCTGGAGGACCGGGACAGACGAACTATGGCTACACCTTC	CSAGGPGQTNYGYTF	TRBV20-1	TRBJ1-2
TGTGCCAGCAGCTTAGGAGTGGAGGAGATTTCTAATGAAAAACTGTTTTTT	CASSLGVEEISNEKLFF	TRBV13	TRBJ1-4
TGTGCCAGTAGTGAGCGTCTAAGCACCGGTGAAAAACTGTTTTTT	CASSERLSTGEKLFF	TRBV19	TRBJ1-4
TGCAGTGCTGTCACAGGGAAAAACATTCAGTACTTC	CSAVTGKNIQYF	TRBV20-1	TRBJ2-4
TGTGCCAGCCGGGATCAGCCCCAGCATTTT	CASRDQPQHF	TRBV27	TRBJ1-5
TGCGCCAGCAGTGAACGGTACAGGGGGGACACTGAAGCTTTCTTT	CASSERYRGDTEAFF	TRBV10-1	TRBJ1-1
TGTGCCAGGGTCAGGATCGAGACCCAGTACTTC	CARVRIETQYF	TRBV19	TRBJ2-5
TGTGCCAGCAGCTTACAGGGACAGGGAAAGAGAAATCAGCCCCAGCATTTT	CASSLQGQGKRNQPQHF	TRBV13	TRBJ1-5
TGTGCCAGCAGCTTTTCCCGGGACAGCCTCTACGAGCAGTACTTC	CASSFSRDSLYEQYF	TRBV9	TRBJ2-7
TGTGCCAGCAGAAAGCCCACCAGTCCGCCCTCCCAGTACTTC	CASRKPTSPPSQYF	TRBV7-4	TRBJ2-5
TGTGCCAGCAGTTACTCAGAGCCCCAGCATTTT	CASSYSEPQHF	TRBV6-2	TRBJ1-5
TGTGCCAGCAGTTACGGGACAGGAGAACACGACACCTATGGCTACACCTTC	CASSYGTGEHDTYGYTF	TRBV6-5	TRBJ1-2
TGCGCCAGCAGCCGGACGAACTTTAGGAATAGGGATGAGCAGTTCTTC	CASSRTNFRNRDEQFF	TRBV4-1	TRBJ2-1
TGTGCCAGCAGCAAGTCGCCGTCCTACGAGCAGTACTTC	CASSKSPSYEQYF	TRBV11-3	TRBJ2-7
TGTGCCAGCAGCCACCCGGGACTTCTCTGGGACTACGAGCAGTACTTC	CASSHPGLLWDYEQYF	TRBV3-1	TRBJ2-7
TGTGCCAGCAGCCAAGCCGGATGGGGACTAGCGGGAACCCGTCAAGAGACCCAGTACTTC	CASSQAGWGLAGTRQETQYF	TRBV14	TRBJ2-5
TGTGCCAGCAGTTTAGAACCAGGGCATCAGCCCCAGCATTTT	CASSLEPGHQPQHF	TRBV27	TRBJ1-5
TGTGCCAGCAGCCAAGATACGGGGGCGCTCCGTGCCGGGGAGCTGTTTTTT	CASSQDTGALRAGELFF	TRBV14	TRBJ2-2
TGTGCCAGCGTATCCATCCAACACTATAATTCACCCCTCCACTTT	CASVSIQHYNSPLHF	TRBV28	TRBJ1-6
TGTGCCAGCAGTTTTTCAGGACAGGTGAACTATGGCTACACCTTC	CASSFSGQVNYGYTF	TRBV6-5	TRBJ1-2
TGTGCCAGCAGTCTGACTAGCGGGGGGTTAGAGACCCAGTACTTC	CASSLTSGGLETQYF	TRBV27	TRBJ2-5
TGTGCCACCAGCAGGGGGACCGTAGAGACCCAGTACTTC	CATSRGTVETQYF	TRBV15	TRBJ2-5
TGTGCCAGCAGCCAAGCTCACTCCGCGGGAGGAGGGGCCTATAGCAATCAGCCCCAGCATTTT	CASSQAHSAGGGAYSNQPQHF	TRBV3-1	TRBJ1-5
TGTGCCAGCAGTACGGGCAATGAAAAACTGTTTTTT	CASSTGNEKLFF	TRBV6-5	TRBJ1-4
TGTGCCAGCAGCTGGAGTGACAGGGGTCAGACCCAGTACTTC	CASSWSDRGQTQYF	TRBV7-9	TRBJ2-5
TGTGCCAGCAGCTTACCGCCGGGACATGATGGCTACACCTTC	CASSLPPGHDGYTF	TRBV7-9	TRBJ1-2
TGTGCCAGTAGTATGGGGGCAGGTGGCACTGAAGCTTTCTTT	CASSMGAGGTEAFF	TRBV19	TRBJ1-1
TGTGCCATCCAAGCTAGAGGGGGCACTATGAACGAGCAGTACTTC	CAIQARGGTMNEQYF	TRBV10-3	TRBJ2-7
TGTGCCAGCAGTGAAGGGGGGCGCTTAGGCACTGAAGCTTTCTTT	CASSEGGRLGTEAFF	TRBV6-1	TRBJ1-1
TGTGCCCCCATGCGCCTATTTGGTTCTAACTATGGCTACACCTTC	CAPMRLFGSNYGYTF	TRBV24-1	TRBJ1-2
TGTGCCAGCAGTGTCTATCGGGGGACGTCCTACAATGAGCAGTTCTTC	CASSVYRGTSYNEQFF	TRBV25-1	TRBJ2-1
TGTGCCAGCATTTTCCCTCAAGGGGATGTCGAGCAGTACTTC	CASIFPQGDVEQYF	TRBV6-5	TRBJ2-7
TGTGCCAGCAGCGTACCATTAAGGTTGGAGCAGTACTTC	CASSVPLRLEQYF	TRBV9	TRBJ2-7
TGTGCCAGCAGCCAAATACTTCGAGAGGTCTACGAGCAGTACTTC	CASSQILREVYEQYF	TRBV14	TRBJ2-7
TGCGCCAGCAGCTTCGACCGATGGTCCTACAATGAGCAGTTCTTC	CASSFDRWSYNEQFF	TRBV5-1	TRBJ2-1
TGCAGTGCTAGAGATCAGACTAGCGAGCAGTACTTC	CSARDQTSEQYF	TRBV20-1	TRBJ2-7
TGTGCTAGCAGCTTAGCGAAGAGATACGACTACGAGCAGTACTTC	CASSLAKRYDYEQYF	TRBV7-7	TRBJ2-7
TGTGCCAGCAGTTGGGGGAACACCGGGGAGCTGTTTTTT	CASSWGNTGELFF	TRBV6-5	TRBJ2-2
TGTGCTAGTGGTTTGGTACCTTCAAGTCTGGGTTTTCATAGCAATCAGCCCCAGCATTTT	CASGLVPSSLGFHSNQPQHF	TRBV12-5	TRBJ1-5
TGTGCCAGCAGCTTTCTTCTGTTTATGGCCAGGGGCACAGATACGCAGTATTTT	CASSFLLFMARGTDTQYF	TRBV7-4	TRBJ2-3
TGTGCCAGCAGCAAGGGGGACCTTCAGCCCCAGCATTTT	CASSKGDLQPQHF	TRBV7-2	TRBJ1-5
TGTGCCAGCAGCCTTGGGGACTCGGGAGAGCAGTTCTTC	CASSLGDSGEQFF	TRBV7-2	TRBJ2-1
TGTGCCAGCAGCTTAACGGGAAGTGAGTACACCGGGGAGCTGTTTTTT	CASSLTGSEYTGELFF	TRBV7-9	TRBJ2-2
TGTGCCACCAGTGAGTCGCGACAGGGGTACTCAACTAATGAAAAACTGTTTTTT	CATSESRQGYSTNEKLFF	TRBV24-1	TRBJ1-4
TGTGCCAGCACCAAGCAACCGTTGGGACGTAGTGGTCAAGAGACCCAGTACTTC	CASTKQPLGRSGQETQYF	TRBV28	TRBJ2-5
TGCGCCAGCAGCTTGCGACAGCCCGTGAACACTGAAGCTTTCTTT	CASSLRQPVNTEAFF	TRBV5-1	TRBJ1-1
TGTGCCAGCAGCGCCCGGGGCGACGGCAATCAGCCCCAGCATTTT	CASSARGDGNQPQHF	TRBV3-1	TRBJ1-5
TGTGCCAGCAGCTTAGACGACAGGGATTATCAGCCCCAGCATTTT	CASSLDDRDYQPQHF	TRBV11-2	TRBJ1-5
TGTGCCAGTAGTATAGGGCCCAGGGTTAAGAGCAATCAGCCCCAGCATTTT	CASSIGPRVKSNQPQHF	TRBV19	TRBJ1-5
TGCAGTGCATTGGAAGGGGGCTCTAGATCCCACGAGCAGTACTTC	CSALEGGSRSHEQYF	TRBV20-1	TRBJ2-7
TGCGCCAGCAGCCGCCGACTAGCGGGAGCCTCCACTGAAGCTTTCTTT	CASSRRLAGASTEAFF	TRBV5-1	TRBJ1-1
TGCGCCAGCAGCCAAGCGGGAGCGGGGGCAGATACGCAGTATTTT	CASSQAGAGADTQYF	TRBV5-1	TRBJ2-3
TGTGCCAGCAGTTTTCGGTCAGGGGACACTGAAGCTTTCTTT	CASSFRSGDTEAFF	TRBV28	TRBJ1-1
TGTGCCAGCTACCCGGCGTTTAATTTCCCCGGGGAGCTGTTTTTT	CASYPAFNFPGELFF	TRBV18	TRBJ2-2
TGTGCCAGCAGTGACGGGGGGGGGCGACGGAGTGGTCAAGAGACCCAGTACTTC	CASSDGGGRRSGQETQYF	TRBV6-4	TRBJ2-5
TGCGCCAGCAGTGTCCGAATTCAGCTGAGCTACGAGCAGTACTTC	CASSVRIQLSYEQYF	TRBV10-2	TRBJ2-7
TGTGCCACCAGTGATGAGTACCCCGTAAAATCAGGGGCTAATGAAAAACTGTTTTTT	CATSDEYPVKSGANEKLFF	TRBV24-1	TRBJ1-4
TGTGCCAGCAGTTTATCTACAATCACCTCAGCGAGGGGCGGGGAGCCCCAGCATTTT	CASSLSTITSARGGEPQHF	TRBV27	TRBJ1-5
TGTGCCAGCACGCGGGGGGCCGGTAACACTGAAGCTTTCTTT	CASTRGAGNTEAFF	TRBV6-4	TRBJ1-1
TGTGCCAGCAGCTTCCGGCCGGGACGGAGGGAGCTGTTTTTT	CASSFRPGRRELFF	TRBV7-2	TRBJ2-2
TGCAGCGTGGGGGGGCGGTACAATGAGCAGTTCTTC	CSVGGRYNEQFF	TRBV29-1	TRBJ2-1
TGTGCCAGCAGTTATAAAGCGACTAGGGGTCCCTACGAGCAGTACTTC	CASSYKATRGPYEQYF	TRBV6-6	TRBJ2-7
TGCGCCAGCAGCGGAATCTCTCCGGGAGCCTTCAATGAGCAGTTCTTC	CASSGISPGAFNEQFF	TRBV5-1	TRBJ2-1
TGTGCCAGCAGTGAGGCACGCAAATGGGGGACAACTAATGAAAAACTGTTTTTT	CASSEARKWGTTNEKLFF	TRBV6-1	TRBJ1-4
TGCAGTGCTCGGGGGACGGATGGCTACACCTTC	CSARGTDGYTF	TRBV20-1	TRBJ1-2
TGTGCCCCTCAGGACAGAGGCTACACCTTC	CAPQDRGYTF	TRBV27	TRBJ1-2
TGTGCCAGCTCACCATTCGCTTGTAGATCAGATACGCAGTATTTT	CASSPFACRSDTQYF	TRBV18	TRBJ2-3
TGTGCCAGCAGCTTGAGAGGGACAGGGGGGGGCTACAATGAGCAGTTCTTC	CASSLRGTGGGYNEQFF	TRBV11-3	TRBJ2-1
TGTGCCAGCAGCTTGCGTTTCGGGGGTCCCGGCCACGAGCAGTACTTC	CASSLRFGGPGHEQYF	TRBV7-4	TRBJ2-7
TGTGCCAGCACCGACCAAGAGACCCAGTACTTC	CASTDQETQYF	TRBV7-2	TRBJ2-5
TGTGCCAGCAGTGAATATGACAGGCGGGGAGAAGCTTTCTTT	CASSEYDRRGEAFF	TRBV6-1	TRBJ1-1
TGTGCCAGCAGGAGACTGGGACAATCACCCCTCCACTTT	CASRRLGQSPLHF	TRBV28	TRBJ1-6
TGCGCCAGCAGCTTCGAGGGCACTGAAGCTTTCTTT	CASSFEGTEAFF	TRBV5-1	TRBJ1-1
TGTGCCAGCAGTTACGCACCCTCTACGGACATCAGTAACACAGATACGCAGTATTTT	CASSYAPSTDISNTDTQYF	TRBV6-6	TRBJ2-3
TGTGCCAGCAGCCCCGGCCGGGACAGTAGAAACACCGGGGAGCTGTTTTTT	CASSPGRDSRNTGELFF	TRBV5-6	TRBJ2-2
TGCGCCAGCACCGATAAAGGCCCCTACAATGAGCAGTTCTTC	CASTDKGPYNEQFF	TRBV10-1	TRBJ2-1
TGTGCCAGCAGCTTAGATGGAGGCTCCTACGAGCAGTACTTC	CASSLDGGSYEQYF	TRBV11-2	TRBJ2-7
TGCAGTGCTAGTCATCAGGGCAGATACAATGAGCAGTTCTTC	CSASHQGRYNEQFF	TRBV20-1	TRBJ2-1
TGTGCCAGCAGCTTCGTGGGGGGGCCGTACGAGCAGTACTTC	CASSFVGGPYEQYF	TRBV13	TRBJ2-7
TGTGCCAGCAGCCTAATCTGGCGGACTATTGTAGGGTCTGAAAAACTGTTTTTT	CASSLIWRTIVGSEKLFF	TRBV4-2	TRBJ1-4
TGTGCCACCAGTGATTTACCGATCCGACAACTCTCGGGCTACACCTTC	CATSDLPIRQLSGYTF	TRBV24-1	TRBJ1-2
TGTGCCAGCAGCAATAAAACAGGAACCTATAATTCACCCCTCCACTTT	CASSNKTGTYNSPLHF	TRBV13	TRBJ1-6
TGTGCCAGTCCCCGACAGGGGTGCAATCAGCCCCAGCATTTT	CASPRQGCNQPQHF	TRBV11-2	TRBJ1-5
TGCAGCGGACACAGGGCTTTGAACACTGAAGCTTTCTTT	CSGHRALNTEAFF	TRBV29-1	TRBJ1-1
TGCGCCAGCAGCACCGGGACAGGGGGCAGCGGCACTGAAGCTTTCTTT	CASSTGTGGSGTEAFF	TRBV10-1	TRBJ1-1
TGTGCCAGCATGCGTTCCAGGGTTAGCAATCAGCCCCAGCATTTT	CASMRSRVSNQPQHF	TRBV11-2	TRBJ1-5
TGTGCCAGCAGCTCACTGCAAGGCCTCCCGGGCAGTCTCTACAATGAGCAGTTCTTC	CASSSLQGLPGSLYNEQFF	TRBV11-2	TRBJ2-1
TGTGCCAGCAGCTTAGAGACCCAGGGGCCCAATTCACCCCTCCACTTT	CASSLETQGPNSPLHF	TRBV7-9	TRBJ1-6
TGTGCCAGCAGTTGGGCTAGGGCTAGCCTAGACTCCTACGAGCAGTACTTC	CASSWARASLDSYEQYF	TRBV2	TRBJ2-7
TGTGCCAGCCGGCCGGGGCCTTGTGGGACAGCCAAAAACATTCAGTACTTC	CASRPGPCGTAKNIQYF	TRBV25-1	TRBJ2-4
TGTGCCAGCAGCGGAATTCATGGGCCGGACAGGTCTGGCCTCTCGCCCAATCAGCCCCAGCATTTT	CASSGIHGPDRSGLSPNQPQHF	TRBV9	TRBJ1-5
TGTGCCAGCAGCTGGGACAGGGCTTTAGGGAAGGACATTCAGTACTTC	CASSWDRALGKDIQYF	TRBV7-2	TRBJ2-4
TGTGCCTGGAGTGTACGTGGATTAGTAGCGGAGCTCTTC	CAWSVRGLVAELF	TRBV30	TRBJ2-1
TGTGCCAGCAGTGCGACTAGGAGAAAAGGCTCCTACGAGCAGTACTTC	CASSATRRKGSYEQYF	TRBV12-3	TRBJ2-7
TGTGCCAGAGGAGGGACTAACTATGGCTACACCTTC	CARGGTNYGYTF	TRBV19	TRBJ1-2
TGTGCCAGCAGCTACGGGGGCACCTATGGCTACACCTTC	CASSYGGTYGYTF	TRBV5-8	TRBJ1-2
TGTGCCAGCAGTTTCGGGCAAGATAGCAATCAGCCCCAGCATTTT	CASSFGQDSNQPQHF	TRBV28	TRBJ1-5
TGTGCCAGCAGCTTGAGATTTAATCGGGGCCCCAATCAGCCCCAGCATTTT	CASSLRFNRGPNQPQHF	TRBV13	TRBJ1-5
TGTGCCAAGGCGCGGTGGAATGAGCAGTTCTTC	CAKARWNEQFF	TRBV12-3	TRBJ2-1
TGTGCCGCTTCGCAGGTCCAGGAAAAACTGTTTTTT	CAASQVQEKLFF	TRBV27	TRBJ1-4
TGTGCCACCGTGGGACAGGGCCTCACCATATATTTT	CATVGQGLTIYF	TRBV28	TRBJ1-3
TGCAGCGTGGACCACAAGGACAGGGCCAAGGAAAAACTGTTTTTT	CSVDHKDRAKEKLFF	TRBV29-1	TRBJ1-4
TGTGCCAGCACCACAGCTAAGAATCGGTACAATGAGCAGTTCTTC	CASTTAKNRYNEQFF	TRBV5-4	TRBJ2-1
TGTGCCAACTTACTAGCGGGAGATACAGATACGCAGTATTTT	CANLLAGDTDTQYF	TRBV6-5	TRBJ2-3
TGTGCCAGCAGCTTAACCCGCAGCCTGGGAGGAACTACAAATTCACCCCTCCACTTT	CASSLTRSLGGTTNSPLHF	TRBV7-2	TRBJ1-6
TGTGCCAGAAGCACAGGGGGCGGGTATGGCTACACCTTC	CARSTGGGYGYTF	TRBV6-5	TRBJ1-2
TGTGCCAGCAGCAGGGACAGGGGAAGCTATGGCTACACCTTC	CASSRDRGSYGYTF	TRBV28	TRBJ1-2
TGTGCCAGCAGCCAGTATGCTAGCGGTGGAAAATACGAGCAGTACTTC	CASSQYASGGKYEQYF	TRBV3-1	TRBJ2-7
TGTGCCAGCAGCGTAGTACTAGACGCCTCCGGATCTGAAGCTTTCTTT	CASSVVLDASGSEAFF	TRBV9	TRBJ1-1
TGTGCCAGCAGCAAGCGCTGGGGGGCCAAGATGAACACTGAAGCTTTCTTT	CASSKRWGAKMNTEAFF	TRBV13	TRBJ1-1
TGCGCCAGCAACTTGTATGGACAGTCGGGCACAGATACGCAGTATTTT	CASNLYGQSGTDTQYF	TRBV5-1	TRBJ2-3
TGTGCCAGCAGCTTTGCTACCGGCATGCAGTTCTTC	CASSFATGMQFF	TRBV11-3	TRBJ2-1
TGTGCCAGCAGTTTTACAGGAAGCACAGATACGCAGTATTTT	CASSFTGSTDTQYF	TRBV12-4	TRBJ2-3
TGTGCCAGCAGTTATACTAGCGGGAGAACCTACGAGCAGTACTTC	CASSYTSGRTYEQYF	TRBV28	TRBJ2-7
TGTGCCGCCCCTGGGACGGCGACCCTCCACTTT	CAAPGTATLHF	TRBV27	TRBJ1-6
TGTGCCAGCAACCACCGACAGGCTGAAGCTTTCTTT	CASNHRQAEAFF	TRBV11-2	TRBJ1-1
TGTGCCAGCAGCTTGAGGCTCCACTATGGCTACACCTTC	CASSLRLHYGYTF	TRBV5-8	TRBJ1-2
TGTGCCAGCAGCCGGAGACGTTTTCAGCCCCAGCATTTT	CASSRRRFQPQHF	TRBV14	TRBJ1-5
TGTGCCAGCAGCTTATGGACTAGCACAGATACGCAGTATTTT	CASSLWTSTDTQYF	TRBV5-4	TRBJ2-3
TGTGCCAGCAGCGACGCCACGGGACTATGTACGAACACTGAAGCTTTCTTT	CASSDATGLCTNTEAFF	TRBV14	TRBJ1-1
TGTGCCAGCAGCTTAGACCTCGGAACGAGCTCCTACAATGAGCAGTTCTTC	CASSLDLGTSSYNEQFF	TRBV7-4	TRBJ2-1
TGTGCCAGCAGCCAAGATCCAGATCCGGACAGTTCACCCCTCCACTTT	CASSQDPDPDSSPLHF	TRBV4-2	TRBJ1-6
TGTGCCAGCAGCCCGACTAGTAAAGTTATCTCCTACGAGCAGTACTTC	CASSPTSKVISYEQYF	TRBV11-1	TRBJ2-7
TGTGCCAGCAGCTTAAAGATGGGACAGGGGGGCTACACCTTC	CASSLKMGQGGYTF	TRBV7-3	TRBJ1-2
TGTGCCAGCAGTTCCCCCGGGACTAAGGAGAACTATGGCTACACCTTC	CASSSPGTKENYGYTF	TRBV27	TRBJ1-2
TGTGCCAGCAATAAAAAGATAATCCCCCAGCCCGCCTCTGGGGCCAACGTCCTGACTTTC	CASNKKIIPQPASGANVLTF	TRBV6-4	TRBJ2-6
TGCCTAGTGGGACAGGGCGGGCCGTTTTCTGGAAACACCATATATTTT	CLVGQGGPFSGNTIYF	TRBV20-1	TRBJ1-3
TGCGCCAGCAATCATTTCGGGGGTGAGCAGTTCTTC	CASNHFGGEQFF	TRBV10-1	TRBJ2-1
TGTGCCAGCAGCTTGCGTCCCGGTACGGGACAGGGGCACACCTCCTACGAGCAGTACTTC	CASSLRPGTGQGHTSYEQYF	TRBV5-6	TRBJ2-7
TGTGCCAGCAGCTTCCGTCAGCCACAGGGGGACTATGGCTACACCTTC	CASSFRQPQGDYGYTF	TRBV7-9	TRBJ1-2
TGTGCCAGCAGTTATCGCTTAGGGGGTAAATTAAAGCCCCAGCATTTT	CASSYRLGGKLKPQHF	TRBV6-6	TRBJ1-5
TGTGCCAGTTTGCGGGAGGCCTACAATGAGCAGTTCTTC	CASLREAYNEQFF	TRBV27	TRBJ2-1
TGTGCCAGCTCGGGGGGGGGCCCGGATACGCAGTATTTT	CASSGGGPDTQYF	TRBV27	TRBJ2-3
TGTGCCAGCAGCTGGGAATTGACAGGAGATACGCAGTATTTT	CASSWELTGDTQYF	TRBV7-3	TRBJ2-3
TGCGCCAGCAGCTTCTTAGGCTATACGCAGTATTTT	CASSFLGYTQYF	TRBV5-1	TRBJ2-3
TGTGCCAGCAGCTTGCGAGTTGGGCTAGAGCAGTACTTC	CASSLRVGLEQYF	TRBV5-6	TRBJ2-7
TGTGCCAGCAGCTTCGCCACTGGAAACACCATATATTTT	CASSFATGNTIYF	TRBV7-4	TRBJ1-3
TGCGCCAGCAGCGCGGGGGGGGCCGCCTACGAGCAGTACTTC	CASSAGGAAYEQYF	TRBV10-1	TRBJ2-7
TGTGCCACCAGTGATTTCGGACAGGGGGTCCAGTGGGTCTACGAGCAGTACTTC	CATSDFGQGVQWVYEQYF	TRBV24-1	TRBJ2-7
TGTGCCAGCAGCGGTAAAAGGGATGATGAAAAACTGTTTTTT	CASSGKRDDEKLFF	TRBV13	TRBJ1-4
TGTGCCAGTATGGCGTGCCCACAACAGGTCCCCTCTAATGAAAAACTGTTTTTT	CASMACPQQVPSNEKLFF	TRBV19	TRBJ1-4
TGTGCCACCAGGCGGAGATACGAGCAGTACTTC	CATRRRYEQYF	TRBV24-1	TRBJ2-7
TGTGCCAGCAGACGCAGGGGCTACACCTTC	CASRRRGYTF	TRBV28	TRBJ1-2
TGCGCCAGCAGCTTGGGCAGGGCTGGCTACACCTTC	CASSLGRAGYTF	TRBV5-1	TRBJ1-2
TGCGCCAGCAGCCACCGGCGACTAGTTACTTTCGATCCCCAGTACTTC	CASSHRRLVTFDPQYF	TRBV4-1	TRBJ2-5
TGCGCCAGCAGCCAAGATCGTCCGGGACTTATTGAATACGAGCAGTACTTC	CASSQDRPGLIEYEQYF	TRBV4-1	TRBJ2-7
TGTGCCATTAAGCCGGGCACCCTACTGGGATCGATCTCCTACGAGCAGTACTTC	CAIKPGTLLGSISYEQYF	TRBV6-5	TRBJ2-7
TGTGCCAGCAGCTTTGGGGGAGAGACCCAGTACTTC	CASSFGGETQYF	TRBV5-4	TRBJ2-5
TGTGCCAGCAGAGACCATAATGGGACTCCTGGCAAATACACCGGGGAGCTGTTTTTT	CASRDHNGTPGKYTGELFF	TRBV6-2	TRBJ2-2
TGCGCCAGCAGCTGCCGCAGGGGGGAATGGTCCTACGAGCAGTACTTC	CASSCRRGEWSYEQYF	TRBV5-1	TRBJ2-7
TGTGCCAGCAGCTTTCTCAATACCGGTACTAGACAATACGAGCAGTACTTC	CASSFLNTGTRQYEQYF	TRBV7-2	TRBJ2-7
TGTGCCAGCAGCTCAGAGGTTTTCCATAGCAATCAGCCCCAGCATTTT	CASSSEVFHSNQPQHF	TRBV28	TRBJ1-5
TGCGCCAGCAGTGCTCAATCCGGGACAGGCAAAAAATATAAGGAGACCCAGTACTTC	CASSAQSGTGKKYKETQYF	TRBV10-1	TRBJ2-5
TGTGCCAGCAGGTTCGGACTAGCGGCGCGAAGACGGAACACCGGGGAGCTGTTTTTT	CASRFGLAARRRNTGELFF	TRBV6-4	TRBJ2-2
TGTGCCAGCAGCGACGCAGGCAGGAACACTGAAGCTTTCTTT	CASSDAGRNTEAFF	TRBV7-9	TRBJ1-1
TGTGCCAGCAGCACGAGCCGGGGACAAGAGACCCAGTACTTC	CASSTSRGQETQYF	TRBV9	TRBJ2-5
TGTGCCAGCAGAAGTTGGACTCCAGGAAACTATGGCTACACCTTC	CASRSWTPGNYGYTF	TRBV11-3	TRBJ1-2
TGTGCCAGTAGTGGGCGGACACGTACTTCCTACGAGCAGTACTTC	CASSGRTRTSYEQYF	TRBV19	TRBJ2-7
TGCAGTGCTAGGGTCGAGAGGGACAGGGCGGAAATACCCTACGAGCAGTACTTC	CSARVERDRAEIPYEQYF	TRBV20-1	TRBJ2-7
TGTGCCAGAAGTGGGACGGGACAGGCTGGTAACTATGGCTACACCTTC	CARSGTGQAGNYGYTF	TRBV6-4	TRBJ1-2
TGCAGCGTTGTCCGGGACAGTGGTAGCAATCAGCCCCAGCATTTT	CSVVRDSGSNQPQHF	TRBV29-1	TRBJ1-5
TGTGCCAGCACCAGGCACTACGAGCAGTACTTC	CASTRHYEQYF	TRBV27	TRBJ2-7
TGTGCCAGCAGCTTGGCCGGAGCGGAAGATAACACCGGGGAGCTGTTTTTT	CASSLAGAEDNTGELFF	TRBV5-6	TRBJ2-2
TGTGCCAGCAGCGGTGGACAGGGTGTGATCTCTGGAAACACCATATATTTT	CASSGGQGVISGNTIYF	TRBV7-3	TRBJ1-3
TGTGCCAGCAGCCCTCCGACAGGGCCATTTCACGAGCAGTACTTC	CASSPPTGPFHEQYF	TRBV7-3	TRBJ2-7
TGTGCCAGCAAGCTCAATGAGCAGTTCTTC	CASKLNEQFF	TRBV5-6	TRBJ2-1
TGTGCCAGCAACATGGGACAGGGTTGGTTGTACACTGAAGCTTTCTTT	CASNMGQGWLYTEAFF	TRBV6-1	TRBJ1-1
TGTGCCTGGAGTGTAGTCCCCTCCCGAAACAGGGGAGCGCAGTATTTT	CAWSVVPSRNRGAQYF	TRBV30	TRBJ2-3
TGTGCCAGCAGCTTAGCGGAGGGTATCTCCTACGAGCAGTACTTC	CASSLAEGISYEQYF	TRBV7-2	TRBJ2-7
TGTGCCAGCAGTTTTTGCAGAACGGGAGGAGCGGGCTCCTACGAGCAGTACTTC	CASSFCRTGGAGSYEQYF	TRBV27	TRBJ2-7
TGTGCCAGCAGCGGAGGCGGGAGTTGCCAGTACTTC	CASSGGGSCQYF	TRBV9	TRBJ2-5
TGTGCCAGCAGCCAAGAGGGGGGAAGACTAGCCACAGATACGCAGTATTTT	CASSQEGGRLATDTQYF	TRBV4-2	TRBJ2-3
TGTGCCAGCAGTGAAAAGGAGGAGAAAGTAAATGGCTACACCTTC	CASSEKEEKVNGYTF	TRBV6-1	TRBJ1-2
TGTGCCACCAGTGATTTGACCGGGGCTGAAGCTTTCTTT	CATSDLTGAEAFF	TRBV24-1	TRBJ1-1
TGTGCCAGCAAGACAAACAGGGCTCCCGACTATAATTCACCCCTCCACTTT	CASKTNRAPDYNSPLHF	TRBV12-3	TRBJ1-6
TGTGCCAGCAGTGTTCTCTTTCTGGGGGGGCGGGTGTACGAGCAGTACTTC	CASSVLFLGGRVYEQYF	TRBV28	TRBJ2-7
TGTGCCAGCAGTGAATACCGGATAGACAGGGTCGGAAGCTCCTACGAGCAGTACTTC	CASSEYRIDRVGSSYEQYF	TRBV25-1	TRBJ2-7
TGTGCCAGCTCACCACCGCAGCAGAGGGGCGAGCAGTACTTC	CASSPPQQRGEQYF	TRBV18	TRBJ2-7
TGTGCCAGCAACCCCCTGTGCTCGGGACCCCTCTACGAGCAGTACTTC	CASNPLCSGPLYEQYF	TRBV7-2	TRBJ2-7
TGTGCCAGCAGTGAGCTAGTCGGGAATGAGCAGTTCTTC	CASSELVGNEQFF	TRBV6-4	TRBJ2-1
TGCGCCAGCAGCATAGTACTTTTATGTGACAATCAGCCCCAGCATTTT	CASSIVLLCDNQPQHF	TRBV5-1	TRBJ1-5
TGTGCCAGAGTGTCTCGTTTGACAGAGGGACAGCCCCAGCATTTT	CARVSRLTEGQPQHF	TRBV19	TRBJ1-5
TGTGCCAGCAGCAAAGACGGCGGGGATAGAACAGATACGCAGTATTTT	CASSKDGGDRTDTQYF	TRBV9	TRBJ2-3
TGTGCCAGCAGTTACGATTCGGGACGCGGACTAGCGGTCAATGAGCAGTTCTTC	CASSYDSGRGLAVNEQFF	TRBV6-5	TRBJ2-1
TGTGCCAGCAGGCGGGAGTGCCGCTACAATGAGCAGTTCTTC	CASRRECRYNEQFF	TRBV25-1	TRBJ2-1
TGTGCCAGCAGCGGACTAGCGGGCGACACAGATACGCAGTATTTT	CASSGLAGDTDTQYF	TRBV13	TRBJ2-3
TGTGCCAGCAGAGGGGGACAGTCACCCCTCCACTTT	CASRGGQSPLHF	TRBV7-4	TRBJ1-6
TGTGCCAGCAGCCCCGGGACAGGGAAGATCGAGCAGTACTTC	CASSPGTGKIEQYF	TRBV11-2	TRBJ2-7
TGCGCCAGCTCTGTCCGCAATCAGCCCCAGCATTTT	CASSVRNQPQHF	TRBV5-1	TRBJ1-5
TGTGCCACCCTTCCCAGGGGGGTAAGGGACGAGCAGTACTTC	CATLPRGVRDEQYF	TRBV24-1	TRBJ2-7
TGTGCCAGCAGCTCGCCTGACGCCGGCTCCTACGAGCAGTACTTC	CASSSPDAGSYEQYF	TRBV9	TRBJ2-7
TGTGCCAGCAGTTTAGATCAGCCCCAGCATTTT	CASSLDQPQHF	TRBV27	TRBJ1-5
TGTGCCAGCAGCTTAAGACTAGCGGGGGCCGAGCAGTACTTC	CASSLRLAGAEQYF	TRBV7-9	TRBJ2-7
TGTGCCATAGACAGGGTATCCTCCTACGAGCAGTACTTC	CAIDRVSSYEQYF	TRBV27	TRBJ2-7
TGTGCCAGCAGTGGGGCGGGACAGGGCTATGGCTACACCTTC	CASSGAGQGYGYTF	TRBV6-1	TRBJ1-2
TGCAGCTCGCAGGGGCTTCTATATAGCAATCAGCCCCAGCATTTT	CSSQGLLYSNQPQHF	TRBV29-1	TRBJ1-5
TGCGCCAGCAGCCAAGATAGACTAGCGGGGGGGCCGTCGGGCTACAATGAGCAGTTCTTC	CASSQDRLAGGPSGYNEQFF	TRBV4-3	TRBJ2-1
TGTGCCAGCAGTTACTCACGGAGGGGAGACTCTGGAAACACCATATATTTT	CASSYSRRGDSGNTIYF	TRBV6-5	TRBJ1-3
TGTGCCAGCAGCGTCCCCGCAGGGGAAGACGAGCAGTACTTC	CASSVPAGEDEQYF	TRBV9	TRBJ2-7
TGTGCCAGCAGTAACGCCAATCCTTCCAGGGGCATGAACACTGAAGCTTTCTTT	CASSNANPSRGMNTEAFF	TRBV6-5	TRBJ1-1
TGCGCCAGAACGGAAAGGGGGGTTTCTTGGGCTGGCTACACCTTC	CARTERGVSWAGYTF	TRBV10-1	TRBJ1-2
TGTGCCTGGAGCGTTTTCTCATGGGACGAGCAGTACTTC	CAWSVFSWDEQYF	TRBV30	TRBJ2-7
TGTGCCAGCAGCTTAGAGGACGATGAGCAGTTCTTC	CASSLEDDEQFF	TRBV11-3	TRBJ2-1
TGTGCCACCAGTGTAGACAGGGTGGAGGAGTACAATGAGCAGTTCTTC	CATSVDRVEEYNEQFF	TRBV24-1	TRBJ2-1
TGCGCCAGCAGACTGGAGGGGGCTGAAGCTTTCTTT	CASRLEGAEAFF	TRBV10-1	TRBJ1-1
TGTGCCAGCAACCGGGCGAACACCGGGGAGCTGTTTTTT	CASNRANTGELFF	TRBV7-2	TRBJ2-2
TGTGCCAGCAGGGGGGGATCTCTAAAGACCGTCCCTGGAAACACCATATATTTT	CASRGGSLKTVPGNTIYF	TRBV5-6	TRBJ1-3
TGTGCCACCAGTGATAAGTCTCAGCAGACGAATCAGCCCCAGCATTTT	CATSDKSQQTNQPQHF	TRBV24-1	TRBJ1-5
TGTGCCAGCAGTTACCGACAGGGGCGCCCACGGGAGACCCAGTACTTC	CASSYRQGRPRETQYF	TRBV6-9	TRBJ2-5
TGTGCCAGCATGGACGGGGCGTACACCTTC	CASMDGAYTF	TRBV27	TRBJ1-2
TGTGCCAGCAGTTACGGGACTAGGCAGTACTTC	CASSYGTRQYF	TRBV6-5	TRBJ2-7
TGTGCCAGCAGTTCCCTTTGGACTACAACCGGGGAGCTGTTTTTT	CASSSLWTTTGELFF	TRBV27	TRBJ2-2
TGTGCCAGTAGTATAGGAGCAGGGAGGGCCGGGGAGCTGTTTTTT	CASSIGAGRAGELFF	TRBV19	TRBJ2-2
TGTGCCAGTAGTATAGATCAAAGCGGGAAAGTTGGGAAGATTGTTGAGCAGTTCTTC	CASSIDQSGKVGKIVEQFF	TRBV19	TRBJ2-1
TGTGCCAGCAGTGACTCCCCTCCTTTAGCAGGCACAGATACGCAGTATTTT	CASSDSPPLAGTDTQYF	TRBV6-4	TRBJ2-3
TGTGCCAGTAGTATAGGGGGGGATAGCAATCAGCCCCAGCATTTT	CASSIGGDSNQPQHF	TRBV19	TRBJ1-5
TGTGCCAGCAGCGCCTTCCCTGTAATACTAGCGGGAGGGAACAAAAACATTCAGTACTTC	CASSAFPVILAGGNKNIQYF	TRBV6-6	TRBJ2-4
TGTGCCGGGCATGGGGAGAATACCACCGGGGAGCTGTTTTTT	CAGHGENTTGELFF	TRBV24-1	TRBJ2-2
TGTGCCAGCAGTTTCTCCCGGGGGGGCGATCGCACAGATACGCAGTATTTT	CASSFSRGGDRTDTQYF	TRBV6-6	TRBJ2-3
TGTGCCAGCAGGGGGACAGGGGGATCTGATGGCTACACCTTC	CASRGTGGSDGYTF	TRBV6-1	TRBJ1-2
TGCAGTGCTAGGGCGATGAGGGGGAACACTGAAGCTTTCTTT	CSARAMRGNTEAFF	TRBV20-1	TRBJ1-1
TGTGCCAGCAGCCAAGGGGGCCCCGATAACAATCAGCCCCAGCATTTT	CASSQGGPDNNQPQHF	TRBV7-9	TRBJ1-5
TGTGCCAGCAGCCGCACGGGGTTCTTCAGGGGGGCCAACGTCCTGACTTTC	CASSRTGFFRGANVLTF	TRBV6-3	TRBJ2-6
TGTGCCACCAGTGAACGGAATTATAGCAATCAGCCCCAGCATTTT	CATSERNYSNQPQHF	TRBV24-1	TRBJ1-5
TGCGCCAGCGTTCAGGCGCTAGCCAAAAACATTCAGTACTTC	CASVQALAKNIQYF	TRBV10-1	TRBJ2-4
TGTGCCAGCAGCACAGTTAAACCGGGACAGGGTTCGGAAGATCAGCCCCAGCATTTT	CASSTVKPGQGSEDQPQHF	TRBV5-4	TRBJ1-5
TGCGCCAGCAGCCAAGATGGTTCGGCGTTGAGACAGGGGATTTACGAGCAGTACTTC	CASSQDGSALRQGIYEQYF	TRBV4-1	TRBJ2-7
TGTGCCAGCAGGATGCCAACCATGGGACAGGGGCCTGCGAACACCGGGGAGCTGTTTTTT	CASRMPTMGQGPANTGELFF	TRBV12-4	TRBJ2-2
TGTGCCAGCTCACCGCCTACAGGGGGCGGAAAACTGTTTTTT	CASSPPTGGGKLFF	TRBV18	TRBJ1-4
TGCGCCAGCAGTGACCGGAGAGCGGGGGACTCGACCGGGGAGCTGTTTTTT	CASSDRRAGDSTGELFF	TRBV10-1	TRBJ2-2
TGTGCCAGCAGCTTGAAGGACAAAGGGGAGGCAGATACGCAGTATTTT	CASSLKDKGEADTQYF	TRBV7-2	TRBJ2-3
TGTGCCAGCAGTCAGGGGGACAGGGCTTCCACTGAAGCTTTCTTT	CASSQGDRASTEAFF	TRBV28	TRBJ1-1
