TGTGCCAGCAGTTTCACTTTGCCGGGGGGGTGGGGCTACGAGCAGTACTTC	CASSFTLPGGWGYEQYF	TRBV28	TRBJ2-7
TGTGCCAGCAGCTTAGCGCCTGGACACCGCAATCAGCCCCAGCATTTT	CASSLAPGHRNQPQHF	TRBV7-6	TRBJ1-5
TGTGCCAGCAGCCAAGCCCGCAGCCAATACACTGAAGCTTTCTTT	CASSQARSQYTEAFF	TRBV4-2	TRBJ1-1
TGCAGTGCTAACCTTGGGGTGATGAACACTGAAGCTTTCTTT	CSANLGVMNTEAFF	TRBV20-1	TRBJ1-1
TGTGCCAGCAGCCTCAACACCCCCTACGAGCAGTACTTC	CASSLNTPYEQYF	TRBV13	TRBJ2-7
TGCAGTGCGCGGACAGGGACTATTAACTATGGCTACACCTTC	CSARTGTINYGYTF	TRBV20-1	TRBJ1-2
TGTGCCAGCAGTGACCCCCTTCCGGGGGGGTCTGTGACGACAGATACGCAGTATTTT	CASSDPLPGGSVTTDTQYF	TRBV25-1	TRBJ2-3
TGTGCCAGCAGCCTCCAAGTGAAGAGGTACTTC	CASSLQVKRYF	TRBV13	TRBJ2-7
TGTGCCAGCAGGTTGGACCGAGATACGCAGTATTTT	CASRLDRDTQYF	TRBV28	TRBJ2-3
TGCGCCAGCAGCTCACTGGGGGGCTACAATGAGCAGTTCTTC	CASSSLGGYNEQFF	TRBV5-1	TRBJ2-1
TGTGCCAGCAATTTCGCACTAGCGGGAGGGCCTTGCAATGAGCAGTTCTTC	CASNFALAGGPCNEQFF	TRBV2	TRBJ2-1
TGTGCCAGCAGTTATTACTCGACAGCCGCCGAGCAGTACTTC	CASSYYSTAAEQYF	TRBV6-9	TRBJ2-7
TGTGCCAGCAGTACGGAAGGACAGGGTACGGGAAGGAGGTGGAACTACGAGCAGTACTTC	CASSTEGQGTGRRWNYEQYF	TRBV6-5	TRBJ2-7
TGTGCCAGTAGTATATCCGGGACAAAAGACAATGAGCAGTTCTTC	CASSISGTKDNEQFF	TRBV19	TRBJ2-1
TGTGCCAGCAGTGCGCCGGAACCCGGGGAGCTGTTTTTT	CASSAPEPGELFF	TRBV27	TRBJ2-2
TGTGCCAGCAGTTTACTAGCGGGAGATGACAATGAGCAGTTCTTC	CASSLLAGDDNEQFF	TRBV28	TRBJ2-1
TGTGCCAGCAGTGTTTTGGGGGCTAACTTGAACACTGAAGCTTTCTTT	CASSVLGANLNTEAFF	TRBV2	TRBJ1-1
TGTGCCAGCAGCTTAGCATGGACTAGCGGGGGGTGCATGCAAGAGACCCAGTACTTC	CASSLAWTSGGCMQETQYF	TRBV7-9	TRBJ2-5
TGCAGTGCCCGGTTTGGCGTGAACACTGAAGCTTTCTTT	CSARFGVNTEAFF	TRBV20-1	TRBJ1-1
TGTGCCAGCTCACATGGGGCCCACTTC	CASSHGAHF	TRBV18	TRBJ2-7
TGTGCCAGCAGCTTCGTCAGGGGGCCCCTTGAAAAACTGTTTTTT	CASSFVRGPLEKLFF	TRBV11-2	TRBJ1-4
TGTGCCAGCTCGCGCCGGGACAAGAATTGCTACAATGAGCAGTTCTTC	CASSRRDKNCYNEQFF	TRBV18	TRBJ2-1
TGTGCCAGCAGGACTGCGCCCAATGACCTCTCCTACGAGCAGTACTTC	CASRTAPNDLSYEQYF	TRBV12-4	TRBJ2-7
TGCGCCAGCAGCCAAGCCAGGGGACCCCCCTTTGGGCGGGAACACACCGGGGAGCTGTTTTTT	CASSQARGPPFGREHTGELFF	TRBV4-1	TRBJ2-2
TGTGCCAGCAGCCCAACAGGGATATTCCTAGCCAAAAACATTCAGTACTTC	CASSPTGIFLAKNIQYF	TRBV7-4	TRBJ2-4
TGTGCCAGCGGCAGGGGGGGGCGAAGCAGCAATCAGCCCCAGCATTTT	CASGRGGRSSNQPQHF	TRBV5-6	TRBJ1-5
TGTGCCAGCAGCTGTCCGACAGGGGAGACTGAAGCTTTCTTT	CASSCPTGETEAFF	TRBV13	TRBJ1-1
TGTGCCAGCAGCTTATCCCTTTATTGGCAGGGGAATAACTATGGCTACACCTTC	CASSLSLYWQGNNYGYTF	TRBV7-9	TRBJ1-2
TGTGCCAGCAGCAGAGCCCCGGCAACTCAAGAGACCCAGTACTTC	CASSRAPATQETQYF	TRBV6-4	TRBJ2-5
TGCAGTGCTCCGGGACAGGGCTCTTCCTGCAATCAGCCCCAGCATTTT	CSAPGQGSSCNQPQHF	TRBV20-1	TRBJ1-5
TGCAGTGCTAGAGCCTGCCTACCAAGAAAGGAACAGGTATCATATGGCTACACCTTC	CSARACLPRKEQVSYGYTF	TRBV20-1	TRBJ1-2
TGTGCCAGTAGTAGGCAGGGGCCTCCCCCAGAGACCCAGTACTTC	CASSRQGPPPETQYF	TRBV19	TRBJ2-5
TGTGCCAGCAGCTTCGGGACAGGGACACGGAGCACAGATACGCAGTATTTT	CASSFGTGTRSTDTQYF	TRBV7-2	TRBJ2-3
TGTGCCAGCAGCAAGGACCTTGGGGGGGGATATCGAGAGCAGTTCTTC	CASSKDLGGGYREQFF	TRBV7-4	TRBJ2-1
TGTGCCAGCAGATCCACTGGACTAGCGGTCAAAAACATTCAGTACTTC	CASRSTGLAVKNIQYF	TRBV12-4	TRBJ2-4
TGTGCCAGCAGTGAACCCTGGGGTACCGCCCAACGCGAGCAGTACTTC	CASSEPWGTAQREQYF	TRBV2	TRBJ2-7
TGTGCCAGCACCGTGGAGAACCCCTACGAGCAGTACTTC	CASTVENPYEQYF	TRBV6-3	TRBJ2-7
TGTGCCAGCAGCTCGGAGGGCTACGAGCAGTACTTC	CASSSEGYEQYF	TRBV11-3	TRBJ2-7
TGCGCCAGCAGCTGCAGACTAGCGGGAGGACCTAGCACAGATACGCAGTATTTT	CASSCRLAGGPSTDTQYF	TRBV4-1	TRBJ2-3
TGTGCCACTAGGGGATTACATGAGCAGTTCTTC	CATRGLHEQFF	TRBV11-1	TRBJ2-1
TGTGCCAGCAGCAAAGCGGCGTCCTACGAGCAGTACTTC	CASSKAASYEQYF	TRBV7-2	TRBJ2-7
TGCAGTGCTAAGATGACATGGGGAGCCAAAAACATTCAGTACTTC	CSAKMTWGAKNIQYF	TRBV20-1	TRBJ2-4
TGTGCCAGCAGCTTGGGGAGGGGGTACTATGGCTACACCTTC	CASSLGRGYYGYTF	TRBV5-6	TRBJ1-2
TGCGCCAGCAGCTTGGCCGAAACCCCAAAGGAGAACCCGGGGGGGTCGAAATTCTATGGCTACACCTTC	CASSLAETPKENPGGSKFYGYTF	TRBV5-1	TRBJ1-2
TGCGCCAGCAGCCAAGATGGGTTCACACAGGGGAGGAATGAGCAGTTCTTC	CASSQDGFTQGRNEQFF	TRBV4-1	TRBJ2-1
TGTGCCAGCAAGGTCACTAGCGGGAGGCCACGCTCCTACAATGAGCAGTTCTTC	CASKVTSGRPRSYNEQFF	TRBV19	TRBJ2-1
TGCAGCGTTGAGTCCGGGACTAGCGGTCTCGAGCAGTACTTC	CSVESGTSGLEQYF	TRBV29-1	TRBJ2-7
TGTGCCAGAGAAATTCCCGACAGGGATCAAGATCAGCCCCAGCATTTT	CAREIPDRDQDQPQHF	TRBV30	TRBJ1-5
TGTGCCAGCAGCTGCGATCAGCCGGGACAGGGGGCACTCATCTACGAGCAGTACTTC	CASSCDQPGQGALIYEQYF	TRBV11-1	TRBJ2-7
TGTGCCAGCAGTTACATACGAGCATATGGCTACACCTTC	CASSYIRAYGYTF	TRBV6-5	TRBJ1-2
TGCGCCAGCAGCAGGGGTCCGGATACGCAGTATTTT	CASSRGPDTQYF	TRBV5-1	TRBJ2-3
TGTGCCAGCAGCCAAGATATTCAGGCACACTATGGCTACACCTTC	CASSQDIQAHYGYTF	TRBV4-2	TRBJ1-2
TGTGCCAGCAGCATAAGCGGCACAGGGAGCTACGAGCAGTACTTC	CASSISGTGSYEQYF	TRBV13	TRBJ2-7
TGTGCCAGCAGCCCGGGACCCGGCTACGAGCAGTACTTC	CASSPGPGYEQYF	TRBV11-3	TRBJ2-7
TGTGCCAGCAGCGTGCGCGGGAGCCCCACGGGGACAGGGGTTAAAGAGGGGAACACTGAAGCTTTCTTT	CASSVRGSPTGTGVKEGNTEAFF	TRBV9	TRBJ1-1
TGTGCCAGCAGCTATCACCCAGACGCTAGCGGGAAGCACGAGCAGTACTTC	CASSYHPDASGKHEQYF	TRBV13	TRBJ2-7
TGTGCCAGCAGCCAATCCATGGGGAGGAAGCCCCAGCATTTT	CASSQSMGRKPQHF	TRBV3-1	TRBJ1-5
TGTGCCAGTAGCGGGAGCGAACAACATCAGCCCCAGCATTTT	CASSGSEQHQPQHF	TRBV6-1	TRBJ1-5
TGTGCCAGCAGCCTTGGAGGGCAACTCCAAGAGACCCAGTACTTC	CASSLGGQLQETQYF	TRBV4-2	TRBJ2-5
TGCAGTGCTAGAAATGAAGCTCACAACCGCAAAAAAAACATTCAGTACTTC	CSARNEAHNRKKNIQYF	TRBV20-1	TRBJ2-4
TGTGCCACCAGTCGCGGGAGATCTGGGGCCAACGTCCTGACTTTC	CATSRGRSGANVLTF	TRBV24-1	TRBJ2-6
TGTGCCAGCAGCTTAGTCCCTGCGGGGGACGATCAGCCCCAGCATTTT	CASSLVPAGDDQPQHF	TRBV7-9	TRBJ1-5
TGTGCCACCAGCAACGAAAAATCGGGACAGACGTTGAACACCGGGGAGCTGTTTTTT	CATSNEKSGQTLNTGELFF	TRBV24-1	TRBJ2-2
TGTGCCAGCAGGGACAGGGTCGCCGGGGAGCTGTTTTTT	CASRDRVAGELFF	TRBV6-6	TRBJ2-2
TGTGCCAGCAGATCGGCCCAAGAGACCCAGTACTTC	CASRSAQETQYF	TRBV28	TRBJ2-5
TGTGCCAGCAGGGGACAGGGGCGGTTGTGCAATCAGCCCCAGCATTTT	CASRGQGRLCNQPQHF	TRBV7-3	TRBJ1-5
TGTGCCAGTGAGGCCGGGCTAAACACTGAAGCTTTCTTT	CASEAGLNTEAFF	TRBV19	TRBJ1-1
TGCGCCAACCCCCTCCGGGACAGGGGGTCGAATTCACCCCTCCACTTT	CANPLRDRGSNSPLHF	TRBV10-1	TRBJ1-6
TGTGCCAGCAGCTTCCGCTGGGGAGCCGCTGGAAACACCATATATTTT	CASSFRWGAAGNTIYF	TRBV11-2	TRBJ1-3
TGTGCCAGCAGCCGAGCGAGGGGTTCTAATGAAAAACTGTTTTTT	CASSRARGSNEKLFF	TRBV13	TRBJ1-4
TGTGCCTGGAGCGACCCTGGGGTTGGGGCACGGGCCCAGCATTTT	CAWSDPGVGARAQHF	TRBV30	TRBJ1-5
TGTGCCAGCAGCTGGGTTACCGAGGGAGACAGGGGAACTGAAGCTTTCTTT	CASSWVTEGDRGTEAFF	TRBV7-9	TRBJ1-1
TGCAAGCGATTCGGGAAGTGCAATCAGCCCCAGCATTTT	CKRFGKCNQPQHF	TRBV20-1	TRBJ1-5
TGTGCCAGTAGTTTGGGGAGGTTAAAACTGTTTTTT	CASSLGRLKLFF	TRBV19	TRBJ1-4
TGTGCCAGCAGCTCAACTACGACGCAGCCCCAGCATTTT	CASSSTTTQPQHF	TRBV7-4	TRBJ1-5
TGTGCTAGCAGCTTAGCGGCCCGACAGGCAGATACGCAGTATTTT	CASSLAARQADTQYF	TRBV7-7	TRBJ2-3
TGTGCCAGCAGCTGTAATGGGGGGGATAGAATGGATAAAGGCGAGCAGTACTTC	CASSCNGGDRMDKGEQYF	TRBV5-8	TRBJ2-7
TGTGCCAGCAGTTACTTGACTAGCGGAAGTTGTAGGTCCTACAATGAGCAGTTCTTC	CASSYLTSGSCRSYNEQFF	TRBV6-2	TRBJ2-1
TGTGCCACCAGAGTAATTAGGGGGAGCGGGAGCTCGTATGGCTACACCTTC	CATRVIRGSGSSYGYTF	TRBV24-1	TRBJ1-2
TGTGCCAGCACCGGCCGGGGACGTGGTCGTATGAACACTGAAGCTTTCTTT	CASTGRGRGRMNTEAFF	TRBV14	TRBJ1-1
TGTGCCAGCAGCGCCGAACACAGTCGGGGTCAAGAGACCCAGTACTTC	CASSAEHSRGQETQYF	TRBV13	TRBJ2-5
TGTGCTAGTGGTTTGGTAACGAGGGTGAGCACAGATACGCAGTATTTT	CASGLVTRVSTDTQYF	TRBV12-5	TRBJ2-3
TGTGCCAGCAGCTTACGAGCGGGTAGGAGGGGGTACGAGCAGTACTTC	CASSLRAGRRGYEQYF	TRBV7-7	TRBJ2-7
TGCAGTGCTAGAAGATCATCCGGGGATTTTGACACTGAAGCTTTCTTT	CSARRSSGDFDTEAFF	TRBV20-1	TRBJ1-1
TGCAGTGGGGTGACAGCGGACGGAGATCAGCCCCAGCATTTT	CSGVTADGDQPQHF	TRBV20-1	TRBJ1-5
TGTGCCAGCAGCTTAGAAATAGTCACCGGGGAGCTGTTTTTT	CASSLEIVTGELFF	TRBV11-3	TRBJ2-2
TGTGCCACCAGTGAGACGGGGGGGGGGTTGATGAACACTGAAGCTTTCTTT	CATSETGGGLMNTEAFF	TRBV24-1	TRBJ1-1
TGCAGCGTGGGGGGGGTGTACTCCGTCTCTGGGGCCAACGTCCTGACTTTC	CSVGGVYSVSGANVLTF	TRBV29-1	TRBJ2-6
TGTGCCAGCAACGGACAGAATAACACTGAAGCTTTCTTT	CASNGQNNTEAFF	TRBV2	TRBJ1-1
TGTGCCAGCAGCCCGCTGGGGGGCGAGACCCAGTACTTC	CASSPLGGETQYF	TRBV3-1	TRBJ2-5
TGTGCCATCAGGGGGGGACATACACATAACTATGGCTACACCTTC	CAIRGGHTHNYGYTF	TRBV10-3	TRBJ1-2
TGCGCCAGCAGCCCCGGGACAGAGGGCTACACCTTC	CASSPGTEGYTF	TRBV5-1	TRBJ1-2
TGCGCCAGCTCTACAGGGCCCTACGAGCAGTACTTC	CASSTGPYEQYF	TRBV10-1	TRBJ2-7
TGTGCCAGCAGCTTGGCCGGAGCTATAACAGGGTTACCCACGCAGTATTTT	CASSLAGAITGLPTQYF	TRBV5-6	TRBJ2-3
TGTGCCAGCAGCCACAGCCCAGGGTATAATGGCTACACCTTC	CASSHSPGYNGYTF	TRBV14	TRBJ1-2
TGTGCCAGCAGCTTGTTTAGACATCCAATTTATGGCTACACCTTC	CASSLFRHPIYGYTF	TRBV5-6	TRBJ1-2
TGTGCCAGCAGTTACTCTAACTATGGCTACACCTTC	CASSYSNYGYTF	TRBV6-5	TRBJ1-2
TGCGCCAGCATATGGGAAACATGCAATCAGCCCCAGCATTTT	CASIWETCNQPQHF	TRBV10-1	TRBJ1-5
TGTGCCAGCAGGCTAAGACAGGCTCAACCGGAAGAAAAACTGTTTTTT	CASRLRQAQPEEKLFF	TRBV7-9	TRBJ1-4
TGTGCCAGCGGGACGAGGGGAGCGCGACGCACAGATACGCAGTATTTT	CASGTRGARRTDTQYF	TRBV6-5	TRBJ2-3
TGTGCCAGTAGGGTCCAGGCCTACAATGAGCAGTTCTTC	CASRVQAYNEQFF	TRBV19	TRBJ2-1
TGTGCCAGCAGTTACTTGGGGGTAAAGCTAAGACCAGATACGCAGTATTTT	CASSYLGVKLRPDTQYF	TRBV6-5	TRBJ2-3
TGTGCCAGCCGGATACAGGGGGCTAGTGGCTATGGCTACACCTTC	CASRIQGASGYGYTF	TRBV18	TRBJ1-2
TGTGCCAGCAGCCGGGGGGGGCAAAGCTCCTACGAGCAGTACTTC	CASSRGGQSSYEQYF	TRBV13	TRBJ2-7
TGTGCCAGCAGGGGGGGGTCGGCAAGATACGAGCAGTACTTC	CASRGGSARYEQYF	TRBV7-3	TRBJ2-7
TGTGCCTGGAGTGGGCGGGAGGGCCCTCGACAAGAGACCCAGTACTTC	CAWSGREGPRQETQYF	TRBV30	TRBJ2-5
TGTGCCAGCAGCTCCAGAGCCGACTATGGCTACACCTTC	CASSSRADYGYTF	TRBV7-6	TRBJ1-2
TGTGCCAGTAGTATAGCGGGTTCCGTCCAGTACGAGCAGTACTTC	CASSIAGSVQYEQYF	TRBV19	TRBJ2-7
TGCAGCGGAGCGGGAATTGGGATTGACTACGAGCAGTACTTC	CSGAGIGIDYEQYF	TRBV29-1	TRBJ2-7
TGTGCCAGCAGCTTCGATGGGACAGGTGGATCATATTTT	CASSFDGTGGSYF	TRBV7-4	TRBJ1-3
TGCAGTGCTCCAGGAAATTGGGGGACTAGCGGCCCCGCGAACACCGGGGAGCTGTTTTTT	CSAPGNWGTSGPANTGELFF	TRBV20-1	TRBJ2-2
TGTGCCAGCATGGGGGGAAGCTCCTACAATGAGCAGTTCTTC	CASMGGSSYNEQFF	TRBV6-2	TRBJ2-1
TGTGCTAGTGGTTTGGACAGGGGGCTTAATCAGCCCCAGCATTTT	CASGLDRGLNQPQHF	TRBV12-5	TRBJ1-5
TGTGCCAGCAGCTTGCCGACAGTGAACACTGAAGCTTTCTTT	CASSLPTVNTEAFF	TRBV5-6	TRBJ1-1
TGTGCCACCAGTCCGACAGGGGGCAGGGGGACCTTATTTAATGAGCAGTTCTTC	CATSPTGGRGTLFNEQFF	TRBV24-1	TRBJ2-1
TGTGCCATCGAAAAACCTCAAGACAGGGGGACCTCCATGAACACTGAAGCTTTCTTT	CAIEKPQDRGTSMNTEAFF	TRBV10-3	TRBJ1-1
TGTGCCAGCAGCTTAGATGGGGAAAGGCACACTGAAGCTTTCTTT	CASSLDGERHTEAFF	TRBV7-2	TRBJ1-1
TGTGCTAGAAGCAGGACTAGCGCGGAATGGGACAATGAGCAGTTCTTC	CARSRTSAEWDNEQFF	TRBV12-5	TRBJ2-1
TGCAGTGCTATGGGACAGTCTAATGAAAAACTGTTTTTT	CSAMGQSNEKLFF	TRBV20-1	TRBJ1-4
TGCGCCAGCAGTGACCGCACCTCGGGCTACGGGGAGCTGTTTTTT	CASSDRTSGYGELFF	TRBV10-1	TRBJ2-2
TGTGCCAGCAGCCCCGCAGGGGGTGGAGGGCAGCCCCAGCATTTT	CASSPAGGGGQPQHF	TRBV13	TRBJ1-5
TGCGCCAGCCTAGCGGGGGGTCCCTATCGGCGGGACGAGCAGTACTTC	CASLAGGPYRRDEQYF	TRBV10-1	TRBJ2-7
TGTGCCACCAGTGGTTCTAGCGGGGTCGGCGAGCAGTACTTC	CATSGSSGVGEQYF	TRBV24-1	TRBJ2-7
TGTGCCAGCAGCTTAGACGGACTAGGAGAATACGAGCAGTACTTC	CASSLDGLGEYEQYF	TRBV11-2	TRBJ2-7
TGTGCCAGCAGCGGGGGTGTCCTCAGGGATTGGTCCAATCAGCCCCAGCATTTT	CASSGGVLRDWSNQPQHF	TRBV9	TRBJ1-5
TGTGCCAGCAGCTTGCCCCGGACATCTGGCTACGAGCAGTACTTC	CASSLPRTSGYEQYF	TRBV5-6	TRBJ2-7
TGTGCCAGCAGGTGGACAGGGAAAACTGGAAACACCATATATTTT	CASRWTGKTGNTIYF	TRBV2	TRBJ1-3
TGTGCCAGCACCGGGACAGGAAATGAGCAGTTCTTC	CASTGTGNEQFF	TRBV14	TRBJ2-1
TGCAGTGCTAGAGGGACAGGAAATTCTATCAATCAGCCCCAGCATTTT	CSARGTGNSINQPQHF	TRBV20-1	TRBJ1-5
TGTGCCAGCAGTTCCCAGTCCCCCCAAAGACAGGGCGACGAGCAGTACTTC	CASSSQSPQRQGDEQYF	TRBV6-1	TRBJ2-7
TGTGCCAGCAGGAGCGGCAGATGGCATTTT	CASRSGRWHF	TRBV5-4	TRBJ1-5
TGTGCCAGCAGCGTAGGGGGCAATGGGGGCCCCCGCTCCTACAATGAGCAGTTCTTC	CASSVGGNGGPRSYNEQFF	TRBV9	TRBJ2-1
TGTGCCAGCAGCTTAGGCTTCTGGGATAATGAGCAGTTCTTC	CASSLGFWDNEQFF	TRBV11-2	TRBJ2-1
TGTGCCAGCAGCCCCACAGGGAGTAGGAATCAGCCCCAGCATTTT	CASSPTGSRNQPQHF	TRBV7-3	TRBJ1-5
TGTGCCAGCAGGAACGCCCCTAGCGGGCAGCAAGAGACCCAGTACTTC	CASRNAPSGQQETQYF	TRBV7-3	TRBJ2-5
TGTGCCAGCAGCTTAAGTCCCCCCAAAGGGGAAGGTCCGTTTCGATTTGCCGGGGAGCTGTTTTTT	CASSLSPPKGEGPFRFAGELFF	TRBV7-9	TRBJ2-2
TGTGCCAGCAGTCAGATCAACACTGAAGCTTTCTTT	CASSQINTEAFF	TRBV2	TRBJ1-1
TGCGCCAGCAGCCCTCGCGACTCAGATACGCAGTATTTT	CASSPRDSDTQYF	TRBV5-1	TRBJ2-3
TGTGCCAGCAGTGACTCGGCGTTACAGGAATTGAACACTGAAGCTTTCTTT	CASSDSALQELNTEAFF	TRBV6-4	TRBJ1-1
TGTGCCATGCAGTACTCCTACGAGCAGTACTTC	CAMQYSYEQYF	TRBV6-5	TRBJ2-7
TGTGCCAGCAGACGACGGGGGTATGGCTACACCTTC	CASRRRGYGYTF	TRBV28	TRBJ1-2
TGCAGTGCTTCTGCTGGCCGATGCACGGACACCTACAATGAGCAGTTCTTC	CSASAGRCTDTYNEQFF	TRBV20-1	TRBJ2-1
TGTGCCATCAGTGGTAATCCCGGGGGGCAGTACTTC	CAISGNPGGQYF	TRBV10-3	TRBJ2-7
TGTGCCAGCAGTTCCTGCCCCAGGGGAAGGCCCCAGCATTTT	CASSSCPRGRPQHF	TRBV6-1	TRBJ1-5
TGTGCCAGCAGCGGGTCACGGGAGCAGTACTTC	CASSGSREQYF	TRBV7-8	TRBJ2-7
TGTGCCACCAGTGATTACGGGGGAAGGGTTGGAACGGCCAACGTCCTGACTTTC	CATSDYGGRVGTANVLTF	TRBV24-1	TRBJ2-6
TGTGCCAGCAGCTCGACAGGGTGGATAGTGGACTATGGCTACACCTTC	CASSSTGWIVDYGYTF	TRBV11-3	TRBJ1-2
TGTGCCAGCAGCAACCGACAGGGCCCTAACTATGGCTACACCTTC	CASSNRQGPNYGYTF	TRBV13	TRBJ1-2
TGTGCCAGCAGGCCCAAAGCTTTCTTT	CASRPKAFF	TRBV6-1	TRBJ1-1
TGTGCCACCTCAGGGGGGGGCCCCTCTCTCTCCTACAATGAGCAGTTCTTC	CATSGGGPSLSYNEQFF	TRBV24-1	TRBJ2-1
TGTGCCAGCAGCTGTCGAGACGAGCAGTACTTC	CASSCRDEQYF	TRBV2	TRBJ2-7
TGTGCCAGCAGCATCAAAGTTAGGGGGCGGGGGTATGGCTACACCTTC	CASSIKVRGRGYGYTF	TRBV7-9	TRBJ1-2
TGTGCCAGCTTCGGGACCGGGGGTGGATCGGATGGAAACACCATATATTTT	CASFGTGGGSDGNTIYF	TRBV27	TRBJ1-3
TGTGCCAGCAGCCAAGATCTCGAGGCACAGGGTACTGGGGTTGAGCAGTTCTTC	CASSQDLEAQGTGVEQFF	TRBV3-1	TRBJ2-1
TGCAGCGGAGAGGGGGAGAGAGCTTTCTTT	CSGEGERAFF	TRBV29-1	TRBJ1-1
TGTGCGATCCGGACAGAGCGTCAGCCCCAGCATTTT	CAIRTERQPQHF	TRBV12-5	TRBJ1-5
TGTGCCAGCAGCTCTAACCTGGGGGCCGGGGGGGACGAGCAGTTCTTC	CASSSNLGAGGDEQFF	TRBV5-4	TRBJ2-1
TGTGCCAGCAGTTATAAAAAGGGGATCCACACTGAAGCTTTCTTT	CASSYKKGIHTEAFF	TRBV6-6	TRBJ1-1
TGTGCCAAAGGCCACGCCACCGGGGAGCTGTTTTTT	CAKGHATGELFF	TRBV19	TRBJ2-2
TGCGCCAGCAGCCAAGATCCCCGTTGGGGCGGGGAGCAGTACTTC	CASSQDPRWGGEQYF	TRBV4-3	TRBJ2-7
TGCGCCAGCAGCGCCAAAGCTGGGGAGATAGCTTTCTTT	CASSAKAGEIAFF	TRBV4-1	TRBJ1-1
TGTGCCAGCAGTGAGGTAGGGCAGAGCACAGATACGCAGTATTTT	CASSEVGQSTDTQYF	TRBV2	TRBJ2-3
TGTGCCAGCAGCGGCCGGGACAGGGGTCGGGGGACCGGGGAGCTGTTTTTT	CASSGRDRGRGTGELFF	TRBV11-2	TRBJ2-2
TGCAGTGCCCTAGCGGGGCACAATGAGCAGTTCTTC	CSALAGHNEQFF	TRBV20-1	TRBJ2-1
TGTGCCAGCAGCCAAAACCGGGAGGGGAACGAGCAGTACTTC	CASSQNREGNEQYF	TRBV9	TRBJ2-7
TGTGCCAGCAGCTTATTCGATCCGGGACGAACAGCCGCTTTCTTT	CASSLFDPGRTAAFF	TRBV7-3	TRBJ1-1
TGTGCCCGGGTCCGGACTAGCGACTTCTCCTACGAGCAGTACTTC	CARVRTSDFSYEQYF	TRBV24-1	TRBJ2-7
TGTGCCAGTAGTCTTCAGGGTAGGGTTCAGCCCCAGCATTTT	CASSLQGRVQPQHF	TRBV19	TRBJ1-5
TGTGCCACCAGTCTCCCGCAACCAGGGCGGGCCAATGAGCAGTTCTTC	CATSLPQPGRANEQFF	TRBV24-1	TRBJ2-1
TGTGCCAGCAGCTTAGGGACAGGGAAGGGGTTAGGAAATCAGCCCCAGCATTTT	CASSLGTGKGLGNQPQHF	TRBV11-3	TRBJ1-5
TGCAGTGCCCCAGGGGGCACAGATACGCAGTATTTT	CSAPGGTDTQYF	TRBV20-1	TRBJ2-3
TGCAGCGTCGAGGGGAATGAAAAACTGTTTTTT	CSVEGNEKLFF	TRBV29-1	TRBJ1-4
TGCAGTGCCCCCACAAGGACTAGTTACACTGAAGCTTTCTTT	CSAPTRTSYTEAFF	TRBV20-1	TRBJ1-1
TGTGCCAGCAGTGACAGTCGAGTTCCTCGGTACGAGCAGTACTTC	CASSDSRVPRYEQYF	TRBV6-4	TRBJ2-7
TGTGCCAGCACGTGGAGGGTCTACTCCTACAATGAGCAGTTCTTC	CASTWRVYSYNEQFF	TRBV9	TRBJ2-1
TGTGCCAGCAGCTGGACCCGGGGGACTAGCGATACTGAGCAGTTCTTC	CASSWTRGTSDTEQFF	TRBV7-2	TRBJ2-1
TGTGCCAGCAGCGGACAGAGGGGTGGCTACACCTTC	CASSGQRGGYTF	TRBV13	TRBJ1-2
TGTGCCTCCGGGAGGCCCACAGATACGCAGTATTTT	CASGRPTDTQYF	TRBV19	TRBJ2-3
TGTGCCAGCAGTTACCTTGGATGGGGACGGAAAGCCATAGCCTACGAGCAGTACTTC	CASSYLGWGRKAIAYEQYF	TRBV6-5	TRBJ2-7
TGCGCCAGGTACAATTTCGGCCTCACCGTTCGGCGCTTCTGGGCGGACCAATCAGATACGCAGTATTTT	CARYNFGLTVRRFWADQSDTQYF	TRBV5-1	TRBJ2-3
TGTGCCAGCAGCTTAGGTCAACTCAGCAGAGCTGGGAGCTCCTACGAGCAGTACTTC	CASSLGQLSRAGSSYEQYF	TRBV7-4	TRBJ2-7
TGCGCCAGCAGCCAATTAAGGGGGCGGGACGAGCAGTACTTC	CASSQLRGRDEQYF	TRBV4-1	TRBJ2-7
TGTGCCAGCAGCAGCGGGATTAGAAGATCTGGAAACACCATATATTTT	CASSSGIRRSGNTIYF	TRBV5-4	TRBJ1-3
TGCAGTGCTGGTGAAAGCGGGAACACCGGGGAGCTGTTTTTT	CSAGESGNTGELFF	TRBV20-1	TRBJ2-2
TGCGCCAGCAGCTTGGGTCAGGGGGAAGGAGACTACGAGCAGTACTTC	CASSLGQGEGDYEQYF	TRBV5-1	TRBJ2-7
TGCAGTGCGGGAGGGGGGGGAAGCACCGGGGAGCTGTTTTTT	CSAGGGGSTGELFF	TRBV20-1	TRBJ2-2
TGTGCCAGCAGCTTCGTCTCTCCCAACGAGACCGGGGAGCTGTTTTTT	CASSFVSPNETGELFF	TRBV13	TRBJ2-2
TGTGCCCCCAAATCGGACCCAGGGGGATTCGTTGCCCAGCATTTT	CAPKSDPGGFVAQHF	TRBV19	TRBJ1-5
TGCGCCAGCAGCGCTAGCCCGGTAGGTTGGTATGGCTACACCTTC	CASSASPVGWYGYTF	TRBV4-1	TRBJ1-2
TGCAGCGTTGGACCCTTTCTAGCCCTTGCAGATACGCAGTATTTT	CSVGPFLALADTQYF	TRBV29-1	TRBJ2-3
TGTGCCAGCAGTTTAGCGACGAGCCCCGTTGGTTTCGCCGGCTACACCTTC	CASSLATSPVGFAGYTF	TRBV27	TRBJ1-2
TGTGCCACTCTAGGGAAGCAGGGGGGCAATCAGCCCCAGCATTTT	CATLGKQGGNQPQHF	TRBV6-5	TRBJ1-5
TGCGCCAGCTTGGGGGGAGATTCCCTCCACTTT	CASLGGDSLHF	TRBV10-1	TRBJ1-6
TGCAGTGCTGGGCTCTCTGAGCAGTACTTC	CSAGLSEQYF	TRBV20-1	TRBJ2-7
TGTGCCAGTAGTATACCGCCTTGGCGATTATGCTACGAGCAGTACTTC	CASSIPPWRLCYEQYF	TRBV19	TRBJ2-7
TGTGCCAGCAGTGCGTCTGACCTCAGTCAAAATTATAGCAATCAGCCCCAGCATTTT	CASSASDLSQNYSNQPQHF	TRBV2	TRBJ1-5
TGTGCCAGCAGTTCGACCCATACAGGGGGAGAGACCCAGTACTTC	CASSSTHTGGETQYF	TRBV28	TRBJ2-5
TGTGCCAGCAGTTACCTCGAAATACGGACCAGCTCCTACGAGCAGTACTTC	CASSYLEIRTSSYEQYF	TRBV6-5	TRBJ2-7
TGCGCCAGCAGCCAAGATGGGAGGGGGGGACACCACGAGCAGTACTTC	CASSQDGRGGHHEQYF	TRBV4-1	TRBJ2-7
TGTGCCAGCAGCCCCCCGGGGGGGAGCTCCTACAATGAGCAGTTCTTC	CASSPPGGSSYNEQFF	TRBV6-1	TRBJ2-1
TGTGCCAGCAGTGACTTCGGAGTACGAAAGACCCAGTACTTC	CASSDFGVRKTQYF	TRBV6-4	TRBJ2-5
TGCGCCAGCAGGGGACAGGCCATGCTTAACTATGGCTACACCTTC	CASRGQAMLNYGYTF	TRBV10-1	TRBJ1-2
TGTGCCACCAGTGGGGCATACGAGCAGTACTTC	CATSGAYEQYF	TRBV24-1	TRBJ2-7
TGCAGTGTTTCCGGGGGGAGATATGGCTACACCTTC	CSVSGGRYGYTF	TRBV20-1	TRBJ1-2
TGTGCCAGCAGCTTTGACAGGGAGTTTCTGTTTTTT	CASSFDREFLFF	TRBV7-3	TRBJ1-4
TGTGCCAGTCGTCTAGACAGCGACTATGGCTACACCTTC	CASRLDSDYGYTF	TRBV19	TRBJ1-2
TGTGCCAGCAGCCCGGGGACAGGAAAATACGAGCAGTACTTC	CASSPGTGKYEQYF	TRBV11-3	TRBJ2-7
TGTGCCAGCAGGGTAAAGGTCTCCTTCAGGGGGATAACAGATACGCAGTATTTT	CASRVKVSFRGITDTQYF	TRBV7-9	TRBJ2-3
TGTGCTAGTGGTTTGCCCCCCCCGGGACACACTGAAGCTTTCTTT	CASGLPPPGHTEAFF	TRBV12-5	TRBJ1-1
TGCGCCAGCGCGTTTACGAACGAGCAGTACTTC	CASAFTNEQYF	TRBV10-1	TRBJ2-7
TGTGCCAGCAGAAAGGCCCCCCCGGGGCGCAACCAAGAGACCCAGTACTTC	CASRKAPPGRNQETQYF	TRBV27	TRBJ2-5
TGTGCCAGCAGTCCCGGTGACGTGGGGAGCACATCTGGAAACACCATATATTTT	CASSPGDVGSTSGNTIYF	TRBV14	TRBJ1-3
TGTGCCAGCAGCCCCACTAGCGGGAGAGCCAAAAACATTCAGTACTTC	CASSPTSGRAKNIQYF	TRBV9	TRBJ2-4
TGTGCCAGCAGCTTACCATGGGGGAGGGGGCGCACAGATACGCAGTATTTT	CASSLPWGRGRTDTQYF	TRBV7-6	TRBJ2-3
TGTGCCAGCAGCCCCCTTCGACAGGGCTGTGGCTACGAGCAGTACTTC	CASSPLRQGCGYEQYF	TRBV13	TRBJ2-7
TGTGCCAGCAGCGCCCCTAGGACATGTAGCAATCAGCCCCAGCATTTT	CASSAPRTCSNQPQHF	TRBV11-3	TRBJ1-5
TGTGCCAGCAAGTCATCTCGGGGGGCGACCGACACAGATACGCAGTATTTT	CASKSSRGATDTDTQYF	TRBV6-2	TRBJ2-3
TGTGCCACCAGTGGTCCACCCGGGACGATGTGGTCCTACAATGAGCAGTTCTTC	CATSGPPGTMWSYNEQFF	TRBV24-1	TRBJ2-1
TGTGCCAGCAGTGGGGTCATGTTTGACTATGGCTACACCTTC	CASSGVMFDYGYTF	TRBV27	TRBJ1-2
TGCGCCAGCTGCCGTCACGGCGGGAGTGGCTACACCTTC	CASCRHGGSGYTF	TRBV10-1	TRBJ1-2
TGTGCCAGCAGCTTCTCCCCCTCGGACAGGGGAGAGGGAATGAGCTACGAGCAGTACTTC	CASSFSPSDRGEGMSYEQYF	TRBV5-8	TRBJ2-7
TGCAGTGCTAGCCGTTTCCCGCAGTTAACCTCGGGTGTAGACTATGGCTACACCTTC	CSASRFPQLTSGVDYGYTF	TRBV20-1	TRBJ1-2
TGTGCCAGCAGCAAAATAACTGAAGCTTTCTTT	CASSKITEAFF	TRBV6-5	TRBJ1-1
TGTGCCAGCAGCTCCGTAACAGGGGGGCCTAATGAGCAGTTCTTC	CASSSVTGGPNEQFF	TRBV7-7	TRBJ2-1
TGCGCCAGCAGCTTGGACAGGGGGCGGAACGAGCAGTACTTC	CASSLDRGRNEQYF	TRBV5-1	TRBJ2-7
TGCAGTGCTGAGACCTCCTTTAAACGGAGAAGCAATCAGCCCCAGCATTTT	CSAETSFKRRSNQPQHF	TRBV20-1	TRBJ1-5
TGTGCCAGCAGCCAAGAACCAGGAAAAGAGACCCAGTACTTC	CASSQEPGKETQYF	TRBV3-1	TRBJ2-5
TGTGCCAGCAGCTTTCTGGACAGTTGGCCCGAGCAGTACTTC	CASSFLDSWPEQYF	TRBV7-2	TRBJ2-7
TGTGCCAGCAGGGTCAGAGGGGGGGCAAAGGTTAAGTACAATGAGCAGTTCTTC	CASRVRGGAKVKYNEQFF	TRBV6-5	TRBJ2-1
TGTGCCAGCAGTACAGCAGACCGGCCTCAGCCCCAGCATTTT	CASSTADRPQPQHF	TRBV27	TRBJ1-5
TGTGCCAGCACCCGAAGATCAGGGACGGTCTGCTATGGCTACACCTTC	CASTRRSGTVCYGYTF	TRBV7-3	TRBJ1-2
TGTGCCACCAGAGAGGGGGACACCGGGGAGCTGTTTTTT	CATREGDTGELFF	TRBV24-1	TRBJ2-2
TGTGCCAGCAGCGGGACAGTCTGGGGTGAGCAGTTCTTC	CASSGTVWGEQFF	TRBV2	TRBJ2-1
TGTGCCAGCAGTGAAGCGCTGGTTTTTCAGGACAGAGCTAGCACAGATACGCAGTATTTT	CASSEALVFQDRASTDTQYF	TRBV6-1	TRBJ2-3
TGTGCCAGCAGCCCAAAGCCCGTGACAGGTCTCTACGAGCAGTACTTC	CASSPKPVTGLYEQYF	TRBV11-3	TRBJ2-7
TGTGCCAGCAACCCAGAGTCCGGGGAGCTGTTTTTT	CASNPESGELFF	TRBV28	TRBJ2-2
TGTGCCAGCAGCCGACGGACAGGGGCCTACGAGCAGTACTTC	CASSRRTGAYEQYF	TRBV7-3	TRBJ2-7
TGCGCCAGCAGCTTGGTACGGGAGAGAAACACCATATATTTT	CASSLVRERNTIYF	TRBV5-1	TRBJ1-3
TGTGCCAGCAGTTTAGGGAGAACAGTTGCAGGGGAATCACGCCAAGAGACCCAGTACTTC	CASSLGRTVAGESRQETQYF	TRBV28	TRBJ2-5
TGTGCCACCAGTGATTCCCCGGGACCGGCCGGGGAGCTGTTTTTT	CATSDSPGPAGELFF	TRBV24-1	TRBJ2-2
TGTGCCAGCAGCAAACATACAGGGAACACTGAAGCTTTCTTT	CASSKHTGNTEAFF	TRBV6-6	TRBJ1-1
TGTGCCAGCAGTGACTCGAACAACTCCGGGACAGGGGGGGGCCGGGACTATGGCTACACCTTC	CASSDSNNSGTGGGRDYGYTF	TRBV6-4	TRBJ1-2
TGTGCCAGCAGTACCTTAAGGGCCCACTATGGCTACACCTTC	CASSTLRAHYGYTF	TRBV6-1	TRBJ1-2
TGTGCCAGCTCACCCCTGGGAGGCAGGAGCAATCAGCCCCAGCATTTT	CASSPLGGRSNQPQHF	TRBV18	TRBJ1-5
TGTGCCAGCAGCCAAGATCTGGGACAGGCCCCAGAGCAGTACTTC	CASSQDLGQAPEQYF	TRBV3-1	TRBJ2-7
TGTGCCAATAAGACTAACTGCCGCTCCTACGAGCAGTACTTC	CANKTNCRSYEQYF	TRBV6-4	TRBJ2-7
TGTGCCATCAGCGAGAACATAGCCAAAAACATTCAGTACTTC	CAISENIAKNIQYF	TRBV10-3	TRBJ2-4
TGTGCCAGCAGCTTTGACGGGCCATGCTATGGCTACACCTTC	CASSFDGPCYGYTF	TRBV7-2	TRBJ1-2
TGTGCCAGCAGTTATCCGGTCCCAGAACAGACAGGCCACACTGAAGCTTTCTTT	CASSYPVPEQTGHTEAFF	TRBV27	TRBJ1-1
TGCGCCAGCAGCCAAGATAATCATCCGGTATACAATGAGCAGTTCTTC	CASSQDNHPVYNEQFF	TRBV4-3	TRBJ2-1
TGTGCCAGCAGTAGGGCAAATTTAAAACTGTTTTTT	CASSRANLKLFF	TRBV5-6	TRBJ1-4
TGCGCCAGCAGCTGCCCACCCCAACAGGGGAGGATCGAGCACTATGGCTACACCTTC	CASSCPPQQGRIEHYGYTF	TRBV5-1	TRBJ1-2
TGCGCCAGCACAGGGTGGGATCAGCCCCAGCATTTT	CASTGWDQPQHF	TRBV10-1	TRBJ1-5
TGTGCCATCGGGGGTCCTAACGGGGAGCAGTACTTC	CAIGGPNGEQYF	TRBV28	TRBJ2-7
TGTGCCTGGACGAGACACTCTGGAAGGGTTTGCACTGAAGCTTTCTTT	CAWTRHSGRVCTEAFF	TRBV30	TRBJ1-1
TGTGCCAGCAGTGACCGGACATATCAGCCCCAGCATTTT	CASSDRTYQPQHF	TRBV6-1	TRBJ1-5
TGTGCCAGCAGGGGGGGGACAGGGATCTTGCAGGCCTCAGGCTACACCTTC	CASRGGTGILQASGYTF	TRBV13	TRBJ1-2
TGCAGTTTGGGGACAGGGGGCCACACTGAAGCTTTCTTT	CSLGTGGHTEAFF	TRBV20-1	TRBJ1-1
TGCGCCAGCAGGTGCGGGGAAGCTCCCTACGAGCAGTACTTC	CASRCGEAPYEQYF	TRBV10-1	TRBJ2-7
TGTGCCAGCAGCCGGGAATATCTGAACCAGGTAATGGGGTTACACGAGCAGTACTTC	CASSREYLNQVMGLHEQYF	TRBV11-3	TRBJ2-7
TGTGCCAGCAGCTTACCCCCACGAGCAGGGTCACTTCACACTGAAGCTTTCTTT	CASSLPPRAGSLHTEAFF	TRBV7-3	TRBJ1-1
TGTGCCAGCAGGCGAGGAACTCAGTACAATGAGCAGTTCTTC	CASRRGTQYNEQFF	TRBV11-3	TRBJ2-1
TGTGCCAGCAGCTTGACACTATCCTACGAGCAGTACTTC	CASSLTLSYEQYF	TRBV7-3	TRBJ2-7
TGCAGTGCTAAATCGGGAGGGTATAGCAATCAGCCCCAGCATTTT	CSAKSGGYSNQPQHF	TRBV20-1	TRBJ1-5
TGTGCCAGCAGCTGGCTGGGAGTTAATGAAAAACTGTTTTTT	CASSWLGVNEKLFF	TRBV5-4	TRBJ1-4
TGTGCCAGCAGTTTATGCTCATACGAGCAGTACTTC	CASSLCSYEQYF	TRBV28	TRBJ2-7
TGTGCCAGCAGCCTAAGGTCACGAACAGGGGGCAAATTCTATGGCTACACCTTC	CASSLRSRTGGKFYGYTF	TRBV7-9	TRBJ1-2
TGTGCCAACGGGACTAGCGGACCATGGGGTTTCACAGATACGCAGTATTTT	CANGTSGPWGFTDTQYF	TRBV6-1	TRBJ2-3
TGTGCCAGCAGCTTAGTCCACAGGACCTGGAACAATGGCTACACCTTC	CASSLVHRTWNNGYTF	TRBV11-3	TRBJ1-2
TGTGCCAGCAGAGTTGGACAGGGGGGCTACACCTTC	CASRVGQGGYTF	TRBV6-1	TRBJ1-2
TGTAATCTCCCTAGCGAGACCCAGTACTTC	CNLPSETQYF	TRBV7-9	TRBJ2-5
TGTGCCAGTACTAGCGGCTGGTACTACGAGCAGTACTTC	CASTSGWYYEQYF	TRBV19	TRBJ2-7
TGTGCCAGCAGCACTCTAGCGGGTGCCACGGGGACCTACGAGCAGTACTTC	CASSTLAGATGTYEQYF	TRBV9	TRBJ2-7
TGTGCCAGCAGTTACTCCTCTCCGGGGACAGGGACAAAAACAAGGAGGAGCTCTGGAAACACCATATATTTT	CASSYSSPGTGTKTRRSSGNTIYF	TRBV6-5	TRBJ1-3
TGTGCCAGCAAAACCGGGACAGGGGGGTCTGGGGCCAACGTCCTGACTTTC	CASKTGTGGSGANVLTF	TRBV28	TRBJ2-6
TGTGCCTGCACAGAACTCGCTTGTGGAAACACCATATATTTT	CACTELACGNTIYF	TRBV30	TRBJ1-3
TGCAGTGCTTCCCCCCGGCCCACAGATACGCAGTATTTT	CSASPRPTDTQYF	TRBV20-1	TRBJ2-3
TGTCGTGGCCCGGGCAATCAGCCCCAGCATTTT	CRGPGNQPQHF	TRBV27	TRBJ1-5
TGTGCCAGCAGCCCATTCCGGGACAGCAATCAGCCCCAGCATTTT	CASSPFRDSNQPQHF	TRBV7-9	TRBJ1-5
TGTGCCAGCAGCCCCTTATTAGGGGGCTCTTGGCGCAATCAGCCCCAGCATTTT	CASSPLLGGSWRNQPQHF	TRBV3-1	TRBJ1-5
TGTGCCAGCAGTGACCCGGATCACGGGGAGCTGTTTTTT	CASSDPDHGELFF	TRBV6-1	TRBJ2-2
TGTGCCAGCAGTTACTCGAAACTAGCGAGTTGTGCCTACGAGCAGTACTTC	CASSYSKLASCAYEQYF	TRBV6-5	TRBJ2-7
TGCAGCGACTCTAGGGGAGGGGCCTCCTACGAGCAGTACTTC	CSDSRGGASYEQYF	TRBV29-1	TRBJ2-7
TGTGCCAGCAGCCAGGGAGACAGCCATGGAGAGATGAACACTGAAGCTTTCTTT	CASSQGDSHGEMNTEAFF	TRBV13	TRBJ1-1
TGTGCCAGCAGTCCTCTTCTCTACGAGCAGTACTTC	CASSPLLYEQYF	TRBV6-4	TRBJ2-7
TGTGCCAGCAGCCAAGCTATCGTCGACACGGCCTACGAGCAGTACTTC	CASSQAIVDTAYEQYF	TRBV14	TRBJ2-7
TGCGCCAGCAGCTTGCAATCAGTGGTTGAAAAACTGTTTTTT	CASSLQSVVEKLFF	TRBV5-1	TRBJ1-4
TGCAGCGCCGGGGCCCCCGGCTACGAGCAGTACTTC	CSAGAPGYEQYF	TRBV29-1	TRBJ2-7
TGTGCCAGCAGCACTCCGCCCAGGTGGGAGGCCTCCTATAATTCACCCCTCCACTTT	CASSTPPRWEASYNSPLHF	TRBV7-3	TRBJ1-6
TGTGCCACCGGGGGAGGGCGCACAGATACGCAGTATTTT	CATGGGRTDTQYF	TRBV6-4	TRBJ2-3
TGCGCCAGCAGAACTGGGGCAACCTCCCAGTACTTC	CASRTGATSQYF	TRBV5-1	TRBJ2-5
TGTGCCACCTTCGACTTCGCCTACGAGCAGTACTTC	CATFDFAYEQYF	TRBV15	TRBJ2-7
TGCGCCAGCAGTAGAAAATACGAGCAGTACTTC	CASSRKYEQYF	TRBV4-1	TRBJ2-7
TGTGCGTTGGACAGGGGAATCGCCAAAAACATTCAGTACTTC	CALDRGIAKNIQYF	TRBV6-5	TRBJ2-4
TGCAGTGCCCAGATCTATTCACCCCTCCACTTT	CSAQIYSPLHF	TRBV20-1	TRBJ1-6
TGTGCCAGCAGCAAAACCGAGCGGAGCACAGATACGCAGTATTTT	CASSKTERSTDTQYF	TRBV13	TRBJ2-3
TGTGCCAGCAGCTTTAAGGGGTTTGTTTCAGGCTATGGCTACACCTTC	CASSFKGFVSGYGYTF	TRBV5-4	TRBJ1-2
TGCGCCAGCAGCAGATGGACTAGCGGGGGGGCAAACTACGAGCAGTACTTC	CASSRWTSGGANYEQYF	TRBV5-1	TRBJ2-7
TGTGCCAGCAGGAGGGACCAGGAGATCCCCGGTTTGAGCTCCTACAATGAGCAGTTCTTC	CASRRDQEIPGLSSYNEQFF	TRBV6-1	TRBJ2-1
TGTGCCACCAGTGAAGAGCGGGACAATGAGCAGTTCTTC	CATSEERDNEQFF	TRBV24-1	TRBJ2-1
TGCGCCAGCAGCTTCCGAGCCAGACCGTTGCCCCAGCATTTT	CASSFRARPLPQHF	TRBV5-1	TRBJ1-5
TGTGCCAGCAGTTACGACAGTTTTCACGGCAATCAGCCCCAGCATTTT	CASSYDSFHGNQPQHF	TRBV6-2	TRBJ1-5
TGTGCCAGCAGCTGCCCGGGGGAGAGGGCCACTGAAGCTTTCTTT	CASSCPGERATEAFF	TRBV11-2	TRBJ1-1
TGTGCCAGCGGCAATCTCAGGGGTAGACACACTGAAGCTTTCTTT	CASGNLRGRHTEAFF	TRBV25-1	TRBJ1-1
TGCAGTGCGTGGAAAACCGCAGGGGGGGATGGCTACACCTTC	CSAWKTAGGDGYTF	TRBV20-1	TRBJ1-2
TGTGCCAGCAGCCCGGGACATAACAATGAGCAGTTCTTC	CASSPGHNNEQFF	TRBV7-4	TRBJ2-1
TGTGCCAGCGGTCTCGGCGGCACAGATACGCAGTATTTT	CASGLGGTDTQYF	TRBV25-1	TRBJ2-3
TGTGCCAGCAGCAGGGGACAGGGTCATAGCAATCAGCCCCAGCATTTT	CASSRGQGHSNQPQHF	TRBV7-9	TRBJ1-5
TGTGCCAGCCTCGATTCGTTCGGTGAGGGGAGGGAGTTCCACTACGAGCAGTACTTC	CASLDSFGEGREFHYEQYF	TRBV7-6	TRBJ2-7
TGTGCCATCAGTGAGGTGGGTACGACTGGGGCCAACGTCCTGACTTTC	CAISEVGTTGANVLTF	TRBV10-3	TRBJ2-6
TGTGCCAGCAGTTTAAGGACAGGGGGCGAGACCCAGTACTTC	CASSLRTGGETQYF	TRBV28	TRBJ2-5
TGTGCCAGCAGGGACCCGTATGAAAAACTGTTTTTT	CASRDPYEKLFF	TRBV14	TRBJ1-4
TGCGCCAGCAGCTTGGAGCCCCGAATCCAGGGCCTTCGTATATATCCTGATCAGCCCCAGCATTTT	CASSLEPRIQGLRIYPDQPQHF	TRBV5-1	TRBJ1-5
TGTGCCAGCAGCCATGCTCCCCAGTGCAGGGGAGCCCCGGGCTACGAGCAGTACTTC	CASSHAPQCRGAPGYEQYF	TRBV3-1	TRBJ2-7
TGCGCCAGCAGCCAACCCAGACAGGTTGTCTATGGCTACACCTTC	CASSQPRQVVYGYTF	TRBV4-1	TRBJ1-2
TGTGCCACCAGTGAGAGTCCGTTTGAGACCCAGTACTTC	CATSESPFETQYF	TRBV24-1	TRBJ2-5
TGCGCCAGCAGCTTTGCATCAGGAGATACGCAGTATTTT	CASSFASGDTQYF	TRBV4-1	TRBJ2-3
TGTGCCACCAGTGGCGCTATAATTTGCACAGATACGCAGTATTTT	CATSGAIICTDTQYF	TRBV24-1	TRBJ2-3
TGTGCCACCAGGAGATACGCAGTCGTGAACACTGAAGCTTTCTTT	CATRRYAVVNTEAFF	TRBV24-1	TRBJ1-1
TGTGCCAGCAGTCAGTTTTCCAACGAGCAGTACTTC	CASSQFSNEQYF	TRBV6-3	TRBJ2-7
TGTGCCAGCAGCAGACAGGGATGTTTGGGGGACGAGCAGTACTTC	CASSRQGCLGDEQYF	TRBV27	TRBJ2-7
TGCGCCAGCAGTGAGAGTGGGACAGGGGCGGGTGCCTACGAGCAGTACTTC	CASSESGTGAGAYEQYF	TRBV10-1	TRBJ2-7
TGCGCCAGCAGTGAGCGCTGGCTAGCGGGGATCTACGAGCAGTACTTC	CASSERWLAGIYEQYF	TRBV10-1	TRBJ2-7
TGTGCCATCTTACCTGTGCGGGGGACCGCTTTCTTT	CAILPVRGTAFF	TRBV19	TRBJ1-1
TGTGCCAGCAGCCCCTGCCCGGGTCCCCGGGAGGCCGGGACAGATACGCAGTATTTT	CASSPCPGPREAGTDTQYF	TRBV7-3	TRBJ2-3
TGTGCCAGCAGTGCCAGGGGAGGACTAGCGGGCGAGGAGCTGTTTTTT	CASSARGGLAGEELFF	TRBV6-1	TRBJ2-2
TGTGCCACCAGTGAGAGGACAGCAACATTCTATGGCTACACCTTC	CATSERTATFYGYTF	TRBV24-1	TRBJ1-2
TGTGCCAGCAGTTTATGCACTCAGCCTGAGCCCCAGCATTTT	CASSLCTQPEPQHF	TRBV28	TRBJ1-5
TGCGCCAGCAATAGCACCGGGACAGATGGGGATATTCATATATACGAGCAGTACTTC	CASNSTGTDGDIHIYEQYF	TRBV5-1	TRBJ2-7
TGTGCCAGCAGTTCCCCGCAGTACTTC	CASSSPQYF	TRBV6-5	TRBJ2-5
TGTGCCAGCAGCCTGTCCTCCTACAATGAGCAGTTCTTC	CASSLSSYNEQFF	TRBV7-9	TRBJ2-1
TGTGCCAGCAGTTTTTCCGGGACAGGGTATGACCAGAACACCGGGGAGCTGTTTTTT	CASSFSGTGYDQNTGELFF	TRBV6-3	TRBJ2-2
TGCGCCAGCACCTCGGGGGCAGCTCAGGGGAATGAGCAGTTCTTC	CASTSGAAQGNEQFF	TRBV10-1	TRBJ2-1
TGCGCCAGCAGCTGTCCGACTCAGGTAGCTGAGCAGTACTTC	CASSCPTQVAEQYF	TRBV5-1	TRBJ2-7
TGTGCCAGCAGTCCAGGACGGGAGACCTACGAGCAGTACTTC	CASSPGRETYEQYF	TRBV28	TRBJ2-7
TGTGTTCGGACTAGCCACACAGATACGCAGTATTTT	CVRTSHTDTQYF	TRBV7-3	TRBJ2-3
TGTGCCAGCAGCACTGGACCAACCGGGGAGCTGTTTTTT	CASSTGPTGELFF	TRBV7-9	TRBJ2-2
TGCGCCAGCGAAGGACGGGTTTTTCAAAGAAAACTGTTTTTT	CASEGRVFQRKLFF	TRBV4-3	TRBJ1-4
TGCGCCAGCAGCTTGAAACTGAGGGCCGGGGACTACGAGCAGTACTTC	CASSLKLRAGDYEQYF	TRBV5-1	TRBJ2-7
TGTGCCTGGTTGTATCTTGGCTACACCTTC	CAWLYLGYTF	TRBV30	TRBJ1-2
TGCGCCAGCAGTGAGACGTCCTATGGCTACACCTTC	CASSETSYGYTF	TRBV10-2	TRBJ1-2
TGTGCCAGCAGCTTGGAAGCGGGGGCGGGAAGGGCCCAGCATTTT	CASSLEAGAGRAQHF	TRBV11-2	TRBJ1-5
TGCAGTGCTAGCTCCGGTACGAGTGGGCAGTATTTT	CSASSGTSGQYF	TRBV20-1	TRBJ2-3
TGTGCCAGCAGCCTCCCGGGACTAGCGACCTTCTCCTACAATGAGCAGTTCTTC	CASSLPGLATFSYNEQFF	TRBV7-9	TRBJ2-1
TGTGCCTGGAGTGCTATTGCATCGGACACTGAAGCTTTCTTT	CAWSAIASDTEAFF	TRBV30	TRBJ1-1
TGTGCCAGCAGCCAGACATACTACTCTGGAAACACCATATATTTT	CASSQTYYSGNTIYF	TRBV7-3	TRBJ1-3
TGTGCCAGCAGTCGATCTCTCAAAACGGTCAAGGACTTC	CASSRSLKTVKDF	TRBV6-1	TRBJ2-5
TGTGCCAGCAGCCCCCGGGAGAATGGGATCCAGCAGTTCTTC	CASSPRENGIQQFF	TRBV3-1	TRBJ2-1
TGTGCCAGCAGTTTGGCAAGAGGCAATCAGCCCCAGCATTTT	CASSLARGNQPQHF	TRBV28	TRBJ1-5
TGTGCCAGCAGCGTAGTCCCGATGACAGGGTGGGGAAGTGAAGCTTTCTTT	CASSVVPMTGWGSEAFF	TRBV9	TRBJ1-1
TGTGCCATCAGTGATCAGGTTGCCAAAAACATTCAGTACTTC	CAISDQVAKNIQYF	TRBV10-3	TRBJ2-4
TGTGCCAGCATAGCGAACGGGACAGTTAATCAGCCCCAGCATTTT	CASIANGTVNQPQHF	TRBV12-4	TRBJ1-5
TGCAGTGCTAGAGAGCTGATCTGGGGACCGGCGCAGCCCCAGCATTTT	CSARELIWGPAQPQHF	TRBV20-1	TRBJ1-5
TGTGCCAGCAGTTACGAGGGCCAGACCGGAGGCTACGAGCAGTACTTC	CASSYEGQTGGYEQYF	TRBV6-5	TRBJ2-7
TGTGCCAACGTCGGGAGGGGCCAAGAGACCCAGTACTTC	CANVGRGQETQYF	TRBV10-3	TRBJ2-5
TGCGCCAGCAGCCAAGATCGTCTTCGTGAGCAGTTCTTC	CASSQDRLREQFF	TRBV4-1	TRBJ2-1
TGCGCCAGCAGCCAAGGGGGGGGACCTAATGAAAAACTGTTTTTT	CASSQGGGPNEKLFF	TRBV4-1	TRBJ1-4
TGTGCCAGCAGCTCCGGACAGGGGGCTTGTCTTAATTCACCCCTCCACTTT	CASSSGQGACLNSPLHF	TRBV7-6	TRBJ1-6
TGTGCCAGCAGCCTGTTGACCCAGGGCAAGGCCTACGAGCAGTACTTC	CASSLLTQGKAYEQYF	TRBV6-5	TRBJ2-7
TGTGCCAGCAGCCGTCCCACCCTTCACACTGAAGCTTTCTTT	CASSRPTLHTEAFF	TRBV3-1	TRBJ1-1
TGCGCCAGCAGCTGCTACCGGGACCCGCCGGGGGGGGAGAGGCCCTCTGGAAACACCATATATTTT	CASSCYRDPPGGERPSGNTIYF	TRBV5-1	TRBJ1-3
TGCGCCAGCAGCCAACCGGCTTCCCAAGAGACCCAGTACTTC	CASSQPASQETQYF	TRBV4-1	TRBJ2-5
TGTGCCAGCCCTCTCCCCCGGGAAGGAGATAGCAATCAGCCCCAGCATTTT	CASPLPREGDSNQPQHF	TRBV9	TRBJ1-5
TGTGCCAGCAGTCTGGGGACAGGGGTACCCGCCGGAGCCAAAAACATTCAGTACTTC	CASSLGTGVPAGAKNIQYF	TRBV6-4	TRBJ2-4
TGTGCCAGCAAGCGGGGTTATAGCAATCAGCCCCAGCATTTT	CASKRGYSNQPQHF	TRBV27	TRBJ1-5
TGTGCCAGCAGCTGGCCGGGACAGCTTGGTGCTAGCACAGATACGCAGTATTTT	CASSWPGQLGASTDTQYF	TRBV13	TRBJ2-3
TGTGCCAGCAGCATTGTACAAAGGACTAGCGGGCCGACCTACAATGAGCAGTTCTTC	CASSIVQRTSGPTYNEQFF	TRBV11-2	TRBJ2-1
TGTGCCATCAGTGCGGCCGGCGACAGACCGGGACTATTAGATACGCAGTATTTT	CAISAAGDRPGLLDTQYF	TRBV10-3	TRBJ2-3
TGTGCCAGCCGGAGACAGGAAAAACTGTTTTTT	CASRRQEKLFF	TRBV2	TRBJ1-4
TGTGCCAGCAGCTTAGTTACTAGGTCCAAGAGCTCCTACAATGAGCAGTTCTTC	CASSLVTRSKSSYNEQFF	TRBV13	TRBJ2-1
TGCAGTGCTTCCTCGCGGAACGAGCAGTACTTC	CSASSRNEQYF	TRBV20-1	TRBJ2-7
TGTGCCAGCAGAGGTGACAGGGAGGTTTCTAATGAGCAGTTCTTC	CASRGDREVSNEQFF	TRBV7-3	TRBJ2-1
TGTGCCAGCAAGCCCGGGACTAGCGGGGGGGCGACAGAGACCCAGTACTTC	CASKPGTSGGATETQYF	TRBV9	TRBJ2-5
TGCGCCAGCAGTGGCAGGTTGGCCCAGGGGGGTACCCCCCACGAGCAGTACTTC	CASSGRLAQGGTPHEQYF	TRBV10-1	TRBJ2-7
TGTGCCAGCAGTCTGGCAGGGCTGGCGCATGGCTACACCTTC	CASSLAGLAHGYTF	TRBV6-1	TRBJ1-2
TGCAGTGCTAGTAGAGAGCGGCAAGAGACCCAGTACTTC	CSASRERQETQYF	TRBV20-1	TRBJ2-5
TGTGCCAGCAGTTTCCTAGGGGAGGGGGAGCTGTTTTTT	CASSFLGEGELFF	TRBV28	TRBJ2-2
TGTGCCAGCAGGAGGGGTCAGGAGCAAACCGGGGAGCTGTTTTTT	CASRRGQEQTGELFF	TRBV6-4	TRBJ2-2
TGTGCCTATCGATTGGACAGTCAGCCCAACAATGAGCAGTTCTTC	CAYRLDSQPNNEQFF	TRBV30	TRBJ2-1
TGTGCAAACCCAATAAAAAACACTTACAATGAGCAGTTCTTC	CANPIKNTYNEQFF	TRBV9	TRBJ2-1
TGTGCCAGCAGCGGATATGGGGAATCTAATGAGCAGTTCTTC	CASSGYGESNEQFF	TRBV7-3	TRBJ2-1
TGTGCCAGCAGCCCAGAGTACGAGCAGTACTTC	CASSPEYEQYF	TRBV6-5	TRBJ2-7
TGTGCCAGCAGCCAAGGCAGACCCCGGGACAGGGGGGGTACGAACACCGGGGAGCTGTTTTTT	CASSQGRPRDRGGTNTGELFF	TRBV14	TRBJ2-2
TGTGCCAGCAGGCGTACAGGGGCTAGTGTGAACGAGACCCAGTACTTC	CASRRTGASVNETQYF	TRBV2	TRBJ2-5
TGTGCCAGCAGTGGACTGATAGCCCAAGAGACCCAGTACTTC	CASSGLIAQETQYF	TRBV28	TRBJ2-5
TGCGCCAGCAGCGCGGAAGCGGGACAGGAGGGAGCTGGGGCCAACGTCCTGACTTTC	CASSAEAGQEGAGANVLTF	TRBV5-1	TRBJ2-6
TGCAGCGTTGGTCCCCGACCTAGACTTTCTAGCACAGATACGCAGTATTTT	CSVGPRPRLSSTDTQYF	TRBV29-1	TRBJ2-3
TGTGCCAGCAGCCAAGATACCGGGTCCATTAGGGTTGAAAAACTGTTTTTT	CASSQDTGSIRVEKLFF	TRBV14	TRBJ1-4
TGTGCCACCAGCAGAGGATCATCCGGGACTAGCGGCAGGTTAGATACGCAGTATTTT	CATSRGSSGTSGRLDTQYF	TRBV15	TRBJ2-3
TGCAGTGCCCATAGCGGGCCCTTGAACACCGGGGAGCTGTTTTTT	CSAHSGPLNTGELFF	TRBV20-1	TRBJ2-2
TGTGCCAGCAGTGATCTGCGACAGGGCCAAGAGACCCAGTACTTC	CASSDLRQGQETQYF	TRBV6-1	TRBJ2-5
TGTGCCAGCAGCTTGTCGGCGGGGGCCAAAAACATTCAGTACTTC	CASSLSAGAKNIQYF	TRBV7-6	TRBJ2-4
TGTGCTAGTGGTTTGTGGGAAACTAGCGGAACCGGGGAGCTGTTTTTT	CASGLWETSGTGELFF	TRBV12-5	TRBJ2-2
TGTGCCTGGAGTGTACCAGCACCGACGGACAAACGTAAGGGCTCCTATAATTCACCCCTCCACTTT	CAWSVPAPTDKRKGSYNSPLHF	TRBV30	TRBJ1-6
TGTGCCAGCAGTTTAGGGGGGGCCCACGAGCAGTACTTC	CASSLGGAHEQYF	TRBV27	TRBJ2-7
TGTGCCAGCAGCACGTCAGGGGGGATCTATGGCTACACCTTC	CASSTSGGIYGYTF	TRBV7-9	TRBJ1-2
TGTGCCAGCGGACAGCCCGTCGGGGAGCTGTTTTTT	CASGQPVGELFF	TRBV2	TRBJ2-2
TGTGCCAGCAATGTCGAAAGGGACTACAATGAGCAGTTCTTC	CASNVERDYNEQFF	TRBV7-7	TRBJ2-1
TGTGCCATCTTTGGAGGCAGGACGTACCAAGAGACCCAGTACTTC	CAIFGGRTYQETQYF	TRBV10-3	TRBJ2-5
TGTGCCAAACCGCCACTAGGATTCGGGAATCAGCCCCAGCATTTT	CAKPPLGFGNQPQHF	TRBV6-1	TRBJ1-5
TGTGCCAGCAGTTACATGAGGGACGGTTATAGCAATCAGCCCCAGCATTTT	CASSYMRDGYSNQPQHF	TRBV6-6	TRBJ1-5
TGTGCCAGCAGCGTGCGACAGGTACCGAAAGACTATGGCTACACCTTC	CASSVRQVPKDYGYTF	TRBV5-4	TRBJ1-2
TGTGCCACCAGGGCCGGGACTAGCGGCCAGTACTTC	CATRAGTSGQYF	TRBV24-1	TRBJ2-5
TGTGCCAGCATCAGCAGGGAGATTCCGCCTCCCCAGCCCCAGCATTTT	CASISREIPPPQPQHF	TRBV7-2	TRBJ1-5
TGTGCCAGCAGCTGGCAGGGCTCGAACACCGGGGAGCTGTTTTTT	CASSWQGSNTGELFF	TRBV7-2	TRBJ2-2
TGTGCCATCAGTGACAAGCACAATCAGCCCCAGCATTTT	CAISDKHNQPQHF	TRBV10-3	TRBJ1-5
TGCGCCAGCAGCGTCCGGACAGGGGGCGTCGTCGAGCAGTACTTC	CASSVRTGGVVEQYF	TRBV4-1	TRBJ2-7
TGCAGTGCTAGCCTTAACCCGACGGGAGCCACTGAAGCTTTCTTT	CSASLNPTGATEAFF	TRBV20-1	TRBJ1-1
TGTGCCAGCAGTGGTTTTAATCATCCGGGACAAGCCTACGAGCAGTACTTC	CASSGFNHPGQAYEQYF	TRBV12-3	TRBJ2-7
TGTGCCAGCAGAAGCCGGAGAACGGACAGGGATTGGGAGCTGTTTTTT	CASRSRRTDRDWELFF	TRBV6-4	TRBJ2-2
TGTGCCAGCAGTAGGGAATCTCTTAACGAGACCCAGTACTTC	CASSRESLNETQYF	TRBV6-5	TRBJ2-5
TGTGCCAGCAGCCACCCCAGGGGCGATCAGCCCCAGCATTTT	CASSHPRGDQPQHF	TRBV14	TRBJ1-5
TGTGCCATCAGGGGGCCCACCGGGGGCACTGAAGCTTTCTTT	CAIRGPTGGTEAFF	TRBV10-3	TRBJ1-1
TGTGCCAGCAGCCCTCGTGACGGGAGTAAGCACTACGAGCAGTACTTC	CASSPRDGSKHYEQYF	TRBV13	TRBJ2-7
TGTGCCCGACCGGGACTAGCTGAAGGGTCGGGATTGGTCACAGATACGCAGTATTTT	CARPGLAEGSGLVTDTQYF	TRBV6-5	TRBJ2-3
TGTGCCAGCAAGACAGGGGCGATCAATCAGCCCCAGCATTTT	CASKTGAINQPQHF	TRBV6-5	TRBJ1-5
TGTGCCAGCAGTTTGACACAAAGGGGGGAGGATGAAGCTTTCTTT	CASSLTQRGEDEAFF	TRBV28	TRBJ1-1
TGCAGTGCTTTGACTCGCGGGACAGTCCCCGGGGAGCTGTTTTTT	CSALTRGTVPGELFF	TRBV20-1	TRBJ2-2
TGTGCCAGCAGCGGGAGGACAGCCGAGCAGTACTTC	CASSGRTAEQYF	TRBV9	TRBJ2-7
TGTGCCTGGACTGGGGGGGCCCGCAGTAATGAGCAGTTCTTC	CAWTGGARSNEQFF	TRBV30	TRBJ2-1
TGCGCCAGCAGCCAAGGGGCCGGGACAGGCGTCCAAGAGACCCAGTACTTC	CASSQGAGTGVQETQYF	TRBV4-3	TRBJ2-5
TGTGCCAGCAGCAATGATAAAGGGATTTACGAGCAGTACTTC	CASSNDKGIYEQYF	TRBV7-3	TRBJ2-7
TGTGCCAGTAGGGGGCACAGTTGCTACGAGCAGTACTTC	CASRGHSCYEQYF	TRBV27	TRBJ2-7
TGCAGTGCAGGGTCGGCACGCACAGATACGCAGTATTTT	CSAGSARTDTQYF	TRBV20-1	TRBJ2-3
TGTGCCAGCAGTACCACAGGTTTCAATCAGCCCCAGCATTTT	CASSTTGFNQPQHF	TRBV6-1	TRBJ1-5
TGTGCCAGCAGCCAGATAGCCAGGGGCTTTGGCTACACCTTC	CASSQIARGFGYTF	TRBV13	TRBJ1-2
TGTGCCAGCAGTTTCGAAGGCGCGCCTGGAAACACCATATATTTT	CASSFEGAPGNTIYF	TRBV27	TRBJ1-3
TGCAGTGCACGACGATATCCACACACGAGCACTGAAGCTTTCTTT	CSARRYPHTSTEAFF	TRBV20-1	TRBJ1-1
TGCAGTGCTACCGGGACAGGGGGCCAGCCCCAGCATTTT	CSATGTGGQPQHF	TRBV20-1	TRBJ1-5
TGTGCCAGCAGGCCCTCTGGACAAGGAGTGGGAAGGGCTTTCTTT	CASRPSGQGVGRAFF	TRBV6-4	TRBJ1-1
TGTGCCAGGGCGGGACTATACAATGAGCAGTTCTTC	CARAGLYNEQFF	TRBV13	TRBJ2-1
TGTGCCAGCAGTGAGGCTTGGGGTAAGAATCCCTTACTGGATGAAAAACTGTTTTTT	CASSEAWGKNPLLDEKLFF	TRBV12-3	TRBJ1-4
TGTGCCAGCAGCCAAGCGGGACAGGGGGTGCAAGAGACCCAGTACTTC	CASSQAGQGVQETQYF	TRBV14	TRBJ2-5
TGTGCCAGCAGCCGCGGGGAAAGGGGTCGGAGCTCCTATAATTCACCCCTCCACTTT	CASSRGERGRSSYNSPLHF	TRBV5-4	TRBJ1-6
TGTGCCAGCAGTTACTCCTGGACAGGGGATGAAAAACTGTTTTTT	CASSYSWTGDEKLFF	TRBV6-2	TRBJ1-4
TGTACCCCGGGGTACGAGCAGTACTTC	CTPGYEQYF	TRBV6-5	TRBJ2-7
TGTGCCAGCAGTTTAAAGGGGGAAAAGACTCTTGGCTACACCTTC	CASSLKGEKTLGYTF	TRBV27	TRBJ1-2
TGTGCCAGCGGAAGCTGGAGGGGTAAAGACGAGCAGTACTTC	CASGSWRGKDEQYF	TRBV27	TRBJ2-7
TGCAGCGGGCCAGCGGGATACCCATCCTACGAGCAGTACTTC	CSGPAGYPSYEQYF	TRBV29-1	TRBJ2-7
TGCAGTGCGGGCGAGGGACTAGCGGGAGATAGGGACTACGAGCAGTACTTC	CSAGEGLAGDRDYEQYF	TRBV20-1	TRBJ2-7
TGTGCCAGCAGCATTAGATTGGCCTACGAGCAGTACTTC	CASSIRLAYEQYF	TRBV5-4	TRBJ2-7
TGTGCCTGGAGTGTACACGGGCCTGCGGGAGGACTGGGCGGGAACACTGAAGCTTTCTTT	CAWSVHGPAGGLGGNTEAFF	TRBV30	TRBJ1-1
TGTGCCAGCAGCCCCCAGGTATACACTGAAGCTTTCTTT	CASSPQVYTEAFF	TRBV7-3	TRBJ1-1
TGCAGCCGTCTCGAAGCATCGAGGTCACCCCTCCACTTT	CSRLEASRSPLHF	TRBV29-1	TRBJ1-6
TGTGCCAGCAGTTCTATTGTCTTGACAGGGTCACCCCTCCACTTT	CASSSIVLTGSPLHF	TRBV6-1	TRBJ1-6
TGTGCCACCAGTGATTTGGATCGGGACAGTAGAGATACGCAGTATTTT	CATSDLDRDSRDTQYF	TRBV24-1	TRBJ2-3
TGTGCCAGTAGTATAGATCAGGGGGGGGGCGAACTTGGGGACTCCTACGAGCAGTACTTC	CASSIDQGGGELGDSYEQYF	TRBV19	TRBJ2-7
TGTGCCAGCAGCCGAAGGGGGGGCCCGGTGAACACTGAAGCTTTCTTT	CASSRRGGPVNTEAFF	TRBV11-3	TRBJ1-1
TGTGCCAGCAGTTACACCGGGGTAGCCGCAGAGACCCAGTACTTC	CASSYTGVAAETQYF	TRBV6-5	TRBJ2-5
TGTGCCAGCAGTGAAGCGCTTGAGGGGGGATCCTACGAGCAGTACTTC	CASSEALEGGSYEQYF	TRBV2	TRBJ2-7
TGTGCCAGCAGTATCAGGGTCGAACAAGAGACCCAGTACTTC	CASSIRVEQETQYF	TRBV6-5	TRBJ2-5
TGCGCCAGCAGCTTGTCACAGGGGTGGGAGATGCAGGGCACCGGGGAGCTGTTTTTT	CASSLSQGWEMQGTGELFF	TRBV5-1	TRBJ2-2
TGTGCCACCAGTGATTTAACCTTGCCGGGACTAGGCTCTGATGAGCAGTTCTTC	CATSDLTLPGLGSDEQFF	TRBV24-1	TRBJ2-1
TGCAGTGCTCCCCCGGGCCGCGCCCAAGAGACCCAGTACTTC	CSAPPGRAQETQYF	TRBV20-1	TRBJ2-5
TGTGCCAGCAGCGGACTAGCGGGGGGGCCGGACAATGAGCAGTTCTTC	CASSGLAGGPDNEQFF	TRBV6-1	TRBJ2-1
TGCGCCAGCAGCGACAGCGGGAGTTGCTCCTACGAGCAGTACTTC	CASSDSGSCSYEQYF	TRBV4-1	TRBJ2-7
TGTGCCAGCACAGGGACAGAAAAATCCTACGAGCAGTACTTC	CASTGTEKSYEQYF	TRBV9	TRBJ2-7
TGTGCCATTAGAAACAATGAGCAGTTCTTC	CAIRNNEQFF	TRBV27	TRBJ2-1
TGTGCCAGCAGCGGTGTAGGGGGGGGGGGGTACGAGCAGTACTTC	CASSGVGGGGYEQYF	TRBV13	TRBJ2-7
TGTGCCAGCAGTTTATTGCTGTACTACGAGCAGTACTTC	CASSLLLYYEQYF	TRBV27	TRBJ2-7
TGTGCCAGCAGTGTAGGACCGCAAATCGGAGGGACGAGAAATAATTCACCCCTCCACTTT	CASSVGPQIGGTRNNSPLHF	TRBV6-4	TRBJ1-6
TGTGCCAGCAGCATAAAATACCGGGAGCCGTCCGAGCAGTACTTC	CASSIKYREPSEQYF	TRBV5-6	TRBJ2-7
TGTGCCAGCAGCCCGCGGCGGGAGGAAGGCGATTCACCCCTCCACTTT	CASSPRREEGDSPLHF	TRBV7-3	TRBJ1-6
TGTGCCAGCAGCCAACCAAGATACAGGGAGGATTCACCCCTCCACTTT	CASSQPRYREDSPLHF	TRBV3-1	TRBJ1-6
TGTGCCAGCAGTGGCTTCTCCGCCCTCTACGAGCAGTACTTC	CASSGFSALYEQYF	TRBV6-4	TRBJ2-7
TGTGCCAGCGCAGTCGGGACAGGGAACACTGAAGCTTTCTTT	CASAVGTGNTEAFF	TRBV27	TRBJ1-1
TGCGCCAGCAGCTTGGGGCTGACGGGGACTTATGGCTACACCTTC	CASSLGLTGTYGYTF	TRBV5-1	TRBJ1-2
TGCAGTGCGCAGCCGGACAAAGGAGATCCTGGGGCCAACGTCCTGACTTTC	CSAQPDKGDPGANVLTF	TRBV20-1	TRBJ2-6
TGTGCCAGCAGTGAATCACCGGGAATTTTGCTCGTGGATTACAATGAGCAGTTCTTC	CASSESPGILLVDYNEQFF	TRBV25-1	TRBJ2-1
TGTGCCAGCAGTTGTAAATCGGGAGCGAAGGCTTTCTTT	CASSCKSGAKAFF	TRBV6-5	TRBJ1-1
TGTGCCAGCAGCGTTATGACTAGCGGGCCGGCAGATACGCAGTATTTT	CASSVMTSGPADTQYF	TRBV9	TRBJ2-3
TGCGCCAGCACCCAAAAAGTGGACAGGGATCAGACAACACCGTACACCGGGGAGCTGTTTTTT	CASTQKVDRDQTTPYTGELFF	TRBV5-1	TRBJ2-2
TGTGCCAGCAGCTTAAGGCCCTTTGCAGATACGCAGTATTTT	CASSLRPFADTQYF	TRBV7-3	TRBJ2-3
TGCGCCAGCAGCCAAGATGCCGCCGGGACAGGGCTATTTGAAAAACTGTTTTTT	CASSQDAAGTGLFEKLFF	TRBV4-3	TRBJ1-4
TGTGCCAGCAGCCAAGGACACCGGACAAATCGGCCAGGGGTCAGTTCACCCCTCCACTTT	CASSQGHRTNRPGVSSPLHF	TRBV3-1	TRBJ1-6
TGTGCCAGCAGCCAAGATGTCGACAGGGGGGGCCGCTACGAGCAGTACTTC	CASSQDVDRGGRYEQYF	TRBV3-1	TRBJ2-7
TGCGCCAGCAGAAGGACTAGCGGATGGGATCAGGGGTGGGAGACCCAGTACTTC	CASRRTSGWDQGWETQYF	TRBV10-2	TRBJ2-5
TGTCAACGGGACACTAACTATGGCTACACCTTC	CQRDTNYGYTF	TRBV6-6	TRBJ1-2
TGCAGTGCTAGAAGGGCGAGAGGGGGTAATGAAAAACTGTTTTTT	CSARRARGGNEKLFF	TRBV20-1	TRBJ1-4
TGTGCCAGCAGCTTTCCCCCCGAGACAGGGGATGGGGGCTACACCTTC	CASSFPPETGDGGYTF	TRBV7-4	TRBJ1-2
TGTGCCAGCAGCCCAGGGGCCCCACATGAGACCCAGTACTTC	CASSPGAPHETQYF	TRBV13	TRBJ2-5
TGCGCCAGCAGCCAAGATGGGGGGGGGGGACGCGGCTACGAGCAGTACTTC	CASSQDGGGGRGYEQYF	TRBV4-3	TRBJ2-7
TGTGCCAGCAGCGCTAGCGGGGTAATAAATGGCACAGATACGCAGTATTTT	CASSASGVINGTDTQYF	TRBV12-3	TRBJ2-3
TGCGCCAGCAGTGACTACAAGGGGGCGAAAGGTGGAAGCAATGAGCAGTTCTTC	CASSDYKGAKGGSNEQFF	TRBV10-1	TRBJ2-1
TGTGCCAGCAGCCAATCGCTATTAACTCTCAGGTTACAAAGCTACGAGCAGTACTTC	CASSQSLLTLRLQSYEQYF	TRBV16	TRBJ2-7
TGTGCCACCAGTGATTTGGGCCGCAACGCCCCCACCTACGAGCAGTACTTC	CATSDLGRNAPTYEQYF	TRBV24-1	TRBJ2-7
TGTGCCAGCAGCCAAGACTATGCCCCGGGACAGGGTGGCAATCAGCCCCAGCATTTT	CASSQDYAPGQGGNQPQHF	TRBV4-2	TRBJ1-5
TGCGCCAGCAGCCAAGTTTTTCATCGGGACTGTTCCCGCTACAATGAGCAGTTCTTC	CASSQVFHRDCSRYNEQFF	TRBV4-3	TRBJ2-1
TGTGCCAGCAGCTGTTACGTACAGGGCCATAGCAATCAGCCCCAGCATTTT	CASSCYVQGHSNQPQHF	TRBV7-9	TRBJ1-5
TGCAGCGTTGACCAGGGCATGAACACTGAAGCTTTCTTT	CSVDQGMNTEAFF	TRBV29-1	TRBJ1-1
TGTGCCAGCAGCCAAGATCCGAGTTTAGGCCGCCCCTATAATTCACCCCTCCACTTT	CASSQDPSLGRPYNSPLHF	TRBV3-1	TRBJ1-6
TGTGCCAGCAGTGAATCGAGGACAGGGTTTAACTATGGCTACACCTTC	CASSESRTGFNYGYTF	TRBV25-1	TRBJ1-2
TGCAGTGCTAGGAGAGTCCCGGGGACAGGGGGCCGACTTACTGAAGCTTTCTTT	CSARRVPGTGGRLTEAFF	TRBV20-1	TRBJ1-1
TGTGCCAGCTCACCATTTGGGGAGGGGAACACTGAAGCTTTCTTT	CASSPFGEGNTEAFF	TRBV18	TRBJ1-1
TGCGCCAGCAGCCAAGATAATCGTTTAACAGGGGGCCGTAATAGCAATCAGCCCCAGCATTTT	CASSQDNRLTGGRNSNQPQHF	TRBV4-3	TRBJ1-5
TGTGCCAGCAAGCGGGAGGCCCTGCCCTACGAGCAGTACTTC	CASKREALPYEQYF	TRBV9	TRBJ2-7
TGTGCCACCAGTGATGTCCGGGACAGGGTTCCTAGAACTGAAAAACTGTTTTTT	CATSDVRDRVPRTEKLFF	TRBV24-1	TRBJ1-4
TGTGCCAGCAGTTACGCGGCCGGGACAGGGCCTCTTAGCGAAAAACTGTTTTTT	CASSYAAGTGPLSEKLFF	TRBV27	TRBJ1-4
TGCAGTGCTAGAGCGAACAATTACGCGAACACCGGGGAGCTGTTTTTT	CSARANNYANTGELFF	TRBV20-1	TRBJ2-2
TGCGAGGATACATTAAGACAGGGGGCACCGTTGAACACCGGGGAGCTGTTTTTT	CEDTLRQGAPLNTGELFF	TRBV5-1	TRBJ2-2
TGTGCCAGCAGCGTTGGACAGGGGGCATATGGCTACACCTTC	CASSVGQGAYGYTF	TRBV9	TRBJ1-2
TGTGCCAGTAGCTTATTCACGGGACAGCTGTCTAATGAAAAACTGTTTTTT	CASSLFTGQLSNEKLFF	TRBV19	TRBJ1-4
TGTGCCAGCAGCTTAAGGGGACAGGGAGCTGAAGCTTTCTTT	CASSLRGQGAEAFF	TRBV7-3	TRBJ1-1
TGTGCCAGCAGCCAACCGAGGGAGGGAAACACCATATATTTT	CASSQPREGNTIYF	TRBV14	TRBJ1-3
TGTGCCAGCAGCGACTGGGACTCAACCGACAGGGGTCTTTCACAGAACACTGAAGCTTTCTTT	CASSDWDSTDRGLSQNTEAFF	TRBV5-6	TRBJ1-1
TGTGCCAGCAGTGGGACAACTAATGAAAAACTGTTTTTT	CASSGTTNEKLFF	TRBV6-4	TRBJ1-4
TGTGCCAGCAGTTTATTCCAAAAGCGAAGGGGGGATTCACCCCTCCACTTT	CASSLFQKRRGDSPLHF	TRBV27	TRBJ1-6
TGTGCCAGCAGCTATTTACTACGTAGCGGGTCCAATGAGCAGTTCTTC	CASSYLLRSGSNEQFF	TRBV11-3	TRBJ2-1
TGTGCCAGCAGCTGTGAAAGGCAATTAACTAGCACAGATACGCAGTATTTT	CASSCERQLTSTDTQYF	TRBV11-3	TRBJ2-3
TGTGCCACCAGGCTACGAATGAACACTGAAGCTTTCTTT	CATRLRMNTEAFF	TRBV15	TRBJ1-1
TGTGCCAGCAGTGACAGAACTAGAACGGGGCTGGATACGCAGTATTTT	CASSDRTRTGLDTQYF	TRBV6-4	TRBJ2-3
TGTGCCAGCAGTTCCGGGGCGCGTGCAACTAATGAAAAACTGTTTTTT	CASSSGARATNEKLFF	TRBV9	TRBJ1-4
TGTGCCAGCAGCCAAGCAAACGGACCAAGGGGCAGAGACGAGCAGTACTTC	CASSQANGPRGRDEQYF	TRBV14	TRBJ2-7
TGTGCGGCAACTCTTCGTCAGCCCCACACAGATACGCAGTATTTT	CAATLRQPHTDTQYF	TRBV9	TRBJ2-3
TGTGCCAGCAGCCCCCGGGCCCCCCTACCTAATGAAAAACTGTTTTTT	CASSPRAPLPNEKLFF	TRBV13	TRBJ1-4
TGTGCCAGCAGCTTTGCAAGGGTTAGCACAGATACGCAGTATTTT	CASSFARVSTDTQYF	TRBV11-3	TRBJ2-3
TGTGCCAGCAGTGGAGAACTAGCACGCTACAATGAGCAGTTCTTC	CASSGELARYNEQFF	TRBV27	TRBJ2-1
TGTGCCACCAGTGATTTCGGACTAGCGGGCTACGAGCAGTACTTC	CATSDFGLAGYEQYF	TRBV24-1	TRBJ2-7
TGCGCCAGCAGCCGAGGGCTGGACGAGCAGTACTTC	CASSRGLDEQYF	TRBV5-1	TRBJ2-7
TGTGCCAGCAGTTACATTGCAGGGGGAGCCTACGAGCAGTACTTC	CASSYIAGGAYEQYF	TRBV6-5	TRBJ2-7
TGTGCCAGCAGTTTAGCGAGGCCCCTCTCCTACGAGCAGTACTTC	CASSLARPLSYEQYF	TRBV6-2	TRBJ2-7
TGCAGTGCTACATGGGGGAGTAATGAAAAACTGTTTTTT	CSATWGSNEKLFF	TRBV20-1	TRBJ1-4
TGTGCCAGCAGCACGGGAAACTATGGCTACACCTTC	CASSTGNYGYTF	TRBV7-6	TRBJ1-2
TGTGCCAGCAGGGACCAGGGGGGAATTTTATCCTATAATTCACCCCTCCACTTT	CASRDQGGILSYNSPLHF	TRBV6-2	TRBJ1-6
TGCGCCATCGGGTCGGGTATCTTC	CAIGSGIF	TRBV10-1	TRBJ2-1
TGTGCCAGCAACGGACACATGGCCGAGCAGTACTTC	CASNGHMAEQYF	TRBV12-4	TRBJ2-7
TGTGCCAGCAGCCCTAATAAGGGAGAGACCCAGTACTTC	CASSPNKGETQYF	TRBV7-6	TRBJ2-5
TGTGCCAGCAGCCAGGCAGAGGGTAACTATGGCTACACCTTC	CASSQAEGNYGYTF	TRBV4-2	TRBJ1-2
TGCAGCGTTGTCCAGGGTAATTCACCCCTCCACTTT	CSVVQGNSPLHF	TRBV29-1	TRBJ1-6
TGTGCCACCAGTGAGGTGACGGATAATTCACCCCTCCACTTT	CATSEVTDNSPLHF	TRBV24-1	TRBJ1-6
TGTGCCAGCAGTGAACGGCTTGGCCAGTCTGGGGCCAACGTCCTGACTTTC	CASSERLGQSGANVLTF	TRBV25-1	TRBJ2-6
TGTGCCAGCAGGGGACAGGGGTTAGACCACGAGCAGTACTTC	CASRGQGLDHEQYF	TRBV6-6	TRBJ2-7
TGTGCCACCAGTGACACCCTAGGGGGGGGGCTGAATAGGAAAGACAATGAGCAGTTCTTC	CATSDTLGGGLNRKDNEQFF	TRBV24-1	TRBJ2-1
TGTGCCAGCAGCGGGGGCTTGAATTATGAGCAGTTCTTC	CASSGGLNYEQFF	TRBV7-8	TRBJ2-1
TGTGCCAGCAAAATTAAGGGCGTTACGCAGTATTTT	CASKIKGVTQYF	TRBV7-4	TRBJ2-3
TGCGCCAGCAGCCAAGCTTGGGGGGTTCTCGTTAAATCCTATGGCTACACCTTC	CASSQAWGVLVKSYGYTF	TRBV4-1	TRBJ1-2
TGTGCCAGTGGACTTGGCTACACCTTC	CASGLGYTF	TRBV19	TRBJ1-2
TGTGCCAGCAGCGTAATACCACAGGGGACGTATAGACAAGGAACAAGCTCCTACGAGCAGTACTTC	CASSVIPQGTYRQGTSSYEQYF	TRBV9	TRBJ2-7
TGTGCCAGCAGGAATGGGACAGGGGGGCAGAACTACGAGCAGTACTTC	CASRNGTGGQNYEQYF	TRBV6-6	TRBJ2-7
TGTGCCAGCAGCATGGACCGGATTCCAGATACGCAGTATTTT	CASSMDRIPDTQYF	TRBV13	TRBJ2-3
TGTGCCCGGGGGTCCGGGACAGGGAGTTCGCAGCCCCAGCATTTT	CARGSGTGSSQPQHF	TRBV7-2	TRBJ1-5
TGCGCCAGCAGCGGAGAGCTAGGTGCCGGGGGCGCAACTAATGAAAAACTGTTTTTT	CASSGELGAGGATNEKLFF	TRBV5-1	TRBJ1-4
TGCGCCAGCGGGGGACAGGGGAGCCGATACCGTTTTCACGAGCAGTACTTC	CASGGQGSRYRFHEQYF	TRBV10-1	TRBJ2-7
TGTGCCAGCAGTTTGCCCCGGGGGCTGGAAAAACTGTTTTTT	CASSLPRGLEKLFF	TRBV6-2	TRBJ1-4
TGTGCCAGCAGTTTACGGGCTAGCGGGGGGGAGACCCAGTACTTC	CASSLRASGGETQYF	TRBV27	TRBJ2-5
TGTGCCAGCAGTGAATTTGACAGGGGGCTCCAATATGGCTACACCTTC	CASSEFDRGLQYGYTF	TRBV6-1	TRBJ1-2
TGTGCCATCGCGAATTGGTGGGGATGGCTATGGAATCAGCCCCAGCATTTT	CAIANWWGWLWNQPQHF	TRBV19	TRBJ1-5
TGTGCCAGCAGTTCCCGTACTAAAACCCCCTACTACGAGCAGTACTTC	CASSSRTKTPYYEQYF	TRBV6-3	TRBJ2-7
TGTGCCAGCAGCCAAGTGGGATCCACAGGGTCGGGAAACACCATATATTTT	CASSQVGSTGSGNTIYF	TRBV14	TRBJ1-3
TGTGCCAGCAGTTACCCGAGGGGCAAATCCTACAATGAGCAGTTCTTC	CASSYPRGKSYNEQFF	TRBV6-2	TRBJ2-1
TGTGCCAGCAATCAAGAAAGCGGGATGAACACTGAAGCTTTCTTT	CASNQESGMNTEAFF	TRBV6-5	TRBJ1-1
TGTGCCAGCAGCCGCACCGGAGGGCGTCCTAGCACAGATACGCAGTATTTT	CASSRTGGRPSTDTQYF	TRBV13	TRBJ2-3
TGTGGACAGGGAGTGGCAACTAATGAAAAACTGTTTTTT	CGQGVATNEKLFF	TRBV11-3	TRBJ1-4
TGTGCCAGCAGAGAGTGCGGGACGAACACTGAAGCTTTCTTT	CASRECGTNTEAFF	TRBV27	TRBJ1-1
TGTGCCAGCAGCCACACCGGGTACTTC	CASSHTGYF	TRBV27	TRBJ2-4
TGTGCCAGCTCACCCCCAGGACTAGAGCACACAGATACGCAGTATTTT	CASSPPGLEHTDTQYF	TRBV18	TRBJ2-3
TGTGCCACCAGCAGAGGGGGTCTTAAGAATGAAAAACTGTTTTTT	CATSRGGLKNEKLFF	TRBV15	TRBJ1-4
TGCGCCAGCCGCAGGGGGGAGCAGTACTTC	CASRRGEQYF	TRBV10-1	TRBJ2-7
TGTGCCTGGAGTTGGGAGTTGGGGACAGGGGGAATCTACGAGCAGTACTTC	CAWSWELGTGGIYEQYF	TRBV30	TRBJ2-7
TGTGCCAGCAGTGGTTCGGAGGGGGCGCCGGCGGTCCGCAATCAGCCCCAGCATTTT	CASSGSEGAPAVRNQPQHF	TRBV2	TRBJ1-5
TGCAGTGCAATCGGGCCGAGGGACAGAACTATGGCCACTGAAGCTTTCTTT	CSAIGPRDRTMATEAFF	TRBV20-1	TRBJ1-1
TGTGCCAGCAGTGACTTGGACGGGGGGGGATCTGAAAAACTGTTTTTT	CASSDLDGGGSEKLFF	TRBV6-4	TRBJ1-4
TGCGCCAGCATCTCCGGGACAGCGGAGTACACCGGGGAGCTGTTTTTT	CASISGTAEYTGELFF	TRBV10-1	TRBJ2-2
TGTGCCAGATGGATCCGGGACAGCGGGTTTCCCTACGAGCAGTACTTC	CARWIRDSGFPYEQYF	TRBV2	TRBJ2-7
TGTGCCCCGGATAGCAATCAGCCCCAGCATTTT	CAPDSNQPQHF	TRBV19	TRBJ1-5
TGTGCCAGCAGCCAACCGGGGCCGGGACAGGGGGACACCGGGGAGCTGTTTTTT	CASSQPGPGQGDTGELFF	TRBV7-3	TRBJ2-2
TGCAGCGCAAACAGACGACAGGCCCATAATGAAAAACTGTTTTTT	CSANRRQAHNEKLFF	TRBV29-1	TRBJ1-4
TGTGCCACCAGCACCTGGCCCGAGGAAATGGGAGAAGAGACCCAGTACTTC	CATSTWPEEMGEETQYF	TRBV15	TRBJ2-5
TGTGCCAGCTCACCACACAACAGGGCTGGGGAGCTGTTTTTT	CASSPHNRAGELFF	TRBV18	TRBJ2-2
TGTGCCAGCAGTCCGCCCCCGGTAAGGAGGGGGGAGCTGTTTTTT	CASSPPPVRRGELFF	TRBV7-3	TRBJ2-2
TGTGCCGCCCTCGGAGGGAAAGGAGGAAATCAGCCCCAGCATTTT	CAALGGKGGNQPQHF	TRBV30	TRBJ1-5
TGCAGTGCTTTTTGGGGACCCGGCCCCACGAACACCGGGGAGCTGTTTTTT	CSAFWGPGPTNTGELFF	TRBV20-1	TRBJ2-2
TGTGCCAGCAACCGTGTCCTTATGCTAGCAGATACGCAGTATTTT	CASNRVLMLADTQYF	TRBV6-4	TRBJ2-3
TGTGCCAGCAGCCTAAAAGTACCGCGGGAGCTTCGCAATCAGCCCCAGCATTTT	CASSLKVPRELRNQPQHF	TRBV7-3	TRBJ1-5
TGTGCCAGCAGCTTGCCGAGACTAGCGGGAGTACCCACAGATACGCAGTATTTT	CASSLPRLAGVPTDTQYF	TRBV5-8	TRBJ2-3
TGTGCCTGGAGTGTATCCAGGACCAACGAGCAGTACTTC	CAWSVSRTNEQYF	TRBV30	TRBJ2-7
TGTGCCAGCAGTTTCGTACCTCCGGCTACCCACACCGGGGAGCTGTTTTTT	CASSFVPPATHTGELFF	TRBV27	TRBJ2-2
TGCGCCAGCACAGGGCAGGGATCATTTTATGGCTACACCTTC	CASTGQGSFYGYTF	TRBV4-1	TRBJ1-2
TGTGGGACAGGGTCAGAGAACTACGAGCAGTACTTC	CGTGSENYEQYF	TRBV6-5	TRBJ2-7
TGTGCCAGCAGCTTGGGGGGCTCTGGAAACACCATATATTTT	CASSLGGSGNTIYF	TRBV5-4	TRBJ1-3
TGTGCCAGCAGCTTGACCGTCGCGGGACTAGCTCACCAACTCTTGTGCACAGATACGCAGTATTTT	CASSLTVAGLAHQLLCTDTQYF	TRBV5-5	TRBJ2-3
TGTGCCAGCAGCTGGACCCTAGCGGGGGAGTATCCAAATGAGCAGTTCTTC	CASSWTLAGEYPNEQFF	TRBV7-3	TRBJ2-1
TGCGCCAGCAGCTTGGGAACGGACTACCGGGTCTCCTACGAGCAGTACTTC	CASSLGTDYRVSYEQYF	TRBV5-1	TRBJ2-7
TGTGCCAGCAGCTCACCCTCGAGGGTGTACTTC	CASSSPSRVYF	TRBV5-5	TRBJ2-4
TGTGCCAGCAGGGTAGGGGACTTCCCCTCCTACGAGCAGTACTTC	CASRVGDFPSYEQYF	TRBV6-2	TRBJ2-7
TGTGCCAGCAGTTTCCCGCTCTCCTACGAGCAGTACTTC	CASSFPLSYEQYF	TRBV12-3	TRBJ2-7
TGTGCCAGCAGCTTGGATAGGTTTGGGACCCTTGCAACTAATGAAAAACTGTTTTTT	CASSLDRFGTLATNEKLFF	TRBV5-6	TRBJ1-4
TGCGCCAGCAGCCAACGGGGGCCCTACGAGCAGTACTTC	CASSQRGPYEQYF	TRBV4-1	TRBJ2-7
TGTGCCAGCAGCGGGGTAAGCCGCTATGGCTACACCTTC	CASSGVSRYGYTF	TRBV9	TRBJ1-2
TGTGCCAGCAGCCGCAGGGGCCAAGAGACCCAGTACTTC	CASSRRGQETQYF	TRBV7-4	TRBJ2-5
TGCGCCAGCAGAGGGCCGGGACAGGGGGCCTACGAGCAGTACTTC	CASRGPGQGAYEQYF	TRBV5-1	TRBJ2-7
TGTGCCAGCAGGACAGGGGGGGGGAATTCACCCCTCCACTTT	CASRTGGGNSPLHF	TRBV28	TRBJ1-6
TGTGCCAGCAGCCAAGATCCCCTGGGACAGGGGTGGGATGAAAAACTGTTTTTT	CASSQDPLGQGWDEKLFF	TRBV4-2	TRBJ1-4
TGCAGTGCTGCCTTCGATGAGGGGGAGATCCCTGAAGCTTTCTTT	CSAAFDEGEIPEAFF	TRBV20-1	TRBJ1-1
TGTGCCAAGGGAACAGGTTCTGAAGAGCAGCCCCAGCATTTT	CAKGTGSEEQPQHF	TRBV10-3	TRBJ1-5
TGTGCCAGCCCGACCGAGGGTCAGCCCCAGCATTTT	CASPTEGQPQHF	TRBV6-3	TRBJ1-5
TGTGCCAGCAGCCCCAACAATAGCGTCCCAGGTAATAATGAAAAACTGTTTTTT	CASSPNNSVPGNNEKLFF	TRBV7-3	TRBJ1-4
TGCGCCAGCAGTGCCCCTCGGGGGGCCAAGGGGCATGAGCAGTTCTTC	CASSAPRGAKGHEQFF	TRBV10-1	TRBJ2-1
TGTGCCAGCAGCTCTACGACGGGACAGGCTCCTATAATCAACACCGGGGAGCTGTTTTTT	CASSSTTGQAPIINTGELFF	TRBV3-1	TRBJ2-2
TGCGCCAGCAGCGTCGGGGGGCGCGTTACAGATACGCAGTATTTT	CASSVGGRVTDTQYF	TRBV4-3	TRBJ2-3
TGCGCCAGCGACTCCGGACAGCTGGATGAAAAACTGTTTTTT	CASDSGQLDEKLFF	TRBV4-3	TRBJ1-4
TGCGCCAGCAGCTTACGCCGGGACAGGGGGGCCGGCCAAGAGACCCAGTACTTC	CASSLRRDRGAGQETQYF	TRBV5-1	TRBJ2-5
TGTGCCAGTAGTAAGGGACAGGCGACCTATGGCTACACCTTC	CASSKGQATYGYTF	TRBV19	TRBJ1-2
TGTGCCCCTTGGGACAGGGGGGGGGCGTCCGGGGAGCTGTTTTTT	CAPWDRGGASGELFF	TRBV19	TRBJ2-2
TGTGCCAGCAGCTTGGACCCCAGTTCGGTTGGAAACACCATATATTTT	CASSLDPSSVGNTIYF	TRBV5-8	TRBJ1-3
TGTGCCAGCAGCGTCCCTAACATCTCCTACAATGAGCAGTTCTTC	CASSVPNISYNEQFF	TRBV9	TRBJ2-1
TGTGCTAGCAGCTTAGGCCTCGACAGGAATTCACCCCTCCACTTT	CASSLGLDRNSPLHF	TRBV7-7	TRBJ1-6
TGTGCCAGCAGCTACCGTCAAACAGGGAACACCATATATTTT	CASSYRQTGNTIYF	TRBV11-2	TRBJ1-3
TGTGCCAGCAGCTGTTATTTAGCCTCAGAGCAGTACTTC	CASSCYLASEQYF	TRBV7-3	TRBJ2-7
TGTGCCAGCAGCCAAGATCTACGGACCGTCAAAGGAAACATTCAGTACTTC	CASSQDLRTVKGNIQYF	TRBV14	TRBJ2-4
TGCAGTGCTAATTCTAGGAACACCGGGGAGCTGTTTTTT	CSANSRNTGELFF	TRBV20-1	TRBJ2-2
TGTGCCAGCAGCAGCGGGGAGGCCAACGTCCTGACTTTC	CASSSGEANVLTF	TRBV5-4	TRBJ2-6
TGTGCCAGCAGCTGTTCCCCGGGACAAAACGGCAATCAGCCCCAGCATTTT	CASSCSPGQNGNQPQHF	TRBV7-3	TRBJ1-5
TGTGCCAAAAAGGGACTGTTTTTT	CAKKGLFF	TRBV10-3	TRBJ1-4
TGTGCCAGCAGCACCCTTGAGCCGGCGGATGGCTACACCTTC	CASSTLEPADGYTF	TRBV14	TRBJ1-2
TGTGCCAGCATAGGTAGCTGGGGTATATGGGCAACTAATGAAAAACTGTTTTTT	CASIGSWGIWATNEKLFF	TRBV28	TRBJ1-4
TGTGCCAGCAGCGTAGTCCTCCTGGACAGGGCGGATGGAAACACCATATATTTT	CASSVVLLDRADGNTIYF	TRBV9	TRBJ1-3
TGTGCCAGCTCACCACTCTCTGTGGGGACTGAAGCTTTCTTT	CASSPLSVGTEAFF	TRBV18	TRBJ1-1
TGTGCCAGCAGCCTGCAAGGACAGTTCTGTGGCTACACCTTC	CASSLQGQFCGYTF	TRBV13	TRBJ1-2
TGCGCCAGCAGCCAAGCTACAGGGGGAGACTCTGGAAACACCATATATTTT	CASSQATGGDSGNTIYF	TRBV4-3	TRBJ1-3
TGTGCCAGCATAAGTGACAGGGTTACCATATATTTT	CASISDRVTIYF	TRBV27	TRBJ1-3
TGTTTCAGTAGCACAGATACGCAGTATTTT	CFSSTDTQYF	TRBV6-1	TRBJ2-3
TGTGCCAGGACTTCTGCCTACGAGCAGTACTTC	CARTSAYEQYF	TRBV27	TRBJ2-7
TGTGCCAGTAGTATGGCCCGAGTAGGGGTGGGAGCTAACTATGGCTACACCTTC	CASSMARVGVGANYGYTF	TRBV19	TRBJ1-2
TGTGCCTGGAGTGTATGCGGCGAGGTCCGGGACAGGACCGGAAACACCATATATTTT	CAWSVCGEVRDRTGNTIYF	TRBV30	TRBJ1-3
TGTGCCAGCTCACCTGGGCGGGACGGCCTCACCGGGGAGCTGTTTTTT	CASSPGRDGLTGELFF	TRBV18	TRBJ2-2
TGTGCCAGCAGTTTACCCCGTGGGGACAGGGGCCTACTAACCGGGGAGCTGTTTTTT	CASSLPRGDRGLLTGELFF	TRBV12-3	TRBJ2-2
TGTGCCAGCAGTTTCCGAGGACTAGCGTTCTACGAGCAGTACTTC	CASSFRGLAFYEQYF	TRBV7-2	TRBJ2-7
TGCGCCAGCAGCTTGGCTATTCTTCTCCGGGACAGGGGAAACAGCAATCAGCCCCAGCATTTT	CASSLAILLRDRGNSNQPQHF	TRBV5-1	TRBJ1-5
TGTGCCAGCATACGCCTAGCGGGAGAGACCCAGTACTTC	CASIRLAGETQYF	TRBV6-1	TRBJ2-5
TGTGCCACCAGTGCGGGGGCGTGGGCTTGGTGGGGATACAATGAGCAGTTCTTC	CATSAGAWAWWGYNEQFF	TRBV24-1	TRBJ2-1
TGCGCCAGCAGAAAAGCAGCTAGGAAGCAGTTCTTC	CASRKAARKQFF	TRBV5-1	TRBJ2-1
TGTGCCAGCAGCTTTGCCCCCCAGCGGGGGGCGTTGCAAGAGACCCAGTACTTC	CASSFAPQRGALQETQYF	TRBV5-5	TRBJ2-5
TGTGCCAGCAGTCCCGACGCGAGAGTGATCCCCTCCTACGAGCAGTACTTC	CASSPDARVIPSYEQYF	TRBV28	TRBJ2-7
TGCAGTGCTAGAGAGACGCCCCGCAATCAGCCCCAGCATTTT	CSARETPRNQPQHF	TRBV20-1	TRBJ1-5
TGTGCCAGCAGCCAGGGGATGCGGCATGAGCAGTTCTTC	CASSQGMRHEQFF	TRBV3-1	TRBJ2-1
TGTGCCAGCAGGATAGCGGGAGGAGGTGCCTACGAGCAGTACTTC	CASRIAGGGAYEQYF	TRBV6-4	TRBJ2-7
TGTGCCGGCAGGAGCTACGAGCAGTACTTC	CAGRSYEQYF	TRBV10-3	TRBJ2-7
TGTGCCAGCAGCGTAGGCCGGGTGACTTACAATGAGCAGTTCTTC	CASSVGRVTYNEQFF	TRBV9	TRBJ2-1
TGCGCCAGCAGCCAAACGCTGGGGGACCCGAACACTGAAGCTTTCTTT	CASSQTLGDPNTEAFF	TRBV4-3	TRBJ1-1
TGTGCCAGCAGTTTATTCCCTTTCCATTACTATGGCTACACCTTC	CASSLFPFHYYGYTF	TRBV28	TRBJ1-2
TGTGCCAGCAGCTTAGACCGAAACCTCTCACCCCCGGGACAGGGGCCGACCTGGTGTCGCCCCCCGAACACTGAAGCTTTCTTT	CASSLDRNLSPPGQGPTWCRPPNTEAFF	TRBV11-3	TRBJ1-1
TGCAGCGTTCCTAGACACGGCTCGAGCAGGACGACCCAGTACTTC	CSVPRHGSSRTTQYF	TRBV29-1	TRBJ2-5
TGTGCCAGCAGTTACAATGTCCAGCGGAACACTGAAGCTTTCTTT	CASSYNVQRNTEAFF	TRBV6-2	TRBJ1-1
TGCGCCCGAGGGGGGGGGCTAGAGGTCTTC	CARGGGLEVF	TRBV5-1	TRBJ2-1
TGTGCCAGCAGTTGTCCCCAGGACAGGGCTTTCTTT	CASSCPQDRAFF	TRBV6-6	TRBJ1-1
TGCAGTGCTAGCGGGGTACCCCGGGACTATGGCTACACCTTC	CSASGVPRDYGYTF	TRBV20-1	TRBJ1-2
TGTGCCAGCAGTGAATCAGGGTGTACAGCGGGATACCCCCGGTTGAACACTGAAGCTTTCTTT	CASSESGCTAGYPRLNTEAFF	TRBV25-1	TRBJ1-1
TGTGCCAGCAGTCCCCTGGACAGGGATAGCTCCTACAATGAGCAGTTCTTC	CASSPLDRDSSYNEQFF	TRBV12-4	TRBJ2-1
TGTGCCATCGGCGCGGAGTGTCAGAACACTGAAGCTTTCTTT	CAIGAECQNTEAFF	TRBV6-5	TRBJ1-1
TGTGCCAGCTCACCAACGTGGCCCCGTGGGGCCCAGCCCCAGCATTTT	CASSPTWPRGAQPQHF	TRBV18	TRBJ1-5
TGTGCCAGCAGCAACCGACTAGCAGACTACGAGCAGTACTTC	CASSNRLADYEQYF	TRBV13	TRBJ2-7
TGTGCCACCAGTGATTCTTCGGGGACTAGCGGGAGCGGGGGACCCATCTCCTACGAGCAGTACTTC	CATSDSSGTSGSGGPISYEQYF	TRBV24-1	TRBJ2-7
TGTGCCAGCAGCTTAGACCACGGTGACAGGGCCTCGTATGGCTACACCTTC	CASSLDHGDRASYGYTF	TRBV11-3	TRBJ1-2
TGTGTTGGGGGACGAGACCGGGAGTCTAATGAAAAACTGTTTTTT	CVGGRDRESNEKLFF	TRBV24-1	TRBJ1-4
TGTGCCAGCAGCTCCGGACAGGGTGGAGGCTACGAGCAGTACTTC	CASSSGQGGGYEQYF	TRBV7-3	TRBJ2-7
TGTGCCAGCAGCGTAGACAGGGCTCAGAATGGCTACACCTTC	CASSVDRAQNGYTF	TRBV5-6	TRBJ1-2
TGTGCCAGCAGCGGGGCGACCTACGAGCAGTACTTC	CASSGATYEQYF	TRBV9	TRBJ2-7
TGTGCCGGGACAGAGCAATCCTACGAGCAGTACTTC	CAGTEQSYEQYF	TRBV6-4	TRBJ2-7
TGTGCCAGCAGCACGCCGATTGGGGGGGCAAAGGAGCAAGAGACCCAGTACTTC	CASSTPIGGAKEQETQYF	TRBV7-6	TRBJ2-5
TGTGCCAGCAGTGAATTATTCCGCTACGAGCAGTACTTC	CASSELFRYEQYF	TRBV25-1	TRBJ2-7
TGTGCCAGCAGCTTAAGTCCGACAACTAGCGGGAGGGCTGGAAATGAGCAGTTCTTC	CASSLSPTTSGRAGNEQFF	TRBV7-6	TRBJ2-1
TGTGCCAGCAAACAGACCTACAGGGAGGGATATGGCTACACCTTC	CASKQTYREGYGYTF	TRBV5-6	TRBJ1-2
TGTGCCAGCAGTTACTCAACCCGAAGAATCTACGAGCAGTACTTC	CASSYSTRRIYEQYF	TRBV6-5	TRBJ2-7
TGTGCCACCAGCACCCGGCTGACTAGCGCTAAGTCCCTAGATACGCAGTATTTT	CATSTRLTSAKSLDTQYF	TRBV15	TRBJ2-3
TGTGCCAAAACAACTAGCGGGTCCTACAATGAGCAGTTCTTC	CAKTTSGSYNEQFF	TRBV6-1	TRBJ2-1
TGCAGTGCTCCCCCCTATAACAATGAGCAGTTCTTC	CSAPPYNNEQFF	TRBV20-1	TRBJ2-1
TGTGCCAGCAGTGAAAAAGTCGTGAGCCGGGCAATGGCGAACACCGGGGAGCTGTTTTTT	CASSEKVVSRAMANTGELFF	TRBV25-1	TRBJ2-2
TGTGCCAGCAGCGGGGCGAGACGGGGCATATGGAACACTGAAGCTTTCTTT	CASSGARRGIWNTEAFF	TRBV3-1	TRBJ1-1
TGTGCCAGCAGCGTCTCTGAGACCCAGTACTTC	CASSVSETQYF	TRBV13	TRBJ2-5
TGCGCCAGCAGCTTGGAGGCCCCCGACAGGTACTATGAAGCTTTCTTT	CASSLEAPDRYYEAFF	TRBV5-1	TRBJ1-1
TGTGCCACCAGTGATACGGGAACCGACGTTTGGATGGACAGGCGCTACACCTTC	CATSDTGTDVWMDRRYTF	TRBV24-1	TRBJ1-2
TGTGCCAGCAGCGACCAGCAGGTCGAGCAGTACTTC	CASSDQQVEQYF	TRBV7-8	TRBJ2-7
TGCGCCAGCGTCCCAGGGTACGAGCAGTACTTC	CASVPGYEQYF	TRBV4-3	TRBJ2-7
TGTGCCAGCAGTGCGCGGGAGGGAATCGATACGCAGTATTTT	CASSAREGIDTQYF	TRBV12-4	TRBJ2-3
TGTGCCAGTAGTATAGATCCAGGGGACAGGGGGCCCTATGGCTACACCTTC	CASSIDPGDRGPYGYTF	TRBV19	TRBJ1-2
TGCGCCAGCAGCTTGGTCCCCAGGTGCCGGGACAGGGGAGATGGCTACACCTTC	CASSLVPRCRDRGDGYTF	TRBV5-1	TRBJ1-2
TGTGCCAGCAGCTTGTTGAAGGGGAGCTATGGCTACACCTTC	CASSLLKGSYGYTF	TRBV5-5	TRBJ1-2
TGTGCCAGCAGCTTCCCCCCCAAATCGGGGGATGAGCAGTTCTTC	CASSFPPKSGDEQFF	TRBV9	TRBJ2-1
TGTGCCAGCAGTATGAGCGGGAAAACCAGGGCAGATACGCAGTATTTT	CASSMSGKTRADTQYF	TRBV12-3	TRBJ2-3
TGTGCCAGCAGCCCACCCCCGACAGGTGCCTTCCAAGAGACCCAGTACTTC	CASSPPPTGAFQETQYF	TRBV3-1	TRBJ2-5
TGTGCCAGCAGCGTTGTGGGTCCTAGAACCCGAGATACGCAGTATTTT	CASSVVGPRTRDTQYF	TRBV9	TRBJ2-3
TGTGCAGGTCAGCGGGACTTTTACAATGAGCAGTTCTTC	CAGQRDFYNEQFF	TRBV30	TRBJ2-1
TGTGCCAGCAGTGAAGGGTTCTACACCTTC	CASSEGFYTF	TRBV6-1	TRBJ1-2
TGTGCCAGCAGTTACCCTCCGGGACAGGTCTACGAGCAGTACTTC	CASSYPPGQVYEQYF	TRBV6-5	TRBJ2-7
TGTGCCAGCAGTGAATACCGAAGGGACAGGGGGTTCCTGAACACTGAAGCTTTCTTT	CASSEYRRDRGFLNTEAFF	TRBV25-1	TRBJ1-1
TGTGCCGGGGTGAGGGTTTCGAGGATTTATGGCTACACCTTC	CAGVRVSRIYGYTF	TRBV7-4	TRBJ1-2
TGTGCCAGCAGCTGGACAGGGGGAAAAGAGACCCAGTACTTC	CASSWTGGKETQYF	TRBV13	TRBJ2-5
TGTGCCAGCATAAAAAGGGGCTACTGCTACGAGCAGTACTTC	CASIKRGYCYEQYF	TRBV28	TRBJ2-7
TGTGCCAGCAGCAATCCTGGACAGGGTGGGCGAACTGGGGCCAACGTCCTGACTTTC	CASSNPGQGGRTGANVLTF	TRBV5-4	TRBJ2-6
TGTGCCAGCAGTTATGAAAACTCACACGATACGCAGTATTTT	CASSYENSHDTQYF	TRBV6-5	TRBJ2-3
TGTGCCAGCAGTTGGGGGCTTGGTACCACAGATACGCAGTATTTT	CASSWGLGTTDTQYF	TRBV6-1	TRBJ2-3
TGTGCCAGCAGCTTGGGGACCGGCTACACCTTC	CASSLGTGYTF	TRBV5-6	TRBJ1-2
TGTGCCAGCAGCTCGACTAGCGGGGGAGAGACCCAGTACTTC	CASSSTSGGETQYF	TRBV9	TRBJ2-5
TGTGCCAGCAGTCCGGGACAGTTCCCTACTGAAGCTTTCTTT	CASSPGQFPTEAFF	TRBV25-1	TRBJ1-1
TGTGCCAGCAGCCACGTAGCTCCCGGGGAGCTGTTTTTT	CASSHVAPGELFF	TRBV14	TRBJ2-2
TGTGCCAGCAGTCACAGGCGGATCTCAGAGACCCAGTACTTC	CASSHRRISETQYF	TRBV28	TRBJ2-5
TGTGCCACCAGTGGTTGGGGTTTCTCTGGAAACACCATATATTTT	CATSGWGFSGNTIYF	TRBV24-1	TRBJ1-3
TGTGCCAGCAGTGTCGCTCTCTATGGCTACACCTTC	CASSVALYGYTF	TRBV6-4	TRBJ1-2
TGTGCCAGCGAGACCAACAATGAGCAGTTCTTC	CASETNNEQFF	TRBV12-3	TRBJ2-1
TGTGCCACCTTGTGGGGGACCACCGGGGAGCTGTTTTTT	CATLWGTTGELFF	TRBV24-1	TRBJ2-2
TGTGCCAGCAGCGAACCCCCGTATGGGGCCAACGTCCTGACTTTC	CASSEPPYGANVLTF	TRBV11-2	TRBJ2-6
TGTGCCAGCCCCCCCGACAATTGCACTGAAGCTTTCTTT	CASPPDNCTEAFF	TRBV6-4	TRBJ1-1
TGTGCTAGTGGTTTTTTGGGGGGGAAGAGCTCCTACGAGCAGTACTTC	CASGFLGGKSSYEQYF	TRBV12-5	TRBJ2-7
TGTGCCAGCAGCTTAAAATCGGGCGGGATAGAGCCATACGAGCAGTACTTC	CASSLKSGGIEPYEQYF	TRBV13	TRBJ2-7
TGTGCCAGCAGCTCCCCGCCGGACTCGGGATACACTGAAGCTTTCTTT	CASSSPPDSGYTEAFF	TRBV7-9	TRBJ1-1
TGTGCCAGCTCACCTTCGACTAGCGGGGGAAACACCGGGGAGCTGTTTTTT	CASSPSTSGGNTGELFF	TRBV18	TRBJ2-2
TGTGCCACGGCCTCACGGACAGGGGGACCGGGCCCCTACGAGCAGTACTTC	CATASRTGGPGPYEQYF	TRBV24-1	TRBJ2-7
TGTGCCAGCAGTTTTGGCGGACAGGGGGCAGGGTACACCTTC	CASSFGGQGAGYTF	TRBV28	TRBJ1-2
TGTGCCAGCAGCACAGGGTATGGCTACACCTTC	CASSTGYGYTF	TRBV7-4	TRBJ1-2
TGTGCCAGCAGCCTCTGGGACAGGGGCTACTATGGCTACACCTTC	CASSLWDRGYYGYTF	TRBV9	TRBJ1-2
TGTGCCAGCAGCCGCTGGGGGGAAGGAAAACTGTTTTTT	CASSRWGEGKLFF	TRBV6-5	TRBJ1-4
TGTGCCAGCAGCTTAGAATTTATCCAGTACAATGAGCAGTTCTTC	CASSLEFIQYNEQFF	TRBV11-2	TRBJ2-1
TGTGCCAGCAGCCAAGCAGACCTAAAAGCGGGAGAGGGCCGCGAGCAGTACTTC	CASSQADLKAGEGREQYF	TRBV14	TRBJ2-7
TGTGCCTGGAGTGTGAGGGTAGCGGGTACTAGCACAGATACGCAGTATTTT	CAWSVRVAGTSTDTQYF	TRBV30	TRBJ2-3
TGTGCCAGCCTAGACAGGCGAGACGAGCAGTACTTC	CASLDRRDEQYF	TRBV13	TRBJ2-7
TGTGCCAGCAGCCTCGTCGACAATGAGCAGTTCTTC	CASSLVDNEQFF	TRBV11-2	TRBJ2-1
TGCAGTGAGACAGGGCTACGACCCGGGGAGCTGTTTTTT	CSETGLRPGELFF	TRBV20-1	TRBJ2-2
TGTGCCAGCAGCTTAGCGCTACACCCGACGAGTAACTACGAGCAGTACTTC	CASSLALHPTSNYEQYF	TRBV7-2	TRBJ2-7
TGTGCCAGCAGCCCGGGCGGCTACACCTTC	CASSPGGYTF	TRBV3-1	TRBJ1-2
TGCGCCAGCAACATTAGAGCGGGAGATGAGCAGTTCTTC	CASNIRAGDEQFF	TRBV4-1	TRBJ2-1
TGTGCATTTTACCAGGGCTCAACAGATACGCAGTATTTT	CAFYQGSTDTQYF	TRBV30	TRBJ2-3
TGTGCCAGCAGTTTGAGGACAGCTTACTATGGCTACACCTTC	CASSLRTAYYGYTF	TRBV27	TRBJ1-2
TGTGCCTGGAGTAGACGACCGGTGAGCACAGATACGCAGTATTTT	CAWSRRPVSTDTQYF	TRBV30	TRBJ2-3
TGTGCCAGCAGATCAGCAGGGGGGGTTGTTAACGGGGAAAACATTCAGTACTTC	CASRSAGGVVNGENIQYF	TRBV6-3	TRBJ2-4
TGTGCCAGCAGCTACCTTAGCACAGATACGCAGTATTTT	CASSYLSTDTQYF	TRBV13	TRBJ2-3
TGTGCCAGCAGCGAAGGGGGGGCGTTTAGATCGCTCTACGAGCAGTACTTC	CASSEGGAFRSLYEQYF	TRBV7-3	TRBJ2-7
TGTGCCACGGCAGTATGGGGAATCAGGGACTATGGCTACACCTTC	CATAVWGIRDYGYTF	TRBV5-5	TRBJ1-2
TGTGCCAGCTCACCCCCCCGACCCCAGTACGAGGGGGGAATTAATGAAAAACTGTTTTTT	CASSPPRPQYEGGINEKLFF	TRBV18	TRBJ1-4
TGTGCCAGCAGCTCCCACAGGGTCGAAAGCTCCTACGAGCAGTACTTC	CASSSHRVESSYEQYF	TRBV11-2	TRBJ2-7
TGTGCCAGCAGCCAGCCTGCCGGGGGAGCGGGCACAGATACGCAGTATTTT	CASSQPAGGAGTDTQYF	TRBV7-3	TRBJ2-3
TGCGCCAGCAGCCAAGGACTAGCGGGTAGACGAAGGACCACAGATACGCAGTATTTT	CASSQGLAGRRRTTDTQYF	TRBV4-1	TRBJ2-3
TGTGCCAGCATATACGACGCAAGCGAATACAATGAGCAGTTCTTC	CASIYDASEYNEQFF	TRBV11-3	TRBJ2-1
TGTGCCTGGAGAGATGCGGGAGGCCCCCAGCATTTT	CAWRDAGGPQHF	TRBV30	TRBJ1-5
TGTGCCTGGGGGGTCACGCCAGGGGGTTGCTACACCTTC	CAWGVTPGGCYTF	TRBV30	TRBJ1-2
TGTGCCACAGCAGACCACGGAATGAACACTGAAGCTTTCTTT	CATADHGMNTEAFF	TRBV15	TRBJ1-1
TGTGCCAGCAGTCGGAGGGGAAGGAACACTGAAGCTTTCTTT	CASSRRGRNTEAFF	TRBV6-5	TRBJ1-1
TGCGCCAGCAGGCCAGATTGGGATGGGAACACTGAAGCTTTCTTT	CASRPDWDGNTEAFF	TRBV5-1	TRBJ1-1
TGTGCCAGCAGCTTGGCTCAGGGATGTGACAATCAGCCCCAGCATTTT	CASSLAQGCDNQPQHF	TRBV5-4	TRBJ1-5
TGTGCCAGCAGTTTACTGGGAGGAAGGCCCTACGAGCAGTACTTC	CASSLLGGRPYEQYF	TRBV12-4	TRBJ2-7
TGTGCCAGCAGCCAAGGGAAATCGGGAGTATACTACGAGCAGTACTTC	CASSQGKSGVYYEQYF	TRBV3-1	TRBJ2-7
TGTGCCTGGAGTGGTCCGGGCGATAGAGAGACCCAGTACTTC	CAWSGPGDRETQYF	TRBV30	TRBJ2-5
TGCGCCAGCAGTGAGGAGCGGGAGGTGGCCTATGGCTACACCTTC	CASSEEREVAYGYTF	TRBV10-1	TRBJ1-2
TGTGCCAGCAGTGAGGGGGGGGGACCCAACGGGGAGCTGTTTTTT	CASSEGGGPNGELFF	TRBV27	TRBJ2-2
TGTGCCAGCAGTGGACAGTTTCTAAGCGCGAACACCGGGGAGCTGTTTTTT	CASSGQFLSANTGELFF	TRBV27	TRBJ2-2
TGCGCCAGCAGTGCACTTAGCGAGTACAATGAGCAGTTCTTC	CASSALSEYNEQFF	TRBV10-1	TRBJ2-1
TGTGCCAGCAGCCTCCTGACAGCCCCGTATGGCTACACCTTC	CASSLLTAPYGYTF	TRBV28	TRBJ1-2
TGTGCCAGCAGCGGAAATATTGCGGTCGAGTGGAATGAGCAGTTCTTC	CASSGNIAVEWNEQFF	TRBV9	TRBJ2-1
TGTGCCAGCGTGGCGGTCGATAGGGGGATCTCCTCCTATAATTCACCCCTCCACTTT	CASVAVDRGISSYNSPLHF	TRBV7-9	TRBJ1-6
TGTGCCAGCGTCTGTCCCAGGGAAAAGCATGGCTACACCTTC	CASVCPREKHGYTF	TRBV7-2	TRBJ1-2
TGTGCCAGCAGCTTAGTGCGAAGGGTTATGAACACTGAAGCTTTCTTT	CASSLVRRVMNTEAFF	TRBV7-4	TRBJ1-1
TGTGCCAGCAGCCAAGCCACTAGCGGGGGGGAGAGCACAGATACGCAGTATTTT	CASSQATSGGESTDTQYF	TRBV3-1	TRBJ2-3
TGTGCCAGCAGCCGACGGGGGCGCTCGGGCTATGGCTACACCTTC	CASSRRGRSGYGYTF	TRBV6-5	TRBJ1-2
TGTGCCAGCAGCCCCTGGGGGCCCCTCTATGGCTACACCTTC	CASSPWGPLYGYTF	TRBV14	TRBJ1-2
TGTGCTAGTGCCCCGGGACAGGGTGGTCAGACGCGCTATGGCTACACCTTC	CASAPGQGGQTRYGYTF	TRBV12-5	TRBJ1-2
TGTGCCAGCAGTTACCGACAGGGTGAAGCTTTCTTT	CASSYRQGEAFF	TRBV6-3	TRBJ1-1
TGCGCCAGCAGTGCTCTGGGACATGAAAAACTGTTTTTT	CASSALGHEKLFF	TRBV10-1	TRBJ1-4
TGTGCCAGCAGTGATTCAGCCGGGACGATGAGGGACTATGGCTACACCTTC	CASSDSAGTMRDYGYTF	TRBV6-4	TRBJ1-2
TGTGCCAGCAGCCAACCATCGGGGACAGCTAATGAAAAACTGTTTTTT	CASSQPSGTANEKLFF	TRBV14	TRBJ1-4
TGTGCCAGCAGCTTAGTGTTGGGGGAGGGGGAAAGCAATCAGCCCCAGCATTTT	CASSLVLGEGESNQPQHF	TRBV7-9	TRBJ1-5
TGTGCCAGCAGCCAAGTAACGTCTGGGGACGGGACCCAGTACTTC	CASSQVTSGDGTQYF	TRBV4-2	TRBJ2-5
TGTGCCACCAGCAGCAGGGGGAATCAGCCCCAGCATTTT	CATSSRGNQPQHF	TRBV15	TRBJ1-5
TGTGCCAGCAGCCCCTGGAATGACAGCAATCAGCCCCAGCATTTT	CASSPWNDSNQPQHF	TRBV9	TRBJ1-5
TGTGCCAGCTCACCACAAACGGACAGCCTAGCCAAAAACATTCAGTACTTC	CASSPQTDSLAKNIQYF	TRBV18	TRBJ2-4
TGCAGTGCTAACCCTCGGACAGATGAAAAACTGTTTTTT	CSANPRTDEKLFF	TRBV20-1	TRBJ1-4
TGTGCCAGCAGCCAAGACCGACAGGCTCCGACACAGCCCCAGCATTTT	CASSQDRQAPTQPQHF	TRBV3-1	TRBJ1-5
TGTGCGTCCTGGGGGCGGGTAAGCAATCAGCCCCAGCATTTT	CASWGRVSNQPQHF	TRBV6-2	TRBJ1-5
TGTGCCAGCAGTTACTCGGAACGTTACGAGCAGTACTTC	CASSYSERYEQYF	TRBV6-5	TRBJ2-7
TGTGCCAGCAGCCCCGACAGGGGTGAGACCCAGTACTTC	CASSPDRGETQYF	TRBV6-4	TRBJ2-5
TGTGCCATCAGCCAGTACGGGCCTAACTATGGCTACACCTTC	CAISQYGPNYGYTF	TRBV10-3	TRBJ1-2
TGTGCCAGCAGTCCCGGGACTGGTGAAAAACTGTTTTTT	CASSPGTGEKLFF	TRBV27	TRBJ1-4
TGTGCCAGCAAATTTGAATATCTCTCAGGCACTGAAGCTTTCTTT	CASKFEYLSGTEAFF	TRBV5-5	TRBJ1-1
TGTGCCAGCTCACCACCTTTAGGGTATCAGCCCCAGCATTTT	CASSPPLGYQPQHF	TRBV18	TRBJ1-5
TGTGCCGTTACTGCGGGGCAAGCTTTCTTT	CAVTAGQAFF	TRBV27	TRBJ1-1
TGTGCCAGCAGTGACCCCGGAATGTACTACGAGCAGTACTTC	CASSDPGMYYEQYF	TRBV6-4	TRBJ2-7
TGCACTGACAGAAACTATGGCTACACCTTC	CTDRNYGYTF	TRBV20-1	TRBJ1-2
TGCAGCGTAGCGAGGACAGAACACGAGCAGTACTTC	CSVARTEHEQYF	TRBV29-1	TRBJ2-7
TGTGCCAGCAGCTTGGGTCCACAGGAAAAGTCCAATTCACCCCTCCACTTT	CASSLGPQEKSNSPLHF	TRBV5-6	TRBJ1-6
TGTGCCAGCAGCTTAGGTTGGCGGGGGTACAATGAGCAGTTCTTC	CASSLGWRGYNEQFF	TRBV7-2	TRBJ2-1
TGTGCCAGCATTGGGACAGTAAAATGGCCGAACACTGAAGCTTTCTTT	CASIGTVKWPNTEAFF	TRBV9	TRBJ1-1
TGTGCCAGCAGCTTATGGCGGCGCGGAGTTCACCATGAGCAGTTCTTC	CASSLWRRGVHHEQFF	TRBV7-6	TRBJ2-1
TGCAGTGCTAGATTGACAGAGAGCTATGGCTACACCTTC	CSARLTESYGYTF	TRBV20-1	TRBJ1-2
TGTGCCAGCAGCTTAGACCTATGTTCTGGGGGACTAGCGGGCCGGGCCTACGAGCAGTACTTC	CASSLDLCSGGLAGRAYEQYF	TRBV11-3	TRBJ2-7
TGCAGCGTTCCCAGACTTTGCACAGATACGCAGTATTTT	CSVPRLCTDTQYF	TRBV29-1	TRBJ2-3
TGTGCCAGCAGCGGTCGGTGGACAGGGTTCTGCACCGAGCAGTACTTC	CASSGRWTGFCTEQYF	TRBV9	TRBJ2-7
TGTGCCAGCAGCTTAGTTGGACGAGTGAACACTGAAGCTTTCTTT	CASSLVGRVNTEAFF	TRBV7-9	TRBJ1-1
TGTGCCAGCAGCACGGGACTAGCGGGAGTAGTGGAGCAGTACTTC	CASSTGLAGVVEQYF	TRBV7-3	TRBJ2-7
TGTGCCTGGAGTCACGGACTAGTTTCAGTCTACGAGCAGTACTTC	CAWSHGLVSVYEQYF	TRBV30	TRBJ2-7
TGTGCCAGCAGCTCCCGCGCACTGGGACGGGGCCGCAGGGTGTATGGCTACACCTTC	CASSSRALGRGRRVYGYTF	TRBV7-8	TRBJ1-2
TGTGCCAGCAGCCTTCAGCGGGATTATACGCAGTATTTT	CASSLQRDYTQYF	TRBV3-1	TRBJ2-3
TGCAGTGCTAGATCCTCACTAGCGGGGGGAGAGACCCAGTACTTC	CSARSSLAGGETQYF	TRBV20-1	TRBJ2-5
TGCGCCAGCAGCTTAGGGGAGACCCAGTACTTC	CASSLGETQYF	TRBV5-1	TRBJ2-5
TGTGCCAGCAGTGAATATGGAGGCAATCAGGGGGGCTTTTGCAATCAGCCCCAGCATTTT	CASSEYGGNQGGFCNQPQHF	TRBV25-1	TRBJ1-5
TGCGCCAGCAGCCTGAGGTACGACTACGAGCAGTACTTC	CASSLRYDYEQYF	TRBV4-3	TRBJ2-7
TGCGCCAGCAGCCAAGCCCTAAATCGAGTCACATGGGGGGCCAAAAACATTCAGTACTTC	CASSQALNRVTWGAKNIQYF	TRBV4-3	TRBJ2-4
TGCGCCAGCAGCCAACCCCAAGGGGGGCGGGGCAATCAGCCCCAGCATTTT	CASSQPQGGRGNQPQHF	TRBV4-1	TRBJ1-5
TGCAGCGTTGAAGGACTAGGGGGGAACGAGCAGTACTTC	CSVEGLGGNEQYF	TRBV29-1	TRBJ2-7
TGTGCCAGCAGTTTACTGAGAATAGAGGAAAAACTGTTTTTT	CASSLLRIEEKLFF	TRBV27	TRBJ1-4
TGTGCCAGTAGTATTTTCTGCGGGAGAGGTGATTTTCGTTCGGTATGGGAGCAGTACTTC	CASSIFCGRGDFRSVWEQYF	TRBV19	TRBJ2-7
TGTGCCAGCAGCCCCTTGGGGGTCTCCTACGAGCAGTACTTC	CASSPLGVSYEQYF	TRBV7-3	TRBJ2-7
TGTGCCAGCAGCAATTGTCAGAGACAGGAATGGCCCAATGAGCAGTTCTTC	CASSNCQRQEWPNEQFF	TRBV27	TRBJ2-1
TGTGCCAGCAGTTACACCCGAATGTCCACTAGCTACGAGCAGTACTTC	CASSYTRMSTSYEQYF	TRBV6-6	TRBJ2-7
TGTGCCAGCAGTCGGGGGCCCCATGAGCAGTTCTTC	CASSRGPHEQFF	TRBV4-2	TRBJ2-1
TGCGCCAGCAGCCAAGATCCTCGGGAGGGGCTGGGCGAGCAGTACTTC	CASSQDPREGLGEQYF	TRBV4-3	TRBJ2-7
TGCGCCAGGCTCTGCAGGAGCAATCAGCCCCAGCATTTT	CARLCRSNQPQHF	TRBV5-1	TRBJ1-5
TGTGCCAGCCGGCGGTCCTACGAGCAGTACTTC	CASRRSYEQYF	TRBV19	TRBJ2-7
TGTGCCTGGAGTGTACTGATGCGGGACAGGGCCTGCTGCCCTAAAGTTGGCTACACCTTC	CAWSVLMRDRACCPKVGYTF	TRBV30	TRBJ1-2
TGTGCCAGCAGTGAACACGACAGTGAAAAACTGTTTTTT	CASSEHDSEKLFF	TRBV6-1	TRBJ1-4
TGTGCCAGAGTTGGGGCGTCAGACCAGCCCCAGCATTTT	CARVGASDQPQHF	TRBV19	TRBJ1-5
TGCGCCACAGGGTTTGCAGGTCAGGCTTTCTTT	CATGFAGQAFF	TRBV5-1	TRBJ1-1
TGTGCCAGCAGCTTAAAGACGGTTGAGACCTACGAGCAGTACTTC	CASSLKTVETYEQYF	TRBV7-2	TRBJ2-7
TGTGCGTATTTCAGGGGGCAGAACTATGGCTACACCTTC	CAYFRGQNYGYTF	TRBV3-1	TRBJ1-2
TGTGCCACCAGTGCGGCGGGACTAGCCCCCTTGGAGCAGTTCTTC	CATSAAGLAPLEQFF	TRBV24-1	TRBJ2-1
TGTGCCAGGAAGGTGCGGGGCCTGGGGTTTGAAGCTTTCTTT	CARKVRGLGFEAFF	TRBV19	TRBJ1-1
TGTGCCAGCAGCCCCCCCGGGAGAAACTCCTTTACTCTTTCTGGAAACACCATATATTTT	CASSPPGRNSFTLSGNTIYF	TRBV9	TRBJ1-3
TGCAGTGCGGAGGGGGTTAACGGGGAAAAACTGTTTTTT	CSAEGVNGEKLFF	TRBV20-1	TRBJ1-4
TGTGCCAGCAGCCGGGAAGAGGGGGTCTCAGTTGCCTACGAGCAGTACTTC	CASSREEGVSVAYEQYF	TRBV13	TRBJ2-7
TGTGCCAGCAGCACGACAGGCAATAAGCAGTACTTC	CASSTTGNKQYF	TRBV7-9	TRBJ2-7
TGTGCCAGCAGTCCCGCTGACAGGGGGACCTACGAGCAGTACTTC	CASSPADRGTYEQYF	TRBV6-4	TRBJ2-7
TGTGCCAGCAGGCCTCGTCCTCCCGCAGGGCCCCAGCATTTT	CASRPRPPAGPQHF	TRBV4-2	TRBJ1-5
TGTGCCAGCAAGGTGCGGAACACTGAAGCTTTCTTT	CASKVRNTEAFF	TRBV6-4	TRBJ1-1
TGTGCCAGCAGCGCGAGCAGGAACTATGGCTACACCTTC	CASSASRNYGYTF	TRBV7-3	TRBJ1-2
TGTGCCAGCAGCCCGGCGGGGTCCCCAGATACGCAGTATTTT	CASSPAGSPDTQYF	TRBV13	TRBJ2-3
TGTGCCAGCAGTGAAGGTCTAGCCCCCTCCTACGAGCAGTACTTC	CASSEGLAPSYEQYF	TRBV6-2	TRBJ2-7
TGTGCCAGCAGTTCCAGGGTGCCCTACGAGCAGTACTTC	CASSSRVPYEQYF	TRBV6-6	TRBJ2-7
TGTGCCAGCAGTCTAGACAGGGCCGACCAGCAAGAGACCCAGTACTTC	CASSLDRADQQETQYF	TRBV28	TRBJ2-5
TGCGCCAGCAGCCACACGACAGGGCCGAACACTGAAGCTTTCTTT	CASSHTTGPNTEAFF	TRBV5-1	TRBJ1-1
TGTGCCACCCGTCAGGGATGCACAGATACGCAGTATTTT	CATRQGCTDTQYF	TRBV24-1	TRBJ2-3
TGCAGTGCTAGAGAGCTGACAGCTCTACAAAATGGCTACACCTTC	CSARELTALQNGYTF	TRBV20-1	TRBJ1-2
TGTGCCAGCAGTAAGTGGCGTCGGGGCGTGGGCTACGAGCAGTACTTC	CASSKWRRGVGYEQYF	TRBV27	TRBJ2-7
TGTGCCAGCAGCCAAAACAGGGAGACTGAGCAGTACTTC	CASSQNRETEQYF	TRBV14	TRBJ2-7
TGTGCCAGCAGCTTGGGCTCGTACTTGCGGGGAATAAGCACAGATACGCAGTATTTT	CASSLGSYLRGISTDTQYF	TRBV5-6	TRBJ2-3
TGTGCCAGCAGCTGGGCCCACGACACTGAAGCTTTCTTT	CASSWAHDTEAFF	TRBV5-6	TRBJ1-1
TGTGCCAGCAGTTCCGTCGCAAACAGGGGGCCTACCCATTCACCCCTCCACTTT	CASSSVANRGPTHSPLHF	TRBV27	TRBJ1-6
TGTGCCAGCAGGAACAGCGGGAGGCCCCGCTTCACTGAAGCTTTCTTT	CASRNSGRPRFTEAFF	TRBV25-1	TRBJ1-1
TGTGCCAGCAGTCAATGGCAAAGGGGGAGAACCACAACTAATGAAAAACTGTTTTTT	CASSQWQRGRTTTNEKLFF	TRBV6-2	TRBJ1-4
TGTGCCAGCAGCCTCTCCTGGGCTGAAGCTTTCTTT	CASSLSWAEAFF	TRBV28	TRBJ1-1
TGTGCCAGCAGCACGACTAGCGCCTACGAGCAGTACTTC	CASSTTSAYEQYF	TRBV7-9	TRBJ2-7
TGTGCCAGCAGTTTCCCGGGGGATCAGCCCCAGCATTTT	CASSFPGDQPQHF	TRBV27	TRBJ1-5
TGTGCCAGCAGCACGGACAATGGGTCGGAAAAACTGTTTTTT	CASSTDNGSEKLFF	TRBV7-9	TRBJ1-4
TGTGCCAGTAGCTCGGGAATTTTAGGCCCCTACGAGCAGTACTTC	CASSSGILGPYEQYF	TRBV19	TRBJ2-7
TGTGCTACCCGCAGATTAACCTCTTCCCTCCACTTT	CATRRLTSSLHF	TRBV12-5	TRBJ1-6
TGCGCCAGCAGTGACGCCTGGGGGGGCTATGGCTACACCTTC	CASSDAWGGYGYTF	TRBV10-1	TRBJ1-2
TGTGCCAGCAGCTTTCACCTCCTGACTGCCACCGGGGAGCTGTTTTTT	CASSFHLLTATGELFF	TRBV5-8	TRBJ2-2
TGTGCCAGTAGTTTGGGACGGGGGCTAACTAGCACAGATACGCAGTATTTT	CASSLGRGLTSTDTQYF	TRBV19	TRBJ2-3
TGTGCCAGCAGCTGCTTCCCAGAGACCCAGTACTTC	CASSCFPETQYF	TRBV7-8	TRBJ2-5
TGTGCCAGCAGAAAGGCTGGGACGGGAGACAATAACAATGAGCAGTTCTTC	CASRKAGTGDNNNEQFF	TRBV11-3	TRBJ2-1
TGCAGTGCTAGTCGGGAGACTGAAGCTTTCTTT	CSASRETEAFF	TRBV20-1	TRBJ1-1
TGTGCCAGCTCACAGCCCAGCGGGAGGCATTGGACAGATACGCAGTATTTT	CASSQPSGRHWTDTQYF	TRBV18	TRBJ2-3
TGTGCCACCAGTGATCTTTCTAACCCAGACAGGGATACGCAGTATTTT	CATSDLSNPDRDTQYF	TRBV24-1	TRBJ2-3
TGTGCCAGCAGCGAGGTCCACAGGTATACAAATTCACCCCTCCACTTT	CASSEVHRYTNSPLHF	TRBV9	TRBJ1-6
TGTGCCAGCAGCCCCCCAGGGAGGCCATATGGCTACACCTTC	CASSPPGRPYGYTF	TRBV3-1	TRBJ1-2
TGTGCCAGCAGGAGTTGGGGGACCCAGTACTTC	CASRSWGTQYF	TRBV6-5	TRBJ2-5
TGTGCCAGCAGACGCGCGGGAGGACTCAATGAGCAGTTCTTC	CASRRAGGLNEQFF	TRBV6-2	TRBJ2-1
TGCGCCAGCAGCCAAGAGGGGGGATGGGGGGACGAGCAGTACTTC	CASSQEGGWGDEQYF	TRBV4-1	TRBJ2-7
TGTGCCAGCAGTTCTCGACGGAGTGCCTACGAGCAGTACTTC	CASSSRRSAYEQYF	TRBV5-6	TRBJ2-7
TGTGCCAGCAGCCAATCGGGGGGCTTCCACAATGAGCAGTTCTTC	CASSQSGGFHNEQFF	TRBV4-2	TRBJ2-1
TGTGCCACCAGTGATTCGCAGGGAGGAGGAAACTATGGCTACACCTTC	CATSDSQGGGNYGYTF	TRBV24-1	TRBJ1-2
TGTGCCATCCACCCCAGGACGCATTACACTGAAGCTTTCTTT	CAIHPRTHYTEAFF	TRBV10-3	TRBJ1-1
TGTGCCAGCAGCCGTTGGACAGACCCAGCGACCGGGGAGCTGTTTTTT	CASSRWTDPATGELFF	TRBV13	TRBJ2-2
TGTGCCAGCAGTGAAGTCCAGGGCGCCGGGACAGGGGATAGCAATCAGCCCCAGCATTTT	CASSEVQGAGTGDSNQPQHF	TRBV6-1	TRBJ1-5
TGTGCCACCAGTGTTCCGGGGCAGGAGCCCCAGCATTTT	CATSVPGQEPQHF	TRBV24-1	TRBJ1-5
TGTGCCAGCAGTGCCACAGGGAGGGCCAAAAACATTCAGTACTTC	CASSATGRAKNIQYF	TRBV6-1	TRBJ2-4
TGTGCCAGCAGCCAAGAACTGAAGCCGGGACTAGCGGGCAATGAGCAGTTCTTC	CASSQELKPGLAGNEQFF	TRBV3-1	TRBJ2-1
TGTGCCAGCGGGTCCGGGAGGAAGAACACTGAAGCTTTCTTT	CASGSGRKNTEAFF	TRBV6-1	TRBJ1-1
TGTGCCAGCAGTTTGGGTTTAACTACGGGGGGAGAGACCCAGTACTTC	CASSLGLTTGGETQYF	TRBV27	TRBJ2-5
TGTGCCAGCAGCTTAGGCCATAACCAGGGTGGACTAGCACAGAAAGATACGCAGTATTTT	CASSLGHNQGGLAQKDTQYF	TRBV11-2	TRBJ2-3
TGTGCCAGCAGCCTTGGCTCTAGCGGGTACAATGAGCAGTTCTTC	CASSLGSSGYNEQFF	TRBV9	TRBJ2-1
TGTGCCAGCAGCCCCGAGGGGGACCAGCCCCAGCATTTT	CASSPEGDQPQHF	TRBV5-5	TRBJ1-5
TGTGCCAGTAGTATAGGGAAGGTGAAAGGGGTAAAGAACACTGAAGCTTTCTTT	CASSIGKVKGVKNTEAFF	TRBV19	TRBJ1-1
TGTGCCAGCAGCAATCCCCGGGGGGGGGATTCACCCCTCCACTTT	CASSNPRGGDSPLHF	TRBV7-6	TRBJ1-6
TGTGCCAGCAGTTTCGTACTAGCGGGAGCTCCGTACGAGCAGTACTTC	CASSFVLAGAPYEQYF	TRBV27	TRBJ2-7
TGTGCCAGCAGTGAAAGTGACACCGGGACCCCCGGCTATAATTCACCCCTCCACTTT	CASSESDTGTPGYNSPLHF	TRBV6-1	TRBJ1-6
TGTGCCACCAGTGATCCCGGGACGGTTTCCTACAATGAGCAGTTCTTC	CATSDPGTVSYNEQFF	TRBV24-1	TRBJ2-1
TGTGCCAGCAGCTTAGTCGATCGACTGGACACTGAAGCTTTCTTT	CASSLVDRLDTEAFF	TRBV7-9	TRBJ1-1
TGTGCCAGCAGTGAGACTGAGGGCTCCTACGAGCAGTACTTC	CASSETEGSYEQYF	TRBV27	TRBJ2-7
TGTGCCAGCAGCAATGATAGAGAAGAAGAGACCCAGTACTTC	CASSNDREEETQYF	TRBV7-6	TRBJ2-5
TGTGCCCATACCGCGGCTAGCGGGGGGGCTTCACTCACAGATACGCAGTATTTT	CAHTAASGGASLTDTQYF	TRBV30	TRBJ2-3
TGTGCCAGTAGGAATAGCGGGCTCGCCTACGAGCAGTACTTC	CASRNSGLAYEQYF	TRBV19	TRBJ2-7
TGTGCCAGCAGTGCGGGAAGGGAGCAGTACTTC	CASSAGREQYF	TRBV6-1	TRBJ2-7
TGTGCCAGCAGTACCGCGTTTCAGCCCCAGCATTTT	CASSTAFQPQHF	TRBV7-2	TRBJ1-5
TGTGCCAGCAGCATATGGAATTGCGGGAGGAGCTCCTACAATGAGCAGTTCTTC	CASSIWNCGRSSYNEQFF	TRBV3-1	TRBJ2-1
TGTGCCAGCAGTTTAAGGCCCAGGGACACCGGGGAGCTGTTTTTT	CASSLRPRDTGELFF	TRBV12-3	TRBJ2-2
TGTGCCATCAGTGAAAGAACTATCAACGGGCCAAAATCCAAAAACATTCAGTACTTC	CAISERTINGPKSKNIQYF	TRBV10-3	TRBJ2-4
TGCAGTGTAACCTTTTTGTTCAGGGGGGTTCAAGATCAGCCCCAGCATTTT	CSVTFLFRGVQDQPQHF	TRBV20-1	TRBJ1-5
TGCAGTGCTATATTCGAGACAGGGGGAAAAGTGAACACTGAAGCTTTCTTT	CSAIFETGGKVNTEAFF	TRBV20-1	TRBJ1-1
TGTGCCAGCAGCTTGCCGTGGCCCCCGCCCCAGCATTTT	CASSLPWPPPQHF	TRBV7-9	TRBJ1-5
TGTGCCAGCATCAAAAAGAGGCTGCGAACAGATACGCAGTATTTT	CASIKKRLRTDTQYF	TRBV6-1	TRBJ2-3
TGTGCCTGGAGTAGAGGGGAACGAACTAATGAAAAACTGTTTTTT	CAWSRGERTNEKLFF	TRBV30	TRBJ1-4
TGTGCCAGCAGCTTAGGGGGGAGATACTACGAGCAGTACTTC	CASSLGGRYYEQYF	TRBV11-2	TRBJ2-7
TGTGCCAGCAGCCCGGGCGGCGGAGAGACCCAGTACTTC	CASSPGGGETQYF	TRBV13	TRBJ2-5
TGTGCCAGCAGTGAAAAGGGACAGAAGACAAATCAGCCCCAGCATTTT	CASSEKGQKTNQPQHF	TRBV6-1	TRBJ1-5
TGTGCCAGCAGCCAAGATCCCTTGGGACCGTCACCCCTCCACTTT	CASSQDPLGPSPLHF	TRBV3-1	TRBJ1-6
TGCAGTGCAAGGCCTATGGGCCATGAGCAGTTCTTC	CSARPMGHEQFF	TRBV20-1	TRBJ2-1
TGTGCCAGCAATGAATTTGGGTCATGCTACGAGCAGTACTTC	CASNEFGSCYEQYF	TRBV11-1	TRBJ2-7
TGTGCCAGCAGCTGCGGGACGGCTTCACCCCTCCACTTT	CASSCGTASPLHF	TRBV5-6	TRBJ1-6
TGTGCCAGCAGCTTGTCGGACTCTTGCTCCTACAATGAGCAGTTCTTC	CASSLSDSCSYNEQFF	TRBV13	TRBJ2-1
TGCGCCAGCAGCTTGAGTCCGGAGGTCGGATTACAGACCCAGTACTTC	CASSLSPEVGLQTQYF	TRBV5-1	TRBJ2-5
TGCAGTGCATGGCAGGAAGAGACCCAGTACTTC	CSAWQEETQYF	TRBV20-1	TRBJ2-5
TGTGCCACCAGCAGTCGGGGGGAAAACTACGAGCAGTACTTC	CATSSRGENYEQYF	TRBV15	TRBJ2-7
TGTGCCAGCAGCATTCCCCCACTACGGACGCAGTATTTT	CASSIPPLRTQYF	TRBV11-2	TRBJ2-3
TGTGCTAGCCCCGCCGACAGGGTGAACACTGAAGCTTTCTTT	CASPADRVNTEAFF	TRBV7-7	TRBJ1-1
TGTGCCAGCAGTTTGGGTAATCCCCCGACAGAGGGGGTCGCCTACGAGCAGTACTTC	CASSLGNPPTEGVAYEQYF	TRBV12-4	TRBJ2-7
TGTGCCTGGAGGAACACTAGCGGGAGACCTTATAATTCACCCCTCCACTTT	CAWRNTSGRPYNSPLHF	TRBV30	TRBJ1-6
TGCGCCAGCAGCAGCCTGCCAGACTGTAGGAGCTCCTACAATGAGCAGTTCTTC	CASSSLPDCRSSYNEQFF	TRBV5-1	TRBJ2-1
TGTGCCAGCCTTGCCCATATTGAGACCCAGTACTTC	CASLAHIETQYF	TRBV5-6	TRBJ2-5
TGTGCCAGCAGTGAACCGGGACTAGCGGGAGGCGGGGAGCTGTTTTTT	CASSEPGLAGGGELFF	TRBV6-1	TRBJ2-2
TGTGCCAGCAGCCACCTAGATACGGATAACTATGGCTACACCTTC	CASSHLDTDNYGYTF	TRBV13	TRBJ1-2
TGCGCCAGCAGCTTGGCGCCACTGTTGCGGGGCAATGAGCAGTTCTTC	CASSLAPLLRGNEQFF	TRBV5-1	TRBJ2-1
TGTGCCTGGAACGCGGGACCGAAGGAGCCTGGACGCGAGCAGTTCTTC	CAWNAGPKEPGREQFF	TRBV30	TRBJ2-1
TGTGCCAGCAGTTACTCCAAAAGGCGCTCCCACCCCACCACAGATACGCAGTATTTT	CASSYSKRRSHPTTDTQYF	TRBV6-5	TRBJ2-3
TGTGCCATCCGCCACAGAGGGAACACTGAAGCTTTCTTT	CAIRHRGNTEAFF	TRBV10-3	TRBJ1-1
TGTGCCAGCTCACACAGGGAAGCAGTTTATGGCTACACCTTC	CASSHREAVYGYTF	TRBV18	TRBJ1-2
TGTGCCTGGAGGGAGGGGACTAGCGGGGGGGCAACAGATACGCAGTATTTT	CAWREGTSGGATDTQYF	TRBV30	TRBJ2-3
TGCGCCAGCAGTGGACTGGACAGGGGGCCGGGCACAGATACGCAGTATTTT	CASSGLDRGPGTDTQYF	TRBV10-1	TRBJ2-3
TGCAGCGTTGCCGACTTAAGAAATGAAAAACTGTTTTTT	CSVADLRNEKLFF	TRBV29-1	TRBJ1-4
TGCGCCAGCGGAAGGGGGGTGACCGGCTCCTACAATGAGCAGTTCTTC	CASGRGVTGSYNEQFF	TRBV4-3	TRBJ2-1
TGTGCCGCATTGTCTTGGGGGAAGGAAGAGACCCAGTACTTC	CAALSWGKEETQYF	TRBV6-2	TRBJ2-5
TGTGCCAGCAGCCCCCCTGGACAGGGGGCGCAGTTCTTC	CASSPPGQGAQFF	TRBV13	TRBJ2-1
TGTGCCAGCAGCCCCACGGGACGGAACACTGAAGCTTTCTTT	CASSPTGRNTEAFF	TRBV7-3	TRBJ1-1
TGTGCCATCGAGGGGGTTAGAGAGAGGACAGGGGCCCGGAATGAAAAACTGTTTTTT	CAIEGVRERTGARNEKLFF	TRBV10-3	TRBJ1-4
TGCAGTGCTTGGGGACAGGGTTACTACGAGCAGTACTTC	CSAWGQGYYEQYF	TRBV20-1	TRBJ2-7
TGTGCCAGCAGTGTTTTGGTAGTCAGAAGGGGATTTTACGAGCAGTACTTC	CASSVLVVRRGFYEQYF	TRBV25-1	TRBJ2-7
TGTGCCAGCAGCCCGGTAGGGACTAGCGGGGGGTTATGCGGAGATGGCGCCTACAATGAGCAGTTCTTC	CASSPVGTSGGLCGDGAYNEQFF	TRBV13	TRBJ2-1
TGCGCCAGCACGATAGACGGCTGTCAGCCCCAGCATTTT	CASTIDGCQPQHF	TRBV10-2	TRBJ1-5
TGCGCCAGCTCCCACCCAGACACGTGGGAGGCTCCATACGAGCAGTACTTC	CASSHPDTWEAPYEQYF	TRBV10-1	TRBJ2-7
TGTGCCAGCAGCCAGTTTAGCGGGCTCTACGAGCAGTACTTC	CASSQFSGLYEQYF	TRBV6-5	TRBJ2-7
TGTGCCAGCAGTTTCAGATGGAGGGTGATTGGGGATCAGCCCCAGCATTTT	CASSFRWRVIGDQPQHF	TRBV27	TRBJ1-5
TGTGCCAGCAGCCATTTTTCACAGGGTAATTCCTACGAGCAGTACTTC	CASSHFSQGNSYEQYF	TRBV14	TRBJ2-7
TGTGCCGGTAGCCAGTTTCGGGACGAGCAGTACTTC	CAGSQFRDEQYF	TRBV10-3	TRBJ2-7
TGTGCCAGCAGCCAAGTTAAAGATCGGGACGGGAACCGGGACTATGGCTACACCTTC	CASSQVKDRDGNRDYGYTF	TRBV4-2	TRBJ1-2
TGTGCCAGCAGCACAACACTGTTCCTGGACAGGGAACTAGATGGCTACACCTTC	CASSTTLFLDRELDGYTF	TRBV7-2	TRBJ1-2
TGCGCCAGCAGCGAGACAACTGCGGTGGGCTACACCTTC	CASSETTAVGYTF	TRBV5-1	TRBJ1-2
TGTGCCTGGAGTCGCCCGGGGACTAGGGATACGCAGTATTTT	CAWSRPGTRDTQYF	TRBV30	TRBJ2-3
TGTGCCAGCAGGGGCGAAAAACTGTTTTTT	CASRGEKLFF	TRBV12-3	TRBJ1-4
TGTGCCAGCAGCCAATGGAGGAAGGGGGTATCCTACGAGCAGTACTTC	CASSQWRKGVSYEQYF	TRBV13	TRBJ2-7
TGTGCCAGCACGTTGCCCTTAGGGGGCCGGCCTGAAGCTTTCTTT	CASTLPLGGRPEAFF	TRBV7-7	TRBJ1-1
TGTGCCAGCAGTTTAAGGGGGCTAGACGGGGAGGCAGGCTACGAGCAGTACTTC	CASSLRGLDGEAGYEQYF	TRBV27	TRBJ2-7
TGTGCCAGCAGCCAAGTATCGGACAGAGGGCCGTCCGCCAAAAACATTCAGTACTTC	CASSQVSDRGPSAKNIQYF	TRBV3-1	TRBJ2-4
TGTGCCAGCAGCCCTTCAGGGACAGGGCTTAATGAAAAACTGTTTTTT	CASSPSGTGLNEKLFF	TRBV7-2	TRBJ1-4
TGTGCCAGCAGCCGGGCTGGGGCAGATACGCAGTATTTT	CASSRAGADTQYF	TRBV13	TRBJ2-3
TGTGCCAGCAGTGCCCCATTTTCTACAGAAGGGGGGATTACTGAAGCTTTCTTT	CASSAPFSTEGGITEAFF	TRBV6-1	TRBJ1-1
TGTGCCAGCAGCTTAGACCCGGGGGTGCATACGCAGTATTTT	CASSLDPGVHTQYF	TRBV7-2	TRBJ2-3
TGTGCCTGGAGTGTGGGCCCGCTTCCCCCGGGGGAAGGGCAGCCCCAGCATTTT	CAWSVGPLPPGEGQPQHF	TRBV30	TRBJ1-5
TGTGCCAGCAGCGGGCCCACTAATGAAAAACTGTTTTTT	CASSGPTNEKLFF	TRBV7-9	TRBJ1-4
TGTGCCACCAGCAGGCAGGGGTTTCTGTTTTTT	CATSRQGFLFF	TRBV15	TRBJ1-4
TGTGCCACCCCATCGACAGGGAAGGGGGGTCGTCAGCCCCAGCATTTT	CATPSTGKGGRQPQHF	TRBV19	TRBJ1-5
TGTGCCACCAGCCACAGGGCCTTAGCTAACTATGGCTACACCTTC	CATSHRALANYGYTF	TRBV15	TRBJ1-2
TGTGCCAGCAGTCACCCCAAACGGCGTGGACAGGGGGCTGACTATGGCTACACCTTC	CASSHPKRRGQGADYGYTF	TRBV2	TRBJ1-2
TGTGCCAGCACCCCATCCACAGGGGGCCGGGTCCCGAACACCGGGGAGCTGTTTTTT	CASTPSTGGRVPNTGELFF	TRBV6-5	TRBJ2-2
TGTGCTAGGACAGGGCCCCAGCATTTT	CARTGPQHF	TRBV12-5	TRBJ1-5
TGTGCCAGCAGCACCCGCCGGAGCTATGGCTACACCTTC	CASSTRRSYGYTF	TRBV7-2	TRBJ1-2
TGCAGCGTCCCGACTAGCGGGCCTCTCTACGAGCAGTACTTC	CSVPTSGPLYEQYF	TRBV29-1	TRBJ2-7
TGCAGTGCATCCGAGCCGGGGGTAAGCAATCAGCCCCAGCATTTT	CSASEPGVSNQPQHF	TRBV20-1	TRBJ1-5
TGTGCCACCAGTGATCTCTGGGGCAATCAGCCCCAGCATTTT	CATSDLWGNQPQHF	TRBV24-1	TRBJ1-5
TGCGCCAGCAGCCCAGAGGGGGAGGGGAGGGAAAGGAGTATAATTAGGAACGACAATGAGCAGTTCTTC	CASSPEGEGRERSIIRNDNEQFF	TRBV5-1	TRBJ2-1
TGTGCCAGCAGTGTAGGTGGGGGGGGTCAAGAGACCCAGTACTTC	CASSVGGGGQETQYF	TRBV3-1	TRBJ2-5
TGTGCCAGCAGAAACTGGGCCTTTCTGCAAGAGACCCAGTACTTC	CASRNWAFLQETQYF	TRBV12-3	TRBJ2-5
TGTGCCAGCAGCGTCCCGGGACCGTACACCGGGGAGCTGTTTTTT	CASSVPGPYTGELFF	TRBV6-4	TRBJ2-2
TGCGCCAGCAGCCATACATCTTTCTTT	CASSHTSFF	TRBV4-1	TRBJ1-1
TGCAGTGCTAGATCCCCAGGCCCTAAGATGTATAGCAATCAGCCCCAGCATTTT	CSARSPGPKMYSNQPQHF	TRBV20-1	TRBJ1-5
TGTGCCAGCAGCGCGAAAGGGATCAGCACACTAGCGGGAGGTCAGCCCCAGCATTTT	CASSAKGISTLAGGQPQHF	TRBV13	TRBJ1-5
TGCAGTGCTCGGGAGCGTCCGAACACTGAAGCTTTCTTT	CSARERPNTEAFF	TRBV20-1	TRBJ1-1
TGTGCCAGCAGCCAAGCCAGGGGTGGGACGGGGTTCTCTGGGGCCAACGTCCTGACTTTC	CASSQARGGTGFSGANVLTF	TRBV7-3	TRBJ2-6
TGTGCCAGCAGCATTCCTAGCGGGGCCAATCAGTACTTC	CASSIPSGANQYF	TRBV6-5	TRBJ2-5
TGTGCCAGCAGCTTGGTCGCCTTGGTGGGGTCGGGGCAGCCCCAGCATTTT	CASSLVALVGSGQPQHF	TRBV5-4	TRBJ1-5
TGTGCCAGTATTGATGACTTGCGAAAGGGGCTCCCTGATAATTCACCCCTCCACTTT	CASIDDLRKGLPDNSPLHF	TRBV19	TRBJ1-6
TGTGCCAGCAGCCAAGCGGGGCGGGGCGTAAATCAGCCCCAGCATTTT	CASSQAGRGVNQPQHF	TRBV3-1	TRBJ1-5
TGTGCCAGCAGCCCTTCGGGGCGTGCCGAGCAGTACTTC	CASSPSGRAEQYF	TRBV7-3	TRBJ2-7
TGTGCCACCAGTGATACGGGGGCAGGATTAGCCAAAAACATTCAGTACTTC	CATSDTGAGLAKNIQYF	TRBV24-1	TRBJ2-4
TGTGCCTTTGAATCCGGGACAGGGGGTCGAACTGAAGCTTTCTTT	CAFESGTGGRTEAFF	TRBV11-3	TRBJ1-1
TGTGCCAGAAGGGCAGGGCGCGTCTCCTACGAGCAGTACTTC	CARRAGRVSYEQYF	TRBV19	TRBJ2-7
TGTGCCAGCAGTGTCGGGAGTGGCGGGATCTCTGGAAACACCATATATTTT	CASSVGSGGISGNTIYF	TRBV6-5	TRBJ1-3
TGCGCCAGCAGCCAGACCCCCCCGCGGCGGCGAAATAGCACAGATACGCAGTATTTT	CASSQTPPRRRNSTDTQYF	TRBV4-1	TRBJ2-3
TGTGCCAGCAGTTTATCAATTTGCGGGAGGAGCACAGATACGCAGTATTTT	CASSLSICGRSTDTQYF	TRBV28	TRBJ2-3
TGTGCCAGCAGCTTAGGGGAGCCGGGACAGGGTAACTACGAGCAGTACTTC	CASSLGEPGQGNYEQYF	TRBV11-1	TRBJ2-7
TGTGCCAGCAGCCTCACAGGGCCGGCAGGCTACGAGCAGTACTTC	CASSLTGPAGYEQYF	TRBV7-9	TRBJ2-7
TGTGCCAGCTCCCAAGGAGGGGGAGGTGCAACTAATGAAAAACTGTTTTTT	CASSQGGGGATNEKLFF	TRBV7-9	TRBJ1-4
TGTGCCAGCAGCTATCTTCCACAGGGCCCCCCAGCTTTCTTT	CASSYLPQGPPAFF	TRBV7-9	TRBJ1-1
TGTGCCAGCAGCTTACGTAGAAAGGCCGCCACTGAAGCTTTCTTT	CASSLRRKAATEAFF	TRBV3-1	TRBJ1-1
TGCGCCACCAGGGGGTTTGACGAGCAGTACTTC	CATRGFDEQYF	TRBV10-1	TRBJ2-7
TGTGCCAGCAGCTTAGAAGGTCTTTATGAAAAACTGTTTTTT	CASSLEGLYEKLFF	TRBV7-3	TRBJ1-4
TGTGCCAGCATCCCCGAACCCAGGACAGGGCGCTACGAGCAGTACTTC	CASIPEPRTGRYEQYF	TRBV12-3	TRBJ2-7
TGTGCCAGCAGCTTATTCCTGGGGGGGGGAACAGATACGCAGTATTTT	CASSLFLGGGTDTQYF	TRBV7-9	TRBJ2-3
TGTGCCAGCAGCTTAGCCAGGAGCGGACCTAATGAAAAACTGTTTTTT	CASSLARSGPNEKLFF	TRBV7-9	TRBJ1-4
TGTGCCAGCAGCTTAAAAGGACAGGGGGATGAAAAACTGTTTTTT	CASSLKGQGDEKLFF	TRBV7-3	TRBJ1-4
TGTGCCAGCAGTTTGGGACTAGTGGGCTACGAGCAGTACTTC	CASSLGLVGYEQYF	TRBV6-5	TRBJ2-7
TGTGCCAGCAAGGACCAAGAGACCCAGTACTTC	CASKDQETQYF	TRBV14	TRBJ2-5
TGTGCGCCCCACGTAAGGGGTGGGACGAGACCGACGGAGACCCAGTACTTC	CAPHVRGGTRPTETQYF	TRBV6-2	TRBJ2-5
TGTGCCAGCAGCGCACGGGGCGTATGGGGCCTCTTGCCTACCGGGGAGCTGTTTTTT	CASSARGVWGLLPTGELFF	TRBV13	TRBJ2-2
TGTGCCAGCAGCCCGAACGGGGGGGAGACCCAGTACTTC	CASSPNGGETQYF	TRBV9	TRBJ2-5
TGTGCCAGCAGTTACTCGGTGTACTGGATATCGACTTGCTCCTACAATGAGCAGTTCTTC	CASSYSVYWISTCSYNEQFF	TRBV6-6	TRBJ2-1
TGTTTACCCCGAGGCAATGAGCAGTTCTTC	CLPRGNEQFF	TRBV10-3	TRBJ2-1
TGTGCCAGCAGTGACGGGCTCACAGATACGCAGTATTTT	CASSDGLTDTQYF	TRBV6-4	TRBJ2-3
TGTGCCAGCTCACCACCGTCCAGGTTGAACACTGAAGCTTTCTTT	CASSPPSRLNTEAFF	TRBV18	TRBJ1-1
TGTGCCAGCAGCTCTACCAACACAGATACGCAGTATTTT	CASSSTNTDTQYF	TRBV7-2	TRBJ2-3
TGTGCCAGCAGCTTAGAGGGGGGGCCGGTCGGGGAGCTGTTTTTT	CASSLEGGPVGELFF	TRBV11-2	TRBJ2-2
TGTGCCAGCAGCACAGGGTTGACCTACGAGCAGTACTTC	CASSTGLTYEQYF	TRBV13	TRBJ2-7
TGCAGTGCGCTCCTGTCGTTTCCCCACGAGACCCAGTACTTC	CSALLSFPHETQYF	TRBV20-1	TRBJ2-5
TGCGCCAGCAGCTTGCTTCCCAGGTTAGACACCGGGGAGCTGTTTTTT	CASSLLPRLDTGELFF	TRBV5-1	TRBJ2-2
