TGTGCCAGCAGTGACGAAGCAATCGGGGGATGGCAGCCCCAGCATTTT	CASSDEAIGGWQPQHF	TRBV6-4	TRBJ1-5
TGTGCCAGCGGGACAAAAGCCAAAAACATTCAGTACTTC	CASGTKAKNIQYF	TRBV2	TRBJ2-4
TGCGCCAGCAGCTGGAGATACAGCGGTAAAGAGTCTTGCTACAATGAGCAGTTCTTC	CASSWRYSGKESCYNEQFF	TRBV5-1	TRBJ2-1
TGTGCCAGCAGGACAGGGTATATAGGCTACACCTTC	CASRTGYIGYTF	TRBV6-4	TRBJ1-2
TGTGCCAGTAGGATTCAGGGACTTAACATTCAGTACTTC	CASRIQGLNIQYF	TRBV19	TRBJ2-4
TGCAAACCCAGGAAATATAGCAATCAGCCCCAGCATTTT	CKPRKYSNQPQHF	TRBV20-1	TRBJ1-5
TGTGCCAGCAGTTTAGCTAGCGGGGGCACCGGGGAGCTGTTTTTT	CASSLASGGTGELFF	TRBV27	TRBJ2-2
TGCGCCAGCAGCCAGGACCCGGGACAGGGTGGTAGATTTGGCTACACCTTC	CASSQDPGQGGRFGYTF	TRBV4-1	TRBJ1-2
TGTGCCAGCAGCTTTCTCACTAGCGGGGGGGCCGGCAATGAGCAGTTCTTC	CASSFLTSGGAGNEQFF	TRBV7-3	TRBJ2-1
TGTGCCAGCAGTCCTGAGGGGCCGATCATGAACACTGAAGCTTTCTTT	CASSPEGPIMNTEAFF	TRBV6-1	TRBJ1-1
TGTGCCAGCAGCTTAGGACCTAGCGCCCCAGAGACCCAGTACTTC	CASSLGPSAPETQYF	TRBV7-9	TRBJ2-5
TGTGCCAGCAGCCAGACCCCCGATGACAGGGAGGTGCCCGGGGAGCTGTTTTTT	CASSQTPDDREVPGELFF	TRBV3-1	TRBJ2-2
TGTGCCAGCAGCTTAGCGTTAGCGACAGGGGTTGCTCCCTACGAGCAGTACTTC	CASSLALATGVAPYEQYF	TRBV7-6	TRBJ2-7
TGCAGTGCTAGTGAGATCTACGTGGGACAGGGGGAAAAACTGTTTTTT	CSASEIYVGQGEKLFF	TRBV20-1	TRBJ1-4
TGTGCCAGCAGCGCTATGGAAAGCCCGAGGGAGCCCCAGCATTTT	CASSAMESPREPQHF	TRBV5-5	TRBJ1-5
TGTGCCAGCAGCCAAGCAAGAGGACTCCTCAATCAGCCCCAGCATTTT	CASSQARGLLNQPQHF	TRBV4-2	TRBJ1-5
TGCGCCAGCAGCCAAGATCAACGTCCGGGACTAGCGGACAGAACCTACGAGCAGTACTTC	CASSQDQRPGLADRTYEQYF	TRBV4-3	TRBJ2-7
TGTGCCAGCAGTTTAGGGGGGGAGTGGAAGCAATCCGTAACGCGTAACACCGGGGAGCTGTTTTTT	CASSLGGEWKQSVTRNTGELFF	TRBV28	TRBJ2-2
TGTGCCAGCAGTTATTTGGGGGGGAACACTGAAGCTTTCTTT	CASSYLGGNTEAFF	TRBV6-3	TRBJ1-1
TGTGCCAGCACCCGGACTAGCGGCGTGGCCGGGGAGCTGTTTTTT	CASTRTSGVAGELFF	TRBV6-5	TRBJ2-2
TGCGCCAGCAGCCAAGTGAACAACACTGAAGCTTTCTTT	CASSQVNNTEAFF	TRBV4-3	TRBJ1-1
TGTGCCAGCAGCCCCCTGAGGGGCATGTATGAGCAGTTCTTC	CASSPLRGMYEQFF	TRBV9	TRBJ2-1
TGCAGTGCTAGGTCCCGAGTGGAGCAGTTCTTC	CSARSRVEQFF	TRBV20-1	TRBJ2-1
TGTGCCAGCAGCCCCACAGGGACTAGGGGCAATGAGCAGTTCTTC	CASSPTGTRGNEQFF	TRBV11-3	TRBJ2-1
TGTGCCAGCAGTGACCCGACTAAGGGGGCCAAAAACATTCAGTACTTC	CASSDPTKGAKNIQYF	TRBV6-4	TRBJ2-4
TGTGCCAGCAGGCCACCCAACTATCGGGGGGAATATGGCTACACCTTC	CASRPPNYRGEYGYTF	TRBV3-1	TRBJ1-2
TGCGCCAGCAGCCAAGTTGCGTCCGCGGGACTTTGGGTTAGTAGGCGTACTAGCACAGATACGCAGTATTTT	CASSQVASAGLWVSRRTSTDTQYF	TRBV4-1	TRBJ2-3
TGTGCCAGCGGGTCCCAGGGGGGGTCCTACGAGCAGTACTTC	CASGSQGGSYEQYF	TRBV6-1	TRBJ2-7
TGTGCCAGTAGTAGCCAACCACCCAACACTGAAGCTTTCTTT	CASSSQPPNTEAFF	TRBV19	TRBJ1-1
TGTGCCAGCAGCATATCCGGGCAGGGGGGGGATGAGCAGTTCTTC	CASSISGQGGDEQFF	TRBV11-3	TRBJ2-1
TGCAGTGCTAGTTGGCCGAACAGGGTCTATTCCGAGAACACTGAAGCTTTCTTT	CSASWPNRVYSENTEAFF	TRBV20-1	TRBJ1-1
TGCAGTGCTAGAGAGACGGAAGGTGTAACAGATACGCAGTATTTT	CSARETEGVTDTQYF	TRBV20-1	TRBJ2-3
TGCGCCAGCAGCCAAGTGCACCGGTACATCTGCAATCAGCCCCAGCATTTT	CASSQVHRYICNQPQHF	TRBV4-1	TRBJ1-5
TGTGCCACCATCCCGGGACCAGGGGTCTCTGGGGCCAACGTCCTGACTTTC	CATIPGPGVSGANVLTF	TRBV24-1	TRBJ2-6
TGTGCCAGGCAACGAGGACTAGCGGAAGAGTACGAGCAGTACTTC	CARQRGLAEEYEQYF	TRBV27	TRBJ2-7
TGTGCCAGCAGCTTGGCCGAATACGAGCAGTACTTC	CASSLAEYEQYF	TRBV5-4	TRBJ2-7
TGTGCCACCAGTCGTGGGAGGCGGAGCTCCTACGAGCAGTACTTC	CATSRGRRSSYEQYF	TRBV15	TRBJ2-7
TGTGCCAGCAGCCAGACAGGGGGGCGTGGCAAGCCCCAGCATTTT	CASSQTGGRGKPQHF	TRBV14	TRBJ1-5
TGTGCCAGGAAATTCCCCCAGGGAAAGGGCTCTGGAAACACCATATATTTT	CARKFPQGKGSGNTIYF	TRBV10-3	TRBJ1-3
TGTGCCAGCGTCGGAGACAGGGAATCTCGCTCTGGAAACACCATATATTTT	CASVGDRESRSGNTIYF	TRBV27	TRBJ1-3
TGTGCCACCAGTGAACCCCCTACAGGGGCACGAGGGAACACTGAAGCTTTCTTT	CATSEPPTGARGNTEAFF	TRBV24-1	TRBJ1-1
TGTGCCAGCCAAGTGGGGGGGAGGAACTATGGCTACACCTTC	CASQVGGRNYGYTF	TRBV6-5	TRBJ1-2
TGTGCCAGCAGCTTAGATATCCTGGAATCCCAGGGAGCTCAGCCCCAGCATTTT	CASSLDILESQGAQPQHF	TRBV11-3	TRBJ1-5
TGTGCCAGCAGCTTAACAAGGCTAAAATACGAGCAGTACTTC	CASSLTRLKYEQYF	TRBV7-9	TRBJ2-7
TGTGCCACCAGTGTCAACACCCAAAATTGTTCCGGGACAGGGGGTAGCTCTGGGGCCAACGTCCTGACTTTC	CATSVNTQNCSGTGGSSGANVLTF	TRBV24-1	TRBJ2-6
TGCAGTGCTTTGCGGCGGTTAAAAGATACGCAGTATTTT	CSALRRLKDTQYF	TRBV20-1	TRBJ2-3
TGTGCCAGCAGCCAAGCGAACGGAAACACCATATATTTT	CASSQANGNTIYF	TRBV4-2	TRBJ1-3
TGTGCCAGCAGTTTTTTTTCCAGGGAGAGCAATCAGCCCCAGCATTTT	CASSFFSRESNQPQHF	TRBV12-4	TRBJ1-5
TGTGCCAGCAGTTGGGGGGGGACGCAGAATGAAAAACTGTTTTTT	CASSWGGTQNEKLFF	TRBV27	TRBJ1-4
TGTGCCAGCAGCTTAGCGGGGGGACCTACAACCGGGGAGCTGTTTTTT	CASSLAGGPTTGELFF	TRBV7-4	TRBJ2-2
TGTGCCAGCAGTAACCGGGACAGGGGCTCCTACGAGCAGTACTTC	CASSNRDRGSYEQYF	TRBV6-1	TRBJ2-7
TGCAGTGCTAGAGAGCGGACAGGGGGATCTGAAGCTTTCTTT	CSARERTGGSEAFF	TRBV20-1	TRBJ1-1
TGTGCCTTGTGGACTGGGCCGTTCGTAAACTACGAGCAGTACTTC	CALWTGPFVNYEQYF	TRBV6-4	TRBJ2-7
TGTGCCAGCTCACCACGGCCTCATTCTGGATCAGATCAGAACTATGGCTACACCTTC	CASSPRPHSGSDQNYGYTF	TRBV18	TRBJ1-2
TGTGCCAGCAGCTTAGAAGGGGGGGGTGGGGAGACCCAGTACTTC	CASSLEGGGGETQYF	TRBV7-6	TRBJ2-5
TGTGCCAGCAGCTTAGAAGAGACCCCTTACCTAGCGGTCTACAATGAGCAGTTCTTC	CASSLEETPYLAVYNEQFF	TRBV7-6	TRBJ2-1
TGTGCCAGCAGCTTAGCACCGGGACAGGGACTAAGGACCTTAAATCAGCCCCAGCATTTT	CASSLAPGQGLRTLNQPQHF	TRBV7-9	TRBJ1-5
TGTGCCAGCAGGACGACCGGGACAGGGGGCAGGCGGAGTCAAGATGGCTACACCTTC	CASRTTGTGGRRSQDGYTF	TRBV12-3	TRBJ1-2
TGTGCCAGCAGCTTGGGTGGACTAGCGGTGGGGTACAATGAGCAGTTCTTC	CASSLGGLAVGYNEQFF	TRBV5-4	TRBJ2-1
TGTGCCAGTAGCACTGACCCAGAGACCCAGTACTTC	CASSTDPETQYF	TRBV19	TRBJ2-5
TGTGCCAGCAGCGGCGAGACTAGGAATGAGCAGTTCTTC	CASSGETRNEQFF	TRBV9	TRBJ2-1
TGCAGTGCTAGAGATCGGGCGGGCTACGAGCAGTACTTC	CSARDRAGYEQYF	TRBV20-1	TRBJ2-7
TGCGCCAGCGGGGGACTAGCGGTCGAGGTTATATTCTACGAGCAGTACTTC	CASGGLAVEVIFYEQYF	TRBV10-1	TRBJ2-7
TGTGCCAGCAAGGTCGCGCGGGACAGGCGTAGCAATCAGCCCCAGCATTTT	CASKVARDRRSNQPQHF	TRBV6-1	TRBJ1-5
TGTGCCACCAGTGATTTAAGGGGGGGGACAGGGACTTATACCGGGGAGCTGTTTTTT	CATSDLRGGTGTYTGELFF	TRBV24-1	TRBJ2-2
TGTGCCAGGACCACCAGGGACCGAAATGGCTACACCTTC	CARTTRDRNGYTF	TRBV2	TRBJ1-2
TGCGCCAGCAGCGATCCGGGACTTGGGAGAAACACCATATATTTT	CASSDPGLGRNTIYF	TRBV4-1	TRBJ1-3
TGTGCCAGCAAAACCGGTCCTCCACGGAGCTACGAGCAGTACTTC	CASKTGPPRSYEQYF	TRBV27	TRBJ2-7
TGTGCCAGCAGCGGTCCCCAAGACGTCGTGAACACTGAAGCTTTCTTT	CASSGPQDVVNTEAFF	TRBV7-4	TRBJ1-1
TGTGCCAGCAGTTACTTTCCCCGGGGGGGCGCCTGGGAGACCCAGTACTTC	CASSYFPRGGAWETQYF	TRBV6-5	TRBJ2-5
TGTGCCAGTAGTATGGCGGACAGGAGGTCCGGCTCCTACGAGCAGTACTTC	CASSMADRRSGSYEQYF	TRBV19	TRBJ2-7
TGTGCCAGCAGTTTGGGCGACAGGGTTCGGTGCTACACCTTC	CASSLGDRVRCYTF	TRBV12-3	TRBJ1-2
TGTGCACCGGGGACTAGCGGGAATGAGCAGTTCTTC	CAPGTSGNEQFF	TRBV27	TRBJ2-1
TGTGCCAGCAGCCCCGGCCAGCGCGGCTACGAGCAGTACTTC	CASSPGQRGYEQYF	TRBV14	TRBJ2-7
TGTGCCATCAACACAGGGAGTCATAATTCACCCCTCCACTTT	CAINTGSHNSPLHF	TRBV10-3	TRBJ1-6
TGCAGTGCTAGGACAGACGTTGACTCTGGGGCCAACGTCCTGACTTTC	CSARTDVDSGANVLTF	TRBV20-1	TRBJ2-6
TGTGCCACTGTCGGAGGGTACTATGGCTACACCTTC	CATVGGYYGYTF	TRBV24-1	TRBJ1-2
TGTGCCACCATTAGCAAGGGGAGACTGACCACAGATACGCAGTATTTT	CATISKGRLTTDTQYF	TRBV15	TRBJ2-3
TGTGCCAGCAATATTGGGCCCAGGTGCAAGTACAATGAGCAGTTCTTC	CASNIGPRCKYNEQFF	TRBV27	TRBJ2-1
TGTGCCAGCAGGGGGGGGGCGCCAAACTACGAGCAGTACTTC	CASRGGAPNYEQYF	TRBV12-4	TRBJ2-7
TGTGCCATCAGTGCCCGGGCCTACGAGCAGTACTTC	CAISARAYEQYF	TRBV10-3	TRBJ2-7
TGCGCCAGCAGCCAAGGAGCCTACGAGCAGTACTTC	CASSQGAYEQYF	TRBV4-1	TRBJ2-7
TGTGCCAGCGGTAAAAGACAGGAACACGAGCAGTACTTC	CASGKRQEHEQYF	TRBV12-3	TRBJ2-7
TGTGCCAGCGTCCCCCAGGGCAATGGCTACACCTTC	CASVPQGNGYTF	TRBV7-2	TRBJ1-2
TGTGCCAGCAGCGAATGGCTCACTAGCGGGAGCTGTTCCCCCTACGAGCAGTACTTC	CASSEWLTSGSCSPYEQYF	TRBV14	TRBJ2-7
TGTGCCAGCAGCAACCTCAGCCGGAACAATGAGCAGTTCTTC	CASSNLSRNNEQFF	TRBV7-3	TRBJ2-1
TGCGCCAGCCAAACAGGCCTAGCCCCCTCGGCTGAGCAGTTCTTC	CASQTGLAPSAEQFF	TRBV5-1	TRBJ2-1
TGTGCCAGCACCAGCGGGAACTTC	CASTSGNF	TRBV2	TRBJ2-7
TGTGCCAGCAGGTCAGTCGGGGGGATGAGACCCCCCTACAATGAGCAGTTCTTC	CASRSVGGMRPPYNEQFF	TRBV28	TRBJ2-1
TGTGCCATCAGTGAGGCAGAGACAGGGACTTGCTATGGCTACACCTTC	CAISEAETGTCYGYTF	TRBV10-3	TRBJ1-2
TGCAGTGCTACCCTCATATCCCGGGACAGTCGAGACACCATATATTTT	CSATLISRDSRDTIYF	TRBV20-1	TRBJ1-3
TGTGCCAGCAGCGGCCGCGGGAGGGTTTCGAACACCGGGGAGCTGTTTTTT	CASSGRGRVSNTGELFF	TRBV7-4	TRBJ2-2
TGTGCCACCAACCGGTATCACCCTGGAAACACCATATATTTT	CATNRYHPGNTIYF	TRBV10-3	TRBJ1-3
TGTGCCAGCAGTCAGGGGTCACATCAGCCCCAGCATTTT	CASSQGSHQPQHF	TRBV28	TRBJ1-5
TGTGCTAGTGGTTTGGTACTTATGGGGAGGTTACCCCAGCATTTT	CASGLVLMGRLPQHF	TRBV12-5	TRBJ1-5
TGTGCCAGCAGTGAATTTAGGGTGGAGACCCAGTACTTC	CASSEFRVETQYF	TRBV6-1	TRBJ2-5
TGCGCCAGCAGCTCCCATCCGGCGGGAGACCTCAATGAGCAGTTCTTC	CASSSHPAGDLNEQFF	TRBV5-1	TRBJ2-1
TGTGCCTGGTCCGACTATGGCTACACCTTC	CAWSDYGYTF	TRBV30	TRBJ1-2
TGTGCCAGCAGCCATACTCCGGGCACGGAGACCCAGTACTTC	CASSHTPGTETQYF	TRBV14	TRBJ2-5
TGTGCCAGCAGCGCTCGGGGGGGAGAAAATGAGCAGTTCTTC	CASSARGGENEQFF	TRBV7-9	TRBJ2-1
TGTGCCAGCAGCCGGCGGACAGGGCGGTCCGAAAAACTGTTTTTT	CASSRRTGRSEKLFF	TRBV28	TRBJ1-4
TGTGCCAGCAGCTTAGGGGGGGGGGGGAACACCGGGGAGCTGTTTTTT	CASSLGGGGNTGELFF	TRBV11-2	TRBJ2-2
TGTGCCAGCAGAGAACAGGGGGTCGATTACAATGAGCAGTTCTTC	CASREQGVDYNEQFF	TRBV25-1	TRBJ2-1
TGTGCCAGCAGACATCTAGAAGGGGCAGGGAACACTGAAGCTTTCTTT	CASRHLEGAGNTEAFF	TRBV9	TRBJ1-1
TGTGCCAGCAGTTCTAGACCTTCGACTAGCGGACACGAGCAGTACTTC	CASSSRPSTSGHEQYF	TRBV27	TRBJ2-7
TGTGCCAGCAGGCTCCCCCCGGGACCATACGAGCAGTACTTC	CASRLPPGPYEQYF	TRBV27	TRBJ2-7
TGTGCTAGTGGTTTGGTACTACGATCACAACTGGGGAATAATTCACCCCTCCACTTT	CASGLVLRSQLGNNSPLHF	TRBV12-5	TRBJ1-6
TGTGCCAGTATAGGTCCGTGGGTCTTC	CASIGPWVF	TRBV19	TRBJ2-1
TGTGCCAGCAGCTTAGCCCTGAGGGCCAAGTCCTACAATGAGCAGTTCTTC	CASSLALRAKSYNEQFF	TRBV7-4	TRBJ2-1
TGTGCCAGCAGCTCGTGGACAGGGGGTAGCAATCAGCCCCAGCATTTT	CASSSWTGGSNQPQHF	TRBV5-5	TRBJ1-5
TGTGCCAGTTCGAGAGAGCAGTTCTTC	CASSREQFF	TRBV19	TRBJ2-1
TGTGCCACCAGTGATTTCCCGCGCGATCCGATAAGAGAGACCCAGTACTTC	CATSDFPRDPIRETQYF	TRBV24-1	TRBJ2-5
TGTGCCAGCAGATTAATAACCGGGACTAGCGGGGGGGCCTCGACGAAAGGGGTCTTC	CASRLITGTSGGASTKGVF	TRBV7-2	TRBJ2-1
TGTGCCAGCAGTTACAGGGGGCATACCTACGAGCAGTACTTC	CASSYRGHTYEQYF	TRBV27	TRBJ2-7
TGCGCCAGCAGCTTCGGGGGAGAGTTCACCGGGGAGCTGTTTTTT	CASSFGGEFTGELFF	TRBV5-1	TRBJ2-2
TGCGCCATCTACAGAGGGAATCAGCCCCAGCATTTT	CAIYRGNQPQHF	TRBV10-1	TRBJ1-5
TGTGCCAGCAGCCGAAGGGCATCCTATAATTCACCCCTCCACTTT	CASSRRASYNSPLHF	TRBV3-1	TRBJ1-6
TGTGCCAGCAGCAAAAATTGGGCTCACTCCTACAATGAGCAGTTCTTC	CASSKNWAHSYNEQFF	TRBV9	TRBJ2-1
TGCGCCAGCAGCCAAGGGCACCGGGACAGGGGATACACCTTC	CASSQGHRDRGYTF	TRBV4-1	TRBJ1-2
TGTGCCAGCATTACAACCCGGGGGCGGAAAGGCGGGGAGCTGTTTTTT	CASITTRGRKGGELFF	TRBV25-1	TRBJ2-2
TGTGCCAGCAGCTTAGCTAGCACATACGGCCTTGGGGGCACAGATACGCAGTATTTT	CASSLASTYGLGGTDTQYF	TRBV7-9	TRBJ2-3
TGTGCCACGGGCTGCTACGAGCAGTACTTC	CATGCYEQYF	TRBV6-1	TRBJ2-7
TGTGCCAGCGGGGGAGGGGTGATCACAGATACGCAGTATTTT	CASGGGVITDTQYF	TRBV2	TRBJ2-3
TGCAGTGCTAGAGATCATCCGACAATAGACGGCCTAGCCAAAAACATTCAGTACTTC	CSARDHPTIDGLAKNIQYF	TRBV20-1	TRBJ2-4
TGTGCCAGCAGCGATACCTATAAGAGTGAGCAGTTCTTC	CASSDTYKSEQFF	TRBV9	TRBJ2-1
TGCAGCGAGGTTTCCGGTGGGTACCAAGAGACCCAGTACTTC	CSEVSGGYQETQYF	TRBV29-1	TRBJ2-5
TGCAGTGCTAGGAGGGCAGGACAGGGGAGCTATGGCTACACCTTC	CSARRAGQGSYGYTF	TRBV20-1	TRBJ1-2
TGTGCCACCAGTCGTACAGGCGGGGGCTCCTACGAGCAGTACTTC	CATSRTGGGSYEQYF	TRBV24-1	TRBJ2-7
TGTGCCAGCAGCTTAGTGACAGTCCCGTATGAGCAGTTCTTC	CASSLVTVPYEQFF	TRBV7-9	TRBJ2-1
TGTGCCAGCAGCGTTAGCGGGCGCACAGATACGCAGTATTTT	CASSVSGRTDTQYF	TRBV9	TRBJ2-3
TGCGCCAGCAGCACAAATGTACCAGGGCTCGGGGTAAGCTCCTACAATGAGCAGTTCTTC	CASSTNVPGLGVSSYNEQFF	TRBV5-1	TRBJ2-1
TGTGCCAGCAGCGTAGGGGTAAAGGACAGGGGAAAAGGGCACATTCAGTACTTC	CASSVGVKDRGKGHIQYF	TRBV9	TRBJ2-4
TGTGCCAGCGAACTAGCGGGTATATCACTCACCGGGGAGCTGTTTTTT	CASELAGISLTGELFF	TRBV7-3	TRBJ2-2
TGTGCCCCTCCGGGGAACTATGGCTACACCTTC	CAPPGNYGYTF	TRBV24-1	TRBJ1-2
TGTGCCAGCCACCCCGGGGCTTTTTCTGGCTACACCTTC	CASHPGAFSGYTF	TRBV6-2	TRBJ1-2
TGTGCCACCAAGCTCGATGAGGGGGGGGGGTCGATCCAGCATTTT	CATKLDEGGGSIQHF	TRBV24-1	TRBJ1-5
TGTGCCACCAGTCGACAGATGACCCTCGACGACGAGCAGTACTTC	CATSRQMTLDDEQYF	TRBV24-1	TRBJ2-7
TGCGCCAGCAGCTTGGTCGCTCGACGGAATCAGCCCCAGCATTTT	CASSLVARRNQPQHF	TRBV5-1	TRBJ1-5
TGTGCCAGCAGCATGGGCCCAGTCCGGGACAGGGAGATTCAGCCCCAGCATTTT	CASSMGPVRDREIQPQHF	TRBV7-2	TRBJ1-5
TGTGCCAGCAGCTTAGTAGGACAGCGCTATGGCTACACCTTC	CASSLVGQRYGYTF	TRBV11-3	TRBJ1-2
TGTGCCAGCAGCGGTACAAACAGGGAACGCTCTGGGGCCAACGTCCTGACTTTC	CASSGTNRERSGANVLTF	TRBV9	TRBJ2-6
TGTGCCAGCAGTAGGGAAAGGACAGGGGTCTATGGCTACACCTTC	CASSRERTGVYGYTF	TRBV5-4	TRBJ1-2
TGTGCCAGCAGCTTATGCGGTCCTTTCGACAGAGTGAACACTGAAGCTTTCTTT	CASSLCGPFDRVNTEAFF	TRBV7-4	TRBJ1-1
TGTGCCAGCAGCAGGGAAGGTCCTGACGAGCAGTACTTC	CASSREGPDEQYF	TRBV7-2	TRBJ2-7
TGTGCCAGCAGCGCCAAGGACAGGGACCCCTACGAGCAGTACTTC	CASSAKDRDPYEQYF	TRBV5-4	TRBJ2-7
TGTGCCATTTCGGAAGGGGGTAACACCGGGGAGCTGTTTTTT	CAISEGGNTGELFF	TRBV10-3	TRBJ2-2
TGCAGTGCGCATAAGACAGGATCTGAAGCTTTCTTT	CSAHKTGSEAFF	TRBV20-1	TRBJ1-1
TGTGCCTGGAGTGGCCAGGGGGCCGTGAACTCCGGGGAGCTGTTTTTT	CAWSGQGAVNSGELFF	TRBV30	TRBJ2-2
TGTGCCAGCAGTCAGGGGGGACGAACCAGCTCCTACGAGCAGTACTTC	CASSQGGRTSSYEQYF	TRBV6-4	TRBJ2-7
TGTGCCAGCTCCCGGACTAGCGGGAAGGACAAGTCCTACGAGCAGTACTTC	CASSRTSGKDKSYEQYF	TRBV13	TRBJ2-7
TGCGCCAGCAGTGAGTCCGGGGACCTGGCCGGGACAGATGGGAACACTGAAGCTTTCTTT	CASSESGDLAGTDGNTEAFF	TRBV10-1	TRBJ1-1
TGCAGTGCTGAAGGGGAGGGGGAGGGGCATCCCACTGAAGCTTTCTTT	CSAEGEGEGHPTEAFF	TRBV20-1	TRBJ1-1
TGCAGCCGAGGGGCTTCACGCGAGAACACTGAAGCTTTCTTT	CSRGASRENTEAFF	TRBV29-1	TRBJ1-1
TGTGCCAGTTCATTTGCAACTAATGAAAAACTGTTTTTT	CASSFATNEKLFF	TRBV27	TRBJ1-4
TGTGCCAGCACCGGACGACTGCAGTACTTC	CASTGRLQYF	TRBV28	TRBJ2-5
TGTGCCAGCAGTGTCCGAACTGGGCAGTTCTTC	CASSVRTGQFF	TRBV6-4	TRBJ2-1
TGTGCCAGCAGCGCCCCCTGGGCCTTC	CASSAPWAF	TRBV7-6	TRBJ1-2
TGTGCCAGCACCCGCGGACAGGGCTACGAGCAGTACTTC	CASTRGQGYEQYF	TRBV2	TRBJ2-7
TGTGCCAGCAGTGAAGCCCCAGGTCCTTGGGACAGAGGGTTCTACAATGAGCAGTTCTTC	CASSEAPGPWDRGFYNEQFF	TRBV6-1	TRBJ2-1
TGTGCCAGCAGCCCCTGTCGGGACCAGCCCCAGCATTTT	CASSPCRDQPQHF	TRBV6-6	TRBJ1-5
TGTGCCAGCAGCGCCCTGAACAAAGCGACTAGCGGGAGCGTTCTGGATGAGGAAAAACTGTTTTTT	CASSALNKATSGSVLDEEKLFF	TRBV11-1	TRBJ1-4
TGTGCCAGTAGTAACGTGAAGGTCGGTCCGAACACTGAAGCTTTCTTT	CASSNVKVGPNTEAFF	TRBV19	TRBJ1-1
TGTGCCAGCAGTGACGGCACCAAACCCCGGGACAGGGAGTGCGGGGAGCTGTTTTTT	CASSDGTKPRDRECGELFF	TRBV25-1	TRBJ2-2
TGCGCGGCCCACAGGGGGATCGAGGACCAGAACACCGGGGAGCTGTTTTTT	CAAHRGIEDQNTGELFF	TRBV5-1	TRBJ2-2
TGTGCTAGCAGCCCCACCAGGGGCGCAGTGGGAGGCGGTCATTCACCCCTCCACTTT	CASSPTRGAVGGGHSPLHF	TRBV7-7	TRBJ1-6
TGCGCCAGCAGCTCCAAAATTCCCAGGGGTTTGTACAAGCCCCAGCATTTT	CASSSKIPRGLYKPQHF	TRBV5-1	TRBJ1-5
TGTGCCATCAGTGAGTGGAAGAACACCGGGGAGCTGTTTTTT	CAISEWKNTGELFF	TRBV10-3	TRBJ2-2
TGCAGTGCTAGCGCTGCCGGGACTAGCGGTCCCTACGAGCAGTACTTC	CSASAAGTSGPYEQYF	TRBV20-1	TRBJ2-7
TGCAGTGCTGGCGTGAATGAGCAGTTCTTC	CSAGVNEQFF	TRBV20-1	TRBJ2-1
TGCGCCAGCAGCCAAGATGGGCGACCAGGAGGTAAAGTCGAGCAGTACTTC	CASSQDGRPGGKVEQYF	TRBV4-3	TRBJ2-7
TGTGCCAGCACCCTCGACAGGGGATCTCAGCCCCAGCATTTT	CASTLDRGSQPQHF	TRBV14	TRBJ1-5
TGTGCCAGCAGCTTAGTCGGGGGCTTAACCTACGAGCAGTACTTC	CASSLVGGLTYEQYF	TRBV11-3	TRBJ2-7
TGTGCCAGCAGCTCCCGAGGTAGGGGTCATCAGCCCCAGCATTTT	CASSSRGRGHQPQHF	TRBV11-2	TRBJ1-5
TGCGCCAGCAGCTCTGGGGACAGGGACGGCACCACTGAAGCTTTCTTT	CASSSGDRDGTTEAFF	TRBV5-1	TRBJ1-1
TGTGCCAGCAGCTTAGCGTCTGGTGAGACCCAGTACTTC	CASSLASGETQYF	TRBV7-8	TRBJ2-5
TGCTGGGACAGGGAGACCCAGTACTTC	CWDRETQYF	TRBV20-1	TRBJ2-5
TGTGCCAGCAGCAACGGGGTATCCTACGAGCAGTACTTC	CASSNGVSYEQYF	TRBV7-2	TRBJ2-7
TGTGCCATCAGTGAGGGTTCAAAGCTAGGGAAAGAACCCACAGATACGCAGTATTTT	CAISEGSKLGKEPTDTQYF	TRBV10-3	TRBJ2-3
TGCAGTGCTCCCGACCTAGCGCTCCACCAGCCCCAGCATTTT	CSAPDLALHQPQHF	TRBV20-1	TRBJ1-5
TGTGCCTGGAGCAACCCACGGGGACGTTTAGAGACCCAGTACTTC	CAWSNPRGRLETQYF	TRBV30	TRBJ2-5
TGTGCCAGCAGGCAAGTAAGGGTCTACGAGCAGTACTTC	CASRQVRVYEQYF	TRBV12-4	TRBJ2-7
TGCAGTGCAACGGGGGGGGGGATCTTC	CSATGGGIF	TRBV20-1	TRBJ2-1
TGCAGTGCTAGAACCGGACAAAATCAGCCCCAGCATTTT	CSARTGQNQPQHF	TRBV20-1	TRBJ1-5
TGTGCCAGCAGCCGTCCCAGGGACCGCTCTGGGGCCAACGTCCTGACTTTC	CASSRPRDRSGANVLTF	TRBV7-3	TRBJ2-6
TGTGCCAGCAGCGGGGGGACTAATGAAAAACTGTTTTTT	CASSGGTNEKLFF	TRBV7-7	TRBJ1-4
TGTGCCAGCAGCCAAGACCGGGGGCCAGATACGCAGTATTTT	CASSQDRGPDTQYF	TRBV3-1	TRBJ2-3
TGTGCCAGCAGCTTGATCCGGGTGAACACTGAAGCTTTCTTT	CASSLIRVNTEAFF	TRBV13	TRBJ1-1
TGTGCCACCAAAGCGGGAGGCCCCTATGGCTACACCTTC	CATKAGGPYGYTF	TRBV6-1	TRBJ1-2
TGTGCCAGCAGTTTAACCCAAGGACTTTACGAGCAGTACTTC	CASSLTQGLYEQYF	TRBV28	TRBJ2-7
TGTGCCAGTAGTCCATGTAGAGCCCAGCATTTT	CASSPCRAQHF	TRBV19	TRBJ1-5
TGCAGTGCTAGAGATCCCTGGGGGGGCGGACCAGATACGCAGTATTTT	CSARDPWGGGPDTQYF	TRBV20-1	TRBJ2-3
TGTGCCAGCAGCCATACCACAGATACGCAGTATTTT	CASSHTTDTQYF	TRBV11-2	TRBJ2-3
TGTGCCAGCAGTGAATTTTGGGGGCGGGAAGGAGCCTATTCTTTCTATGAGCAGTTCTTC	CASSEFWGREGAYSFYEQFF	TRBV25-1	TRBJ2-1
TGCAGTGCTCGGGGGACGGCTCGGGGCTACACCTTC	CSARGTARGYTF	TRBV20-1	TRBJ1-2
TGTGCCAGCAGTGGTTTTCTTGGACTTTTTTTGACAGATACGCAGTATTTT	CASSGFLGLFLTDTQYF	TRBV6-4	TRBJ2-3
TGTGCCAGCAAAGGGGAGAATCAGCCCCAGCATTTT	CASKGENQPQHF	TRBV6-5	TRBJ1-5
TGTGCCACCAGTGACAGCCAACGGAATCAGCCCCAGCATTTT	CATSDSQRNQPQHF	TRBV24-1	TRBJ1-5
TGTGCCAGGGTCAGGGGAGCATGGAGACATGAGCAGTTCTTC	CARVRGAWRHEQFF	TRBV28	TRBJ2-1
TGTGCCAGCAGTTACTCGGGGGGGGGCAACGAGCAGTACTTC	CASSYSGGGNEQYF	TRBV6-5	TRBJ2-7
TGTGCTAGTGGCTTTCACAGGGTGGCTAGCTCCTATAATTCACCCCTCCACTTT	CASGFHRVASSYNSPLHF	TRBV12-5	TRBJ1-6
TGTGCCACTCCACTCGGGACTAGCGGGGGGGCGTCCACAGATACGCAGTATTTT	CATPLGTSGGASTDTQYF	TRBV12-3	TRBJ2-3
TGCGCCAGCAGCAGCAAAAAGACAGGCAATCAGCCCCAGCATTTT	CASSSKKTGNQPQHF	TRBV4-3	TRBJ1-5
TGTGCCAGCAGTTACTCGGAAGACGAGAGGCCAGGGTCTGGGACCGAGCAGTACTTC	CASSYSEDERPGSGTEQYF	TRBV6-2	TRBJ2-7
TGTGCCAGAATGGACAGGGCAGGTCGAAGGGAGACCCAGTACTTC	CARMDRAGRRETQYF	TRBV10-3	TRBJ2-5
TGTGCCAGCAGCCCGTACAGGGTTCTACCTGGGGCCAACGTCCTGACTTTC	CASSPYRVLPGANVLTF	TRBV7-9	TRBJ2-6
TGTGCCAGCAGTTACTACACAGGACAGGGTTGGGCCAAAAACATTCAGTACTTC	CASSYYTGQGWAKNIQYF	TRBV6-6	TRBJ2-4
TGTGCCGTAGACGTAAAACTAGCTTTCTTT	CAVDVKLAFF	TRBV19	TRBJ1-1
TGTGCCAGCAGCGTAGGGCGACAGGGGGCTGAGGGCGTGAACGAGCAGTACTTC	CASSVGRQGAEGVNEQYF	TRBV5-4	TRBJ2-7
TGTGCCAGCGCCGGTAGCGGGGGGGCCCCAGTAGGCACCGGGGAGCTGTTTTTT	CASAGSGGAPVGTGELFF	TRBV9	TRBJ2-2
TGTGCCAGCAGCCGGCAGACAGGGACTGCTGAAGCTTTCTTT	CASSRQTGTAEAFF	TRBV3-1	TRBJ1-1
TGCCCAGGGGGGGATAATCAGCCCCAGCATTTT	CPGGDNQPQHF	TRBV19	TRBJ1-5
TGCGCCAGCAGCCAAGAGGGGGTATGTGGGGCAGATACGCAGTATTTT	CASSQEGVCGADTQYF	TRBV4-1	TRBJ2-3
TGTGCCAGCAGCCCAGTTCGGACTAGCCACACCGGGGAGCTGTTTTTT	CASSPVRTSHTGELFF	TRBV7-9	TRBJ2-2
TGTGCCATCAGACGACTAGGGGGGAGCTCCTACAATGAGCAGTTCTTC	CAIRRLGGSSYNEQFF	TRBV10-3	TRBJ2-1
TGTGCCAGCCCGACCTGCAATCAGCCCCAGCATTTT	CASPTCNQPQHF	TRBV19	TRBJ1-5
TGTGGAGGGGGGACGCAGTATTTT	CGGGTQYF	TRBV2	TRBJ2-3
TGTGCCAGCAGCTCCGGGACAGGGGCTGGGGCCAACGTCCTGACTTTC	CASSSGTGAGANVLTF	TRBV7-8	TRBJ2-6
TGCGCCAGCAGCCCCAACCCGACCCCGGGGGTAATCGAGCAGTACTTC	CASSPNPTPGVIEQYF	TRBV4-3	TRBJ2-7
TGTGCCACCAGTGGCCAGGGCGGGAGGGACAAAGCTTTCTTT	CATSGQGGRDKAFF	TRBV24-1	TRBJ1-1
TGCAGCGTTGGGGGGAGTGGGAACGAGCAGTACTTC	CSVGGSGNEQYF	TRBV29-1	TRBJ2-7
TGCGCCAGCAGCTTGAGGGACGGAACCACCGGGGAGCTGTTTTTT	CASSLRDGTTGELFF	TRBV5-1	TRBJ2-2
TGTGCCAGCAGTGGAGAACAGGGGGGAGAGACCCAGTACTTC	CASSGEQGGETQYF	TRBV25-1	TRBJ2-5
TGTGCCAGCAGCCAATGTCTATCACTGGGCCCTGGAAACACCATATATTTT	CASSQCLSLGPGNTIYF	TRBV3-1	TRBJ1-3
TGTGCCAGTAGTATATTAGGACTAGCGTTCTACGAGCAGTACTTC	CASSILGLAFYEQYF	TRBV19	TRBJ2-7
TGTGCCAGCAGCAGGGCGACAGGGTGGGGCTCCTACGAGCAGTACTTC	CASSRATGWGSYEQYF	TRBV13	TRBJ2-7
TGTGCCACGGCGGGCTACGAGCAGTACTTC	CATAGYEQYF	TRBV19	TRBJ2-7
TGTGCCAGCAGTGAATGCAAGCTGTCAGGGGAGGCCTCTGGGGCCAACGTCCTGACTTTC	CASSECKLSGEASGANVLTF	TRBV25-1	TRBJ2-6
TGCAGCGTTGACAGACGCCGAGGGAACACTGAAGCTTTCTTT	CSVDRRRGNTEAFF	TRBV29-1	TRBJ1-1
TGTGCCAGCAGTTTATTAACAGGGCACACCGGGGAGCTGTTTTTT	CASSLLTGHTGELFF	TRBV27	TRBJ2-2
TGTGCCAGTAGATATCAGGGGACCTATAATTCACCCCTCCACTTT	CASRYQGTYNSPLHF	TRBV19	TRBJ1-6
TGTGCCACCAGTGATTGGTTGACAGGGTGGACTAATGAAAAACTGTTTTTT	CATSDWLTGWTNEKLFF	TRBV24-1	TRBJ1-4
TGTGCCAGCAGCGGTCCAGCGGGCAACAATCAGCCCCAGCATTTT	CASSGPAGNNQPQHF	TRBV11-3	TRBJ1-5
TGTGCCAGCTCAGGGTGGGGCTACGAGCAGTACTTC	CASSGWGYEQYF	TRBV9	TRBJ2-7
TGTGCCAGCAGCTTAGTAGGACAGGGTGATGGCGAGCAGTACTTC	CASSLVGQGDGEQYF	TRBV13	TRBJ2-7
TGCAGTGCTGTTGGGGTACAGCCCCAGCATTTT	CSAVGVQPQHF	TRBV20-1	TRBJ1-5
TGTGCCAGCAGTGAGGGACACACCATATATTTT	CASSEGHTIYF	TRBV28	TRBJ1-3
TGTGCCACGGGCGACAGGGGGCGCTTTTTGTACACTGAAGCTTTCTTT	CATGDRGRFLYTEAFF	TRBV15	TRBJ1-1
TGTGCCAGCAGGCCAACTCCCTCCGACAGGCCTTGCCGCGGCACTGAAGCTTTCTTT	CASRPTPSDRPCRGTEAFF	TRBV4-2	TRBJ1-1
TGTGCCAGCAGTTACACCGGGGGGGTTTGGAGCAATCAGCCCCAGCATTTT	CASSYTGGVWSNQPQHF	TRBV6-3	TRBJ1-5
TGCGCCAGCACCATACAGGGCGGGGAGCTGTTTTTT	CASTIQGGELFF	TRBV10-1	TRBJ2-2
TGTGCCAGCAGCTTGGCTCTGCAAACAGGGCTTTGGTGGGTGAACACTGAAGCTTTCTTT	CASSLALQTGLWWVNTEAFF	TRBV5-4	TRBJ1-1
TGCAGCGTTGAATATTCGGGGACAGAAGAGACCCAGTACTTC	CSVEYSGTEETQYF	TRBV29-1	TRBJ2-5
TGCGCCAGCAGCTTGGAAGCAGGGGAATTCCCCGACGAGCAGTACTTC	CASSLEAGEFPDEQYF	TRBV5-1	TRBJ2-7
TGTGCTAGTGGTTTGGTACTTAAAGAAACCGGTCCGGACAGCCCGGGCGAGCAGTACTTC	CASGLVLKETGPDSPGEQYF	TRBV12-5	TRBJ2-7
TGTGCCAGCAGTTACTCGTCAAGCTCCGACAGGGGCTTTTCTGAAGCTTTCTTT	CASSYSSSSDRGFSEAFF	TRBV6-6	TRBJ1-1
TGTGCCAGCAGCTCCCCCTACCGGGGCAATGAGCAGTTCTTC	CASSSPYRGNEQFF	TRBV7-3	TRBJ2-1
TGTGCCAGCAGGAAATACACTAAATCCTACGAGCAGTACTTC	CASRKYTKSYEQYF	TRBV27	TRBJ2-7
TGTGCCAGCAGCTTGGGCGGGAGCTCCTACAATGAGCAGTTCTTC	CASSLGGSSYNEQFF	TRBV5-4	TRBJ2-1
TGTGCCAGCAGCCGTACTTATTGGACCGGGGAGCTGTTTTTT	CASSRTYWTGELFF	TRBV7-4	TRBJ2-2
TGCGCCAGCAGCCAAGCCCGGGGGGGGCGGGGGGAATCCACTGAAGCTTTCTTT	CASSQARGGRGESTEAFF	TRBV4-3	TRBJ1-1
TGCGCCAGCAGCTTGGTGCCGGGACAGAAAACCCACAATCAGCCCCAGCATTTT	CASSLVPGQKTHNQPQHF	TRBV5-1	TRBJ1-5
TGTGCCTGGAAGGACGGGACTAGCGGGTCCTACGAGCAGTACTTC	CAWKDGTSGSYEQYF	TRBV30	TRBJ2-7
TGTGCCAGCTCTGGTTCCGGGACTAGCGGGAGGTCCTACGAGCAGTACTTC	CASSGSGTSGRSYEQYF	TRBV2	TRBJ2-7
TGTGCCATCAGTGAGTGGGTCTTACAGCGGGAAAACTATGGCTACACCTTC	CAISEWVLQRENYGYTF	TRBV10-3	TRBJ1-2
TGCAGTGCTCCGGACCCCTCTGAAGCTTTCTTT	CSAPDPSEAFF	TRBV20-1	TRBJ1-1
TGTGCCAGCGATTTGCCCGGAACTGAAGCTTTCTTT	CASDLPGTEAFF	TRBV7-2	TRBJ1-1
TGTGCCAGCAGCGTAGACCTACTGGACAGGGAAAACTACGAGCAGTACTTC	CASSVDLLDRENYEQYF	TRBV9	TRBJ2-7
TGTGCCAGCCCGGGACAGGGGAGGGAAGACTATGGCTACACCTTC	CASPGQGREDYGYTF	TRBV6-2	TRBJ1-2
TGTGCCAGCCCGCGGGAGAACTACGAGCAGTACTTC	CASPRENYEQYF	TRBV6-1	TRBJ2-7
TGTGCCAGCAGTGTGCCCCTATTACGGCAACCCCGACAGGGGTCTCAGCCCCAGCATTTT	CASSVPLLRQPRQGSQPQHF	TRBV6-1	TRBJ1-5
TGTGCCAGCTCAAGGGCCTATCAGTACTTC	CASSRAYQYF	TRBV18	TRBJ2-5
TGTGCCAGCAGTCCGACAATCCCCAGGGGTTACGAGCAGTACTTC	CASSPTIPRGYEQYF	TRBV6-3	TRBJ2-7
TGCAGTGCTAGAGGCTGTCCAAACACTGAAGCTTTCTTT	CSARGCPNTEAFF	TRBV20-1	TRBJ1-1
TGTGCCAGCAGTTTACAGGGGGGGAGAGCCAAAAACATTCAGTACTTC	CASSLQGGRAKNIQYF	TRBV6-5	TRBJ2-4
TGTGCCAGCAGTTGGAAGGGACAGGGGTTGGGGGCTTTCTTT	CASSWKGQGLGAFF	TRBV27	TRBJ1-1
TGCAGCGTCCTAGGCCGGGACATCTGCCCCTACGAGCAGTACTTC	CSVLGRDICPYEQYF	TRBV29-1	TRBJ2-7
TGTGCCAGCAGTGACGGCCTGAAGAATAAACACACCGGGGAGCTGTTTTTT	CASSDGLKNKHTGELFF	TRBV6-4	TRBJ2-2
TGTGCCAGCAGTCGCCGGGACAGGGGGAACACCGGGGAGCTGTTTTTT	CASSRRDRGNTGELFF	TRBV27	TRBJ2-2
TGTGCCAGCTCACCACTCGGCTGGAACACTGAAGCTTTCTTT	CASSPLGWNTEAFF	TRBV18	TRBJ1-1
TGTGCCAGCACTCCGGGACTAGCGGGAGGAGAGCAGTACTTC	CASTPGLAGGEQYF	TRBV27	TRBJ2-7
TGCGCCAGCAGCGACCCAACCCTTAGTAACAATGAGCAGTTCTTC	CASSDPTLSNNEQFF	TRBV5-1	TRBJ2-1
TGCAGCGTAGAATACAGGAACGAGCAGTACTTC	CSVEYRNEQYF	TRBV29-1	TRBJ2-7
TGTGCCACCAGTGAAACTAACAGGGGAGGGGCCCAGCATTTT	CATSETNRGGAQHF	TRBV24-1	TRBJ1-5
TGCGCCAGCTTCTTGGGGGGTTGGGGCACCTTC	CASFLGGWGTF	TRBV5-1	TRBJ1-2
TGTGCCAGCAGCCAAGGGCTAGTTCGCACAGATACGCAGTATTTT	CASSQGLVRTDTQYF	TRBV3-1	TRBJ2-3
TGTGCCACCAGTGTACGAAGTTGGGGACAGGGGGCGGGCTATGGCTACACCTTC	CATSVRSWGQGAGYGYTF	TRBV24-1	TRBJ1-2
TGTGCCAGCAGTTACCAGGCGGGGGGATTAGTGGTCGGGGCCAACGTCCTGACTTTC	CASSYQAGGLVVGANVLTF	TRBV6-2	TRBJ2-6
TGCAGTGCTAGGCACAGGGACTATGGCTACACCTTC	CSARHRDYGYTF	TRBV20-1	TRBJ1-2
TGTGCCAGCAGCTCACCCTACGAGCAGTACTTC	CASSSPYEQYF	TRBV5-6	TRBJ2-7
TGTGCTGTCGCCTACGAGCAGTACTTC	CAVAYEQYF	TRBV6-2	TRBJ2-7
TGTGCCAGCAGCTTAGCTGGGGGATTTTTCTACACTGAAGCTTTCTTT	CASSLAGGFFYTEAFF	TRBV7-9	TRBJ1-1
TGCGCCAGCAGTGGGGGGGGGGGATATTGTAGAGCTAACTCTGGAAACACCATATATTTT	CASSGGGGYCRANSGNTIYF	TRBV10-2	TRBJ1-3
TGTGCCACCAGTGATTTGCCCGTCAGGGATGAGCAGTTCTTC	CATSDLPVRDEQFF	TRBV24-1	TRBJ2-1
TGTGCTAGTGGTGACAGGCCTGTAAGGTCTGGGGCCAACGTCCTGACTTTC	CASGDRPVRSGANVLTF	TRBV12-5	TRBJ2-6
TGTGCCAGCAGCTTCACAGGGGGACGCGGGGAGCTGTTTTTT	CASSFTGGRGELFF	TRBV7-2	TRBJ2-2
TGTGCCAGCAGTTTACAAGGTACGCTACAGGGAGACACAGATACGCAGTATTTT	CASSLQGTLQGDTDTQYF	TRBV28	TRBJ2-3
TGTGCCAGCAGCTCCGCCGGGGCGAGATCCGACAATGAGCAGTTCTTC	CASSSAGARSDNEQFF	TRBV11-2	TRBJ2-1
TGCAGCAGACAGGGCTGGGGCTACACCTTC	CSRQGWGYTF	TRBV29-1	TRBJ1-2
TGTGCCAGCAGTGAATACAAAGGGACTGTTGGCTACACCTTC	CASSEYKGTVGYTF	TRBV25-1	TRBJ1-2
TGTGCCAGCAGCCACTACGACAGGGCAGGCACAGATACGCAGTATTTT	CASSHYDRAGTDTQYF	TRBV13	TRBJ2-3
TGCGCCAGCAGCCACCGACAGGGCCTTCCAGAGGAAAAACTGTTTTTT	CASSHRQGLPEEKLFF	TRBV4-3	TRBJ1-4
TGTGCCAGCAGCCCTAGGTCCATCAAGGCCTATCCCTCCTACGAGCAGTACTTC	CASSPRSIKAYPSYEQYF	TRBV9	TRBJ2-7
TGTGCCACCACAGGGTCCTATGGCTACACCTTC	CATTGSYGYTF	TRBV24-1	TRBJ1-2
TGTGCCGGTGGAGGGCCTTACGAACAAGAGACCCAGTACTTC	CAGGGPYEQETQYF	TRBV5-5	TRBJ2-5
TGTGCCAGCAGCCGGCGGGGCGGAAACACCATATATTTT	CASSRRGGNTIYF	TRBV13	TRBJ1-3
TGTGCCTGGAGTCCCGGACAGGGAAGTAAGTATAGCAATCAGCCCCAGCATTTT	CAWSPGQGSKYSNQPQHF	TRBV30	TRBJ1-5
TGTGCCAGCAGCCAATTGCAGCGGGAGGAGTTGCAGTTCTTC	CASSQLQREELQFF	TRBV3-1	TRBJ2-1
TGTGCCAGCGCCTGGGGTAACACGGCCGGGGAGCTGTTTTTT	CASAWGNTAGELFF	TRBV6-3	TRBJ2-2
TGTGCCAGCAGCTTCGAAGGACAGGGAAGGAGGACAGATACGCAGTATTTT	CASSFEGQGRRTDTQYF	TRBV5-5	TRBJ2-3
TGTGCCAGCAGTCGTGGACAGGGGGCGAATCCGAACCAAGAGACCCAGTACTTC	CASSRGQGANPNQETQYF	TRBV6-1	TRBJ2-5
TGTGCCAGCAGCCGGAGGAACACTGAAGCTTTCTTT	CASSRRNTEAFF	TRBV11-2	TRBJ1-1
TGCAGTGCTTCTCGGACGTCAGGGGGCTCTACCTCTGGAAACACCATATATTTT	CSASRTSGGSTSGNTIYF	TRBV20-1	TRBJ1-3
TGTGCCAGCAGCAAGGGACAGCTCACCTACTATGGCTACACCTTC	CASSKGQLTYYGYTF	TRBV9	TRBJ1-2
TGCGCCAGCAGCACCATCCCCAGCAAGCATAATGAAAAACTGTTTTTT	CASSTIPSKHNEKLFF	TRBV4-1	TRBJ1-4
TGTGCCAGCCCCCACAGGGACGAGCAGTACTTC	CASPHRDEQYF	TRBV7-9	TRBJ2-7
TGCGCCAGCAGCCAGTGGGACAGCTACGAGCAGTACTTC	CASSQWDSYEQYF	TRBV4-1	TRBJ2-7
TGTGCCAGCAGCGTACCAACAGGGGTCACCGGGGAGCTGTTTTTT	CASSVPTGVTGELFF	TRBV9	TRBJ2-2
TGCGCCAGCAGCCAAGTTGGACCGGCCGGGGAGCTGTTTTTT	CASSQVGPAGELFF	TRBV4-1	TRBJ2-2
TGTGCCACCATTGATTCGGCCGGAACTGACAGCTCCTACAATGAGCAGTTCTTC	CATIDSAGTDSSYNEQFF	TRBV24-1	TRBJ2-1
TGCGCCAGCAGACAGGGGGCTGGCCAGCATTTT	CASRQGAGQHF	TRBV10-1	TRBJ1-5
TGCGCCAGAAAGGCCGTCTACGAGCAGTACTTC	CARKAVYEQYF	TRBV5-1	TRBJ2-7
TGTGCCACCAGTGATTTAGACACCCAGGGCGAAAGTGAAAAACTGTTTTTT	CATSDLDTQGESEKLFF	TRBV24-1	TRBJ1-4
TGTGCCTGGGAAGGCCTCGGGGACTCCTACGAGCAGTACTTC	CAWEGLGDSYEQYF	TRBV30	TRBJ2-7
TGTAGTAGGGATCAGCCCCAGCATTTT	CSRDQPQHF	TRBV7-9	TRBJ1-5
TGTGCCAGCAGCCAAGTACGGAGCGCCCCGATATATAGCAATCAGCCCCAGCATTTT	CASSQVRSAPIYSNQPQHF	TRBV14	TRBJ1-5
TGCGCCAGCAGCCAACGGCAACCAGGGTGCCAAGAGACCCAGTACTTC	CASSQRQPGCQETQYF	TRBV4-3	TRBJ2-5
TGTGCCAGCAGTACGCTCGGACACAATGAGCAGTTCTTC	CASSTLGHNEQFF	TRBV28	TRBJ2-1
TGTGCCACCCCAGTAGGCCAGTACTTC	CATPVGQYF	TRBV6-5	TRBJ2-7
TGTGCCAGCAGTGAAAGTATAAATCCCGGCCTCTCTCGTAACATTCAGTACTTC	CASSESINPGLSRNIQYF	TRBV6-4	TRBJ2-4
TGCGCCAGCAGCCAAGATCCTCCAGCCCAGCATTTT	CASSQDPPAQHF	TRBV4-1	TRBJ1-5
TGTGCCAGCAGTGAGGAACCGGGGGCGAGCCAGCCCCAGCATTTT	CASSEEPGASQPQHF	TRBV6-4	TRBJ1-5
TGTGCCAGCGCCTATTGGGACTATCCGGGAAACACCATATATTTT	CASAYWDYPGNTIYF	TRBV5-6	TRBJ1-3
TGTGCCAGCAGTGGTAGCAGGGGGAGAGCTTTCTTT	CASSGSRGRAFF	TRBV6-4	TRBJ1-1
TGTGCCAGCAGCCTTTTATCCCACAGGGGCTTGGGCAATCAGCCCCAGCATTTT	CASSLLSHRGLGNQPQHF	TRBV5-6	TRBJ1-5
TGCGCCAGCAGGGGCCGTCGCCGGATGGCCGAGCAGTACTTC	CASRGRRRMAEQYF	TRBV4-3	TRBJ2-7
TGCGCCACAGTGACAGGTAATGAAAAACTGTTTTTT	CATVTGNEKLFF	TRBV5-1	TRBJ1-4
TGTGCCAGCAGCCAAAAAGGTTTCAGGGACTCTTGGAACACTGAAGCTTTCTTT	CASSQKGFRDSWNTEAFF	TRBV14	TRBJ1-1
TGTGCCAGCAGGAGAGGGGAGGGGGAAAAACTGTTTTTT	CASRRGEGEKLFF	TRBV6-1	TRBJ1-4
TGCGCCAGCAGCGTAAGGGGGCCTAACTATGGCTACACCTTC	CASSVRGPNYGYTF	TRBV5-1	TRBJ1-2
TGTGCCATCGCGGACAGGGATGAAAAACTGTTTTTT	CAIADRDEKLFF	TRBV24-1	TRBJ1-4
TGTGCCAGCAGTTTACTAAAAATGGGGGTCACAGCCCTAGGGGAAGAGACCCAGTACTTC	CASSLLKMGVTALGEETQYF	TRBV12-3	TRBJ2-5
TGTGCCAAGACTGGGGGGACTGGACGCGACGAGCAGTACTTC	CAKTGGTGRDEQYF	TRBV27	TRBJ2-7
TGTGCCAGCAGTCCCGGGACAGAAGAGAGTTGCTCTGGGGCCAACGTCCTGACTTTC	CASSPGTEESCSGANVLTF	TRBV25-1	TRBJ2-6
TGTGCCAGCACACGTAGCGGGACGGATTGGGGCTCCTACAATGAGCAGTTCTTC	CASTRSGTDWGSYNEQFF	TRBV2	TRBJ2-1
TGCAGCGTTGAATTCGGTATCGAACGCACAGATACGCAGTATTTT	CSVEFGIERTDTQYF	TRBV29-1	TRBJ2-3
TGTGCCAGCAGCCCGGGACGCCGCACCGGCTACACCTTC	CASSPGRRTGYTF	TRBV2	TRBJ1-2
TGTGCCAGCTCACCAGAGAGGGACGAATGTGAAGCTTTCTTT	CASSPERDECEAFF	TRBV18	TRBJ1-1
TGCGCCAGCAGCCACGTCGCTGGAAACACCATATATTTT	CASSHVAGNTIYF	TRBV4-1	TRBJ1-3
TGTGCCAGCAGCCAACTGGGGGGTCGCAGGCAAGAGACCCAGTACTTC	CASSQLGGRRQETQYF	TRBV4-2	TRBJ2-5
TGTGCCACCAGTGATTTCAGTGACAGTGGGGCACCCCTCCACTTT	CATSDFSDSGAPLHF	TRBV24-1	TRBJ1-6
TGTGCCAGCAGTGAGACGACCCCGATCTGGGGCCTCTCCTACAATGAGCAGTTCTTC	CASSETTPIWGLSYNEQFF	TRBV6-4	TRBJ2-1
TGTGCCACCAGTGATTTGTCTCTTTGGGGGCCGTATTGCTACAATGAGCAGTTCTTC	CATSDLSLWGPYCYNEQFF	TRBV24-1	TRBJ2-1
TGTGCCAGCAGCCAAGATCCCCGACAGGGGGGTACTAATGAAAAACTGTTTTTT	CASSQDPRQGGTNEKLFF	TRBV14	TRBJ1-4
TGTGCCTGGAGTGTAACCAGGGATTTTCAGCCCCAGCATTTT	CAWSVTRDFQPQHF	TRBV30	TRBJ1-5
TGTGCCAGCAGTGACCTCGGACTATGCTACAATGAGCAGTTCTTC	CASSDLGLCYNEQFF	TRBV25-1	TRBJ2-1
TGTGCCAGCAGCCACCGGGGTAGAAAGACAGGGTCATACAATGAGCAGTTCTTC	CASSHRGRKTGSYNEQFF	TRBV14	TRBJ2-1
TGTGCCACCAGTCGGAAGACAGGGGGCATTCCCTGGAAAAACATTCAGTACTTC	CATSRKTGGIPWKNIQYF	TRBV24-1	TRBJ2-4
TGTGCCAGCGCTAGGCCTCCTGGCTACACCTTC	CASARPPGYTF	TRBV28	TRBJ1-2
TGTGCCAGCAGCCCCTGGACAGGGACTAAGGAGACCCAGTACTTC	CASSPWTGTKETQYF	TRBV13	TRBJ2-5
TGCAGTGCCCGGACCGGGACTAGCGGGGGGGCAACCCTCTCCTACAATGAGCAGTTCTTC	CSARTGTSGGATLSYNEQFF	TRBV20-1	TRBJ2-1
TGTGCCAGCAGCCCCCGAACAGGGCCGACCGGGGAGCTGTTTTTT	CASSPRTGPTGELFF	TRBV12-3	TRBJ2-2
TGTGCCACATGTCGGGACAGGGGGCGTGAAGCTTTCTTT	CATCRDRGREAFF	TRBV14	TRBJ1-1
TGTGCCAGCAGCCAAGTTTCGAAGGCCAGCTCCTACGAGCAGTACTTC	CASSQVSKASSYEQYF	TRBV3-1	TRBJ2-7
TGTGCCAGCAGCTTGAACAGGGGGCGGTGGTCCGAAGGGTCCTACAATGAGCAGTTCTTC	CASSLNRGRWSEGSYNEQFF	TRBV11-3	TRBJ2-1
TGTGCCAGCAGCGGAAACACTAGCGGGGAAGGTCCTGGGGCCAACGTCCTGACTTTC	CASSGNTSGEGPGANVLTF	TRBV9	TRBJ2-6
TGTGCCAGCAGCAAAGACGATCCTGAAGCTTTCTTT	CASSKDDPEAFF	TRBV13	TRBJ1-1
TGTGCCAGCAGCCCATTTACAGGGGGCGCGGGACGCCCCCAGCCCCAGCATTTT	CASSPFTGGAGRPQPQHF	TRBV13	TRBJ1-5
TGTGCCAGCACCGCGCGGGGGGGGTCCTACGAGCAGTACTTC	CASTARGGSYEQYF	TRBV28	TRBJ2-7
TGTGCCAGCAGCCAGGGAGGGTGTTCACCCCTCCACTTT	CASSQGGCSPLHF	TRBV14	TRBJ1-6
TGTGCCAGCAGTGGAGAGCGGGGCTACGAGCAGTACTTC	CASSGERGYEQYF	TRBV6-1	TRBJ2-7
TGCAGTGCTAGAGATCAACTGGGGGGAAAGAGCAATGAGCAGTTCTTC	CSARDQLGGKSNEQFF	TRBV20-1	TRBJ2-1
TGTGCCAGCAGCCAACCTAGGGACAGCGATTATGTTAACACCGGGGAGCTGTTTTTT	CASSQPRDSDYVNTGELFF	TRBV14	TRBJ2-2
TGTGCCAGCAGCGACAGACAGGCCTTGAGCTCCTACGAGCAGTACTTC	CASSDRQALSSYEQYF	TRBV5-6	TRBJ2-7
TGCAGTAAAACGCAGACTAGCCGCTACGAGCAGTACTTC	CSKTQTSRYEQYF	TRBV20-1	TRBJ2-7
TGTGCCAGCAGTGGACTGAACACTGAAGCTTTCTTT	CASSGLNTEAFF	TRBV6-5	TRBJ1-1
TGTGCCATCAGTGAGGACATAGGATACATGCACCCGGTGCGAGTATTAGGAGAGACCCAGTACTTC	CAISEDIGYMHPVRVLGETQYF	TRBV10-3	TRBJ2-5
TGTGCCACCGGGGGGACCGCGGGAGCAGCTGAAGCTTTCTTT	CATGGTAGAAEAFF	TRBV7-9	TRBJ1-1
TGTGCCATCAGTGAGGGTGGACCGGGGCACCGTTGGCATGGTGCTCGGGGCTACACCTTC	CAISEGGPGHRWHGARGYTF	TRBV10-3	TRBJ1-2
TGTGCCAGCAGGTCAGACAGCCCTAATTCACCCCTCCACTTT	CASRSDSPNSPLHF	TRBV12-3	TRBJ1-6
TGCAGTGCTAGAAGATCTAGCGGGGGGGCCAGCTCTGGGGCCAACGTCCTGACTTTC	CSARRSSGGASSGANVLTF	TRBV20-1	TRBJ2-6
TGTGCCAGCAGTTACGAGGGTAAGATACCCACAGATACGCAGTATTTT	CASSYEGKIPTDTQYF	TRBV6-2	TRBJ2-3
TGCGCCAGCAGTGAGGGGGGAAGAGACACAGATACGCAGTATTTT	CASSEGGRDTDTQYF	TRBV10-1	TRBJ2-3
TGCGCCAGCAGCTCCGGGACAGAGAAGGTTCAAGAGACCCAGTACTTC	CASSSGTEKVQETQYF	TRBV5-1	TRBJ2-5
TGTGCCAGCAGCCGGGGGAGCAAATACGAGCAGTACTTC	CASSRGSKYEQYF	TRBV7-3	TRBJ2-7
TGCAGTGCTAGCACGCGGGTAAGCAATGAGCAGTTCTTC	CSASTRVSNEQFF	TRBV20-1	TRBJ2-1
TGCAGTGCTACTGTGGTCAGGGAGCAGACTGAAGCTTTCTTT	CSATVVREQTEAFF	TRBV20-1	TRBJ1-1
TGTGCCAGCACGACTCTTCCGGGACAGGGGGCACTGACCTATGGCTACACCTTC	CASTTLPGQGALTYGYTF	TRBV6-1	TRBJ1-2
TGTGCCACGACGGGAGGAGATAACTATGGCTACACCTTC	CATTGGDNYGYTF	TRBV6-5	TRBJ1-2
TGCGCCAGCAAAGACAGGGCGTCTTTTCAAAGGCCTAATGAAAAACTGTTTTTT	CASKDRASFQRPNEKLFF	TRBV5-1	TRBJ1-4
TGTGCCAGCAGCCACAGGGAAGAGACCCAGTACTTC	CASSHREETQYF	TRBV7-4	TRBJ2-5
TGTGCCAGCAGTCCGACGTCGGGGTACTACGAGCAGTACTTC	CASSPTSGYYEQYF	TRBV28	TRBJ2-7
TGTGCCAGCAGTGTGGGGGGGCCTAGGGAAGAGACCCAGTACTTC	CASSVGGPREETQYF	TRBV12-4	TRBJ2-5
TGTGCCAGCAGTGTGGTGGGACAGGGTATTTATAGCAATCAGCCCCAGCATTTT	CASSVVGQGIYSNQPQHF	TRBV12-3	TRBJ1-5
TGCAGTGCTAGAGAGGACGTCGGACTGAGGCGAAACACCGGGGAGCTGTTTTTT	CSAREDVGLRRNTGELFF	TRBV20-1	TRBJ2-2
TGTGCCAGCAGTTTACTACCACGGGACTGGGGCGAGCAGTTCTTC	CASSLLPRDWGEQFF	TRBV27	TRBJ2-1
TGTCCCTTCAGGAATCCGGGACGTAGGGACTACGAGCAGTACTTC	CPFRNPGRRDYEQYF	TRBV30	TRBJ2-7
TGTGCCAGCAGTTACCTCCCGGAAATTAGTCGCGCCAAAAACATTCAGTACTTC	CASSYLPEISRAKNIQYF	TRBV6-3	TRBJ2-4
TGTGCCAGCAGCGAAGCGGGAGAGGACAATGAGCAGTTCTTC	CASSEAGEDNEQFF	TRBV5-6	TRBJ2-1
TGTGCCAGCAGTTGCAGGGGGGACCCCTACGAGCAGTACTTC	CASSCRGDPYEQYF	TRBV6-9	TRBJ2-7
TGTGCCAGCAGCACAGCTTTCTTT	CASSTAFF	TRBV11-2	TRBJ1-1
TGTGCCAGTAGTATAGATCCTCAGGGCATCTCCTACGAGCAGTACTTC	CASSIDPQGISYEQYF	TRBV19	TRBJ2-7
TGTGCCAGGGAGAGAGGGGGCAACACTGAAGCTTTCTTT	CARERGGNTEAFF	TRBV19	TRBJ1-1
TGTGCCAGCTCACCCCCCCTTACAGGGGGCGGCTATGGCTACACCTTC	CASSPPLTGGGYGYTF	TRBV18	TRBJ1-2
TGTGCCAGCAGCTTAGGCCCCGGGGTAGGTGGTACTGAAGCTTTCTTT	CASSLGPGVGGTEAFF	TRBV7-9	TRBJ1-1
TGTGCCAGCAGCTTATTAAATCCCCTCGGACAGGGGGCGGGAGCTGAAGCTTTCTTT	CASSLLNPLGQGAGAEAFF	TRBV7-9	TRBJ1-1
TGTGCCAGCAGCGTAGGATCCGGGACGGTTAAGACCCAGTACTTC	CASSVGSGTVKTQYF	TRBV9	TRBJ2-5
TGTGCCAGCAGAGTAAGGGACAGCACTCAGCCCCAGCATTTT	CASRVRDSTQPQHF	TRBV12-4	TRBJ1-5
TGCAGTGCTAGAGATATGGGGGCGCGGGGGATTGGTCAGTCGGCCTATGGCTACACCTTC	CSARDMGARGIGQSAYGYTF	TRBV20-1	TRBJ1-2
TGTGCCAGCAAAGTTAGGGGTGGCGGGTATGGCTACACCTTC	CASKVRGGGYGYTF	TRBV6-4	TRBJ1-2
TGTGCTAGTGGTTTGGTACTCTTCGAGAGCAGGGGCACAGATACGCAGTATTTT	CASGLVLFESRGTDTQYF	TRBV12-5	TRBJ2-3
TGCAGTGCCGTCTCGACCCCCTACCGGAACACTGAAGCTTTCTTT	CSAVSTPYRNTEAFF	TRBV20-1	TRBJ1-1
TGCAGCGTTGAGAACGCCCAAGGGCCTGGTTCACCCCTCCACTTT	CSVENAQGPGSPLHF	TRBV29-1	TRBJ1-6
TGTGCCAGCAGCCCCCAGGGGGATGAAAAACTGTTTTTT	CASSPQGDEKLFF	TRBV7-2	TRBJ1-4
TGTGCCAGCAGTTACTGTGAGACTTGCGGGTACTACGAGCAGTACTTC	CASSYCETCGYYEQYF	TRBV6-6	TRBJ2-7
TGTGCCAGCAGCCTCCGGGGGACCTTTGCAGAGACCCAGTACTTC	CASSLRGTFAETQYF	TRBV9	TRBJ2-5
TGCGCCAGCAGCTTCCGCAGCCGGGACTGTGATACGCAGTATTTT	CASSFRSRDCDTQYF	TRBV5-1	TRBJ2-3
TGCAGTGCTAGAGATCAGGGCGGGAACGGCTCCTACAATGAGCAGTTCTTC	CSARDQGGNGSYNEQFF	TRBV20-1	TRBJ2-1
TGTGCCAGCAGCCAAGATCGGGGAAGAAATGAGCAGTTCTTC	CASSQDRGRNEQFF	TRBV3-1	TRBJ2-1
TGTGCCAGCAGCCAAACTGCTAAGGGGGCGGTCGACTCAGTACTTTACGAGCAGTACTTC	CASSQTAKGAVDSVLYEQYF	TRBV7-4	TRBJ2-7
TGCGCCAGCAGCAACAGGGAGCAGCCAGATACGCAGTATTTT	CASSNREQPDTQYF	TRBV10-1	TRBJ2-3
TGTGCCAGCAGTTGTCCCCCCCAAACTTATTACAATGAGCAGTTCTTC	CASSCPPQTYYNEQFF	TRBV27	TRBJ2-1
TGTGCCAGCAGCGCCAAGCAGCGGGGCGCCTCCGGCGGGGAGCTGTTTTTT	CASSAKQRGASGGELFF	TRBV9	TRBJ2-2
TGTGCCAGCAGCGGGACAGGTCGAAAAACCTACAATGAGCAGTTCTTC	CASSGTGRKTYNEQFF	TRBV13	TRBJ2-1
TGTGCCAGCAGCGAACCATTTAATGAAAAACTGTTTTTT	CASSEPFNEKLFF	TRBV9	TRBJ1-4
TGTGCCAGCAGCTTAGGCGGACAGCGACTTCGGGTGAACACTGAAGCTTTCTTT	CASSLGGQRLRVNTEAFF	TRBV7-2	TRBJ1-1
TGTGCCAGCAGCTTGCCTCGGCCAGGCAATCAGCCCCAGCATTTT	CASSLPRPGNQPQHF	TRBV5-6	TRBJ1-5
TGTGCCAGCAGCTTAAGTACCGACAGGGGGCGTCCCTATGGCTACACCTTC	CASSLSTDRGRPYGYTF	TRBV7-3	TRBJ1-2
TGCACGGCGGGCTACGAGCAGTACTTC	CTAGYEQYF	TRBV20-1	TRBJ2-7
TGCGCCAGCAGCGTCCACTTTTCAGAAAGCAATCAGCCCCAGCATTTT	CASSVHFSESNQPQHF	TRBV5-1	TRBJ1-5
TGTGCCCGGGAGGGCAAGGAATGTGAAGCTTTCTTT	CAREGKECEAFF	TRBV3-1	TRBJ1-1
TGTAGGGGGACAGAGGGGAACACCGGGGAGCTGTTTTTT	CRGTEGNTGELFF	TRBV7-9	TRBJ2-2
TGTGCCAGCAGTAGCCCAAGGTCCTACGAGCAGTACTTC	CASSSPRSYEQYF	TRBV27	TRBJ2-7
TGTGCCAGCAGCTTAGGCGGGTCTCGGAATTACGAGCAGTACTTC	CASSLGGSRNYEQYF	TRBV7-9	TRBJ2-7
TGCGCCAGCAGAGGCGGACTAGGCCGTGAGCAGTTCTTC	CASRGGLGREQFF	TRBV4-1	TRBJ2-1
TGTGCTAGTGGTTTGTTCTTTAAGATTAACGAGCAGTACTTC	CASGLFFKINEQYF	TRBV12-5	TRBJ2-7
TGTGCCAGCAGAGGTCCTAGGGGAGCTTTCTTT	CASRGPRGAFF	TRBV6-4	TRBJ1-1
TGCAGCGTGAGCGGCCTAATAAGATTACTCTGTTTCACTGAAGCTTTCTTT	CSVSGLIRLLCFTEAFF	TRBV29-1	TRBJ1-1
TGTGCCATCAGTGAGATATGGGGAGGATTCTACAATGAGCAGTTCTTC	CAISEIWGGFYNEQFF	TRBV10-3	TRBJ2-1
TGTGCCAGTAGTTTTGTCCCGGGGGGGTTGAGCACAGATACGCAGTATTTT	CASSFVPGGLSTDTQYF	TRBV19	TRBJ2-3
TGTGCCAGCAGCATTTGCACCAGGGCCGAAAACTCCTATAATTCACCCCTCCACTTT	CASSICTRAENSYNSPLHF	TRBV11-1	TRBJ1-6
TGTGCCAGCAGCCGGTTTGACAGGGGTCGAGGGGCCGACAACACCGGGGAGCTGTTTTTT	CASSRFDRGRGADNTGELFF	TRBV7-3	TRBJ2-2
TGTGCCAGCAGCTGTTTCCAGAGCAATCAGCCCCAGCATTTT	CASSCFQSNQPQHF	TRBV7-2	TRBJ1-5
TGTGCCAGCAGTCCCCGGACGAGTCAGCCCCAGCATTTT	CASSPRTSQPQHF	TRBV27	TRBJ1-5
TGTGCCAGCTGGGGCACCGGGGAGCTGTTTTTT	CASWGTGELFF	TRBV2	TRBJ2-2
TGTGCCAGCAGCTTAGCGAGTAGGAGGGGTCAGCCCCAGCATTTT	CASSLASRRGQPQHF	TRBV7-4	TRBJ1-5
TGTGCCAGCAGCCTAGCGCTGGAGCAGTTCTTC	CASSLALEQFF	TRBV7-3	TRBJ2-1
TGTGCCAGCAGAGTTGGTTTGGGGGGGGCAGTTGGGTCCTGGGGCTCCTACAATGAGCAGTTCTTC	CASRVGLGGAVGSWGSYNEQFF	TRBV6-4	TRBJ2-1
TGTGCCAGCAGTCCCCGGATCTGGACAGGGAGTTATGAGCAGTTCTTC	CASSPRIWTGSYEQFF	TRBV27	TRBJ2-1
TGCGCCAGCAGCGTTCGAGGGGGGTCGAACACCGGGGAGCTGTTTTTT	CASSVRGGSNTGELFF	TRBV5-1	TRBJ2-2
TGCGCCAGCAGCCCCGGGTCGACAGGGGGGAATCGGCCTGGCTACACCTTC	CASSPGSTGGNRPGYTF	TRBV5-1	TRBJ1-2
TGTGCCAGCAGCGTAGCGGACAGACACTATGGCTACACCTTC	CASSVADRHYGYTF	TRBV9	TRBJ1-2
TGTGCCAGTGTCCCCAGAACGCGGTACCGCTGGACCCAGTACTTC	CASVPRTRYRWTQYF	TRBV7-3	TRBJ2-5
TGCGCCAGAAACGAGGACAGGGCAGTGAACACTGAAGCTTTCTTT	CARNEDRAVNTEAFF	TRBV10-1	TRBJ1-1
TGTGCCAGCAGCGTAGACCCCCGCGCGGACAGGGGGCCCCATGAGCAGTTCTTC	CASSVDPRADRGPHEQFF	TRBV9	TRBJ2-1
TGTGCCACACCCCATTACAGGGGGCCCGAGACCCAGTACTTC	CATPHYRGPETQYF	TRBV24-1	TRBJ2-5
TGTGCCTGGAGTGTACGTCCTAGTCCCCGGGGGGACTATGGCTACACCTTC	CAWSVRPSPRGDYGYTF	TRBV30	TRBJ1-2
TGCGCCAGCAGTGAGTTAGCCCTAGCGGGGAGTTTCTCAGATACGCAGTATTTT	CASSELALAGSFSDTQYF	TRBV10-1	TRBJ2-3
TGTGCCAATTGGACAGGGTATGGGGGCGCCTACGAGCAGTACTTC	CANWTGYGGAYEQYF	TRBV7-7	TRBJ2-7
TGCGCCAGCAGCTTGCGGGGGGGCCGGGACACCGGGGAGCTGTTTTTT	CASSLRGGRDTGELFF	TRBV5-1	TRBJ2-2
TGTGCCAGCAGCGCAGGGCTTGGGAACACTGAAGCTTTCTTT	CASSAGLGNTEAFF	TRBV9	TRBJ1-1
TGCGCCAGCAGCTTGGTAAATTCCACATTTTTATACGAGCAGTACTTC	CASSLVNSTFLYEQYF	TRBV5-1	TRBJ2-7
TGTGCCAGCAGCGTAGAACCTTACAGGGACGGGAGGTGGGGTCAGCCCCAGCATTTT	CASSVEPYRDGRWGQPQHF	TRBV9	TRBJ1-5
TGTGCCATCCGGGGGTCTGAAGCTTTCTTT	CAIRGSEAFF	TRBV19	TRBJ1-1
TGTGCCAGCAGTGAGTTGACGCCACAGGGGCCGGGAAATTCACCCCTCCACTTT	CASSELTPQGPGNSPLHF	TRBV2	TRBJ1-6
TGTGCCAGCAGTTCTAGCGGGAGCACAGATACGCAGTATTTT	CASSSSGSTDTQYF	TRBV6-1	TRBJ2-3
TGTGCCAGCAGCCCAGGCGACGGACTTTTAATGAACATTCAGTACTTC	CASSPGDGLLMNIQYF	TRBV7-9	TRBJ2-4
TGTGCCCCATGCCTACTAAACGGGGAGCTGTTTTTT	CAPCLLNGELFF	TRBV28	TRBJ2-2
TGTGCCACCAGTGATTTGCTCATCCACACCGGGACAGGGAGTTGCTATGGCTACACCTTC	CATSDLLIHTGTGSCYGYTF	TRBV24-1	TRBJ1-2
TGTGCCAGCAGTGAGGTGGGGGAGCATGAGGCGGGCTACACCTTC	CASSEVGEHEAGYTF	TRBV25-1	TRBJ1-2
TGTGCCAGCTCACCAAAGGAACCCGGCCCTTTCGGCTACACCGGGGAGCTGTTTTTT	CASSPKEPGPFGYTGELFF	TRBV18	TRBJ2-2
TGTGCCAGCAGCGCGGGACCTCGGGCAACTAATGAAAAACTGTTTTTT	CASSAGPRATNEKLFF	TRBV7-4	TRBJ1-4
TGTGCCTCCGACTCTAGCGGGTTCCCCGGGGAGCTGTTTTTT	CASDSSGFPGELFF	TRBV6-1	TRBJ2-2
TGTGCCAGCAGCAGGGACAGGAACACTGAAGCTTTCTTT	CASSRDRNTEAFF	TRBV7-3	TRBJ1-1
TGCGCCAGCAAACGGGTCTACGGACAGGGAGAATCCAACACCGGGGAGCTGTTTTTT	CASKRVYGQGESNTGELFF	TRBV10-1	TRBJ2-2
TGTGCCAGCAGTTTGGGGGGGAGCTACGAGCAGTACTTC	CASSLGGSYEQYF	TRBV27	TRBJ2-7
TGTGCCAGCAGTTCAGGGTGGGCAACTAATGAAAAACTGTTTTTT	CASSSGWATNEKLFF	TRBV2	TRBJ1-4
TGCAGTGCTGTATCTTGGCCAACGACAGGGGCGGCCTACAATGAGCAGTTCTTC	CSAVSWPTTGAAYNEQFF	TRBV20-1	TRBJ2-1
TGTGCCAGCAGCCCGGGACTAATCACGCAGTATTTT	CASSPGLITQYF	TRBV7-2	TRBJ2-3
TGTGCCAGCAGCGCCGACAGGGGGCATCAGCCCCAGCATTTT	CASSADRGHQPQHF	TRBV9	TRBJ1-5
TGTGCCAGCAGTTCTCGGGGCCAAAGCTCCTACGAGCAGTACTTC	CASSSRGQSSYEQYF	TRBV27	TRBJ2-7
TGCAGTGCGGAGCAGCCTGATGATTCACCCCTCCACTTT	CSAEQPDDSPLHF	TRBV20-1	TRBJ1-6
TGTGCCAGCAGTCGCTACTGGGCCCCAAACACTGAAGCTTTCTTT	CASSRYWAPNTEAFF	TRBV27	TRBJ1-1
TGCAGGCAGGGGGGGCGGCGGAATCAGCCCCAGCATTTT	CRQGGRRNQPQHF	TRBV20-1	TRBJ1-5
TGTGCCAGTAGTATAGAAAGCGGGATGAACCCCGAGCAGTACTTC	CASSIESGMNPEQYF	TRBV19	TRBJ2-7
TGTGCCAGCTCGAAGTTGTTAGGGGCACAGGCTTATAGCAATCAGCCCCAGCATTTT	CASSKLLGAQAYSNQPQHF	TRBV18	TRBJ1-5
TGCGCCAGCATCCAAAGAGGTGGTCATCAGCCCCAGCATTTT	CASIQRGGHQPQHF	TRBV10-1	TRBJ1-5
TGTGCCAGTCCCAGCGACATGTCACTTTTAATTGATGGCTACACCTTC	CASPSDMSLLIDGYTF	TRBV7-4	TRBJ1-2
TGTGCCAGCGAGAACAGTGTTTGGCCTAACTATGGCTACACCTTC	CASENSVWPNYGYTF	TRBV2	TRBJ1-2
TGTGCCAGCAGCTTGGGAAAACCCAGGCGGGTCTATGGCTACACCTTC	CASSLGKPRRVYGYTF	TRBV5-6	TRBJ1-2
TGTGCCAGCAGCTATGGGGGGACGGAGCCCCAGCATTTT	CASSYGGTEPQHF	TRBV13	TRBJ1-5
TGTGCCAGCAGTTTCTACTTTGTCCGGGCCTCTGGCTACACCTTC	CASSFYFVRASGYTF	TRBV12-3	TRBJ1-2
TGTGCCAGCAGTTTCCGTAGAAGGGACAGCGGGGCCTTGTGCTACGAGCAGTACTTC	CASSFRRRDSGALCYEQYF	TRBV27	TRBJ2-7
TGTGCCAGCAGCTTAGGCGGGAAAGACTACGAGCAGTACTTC	CASSLGGKDYEQYF	TRBV11-3	TRBJ2-7
TGCGCCAGCAGCCAACTTATCGCCTTTGGCTTC	CASSQLIAFGF	TRBV4-1	TRBJ2-7
TGTGCCAGCAGCGCCCTAGGGAGCCGGGGTGGAAACGAGCAGTACTTC	CASSALGSRGGNEQYF	TRBV7-9	TRBJ2-7
TGTGCCAGCAGCCCGCAGGTAAAAGAGACTGAAGCTTTCTTT	CASSPQVKETEAFF	TRBV5-6	TRBJ1-1
TGTGCCAGCTCACCCGACCGGGACAGGGAGGAGCAGTTCTTC	CASSPDRDREEQFF	TRBV18	TRBJ2-1
TGTGCCAGTAGTATGCATCCACCCAGAGCGGCCGGCACAGATACGCAGTATTTT	CASSMHPPRAAGTDTQYF	TRBV19	TRBJ2-3
TGTGCCAGCAGTTTTGAGACAGGGGATCAGCCCCAGCATTTT	CASSFETGDQPQHF	TRBV28	TRBJ1-5
TGTGCCAGCAGTGACCTGGGGGACGAGCAGTACTTC	CASSDLGDEQYF	TRBV6-1	TRBJ2-7
TGTGCCAGCAGTGAACCAGGACAGGTGGGAGCTTTCTTT	CASSEPGQVGAFF	TRBV6-1	TRBJ1-1
TGTGCCAGCAGCTTGGGTTGTAGCGGGGCACAAGAGACCCAGTACTTC	CASSLGCSGAQETQYF	TRBV5-6	TRBJ2-5
TGTGCCAGCAGCTTGGCCTTGGTCCCCGGTAAGAGGAACACCGGGGAGCTGTTTTTT	CASSLALVPGKRNTGELFF	TRBV5-6	TRBJ2-2
TGTGCCAGCAGCGTAGAGCCGGGAGGGGGGGGAAAGGACTACGAGCAGTACTTC	CASSVEPGGGGKDYEQYF	TRBV9	TRBJ2-7
TGTGCCAGCAGTTTCCCGAGGGAGGGAAACACCATATATTTT	CASSFPREGNTIYF	TRBV27	TRBJ1-3
TGTGCCACCAGCAGCATTGAGACCCAGTACTTC	CATSSIETQYF	TRBV15	TRBJ2-5
TGTGCCAGCAGCCCGTACCCGGGCAAAAACATTCAGTACTTC	CASSPYPGKNIQYF	TRBV5-6	TRBJ2-4
TGTGCCAGCAAACGGGACAGTAGTGGCTACACCTTC	CASKRDSSGYTF	TRBV25-1	TRBJ1-2
TGTGCTAGTGGGATGCCTCGGGGCCTCCTAAACTATGGCTACACCTTC	CASGMPRGLLNYGYTF	TRBV12-5	TRBJ1-2
TGTGCCACCAAGGACAGGAAGCAGTACTTC	CATKDRKQYF	TRBV24-1	TRBJ2-7
TGTGCCAGCAGTTTATGCCCTCTAACACTCGGAATCACCCCTAGCACAGATACGCAGTATTTT	CASSLCPLTLGITPSTDTQYF	TRBV27	TRBJ2-3
TGTGCCAGCAGCCAAGATGGGGGGACAGGAGATGATAGCAATCAGCCCCAGCATTTT	CASSQDGGTGDDSNQPQHF	TRBV3-1	TRBJ1-5
TGTGCCAGCAGTGACAGTGCGGGACAGGGTAACTATGGCTACACCTTC	CASSDSAGQGNYGYTF	TRBV2	TRBJ1-2
TGTGCCAGCAGCAAGAGGACTCGGAGCATAAGCTCTGGAAACACCATATATTTT	CASSKRTRSISSGNTIYF	TRBV5-6	TRBJ1-3
TGTGCCAGCAGTTTAGAAAGAATAGGACTACGCACCTTC	CASSLERIGLRTF	TRBV28	TRBJ1-2
TGTGCCACCAGTGATTTTAGTCTAGCGGAAAGGGACGAGCAGTACTTC	CATSDFSLAERDEQYF	TRBV24-1	TRBJ2-7
TGTGCCAGCAGACCGGACAGTCTATCTAACTATGGCTACACCTTC	CASRPDSLSNYGYTF	TRBV5-6	TRBJ1-2
TGTGCCAGCAGCTTGGGAGGGACCATCTTCAATGAGCAGTTCTTC	CASSLGGTIFNEQFF	TRBV5-6	TRBJ2-1
TGTGCCAGCAGCTCGCCGGGACTAGCGGTGGGGACCGAGACCCAGTACTTC	CASSSPGLAVGTETQYF	TRBV5-6	TRBJ2-5
TGTGCCAGCAGCTTAGATCTCCCCCCTGCACCCGGGACAAAGAGCTACGAGCAGTACTTC	CASSLDLPPAPGTKSYEQYF	TRBV11-3	TRBJ2-7
TGTGCCAGCAGCGTCAATCGCTCCAATCAGCCCCAGCATTTT	CASSVNRSNQPQHF	TRBV9	TRBJ1-5
TGCAGTGCTAGAAAGCGGACAATGGTAAATTCCTACGAGCAGTACTTC	CSARKRTMVNSYEQYF	TRBV20-1	TRBJ2-7
TGTGCCAGCAGCGTTACTAGGGGCTACGAGCAGTACTTC	CASSVTRGYEQYF	TRBV7-3	TRBJ2-7
TGCGCCAGCAGCCAAATGACGACCTCCCCCTGGAACCCGAAGCCACAGGGGAAGGGTAGGGGCTATGGCTACACCTTC	CASSQMTTSPWNPKPQGKGRGYGYTF	TRBV4-3	TRBJ1-2
TGTGCCAGCAGTTTACAGGGGGTTCTCAATCAGCCCCAGCATTTT	CASSLQGVLNQPQHF	TRBV12-4	TRBJ1-5
TGTGCTAGTGGTTTGGTTCGGGGGGGGCGGGCTAAGGGGTTAGTGTGCGAGCAGTTCTTC	CASGLVRGGRAKGLVCEQFF	TRBV12-5	TRBJ2-1
TGTGCCAGCAACTGGGAGGAAAGGAAAGGGGGAGGCTACAATGAGCAGTTCTTC	CASNWEERKGGGYNEQFF	TRBV12-4	TRBJ2-1
TGCGTCCACACCGGACAGGATGGCTACACCTTC	CVHTGQDGYTF	TRBV20-1	TRBJ1-2
TGTGCCAGCAGTTACCCGGGAGGTGGACAAGAGACCCAGTACTTC	CASSYPGGGQETQYF	TRBV28	TRBJ2-5
TGTGCCAGCACCCGTGCGGACAGACCCTTCTATGGCTACACCTTC	CASTRADRPFYGYTF	TRBV11-2	TRBJ1-2
TGTGCAAGGGGACTCGAGACCCAGTACTTC	CARGLETQYF	TRBV6-2	TRBJ2-5
TGTGCCAGCAGCCACAGTAGGCTCTCTGGAAACACCATATATTTT	CASSHSRLSGNTIYF	TRBV14	TRBJ1-3
TGTGCCATTCCGTTAGCGGGAGGCGGGGAGCTGTTTTTT	CAIPLAGGGELFF	TRBV7-9	TRBJ2-2
TGCGCCAGCAGCTTGACGGCCGTTTATCAAGACAGGGGCCCGATGGCTGAAGCTTTCTTT	CASSLTAVYQDRGPMAEAFF	TRBV5-1	TRBJ1-1
TGTGCCAGCAGACGGGGGGGCACCTCTCCCACAGATACGCAGTATTTT	CASRRGGTSPTDTQYF	TRBV7-9	TRBJ2-3
TGCGCCAGCAGCTATGCTTCTTCCCCAATTTATAGCAATCAGCCCCAGCATTTT	CASSYASSPIYSNQPQHF	TRBV5-1	TRBJ1-5
TGTGCTAGTGGTAACCTGTTTGGGGGGCGCCAAGATACGCAGTATTTT	CASGNLFGGRQDTQYF	TRBV12-5	TRBJ2-3
TGTGCCATCCATGGGGGGGATCAGCCCCAGCATTTT	CAIHGGDQPQHF	TRBV10-3	TRBJ1-5
TGTGCCAGCAGCTCGCGGGGACCCGATAATGAAAAACTGTTTTTT	CASSSRGPDNEKLFF	TRBV7-3	TRBJ1-4
TGTGCCAGCAGCGGGGACAGGGAAGCCATATATTTT	CASSGDREAIYF	TRBV5-4	TRBJ1-3
TGTGCCAGCAGTTCCCGGACTGGGGCCAACGTCCTGACTTTC	CASSSRTGANVLTF	TRBV6-5	TRBJ2-6
TGTGCCAGCAGTGAAATTCGTCTCCTGCCATCAGATACGCAGTATTTT	CASSEIRLLPSDTQYF	TRBV6-1	TRBJ2-3
TGTGCCAGCTCACCACACCCTCGGGGGGGAGGGGATCTCTACGAGCAGTACTTC	CASSPHPRGGGDLYEQYF	TRBV18	TRBJ2-7
TGTGCCAGCAGCACCAACAATCAGCCCCAGCATTTT	CASSTNNQPQHF	TRBV7-3	TRBJ1-5
TGTGCCAGCAGTCACCGGCCCCTAGATTCAGATACGCAGTATTTT	CASSHRPLDSDTQYF	TRBV28	TRBJ2-3
TGTGCCAGCAGTGTCCGGGGGACCGTGAACACTGAAGCTTTCTTT	CASSVRGTVNTEAFF	TRBV2	TRBJ1-1
TGCGCCAGCAGTTCAATGGGGAACACTGAAGCTTTCTTT	CASSSMGNTEAFF	TRBV5-1	TRBJ1-1
TGTGCCAGCAGCTTTCGAGGGACGTTCGGCTACACCTTC	CASSFRGTFGYTF	TRBV5-8	TRBJ1-2
TGCAGTGCAGAGGGGTTGGTAGCTTTCTTT	CSAEGLVAFF	TRBV20-1	TRBJ1-1
TGCGCCAGCAGCTTGCTTTTAGCCGGGACAGGAATTAACACTGAAGCTTTCTTT	CASSLLLAGTGINTEAFF	TRBV5-1	TRBJ1-1
TGTGCCAGCAGTTACTCCGCGGGGGGCAAAGATTCACCCCTCCACTTT	CASSYSAGGKDSPLHF	TRBV6-3	TRBJ1-6
TGTGCCAGCCGCCCATTGTCGGGGGGGGCTCAAGACCCGGCGTGGTACAATGAGCAGTTCTTC	CASRPLSGGAQDPAWYNEQFF	TRBV11-3	TRBJ2-1
TGTGCCAGCAGTCGTCCCAGTTCCTCCGGCAGCAATCAGCCCCAGCATTTT	CASSRPSSSGSNQPQHF	TRBV27	TRBJ1-5
TGTGCCAGCAGCTTAAGGGGTAGACAGGTGAGGAATGCTTTCTTT	CASSLRGRQVRNAFF	TRBV5-6	TRBJ1-1
TGTGCCAGCAGCGTCCCGGGACAGGGGGAAAGCGAGCAGTACTTC	CASSVPGQGESEQYF	TRBV13	TRBJ2-7
TGTGCCAGCAGCTACCCGCGGCAAAGGACTAGGTACGAGCAGTACTTC	CASSYPRQRTRYEQYF	TRBV11-3	TRBJ2-7
TGTGCCAGCAGTTCGACAATCCGTTACCAAGAGACCCAGTACTTC	CASSSTIRYQETQYF	TRBV12-4	TRBJ2-5
TGCGCCAGCAGCTCGGATGCAGGGGGGCTTTTTTACAATGAGCAGTTCTTC	CASSSDAGGLFYNEQFF	TRBV5-1	TRBJ2-1
TGTGCCAGCAGCCAAGAACCGGGGGGGAGGTTCGAGCAGTACTTC	CASSQEPGGRFEQYF	TRBV14	TRBJ2-7
TGTGCCAGCATATTAGGACAGAGGCGGAACCGCACAGATACGCAGTATTTT	CASILGQRRNRTDTQYF	TRBV9	TRBJ2-3
TGTGCCAGCAGTACCACTTGGGACGCGGGAGCAGATACGCAGTATTTT	CASSTTWDAGADTQYF	TRBV6-5	TRBJ2-3
TGCGCCAGCAGCCAAGACCTCAGGACAGGGGATGTGAACACTGAAGCTTTCTTT	CASSQDLRTGDVNTEAFF	TRBV4-1	TRBJ1-1
TGTGCCACCAGCAGTAGCCAAGCTAACTATGGCTACACCTTC	CATSSSQANYGYTF	TRBV15	TRBJ1-2
TGTGCCAGCAGCCGGAAGAACGGTCCGCAGTTCTTC	CASSRKNGPQFF	TRBV7-9	TRBJ2-1
TGTGCCAGCAGTCGAGACCACGGGCCTTCCTACGAGCAGTACTTC	CASSRDHGPSYEQYF	TRBV28	TRBJ2-7
TGTGCCAGCAGCGAGGGTTGGCAGTTCTTC	CASSEGWQFF	TRBV7-8	TRBJ2-1
TGTGCCAGCAGCTTACACAGGTTTAAATACGAGCAGTACTTC	CASSLHRFKYEQYF	TRBV7-6	TRBJ2-7
TGCGCCAGCTCGGGGGGGGCCTACGAGCAGTACTTC	CASSGGAYEQYF	TRBV10-1	TRBJ2-7
TGTGCCGTGTCGGCCGAGCAGTACTTC	CAVSAEQYF	TRBV27	TRBJ2-7
TGTGCCAGCAGCTTCTGCGGGGACGACAGCACTGAAGCTTTCTTT	CASSFCGDDSTEAFF	TRBV7-2	TRBJ1-1
TGCGCCAGCAGCTTGCCCGGGAGGGGAGAAAATAGCAATCAGCCCCAGCATTTT	CASSLPGRGENSNQPQHF	TRBV5-1	TRBJ1-5
TGCATTGTGACGTCGGTTAGCACAGATACGCAGTATTTT	CIVTSVSTDTQYF	TRBV20-1	TRBJ2-3
TGTGCCAGCAGGACCCTAGCGGGGGATGAGCAGTACTTC	CASRTLAGDEQYF	TRBV7-9	TRBJ2-7
TGTGCCAGCAGTACTTATGGGGCAAGGACAGATACGCAGTATTTT	CASSTYGARTDTQYF	TRBV28	TRBJ2-3
TGTGCCAGCAGCACCACTAGGGCGCAGTATTTT	CASSTTRAQYF	TRBV7-4	TRBJ2-3
TGTGCCTGGTACCAGACGGGACAGGGGGCCGCAGACGAGCAGTACTTC	CAWYQTGQGAADEQYF	TRBV30	TRBJ2-7
TGTGCCAGCAGCAACAGGTGTTCAGATACGCAGTATTTT	CASSNRCSDTQYF	TRBV28	TRBJ2-3
TGTGCCAGCAGCGAGACAGGGGGCTCGATGAACACTGAAGCTTTCTTT	CASSETGGSMNTEAFF	TRBV5-6	TRBJ1-1
TGCGCCAGCAGCTGGGGACCCACGAAACCTAACTATGGCTACACCTTC	CASSWGPTKPNYGYTF	TRBV5-1	TRBJ1-2
TGTGCCAGCAGCATGGGGGAGGCAGATACGCAGTATTTT	CASSMGEADTQYF	TRBV7-4	TRBJ2-3
TGTGCCAGCAGTTTGTCCCAACAGGGCCGCGAGCAGTACTTC	CASSLSQQGREQYF	TRBV27	TRBJ2-7
TGTGCCAGCAGTCGCTGGGCTCGGACCAACGTCCTGACTTTC	CASSRWARTNVLTF	TRBV27	TRBJ2-6
TGTGCCAGCAGCTTAGCCCCTTTTCAGGCCCTAAACACCGGGGAGCTGTTTTTT	CASSLAPFQALNTGELFF	TRBV7-8	TRBJ2-2
TGCGCCAACCCCAGGGAAGGGAAAGGCACCGGGGAGCTGTTTTTT	CANPREGKGTGELFF	TRBV10-1	TRBJ2-2
TGCAGTGCTACAAGTGGGGCCAACGTCCTGACTTTC	CSATSGANVLTF	TRBV20-1	TRBJ2-6
TGTGCCAGCAGCCGCCCAGGGTCGGCACCTCGGACTGAAGCTTTCTTT	CASSRPGSAPRTEAFF	TRBV9	TRBJ1-1
TGTGCCAGCAGCGGCGCTGGACAGGGTAGCAATCAGCCCCAGCATTTT	CASSGAGQGSNQPQHF	TRBV5-6	TRBJ1-5
TGTGCCAGCAGTGAAGCTTTGTGGGACACAGGCACAGATACGCAGTATTTT	CASSEALWDTGTDTQYF	TRBV6-1	TRBJ2-3
TGTGCCAGCGGACAGGGGGAAAATCAGCCCCAGCATTTT	CASGQGENQPQHF	TRBV11-2	TRBJ1-5
TGTGCCAGCAGCTTAGTCAAACAGGCCTGCGAGCAGTACTTC	CASSLVKQACEQYF	TRBV7-9	TRBJ2-7
TGTGCCAGCAGCGCAATAATGCGGGAGGCTAGGGCTAACTATGGCTACACCTTC	CASSAIMREARANYGYTF	TRBV3-1	TRBJ1-2
TGTGCCAGCAGCCGAAGACGACCGACCACCGGGGAGCTGTTTTTT	CASSRRRPTTGELFF	TRBV7-9	TRBJ2-2
TGCGCCAGCAGCCAAGAATTCCGGGCGGACTTC	CASSQEFRADF	TRBV4-1	TRBJ2-7
TGTGCCAGCTCACCAGCGGAAAGGGGGCAAAAGGCCAAAAACATTCAGTACTTC	CASSPAERGQKAKNIQYF	TRBV18	TRBJ2-4
TGCGCCAGCAGCTTGGCAGGGACTGATTACAATGAGCAGTTCTTC	CASSLAGTDYNEQFF	TRBV5-1	TRBJ2-1
TGTGCCAGCAACGGTACACAGGGTTACGAGCAGTACTTC	CASNGTQGYEQYF	TRBV5-6	TRBJ2-7
TGTGCCAGCAGTTGTAAACCCCGGACTAGCGGGAGGGCTAGGCTTACCGGGGAGCTGTTTTTT	CASSCKPRTSGRARLTGELFF	TRBV6-9	TRBJ2-2
TGTGCCACCACCCCGAACGGGGCTCGCACAGATACGCAGTATTTT	CATTPNGARTDTQYF	TRBV24-1	TRBJ2-3
TGTGCCATCAGTGAGTCGAACCCGACAGTACTTCATGAGCAGTTCTTC	CAISESNPTVLHEQFF	TRBV10-3	TRBJ2-1
TGTGCCAGCAGCTTGATGTCCTCAGACGACCGGACCTACGAGCAGTACTTC	CASSLMSSDDRTYEQYF	TRBV5-6	TRBJ2-7
TGCAGTGCTAGACCGGGACTTATCCTCAATGAGCAGTTCTTC	CSARPGLILNEQFF	TRBV20-1	TRBJ2-1
TGTGCCATAAGGGGTGGGGGAAATCAGCCCCAGCATTTT	CAIRGGGNQPQHF	TRBV6-5	TRBJ1-5
TGTGCCAAACCCACGGGAGATGGACAAGAGACCCAGTACTTC	CAKPTGDGQETQYF	TRBV24-1	TRBJ2-5
TGTGCCAGCAGCTTGGGCCCTAGCGGGTGCTACGAGCAGTACTTC	CASSLGPSGCYEQYF	TRBV7-3	TRBJ2-7
TGTGCCAGCAATCTCGACGGTTACGCCTACGAGCAGTACTTC	CASNLDGYAYEQYF	TRBV2	TRBJ2-7
TGCGCCAGCAGCGAGAGAGGGGTAAACACTGAAGCTTTCTTT	CASSERGVNTEAFF	TRBV5-1	TRBJ1-1
TGTGCCACCCACCTCCAGGGGACGGAAAAACTGTTTTTT	CATHLQGTEKLFF	TRBV10-3	TRBJ1-4
TGTGCCAGCAGCTTGACTCCCAGGGGAAGCGGGGGGGAGAACACTGAAGCTTTCTTT	CASSLTPRGSGGENTEAFF	TRBV7-9	TRBJ1-1
TGTGCCAGCAGTTTATGGGGGACAGGGCGTGGGGCTGAAGCTTTCTTT	CASSLWGTGRGAEAFF	TRBV28	TRBJ1-1
TGCGCCAGCAGCCAAGTGACTCTTGGCAAAAACATTCAGTACTTC	CASSQVTLGKNIQYF	TRBV4-1	TRBJ2-4
TGTGCCAGCAGTGTCAGAACGGGAACTCCGGAGACCCAGTACTTC	CASSVRTGTPETQYF	TRBV6-1	TRBJ2-5
TGTGCCAGCAGCCAAGATAACCGGACAGGGAAAGCAGATACGCAGTATTTT	CASSQDNRTGKADTQYF	TRBV14	TRBJ2-3
TGTGCCAGCAGTTTAGGTGTCAGGGAGATACAGCTCACTGAAGCTTTCTTT	CASSLGVREIQLTEAFF	TRBV12-3	TRBJ1-1
TGTGCCAGCAGCCCCATGGACAGGGCCGTCGTGAACTATGGCTACACCTTC	CASSPMDRAVVNYGYTF	TRBV7-3	TRBJ1-2
TGTGCCAGCTCAAAAACCCCGGACAGGGTCCCTAAGGATTATGGCTACACCTTC	CASSKTPDRVPKDYGYTF	TRBV18	TRBJ1-2
TGTGCCAGCAGTGACCCACCTGTACCAGCGGACAGGGCCCAGCGCTACGAGCAGTACTTC	CASSDPPVPADRAQRYEQYF	TRBV6-4	TRBJ2-7
TGTGCCTGGCAGCGGGGGACAGGGGAGAACTTC	CAWQRGTGENF	TRBV30	TRBJ1-2
TGTGCCAGTAGTGAGAGACAGGGGAGAGAAAAACTGTTTTTT	CASSERQGREKLFF	TRBV19	TRBJ1-4
TGTGCCATCAGAATTTATGGGACAGACTCTGGAAACACCATATATTTT	CAIRIYGTDSGNTIYF	TRBV10-3	TRBJ1-3
TGTGCCAGCAGTCCGAGGAGGGCCAGCCGGGGTGAGCAGTTCTTC	CASSPRRASRGEQFF	TRBV27	TRBJ2-1
TGCGCCAGCAGAGAGGAACTAGGGCGGGACAGGGTGGGTGATAGCAATCAGCCCCAGCATTTT	CASREELGRDRVGDSNQPQHF	TRBV5-1	TRBJ1-5
TGCGCCAGCACCGGGGTAAGGGGGACAGGGCCCCAGCATTTT	CASTGVRGTGPQHF	TRBV10-2	TRBJ1-5
TGTGCTAGTGGTTTCAAGGACTCCTACGAGCAGTACTTC	CASGFKDSYEQYF	TRBV12-5	TRBJ2-7
TGTGCCAGCAGCATAGGGGAAGCCGGCTACACCTTC	CASSIGEAGYTF	TRBV9	TRBJ1-2
TGTGCCTGGATACGGAGGACCCTTCATAACTATGGCTACACCTTC	CAWIRRTLHNYGYTF	TRBV28	TRBJ1-2
TGTGCCAGCAGCCCAGACGACGAGCAGTACTTC	CASSPDDEQYF	TRBV7-4	TRBJ2-7
TGTGCCAGCAGCCCTGACCGGTTCAGGTTCTACAATGAGCAGTTCTTC	CASSPDRFRFYNEQFF	TRBV7-9	TRBJ2-1
TGTGCCAGCAGCTTGGGACTAGCGAGGGAGACCCTCTACGAGCAGTACTTC	CASSLGLARETLYEQYF	TRBV5-5	TRBJ2-7
TGCAGTGCTAGAGAATCGGATTTTGCTGGGGCCAACGTCCTGACTTTC	CSARESDFAGANVLTF	TRBV20-1	TRBJ2-6
TGTGCCAGCAGCTCAGGACGCTGCAATCAGCCCCAGCATTTT	CASSSGRCNQPQHF	TRBV7-3	TRBJ1-5
TGCGCGGTTCTCAGGAGCAATCAGCCCCAGCATTTT	CAVLRSNQPQHF	TRBV10-2	TRBJ1-5
TGTGCCAGCAGCCAAGGCCCCGTGACAGGGCCGGACGAGCAGTACTTC	CASSQGPVTGPDEQYF	TRBV14	TRBJ2-7
TGTGCCAGCGACAGGGAACTGACTTTC	CASDRELTF	TRBV27	TRBJ2-6
TGTGCTAGTGGTTTGATCTGGCAGGAGAATAACTATGGCTACACCTTC	CASGLIWQENNYGYTF	TRBV12-5	TRBJ1-2
TGTGCCAGTACTGGGAGCCACGAGCAGTACTTC	CASTGSHEQYF	TRBV19	TRBJ2-7
TGTGCCAGCAGCTTAAAGGGTAGAGGGGAGGGCGGGGAGCTGTTTTTT	CASSLKGRGEGGELFF	TRBV7-9	TRBJ2-2
TGTGCCAGCAGCGTAGAACGCGGACAACTCTACGAGCAGTACTTC	CASSVERGQLYEQYF	TRBV7-9	TRBJ2-7
TGTGCCAGCAGCCAAGAGGTAGGCCTGAAACAGGGGGCGAACACCGGGGAGCTGTTTTTT	CASSQEVGLKQGANTGELFF	TRBV4-2	TRBJ2-2
TGTGCCAGCAGTGTCCCGGAGGACAGGGGGGTGGGGACTGAAGCTTTCTTT	CASSVPEDRGVGTEAFF	TRBV6-1	TRBJ1-1
TGTGCCAGCAGTGGGCCCGAAAGGAGGTTCCGGGCCTACGAGCAGTACTTC	CASSGPERRFRAYEQYF	TRBV2	TRBJ2-7
TGTGCCATCAGTGAGGACAGGGGGCGGCTCGGCAAAAACATTCAGTACTTC	CAISEDRGRLGKNIQYF	TRBV10-3	TRBJ2-4
TGTGCCAGCAGTGACTCGACAGGTCCGGCTAGCACAGATACGCAGTATTTT	CASSDSTGPASTDTQYF	TRBV6-4	TRBJ2-3
TGTGCCAGCAGCTATCCGGGGGGGCCATCCGTCTTC	CASSYPGGPSVF	TRBV7-6	TRBJ2-1
TGCGCCAGCAGCCAACGACACCGGGGGCTTAAGACTGAAGCTTTCTTT	CASSQRHRGLKTEAFF	TRBV4-1	TRBJ1-1
TGTGCCAGCAGGATCCACCGGGACAGGGAGGGCAAGTGTAACCAGTACTTC	CASRIHRDREGKCNQYF	TRBV6-1	TRBJ2-5
TGTGCCAGCAGTGACGGGGTAACTGAAGCTTTCTTT	CASSDGVTEAFF	TRBV6-4	TRBJ1-1
TGTGCCAGTAGTAAGTGTACTAGCGGGAGCCCAAATGAGCAGTTCTTC	CASSKCTSGSPNEQFF	TRBV19	TRBJ2-1
TGTGCCAGCAGTCGCCCGGGACAGTCCTACGAGCAGTACTTC	CASSRPGQSYEQYF	TRBV28	TRBJ2-7
TGCGCCACGGGACTAGCGGGACAAATTGGCAACACCGGGGAGCTGTTTTTT	CATGLAGQIGNTGELFF	TRBV5-1	TRBJ2-2
TGTGCCAGCAGCTCCCCGGGACAGGGGGCAGAGACCCAGTACTTC	CASSSPGQGAETQYF	TRBV13	TRBJ2-5
TGTGCCACCAGCAGGGGGGGTAGCTCCTACGAGCAGTACTTC	CATSRGGSSYEQYF	TRBV15	TRBJ2-7
TGCAGTGCTAGAGGAGACAGGGCTGGAAACACCATATATTTT	CSARGDRAGNTIYF	TRBV20-1	TRBJ1-3
TGCGCCAGCAGCAGGGGCCTATCCCTCTACAATGAGCAGTTCTTC	CASSRGLSLYNEQFF	TRBV5-1	TRBJ2-1
TGCGCCAGCGAATTCAAGCCCGACGACAGCTGTAGCGCTCAGCCCCAGCATTTT	CASEFKPDDSCSAQPQHF	TRBV10-1	TRBJ1-5
TGCGCCAGCCCGGCGGGGAGCTCCTACAATGAGCAGTTCTTC	CASPAGSSYNEQFF	TRBV5-1	TRBJ2-1
TGTGCCAGCAGCTCCCCGGTGGGCCTTTGTGCCTACGAGCAGTACTTC	CASSSPVGLCAYEQYF	TRBV11-2	TRBJ2-7
TGTGCCTGGCACGGACAGAACACTGAAGCTTTCTTT	CAWHGQNTEAFF	TRBV30	TRBJ1-1
TGCGCCAGCAGCTCTCCCTTTGGACTAGCGGGGGGAAAGCGATACGAGCAGTACTTC	CASSSPFGLAGGKRYEQYF	TRBV5-1	TRBJ2-7
TGCAGTGCTAGGATGGGGGGTTATAATTCACCCCTCCACTTT	CSARMGGYNSPLHF	TRBV20-1	TRBJ1-6
TGCAGTGCTAGGGTATCGCTCCACGGCGGGGGGGTCAGCTCCTACGAGCAGTACTTC	CSARVSLHGGGVSSYEQYF	TRBV20-1	TRBJ2-7
TGTGCCAGCAGGGTGGGACTAGGGGAGTACTTC	CASRVGLGEYF	TRBV7-3	TRBJ2-7
TGTGCCAGTCAGAGGGGGGGGGGAGCCGGGGAGCTGTTTTTT	CASQRGGGAGELFF	TRBV27	TRBJ2-2
TGCGCCAGCAGCTTGCGGCGGACTAGCGGGAGGGAGCCCCAGCATTTT	CASSLRRTSGREPQHF	TRBV5-1	TRBJ1-5
TGTGCCAGCAGCCGGAAGGGGCTAGGGGCGGACTATAATTCACCCCTCCACTTT	CASSRKGLGADYNSPLHF	TRBV13	TRBJ1-6
TGTGCCAGCAGTGAAGCTAAAAGGTCCGGGACTAGGGGCAATGAGCAGTTCTTC	CASSEAKRSGTRGNEQFF	TRBV6-1	TRBJ2-1
TGTGCCAGCAGCCAAGATCCCGACGGAATGAAGGGGAAAGAGACCCAGTACTTC	CASSQDPDGMKGKETQYF	TRBV4-2	TRBJ2-5
TGTGCCAGCAGGGGGGTAGGAAAAACCTACGAGCAGTACTTC	CASRGVGKTYEQYF	TRBV27	TRBJ2-7
TGTGCCAGCAGCCAATTGATCCGGACAGGGTGGGGCTATGGCTACACCTTC	CASSQLIRTGWGYGYTF	TRBV6-5	TRBJ1-2
TGTGCCAGCAGCAATTCGCCCGGGGGGGGGACTAGCACAGATACGCAGTATTTT	CASSNSPGGGTSTDTQYF	TRBV7-2	TRBJ2-3
TGTGCCACCAGCAAGGGCCGGGACAGGGAATCCTATGGGCCGAACACCGGGGAGCTGTTTTTT	CATSKGRDRESYGPNTGELFF	TRBV15	TRBJ2-2
TGTGCCAGCAACCCCGCCTTGAAGGGGTGTCACCCTATTCAGCCCCAGCATTTT	CASNPALKGCHPIQPQHF	TRBV6-4	TRBJ1-5
TGTGCCAGGATGGGGGGGGGAGGTGAGACCCAGTACTTC	CARMGGGGETQYF	TRBV27	TRBJ2-5
TGTGCCAGCAGTGAGAGACACACCGGGGAGCTGTTTTTT	CASSERHTGELFF	TRBV6-2	TRBJ2-2
TGTGCCAGCAGCTTCCGGGGGCGGTTACGGAACACTGAAGCTTTCTTT	CASSFRGRLRNTEAFF	TRBV5-5	TRBJ1-1
TGTGCCACCCCTACTAGCGGGACCGGGGAGCTGTTTTTT	CATPTSGTGELFF	TRBV6-5	TRBJ2-2
TGTGCCAGCAGCTCGAACAGGGCGGGCATGAACACTGAAGCTTTCTTT	CASSSNRAGMNTEAFF	TRBV7-3	TRBJ1-1
TGTCGGGGCCGACAGGTTTCCTCGTCCTACGAGCAGTACTTC	CRGRQVSSSYEQYF	TRBV6-6	TRBJ2-7
TGTGCCAGCAGCGGGGAGGTTAACAATGAGCAGTTCTTC	CASSGEVNNEQFF	TRBV13	TRBJ2-1
TGTGCCACCAGTGCACTAGCGGGGGGGGGGGGCGGCACAGATACGCAGTATTTT	CATSALAGGGGGTDTQYF	TRBV24-1	TRBJ2-3
TGTGCCAGCAGGCTTGGGGAGCCCCAGCATTTT	CASRLGEPQHF	TRBV6-5	TRBJ1-5
TGTGCCTGGAGATCCATTAACCCCATAGCGGGGGCGACCTACGAGCAGTACTTC	CAWRSINPIAGATYEQYF	TRBV30	TRBJ2-7
TGCGCCAGCAGCTGGCCTGAGGGGTACAGGGCTCAGCCCCAGCATTTT	CASSWPEGYRAQPQHF	TRBV5-1	TRBJ1-5
TGTGCCTTACAGGGTTACGAGAAAACTTCTTTGGGCTTCGATAATGAAAAACTGTTTTTT	CALQGYEKTSLGFDNEKLFF	TRBV28	TRBJ1-4
TGTGCCAGGGACGCTAGCGGAGGCAGCTCCTACAATGAGCAGTTCTTC	CARDASGGSSYNEQFF	TRBV7-9	TRBJ2-1
TGTGCCAGCAGCTTAGTTCTTCCCGGAGGGGGTAGGGCCTACGAGCAGTACTTC	CASSLVLPGGGRAYEQYF	TRBV7-6	TRBJ2-7
TGTGCCATAGGGACAGGGGGCACAAGTGATACGCAGTATTTT	CAIGTGGTSDTQYF	TRBV13	TRBJ2-3
TGTGCCAGCAGCCAAGACCCAGGGGGGGGGAACACCATATATTTT	CASSQDPGGGNTIYF	TRBV14	TRBJ1-3
TGCAGTGCTAGCCCATGCTCCTGGACTTTGGGAGGCTACACCTTC	CSASPCSWTLGGYTF	TRBV20-1	TRBJ1-2
TGTGCCAGCAGCTCCGACAGAGGTGCTGAAGCTTTCTTT	CASSSDRGAEAFF	TRBV7-2	TRBJ1-1
TGTGCCAGCAGTTTATGGGAGGACTACCGCTCCTACGAGCAGTACTTC	CASSLWEDYRSYEQYF	TRBV27	TRBJ2-7
TGTAGGGGACAGGGCCATGATATGAACACTGAAGCTTTCTTT	CRGQGHDMNTEAFF	TRBV7-9	TRBJ1-1
TGTGCCAGCAGCTTAACTGTATCACTCCGAAAGGGCTACAATGAGCAGTTCTTC	CASSLTVSLRKGYNEQFF	TRBV7-3	TRBJ2-1
TGCAGCGGGATCCACCGTAACTCAAATGAGCAGTTCTTC	CSGIHRNSNEQFF	TRBV29-1	TRBJ2-1
TGCAGTGCTTCCTGCGCCCGAACCAAAGATGGGTACCAGACAGGGGAGAACACCGGGGAGCTGTTTTTT	CSASCARTKDGYQTGENTGELFF	TRBV20-1	TRBJ2-2
TGTGCCGCTGGGGGGGGCTCCTACAATGAGCAGTTCTTC	CAAGGGSYNEQFF	TRBV25-1	TRBJ2-1
TGTGCCAGTAGTATGCCGGGATCTACCACATCCTACGAGCAGTACTTC	CASSMPGSTTSYEQYF	TRBV19	TRBJ2-7
TGTGCCAGCAGTAGTGGGCAAATGCACACTGAAGCTTTCTTT	CASSSGQMHTEAFF	TRBV2	TRBJ1-1
TGTGCCAGCAGCTTACCGGGACTAGCGGAAGGCTCCTACAATGAGCAGTTCTTC	CASSLPGLAEGSYNEQFF	TRBV7-2	TRBJ2-1
TGTGCCAGCAGCGGGCACAGGGACGGTAACGGGGGGCACTATGGCTACACCTTC	CASSGHRDGNGGHYGYTF	TRBV9	TRBJ1-2
TGTGCCAGCACGGGGAGGGGGGGGCGCTCCTACAATGAGCAGTTCTTC	CASTGRGGRSYNEQFF	TRBV6-4	TRBJ2-1
TGCGCCAGCAGCCCGGCTACCTTGCAGGGCAATCAGCCCCAGCATTTT	CASSPATLQGNQPQHF	TRBV5-1	TRBJ1-5
TGTGCTAGTGGCCGTTGTGCCGGACTAGCGGGGTACAATGAGCAGTTCTTC	CASGRCAGLAGYNEQFF	TRBV12-5	TRBJ2-1
TGTGCCAGCACCCTCCCGAAGGATTCTGTAGCTAGCACAGATACGCAGTATTTT	CASTLPKDSVASTDTQYF	TRBV27	TRBJ2-3
TGTGCCAGCAGCTGCGGGGAGAGCTCCTACAATGAGCAGTTCTTC	CASSCGESSYNEQFF	TRBV7-7	TRBJ2-1
TGTGCCACCAGTGATTTGCGGGACTTTAACCGTCCCTACAATGAGCAGTTCTTC	CATSDLRDFNRPYNEQFF	TRBV24-1	TRBJ2-1
TGCACACAGGGTAATGAAAAACTGTTTTTT	CTQGNEKLFF	TRBV20-1	TRBJ1-4
TGTGCCAGTAGTTGGGACAGGGATCGCAATCAGCCCCAGCATTTT	CASSWDRDRNQPQHF	TRBV19	TRBJ1-5
TGCAGTGCTAGAAAGAGGGGGGCCTACGAGCAGTACTTC	CSARKRGAYEQYF	TRBV20-1	TRBJ2-7
TGCGCCAGCAGCTTCCCCTGGACCCATCGCTACGAGCAGTACTTC	CASSFPWTHRYEQYF	TRBV5-1	TRBJ2-7
TGTACCACGCCTACTAGCGGGAGGGCAGACTTAACAGATACGCAGTATTTT	CTTPTSGRADLTDTQYF	TRBV30	TRBJ2-3
TGTGCCAGCAGCTTATGCAGGGGGCGCTCTGGGGCCAACGTCCTGACTTTC	CASSLCRGRSGANVLTF	TRBV7-2	TRBJ2-6
TGCGCCAGCAGCCAATTCGGGGGGAATAACTATGGCTACACCTTC	CASSQFGGNNYGYTF	TRBV4-1	TRBJ1-2
TGTGCCATTATACTAGCGGGGGGGCCCGACAATGAGCAGTTCTTC	CAIILAGGPDNEQFF	TRBV7-9	TRBJ2-1
TGCAGCGTTGAAGCCCCCCTTCGACAGGGGGCAGACAAACTGTTTTTT	CSVEAPLRQGADKLFF	TRBV29-1	TRBJ1-4
TGCGCCAGCAGCCGGCTAGTACTAGCGGGCATGCAAGAGACCCAGTACTTC	CASSRLVLAGMQETQYF	TRBV4-3	TRBJ2-5
TGCGCCAGCAGCTTAAGGGGGGCAGCCCAAGAGACCCAGTACTTC	CASSLRGAAQETQYF	TRBV5-1	TRBJ2-5
TGTGCCAGCAGGAGGTACACCGGGGAGCTGTTTTTT	CASRRYTGELFF	TRBV6-2	TRBJ2-2
TGTGCCAGCAGTAAAGAATGGACAGTGGAGACCCAGTACTTC	CASSKEWTVETQYF	TRBV6-5	TRBJ2-5
TGCAGTGCTAGATGGACAGGGGGCTCTGAAGCTTTCTTT	CSARWTGGSEAFF	TRBV20-1	TRBJ1-1
TGTGCCAGCAGTTGGTGGGCGGTGACCAATCAGCCCCAGCATTTT	CASSWWAVTNQPQHF	TRBV25-1	TRBJ1-5
TGCGCCAGCAGCGCCGTATTAATCTGGACTAGCGGGGTCTCCTACAATGAGCAGTTCTTC	CASSAVLIWTSGVSYNEQFF	TRBV5-1	TRBJ2-1
TGCAGCGCAACCGGGACGGGGGCACTCGCTTCTGGAAACACCATATATTTT	CSATGTGALASGNTIYF	TRBV29-1	TRBJ1-3
TGCGCCAGCAGTAGCCCCCTCAACGAGCAGTACTTC	CASSSPLNEQYF	TRBV5-1	TRBJ2-7
TGTGCCAGCAGCACCCTGTTAAAACTGTTTTTT	CASSTLLKLFF	TRBV5-5	TRBJ1-4
TGTGCCAGCAGCTTAGGACAGGGGTACGAGCAGTACTTC	CASSLGQGYEQYF	TRBV5-4	TRBJ2-7
TGTGCCTGGATTCTCAACGGAAGGCCCGCGAACACCGGGGAGCTGTTTTTT	CAWILNGRPANTGELFF	TRBV30	TRBJ2-2
TGTGCCAGCAGCAGACCATCGGTTCGACGAGTGAGCTCCTACGAGCAGTACTTC	CASSRPSVRRVSSYEQYF	TRBV5-6	TRBJ2-7
TGCAGTGCTACGCCTTCAGGGGATGGCTACACCTTC	CSATPSGDGYTF	TRBV20-1	TRBJ1-2
TGTGCCAGCAGTCGAACAACCGGGGTGGATCAAGAGACCCAGTACTTC	CASSRTTGVDQETQYF	TRBV12-4	TRBJ2-5
TGTGCCAGGGGGGGCAAAATGTACGAGCAGTACTTC	CARGGKMYEQYF	TRBV7-9	TRBJ2-7
TGTGCCAGCAGCCAAGCCCCGAGGTTAAAAGGGACAGAGAACACTGAAGCTTTCTTT	CASSQAPRLKGTENTEAFF	TRBV14	TRBJ1-1
TGTGCCAGCTCACCGGGTTCCGGGGCATCACCTAATTCACCCCTCCACTTT	CASSPGSGASPNSPLHF	TRBV18	TRBJ1-6
TGTGCCAGCAGCAGAGCACAGGGCCTTTTTGGTGGTGAAGCTTTCTTT	CASSRAQGLFGGEAFF	TRBV7-9	TRBJ1-1
TGTGCCACCAGTGATGGACAGGGGTCCCCTCAGGAGACCCAGTACTTC	CATSDGQGSPQETQYF	TRBV24-1	TRBJ2-5
TGCGCCAGCAGCCAAGTCCGGGGAGGGGGGGCTGCAACTAATGAAAAACTGTTTTTT	CASSQVRGGGAATNEKLFF	TRBV4-1	TRBJ1-4
TGTGCCAGCAGCCCCTTTCTAGCGGGTCTATTAGCCAAAAACATTCAGTACTTC	CASSPFLAGLLAKNIQYF	TRBV5-4	TRBJ2-4
TGTGCCAGATACAGGGATTATAGCAATCAGCCCCAGCATTTT	CARYRDYSNQPQHF	TRBV6-1	TRBJ1-5
TGTGCCAGCAGTTTAACACCTTGGGCGGTCCTCCCGAACACTGAAGCTTTCTTT	CASSLTPWAVLPNTEAFF	TRBV12-4	TRBJ1-1
TGTGCCACCAGTGATCGTAGCCGAAGGGTCACCTACGAGCAGTACTTC	CATSDRSRRVTYEQYF	TRBV24-1	TRBJ2-7
TGTGCCAGCAGCAAAAGGTCGAGGGTCGGCTCCTACAATGAGCAGTTCTTC	CASSKRSRVGSYNEQFF	TRBV3-1	TRBJ2-1
TGTGCCAGCAGCACAGTACATAGCAATCAGCCCCAGCATTTT	CASSTVHSNQPQHF	TRBV7-3	TRBJ1-5
TGTGCCAGCAGTGTTCTACTGCGCGGGAGCCGGGGACGGGACGAGCAGTACTTC	CASSVLLRGSRGRDEQYF	TRBV12-3	TRBJ2-7
TGTGCCAGCAGTTTAGAAAGCCTAGTCACCCCAAGCTCCTACAATGAGCAGTTCTTC	CASSLESLVTPSSYNEQFF	TRBV12-4	TRBJ2-1
TGTGCCAGCAGCGTCGGCAGGCACTCTGGGGCCAACGTCCTGACTTTC	CASSVGRHSGANVLTF	TRBV7-3	TRBJ2-6
TGTGCCACCAGCAGAGATCGCGCGTTTTCAGGACAGGCGAACACTGAAGCTTTCTTT	CATSRDRAFSGQANTEAFF	TRBV15	TRBJ1-1
TGTGCCAGCAGCTGTCCGGGACAGGGTAGGTTCGCTTACGAGCAGTACTTC	CASSCPGQGRFAYEQYF	TRBV7-2	TRBJ2-7
TGTGCCAGCAGCCCCTGGGGACAGGGAGGGCCCTTAGGGAAGTACGAGCAGTACTTC	CASSPWGQGGPLGKYEQYF	TRBV6-8	TRBJ2-7
TGCGCCAGCAGCAGAGTTAGCGAGACGACTGGAAACACCATATATTTT	CASSRVSETTGNTIYF	TRBV5-1	TRBJ1-3
TGTGCCAGCAGTGACAGCCTTGACTATGGCTACACCTTC	CASSDSLDYGYTF	TRBV6-2	TRBJ1-2
TGTGCCAGCAGCGAAGGGGCCGGCTACACCTTC	CASSEGAGYTF	TRBV13	TRBJ1-2
TGTGCCAGCAGTAGGCCTGGACAGGGACTCCCACCTTTACATCAGCCCCAGCATTTT	CASSRPGQGLPPLHQPQHF	TRBV12-3	TRBJ1-5
TGCAGCGTTGGACAGGGGTCTGAAAAACTGTTTTTT	CSVGQGSEKLFF	TRBV29-1	TRBJ1-4
TGTGCCTGGAGTGCCTCATACGCCTACGAGCAGTACTTC	CAWSASYAYEQYF	TRBV30	TRBJ2-7
TGTGCCAGCAGCGTAGACCCGGGACAGGGAGTGAGCATGAACACTGAAGCTTTCTTT	CASSVDPGQGVSMNTEAFF	TRBV9	TRBJ1-1
TGTGCCAGCAGCTTAGCCGGGACAGCGGAGCTGGGAAACTCTGGAAACACCATATATTTT	CASSLAGTAELGNSGNTIYF	TRBV7-8	TRBJ1-3
TGTGCCAGCAGCTTAGACAAACTAGCGGGATTCTATTATTTT	CASSLDKLAGFYYF	TRBV7-2	TRBJ2-3
TGCGCCAGCAGCCAAGATAACGGACAGATACCTAACTATGGCTACACCTTC	CASSQDNGQIPNYGYTF	TRBV4-1	TRBJ1-2
TGTGCCAGCAGAAGACCTGTGGGGACAGGGGGGCCCTCTGGAAACACCATATATTTT	CASRRPVGTGGPSGNTIYF	TRBV3-1	TRBJ1-3
TGCGCCAGCAGCTTGAACCGGGGGCCCTTTTATAGCAATCAGCCCCAGCATTTT	CASSLNRGPFYSNQPQHF	TRBV5-1	TRBJ1-5
TGTGCCAGCAGTAAAGCAGGGGGCTCTTTCCCCAAAAACATTCAGTACTTC	CASSKAGGSFPKNIQYF	TRBV6-1	TRBJ2-4
TGCGCCAGCAGCCAAGCCCCTGGGATCCACACTAATGAAAAACTGTTTTTT	CASSQAPGIHTNEKLFF	TRBV4-3	TRBJ1-4
TGTGCCAGCAGCTCGACCTGGGGACAGGATGAGCAGTTCTTC	CASSSTWGQDEQFF	TRBV5-4	TRBJ2-1
TGCAGCGTGGGTGATCGAACCGGGGAGCTGTTTTTT	CSVGDRTGELFF	TRBV29-1	TRBJ2-2
TGTGCCAGCACCCCCATCGAGCTGTTTACAGGGATACGATATGGCTACACCTTC	CASTPIELFTGIRYGYTF	TRBV6-5	TRBJ1-2
TGTGCCAGCAGCACCACACAGGGCAGGACCCGCGCGACCTACGAGCAGTACTTC	CASSTTQGRTRATYEQYF	TRBV5-5	TRBJ2-7
TGTGCCAGCGTGGGGGGGAGCTCTGGGGCCAACGTCCTGACTTTC	CASVGGSSGANVLTF	TRBV27	TRBJ2-6
TGTGCCAGCAGCGTCGGGAGGGAGGGGGGGCAAGAGACCCAGTACTTC	CASSVGREGGQETQYF	TRBV12-4	TRBJ2-5
TGTGCCAGCTCACCGGAAGTGCGCCCCTACGAGCAGTACTTC	CASSPEVRPYEQYF	TRBV18	TRBJ2-7
TGTGCCAGCAGCGGGATCACACTAGCGGGAGAAAACACTGAAGCTTTCTTT	CASSGITLAGENTEAFF	TRBV13	TRBJ1-1
TGTGCTAGTGGTTTGCCGACCTACAGGGATGAGCAGTTCTTC	CASGLPTYRDEQFF	TRBV12-5	TRBJ2-1
TGTGCCAGCAGCTTGCACCCCTACACCACACGGACCTACGAGCAGTACTTC	CASSLHPYTTRTYEQYF	TRBV11-2	TRBJ2-7
TGTGCCAGTAAAGGGTTCCGGGACGAGGGCTACGAGCAGTACTTC	CASKGFRDEGYEQYF	TRBV2	TRBJ2-7
TGTGCGGGACAGGGGGCTTCACCCCTCCACTTT	CAGQGASPLHF	TRBV2	TRBJ1-6
TGCGCCAGCAGCTTGGAGGGACAGGGGGGTACTGGAAACACCATATATTTT	CASSLEGQGGTGNTIYF	TRBV5-1	TRBJ1-3
TGTGCCAGCATACGGACAGCAATCTATAATTCACCCCTCCACTTT	CASIRTAIYNSPLHF	TRBV6-5	TRBJ1-6
TGTGCCAGCAGTTTATCGAGATCTGATACGCAGTATTTT	CASSLSRSDTQYF	TRBV27	TRBJ2-3
TGTGCCAGCAGAGGACCGGCCGGGTTCATGAACACTGAAGCTTTCTTT	CASRGPAGFMNTEAFF	TRBV13	TRBJ1-1
TGTGCCAGCAGCGGAAGAGGGGGGGCAGCAGATACGCAGTATTTT	CASSGRGGAADTQYF	TRBV13	TRBJ2-3
TGTGCCAGCAGCCCATCCGAGGCGCGGCCCTATAATTCACCCCTCCACTTT	CASSPSEARPYNSPLHF	TRBV7-3	TRBJ1-6
TGTGCCAGCAGTGACCTACCCACTAGCGTTCCAGACACAGATACGCAGTATTTT	CASSDLPTSVPDTDTQYF	TRBV6-1	TRBJ2-3
TGTGCCAGCAGCTTAAATCCCTTAAGCGGGGGCCGAAACACCGGGGAGCTGTTTTTT	CASSLNPLSGGRNTGELFF	TRBV7-3	TRBJ2-2
TGTGCCACCAGTGATGTCCTTTCGTTGGCCTACGAGCAGTACTTC	CATSDVLSLAYEQYF	TRBV24-1	TRBJ2-7
TGCAGCGTTGAAGTACCCCTGGGACAGGGAATGGAGCAGTACTTC	CSVEVPLGQGMEQYF	TRBV29-1	TRBJ2-7
TGTGCCAGCCCCAACCTGGGGGGCTGGGGTCAAGAGACCCAGTACTTC	CASPNLGGWGQETQYF	TRBV7-6	TRBJ2-5
TGTGCCAGCAGAAGGACAGGCGCCTATGGCTACACCTTC	CASRRTGAYGYTF	TRBV6-5	TRBJ1-2
TGCGCCAGCAGCTTGGCCCCGCGGGACGGCGGGGACGAGCAGTACTTC	CASSLAPRDGGDEQYF	TRBV5-1	TRBJ2-7
TGTGCCAGTAGTATGCCGAAAGCTAACTATGGCTACACCTTC	CASSMPKANYGYTF	TRBV19	TRBJ1-2
TGTGCCAGCAGCTCCAAACAGGGCGAGCAGTACTTC	CASSSKQGEQYF	TRBV13	TRBJ2-7
TGTGCCAGCAGCAATCCCAGGACAGGGGGCACGGAAGAGACCCAGTACTTC	CASSNPRTGGTEETQYF	TRBV7-2	TRBJ2-5
TGTGCCAGCAGCCCCTATGGGTCCCCGAAACGTCCAGCCTACAATGAGCAGTTCTTC	CASSPYGSPKRPAYNEQFF	TRBV13	TRBJ2-1
TGTGCCTGGAAAAGCCACCATAGCAATCAGCCCCAGCATTTT	CAWKSHHSNQPQHF	TRBV30	TRBJ1-5
TGTGCCAGCAGTTCAAACCGGAGTACCCCTAATTACGAGCAGTACTTC	CASSSNRSTPNYEQYF	TRBV27	TRBJ2-7
TGTGCCAGCAGCCTTACACCTACTGAAGCTTTCTTT	CASSLTPTEAFF	TRBV7-9	TRBJ1-1
TGTGCCAGCAGCGCCGGACAGGGGACCGCCCAGCATTTT	CASSAGQGTAQHF	TRBV9	TRBJ1-5
TGTGCCAGCAGTAGGACCCGGTTTAACGGAGAGACCCAGTACTTC	CASSRTRFNGETQYF	TRBV27	TRBJ2-5
TGTGCCAGCAGCAGGGATCGTCAGAGAGATACGCAGTATTTT	CASSRDRQRDTQYF	TRBV13	TRBJ2-3
TGCAGTGCTAGCATAAACACAGGGGGGGAATTCTTTCCTTACAATGAGCAGTTCTTC	CSASINTGGEFFPYNEQFF	TRBV20-1	TRBJ2-1
TGTGCCACACCGCAAGATACGCAGTATTTT	CATPQDTQYF	TRBV6-1	TRBJ2-3
TGTGCCAGCAGCCCCGGCTTAGGGACAGGAAGCTCCTATAATTCACCCCTCCACTTT	CASSPGLGTGSSYNSPLHF	TRBV7-3	TRBJ1-6
TGCGAGACGGCGAGCTCCTACGAGCAGTACTTC	CETASSYEQYF	TRBV10-1	TRBJ2-7
TGTGCCACCAGCAGAGATTCAGGGAGGGAAACAAAGAGGGGGATGGAGCAGTACTTC	CATSRDSGRETKRGMEQYF	TRBV15	TRBJ2-7
TGCAGTCGGGCAGTTCGGGGGAATGAGCAGTTCTTC	CSRAVRGNEQFF	TRBV20-1	TRBJ2-1
TGTGCCAGCAGCCCCAGGGGGGGAGGGGGAAACACCATATATTTT	CASSPRGGGGNTIYF	TRBV5-4	TRBJ1-3
TGCAGTGCTAGAGACTTCCAGAGACATCCGAGCAATCAGCCCCAGCATTTT	CSARDFQRHPSNQPQHF	TRBV20-1	TRBJ1-5
TGTGCCACCAGTGATCCTGGTAGCGGGGAGCATGAGCAGTTCTTC	CATSDPGSGEHEQFF	TRBV24-1	TRBJ2-1
TGTGCCAGCAGCAAAAAGTCTATCAGGTTAGCGGGTAGGCGCTACAATGAGCAGTTCTTC	CASSKKSIRLAGRRYNEQFF	TRBV7-9	TRBJ2-1
TGTGCCAGCAGCTTCTCCGGGACAGGGGCAGATACGCAGTATTTT	CASSFSGTGADTQYF	TRBV11-3	TRBJ2-3
TGTGCCAGCAGCCAAGTGGTCGGGGGCCCTAACTATGGCTACACCTTC	CASSQVVGGPNYGYTF	TRBV3-1	TRBJ1-2
TGTGCCAGCAGCCCCCTGGCCCGCGGGACAGGGCAAGCTTTCTTT	CASSPLARGTGQAFF	TRBV7-2	TRBJ1-1
TGCAGTGCTAGGTGCACCGGGGAGCTGTTTTTT	CSARCTGELFF	TRBV20-1	TRBJ2-2
TGCGCCAGCAATCGCAGGAGCTCCTACGAGCAGTACTTC	CASNRRSSYEQYF	TRBV10-1	TRBJ2-7
TGTGCCAGCAGCTTAGCGGAAAGCACTAGCGGGGGCTACGAGCAGTACTTC	CASSLAESTSGGYEQYF	TRBV7-9	TRBJ2-7
TGTGCCAGCTCACCACACCGACAAATCACTGAAGCTTTCTTT	CASSPHRQITEAFF	TRBV18	TRBJ1-1
TGTGCCAGCAGTTTATTGCGGGGACAGGGCTACGAGCAGTACTTC	CASSLLRGQGYEQYF	TRBV27	TRBJ2-7
TGTGCCAGCACTTCCATCGGGACCGGAAATGAGCAGTTCTTC	CASTSIGTGNEQFF	TRBV6-4	TRBJ2-1
TGTGCCAGCAGTTTAGCGTCCTGTGTCGGGACAGGTCCGAGGCGGGGGACCCAGTACTTC	CASSLASCVGTGPRRGTQYF	TRBV12-3	TRBJ2-5
TGTGCCAGCAGCTTCGAGAATAGGACAGGGGGCGTTTTCGACACCGGGGAGCTGTTTTTT	CASSFENRTGGVFDTGELFF	TRBV7-9	TRBJ2-2
TGTGCCAGCAGCTTAACAGGGTCCGCGAACACCGGGGAGCTGTTTTTT	CASSLTGSANTGELFF	TRBV5-6	TRBJ2-2
TGTGCCATTGACGTCGAGCAGTACTTC	CAIDVEQYF	TRBV6-4	TRBJ2-7
TGCAGCGCCGTCGGACCTGATGAGACCTACGAGCAGTACTTC	CSAVGPDETYEQYF	TRBV29-1	TRBJ2-7
TGTGCCAGTAGTACCACTAGCGGGAGGGCCGTGCAGCCCCAGCATTTT	CASSTTSGRAVQPQHF	TRBV19	TRBJ1-5
TGTGCCAGCAGAGTGACTAGCGGGTCAGATACGCAGTATTTT	CASRVTSGSDTQYF	TRBV25-1	TRBJ2-3
TGTGCCAGCAGTTACTCGGATGTCTCCTGTCGGGGGGGCAACTACGAGCAGTACTTC	CASSYSDVSCRGGNYEQYF	TRBV6-5	TRBJ2-7
TGCGCCAGCAGCCCGCGGGAGCTGAACACTGAAGCTTTCTTT	CASSPRELNTEAFF	TRBV4-1	TRBJ1-1
TGCAGTGCTAGAGTTGGGACTAGATACCATCAAGAGACCCAGTACTTC	CSARVGTRYHQETQYF	TRBV20-1	TRBJ2-5
TGCAGTGCTAGAGCCAGGGACAGGGGGGAATGGGCCGCTGAAGCTTTCTTT	CSARARDRGEWAAEAFF	TRBV20-1	TRBJ1-1
TGTGCCAGCAGCCGGGGGAAAGACAGGGTGTACAATGAGCAGTTCTTC	CASSRGKDRVYNEQFF	TRBV11-2	TRBJ2-1
TGTGCCACCAGCAGACGGGCGGACAGGGCGGATTCGAACACCGGGGAGCTGTTTTTT	CATSRRADRADSNTGELFF	TRBV15	TRBJ2-2
TGTGCCAGCAGCTTAGGCGGGGGTATGGGAAGGCACAATGAGCAGTTCTTC	CASSLGGGMGRHNEQFF	TRBV11-3	TRBJ2-1
TGTGCCAGCAGCTTTGCCCTAGCGGGACCAAAGCCCTACACCGGGGAGCTGTTTTTT	CASSFALAGPKPYTGELFF	TRBV7-9	TRBJ2-2
TGTGCCAGCAGCTGGCGTCTTAAGGGGGGGACTGGGGCCAACGTCCTGACTTTC	CASSWRLKGGTGANVLTF	TRBV5-4	TRBJ2-6
TGTGCCACAACAGGGATTAGGCTTGGTGGACCTGAAAAACTGTTTTTT	CATTGIRLGGPEKLFF	TRBV7-9	TRBJ1-4
TGTGCCAGCAGTAATACAGGGAGGCATCAGCCCCAGCATTTT	CASSNTGRHQPQHF	TRBV27	TRBJ1-5
TGTGCCAGCAGCCTAAGCATCCCTAGCGGGGGGGCCTCTTCCTACGAGCAGTACTTC	CASSLSIPSGGASSYEQYF	TRBV12-3	TRBJ2-7
TGTGCCAGCCGGGCTGGTTGGTGTGAAGCTTTCTTT	CASRAGWCEAFF	TRBV27	TRBJ1-1
TGTGCCAGCAGCGCCGTCAGGGTAGCCGGGACTAGGTGGACCACCGGGGAGCTGTTTTTT	CASSAVRVAGTRWTTGELFF	TRBV9	TRBJ2-2
TGTGCCAGCAGTGAATACGAAGTTAGCAATCAGCCCCAGCATTTT	CASSEYEVSNQPQHF	TRBV25-1	TRBJ1-5
TGTGCCAGCAGTGGGGTTCGTGACGAGCAGTACTTC	CASSGVRDEQYF	TRBV6-3	TRBJ2-7
TGCAGTGGTGAACGGGACAGGGCGGCTTACAATGAGCAGTTCTTC	CSGERDRAAYNEQFF	TRBV20-1	TRBJ2-1
TGTGCCAGCAGTGACTCCAGACAGGCATTTAGCAATCAGCCCCAGCATTTT	CASSDSRQAFSNQPQHF	TRBV6-4	TRBJ1-5
TGTGCTAGTGGGAGGGGGCCCCCCCTCCACTTT	CASGRGPPLHF	TRBV12-5	TRBJ1-6
TGTGCCAGCAGCTTTAGGGACAGCGAGAAGATGAACACTGAAGCTTTCTTT	CASSFRDSEKMNTEAFF	TRBV11-3	TRBJ1-1
TGTGCCTGGAGACCGGGACTAGCGGGAGTTTCGCTACCCTACGAGCAGTACTTC	CAWRPGLAGVSLPYEQYF	TRBV30	TRBJ2-7
TGTGCCAGCAGCTTCCGGGACAATGGCAATCAGCCCCAGCATTTT	CASSFRDNGNQPQHF	TRBV11-1	TRBJ1-5
TGTGCCAGCAGCTTAACCCCGGGACTAGCGGGAGCGAGGGTATATCAGCCCCAGCATTTT	CASSLTPGLAGARVYQPQHF	TRBV11-2	TRBJ1-5
TGTGCCACCGGGGCGGGAAGGTCGACTAATGAAAAACTGTTTTTT	CATGAGRSTNEKLFF	TRBV24-1	TRBJ1-4
TGTGCCAGCAGTGAAGCGGCCGACCGGAACACTGAAGCTTTCTTT	CASSEAADRNTEAFF	TRBV2	TRBJ1-1
TGTGCCAGCAGGGAGCTGACTAGCGGTTTGCAAGAGACCCAGTACTTC	CASRELTSGLQETQYF	TRBV6-4	TRBJ2-5
TGTGCCAGCAGGTCCCCCGGGACACTGCCGCCGGATCAGCCCCAGCATTTT	CASRSPGTLPPDQPQHF	TRBV25-1	TRBJ1-5
TGTGCCAGCATCCGAGGGCCGAGCGACGAGCAGTACTTC	CASIRGPSDEQYF	TRBV12-3	TRBJ2-7
TGTGCCAGCAGTTACTCGGCGGGAGTTAGATCCTACAATGAGCAGTTCTTC	CASSYSAGVRSYNEQFF	TRBV6-5	TRBJ2-1
TGTGCCAGCAGTATAGGGGTTAGCTCCTACAATGAGCAGTTCTTC	CASSIGVSSYNEQFF	TRBV6-3	TRBJ2-1
TGTGCCAGCAGCTTAGCGCCCCAACTAGCGGGGGCATACAATGAGCAGTTCTTC	CASSLAPQLAGAYNEQFF	TRBV7-2	TRBJ2-1
TGTGCCAGTAGGAGACAGGTCTCCTACGAGCAGTACTTC	CASRRQVSYEQYF	TRBV19	TRBJ2-7
TGCAGTGCTAGAGTTGGGCATAATTCACCCCTCCACTTT	CSARVGHNSPLHF	TRBV20-1	TRBJ1-6
TGCAGCGTTGAAACCGGATCGAGGGAAAGACCCCTCCACTTT	CSVETGSRERPLHF	TRBV29-1	TRBJ1-6
TGCGCCAGCAGCTTGATCGCAGAACACAATCAGCCCCAGCATTTT	CASSLIAEHNQPQHF	TRBV5-1	TRBJ1-5
TGTGCCAGCAGTTACTCGACCAATCACAGGGGCCATAAAAAACATCAGCCCCAGCATTTT	CASSYSTNHRGHKKHQPQHF	TRBV6-6	TRBJ1-5
TGTGTTGCTAGGGGACAGGGCTACGAGCAGTACTTC	CVARGQGYEQYF	TRBV24-1	TRBJ2-7
TGTGCCAGCAGCCTTGGTTTACCACAGGGCACTGAAGCTTTCTTT	CASSLGLPQGTEAFF	TRBV13	TRBJ1-1
TGCGCCAGCAGCTTGCCGTTCGATAGCGGGGTATCCACAGATACGCAGTATTTT	CASSLPFDSGVSTDTQYF	TRBV5-1	TRBJ2-3
TGTGCCAGCAGGGACAGGGGGGGGAACACTGAAGCTTTCTTT	CASRDRGGNTEAFF	TRBV6-4	TRBJ1-1
TGTGCCAGCAGTGAGGGGTGGATGGGACGAAATGAGCAGTTCTTC	CASSEGWMGRNEQFF	TRBV6-1	TRBJ2-1
TGTGCCATCAAGGATGCGCGACAGGGTCAGCCCCAGCATTTT	CAIKDARQGQPQHF	TRBV10-3	TRBJ1-5
TGTGCCAGGAGGAGGGCCGAGCAGTACTTC	CARRRAEQYF	TRBV3-1	TRBJ2-7
TGTGCCAGCAGTTTAACCGCCGGGGGGGACACTGAAGCTTTCTTT	CASSLTAGGDTEAFF	TRBV28	TRBJ1-1
TGTGCCAGCAGTGACTCGTCTGGAGGGGGGTGGGCTTTCTTT	CASSDSSGGGWAFF	TRBV6-4	TRBJ1-1
TGTGCCTGGAGTGTTAGGGAACTACAGAGTAGAACCACCGGGGAGCTGTTTTTT	CAWSVRELQSRTTGELFF	TRBV30	TRBJ2-2
TGTGCGACGATGGGGGGGTTATATGAGCAGTTCTTC	CATMGGLYEQFF	TRBV11-3	TRBJ2-1
TGTGCCCCTAGGAGGGGGGACGAGCAGTACTTC	CAPRRGDEQYF	TRBV6-4	TRBJ2-7
TGTGCCACCAGCTCGGACCGAAAAGAGACCCAGTACTTC	CATSSDRKETQYF	TRBV15	TRBJ2-5
TGTGCCAGCAGCGTCCGGTACGACATTCAGTACTTC	CASSVRYDIQYF	TRBV7-7	TRBJ2-4
TGTGCCAGCGCAAAGCGGACAGGGGTGTGTGAAAAACTGTTTTTT	CASAKRTGVCEKLFF	TRBV6-4	TRBJ1-4
TGTGCCAGCAGCTTAGCAGGGGGGGGTCGAAGCAATCAGCCCCAGCATTTT	CASSLAGGGRSNQPQHF	TRBV11-2	TRBJ1-5
TGCAGCCGCAAGATGGACGGGGAGCTGTTTTTT	CSRKMDGELFF	TRBV29-1	TRBJ2-2
TGTGCCAGCAGCAGAAGCGGGAGACATAGCACAGATACGCAGTATTTT	CASSRSGRHSTDTQYF	TRBV7-9	TRBJ2-3
TGTGCCAGCAGTTCTAGAGGGCCAGGGGGTGACGAGCAGTACTTC	CASSSRGPGGDEQYF	TRBV27	TRBJ2-7
TGTGCCAGCTTGAGGGGGCTCAGCTCCTACGAGCAGTACTTC	CASLRGLSSYEQYF	TRBV6-1	TRBJ2-7
TGTGCCAGTAACCCAGAAGTTGATGAAAAACTGTTTTTT	CASNPEVDEKLFF	TRBV19	TRBJ1-4
TGCAGTGCTAGATCACTAGCGGGAGGGCGAGTTTACCGGGATAATCAGCCCCAGCATTTT	CSARSLAGGRVYRDNQPQHF	TRBV20-1	TRBJ1-5
TGTGCCAGTAGTGGAGGGGGGGCCTACAATGAGCAGTTCTTC	CASSGGGAYNEQFF	TRBV19	TRBJ2-1
TGTGCCAGCAGTTTATCCCTGACGACGGTGGCCTACGAGCAGTACTTC	CASSLSLTTVAYEQYF	TRBV28	TRBJ2-7
TGTGCCAGCAGCCGTTGCGGGAGTAAGGTCCTCGAGCAGTACTTC	CASSRCGSKVLEQYF	TRBV7-3	TRBJ2-7
TGCGCCAGGCAATACGGAGGAAACACCATATATTTT	CARQYGGNTIYF	TRBV4-1	TRBJ1-3
TGTGCCAGCAGCGGCGTACACCGGGAGAACACTGAAGCTTTCTTT	CASSGVHRENTEAFF	TRBV14	TRBJ1-1
TGTGCCAGCAGTTTTGGAACGCCCAATGAGCAGTTCTTC	CASSFGTPNEQFF	TRBV28	TRBJ2-1
TGTGCCTGGAGTGTATCTGAGGACTACGAGCAGTACTTC	CAWSVSEDYEQYF	TRBV30	TRBJ2-7
TGTGCCAGCAGCCAATGCCGACTAGTATGCGAGCAGTACTTC	CASSQCRLVCEQYF	TRBV7-2	TRBJ2-7
TGTGCCAGCAGTGATCGAAGGGGGTCCTACGAGCAGTACTTC	CASSDRRGSYEQYF	TRBV6-4	TRBJ2-7
TGCAGTGCTAGAGCCCGGACAGGAGGGAGTGGCCGCACCGGGGAGCTGTTTTTT	CSARARTGGSGRTGELFF	TRBV20-1	TRBJ2-2
TGTGCCAGCAGCGTACCGGGGCCTCAGGTAACTAATGAAAAACTGTTTTTT	CASSVPGPQVTNEKLFF	TRBV9	TRBJ1-4
TGTGCCAAAGACAGGGGTGTTAATGAGCAGTTCTTC	CAKDRGVNEQFF	TRBV28	TRBJ2-1
TGTGCCAGCTCACCATCCGAAGGAAAAGTCGGCGACCAAGAGACCCAGTACTTC	CASSPSEGKVGDQETQYF	TRBV18	TRBJ2-5
TGTGCCAGCAGTAGAAAATACCAAAAGGGGGCTCGTACAGATACGCAGTATTTT	CASSRKYQKGARTDTQYF	TRBV28	TRBJ2-3
TGTGCCCCCGAGTGTAAAGAGACCCAGTACTTC	CAPECKETQYF	TRBV19	TRBJ2-5
TGTGCCAGCAGCGCCGGGCTCTACGAGCAGTACTTC	CASSAGLYEQYF	TRBV9	TRBJ2-7
TGCAGTGCTAGAGCGGCAGGCGGAGGGATTCATGAGCAGTTCTTC	CSARAAGGGIHEQFF	TRBV20-1	TRBJ2-1
TGTGCCAGCAGTTTGGAACTATCCCAGAGCATCCATCAGCCCCAGCATTTT	CASSLELSQSIHQPQHF	TRBV27	TRBJ1-5
TGCAGCGGTTTTCCTCAGAACGAGCAGTACTTC	CSGFPQNEQYF	TRBV29-1	TRBJ2-7
TGTGCCAGCAGTCACAGCGGGGCTGGGGCCAACGTCCTGACTTTC	CASSHSGAGANVLTF	TRBV6-6	TRBJ2-6
TGTGCCAGCAGTGGGACAGGGGGAAATAATTCACCCCTCCACTTT	CASSGTGGNNSPLHF	TRBV12-3	TRBJ1-6
TGTGCCACCAGCGAGACTAGCGCGTACCAGTATGGCACAGATACGCAGTATTTT	CATSETSAYQYGTDTQYF	TRBV15	TRBJ2-3
TGTGCCAGCAGCTTGTCTACCCGTAGCGGGGTCGGTTACGAGCAGTACTTC	CASSLSTRSGVGYEQYF	TRBV7-8	TRBJ2-7
TGTGCCAGCAGCCAAGATAGAGTTGAAAAACTGTTTTTT	CASSQDRVEKLFF	TRBV14	TRBJ1-4
TGCAGCGTTGAAGATAGTCCAGGGGGGCTGGATGAGCAGTTCTTC	CSVEDSPGGLDEQFF	TRBV29-1	TRBJ2-1
TGTGCCAGCAGCTTAGCTATCCCACAGATGTCGAGGACCCCCCTACGGTACGAGCAGTACTTC	CASSLAIPQMSRTPLRYEQYF	TRBV11-2	TRBJ2-7
TGTGCCACCAGTGACACGACAGGGGACTCAACTAATGAAAAACTGTTTTTT	CATSDTTGDSTNEKLFF	TRBV24-1	TRBJ1-4
TGTGCCAGCAGCTTGCCTAGGATAACGGCAGGCCCTGGGAATACCGGGGAGCTGTTTTTT	CASSLPRITAGPGNTGELFF	TRBV5-6	TRBJ2-2
TGTGCCAGCAGCTTGGCAACGCGCGGGGCCCTGGCTAACTATGGCTACACCTTC	CASSLATRGALANYGYTF	TRBV5-6	TRBJ1-2
TGTGCCAGCAGCTTGGCCGGGAAATATCCAAATGAGCAGTTCTTC	CASSLAGKYPNEQFF	TRBV5-8	TRBJ2-1
TGTGCCATCTCAGTGCACTATGGCTACACCTTC	CAISVHYGYTF	TRBV6-2	TRBJ1-2
TGTGCCAGCTCGAGCCGGGTAAGCGGGTACAATGAGCAGTTCTTC	CASSSRVSGYNEQFF	TRBV18	TRBJ2-1
TGTGCCACACTGGGACGGGGCGAGCAGTACTTC	CATLGRGEQYF	TRBV10-3	TRBJ2-7
TGTGCCAGCCGTCCAGGAACGAACACCGGGGAGCTGTTTTTT	CASRPGTNTGELFF	TRBV6-5	TRBJ2-2
TGTGCCAGCCTCGAGGGTAAAGGTGAGCAGTTCTTC	CASLEGKGEQFF	TRBV19	TRBJ2-1
TGTGCCAGCAGTGTTCCGGGGGACACTGAAGCTTTCTTT	CASSVPGDTEAFF	TRBV27	TRBJ1-1
TGTGCCAGCAGCTGGCACGTAGGACAGGGGACCCAGCCCCAGCATTTT	CASSWHVGQGTQPQHF	TRBV6-2	TRBJ1-5
TGTGCCAGCAGCTTAGTAAGAAGCGGCTGGCAAGAGACCCAGTACTTC	CASSLVRSGWQETQYF	TRBV13	TRBJ2-5
TGTGCCAGGACAGGACAAGAGACCCAGTACTTC	CARTGQETQYF	TRBV28	TRBJ2-5
TGTGCCAGCAGCGGACTAGCGGGGGGGCTACACTACGAGCAGTACTTC	CASSGLAGGLHYEQYF	TRBV3-1	TRBJ2-7
TGTGCCAGCAGTTTCCCCAGGCTGGCGGCGCGGGAGATGGCCCAGTACTTC	CASSFPRLAAREMAQYF	TRBV12-4	TRBJ2-5
TGCGCCAGCAGCCAAGACCGTGGGCTCTTGCATTTT	CASSQDRGLLHF	TRBV4-1	TRBJ1-5
TGTGCCAGCAGCTTGGGGGGGGAAGGCACAGATACGCAGTATTTT	CASSLGGEGTDTQYF	TRBV5-4	TRBJ2-3
TGTGCTAGTGGTTTGGTGGACAGTCGAAGCAATCAGCCCCAGCATTTT	CASGLVDSRSNQPQHF	TRBV12-5	TRBJ1-5
TGCAGTTTTCGGATCAATGAGCAGTTCTTC	CSFRINEQFF	TRBV20-1	TRBJ2-1
TGTGCCAGCAGCAACGGGGGTTTTAACACAGATACGCAGTATTTT	CASSNGGFNTDTQYF	TRBV6-2	TRBJ2-3
TGTGCCACCACCCGGGACACTCCTAACTATGGCTACACCTTC	CATTRDTPNYGYTF	TRBV24-1	TRBJ1-2
TGTGCCAGCAGCCAATTCCCCCGGGGCCCAACCTATGGCTACACCTTC	CASSQFPRGPTYGYTF	TRBV3-1	TRBJ1-2
TGTGCCCCAGCGGAACACACCGGGGAGCTGTTTTTT	CAPAEHTGELFF	TRBV5-4	TRBJ2-2
TGTGCCAGCAGTTCCCAAAGGATCGACAGCACTGAAGCTTTCTTT	CASSSQRIDSTEAFF	TRBV6-8	TRBJ1-1
TGTGCCAGCAGTGAACACACCGGGACTGTTGAGACCCAGTACTTC	CASSEHTGTVETQYF	TRBV6-4	TRBJ2-5
TGTGCCAGCAGCTGTGGACTAGAGACCCAGTACTTC	CASSCGLETQYF	TRBV5-4	TRBJ2-5
TGCAGCGTCCGGACAGGGAACACTGAAGCTTTCTTT	CSVRTGNTEAFF	TRBV29-1	TRBJ1-1
TGTGCCAGCTTCCGTATGACACATCAGCCCCAGCATTTT	CASFRMTHQPQHF	TRBV27	TRBJ1-5
TGTGCTAGTGGTAGTCAATGTAGGGGCGTGATCAGAGATACGCAGTATTTT	CASGSQCRGVIRDTQYF	TRBV12-5	TRBJ2-3
TGTGCCAGCAGCAAAAAAGACAGGGGGCGCCTTAACTATGGCTACACCTTC	CASSKKDRGRLNYGYTF	TRBV7-4	TRBJ1-2
TGCAAAAAGGCCCGGGACAGGGGGATCACAGATACGCAGTATTTT	CKKARDRGITDTQYF	TRBV20-1	TRBJ2-3
TGTGCCAGCAGCCGGGACAGGGACCCCCACACCGGGGAGCTGTTTTTT	CASSRDRDPHTGELFF	TRBV12-4	TRBJ2-2
TGTGCCAGCAGAAGGCCACAAGAGACCCAGTACTTC	CASRRPQETQYF	TRBV28	TRBJ2-5
TGTGCCAGCAGTAAGCGGGCCATGTATGAAAAACTGTTTTTT	CASSKRAMYEKLFF	TRBV6-4	TRBJ1-4
TGTGCCAGCAGTGGTATAAGGGAGGGGATGGAGTATGGCTACACCTTC	CASSGIREGMEYGYTF	TRBV27	TRBJ1-2
TGTGCCACCCCCCGGGACACGAATTCACCCCTCCACTTT	CATPRDTNSPLHF	TRBV24-1	TRBJ1-6
TGTGCCAGCAGCGTTAGCGGGACCCTAGCCAAAAACATTCAGTACTTC	CASSVSGTLAKNIQYF	TRBV7-9	TRBJ2-4
TGTGCCAGCAGTGATACGGGGAGCAATGAGCAGTTCTTC	CASSDTGSNEQFF	TRBV12-3	TRBJ2-1
TGTGCCATCAGTGCTTACCCCCGGGACGAGCTAGGGGACCAAGAGACCCAGTACTTC	CAISAYPRDELGDQETQYF	TRBV10-3	TRBJ2-5
TGTGCCAGCACGGACAGGGGAAGGATATGCAATCAGCCCCAGCATTTT	CASTDRGRICNQPQHF	TRBV6-4	TRBJ1-5
TGTGCCAGCTCAGGGACAGGAGGCAGCAATCAGCCCCAGCATTTT	CASSGTGGSNQPQHF	TRBV2	TRBJ1-5
TGCGCCAGCAGACAGACTAGAGATACGCAGTATTTT	CASRQTRDTQYF	TRBV5-1	TRBJ2-3
TGTGCCAGCAGCGTAGCTTCGGCTGGACTGAACACTGAAGCTTTCTTT	CASSVASAGLNTEAFF	TRBV9	TRBJ1-1
TGCGCCAGCAGCCCCGTACGGTGTGGCTACACCTTC	CASSPVRCGYTF	TRBV5-1	TRBJ1-2
TGTGCCTGGAGCGGACAGGGCTACGAGCAGTACTTC	CAWSGQGYEQYF	TRBV30	TRBJ2-7
TGTGCCAGCAGCTGTTGGGATCCGGGACTAGCCCTTCTTAACCCTTGCTACGAGCAGTACTTC	CASSCWDPGLALLNPCYEQYF	TRBV11-3	TRBJ2-7
TGTGCCAGCAGCCAGGGTGGCCCTACCTACGAGCAGTACTTC	CASSQGGPTYEQYF	TRBV14	TRBJ2-7
TGTGCCAGCAGCAATGGCCGAGGGGATGGCTACACCTTC	CASSNGRGDGYTF	TRBV7-3	TRBJ1-2
TGTGCCAGCAGTACTTGGGACATACCCGATACGCAGTATTTT	CASSTWDIPDTQYF	TRBV6-1	TRBJ2-3
TGTGCCAGCAGGTTGGGACAGGAGGGGGATGAAAAACTGTTTTTT	CASRLGQEGDEKLFF	TRBV9	TRBJ1-4
TGTGCCACCAAGGGGTCGCATGAGCAGTTCTTC	CATKGSHEQFF	TRBV24-1	TRBJ2-1
TGTGCCAGCAGCGCCGGGCAAGAGCAAAACATTCAGTACTTC	CASSAGQEQNIQYF	TRBV13	TRBJ2-4
TGTGCCAGCAGGACAAAACGGGAGGTACAAGAGACCCAGTACTTC	CASRTKREVQETQYF	TRBV25-1	TRBJ2-5
TGTGCCAGCCTGCGGGGTAGGGACACTGAAGCTTTCTTT	CASLRGRDTEAFF	TRBV5-6	TRBJ1-1
TGTGCCAGCAGCTTGCTTGGCCGGACAGATCAGCCCCAGCATTTT	CASSLLGRTDQPQHF	TRBV7-2	TRBJ1-5
TGTGCCAGCAGCGGACAGGGCCCTGGCTACACCTTC	CASSGQGPGYTF	TRBV5-8	TRBJ1-2
TGTGCCAGCAGGAGAATTAGAGGAAGGGCAGGGGGCTACGAGCAGTACTTC	CASRRIRGRAGGYEQYF	TRBV28	TRBJ2-7
TGTGCCAGCAGTGAATTCGGGGGCTACGAGCAGTACTTC	CASSEFGGYEQYF	TRBV6-1	TRBJ2-7
TGTGCCAGCAGAAGTCCAGGAGGTTACACAGATACGCAGTATTTT	CASRSPGGYTDTQYF	TRBV12-3	TRBJ2-3
TGTGCCTGCTACCAGGCAGCTGGGGAACTGGGGAACACTGAAGCTTTCTTT	CACYQAAGELGNTEAFF	TRBV30	TRBJ1-1
TGTGCCAGCTCATTCGACAGCAATCAGCCCCAGCATTTT	CASSFDSNQPQHF	TRBV13	TRBJ1-5
TGCGCCAGCTCAGAACGTCTAAGGATTTACCGTAACACTGAAGCTTTCTTT	CASSERLRIYRNTEAFF	TRBV10-1	TRBJ1-1
TGTGCCAGCAGTTGGGGAGGAGGGAACGCTCCCCAAGAGACCCAGTACTTC	CASSWGGGNAPQETQYF	TRBV28	TRBJ2-5
TGTGCCAGCAGACCAAATCGGGGCACAGATACGCAGTATTTT	CASRPNRGTDTQYF	TRBV6-6	TRBJ2-3
TGTGCCAGCAGGTCAGGGACAGGGACTGAAGCTTTCTTT	CASRSGTGTEAFF	TRBV28	TRBJ1-1
TGCGCCAGCAGGCTTAGCGGGCGGGCTTATGAGCAGTTCTTC	CASRLSGRAYEQFF	TRBV5-1	TRBJ2-1
TGCAGTGCTAGCGGGGGCGAGGAGCAGTACTTC	CSASGGEEQYF	TRBV20-1	TRBJ2-7
TGTGCCAGCAGTTACTCCCGCCAGGGGAGCTGCGAGCAGTACTTC	CASSYSRQGSCEQYF	TRBV6-3	TRBJ2-7
TGTGCCAGCAGTTACAGGGCAAACACTGAAGCTTTCTTT	CASSYRANTEAFF	TRBV6-5	TRBJ1-1
TGTGCCAAAGAGACTAGGTTGGAGACCCAGTACTTC	CAKETRLETQYF	TRBV19	TRBJ2-5
TGTGCCAGTAGTAGTACGGTGGACTCCTATAATTCACCCCTCCACTTT	CASSSTVDSYNSPLHF	TRBV19	TRBJ1-6
TGTGCCAGCAGCCGGGGCCCCCCGTTCTACGAGCAGTACTTC	CASSRGPPFYEQYF	TRBV7-3	TRBJ2-7
TGTGCCTGGAGTGCCCGGTTGGAGGGGGGGACCAAAAGGAAGTACTTC	CAWSARLEGGTKRKYF	TRBV30	TRBJ2-4
TGCGCCAGCCAATCTCCACGGATCAAAGAGACCCAGTACTTC	CASQSPRIKETQYF	TRBV5-1	TRBJ2-5
TGTAGGGGGATCACAGATACGCAGTATTTT	CRGITDTQYF	TRBV10-3	TRBJ2-3
TGCAGTGCTAGACCTACTAGGTCGGAGACCCAGTACTTC	CSARPTRSETQYF	TRBV20-1	TRBJ2-5
TGCAAACGCGTATACGCCTACGAGCAGTACTTC	CKRVYAYEQYF	TRBV20-1	TRBJ2-7
TGTGCCACCCCGCACAGGAAACTGAACACTGAAGCTTTCTTT	CATPHRKLNTEAFF	TRBV15	TRBJ1-1
TGCAGCGTTGCCCTAGCTTATGGCTACACCTTC	CSVALAYGYTF	TRBV29-1	TRBJ1-2
TGTGCCAGCAGGTTAATGTCAGGTTGGGGTGAAAAACTGTTTTTT	CASRLMSGWGEKLFF	TRBV7-8	TRBJ1-4
TGTGCCAGCAGCCAAGGACAGGGGGGTCCTTATAGCAATCAGCCCCAGCATTTT	CASSQGQGGPYSNQPQHF	TRBV4-2	TRBJ1-5
TGCGCCAGCAGCCAATGGCCGGGACAGGGAGTAGATTTATACTACGAGCAGTACTTC	CASSQWPGQGVDLYYEQYF	TRBV4-3	TRBJ2-7
TGTGCCAGCAGGCTGAGGGGGATCTCTGGAAACACCATATATTTT	CASRLRGISGNTIYF	TRBV28	TRBJ1-3
TGTGCCAGCAGCTCGGCCTACGAGCAGTACTTC	CASSSAYEQYF	TRBV7-2	TRBJ2-7
TGCGCCAGCAGCCAAGCCCGAGGGATTAGGTATGGCTACACCTTC	CASSQARGIRYGYTF	TRBV4-3	TRBJ1-2
TGTGCCAGCAGTGACGGGAATCAGCCCCAGCATTTT	CASSDGNQPQHF	TRBV6-4	TRBJ1-5
TGTGCCAGCAGCGCCCCTCTACAGGGTGCCAGAACAGATACGCAGTATTTT	CASSAPLQGARTDTQYF	TRBV9	TRBJ2-3
TGTGCCAGCAGGGACAGGGGCGGCTACGAGCAGTACTTC	CASRDRGGYEQYF	TRBV27	TRBJ2-7
TGCGCCAGCAGCTTGACCGAAGAGACCCAGTACTTC	CASSLTEETQYF	TRBV5-1	TRBJ2-5
TGTGCCAGCAGCTTACCTCGGTCGGTCCCACGGTTGACATCCTACGAGCAGTACTTC	CASSLPRSVPRLTSYEQYF	TRBV5-8	TRBJ2-7
TGTGCCAGCAGTTTACGTGGCGGGGGGAAACACACCGGGGAGCTGTTTTTT	CASSLRGGGKHTGELFF	TRBV27	TRBJ2-2
TGTGCCAGCAGCAAGTCGGGGAGGGGGGCGACTGGCATAAACAATCAGCCCCAGCATTTT	CASSKSGRGATGINNQPQHF	TRBV5-5	TRBJ1-5
TGTGCCACCAGTGATTTGCACGGGGACAATGAGCAGTTCTTC	CATSDLHGDNEQFF	TRBV24-1	TRBJ2-1
TGTGCCAGCAGCGTAGTCGGCAGGGAGAGTTGGGCTGGAAACACCATATATTTT	CASSVVGRESWAGNTIYF	TRBV9	TRBJ1-3
TGCAGTGCTAGAGATAAAAGTGGGGAGAGAGAGACCCAGTACTTC	CSARDKSGERETQYF	TRBV20-1	TRBJ2-5
TGTGCCAGCAGTTATCGACAGGACACCGGGGAGCTGTTTTTT	CASSYRQDTGELFF	TRBV6-2	TRBJ2-2
TGTGCCAGCAGTTACGTACGATTAGGTGACGCCAAGCCTGATGGCTCTCCGACCAACACCATATATTTT	CASSYVRLGDAKPDGSPTNTIYF	TRBV6-6	TRBJ1-3
TGTGCCAGCCGGAACAGGGCCTCTGGAAACACCATATATTTT	CASRNRASGNTIYF	TRBV27	TRBJ1-3
TGTGCCAGCAAGGGACAGGGGAACACCGGGGAGCTGTTTTTT	CASKGQGNTGELFF	TRBV6-1	TRBJ2-2
TGCGCCAGCAGCTCGGGAGGGGGAGGGACGGAAAAACTGTTTTTT	CASSSGGGGTEKLFF	TRBV5-1	TRBJ1-4
TGTGCCAGCAGTTTTAGACAGGAAGATGGCTACACCTTC	CASSFRQEDGYTF	TRBV28	TRBJ1-2
TGTGCCAGCAGCTACTGTGGGGGGCCGGCTCGGACCGGGGAAACAGATACGCAGTATTTT	CASSYCGGPARTGETDTQYF	TRBV7-9	TRBJ2-3
TGCGCCAGCAGCTTTCCGGGCCGAGAAAAACTGTTTTTT	CASSFPGREKLFF	TRBV5-1	TRBJ1-4
TGTGCCAGTAGTATAGATCTCCTGGGGGGGATCTCCTACAATGAGCAGTTCTTC	CASSIDLLGGISYNEQFF	TRBV19	TRBJ2-1
