TGTGCCCCAGTTCCCGGGACATACGAGCAGTACTTC	CAPVPGTYEQYF	TRBV2	TRBJ2-7
TGCAGTGCTAGAGCTAGGATAAAGGATGCACAGGGGAACACTGAAGCTTTCTTT	CSARARIKDAQGNTEAFF	TRBV20-1	TRBJ1-1
TGTGCCAGCAGCTTCACCGACAGGGATCCGGCTGAAGCTTTCTTT	CASSFTDRDPAEAFF	TRBV11-3	TRBJ1-1
TGCGCCAGCAGTGAGCTTTCAGAGCAGTACTTC	CASSELSEQYF	TRBV10-1	TRBJ2-7
TGTGCCAGCAGCTCCCCGACAGATTACACCGGGGAGCTGTTTTTT	CASSSPTDYTGELFF	TRBV5-4	TRBJ2-2
TGTGCCAGCAGCTTGACCGTAACAGTTAGCCGCAATCAGCCCCAGCATTTT	CASSLTVTVSRNQPQHF	TRBV5-4	TRBJ1-5
TGTGCCAGCAGTGATTTGGGACTTTGCTCCTACGAGCAGTACTTC	CASSDLGLCSYEQYF	TRBV6-4	TRBJ2-7
TGTGCCAGCAGCTTACAGGGTAAAGAAAAACTGTTTTTT	CASSLQGKEKLFF	TRBV11-1	TRBJ1-4
TGTGCTAGTGGTTTGGTACAGGTCGGCAACACTGAAGCTTTCTTT	CASGLVQVGNTEAFF	TRBV12-5	TRBJ1-1
TGTGCCAGCAGAGGTACAGGGGGCAGGCTCGCCACTGAAGCTTTCTTT	CASRGTGGRLATEAFF	TRBV12-3	TRBJ1-1
TGTGCTAGTGGTTTGTCGGCGGGACTAGCGGCTGGGGCCAACGTCCTGACTTTC	CASGLSAGLAAGANVLTF	TRBV12-5	TRBJ2-6
TGCAGTGCTAGAATCCAGGGGAATAGAACGGCCTACGAGCAGTACTTC	CSARIQGNRTAYEQYF	TRBV20-1	TRBJ2-7
TGTGCCAGCAGCTGGGTGGGGACTGCCAACTCCTACGAGCAGTACTTC	CASSWVGTANSYEQYF	TRBV9	TRBJ2-7
TGTGCCAGCAGCACGGGGACAGGCCCCCTCCAAGAGACCCAGTACTTC	CASSTGTGPLQETQYF	TRBV7-4	TRBJ2-5
TGTGCCAGCAGTTTAGGGCCAACAGGGCATCGGCCGGAAAAACTGTTTTTT	CASSLGPTGHRPEKLFF	TRBV12-4	TRBJ1-4
TGTGCCAGCAGTTTAAAGGAGGGTTTCTGGGAAAACTATGGCTACACCTTC	CASSLKEGFWENYGYTF	TRBV27	TRBJ1-2
TGTGCCAGCAGCAGAGACAGGATGGCCTACGAGCAGTACTTC	CASSRDRMAYEQYF	TRBV7-9	TRBJ2-7
TGTGCCAGCAGCGAAGGGCCGGAAGTCTACGAGCAGTACTTC	CASSEGPEVYEQYF	TRBV13	TRBJ2-7
TGTGCCAGTAGTACCATGGGAAGAGGAGGCCAAGAGACCCAGTACTTC	CASSTMGRGGQETQYF	TRBV19	TRBJ2-5
TGTGCCTCCGGGGCTGGGGCCGCGAACACCGGGGAGCTGTTTTTT	CASGAGAANTGELFF	TRBV30	TRBJ2-2
TGCGCCAGCAGCTTGCCACGGGTTTCGGGCTCTGGAAACACCATATATTTT	CASSLPRVSGSGNTIYF	TRBV5-1	TRBJ1-3
TGTGCCAGCAGCTTACGACAGAGCTCCCCTAACTATGGCTACACCTTC	CASSLRQSSPNYGYTF	TRBV7-6	TRBJ1-2
TGTGCCAGCAGCGAAGATCGGAGACAGGCCGCGAACACTGAAGCTTTCTTT	CASSEDRRQAANTEAFF	TRBV9	TRBJ1-1
TGTGCCAGCAGTCCTCCGTACCGACAGTCGGTTCAGCCCCAGCATTTT	CASSPPYRQSVQPQHF	TRBV12-4	TRBJ1-5
TGTGCCAAAGCCTCTAGCGGGGTCCGGGCTAACCAAGAGACCCAGTACTTC	CAKASSGVRANQETQYF	TRBV2	TRBJ2-5
TGCGCCAGCAGCCAAGATAAAATTTGGACTAGCGGGACCTGCAATGAGCAGTTCTTC	CASSQDKIWTSGTCNEQFF	TRBV4-1	TRBJ2-1
TGTGCCAGCAGCTGCGGGAGCAACAATGAGCAGTTCTTC	CASSCGSNNEQFF	TRBV7-9	TRBJ2-1
TGCGCCAGCAGCCAACAAGACAGGGAACACACTGAAGCTTTCTTT	CASSQQDREHTEAFF	TRBV4-1	TRBJ1-1
TGTGCCAGCACCCAGGGGGAGGATGAGCAGTTCTTC	CASTQGEDEQFF	TRBV27	TRBJ2-1
TGCAGTGCCTCGTACTACGAGCAGTACTTC	CSASYYEQYF	TRBV20-1	TRBJ2-7
TGTGCCAGCAGCAAGCCCGGGACTAGCGGGTACAATGAGCAGTTCTTC	CASSKPGTSGYNEQFF	TRBV13	TRBJ2-1
TGTGCCAGCAGTGACAAAGGGGGAAGCTCCTACGAGCAGTACTTC	CASSDKGGSSYEQYF	TRBV6-4	TRBJ2-7
TGTGCCAGCAGCCGGGCGAACACAGGGGAGGACTATGGCTACACCTTC	CASSRANTGEDYGYTF	TRBV14	TRBJ1-2
TGTGCCAGCAGTGCGGGGGATGTCGAGCAGTACTTC	CASSAGDVEQYF	TRBV6-2	TRBJ2-7
TGTGCCTGGACTACCTCGCTCGGCGATCAGCCCCAGCATTTT	CAWTTSLGDQPQHF	TRBV30	TRBJ1-5
TGTGCCACCAGTGATCCGGGACAAGGCGAGCAGTACTTC	CATSDPGQGEQYF	TRBV24-1	TRBJ2-7
TGTGCCAGTAGTTCCTTCCCCAGGGGGCAGCCCCAGCATTTT	CASSSFPRGQPQHF	TRBV19	TRBJ1-5
TGTGCCGGACTAGCGGGAGGGTATGGGTACGAGCAGTACTTC	CAGLAGGYGYEQYF	TRBV6-5	TRBJ2-7
TGTGCCAGCAGTGACTCGAGGAACGTCGCTAGTCGGTACGAGCAGTACTTC	CASSDSRNVASRYEQYF	TRBV6-4	TRBJ2-7
TGTGCCAGCAGGATCAGGCGTCACTTTCCTCAGTCTAATGAAAAACTGTTTTTT	CASRIRRHFPQSNEKLFF	TRBV28	TRBJ1-4
TGTGCCAGCAGCGCAGGGTCCAGAAAACTGTTTTTT	CASSAGSRKLFF	TRBV9	TRBJ1-4
TGTGCCACCAGTGATTTGTCCTCCCGCGGGAGATTCCCCGAATTAAACTATAATTCACCCCTCCACTTT	CATSDLSSRGRFPELNYNSPLHF	TRBV24-1	TRBJ1-6
TGTGCCAGCAGTTTCGCTCCGGGGGCCTACGAGCAGTACTTC	CASSFAPGAYEQYF	TRBV27	TRBJ2-7
TGTGCAGGACCAGAGCGAGGCGAGTCCGGGGAGCTGTTTTTT	CAGPERGESGELFF	TRBV6-4	TRBJ2-2
TGCGCCAGCAGCAGACAGTTCCTTCAGCCCCAGCATTTT	CASSRQFLQPQHF	TRBV10-1	TRBJ1-5
TGTGCCAGCAGCTTAGTAGACGGGACAGTGGCTAACTATGGCTACACCTTC	CASSLVDGTVANYGYTF	TRBV7-9	TRBJ1-2
TGCGCCAGAATCCCAGGGACTGAAGCTTTCTTT	CARIPGTEAFF	TRBV4-1	TRBJ1-1
TGTGCCACCAGTGATTTGCCCGGACAGCAGCCCCAGCATTTT	CATSDLPGQQPQHF	TRBV24-1	TRBJ1-5
TGTGCCAGCACGGACCGGGACATGTGGAACACTGAAGCTTTCTTT	CASTDRDMWNTEAFF	TRBV2	TRBJ1-1
TGTGCCAGCAGTTACGTCGGGGCAGGTGTGGATTCAGGAGAAAAACTGTTTTTT	CASSYVGAGVDSGEKLFF	TRBV28	TRBJ1-4
TGTGCCAGTACCGATTCGGGTTTACATGAGCAGTTCTTC	CASTDSGLHEQFF	TRBV19	TRBJ2-1
TGTGCCAGCATGGAAGATAGCGACAGGAGAAGCAATCAGCCCCAGCATTTT	CASMEDSDRRSNQPQHF	TRBV7-9	TRBJ1-5
TGTGCCACCAGAATAAAAGGGCTAGCGGGGGCCTACGAGCAGTACTTC	CATRIKGLAGAYEQYF	TRBV24-1	TRBJ2-7
TGCGCCAGGGAGGCATGTGACGAGCAGTACTTC	CAREACDEQYF	TRBV4-1	TRBJ2-7
TGCGCCAGCAGCTCGCCCGGCCACAGGACCCAGTACTTC	CASSSPGHRTQYF	TRBV5-1	TRBJ2-5
TGTGCCAGCAGTTACGCCCGGGCCAATGAGCAGTTCTTC	CASSYARANEQFF	TRBV6-6	TRBJ2-1
TGTGCCAGCCCCCAGGGGCGGGATCAGCCCCAGCATTTT	CASPQGRDQPQHF	TRBV13	TRBJ1-5
TGTGCCAGCAAGGGGGGGCCGGGGGTAACGATCGAGCAGTACTTC	CASKGGPGVTIEQYF	TRBV6-5	TRBJ2-7
TGTGCCAGCAGCAAACGGCCCAGCTCAAGGGGGATGGAGCTAGGATATGGCTACACCTTC	CASSKRPSSRGMELGYGYTF	TRBV7-3	TRBJ1-2
TGTGCCAGCAGCAGAAGTGACTACGAGCAGTACTTC	CASSRSDYEQYF	TRBV5-6	TRBJ2-7
TGTGCCAGCAGCCAAGACATGGGAGGGGGCACCGGGGAGCTGTTTTTT	CASSQDMGGGTGELFF	TRBV3-1	TRBJ2-2
TGCGCCAGCAGTGCCTCGTCAGCAAATCAGCCCCAGCATTTT	CASSASSANQPQHF	TRBV10-1	TRBJ1-5
TGTGCCTGGAGTGTGACAGACTCGGAGAACACTGAAGCTTTCTTT	CAWSVTDSENTEAFF	TRBV30	TRBJ1-1
TGCAGTGCTAGAGCCGGGACTAGCGGAACTACCACAGATACGCAGTATTTT	CSARAGTSGTTTDTQYF	TRBV20-1	TRBJ2-3
TGCAGTGCTAGGGGGGATCGACTTCCCTACACTGAAGCTTTCTTT	CSARGDRLPYTEAFF	TRBV20-1	TRBJ1-1
TGTGCTAGCAGCTTAGGAAGGGGAGGTGATACGCAGTATTTT	CASSLGRGGDTQYF	TRBV7-7	TRBJ2-3
TGTGCCATCAGTGAGTTCGGTAGGGGGGTTAATGAGCAGTTCTTC	CAISEFGRGVNEQFF	TRBV10-3	TRBJ2-1
TGCAGTGCGACCCAGGGCTACCTATACGAGCAGTACTTC	CSATQGYLYEQYF	TRBV20-1	TRBJ2-7
TGTGCCAGCAGTTGGAATTGGGGGGGAGAGACCCAGTACTTC	CASSWNWGGETQYF	TRBV6-9	TRBJ2-5
TGTGCCAGCAGCAACCGGACAGGGGAGCTATACACCATATATTTT	CASSNRTGELYTIYF	TRBV5-8	TRBJ1-3
TGTGCCACCGACAGGGTGACGAACACCGGGGAGCTGTTTTTT	CATDRVTNTGELFF	TRBV24-1	TRBJ2-2
TGTGCCAGCAGCATTGACAGAGGAGAGTACGAGCAGTACTTC	CASSIDRGEYEQYF	TRBV7-2	TRBJ2-7
TGTGCCAGCAGCCGAGACAGAGGACCCTCTGGGGCCAACGTCCTGACTTTC	CASSRDRGPSGANVLTF	TRBV7-6	TRBJ2-6
TGTGCCAGCAGCCGTGGGACAGGGGGCGGCGGGGACCAAGAGACCCAGTACTTC	CASSRGTGGGGDQETQYF	TRBV5-4	TRBJ2-5
TGTGCCAGCAGTTACTCGGGGGATGGCTACACCTTC	CASSYSGDGYTF	TRBV6-3	TRBJ1-2
TGTGCCAGCAGCCACCCGGGGACTAGCATCGGCCTCGAGAGAGATACGCAGTATTTT	CASSHPGTSIGLERDTQYF	TRBV14	TRBJ2-3
TGTGCCAGCAGTTTAGGTTCCGGGACAGGGGAGACCCAGTACTTC	CASSLGSGTGETQYF	TRBV27	TRBJ2-5
TGTGCCAGCAGCGACGATAGACGCAGACTAGCGGGCGGCCGTTACAATGAGCAGTTCTTC	CASSDDRRRLAGGRYNEQFF	TRBV7-4	TRBJ2-1
TGTGCCAGCAGCCAAGTCTTTCAAGTTGGAAACACCATATATTTT	CASSQVFQVGNTIYF	TRBV3-1	TRBJ1-3
TGTGCCAGCAGCTTGTGGAGTCCCCGCGGGAGAGGGACTGAAGCTTTCTTT	CASSLWSPRGRGTEAFF	TRBV5-8	TRBJ1-1
TGTGCCAGTCATCGGGGGTCCAGCACAGATACGCAGTATTTT	CASHRGSSTDTQYF	TRBV6-1	TRBJ2-3
TGTGCCAGCCAAGGGGGCGTTGGACAGCCCCAGCATTTT	CASQGGVGQPQHF	TRBV28	TRBJ1-5
TGTGCCAGCAGACGCAGGAGGGTTAACACCGGGGAGCTGTTTTTT	CASRRRRVNTGELFF	TRBV28	TRBJ2-2
TGTGCCAGCAGCTCAACCAGCTCTGGAAACACCATATATTTT	CASSSTSSGNTIYF	TRBV7-9	TRBJ1-3
TGTGCCAGCAGTTATATAGGGGGACAGATGTCCTACAATGAGCAGTTCTTC	CASSYIGGQMSYNEQFF	TRBV6-9	TRBJ2-1
TGTGCCAGCAGCGCTCACTCACTGGGCTACACCTTC	CASSAHSLGYTF	TRBV5-6	TRBJ1-2
TGTGCCAGCAGCTTAGTCCACCCGGGACAGGGAGCTAATCAGCCCCAGCATTTT	CASSLVHPGQGANQPQHF	TRBV7-3	TRBJ1-5
TGTGCCAGCAGCCCCGGACAGGGAGCACGACATCAGCCCCAGCATTTT	CASSPGQGARHQPQHF	TRBV11-2	TRBJ1-5
TGTGCCAGCAGCCAAAATCGAGGGATATGGCCGACCTACAATGAGCAGTTCTTC	CASSQNRGIWPTYNEQFF	TRBV3-1	TRBJ2-1
TGTGCCAGCAGCCAGGATAGATCCACTGAAGCTTTCTTT	CASSQDRSTEAFF	TRBV14	TRBJ1-1
TGTGCCAGCAGCCAACGGGGCCCGGACACTGAAGCTTTCTTT	CASSQRGPDTEAFF	TRBV4-2	TRBJ1-1
TGCGCCAGCAGCCCTCGGCGGGAAGCTTTCTTT	CASSPRREAFF	TRBV4-1	TRBJ1-1
TGTGCCAGCAGTTACTACAGGGGTCCGGGAAACACCATATATTTT	CASSYYRGPGNTIYF	TRBV6-5	TRBJ1-3
TGTGCCAGCAGCTTCAGGGACGGAAATCAGCCCCAGCATTTT	CASSFRDGNQPQHF	TRBV11-3	TRBJ1-5
TGTGCCAGCAGCTTAGTGGAGGGACAGAAGATCGAAACTAATGAAAAACTGTTTTTT	CASSLVEGQKIETNEKLFF	TRBV7-9	TRBJ1-4
TGCGCCAGCATACGGACCCAGGACCCCGTGTGGTTGGAAGCTTTCTTT	CASIRTQDPVWLEAFF	TRBV4-1	TRBJ1-1
TGCAGTGCTGGGACTAGCGGGGGGGCCCCGTCAGATACGCAGTATTTT	CSAGTSGGAPSDTQYF	TRBV20-1	TRBJ2-3
TGTGCCAGCAGCTTAGAGATGCTTCGGGGGCTAAGCTCCTACAATGAGCAGTTCTTC	CASSLEMLRGLSSYNEQFF	TRBV7-2	TRBJ2-1
TGCAGCGTTGCTTGGAGCCAGGAAAGCTCCTACGAGCAGTACTTC	CSVAWSQESSYEQYF	TRBV29-1	TRBJ2-7
TGTGCCAGCAGCTTACCCACGGGGACAGGAACTAACTATGGCTACACCTTC	CASSLPTGTGTNYGYTF	TRBV7-3	TRBJ1-2
TGCGCCAGCAGCGCCGCGCTCACGCTAGGGTACCTTAGCACAGATACGCAGTATTTT	CASSAALTLGYLSTDTQYF	TRBV4-1	TRBJ2-3
TGTGCCAGCAGCGAACGGGACGGTATTTACGAGCAGTACTTC	CASSERDGIYEQYF	TRBV7-2	TRBJ2-7
TGTGCCAGTTCAGGGTCCTTCACAGATACGCAGTATTTT	CASSGSFTDTQYF	TRBV19	TRBJ2-3
TGTGCCAGCAGCCCGGACCCAGCCTCCCCCGATGGCTACACCTTC	CASSPDPASPDGYTF	TRBV13	TRBJ1-2
TGTGCCAATGACAGGCGCCGGACCGGGGAGCTGTTTTTT	CANDRRRTGELFF	TRBV7-6	TRBJ2-2
TGTGCCAGCAGCCAAGGTTCTAGCGGGAGGGGCCACAATGAGCAGTTCTTC	CASSQGSSGRGHNEQFF	TRBV3-1	TRBJ2-1
TGCGCCAGCAGCTTAAGCCGGACAGGGTGTTCAGATACGCAGTATTTT	CASSLSRTGCSDTQYF	TRBV5-1	TRBJ2-3
TGTGCCAGCATCAGAGAGAACTATGGCTACACCTTC	CASIRENYGYTF	TRBV27	TRBJ1-2
TGTGCCAGCAGCCCACTAGCGGTAGTGGCCTACGAGCAGTACTTC	CASSPLAVVAYEQYF	TRBV13	TRBJ2-7
TGTGCCACCCGGGGACTAGAGACAGATACGCAGTATTTT	CATRGLETDTQYF	TRBV24-1	TRBJ2-3
TGCGCCAGCAGCCGGACCAACACCGGGGAGCTGTTTTTT	CASSRTNTGELFF	TRBV5-1	TRBJ2-2
TGCAGCGTTGAAGCCAGGGGGGGGCCAAAGACCCAGTACTTC	CSVEARGGPKTQYF	TRBV29-1	TRBJ2-5
TGTGCCAGCAGCTGCAAGGGCGGGGGGTCCTACGAGCAGTACTTC	CASSCKGGGSYEQYF	TRBV7-9	TRBJ2-7
TGTGCCAGCAAGGACCGTGGGGGGGTCGGTCAGCCCCAGCATTTT	CASKDRGGVGQPQHF	TRBV28	TRBJ1-5
TGTGCCAGCAGCTTTTACGCGGGAGCTTACAATGAGCAGTTCTTC	CASSFYAGAYNEQFF	TRBV7-6	TRBJ2-1
TGTGCCAGCACCTTAGGCAACTATGGCTACACCTTC	CASTLGNYGYTF	TRBV11-3	TRBJ1-2
TGTGCCACCAGGGCCGGGACTGGCTACACCTTC	CATRAGTGYTF	TRBV24-1	TRBJ1-2
TGTGCCTGGAGTTCGGGAGTCCCCTCGGGAAACGAGCAGTACTTC	CAWSSGVPSGNEQYF	TRBV30	TRBJ2-7
TGCGCCAGCAGCCACCCGGGGGGCAGAAGCTCCTACAATGAGCAGTTCTTC	CASSHPGGRSSYNEQFF	TRBV4-3	TRBJ2-1
TGCGCCAGCAGCCAAGACAAATTTGGAGGGGAGCAGTACTTC	CASSQDKFGGEQYF	TRBV4-1	TRBJ2-7
TGTGCCAGCAGTTACTCGAACCAGGGCTCGCAAGAGACCCAGTACTTC	CASSYSNQGSQETQYF	TRBV6-5	TRBJ2-5
TGTGCCAGCAGCCAATATAGGGGGGTCTATGGCTACACCTTC	CASSQYRGVYGYTF	TRBV11-3	TRBJ1-2
TGTGCCAGTAGTTATGGACTAGCGCACTCCTACAATGAGCAGTTCTTC	CASSYGLAHSYNEQFF	TRBV19	TRBJ2-1
TGTGCCAGCAGCTCTGCCCCTACAGGGGGCAACTATGGCTACACCTTC	CASSSAPTGGNYGYTF	TRBV11-2	TRBJ1-2
TGTGCCAGCAGCTTGGGACAGACCGCCTCTGGGGCCAACGTCCTGACTTTC	CASSLGQTASGANVLTF	TRBV5-5	TRBJ2-6
TGTGCCATCCCACCAAGCCGGACAGGGGATTTCAGACAGCCCCAGCATTTT	CAIPPSRTGDFRQPQHF	TRBV10-3	TRBJ1-5
TGTGCCAGCAGCCAAGCTACCCGGAAGCAGAACACCGGGGAGCTGTTTTTT	CASSQATRKQNTGELFF	TRBV4-2	TRBJ2-2
TGTGCCAGCAGTTCCCCGGGCTCTGGGGCCAACGTCCTGACTTTC	CASSSPGSGANVLTF	TRBV6-5	TRBJ2-6
TGTGCCAGCAGCCAGACCCAAGAGACCCAGTACTTC	CASSQTQETQYF	TRBV7-4	TRBJ2-5
TGTGCCAGCAGCCAAGTACGGACAGGGTGTCAGCCCCAGCATTTT	CASSQVRTGCQPQHF	TRBV14	TRBJ1-5
TGCGCCAGCAGCAGATACAAGGTGGGGGGGGGAACAGATACGCAGTATTTT	CASSRYKVGGGTDTQYF	TRBV5-1	TRBJ2-3
TGTGCCAGCAGCAGAGGGCGACTCAATCAGCCCCAGCATTTT	CASSRGRLNQPQHF	TRBV5-8	TRBJ1-5
TGTGCCAGCAGTGTGGAACGGGACTGGCCAGATACGCAGTATTTT	CASSVERDWPDTQYF	TRBV28	TRBJ2-3
TGTGCCAGCAGCTTCGAGACTAGCGGGAGTGGCGGAGTTGGAGGGGACGAGCAGTACTTC	CASSFETSGSGGVGGDEQYF	TRBV11-3	TRBJ2-7
TGCGCCAGCAGCTTGGTTATGGACAGGAAGCCGGCCTCGGGCTACACCTTC	CASSLVMDRKPASGYTF	TRBV5-1	TRBJ1-2
TGTGCCACCTTTCCAGAGCCTGGCTACACCTTC	CATFPEPGYTF	TRBV24-1	TRBJ1-2
TGTGCCAGCAGCCTAGCGGGGGATGGGGAGGAGACCCAGTACTTC	CASSLAGDGEETQYF	TRBV13	TRBJ2-5
TGTGCCAGCAGCGGCCCCTTGACAGGGGATGGCTACACCTTC	CASSGPLTGDGYTF	TRBV6-5	TRBJ1-2
TGCGCCAGCAGCCAACTCGCGGGAGAGCTTCATAGCAATCAGCCCCAGCATTTT	CASSQLAGELHSNQPQHF	TRBV4-1	TRBJ1-5
TGTGCCAGCAGCTTAGGGAGACATAGGTACGAGCAGTACTTC	CASSLGRHRYEQYF	TRBV7-9	TRBJ2-7
TGCGCCAGCAGCAAGGTGGTTAGGGGGACAGGGGGGCGCTATCAGCCCCAGCATTTT	CASSKVVRGTGGRYQPQHF	TRBV5-1	TRBJ1-5
TGTGCCAGCAGCACCCGCACACTGTCAGCTTTCTTT	CASSTRTLSAFF	TRBV5-4	TRBJ1-1
TGTGCCAGCGGGGGTACGGTCTGGTCGACCCAGTACTTC	CASGGTVWSTQYF	TRBV25-1	TRBJ2-5
TGTGCCACCAGACAGTTGAGCAATCAGCCCCAGCATTTT	CATRQLSNQPQHF	TRBV14	TRBJ1-5
TGTGCCATCACCCCGGGACAGGTTGAACCCCACGGACCGAACACCATATATTTT	CAITPGQVEPHGPNTIYF	TRBV10-3	TRBJ1-3
TGTGCTAGCAGCTTATCACGACCAGGGCCTTACTATGGCTACACCTTC	CASSLSRPGPYYGYTF	TRBV7-7	TRBJ1-2
TGTGCCAGCAGTTACACTTTGCGTTCGGGTATGGGCTACACCTTC	CASSYTLRSGMGYTF	TRBV6-6	TRBJ1-2
TGTGCCAGCAGCTTGCGTGGGACAGTGTCCCCGTACGAGCAGTACTTC	CASSLRGTVSPYEQYF	TRBV5-6	TRBJ2-7
TGTGCAAGCCCTAACGAGCAGTACTTC	CASPNEQYF	TRBV3-1	TRBJ2-7
TGTGCCAGTAGTATCCGATACTACCCTGGCTCCAAGGACGAGCAGTACTTC	CASSIRYYPGSKDEQYF	TRBV19	TRBJ2-7
TGCGCCAGCAGCTTGGCCTGGACGAATGGATCTTACGAGCAGTACTTC	CASSLAWTNGSYEQYF	TRBV5-1	TRBJ2-7
TGTGCCAGCAGTCGAGGGGGGGGAAATGACGAGCAGTACTTC	CASSRGGGNDEQYF	TRBV27	TRBJ2-7
TGTGCCAGCAGCCTGACCAATCAGCCCCAGCATTTT	CASSLTNQPQHF	TRBV7-3	TRBJ1-5
TGTGCTAGTGGTTTGGACCAGGGCTCGACCCAGTACTTC	CASGLDQGSTQYF	TRBV12-5	TRBJ2-5
TGTGCCAGCAGGTCCCCCCAGGTAGACTACGAGCAGTACTTC	CASRSPQVDYEQYF	TRBV25-1	TRBJ2-7
TGTGCCAGCGGATGGGGGCGGGGAACAGATACGCAGTATTTT	CASGWGRGTDTQYF	TRBV27	TRBJ2-3
TGTGCTGGGACAACCCGCTACGAGCAGTACTTC	CAGTTRYEQYF	TRBV5-6	TRBJ2-7
TGTGCCAGCAGTCGTAGCGCGGGACTACAGGATAACACCGGGGAGCTGTTTTTT	CASSRSAGLQDNTGELFF	TRBV28	TRBJ2-2
TGTGCCAGCAGCTTGGGACTAGCGGTTTCCTACGAGCAGTACTTC	CASSLGLAVSYEQYF	TRBV11-2	TRBJ2-7
TGTGCCTTCAGCCGAACGTCACCCCTCCACTTT	CAFSRTSPLHF	TRBV9	TRBJ1-6
TGTGCCAGCAGCTTTAGAACAGGGGTAGAGACCCAGTACTTC	CASSFRTGVETQYF	TRBV5-6	TRBJ2-5
TGTGCCAGCAAGTCTGCTGAGGCGGGGGATCAGCCCCAGCATTTT	CASKSAEAGDQPQHF	TRBV13	TRBJ1-5
TGTGCCAGGGAGGAGGGACAAGAGACCCAGTACTTC	CAREEGQETQYF	TRBV28	TRBJ2-5
TGCACACGCAATCAGCCCCAGCATTTT	CTRNQPQHF	TRBV10-1	TRBJ1-5
TGTGCCAGCAGCCAAGATCCGGGGGAGGGTAGTACCTACGAGCAGTACTTC	CASSQDPGEGSTYEQYF	TRBV14	TRBJ2-7
TGTGCCAGCAGGAAACAGAAAAACCGGGGGGCTGGCTACGAGCAGTACTTC	CASRKQKNRGAGYEQYF	TRBV7-9	TRBJ2-7
TGCGCCAGCAGCCAAGACCCCGAATTTTTCTACGAGCAGTACTTC	CASSQDPEFFYEQYF	TRBV4-1	TRBJ2-7
TGTGCCAGCAGTAGCCGTAGGAGTGGACAGGATATGAACACTGAAGCTTTCTTT	CASSSRRSGQDMNTEAFF	TRBV2	TRBJ1-1
TGCGCCAGCAGCTTGCACTTCTATCAGGGATACACTGAAGCTTTCTTT	CASSLHFYQGYTEAFF	TRBV5-1	TRBJ1-1
TGTGCCAGCAGCTACCTAGATAACAATGAGCAGTTCTTC	CASSYLDNNEQFF	TRBV11-3	TRBJ2-1
TGTGCCAGCAGCCAAGCCCATCGGAAGGTTCCCAAAAACATTCAGTACTTC	CASSQAHRKVPKNIQYF	TRBV14	TRBJ2-4
TGTGCCAGCAGCCCACAGGGGGGATACGAGCAGTACTTC	CASSPQGGYEQYF	TRBV13	TRBJ2-7
TGTGCCAGCACCCGGATGAGCTCCTACGAGCAGTACTTC	CASTRMSSYEQYF	TRBV12-3	TRBJ2-7
TGTGCCAGTAGGGGTGTGGCTGAGGGCGGTGACTATGAGCAGTTCTTC	CASRGVAEGGDYEQFF	TRBV19	TRBJ2-1
TGTGCCAGCAGTGAGAGCCAGGAGATGCGAAACTATGGCTACACCTTC	CASSESQEMRNYGYTF	TRBV6-1	TRBJ1-2
TGTGCCATCAGTGGGAGAGGCTCAAATGGCTACACCTTC	CAISGRGSNGYTF	TRBV10-3	TRBJ1-2
TGTGCCAGTCTTCACAGGGGGCGATGCAATGAGCAGTTCTTC	CASLHRGRCNEQFF	TRBV28	TRBJ2-1
TGTGCCAGCAGCTGCCGGGACAGGGCTAACTATGGCTACACCTTC	CASSCRDRANYGYTF	TRBV5-5	TRBJ1-2
TGTGCCAGCAGTTCCCTCTCGGGGTCATACGGGATACTAGCCAAAAACATTCAGTACTTC	CASSSLSGSYGILAKNIQYF	TRBV6-2	TRBJ2-4
TGTGCCAGCTCACGGACAGGGGAGGGCTACAATGAGCAGTTCTTC	CASSRTGEGYNEQFF	TRBV18	TRBJ2-1
TGCGCCAGCAGCTCACCGTGGGTCCGAGAGACCCAGTACTTC	CASSSPWVRETQYF	TRBV5-1	TRBJ2-5
TGTGCCAGCAGCTTGGACAAGGGGGTATTTGGCCGCAATCAGCCCCAGCATTTT	CASSLDKGVFGRNQPQHF	TRBV7-9	TRBJ1-5
TGTGCCAGCAGAAGAACCCGGGACAGGGGGGAGACCCAGTACTTC	CASRRTRDRGETQYF	TRBV27	TRBJ2-5
TGCGCCCCTGCTCGGAACATTTCCGAAAAACTGTTTTTT	CAPARNISEKLFF	TRBV5-1	TRBJ1-4
TGTGCCAGCATAAACGTGAGGAGGACCGCGGGGGACGAGCAGTACTTC	CASINVRRTAGDEQYF	TRBV9	TRBJ2-7
TGTGCCAGCACAGGGGGGCGAGCCTCTGGAAACACCATATATTTT	CASTGGRASGNTIYF	TRBV6-6	TRBJ1-3
TGCGCCAGCAGTTCACGTGGGACAGATACGCAGTATTTT	CASSSRGTDTQYF	TRBV4-1	TRBJ2-3
TGCAGTGCTGAAACCAGTACAGGCAATCAGCCCCAGCATTTT	CSAETSTGNQPQHF	TRBV20-1	TRBJ1-5
TGTGCCAGCAGGATCGGGGTAGTTGGGGTGAACACTGAAGCTTTCTTT	CASRIGVVGVNTEAFF	TRBV9	TRBJ1-1
TGCGCCAGCAGCGCCAAGCTGACTAGCATTCTCTACGAGCAGTACTTC	CASSAKLTSILYEQYF	TRBV5-1	TRBJ2-7
TGTGCCAGCAGCGTCAGGGATAGCAATCAGCCCCAGCATTTT	CASSVRDSNQPQHF	TRBV5-6	TRBJ1-5
TGTGCCAGCAGCAGCGGAGGGAGGCAGGACCTATCCTCTGGGGCCAACGTCCTGACTTTC	CASSSGGRQDLSSGANVLTF	TRBV13	TRBJ2-6
TGTGCCTGGAGTGGGGACGGAATTGGCTCCTACGAGCAGTACTTC	CAWSGDGIGSYEQYF	TRBV30	TRBJ2-7
TGTGCCAGCAGTTTCATATGGCTCATTTGGCAGCCCCAGCATTTT	CASSFIWLIWQPQHF	TRBV12-3	TRBJ1-5
TGTGCCAGCAGTTACAGGGTTTTAACCAATGAGCAGTTCTTC	CASSYRVLTNEQFF	TRBV28	TRBJ2-1
TGTGCCAGCAGCCAAGACCAGTCCGGGACTAGGGGCGCTGAAGCTTTCTTT	CASSQDQSGTRGAEAFF	TRBV14	TRBJ1-1
TGTGCCTGTTTCAAGGGACAGGGCCGTAAGGAGGGTAATCAGCCCCAGCATTTT	CACFKGQGRKEGNQPQHF	TRBV11-2	TRBJ1-5
TGCGCCAGCAGCCGGCCGGGGTACGAGCAGTACTTC	CASSRPGYEQYF	TRBV4-1	TRBJ2-7
TGCGCCAGCAGCTACTATCGCTACGAGACCCAGTACTTC	CASSYYRYETQYF	TRBV5-1	TRBJ2-5
TGTGCGGAACAACCGACACGTTCCTACGAGCAGTACTTC	CAEQPTRSYEQYF	TRBV30	TRBJ2-7
TGTGCTAGTGGTTTGGTACAGGACGTTTCACCCCTCCACTTT	CASGLVQDVSPLHF	TRBV12-5	TRBJ1-6
TGTGCCAGTAGTATGTGGCCGGGCGAGGCTGGCTACACCTTC	CASSMWPGEAGYTF	TRBV19	TRBJ1-2
TGTGCCACCGGCCAGGGGGGAGATACGCAGTATTTT	CATGQGGDTQYF	TRBV6-5	TRBJ2-3
TGTGCCAGCAGCCACCGGAGCGGGAGCTACGAGCAGTACTTC	CASSHRSGSYEQYF	TRBV3-1	TRBJ2-7
TGTGCCAGCAGCTCCGGGTTCCACGAGCAGTACTTC	CASSSGFHEQYF	TRBV13	TRBJ2-7
TGTGCCAGCAGGGACGGGACAGCACCGGTAGAACAAGAGACCCAGTACTTC	CASRDGTAPVEQETQYF	TRBV12-4	TRBJ2-5
TGTGCCAGCAGGTGCCTAACTAGCGGGAGCCATAGCAATCAGCCCCAGCATTTT	CASRCLTSGSHSNQPQHF	TRBV9	TRBJ1-5
TGTGCCAGCAGCTTCAGGGAACCCTATGGCTACACCTTC	CASSFREPYGYTF	TRBV7-3	TRBJ1-2
TGTGCCAGCAGTTCTACCGGGCGTATCCCTAACTATGGCTACACCTTC	CASSSTGRIPNYGYTF	TRBV6-3	TRBJ1-2
TGTGCCATCTATAAAACCTTAGGGGGGGCGCGTTTTGCAGATACGCAGTATTTT	CAIYKTLGGARFADTQYF	TRBV10-3	TRBJ2-3
TGTGCCAGCAGCTTAGAGGAGACAGGGGGCCCCGCGAAAGGTAATGAAAAACTGTTTTTT	CASSLEETGGPAKGNEKLFF	TRBV7-3	TRBJ1-4
TGTGCCAACGAAGACAGGGGAGGAATTTCCATGAACACTGAAGCTTTCTTT	CANEDRGGISMNTEAFF	TRBV14	TRBJ1-1
TGTGCCAGCAGCTTAGTCGGGACTCCAGGGCACTCCTACGAGCAGTACTTC	CASSLVGTPGHSYEQYF	TRBV11-3	TRBJ2-7
TGCAGGGACAGGGCAGAAAAACTGTTTTTT	CRDRAEKLFF	TRBV20-1	TRBJ1-4
TGCAGTGCGGACAGGGCCGGAAATCAGCCCCAGCATTTT	CSADRAGNQPQHF	TRBV20-1	TRBJ1-5
TGCGCCAGCAGTGAGTGTTTCTTTAAACAGGGTGGACCGGAGCAGTACTTC	CASSECFFKQGGPEQYF	TRBV10-2	TRBJ2-7
TGCAGTGCTAGAGGCCAGAAAGACGGCAATTCACCCCTCCACTTT	CSARGQKDGNSPLHF	TRBV20-1	TRBJ1-6
TGTGCCAGCAGGAGAGGGGCAGATACGCAGTATTTT	CASRRGADTQYF	TRBV7-3	TRBJ2-3
TGTGCCTGGAGTGTTCCGAAGGCTACTAATCAGCCCCAGCATTTT	CAWSVPKATNQPQHF	TRBV30	TRBJ1-5
TGCGCCAGCGCTGGCAACCACGAGCAGTACTTC	CASAGNHEQYF	TRBV10-2	TRBJ2-7
TGTGCCAGTATCCAGCGGTACGAGCAGTACTTC	CASIQRYEQYF	TRBV19	TRBJ2-7
TGCGCCAGCAGCCAAGATACTCTCGGGCACGAGCAGTACTTC	CASSQDTLGHEQYF	TRBV4-1	TRBJ2-7
TGTGCCAGCAGCTCGGACGGGACGGAAGAGACCCAGTACTTC	CASSSDGTEETQYF	TRBV7-2	TRBJ2-5
TGTGCCAGCAGTCCCAGGGGAGTTTTTTTGATCTCTGGGGCCAACGTCCTGACTTTC	CASSPRGVFLISGANVLTF	TRBV27	TRBJ2-6
TGTGCCCGCCCCGCAGGGTGGGAGAACACCGGGGAGCTGTTTTTT	CARPAGWENTGELFF	TRBV24-1	TRBJ2-2
TGTGCCAGCAGCTGGGGGAGGGTTCACTCTGGAAACACCATATATTTT	CASSWGRVHSGNTIYF	TRBV7-2	TRBJ1-3
TGTGCCAGCAGCACGGGAGACAATCAGCCCCAGCATTTT	CASSTGDNQPQHF	TRBV7-9	TRBJ1-5
TGTGCCAGCCCTAGGACAGGGGGGAGTGCTTTCTTT	CASPRTGGSAFF	TRBV12-3	TRBJ1-1
TGTGCCAGCACAACAGCGGGAGGAGGCACAGATACGCAGTATTTT	CASTTAGGGTDTQYF	TRBV6-3	TRBJ2-3
TGTGCCAATCAAGAACGGAGAAATACTGAAGCTTTCTTT	CANQERRNTEAFF	TRBV18	TRBJ1-1
TGTGCCAGCAGCAACAGGGGGATCCGAGCGGGCTACACCTTC	CASSNRGIRAGYTF	TRBV13	TRBJ1-2
TGTGCCAGCAGTTCAACGGGACAGGGGGCGAGAGAAAAACTGTTTTTT	CASSSTGQGAREKLFF	TRBV27	TRBJ1-4
TGTGCCAGCAGTTGGGGGAGCGGTTTGAGGGATCAGCCCCAGCATTTT	CASSWGSGLRDQPQHF	TRBV6-2	TRBJ1-5
TGTGCCAGCTCGGCCGACAGGGCAAATGAGCAGTTCTTC	CASSADRANEQFF	TRBV18	TRBJ2-1
TGTGCCAGCAGCCCCGGGGGGGCCAAAAACATTCAGTACTTC	CASSPGGAKNIQYF	TRBV6-5	TRBJ2-4
TGTGCCAGCAGTGACTCGGGGGGGGCCAAAAACATTCAGTACTTC	CASSDSGGAKNIQYF	TRBV6-4	TRBJ2-4
TGTGCCAGCTTCCCTGGGGGCGAGGAGACTGAGCAGTTCTTC	CASFPGGEETEQFF	TRBV27	TRBJ2-1
TGTGCCAGCAGCCCCGGTACGGGGACAGGGGGGACCGAGCAGTACTTC	CASSPGTGTGGTEQYF	TRBV13	TRBJ2-7
TGTGCCAGCAGCTTAGCGAAGGGGGGGGCATATCAGCCCCAGCATTTT	CASSLAKGGAYQPQHF	TRBV7-9	TRBJ1-5
TGCGCCAGCAGTGAGAGCCCTTTTCCCCCTAGGGGGGCCCCCGGCACAGATACGCAGTATTTT	CASSESPFPPRGAPGTDTQYF	TRBV10-1	TRBJ2-3
TGTGCCAGCAGTTTGCAACGGGAGTACAATGAGCAGTTCTTC	CASSLQREYNEQFF	TRBV28	TRBJ2-1
TGCAGTGCTATTGTACGGGGGAATGAGCAGTTCTTC	CSAIVRGNEQFF	TRBV20-1	TRBJ2-1
TGTGCCACCAGTGATGGGAGGCGGGAGGGACTCAATGAGCAGTTCTTC	CATSDGRREGLNEQFF	TRBV24-1	TRBJ2-1
TGTGCCAGCAGCGCACGGACTAGCGGGGGGGCCCCTCCGCAGTTCTTC	CASSARTSGGAPPQFF	TRBV5-8	TRBJ2-1
TGTGCCAGCATGGAAGGGGTATACAATGAGCAGTTCTTC	CASMEGVYNEQFF	TRBV6-1	TRBJ2-1
TGTGCCTGGAGAGACTGCCCCGTGTACCAAGAGACCCAGTACTTC	CAWRDCPVYQETQYF	TRBV30	TRBJ2-5
TGTGCCAGCAGCTTCGCGGGACATTCAAAGCCCCAAGAGACCCAGTACTTC	CASSFAGHSKPQETQYF	TRBV5-6	TRBJ2-5
TGTGCCAGCAGCCCGGCAGGGAGCAATCAGCCCCAGCATTTT	CASSPAGSNQPQHF	TRBV3-1	TRBJ1-5
TGTGCCAGCAGCTTAGCCCGACAGCGGGAGACCCAGTACTTC	CASSLARQRETQYF	TRBV7-9	TRBJ2-5
TGTGCCAGCAGCTTGGACAGGGGTGGGGGAAACACCATATATTTT	CASSLDRGGGNTIYF	TRBV7-8	TRBJ1-3
TGTGCCAGTCGGGAGGGAAAAGAGCGGGGGACCTACAATGAGCAGTTCTTC	CASREGKERGTYNEQFF	TRBV6-6	TRBJ2-1
TGTGCCAGCAGCCAGAAACTGGCCAGACGACGGGATGAGCAGTTCTTC	CASSQKLARRRDEQFF	TRBV7-3	TRBJ2-1
TGTGCCAGCAAAAAAGGAGGAGGGGGATGGAGCACAGATACGCAGTATTTT	CASKKGGGGWSTDTQYF	TRBV11-3	TRBJ2-3
TGTGCCTGGAGCCGCCGGGACAGGACTAACACTGAAGCTTTCTTT	CAWSRRDRTNTEAFF	TRBV30	TRBJ1-1
TGTGCCACTGCCCGTGCCGACTACAATGAGCAGTTCTTC	CATARADYNEQFF	TRBV24-1	TRBJ2-1
TGTGCCATCAGTGACCGGCCCCCGGGACAGGTTCTCGGACCCGGGGAGCTGTTTTTT	CAISDRPPGQVLGPGELFF	TRBV10-3	TRBJ2-2
TGCAGTGCTAGCCACAGGGGGTTATTTACAGATACGCAGTATTTT	CSASHRGLFTDTQYF	TRBV20-1	TRBJ2-3
TGCATTCCCCGGGACAGACACGCCGGGGAGCTGTTTTTT	CIPRDRHAGELFF	TRBV20-1	TRBJ2-2
TGTGCCAGCAGCAGACTAGGGTACAATGAGCAGTTCTTC	CASSRLGYNEQFF	TRBV13	TRBJ2-1
TGTGCCAGCAGCCTAGACAGGCCCCAGGCCAAGGGTTCCTACAATGAGCAGTTCTTC	CASSLDRPQAKGSYNEQFF	TRBV6-5	TRBJ2-1
TGTGCCATCAGTGATTCCCCCGGGACTAGCGGGAGAGTCTATGGCTACACCTTC	CAISDSPGTSGRVYGYTF	TRBV10-3	TRBJ1-2
TGTGCCACCAGGATGCACGGTAATAACACTGAAGCTTTCTTT	CATRMHGNNTEAFF	TRBV24-1	TRBJ1-1
TGTGCCAGCAGCCAGGAGCAAGAGACCCAGTACTTC	CASSQEQETQYF	TRBV7-9	TRBJ2-5
TGTGCCAGCACCTTACCAGGGAGCCGGCAAGAGACCCAGTACTTC	CASTLPGSRQETQYF	TRBV5-6	TRBJ2-5
TGTGCCAGCAGCTTGTCAAGCAGGACAGGGGGCGTACGGGTGTTTCCTTATGGCTACACCTTC	CASSLSSRTGGVRVFPYGYTF	TRBV11-2	TRBJ1-2
TGTGCCAGCAGTTCACCCGGGACTATTTCACCCGAGTACCAAGAGACCCAGTACTTC	CASSSPGTISPEYQETQYF	TRBV6-5	TRBJ2-5
TGTGCCAGCAGCAGCCTGAGCTATTACGAAGAGCAGGGATGCAATCAGCCCCAGCATTTT	CASSSLSYYEEQGCNQPQHF	TRBV11-3	TRBJ1-5
TGCAGCGATTGGGGGGGGGAGCAGTACTTC	CSDWGGEQYF	TRBV29-1	TRBJ2-7
TGTGCCAGCAGCTTAGATACGGGGGGGGATGAGCAGTTCTTC	CASSLDTGGDEQFF	TRBV11-2	TRBJ2-1
TGTGCCAGCAGCCCTCAAGACAGGAATGCAACTAATGAAAAACTGTTTTTT	CASSPQDRNATNEKLFF	TRBV11-2	TRBJ1-4
TGCAGTGCTAGAGTCAGGGGGAAGACTGGCCAAGAGACCCAGTACTTC	CSARVRGKTGQETQYF	TRBV20-1	TRBJ2-5
TGCAGTGCTAGAGATTACGAATCCTACAATGAGCAGTTCTTC	CSARDYESYNEQFF	TRBV20-1	TRBJ2-1
TGTGCCAGCAGCTTAGGCCCTACCGACAGAGGATCCTACGAGCAGTACTTC	CASSLGPTDRGSYEQYF	TRBV7-9	TRBJ2-7
TGTGCCAGCAGCCCGGGCAGACAGGGGGGTTCCTACGAGCAGTACTTC	CASSPGRQGGSYEQYF	TRBV4-2	TRBJ2-7
TGTGCCAGCAGCTTGGCGCAGGCAAAAGACTCCTACGAGCAGTACTTC	CASSLAQAKDSYEQYF	TRBV5-5	TRBJ2-7
TGTGCCAGCAGTTTTCTGACCACAGATACGCAGTATTTT	CASSFLTTDTQYF	TRBV12-3	TRBJ2-3
TGTGCCAGCAGTTACACGCCTCTGGAGGGTTATCAGCCCCAGCATTTT	CASSYTPLEGYQPQHF	TRBV6-5	TRBJ1-5
TGTGCCAGCAGCCTCGGGGCCAATGGGGACGAGCAGTACTTC	CASSLGANGDEQYF	TRBV7-3	TRBJ2-7
TGTGCCAGCACGCCAAGGGACTTCGGGACCTACAATGAGCAGTTCTTC	CASTPRDFGTYNEQFF	TRBV11-3	TRBJ2-1
TGCGCCAGCAGCTTGGGGCATTGGGGGCACGAGGCGGAGCAGTACTTC	CASSLGHWGHEAEQYF	TRBV5-1	TRBJ2-7
TGCAGTGCTAGCGTTATAACGTCGGCAACTAATGAAAAACTGTTTTTT	CSASVITSATNEKLFF	TRBV20-1	TRBJ1-4
TGCAGCGTTGAAGCCCCACAGGGCGCAACTAATGAAAAACTGTTTTTT	CSVEAPQGATNEKLFF	TRBV29-1	TRBJ1-4
TGTGCCACCAGCCGAAGGTCGGGGACTAGCGGGGTGGGCTATGAGCAGTTCTTC	CATSRRSGTSGVGYEQFF	TRBV15	TRBJ2-1
TGCAGTGCTGTTATACGGGGGGGCATTCAGTACTTC	CSAVIRGGIQYF	TRBV20-1	TRBJ2-4
TGTGCCAGCAGCCAAGATCCCGGGGGGGGGAAAAGCTCCTACAATGAGCAGTTCTTC	CASSQDPGGGKSSYNEQFF	TRBV3-1	TRBJ2-1
TGTGCCAGCAGTTATCTGGGGGGAAAGGGGGAAGGCAACACTGAAGCTTTCTTT	CASSYLGGKGEGNTEAFF	TRBV6-6	TRBJ1-1
TGTGCCCGTGATGGAATACTTTCGCCCGAGCAGTACTTC	CARDGILSPEQYF	TRBV7-9	TRBJ2-7
TGTGCCTGGAGCTTTTACAATGAGCAGTTCTTC	CAWSFYNEQFF	TRBV30	TRBJ2-1
TGTGCCATCAGTGAGTGTGGAGGTGGCCCTTACGAGCAGTACTTC	CAISECGGGPYEQYF	TRBV10-3	TRBJ2-7
TGTGCCAGCAGTGTCGGGGGACAGGGTTCCTACGAGCAGTACTTC	CASSVGGQGSYEQYF	TRBV6-1	TRBJ2-7
TGCGCCAGCAGCCAGCTTCCAAAACCGAGACAGCCCGGGCCCCAGCATTTT	CASSQLPKPRQPGPQHF	TRBV5-1	TRBJ1-5
TGTGCCAGGGGGGGCCGTCTCAATGAGCAGTTCTTC	CARGGRLNEQFF	TRBV19	TRBJ2-1
TGTGCCAGCAGCCTCCCCTCAGGGGACAGGGGGACCTCTGGAAACACCATATATTTT	CASSLPSGDRGTSGNTIYF	TRBV14	TRBJ1-3
TGTGCCAGCGCGAGACAGGGGGTCACTGAAGCTTTCTTT	CASARQGVTEAFF	TRBV28	TRBJ1-1
TGTGCCTGGAAAACCCAACAGAGTCAGCCCCAGCATTTT	CAWKTQQSQPQHF	TRBV30	TRBJ1-5
TGTGCCAGCAGTTCCCAACGGCTTCCCCCTCAGCCCCAGCATTTT	CASSSQRLPPQPQHF	TRBV28	TRBJ1-5
TGTGCCAGCAGCAATGGTCGGGAGAGACCTCTCGATAGAGAAAAACTGTTTTTT	CASSNGRERPLDREKLFF	TRBV7-9	TRBJ1-4
TGTGCCAGCAGGATTGGTGGACAGGGAGGGGCGCCCAGTCAGCCCCAGCATTTT	CASRIGGQGGAPSQPQHF	TRBV6-8	TRBJ1-5
TGTGCCAGCAGCCCTTTGGGGGCAGGGACCCGGCTCTACACCTTC	CASSPLGAGTRLYTF	TRBV14	TRBJ1-2
TGTGCCAGCAGTGAAGCGTCCCCGTGGACAGGGCGTTACTCCTACGAGCAGTACTTC	CASSEASPWTGRYSYEQYF	TRBV6-1	TRBJ2-7
TGTGCCAGCATTCCCTACGGACGCAGGGGGGGACAGTACTTC	CASIPYGRRGGQYF	TRBV6-3	TRBJ2-7
TGTGCCAGCAGCTTAGGGTCGTCCCGGGCAAAGGCCGTCGAGCAGTACTTC	CASSLGSSRAKAVEQYF	TRBV7-4	TRBJ2-7
TGCGCCAGCAGCAGGAGGAGGGGGGGCGGAGGAAACACTGAAGCTTTCTTT	CASSRRRGGGGNTEAFF	TRBV5-1	TRBJ1-1
TGCAGTGCTAGAGATGGGGGCGGGGGGCCCCAGCATTTT	CSARDGGGGPQHF	TRBV20-1	TRBJ1-5
TGTGCCACCAGTGATTCGGGACAGGAGAGTGAAAAACTGTTTTTT	CATSDSGQESEKLFF	TRBV24-1	TRBJ1-4
TGTGCCAGCAGTGAATTAACATCTTGCGGGAGCGGGGCTAGCTCCTACGAGCAGTACTTC	CASSELTSCGSGASSYEQYF	TRBV6-1	TRBJ2-7
TGTGCCAGCAGGTCATGGAGGGCGGCTGAGCAGTTCTTC	CASRSWRAAEQFF	TRBV12-4	TRBJ2-1
TGTGCCAGCAGGGGGGGCCAAGCGAACACCGGGGAGCTGTTTTTT	CASRGGQANTGELFF	TRBV27	TRBJ2-2
TGTGCCACCAGTGTTGCCCGGTACGGAACAGGGGGGCAGGGTCAGCCCCAGCATTTT	CATSVARYGTGGQGQPQHF	TRBV24-1	TRBJ1-5
TGCGCCAACCAACAGGGCTCGAACACTGAAGCTTTCTTT	CANQQGSNTEAFF	TRBV10-1	TRBJ1-1
TGTGCCAGCAGCGTAGACAGGGGGAATCAGCCCCAGCATTTT	CASSVDRGNQPQHF	TRBV6-2	TRBJ1-5
TGCGCCAGCAGCTTGGCCTGGGGAGGACCAGGGGAGCCCACAGATACGCAGTATTTT	CASSLAWGGPGEPTDTQYF	TRBV5-1	TRBJ2-3
TGTGCCAGCAGTGTGCCGGGACAGGGGATAACAGATACGCAGTATTTT	CASSVPGQGITDTQYF	TRBV27	TRBJ2-3
TGCCGCCCTAGCGGGAAGGAGACCCAGTACTTC	CRPSGKETQYF	TRBV20-1	TRBJ2-5
TGTGCCTGGCTGAACAGGGAAATGCCCCAGCATTTT	CAWLNREMPQHF	TRBV30	TRBJ1-5
TGTGCCAGCAGTAGAACTACTAGGGAAAGAGAGACCCAGTACTTC	CASSRTTRERETQYF	TRBV6-4	TRBJ2-5
TGCGCCAGCAGCTTAGTTAATGAGCAGTTCTTC	CASSLVNEQFF	TRBV5-1	TRBJ2-1
TGTGCCAGCAGCCCTGGGACTAGCGGACGCTCCTACGAGCAGTACTTC	CASSPGTSGRSYEQYF	TRBV7-2	TRBJ2-7
TGTGCCAGCAGCTTAGAACCCTGGACTAGCGGTGAATCCTACGAGCAGTACTTC	CASSLEPWTSGESYEQYF	TRBV7-2	TRBJ2-7
TGTGCCAGCAGCTCGAGGGGTGTTTCTGAAGCTTTCTTT	CASSSRGVSEAFF	TRBV7-3	TRBJ1-1
TGTGCCAGCAGCCCCAACCCGACAGGGACCCAGTACTTC	CASSPNPTGTQYF	TRBV14	TRBJ2-5
TGCGCCAGCAGTAGCCGGACAGGGGGCCAGGCTAATGAAAAACTGTTTTTT	CASSSRTGGQANEKLFF	TRBV5-1	TRBJ1-4
TGTGCCAGCAGTTATGATGACAGGGGGCCGGAAGGGGCGGGAGGCTACACCTTC	CASSYDDRGPEGAGGYTF	TRBV6-3	TRBJ1-2
TGCGCCAGCAGCCGGTGGACCCCGGCCGCCCTCTACGAGCAGTACTTC	CASSRWTPAALYEQYF	TRBV4-3	TRBJ2-7
TGTGCCAGCACTCGAGTGGGGTCCCAAACCTACAATGAGCAGTTCTTC	CASTRVGSQTYNEQFF	TRBV27	TRBJ2-1
TGCGCCAGCAGCCCAACAGGGATGTACTATGGCTACACCTTC	CASSPTGMYYGYTF	TRBV4-1	TRBJ1-2
TGTGCCTGGAGCCCGGGACAGGGTCCAAATCAGCCCCAGCATTTT	CAWSPGQGPNQPQHF	TRBV30	TRBJ1-5
TGCAGCGTTGACAAAATTGTAGGAGGGGTAGTTAGAAACATTCAGTACTTC	CSVDKIVGGVVRNIQYF	TRBV29-1	TRBJ2-4
TGTGCCAGCAGTGACCCCGGGCGGACAGGGCTCTACGAGCAGTACTTC	CASSDPGRTGLYEQYF	TRBV6-1	TRBJ2-7
TGTGCCTGGAGTGTAAGGTGGGGGACTAGCGGCTACGAGCAGTACTTC	CAWSVRWGTSGYEQYF	TRBV30	TRBJ2-7
TGTGCCAGCTCAGGACCTACGATGTATGGCTACACCTTC	CASSGPTMYGYTF	TRBV12-3	TRBJ1-2
TGTGCCAGCAGCGACCCCGAACCCGGGACGAACGAGACCCAGTACTTC	CASSDPEPGTNETQYF	TRBV5-5	TRBJ2-5
TGCGCCAGCAGCTTGAAAGAGGCAAGATCCTACGAGCAGTACTTC	CASSLKEARSYEQYF	TRBV5-1	TRBJ2-7
TGTGCCAGCAGTTTAGGGGTCCGAGCTTTCTTT	CASSLGVRAFF	TRBV6-5	TRBJ1-1
TGTGCCTGGAGAGCCGACAGCTATGGCTACACCTTC	CAWRADSYGYTF	TRBV30	TRBJ1-2
TGTGCCAGCAGTTTATGGTCATTTCTGAGGGGGGAGCCCCAGCATTTT	CASSLWSFLRGEPQHF	TRBV27	TRBJ1-5
TGTGCCAGCAGCCAAGATAAAGTCAAAGTGAAGGACTACGAGCAGTACTTC	CASSQDKVKVKDYEQYF	TRBV4-2	TRBJ2-7
TGTGCCAGCAGCTTTACAGGACTTTCCGGGACAGGGTTGGATGGCTACACCTTC	CASSFTGLSGTGLDGYTF	TRBV7-9	TRBJ1-2
TGTGCCAGCAGCTTAAGGTTCACAGGTCCTGCAGAGAACACTGAAGCTTTCTTT	CASSLRFTGPAENTEAFF	TRBV7-6	TRBJ1-1
TGCAGCGTTATGGGGGTTGACACTGAAGCTTTCTTT	CSVMGVDTEAFF	TRBV29-1	TRBJ1-1
TGCAGTGCTTCGGGGGGGCCCTGGGGTATCGGGGAGCTGTTTTTT	CSASGGPWGIGELFF	TRBV20-1	TRBJ2-2
TGTGCCTGGAGTGTACTCTACGGACGCCAGGCTTCCAACACTGAAGCTTTCTTT	CAWSVLYGRQASNTEAFF	TRBV30	TRBJ1-1
TGTGCCAGCAGTTTGGGCAGAGGGAAAGAGACCCAGTACTTC	CASSLGRGKETQYF	TRBV27	TRBJ2-5
TGTGCCAGCAGTGAAAATCCCGGAACATGCGAGCAGTTCTTC	CASSENPGTCEQFF	TRBV6-1	TRBJ2-1
TGTGCCACCGGGTGGGGCCGCGGGGAGCTGTTTTTT	CATGWGRGELFF	TRBV24-1	TRBJ2-2
TGCAGTGCTAGAGGCTACGGGCCGACCCAGTACTTC	CSARGYGPTQYF	TRBV20-1	TRBJ2-5
TGTGCCAGCAAGTCCCGAGAAAGGACTAGATACACCGGGGAGCTGTTTTTT	CASKSRERTRYTGELFF	TRBV6-1	TRBJ2-2
TGTGCCAGCAGCTGTCTGTGGGACAGGGTAGTCCCGAACACTGAAGCTTTCTTT	CASSCLWDRVVPNTEAFF	TRBV14	TRBJ1-1
TGTGCCAGCAGTGACCAGGCGGGGAGGGGAGAAAAACTGTTTTTT	CASSDQAGRGEKLFF	TRBV6-4	TRBJ1-4
TGTGCCAGCAGCTTAGGATCGGGCAACCCGGCCGGCTACACCTTC	CASSLGSGNPAGYTF	TRBV7-8	TRBJ1-2
TGCAGTGCTATGGGACAGGGATTACATGAAAAACTGTTTTTT	CSAMGQGLHEKLFF	TRBV20-1	TRBJ1-4
TGTGCCAGCAGCACCCCTGGGAGACTCGAGGTAGGCTATGGCTACACCTTC	CASSTPGRLEVGYGYTF	TRBV6-2	TRBJ1-2
TGTGCCAGCAGTGTGGGCTGGCCACTAGCGGGAAGGCCTAGTTCCTACGAGCAGTACTTC	CASSVGWPLAGRPSSYEQYF	TRBV3-1	TRBJ2-7
TGTGCGGCCAGGGGGAAGAGCTACGAGCAGTACTTC	CAARGKSYEQYF	TRBV2	TRBJ2-7
TGTGCCAGCAGCACACTGCTCGGCCGACAAGGGACTGAAGCTTTCTTT	CASSTLLGRQGTEAFF	TRBV27	TRBJ1-1
TGTGCCAGCAGCTCTCTAAGTCGGGACAAGGATTACGAGCAGTACTTC	CASSSLSRDKDYEQYF	TRBV13	TRBJ2-7
TGTGCCACCAGCAGAGCAGGCAGGGTTTACACTGAAGCTTTCTTT	CATSRAGRVYTEAFF	TRBV15	TRBJ1-1
TGCGCCAGCAGCAGCCGGTATAGCAATCAGCCCCAGCATTTT	CASSSRYSNQPQHF	TRBV5-1	TRBJ1-5
TGTGCCAGCAGAGGGGGGGAACCATACGAGCAGTACTTC	CASRGGEPYEQYF	TRBV6-4	TRBJ2-7
TGTGCCAGCAGCTTAGGGTTACAGGGGATGATCTGGTCACCCCTCCACTTT	CASSLGLQGMIWSPLHF	TRBV7-6	TRBJ1-6
TGCGCCAGCAGCCGGACAGGGTATAATTCACCCCTCCACTTT	CASSRTGYNSPLHF	TRBV10-2	TRBJ1-6
TGTGCCACCAGTGCTGGGGGCAGTGAAGCTTTCTTT	CATSAGGSEAFF	TRBV24-1	TRBJ1-1
TGCAGTGCTAGAAGGTTCGGACTCTCTGAAGCTTTCTTT	CSARRFGLSEAFF	TRBV20-1	TRBJ1-1
TGTGCCACCAGTGAGGGGACTAGCGGGCAAGTCTTC	CATSEGTSGQVF	TRBV24-1	TRBJ2-1
TGCAGTGCTTCCTGGGGGGTTTACGAGCAGTACTTC	CSASWGVYEQYF	TRBV20-1	TRBJ2-7
TGTGCCACCAGTGATTTCCGGGAGGGCCGGAGGCAAGAGACCCAGTACTTC	CATSDFREGRRQETQYF	TRBV24-1	TRBJ2-5
TGTGCCAGCAGCAAGGACAGCTACTATGGCTACACCTTC	CASSKDSYYGYTF	TRBV9	TRBJ1-2
TGTGCCAGCAGCACGTCTAGCGAAAAGGGAAATGAGCAGTTCTTC	CASSTSSEKGNEQFF	TRBV13	TRBJ2-1
TGCAGTGCTCGGTTTACGGGACAGACCCTTAGCAATCAGCCCCAGCATTTT	CSARFTGQTLSNQPQHF	TRBV20-1	TRBJ1-5
TGTGCCAGCAGCACGCGGGAGGAGAACACTGAAGCTTTCTTT	CASSTREENTEAFF	TRBV6-1	TRBJ1-1
TGTGCCAGCAGCGAAAGTCTAAATCAGCCCCAGCATTTT	CASSESLNQPQHF	TRBV7-6	TRBJ1-5
TGCAGTGCTAGCGGGACAGTATGCAATCAGCCCCAGCATTTT	CSASGTVCNQPQHF	TRBV20-1	TRBJ1-5
TGTGCCAGCAGCTTCAGGCAGACCTACGAGCAGTACTTC	CASSFRQTYEQYF	TRBV7-3	TRBJ2-7
TGTGCCACCAGTGATTCCCTAGGGGGGGTGGAGGATGAGCAGTTCTTC	CATSDSLGGVEDEQFF	TRBV24-1	TRBJ2-1
TGCAGTGCTAGACAATTGCTGACAGGGCTCGGCCAGCCCCAGCATTTT	CSARQLLTGLGQPQHF	TRBV20-1	TRBJ1-5
TGTGCCAGCTCACCACCTATGGGGAAAGAAGCGACTAATGAAAAACTGTTTTTT	CASSPPMGKEATNEKLFF	TRBV18	TRBJ1-4
TGTGCCAGCAGTTACCGGGTGGACTATTACAATGAGCAGTTCTTC	CASSYRVDYYNEQFF	TRBV6-5	TRBJ2-1
TGTGCCAGCAGGGGATCGTTGGGAACCTACAATGAGCAGTTCTTC	CASRGSLGTYNEQFF	TRBV6-5	TRBJ2-1
TGTGCCAGCAAAGATTGGGGGACAGGAACGGAGCGAGGAAGCAATCAGCCCCAGCATTTT	CASKDWGTGTERGSNQPQHF	TRBV6-1	TRBJ1-5
TGCGCCAGGGACAGCCATTGGAATGAGCAGTTCTTC	CARDSHWNEQFF	TRBV4-3	TRBJ2-1
TGTGCCAGCAGCAGACTGGTAGCCCGTAACACTGAAGCTTTCTTT	CASSRLVARNTEAFF	TRBV7-3	TRBJ1-1
TGCAGTGCTAGAGCTGTCCTACGGGGACTAGCGGGGGGTTACTCCACAGATACGCAGTATTTT	CSARAVLRGLAGGYSTDTQYF	TRBV20-1	TRBJ2-3
TGTGCCAGCAGCGGGTCTGGGGGCTCCTACGAGCAGTACTTC	CASSGSGGSYEQYF	TRBV9	TRBJ2-7
TGTGCCAGCAGCTTAGATCCCGAGGGACAACGGGACGAGTCTCGCACTGAAGCTTTCTTT	CASSLDPEGQRDESRTEAFF	TRBV11-2	TRBJ1-1
TGTGCCAGCAGCTTAGTCTTGATCGGACTAGCGGATAGCGGGGAGCTGTTTTTT	CASSLVLIGLADSGELFF	TRBV11-3	TRBJ2-2
TGTGCCAGCAGTAAACAGCACCGGAGGGGCGACTATGGCTACACCTTC	CASSKQHRRGDYGYTF	TRBV27	TRBJ1-2
TGTGCCAGGTCCGACAGGGACGCCACTGAAGCTTTCTTT	CARSDRDATEAFF	TRBV6-4	TRBJ1-1
TGTGCCACCAGTCCGCCGGGCCCGCGGGCTGAGACCCAGTACTTC	CATSPPGPRAETQYF	TRBV24-1	TRBJ2-5
TGTGCCAGCAGCAGCACAGGGTCGGGGGGTAGCTTCGACACTGAAGCTTTCTTT	CASSSTGSGGSFDTEAFF	TRBV7-9	TRBJ1-1
TGTGCCTGGAGTGTACAACCCAGACAGGGGGACTTC	CAWSVQPRQGDF	TRBV30	TRBJ2-7
TGTGCCAGCAGCTACGTGACGTTCTCCTACGAGCAGTACTTC	CASSYVTFSYEQYF	TRBV7-6	TRBJ2-7
TGTGCCAGCAGTTTATTTACCGTTAAGGCAAGAAAATGCGACTCTACAGATACGCAGTATTTT	CASSLFTVKARKCDSTDTQYF	TRBV28	TRBJ2-3
TGTGCCACCAGTGATTTTGATGCTCGTCCCACAGGGCGTTGGCAAGTAAATCAGCCCCAGCATTTT	CATSDFDARPTGRWQVNQPQHF	TRBV24-1	TRBJ1-5
TGCGCCAGCAGCCAGTTATTGGTAGCGGGGGACGAGCAGTACTTC	CASSQLLVAGDEQYF	TRBV4-1	TRBJ2-7
TGTGCCAGCCATCAGAAACGCACAGATACGCAGTATTTT	CASHQKRTDTQYF	TRBV27	TRBJ2-3
TGCGCCAGGGCTAGCGAGTCGTCCTACAATGAGCAGTTCTTC	CARASESSYNEQFF	TRBV10-1	TRBJ2-1
TGTGCCAGCAGTTGGGTACACCAGACAGATACGCAGTATTTT	CASSWVHQTDTQYF	TRBV6-3	TRBJ2-3
TGTGCCAGTTTTCCGGGCGGCGTAGCTTTCTTT	CASFPGGVAFF	TRBV27	TRBJ1-1
TGTGCCAGCAGTTTAGGCAGCCACAATGAGCAGTTCTTC	CASSLGSHNEQFF	TRBV27	TRBJ2-1
TGTGCCAGCAGGAGTGTTGGAGCGACCCGACTAGCGGGAGATACGCAGTATTTT	CASRSVGATRLAGDTQYF	TRBV6-5	TRBJ2-3
TGTGCCAGCAGTTACGTCCTAGCGGGCACAGATACGCAGTATTTT	CASSYVLAGTDTQYF	TRBV6-5	TRBJ2-3
TGCGCCAGCTCCAGACTTTCTGAAGCTTTCTTT	CASSRLSEAFF	TRBV10-1	TRBJ1-1
TGCAGTGCATGGGGGGGGGCTTCCGGGCAGTATTTT	CSAWGGASGQYF	TRBV20-1	TRBJ2-3
TGTGCCAGCAGTTACCGCCGCTTAGGAAACACCATATATTTT	CASSYRRLGNTIYF	TRBV6-5	TRBJ1-3
TGTGCCTGGTACCATGGACAGGGAGAATGCCTCGGGCATGAAGCTTTCTTT	CAWYHGQGECLGHEAFF	TRBV30	TRBJ1-1
TGTGCCAGCAGCAACCGCTTAGCGCAGATCGACGAGCAGTACTTC	CASSNRLAQIDEQYF	TRBV11-3	TRBJ2-7
TGTGCCAGCAGCGTAAGAATATATTTT	CASSVRIYF	TRBV7-2	TRBJ1-3
TGTGCCAGCAGCACCACAAGCACAGATACGCAGTATTTT	CASSTTSTDTQYF	TRBV9	TRBJ2-3
TGTGCCAGCAGATCCTTGAAGGGGGCTGACGGGCAGCCCCAGCATTTT	CASRSLKGADGQPQHF	TRBV6-4	TRBJ1-5
TGTGCCAGCAGTGAAGAAGGGCTCCAGCCCCAGCATTTT	CASSEEGLQPQHF	TRBV2	TRBJ1-5
TGTGCCAGTAGTGGGGTCGACAGGGGGGGGGGGGAAGAGACCCAGTACTTC	CASSGVDRGGGEETQYF	TRBV19	TRBJ2-5
TGCAGCGAAAGCGGCCGTTGCTACGAGCAGTACTTC	CSESGRCYEQYF	TRBV29-1	TRBJ2-7
TGCGCCAGCAGCGGTTACCCTGTTTTACTAGATACGCAGTATTTT	CASSGYPVLLDTQYF	TRBV5-1	TRBJ2-3
TGTGCCACCGGCCGGGACAGGGGGGACCTGGGCGAGACCCAGTACTTC	CATGRDRGDLGETQYF	TRBV24-1	TRBJ2-5
TGTGCCAGCCAGGGGAATTGCTCTGGGGCCAACGTCCTGACTTTC	CASQGNCSGANVLTF	TRBV27	TRBJ2-6
TGTGCCAGCAGCCCGGGACTAGCGGGCGCCATCAATGAGCAGTTCTTC	CASSPGLAGAINEQFF	TRBV14	TRBJ2-1
TGTGCCAGCTCACCAAGGGGGGGGTGGGGACTAGCGGGGGGTCTCAGGTACTTC	CASSPRGGWGLAGGLRYF	TRBV18	TRBJ2-5
TGTGCCAGCAGCACCCACCGGGACAAGGGGGCCAACGTCCTGACTTTC	CASSTHRDKGANVLTF	TRBV7-2	TRBJ2-6
TGTGCCACCAGTATGGGGACCAGCCCCCCATACAATGAGCAGTTCTTC	CATSMGTSPPYNEQFF	TRBV24-1	TRBJ2-1
TGTGCCAGCAGCGTAGCGACGCGGGACAGGGCTCTAGAGCAGTACTTC	CASSVATRDRALEQYF	TRBV9	TRBJ2-7
TGCAGTGCTAGGTGGGGCTATGGGGGGCAAGAGACCCAGTACTTC	CSARWGYGGQETQYF	TRBV20-1	TRBJ2-5
TGTGCCAGCAGCTCCAGGGGGCTGGGGAGCGCAGATACGCAGTATTTT	CASSSRGLGSADTQYF	TRBV6-5	TRBJ2-3
TGTGCCAGCAGCTTCCCTCCTAGGGAGACCCAGTACTTC	CASSFPPRETQYF	TRBV7-2	TRBJ2-5
TGTGCCAGCAGCATAAACAGGTTCCGTGCTGAAGCTTTCTTT	CASSINRFRAEAFF	TRBV7-9	TRBJ1-1
TGCAGCGAGATCCGGGGACTGGGGAAGTCTAATCAGCCCCAGCATTTT	CSEIRGLGKSNQPQHF	TRBV29-1	TRBJ1-5
TGTGCCAGCAGCTCGAACGGGGGACAGCCGGACACCGGGGAGCTGTTTTTT	CASSSNGGQPDTGELFF	TRBV5-6	TRBJ2-2
TGTGCCAGCAGCGGCTTCTCCGCCTACGAGCAGTACTTC	CASSGFSAYEQYF	TRBV7-9	TRBJ2-7
TGTGCCAGCAGCCGGTCCCAGACAGGTCACGAGCAGTACTTC	CASSRSQTGHEQYF	TRBV3-1	TRBJ2-7
TGTGCCAGCCCTACCGACAGGGGGGCAGGAAACACCATATATTTT	CASPTDRGAGNTIYF	TRBV6-1	TRBJ1-3
TGTGCCAGACAGGGCTACGAGCAGTACTTC	CARQGYEQYF	TRBV6-5	TRBJ2-7
TGTGCCAGCAGTTTAGGTGATTGGTCAGGGGAGATTCAGCCCCAGCATTTT	CASSLGDWSGEIQPQHF	TRBV28	TRBJ1-5
TGTGCCAGCAGCACCGGACGTAGACAGTACTTC	CASSTGRRQYF	TRBV6-1	TRBJ2-4
TGTGCCAGCAGCTTACTAGCGGGGGGGCCGGGAAATAATGAGCAGTTCTTC	CASSLLAGGPGNNEQFF	TRBV7-9	TRBJ2-1
TGTGCCAGCAGTGAGTGGCCGACATGCGGCACCGGGGAGCTGTTTTTT	CASSEWPTCGTGELFF	TRBV6-4	TRBJ2-2
TGCAGTGCTAGAGAACCCGTTGCCAAGCGTACAGAATTCGGGAATGAGCAGTTCTTC	CSAREPVAKRTEFGNEQFF	TRBV20-1	TRBJ2-1
TGTGCCAGCAGTTTACGAAATAGGGTAGCCACAGATACGCAGTATTTT	CASSLRNRVATDTQYF	TRBV28	TRBJ2-3
TGTGCCAGCATTACCCCGGGACAGGGTATTTGGACCCAGCATTTT	CASITPGQGIWTQHF	TRBV9	TRBJ1-5
TGTGCCAGCAGCTTGGACCGACACAGGGTACTAATTTACTATGGCTACACCTTC	CASSLDRHRVLIYYGYTF	TRBV7-3	TRBJ1-2
TGTGCCAGGCATCCCAGCGGCGAGGGTAACTATGGCTACACCTTC	CARHPSGEGNYGYTF	TRBV28	TRBJ1-2
TGTGCCAGCAGCCACGGAGAGGGGGCACCCTCCTACGAGCAGTACTTC	CASSHGEGAPSYEQYF	TRBV3-1	TRBJ2-7
TGCAGTGCCAGACGGACAGCCGAACAAGAGACCCAGTACTTC	CSARRTAEQETQYF	TRBV20-1	TRBJ2-5
TGTGCCGGGACCTCGACAGGGGGGAGCCAAGAGACCCAGTACTTC	CAGTSTGGSQETQYF	TRBV18	TRBJ2-5
TGTGCCAGCAGCTTAGGTCCCGGGACAGCTTACACTGAAGCTTTCTTT	CASSLGPGTAYTEAFF	TRBV7-9	TRBJ1-1
TGTGCCACCAGTGATTTTACTCCCGACAAACCAACTAATGAAAAACTGTTTTTT	CATSDFTPDKPTNEKLFF	TRBV24-1	TRBJ1-4
TGTGCCAGCAGCTTATCGGACAGGGGCTACGAGCAGTACTTC	CASSLSDRGYEQYF	TRBV7-8	TRBJ2-7
TGTGCCAGCAGCCCCGGGACGACCTACGAGCAGTACTTC	CASSPGTTYEQYF	TRBV28	TRBJ2-7
TGTGCCAGCAGCTTAGGGGAAGGAAATTCACCCCTCCACTTT	CASSLGEGNSPLHF	TRBV11-1	TRBJ1-6
TGTGCCTGGAAGGGACAGGGGGCATGCTCCTACAATGAGCAGTTCTTC	CAWKGQGACSYNEQFF	TRBV30	TRBJ2-1
TGTGCCAGCAGCTTCGCGGATCCCAACATGAACACTGAAGCTTTCTTT	CASSFADPNMNTEAFF	TRBV7-9	TRBJ1-1
TGTGCCAGCAGTGAGGCGGTGATAGAGCAGTACTTC	CASSEAVIEQYF	TRBV6-1	TRBJ2-7
TGTGCCAGCAATCAAGAGGGGGAGAATCAGCCCCAGCATTTT	CASNQEGENQPQHF	TRBV14	TRBJ1-5
TGTGCCAGCAGGAGAGGACAGGGGGCACTCAATCAGCCCCAGCATTTT	CASRRGQGALNQPQHF	TRBV5-4	TRBJ1-5
TGTGCCAGCAGCGTAGCCAACAGGGGGCGGTTTTTGTACGAGCAGTACTTC	CASSVANRGRFLYEQYF	TRBV9	TRBJ2-7
TGTGCCTGGACGGGACAGGGGAATTCACCCCTCCACTTT	CAWTGQGNSPLHF	TRBV30	TRBJ1-6
TGTGCCAGCAGCAGCAACAGGGGGAGCTATCCGGTCCACTATGGCTACACCTTC	CASSSNRGSYPVHYGYTF	TRBV6-5	TRBJ1-2
TGTGCCAGCAGTTACGAGAATCGGGCCAGGGACACCATATATTTT	CASSYENRARDTIYF	TRBV6-5	TRBJ1-3
TGCAGTGCGTTTTCCGACGACAGGGGCCACTATGGCTACACCTTC	CSAFSDDRGHYGYTF	TRBV20-1	TRBJ1-2
TGTGCCAGCAGCGTAGATGGGACTGGCTACGAGCAGTACTTC	CASSVDGTGYEQYF	TRBV9	TRBJ2-7
TGTGCCAGCAGTTTTAGAGGGCGTGGGTGTTCATACACCGGGGAGCTGTTTTTT	CASSFRGRGCSYTGELFF	TRBV6-2	TRBJ2-2
TGTGCCAGCAGTGTTGGGACTCGCCAACGAGAGACCCAGTACTTC	CASSVGTRQRETQYF	TRBV6-4	TRBJ2-5
TGCGCCAGCAGCCACGCTAAAGGGAGGGGACATGAGCAGTTCTTC	CASSHAKGRGHEQFF	TRBV4-1	TRBJ2-1
TGCGCCAGCAGCTTGAGCGGGAGAACGAGCTCTGGAAACACCATATATTTT	CASSLSGRTSSGNTIYF	TRBV5-1	TRBJ1-3
TGTGCCAGCTCACCACCCTTACAGGGCCTCCACTTT	CASSPPLQGLHF	TRBV18	TRBJ1-6
TGTGCCAGCAGCTTAACAGGGCAAGCTTTCTTT	CASSLTGQAFF	TRBV7-2	TRBJ1-1
TGTGCCATCCCCACTAGCGGGGGGGCCATTGAGCAGTTCTTC	CAIPTSGGAIEQFF	TRBV10-3	TRBJ2-1
TGTGCCACAGGGCGCGTCTACGAGCAGTACTTC	CATGRVYEQYF	TRBV28	TRBJ2-7
TGTGCCAGCCCCACTAGCGGGAGTGGGACAGATACGCAGTATTTT	CASPTSGSGTDTQYF	TRBV7-9	TRBJ2-3
TGTGCCAGCGGCGCGACAGGGTGGGACGACGAGCAGTACTTC	CASGATGWDDEQYF	TRBV9	TRBJ2-7
TGCGCCAGCCGAATGGGGACAGAAGAGCACACCATATATTTT	CASRMGTEEHTIYF	TRBV5-1	TRBJ1-3
TGTGCCAGCAGCCCCCGGGCCGGTATTTACAATGAGCAGTTCTTC	CASSPRAGIYNEQFF	TRBV3-1	TRBJ2-1
TGTGCCAGCAGTTTATGTCGTCAACAGACGAGCACAGATACGCAGTATTTT	CASSLCRQQTSTDTQYF	TRBV28	TRBJ2-3
TGTGCCAGCAGCTTAGATAAGCGTGACAGGGCAAAGTTAGTTGAACAGGAGAACACTGAAGCTTTCTTT	CASSLDKRDRAKLVEQENTEAFF	TRBV11-2	TRBJ1-1
TGTGCCAGCAGCGTAAACAGGGATACCCTCCACTTT	CASSVNRDTLHF	TRBV9	TRBJ1-6
TGTGCCAGCAGCTTGGTCTCGTTAACCTACAATGAGCAGTTCTTC	CASSLVSLTYNEQFF	TRBV5-6	TRBJ2-1
TGTGCCAGCAGCTTAGCACCAGTGGGGACAGGGAACAATGAGCAGTTCTTC	CASSLAPVGTGNNEQFF	TRBV7-4	TRBJ2-1
TGCGCCAGCAGCTTGGCCCTGACAGGGGCAAACACCGGGGAGCTGTTTTTT	CASSLALTGANTGELFF	TRBV5-1	TRBJ2-2
TGCGCCAGCAGCCTACCGTATGCCACTGAAGCTTTCTTT	CASSLPYATEAFF	TRBV5-1	TRBJ1-1
TGTGCCAGCAGCCAATCGACGGGAGGGGAGCAGTTCTTC	CASSQSTGGEQFF	TRBV14	TRBJ2-1
TGTGCCAGCAGCAGACTAGGCAAGAAACAAGAGACCCAGTACTTC	CASSRLGKKQETQYF	TRBV13	TRBJ2-5
TGTGCCAGCAGAAGGAGCGGTATTACCACTGAAGCTTTCTTT	CASRRSGITTEAFF	TRBV12-4	TRBJ1-1
TGTGCCAGCAGCCAAGCAGCTCATCACGAGCAGTACTTC	CASSQAAHHEQYF	TRBV14	TRBJ2-7
TGTGCCGTAGACACCACCGACGAGCAGTACTTC	CAVDTTDEQYF	TRBV6-1	TRBJ2-7
TGTGCCAGCAGTCATAGCGCAGGGACTGGGGGAGGCAATCAGCCCCAGCATTTT	CASSHSAGTGGGNQPQHF	TRBV28	TRBJ1-5
TGTGCCAGCAGTTACATTCTTGCCGGGACAGGTAAGACAAAATATGGCTACACCTTC	CASSYILAGTGKTKYGYTF	TRBV6-5	TRBJ1-2
TGTGCCATCATCTTTGGACTAGGCGAGGAGCAGTTCTTC	CAIIFGLGEEQFF	TRBV10-3	TRBJ2-1
TGTGCCAGCAGTCTATTACACAATGAGCAGTTCTTC	CASSLLHNEQFF	TRBV7-9	TRBJ2-1
TGCGCCAGCAGCTTGGCTAAATTTCAATGGCAATTTAAGAAATATTCCGGGACTAGCGGGGGCAATGAGCAGTTCTTC	CASSLAKFQWQFKKYSGTSGGNEQFF	TRBV5-1	TRBJ2-1
TGTGCCATCATCCATAAATCAAACGAGCAGTACTTC	CAIIHKSNEQYF	TRBV10-3	TRBJ2-7
TGTGCCAGCAGCCCCGACAGGGGGCGCCAAGAGACCCAGTACTTC	CASSPDRGRQETQYF	TRBV6-4	TRBJ2-5
TGTGCTAGTGGTTTGGTAAGGAGGGGGGCTGTCTACAATGAGCAGTTCTTC	CASGLVRRGAVYNEQFF	TRBV12-5	TRBJ2-1
TGTGCCAGCAGCCAAGGAGCCATAAAGTTGACAATGACAGGGTTGGTAAATGAAAAACTGTTTTTT	CASSQGAIKLTMTGLVNEKLFF	TRBV14	TRBJ1-4
TGCGCCAGCAGCGCAGGGGCAGGGGTGAGCACTGAAGCTTTCTTT	CASSAGAGVSTEAFF	TRBV5-1	TRBJ1-1
TGTGCCAGCAGTTATCCCGGGGAAGGCAATGAGCAGTTCTTC	CASSYPGEGNEQFF	TRBV6-2	TRBJ2-1
TGCAGTGCTAGACTCAATGAGCAGTTCTTC	CSARLNEQFF	TRBV20-1	TRBJ2-1
TGCAGCGCCCCCGCGGCAGGCAATCAGCCCCAGCATTTT	CSAPAAGNQPQHF	TRBV29-1	TRBJ1-5
TGTGCCAGCAGAAGGCGGACAGGGGGCATGGGCAATCAGCCCCAGCATTTT	CASRRRTGGMGNQPQHF	TRBV27	TRBJ1-5
TGTGCCAGCAGTTGGGGTAAACTGCAAATGAACACTGAAGCTTTCTTT	CASSWGKLQMNTEAFF	TRBV12-4	TRBJ1-1
TGCGCCAGCAGCTTGGGGAGGAACACTGAAGCTTTCTTT	CASSLGRNTEAFF	TRBV5-1	TRBJ1-1
TGTGCTAGTGGTTTGGCATATAGTGGCGCAGGCCGGAGACATAACTATGGCTACACCTTC	CASGLAYSGAGRRHNYGYTF	TRBV12-5	TRBJ1-2
TGTGCCAGCAGCTTAGAGGGGGAGGGTGAGGCTTTCTTT	CASSLEGEGEAFF	TRBV7-9	TRBJ1-1
TGTGCCAGCAGCGACCGACTAGTGGATGAGCAGTTCTTC	CASSDRLVDEQFF	TRBV9	TRBJ2-1
TGTGCGCGGGGAAATCCCTACAATGAGCAGTTCTTC	CARGNPYNEQFF	TRBV12-3	TRBJ2-1
TGTGCCAGCAGCTCAACTGGCTTTGGACACGAGCAGTACTTC	CASSSTGFGHEQYF	TRBV7-9	TRBJ2-7
TGTGCCAGTCTCTCCAGTTATGATACGCAGTATTTT	CASLSSYDTQYF	TRBV2	TRBJ2-3
TGTGCCAGCAGCCGGGAGGGACAGGTAGTCAATCAGCCCCAGCATTTT	CASSREGQVVNQPQHF	TRBV6-4	TRBJ1-5
TGTGCCTGGAGTGTATTTCGAAACGGGGACGGCTACGAGCAGTACTTC	CAWSVFRNGDGYEQYF	TRBV30	TRBJ2-7
TGCAGTGCTGCGACGGAGCTAGAGACCCAGTACTTC	CSAATELETQYF	TRBV20-1	TRBJ2-5
TGCGCCAGCAGCCGGTCAGAGTGTTCCTCCCATACGCAGTATTTT	CASSRSECSSHTQYF	TRBV5-1	TRBJ2-3
TGTGCCAGGACGCTAGCGGGAGACTCTTCTTACAATGAGCAGTTCTTC	CARTLAGDSSYNEQFF	TRBV6-1	TRBJ2-1
TGTGCCAGCAGTTTAAACTCTCGTTCCACCTGGACCTGTTGCAATCAGCCCCAGCATTTT	CASSLNSRSTWTCCNQPQHF	TRBV12-3	TRBJ1-5
TGTGCCAGCACCCCGTTTAGGCAAGAGACCCAGTACTTC	CASTPFRQETQYF	TRBV7-9	TRBJ2-5
TGTGCCAGCGGACGACAGGACGAGCAGTACTTC	CASGRQDEQYF	TRBV28	TRBJ2-7
TGCAGCGTCCTAAGGGGGGACTGGACCAAAAACATTCAGTACTTC	CSVLRGDWTKNIQYF	TRBV29-1	TRBJ2-4
TGTGCCAGCAGTTACCACCCCCAGGGCCTTGGCAATCAGCCCCAGCATTTT	CASSYHPQGLGNQPQHF	TRBV6-5	TRBJ1-5
TGTGCCAGCAGCTTACGGAGGCGGAAGAACACTGAAGCTTTCTTT	CASSLRRRKNTEAFF	TRBV11-3	TRBJ1-1
TGTGCCACCAGTGATTCCAGACAGGGCACTGATCAGCCCCAGCATTTT	CATSDSRQGTDQPQHF	TRBV24-1	TRBJ1-5
TGTGAGCCAGGGTCCACTGAAGCTTTCTTT	CEPGSTEAFF	TRBV12-3	TRBJ1-1
TGTCCCGGGGACGGCGGCTACACCTTC	CPGDGGYTF	TRBV27	TRBJ1-2
TGTGCCAGCAGCTGGGGCAACGGGAGAGGGTTCACCTACGAGCAGTACTTC	CASSWGNGRGFTYEQYF	TRBV11-3	TRBJ2-7
TGTGCCTGGTCGGGACAGAGCTACAATGAGCAGTTCTTC	CAWSGQSYNEQFF	TRBV30	TRBJ2-1
TGTGCCAGCAGACCTGGAGGGTCATACACTGAAGCTTTCTTT	CASRPGGSYTEAFF	TRBV6-6	TRBJ1-1
TGTGCCAGCAGCTTCTTGTGGGAAGTTAAGGATGAGACCGGGGAGCTGTTTTTT	CASSFLWEVKDETGELFF	TRBV11-3	TRBJ2-2
TGTGCCAGCAGGGGATACGTAGGGGGCTACGAGCAGTACTTC	CASRGYVGGYEQYF	TRBV12-4	TRBJ2-7
TGTGCCAGCAGCTTAGATCAGGGAGCGAGCAATCAGCCCCAGCATTTT	CASSLDQGASNQPQHF	TRBV11-3	TRBJ1-5
TGCAGTGCTAGAGATCATGCCGAACAGGGGGGAAGCTCCTACGAGCAGTACTTC	CSARDHAEQGGSSYEQYF	TRBV20-1	TRBJ2-7
TGCGACAGGGGCCGATTTCTGAGCACCATATATTTT	CDRGRFLSTIYF	TRBV10-1	TRBJ1-3
TGCGCCAACCGGCGGTTGTTTAGGAACACTGAAGCTTTCTTT	CANRRLFRNTEAFF	TRBV10-1	TRBJ1-1
TGTGCCAGCAGACAGGGCTCTCCCTTGATCAATCAGCCCCAGCATTTT	CASRQGSPLINQPQHF	TRBV6-5	TRBJ1-5
TGTGCCAGTAGTATTCGCACCAGGGAAGAGACCCAGTACTTC	CASSIRTREETQYF	TRBV19	TRBJ2-5
TGTGCCAGCCCTCCCCCAGGGCTATTAGATCGCACAGATACGCAGTATTTT	CASPPPGLLDRTDTQYF	TRBV13	TRBJ2-3
TGCAGTGCTAGTTGGGTGGGACTTCGCTCTAATGAGCAGTTCTTC	CSASWVGLRSNEQFF	TRBV20-1	TRBJ2-1
TGCAGCGTTGATCCTATCCGGGGGGTTCCCGGGGAGCTGTTTTTT	CSVDPIRGVPGELFF	TRBV29-1	TRBJ2-2
TGTGCCAGCAGCGGCGAATCTTTTCCGGGCTACACCTTC	CASSGESFPGYTF	TRBV13	TRBJ1-2
TGTGCCAGCAGCAGCGGGGTACAAGAGACCCAGTACTTC	CASSSGVQETQYF	TRBV11-1	TRBJ2-5
TGTGCCAGCAGCCCTAGCGACCCTAGCACAGATACGCAGTATTTT	CASSPSDPSTDTQYF	TRBV6-2	TRBJ2-3
TGTGCCAGCAGCTTGGGTTCGCTGGGGAACACTGAAGCTTTCTTT	CASSLGSLGNTEAFF	TRBV5-4	TRBJ1-1
TGTGCCAGCAGTACGTTAAACCAGCCCCAGCATTTT	CASSTLNQPQHF	TRBV12-3	TRBJ1-5
TGCGCCAGCAGCCTAATTTGCCAGGCGGGGGGCAGCCTACGCAAAAACATTCAGTACTTC	CASSLICQAGGSLRKNIQYF	TRBV4-1	TRBJ2-4
TGTGCCAGCGGATGGGGGGGCGCCTACGAGCAGTACTTC	CASGWGGAYEQYF	TRBV25-1	TRBJ2-7
TGTGCCAGCAGCTTAGCTGCGGGAGGGATCCGGGGCCTTAGCTCCTACAATGAGCAGTTCTTC	CASSLAAGGIRGLSSYNEQFF	TRBV11-2	TRBJ2-1
TGTGCTAGTGGTTCCCTAACTGACAGGGGAAACACTGAAGCTTTCTTT	CASGSLTDRGNTEAFF	TRBV12-5	TRBJ1-1
TGTGCCAGCAGTCCCGGGACAGGGGGCGAGACCCAGTACTTC	CASSPGTGGETQYF	TRBV27	TRBJ2-5
TGCGCCAGCTCCGATCACAATGAGCAGTTCTTC	CASSDHNEQFF	TRBV10-1	TRBJ2-1
TGTGCCAGCAGCTTGGGAGCGGAAAAACTGTTTTTT	CASSLGAEKLFF	TRBV5-4	TRBJ1-4
TGTGCCAGCAGCTGGTACCGGGATGACTCCTATTATGAGCAGTTCTTC	CASSWYRDDSYYEQFF	TRBV11-3	TRBJ2-1
TGTGCCAGCCTCTTCCGGGGGGTCAGTAACTATGGCTACACCTTC	CASLFRGVSNYGYTF	TRBV6-4	TRBJ1-2
TGTGCCAGTAGCCTCTGGGGACTAGCGGGGGGGCCATCAGATACGCAGTATTTT	CASSLWGLAGGPSDTQYF	TRBV19	TRBJ2-3
TGCGCCAGCGCTAGCGGGGACACAGATACGCAGTATTTT	CASASGDTDTQYF	TRBV4-1	TRBJ2-3
TGTGCCAGCAGTTACTCGCTTCGCTGCCAGACAGAAAGATTCTCTGGAAACACCATATATTTT	CASSYSLRCQTERFSGNTIYF	TRBV6-5	TRBJ1-3
TGCAGTGCTAGGAAGAAACCACCAGCCGGGGGCTCTTCTGGGGCCAACGTCCTGACTTTC	CSARKKPPAGGSSGANVLTF	TRBV20-1	TRBJ2-6
TGTGCCAGCAGCCAAGATAGCAAGGGGACAGAGTTTGAAAAACTGTTTTTT	CASSQDSKGTEFEKLFF	TRBV4-2	TRBJ1-4
TGTGCCAGCAGCAGGAGGTGCAGCGGGGAATCGGACAATGAGCAGTTCTTC	CASSRRCSGESDNEQFF	TRBV7-9	TRBJ2-1
TGTGCCACGCTACAGGGACTAGCGGTCCTGACCCAGTACTTC	CATLQGLAVLTQYF	TRBV24-1	TRBJ2-5
TGTGCCAGCAGTTACGAACCCAGACTAGAGTCCGCTAGCACAGATACGCAGTATTTT	CASSYEPRLESASTDTQYF	TRBV6-6	TRBJ2-3
TGTGCCAGCCCACAGGGGGCCTACGAGCAGTACTTC	CASPQGAYEQYF	TRBV19	TRBJ2-7
TGTGCCAGCAGCTCACTTCCGAACACCGGGGAGCTGTTTTTT	CASSSLPNTGELFF	TRBV7-8	TRBJ2-2
TGTGCCCTCCCGGGATACTTTATGGTTCAGCCAGGGAAAGCCCAGTACTTC	CALPGYFMVQPGKAQYF	TRBV24-1	TRBJ2-5
TGTGCCAGCAGTTATCTTTGGGACAGGCTTAAAGAAGAGACCCAGTACTTC	CASSYLWDRLKEETQYF	TRBV6-5	TRBJ2-5
TGTGCCAGCAGCCGCAGTCTAGGAATAAATACTGAAGCTTTCTTT	CASSRSLGINTEAFF	TRBV12-3	TRBJ1-1
TGTGCCAGCAGCTTGGCCACTCTCCGGACTGGCTACGAGCAGTACTTC	CASSLATLRTGYEQYF	TRBV5-4	TRBJ2-7
TGTGCCAGCAGCTACGTCGTTCTAAACACCGGGGAGCTGTTTTTT	CASSYVVLNTGELFF	TRBV5-4	TRBJ2-2
TGTGCCAGCAGTGAAGCCGCACCGGGCGCCATCAGTTACTTC	CASSEAAPGAISYF	TRBV6-4	TRBJ2-5
TGTGCCAGCAGTGACTCAGCGAGGCGCTCCTACAATGAGCAGTTCTTC	CASSDSARRSYNEQFF	TRBV6-4	TRBJ2-1
TGTGCCAGCAGCGGACCGGGAAGCAATCAGCCCCAGCATTTT	CASSGPGSNQPQHF	TRBV7-4	TRBJ1-5
TGCAGTGCTAGAAAGGTCGACAGGGCCGGAAATCAGCCCCAGCATTTT	CSARKVDRAGNQPQHF	TRBV20-1	TRBJ1-5
TGTGCCAGCAGCGTAGCCTCTACTAGGAGCACAGATACGCAGTATTTT	CASSVASTRSTDTQYF	TRBV9	TRBJ2-3
TGTGCCAGCACCCCGGGACCCACCGGGGAGCTGTTTTTT	CASTPGPTGELFF	TRBV6-6	TRBJ2-2
TGTGCCAGCAGCTTAGACAGGGGCCGAGCTAATGAAAAACTGTTTTTT	CASSLDRGRANEKLFF	TRBV11-3	TRBJ1-4
TGCAGTGCTAGAAGGAGGGGGTCGGGGCTGTACTACGAGCAGTACTTC	CSARRRGSGLYYEQYF	TRBV20-1	TRBJ2-7
TGTGCCAGCAGTGAAGCCTGCAGGGTTCTCTGTAATGAAAAACTGTTTTTT	CASSEACRVLCNEKLFF	TRBV6-1	TRBJ1-4
TGCGCCAGCAGCCAAGTACAAGCGGGAGGGAGCTCTGGGGCCAACGTCCTGACTTTC	CASSQVQAGGSSGANVLTF	TRBV4-1	TRBJ2-6
TGTGCCAGCAGCTTCATAAGCGGGAGGTACCCTTTTAGCACAGATACGCAGTATTTT	CASSFISGRYPFSTDTQYF	TRBV7-2	TRBJ2-3
TGTGCCAGCAGTTGGACTGGGGGAGCTAGCGGGAGACTTCATGAGCAGTTCTTC	CASSWTGGASGRLHEQFF	TRBV12-3	TRBJ2-1
TGTGCCAGCAGCTTCTATCGGAAGCGGGAGCGGGTAGGGTACGAGCAGTACTTC	CASSFYRKRERVGYEQYF	TRBV11-2	TRBJ2-7
TGCAGCGTTGAACAGAAAGGGCCCGAGACCCAGTACTTC	CSVEQKGPETQYF	TRBV29-1	TRBJ2-5
TGTGCCAGCAGCCTGGAAGAAGGAAGACAGGGGGAGGCGTATAATTCACCCCTCCACTTT	CASSLEEGRQGEAYNSPLHF	TRBV7-4	TRBJ1-6
TGTGCCAGCAGTAGGGGACTAGCGGGGGTGGCTCGCGCCGTGGAGACCCAGTACTTC	CASSRGLAGVARAVETQYF	TRBV6-5	TRBJ2-5
TGTGCCAGCAGCCCACACGGTGCGGTAAGTACAGGGGTTACACCCCTCCACTTT	CASSPHGAVSTGVTPLHF	TRBV11-3	TRBJ1-6
TGTGCCACCAGTGATAGGGCGGGAGGGTACACTGAAGCTTTCTTT	CATSDRAGGYTEAFF	TRBV24-1	TRBJ1-1
TGTGCCAGCAGCTCCTTAGAGACCCAGTACTTC	CASSSLETQYF	TRBV7-9	TRBJ2-5
TGTGCCAGCTTCCCAGGGGGCCGAGGGATGGGCGGCTACACCTTC	CASFPGGRGMGGYTF	TRBV7-9	TRBJ1-2
TGTGCCAGCAGTGAATGCGGGTTCTACAATGAGCAGTTCTTC	CASSECGFYNEQFF	TRBV6-5	TRBJ2-1
TGCGCCAGCAGCTTTACAACAGCCTCTGGAAACACCATATATTTT	CASSFTTASGNTIYF	TRBV5-1	TRBJ1-3
TGTGCCAGCAGCCTGGTAAGGTGTTTGAGAAACACCATATATTTT	CASSLVRCLRNTIYF	TRBV7-3	TRBJ1-3
TGTGCCAGCAGCGGGACAGGGGTCTCCTACGAGCAGTACTTC	CASSGTGVSYEQYF	TRBV13	TRBJ2-7
TGTGCCAGCAGCTTGTCCCACCGGGGGCCAGTCTCCTACGAGCAGTACTTC	CASSLSHRGPVSYEQYF	TRBV5-6	TRBJ2-7
TGTGCCACCACCCCGCCGGGACCCAATCAGCCCCAGCATTTT	CATTPPGPNQPQHF	TRBV24-1	TRBJ1-5
TGTGCCAACCGTCACAAACTAGGGGCAAACACCGGGGAGCTGTTTTTT	CANRHKLGANTGELFF	TRBV5-4	TRBJ2-2
TGCAGTGCTAGAGATGCTGGCCGGGGGGGGCTAAACATTCAGTACTTC	CSARDAGRGGLNIQYF	TRBV20-1	TRBJ2-4
TGCAGCGTTGGGGGGGCCCCATACGAGCAGTACTTC	CSVGGAPYEQYF	TRBV29-1	TRBJ2-7
TGTGCCAGCAGCGCCCATATGCGGAGCACAGATACGCAGTATTTT	CASSAHMRSTDTQYF	TRBV9	TRBJ2-3
TGTGCCTGGAGTGTACGGCGGACAGGGGTGGGGGAGCTGTTTTTT	CAWSVRRTGVGELFF	TRBV30	TRBJ2-2
TGTGCCAGCAGTGAAGACAGGGGAGCTTTCTTT	CASSEDRGAFF	TRBV6-4	TRBJ1-1
TGTGCCAGCAGCTTGGAAAAGACGGGGCCGACAAACGAGCAGTACTTC	CASSLEKTGPTNEQYF	TRBV5-4	TRBJ2-7
TGTGCCGGACAGGGGGGCCTAGGTATCCAAGAGACCCAGTACTTC	CAGQGGLGIQETQYF	TRBV2	TRBJ2-5
TGTGCCATCAGGGCTAGCGCCAAAGAGACCCAGTACTTC	CAIRASAKETQYF	TRBV10-3	TRBJ2-5
TGCGCCAGCAGTGAACGACCCCGCCGAGGTAACTACGAGCAGTACTTC	CASSERPRRGNYEQYF	TRBV10-1	TRBJ2-7
TGTGCCAGCAGTCGGTCTGGGGAGGGGGTTTACGAGCAGTACTTC	CASSRSGEGVYEQYF	TRBV12-3	TRBJ2-7
TGCGCCAGCAGCTTGCGGGACAGGGGGGATCAGCCCCAGCATTTT	CASSLRDRGDQPQHF	TRBV5-1	TRBJ1-5
TGTGCCACCCCGATCCAAGGGGGGCTGGAGTACGAGCAGTACTTC	CATPIQGGLEYEQYF	TRBV24-1	TRBJ2-7
TGTGCCTGGGCCCCCCCAGGGGACAGGGTCCATCAATACGAGCAGTACTTC	CAWAPPGDRVHQYEQYF	TRBV19	TRBJ2-7
TGTGCCAGCAGCGTAGGCCTTCGATTTACTGAAGCTTTCTTT	CASSVGLRFTEAFF	TRBV9	TRBJ1-1
TGTGCCATCACCCCCATGGGACAGGGTGCGGAGACCCAGTACTTC	CAITPMGQGAETQYF	TRBV10-3	TRBJ2-5
TGTGCCACCAGCAGAGCAGGGTTGCGATCAAACTGCACTGAAGCTTTCTTT	CATSRAGLRSNCTEAFF	TRBV15	TRBJ1-1
TGTGCCTGGTTCGGAGGTGAGCAGTTCTTC	CAWFGGEQFF	TRBV30	TRBJ2-1
TGCAGCGTTGAATTTCCGAGCGGAGGGTTAGTCCAAGAGACCCAGTACTTC	CSVEFPSGGLVQETQYF	TRBV29-1	TRBJ2-5
TGTGCCAGCAGTAGCCAGGTGCGGGGGTCGAACACCGGGGAGCTGTTTTTT	CASSSQVRGSNTGELFF	TRBV27	TRBJ2-2
TGTGCCAGCAGTTTGGCGGTCCCGCTAGCGGGAGAGACCCAGTACTTC	CASSLAVPLAGETQYF	TRBV27	TRBJ2-5
TGTGCCACCGGGACAGGGGTGGGGAATGAAAAACTGTTTTTT	CATGTGVGNEKLFF	TRBV5-5	TRBJ1-4
TGTGCCAGCAGCTTGGCGACGGTGGACCCTAGAACTTACGAGCAGTACTTC	CASSLATVDPRTYEQYF	TRBV5-5	TRBJ2-7
TGCAGTGCCCCCGGACCCCCGTACTTC	CSAPGPPYF	TRBV20-1	TRBJ2-7
TGTGCCAGCAGTTACTCGTCGGGGCCAACGGGGCAGCCCCAGCATTTT	CASSYSSGPTGQPQHF	TRBV6-6	TRBJ1-5
TGTGCCAGCAGACTAGCGGGGAAGGACTACAATGAGCAGTTCTTC	CASRLAGKDYNEQFF	TRBV25-1	TRBJ2-1
TGTGCCAGCAGCTTTACATCGAGTAAAATCTCCTACGAGCAGTACTTC	CASSFTSSKISYEQYF	TRBV5-6	TRBJ2-7
TGTGCCAGCAGTGGCGGGACTAGCGGAGTAGGGGATGAGCAGTTCTTC	CASSGGTSGVGDEQFF	TRBV27	TRBJ2-1
TGCGCCAAGTTACCACCAGTTTCCTACGAGCAGTACTTC	CAKLPPVSYEQYF	TRBV5-1	TRBJ2-7
TGCGCCAGCAGCCAAGACTCCGGACTATATAGCAATCAGCCCCAGCATTTT	CASSQDSGLYSNQPQHF	TRBV4-1	TRBJ1-5
TGTCACGAGTCCTACAATGAGCAGTTCTTC	CHESYNEQFF	TRBV20-1	TRBJ2-1
TGCGCCAGCGGGTCCGGGACAGGGTACACCGGGGAGCTGTTTTTT	CASGSGTGYTGELFF	TRBV5-1	TRBJ2-2
TGTGCCAGCAGCGTTAATCGGGCCTACGAGCAGTACTTC	CASSVNRAYEQYF	TRBV9	TRBJ2-7
TGTGCCAGCAGGACAGCCCTCTACGAGCAGTACTTC	CASRTALYEQYF	TRBV28	TRBJ2-7
TGTGCCAGCGAAACTAGCTCATCCTACAATGAGCAGTTCTTC	CASETSSSYNEQFF	TRBV6-5	TRBJ2-1
TGTGCCAGCAGACCGGCCGGGGGGTGCGCTGGCTACACCTTC	CASRPAGGCAGYTF	TRBV7-4	TRBJ1-2
TGTGCCAGTATGGAGTGCTTCCTGACGGACCATTCACCCCTCCACTTT	CASMECFLTDHSPLHF	TRBV19	TRBJ1-6
TGTGCCAGCAGCCCTCTAGCGGGGGCCATTAAAGAGACCCAGTACTTC	CASSPLAGAIKETQYF	TRBV13	TRBJ2-5
TGCGCCAGCATCGGGGAAGAAGGAAACACCATATATTTT	CASIGEEGNTIYF	TRBV5-1	TRBJ1-3
TGTGCCAGCTCACCACCCCGACTAGCGGGTTTCCCCTACGAGCAGTACTTC	CASSPPRLAGFPYEQYF	TRBV18	TRBJ2-7
TGTGCCAGCAGCTTAGCTGGACCCCAGGGAGGGGTTGATCCCTACGAGCAGTACTTC	CASSLAGPQGGVDPYEQYF	TRBV7-2	TRBJ2-7
TGTGCCAGTAGCACTTCCGTGGACTATGGCTACACCTTC	CASSTSVDYGYTF	TRBV19	TRBJ1-2
TGCGCCAGCAGCCTGGGGGGACTAGCCGGGGAGCTGTTTTTT	CASSLGGLAGELFF	TRBV5-1	TRBJ2-2
TGCAGTGCTAGAGACACAGGGGGCTTGGACGAGCAGTACTTC	CSARDTGGLDEQYF	TRBV20-1	TRBJ2-7
TGCAGTGCCCCCGGGACAGGGCTACGGAATCAGCCCCAGCATTTT	CSAPGTGLRNQPQHF	TRBV20-1	TRBJ1-5
TGTGCCAGCAGCTCCCGGAGGCGGGAGCCCTACGAGCAGTACTTC	CASSSRRREPYEQYF	TRBV11-2	TRBJ2-7
TGTGCCAGCAGTCCCAGGGGCAATAATAGCAATCAGCCCCAGCATTTT	CASSPRGNNSNQPQHF	TRBV6-1	TRBJ1-5
TGTGCCAGCAGAGCGTGGGACAGGGCTTCAGGTCAGCCCCAGCATTTT	CASRAWDRASGQPQHF	TRBV6-1	TRBJ1-5
TGTGTTGGGAGCAAAGAGCCCCGGGAAAGGATGCAGTACTTC	CVGSKEPRERMQYF	TRBV6-2	TRBJ2-7
TGTGCCAGCAGTGAACCGCCCAGGGGTCCACTTAAGTACGAGCAGTACTTC	CASSEPPRGPLKYEQYF	TRBV25-1	TRBJ2-7
TGTGCCAGCAGCTTCCCGTTCACAGGGGGAGGTCCACAGCCCCAGCATTTT	CASSFPFTGGGPQPQHF	TRBV7-9	TRBJ1-5
TGCGCCAGCAGCCAATCCCCAGGGGACTATAATTCACCCCTCCACTTT	CASSQSPGDYNSPLHF	TRBV4-1	TRBJ1-6
TGTGCCAGCAGAAGAACCGGGACAGAGAATTCACCCCTCCACTTT	CASRRTGTENSPLHF	TRBV9	TRBJ1-6
TGTGCCACCAGATCGACTATAGGAGATACGCAGTATTTT	CATRSTIGDTQYF	TRBV24-1	TRBJ2-3
TGTGCCAGCAGCCAAGATGCCGGGGCGGGGTCGAGCACAGATACGCAGTATTTT	CASSQDAGAGSSTDTQYF	TRBV4-2	TRBJ2-3
TGCAGTGCTTTGGAGGGAGAAAAGGGCACCCAGTACTTC	CSALEGEKGTQYF	TRBV20-1	TRBJ2-5
TGTGCCAGCCGAAGGCCAGGGACTGAAGCTTTCTTT	CASRRPGTEAFF	TRBV6-1	TRBJ1-1
TGTGCCACTCACTTCTCAGATCAGCCCCAGCATTTT	CATHFSDQPQHF	TRBV24-1	TRBJ1-5
TGTGCCAGCAGCCCTCGAATACTCACTGAAGCTTTCTTT	CASSPRILTEAFF	TRBV27	TRBJ1-1
TGTGCCAGCAGCGGGACAGGGATTAGGACTAATGAAAAACTGTTTTTT	CASSGTGIRTNEKLFF	TRBV5-6	TRBJ1-4
TGTGCCAGCAGTGAACGGGGAACCCAAGAGACCCAGTACTTC	CASSERGTQETQYF	TRBV2	TRBJ2-5
TGCAGTGCTAGGGTAGCAGGGGAGCAGTTCTTC	CSARVAGEQFF	TRBV20-1	TRBJ2-1
TGTGCCAGCAGTTTCCTGGAGGTCAGGGCCTACGAGCAGTACTTC	CASSFLEVRAYEQYF	TRBV12-3	TRBJ2-7
TGCAGTGCTAGAGGGGGGGGGCTCTCCTACAATGAGCAGTTCTTC	CSARGGGLSYNEQFF	TRBV20-1	TRBJ2-1
TGTGCCAGCAGCGCCCGACAGGGGGAAAGCACTGAAGCTTTCTTT	CASSARQGESTEAFF	TRBV13	TRBJ1-1
TGCAGTGCGTCAGCCGGGACAGGGCGGACCCAAGAGACCCAGTACTTC	CSASAGTGRTQETQYF	TRBV20-1	TRBJ2-5
TGTGCCAGCAGCTATAGTCACGGGCGCACAGATACGCAGTATTTT	CASSYSHGRTDTQYF	TRBV7-9	TRBJ2-3
TGCGCCAGCCCCCGGGACAGGGGGACGAGGGTCGAGACCCAGTACTTC	CASPRDRGTRVETQYF	TRBV5-1	TRBJ2-5
TGTGCCAGCAGCCAACCAGGGCCCAGTTCAGCTTTCTTT	CASSQPGPSSAFF	TRBV14	TRBJ1-1
TGTGCTAGTGGTGTACAGAGTGGTTATGGCTACACCTTC	CASGVQSGYGYTF	TRBV12-5	TRBJ1-2
TGTGCCAGCAGTTTATCGCCAGAGACTAGCGGGGAAAATGAGCAGTTCTTC	CASSLSPETSGENEQFF	TRBV27	TRBJ2-1
TGTGCCAGTAGTGGTACGGGACACCTCAATCAGCCCCAGCATTTT	CASSGTGHLNQPQHF	TRBV19	TRBJ1-5
TGTGCCAGCAGCACGGGACAGGGCCCCCTCAACACTGAAGCTTTCTTT	CASSTGQGPLNTEAFF	TRBV6-8	TRBJ1-1
TGTGCCCCATCTATAACCTACACCTTC	CAPSITYTF	TRBV6-5	TRBJ1-2
TGTGCCAGCAGTGGGACACGCTATGGCTACACCTTC	CASSGTRYGYTF	TRBV6-4	TRBJ1-2
TGCGCCAGCACCCTGGATCTGGCGGGACAGGGGAACCTCGACAATCAGCCCCAGCATTTT	CASTLDLAGQGNLDNQPQHF	TRBV10-1	TRBJ1-5
TGCAGTGGGCAAGTTGGGGCCTACGAGCAGTACTTC	CSGQVGAYEQYF	TRBV20-1	TRBJ2-7
TGCAGCTGTTCAGGGGGAGTGAGGAGGTGTCCCTACGAGCAGTACTTC	CSCSGGVRRCPYEQYF	TRBV29-1	TRBJ2-7
TGTGCCAGCCCGGAGCCAGGGACTAACTATGGCTACACCTTC	CASPEPGTNYGYTF	TRBV5-6	TRBJ1-2
TGTGCCAGCGCCAGGGACAGCGAGCAGTACTTC	CASARDSEQYF	TRBV9	TRBJ2-7
TGCGCCAGCAGCTTAAGCCGGAGAGGGAACACTGAAGCTTTCTTT	CASSLSRRGNTEAFF	TRBV5-1	TRBJ1-1
TGTGCCAGTAGTATAGTAACGGATACTGCACTCGGACAGGGCCAAGAGACCCAGTACTTC	CASSIVTDTALGQGQETQYF	TRBV19	TRBJ2-5
TGTGCCAGCAGCTTAGCTCCGTCCCTGAAAACAGGGACCGATGGGGCCAACGTCCTGACTTTC	CASSLAPSLKTGTDGANVLTF	TRBV11-2	TRBJ2-6
TGTGCCTATTTCGGGGGCCGTAACTATGGCTACACCTTC	CAYFGGRNYGYTF	TRBV30	TRBJ1-2
TGCGCCAGCAGGGAAGGGCAGACCACTGAAGCTTTCTTT	CASREGQTTEAFF	TRBV5-1	TRBJ1-1
TGCAGTGCTAGGGTTAGACTGTTTTTT	CSARVRLFF	TRBV20-1	TRBJ1-4
TGCGCCAGCAGCTTCTTAAATATAACGAACACCGGGGAGCTGTTTTTT	CASSFLNITNTGELFF	TRBV5-1	TRBJ2-2
TGTGCCAGCAGCCAATTGGCAGGGGGCCGGGAGCTGTTTTTT	CASSQLAGGRELFF	TRBV4-2	TRBJ2-2
TGCAGACGAGGACGGGATACGCAGTATTTT	CRRGRDTQYF	TRBV20-1	TRBJ2-3
TGTGCCAGCAGCTGCTCTGGACCGGCAACTAATGAAAAACTGTTTTTT	CASSCSGPATNEKLFF	TRBV5-4	TRBJ1-4
TGTGCCAGCAGCTTAGGGACGGGTCCGGGACTGTCGGGGGACTATGGCTACACCTTC	CASSLGTGPGLSGDYGYTF	TRBV7-2	TRBJ1-2
TGTGCCAGCAGCCAACCCTATCCCAGGGGGCAAGAGACCCAGTACTTC	CASSQPYPRGQETQYF	TRBV7-9	TRBJ2-5
TGTGCCAGCAGAAAAGGCCCCATCGATGGCTACACCTTC	CASRKGPIDGYTF	TRBV6-4	TRBJ1-2
TGTGCCAGCAGAGTGGGTAAAAACATTCAGTACTTC	CASRVGKNIQYF	TRBV6-2	TRBJ2-4
TGCGCCAGCAGGCAGGGGTTAGCCAAAAACATTCAGTACTTC	CASRQGLAKNIQYF	TRBV10-1	TRBJ2-4
TGTGCCAGCAGCTTTGGATACGAGCAGTACTTC	CASSFGYEQYF	TRBV7-3	TRBJ2-7
TGTGCCAGCAGGACAGCAGGACCCTACCACACCGGGGAGCTGTTTTTT	CASRTAGPYHTGELFF	TRBV2	TRBJ2-2
TGTGCCAGCAGCTTATATGGCACTAGCGGGAGACAAGAGACCCAGTACTTC	CASSLYGTSGRQETQYF	TRBV7-3	TRBJ2-5
TGTGCCAGCAGCTTGACTAGCGGGTGCGGTAGCACAGATACGCAGTATTTT	CASSLTSGCGSTDTQYF	TRBV7-8	TRBJ2-3
TGTGCCAGCAGCTTAGTTTGGCGGAGCTGCCGGGAGGAGGACGAGCAGTACTTC	CASSLVWRSCREEDEQYF	TRBV7-8	TRBJ2-7
TGTGCCATCAAGGAAGAGCGGGAGGGCACAGATACGCAGTATTTT	CAIKEEREGTDTQYF	TRBV10-3	TRBJ2-3
TGTGCCAGCAGCAAATCCGGGATAGGCTACGAGCAGTACTTC	CASSKSGIGYEQYF	TRBV5-4	TRBJ2-7
TGTGCCAGCAGCGGAGCAGCATTGCTAGACACCGATACGCAGTATTTT	CASSGAALLDTDTQYF	TRBV7-2	TRBJ2-3
TGTGCCAGCAGCCCAGTGGCACCAAAGGGGCCATCGCCCCAGCATTTT	CASSPVAPKGPSPQHF	TRBV13	TRBJ1-5
TGTGCCAGCAGTTTAGCCTCTGGACACGGTTTTGGGTCCTACGAGCAGTACTTC	CASSLASGHGFGSYEQYF	TRBV27	TRBJ2-7
TGTGCCAGCAGCCCGCCTACGTGGAGACTAGCTATCCAAGAGACCCAGTACTTC	CASSPPTWRLAIQETQYF	TRBV7-8	TRBJ2-5
TGTGCCAGCAGTTACCCGTCCAGGGCGAATGAGCAGTTCTTC	CASSYPSRANEQFF	TRBV6-6	TRBJ2-1
TGTGCCATCAGGGAATCTCCCGACAGCTGCTACGAGCAGTACTTC	CAIRESPDSCYEQYF	TRBV27	TRBJ2-7
TGTGCCAGCAGCTTGGGAGGCGTAACTTTAATGTGGGGTCGCTTCCACCCAGAAAACGATAGCAATCAGCCCCAGCATTTT	CASSLGGVTLMWGRFHPENDSNQPQHF	TRBV5-4	TRBJ1-5
TGTGCCAGCAGTTTTCCACTGTGGAGCTCCTACGAGCAGTACTTC	CASSFPLWSSYEQYF	TRBV27	TRBJ2-7
TGTGCCAGTAGTATGCACAAGGAAGAGACCCAGTACTTC	CASSMHKEETQYF	TRBV19	TRBJ2-5
TGTGCCAGTGCAAGACGGACAGGGAATTCACCCCTCCACTTT	CASARRTGNSPLHF	TRBV19	TRBJ1-6
TGCGCCAGCAGTGAGAGGGACAGAGCCAAAAACATTCAGTACTTC	CASSERDRAKNIQYF	TRBV10-1	TRBJ2-4
TGTGCCAGCAGTGACGCGAGGTATAGGTGTTACGAGCAGTACTTC	CASSDARYRCYEQYF	TRBV25-1	TRBJ2-7
TGTGCCAGCAGCGCTACGCAGGATACGCAGTATTTT	CASSATQDTQYF	TRBV9	TRBJ2-3
TGTGCCAGCAGGGTCCTAGCGCCCGTGACAGGGGTCTATGGCTACACCTTC	CASRVLAPVTGVYGYTF	TRBV3-1	TRBJ1-2
TGTGCTAGCAGCCCGCATCATAGGCAGAACAATGAGCAGTTCTTC	CASSPHHRQNNEQFF	TRBV7-7	TRBJ2-1
TGCGCCAGCAGCTTGGCGGGGGGGCGGTTTTACGAGCAGTACTTC	CASSLAGGRFYEQYF	TRBV5-1	TRBJ2-7
TGTGCCAGCAGCGCGAGGGGGGCAGTCGCTAGCAATGAGCAGTTCTTC	CASSARGAVASNEQFF	TRBV13	TRBJ2-1
TGCAGCGTAACACAGGTCGCCAAAAACATTCAGTACTTC	CSVTQVAKNIQYF	TRBV29-1	TRBJ2-4
TGTGCCAGCGAAGCCTCCGGGGGAGAGCAAGAGACCCAGTACTTC	CASEASGGEQETQYF	TRBV7-9	TRBJ2-5
TGCAGTGCTATCAGCACCGGGGAGCTGTTTTTT	CSAISTGELFF	TRBV20-1	TRBJ2-2
TGCGCCAGCAGAGGAGGGGAACGGATAAAGCAGTACTTC	CASRGGERIKQYF	TRBV5-1	TRBJ2-7
TGCAGCGTTGGTCTTAACAGGAGGATCCAGCCCCAGCATTTT	CSVGLNRRIQPQHF	TRBV29-1	TRBJ1-5
TGTGCCAGCAGTCGGTCTCGGGGGGGCCGATACAATGAGCAGTTCTTC	CASSRSRGGRYNEQFF	TRBV11-3	TRBJ2-1
TGCGCCAGCAGCTTTCAGGGGCTATACGAGCAGTACTTC	CASSFQGLYEQYF	TRBV5-1	TRBJ2-7
TGTGCCAGCAGCCAACCAGCAGTGTTCGGCCCAGGGGAGCTGTTTTTT	CASSQPAVFGPGELFF	TRBV3-1	TRBJ2-2
TGCGCCAGCACGATACCCTACAATGAGCAGTTCTTC	CASTIPYNEQFF	TRBV5-1	TRBJ2-1
TGCAGTGCTAAGGGGTTCTCCTACAATGAGCAGTTCTTC	CSAKGFSYNEQFF	TRBV20-1	TRBJ2-1
TGTGCCAGCAGTTGTCGGGACCCCGAGACCCAGTACTTC	CASSCRDPETQYF	TRBV6-2	TRBJ2-5
TGTGCCAGCAGCCAAGGGCCGGGGAAGTACGAATCAGATACGCAGTATTTT	CASSQGPGKYESDTQYF	TRBV14	TRBJ2-3
TGTGCCACTCTCGATAACGGGACAGAAACTGGAAACACCATATATTTT	CATLDNGTETGNTIYF	TRBV24-1	TRBJ1-3
TGTGCCAGCTCGATTGGATTCCATTTCGGGCACATAACCCATACAAACACTGAAGCTTTCTTT	CASSIGFHFGHITHTNTEAFF	TRBV6-5	TRBJ1-1
TGTGCCAGCAGCTTAGATCGACCTGGACCGGGACAGACGGGCTACACCTTC	CASSLDRPGPGQTGYTF	TRBV11-2	TRBJ1-2
TGTGCCAGCAGCTTAAAAAGAGGGACTAGCGGCCACTGGGAAGAGACCCAGTACTTC	CASSLKRGTSGHWEETQYF	TRBV7-3	TRBJ2-5
TGCAGTGCTAGGCCCGGGACAGTACCTTTTACGACGTGCGAGCAGTACTTC	CSARPGTVPFTTCEQYF	TRBV20-1	TRBJ2-7
TGTGCCAGCAGTCTTAGCGGACTAGATAACACAGATACGCAGTATTTT	CASSLSGLDNTDTQYF	TRBV7-9	TRBJ2-3
TGTGCCTGGAGTGACCGGAAGGACAGCTTATTAAATCAGCCCCAGCATTTT	CAWSDRKDSLLNQPQHF	TRBV30	TRBJ1-5
TGTGCCAGCAGTGGAACGTTGGGGAGCCCCCTGAACACTGAAGCTTTCTTT	CASSGTLGSPLNTEAFF	TRBV6-5	TRBJ1-1
TGTGCCACCGGGGGCACCTACGAGCAGTACTTC	CATGGTYEQYF	TRBV19	TRBJ2-7
TGTGCCAGCAGTGGGGGTGAACTCTTGGGCTATGGCTACACCTTC	CASSGGELLGYGYTF	TRBV6-2	TRBJ1-2
TGCAGTGCTCCTCGGGCCAAAAACATTCAGTACTTC	CSAPRAKNIQYF	TRBV20-1	TRBJ2-4
TGTGCCAGCAGCTGGGGGACTCGGTGGGCCTCCTACGAGCAGTACTTC	CASSWGTRWASYEQYF	TRBV13	TRBJ2-7
TGTGCCAGCCGACTAGCGTTAGGCCACGAGCAGTACTTC	CASRLALGHEQYF	TRBV5-4	TRBJ2-7
TGTGCCAGCAGCCCCACACAAAGGGACAGCAGCTATGGCTACACCTTC	CASSPTQRDSSYGYTF	TRBV6-5	TRBJ1-2
TGTGCCAGCAGCGTTGGGGACAGGGTTCGGTTAGAGCAGTACTTC	CASSVGDRVRLEQYF	TRBV11-2	TRBJ2-7
TGCGCCAGCAGTGCGGTTCGGGACAGGGTAGCGTCACCCCTCCACTTT	CASSAVRDRVASPLHF	TRBV10-1	TRBJ1-6
TGTGCCAGCAGCCTACTTTTGAACACTGAAGCTTTCTTT	CASSLLLNTEAFF	TRBV4-2	TRBJ1-1
TGCGCCAGCAGCCCAGACTTCAACACCGGAACTAGCGGGAGCTCCTACAATGAGCAGTTCTTC	CASSPDFNTGTSGSSYNEQFF	TRBV4-1	TRBJ2-1
TGCAGTGCTGTTCCCTCGGGCCCAGATACGCAGTATTTT	CSAVPSGPDTQYF	TRBV20-1	TRBJ2-3
TGTGCCAGCAGCAGCTCTACCCCTAACTATGGCTACACCTTC	CASSSSTPNYGYTF	TRBV13	TRBJ1-2
TGTGCCAGCAGCTTGTGGCCCGAAAGGGGGGAACTCCCTGAAGAGACCCAGTACTTC	CASSLWPERGELPEETQYF	TRBV5-6	TRBJ2-5
TGTGCCAGCAGCACCTTTTGGGTACTCAGCAATCAGCCCCAGCATTTT	CASSTFWVLSNQPQHF	TRBV7-6	TRBJ1-5
TGTGCCAGCAGCCCAAGGGGTGAAGCTTTCTTT	CASSPRGEAFF	TRBV7-3	TRBJ1-1
TGTGCCTGGCCAAGGAACACTGAAGCTTTCTTT	CAWPRNTEAFF	TRBV30	TRBJ1-1
TGCAGTGCTAGTCTTAGCCCGGTCTGTCAGACCCAGTACTTC	CSASLSPVCQTQYF	TRBV20-1	TRBJ2-5
TGTGCCAGCAGCCAGGTCTATGATGACTCGCCGATTCTCTACGAGCAGTACTTC	CASSQVYDDSPILYEQYF	TRBV14	TRBJ2-7
TGTGCCAGCAGAGGAAGGGACAGGTTCACAGATACGCAGTATTTT	CASRGRDRFTDTQYF	TRBV6-3	TRBJ2-3
TGTGCCAGCAGCTTTCCAATTGAAAAACTGTTTTTT	CASSFPIEKLFF	TRBV7-9	TRBJ1-4
TGTGCCACCAAACGACAGGGTGGCTACACCTTC	CATKRQGGYTF	TRBV15	TRBJ1-2
TGTGCCAGCAGCTTAGTGATCTGTTGGAACACTGAAGCTTTCTTT	CASSLVICWNTEAFF	TRBV11-3	TRBJ1-1
TGTGCCAGCAGCCCCCGGGGGGGGCCGAGCTGCGAGACCCAGTACTTC	CASSPRGGPSCETQYF	TRBV11-3	TRBJ2-5
TGTGCCAGCAGCGCGCGGGACGGTGATACGCAGTATTTT	CASSARDGDTQYF	TRBV7-6	TRBJ2-3
TGCAGTGCTAGCTGGGGTAGCAGCGGGGAGCTGTTTTTT	CSASWGSSGELFF	TRBV20-1	TRBJ2-2
TGTGCCAGCAGCAGCGGATTTAGGGGAGTCTCCTACGAGCAGTACTTC	CASSSGFRGVSYEQYF	TRBV7-4	TRBJ2-7
TGTGCCATCAGTGTATACGGTAAACCAAGATTACCGCGACAGGGCAGCTCCTACGAGCAGTACTTC	CAISVYGKPRLPRQGSSYEQYF	TRBV10-3	TRBJ2-7
TGTGCCAGCAGCTTGGCTCGATGGGCCGGGACGCCCTACTACGAGCAGTACTTC	CASSLARWAGTPYYEQYF	TRBV5-6	TRBJ2-7
TGTGCCAGCAGCCAAGCTCCTTTACTAGCGGGGGGGAGGAGTGTCCGCACAGATACGCAGTATTTT	CASSQAPLLAGGRSVRTDTQYF	TRBV3-1	TRBJ2-3
TGTGCCAGCAGCACGACAGGGACCTATGGCTACACCTTC	CASSTTGTYGYTF	TRBV9	TRBJ1-2
TGTGCCAGCAGCTTGGCCAGGACGGGGACCCAGTACTTC	CASSLARTGTQYF	TRBV7-2	TRBJ2-5
TGTGCCAGCAGGTACAGGGGGCGAGAGAGCTCCTACGAGCAGTACTTC	CASRYRGRESSYEQYF	TRBV5-4	TRBJ2-7
TGTGCTAGCAGCTTAGCTAGCGGCCAAGAGACCCAGTACTTC	CASSLASGQETQYF	TRBV7-7	TRBJ2-5
TGTGCCAGCAGCTTAGCCGTGAGGACAGCATCCTACGAGCAGTACTTC	CASSLAVRTASYEQYF	TRBV7-2	TRBJ2-7
TGTGCCAGTAGTCCGGGGTTAAACTATGGCTACACCTTC	CASSPGLNYGYTF	TRBV19	TRBJ1-2
TGTGCCAGCACCAACAGGGTCGAAAAACTGTTTTTT	CASTNRVEKLFF	TRBV28	TRBJ1-4
TGTGCCAGCAGTTTAGAACATACTAGCGGGTACAATGAGCAGTTCTTC	CASSLEHTSGYNEQFF	TRBV27	TRBJ2-1
TGTGCCAGCCCCATCACATCCCTTGGGAACACCGGGGAGCTGTTTTTT	CASPITSLGNTGELFF	TRBV27	TRBJ2-2
TGTGCCAGCAGCTCAAAATTGGACAGGGGGGAAATTAGTCACACCGGGGAGCTGTTTTTT	CASSSKLDRGEISHTGELFF	TRBV13	TRBJ2-2
TGTGCCTGCACCCGCCTCTACGAGCAGTACTTC	CACTRLYEQYF	TRBV30	TRBJ2-7
TGTGCCAGCAGTTACACTTCGACCCAGTACTTC	CASSYTSTQYF	TRBV6-5	TRBJ2-5
TGTGCTAGTGGTAATCTCCCGGGACGAAGCACAGATACGCAGTATTTT	CASGNLPGRSTDTQYF	TRBV12-5	TRBJ2-3
TGTGCCAGCAGTTACGGGGGGACGGCGATGAATGAGCAGTTCTTC	CASSYGGTAMNEQFF	TRBV6-5	TRBJ2-1
TGTGCCAGCAGCGCCATCGGGGCGCCACAGTACTTC	CASSAIGAPQYF	TRBV7-3	TRBJ2-5
TGTGCCAGCAGTTACCAGGGGAATCAGCCCCAGCATTTT	CASSYQGNQPQHF	TRBV6-9	TRBJ1-5
TGTGCCAGCAGCAGAGGATCCTACAATGAGCAGTTCTTC	CASSRGSYNEQFF	TRBV11-3	TRBJ2-1
TGTGCCAGCAGCTTAACCGGGGGAAATCAGCCCCAGCATTTT	CASSLTGGNQPQHF	TRBV5-4	TRBJ1-5
TGCGCCAGCAGTGAGCGGGGGGGGCGGAATCTATCTGGAAACACCATATATTTT	CASSERGGRNLSGNTIYF	TRBV10-2	TRBJ1-3
TGTGCCAGCAGCTTGGCCAGGGCGGTACCCTACGAGCAGTACTTC	CASSLARAVPYEQYF	TRBV5-6	TRBJ2-7
TGTGCCAGCAGCTTAGCAAACATCCACAGGCGTAGAGGAGCTTTCTTT	CASSLANIHRRRGAFF	TRBV11-3	TRBJ1-1
TGTGCCAGCAGTTACTCAAAACAGTGGTTCTCCTACGAGCAGTACTTC	CASSYSKQWFSYEQYF	TRBV6-2	TRBJ2-7
TGTGCTAGTGGTTTCGTTGTAGGGGGCCCCACCAATGAGCAGTTCTTC	CASGFVVGGPTNEQFF	TRBV12-5	TRBJ2-1
TGTGCCAGTAGTAACCCGAGAACCTATCACAATCAGCCCCAGCATTTT	CASSNPRTYHNQPQHF	TRBV19	TRBJ1-5
TGCAGTGCTAGAGATCGGGGCAAACGGGGTAGCTACGAGCAGTACTTC	CSARDRGKRGSYEQYF	TRBV20-1	TRBJ2-7
TGCGCCAGCAGCCAAGATAGTGTCCCCTGGGGGGGCTCGTGGGTGGTTAATGAGCAGTTCTTC	CASSQDSVPWGGSWVVNEQFF	TRBV4-1	TRBJ2-1
TGTGCCAGCAGCTTAGCTAGGGGGGGGAAGGCGGGGTCTGGAAACACCATATATTTT	CASSLARGGKAGSGNTIYF	TRBV11-2	TRBJ1-3
TGTGCCAGCAGTGCCTTTCCGTCAGGGGGGAACATTCAGTACTTC	CASSAFPSGGNIQYF	TRBV2	TRBJ2-4
TGCGCCAGCAGCCAGGGTACCGTCCACGCGGTATACAATGAGCAGTTCTTC	CASSQGTVHAVYNEQFF	TRBV5-1	TRBJ2-1
TGTGCCTCACCCACTGGACTAGCGGACCCCAGGTTGAACACCGGGGAGCTGTTTTTT	CASPTGLADPRLNTGELFF	TRBV30	TRBJ2-2
TGTGCCAGTAGTATAGATACGACAGGGGAATATTACAATCAGCCCCAGCATTTT	CASSIDTTGEYYNQPQHF	TRBV19	TRBJ1-5
TGTGCCAGCAGCGACCGGGGGGATGAAGCTTTCTTT	CASSDRGDEAFF	TRBV5-6	TRBJ1-1
TGTGCCAGCAGCCGGAGCCGGGGGAGAGTTGGGTATGAAAAACTGTTTTTT	CASSRSRGRVGYEKLFF	TRBV27	TRBJ1-4
TGTGCCAGCAGCCAGGGGGCGGAGAAATCTGGAAACACCATATATTTT	CASSQGAEKSGNTIYF	TRBV7-4	TRBJ1-3
TGTGCCTGGAGAAGTTGCTCGTTTCCTTTAAAGAGCTCCCCGCCCCAGCATTTT	CAWRSCSFPLKSSPPQHF	TRBV30	TRBJ1-5
TGTGCCTGGAGGCAGAGCTCTGGAAACACCATATATTTT	CAWRQSSGNTIYF	TRBV30	TRBJ1-3
TGTGCTAGTGGTTTAAGGTCAACAGGGGGTGAGGAGACCCAGTACTTC	CASGLRSTGGEETQYF	TRBV12-5	TRBJ2-5
TGTGCCAGCAGTCCCGCACGCGGGGGCTTAGAAGCTTTCTTT	CASSPARGGLEAFF	TRBV27	TRBJ1-1
TGTGCCTGCCCGGACAGGACCATGACCGATGGCTACACCTTC	CACPDRTMTDGYTF	TRBV30	TRBJ1-2
TGTGCCAGCAGCTTACAGGGTCCCGGCTCTACTGGGGCCAACGTCCTGACTTTC	CASSLQGPGSTGANVLTF	TRBV11-3	TRBJ2-6
TGTGCCACCAGTGACGTCGGGGCAGGGATGAACACTGAAGCTTTCTTT	CATSDVGAGMNTEAFF	TRBV24-1	TRBJ1-1
TGTGCCGGATCAGAGCCCGGTTTGCGTAGGGACACTGAAGCTTTCTTT	CAGSEPGLRRDTEAFF	TRBV6-5	TRBJ1-1
TGTGCCAGCAGACGACTCCGGGACAGCGAAGTTCAGCCCCAGCATTTT	CASRRLRDSEVQPQHF	TRBV6-6	TRBJ1-5
TGTGCCAGCAGAACCTATGAGCCCCAGCATTTT	CASRTYEPQHF	TRBV28	TRBJ1-5
TGTGCCAGCAGGCCCCTAGCGGGGGGGTTAGGGCGGGGCTACAATGAGCAGTTCTTC	CASRPLAGGLGRGYNEQFF	TRBV6-2	TRBJ2-1
TGTGCCAGCAGCAAAGCCAGGGGGCGATTCTCCTACAATGAGCAGTTCTTC	CASSKARGRFSYNEQFF	TRBV13	TRBJ2-1
TGTGCCAGTAGTATAGATACTAGGCGCAAGGGGAACTACGAGCAGTACTTC	CASSIDTRRKGNYEQYF	TRBV19	TRBJ2-7
TGTGCCACCTCCCGTGGGGGGACCTACGAGCAGTACTTC	CATSRGGTYEQYF	TRBV24-1	TRBJ2-7
TGCGCCAGGGACAGGAGGCACAATGAGCAGTTCTTC	CARDRRHNEQFF	TRBV5-1	TRBJ2-1
TGCAGTGCTAGTAAACTAGCGGGTGAAACCAAAAACATTCAGTACTTC	CSASKLAGETKNIQYF	TRBV20-1	TRBJ2-4
TGCGCCAGCTCGGTTTTACTGAACAATCAGCCCCAGCATTTT	CASSVLLNNQPQHF	TRBV10-1	TRBJ1-5
TGTGCCAGCAGGATGGGGGGACAGGCGGTCAATCAGCCCCAGCATTTT	CASRMGGQAVNQPQHF	TRBV6-5	TRBJ1-5
TGCAGTGCTAGAGATAGCAGATGGGACAGACGGGAGACCCAGTACTTC	CSARDSRWDRRETQYF	TRBV20-1	TRBJ2-5
TGCGCCAGCAGCAGGACAGGGGTTAATCAGCCCCAGCATTTT	CASSRTGVNQPQHF	TRBV5-1	TRBJ1-5
TGCAGTGCTAGCGCAGACTACGAGCAGTACTTC	CSASADYEQYF	TRBV20-1	TRBJ2-7
TGTGCCAGCAGCTTAGTCAGGGGTGATCGGGCGAAGAACTATGGCTACACCTTC	CASSLVRGDRAKNYGYTF	TRBV11-3	TRBJ1-2
TGCAGTGCTAGAGGGGGACTGCCCTACGAGCAGTACTTC	CSARGGLPYEQYF	TRBV20-1	TRBJ2-7
TGTGCCAGCAGGAAGCAGCGCACTGAAGCTTTCTTT	CASRKQRTEAFF	TRBV28	TRBJ1-1
TGTGCCACTTGCCGGGACAGGGTCGGCGGGAATCAGCCCCAGCATTTT	CATCRDRVGGNQPQHF	TRBV7-2	TRBJ1-5
TGTGCCAGCTCCCTGGCAGATGGCTACACCTTC	CASSLADGYTF	TRBV18	TRBJ1-2
TGTGCCAGCAGTACGTTCAGGGACCCTAATCAGCCCCAGCATTTT	CASSTFRDPNQPQHF	TRBV6-1	TRBJ1-5
TGTGCCAGCAGCCACGGGGACCCCGGGGGGGCTACAGATACGCAGTATTTT	CASSHGDPGGATDTQYF	TRBV3-1	TRBJ2-3
TGTGCCATCAGTGCCCCCAGCAATGAAGCTTTCTTT	CAISAPSNEAFF	TRBV10-3	TRBJ1-1
TGTGCCAGCGTACAGTCCTATGGCTACACCTTC	CASVQSYGYTF	TRBV12-4	TRBJ1-2
TGTGCCAGCAGCTCCACCGACAGAAAACTGTTTTTT	CASSSTDRKLFF	TRBV7-7	TRBJ1-4
TGTGCCAGCAGTTTCCCCGAGGACAGGGGGATATGTCTCAATGAGCAGTTCTTC	CASSFPEDRGICLNEQFF	TRBV12-3	TRBJ2-1
TGTGCCAGCCCGGAGGGGACGGCTAGCACAGATACGCAGTATTTT	CASPEGTASTDTQYF	TRBV7-3	TRBJ2-3
TGTGCCTGGAGTCCGAGATCCGGGACTAGCGGGAGCAATCAGCCCCAGCATTTT	CAWSPRSGTSGSNQPQHF	TRBV30	TRBJ1-5
TGTGCCACCAGCAGTGGGAGGTTCCACAATGAGCAGTTCTTC	CATSSGRFHNEQFF	TRBV15	TRBJ2-1
TGTGCCAGCAGCACGGGGGGGCCTGCCAATTTGTACAATGAGCAGTTCTTC	CASSTGGPANLYNEQFF	TRBV9	TRBJ2-1
TGTGCCTGGCCCGGGACAGAAAACATTCAGTACTTC	CAWPGTENIQYF	TRBV30	TRBJ2-4
TGTGCCAGCAGCCGAGCCTTCCGGACCACTAGGGCGCGCAATGAGCAGTTCTTC	CASSRAFRTTRARNEQFF	TRBV9	TRBJ2-1
TGTGCCAGCAACCCTTCAGCCGATACCCTTTCGCAGTTCTTC	CASNPSADTLSQFF	TRBV27	TRBJ2-1
TGTGCCAGCAGGCCACAGGGTCAGAACACTGAAGCTTTCTTT	CASRPQGQNTEAFF	TRBV6-3	TRBJ1-1
TGTGCCAGCAGTTTAATTACGGGACTAGCGGGCCCAAATGCAGATACGCAGTATTTT	CASSLITGLAGPNADTQYF	TRBV27	TRBJ2-3
TGTGCCAGCAGCGTACCGGGGACAAGCCCACCATACGAGCAGTACTTC	CASSVPGTSPPYEQYF	TRBV9	TRBJ2-7
TGTGCCAGCAGTGAAACGGGGGCCACGCAGTATTTT	CASSETGATQYF	TRBV6-2	TRBJ2-3
TGTGCCAGCAGTGAAGCGCTTGTAGCGGACCGAGGAAGGGATACGCAGTATTTT	CASSEALVADRGRDTQYF	TRBV2	TRBJ2-3
TGTGCCAGCAGTTACTGGAAAGAGGGGCCCACAGATACGCAGTATTTT	CASSYWKEGPTDTQYF	TRBV6-3	TRBJ2-3
TGTGCCAGCAGTTTACCCCTCGGGACAGGGCACACTGAAGCTTTCTTT	CASSLPLGTGHTEAFF	TRBV12-4	TRBJ1-1
TGCGCCAGCGCCCACGCCGGAATCTACGAGCAGTACTTC	CASAHAGIYEQYF	TRBV10-1	TRBJ2-7
TGTGCCATAATTGGGACAGAGGGGCGTCAGCCCCAGCATTTT	CAIIGTEGRQPQHF	TRBV10-3	TRBJ1-5
TGTGCCAGCAGCTTTCGACAGGGGGCAACCCTCTACGAGCAGTACTTC	CASSFRQGATLYEQYF	TRBV7-3	TRBJ2-7
TGTGCCAGCAGCTTAGCAGCAGGGGGCACCTCCGACTATGGCTACACCTTC	CASSLAAGGTSDYGYTF	TRBV7-9	TRBJ1-2
TGTGCCAGCAGCTTCGACCAAGAGACCCAGTACTTC	CASSFDQETQYF	TRBV7-9	TRBJ2-5
TGTGCCAGCAGTGATACGACAGAACGCTATGGCTACACCTTC	CASSDTTERYGYTF	TRBV2	TRBJ1-2
TGCAGTGCTAGAGTGACAGGGAACTACACCTTC	CSARVTGNYTF	TRBV20-1	TRBJ1-2
TGCGCCAGCAGCCATCCAAACCTGGGGGGGGAGGGGGGACCCCGGCGACCCGATACGCAGTATTTT	CASSHPNLGGEGGPRRPDTQYF	TRBV4-1	TRBJ2-3
TGTGCCAGCAGCCCACCCCGGAGGAGAAGGTACTCCTACAATGAGCAGTTCTTC	CASSPPRRRRYSYNEQFF	TRBV5-4	TRBJ2-1
TGTGCCAGCAGCGGAGGGCGCAAACGGGCTTTCTTT	CASSGGRKRAFF	TRBV9	TRBJ1-1
TGTGCCAGCAGCCATTCAACAGGGGGTTTGATAGATACGCAGTATTTT	CASSHSTGGLIDTQYF	TRBV3-1	TRBJ2-3
TGTGCCAGCAGCCAAGAAGGGGCTAACTATGGCTACACCTTC	CASSQEGANYGYTF	TRBV3-1	TRBJ1-2
TGTGCCAGCGGCAAGCGGGAAAACATTCAGTACTTC	CASGKRENIQYF	TRBV27	TRBJ2-4
TGTGCCACCAGTGACGAATCAGGGACAGAAGAGACCCAGTACTTC	CATSDESGTEETQYF	TRBV24-1	TRBJ2-5
TGCAGTGCTTCTTCCCGGGACAGGGGGGAAACTGAAGCTTTCTTT	CSASSRDRGETEAFF	TRBV20-1	TRBJ1-1
TGTGCCAGCAGCAGAGTGTACGCGGGGCGGAAGAACACCGGGGAGCTGTTTTTT	CASSRVYAGRKNTGELFF	TRBV6-4	TRBJ2-2
TGTGCCAGCAGTTTATCGGTGGGGCTTCACTTGTCCGTCTATGGCTACACCTTC	CASSLSVGLHLSVYGYTF	TRBV27	TRBJ1-2
TGTGCCAGCAGTTTCCGGACGTATTTT	CASSFRTYF	TRBV28	TRBJ1-3
TGTGCCAGCACGCTGGTGGGACTAGCGGGGGGATTGGCCTACAATGAGCAGTTCTTC	CASTLVGLAGGLAYNEQFF	TRBV9	TRBJ2-1
TGTGCCAGCAGTGACTCGACACAGGGCCTGGCAGATACGCAGTATTTT	CASSDSTQGLADTQYF	TRBV6-4	TRBJ2-3
TGCAGTGCTAGAGTCCAGGTCACTGAAGCTTTCTTT	CSARVQVTEAFF	TRBV20-1	TRBJ1-1
TGTGCCAGCAGTAAGAGTCGGGGGGCCGGGGAGCTGTTTTTT	CASSKSRGAGELFF	TRBV25-1	TRBJ2-2
TGTGCCAGCAGTTCCATGGGACAGGTGAAAACGCAGTATTTT	CASSSMGQVKTQYF	TRBV6-5	TRBJ2-3
TGTGCCAGCAGCGGGGGGACATCCTATAATTCACCCCTCCACTTT	CASSGGTSYNSPLHF	TRBV13	TRBJ1-6
TGTGCCAGCAGTCCCGGGAGGGGCACTGAAGCTTTCTTT	CASSPGRGTEAFF	TRBV12-4	TRBJ1-1
TGTGCCAGCAAAGGGGGGGCTGAGCAGTTCTTC	CASKGGAEQFF	TRBV6-4	TRBJ2-1
TGCAGTGCTGGGGCCCCCCGGACAGGGGGAGAAAAACTGTTTTTT	CSAGAPRTGGEKLFF	TRBV20-1	TRBJ1-4
TGTGCCAGCAGCTTACCTAGATTAAACCGGGGGCGTGACAATGAGCAGTTCTTC	CASSLPRLNRGRDNEQFF	TRBV7-2	TRBJ2-1
TGTGCCAGCAGTGACTCGAGGCGGGAGAGCACTGAAGCTTTCTTT	CASSDSRRESTEAFF	TRBV6-4	TRBJ1-1
TGTGCCACCAGTGATCGAGGGGGGGGTAATGAGCAGTTCTTC	CATSDRGGGNEQFF	TRBV24-1	TRBJ2-1
TGTGCCTGGCGAAATGGCTCGAATCCTGACTATGGCTACACCTTC	CAWRNGSNPDYGYTF	TRBV30	TRBJ1-2
TGTGCCAGCAGTACATCCGGGACTACTCGTCAGCCCCAGCATTTT	CASSTSGTTRQPQHF	TRBV2	TRBJ1-5
TGTGCCAGCAGTGACAGACATAGAGGGACAGGGTGGTACGAGCAGTACTTC	CASSDRHRGTGWYEQYF	TRBV25-1	TRBJ2-7
TGTGCCAGCACCCCGGGACAGGGTTCTCACTACGAGCAGTACTTC	CASTPGQGSHYEQYF	TRBV9	TRBJ2-7
TGTGCCACCAGCAGAGAGGCCGTGCGGGACAAACTAGAAGAGACCCAGTACTTC	CATSREAVRDKLEETQYF	TRBV15	TRBJ2-5
TGTGCCAGCAGCCAAGATCAGGGGAGTGCTCCCACTGAAGCTTTCTTT	CASSQDQGSAPTEAFF	TRBV3-1	TRBJ1-1
TGTGCCACCCCTGCGGGGATTGCGCCCCTCCACTTT	CATPAGIAPLHF	TRBV24-1	TRBJ1-6
TGTGCCAGCAGTTTGGGGGAGAGCACTGAAGCTTTCTTT	CASSLGESTEAFF	TRBV28	TRBJ1-1
TGTGCCAGCAGCGGCCAATACGGATTTCCTGAAGCTTTCTTT	CASSGQYGFPEAFF	TRBV13	TRBJ1-1
TGTGCCAGCAGTTTACCCCTATCCTTACAGAAGGACCTCCCTCAGCCCCAGCATTTT	CASSLPLSLQKDLPQPQHF	TRBV12-4	TRBJ1-5
TGCGCCAGCGGGGATCGGACAGGGGGCGCGAGCGAGACCCAGTACTTC	CASGDRTGGASETQYF	TRBV10-1	TRBJ2-5
TGCAGTCACCAGGGCGGGTACGAGCAGTACTTC	CSHQGGYEQYF	TRBV20-1	TRBJ2-7
TGCGCCAGCAGCACGCCGGGACAGGTTTCTAACTATGGCTACACCTTC	CASSTPGQVSNYGYTF	TRBV5-1	TRBJ1-2
TGTGCCAGCAGCTTAGACAGGGAGGGGGAGCCCCAGCATTTT	CASSLDREGEPQHF	TRBV7-2	TRBJ1-5
TGTGCCAGCAGCTTAGTCGGGGCCAGGCCGGGCAACGAGCAGTACTTC	CASSLVGARPGNEQYF	TRBV7-4	TRBJ2-7
TGCAGTGCTAGCCCACGACAGGGGGCACGGTACACTGAAGCTTTCTTT	CSASPRQGARYTEAFF	TRBV20-1	TRBJ1-1
TGTGCCAGCAGCACCCCGACAGGGGGCATTCCGGCGGGTGGCTACACCTTC	CASSTPTGGIPAGGYTF	TRBV13	TRBJ1-2
TGTGCCAGCAGCCGGAACACTGAAGCTTTCTTT	CASSRNTEAFF	TRBV13	TRBJ1-1
TGTGCCAGCAGCAGCCGGGACAGGGTCTCTGGGGCCAACGTCCTGACTTTC	CASSSRDRVSGANVLTF	TRBV7-9	TRBJ2-6
TGTGCCAGCAGTCGACAGGGGCCCGAGCAGTACTTC	CASSRQGPEQYF	TRBV27	TRBJ2-7
TGTGCCAGCAGTTTTACAGGGGGCGATAATTCACCCCTCCACTTT	CASSFTGGDNSPLHF	TRBV6-1	TRBJ1-6
TGTGCCAGCAGCGGAGGGGAGAAAGTTGAAGACCCAACGCCTCCCCTGTGTGTGAACACTGAAGCTTTCTTT	CASSGGEKVEDPTPPLCVNTEAFF	TRBV7-3	TRBJ1-1
TGTGCCAGCAGCTTCCGCGAGGACACCGAGACCCAGTACTTC	CASSFREDTETQYF	TRBV5-5	TRBJ2-5
TGTGCCAGCAGACATAAATCAGGCGGATGGATGGATGAGCAGTTCTTC	CASRHKSGGWMDEQFF	TRBV12-3	TRBJ2-1
TGCGCCAGCAGCTTGGGCAAGGCGGGTTACGAGCAGTACTTC	CASSLGKAGYEQYF	TRBV5-1	TRBJ2-7
TGTGCTAGTGGTTTGCAGACAAGCAATCAGCCCCAGCATTTT	CASGLQTSNQPQHF	TRBV12-5	TRBJ1-5
TGTGCTAGCAGCTTGAACGGGACAGTCGCAAATGAAAAACTGTTTTTT	CASSLNGTVANEKLFF	TRBV7-7	TRBJ1-4
TGTGCCAGCAGCTCCACTTGGACTAGATCGGAGCAGTTCTTC	CASSSTWTRSEQFF	TRBV5-6	TRBJ2-1
TGTGCCAGCAGCCAAGATTTCAGCAGAGGCTACACCTTC	CASSQDFSRGYTF	TRBV3-1	TRBJ1-2
TGCAGTGCTATTCCGGGGGGAGAAGGGGAGAATGAGCAGTTCTTC	CSAIPGGEGENEQFF	TRBV20-1	TRBJ2-1
TGTGCCAGTAGTTGCCGGCAGGGGATTCGTCGGCTAGGAGATACGCAGTATTTT	CASSCRQGIRRLGDTQYF	TRBV19	TRBJ2-3
TGCGCCAGCAGCCAACCCAGCGGGGGCAGCAATCAGCCCCAGCATTTT	CASSQPSGGSNQPQHF	TRBV4-3	TRBJ1-5
TGTGCCATCAGTGCAAAAGCACTGTTGCCCAGGAAGCCCCAGCATTTT	CAISAKALLPRKPQHF	TRBV10-3	TRBJ1-5
TGTGCCCCAACTAGTAGGGAGGGCCGGGGGGGCCAAGAGACCCAGTACTTC	CAPTSREGRGGQETQYF	TRBV12-3	TRBJ2-5
TGTGCCAGTAGTATAGAGCCACGGGGTGACAGCTCTGGGAACTACAATGAGCAGTTCTTC	CASSIEPRGDSSGNYNEQFF	TRBV19	TRBJ2-1
TGTGCCAGCAGTGAGTGCCGGGGGGATCCCGGGGAGCTGTTTTTT	CASSECRGDPGELFF	TRBV6-2	TRBJ2-2
TGTGCCAGCAGCTTGGTATCCGGGTCAGATGACTCCTACGAGCAGTACTTC	CASSLVSGSDDSYEQYF	TRBV7-2	TRBJ2-7
TGTGCCAGCAGCGAACTAGCGGGCACCTACGAGCAGTACTTC	CASSELAGTYEQYF	TRBV7-3	TRBJ2-7
TGTGCCAGCAGTTATACCTTGCACAGGACGGCCTACGAGCAGTACTTC	CASSYTLHRTAYEQYF	TRBV6-5	TRBJ2-7
TGTGCCAGCAGCTCTAGGCCCGGGAGGCCTCGCACCGGGGAGCTGTTTTTT	CASSSRPGRPRTGELFF	TRBV9	TRBJ2-2
TGTGCCAGCAGCGTAGCGCCGGGACAGGGGGCCCATTTTTCACCCCTCCACTTT	CASSVAPGQGAHFSPLHF	TRBV9	TRBJ1-6
TGTGCCAGCACGGATAGCCTGCGAGACTATGGCTACACCTTC	CASTDSLRDYGYTF	TRBV7-6	TRBJ1-2
TGTGCCAGCAGCACCGCAGAGGGGCCCTACGAGCAGTACTTC	CASSTAEGPYEQYF	TRBV13	TRBJ2-7
TGTGCCAGCAGTTACTGGAAAGATACGCAGTATTTT	CASSYWKDTQYF	TRBV6-3	TRBJ2-3
TGTGCCAGCAGTGAATGTTGGGACAGGGATTCACCCCTCCACTTT	CASSECWDRDSPLHF	TRBV6-1	TRBJ1-6
TGTGCCAGCAGCTTGCTAAGGAGAAGACAGACCCAGTACTTC	CASSLLRRRQTQYF	TRBV5-8	TRBJ2-5
TGTGCCAGCAGCCTACAACGGGAGGGCTCTGGGGCCAACGTCCTGACTTTC	CASSLQREGSGANVLTF	TRBV13	TRBJ2-6
TGCAGTGCTAGAGTGATTAAGCACTTGAACACTGAAGCTTTCTTT	CSARVIKHLNTEAFF	TRBV20-1	TRBJ1-1
TGTGCCAGCAGCTTCCCAAGGGGGGGCGTAAAGGCCCAGCATTTT	CASSFPRGGVKAQHF	TRBV5-8	TRBJ1-5
TGCAGTGCTAGAGCGGTTAGGGAAGGTGAAGCTTTCTTT	CSARAVREGEAFF	TRBV20-1	TRBJ1-1
TGTGCCAGCACTTGGGGGGGAGGGGAGCTGTTTTTT	CASTWGGGELFF	TRBV2	TRBJ2-2
TGTGCCAGCAGTAATTCTAAGGCGGTCACTTTCATTCCCCATGAGCAGTTCTTC	CASSNSKAVTFIPHEQFF	TRBV6-6	TRBJ2-1
TGTGCCACCCACGAGGGAGAGACCCAGTACTTC	CATHEGETQYF	TRBV24-1	TRBJ2-5
TGTGCCAGCAGCTTAACGCCCCCGGGACGAAGGGTTTCCCCCTACGAGCAGTACTTC	CASSLTPPGRRVSPYEQYF	TRBV7-3	TRBJ2-7
TGTGCCAGCAGCTTAGAGCCGGGACAGGGGATCTCCGCCTACGAGCAGTACTTC	CASSLEPGQGISAYEQYF	TRBV11-1	TRBJ2-7
TGCAGTGCTAGCCCCCTAGGGACAGGGATTGGCTACACCTTC	CSASPLGTGIGYTF	TRBV20-1	TRBJ1-2
TGCAGTGCTAGAGATCGCTTTCCGACAGGGGCTTTCTTT	CSARDRFPTGAFF	TRBV20-1	TRBJ1-1
TGTGCCTGGAGTGTCAGAAGACAGCACTCCTACGAGCAGTACTTC	CAWSVRRQHSYEQYF	TRBV30	TRBJ2-7
TGTGCCAGCAGTTATTCCTTGGTGTGCACAGATACGCAGTATTTT	CASSYSLVCTDTQYF	TRBV28	TRBJ2-3
TGTGCCACAGTGGGGGAACAGGGGGGGGGACACTACGAGCAGTACTTC	CATVGEQGGGHYEQYF	TRBV24-1	TRBJ2-7
TGTGCCAGCAGCCAAGGATCAGGGCGTGGCTACACCTTC	CASSQGSGRGYTF	TRBV3-1	TRBJ1-2
TGTGCCAGCAGTTCTAGCGGGGGTAATGAGCAGTTCTTC	CASSSSGGNEQFF	TRBV28	TRBJ2-1
TGTGCCAGCAGCGGCTACCCGTACTTC	CASSGYPYF	TRBV7-2	TRBJ2-7
TGTGCCAGCAGTGACCCTCCGGGCACTGAAGCTTTCTTT	CASSDPPGTEAFF	TRBV6-4	TRBJ1-1
TGTGCCAGCAGCTCCTGGGGATCCTACGAGCAGTACTTC	CASSSWGSYEQYF	TRBV11-2	TRBJ2-7
TGTGCCAGCAGCCAAGATACCATGGACAGCTCCTACGAGCAGTACTTC	CASSQDTMDSSYEQYF	TRBV14	TRBJ2-7
TGCAGTGCTAGAGGGGGGTCCACGACTGAAGCTTTCTTT	CSARGGSTTEAFF	TRBV20-1	TRBJ1-1
TGTGCCAGCATCAGGGGGAGGCCAGATACGCAGTATTTT	CASIRGRPDTQYF	TRBV5-4	TRBJ2-3
TGTGCCAGCAGTGATGACCTTGGACAGGTGAAGAGCTCCTACGAGCAGTACTTC	CASSDDLGQVKSSYEQYF	TRBV6-4	TRBJ2-7
TGTGCCAGCAGCATCTCCAGGGGAGGCGAGCAGTACTTC	CASSISRGGEQYF	TRBV7-4	TRBJ2-7
TGCAGCGTTGCCCCCGTGGGGGGGGGACAGGCGAATCAGCCCCAGCATTTT	CSVAPVGGGQANQPQHF	TRBV29-1	TRBJ1-5
TGTGCTAGTGGTTCCCCTGGAGATAGGGACGAGCAGTACTTC	CASGSPGDRDEQYF	TRBV12-5	TRBJ2-7
TGTCGCCCCACGAGGGATCCACGATTTAGCACAGATACGCAGTATTTT	CRPTRDPRFSTDTQYF	TRBV6-1	TRBJ2-3
TGTGCCAGCAGCTCGGAGGCCGGGACAGGGGGCGCAATCCTTTCACCCCTCCACTTT	CASSSEAGTGGAILSPLHF	TRBV7-4	TRBJ1-6
TGTGCCAGCAGCTGGATTAACTATGGCTACACCTTC	CASSWINYGYTF	TRBV7-9	TRBJ1-2
TGTGCCACCAGTGATGGACCAGGGGGCCATACGCTGATTGGCTATGGCTACACCTTC	CATSDGPGGHTLIGYGYTF	TRBV24-1	TRBJ1-2
TGTGCCAGTAGTATAGATTGCGGAGGTGTCCAAGCTTTCTTT	CASSIDCGGVQAFF	TRBV19	TRBJ1-1
TGTGCCAGCAGTGTTCTCTTGATAGGAGGCTACACCTTC	CASSVLLIGGYTF	TRBV6-1	TRBJ1-2
TGTGCCAGCAGCTACGCACGGTGCTACGAGCAGTACTTC	CASSYARCYEQYF	TRBV13	TRBJ2-7
TGTGCCTGGAGTTACAATGAGCAGTTCTTC	CAWSYNEQFF	TRBV30	TRBJ2-1
TGTGCCAGCAGCCAGCTATCTCCGACTAGCGGGCGGTTCTACGAGCAGTACTTC	CASSQLSPTSGRFYEQYF	TRBV14	TRBJ2-7
TGTGCCAGCAGTGGCGTCGAGCAGTACTTC	CASSGVEQYF	TRBV6-3	TRBJ2-7
TGTGCCAGCAGCATGCCCGACCACGCTCAGCCCCAGCATTTT	CASSMPDHAQPQHF	TRBV9	TRBJ1-5
TGTGCCAGCAGCGTTACTGTGGTATACACTGAAGCTTTCTTT	CASSVTVVYTEAFF	TRBV11-3	TRBJ1-1
TGTGCCAGCAGCTCGGGTGGGGCCAGCAATCAGCCCCAGCATTTT	CASSSGGASNQPQHF	TRBV11-3	TRBJ1-5
TGTGCCAGCAGTTACTCCTTGGGGGGGGGCTACACCTTC	CASSYSLGGGYTF	TRBV6-3	TRBJ1-2
TGTGCCAGCAGCTTACGCTTGACTAGCGGGCCTGAGACCCAGTACTTC	CASSLRLTSGPETQYF	TRBV7-8	TRBJ2-5
TGTGCCAGCAGCTCAACTAAGCCAGATACGCAGTATTTT	CASSSTKPDTQYF	TRBV5-4	TRBJ2-3
TGCCCCCGTAGGACAGGGGCCGGGGAGCTGTTTTTT	CPRRTGAGELFF	TRBV20-1	TRBJ2-2
TGTGCCAGCAGCGAGAGGGCTGGCTACACCTTC	CASSERAGYTF	TRBV13	TRBJ1-2
TGCAGTGCTAGAGATCCCCCCAGACTGTCCTACGAGCAGTACTTC	CSARDPPRLSYEQYF	TRBV20-1	TRBJ2-7
TGTGCCTGGCCTAAGCAACCCTATAATTCACCCCTCCACTTT	CAWPKQPYNSPLHF	TRBV30	TRBJ1-6
TGTGCCAGCAGCTTCTCGTTGGGGAACACTGAAGCTTTCTTT	CASSFSLGNTEAFF	TRBV7-3	TRBJ1-1
TGCAGCTGTGGACTTAGAAGTGAAAAACTGTTTTTT	CSCGLRSEKLFF	TRBV29-1	TRBJ1-4
TGTGCCTGGCGGACAGGGTTAGCTTTCTTT	CAWRTGLAFF	TRBV30	TRBJ1-1
TGTGCCTGGGACTCCAGCTCTGGGGCCAACGTCCTGACTTTC	CAWDSSSGANVLTF	TRBV30	TRBJ2-6
TGTGCCAGCAGTTACAACGGACCGATGAACACTGAAGCTTTCTTT	CASSYNGPMNTEAFF	TRBV6-2	TRBJ1-1
TGCAGCGTTGGTCCCGCTCGGGGGCTAGATCCCTATAGCAATCAGCCCCAGCATTTT	CSVGPARGLDPYSNQPQHF	TRBV29-1	TRBJ1-5
TGTGCCAGTATGTCGCGGGACCATGGCTATGGCTACACCTTC	CASMSRDHGYGYTF	TRBV19	TRBJ1-2
TGTGCCACCAGTGAAAAAAAAATGGACGATGAGGGACGCTATGGCTACACCTTC	CATSEKKMDDEGRYGYTF	TRBV24-1	TRBJ1-2
TGCAGTGCTAGCCAGGACAGGGGGATGAACACCATATATTTT	CSASQDRGMNTIYF	TRBV20-1	TRBJ1-3
TGTGCCAGCAGCTTAGAACAGGGGGCCTACGAGCAGTACTTC	CASSLEQGAYEQYF	TRBV11-3	TRBJ2-7
TGCGCCAGCGCGGGAGCGTCCTACGAGCAGTACTTC	CASAGASYEQYF	TRBV5-1	TRBJ2-7
TGTGCCAGCAGTTTAACACCGTCTCCCCGGGCGTCCTACGAGCAGTACTTC	CASSLTPSPRASYEQYF	TRBV28	TRBJ2-7
TGCGCCAGCAGCCAAGAGGCCACAGGGGGGAAAGGGGAGCTGTTTTTT	CASSQEATGGKGELFF	TRBV4-1	TRBJ2-2
TGCGCCAGCAGCGCCGGGACTAGCGGGAGGGTCGGCGAGCAGTACTTC	CASSAGTSGRVGEQYF	TRBV5-1	TRBJ2-7
TGCAGTGCAGGGCCTTGGTTTAGCTGCAATCAGCCCCAGCATTTT	CSAGPWFSCNQPQHF	TRBV20-1	TRBJ1-5
TGTGCCACCAGTAGACAAGGGTACAATGAGCAGTTCTTC	CATSRQGYNEQFF	TRBV24-1	TRBJ2-1
TGTGCCAGCAGCCAAGGGGGGAATATATATGGCTACACCTTC	CASSQGGNIYGYTF	TRBV14	TRBJ1-2
TGTGCCAGCAGCTCCTCGGAGGGGCCACACAATGAGCAGTTCTTC	CASSSSEGPHNEQFF	TRBV11-2	TRBJ2-1
TGTGCCAGTAGGCCGGGCCGCAGGGGCTACACCTTC	CASRPGRRGYTF	TRBV19	TRBJ1-2
TGTGCCCGGCGATACAATGAGCAGTTCTTC	CARRYNEQFF	TRBV6-5	TRBJ2-1
TGTGCCAGCATCCATAGGGGACAGGGTCCGGTCACTGAAGCTTTCTTT	CASIHRGQGPVTEAFF	TRBV27	TRBJ1-1
TGTGCCAGCAGTGGAGCGGGAATGGGGGAAATTACTGAAGCTTTCTTT	CASSGAGMGEITEAFF	TRBV28	TRBJ1-1
TGTATGGCCAGGTCCTACAATGAGCAGTTCTTC	CMARSYNEQFF	TRBV30	TRBJ2-1
TGTGCCAGCAGTCCTGGGGACCGGGTTTCCTATAATTCACCCCTCCACTTT	CASSPGDRVSYNSPLHF	TRBV27	TRBJ1-6
TGTGCCAGCAGTTTAACCGACAGGGGCACGGCTAACTATGGCTACACCTTC	CASSLTDRGTANYGYTF	TRBV27	TRBJ1-2
TGTGGTCCTGGCGGAGGGGGGGAGACCCAGTACTTC	CGPGGGGETQYF	TRBV11-3	TRBJ2-5
TGCGCCAGCAGCTTGGAGGGGGGTTACAATGAGCAGTTCTTC	CASSLEGGYNEQFF	TRBV5-1	TRBJ2-1
TGTGCCAGCATTGGGGGGGTGCCCTACGAGCAGTACTTC	CASIGGVPYEQYF	TRBV27	TRBJ2-7
TGTGCCAGCAGGCCAGAAAAGGTTTCACCCCTCCACTTT	CASRPEKVSPLHF	TRBV7-9	TRBJ1-6
TGTGCCAGTACAACTAGCGGGGACGAGAATGAGCAGTTCTTC	CASTTSGDENEQFF	TRBV19	TRBJ2-1
TGTGCCAGCAGTGAAAACCTGCGGAGGGGGCCCGGGGAGCTGTTTTTT	CASSENLRRGPGELFF	TRBV6-4	TRBJ2-2
TGTGCCAGCAGCTGGGGAGAGACCCAGTACTTC	CASSWGETQYF	TRBV11-2	TRBJ2-5
TGTGCCAGCAGCCAATGGGAGGGTCCGGGACAGGGCAAGAACACTGAAGCTTTCTTT	CASSQWEGPGQGKNTEAFF	TRBV3-1	TRBJ1-1
TGCAGCGTTGTTGTACCCTCACAGGGTTTTAACTATGGCTACACCTTC	CSVVVPSQGFNYGYTF	TRBV29-1	TRBJ1-2
TGTGCCACCAACCCCGGCAAACTTTTTACAGATACGCAGTATTTT	CATNPGKLFTDTQYF	TRBV18	TRBJ2-3
TGTGCCAGCAGCGGGAAAGGGGGAAAAGAGACCCAGTACTTC	CASSGKGGKETQYF	TRBV7-3	TRBJ2-5
TGTCGTCGGGACAGACGCCCTTGCTACGAGCAGTACTTC	CRRDRRPCYEQYF	TRBV7-9	TRBJ2-7
TGTGCCTGGTATACAGGGGCGCTAAACGAGCAGTACTTC	CAWYTGALNEQYF	TRBV30	TRBJ2-7
TGCAGTGCTAGAGTGCTCCCTAAGGGGACTCAGGGGAAAACTTGGTACACCATATATTTT	CSARVLPKGTQGKTWYTIYF	TRBV20-1	TRBJ1-3
TGTGCCACCAGTGACCTCAGTGATGGCTACACCTTC	CATSDLSDGYTF	TRBV24-1	TRBJ1-2
TGCGCCAGCAGTGAATCAGGGCAACAGGGCGGAAACAGGGGTAGCAATCAGCCCCAGCATTTT	CASSESGQQGGNRGSNQPQHF	TRBV10-1	TRBJ1-5
TGTGCCACCAGTGATTTTTGCGGGTGGGAACTACGTAGAGATACGCAGTATTTT	CATSDFCGWELRRDTQYF	TRBV24-1	TRBJ2-3
TGTGCCAGCAGCTTAGCGCTATCGGCCAAAAATCAGCCCCAGCATTTT	CASSLALSAKNQPQHF	TRBV7-2	TRBJ1-5
