TGCGCCAGCAGCCAAGATTTGGACAGGGGACAGGACTCTGGAAACACCATATATTTT	CASSQDLDRGQDSGNTIYF	TRBV4-1	TRBJ1-3
TGTGCCACCAGCGTCGGCAGGGGCTATGGCTACACCTTC	CATSVGRGYGYTF	TRBV24-1	TRBJ1-2
TGTGCCAGACGAGGACAGGGGGCCCCAGGCTACACCTTC	CARRGQGAPGYTF	TRBV6-2	TRBJ1-2
TGTGCCAGCAGTGACCCCCCAGCGGTGAACACTGAAGCTTTCTTT	CASSDPPAVNTEAFF	TRBV2	TRBJ1-1
TGCAGTGCTAGTCACCGTTTCCCACGACGTGAGGACTACGAGCAGTACTTC	CSASHRFPRREDYEQYF	TRBV20-1	TRBJ2-7
TGTGCCATCAGTGCTGGGAAGCTAGAGACTAGCGGGGGGACCGGGGAGCTGTTTTTT	CAISAGKLETSGGTGELFF	TRBV10-3	TRBJ2-2
TGTGCCAGCAGCTCCGTGGGGCGTAGGCAATACGAGCAGTACTTC	CASSSVGRRQYEQYF	TRBV5-6	TRBJ2-7
TGTGCCAGCAGCCTCCTCAAGCTAGCGGTGGGCACAGATACGCAGTATTTT	CASSLLKLAVGTDTQYF	TRBV7-3	TRBJ2-3
TGTGCCAGCAGTTACCCGGGACAGGTCCTTAATGAAAAACTGTTTTTT	CASSYPGQVLNEKLFF	TRBV6-9	TRBJ1-4
TGCAGCGAAAGCACCCCCTACGAGCAGTACTTC	CSESTPYEQYF	TRBV29-1	TRBJ2-7
TGTGCCACCAGTGAAAGGGACCGAGGGATCTGGTACGAGCAGTACTTC	CATSERDRGIWYEQYF	TRBV24-1	TRBJ2-7
TGTGCCAGCAGCATAGCGGGAGGATGTGAGCAGTTCTTC	CASSIAGGCEQFF	TRBV5-4	TRBJ2-1
TGCGCCTGGGGACAGCTGCCTTTAGACAGCAATCAGCCCCAGCATTTT	CAWGQLPLDSNQPQHF	TRBV5-1	TRBJ1-5
TGTGCCAGCAGCAACCCATCGGGCTACGAGCAGTACTTC	CASSNPSGYEQYF	TRBV9	TRBJ2-7
TGTGCCAGCAGTTTACCCCCGGGACTGGGCGAGCAGTACTTC	CASSLPPGLGEQYF	TRBV27	TRBJ2-7
TGTGCCAGCCTAGTTGGGGGGAATTGTCAACACGAGCAGTACTTC	CASLVGGNCQHEQYF	TRBV6-4	TRBJ2-7
TGTGCCAGCAGCACCCCCGGGGGGGCCGTTGGGAAAGAGACCCAGTACTTC	CASSTPGGAVGKETQYF	TRBV6-1	TRBJ2-5
TGTGCCACCACTAAATTCCGGGACAGGGGGAGCCCGACCCCCAATGAGCAGTTCTTC	CATTKFRDRGSPTPNEQFF	TRBV24-1	TRBJ2-1
TGCGCCAGCAGCCAAGCCCGCAGGGTTAATTATGGCAATCAGCCCCAGCATTTT	CASSQARRVNYGNQPQHF	TRBV4-3	TRBJ1-5
TGTGCCAGCAGCTTAGCACCTGCTGGAAACACCATATATTTT	CASSLAPAGNTIYF	TRBV7-8	TRBJ1-3
TGCAGCGTTGAAGACCCCCGGATCTCCGGGGAGCTGTTTTTT	CSVEDPRISGELFF	TRBV29-1	TRBJ2-2
TGTGCCAGCAGCTTGGCCGCGCCGGGACTAGCCCCCTCCTACAATGAGCAGTTCTTC	CASSLAAPGLAPSYNEQFF	TRBV5-4	TRBJ2-1
TGCGCCAGCAGCCAATTAGGGGGGGCCCAAGAGACCCAGTACTTC	CASSQLGGAQETQYF	TRBV4-1	TRBJ2-5
TGCGCCAGCAGAACAAAAAAGTCAGGTTCTAACTATGGCTACACCTTC	CASRTKKSGSNYGYTF	TRBV10-1	TRBJ1-2
TGCGCCAGCACTAGTCCTTCGGAGGGGGAGTATGGCTACACCTTC	CASTSPSEGEYGYTF	TRBV10-2	TRBJ1-2
TGTGCCAGCAGCCGCCTCCACTATGGCTACACCTTC	CASSRLHYGYTF	TRBV4-2	TRBJ1-2
TGTGCCAGCAGCAAGCGGGGCGCACTGTATAATTCACCCCTCCACTTT	CASSKRGALYNSPLHF	TRBV7-3	TRBJ1-6
TGTGCCAGCAGCGCCCGGCACGGGGTTCCGAACGAGCAGTACTTC	CASSARHGVPNEQYF	TRBV13	TRBJ2-7
TGTGCCAGCAGCTTGTCCAGGGGGGAGCAGTACTTC	CASSLSRGEQYF	TRBV5-6	TRBJ2-7
TGTGCCAGCAGCGTAGAGTACGACAGCCGGAACAATGAGCAGTTCTTC	CASSVEYDSRNNEQFF	TRBV9	TRBJ2-1
TGTGCCACCCATAGGGCCCACTCCTACGAGCAGTACTTC	CATHRAHSYEQYF	TRBV24-1	TRBJ2-7
TGTGCCAGCAGCTTAGACCCGCGGGAGGCGAACACTGAAGCTTTCTTT	CASSLDPREANTEAFF	TRBV7-9	TRBJ1-1
TGTGCCACCAGTGTTTTTGACAGGCAAGGGGAGAGCTCTGGAAACACCATATATTTT	CATSVFDRQGESSGNTIYF	TRBV24-1	TRBJ1-3
TGTGCCAGCAGCTTAGGGGTTTCAGGGTACGAGCAGTACTTC	CASSLGVSGYEQYF	TRBV7-9	TRBJ2-7
TGCAGCGTTGAACTAGCGGGGGGAATCTACGAGCAGTACTTC	CSVELAGGIYEQYF	TRBV29-1	TRBJ2-7
TGCGCCAGCAGCAGGAGGGGGTTTCATGAAAAACTGTTTTTT	CASSRRGFHEKLFF	TRBV5-1	TRBJ1-4
TGCAGCGTTAACCCCGGGACTAGCGGCTCCTACGAGCAGTACTTC	CSVNPGTSGSYEQYF	TRBV29-1	TRBJ2-7
TGTGCCAGCACGCCGAAGTCCATCCTGAGGGGGAACATTCAGTACTTC	CASTPKSILRGNIQYF	TRBV11-3	TRBJ2-4
TGTGCCAGCAGCGAACGATTCCGGGACAGGGGCGTGGTGGTCAATGTGGTAACTAATGAAAAACTGTTTTTT	CASSERFRDRGVVVNVVTNEKLFF	TRBV13	TRBJ1-4
TGCGCCAGCAGTGAGTCCAAATGGGAGGCCAAGAGGACGCAGTATTTT	CASSESKWEAKRTQYF	TRBV10-1	TRBJ2-3
TGTGCCAGTAGTTGGTACCCTCGACAGGTGGCCTACGAGCAGTACTTC	CASSWYPRQVAYEQYF	TRBV19	TRBJ2-7
TGTGCCAGCAGCCAAGACCCCAGGGAAATCGACGAGCAGTACTTC	CASSQDPREIDEQYF	TRBV4-2	TRBJ2-7
TGTGCCAGCTCACCACCTGAGGGCGGCACAGATACGCAGTATTTT	CASSPPEGGTDTQYF	TRBV18	TRBJ2-3
TGTGCCTGGAGTTTACAGCTCTCCTACGAGCAGTACTTC	CAWSLQLSYEQYF	TRBV30	TRBJ2-7
TGTGCCAGCAGCAGGACAGGCCACCCCCAGCATTTT	CASSRTGHPQHF	TRBV6-2	TRBJ1-5
TGTGCCAGAAGGCGGACCACTGAAGCTTTCTTT	CARRRTTEAFF	TRBV19	TRBJ1-1
TGTGCCAGCTCGAACGCCACAGGGCAATTGAACACTGAAGCTTTCTTT	CASSNATGQLNTEAFF	TRBV18	TRBJ1-1
TGTGCCAGCAGCCAAGAGGAGACTAGCGGGAGGGCCCAGGGAGATACGCAGTATTTT	CASSQEETSGRAQGDTQYF	TRBV3-1	TRBJ2-3
TGTGCCAGCTACACCGAGGGGAGACGGAAGAACACTGAAGCTTTCTTT	CASYTEGRRKNTEAFF	TRBV27	TRBJ1-1
TGTGCCAGCAGCATAGCGGGAAAAGGGTGCACAGATACGCAGTATTTT	CASSIAGKGCTDTQYF	TRBV13	TRBJ2-3
TGTGCCAGCGACGGAGCCTACGAGCAGTACTTC	CASDGAYEQYF	TRBV18	TRBJ2-7
TGTGCCAGCAGCTTGGGTGCCGGGGAAGCTTTCTTT	CASSLGAGEAFF	TRBV5-4	TRBJ1-1
TGTGCCAGCAGCTTGCCGACAGGGGGGAGCAATCAGCCCCAGCATTTT	CASSLPTGGSNQPQHF	TRBV5-4	TRBJ1-5
TGTGCCACCAGTGATTTAGGAAAGGTGGGCTGTTTCGGGGAGCTGTTTTTT	CATSDLGKVGCFGELFF	TRBV24-1	TRBJ2-2
TGTGCCAGCAGTTTATGTCTGCCGACAGGGTATGGCTACACCTTC	CASSLCLPTGYGYTF	TRBV27	TRBJ1-2
TGCAGCGTTGACACGAGGGTCTCATCAGATACGCAGTATTTT	CSVDTRVSSDTQYF	TRBV29-1	TRBJ2-3
TGCGCCAGCAGCCACGAGACTGATCAGCCCCAGCATTTT	CASSHETDQPQHF	TRBV4-3	TRBJ1-5
TGTGCCAGCAGTTTAGGGACAGGGGATGGTAATTCACCCCTCCACTTT	CASSLGTGDGNSPLHF	TRBV27	TRBJ1-6
TGCGCCAGATTCAGGGGTGGGTACAATGAGCAGTTCTTC	CARFRGGYNEQFF	TRBV5-1	TRBJ2-1
TGTGCCAGCAGCTTGGCCTCACAGTCTAACTTC	CASSLASQSNF	TRBV5-6	TRBJ1-2
TGTGCCAGTAGTATAGGTTTAAGGGCGGGCTCAAGCCCTGAAGCTTTCTTT	CASSIGLRAGSSPEAFF	TRBV19	TRBJ1-1
TGCGCCATATCAGGGATCTTC	CAISGIF	TRBV10-2	TRBJ2-1
TGTGCCAGCAGTTCCAGGGGGCTCCCAGATACGCAGTATTTT	CASSSRGLPDTQYF	TRBV27	TRBJ2-3
TGTGCCAGCAGAGCAAACGGGGGACAGCTACGTAACAATGAGCAGTTCTTC	CASRANGGQLRNNEQFF	TRBV28	TRBJ2-1
TGTGCCAGCAGGTGGGGGAACACTGAAGCTTTCTTT	CASRWGNTEAFF	TRBV6-1	TRBJ1-1
TGCGCCAGCAGCGGGGACGGGAAAGCCTACGAGCAGTACTTC	CASSGDGKAYEQYF	TRBV10-2	TRBJ2-7
TGTCTCCGTAGGGGGAAAAAAGAGACCCAGTACTTC	CLRRGKKETQYF	TRBV7-9	TRBJ2-5
TGCGCCAGCAGCCGAGAGGACAGGGCTAGAGCCTACGAGCAGTACTTC	CASSREDRARAYEQYF	TRBV4-1	TRBJ2-7
TGCAGCGTTTCACTGAGGACTAGAGAGCAGTTCTTC	CSVSLRTREQFF	TRBV29-1	TRBJ2-1
TGTGCCAGCAGCTTCCGCCAGGGTGGTACGGGAACTGGGGCCAACGTCCTGACTTTC	CASSFRQGGTGTGANVLTF	TRBV7-8	TRBJ2-6
TGTGCCAGCAGCGGAAGGGATATGAACACTGAAGCTTTCTTT	CASSGRDMNTEAFF	TRBV11-3	TRBJ1-1
TGTGCCAGCAGCTTTTTACAGGGCGGGGGGGTGGGGAACACTGAAGCTTTCTTT	CASSFLQGGGVGNTEAFF	TRBV7-6	TRBJ1-1
TGCAGTGCTAGAGATCGCATAGGGGGGTACTACGAGCAGTACTTC	CSARDRIGGYYEQYF	TRBV20-1	TRBJ2-7
TGTGCCTGGAGTAAAGTAGTCGGTCAGCCCCAGCATTTT	CAWSKVVGQPQHF	TRBV30	TRBJ1-5
TGTGCCAGCAGTTACCGCCCTGTGCTGAACACTGAAGCTTTCTTT	CASSYRPVLNTEAFF	TRBV6-3	TRBJ1-1
TGTGCCAGCAGTCAAACTAGAGAATACGAGCAGTACTTC	CASSQTREYEQYF	TRBV7-6	TRBJ2-7
TGTGCCAGCAGTCCCCTAGTCGCAGTTCATGGCTACACCTTC	CASSPLVAVHGYTF	TRBV28	TRBJ1-2
TGTGCCAGCAGTCGAGGCTTGCTAGGAGGGAGCGGAAACACTGAAGCTTTCTTT	CASSRGLLGGSGNTEAFF	TRBV6-5	TRBJ1-1
TGTGCCAGCAGTTTCCGGGGGGCGGGTTGGTTAAATGAAAAACTGTTTTTT	CASSFRGAGWLNEKLFF	TRBV12-3	TRBJ1-4
TGTGCCAGCAGCTTAAGGGGGGGCCCGTATAGCAATCAGCCCCAGCATTTT	CASSLRGGPYSNQPQHF	TRBV13	TRBJ1-5
TGTGCCTGGATGTTGGGGTCAGGGGGAAATGAAAAACTGTTTTTT	CAWMLGSGGNEKLFF	TRBV30	TRBJ1-4
TGTGCCACCAGTGATGCGACACCCTGCACAGATACGCAGTATTTT	CATSDATPCTDTQYF	TRBV24-1	TRBJ2-3
TGTGCCAGCTCACTAGTCCTAGCGGGCGCGTCCGGGGAGCTGTTTTTT	CASSLVLAGASGELFF	TRBV18	TRBJ2-2
TGTGCCAGTAGTAACGTTCTATACGAGCAGTACTTC	CASSNVLYEQYF	TRBV19	TRBJ2-7
TGCAGTGCTAGCAGGGATCTTGGCACGCAGTATTTT	CSASRDLGTQYF	TRBV20-1	TRBJ2-3
TGTGCCAGCAGCATGAACACAGGGGGGGCCTTGTACAATGAGCAGTTCTTC	CASSMNTGGALYNEQFF	TRBV9	TRBJ2-1
TGCGCCAAGCTTGATACGCAGTATTTT	CAKLDTQYF	TRBV10-1	TRBJ2-3
TGTGCCAGCAGCTTGGGCACAGGGGTTGGAAACACCATATATTTT	CASSLGTGVGNTIYF	TRBV5-4	TRBJ1-3
TGTGCCAGCTCACCACCCTCGGTAGTCCCCTACAATGAGCAGTTCTTC	CASSPPSVVPYNEQFF	TRBV18	TRBJ2-1
TGTGCCACCAGCAGTAGGGTCCCCGTATATTACTATGGCTACACCTTC	CATSSRVPVYYYGYTF	TRBV15	TRBJ1-2
TGTGCCAGCAGTTGCCGACTGCGGGATGGCTACACCTTC	CASSCRLRDGYTF	TRBV6-3	TRBJ1-2
TGTGCCAGCAGCCACCAGGGAGAACTCGGGCAACAGCCCCAGCATTTT	CASSHQGELGQQPQHF	TRBV3-1	TRBJ1-5
TGCGCCAGCAGTGGTTCCGGGACGGAGGGCTCCTACAATGAGCAGTTCTTC	CASSGSGTEGSYNEQFF	TRBV5-1	TRBJ2-1
TGTGCCTGGAACGGGCGGGAGTGGAATACGCAGTATTTT	CAWNGREWNTQYF	TRBV30	TRBJ2-3
TGTGCTAGCAGCTTAGCGCGGCAAGGGCCGTATGAGCAGTTCTTC	CASSLARQGPYEQFF	TRBV7-7	TRBJ2-1
TGTGCCAGTAGTATACCGACGGAAGGTAGCAATCAGCCCCAGCATTTT	CASSIPTEGSNQPQHF	TRBV19	TRBJ1-5
TGCGCCAGCAGCCAAGATTTGTACAGGGAAAACATTCAGTACTTC	CASSQDLYRENIQYF	TRBV4-1	TRBJ2-4
TGTGCCAGCGGCTCGACTCGACAGGGCAAGGCCTACGAGCAGTACTTC	CASGSTRQGKAYEQYF	TRBV6-1	TRBJ2-7
TGTGCCAGCAGCAAACACCTCGACAGGGCCCCTACTGGCGTAGATACGCAGTATTTT	CASSKHLDRAPTGVDTQYF	TRBV13	TRBJ2-3
TGTGCCCAGTCCAGGGGGGGGGGGTCCTACAATGAGCAGTTCTTC	CAQSRGGGSYNEQFF	TRBV24-1	TRBJ2-1
TGCAGTGCTCTTCGACTAGCGGGCAAAGCCGGGGAGCTGTTTTTT	CSALRLAGKAGELFF	TRBV20-1	TRBJ2-2
TGCGCCAGCAGCGGCAGGGGGGTCTTAAGGGAAAACAATCAGCCCCAGCATTTT	CASSGRGVLRENNQPQHF	TRBV5-1	TRBJ1-5
TGTGCCAGCAGTGACTCACTAGCGGGCAGGACCTACGAGCAGTACTTC	CASSDSLAGRTYEQYF	TRBV6-4	TRBJ2-7
TGTGCCAGTAGTATAGATCCTTCCCCCGGGACTAGGGGCACAGATACGCAGTATTTT	CASSIDPSPGTRGTDTQYF	TRBV19	TRBJ2-3
TGTGCCAGCAGTTACTCTTGTCTAGCGCCCGGGCAAGAGACCCAGTACTTC	CASSYSCLAPGQETQYF	TRBV6-5	TRBJ2-5
TGTGCCAGCAGCGTCCCATTCCCCGGGTTCAGCTCCTACAATGAGCAGTTCTTC	CASSVPFPGFSSYNEQFF	TRBV5-6	TRBJ2-1
TGTGCCTTACCTTGGGACAGGGACACCCCTGGGGCCAACGTCCTGACTTTC	CALPWDRDTPGANVLTF	TRBV6-1	TRBJ2-6
TGTGCCAGCAGGCCCCCCCCCGGGGGAGCCTATGGCTACACCTTC	CASRPPPGGAYGYTF	TRBV6-6	TRBJ1-2
TGTGCCAGCAGCTTTGCAGGCATAATCTACTCCTACGAGCAGTACTTC	CASSFAGIIYSYEQYF	TRBV7-9	TRBJ2-7
TGCGCCAGCAGCGCGGTCGGGGGGGCGATTATCTTC	CASSAVGGAIIF	TRBV5-1	TRBJ2-1
TGTGCCAGCAGCTGTTTGACAGGGACCACCGGGGAGCTGTTTTTT	CASSCLTGTTGELFF	TRBV11-2	TRBJ2-2
TGCGCCAGCAGCTTGTCGCAAGGGACTAGCGGATCTTTACACACCGGGGAGCTGTTTTTT	CASSLSQGTSGSLHTGELFF	TRBV5-1	TRBJ2-2
TGTGCCAGCATAAATTTAACAGGGCGTTACGAGCAGTACTTC	CASINLTGRYEQYF	TRBV6-5	TRBJ2-7
TGTGCCAGCAGTGAGGAGGCCGGGACGGGGGATGAAAAACTGTTTTTT	CASSEEAGTGDEKLFF	TRBV6-4	TRBJ1-4
TGTGCCAGCAGTTTCGTCCCCGACTCCAGCTCTGGAAACACCATATATTTT	CASSFVPDSSSGNTIYF	TRBV6-4	TRBJ1-3
TGTGCCAGCGCCCTTCGGGCGGCTGAAGCTTTCTTT	CASALRAAEAFF	TRBV7-9	TRBJ1-1
TGCGCCAGCAGTGTACTAGGGGCTGGTGAGGGCAGCTCCTACGAGCAGTACTTC	CASSVLGAGEGSSYEQYF	TRBV10-1	TRBJ2-7
TGTGCCAGCAGCCAAGACAGGGGTTCACCCCTCCACTTT	CASSQDRGSPLHF	TRBV4-2	TRBJ1-6
TGTGCCAGCATGGTCCAGGGAGGGTCATACAATGAGCAGTTCTTC	CASMVQGGSYNEQFF	TRBV7-9	TRBJ2-1
TGTGCCAGCAGCCTTGACAGGGCAGGGAGGTACTTC	CASSLDRAGRYF	TRBV9	TRBJ2-7
TGTGCCAGCAGCTTAGGCGGTGGCACAGATACGCAGTATTTT	CASSLGGGTDTQYF	TRBV13	TRBJ2-3
TGCAGTGCAGGGCGACAGTCTGGGAACTATGGCTACACCTTC	CSAGRQSGNYGYTF	TRBV20-1	TRBJ1-2
TGCAGTGCTAGTTGGCCGGGACGACCCTACGAGCAGTACTTC	CSASWPGRPYEQYF	TRBV20-1	TRBJ2-7
TGCGCCAGCAGCTGGTCAGGGCCGACTGAAGCTTTCTTT	CASSWSGPTEAFF	TRBV5-1	TRBJ1-1
TGTGCCAGCAGTCTAGGACAGCCTAGCAATCAGCCCCAGCATTTT	CASSLGQPSNQPQHF	TRBV28	TRBJ1-5
TGTGCCAGCAGCAAAGTGCTCTGGGATGTGTGGGAGCTGTTTTTT	CASSKVLWDVWELFF	TRBV7-2	TRBJ2-2
TGTGCCAGCAGCTACAGGACTAACTACGAGCAGTACTTC	CASSYRTNYEQYF	TRBV7-9	TRBJ2-7
TGCAGTGCGGCCCCGGGGACACCCGGTGGCTACACCTTC	CSAAPGTPGGYTF	TRBV20-1	TRBJ1-2
TGCGCCAGAGCCGAGCGATCGAATGAGCAGTTCTTC	CARAERSNEQFF	TRBV4-1	TRBJ2-1
TGTGCCAGCATCAGTACAGGGTCTGAACCACCCTATGGCTACACCTTC	CASISTGSEPPYGYTF	TRBV6-5	TRBJ1-2
TGCGCCAGCAGCTCCCAAGCAGACAGGTGTGACTCCTACGAGCAGTACTTC	CASSSQADRCDSYEQYF	TRBV5-1	TRBJ2-7
TGCGCCAGCAGCCAGGACAGGGGAGGTGAATACGAGCAGTACTTC	CASSQDRGGEYEQYF	TRBV10-1	TRBJ2-7
TGTGCCAGCAGCTCCCTGGGGACGCTGAACACTGAAGCTTTCTTT	CASSSLGTLNTEAFF	TRBV5-4	TRBJ1-1
TGTGCCAGCACCTTGGGGACAGCGCAGTACTTC	CASTLGTAQYF	TRBV7-3	TRBJ2-7
TGTGCCAGCAGTTGGTCCGGGGGGGAAAAGCGGGAGACCCAGTACTTC	CASSWSGGEKRETQYF	TRBV6-2	TRBJ2-5
TGTGCCTGGAAGAGGGAAGGGAACACTGAAGCTTTCTTT	CAWKREGNTEAFF	TRBV30	TRBJ1-1
TGTGCCAGCAGCTTGGAAGGGAGCTACACTGAAGCTTTCTTT	CASSLEGSYTEAFF	TRBV5-6	TRBJ1-1
TGCGCCAGCAGAGCCGTTTCCGGTATGGACAGGGGGCTTTCTGAAGCTTTCTTT	CASRAVSGMDRGLSEAFF	TRBV10-2	TRBJ1-1
TGCGCCCCTCGGGGCACTAGGGCTGTGGACTATGGCTACACCTTC	CAPRGTRAVDYGYTF	TRBV5-1	TRBJ1-2
TGTGCCAGCAGTTACCCGGCGTCAAGAGCTAACTATGGCTACACCTTC	CASSYPASRANYGYTF	TRBV6-5	TRBJ1-2
TGTGCCACCAGTGCCGGAGCTTCTACTGAAGCTTTCTTT	CATSAGASTEAFF	TRBV24-1	TRBJ1-1
TGTGCCAGCAGCTTACTAGCGGGGGGCTACGAGCAGTACTTC	CASSLLAGGYEQYF	TRBV7-9	TRBJ2-7
TGTGCCAGTTCCGGGACTAGCGGATTCCCCTACGAGCAGTACTTC	CASSGTSGFPYEQYF	TRBV6-1	TRBJ2-7
TGCGCCAGCAGGTCCCGCCGGACAGGTTTGGTAAGCTACTACGAGCAGTACTTC	CASRSRRTGLVSYYEQYF	TRBV10-1	TRBJ2-7
TGCGCCAGCAGGTGGGTGAGTGGACCCCCGGGACTATCCTCCTACGAGCAGTACTTC	CASRWVSGPPGLSSYEQYF	TRBV10-2	TRBJ2-7
TGTGCCAGCAGCTTCACGAAAGACTCTAATGAAAAACTGTTTTTT	CASSFTKDSNEKLFF	TRBV11-2	TRBJ1-4
TGTGCTAGTGACCTGAAACCAGATACGCAGTATTTT	CASDLKPDTQYF	TRBV12-5	TRBJ2-3
TGTGCCAGCCCGACTTCCGGCTACACCTTC	CASPTSGYTF	TRBV7-6	TRBJ1-2
TGCAGTGCTAGAGAAATTGTGGTTACAGGGCCACCCCTCCACTTT	CSAREIVVTGPPLHF	TRBV20-1	TRBJ1-6
TGTGCCAGCAGCTACTCTTCCTACACTGAAGCTTTCTTT	CASSYSSYTEAFF	TRBV5-6	TRBJ1-1
TGCGCCAGCATTCCCGGGGGGGCAGCGTACAATGAGCAGTTCTTC	CASIPGGAAYNEQFF	TRBV10-1	TRBJ2-1
TGTGCCTGGATTCTGGGAGTTAACGGTAAAGCTTTCTTT	CAWILGVNGKAFF	TRBV30	TRBJ1-1
TGTGCCAGTAGTATTCACAGCTCGGTCTCCTACAATGAGCAGTTCTTC	CASSIHSSVSYNEQFF	TRBV19	TRBJ2-1
TGTGCCAGCAGCAACGGGCCGGGACTAGCGGGAGCCTCTGGAAACACCATATATTTT	CASSNGPGLAGASGNTIYF	TRBV13	TRBJ1-3
TGTGCCAGCAGCAGCAGACAGGGGGCGCATAGCAATCAGCCCCAGCATTTT	CASSSRQGAHSNQPQHF	TRBV7-3	TRBJ1-5
TGTGCCAGCAGCTTAGGACACCAGTTGTATAGCAATCAGCCCCAGCATTTT	CASSLGHQLYSNQPQHF	TRBV11-2	TRBJ1-5
TGCAAGAAGGATTCTAACTATGGCTACACCTTC	CKKDSNYGYTF	TRBV20-1	TRBJ1-2
TGTGCCAGCAGTGAGGGGGCCGCGAACACCGGGGAGCTGTTTTTT	CASSEGAANTGELFF	TRBV6-1	TRBJ2-2
TGTGCCAGCAGCTTAGACCCCCAGGGGAGGGGAAACACCATATATTTT	CASSLDPQGRGNTIYF	TRBV11-2	TRBJ1-3
TGTGCCAGCTTATGGGGGGTTAACACCGGGGAGCTGTTTTTT	CASLWGVNTGELFF	TRBV6-2	TRBJ2-2
TGTGCCAGCAATGGGGGTGATGGCTACACCTTC	CASNGGDGYTF	TRBV6-3	TRBJ1-2
TGCGCCAGCAGCGAGACCCAGTACACCATATATTTT	CASSETQYTIYF	TRBV4-1	TRBJ1-3
TGCGCCAGCAGCTTGGGGGGAACAGGGGGGATGTACTACGAGCAGTACTTC	CASSLGGTGGMYYEQYF	TRBV5-1	TRBJ2-7
TGTGCTCGCGGGACAGGGGACGAGCAGTACTTC	CARGTGDEQYF	TRBV27	TRBJ2-7
TGTGCCAGCAGTGAATTGAACTCCGAAAGCCGGGACAGGGGCTACGAGCAGTACTTC	CASSELNSESRDRGYEQYF	TRBV25-1	TRBJ2-7
TGCGCCAGCAGTGACGAGAACACCGGGGAGCTGTTTTTT	CASSDENTGELFF	TRBV10-1	TRBJ2-2
TGTGCCAGCAGCAGGGGGGGGGATGGCTACACCTTC	CASSRGGDGYTF	TRBV6-1	TRBJ1-2
TGTGCCAAGGGTACCAGGGTACGCGGGGAGCTGTTTTTT	CAKGTRVRGELFF	TRBV6-5	TRBJ2-2
TGCGCCAGCAGTGGGGACCCGGGACTAGCGGCCTACAATGAGCAGTTCTTC	CASSGDPGLAAYNEQFF	TRBV10-2	TRBJ2-1
TGTGCCAGCTCCGAAAAGGGGGCCGGATTAATCACCATATATTTT	CASSEKGAGLITIYF	TRBV5-6	TRBJ1-3
TGTGCCAGTAGTATCAACAGGGGGCCCGCTGGGGCCAACGTCCTGACTTTC	CASSINRGPAGANVLTF	TRBV19	TRBJ2-6
TGTGCCAGCTCACCATGGATGGGCGTGATTTTGCTGAGAGGTGTCTATGGCTACACCTTC	CASSPWMGVILLRGVYGYTF	TRBV18	TRBJ1-2
TGTGCCAGCAGTCCTCGGCGACAAGAGACCCAGTACTTC	CASSPRRQETQYF	TRBV2	TRBJ2-5
TGTGCCAGCAGCCCACTAGCGGGAGTGAATAATTCACCCCTCCACTTT	CASSPLAGVNNSPLHF	TRBV14	TRBJ1-6
TGTGCTAGCAGCGGTAGGGAACGTTTCTATAGCAATCAGCCCCAGCATTTT	CASSGRERFYSNQPQHF	TRBV7-7	TRBJ1-5
TGTGCCTGGAGTACGCCCGGGACAGGGGGCGCACGGGAGGGCACAGATACGCAGTATTTT	CAWSTPGTGGAREGTDTQYF	TRBV30	TRBJ2-3
TGTGCCAGTTGGAGGGTCGGAAACACCATATATTTT	CASWRVGNTIYF	TRBV3-1	TRBJ1-3
TGTGCCAGCAGCTTATGGGCGGGACAATCCCCCGGACAGCCCCAGCATTTT	CASSLWAGQSPGQPQHF	TRBV7-3	TRBJ1-5
TGTGCCAGCAGCGCGGAGGATCCCTACGAGCAGTACTTC	CASSAEDPYEQYF	TRBV11-3	TRBJ2-7
TGTGCCAGCAGCCAAATAGGCGGAGGGAATGAAAAACTGTTTTTT	CASSQIGGGNEKLFF	TRBV7-3	TRBJ1-4
TGTGCCAGTAGGGGACTCTCGGCCCTCAGTAGCAATCAGCCCCAGCATTTT	CASRGLSALSSNQPQHF	TRBV19	TRBJ1-5
TGCAGTGCTTTGAGACAGCGCCGCCCCACTGAAGCTTTCTTT	CSALRQRRPTEAFF	TRBV20-1	TRBJ1-1
TGCGCCAGCAGCCAAGACGTGGAGATCTACAATGAGCAGTTCTTC	CASSQDVEIYNEQFF	TRBV4-3	TRBJ2-1
TGCGCCAGCAGCCAGGCCCGGGACACTGAAGCTTTCTTT	CASSQARDTEAFF	TRBV4-3	TRBJ1-1
TGTGCCAGCAGTTTTAGCGCTCTCGATACGCAGTATTTT	CASSFSALDTQYF	TRBV12-3	TRBJ2-3
TGTGCCAGGAGGACCCCGGGGGCGCTCGGGCAGCCCCAGCATTTT	CARRTPGALGQPQHF	TRBV9	TRBJ1-5
TGTGCCACCAGTGCGGACAGGGGGTATGGCTACACCTTC	CATSADRGYGYTF	TRBV24-1	TRBJ1-2
TGTGCCAGCAGCCTAAAGACTAGCGGGAGGGCCCGGATCAATCAGCCCCAGCATTTT	CASSLKTSGRARINQPQHF	TRBV14	TRBJ1-5
TGTGCCAGCAGGGTGGGGGAGAGAAACTCTGGAAACACCATATATTTT	CASRVGERNSGNTIYF	TRBV6-1	TRBJ1-3
TGTGCCAGCAGTCCCGGGCTCAAAGGGCAGCCCCAGCATTTT	CASSPGLKGQPQHF	TRBV6-5	TRBJ1-5
TGTGCCAGCAGCAACTCGGTGGGGGACACAGATACGCAGTATTTT	CASSNSVGDTDTQYF	TRBV7-4	TRBJ2-3
TGCGCCAGCAGCTCCCCCCAGAGATATAGGGGTAATTCACCCCTCCACTTT	CASSSPQRYRGNSPLHF	TRBV5-1	TRBJ1-6
TGCGCCAGCATCAACCCAATAGCGTACGAGCAGTACTTC	CASINPIAYEQYF	TRBV10-1	TRBJ2-7
TGTGCCTCCATCGGGACAGGCGACATGAACACTGAAGCTTTCTTT	CASIGTGDMNTEAFF	TRBV30	TRBJ1-1
TGTGCCAGCTGTCCCTCGGCAATTACCTACGAGCAGTACTTC	CASCPSAITYEQYF	TRBV6-2	TRBJ2-7
TGTGCCAGCAGTGACCCACACTGGGGGATTTTTGGTGGCTACACCTTC	CASSDPHWGIFGGYTF	TRBV6-4	TRBJ1-2
TGTGCTAGTGGTTTGTTGTCTACGAAGACAGCGGTAGAGACCCAGTACTTC	CASGLLSTKTAVETQYF	TRBV12-5	TRBJ2-5
TGTGCCAGTAGTATAGCCCCGGGACACCGGGGCTACGAGCAGTACTTC	CASSIAPGHRGYEQYF	TRBV19	TRBJ2-7
TGCGCCAGCAGCTTAAAGGGGATGAGGACCGAGCAGTACTTC	CASSLKGMRTEQYF	TRBV5-1	TRBJ2-7
TGCAGCGTTGTCGGAGGGTTCTTGACTCCAGGAGAGACCCAGTACTTC	CSVVGGFLTPGETQYF	TRBV29-1	TRBJ2-5
TGTGCCAGCAGCGGGACCTGGGGGAGGGCCTACGAGCAGTACTTC	CASSGTWGRAYEQYF	TRBV9	TRBJ2-7
TGCGCCAGCAGCCGGTCTACCTACGAGCAGTACTTC	CASSRSTYEQYF	TRBV4-1	TRBJ2-7
TGTGCCAGCAGTGACTCGACAGGGGGGGACTACGAGCAGTACTTC	CASSDSTGGDYEQYF	TRBV6-4	TRBJ2-7
TGTGCCAGCAGCTTGGCCCCGCTGTACCTCCGGGGGGCAGGGTTAGTCTACGAGCAGTACTTC	CASSLAPLYLRGAGLVYEQYF	TRBV5-5	TRBJ2-7
TGTGCCAGCAGTGACCGCGGAGTCAATGAGCAGTTCTTC	CASSDRGVNEQFF	TRBV6-4	TRBJ2-1
TGCAGTGCTAGCCAGACTAGCGGCGACAATGAGCAGTTCTTC	CSASQTSGDNEQFF	TRBV20-1	TRBJ2-1
TGTGCCAGCAGCTGCACCGAGTACGAGCAGTACTTC	CASSCTEYEQYF	TRBV7-3	TRBJ2-7
TGTGCCAGCAGTGAGGGAGGAGTAGAGACCCAGTACTTC	CASSEGGVETQYF	TRBV6-1	TRBJ2-5
TGCGCCAGCAGCTTTTTCCCGGACAGGAACTCTGGGGCCAACGTCCTGACTTTC	CASSFFPDRNSGANVLTF	TRBV5-1	TRBJ2-6
TGTGCCAGCAGCACTCGGGCCTATAACAATGAGCAGTTCTTC	CASSTRAYNNEQFF	TRBV13	TRBJ2-1
TGCGCCAGCAGCCGGGAAAGCAATCAGCCCCAGCATTTT	CASSRESNQPQHF	TRBV5-1	TRBJ1-5
TGTGCCAGCAGCGTCTCCTACCCTTCCCGTTCGGTAGAGACCCAGTACTTC	CASSVSYPSRSVETQYF	TRBV9	TRBJ2-5
TGTGCCAGCAGCCATTTTATGGACAGGGCTAGTGGCTACGAGCAGTACTTC	CASSHFMDRASGYEQYF	TRBV3-1	TRBJ2-7
TGTGCCAGCAGTTACTGTCCTCATATGCAGGGAGGCTACACCTTC	CASSYCPHMQGGYTF	TRBV6-5	TRBJ1-2
TGTGCCAGCAGCTCTGAAGAGGGTGTAGGCTACACCTTC	CASSSEEGVGYTF	TRBV7-2	TRBJ1-2
TGCAGTGCGGGTCAGGACCCCGAGCAGTACTTC	CSAGQDPEQYF	TRBV20-1	TRBJ2-7
TGTGCCAGCAGCACGTTTCCAATCTGGCCGGGGCCTCGCTCCTACAATGAGCAGTTCTTC	CASSTFPIWPGPRSYNEQFF	TRBV13	TRBJ2-1
TGTGCCTGGAGTAGCCCCCAGGGGCCAACCTATAATTCACCCCTCCACTTT	CAWSSPQGPTYNSPLHF	TRBV30	TRBJ1-6
TGTGCCAGCAGTGGACTAGCGGCTAAGGGGCAGTTCTTC	CASSGLAAKGQFF	TRBV6-1	TRBJ2-1
TGCGCCAGCAGCTTGGAGTCTCCAGGGGGATGGTGGGCGGGCACAGATACGCAGTATTTT	CASSLESPGGWWAGTDTQYF	TRBV5-1	TRBJ2-3
TGTGCCAGCAGGCGGGCTATCTCAAGCACCGGGGAGCTGTTTTTT	CASRRAISSTGELFF	TRBV6-2	TRBJ2-2
TGTGCCAGCAACTGGGACAGAGCAGGCTCCTACAATGAGCAGTTCTTC	CASNWDRAGSYNEQFF	TRBV28	TRBJ2-1
TGTGCCAGCAGGGGACAGGGGGAGACCCTGGATGGCTACACCTTC	CASRGQGETLDGYTF	TRBV5-6	TRBJ1-2
TGTGCCAGCAGCCACCGGGTTCGTATGAACACTGAAGCTTTCTTT	CASSHRVRMNTEAFF	TRBV14	TRBJ1-1
TGCAGTGCTAGAGATCCCCGGGGCATATATAGCAATCAGCCCCAGCATTTT	CSARDPRGIYSNQPQHF	TRBV20-1	TRBJ1-5
TGTGCCAGCAGTGGGGGCGAGACCCAGTACTTC	CASSGGETQYF	TRBV27	TRBJ2-5
TGCGCCAGCAGCTTGATCCGGGACGAGCGAGGCTACACCTTC	CASSLIRDERGYTF	TRBV5-1	TRBJ1-2
TGTGCCAGCAGTATCGTTCCCGGGACAGCCTGGGGGTATAGCAATCAGCCCCAGCATTTT	CASSIVPGTAWGYSNQPQHF	TRBV6-5	TRBJ1-5
TGTGCCAGCAGTGAACCGCGGGAGGGACCCGCCTACGAGCAGTACTTC	CASSEPREGPAYEQYF	TRBV6-1	TRBJ2-7
TGCGCCAGCAGCTTGCTGCCGGGACAGAGTATACACGAGCAGTACTTC	CASSLLPGQSIHEQYF	TRBV5-1	TRBJ2-7
TGTGCCAGCAGCCAAGAGGGAGTTTCGGTCTACAATGAGCAGTTCTTC	CASSQEGVSVYNEQFF	TRBV14	TRBJ2-1
TGTGCCAGCAGAGGGACCCAAGTCCTGACTTTC	CASRGTQVLTF	TRBV27	TRBJ2-6
TGTGCCAGTAGTAGGACAAAACTGTTTTTT	CASSRTKLFF	TRBV19	TRBJ1-4
TGTGCCAGCAGTCAGGGGCAAGAAAAACTGTTTTTT	CASSQGQEKLFF	TRBV6-4	TRBJ1-4
TGTGCCAGCAGCGGGAGGGGCTCAACTAATGAAAAACTGTTTTTT	CASSGRGSTNEKLFF	TRBV13	TRBJ1-4
TGTGCCAGCAGTGAATCCCCGATCGGGACACAGAGGTTCTACGAGCAGTACTTC	CASSESPIGTQRFYEQYF	TRBV25-1	TRBJ2-7
TGCAGTGCTAGGGTATGTGGACAGGTCCAGTACGAGCAGTACTTC	CSARVCGQVQYEQYF	TRBV20-1	TRBJ2-7
TGTGCTAGTGGTTTGGTACTCCGTATGGGCGGTCAGCCCCAGCATTTT	CASGLVLRMGGQPQHF	TRBV12-5	TRBJ1-5
TGTGCCAGCAGCTTAGCCGGGACTAGGAAGGTTGGTGCGCTCCGGGCGCAAGAGACCCAGTACTTC	CASSLAGTRKVGALRAQETQYF	TRBV7-3	TRBJ2-5
TGTGCCAGCAGCGCGGGACAGGGTTATTCACCCCTCCACTTT	CASSAGQGYSPLHF	TRBV7-3	TRBJ1-6
TGTGCCATCGGGGGGGCCCGTAAACTAGCCAAAAACATTCAGTACTTC	CAIGGARKLAKNIQYF	TRBV10-3	TRBJ2-4
TGTGCCAGCAGAGGGGGGTATTTT	CASRGGYF	TRBV28	TRBJ1-3
TGTGCCATCAGAGTTCGGGGGGTTGACTACGAGCAGTACTTC	CAIRVRGVDYEQYF	TRBV10-3	TRBJ2-7
TGTGCCACCAGTGATTCCCGCTCTGGGGCCAACGTCCTGACTTTC	CATSDSRSGANVLTF	TRBV24-1	TRBJ2-6
TGTGCCAGCAGTAGAAATTATTTAGGGACTAGCACAGATACGCAGTATTTT	CASSRNYLGTSTDTQYF	TRBV6-3	TRBJ2-3
TGTGCCGGAACTAGCGGGGGTGCTAGCACAGATACGCAGTATTTT	CAGTSGGASTDTQYF	TRBV24-1	TRBJ2-3
TGTGCCAGCAGCTTCCCGTGGACAGTGTTTCTCCGGGATACGCAGTATTTT	CASSFPWTVFLRDTQYF	TRBV7-9	TRBJ2-3
TGTGCCAGCAGCCTGGACAGGGGCTACACCTTC	CASSLDRGYTF	TRBV13	TRBJ1-2
TGTGCCAGCAGTTATGTCCCCGGGCCGGGGTACTATGGCTACACCTTC	CASSYVPGPGYYGYTF	TRBV6-2	TRBJ1-2
TGTGCCAGCGACTGGACCTTATTCGGGGGGGGCGTGCAGTATTTT	CASDWTLFGGGVQYF	TRBV27	TRBJ2-3
TGCGCCAGCAGCCAAGATTCGTACAGACTCAACATTCAGTACTTC	CASSQDSYRLNIQYF	TRBV4-1	TRBJ2-4
TGTGCCAGCAGTGGACAGGGTCCCTACGAGCAGTACTTC	CASSGQGPYEQYF	TRBV6-8	TRBJ2-7
TGTGAAAGGGACCGACAGGGAGGTTATCAGCCCCAGCATTTT	CERDRQGGYQPQHF	TRBV11-3	TRBJ1-5
TGTGCCACCCTCGGCGGACCCTCCTACGAGCAGTACTTC	CATLGGPSYEQYF	TRBV15	TRBJ2-7
TGTGCCAGCCACCCGGACATCGAGACCCAGTACTTC	CASHPDIETQYF	TRBV6-4	TRBJ2-5
TGTGCCAGCAGCCAAGGGGGGACAGGGGGGGAGACTAACTATGGCTACACCTTC	CASSQGGTGGETNYGYTF	TRBV4-2	TRBJ1-2
TGTGCCAGCAGCTGGCCGGGACTAGCGGGACGCGGCACAGATACGCAGTATTTT	CASSWPGLAGRGTDTQYF	TRBV7-6	TRBJ2-3
TGTGCCAGCAGTCCCTCAGGGCATGCCCCTGAAGCTTTCTTT	CASSPSGHAPEAFF	TRBV12-3	TRBJ1-1
TGTGCCAGCAGTTTCCCAAATCCGGAGGGACAGGGTATAGGCTACAATGAGCAGTTCTTC	CASSFPNPEGQGIGYNEQFF	TRBV27	TRBJ2-1
TGTGCCAGTCTTAGCACAGATACGCAGTATTTT	CASLSTDTQYF	TRBV6-5	TRBJ2-3
TGTGCCAGCAGCCAAGGGCCGTCGCCGGGACAGGGGACCTACGAGCAGTACTTC	CASSQGPSPGQGTYEQYF	TRBV3-1	TRBJ2-7
TGTGCCAGCAGTACTTATGACAGGGGGACCGATCAGCCCCAGCATTTT	CASSTYDRGTDQPQHF	TRBV6-4	TRBJ1-5
TGCAGTGCTAGAGAACTCTTAGAGGGGTATAGCAATCAGCCCCAGCATTTT	CSARELLEGYSNQPQHF	TRBV20-1	TRBJ1-5
TGCGCCAGCAGCTTACTAGCGGGAGTTCATGAGACCCAGTACTTC	CASSLLAGVHETQYF	TRBV5-1	TRBJ2-5
TGTGCCAGCAGCATCGGGACAGGGTTGGACAATGAGCAGTTCTTC	CASSIGTGLDNEQFF	TRBV13	TRBJ2-1
TGCAGTGCTGCGGGACAAGAGACCCAGTACTTC	CSAAGQETQYF	TRBV20-1	TRBJ2-5
TGCGCCAGCAGCCACCGGGGAGATACGCAGTATTTT	CASSHRGDTQYF	TRBV4-3	TRBJ2-3
TGTGCCAGTACGCGGGAGACCCCTCTATTGGGATCTAGCACAGATACGCAGTATTTT	CASTRETPLLGSSTDTQYF	TRBV19	TRBJ2-3
TGTGCCAGCAGTGTCGCCGGGACTAGCGGCATGGGGCCAGATACGCAGTATTTT	CASSVAGTSGMGPDTQYF	TRBV6-1	TRBJ2-3
TGCGCCAGCAGCCAAATCACAGGGGTTCAGGCGGATAATTCACCCCTCCACTTT	CASSQITGVQADNSPLHF	TRBV4-1	TRBJ1-6
TGTGCCAGCAGCCGCCCCAGGGCGGGACAACGGGGGACTAATGAAAAACTGTTTTTT	CASSRPRAGQRGTNEKLFF	TRBV3-1	TRBJ1-4
TGTGCCCCCGGTGAGGCCTACGAGCAGTACTTC	CAPGEAYEQYF	TRBV6-5	TRBJ2-7
TGCAGCGTTGGAATCAGAGGGAACACTGAAGCTTTCTTT	CSVGIRGNTEAFF	TRBV29-1	TRBJ1-1
TGTGCCAGCAGTTACGGGACCAATTCGGGGGACCTGGAAGAGACCCAGTACTTC	CASSYGTNSGDLEETQYF	TRBV6-6	TRBJ2-5
TGTGCCAGCAGCACCAGCGGTAGACAAGCCAAAAACATTCAGTACTTC	CASSTSGRQAKNIQYF	TRBV7-8	TRBJ2-4
TGTGCCAGCAGTGAAGCGCCCTTGGGGAACAATCAGCCCCAGCATTTT	CASSEAPLGNNQPQHF	TRBV6-1	TRBJ1-5
TGTGCCAGCAGTACAACGGGGGGATGGATGGCCAAAAACATTCAGTACTTC	CASSTTGGWMAKNIQYF	TRBV12-3	TRBJ2-4
TGTGCCAGCAGCTTGGGCGCAGGGGCTGGAAACACCATATATTTT	CASSLGAGAGNTIYF	TRBV5-5	TRBJ1-3
TGTGCCAGCAGCGACAGGGAGTCCTACAATGAGCAGTTCTTC	CASSDRESYNEQFF	TRBV7-3	TRBJ2-1
TGTGCCAGCAGGAACCCGGTAAAGGAAAGCACAGATACGCAGTATTTT	CASRNPVKESTDTQYF	TRBV2	TRBJ2-3
TGTGCCAGCAGTTACGTACAGGGATGGGAACATCAGCCCCAGCATTTT	CASSYVQGWEHQPQHF	TRBV6-5	TRBJ1-5
TGCGCCAGCAGCCGACAGGAAGAGCAGTACTTC	CASSRQEEQYF	TRBV5-1	TRBJ2-7
TGTGCCACTCAGGGGTCCGGATGCTATGGCTACACCTTC	CATQGSGCYGYTF	TRBV24-1	TRBJ1-2
TGTGCCAGCATTTACCGAGTGGGGGGTCAAATGGGGCTCACTCGTGGGGATTCACCCCTCCACTTT	CASIYRVGGQMGLTRGDSPLHF	TRBV5-4	TRBJ1-6
TGTGCCAGCAGCCAAGATATCACAGGGGGTAAAGGATTCCTAGGAAGCTCCTACGAGCAGTACTTC	CASSQDITGGKGFLGSSYEQYF	TRBV4-2	TRBJ2-7
TGTGCCAGCAGCCAAGCCAGACAGGGGGGCCTAAAAGAAAGCACAGATACGCAGTATTTT	CASSQARQGGLKESTDTQYF	TRBV14	TRBJ2-3
TGTGCCAGCAGTTTCAGGTGGATTAATTCACCCCTCCACTTT	CASSFRWINSPLHF	TRBV28	TRBJ1-6
TGTGCCAGCAGCCAAGTTACCCAAATAAACGGCACGTACGAGCAGTACTTC	CASSQVTQINGTYEQYF	TRBV14	TRBJ2-7
TGTGCTAGCAGCTTATTTGTTTACAGGGGCATCCTCCACTTT	CASSLFVYRGILHF	TRBV7-7	TRBJ1-6
TGTGCCAGCAGCATGCCACGAGGGAGCAATGAGCAGTTCTTC	CASSMPRGSNEQFF	TRBV5-6	TRBJ2-1
TGTGCCAGCAGCCAGAGGGCCCCTACTAATGAAAAACTGTTTTTT	CASSQRAPTNEKLFF	TRBV12-4	TRBJ1-4
TGTGCCAGCAGTGACCGCGGGAGTTACGAGCAGTACTTC	CASSDRGSYEQYF	TRBV6-1	TRBJ2-7
TGCGCCAGCAGCCCGACGGGGGGGGGCACAGATACGCAGTATTTT	CASSPTGGGTDTQYF	TRBV4-3	TRBJ2-3
TGTGCCTGGAGTGTACATCTAGCGGGCGTGGATACGCAGTATTTT	CAWSVHLAGVDTQYF	TRBV30	TRBJ2-3
TGCGCCAGCAGCCAATCCAGTGGGACTGGCTACACCTTC	CASSQSSGTGYTF	TRBV4-1	TRBJ1-2
TGTGCCAGCAGCTGCGGGGTCGGACAGTTTAGCTCCTACGAGCAGTACTTC	CASSCGVGQFSSYEQYF	TRBV5-8	TRBJ2-7
TGTGCCAGCAGTAACCCAGGTAACGTGCCGGGGGCTAACAATGAGCAGTTCTTC	CASSNPGNVPGANNEQFF	TRBV25-1	TRBJ2-1
TGTGCCAGCAGCGGGTACGAGCAGTACTTC	CASSGYEQYF	TRBV6-4	TRBJ2-7
TGTGCCAGTAGCCCTACGGAGGGGGGGCCCAAGGGCAATCAGCCCCAGCATTTT	CASSPTEGGPKGNQPQHF	TRBV19	TRBJ1-5
TGTGCCAGTAGTATACCCCCACTAGCGGGAGAACTTGGCTACACCTTC	CASSIPPLAGELGYTF	TRBV19	TRBJ1-2
TGCGCCAGCAGTGAGTCGCCGTTCCGCTTACAGCCAGACCTTGAGACCCAGTACTTC	CASSESPFRLQPDLETQYF	TRBV10-2	TRBJ2-5
TGCAGTGCTAGAGATAGAGCGGCCTCCTACAATGAGCAGTTCTTC	CSARDRAASYNEQFF	TRBV20-1	TRBJ2-1
TGTGCCAGCAGTGTGGAAGGACAGAAAAGGGATACGCAGTATTTT	CASSVEGQKRDTQYF	TRBV6-4	TRBJ2-3
TGTGCCAGCAGTATAGGGGCACCCCACTCCTACGAGCAGTACTTC	CASSIGAPHSYEQYF	TRBV5-6	TRBJ2-7
TGTGCCAGCAGCGGCCCCAGGGTCGGTGTGAATGAAGCTTTCTTT	CASSGPRVGVNEAFF	TRBV13	TRBJ1-1
TGTGCAGGGGGACTAGCGGGAGATGAGCAGTTCTTC	CAGGLAGDEQFF	TRBV30	TRBJ2-1
TGTGCCAGTAGTGTACTGACTAGCGGGGGGTCGGGAGTCGAGCAGTACTTC	CASSVLTSGGSGVEQYF	TRBV19	TRBJ2-7
TGTGCCAGCAGCTCTGATCACCGCCGGGACAGGGGTAACCTCATTCAGTACTTC	CASSSDHRRDRGNLIQYF	TRBV5-5	TRBJ2-4
TGCGCCAGCAGCTTACTCCCGACCTATAATTCACCCCTCCACTTT	CASSLLPTYNSPLHF	TRBV5-1	TRBJ1-6
TGTGCCAGCAGCGATCCCTACATCCTAGATGGCTACACCTTC	CASSDPYILDGYTF	TRBV7-8	TRBJ1-2
TGCCGCCCCAGAACAGGGGTTCCCTACGGAGACAAGGGCTACACCTTC	CRPRTGVPYGDKGYTF	TRBV29-1	TRBJ1-2
TGTGCCAGCAGCCCTAGCGGGGTAGCTGACAATGAGCAGTTCTTC	CASSPSGVADNEQFF	TRBV7-3	TRBJ2-1
TGTGCCAGCAGTGAAGCGCCCCGGACAGCAAGGAATCAGCCCCAGCATTTT	CASSEAPRTARNQPQHF	TRBV6-1	TRBJ1-5
TGCGCCAGCAGCATTTTGGGACATCTGTTTTTT	CASSILGHLFF	TRBV5-1	TRBJ1-4
TGTGCCAGCAGCCAAGCTAGCGGGTTCTACGAGCAGTACTTC	CASSQASGFYEQYF	TRBV14	TRBJ2-7
TGTGCGACCCGTTCCGGTACAGTCACAACTAATGAAAAACTGTTTTTT	CATRSGTVTTNEKLFF	TRBV2	TRBJ1-4
TGTGCCAGCAGTTACTTGAACTGTGAGGGGACGCAGTATTTT	CASSYLNCEGTQYF	TRBV6-5	TRBJ2-3
TGTGCCAGCAGCAAGCCGGGACTACTTAACTATGGCTACACCTTC	CASSKPGLLNYGYTF	TRBV5-6	TRBJ1-2
TGTGCCAGCAGTGACCCATCGTCGGGACATGCTTTCTTT	CASSDPSSGHAFF	TRBV6-4	TRBJ1-1
TGCAGTGCACTGCCGGCAGAGGATGGCTACACCTTC	CSALPAEDGYTF	TRBV20-1	TRBJ1-2
TGTGCCAGCAGTGAAGCTCCGGGGGGAGGGGGAACCTACGAGCAGTACTTC	CASSEAPGGGGTYEQYF	TRBV2	TRBJ2-7
TGTGCCAGCTTTGTAGAACGGGGGCAAGGTAGCAATCAGCCCCAGCATTTT	CASFVERGQGSNQPQHF	TRBV5-6	TRBJ1-5
TGTGCCAGCAGCCCGACTAGCGGGAGTGTTAATGAAAAACTGTTTTTT	CASSPTSGSVNEKLFF	TRBV7-6	TRBJ1-4
TGTGCCAGTAATAGCGTATGGAGAGCCTCCTACGAGCAGTACTTC	CASNSVWRASYEQYF	TRBV19	TRBJ2-7
TGTGCCAGCAGCTTCACCCAGGGTAATTCACCCCTCCACTTT	CASSFTQGNSPLHF	TRBV7-4	TRBJ1-6
TGCGCCAGCAGCTTCCCTCGGAGACAGTCTAGCAATCAGCCCCAGCATTTT	CASSFPRRQSSNQPQHF	TRBV5-1	TRBJ1-5
TGTGCCAGCTTGGCGTTGGGACTAGCGGGGGGGCCCTACGAGCAGTACTTC	CASLALGLAGGPYEQYF	TRBV19	TRBJ2-7
TGCGCCAGAGCGGGCGAGACCCAGTACTTC	CARAGETQYF	TRBV10-1	TRBJ2-5
TGTGCCAGCCGGGGACAGTTCGATGAACTTAACTATGGCTACACCTTC	CASRGQFDELNYGYTF	TRBV6-2	TRBJ1-2
TGTGCCATCAGTGCAACCTCCCCCTCCCCTCTGGACGAGCAGTACTTC	CAISATSPSPLDEQYF	TRBV10-3	TRBJ2-7
TGCAGTGCGGGGAGGGTCGTGAACACTGAAGCTTTCTTT	CSAGRVVNTEAFF	TRBV20-1	TRBJ1-1
TGTGCCAGCAGCAGGCTCGCAGGACAAGATGGGTACTTC	CASSRLAGQDGYF	TRBV7-2	TRBJ2-7
TGTGCCAGCCGCCGGGGCGAGAATCAGCCCCAGCATTTT	CASRRGENQPQHF	TRBV2	TRBJ1-5
TGTGCCAGCAGCCCGAGGACAGCCGATACGCAGTATTTT	CASSPRTADTQYF	TRBV7-2	TRBJ2-3
TGTGCCAGCAGTGGAGCCAGACAGAGTGCGAACACCGGGGAGCTGTTTTTT	CASSGARQSANTGELFF	TRBV2	TRBJ2-2
TGCGCCAGCAGCCACCCTACAGTCCCAGGCCCCTATGGCTACACCTTC	CASSHPTVPGPYGYTF	TRBV4-1	TRBJ1-2
TGCAGCGTTGAAGATCACTACACGAGTTCCTACAATGAGCAGTTCTTC	CSVEDHYTSSYNEQFF	TRBV29-1	TRBJ2-1
TGTGCCAGCAAAAAGGACAGGAGCAATCAGCCCCAGCATTTT	CASKKDRSNQPQHF	TRBV6-1	TRBJ1-5
TGTGCCAGCAGCCTAGTCTACGAGCAGTACTTC	CASSLVYEQYF	TRBV7-2	TRBJ2-7
TGTGCCAGCAGTTACCCGCTACCCTCGACCTACGAGCAGTACTTC	CASSYPLPSTYEQYF	TRBV6-5	TRBJ2-7
TGCGCCAGCAGCAAGGGAGTCTACAATGAGCAGTTCTTC	CASSKGVYNEQFF	TRBV10-1	TRBJ2-1
TGTGCCACCAGTGATTTGCGGGGGGGGACTGCCAAAAACATTCAGTACTTC	CATSDLRGGTAKNIQYF	TRBV24-1	TRBJ2-4
TGTGCCAGCGTTGCTAGCGGGACCAAAGATACGCAGTATTTT	CASVASGTKDTQYF	TRBV7-6	TRBJ2-3
TGCAGTGCAAGACCCCGGCAACAAGAGACCCAGTACTTC	CSARPRQQETQYF	TRBV20-1	TRBJ2-5
TGCAGTGCTAAGAACGGGGGAAGCTCCTACAATGAGCAGTTCTTC	CSAKNGGSSYNEQFF	TRBV20-1	TRBJ2-1
TGCAGACCTGAACAGGGAGGTGCTAGCTCCTACGAGCAGTACTTC	CRPEQGGASSYEQYF	TRBV20-1	TRBJ2-7
TGTGCTAGTGGTTTGGGCTTTCGGACTACCTACGAGCAGTACTTC	CASGLGFRTTYEQYF	TRBV12-5	TRBJ2-7
TGTGCTAGTGGTTTGCGATTATCAACAGTGAGGGGGGGGGCCTCCCAATATCGCACAGATACGCAGTATTTT	CASGLRLSTVRGGASQYRTDTQYF	TRBV12-5	TRBJ2-3
TGTGCCAGCAGTTTAGACAGCAACTATGGCTACACCTTC	CASSLDSNYGYTF	TRBV27	TRBJ1-2
TGTGCCACCAGTGAAACTAGAACCCGTTCGCTCTATGGCTACACCTTC	CATSETRTRSLYGYTF	TRBV24-1	TRBJ1-2
TGTGCCAGCAGTCTAGCGGGGGATACGCAGTATTTT	CASSLAGDTQYF	TRBV6-1	TRBJ2-3
TGTGCCAGCAGCGACCCACAGGGTGAAGAGAATGAGCAGTTCTTC	CASSDPQGEENEQFF	TRBV13	TRBJ2-1
TGTGCCATCAAGTCCGGGTCGGATCCGGTCTCTGGGGCCAACGTCCTGACTTTC	CAIKSGSDPVSGANVLTF	TRBV10-3	TRBJ2-6
TGCAGCGTAGACAGAAAACATGCTTTCTTT	CSVDRKHAFF	TRBV29-1	TRBJ1-1
TGTGCCAGCAGCTTAGCGCTTCTAGGGAAAGAGACCCAGTACTTC	CASSLALLGKETQYF	TRBV7-9	TRBJ2-5
TGTGCCAGCAGCTTGTGGGGGGCAAACAATGAGCAGTTCTTC	CASSLWGANNEQFF	TRBV7-4	TRBJ2-1
TGCGCCAGCAGCCGACAGGGTCCTGAAAAACTGTTTTTT	CASSRQGPEKLFF	TRBV10-1	TRBJ1-4
TGTGCCAGCAGCTGTGGGGGGGGGGATGAGCAGTTCTTC	CASSCGGGDEQFF	TRBV7-3	TRBJ2-1
TGTGCCACCAGTGATTCCCAGCGTCTTGGAAACACCATATATTTT	CATSDSQRLGNTIYF	TRBV24-1	TRBJ1-3
TGTGCCCCAAGACAGGGGCTGAGCTCTGGAAACACCATATATTTT	CAPRQGLSSGNTIYF	TRBV19	TRBJ1-3
TGCGCCAAACCGACAGGGGGCAATCAGCCCCAGCATTTT	CAKPTGGNQPQHF	TRBV10-1	TRBJ1-5
TGTGCCAGCAGCTCGATGGACAGGGGGAAGTCTTATAGCAATCAGCCCCAGCATTTT	CASSSMDRGKSYSNQPQHF	TRBV13	TRBJ1-5
TGCAGTGCTATGGGGGGGCAGAACACCATATATTTT	CSAMGGQNTIYF	TRBV20-1	TRBJ1-3
TGTGCCAGCAGCCATACCAAGGACCAAGAGACCCAGTACTTC	CASSHTKDQETQYF	TRBV13	TRBJ2-5
TGCGCCAGCAGCCCGGAGCGGGAGGCAGATACGCAGTATTTT	CASSPEREADTQYF	TRBV4-1	TRBJ2-3
TGTGCCAGCAGCTTCCTTACAGGGAGTGGCTACACCTTC	CASSFLTGSGYTF	TRBV5-8	TRBJ1-2
TGTGCCAGCAGCCAAGGGACGTTGGAGGGTAATGAAAAACTGTTTTTT	CASSQGTLEGNEKLFF	TRBV14	TRBJ1-4
TGTGCCAGCAGCTTAACTGGGGCCACAGAGCAGGGCTCTGGAAACACCATATATTTT	CASSLTGATEQGSGNTIYF	TRBV7-3	TRBJ1-3
TGCAGTGCTAGAGCGGGGGGGGAGACCCAGTACTTC	CSARAGGETQYF	TRBV20-1	TRBJ2-5
TGTGCCACCAGTCGTATAATGACAGGAGAAGGCTACACCTTC	CATSRIMTGEGYTF	TRBV24-1	TRBJ1-2
TGTGCCACCAGTGACAACAGGGGTGGAAACACCATATATTTT	CATSDNRGGNTIYF	TRBV24-1	TRBJ1-3
TGTGCCAGCAGTTTCCGCCAGGAATCCAGGGGGAGTCAAGAGACCCAGTACTTC	CASSFRQESRGSQETQYF	TRBV12-4	TRBJ2-5
TGTGCCACCAGCAGAGAGGGGCAGTTCTTC	CATSREGQFF	TRBV15	TRBJ2-1
TGTGCCAGCAGCCTCCCCAAAAGCGGGAGTTTACTTGAGCAGTACTTC	CASSLPKSGSLLEQYF	TRBV7-9	TRBJ2-7
TGTGCCAGCAGCTTGAATCCTCCCTCGGGGTTCTTT	CASSLNPPSGFF	TRBV5-5	TRBJ1-1
TGTGCCAGCAGCACAGGGACACGTTTCATGAACACTGAAGCTTTCTTT	CASSTGTRFMNTEAFF	TRBV7-3	TRBJ1-1
TGTGCCAGCAGTTACTCGAGGGGTCATTACGAGCAGTACTTC	CASSYSRGHYEQYF	TRBV6-5	TRBJ2-7
TGTGCCAGCAGCTGCTCATTTGAAGGGGGCTGGGCGGGATCCTACGAGCAGTACTTC	CASSCSFEGGWAGSYEQYF	TRBV7-3	TRBJ2-7
TGTGCCACCAGCAGAGTGAAGGTGGGGGGCTTTGATGAGCAGTTCTTC	CATSRVKVGGFDEQFF	TRBV15	TRBJ2-1
TGTGCCAGCAGGGAGTGTAAAGCACAGGGGGCGACAGAGCAGTACTTC	CASRECKAQGATEQYF	TRBV6-3	TRBJ2-7
TGTGCCAGCAGCCGAGGGGACAGTCCTAACTATGGCTACACCTTC	CASSRGDSPNYGYTF	TRBV14	TRBJ1-2
TGTGCCAGCAGTGAAATTTTTTCAAGGGGGTTCAGCTATAATTCACCCCTCCACTTT	CASSEIFSRGFSYNSPLHF	TRBV6-4	TRBJ1-6
TGTGCCGGTATTCTATGGCTAGGAGTGGTGCATTTT	CAGILWLGVVHF	TRBV6-4	TRBJ1-5
TGTGCCAGCAGCCGCGGGAGTACAAAGGATGGCTACACCTTC	CASSRGSTKDGYTF	TRBV12-4	TRBJ1-2
TGTGCCAGCTCACCTGGGACAGAAGGGAACTATGGCTACACCTTC	CASSPGTEGNYGYTF	TRBV18	TRBJ1-2
TGTGCCAGCAGCCGGCGCCGGGGGGGCCTTATAAGCTACGAGCAGTACTTC	CASSRRRGGLISYEQYF	TRBV11-2	TRBJ2-7
TGTGCCACCAGTGAAGGGATGACTCCGGTCGGGCCGACCATGACCTCTCCTAGCACAGATACGCAGTATTTT	CATSEGMTPVGPTMTSPSTDTQYF	TRBV24-1	TRBJ2-3
TGTGCCAGCAGTTTCCAAAGGACTAGCGGGGAAGGTCCCTACAATGAGCAGTTCTTC	CASSFQRTSGEGPYNEQFF	TRBV7-9	TRBJ2-1
TGTGCCAGCAGCTTCCGCAGGGGGAACTCTGGAAACACCATATATTTT	CASSFRRGNSGNTIYF	TRBV11-3	TRBJ1-3
TGTGCCAGCAGTGTCGTAGGTCCAGCCCCACATAGCCCTCGGGACAGGGGGTTACTTTCCGCGAGCCGGAAAAACATTCAGTACTTC	CASSVVGPAPHSPRDRGLLSASRKNIQYF	TRBV25-1	TRBJ2-4
TGTGCCAGCAGCTTCGAATATGGGGAACGACTGGCTTTCTTT	CASSFEYGERLAFF	TRBV7-3	TRBJ1-1
TGCAGTGCTAGAGCAAAGGTAGGTAGGGGATTGCTGCAGCCCCAGCATTTT	CSARAKVGRGLLQPQHF	TRBV20-1	TRBJ1-5
TGTGCCAGCAGGACAGGGGAGGGGCGCTATCAGCCCCAGCATTTT	CASRTGEGRYQPQHF	TRBV7-3	TRBJ1-5
TGTGCCAGCAGCCCTCCCAAGGAGGGAAGGGTAGCCGGGACAGGGGGTTTGAACACCGGGGAGCTGTTTTTT	CASSPPKEGRVAGTGGLNTGELFF	TRBV14	TRBJ2-2
TGTGCCAGCAGCGATGGGGGGGAGGGGGCCTACGAGCAGTACTTC	CASSDGGEGAYEQYF	TRBV9	TRBJ2-7
TGTGCCAGGTGGGATATAGACGGAGCTTTCTTT	CARWDIDGAFF	TRBV9	TRBJ1-1
TGTGCCAGCAGCTTGGACCCAGGCCACAGGCCCATGAACACTGAAGCTTTCTTT	CASSLDPGHRPMNTEAFF	TRBV5-4	TRBJ1-1
TGTGCCAGCAGCTTACCACTTCGGGCACCTTCCTACGAGCAGTACTTC	CASSLPLRAPSYEQYF	TRBV7-9	TRBJ2-7
TGTGCCAGCAAGCTCGGGGCCGACAATGAGCAGTTCTTC	CASKLGADNEQFF	TRBV6-5	TRBJ2-1
TGTGCCACCAGTGAGGGGGCGTGGGACGACACCTTC	CATSEGAWDDTF	TRBV24-1	TRBJ1-2
TGTGCCAGCAGCCGATCTAGGGCCAAGTACACAGATACGCAGTATTTT	CASSRSRAKYTDTQYF	TRBV13	TRBJ2-3
TGTGCCAGCAGCTTAGGGACCCTCGTTGATAGCCCTATGGAATCAGATACGCAGTATTTT	CASSLGTLVDSPMESDTQYF	TRBV7-2	TRBJ2-3
TGCGCCAGCCGGGACAGGGGAACTAATGAAAAACTGTTTTTT	CASRDRGTNEKLFF	TRBV10-1	TRBJ1-4
TGTGCCAGCTCACCACCCCTCCAGCTCGTCTATGGCTACACCTTC	CASSPPLQLVYGYTF	TRBV18	TRBJ1-2
TGTGCCAGCAGGGAAGGCGTTGACAGGATTCAGCCCCAGCATTTT	CASREGVDRIQPQHF	TRBV12-4	TRBJ1-5
TGTGCCAGCAGCTCTGGACCATACAATGAAAAACTGTTTTTT	CASSSGPYNEKLFF	TRBV7-3	TRBJ1-4
TGTGCCAGCAGCCAAGATCACAACCAGGAGAATTCACCCCTCCACTTT	CASSQDHNQENSPLHF	TRBV4-2	TRBJ1-6
TGTGCCAGCAGTCTGGGGGGCCTGAGGGTCCCTGGCTACACCTTC	CASSLGGLRVPGYTF	TRBV12-4	TRBJ1-2
TGTGCCTCAGATAGACAGGGATATGGCTACACCTTC	CASDRQGYGYTF	TRBV27	TRBJ1-2
TGTGCCACCAGTGACGAAAGTCAGGGATACGAGCAGTACTTC	CATSDESQGYEQYF	TRBV24-1	TRBJ2-7
TGTGCCAGCAGCCTGAGGATTATAGAGACCCAGTACTTC	CASSLRIIETQYF	TRBV7-3	TRBJ2-5
TGTGCCAGTAGTATAGACTTCCCTAACAGGGGCTCGGCCGAGCAGTACTTC	CASSIDFPNRGSAEQYF	TRBV19	TRBJ2-7
TGTGCCAGCTTTGTAAATGAGCAGTTCTTC	CASFVNEQFF	TRBV7-3	TRBJ2-1
TGTGCCAGCAGCGTAGTCAGCGGGAGTAATTCACCCCTCCACTTT	CASSVVSGSNSPLHF	TRBV9	TRBJ1-6
TGTGCCAGCAGTTTACGGAATAGGAACTCCTACGAGCAGTACTTC	CASSLRNRNSYEQYF	TRBV12-3	TRBJ2-7
TGTGCCAGCAGTGACAAGCAGGGGCAGACCTACGAGCAGTACTTC	CASSDKQGQTYEQYF	TRBV6-4	TRBJ2-7
TGTGCCACCAGTGAGTTGCAGAATGAAAAACTGTTTTTT	CATSELQNEKLFF	TRBV24-1	TRBJ1-4
TGTGCCAGCAGTGAACTAGCGGGAGAGGGGATATACGAGCAGTACTTC	CASSELAGEGIYEQYF	TRBV6-6	TRBJ2-7
TGTGCCAGCAGCTACCAGGCCTACGAGCAGTACTTC	CASSYQAYEQYF	TRBV7-3	TRBJ2-7
TGTGCCAGCAGGCGGGACAGGTGGGGAAGCAATCAGCCCCAGCATTTT	CASRRDRWGSNQPQHF	TRBV6-4	TRBJ1-5
TGCGCCAGCAGCTTTCCCTCTATCAGGGGTACCCTAGACTATGGCTACACCTTC	CASSFPSIRGTLDYGYTF	TRBV5-1	TRBJ1-2
TGTGCCAGCAGCGCCAGAGAGGACAGGGGGGGGTCCATTAGCTCCTACAATGAGCAGTTCTTC	CASSAREDRGGSISSYNEQFF	TRBV9	TRBJ2-1
TGTGCCAGCAGCTCCCAGGGCAAAAACATTCAGTACTTC	CASSSQGKNIQYF	TRBV9	TRBJ2-4
TGCAGCGTTGAAGTGACAGGGGACTCTGGAAACACCATATATTTT	CSVEVTGDSGNTIYF	TRBV29-1	TRBJ1-3
TGTGCCAGCAGCTGGGGACAGGGGTTAAATCAGCCCCAGCATTTT	CASSWGQGLNQPQHF	TRBV6-4	TRBJ1-5
TGTGCCAGCAGCTTAGAAAGGACACGGAATGAGCAGTTCTTC	CASSLERTRNEQFF	TRBV7-8	TRBJ2-1
TGTGCCAGCAGCCAAAAGGACCCAGCAACTAATGAAAAACTGTTTTTT	CASSQKDPATNEKLFF	TRBV14	TRBJ1-4
TGTGCCAGCAGAGGGGGGACAGGGGGCCAGAATCAGCCCCAGCATTTT	CASRGGTGGQNQPQHF	TRBV2	TRBJ1-5
TGTGCCAGCAGCTTTTGTGGACTAGCGGGGGGGCGAGATACGCAGTATTTT	CASSFCGLAGGRDTQYF	TRBV13	TRBJ2-3
TGTGCCAGCAGGGACAGGGGGCGAGGCTCCTACGAGCAGTACTTC	CASRDRGRGSYEQYF	TRBV27	TRBJ2-7
TGTGCCAGCAGGAGGGGTGTCAAAAACATTCAGTACTTC	CASRRGVKNIQYF	TRBV13	TRBJ2-4
TGTGCCAGCAGTTTACGATGTAAGGGGGCGCACCCCACCTATGGCTACACCTTC	CASSLRCKGAHPTYGYTF	TRBV27	TRBJ1-2
TGTGCCAGCAGCCGGGGGGGAGGAAGCACAGATACGCAGTATTTT	CASSRGGGSTDTQYF	TRBV13	TRBJ2-3
TGTGCCAGCAGAGGAGCCTTACAGGGTACGGCTGGGGCCAACGTCCTGACTTTC	CASRGALQGTAGANVLTF	TRBV28	TRBJ2-6
TGTGCCAGCAGTGACCAACCCCCCACGACAGGATATGGCTACACCTTC	CASSDQPPTTGYGYTF	TRBV6-1	TRBJ1-2
TGCGCCAGCACGGGACTGGGGAGGAACACTGAAGCTTTCTTT	CASTGLGRNTEAFF	TRBV10-1	TRBJ1-1
TGTGCCAGCAGCTTAGTAGTAGCGGGCAATGAGCAGTTCTTC	CASSLVVAGNEQFF	TRBV11-3	TRBJ2-1
TGTGCCAGCAGGACAGAGAAACGACAGCCCCAGCATTTT	CASRTEKRQPQHF	TRBV7-3	TRBJ1-5
TGTGCCAGCAGCCGAGAAAGGTACACAGAGACCCAGTACTTC	CASSRERYTETQYF	TRBV7-3	TRBJ2-5
TGTGGATGTGACCAGGGGTGGGACTACAATGAGCAGTTCTTC	CGCDQGWDYNEQFF	TRBV12-3	TRBJ2-1
TGTGCCAGCAGCCCGGCGGGAGGGGATGAAGCTTTCTTT	CASSPAGGDEAFF	TRBV9	TRBJ1-1
TGTGCCAGCAGCCAAGACCAGGGTTTAGAATACTATGGCTACACCTTC	CASSQDQGLEYYGYTF	TRBV14	TRBJ1-2
TGTGCCAGCAGCAAACGGGGATTGGCCAATGAGCAGTTCTTC	CASSKRGLANEQFF	TRBV9	TRBJ2-1
TGTGCCAGCAGTGAAGATTTACTCGCGGCCAGGAAAATTGAAAAACTGTTTTTT	CASSEDLLAARKIEKLFF	TRBV6-1	TRBJ1-4
TGTGCCAAAGGATCAGAAACATATGGCTACACCTTC	CAKGSETYGYTF	TRBV6-6	TRBJ1-2
TGTGCCAGTAGTATAAACCAGTCGCCCCAGCATTTT	CASSINQSPQHF	TRBV19	TRBJ1-5
TGTGCCAGCAAGATTGGCCCCGGGGGCGGGGAGCTGTTTTTT	CASKIGPGGGELFF	TRBV25-1	TRBJ2-2
TGTGCCTGGAGACTTGACAGGGTAGGCCGCGTTAAGAACACTGAAGCTTTCTTT	CAWRLDRVGRVKNTEAFF	TRBV30	TRBJ1-1
TGTGCCAGCATTGGGGGGCCAGGAGCGAACACCGGGGAGCTGTTTTTT	CASIGGPGANTGELFF	TRBV14	TRBJ2-2
TGTGCCAGCAGTTACTGGGACAGCTATAATTCACCCCTCCACTTT	CASSYWDSYNSPLHF	TRBV6-2	TRBJ1-6
TGTGCCAGCAGCCAACAAGGGACAGGGGAAATAGTCGGCACAGATACGCAGTATTTT	CASSQQGTGEIVGTDTQYF	TRBV11-3	TRBJ2-3
TGCGCCAGCAGACTACAAACGACAGAGCCCAACGTCCTGACTTTC	CASRLQTTEPNVLTF	TRBV4-3	TRBJ2-6
TGTGCCAGCAGTTATCCCCCAGTATGTTATGGCTACACCTTC	CASSYPPVCYGYTF	TRBV6-5	TRBJ1-2
TGTGCCAGCAGCTCCGGGACAGGGCCACCGAACACCGGGGAGCTGTTTTTT	CASSSGTGPPNTGELFF	TRBV5-6	TRBJ2-2
TGCGCCAGCAGCTTGGGGAAGGCGACCTACGAGCAGTACTTC	CASSLGKATYEQYF	TRBV5-1	TRBJ2-7
TGTGCCAGCAGTGAACAAAGGGGAAGTGCTTTCTTT	CASSEQRGSAFF	TRBV6-1	TRBJ1-1
TGCGCCAGCAGCAAGGGACTAGCGGGATTCATCTACGCGATGGATGAGCAGTTCTTC	CASSKGLAGFIYAMDEQFF	TRBV5-1	TRBJ2-1
TGTGCCACCAGCAGACACCCCAAAACAGGGGCCCAGCCGTACGAGCAGTACTTC	CATSRHPKTGAQPYEQYF	TRBV15	TRBJ2-7
TGTGCCAGCAGTTTAGGGGACAGGTGTAAAAGGGGCCAAGAGACCCAGTACTTC	CASSLGDRCKRGQETQYF	TRBV6-4	TRBJ2-5
TGTGCCAGCAGGACTAGCGGCGGGGAGCTGTTTTTT	CASRTSGGELFF	TRBV6-5	TRBJ2-2
TGTGCCATAAGTCCCACTCCCCTGCATTCCTACGAGCAGTACTTC	CAISPTPLHSYEQYF	TRBV6-2	TRBJ2-7
TGCGCCAGCAGAATAGGTCTGACTTTCACCATATATTTT	CASRIGLTFTIYF	TRBV4-1	TRBJ1-3
TGTGCCAGCAGTGCCCTAACACAGAACACCGGGGAGCTGTTTTTT	CASSALTQNTGELFF	TRBV6-4	TRBJ2-2
TGTGCCAGCAGCTTGTATTTCGTAAGCACCGGGGAGCTGTTTTTT	CASSLYFVSTGELFF	TRBV5-6	TRBJ2-2
TGTGCCAGCAGTTTAAAGAGCCCCGGACAGCGGCTCTACAATGAGCAGTTCTTC	CASSLKSPGQRLYNEQFF	TRBV27	TRBJ2-1
TGTGCCAGCAGCTTCGGTCCGGGACTAGCGGGGGGTTCCTACGAGCAGTACTTC	CASSFGPGLAGGSYEQYF	TRBV7-2	TRBJ2-7
TGTGCCAGCACCTTGACAGGGGGCGCGGGCCTTAGCAATCAGCCCCAGCATTTT	CASTLTGGAGLSNQPQHF	TRBV11-2	TRBJ1-5
TGTGCCAGCAGCGCCCATAGACCGCCGGGACTGAAATCACCCCTCCACTTT	CASSAHRPPGLKSPLHF	TRBV9	TRBJ1-6
TGCGCCAGCAGCCAGACTAGCGGCATCCAAGAGACCCAGTACTTC	CASSQTSGIQETQYF	TRBV4-3	TRBJ2-5
TGTGCCAGCACCCTCGGGAGACAGGGTAACTCCTACAATGAGCAGTTCTTC	CASTLGRQGNSYNEQFF	TRBV3-1	TRBJ2-1
TGTGCGACAGGGTGTCGGGAGACCCAGTACTTC	CATGCRETQYF	TRBV6-4	TRBJ2-5
TGTGCCAGCAGCTTCGGACAGGTTGAGCAGTACTTC	CASSFGQVEQYF	TRBV9	TRBJ2-7
TGTGCCAGCAGCTACTCAAGCAACACTGAAGCTTTCTTT	CASSYSSNTEAFF	TRBV7-3	TRBJ1-1
TGTGCCAGCAGCGTTGACAGGCGACCTCAAGAGACCCAGTACTTC	CASSVDRRPQETQYF	TRBV7-3	TRBJ2-5
TGTGCCAGCAGAGATATCGCGAGGGACTTGCCAGTCAATCAGCCCCAGCATTTT	CASRDIARDLPVNQPQHF	TRBV28	TRBJ1-5
TGCGCCAGCAGTGAGTCGGGACCCCCCTCTGGGGCCAACGTCCTGACTTTC	CASSESGPPSGANVLTF	TRBV10-2	TRBJ2-6
TGCGCCAGCAGGGACAGGAGTGGACAAGAGACCCAGTACTTC	CASRDRSGQETQYF	TRBV10-1	TRBJ2-5
TGCAGTGCTAGAGCAGACTTGGGGACTCCCAACTATGGCTACACCTTC	CSARADLGTPNYGYTF	TRBV20-1	TRBJ1-2
TGCGCCAGCAGCCGGCAGGGGGGGTACGAGCAGTACTTC	CASSRQGGYEQYF	TRBV4-1	TRBJ2-7
TGTGCCAGCAGCTTCAACCCAGCCCAAACGCAGCCCCAGCATTTT	CASSFNPAQTQPQHF	TRBV5-6	TRBJ1-5
TGTGCCAGCAGTTTCCCGAAGAGGAAGGGCCAGTATTCCGCGGGTCGCTCCTACGAGCAGTACTTC	CASSFPKRKGQYSAGRSYEQYF	TRBV27	TRBJ2-7
TGTGCCAGCAGAAATAGTAATAATGGAAACACCATATATTTT	CASRNSNNGNTIYF	TRBV6-4	TRBJ1-3
TGCAGTGCGGAGCGGCATAGCTACGAGCAGTACTTC	CSAERHSYEQYF	TRBV20-1	TRBJ2-7
TGTGCCAGCAGTTTAAGGATAGGGACAAACACCGGGGAGCTGTTTTTT	CASSLRIGTNTGELFF	TRBV28	TRBJ2-2
TGTGCCAGCAGTTTATGGTGGGACAATGGGACTGAAGCTTTCTTT	CASSLWWDNGTEAFF	TRBV27	TRBJ1-1
TGTGCCACCAGTGTAACACAGGGAGTAGAGACCCAGTACTTC	CATSVTQGVETQYF	TRBV24-1	TRBJ2-5
TGTGCCAGCAGTAGGACAGTCAGGCCCCACTATGGCTACACCTTC	CASSRTVRPHYGYTF	TRBV6-3	TRBJ1-2
TGTGCCACGACAGGGGGCAGGAAGGCCTATAAAACGCTCTACTTCGAGCAGTACTTC	CATTGGRKAYKTLYFEQYF	TRBV24-1	TRBJ2-7
TGCAGTGCTAGAGAACGGACAGAGATGAACACTGAAGCTTTCTTT	CSARERTEMNTEAFF	TRBV20-1	TRBJ1-1
TGTGCCAGCAGCTTAGCCAGGGGGCCCCCTAAATACGAGCAGTACTTC	CASSLARGPPKYEQYF	TRBV13	TRBJ2-7
TGTGCCAGCAGCAGAACCGAAGCAGGGCTAGGGACCTACGAGCAGTACTTC	CASSRTEAGLGTYEQYF	TRBV5-4	TRBJ2-7
TGTGCCAGCAGCCCGGAGGGCGCGAGCAATCAGCCCCAGCATTTT	CASSPEGASNQPQHF	TRBV13	TRBJ1-5
TGTGCCAGCAGCTTAGTGCCTCACGAAGAGACCCAGTACTTC	CASSLVPHEETQYF	TRBV7-2	TRBJ2-5
TGCGCCAGCAGTGAGTCCCCCTCATCCCTAGCGGGATACAATGAGCAGTTCTTC	CASSESPSSLAGYNEQFF	TRBV10-2	TRBJ2-1
TGTGCCAGCACACAGAGGGGGCTTGCTTTCTTT	CASTQRGLAFF	TRBV14	TRBJ1-1
TGTGCCATCAGCATCCGGGGGCGGGAGGAGCAGTTCTTC	CAISIRGREEQFF	TRBV10-3	TRBJ2-1
TGTGCCAGCAGTTACCTCGTTGCAGATCGATTCGAGCAGTACTTC	CASSYLVADRFEQYF	TRBV6-2	TRBJ2-7
TGTGCCACCAGCCCTGAGTCAATGGCCGCGCAGGGAGCTTCTGAGCAGTACTTC	CATSPESMAAQGASEQYF	TRBV15	TRBJ2-7
TGTGCCACCAGAAATATGGACGAGCAGTACTTC	CATRNMDEQYF	TRBV24-1	TRBJ2-7
TGTGCCAGCAGCTTGGAAAACCGGGACGAATGCAATCAGCCCCAGCATTTT	CASSLENRDECNQPQHF	TRBV7-6	TRBJ1-5
TGTGCCAGCTCACCGTGGCGGGACGAAGATAATGAAAAACTGTTTTTT	CASSPWRDEDNEKLFF	TRBV18	TRBJ1-4
TGTGCCAGCAGCTTAACCAAGCAGGAGGACTATGGCTACACCTTC	CASSLTKQEDYGYTF	TRBV7-3	TRBJ1-2
TGCGCCAGCATTACAGGGGGCGGGAACACTGAAGCTTTCTTT	CASITGGGNTEAFF	TRBV10-1	TRBJ1-1
TGTGCCAGCCGTCTCTGTGATCCCGCGCCGGGGACTAGCGGGGAGTTCTCTTACGAGCAGTACTTC	CASRLCDPAPGTSGEFSYEQYF	TRBV6-3	TRBJ2-7
TGCAGTGCTAGAGTAACCCGGGTATCACCCCTCCACTTT	CSARVTRVSPLHF	TRBV20-1	TRBJ1-6
TGCAGTGCTGGGGAGCAGTACTTC	CSAGEQYF	TRBV20-1	TRBJ2-7
TGTGCCAGCAGCCACGCTCTAGTATACGAGCAGTACTTC	CASSHALVYEQYF	TRBV3-1	TRBJ2-7
TGTGCCAGCAGCTTAATACCTAGGGAGGGCTTCTACGAGCAGTACTTC	CASSLIPREGFYEQYF	TRBV7-2	TRBJ2-7
TGTGCCAGCGGAGGGGGGAGAAACACCATATATTTT	CASGGGRNTIYF	TRBV27	TRBJ1-3
TGTGCCAGCAGGCGATCGACTAGTACCCCAGAAAAGGTAAGGCCCTACGAGCAGTACTTC	CASRRSTSTPEKVRPYEQYF	TRBV27	TRBJ2-7
TGTGCCAGCAGGTGTGGACAGGGTATAAATGAAAGCAATCAGCCCCAGCATTTT	CASRCGQGINESNQPQHF	TRBV5-4	TRBJ1-5
TGTGCCACCAGTGTAGACTCCAGGGGGGCGGGGGAGGAAGAGCGATGGGAGACCCAGTACTTC	CATSVDSRGAGEEERWETQYF	TRBV24-1	TRBJ2-5
TGTGCCAGCAGGCTACGTCCGGGACATAGAGCCCTCCACTTT	CASRLRPGHRALHF	TRBV6-3	TRBJ1-6
TGCGCCAGCATTCCGGTTTGGGCAGGGGCCGAGACCCAGTACTTC	CASIPVWAGAETQYF	TRBV10-1	TRBJ2-5
TGTGCCAGCAGCAGGGTTGGGGCAAGACCCTCCTACGAGCAGTACTTC	CASSRVGARPSYEQYF	TRBV11-2	TRBJ2-7
TGTGCCAGCAGCATAGGACTAGCGGCGGACTTC	CASSIGLAADF	TRBV5-4	TRBJ2-7
TGCAGTGCTAGCTCTGGAGATGAGCAGTTCTTC	CSASSGDEQFF	TRBV20-1	TRBJ2-1
TGTGCCACCAGCAGAGGGCCCGACAGCCCAGGGGAGGGGAAAGATACGCAGTATTTT	CATSRGPDSPGEGKDTQYF	TRBV15	TRBJ2-3
TGTGCCAGCAGCTTAGGTTCCAGGGCTAGCACAGATACGCAGTATTTT	CASSLGSRASTDTQYF	TRBV7-6	TRBJ2-3
TGTGCCAGCAGCTCTGCCCCTAGCGGGAGGGCCAATGAGCAGTTCTTC	CASSSAPSGRANEQFF	TRBV7-9	TRBJ2-1
TGCGCCAGCAGCTTGGGTGGGGGGGGGAGGACCTACGAGCAGTACTTC	CASSLGGGGRTYEQYF	TRBV5-1	TRBJ2-7
TGTGCCAGCAGCTTAGTAGGACAGGGGGCGGCAACTAATGAAAAACTGTTTTTT	CASSLVGQGAATNEKLFF	TRBV11-3	TRBJ1-4
TGTGCCAGCACGACAGGGCTCCGGTATTTT	CASTTGLRYF	TRBV4-2	TRBJ1-3
TGTGCCAGCAATTGGGGTGACAGGGGGCCCGTTTACGAGCAGTACTTC	CASNWGDRGPVYEQYF	TRBV3-1	TRBJ2-7
TGTGCCAGCAGTTACTCTGCGGGACTTGAAACGGAATACACCGGGGAGCTGTTTTTT	CASSYSAGLETEYTGELFF	TRBV6-5	TRBJ2-2
TGTGCCAGCAGCCGACTAGCGACGGACAATGAGCAGTTCTTC	CASSRLATDNEQFF	TRBV3-1	TRBJ2-1
TGTGCCAGCAGGGACAGACCTAGCACAGATACGCAGTATTTT	CASRDRPSTDTQYF	TRBV25-1	TRBJ2-3
TGTGCCCCCGGGGGACAATCTGGGAATCAGCCCCAGCATTTT	CAPGGQSGNQPQHF	TRBV12-3	TRBJ1-5
TGTGCCAGCAACTGCGTCGGGAGGGGATTCTATAATTCACCCCTCCACTTT	CASNCVGRGFYNSPLHF	TRBV7-2	TRBJ1-6
TGCAGTGCTAATTCCCTCCGTGGGCGACAGGGGAAGGATCAGCCCCAGCATTTT	CSANSLRGRQGKDQPQHF	TRBV20-1	TRBJ1-5
TGCAGTGCGGGACAGAGCCGCTCTGGGGCCAACGTCCTGACTTTC	CSAGQSRSGANVLTF	TRBV20-1	TRBJ2-6
TGTGCCAGCAGCTGGGGGGCGGGGGGGAATAGCTCCTATAATTCACCCCTCCACTTT	CASSWGAGGNSSYNSPLHF	TRBV5-6	TRBJ1-6
TGCAGTGCTAGACTGGTTTCCCGAGGCCCCTACGAGCAGTACTTC	CSARLVSRGPYEQYF	TRBV20-1	TRBJ2-7
TGTGCCAGCAGCGTTCGCCCCAGGGGGCGGGTTGACAATTCACCCCTCCACTTT	CASSVRPRGRVDNSPLHF	TRBV7-4	TRBJ1-6
TGTGCCACCAAAAAGGGGAATAGGAGGTATGGCTACACCTTC	CATKKGNRRYGYTF	TRBV24-1	TRBJ1-2
TGTGCCAGCAGCACACCTTCTAACTATGGCTACACCTTC	CASSTPSNYGYTF	TRBV5-6	TRBJ1-2
TGCAGTGCTAGAGTGGGACCCCGGAACAACTCGTACGAGCAGTACTTC	CSARVGPRNNSYEQYF	TRBV20-1	TRBJ2-7
TGCGCCAGCAGCGGAGGGGGACTAGCGGGGATCTTC	CASSGGGLAGIF	TRBV5-1	TRBJ2-1
TGCGCCAGCAGTGAATCCGACAGGGAGTTGTACGAGCAGTACTTC	CASSESDRELYEQYF	TRBV10-1	TRBJ2-7
TGTGCCAGCAGTAGCCACTTGGGCGGCTCTGGGGCCAACGTCCTGACTTTC	CASSSHLGGSGANVLTF	TRBV6-4	TRBJ2-6
TGTGCCAGCAGCCATGACCTGAGTAACTATGGCTACACCTTC	CASSHDLSNYGYTF	TRBV3-1	TRBJ1-2
TGTGCCAGCAGCCAACCTCGACAGGGTAATTCACCCCTCCACTTT	CASSQPRQGNSPLHF	TRBV14	TRBJ1-6
TGTGCCAGTAGTATCGGCCCGAGGGCGTACGAGCAGTACTTC	CASSIGPRAYEQYF	TRBV19	TRBJ2-7
TGTGCCAGCAGCGCTTTACGGGACAGCCCAGAGACCCAGTACTTC	CASSALRDSPETQYF	TRBV9	TRBJ2-5
TGCAGTGCCTATCATTACGAGCAGTACTTC	CSAYHYEQYF	TRBV20-1	TRBJ2-7
TGTGCCTGGAGTGTACGCCTCCTCAGCCCGGAGGGGTACAATCAGCCCCAGCATTTT	CAWSVRLLSPEGYNQPQHF	TRBV30	TRBJ1-5
TGTGCCAGCAGCGGCCCCTCGGGGCTAAGTTCCTACGAGCAGTACTTC	CASSGPSGLSSYEQYF	TRBV9	TRBJ2-7
TGTGCCAGCAGCTCCGGGACGAGCAGGTGGGGGAGGGACTATGGCTACACCTTC	CASSSGTSRWGRDYGYTF	TRBV7-9	TRBJ1-2
TGTGCCAGCAGTTACTCGATCCCCGACACTCAGGGGGGACTAAATCAGCCCCAGCATTTT	CASSYSIPDTQGGLNQPQHF	TRBV6-6	TRBJ1-5
TGTGCCAGCAGCTCGGTCAGGGTCTCCTACGAGCAGTACTTC	CASSSVRVSYEQYF	TRBV7-3	TRBJ2-7
TGTGCCAGCAGCTGGCGCCAACGAGGCGGTGGAAACACCATATATTTT	CASSWRQRGGGNTIYF	TRBV5-4	TRBJ1-3
TGCGCCAGCAGCCCCCGATCCTTAGGGGTTTTAGCAACTAATGAAAAACTGTTTTTT	CASSPRSLGVLATNEKLFF	TRBV4-1	TRBJ1-4
TGTGCCAGCAGTTTAAGGGGCCCCGGGGCTGGCGGGGAGCTGTTTTTT	CASSLRGPGAGGELFF	TRBV28	TRBJ2-2
TGTGCCAGCAGCGCCAGGGCTGAAGCTTTCTTT	CASSARAEAFF	TRBV13	TRBJ1-1
TGTGCCAGCAGCGTAGGTATGCTAGCGGGGCCGGGCACAGATACGCAGTATTTT	CASSVGMLAGPGTDTQYF	TRBV9	TRBJ2-3
TGTGCCAGCAGCCAAGCATCCAGCCCAGGACAGGGGGGGAGATACGAGCAGTACTTC	CASSQASSPGQGGRYEQYF	TRBV14	TRBJ2-7
TGCGCCAGCCCGAGTCTTGGACTAAGCAATCAGCCCCAGCATTTT	CASPSLGLSNQPQHF	TRBV5-1	TRBJ1-5
TGTGCCAGCAGCGAAAATCTCTGCGGACCCGAACCAGCCAAAAACATTCAGTACTTC	CASSENLCGPEPAKNIQYF	TRBV13	TRBJ2-4
TGTGCCAGCAGCAACACGATATCGGGACAGGAGACCCAGTACTTC	CASSNTISGQETQYF	TRBV6-1	TRBJ2-5
TGTGCCAGCAGTGGTGCTGCACAGGGCTACGAGCAGTACTTC	CASSGAAQGYEQYF	TRBV12-4	TRBJ2-7
TGTGCCAGCAGCTTGGTGAACGGGGAGGGCGAAAAACTGTTTTTT	CASSLVNGEGEKLFF	TRBV5-4	TRBJ1-4
TGTGCCAGCAGCTTAGCCGGGCTTGGTTACACTGAAGCTTTCTTT	CASSLAGLGYTEAFF	TRBV7-6	TRBJ1-1
TGTGCCAGCAGTTACGTGGTCACGTGGGACGAGCAGTACTTC	CASSYVVTWDEQYF	TRBV6-6	TRBJ2-7
TGCGCCAGCAGCCAAGACTGGGGCCTTCCCTCCTACGAGCAGTACTTC	CASSQDWGLPSYEQYF	TRBV4-3	TRBJ2-7
TGTGCCAGCACGGGAGCGGTAGGGGCTAACTATGGCTACACCTTC	CASTGAVGANYGYTF	TRBV6-1	TRBJ1-2
TGTGCCAGCAGCTGTTCGGACAGGGCCAATCAGCCCCAGCATTTT	CASSCSDRANQPQHF	TRBV11-3	TRBJ1-5
TGCAGTGCGGCCACAGGGGTGGAAGCTTTCTTT	CSAATGVEAFF	TRBV20-1	TRBJ1-1
TGTGCCAGCAAACGACCCTACGAGCAGTACTTC	CASKRPYEQYF	TRBV12-3	TRBJ2-7
TGTGCCACCAGCCAAGGTTATCAGGTAAAAAATCAAGAGACCCAGTACTTC	CATSQGYQVKNQETQYF	TRBV24-1	TRBJ2-5
TGTGCCAGCAGCTTAGGAAAACGGGACATCTCTACCGCTGGAAACACCATATATTTT	CASSLGKRDISTAGNTIYF	TRBV11-2	TRBJ1-3
TGTGCCAGCAGTTACACCTTGGGAGGTTATAACGATACGCAGTATTTT	CASSYTLGGYNDTQYF	TRBV6-6	TRBJ2-3
TGCAGTGCTAGAGATCTGGAGACAGGGACAGATACGCAGTATTTT	CSARDLETGTDTQYF	TRBV20-1	TRBJ2-3
TGTGCCAGCAGTGGTCTGAAATTCCGAGTTCCGAATCAGCCCCAGCATTTT	CASSGLKFRVPNQPQHF	TRBV2	TRBJ1-5
TGTGCCAGCAGCCCCCCCCTCTCAGGGAGCTCCTACGAGCAGTACTTC	CASSPPLSGSSYEQYF	TRBV9	TRBJ2-7
TGTGCCAGCAGTGGGGTGACTTCCTATGGCTACACCTTC	CASSGVTSYGYTF	TRBV6-4	TRBJ1-2
TGTGCCAGCGAGGGGGTTGGCCCCCCGAACACTGAAGCTTTCTTT	CASEGVGPPNTEAFF	TRBV7-3	TRBJ1-1
TGTGCCAGCAGATACAGGGACACCACTGAAGCTTTCTTT	CASRYRDTTEAFF	TRBV27	TRBJ1-1
TGTGCCAGCAGGTACCTAGCGGGTTTGAGCTCCTACAATGAGCAGTTCTTC	CASRYLAGLSSYNEQFF	TRBV11-3	TRBJ2-1
TGTGCCAGCAGCCCCGGGGCCAAGGCCCCCTACGAGCAGTACTTC	CASSPGAKAPYEQYF	TRBV11-2	TRBJ2-7
TGTGCCAGCAGCTTAGTCTCCCGAGTTACCAACCCAGGGGGCCACGGGGATCAGCCCCAGCATTTT	CASSLVSRVTNPGGHGDQPQHF	TRBV11-3	TRBJ1-5
TGCGCCAGCAGCCAAGACTGTAGCGACAATGAGCAGTTCTTC	CASSQDCSDNEQFF	TRBV4-1	TRBJ2-1
TGTGCCATTCTACAGAACACTGAAGCTTTCTTT	CAILQNTEAFF	TRBV10-3	TRBJ1-1
TGTGCCAGCAGGACAGGGGGCGAATCCTACGAGCAGTACTTC	CASRTGGESYEQYF	TRBV27	TRBJ2-7
TGTGCCAGCAGCCAATCGCTGACGGAGGGCTACAATGAGCAGTTCTTC	CASSQSLTEGYNEQFF	TRBV16	TRBJ2-1
TGTGCCAGCAGAACACCAAACGGTCATCAGCCCCAGCATTTT	CASRTPNGHQPQHF	TRBV6-1	TRBJ1-5
TGTGCCAGCAGCGTAAGTTGGGACAGGGTGAAAGAGACCCAGTACTTC	CASSVSWDRVKETQYF	TRBV9	TRBJ2-5
TGTGCCAGCAGCGAGGGGAATCAGCCCCAGCATTTT	CASSEGNQPQHF	TRBV5-4	TRBJ1-5
TGTGCCAGCGTAAAGGACTCTGAGCAGTTCTTC	CASVKDSEQFF	TRBV12-3	TRBJ2-1
TGTGCCAGCAGTCCCCACAGGGTGGGCACAGATACGCAGTATTTT	CASSPHRVGTDTQYF	TRBV6-1	TRBJ2-3
TGCGCCAGCAAAAGGTCTGAAGCTTTCTTT	CASKRSEAFF	TRBV4-1	TRBJ1-1
TGTGCCAGCAGCCCCCCTGGCAGGCAAGAAAAACTGTTTTTT	CASSPPGRQEKLFF	TRBV7-8	TRBJ1-4
TGCGCCAGCAGCGGGGATGGGGATTCACCCCTCCACTTT	CASSGDGDSPLHF	TRBV4-3	TRBJ1-6
TGTGCCAGTACGCGGGAGCGCTCCTACGAGCAGTACTTC	CASTRERSYEQYF	TRBV6-4	TRBJ2-7
TGCGCCAGCAGTGGCCAGGAGGGGGGCTATGGCTACACCTTC	CASSGQEGGYGYTF	TRBV10-1	TRBJ1-2
TGTGCCAGCTGGGGGGGGACCTACGAGCAGTACTTC	CASWGGTYEQYF	TRBV6-5	TRBJ2-7
TGCGCCAGCCAACGTGGCTCCGGGGAGCTGTTTTTT	CASQRGSGELFF	TRBV10-1	TRBJ2-2
TGTGCCAGCAGCTTGGGGTGGGGGGGCACAGATACGCAGTATTTT	CASSLGWGGTDTQYF	TRBV5-5	TRBJ2-3
TGTGCCAGCAATAGAAATAGCTCCTACGAGCAGTACTTC	CASNRNSSYEQYF	TRBV27	TRBJ2-7
TGTGCCAGCAGCGGGGGGATTGACGAGCAGTACTTC	CASSGGIDEQYF	TRBV6-3	TRBJ2-7
TGTGCCAGGAGGTTCCGGGACAGGGGCCTAATTCCCTATGGCTACACCTTC	CARRFRDRGLIPYGYTF	TRBV10-3	TRBJ1-2
TGTGCCAGCAGTTTCACAGGGGGGGTCATGAACACTGAAGCTTTCTTT	CASSFTGGVMNTEAFF	TRBV27	TRBJ1-1
TGCGCCAGCATGACGACAGGGGTTTTATTTGGCTACACCTTC	CASMTTGVLFGYTF	TRBV4-3	TRBJ1-2
TGTGCCAGCAGCCGAAGATGGGGCGAGGACAGTGGGGCTAACTATGGCTACACCTTC	CASSRRWGEDSGANYGYTF	TRBV3-1	TRBJ1-2
TGCGCCAGCAGCCAGATCCCCTCAGTGAACAATCAGCCCCAGCATTTT	CASSQIPSVNNQPQHF	TRBV4-1	TRBJ1-5
TGTGCCAGCAGCTTAGATCCAACCGTCGGACGAGAAAAACTGTTTTTT	CASSLDPTVGREKLFF	TRBV11-3	TRBJ1-4
TGTGCCAGCAGCCGGCTGCAACTAGCGGGAGAGCCGAAAAGAACAGATACGCAGTATTTT	CASSRLQLAGEPKRTDTQYF	TRBV7-9	TRBJ2-3
TGTGCCAGCAGCTTAGATGGGAGGACCGGGGAGCTGTTTTTT	CASSLDGRTGELFF	TRBV7-9	TRBJ2-2
TGTGCCAGCAGCCCTCACAGGGAAACGGCCCTTTACTACGAGCAGTACTTC	CASSPHRETALYYEQYF	TRBV4-2	TRBJ2-7
TGTGCCAACTTCGTCAATGAGCAGTTCTTC	CANFVNEQFF	TRBV6-5	TRBJ2-1
TGTGCTAGCAGCTGTGTCATCACTAGGCTACCGCGGAACACCGGGGAGCTGTTTTTT	CASSCVITRLPRNTGELFF	TRBV7-7	TRBJ2-2
TGTGCCAGCAGCATAGGGGACAACGGTTCACCCCTCCACTTT	CASSIGDNGSPLHF	TRBV13	TRBJ1-6
TGTGCCAGCATTGGAGGGCATGGCTACACCTTC	CASIGGHGYTF	TRBV9	TRBJ1-2
TGTGCCAGCAGTTACGGCCGGGACAGGGGGTCAGACACTGAAGCTTTCTTT	CASSYGRDRGSDTEAFF	TRBV6-5	TRBJ1-1
TGTGCCAGCAGCTGGGCGATAGCGGGGGTGATAGAGACCCAGTACTTC	CASSWAIAGVIETQYF	TRBV5-6	TRBJ2-5
TGTGCCAGCCCGGACAGTAAAGAGACCCAGTACTTC	CASPDSKETQYF	TRBV27	TRBJ2-5
TGTGCCACCAGCAGAGAGGTTTCAGGGACGTGGCTCACAGATACGCAGTATTTT	CATSREVSGTWLTDTQYF	TRBV15	TRBJ2-3
TGTGCCTGGAGTGTACGACCCAGGGGTGTCGAAAAACTGTTTTTT	CAWSVRPRGVEKLFF	TRBV30	TRBJ1-4
TGCGCCAGCAGCCAAGCCCAGGACCCCGAGCAGTACTTC	CASSQAQDPEQYF	TRBV4-3	TRBJ2-7
TGTGCCAGCAGTCCTCCGGGTCCGGGACAGAATGAAAAACTGTTTTTT	CASSPPGPGQNEKLFF	TRBV6-4	TRBJ1-4
TGTGCCAGCAGTGCAACGGGGACCAATCAGCCCCAGCATTTT	CASSATGTNQPQHF	TRBV25-1	TRBJ1-5
TGTGCCAGCAGTAACAGACTAGTCCTTGAGGGAGGTTCCTACGAGCAGTACTTC	CASSNRLVLEGGSYEQYF	TRBV6-1	TRBJ2-7
TGTGCCAGCAGCCAAGATAGACAGGGGGCCAAGAACACTGAAGCTTTCTTT	CASSQDRQGAKNTEAFF	TRBV3-1	TRBJ1-1
TGTGCCAGCAGTTGGGGTGAGGGAGCTAACTATGGCTACACCTTC	CASSWGEGANYGYTF	TRBV6-3	TRBJ1-2
TGTGCCTGGAGGGGTATCACTAGCGGGAGGGCCCCTGCCTACGAGCAGTACTTC	CAWRGITSGRAPAYEQYF	TRBV30	TRBJ2-7
TGCGCCAGCAGCCAACTGGGGGGGGCTGGCAACGGCAATCAGCCCCAGCATTTT	CASSQLGGAGNGNQPQHF	TRBV4-3	TRBJ1-5
TGTGCCAGCAGCTTAGTGTCCGGACAGATAGTGAGCAATCAGCCCCAGCATTTT	CASSLVSGQIVSNQPQHF	TRBV7-6	TRBJ1-5
TGTGCCACCAGTGGGAGGGACAGGGGCTATAGCAATCAGCCCCAGCATTTT	CATSGRDRGYSNQPQHF	TRBV24-1	TRBJ1-5
TGCGCCAGCAGCTGTGAAATTAACAGGGGTCCGCCGCCCTCACCCCTCCACTTT	CASSCEINRGPPPSPLHF	TRBV5-1	TRBJ1-6
TGTGCCAGCAGCTTCCTCAGGGACAGGGTTAAGGCAACCTACGAGCAGTACTTC	CASSFLRDRVKATYEQYF	TRBV7-3	TRBJ2-7
TGTGCCAGCTCACCACTCAAAGGGACATTTGAAAAACTGTTTTTT	CASSPLKGTFEKLFF	TRBV18	TRBJ1-4
TGCAGTGCTAGAGATCTGGAGGGACAGCTGGGACCGCCAACTAATGAAAAACTGTTTTTT	CSARDLEGQLGPPTNEKLFF	TRBV20-1	TRBJ1-4
TGCAGTGCCGGGGGCCGGGGGGGGTTAGGAGTCGAGCAGTACTTC	CSAGGRGGLGVEQYF	TRBV20-1	TRBJ2-7
TGTGCCACCAGTGATCTAGAAAACCAGCCCCAGCATTTT	CATSDLENQPQHF	TRBV24-1	TRBJ1-5
TGTGCCAGCAGCCTCCGGTCGGGGGAGAACACTGAAGCTTTCTTT	CASSLRSGENTEAFF	TRBV11-3	TRBJ1-1
TGTGCCAGCAGCGGAGGGAGGGGAGGCTCCTACGAGCAGTACTTC	CASSGGRGGSYEQYF	TRBV13	TRBJ2-7
TGTGCCAGCAGTTACGACTCCCAACATAGGGGGAACACCGGGGAGCTGTTTTTT	CASSYDSQHRGNTGELFF	TRBV6-2	TRBJ2-2
TGTGCCAGCAGTTACACCAGGGATGGCTACACCTTC	CASSYTRDGYTF	TRBV6-2	TRBJ1-2
TGTGCCAGCAGCTCTAGGGGGAGTCAAGTGTCGTTTTCCTACGAGCAGTACTTC	CASSSRGSQVSFSYEQYF	TRBV4-2	TRBJ2-7
TGTGCCAGCAGTTTCGAAGACACAGGGGGCTACTCCTACGAGCAGTACTTC	CASSFEDTGGYSYEQYF	TRBV12-3	TRBJ2-7
TGTGCTAGTGGTTTTCCATTAGGGGGCAATACTGAAGCTTTCTTT	CASGFPLGGNTEAFF	TRBV12-5	TRBJ1-1
TGTGCCAGCCGGGGGGAGGAGGGCACAGATACGCAGTATTTT	CASRGEEGTDTQYF	TRBV6-5	TRBJ2-3
TGCAGCGAATGGCATCCCAATGAGCAGTTCTTC	CSEWHPNEQFF	TRBV29-1	TRBJ2-1
TGTGCCAGCAGTTTATCGGAACAAGAGACCCAGTACTTC	CASSLSEQETQYF	TRBV28	TRBJ2-5
TGCGCCAGCAGTGAGTGGACAGGAACGTGGGGGGGAAAGCGGACAGATACGCAGTATTTT	CASSEWTGTWGGKRTDTQYF	TRBV10-1	TRBJ2-3
TGTGCCAGCAGCAGGGGGACCTCCTACGAGCAGTACTTC	CASSRGTSYEQYF	TRBV13	TRBJ2-7
TGCGCCAGCAGCTTGGGAACTAGCGGGAGTAACTATAATTCACCCCTCCACTTT	CASSLGTSGSNYNSPLHF	TRBV5-1	TRBJ1-6
TGCGCCAGCAACCAGGGGGAATCGCAGTCTCAGCCCCAGCATTTT	CASNQGESQSQPQHF	TRBV10-1	TRBJ1-5
TGTGCCAGCAGTGCTGGGTACCAAGAGACCCAGTACTTC	CASSAGYQETQYF	TRBV27	TRBJ2-5
TGTGCCAGCAGTCAGGGAGGCGCCGAGCAGTACTTC	CASSQGGAEQYF	TRBV6-4	TRBJ2-7
TGTGCCAGCAGCGCACTTCGCTCCTACAATGAGCAGTTCTTC	CASSALRSYNEQFF	TRBV13	TRBJ2-1
TGTGCCAGCAGCTTAGGCCCCCCTTCCGGGCTCTCTCAGCCCCAGCATTTT	CASSLGPPSGLSQPQHF	TRBV11-2	TRBJ1-5
TGTGCCAGCAGAGGGGGGAGGGACAATGAGCAGTTCTTC	CASRGGRDNEQFF	TRBV6-6	TRBJ2-1
TGTGCCAGCAGTTATGTGCTCCGAGAAGCTTTCTTT	CASSYVLREAFF	TRBV6-8	TRBJ1-1
TGCGCCAGCAGCTTGTTCCAACTAGCGGGAGGGGGAGGACCCCCTTATGAGCAGTTCTTC	CASSLFQLAGGGGPPYEQFF	TRBV5-1	TRBJ2-1
TGTGCCAGCAGCCAAGATTACTGCTCCTACGAGCAGTACTTC	CASSQDYCSYEQYF	TRBV14	TRBJ2-7
TGTGCTAGTGGTTTGGTAGGGGGCCGAGGGCAGTTCTTC	CASGLVGGRGQFF	TRBV12-5	TRBJ2-1
TGTGCCAGCAGTGGCGTCGGACGGCTCCCCCGGTACAATGAGCAGTTCTTC	CASSGVGRLPRYNEQFF	TRBV27	TRBJ2-1
TGTGCCAGCAGCAGTTTTTACTGGGGACGGCACTACGAGCAGTACTTC	CASSSFYWGRHYEQYF	TRBV13	TRBJ2-7
TGTGCCAGCAGCGTCTTACAGGACGATGGCTACACCTTC	CASSVLQDDGYTF	TRBV7-2	TRBJ1-2
TGTGCCAGCAGCCCTCCCTGGGGGGGTATTGAGACCCAGTACTTC	CASSPPWGGIETQYF	TRBV12-4	TRBJ2-5
TGTGCCAGCAGTCACAGGGGCAAAGGCTCTGGGGCCAACGTCCTGACTTTC	CASSHRGKGSGANVLTF	TRBV6-1	TRBJ2-6
TGCGCCAGCAGCCAAGAGCCTCGGTTCTATTACACAGATACGCAGTATTTT	CASSQEPRFYYTDTQYF	TRBV4-1	TRBJ2-3
TGTGCCAGCAGGGCAGGGGAAGATAATTCACCCCTCCACTTT	CASRAGEDNSPLHF	TRBV27	TRBJ1-6
TGTGCCTGGAGTTCGGGACAGGCCGCCCTCCACTTT	CAWSSGQAALHF	TRBV30	TRBJ1-6
TGTGCCAGCAGCGACCGGCGAATTTGGGGGCAGGGTTGGTGGAACAATGAGCAGTTCTTC	CASSDRRIWGQGWWNNEQFF	TRBV9	TRBJ2-1
TGTGCCAGCAGCGTAGGGGCGGAGACCCAGTACTTC	CASSVGAETQYF	TRBV7-3	TRBJ2-5
TGTGCCAGCAAAGCCATCGGTAGGGAGGGGTACAATGAGCAGTTCTTC	CASKAIGREGYNEQFF	TRBV6-5	TRBJ2-1
TGTGCCTGGGGACTAGAAGATGAGCAGTTCTTC	CAWGLEDEQFF	TRBV30	TRBJ2-1
TGTGCCAGCAGCTTCCCTTGGGGAGTCACTGAAGCTTTCTTT	CASSFPWGVTEAFF	TRBV11-2	TRBJ1-1
TGCGCCAGCAGTGATAGGGGCAAAAACATTCAGTACTTC	CASSDRGKNIQYF	TRBV10-2	TRBJ2-4
TGTGCCAGCAGCCAACCACAGGGGTCCCAGCCCCAGCATTTT	CASSQPQGSQPQHF	TRBV14	TRBJ1-5
TGCAGTGCTATTGGACTCCGTTACACTGAAGCTTTCTTT	CSAIGLRYTEAFF	TRBV20-1	TRBJ1-1
TGTGCCAGCAGTTCGGGGACAGGGTTAGGGAACACTGAAGCTTTCTTT	CASSSGTGLGNTEAFF	TRBV27	TRBJ1-1
TGTGCCCCCTCCCGGGGGGAGGCCTACGAGCAGTACTTC	CAPSRGEAYEQYF	TRBV24-1	TRBJ2-7
TGCAGTGCCACCTGTAGACAGGGGGCGATGTCCCCTTTTTCACCCCTCCACTTT	CSATCRQGAMSPFSPLHF	TRBV20-1	TRBJ1-6
TGTGCCAGCAGAAACGGGACTAGCGGGAGAGCCTACGAGCAGTACTTC	CASRNGTSGRAYEQYF	TRBV2	TRBJ2-7
TGTGCCAGTAGTGAATGCTTTGGACAGGGAGGCTATGGCTACACCTTC	CASSECFGQGGYGYTF	TRBV19	TRBJ1-2
TGTGCCAGCTCACCACTTATACTAGCGGGGCTAGTAGGCTATGGGATCTTC	CASSPLILAGLVGYGIF	TRBV18	TRBJ2-1
TGTGCCAGCAGTTTATCTAAGAGGACCTACAATGAGCAGTTCTTC	CASSLSKRTYNEQFF	TRBV12-3	TRBJ2-1
TGTGCCACCAGCAGATCGGGGGAGAGCCAACATAGCAATCAGCCCCAGCATTTT	CATSRSGESQHSNQPQHF	TRBV15	TRBJ1-5
TGTGCCAGCAGCTCCGGGGACATTAAGAACACTGAAGCTTTCTTT	CASSSGDIKNTEAFF	TRBV9	TRBJ1-1
TGTGCCAGTAGTATAGAGTCAACATTGCGGTTATTAGGGGGAGGAGGGGAGCTGTTTTTT	CASSIESTLRLLGGGGELFF	TRBV19	TRBJ2-2
TGTGCCAGCAGCTTGGGGGTCAGGGATACGCAGTATTTT	CASSLGVRDTQYF	TRBV5-4	TRBJ2-3
TGTGCCAGCAGCCCGGGACAGGGGGCGGGGAACGAGCAGTACTTC	CASSPGQGAGNEQYF	TRBV5-6	TRBJ2-7
TGTGCCAGCAGGGTACAGCGCAGGGGATACTATAGCAATCAGCCCCAGCATTTT	CASRVQRRGYYSNQPQHF	TRBV27	TRBJ1-5
TGTGCCAGCAGCCAAGGACATCCACAGTACTATGGCTACACCTTC	CASSQGHPQYYGYTF	TRBV14	TRBJ1-2
TGTGCCAGCAGCTTGGCCCGGGACAGGGGAGGTCAGCCCCAGCATTTT	CASSLARDRGGQPQHF	TRBV11-3	TRBJ1-5
TGTGCCAGCAGTACCTCATGGGAGGGGGACTGCTATGGCTACACCTTC	CASSTSWEGDCYGYTF	TRBV28	TRBJ1-2
TGTGCCAGCAGCGATCGGGACAGGGGGGCCACCGTGAACACTGAAGCTTTCTTT	CASSDRDRGATVNTEAFF	TRBV9	TRBJ1-1
TGTGCCATCAGTGAGCAGCAGGGCAAATACGAGCAGTACTTC	CAISEQQGKYEQYF	TRBV10-3	TRBJ2-7
TGTGCCAGCAGCTTACCCATAAAGGGAGGGGAGGAAGCTTTCTTT	CASSLPIKGGEEAFF	TRBV7-2	TRBJ1-1
TGTGCCAATGGGACGATCCAAGAGACCCAGTACTTC	CANGTIQETQYF	TRBV30	TRBJ2-5
TGTGCCAGCAGCAATAAGAGGGGAGAGACCCAGTACTTC	CASSNKRGETQYF	TRBV7-9	TRBJ2-5
TGTGCCAGCAGTTTTGACAGGAACTTCGAGCAGTACTTC	CASSFDRNFEQYF	TRBV12-4	TRBJ2-7
TGCGCCAGCAGTGAAAGGACAGGGCACGATCAGCCCCAGCATTTT	CASSERTGHDQPQHF	TRBV10-1	TRBJ1-5
TGCAGTGCTCCAGGGGGGCGTGGGGCCAACGTCCTGACTTTC	CSAPGGRGANVLTF	TRBV20-1	TRBJ2-6
TGTGCCAGCAGTTTCACCGTCGAGGGGGCGTCACCCCTCCACTTT	CASSFTVEGASPLHF	TRBV28	TRBJ1-6
TGCAGTGCTGGGAAGACCGGGACTAGTGCCGAGCAGTACTTC	CSAGKTGTSAEQYF	TRBV20-1	TRBJ2-7
TGCGCCAGCAACCGGGACAGGGGGGACTACAATGAGCAGTTCTTC	CASNRDRGDYNEQFF	TRBV10-2	TRBJ2-1
TGTGCCACCAGTGAGGATTCCCCGCCCCCCCAAGAGACCCAGTACTTC	CATSEDSPPPQETQYF	TRBV24-1	TRBJ2-5
TGTGCCAGCAGCTCACCGTTAACGCAAGGGGATCCCTCCTACGAGCAGTACTTC	CASSSPLTQGDPSYEQYF	TRBV11-2	TRBJ2-7
TGTGCCAGCAGCGTAGCAGGGGGCCAGAATGGAAACACCATATATTTT	CASSVAGGQNGNTIYF	TRBV9	TRBJ1-3
TGCGCCAGCAGCCCCCCCAGTCCTCCACTAGCGTTTAACAATGAGCAGTTCTTC	CASSPPSPPLAFNNEQFF	TRBV4-1	TRBJ2-1
TGTGCCAGCAGCGGTGGCCCCGGCGTGAACACCGGGGAGCTGTTTTTT	CASSGGPGVNTGELFF	TRBV7-2	TRBJ2-2
TGCGCCAGCAGCTCGGCCGTAAGGGGCCCGGGCAGCTCCTACGAGCAGTACTTC	CASSSAVRGPGSSYEQYF	TRBV5-1	TRBJ2-7
TGTGCCAGCAGTTGGACTAGTTACAATGAGCAGTTCTTC	CASSWTSYNEQFF	TRBV27	TRBJ2-1
TGTGCCAGCAGGAGGTGCGGGAGGGAGGTGATAGAAAACATTCAGTACTTC	CASRRCGREVIENIQYF	TRBV27	TRBJ2-4
TGTGCCAGCAGCGGAAGGGTGGGGGCCACCTGCTATGGCTACACCTTC	CASSGRVGATCYGYTF	TRBV7-9	TRBJ1-2
TGTGCCAGCAGTTTGACAGGGTGGGGAATCACTGAAGCTTTCTTT	CASSLTGWGITEAFF	TRBV6-3	TRBJ1-1
TGCGCCAGCACCAGATTCGGTTTGGATACGCAGTATTTT	CASTRFGLDTQYF	TRBV10-1	TRBJ2-3
TGTGCCAGCAGTTTGACTAGAGATACGCAGTATTTT	CASSLTRDTQYF	TRBV27	TRBJ2-3
TGTGCCAGCACATCAGGGCCGGAGGGCGGGGAGCTGTTTTTT	CASTSGPEGGELFF	TRBV12-3	TRBJ2-2
TGTGCCACCACCGGTAAGAAAGTACAGATTTTTGATAGCGGGGAGCTGTTTTTT	CATTGKKVQIFDSGELFF	TRBV24-1	TRBJ2-2
TGTGCCAGCAGCTTGGGGGCAGCCGGAAACACCATATATTTT	CASSLGAAGNTIYF	TRBV7-9	TRBJ1-3
TGTGCCAGCCCGCGGGAGAATTCCTACAATGAGCAGTTCTTC	CASPRENSYNEQFF	TRBV14	TRBJ2-1
TGTGCCAGCAGCTTTGCCGGCGGGACAGTTTACGAGCAGTACTTC	CASSFAGGTVYEQYF	TRBV5-5	TRBJ2-7
TGTGCCAGCAGCCAAGGTTCGGGACTAGCGGCTAGGACTACGTACAATGAGCAGTTCTTC	CASSQGSGLAARTTYNEQFF	TRBV4-2	TRBJ2-1
TGTGCCACCAGTGCCAAGACAGGGGGCTACACCTTC	CATSAKTGGYTF	TRBV24-1	TRBJ1-2
TGCAGTGCTAGGGCTAAACAGGGGGCGCAGGAGGACGAGCAGTACTTC	CSARAKQGAQEDEQYF	TRBV20-1	TRBJ2-7
TGTGCCACCAGTCGGAGGGTAGCGCCCTACACTGAAGCTTTCTTT	CATSRRVAPYTEAFF	TRBV24-1	TRBJ1-1
TGCGCCAGCAGCTTTTGGGGACAGGGGTGTAACTATGGCTACACCTTC	CASSFWGQGCNYGYTF	TRBV5-1	TRBJ1-2
TGTGCCTGGAGTGCTCGGGAGGGCCCTAGCACTGAAGCTTTCTTT	CAWSAREGPSTEAFF	TRBV30	TRBJ1-1
TGCGCCAGTCTCGTCCTGTGGAGGGTTTCACCCCTCCACTTT	CASLVLWRVSPLHF	TRBV10-1	TRBJ1-6
TGTGCCACCAGTGATTCGGGTAGAGTAGCCAAAAACATTCAGTACTTC	CATSDSGRVAKNIQYF	TRBV24-1	TRBJ2-4
TGCGCCAGCAGCTTGCTTCCCGGGGACGGTGAAGCTTTCTTT	CASSLLPGDGEAFF	TRBV5-1	TRBJ1-1
TGTGCCAGCAGTTACAACCATGACAGCGCCTATGGCTACACCTTC	CASSYNHDSAYGYTF	TRBV6-5	TRBJ1-2
TGTGCCAGCAGTGGAGACGGCGGGGAGCTGTTTTTT	CASSGDGGELFF	TRBV28	TRBJ2-2
TGCAGTGCCCGGGGGGGTTTAGCAGGCTACACCTTC	CSARGGLAGYTF	TRBV20-1	TRBJ1-2
TGTGCCACCAGTGAGACTAGCGGGGGGGCCCAAGAGACCCAGTACTTC	CATSETSGGAQETQYF	TRBV24-1	TRBJ2-5
TGTGCCTGGAGTGCGACCCGCCCACTGACTAGCGGGAGCTACGATACGCAGTATTTT	CAWSATRPLTSGSYDTQYF	TRBV30	TRBJ2-3
TGTGCCACCGGAACCCAAAACGGAACTCCGACCGAGCAGTACTTC	CATGTQNGTPTEQYF	TRBV24-1	TRBJ2-7
TGCAGTGCGATGAGTGAAGAGGGCTGCACTGAAGCTTTCTTT	CSAMSEEGCTEAFF	TRBV20-1	TRBJ1-1
TGTGCCTGGAGTAGGATGGGGCCCTCCACTGAAGCTTTCTTT	CAWSRMGPSTEAFF	TRBV30	TRBJ1-1
TGCAGTGCTAGAGATCGGCTAGCGGGTGACAGTCTGGAGACCCAGTACTTC	CSARDRLAGDSLETQYF	TRBV20-1	TRBJ2-5
TGCGCCAGCAGGTTGCCCCAGGGATTTGATACGCAGTATTTT	CASRLPQGFDTQYF	TRBV5-1	TRBJ2-3
TGTGCCGTGCACAGGGGGTCCTACGAGCAGTACTTC	CAVHRGSYEQYF	TRBV10-3	TRBJ2-7
TGTGCCAGCAGTGACTGCACTAGAGTTTACTATGGCTACACCTTC	CASSDCTRVYYGYTF	TRBV6-4	TRBJ1-2
TGTGCCAGCAGTTACTTGACAGGGTACGAGCAGTACTTC	CASSYLTGYEQYF	TRBV6-5	TRBJ2-7
TGTGCCAGCAGCTTAAGGGGAGCGGGACAGTATGAGCAGTACTTC	CASSLRGAGQYEQYF	TRBV7-3	TRBJ2-7
TGCGCCAGCAGCGAGGGAACCAATAGCAATCAGCCCCAGCATTTT	CASSEGTNSNQPQHF	TRBV10-1	TRBJ1-5
TGTGCCAGCAGCAGTAGCCAGGGTTCCACAGATACGCAGTATTTT	CASSSSQGSTDTQYF	TRBV7-3	TRBJ2-3
TGTGCCAGCAGTGACTCAATGAGAAAGGGATGCACAGATACGCAGTATTTT	CASSDSMRKGCTDTQYF	TRBV6-4	TRBJ2-3
TGTGCCAGTAGTCCGGGACAGTACGAGCAGTACTTC	CASSPGQYEQYF	TRBV19	TRBJ2-7
TGTGCCAGCAGCGGATCACTAGCGGGAGGTGGGGTAATGAACACTGAAGCTTTCTTT	CASSGSLAGGGVMNTEAFF	TRBV13	TRBJ1-1
TGTGCCAGCAGTGGAATGGGACAATTCAATCAGCCCCAGCATTTT	CASSGMGQFNQPQHF	TRBV6-5	TRBJ1-5
TGTGCCAGCAGCTTAGGGCAAAAAACGACGGTTCGCCTCGGGATAAGCTCCTACGAGCAGTACTTC	CASSLGQKTTVRLGISSYEQYF	TRBV11-2	TRBJ2-7
TGTGCCAGCAGCTTACGGGGTGACCAGAGGGATTGTTCGATTCGACGATACTCCTACGAGCAGTACTTC	CASSLRGDQRDCSIRRYSYEQYF	TRBV7-3	TRBJ2-7
TGTGCCATCGATAAGTCCAACACCATATATTTT	CAIDKSNTIYF	TRBV10-3	TRBJ1-3
TGCAGTGCTAGAGCAGATAATGAAAAACTGTTTTTT	CSARADNEKLFF	TRBV20-1	TRBJ1-4
TGTGCCAGCGGGTGGGTCTCCGAGCAGTACTTC	CASGWVSEQYF	TRBV27	TRBJ2-7
TGTGCCAGCAGCCCCGGGACAGAGAGCTCCTACGAGCAGTACTTC	CASSPGTESSYEQYF	TRBV7-4	TRBJ2-7
TGTGCCAGCAGCTCGACATACGGACTAGCGGGGGGGCCGGACACCGGGGAGCTGTTTTTT	CASSSTYGLAGGPDTGELFF	TRBV7-3	TRBJ2-2
TGTGCCAGCTCGACGGACGTATCCAGGTATAATTCACCCCTCCACTTT	CASSTDVSRYNSPLHF	TRBV27	TRBJ1-6
TGCGCCAGCAGCTTGGGGCTCAGCCGAGAAAATGAGCAGTTCTTC	CASSLGLSRENEQFF	TRBV5-1	TRBJ2-1
TGTGCCAGCAGTTACTCTAATATAACACAGGGGCAAGAGAACACCGGGGAGCTGTTTTTT	CASSYSNITQGQENTGELFF	TRBV6-2	TRBJ2-2
TGTGCCAGGGACAGGGCCGGAAACACCATATATTTT	CARDRAGNTIYF	TRBV5-6	TRBJ1-3
TGTGCCAGTATTGCGGGGAAAGAGACCCAGTACTTC	CASIAGKETQYF	TRBV19	TRBJ2-5
TGTGCCAGCAGCTTAGCTGCACAGGTAAGAAAAGGCATCTTT	CASSLAAQVRKGIF	TRBV11-3	TRBJ1-1
TGTGCCAGCAGCGGGGGACTAGCGGGAGGGCCCGGTAACCACAATGAGCAGTTCTTC	CASSGGLAGGPGNHNEQFF	TRBV7-2	TRBJ2-1
TGTGCCATGAGTCTAGACTACGAGCAGTACTTC	CAMSLDYEQYF	TRBV10-3	TRBJ2-7
TGTGCCATCACCACAGGGCGCCCACATGGCTACACCTTC	CAITTGRPHGYTF	TRBV10-3	TRBJ1-2
TGCAGTGCTGATCGCCCTTGGGGAAACACCATATATTTT	CSADRPWGNTIYF	TRBV20-1	TRBJ1-3
TGTGCCAGCAGTCATCCTCTGGGACTAGCAGATGAACAAGAGACCCAGTACTTC	CASSHPLGLADEQETQYF	TRBV2	TRBJ2-5
TGTGCCAGCAGGCTGGTACCAGAATTCTCTGAAGCTTTCTTT	CASRLVPEFSEAFF	TRBV6-3	TRBJ1-1
TGTGCCAGCCCCAAGTGGGACAGGGGGCAGGGCGTTACCGGGAGGGCTGAAGCTTTCTTT	CASPKWDRGQGVTGRAEAFF	TRBV2	TRBJ1-1
TGCAGTGCTAGAGATGAACTCCACGAGCAGTACTTC	CSARDELHEQYF	TRBV20-1	TRBJ2-7
TGTGCCCGAATACTAGCGGGCCTGGAGCAGTACTTC	CARILAGLEQYF	TRBV28	TRBJ2-7
TGTGCCAGCAGTAGCCCCAGGGTACCCACTGAAGCTTTCTTT	CASSSPRVPTEAFF	TRBV6-5	TRBJ1-1
TGCAGTGCCACTAGCGGCTACGAGCAGTACTTC	CSATSGYEQYF	TRBV20-1	TRBJ2-7
TGCAGTGCTAGAGATTTCCAGCCCCAGCATTTT	CSARDFQPQHF	TRBV20-1	TRBJ1-5
TGTGCCACCAGTGATTTGCACGCAGGGCTCCAAGAGACCCAGTACTTC	CATSDLHAGLQETQYF	TRBV24-1	TRBJ2-5
TGTGCCAGCAGCTCCCCGGGGCCTTCCTACAATGAGCAGTTCTTC	CASSSPGPSYNEQFF	TRBV7-3	TRBJ2-1
TGCAGTGCTACCCGACAAAGGAACAGGGGGCTACAAGAGACCCAGTACTTC	CSATRQRNRGLQETQYF	TRBV20-1	TRBJ2-5
TGTGCCAGCAGCGCGAAGGAGGGATACCAGCCCCAGCATTTT	CASSAKEGYQPQHF	TRBV5-6	TRBJ1-5
TGCAGCGTTACAGGGGGCTACAATGAGCAGTTCTTC	CSVTGGYNEQFF	TRBV29-1	TRBJ2-1
TGTGCCAGCAGCTCATCCGGTCGGGGGACTAGGGACAATGAGCAGTTCTTC	CASSSSGRGTRDNEQFF	TRBV13	TRBJ2-1
TGTGCCAGCAGCAGATCACAGGGTCGGGGCCTAATCACTGAAGCTTTCTTT	CASSRSQGRGLITEAFF	TRBV13	TRBJ1-1
TGTGCCAGCAGTTACGTAGCGGGGAATGAGCAGTTCTTC	CASSYVAGNEQFF	TRBV6-5	TRBJ2-1
TGTGCCAGCAGTTATAGAAGGTCCGGACTAGCGTCGGAGGAGACCCAGTACTTC	CASSYRRSGLASEETQYF	TRBV6-6	TRBJ2-5
TGTGCCAGCAGTGGGACAGGGCCTAAGGGCTATGGCTACACCTTC	CASSGTGPKGYGYTF	TRBV25-1	TRBJ1-2
TGTGCCAGCCGAGTAGGACTAGCGGGGGGCATCCGCGAAGAGACCCAGTACTTC	CASRVGLAGGIREETQYF	TRBV9	TRBJ2-5
TGTGCCAGCAGCCTGTTCGAATCCGAAAAACTGTTTTTT	CASSLFESEKLFF	TRBV13	TRBJ1-4
TGTGCCAGCAGCACCGGGGGAGGAGGACTTCAGCCCCAGCATTTT	CASSTGGGGLQPQHF	TRBV11-3	TRBJ1-5
TGTGCCAGCAGTTACTCCCCCATTAGCAGGACAGGGAACTCCTACGAGCAGTACTTC	CASSYSPISRTGNSYEQYF	TRBV6-5	TRBJ2-7
TGTGCCAGTAGTATAGTCAGAAATGGGACAGGGGTTAGCCAAGAGACCCAGTACTTC	CASSIVRNGTGVSQETQYF	TRBV19	TRBJ2-5
TGTGCCAGCAGCTTAGGTTGGGGACTAGCGGGTAGTTACGAGCAGTACTTC	CASSLGWGLAGSYEQYF	TRBV11-3	TRBJ2-7
TGTGCCAGCAGCAAGACCATGACCCAGTACTTC	CASSKTMTQYF	TRBV6-5	TRBJ2-5
TGCAGTGCAAGCAGCGGGACCTACAATGAGCAGTTCTTC	CSASSGTYNEQFF	TRBV20-1	TRBJ2-1
TGTGCCAGCAGTCAAAAAGGGGCCTCCCAGCATTTT	CASSQKGASQHF	TRBV6-4	TRBJ1-5
TGCAGTGCTCCCCAGGGGGCCGAGAGGTATCAGCCCCAGCATTTT	CSAPQGAERYQPQHF	TRBV20-1	TRBJ1-5
TGTGCCAGCAGTTCGGTCGACAGCGACACTGAAGCTTTCTTT	CASSSVDSDTEAFF	TRBV6-2	TRBJ1-1
TGTGCCATCAGTGAGTCGATAGGACAGGGGGTCGCTCTTAACCCGGATAATGAGCAGTTCTTC	CAISESIGQGVALNPDNEQFF	TRBV10-3	TRBJ2-1
TGTGCCAGCAGCCAACCGGGACAGGGAGTCTATGGCTACACCTTC	CASSQPGQGVYGYTF	TRBV7-2	TRBJ1-2
TGTGCCAGCAGTTATTCGGAACTAGCGGGTAACGAGCAGTACTTC	CASSYSELAGNEQYF	TRBV6-9	TRBJ2-7
TGCGCCAGCAGCCAAACCCCCCCCGGCGGGTTCCCTAACTATGGCTACACCTTC	CASSQTPPGGFPNYGYTF	TRBV5-1	TRBJ1-2
TGTGCCAGCAGGGACAGGGTTTCTAGCACAGATACGCAGTATTTT	CASRDRVSSTDTQYF	TRBV9	TRBJ2-3
TGCAGTGCTGCCTTTAAGGGCAGAGAAACCTCCTACAATGAGCAGTTCTTC	CSAAFKGRETSYNEQFF	TRBV20-1	TRBJ2-1
TGTGCCATCAGTGATCCGCCCCGTAGGGGCAACACTGAAGCTTTCTTT	CAISDPPRRGNTEAFF	TRBV10-3	TRBJ1-1
TGTGCCATCAGGCCAAGGGGGCCTGAAGCTTTCTTT	CAIRPRGPEAFF	TRBV10-3	TRBJ1-1
TGTGCCAGCCGCTTAGCGGAGTACGAGCAGTACTTC	CASRLAEYEQYF	TRBV28	TRBJ2-7
TGTGCCAGCAGTTTGTGGGGGTTTTGGGTCGACGAGCAGTACTTC	CASSLWGFWVDEQYF	TRBV28	TRBJ2-7
TGTGCCAGCAGCAACCGCGGGAGGTACGGAAGCACAGATACGCAGTATTTT	CASSNRGRYGSTDTQYF	TRBV3-1	TRBJ2-3
TGTGCCAGCAGCTTTAAAACACAGGAGGACACCATATATTTT	CASSFKTQEDTIYF	TRBV13	TRBJ1-3
TGTGCCAGCAGTTTAAGTCACCCCGGGACAGCCCCCTACGAGCAGTACTTC	CASSLSHPGTAPYEQYF	TRBV28	TRBJ2-7
TGTGCCAGCAGTTACCCACTAGCAACTAGCGGGAGGGCGTGTAGCTCCTACGAGCAGTACTTC	CASSYPLATSGRACSSYEQYF	TRBV6-2	TRBJ2-7
TGTGCCAGCAGCCAAGTATGGGGGTCGGGCACCTACGAGCAGTACTTC	CASSQVWGSGTYEQYF	TRBV3-1	TRBJ2-7
TGCAGTGCCAATCAGCGGCTAGGAGCCTACAATGAGCAGTTCTTC	CSANQRLGAYNEQFF	TRBV20-1	TRBJ2-1
TGTGCCAGCAGTTCTAAGGTCCCGGGGAACGCCGCCTCCTACAATGAGCAGTTCTTC	CASSSKVPGNAASYNEQFF	TRBV27	TRBJ2-1
TGTGCCACCAGTACGATTACAGCGACCCCCTATAATTCACCCCTCCACTTT	CATSTITATPYNSPLHF	TRBV24-1	TRBJ1-6
TGTGCCAGCAGTTACTCGCCTAAAGGGACAGGGACGGGGGACTATGGCTACACCTTC	CASSYSPKGTGTGDYGYTF	TRBV6-2	TRBJ1-2
TGCGCCAGCAGCCGTTGTCTAGCGGGGGGCCCTATCTCGAACACCGGGGAGCTGTTTTTT	CASSRCLAGGPISNTGELFF	TRBV4-3	TRBJ2-2
TGTGCCAGCAGCACCTATCACGGGCTAGCCAAAAACATTCAGTACTTC	CASSTYHGLAKNIQYF	TRBV7-4	TRBJ2-4
TGTGCCAGCAGCCAAGATCGAGGGGTTAAGCGCACCATATATTTT	CASSQDRGVKRTIYF	TRBV14	TRBJ1-3
TGTGCCAGCAGCTTGGCCGTTATTGAGGGATCGGAGACCCAGTACTTC	CASSLAVIEGSETQYF	TRBV5-4	TRBJ2-5
TGTGCCAGCAGTTTTGGGGGGGGCTTCTACGAGCAGTACTTC	CASSFGGGFYEQYF	TRBV6-9	TRBJ2-7
TGTGCCAGCACGACGACTAGCGGGCCCGAGACCCAGTACTTC	CASTTTSGPETQYF	TRBV6-1	TRBJ2-5
TGCGCCAGCAGCTCGAATCCGGGGGTACTAGAGACCCAGTACTTC	CASSSNPGVLETQYF	TRBV5-1	TRBJ2-5
TGTGCTAGTCTCTCCACTGAAGCTTTCTTT	CASLSTEAFF	TRBV12-5	TRBJ1-1
TGTGCCAGCAGCTTCAGGAGACTCCCGGATACGCAGTATTTT	CASSFRRLPDTQYF	TRBV11-3	TRBJ2-3
TGTGCCAGCAGAGGGAGGACGACCGGGGACAGGGAAAATTCACCCCTCCACTTT	CASRGRTTGDRENSPLHF	TRBV7-8	TRBJ1-6
TGTGCCAGCAGCTCTCTTGGACTAGCGGGGGGGCCCCCGTTAGTAGGAACGAACACCGGGGAGCTGTTTTTT	CASSSLGLAGGPPLVGTNTGELFF	TRBV11-3	TRBJ2-2
TGTGCCAGCAGCTTAGACACAGGGTTGGGCCTAAGGTGGAGGTTTGAAAAACTGTTTTTT	CASSLDTGLGLRWRFEKLFF	TRBV7-2	TRBJ1-4
TGTGCCAGCAGCCCCCCCCCGGGATATACGCAGTATTTT	CASSPPPGYTQYF	TRBV13	TRBJ2-3
TGTGCCAGCAGTTTCCTTTGGGTTCCGGGAGACGTGTCCTACGAGCAGTACTTC	CASSFLWVPGDVSYEQYF	TRBV27	TRBJ2-7
TGTGCCAGCGCCGGCGCAGGGGGTTGCAATCAGCCCCAGCATTTT	CASAGAGGCNQPQHF	TRBV6-2	TRBJ1-5
TGTGCCAGCAGCCAAGATTCGGGGTTGGCCGGAGGGGCCAACGTCCTGACTTTC	CASSQDSGLAGGANVLTF	TRBV3-1	TRBJ2-6
TGTGCCAGCAGCTTAGCGGGTTCAAGGGGGACCACCTATGGCTACACCTTC	CASSLAGSRGTTYGYTF	TRBV11-3	TRBJ1-2
TGCGCCAGCCCCGACGAGGGTGGCGGGAGCCGGAACACTGAAGCTTTCTTT	CASPDEGGGSRNTEAFF	TRBV10-2	TRBJ1-1
TGCGCCAGCAGTGAGTCGCCGAGGCTTTACATGAACACTGAAGCTTTCTTT	CASSESPRLYMNTEAFF	TRBV10-1	TRBJ1-1
TGTGCCACCAACCCGGGAAGCAATCAGCCCCAGCATTTT	CATNPGSNQPQHF	TRBV24-1	TRBJ1-5
TGTGCCAGCAGCTTAATATTCATGACGGGCATGGGTCGTCCCTATGGCTACACCTTC	CASSLIFMTGMGRPYGYTF	TRBV7-3	TRBJ1-2
TGTGCCAGCAGAGGAGGGTTCAGGGGGCGCGGTTATCAGCCCCAGCATTTT	CASRGGFRGRGYQPQHF	TRBV6-3	TRBJ1-5
TGTGCCAGCAGTTTAGGGCGGGGGGCCTACGAGCAGTACTTC	CASSLGRGAYEQYF	TRBV27	TRBJ2-7
TGTGCCAGCAGTTACGATATCAACAGACAGTGCGATACAACTAATGAAAAACTGTTTTTT	CASSYDINRQCDTTNEKLFF	TRBV6-5	TRBJ1-4
TGCGCCAGCAGCTTGGGGACTAGCGGGGCCAATGAGCAGTTCTTC	CASSLGTSGANEQFF	TRBV5-1	TRBJ2-1
TGTGCCAGCAGCCCATCACGGTCCCTAGGGATAGGGGCTTTCTTT	CASSPSRSLGIGAFF	TRBV13	TRBJ1-1
TGTGCCAGCAGCCAAGCCCCAGAGCGGGAGGGCTACGAGCAGTACTTC	CASSQAPEREGYEQYF	TRBV4-2	TRBJ2-7
TGCGCCAGCAGCCAGGCCCGCAAGAAATTAGAGCAGTACTTC	CASSQARKKLEQYF	TRBV5-1	TRBJ2-7
TGTGCCAGCAGTTTTTTAAAGAAGGATACGCAGTATTTT	CASSFLKKDTQYF	TRBV27	TRBJ2-3
TGTGCTAGTGGTTTGCGGCAGGAAGGGGCTCAGCCCCAGCATTTT	CASGLRQEGAQPQHF	TRBV12-5	TRBJ1-5
TGTGCCAGCAGCCCAACATGGGACATTTTCAACGAGCAGTACTTC	CASSPTWDIFNEQYF	TRBV11-3	TRBJ2-7
TGTGCCACCGCTTCGGGGTGTGATATAAGCAATCAGCCCCAGCATTTT	CATASGCDISNQPQHF	TRBV6-4	TRBJ1-5
TGTGCCAGTAGTATTGAGAGAAACTATGGCTACACCTTC	CASSIERNYGYTF	TRBV19	TRBJ1-2
TGTGCCAGCAATTGGCCGGACAGGGGGACCCAGCCCCAGCATTTT	CASNWPDRGTQPQHF	TRBV12-4	TRBJ1-5
TGTGCCAGCAGCCACAAGGGGACAGGGGGGAGCAATCAGCCCCAGCATTTT	CASSHKGTGGSNQPQHF	TRBV6-4	TRBJ1-5
TGTGCCAGCAGTGGTAAATCCATACAGGGCCAGTCCTACGAGCAGTACTTC	CASSGKSIQGQSYEQYF	TRBV6-4	TRBJ2-7
TGCGCCAGAGACAGGACGAATTACACCGGGGAGCTGTTTTTT	CARDRTNYTGELFF	TRBV10-1	TRBJ2-2
TGTGCCAGCACTGGAGCTAGTAAGCGCCTTAAGGACAATGAAAAACTGTTTTTT	CASTGASKRLKDNEKLFF	TRBV28	TRBJ1-4
TGTGCCAGCAGCCCGGGGGTACCCTACGAGCAGTACTTC	CASSPGVPYEQYF	TRBV7-2	TRBJ2-7
TGTGCCAGCTCACGATCCACCAGGACAGGGCGCTCCTACGAGCAGTACTTC	CASSRSTRTGRSYEQYF	TRBV18	TRBJ2-7
TGTGCCAGCAGTGCCGGGAAAAGGGGGCTTGGCTCCTACAATGAGCAGTTCTTC	CASSAGKRGLGSYNEQFF	TRBV2	TRBJ2-1
TGTGCCAGCAGCTTACCCGGCACCCGGGACCGAGTCCAAGAGACCCAGTACTTC	CASSLPGTRDRVQETQYF	TRBV11-1	TRBJ2-5
TGTGCCAGCAGTTTATCAATACGCCAGGGACACACTGAAGCTTTCTTT	CASSLSIRQGHTEAFF	TRBV27	TRBJ1-1
TGCAGTGCTAGCCACGGGCAGGGGAACACTGAAGCTTTCTTT	CSASHGQGNTEAFF	TRBV20-1	TRBJ1-1
TGCGGGTCCCCGCAGGAATCCGGGTCCTATAATTCACCCCTCCACTTT	CGSPQESGSYNSPLHF	TRBV5-1	TRBJ1-6
TGTGCCACCAGTGATTTCCGGGACAGGGAGTCCGACACTGAAGCTTTCTTT	CATSDFRDRESDTEAFF	TRBV24-1	TRBJ1-1
TGTGCCAGCAGTGAAGTGAGTCAGGACTCCTATAATTCACCCCTCCACTTT	CASSEVSQDSYNSPLHF	TRBV2	TRBJ1-6
TGTGCCAGCAGTTGTACTATGACCCAGTACTTC	CASSCTMTQYF	TRBV6-5	TRBJ2-5
TGTGCCAGCAGCGAATCGTCCGGGACAGAAGGCGAGCAGTACTTC	CASSESSGTEGEQYF	TRBV6-6	TRBJ2-7
TGCGCCAGCAGCTTGGGCGTTAAAGGCGGTGGACAGACTGCGAACACCGGGGAGCTGTTTTTT	CASSLGVKGGGQTANTGELFF	TRBV5-1	TRBJ2-2
TGTGCCAGCAGCGTAGAGGGACGTCGGCTAGCGGGTCCCTTCACTACTTACAATGAGCAGTTCTTC	CASSVEGRRLAGPFTTYNEQFF	TRBV9	TRBJ2-1
TGCGCCAGCAGGACATACCGGACAACAGCGATGAACACTGAAGCTTTCTTT	CASRTYRTTAMNTEAFF	TRBV10-1	TRBJ1-1
TGTGCCAGCAGTTTGACAGCGTGTCAGCCCCAGCATTTT	CASSLTACQPQHF	TRBV28	TRBJ1-5
TGTGCCAGCACCCCTAGGGGCTTGGACAGGAATTCGTGCTATGGCTACACCTTC	CASTPRGLDRNSCYGYTF	TRBV11-3	TRBJ1-2
TGCAGTGCTCCTATAGACTACGAGCAGTACTTC	CSAPIDYEQYF	TRBV20-1	TRBJ2-7
TGCGCCAGCAGCCAAGGGGTGCTAATACCGGGGAGGGGGTCAGATACGCAGTATTTT	CASSQGVLIPGRGSDTQYF	TRBV4-1	TRBJ2-3
TGTGCCAGCAGCTTCAGGAACTCTGGAAACACCATATATTTT	CASSFRNSGNTIYF	TRBV9	TRBJ1-3
TGCGCCAGCAGCCAATCTATGACTAGCGGGCAAGCCTCCTACGAGCAGTACTTC	CASSQSMTSGQASYEQYF	TRBV4-3	TRBJ2-7
TGTGCCAGCAGCTTGGCCCAAACCGGGACAATAGGCAGATTGAACACCGGGGAGCTGTTTTTT	CASSLAQTGTIGRLNTGELFF	TRBV5-4	TRBJ2-2
TGTGCCAGCAGCTTGCGTAGGGTACAGAGCACCCCCCAGCATTTT	CASSLRRVQSTPQHF	TRBV5-4	TRBJ1-5
TGTGCTAGCAGCTTATTGAACCAGGGGGGTTCCGATACGCAGTATTTT	CASSLLNQGGSDTQYF	TRBV7-7	TRBJ2-3
TGCAGTGCTAGAGATACGGGGACAGGAACTGAAAAACTGTTTTTT	CSARDTGTGTEKLFF	TRBV20-1	TRBJ1-4
TGTGCCAGCAGTTTCCATGCGGACTCCTACGAGCAGTACTTC	CASSFHADSYEQYF	TRBV27	TRBJ2-7
TGTGCCAGCAGCGGCGACGCATACGAGCAGTACTTC	CASSGDAYEQYF	TRBV7-3	TRBJ2-7
TGTGCCAGCAGCAGTGTACGGGCGGGCTCTGGGGCCAACGTCCTGACTTTC	CASSSVRAGSGANVLTF	TRBV7-3	TRBJ2-6
TGTGCCACCGACGGGGTACAAGAGACCCAGTACTTC	CATDGVQETQYF	TRBV12-4	TRBJ2-5
TGTGCCACCAGTCGCAGGGGCGGCTACGAGCAGTACTTC	CATSRRGGYEQYF	TRBV15	TRBJ2-7
TGTGCCAGCAGCAAGGGCAGGGACTTC	CASSKGRDF	TRBV7-9	TRBJ2-7
TGTGCCAGCAGCTTATTACTCATCAGGGTAGGCTACACCTTC	CASSLLLIRVGYTF	TRBV7-6	TRBJ1-2
TGTGCCAGCAGTGACCTCCGGACAGTATCTGGTCTAAACATTCAGTACTTC	CASSDLRTVSGLNIQYF	TRBV6-4	TRBJ2-4
TGTGCCAGCAGTTACCTCCCCCGGTACAATGAGCAGTTCTTC	CASSYLPRYNEQFF	TRBV6-5	TRBJ2-1
TGTGCCAGCAGTTTCGCCCAGCGGGGGCAAAACATTCAGTACTTC	CASSFAQRGQNIQYF	TRBV6-2	TRBJ2-4
TGTGCCAGCAGCCCGTTAGGGGCAAACTCCGGGGAGCTGTTTTTT	CASSPLGANSGELFF	TRBV13	TRBJ2-2
TGCGCCAGCATACCGGGCACAGATACGCAGTATTTT	CASIPGTDTQYF	TRBV10-2	TRBJ2-3
TGTGCCACCAGAAAGCGGGAGAGGATAAGGAGCAATCAGCCCCAGCATTTT	CATRKRERIRSNQPQHF	TRBV24-1	TRBJ1-5
TGTGCCACCAGTCAGGGTCTAGCCAAAAACATTCAGTACTTC	CATSQGLAKNIQYF	TRBV24-1	TRBJ2-4
TGTGCCAGCCCGAGGACAGAGGCGTGTTTAGTGCCCCAGCATTTT	CASPRTEACLVPQHF	TRBV18	TRBJ1-5
TGTGCCAGCAACCAGACAGGGCGGCCAACTAATGAAAAACTGTTTTTT	CASNQTGRPTNEKLFF	TRBV27	TRBJ1-4
TGCAGCGTTGGGTTGGGGGCGGTATCCTACGAGCAGTACTTC	CSVGLGAVSYEQYF	TRBV29-1	TRBJ2-7
TGTGCCACCAGCCCGCCCAGGGGTAAAGGAGTGGAGCAGTACTTC	CATSPPRGKGVEQYF	TRBV15	TRBJ2-7
TGCAGTGAGTGGGCACCCAACACTGAAGCTTTCTTT	CSEWAPNTEAFF	TRBV20-1	TRBJ1-1
TGTGGAGGCGACCAAGAGACCCAGTACTTC	CGGDQETQYF	TRBV7-9	TRBJ2-5
TGCAGTGCTACCCACCCCCGTCAGAGAAGCCCCGATATTGGATACGAGCAGTACTTC	CSATHPRQRSPDIGYEQYF	TRBV20-1	TRBJ2-7
TGTGCCAGCAGCCGGGGACTAGCGGGAAAAGGTGATGAGCAGTTCTTC	CASSRGLAGKGDEQFF	TRBV11-2	TRBJ2-1
TGTGCCAGCAGCGCCCAACAGGGTTTTAGCAATCAGCCCCAGCATTTT	CASSAQQGFSNQPQHF	TRBV13	TRBJ1-5
TGTGCCAGCAGCACCGGCGGAGAGGCGACGGCGAACACTGAAGCTTTCTTT	CASSTGGEATANTEAFF	TRBV7-3	TRBJ1-1
TGCGCCACTCTCCTCTGGGGGGAACACCTTTTCTATGGCTACACCTTC	CATLLWGEHLFYGYTF	TRBV5-1	TRBJ1-2
TGTGCCAAGGTCCGGGGGGACAACACCATATATTTT	CAKVRGDNTIYF	TRBV19	TRBJ1-3
TGCAGCGGGTTCCCGCCCGGCAGTCTGTCAGGCGGCAATCAGCCCCAGCATTTT	CSGFPPGSLSGGNQPQHF	TRBV29-1	TRBJ1-5
TGTGCCAGCAGTTGGACAGGTCGTGGCCCCAGGAACACTGAAGCTTTCTTT	CASSWTGRGPRNTEAFF	TRBV27	TRBJ1-1
TGTGCCAGCGAACCAGGAATAGAGACCCAGTACTTC	CASEPGIETQYF	TRBV6-4	TRBJ2-5
TGTGCCAGCAGCAGATTTAGCCGGGACAGGGGATCCTACGAGCAGTACTTC	CASSRFSRDRGSYEQYF	TRBV7-3	TRBJ2-7
TGTGCCAGCAGTTCATTTCCCTCTTACGGGGTGAGCAATCAGCCCCAGCATTTT	CASSSFPSYGVSNQPQHF	TRBV6-5	TRBJ1-5
TGCGCCAGCAAGCCACTCCTGGACACCTCTATTGGAAAGAACACCGGGGAGCTGTTTTTT	CASKPLLDTSIGKNTGELFF	TRBV10-1	TRBJ2-2
TGTGCCAGCAGCCTGGACCCCGATGAGCAGTTCTTC	CASSLDPDEQFF	TRBV14	TRBJ2-1
TGTGCCAGCAGGTGTCCAGACAGGTTAGCCAAAAACATTCAGTACTTC	CASRCPDRLAKNIQYF	TRBV28	TRBJ2-4
TGCGCCAGCAGCCAAGCCCCGTTGGGGGATACTCCCCCGGGGTACAATGAGCAGTTCTTC	CASSQAPLGDTPPGYNEQFF	TRBV4-1	TRBJ2-1
TGCAGCGTTTCTGGGGTTGCTGAAGCTTTCTTT	CSVSGVAEAFF	TRBV29-1	TRBJ1-1
TGTGCCAGCAGCTTAGACTATTGGGGCCCTGGGGGGATGACCACTGAAGCTTTCTTT	CASSLDYWGPGGMTTEAFF	TRBV11-3	TRBJ1-1
TGTGCCACCAGTGCCATGCTAGATTCCGTGGGGGTCAATTCACCCCTCCACTTT	CATSAMLDSVGVNSPLHF	TRBV24-1	TRBJ1-6
TGTGCTAGTGGGACAATGGGAGTTCAGCCCCAGCATTTT	CASGTMGVQPQHF	TRBV12-5	TRBJ1-5
TGTGCCAGCAGCTTAGGAATACTGGGGGCCAAAAACATTCAGTACTTC	CASSLGILGAKNIQYF	TRBV7-3	TRBJ2-4
TGTGCCAGCAGCCGGGGGAATAATTCACCCCTCCACTTT	CASSRGNNSPLHF	TRBV7-2	TRBJ1-6
TGCTTGGGAGTGTTTACTGAAGCTTTCTTT	CLGVFTEAFF	TRBV20-1	TRBJ1-1
TGTGCCTGGAGGCCCCAAGACACTGGGTATGGCTACACCTTC	CAWRPQDTGYGYTF	TRBV30	TRBJ1-2
TGTGCCAGCAGCCAAGCAGAGGGTACGGCTGAAGCTTTCTTT	CASSQAEGTAEAFF	TRBV3-1	TRBJ1-1
TGTGCCAGCAGTGATCGACAGGGGAATGAGCAGTTCTTC	CASSDRQGNEQFF	TRBV6-5	TRBJ2-1
TGTGCCACCAGCCCCAGGGGCTGGTGTACTGAAGCTTTCTTT	CATSPRGWCTEAFF	TRBV15	TRBJ1-1
TGTGCCGCTGGAGGTACGGACAGGACTTCAGCTAACTATGGCTACACCTTC	CAAGGTDRTSANYGYTF	TRBV10-3	TRBJ1-2
TGTGCCAGCAGTGACTTAGGGAGGGAGGAATCCTATAATTCACCCCTCCACTTT	CASSDLGREESYNSPLHF	TRBV25-1	TRBJ1-6
TGCAGCGCCGGGACTAGGCAGTTCTTC	CSAGTRQFF	TRBV29-1	TRBJ2-1
TGCGCCAGCAGCTTGGCCGGGGGGCCCCGGTACTACGAGCAGTACTTC	CASSLAGGPRYYEQYF	TRBV5-1	TRBJ2-7
TGTGCCAAGTCCCCCGGACGGAACACTGAAGCTTTCTTT	CAKSPGRNTEAFF	TRBV28	TRBJ1-1
TGTGCCAGCAGCAAAGCCGACAGGGCCTCCTACGAGCAGTACTTC	CASSKADRASYEQYF	TRBV7-2	TRBJ2-7
TGTGCCAGCAGTTGGCCGACCCTCCACTTT	CASSWPTLHF	TRBV6-2	TRBJ1-6
TGTGCCAGCAGCTCCCCGCGGACAGGGGAGGTGTCTGGAAACACCATATATTTT	CASSSPRTGEVSGNTIYF	TRBV11-2	TRBJ1-3
TGTGCCAGCAGTGATCCCGGGGTAAGGGACAGCCCGTATGAAAAACTGTTTTTT	CASSDPGVRDSPYEKLFF	TRBV6-1	TRBJ1-4
TGTGCTAAAAACCGGGACCCCCGTGGCTACACCTTC	CAKNRDPRGYTF	TRBV12-5	TRBJ1-2
TGCAGTGCTAGCCATTCCGGGACAGGGTTTCTAGCCTACGAGCAGTACTTC	CSASHSGTGFLAYEQYF	TRBV20-1	TRBJ2-7
TGTGCCAGCAGTTACCGGGGGATAGGGGCATTTCTCAATCAGCCCCAGCATTTT	CASSYRGIGAFLNQPQHF	TRBV6-6	TRBJ1-5
TGCGCCAGCAGCTTGGATAATAACCAACTTGGAAACCATACCTACAATGAGCAGTTCTTC	CASSLDNNQLGNHTYNEQFF	TRBV5-1	TRBJ2-1
TGTGCCAGCAAACCCCCCCAGGACAGCTCCTATAATTCACCCCTCCACTTT	CASKPPQDSSYNSPLHF	TRBV27	TRBJ1-6
TGTGCCAGCAGTCTCCTATGGCCCGGACTAAACACTGAAGCTTTCTTT	CASSLLWPGLNTEAFF	TRBV27	TRBJ1-1
TGTGCCAGTAGTATCGTTAAACCTCTCTCTCACACCGGGGAGCTGTTTTTT	CASSIVKPLSHTGELFF	TRBV19	TRBJ2-2
TGTGCCAGCACGGAAGGGAGTATAACAGATACGCAGTATTTT	CASTEGSITDTQYF	TRBV7-3	TRBJ2-3
TGTGCCAGCAGCCATCAGGGGGGGAACACTGAAGCTTTCTTT	CASSHQGGNTEAFF	TRBV3-1	TRBJ1-1
TGCAGTGCTAGTAGTATAGCGGGGTCCCGCTTC	CSASSIAGSRF	TRBV20-1	TRBJ2-7
TGTGCCAGCAGCGCGTTTTATCTAACCACGTGGCAGACTGAAGCTTTCTTT	CASSAFYLTTWQTEAFF	TRBV7-2	TRBJ1-1
TGCAGTGCTAGCTTCCCCCAGCACGCCGAGGATGGCTACACCTTC	CSASFPQHAEDGYTF	TRBV20-1	TRBJ1-2
TGCGCCAGCAGCCCTCCCGGGGGGCCTACCGGGGAGCTGTTTTTT	CASSPPGGPTGELFF	TRBV4-1	TRBJ2-2
TGTGCCAGCACCGGCGGGGTAGGGGACCAAAATGAAAAACTGTTTTTT	CASTGGVGDQNEKLFF	TRBV9	TRBJ1-4
TGTGCCAGCAGCTTGCTGGCCTACGAGCAGTACTTC	CASSLLAYEQYF	TRBV5-6	TRBJ2-7
TGTGCCAGCAGTTTAGACCCTAGGCGGACAGGGAGAGAGGCAACTAATGAAAAACTGTTTTTT	CASSLDPRRTGREATNEKLFF	TRBV12-3	TRBJ1-4
TGTGCCATCAGTGGACAGGTGGGGATCTTCCTTCTCGGGGACATATACGAGCAGTACTTC	CAISGQVGIFLLGDIYEQYF	TRBV10-3	TRBJ2-7
TGTGCCAGCAGCGTCCAGGCTAACACAGATACGCAGTATTTT	CASSVQANTDTQYF	TRBV9	TRBJ2-3
TGTGCCAGAGCCCTACTAGCGGAAAGCACAGATACGCAGTATTTT	CARALLAESTDTQYF	TRBV12-4	TRBJ2-3
TGTGCCAGCAGAAGGAGCGACACTGAAGCTTTCTTT	CASRRSDTEAFF	TRBV27	TRBJ1-1
TGTGCCAGCAGCTTAAAGCACAGGGTGGCTGAAGCTTTCTTT	CASSLKHRVAEAFF	TRBV7-6	TRBJ1-1
TGTGCCAGCAGTGAACTAGCGGGAGGGCTGCGGTTGGAGACCCAGTACTTC	CASSELAGGLRLETQYF	TRBV28	TRBJ2-5
TGTGCCAGCACCCCGAGGGGCTCCGGGACAGACAACATTCAGTACTTC	CASTPRGSGTDNIQYF	TRBV28	TRBJ2-4
TGCAGTGCTAGTGTCAGGTTAAGGGGAGGCTACGAGCAGTACTTC	CSASVRLRGGYEQYF	TRBV20-1	TRBJ2-7
TGCGCCAGCAAGATAACCGACCAAGAGACCCAGTACTTC	CASKITDQETQYF	TRBV10-1	TRBJ2-5
TGCGCCAGCAGTCCAGCCAACCACAGACTGAACACTGAAGCTTTCTTT	CASSPANHRLNTEAFF	TRBV10-1	TRBJ1-1
TGTGCCAGCAGTTACTCCCCAGGGGGCATCGATCAGCCCCAGCATTTT	CASSYSPGGIDQPQHF	TRBV6-5	TRBJ1-5
TGCCAGACAAAGGCAGACCATAGCAATCAGCCCCAGCATTTT	CQTKADHSNQPQHF	TRBV20-1	TRBJ1-5
TGTGCCAGCAGTGAATCGGATTGGAGTCTCAATGAGCAGTTCTTC	CASSESDWSLNEQFF	TRBV25-1	TRBJ2-1
TGCAGTGCTAGACTTAGGCAGGGGGCCTACGAGCAGTACTTC	CSARLRQGAYEQYF	TRBV20-1	TRBJ2-7
TGTGCCAGTAGTCTGGTTCGGGACATTATATATGGCTACACCTTC	CASSLVRDIIYGYTF	TRBV19	TRBJ1-2
TGTGCCAGCAGTTATGGGACAGGGGTTGCTTTCGAGACCCAGTACTTC	CASSYGTGVAFETQYF	TRBV6-3	TRBJ2-5
TGTGCCAGCAGTTTAATCCGAGGACAGGGGAACACCATATATTTT	CASSLIRGQGNTIYF	TRBV27	TRBJ1-3
TGCAGCGTTGAACGAGACAGGGGCCCTGTCTATGGCTACACCTTC	CSVERDRGPVYGYTF	TRBV29-1	TRBJ1-2
TGCAAGAACCCCGGGGGGGTCCTAGCAGATACGCAGTATTTT	CKNPGGVLADTQYF	TRBV20-1	TRBJ2-3
TGTGCCAGCAGCCCCGGGACAGGGGAAAGCACAGATACGCAGTATTTT	CASSPGTGESTDTQYF	TRBV13	TRBJ2-3
TGTGCCACCAGTGATTCTGCAAGTAAGGGGGAGACTAGCCTTGGGTGCAGCTCCTATAATTCACCCCTCCACTTT	CATSDSASKGETSLGCSSYNSPLHF	TRBV24-1	TRBJ1-6
TGTGCCAGTAGTATAGAGGTTCCGTCTTGGGTCCAATCTAATGAGCAGTTCTTC	CASSIEVPSWVQSNEQFF	TRBV19	TRBJ2-1
TGTGCCAGCAGCCGTAAAGGACAAGAGTTTAGGGATGGCTACACCTTC	CASSRKGQEFRDGYTF	TRBV4-2	TRBJ1-2
TGTGCCAGCAGAGAAGGCATAAGGTCACCCCTCCACTTT	CASREGIRSPLHF	TRBV3-1	TRBJ1-6
TGTGCCAGCAGCTTGTATACCAAACGGCACCTCACTGAAGCTTTCTTT	CASSLYTKRHLTEAFF	TRBV7-9	TRBJ1-1
TGCGCCAGCAGTGAGGTTCCGTTACGTACGAGACAGGGGAATTCGCATCCTCCGGGCTACACCTTC	CASSEVPLRTRQGNSHPPGYTF	TRBV10-1	TRBJ1-2
TGTGCCAGCAGCGAGAGCCTGGGGGCCTATGGCTACACCTTC	CASSESLGAYGYTF	TRBV7-3	TRBJ1-2
TGTGCCAGCAGCCTAGTTGAGACCCAGTACTTC	CASSLVETQYF	TRBV7-2	TRBJ2-5
TGCGCCAGCAGCCAAGTTTCAGGGAGCAATGAGCAGTTCTTC	CASSQVSGSNEQFF	TRBV4-1	TRBJ2-1
TGTGCCACCAGCTCGGTTTCCAGACAGGGAGGGATGAAAGCGAACACCGGGGAGCTGTTTTTT	CATSSVSRQGGMKANTGELFF	TRBV24-1	TRBJ2-2
TGTGCCAGTAAGTCGGGGGGTTTTCCCCAGCATTTT	CASKSGGFPQHF	TRBV19	TRBJ1-5
TGTGCCAGCAGCCGTACAGGGACTATGGTGGGGCCCGAGCAGTACTTC	CASSRTGTMVGPEQYF	TRBV7-8	TRBJ2-7
TGTGCCAGCAGCCAAGATCACCGGGACAATGAAAAACTGTTTTTT	CASSQDHRDNEKLFF	TRBV3-1	TRBJ1-4
TGTGCCAGCAGTTCAGGGCCCTTCGTCACAGATACGCAGTATTTT	CASSSGPFVTDTQYF	TRBV12-3	TRBJ2-3
TGTGCCAGGACCGGGGGACTCTACAATGAGCAGTTCTTC	CARTGGLYNEQFF	TRBV19	TRBJ2-1
TGTGCCAGGGCAGGGGGAGTTAGGGAGACCCAGTACTTC	CARAGGVRETQYF	TRBV6-6	TRBJ2-5
TGTGCCAGCAGCAAGGGGCCCTACGAGCAGTACTTC	CASSKGPYEQYF	TRBV6-2	TRBJ2-7
TGTGCCAGCAGTGGAGACAGGGTTCTCCAGCCCCAGCATTTT	CASSGDRVLQPQHF	TRBV6-4	TRBJ1-5
TGTGCCAGCAGCACCCCCGGGATGTTCTTC	CASSTPGMFF	TRBV9	TRBJ2-1
TGCGCCAGCAGTGAGTGGGACGGATGTCCCCCCACTGAAGCTTTCTTT	CASSEWDGCPPTEAFF	TRBV10-1	TRBJ1-1
TGTGCCAGCAGCCAGAGCGCGGAAGAGGGCCAAGAGACCCAGTACTTC	CASSQSAEEGQETQYF	TRBV4-2	TRBJ2-5
TGTGCCAGCAGCGCGGAGAGAGACAGGGGAGGAGCTGAAGCTTTCTTT	CASSAERDRGGAEAFF	TRBV13	TRBJ1-1
TGCAGTGCTAGAGATCTAACCGGACAGGGCGTATATGAAAAACTGTTTTTT	CSARDLTGQGVYEKLFF	TRBV20-1	TRBJ1-4
TGTGCCATCAGCCCGGGGAGGGACCCTTCTGAAGCTTTCTTT	CAISPGRDPSEAFF	TRBV10-3	TRBJ1-1
TGCGCCAAAGCGGGAAGTGGCTCTGGGGCCAACGTCCTGACTTTC	CAKAGSGSGANVLTF	TRBV5-1	TRBJ2-6
TGTGCCAGCAGTTTAAAAGTCCCTGAGGGAAGCTCCTACGAGCAGTACTTC	CASSLKVPEGSSYEQYF	TRBV27	TRBJ2-7
TGCAGTGCTAGCCCGGAGTCAGGGGTCATTGATCAGCCCCAGCATTTT	CSASPESGVIDQPQHF	TRBV20-1	TRBJ1-5
TGTGCTAGTGGTTCAAAGGCAAAGCGACCTAGACAGGGTGAGCGGAGCTCACCCCTCCACTTT	CASGSKAKRPRQGERSSPLHF	TRBV12-5	TRBJ1-6
TGTGCCAGCAGCCACAGGGCCACAGATACGCAGTATTTT	CASSHRATDTQYF	TRBV7-3	TRBJ2-3
TGCAGTGCTACCGGGGGGGTCTACGAGCAGTACTTC	CSATGGVYEQYF	TRBV20-1	TRBJ2-7
TGTGCCAGCTCACCCTTTGACAGGGTCGGTTCACCCCTCCACTTT	CASSPFDRVGSPLHF	TRBV18	TRBJ1-6
TGTGCCAGCAGCTTACCCTATCCGAAGAGAGAATTTTGCACAGATACGCAGTATTTT	CASSLPYPKREFCTDTQYF	TRBV7-9	TRBJ2-3
TGCAGTTCCCCTCGCCCAGCGGGAGCGAGGGATAGCTACAATGAGCAGTTCTTC	CSSPRPAGARDSYNEQFF	TRBV20-1	TRBJ2-1
TGTGCCAGCAGCCACCCGTTAGGAAAGAGGGGCTACGAGCAGTACTTC	CASSHPLGKRGYEQYF	TRBV13	TRBJ2-7
TGTGCCAGCAGTTATCTCAGCGGCACCTACGAGCAGTACTTC	CASSYLSGTYEQYF	TRBV6-2	TRBJ2-7
TGTGCCAGCAGCCGGTTTCGATCCTACGAGCAGTACTTC	CASSRFRSYEQYF	TRBV6-5	TRBJ2-7
TGTGCCAGCAGCCTGGGACTAGCGGGGGTAGGGGCTTTGGAGCTGTTTTTT	CASSLGLAGVGALELFF	TRBV3-1	TRBJ2-2
