TGTGCCAGCAGCTACAGGGGGGGCTATGGCTACACCTTC	CASSYRGGYGYTF	TRBV7-4	TRBJ1-2
TGTGCCAGCAGCGAGGGACGACGGGGATCCCAGTACTTC	CASSEGRRGSQYF	TRBV6-2	TRBJ2-5
TGTGCCAGCAGTTCTCGGTCTTACAATGAGCAGTTCTTC	CASSSRSYNEQFF	TRBV6-5	TRBJ2-1
TGCGCCAGCAGCTACAACAGCAGGACCCAGTACTTC	CASSYNSRTQYF	TRBV5-1	TRBJ2-5
TGTGCCAGCAGCTTCCGGGCCCTTTGGTACGAGCAGTACTTC	CASSFRALWYEQYF	TRBV9	TRBJ2-7
TGTGCCACTACGGAGCCTGCTAGCACAGATACGCAGTATTTT	CATTEPASTDTQYF	TRBV11-3	TRBJ2-3
TGTGCCAGCAGCCAAGGTACACGGGGGATAATTGACTTC	CASSQGTRGIIDF	TRBV4-2	TRBJ2-7
TGTGCCAGCAGGGGGGGGCGTCTCGCTCCCTACGAGCAGTACTTC	CASRGGRLAPYEQYF	TRBV7-3	TRBJ2-7
TGTGCCAGCAGCAGTTGGGGCCGCACCGGGGAGCTGTTTTTT	CASSSWGRTGELFF	TRBV7-2	TRBJ2-2
TGTGCCAGCAGCAACCCTAACCCCGGGACGTTGAACACTGAAGCTTTCTTT	CASSNPNPGTLNTEAFF	TRBV9	TRBJ1-1
TGCGCCAGCAGCCAAGACACCGTCTTGAGTAGTAGCAATCAGCCCCAGCATTTT	CASSQDTVLSSSNQPQHF	TRBV4-1	TRBJ1-5
TGTGCCATCAGTGAACTTCCTGACAGGGTACCTGGGGCCAACGTCCTGACTTTC	CAISELPDRVPGANVLTF	TRBV10-3	TRBJ2-6
TGTGCCAGCAGCCGTAAAGGAGCGAACACCGGGGAGCTGTTTTTT	CASSRKGANTGELFF	TRBV5-5	TRBJ2-2
TGTGCCAGCAGCTTAGACAACTTGGACAGACGAACGGGTGGGTTCGGCACAGATACGCAGTATTTT	CASSLDNLDRRTGGFGTDTQYF	TRBV11-3	TRBJ2-3
TGTGCCAGCAGTCTGGACCCTAGCGGGGGGGTCTTC	CASSLDPSGGVF	TRBV6-1	TRBJ2-1
TGTGCCAGCAGGAGGGTCCGGGGCACTGAAGCTTTCTTT	CASRRVRGTEAFF	TRBV6-2	TRBJ1-1
TGTGCCAGCAGTTTCGGGGACCCTGGGAACACTGAAGCTTTCTTT	CASSFGDPGNTEAFF	TRBV28	TRBJ1-1
TGTGCCAGTAAGACGCCTCTCAATGAGCAGTTCTTC	CASKTPLNEQFF	TRBV19	TRBJ2-1
TGTGCCAGCAGCGCGACAGGGTTAAGGTCACCCCTCCACTTT	CASSATGLRSPLHF	TRBV7-4	TRBJ1-6
TGTGCCAGCAGCTTAGTAAGCCGCTCCTACAATGAGCAGTTCTTC	CASSLVSRSYNEQFF	TRBV5-8	TRBJ2-1
TGTGCCAGCAGCTTGGAGCCCCGGGCCCCAAAAAGCACAGATACGCAGTATTTT	CASSLEPRAPKSTDTQYF	TRBV5-6	TRBJ2-3
TGTGCCAGCAGCCGGGGCCTTTTGATGACAAAGGGCAATGGCTACACCTTC	CASSRGLLMTKGNGYTF	TRBV14	TRBJ1-2
TGTGCCAGCAGCGTAGGTTGGCTATCCTTTAACTATGGCTACACCTTC	CASSVGWLSFNYGYTF	TRBV9	TRBJ1-2
TGTGCCACTTGGCCCCTGGGGACAGTAGACGAGCAGTACTTC	CATWPLGTVDEQYF	TRBV24-1	TRBJ2-7
TGCGCCAGCAGCTTGGTGAGTTCAAATCAGCCCCAGCATTTT	CASSLVSSNQPQHF	TRBV5-1	TRBJ1-5
TGTGCCCCAAGGGGGAACGAGGAAAAACTGTTTTTT	CAPRGNEEKLFF	TRBV30	TRBJ1-4
TGCGCCAGCAGCAGAACTAGGGGCTCCACCGGGGAGCTGTTTTTT	CASSRTRGSTGELFF	TRBV5-1	TRBJ2-2
TGTGCCAGCAAGAGCACGGACAGACGGCGGGAGACCCAGTACTTC	CASKSTDRRRETQYF	TRBV6-8	TRBJ2-5
TGTGCCAGCAGCAGTACGCGACTAGTGCAGTATTTT	CASSSTRLVQYF	TRBV7-3	TRBJ2-3
TGTGCCAGCAGCTTAAACGAGACAGGGCGGCCGAACACCGGGGAGCTGTTTTTT	CASSLNETGRPNTGELFF	TRBV7-2	TRBJ2-2
TGTGCCAGCAGTCGACACACACACTATGGCTACACCTTC	CASSRHTHYGYTF	TRBV28	TRBJ1-2
TGTGCCAGCAGTGGACATGGGCTAGATACGCAGTATTTT	CASSGHGLDTQYF	TRBV12-4	TRBJ2-3
TGTGCCAGCAGTGTAGGGGAAGAGACCCAGTACTTC	CASSVGEETQYF	TRBV6-4	TRBJ2-5
TGTGCCAGCAGCGTAACCCGCCAACATGGCTATGGCTACACCTTC	CASSVTRQHGYGYTF	TRBV9	TRBJ1-2
TGTGCCAGCAGCTTAGGCCCCTTGCAGCAGGCGGGAACCAAAAACATTCAGTACTTC	CASSLGPLQQAGTKNIQYF	TRBV7-3	TRBJ2-4
TGTGCCAGCAGCATGTTGGACAGTGCAACTAATGAAAAACTGTTTTTT	CASSMLDSATNEKLFF	TRBV5-6	TRBJ1-4
TGTGCCAGCAGTTACTCGTCCCCGAGGGGGCCTAACCACTATGGCTACACCTTC	CASSYSSPRGPNHYGYTF	TRBV6-6	TRBJ1-2
TGTGCCAGCAGCTTAGTCGACGGACTAGCGTATGAGCAGTTCTTC	CASSLVDGLAYEQFF	TRBV7-9	TRBJ2-1
TGTGCCAGCAGCCGGGAGTGGGGAGGAGTAAACATTCAGTACTTC	CASSREWGGVNIQYF	TRBV3-1	TRBJ2-4
TGTGATACGTGCCAAGGGGGGAGGAAGAACACCGGGGAGCTGTTTTTT	CDTCQGGRKNTGELFF	TRBV27	TRBJ2-2
TGTGCCAGCAGTGGTAACCAGGATTCTAACAATGAGCAGTTCTTC	CASSGNQDSNNEQFF	TRBV6-1	TRBJ2-1
TGTGCCAGCAGCGCCGGGACGGGGTACTTC	CASSAGTGYF	TRBV7-3	TRBJ2-5
TGTGCCAGCAGTTCGACAGGGGAACCAGGGGTCTACGAGCAGTACTTC	CASSSTGEPGVYEQYF	TRBV6-4	TRBJ2-7
TGCAGTGCTAGCCCTAACAGGGGGCATGCTGAAGCTTTCTTT	CSASPNRGHAEAFF	TRBV20-1	TRBJ1-1
TGCAGTGAGCGAGGGGACAGACTAACAGATACGCAGTATTTT	CSERGDRLTDTQYF	TRBV20-1	TRBJ2-3
TGTGCCGCAACTGGCAGGGCCTACCAGACTAATCAGCCCCAGCATTTT	CAATGRAYQTNQPQHF	TRBV19	TRBJ1-5
TGTGCCAGCAGCCAAGATGGACAGGGTGGCTACACCTTC	CASSQDGQGGYTF	TRBV4-2	TRBJ1-2
TGCAGTGCTAGAGTCAAAAACTGGCACCCAATTGGCGAGCAGTACTTC	CSARVKNWHPIGEQYF	TRBV20-1	TRBJ2-7
TGTGCCAGCAGTTACCCCAGGGACAGGGGGGGGACGCAGTACTTC	CASSYPRDRGGTQYF	TRBV6-2	TRBJ2-5
TGTGCCACCAGCAGAGCCCCGAAATATGAGCAGTACTTC	CATSRAPKYEQYF	TRBV15	TRBJ2-7
TGTGCCAGCAGCAGGGCGGGACAGGCGAAGGGAAACATTCAGTACTTC	CASSRAGQAKGNIQYF	TRBV7-3	TRBJ2-4
TGTGCCAGCAGCTTGATTCGCGCCGAGACCCAGTACTTC	CASSLIRAETQYF	TRBV7-2	TRBJ2-5
TGTGCCAGCAGCTCCCGGACTAGCCGTCGAGGAGTTGGGGACTCCTACGAGCAGTACTTC	CASSSRTSRRGVGDSYEQYF	TRBV11-3	TRBJ2-7
TGCAGTGCTAGTATCGGGACAGGGCTCACACACGACGGAAACACCATATATTTT	CSASIGTGLTHDGNTIYF	TRBV20-1	TRBJ1-3
TGTGCCAGCAGTGTGATCGGGCTGGAGCAGTTCTTC	CASSVIGLEQFF	TRBV6-1	TRBJ2-1
TGTGCCAGCAGCTTAACCCGACACAATTCACCCCTCCACTTT	CASSLTRHNSPLHF	TRBV7-2	TRBJ1-6
TGTGCCAGCAAAGACGGGCGAGAGGGAGGCTATGGCTACACCTTC	CASKDGREGGYGYTF	TRBV6-6	TRBJ1-2
TGTGCCCGGGGCCGGAGGGGGGAGAATGAGCAGTTCTTC	CARGRRGENEQFF	TRBV7-8	TRBJ2-1
TGTGCCAGCAGGAAGAAGAGACAGGGAGGCCTTAAAAATCAGCCCCAGCATTTT	CASRKKRQGGLKNQPQHF	TRBV27	TRBJ1-5
TGCAGCCGACAGGGGGCGAGGACCCATAGCAATCAGCCCCAGCATTTT	CSRQGARTHSNQPQHF	TRBV20-1	TRBJ1-5
TGTGCCAGACCCGTGGGGGGGGGGGACTCCTACGAGCAGTACTTC	CARPVGGGDSYEQYF	TRBV19	TRBJ2-7
TGCGCCAGCAGACTGGGGACCGGGGGGCACGAGCAGTACTTC	CASRLGTGGHEQYF	TRBV5-1	TRBJ2-7
TGCAGCGTTCTGAGGGGGGAGGGCGGGAGAACCTACGAGCAGTACTTC	CSVLRGEGGRTYEQYF	TRBV29-1	TRBJ2-7
TGTGCCAGCAGTAGGGGCTTGAATCAGCCCCAGCATTTT	CASSRGLNQPQHF	TRBV6-5	TRBJ1-5
TGTGCCCGTCCGGGGTTAGGGCCTTCCTACAATGAGCAGTTCTTC	CARPGLGPSYNEQFF	TRBV10-3	TRBJ2-1
TGTGCCAGCAAAAGACTGGGACGCGCGGACAACGAGCAGTACTTC	CASKRLGRADNEQYF	TRBV6-4	TRBJ2-7
TGTGCCAGCTCACCAGGCGTAGGTTTCACAGATACGCAGTATTTT	CASSPGVGFTDTQYF	TRBV18	TRBJ2-3
TGTGCCAGTAGTATGGGCCTGGATCAGACCTATAATTCACCCCTCCACTTT	CASSMGLDQTYNSPLHF	TRBV19	TRBJ1-6
TGTGCCAGCAGTCTGGACAGGGGCTACGAGCAGTACTTC	CASSLDRGYEQYF	TRBV6-3	TRBJ2-7
TGTGCCAGCAGCAAAAAGGGGCCCAGCTCCTACGAGCAGTACTTC	CASSKKGPSSYEQYF	TRBV7-3	TRBJ2-7
TGTGCCATCAGTGAGTCGATAGGGGAGAGTGGGGATAGCTCCTACGAGCAGTACTTC	CAISESIGESGDSSYEQYF	TRBV10-3	TRBJ2-7
TGTGCCAGCAGCTTCGACAGCGGGGAGCTGTTTTTT	CASSFDSGELFF	TRBV13	TRBJ2-2
TGTGCCAGCAGTGACCCACGGGGGGGGCTCAACAATGAGCAGTTCTTC	CASSDPRGGLNNEQFF	TRBV6-4	TRBJ2-1
TGTGCCAGCAGCCAGACTAGCGGCCCGATAAACACCGGGGAGCTGTTTTTT	CASSQTSGPINTGELFF	TRBV6-5	TRBJ2-2
TGTGCCACCAGCAGAGAGGGACAGGGCCCTAGCAATCAGCCCCAGCATTTT	CATSREGQGPSNQPQHF	TRBV15	TRBJ1-5
TGTGCCAGCAGCGCCCCGGGACCCGGGGACTACAATGAGCAGTTCTTC	CASSAPGPGDYNEQFF	TRBV13	TRBJ2-1
TGCGCCAGCAGCTGCAGGACTAGGTATGTGGACGAGCAGTACTTC	CASSCRTRYVDEQYF	TRBV5-1	TRBJ2-7
TGTGCCAGCAGCGAGGAGGCTAGACTTCGATACAATGAGCAGTTCTTC	CASSEEARLRYNEQFF	TRBV5-4	TRBJ2-1
TGTGCCAGCAGTTCCAGACAGGGTAGACATTCCAATGAGCAGTTCTTC	CASSSRQGRHSNEQFF	TRBV6-6	TRBJ2-1
TGTGCCAGCAGTTTGACAGGGGGGAAAGGCAATCAGCCCCAGCATTTT	CASSLTGGKGNQPQHF	TRBV28	TRBJ1-5
TGCAGTGCCGTGGGGACTAGCGGCACAGATACGCAGTATTTT	CSAVGTSGTDTQYF	TRBV20-1	TRBJ2-3
TGTGCCACCAGTGGCGAAACTAGCCGGACGCAGTATTTT	CATSGETSRTQYF	TRBV24-1	TRBJ2-3
TGTGCCAGCAGCGGCCGTCCCCCCGGGACTAGCGGGAGCCGGGGTCCGGGGGGGATAGAGCAGTACTTC	CASSGRPPGTSGSRGPGGIEQYF	TRBV9	TRBJ2-7
TGTGCCAGCAGTAGGTTGTGTTCCAGACAGGGGAGAGATACGCAGTATTTT	CASSRLCSRQGRDTQYF	TRBV14	TRBJ2-3
TGTGCCAGCAGCGTACCAGGGACTGGCAGCGAGCAGTACTTC	CASSVPGTGSEQYF	TRBV9	TRBJ2-7
TGTGCCAGCGGTAATAGTCGGGGGGCTGTCAGGGCCAGGACGCATTTT	CASGNSRGAVRARTHF	TRBV6-5	TRBJ1-5
TGTGCCACCAGTGACCTAACGGTGACAAGTGTCTACGAGCAGTACTTC	CATSDLTVTSVYEQYF	TRBV24-1	TRBJ2-7
TGTGCCAGCAGCCAAGCTGGGCGGGACTATGGCTACACCTTC	CASSQAGRDYGYTF	TRBV3-1	TRBJ1-2
TGTGCCAGCAGCGAATGGATTCGGGGCTCCTACGAGCAGTACTTC	CASSEWIRGSYEQYF	TRBV7-2	TRBJ2-7
TGTGCCAGCAGCTTAACAGACAAGGTGGTTGCGTGCGAAAACACCATATATTTT	CASSLTDKVVACENTIYF	TRBV7-4	TRBJ1-3
TGTGCCAGCAGCCTCGCGCCTAGGTGTGAAGCTTTCTTT	CASSLAPRCEAFF	TRBV3-1	TRBJ1-1
TGTGCCATGTTGGACAGCTATGGCTACACCTTC	CAMLDSYGYTF	TRBV13	TRBJ1-2
TGCAGTGCTAGTGACCGGGACAGAGGTTACATAGATGGCGATAGCAATCAGCCCCAGCATTTT	CSASDRDRGYIDGDSNQPQHF	TRBV20-1	TRBJ1-5
TGCGCCAGCAGCTCAACCGGTAGCACTGAAGCTTTCTTT	CASSSTGSTEAFF	TRBV5-1	TRBJ1-1
TGTGCCAGCAGTTACGTCAGACAGGGGCACTACTCTGGAAACACCATATATTTT	CASSYVRQGHYSGNTIYF	TRBV6-2	TRBJ1-3
TGTGCCAGCAGCTGGACGGGTCCCCCCAGGGACAGTCTCGACGAGCAGTACTTC	CASSWTGPPRDSLDEQYF	TRBV7-3	TRBJ2-7
TGCGCCAGCAATGGGGGCATCTCCTACGAGCAGTACTTC	CASNGGISYEQYF	TRBV5-1	TRBJ2-7
TGCGCCAGCAGGAAAGGACAGGGGCCACCGTTCTACGAGCAGTACTTC	CASRKGQGPPFYEQYF	TRBV5-1	TRBJ2-7
TGTGCCAGCAGCATCTGTACGCAGTATTTT	CASSICTQYF	TRBV7-9	TRBJ2-3
TGCAGTGCCTCCCCCCGGACAGGAGTGAACACTGAAGCTTTCTTT	CSASPRTGVNTEAFF	TRBV20-1	TRBJ1-1
TGTGCCAGCAGCGTAAGGAGCAGTTGGCAGCCCCAGCATTTT	CASSVRSSWQPQHF	TRBV7-3	TRBJ1-5
TGTGCCAGCAGCAGCCGGGGCCCCTACAATGAGCAGTTCTTC	CASSSRGPYNEQFF	TRBV11-3	TRBJ2-1
TGTGCCAGCATCACCGGTATGGACAGATTCATGAACACTGAAGCTTTCTTT	CASITGMDRFMNTEAFF	TRBV5-5	TRBJ1-1
TGTGCCAGCAGCTATCGGACAGGCCAGTCACCCCTCCACTTT	CASSYRTGQSPLHF	TRBV11-3	TRBJ1-6
TGTGCCAACGGCCGGGACGGCGGCAATCAGCCCCAGCATTTT	CANGRDGGNQPQHF	TRBV6-4	TRBJ1-5
TGTGCCAGCAGCTTTCCTGGGAGGGTCTCTGGGGCCAACGTCCTGACTTTC	CASSFPGRVSGANVLTF	TRBV5-8	TRBJ2-6
TGTGCCATAAACGGGACTAGTTTCGAGCAGTACTTC	CAINGTSFEQYF	TRBV18	TRBJ2-7
TGTGCCAGCAGCTCAACTAGCGGGATCGGGGAGCTGTTTTTT	CASSSTSGIGELFF	TRBV4-2	TRBJ2-2
TGTGCCAGCAGCCAAGATCTTTGTGGACTCCCCGGGGAATACGAGCAGTACTTC	CASSQDLCGLPGEYEQYF	TRBV3-1	TRBJ2-7
TGTGCCAGCAGCTCCCACGGGGACAGAGGGGAGACCCAGTACTTC	CASSSHGDRGETQYF	TRBV13	TRBJ2-5
TGTGCCAGCAGTGGGGGCAGATCCTCTGGAAACACCATATATTTT	CASSGGRSSGNTIYF	TRBV2	TRBJ1-3
TGTGCCAGTAGTATCTCGGGACAGGGGGGGACTGATACGCAGTATTTT	CASSISGQGGTDTQYF	TRBV19	TRBJ2-3
TGTGCCAGCAGTGAGTTGTACCGGACAGGGGTAAGCCGTTTTTACACCGGGGAGCTGTTTTTT	CASSELYRTGVSRFYTGELFF	TRBV6-4	TRBJ2-2
TGTGCCAGCAGCCAAGCACAGGGGGCCACCGGGGAGCTGTTTTTT	CASSQAQGATGELFF	TRBV3-1	TRBJ2-2
TGCGCCAGCAGCAGCTGGGATAAGACAGGGGCTTTCTTT	CASSSWDKTGAFF	TRBV4-3	TRBJ1-1
TGTGCCAGCAGCGGAGAGGCCTACGAGCAGTACTTC	CASSGEAYEQYF	TRBV7-4	TRBJ2-7
TGTGCCAGCAGTCCTTGGGGACGGGAGGACAGGATTTACAATGAGCAGTTCTTC	CASSPWGREDRIYNEQFF	TRBV6-3	TRBJ2-1
TGCGCCAGCAGCTCACAGGGGGGGCGTCTCTACGAGCAGTACTTC	CASSSQGGRLYEQYF	TRBV5-1	TRBJ2-7
TGTGCCACCAGTCTCCCGTGGACAGGGGTCGTCATGAACACTGAAGCTTTCTTT	CATSLPWTGVVMNTEAFF	TRBV24-1	TRBJ1-1
TGTGCTAGTGGTTTGGCGACAGGATATAGCAATCAGCCCCAGCATTTT	CASGLATGYSNQPQHF	TRBV12-5	TRBJ1-5
TGCGCCAGCAGGCTAGGGACTGAAGCTTTCTTT	CASRLGTEAFF	TRBV4-1	TRBJ1-1
TGTGCTGACAGGCATTCCCAGTACTTC	CADRHSQYF	TRBV11-3	TRBJ2-5
TGCTTAGGGGGGACTAATGAAAAACTGTTTTTT	CLGGTNEKLFF	TRBV20-1	TRBJ1-4
TGTGCCTGGAGTGTACCGACGACAGAGCAGTACTTC	CAWSVPTTEQYF	TRBV30	TRBJ2-7
TGTGCCAGCAGCGGTAGAAAGTCCACTGAAGCTTTCTTT	CASSGRKSTEAFF	TRBV7-3	TRBJ1-1
TGTGCCAGCAGCCCTTCCCAGGGTTCCGGAAACACCATATATTTT	CASSPSQGSGNTIYF	TRBV5-4	TRBJ1-3
TGCAGTGCTACATTGACAGACTCCTACAATGAGCAGTTCTTC	CSATLTDSYNEQFF	TRBV20-1	TRBJ2-1
TGTGCCAGCAGCCCGCAGGCGAACACCGGGGAGCTGTTTTTT	CASSPQANTGELFF	TRBV6-5	TRBJ2-2
TGTGCCACCAGTGAGGCTGGAAAGGCAGATACGCAGTATTTT	CATSEAGKADTQYF	TRBV24-1	TRBJ2-3
TGCGCCAGCACGCGGACCCTCGGCTACACCTTC	CASTRTLGYTF	TRBV10-2	TRBJ1-2
TGTGCCAGCAGTTTAGGGGGGGGGGGAAGCTCCTACAATGAGCAGTTCTTC	CASSLGGGGSSYNEQFF	TRBV27	TRBJ2-1
TGTGCCAGCTCACCGCTAGCGGGCAGTCAAGAGACCCAGTACTTC	CASSPLAGSQETQYF	TRBV18	TRBJ2-5
TGCAGTGCTAGCCCCCCGGGGTGGCGCTATGGCTACACCTTC	CSASPPGWRYGYTF	TRBV20-1	TRBJ1-2
TGCGCCAGCATTAGGGAAAATTGCAATCAGCCCCAGCATTTT	CASIRENCNQPQHF	TRBV10-2	TRBJ1-5
TGCGCCAGCAGCGATAGAGAGGGGGGCCGAATCAATGAAAAACTGTTTTTT	CASSDREGGRINEKLFF	TRBV4-1	TRBJ1-4
TGCAGTGCTAGAGCGGCGGGAGGGGACAATGAGCAGTTCTTC	CSARAAGGDNEQFF	TRBV20-1	TRBJ2-1
TGTGCCTGGAGTGTACTTCTATTTGACAGGGTGATGGATCAGCCCCAGCATTTT	CAWSVLLFDRVMDQPQHF	TRBV30	TRBJ1-5
TGCGCCAGCGACACAGGGGACCTGACAGGAGAGACCCAGTACTTC	CASDTGDLTGETQYF	TRBV4-3	TRBJ2-5
TGCAGTGCTAGACCAACAGGGCTGGTAAGCTACAATGAGCAGTTCTTC	CSARPTGLVSYNEQFF	TRBV20-1	TRBJ2-1
TGCGCCACTGACAGGGGAGGGCGCGGAAACACCATATATTTT	CATDRGGRGNTIYF	TRBV5-1	TRBJ1-3
TGCAGTGCTAGAGGTGGGGGGATCCTCTTC	CSARGGGILF	TRBV20-1	TRBJ2-1
TGTGCCAGCAGCATCTACGGGAACAATCAGCCCCAGCATTTT	CASSIYGNNQPQHF	TRBV9	TRBJ1-5
TGTGCCAGCAGCCGACGACTAGCGGGAGTACAAGAGACCCAGTACTTC	CASSRRLAGVQETQYF	TRBV7-3	TRBJ2-5
TGTGCCAGCAGTTACTCGGACAGGGCCTACGAGCAGTACTTC	CASSYSDRAYEQYF	TRBV6-3	TRBJ2-7
TGTGCCAGCGCCTGTGTGGGGAATGAGACCCAGTACTTC	CASACVGNETQYF	TRBV12-3	TRBJ2-5
TGTGCCAGCAGTTGTGGGGGGGTCACCGGGGAGCTGTTTTTT	CASSCGGVTGELFF	TRBV6-5	TRBJ2-2
TGTGCCAGTAGTATAAGGCACAGGAGAGGGGGGACTGAAGCTTTCTTT	CASSIRHRRGGTEAFF	TRBV19	TRBJ1-1
TGTGCCAGCAGCTCCCCCTTACAGGGGGCCGCACGTGAAAAACTGTTTTTT	CASSSPLQGAAREKLFF	TRBV13	TRBJ1-4
TGCGCCAGCAGCTGTGAGGGGGCGTGCCAGCCCCAGCATTTT	CASSCEGACQPQHF	TRBV5-1	TRBJ1-5
TGTGCCAGCAGCGACTTTAGAGGTAACACAGATACGCAGTATTTT	CASSDFRGNTDTQYF	TRBV7-6	TRBJ2-3
TGTGCCAGCAGTGACCCTAGTATTAACTTTCTAGAGACCCAGTACTTC	CASSDPSINFLETQYF	TRBV6-4	TRBJ2-5
TGTGCCAGCAGCTTTAGTATCTCTGGGGGGAGGGAGCAGTACTTC	CASSFSISGGREQYF	TRBV7-3	TRBJ2-7
TGTGCCACCAGCAGTCCGGTGGCGAGACAGGGTCCTCAAGGGAACCATTGTCTTGGCTACACCTTC	CATSSPVARQGPQGNHCLGYTF	TRBV15	TRBJ1-2
TGCAGCGGACCATCCGGGACAGGATGCACGCAGTATTTT	CSGPSGTGCTQYF	TRBV29-1	TRBJ2-3
TGTGCCAGCAGTTACGGGGGGGACGAGCAGTACTTC	CASSYGGDEQYF	TRBV6-2	TRBJ2-7
TGTGCCAGCAGCTTAGCCCTCTCCCAGGGGCCTGAAGCTTTCTTT	CASSLALSQGPEAFF	TRBV11-3	TRBJ1-1
TGTGCCAGCAGTGAGGGACCGCAGCCCCAGCATTTT	CASSEGPQPQHF	TRBV6-1	TRBJ1-5
TGTGCCAGCAGTGACGGTGAGGGGGGCTACAATGAGCAGTTCTTC	CASSDGEGGYNEQFF	TRBV6-1	TRBJ2-1
TGCGCCAGCAGCAAATGCACAGGGATGGGGTATAGCAATCAGCCCCAGCATTTT	CASSKCTGMGYSNQPQHF	TRBV5-1	TRBJ1-5
TGTGCCAGCAGCTTGCCAACTCATGACGGGGAGGATGGCTACACCTTC	CASSLPTHDGEDGYTF	TRBV5-6	TRBJ1-2
TGCAGTGCTAGAAGACACGGAGACTACGAGCAGTACTTC	CSARRHGDYEQYF	TRBV20-1	TRBJ2-7
TGCAGTGCCCCCGAACACGAGCAGTACTTC	CSAPEHEQYF	TRBV20-1	TRBJ2-7
TGCAGTGCAAAAGGCCAGATAGAAAAACTGTTTTTT	CSAKGQIEKLFF	TRBV20-1	TRBJ1-4
TGTGCCAGCAGCTTCGGGCTAGCAAGTTCCTACAATGAGCAGTTCTTC	CASSFGLASSYNEQFF	TRBV5-4	TRBJ2-1
TGTGCCAGCAGCAACGCAGGGGTAAGACGAGGAGAAAAACTGTTTTTT	CASSNAGVRRGEKLFF	TRBV7-9	TRBJ1-4
TGTGCCAGCAGCTTGGGGGCACTCTATGGCTACACCTTC	CASSLGALYGYTF	TRBV11-3	TRBJ1-2
TGCGCCAGCAGCTACCAACAGGGGGTCCCGGGAGATAGCAATCAGCCCCAGCATTTT	CASSYQQGVPGDSNQPQHF	TRBV5-1	TRBJ1-5
TGTGCCAGCAGTTTAGCGGGAGGGGGGCTCTCCTACGAGCAGTACTTC	CASSLAGGGLSYEQYF	TRBV2	TRBJ2-7
TGTGCCAGCAGCATTAAGCTAGCGGCCCCAGATACGCAGTATTTT	CASSIKLAAPDTQYF	TRBV13	TRBJ2-3
TGTGCCAGCAGTAGGACAGGGTCAGATTCACCCCTCCACTTT	CASSRTGSDSPLHF	TRBV6-6	TRBJ1-6
TGCGCCAGCAGGGGAAACTATGGCTACACCTTC	CASRGNYGYTF	TRBV4-3	TRBJ1-2
TGTGCCAGCAGCCCCTGGGGACTGAACACTGAAGCTTTCTTT	CASSPWGLNTEAFF	TRBV28	TRBJ1-1
TGTGCCAGCACCCGGGACAATGGCTACACCTTC	CASTRDNGYTF	TRBV6-4	TRBJ1-2
TGTGCCAGCAGTGCGGTGCGGGAGCTTCTAGCCAAAAACATTCAGTACTTC	CASSAVRELLAKNIQYF	TRBV25-1	TRBJ2-4
TGTGCCAGCAGCTTGGACAGGGGGCATACTTCTGGGGCCAACGTCCTGACTTTC	CASSLDRGHTSGANVLTF	TRBV11-3	TRBJ2-6
TGTGCCATCAGTGAAATAATAATTTTAGGTGAAGAGACCCAGTACTTC	CAISEIIILGEETQYF	TRBV10-3	TRBJ2-5
TGTGCCAGCAGCCAAGGATCTACGGGAGGGACCTTCCCGGGGGAGAACTACGAGCAGTACTTC	CASSQGSTGGTFPGENYEQYF	TRBV4-2	TRBJ2-7
TGTGCCAGCAGTGCTGGACTAGCGGGAGACTACGAGCAGTACTTC	CASSAGLAGDYEQYF	TRBV6-4	TRBJ2-7
TGTGCCAGCAGCCCAGGGCTTATGAACTACGAGCAGTACTTC	CASSPGLMNYEQYF	TRBV13	TRBJ2-7
TGTGCCACAATACAGGGTCCAGGCTACACCTTC	CATIQGPGYTF	TRBV6-4	TRBJ1-2
TGTGCCAGCAGTTTATGCGCCCTCATCGCCTATAGGAGCCCCTATGGCTACACCTTC	CASSLCALIAYRSPYGYTF	TRBV28	TRBJ1-2
TGTGCCAGCAGTGACGAGAGGGGCCTCGAGAACACCGGGGAGCTGTTTTTT	CASSDERGLENTGELFF	TRBV6-4	TRBJ2-2
TGTGCCAGCAGATACCTCCCTTGTGCTAGATCAGGGGCCGACGCCTACTCGAGCTCCTATAATTCACCCCTCCACTTT	CASRYLPCARSGADAYSSSYNSPLHF	TRBV5-6	TRBJ1-6
TGTGCCAGCTCACCACCGCCCGGGGTATTCGGGAGCAATCAGCCCCAGCATTTT	CASSPPPGVFGSNQPQHF	TRBV18	TRBJ1-5
TGTGCCAGCAGACGCCGTTGTACGCATACCGGGGAGCTGTTTTTT	CASRRRCTHTGELFF	TRBV12-3	TRBJ2-2
TGTGCCCCCTACAACGAGGGGAACAATGAGCAGTTCTTC	CAPYNEGNNEQFF	TRBV25-1	TRBJ2-1
TGCAGTGCTAGAGGCAACGACCAGGGGTCCCTCCACTTT	CSARGNDQGSLHF	TRBV20-1	TRBJ1-6
TGTGCCACGACACGGACAGGGGTTAGCACTGAAGCTTTCTTT	CATTRTGVSTEAFF	TRBV10-3	TRBJ1-1
TGTGCCAGCAGCCCCAGGGAACGGGACAATGAGCAGTTCTTC	CASSPRERDNEQFF	TRBV6-1	TRBJ2-1
TGCAGTGCTAGCCGGCATTTCAGCTCTGGAAACACCATATATTTT	CSASRHFSSGNTIYF	TRBV20-1	TRBJ1-3
TGTGCCATGATCAATCGCTCCCGTTGGGACAGGTATGGCTACACCTTC	CAMINRSRWDRYGYTF	TRBV7-9	TRBJ1-2
TGTGCCAGCAGGGGTTACGGACAGGGGGGGGCGAACACCGGGGAGCTGTTTTTT	CASRGYGQGGANTGELFF	TRBV6-2	TRBJ2-2
TGTGCCAGCAGTCTACAGGGCCATCAGCCCCAGCATTTT	CASSLQGHQPQHF	TRBV2	TRBJ1-5
TGTGCCAGCAGCTACGTTATCGGGATCACAGATACGCAGTATTTT	CASSYVIGITDTQYF	TRBV13	TRBJ2-3
TGTGCCAGCAGAAAAAGGGGGGCCGACTATGGCTACACCTTC	CASRKRGADYGYTF	TRBV6-5	TRBJ1-2
TGTGCCGCCGCAGACAGGGCCATTTCCTACGAGCAGTACTTC	CAAADRAISYEQYF	TRBV5-6	TRBJ2-7
TGTGCCAGCAGCTTAAAGACACCAGTGACCTACTATAATTCACCCCTCCACTTT	CASSLKTPVTYYNSPLHF	TRBV5-4	TRBJ1-6
TGCAGTGCTAGAGTCGGGGGGGCCCACACCGGGGAGCTGTTTTTT	CSARVGGAHTGELFF	TRBV20-1	TRBJ2-2
TGTGCCAGCAGCTTCCTCACAGGGTCTACCTACGAGCAGTACTTC	CASSFLTGSTYEQYF	TRBV7-9	TRBJ2-7
TGTGCCAACCCGGACATTGGAAGGGATACGCAGTATTTT	CANPDIGRDTQYF	TRBV9	TRBJ2-3
TGTGCCAGCAGCGCGGACTCTGTGCATGGTCAGCATTTT	CASSADSVHGQHF	TRBV11-3	TRBJ1-5
TGTGCCACCAGTGATGAGGGGGACACCTACGAGCAGTACTTC	CATSDEGDTYEQYF	TRBV24-1	TRBJ2-7
TGTGCCACCAGTGATGGACGCTATGCCCCAGGCTACACCTTC	CATSDGRYAPGYTF	TRBV24-1	TRBJ1-2
TGTGCCAGCAGTTCTGGCAGACAGGGGACCACGAACACTGAAGCTTTCTTT	CASSSGRQGTTNTEAFF	TRBV27	TRBJ1-1
TGCGCCAGCATAACTAGCGGATGGCCAGGGACAGATACGCAGTATTTT	CASITSGWPGTDTQYF	TRBV5-1	TRBJ2-3
TGCAGTGCTACCGAGGTTGCAGGGGGCACAGATACGCAGTATTTT	CSATEVAGGTDTQYF	TRBV20-1	TRBJ2-3
TGTGCCAGCAGCACAAGACCCCCGTCTGGAAACACCATATATTTT	CASSTRPPSGNTIYF	TRBV7-8	TRBJ1-3
TGTGCCAGCAGCCGGGACGATAGCAATCAGCCCCAGCATTTT	CASSRDDSNQPQHF	TRBV7-9	TRBJ1-5
TGTGCCAGCAGCGGGCGGACAGAGACCGGGGAGCTGTTTTTT	CASSGRTETGELFF	TRBV7-2	TRBJ2-2
TGCAGTGCTAGGGGGCTGAATGAAAAACTGTTTTTT	CSARGLNEKLFF	TRBV20-1	TRBJ1-4
TGTGCCGGGTTGGACAGGGGAAGCCGGGGTAATCAGCCCCAGCATTTT	CAGLDRGSRGNQPQHF	TRBV10-3	TRBJ1-5
TGTGCCCCCGGACAGGGGCTCACAGATACGCAGTATTTT	CAPGQGLTDTQYF	TRBV19	TRBJ2-3
TGTGCCAGCATTGGGGGGGTTTCACCCCTCCACTTT	CASIGGVSPLHF	TRBV5-4	TRBJ1-6
TGTGCCAGCAGCTCAATTTGGGGGCAAAGGTGTTCGATAGATAGCAATCAGCCCCAGCATTTT	CASSSIWGQRCSIDSNQPQHF	TRBV7-7	TRBJ1-5
TGTGCCAGCAGCGTAGTAGCAGGGGGAAATCAGCCCCAGCATTTT	CASSVVAGGNQPQHF	TRBV9	TRBJ1-5
TGTGCCAGCAGCCAAGACCAGACCCGTTCCCAATCAAGTGAAGCTTTCTTT	CASSQDQTRSQSSEAFF	TRBV14	TRBJ1-1
TGCAGTGCTAGGGCTACCCGGCAAGGCTTCACGCAGTTCTTC	CSARATRQGFTQFF	TRBV20-1	TRBJ2-1
TGCAGTGCTAGAGATCCAGGGGAGGAGGTGAACACTGAAGCTTTCTTT	CSARDPGEEVNTEAFF	TRBV20-1	TRBJ1-1
TGTGCCAGCAGCATAGCAGAGTCAATTGGGGCCAACGTCCTGACTTTC	CASSIAESIGANVLTF	TRBV7-3	TRBJ2-6
TGTGCCACCAGTGTCTGTCTCAGGGACAATGAGCAGTTCTTC	CATSVCLRDNEQFF	TRBV24-1	TRBJ2-1
TGTGCCAGCAGCTCCGCCCAGCGCGGGAGGAGTTCGCTGTACAATGAGCAGTTCTTC	CASSSAQRGRSSLYNEQFF	TRBV7-3	TRBJ2-1
TGCAGCAGGGGGAACTACGAGCAGTACTTC	CSRGNYEQYF	TRBV29-1	TRBJ2-7
TGCAGTGCTAGATCTTCGGGGGATGGGCACAATGAGCAGTTCTTC	CSARSSGDGHNEQFF	TRBV20-1	TRBJ2-1
TGCAGTGCCCACTTAGCAGTCGAGCAGTACTTC	CSAHLAVEQYF	TRBV20-1	TRBJ2-7
TGTGCCAGCTACAGCTCAGAGCGGGGGCGCATGGTCACTGAAGCTTTCTTT	CASYSSERGRMVTEAFF	TRBV27	TRBJ1-1
TGTGCCTGGAGAAGGATCTCTCCGGGACTAGCGGGAACCACAGATACGCAGTATTTT	CAWRRISPGLAGTTDTQYF	TRBV30	TRBJ2-3
TGTGCCAGCAGCTGGGGGACTAGCGGCAACTTTTTATTCGAGACCCAGTACTTC	CASSWGTSGNFLFETQYF	TRBV7-8	TRBJ2-5
TGTGCCAGCAGCCACCGCGGACAGGGGGCAGATACGCAGTATTTT	CASSHRGQGADTQYF	TRBV3-1	TRBJ2-3
TGTGCCAACCCGGGGCACGATTCACCCCTCCACTTT	CANPGHDSPLHF	TRBV2	TRBJ1-6
TGTGCCAGCAGCGGGGCACAGGGGCGGCTAGATACGCAGTATTTT	CASSGAQGRLDTQYF	TRBV9	TRBJ2-3
TGTGCCAGCAAAGCCCGAGGGATGGGCGTGGGAGAAAAACTGTTTTTT	CASKARGMGVGEKLFF	TRBV11-1	TRBJ1-4
TGTGCCTGGAGTGCAAGCGCAAGACAGGTCAATCAGCCCCAGCATTTT	CAWSASARQVNQPQHF	TRBV30	TRBJ1-5
TGTGCCAGCAGCTCCGGCCGGGGACTAGCGGGGGAAGAGACCCAGTACTTC	CASSSGRGLAGEETQYF	TRBV13	TRBJ2-5
TGTGCCAGCAAGACAAGGGGACAGGGGGCCGGTAGCAATGAAAAACTGTTTTTT	CASKTRGQGAGSNEKLFF	TRBV12-3	TRBJ1-4
TGTGCCAGCAGCGCCCGCCACAGGTCGGAGGGGTACACCATATATTTT	CASSARHRSEGYTIYF	TRBV5-6	TRBJ1-3
TGTGCCAGCAGCCCGGCGGGTAGCAATCAGCCCCAGCATTTT	CASSPAGSNQPQHF	TRBV14	TRBJ1-5
TGTGCCAGCAGTTACATCAGCTTTAAGCACGGTCAGCCCCAGCATTTT	CASSYISFKHGQPQHF	TRBV6-3	TRBJ1-5
TGTGCCAGTCCAGGGGTAGCGGAGACCCAGTACTTC	CASPGVAETQYF	TRBV19	TRBJ2-5
TGTGCCAGCAGCGCATACGGGATAGTAGCTAGCTCCTATAATTCACCCCTCCACTTT	CASSAYGIVASSYNSPLHF	TRBV11-3	TRBJ1-6
TGTGCCAGCAGCCACCCGGGGAAAGATACGCAGTATTTT	CASSHPGKDTQYF	TRBV3-1	TRBJ2-3
TGTGCCAGCAGCGGGACAGGGGGAGTTGGTACAACTAATGAAAAACTGTTTTTT	CASSGTGGVGTTNEKLFF	TRBV2	TRBJ1-4
TGTGCCACCAGTGGATGCAGGGGGGAACTTCTAAGCAATCAGCCCCAGCATTTT	CATSGCRGELLSNQPQHF	TRBV24-1	TRBJ1-5
TGTGCCAGCAGCTATCGGACAGGGGACCGGGCCTACGAGCAGTACTTC	CASSYRTGDRAYEQYF	TRBV13	TRBJ2-7
TGTGCCAGCAGTTACGGGGGTCAGCTCGAGACCCAGTACTTC	CASSYGGQLETQYF	TRBV6-6	TRBJ2-5
TGTGCCAGCAGCCGACAGCGATCTAGCGGGTGCTACGAGCAGTACTTC	CASSRQRSSGCYEQYF	TRBV11-3	TRBJ2-7
TGTGCCACCAGTTTCCGATACAGGGGGCGAGGTTCGGACTATGGCTACACCTTC	CATSFRYRGRGSDYGYTF	TRBV24-1	TRBJ1-2
TGTGCCAGCCTTATTTGTACTAGCGGGGAAAGCCGACTCTACGAGCAGTACTTC	CASLICTSGESRLYEQYF	TRBV5-4	TRBJ2-7
TGTGCCAGCAGCTTAAGCGCCGAGCAGGGCCCGCACGAGCAGTACTTC	CASSLSAEQGPHEQYF	TRBV7-3	TRBJ2-7
TGTGCCTGCTGTTGGGGACTAATAACAGATACGCAGTATTTT	CACCWGLITDTQYF	TRBV30	TRBJ2-3
TGTGCCAGCAGCTGGTCCACAGACACAGGACAGGGATGGACTGAGCAGTACTTC	CASSWSTDTGQGWTEQYF	TRBV11-2	TRBJ2-7
TGTGCCAGCAGCTTAGTCGACAGGGGCCGCAATCAGCCCCAGCATTTT	CASSLVDRGRNQPQHF	TRBV7-8	TRBJ1-5
TGTGCCATCAGTGGGACAGAATTTTATGGCTACACCTTC	CAISGTEFYGYTF	TRBV10-3	TRBJ1-2
TGTGCCAGCAGTTACCACAGGGCTGGAGAGACCCAGTACTTC	CASSYHRAGETQYF	TRBV6-2	TRBJ2-5
TGCAGTGCCCCTAGCGAGACCCAGTACTTC	CSAPSETQYF	TRBV20-1	TRBJ2-5
TGCAGTGCTAGACAAGGGACAGGCAAGCTTTACGAGCAGTACTTC	CSARQGTGKLYEQYF	TRBV20-1	TRBJ2-7
TGTGCCAGTAGGGGATTGACAGGGGGCACTGAAGCTTTCTTT	CASRGLTGGTEAFF	TRBV19	TRBJ1-1
TGTGCCAGCAGTCCCCGGGACTGTCTGCAAGAGACCCAGTACTTC	CASSPRDCLQETQYF	TRBV25-1	TRBJ2-5
TGTGCCAGCAGCTGGGGATCCTTGCAGCCCCAGCATTTT	CASSWGSLQPQHF	TRBV7-4	TRBJ1-5
TGTGCCAGCAGCTTAGAGAAAGGACAGGGACCGGATAATGAAAAACTGTTTTTT	CASSLEKGQGPDNEKLFF	TRBV7-4	TRBJ1-4
TGTGCCAGCAGTTCAAATGCGGTCCAGCTCCGGGATGAGCAGTTCTTC	CASSSNAVQLRDEQFF	TRBV28	TRBJ2-1
TGTGCCAGCAGTTACATACGATCGATCCGGGACAGACTAGGATTCACGGAGTACAATGAGCAGTTCTTC	CASSYIRSIRDRLGFTEYNEQFF	TRBV6-6	TRBJ2-1
TGCGCCAGGCAGTCTCGGGCGGACGGGGGCCACTCCTACAATGAGCAGTTCTTC	CARQSRADGGHSYNEQFF	TRBV4-1	TRBJ2-1
TGCGCCAGCAGCCAAGGGAGCCGGGGGGGGTGCACAGATACGCAGTATTTT	CASSQGSRGGCTDTQYF	TRBV4-1	TRBJ2-3
TGTGCCAGGAACCAAGGGCCACATCTGAACACTGAAGCTTTCTTT	CARNQGPHLNTEAFF	TRBV7-8	TRBJ1-1
TGTGCCAGCAGTCAGGCGGACTGCACTGAAGCTTTCTTT	CASSQADCTEAFF	TRBV6-1	TRBJ1-1
TGTGCCTCTGGAAGAGCAGGGACCCTAGCCAAAAACATTCAGTACTTC	CASGRAGTLAKNIQYF	TRBV30	TRBJ2-4
TGCAGTGCTAGTCGCAGCTGTTCTGTTAACTATGGCTACACCTTC	CSASRSCSVNYGYTF	TRBV20-1	TRBJ1-2
TGTGCCAGCAGCGCTACGGGACAGGGATCGACTTTCGGTGAAAAACTGTTTTTT	CASSATGQGSTFGEKLFF	TRBV9	TRBJ1-4
TGTGCCAGCAGCGTATCATTAATTTGCTACGAGCAGTACTTC	CASSVSLICYEQYF	TRBV9	TRBJ2-7
TGTGCCAGCAGCTTGTATCCTGACAGGGCCCCCTCCATGGCCACTAATGAAAAACTGTTTTTT	CASSLYPDRAPSMATNEKLFF	TRBV5-5	TRBJ1-4
TGTGCCAGCAGCGGAGAGGGGGTGAGTACAAATGAAAAACTGTTTTTT	CASSGEGVSTNEKLFF	TRBV12-4	TRBJ1-4
TGTGCCATCGGGGTTGGCTACACCTTC	CAIGVGYTF	TRBV10-3	TRBJ1-2
TGTGCCAGCAGCTTACACCGGTCGGGACTCTATGGCTACACCTTC	CASSLHRSGLYGYTF	TRBV7-3	TRBJ1-2
TGTGCCAGCAGCCACACCGGGACAGGGGGAGCCGAGCAGTACTTC	CASSHTGTGGAEQYF	TRBV14	TRBJ2-7
TGCAGTGCGTTGGACAGGGGCTACGAGCAGTACTTC	CSALDRGYEQYF	TRBV20-1	TRBJ2-7
TGTGCCAGCAGCCCGGTAAAGGACAGGGGAAAACCCAACACCGGGGAGCTGTTTTTT	CASSPVKDRGKPNTGELFF	TRBV13	TRBJ2-2
TGCGCCAGCAGCCAAGACCAAATCGGGGGTTATGGCTACACCTTC	CASSQDQIGGYGYTF	TRBV4-3	TRBJ1-2
TGTGCCAGCGGTTCCGGGACAGGGGGGATGACTGAAGCTTTCTTT	CASGSGTGGMTEAFF	TRBV6-5	TRBJ1-1
TGTGCCAGCTCGGACAGGGTCCACGAGCAGTACTTC	CASSDRVHEQYF	TRBV18	TRBJ2-7
TGTGCCACCAGTGATTTGGCAAGGTTTCTCAGAGCTTTCTTT	CATSDLARFLRAFF	TRBV24-1	TRBJ1-1
TGTGCCAGCAGCTTGGGCCAACCGGGACATTTTACGTACCCTGAAGCTTTCTTT	CASSLGQPGHFTYPEAFF	TRBV5-4	TRBJ1-1
TGTGCCAGCAGTTCCCCAAGGACTAGCGGGCAGGTCTACGAGCAGTACTTC	CASSSPRTSGQVYEQYF	TRBV25-1	TRBJ2-7
TGTGCCAGCAGTTTAGCTATCAACACAGATACGCAGTATTTT	CASSLAINTDTQYF	TRBV12-3	TRBJ2-3
TGTGCCAGCAGTCGTAACATAGGCATTTTGAATCAGCCCCAGCATTTT	CASSRNIGILNQPQHF	TRBV27	TRBJ1-5
TGTGCCAGCAGTGAAAGGCTGAGAGGGCAGAAGGATACGCAGTATTTT	CASSERLRGQKDTQYF	TRBV25-1	TRBJ2-3
TGTGCCAGCAGGGGGGACCACAATGAGCAGTTCTTC	CASRGDHNEQFF	TRBV6-1	TRBJ2-1
TGTGCCAGCATAAAGCATAAAGAGACCCAGTACTTC	CASIKHKETQYF	TRBV27	TRBJ2-5
TGTGCCACCAGTGATTATTTCCGACAGGGTTCGAGCTACGAGCAGTACTTC	CATSDYFRQGSSYEQYF	TRBV24-1	TRBJ2-7
TGCGCCAGCAGTGAGTCGGGGGGACAGGGAGCCTACGAGCAGTACTTC	CASSESGGQGAYEQYF	TRBV10-1	TRBJ2-7
TGCAGTGCGCTCAGGGAAGAAAACCACCTTACTAATGAAAAACTGTTTTTT	CSALREENHLTNEKLFF	TRBV20-1	TRBJ1-4
TGTGCCAGCAGCTCCACATCTGGAGATACTAACTATGGCTACACCTTC	CASSSTSGDTNYGYTF	TRBV11-2	TRBJ1-2
TGCGCCAGCAGCATTCGGCTCCGGAATCAGCCCCAGCATTTT	CASSIRLRNQPQHF	TRBV5-1	TRBJ1-5
TGTGCCAGCAGTTGGGGACACTCTGGAAACACCATATATTTT	CASSWGHSGNTIYF	TRBV25-1	TRBJ1-3
TGTGCCTGGATCAGCGGTAGATGGCCCTACGAGCAGTACTTC	CAWISGRWPYEQYF	TRBV30	TRBJ2-7
TGCGCCAAGAAATCTCCGGGGGGGCCCGTCGAGGTCTCCTACGAGCAGTACTTC	CAKKSPGGPVEVSYEQYF	TRBV10-1	TRBJ2-7
TGTGCCAGCAGCCAAGAGCCCCAGGGGAGAGCACATCAGCCCCAGCATTTT	CASSQEPQGRAHQPQHF	TRBV14	TRBJ1-5
TGCGCCAGCAGCCTTCGCAGACAACACCCCCTCCACTTT	CASSLRRQHPLHF	TRBV5-1	TRBJ1-6
TGTGCCAGCAGCTTAACGGGCAGGGGACACTACGAGCAGTACTTC	CASSLTGRGHYEQYF	TRBV7-3	TRBJ2-7
TGTGCCAGCAGCTTAGCGATTCGGCCGGGACGCCGGAACACCGGGGAGCTGTTTTTT	CASSLAIRPGRRNTGELFF	TRBV13	TRBJ2-2
TGTGCCAGCAGCGCCCCATGCCTAGGTAACTATGGCTACACCTTC	CASSAPCLGNYGYTF	TRBV11-3	TRBJ1-2
TGTGCCACGGTAACTAGCGCAATGGAGACCCAGTACTTC	CATVTSAMETQYF	TRBV6-1	TRBJ2-5
TGTGCCAGCAGCTCCCCAGAGGACAGGGTGCCCGACAATGAGCAGTTCTTC	CASSSPEDRVPDNEQFF	TRBV6-4	TRBJ2-1
TGTGCCAGCAGCGGCGGGACAGGGGGGGAAAAACTGTTTTTT	CASSGGTGGEKLFF	TRBV7-6	TRBJ1-4
TGTGCCAGCAGCCGTAACGACATGAATGAAAAACTGTTTTTT	CASSRNDMNEKLFF	TRBV3-1	TRBJ1-4
TGCGCCAGCAGTGTCTCCGGCGCTGAAGCTTTCTTT	CASSVSGAEAFF	TRBV10-1	TRBJ1-1
TGCAGTGCTAGTATTAAACCCAGGGTCTACGAGCAGTACTTC	CSASIKPRVYEQYF	TRBV20-1	TRBJ2-7
TGCAGTGACACAGGCATGTATGAGCAGTTCTTC	CSDTGMYEQFF	TRBV20-1	TRBJ2-1
TGTGCCAGTAGTTCCGGGTATGGGGAGAAGCACGAGCAGTACTTC	CASSSGYGEKHEQYF	TRBV19	TRBJ2-7
TGTGCCAGCAGTTTAAAGGGGGGGGGGGGGACCCAGTACTTC	CASSLKGGGGTQYF	TRBV27	TRBJ2-5
TGCAGTGCTAGGACAAGCCGGATTGGGGGGGGACAGCCCCAGCATTTT	CSARTSRIGGGQPQHF	TRBV20-1	TRBJ1-5
TGTGAGCCTGAGTGGGGGCCGGGGTACAATGAGCAGTTCTTC	CEPEWGPGYNEQFF	TRBV9	TRBJ2-1
TGTGCCCTAAGTAGCGGGGATAACAATGAGCAGTTCTTC	CALSSGDNNEQFF	TRBV27	TRBJ2-1
TGTGCCAGCAGCGCAGGACAGGGGATTTCCTTCCACACTGAAGCTTTCTTT	CASSAGQGISFHTEAFF	TRBV7-7	TRBJ1-1
TGTGCCAGCAGAACGAGGAACGGATATAATTCACCCCTCCACTTT	CASRTRNGYNSPLHF	TRBV9	TRBJ1-6
TGTGCCAGCAGGGAAGCCCAAAGGGGACAGGGTTCTAAAGCTTTCTTT	CASREAQRGQGSKAFF	TRBV12-4	TRBJ1-1
TGTGCCAGCAGCTTATGGTTCGGGACCCAGGGGAATCAGCCCCAGCATTTT	CASSLWFGTQGNQPQHF	TRBV11-3	TRBJ1-5
TGTAATAGGGGGGCCGGGGATAGCACAGATACGCAGTATTTT	CNRGAGDSTDTQYF	TRBV6-1	TRBJ2-3
TGTGCCAGCTCACCACCCCCCACTCTAGTTAGCGATGGGGTAGAAAAACTGTTTTTT	CASSPPPTLVSDGVEKLFF	TRBV18	TRBJ1-4
TGTGCCAGTAGTATAGGTCTAGACTGGGGAGAAGAGACCCAGTACTTC	CASSIGLDWGEETQYF	TRBV19	TRBJ2-5
TGTGCCAGCACAGGGCGGACTAGCGGGGGGCGTCCCGGGGAGCTGTTTTTT	CASTGRTSGGRPGELFF	TRBV9	TRBJ2-2
TGTGCCAGTACCCTTGGGGGGCCGAACACCGGGGAGCTGTTTTTT	CASTLGGPNTGELFF	TRBV19	TRBJ2-2
TGTGCCAGTAGTATAGAGCCGCCGGGACAGAAGACTAACTATGGCTACACCTTC	CASSIEPPGQKTNYGYTF	TRBV19	TRBJ1-2
TGTGCCAGCAGTGTGATCAACCCGGGGGTTTGGGAAGCTTTCTTT	CASSVINPGVWEAFF	TRBV6-1	TRBJ1-1
TGCGCCAGCGGCCACAGGGCGGGTAATGAAAAACTGTTTTTT	CASGHRAGNEKLFF	TRBV5-1	TRBJ1-4
TGCAGCGTTGAAATCAAACAGAATCAGCCCCAGCATTTT	CSVEIKQNQPQHF	TRBV29-1	TRBJ1-5
TGTGCCACCAGTGATTTGCAGACCGCGAACACCGGGGAGCTGTTTTTT	CATSDLQTANTGELFF	TRBV24-1	TRBJ2-2
TGTGCCAGTAGTATGTCGGCCGGGACAACTTGGTACGAGCAGTACTTC	CASSMSAGTTWYEQYF	TRBV19	TRBJ2-7
TGTGCCAGCAAAAGGGAAATGGGGGAGGCTGAAGCTTTCTTT	CASKREMGEAEAFF	TRBV7-3	TRBJ1-1
TGTGCCAGCAGCTTACCTCTGACGTCAGTTCTTTCCTACGAGCAGTACTTC	CASSLPLTSVLSYEQYF	TRBV7-2	TRBJ2-7
TGTGCCAGCAGCTACAGGGCGATGAACACTGAAGCTTTCTTT	CASSYRAMNTEAFF	TRBV11-3	TRBJ1-1
TGTGCCAGTAAGAGGACAGTTGATCAGCCCCAGCATTTT	CASKRTVDQPQHF	TRBV19	TRBJ1-5
TGCGCCAGCAGCTGGAAATGGAGACACATGATTAACTATGGCTACACCTTC	CASSWKWRHMINYGYTF	TRBV5-1	TRBJ1-2
TGTGCCAGCAGCCATCCCAGGACCCAGTACTTC	CASSHPRTQYF	TRBV7-6	TRBJ2-5
TGTGCCAGCAGCGTAACTGGGGCTTTCTTT	CASSVTGAFF	TRBV9	TRBJ1-1
TGTGCCACCCTCCCCGGGACAGGGACTGAAGCTTTCTTT	CATLPGTGTEAFF	TRBV24-1	TRBJ1-1
TGTGCCAGCAGCGACCGACAGGGGAAGAACACTGAAGCTTTCTTT	CASSDRQGKNTEAFF	TRBV7-3	TRBJ1-1
TGTGCCAGCAGTCTAGCGGGGCCCTACGAGCAGTACTTC	CASSLAGPYEQYF	TRBV27	TRBJ2-7
TGTGCCAGCAGTTACTCGGGGAACCGGACCTACGAGCAGTACTTC	CASSYSGNRTYEQYF	TRBV6-5	TRBJ2-7
TGTGCCAGCAGTTCCGGGAGGCGGGCCAATCAGCCCCAGCATTTT	CASSSGRRANQPQHF	TRBV27	TRBJ1-5
TGTGCCAGCAGCCGATCCTCTCGGTGCCGGGACAGGGGGGATGAGCAGTTCTTC	CASSRSSRCRDRGDEQFF	TRBV7-3	TRBJ2-1
TGTGCCAGCAGCCAAGATGGGACTAGCGGGTCCTACGAGCAGTACTTC	CASSQDGTSGSYEQYF	TRBV4-2	TRBJ2-7
TGCAGTGCTAGAGACCGGACCAACAGGTACACAGATACGCAGTATTTT	CSARDRTNRYTDTQYF	TRBV20-1	TRBJ2-3
TGTGCCAGCAGCCAAGATTCGGCTGAGCCAGATACGCAGTATTTT	CASSQDSAEPDTQYF	TRBV14	TRBJ2-3
TGTGCCAGCAGCCGGTGCAGGGGGCAGTTCTTC	CASSRCRGQFF	TRBV13	TRBJ2-1
TGTGCCACAGCGAGCGTCTTTTACAATGAGCAGTTCTTC	CATASVFYNEQFF	TRBV24-1	TRBJ2-1
TGTGCCAGCAGCCGGGGCCGGGGGTCCTACGAGCAGTACTTC	CASSRGRGSYEQYF	TRBV9	TRBJ2-7
TGTGCCAGCAGCCCCGCGTCGCGCCACTCCTACGAGCAGTACTTC	CASSPASRHSYEQYF	TRBV13	TRBJ2-7
TGTGCCAGCAGCTTAGCCTATAACTGCTCCTACGAGCAGTACTTC	CASSLAYNCSYEQYF	TRBV7-9	TRBJ2-7
TGTGCCAGCAGCCAAGATAGGGTGGACAGGATTGTACTCAATCAGCCCCAGCATTTT	CASSQDRVDRIVLNQPQHF	TRBV4-2	TRBJ1-5
TGTGCCAGCAGTGACCCGTGGGGACAGTCAGGGGAAAAACTGTTTTTT	CASSDPWGQSGEKLFF	TRBV6-4	TRBJ1-4
TGTGCCATCAGTGCATGGAGGGGCAATCAGCCCCAGCATTTT	CAISAWRGNQPQHF	TRBV10-3	TRBJ1-5
TGTGCCAGCAGCTCTGGACAGGTCGGCCCTTGTAATGAAAAACTGTTTTTT	CASSSGQVGPCNEKLFF	TRBV7-3	TRBJ1-4
TGTGCCAGCAGTGCCACGGGGAGATGGAATGAGCAGTTCTTC	CASSATGRWNEQFF	TRBV6-5	TRBJ2-1
TGTGCCAGTGGACTAGCGGGAGGGCGGAATCAGCCCCAGCATTTT	CASGLAGGRNQPQHF	TRBV6-4	TRBJ1-5
TGCAGTGCTAGCACCGCATTGGGACTGTACTACGAGCAGTACTTC	CSASTALGLYYEQYF	TRBV20-1	TRBJ2-7
TGTGCCAGCAGGGACAGGGGTATTGGTGGCAATCAGCCCCAGCATTTT	CASRDRGIGGNQPQHF	TRBV27	TRBJ1-5
TGTGCCAGCAGCGAGACATTACACACTGAAGCTTTCTTT	CASSETLHTEAFF	TRBV7-3	TRBJ1-1
TGTGCCAGCAGGGGGTTTGCAGGGAGGAACACTGAAGCTTTCTTT	CASRGFAGRNTEAFF	TRBV5-6	TRBJ1-1
TGTGCCAGCAAGCCCGAACCCTCTGGGGCCAACGTCCTGACTTTC	CASKPEPSGANVLTF	TRBV6-6	TRBJ2-6
TGTTATTCACCCGGGGACAACACTGAAGCTTTCTTT	CYSPGDNTEAFF	TRBV29-1	TRBJ1-1
TGTGCCAGCAGTTTTTTCCAGTGGCTCGGGGGTATCAATCAGCCCCAGCATTTT	CASSFFQWLGGINQPQHF	TRBV12-4	TRBJ1-5
TGCGCCAGTCGGAAAACCAGACTAGCGGGCACCGGGGAGCTGTTTTTT	CASRKTRLAGTGELFF	TRBV10-2	TRBJ2-2
TGTGCCAGCACGAGCATCGAGCAGTACTTC	CASTSIEQYF	TRBV6-5	TRBJ2-7
TGTGCCTGGAGTGCGGAACCCGACAGGGACCCGGGCACTGAAGCTTTCTTT	CAWSAEPDRDPGTEAFF	TRBV30	TRBJ1-1
TGTGCCAGCAGCTTGGAGAGGAGCTCCTACGAGCAGTACTTC	CASSLERSSYEQYF	TRBV5-4	TRBJ2-7
TGCAGTGCTAGAGACCAGCAGTTCTTC	CSARDQQFF	TRBV20-1	TRBJ2-1
TGTGCCTGGCAAGTGGACAGGGCCGAGAGCAATCAGCCCCAGCATTTT	CAWQVDRAESNQPQHF	TRBV30	TRBJ1-5
TGTGGACATACTGGAAACACCATATATTTT	CGHTGNTIYF	TRBV5-6	TRBJ1-3
TGTGCCAGCAGCTTAGGGTTCTTTAGTGGGGCAAGCTACGAGCAGTACTTC	CASSLGFFSGASYEQYF	TRBV7-9	TRBJ2-7
TGCAGCGTTGCCACAGGGGGGGGGACCGGGGAGCTGTTTTTT	CSVATGGGTGELFF	TRBV29-1	TRBJ2-2
TGTGCCAGCAGATGCCCGGACAGGGGAAACACCATATATTTT	CASRCPDRGNTIYF	TRBV6-1	TRBJ1-3
TGTGCCAGCAGTGCAGGGGGCAAACGGGACTACAATGAGCAGTTCTTC	CASSAGGKRDYNEQFF	TRBV6-4	TRBJ2-1
TGTGCCAGCAGCAGGGGGGACAGGGCCGACACCGGAGAGACCCAGTACTTC	CASSRGDRADTGETQYF	TRBV9	TRBJ2-5
TGCAGCGTTGAGGGGGCGCACCGGGACAATCAGCCCCAGCATTTT	CSVEGAHRDNQPQHF	TRBV29-1	TRBJ1-5
TGTGCCACCAGTGGTCCCCCACTGACAAGGTCCCCTAGCACAGATACGCAGTATTTT	CATSGPPLTRSPSTDTQYF	TRBV24-1	TRBJ2-3
TGTGCCAGCAGCTTAGCTAAATCGGACGAGACCCAGTACTTC	CASSLAKSDETQYF	TRBV11-3	TRBJ2-5
TGTGCCAGCAGCTTGACTAGCGGGTCGTCTGGGGAGCTGTTTTTT	CASSLTSGSSGELFF	TRBV5-5	TRBJ2-2
TGCGCCAGCAGCCGACAGGGCTCCTACGAGCAGTACTTC	CASSRQGSYEQYF	TRBV5-1	TRBJ2-7
TGCGCCAGCAGCCCAGATAATGAAATCAATGAGCAGTTCTTC	CASSPDNEINEQFF	TRBV5-1	TRBJ2-1
TGCAGTGCTAAGGACAGAGATTGGAAACCCACAGATCAGCCCCAGCATTTT	CSAKDRDWKPTDQPQHF	TRBV20-1	TRBJ1-5
TGCGCCAGCAGCCAAGACCGGGATCTACCGCCGGGACCTTGCGATACGCAGTATTTT	CASSQDRDLPPGPCDTQYF	TRBV4-1	TRBJ2-3
TGTGCCAGCAGCCAAGAGGAAATAGTCAACCCGGGGCGGGACTACAATGAGCAGTTCTTC	CASSQEEIVNPGRDYNEQFF	TRBV14	TRBJ2-1
TGCAGTGCTAGAGAATCGACAGGGGGCACTGAAGCTTTCTTT	CSARESTGGTEAFF	TRBV20-1	TRBJ1-1
TGCGCCAGCAGCTTGGACGGGGGGGCCAATTACGAGCAGTACTTC	CASSLDGGANYEQYF	TRBV5-1	TRBJ2-7
TGCGCCAGCAGCTGGGGATTCTACGAGCAGTACTTC	CASSWGFYEQYF	TRBV5-1	TRBJ2-7
TGTGCCAGCCCCCTGGACAGGGGACCTAATGAAAAACTGTTTTTT	CASPLDRGPNEKLFF	TRBV12-3	TRBJ1-4
TGTGCCAGCAGTTTCTCAAGGGTCGTTCGTAATGAAAAACTGTTTTTT	CASSFSRVVRNEKLFF	TRBV12-3	TRBJ1-4
TGCAGTGCTAGACACCTAGCGGGTACACCCCCCGAGCAGTACTTC	CSARHLAGTPPEQYF	TRBV20-1	TRBJ2-7
TGCGCCAGCGACCGCACTGAAGCTTTCTTT	CASDRTEAFF	TRBV5-1	TRBJ1-1
TGTGCCAGCAGCTTGCTTGGGACAGGGGGCTGGAACTATGGCTACACCTTC	CASSLLGTGGWNYGYTF	TRBV5-4	TRBJ1-2
TGTGCCATGGCAGATAAACTAGCGGGGGTGGGGGGGTTTCTGTGGGTTTACAATGAGCAGTTCTTC	CAMADKLAGVGGFLWVYNEQFF	TRBV10-3	TRBJ2-1
TGTGCCAGCACAGGGGCCAATCAGCCCCAGCATTTT	CASTGANQPQHF	TRBV6-4	TRBJ1-5
TGTGCCAGCAGCTTATCGACAGGAGAGCAGTACTTC	CASSLSTGEQYF	TRBV7-3	TRBJ2-7
TGTGCCAGCAGTCCCCCCAGACTGAACACTGAAGCTTTCTTT	CASSPPRLNTEAFF	TRBV11-2	TRBJ1-1
TGCGCCAGCAGCCAAGATCGGCATCCGGGACAGGGGAGTAACTATGGCTACACCTTC	CASSQDRHPGQGSNYGYTF	TRBV4-1	TRBJ1-2
TGTGCCAGCAGCGGGGGGCGGAGCTATGGCTACACCTTC	CASSGGRSYGYTF	TRBV9	TRBJ1-2
TGTGCCAGCAGCGTAGCTTCTAGCGGCTCCAACGAGCAGTACTTC	CASSVASSGSNEQYF	TRBV9	TRBJ2-7
TGTGCCAGCAGCCCCCATACGGGCTATGGCTACACCTTC	CASSPHTGYGYTF	TRBV12-4	TRBJ1-2
TGTGCCAGCAGTGACCTGACAAGACAGGGAACCATTCAGTACTTC	CASSDLTRQGTIQYF	TRBV6-4	TRBJ2-4
TGTGCCACCAGTGATTTGCACACTAGCGGGAGACCCTACGAGCAGTACTTC	CATSDLHTSGRPYEQYF	TRBV24-1	TRBJ2-7
TGTGCCACCCGGGGAGATTTCGGGCACACCGGGGAGCTGTTTTTT	CATRGDFGHTGELFF	TRBV12-3	TRBJ2-2
TGCGCCAGCAGCCAAGAGGGAGGGCGGGAGAGGGAAAAACTGTTTTTT	CASSQEGGREREKLFF	TRBV4-1	TRBJ1-4
TGTGCCAGCCCCGGGGCCCGTAGCAATCAGCCCCAGCATTTT	CASPGARSNQPQHF	TRBV12-3	TRBJ1-5
TGCGCCAGCAGCCTTCACAGGGCAACTAATGAAAAACTGTTTTTT	CASSLHRATNEKLFF	TRBV4-1	TRBJ1-4
TGTGCCAGCAGCTGGGGGACGATCCCCTACGAGCAGTACTTC	CASSWGTIPYEQYF	TRBV9	TRBJ2-7
TGTGCCAGCAGGACTACAGCTGTGTACAATGAGCAGTTCTTC	CASRTTAVYNEQFF	TRBV9	TRBJ2-1
TGTGCCAGCAGCTTGGTTGGGATCGAGCAGTACTTC	CASSLVGIEQYF	TRBV5-6	TRBJ2-7
TGCAGTGCTCAGGGCCGAGGGTTCTATAATTCACCCCTCCACTTT	CSAQGRGFYNSPLHF	TRBV20-1	TRBJ1-6
TGTGCCAGCAGTCCCGGACTAGCGGGTGGCTACAATGAGCAGTTCTTC	CASSPGLAGGYNEQFF	TRBV28	TRBJ2-1
TGTGCCAGCTCACGCGGGACGGGCCAGCCCCAGCATTTT	CASSRGTGQPQHF	TRBV18	TRBJ1-5
TGTGCCACCAGCAGAGCTCCAGCGGGAGGCGAAAACATTCAGTACTTC	CATSRAPAGGENIQYF	TRBV15	TRBJ2-4
TGTGCCAGCAGCGGGCCCTGGGGCGGTTTGAACACTGAAGCTTTCTTT	CASSGPWGGLNTEAFF	TRBV7-3	TRBJ1-1
TGTGCCAGCAGCGCTCCAGGGGGAGAGACCCAGTACTTC	CASSAPGGETQYF	TRBV9	TRBJ2-5
TGTGCCAGCAGTGTGTTTACAGCGGCCTACGAGCAGTACTTC	CASSVFTAAYEQYF	TRBV2	TRBJ2-7
TGCAGTGCCCTTCCACTAGCGGGCACAGGACGCACAGATACGCAGTATTTT	CSALPLAGTGRTDTQYF	TRBV20-1	TRBJ2-3
TGTGCCAGCAGCCAAGACCTGCCGGGAGCACTAGCAAAGACCGGGGAGCTGTTTTTT	CASSQDLPGALAKTGELFF	TRBV3-1	TRBJ2-2
TGTGCCAGCAGTCAAGGGCGCCGGGACAGGGGAGCGTCCTATAATTCACCCCTCCACTTT	CASSQGRRDRGASYNSPLHF	TRBV27	TRBJ1-6
TGCAGTGCTAGACCCGGACAGGAAGGGCATTTT	CSARPGQEGHF	TRBV20-1	TRBJ1-5
TGTGCCAGCAGCACTGGACTAGCGGGACACTACCACGGGAATGAGCAGTTCTTC	CASSTGLAGHYHGNEQFF	TRBV7-4	TRBJ2-1
TGCAGTGCATACTCCGAGAGTTATAGCAATCAGCCCCAGCATTTT	CSAYSESYSNQPQHF	TRBV20-1	TRBJ1-5
TGTGCTAGCAGCTTAGCGCCTACTAGCCTCTACGAGCAGTACTTC	CASSLAPTSLYEQYF	TRBV7-7	TRBJ2-7
TGTGCCAGCGGCCGGGGACTAGCGGGCGTAATTTCCTACAATGAGCAGTTCTTC	CASGRGLAGVISYNEQFF	TRBV27	TRBJ2-1
TGTGCCAGGGGTCAAAACTATGGCTACACCTTC	CARGQNYGYTF	TRBV19	TRBJ1-2
TGTGCCTCCACAGGGGGCTGCAATGACACTGAAGCTTTCTTT	CASTGGCNDTEAFF	TRBV30	TRBJ1-1
TGTGCCAGCAGCTGTGGGGGACTAATTCAGCCCCAGCATTTT	CASSCGGLIQPQHF	TRBV7-9	TRBJ1-5
TGTGCCAGCGGCAGGGTAACCCAAATGGCTAGCACAGATACGCAGTATTTT	CASGRVTQMASTDTQYF	TRBV28	TRBJ2-3
TGTGCCAGCAGCTTAATACTAGCGGGAGGAGGCGGGTACGAGCAGTACTTC	CASSLILAGGGGYEQYF	TRBV7-3	TRBJ2-7
TGTGCCAGCAGTCCAGGGGCTATCCAAGAGACCCAGTACTTC	CASSPGAIQETQYF	TRBV6-6	TRBJ2-5
TGTGCCAGCAGCTTCGCACAACGCGGGGCCACTGAAGCTTTCTTT	CASSFAQRGATEAFF	TRBV7-3	TRBJ1-1
TGTGCCAGCAGCGTAGGAGACCCCGAGCGGGAGGAGCAGTACTTC	CASSVGDPEREEQYF	TRBV9	TRBJ2-7
TGTGCCAGCTGGTCCCGGGGGCGGCCCACTTTCTTT	CASWSRGRPTFF	TRBV6-1	TRBJ1-1
TGTGCCAGTAGTATCCCCTTTACAGGGCCGATCTGGGCTGGGGCCAACGTCCTGACTTTC	CASSIPFTGPIWAGANVLTF	TRBV19	TRBJ2-6
TGTGCCAGCAGCGCCCAAAACTCGCCCCAGCATTTT	CASSAQNSPQHF	TRBV9	TRBJ1-5
TGTGCCACCGGCGGGGGCAATGACACTGAAGCTTTCTTT	CATGGGNDTEAFF	TRBV24-1	TRBJ1-1
TGTGCCAGCAGTGATTTTGGACAGGGGGAAGAGGTTAAAGGCACCGGGGAGCTGTTTTTT	CASSDFGQGEEVKGTGELFF	TRBV6-1	TRBJ2-2
TGTGCCACCAGTGATGCACGTCGGGGAACTAGTACACCCCTCCACTTT	CATSDARRGTSTPLHF	TRBV24-1	TRBJ1-6
TGCAGTGCTGTAGGGGACTGCTCACCCCTCCACTTT	CSAVGDCSPLHF	TRBV20-1	TRBJ1-6
TGTGCCAGCAGTTTAGTCCATTCAGGTGAACGGGGTTTTCAGCCCCAGCATTTT	CASSLVHSGERGFQPQHF	TRBV12-3	TRBJ1-5
TGTGCCAGCAGCCAAGATGGCCGCGGGGGGGGGTCCTACGAGCAGTACTTC	CASSQDGRGGGSYEQYF	TRBV14	TRBJ2-7
TGTGCCACCAGCAGAGATTCAAACGGAGAGACCCAGTACTTC	CATSRDSNGETQYF	TRBV15	TRBJ2-5
TGCGCCAGCAGCAAGCGCAGGTTAAATTCACCCCTCCACTTT	CASSKRRLNSPLHF	TRBV4-1	TRBJ1-6
TGTGCCAGCAGAATTTGTACCGACAGGGGGCGATGTGAGCAGTACTTC	CASRICTDRGRCEQYF	TRBV5-8	TRBJ2-7
TGTGCCAGCATACCCCGGGGAAGGTCACCAGGAGAAGAGCAGTACTTC	CASIPRGRSPGEEQYF	TRBV5-4	TRBJ2-7
TGTGCCAGCAGCCAAGATCGGGGCTTCACGAACTATGGCTACACCTTC	CASSQDRGFTNYGYTF	TRBV3-1	TRBJ1-2
TGTGCCAGCAGTGACTCGAAAGCTGGGGCTTTTGAGACCCAGTACTTC	CASSDSKAGAFETQYF	TRBV6-4	TRBJ2-5
TGTGCCAGCAGTGACCCTCAAAGGGCGGGCGGCTACACCTTC	CASSDPQRAGGYTF	TRBV27	TRBJ1-2
TGTGCCAGCAGCTATCCCCGGTCGCCCAAGTATTACGAGCAGTACTTC	CASSYPRSPKYYEQYF	TRBV7-3	TRBJ2-7
TGTGCCACCAGTCGGAGAGTTCCGACCCGGGTGGAATGTACGCTAGCCAAAAACATTCAGTACTTC	CATSRRVPTRVECTLAKNIQYF	TRBV24-1	TRBJ2-4
TGTGCCAGCAGTGACGGCCCCTGGGGCTATAATTCACCCCTCCACTTT	CASSDGPWGYNSPLHF	TRBV6-1	TRBJ1-6
TGTGCCAGCAGCGTAGAGACAGATGGGGGGGGTGAGACCCAGTACTTC	CASSVETDGGGETQYF	TRBV9	TRBJ2-5
TGTGCCAAGCTGGTTGATACGCAGTATTTT	CAKLVDTQYF	TRBV6-3	TRBJ2-3
TGTGCCAGCAGCCCCCCATCCTACGAGCAGTACTTC	CASSPPSYEQYF	TRBV5-6	TRBJ2-7
TGCGCCAGCAGCTTGGCAAAGCCGACAGGGGGCTACAATGAGCAGTTCTTC	CASSLAKPTGGYNEQFF	TRBV5-1	TRBJ2-1
TGCGCCCGGGACAGGGTTCTAGGAGATGGAGTGAACACAGATACGCAGTATTTT	CARDRVLGDGVNTDTQYF	TRBV10-1	TRBJ2-3
TGCAGCGTGCCGGGACAGGGGTATCGGAGCGAGCAGTACTTC	CSVPGQGYRSEQYF	TRBV29-1	TRBJ2-7
TGTGCCAGCAGTCCCTTTACACGGGGGGGCCTGACTGAGTGCCACGAGCAGTACTTC	CASSPFTRGGLTECHEQYF	TRBV6-1	TRBJ2-7
TGTGCCAGTAAAATTGGGGCTTATTTAAACTTCTATAGCACAGATACGCAGTATTTT	CASKIGAYLNFYSTDTQYF	TRBV19	TRBJ2-3
TGTGCCAGCAGTCAGGGCGGCTCTGGAAACACCATATATTTT	CASSQGGSGNTIYF	TRBV27	TRBJ1-3
TGTGCCAGCAGCTTATGGGGGGGGTATTCTGGAAACACCATATATTTT	CASSLWGGYSGNTIYF	TRBV7-9	TRBJ1-3
TGCAGTGCTTCCCCAAGCGAGGTGAATGAAGCTTTCTTT	CSASPSEVNEAFF	TRBV20-1	TRBJ1-1
TGTGCCAGTAGTATGTCTAAAACTGCTGAAGCTTTCTTT	CASSMSKTAEAFF	TRBV19	TRBJ1-1
TGCGCCAGCGACCCCACAGGGAAAATGAGGTATAGCAATCAGCCCCAGCATTTT	CASDPTGKMRYSNQPQHF	TRBV10-2	TRBJ1-5
TGTGCCAGCATTTTTCCCGTCGACCAGGGGAGACGCTATGGCTACACCTTC	CASIFPVDQGRRYGYTF	TRBV6-2	TRBJ1-2
TGTGCCAGCATACCGACGGGGGCGCGTAATGAAAAACTGTTTTTT	CASIPTGARNEKLFF	TRBV27	TRBJ1-4
TGTGCCACCTTAGGGGAAGGAACCTCGAACAATGAGCAGTTCTTC	CATLGEGTSNNEQFF	TRBV24-1	TRBJ2-1
TGTGCCAGCAGTGGCTGCTCTACCCACAGGGGGGATGAAGCTTTCTTT	CASSGCSTHRGDEAFF	TRBV25-1	TRBJ1-1
TGTGCCAGCAGCTTAAGGGGGACGGGGGGAAACATTCAGTACTTC	CASSLRGTGGNIQYF	TRBV5-4	TRBJ2-4
TGTGCCTGGAGTGTAGGGGCGGGACAGGGGACTAACTATGGCTACACCTTC	CAWSVGAGQGTNYGYTF	TRBV30	TRBJ1-2
TGTGCCCCGGGGGGGACTAGCGGGGAGACCCAGTACTTC	CAPGGTSGETQYF	TRBV28	TRBJ2-5
TGTGCCAGCAGTTACAATTGGGGACAGGGAAGCTCCTACGAGCAGTACTTC	CASSYNWGQGSSYEQYF	TRBV6-5	TRBJ2-7
TGTGCCAGCAGGGGGAGAGGTGTGCAAGAGACCCAGTACTTC	CASRGRGVQETQYF	TRBV28	TRBJ2-5
TGTGCCAGTAGTGAGAATGTAAACTGCTCCTACGAGCAGTACTTC	CASSENVNCSYEQYF	TRBV19	TRBJ2-7
TGTGCCACCGCCCGGGACAGTGACCTACAGCATTTT	CATARDSDLQHF	TRBV25-1	TRBJ1-5
TGCAGTGCTAGAACTCATTCAGATACGCAGTATTTT	CSARTHSDTQYF	TRBV20-1	TRBJ2-3
TGTGCCAGCAGCTGTAAACCTGCCCCGGGACAGGGAAGAGCGACCGGGGAGCTGTTTTTT	CASSCKPAPGQGRATGELFF	TRBV11-3	TRBJ2-2
TGTGCCAGTAGTATACCGGGGAGAGACCTTAGGACGGAGCTGTTTTTT	CASSIPGRDLRTELFF	TRBV19	TRBJ2-2
TGTGCCAGCAGCTTGCCCCGCGGGAGTACCCTCGGGGAGCTGTTTTTT	CASSLPRGSTLGELFF	TRBV5-5	TRBJ2-2
TGCGCCAGCAGCAAGGGACGGTACAATGAGCAGTTCTTC	CASSKGRYNEQFF	TRBV5-1	TRBJ2-1
TGTGCCAGCAGTTGCGGGACAGGTAAAGGGTCACCCCTCCACTTT	CASSCGTGKGSPLHF	TRBV6-3	TRBJ1-6
TGTGCTAGTGGTTTAAATCGATCCGGGACTAGCGGCCCAGGATACTCTGGGGCCAACGTCCTGACTTTC	CASGLNRSGTSGPGYSGANVLTF	TRBV12-5	TRBJ2-6
TGTGCACAGGGAAGGCGGGCGGCATCCTACGAGCAGTACTTC	CAQGRRAASYEQYF	TRBV7-9	TRBJ2-7
TGCGCCAGCAGCTTGAGCGGCGTAAGACAGGTAGCCTACAATGAGCAGTTCTTC	CASSLSGVRQVAYNEQFF	TRBV5-1	TRBJ2-1
TGTGCCACCAGTGCCCGCACTAGCGGGGCATGGACCTCCTACAATGAGCAGTTCTTC	CATSARTSGAWTSYNEQFF	TRBV24-1	TRBJ2-1
TGTGCCAGCAGCGATCAGGGCAACCGAAGGGGCTCCTACGAGCAGTACTTC	CASSDQGNRRGSYEQYF	TRBV9	TRBJ2-7
TGTGCCAGCAGTCGGATGACTCAGGCCCGGGACAGGGGGAATCTGGGCAAAAACATTCAGTACTTC	CASSRMTQARDRGNLGKNIQYF	TRBV28	TRBJ2-4
TGTGCCAGCAGCCAAGAGGGGATGGGGTATGGCTACACCTTC	CASSQEGMGYGYTF	TRBV3-1	TRBJ1-2
TGTGCCACCAGTGTGTTAGCGGGGGCCGATACGCAGTATTTT	CATSVLAGADTQYF	TRBV24-1	TRBJ2-3
TGTGCCAGCGTGGACGAAAATGAAAAACTGTTTTTT	CASVDENEKLFF	TRBV4-2	TRBJ1-4
TGTGCCAGCAGCCCGACAGGGGGCACCATTCTGGTCTTC	CASSPTGGTILVF	TRBV12-4	TRBJ2-1
TGTGAACGATACCCAGGGCTTACCTACGAGCAGTACTTC	CERYPGLTYEQYF	TRBV24-1	TRBJ2-7
TGTGCCAGCAGCGACGGAACCACCCGGGGGGGGCTCGGCGAGCAGTACTTC	CASSDGTTRGGLGEQYF	TRBV13	TRBJ2-7
TGTGCCAGCAGTTCCCCTAGCGGGGTTCACTACTACGAGCAGTACTTC	CASSSPSGVHYYEQYF	TRBV6-6	TRBJ2-7
TGCGCCAGCAGCCGGGGTTATTTGTTCTTCAATGAGCAGTTCTTC	CASSRGYLFFNEQFF	TRBV5-1	TRBJ2-1
TGTGCCAGCAGCATACCGGGACAGGGAAGCAATCAGCCCCAGCATTTT	CASSIPGQGSNQPQHF	TRBV13	TRBJ1-5
TGTGCCAGCAGCCCGAGCGCGAACACCGGGGAGCTGTTTTTT	CASSPSANTGELFF	TRBV11-3	TRBJ2-2
TGTGCTAGTGGGACCGGGGGGCCCTTGGGGGGTCTTGCCAAAAACATTCAGTACTTC	CASGTGGPLGGLAKNIQYF	TRBV12-5	TRBJ2-4
TGTGCCAGCAGAGTGACTAGCGGGGGCAAAAACATTCAGTACTTC	CASRVTSGGKNIQYF	TRBV6-5	TRBJ2-4
TGTGCCAGCAAAGGGACAGGGGCCGCGTCACAGCCGTGCATCTATGGCTACACCTTC	CASKGTGAASQPCIYGYTF	TRBV7-9	TRBJ1-2
TGCGCCAGCAGCCTCGCAGGGGGCACTGAAGCTTTCTTT	CASSLAGGTEAFF	TRBV5-1	TRBJ1-1
TGTGCCAAAGTTTGGTGCGGATCCTACAATGAGCAGTTCTTC	CAKVWCGSYNEQFF	TRBV12-3	TRBJ2-1
TGCGCCAGCAGCCTTGAGGACCGGCTCGTCTACACCTTC	CASSLEDRLVYTF	TRBV5-1	TRBJ1-2
TGTGCCAGCAGCTTATTTTCACGCGGGAACACTGAAGCTTTCTTT	CASSLFSRGNTEAFF	TRBV11-2	TRBJ1-1
TGTGCCACCCGGTCTTGCGGGAGGAAGGAGACCCAGTACTTC	CATRSCGRKETQYF	TRBV19	TRBJ2-5
TGTGCCATCAGGGACAGCGCGAACACTGAAGCTTTCTTT	CAIRDSANTEAFF	TRBV10-3	TRBJ1-1
TGTGCCAGCAAGAAGATAACACGGGGCAGGGGTTCGGTCACAGATACGCAGTATTTT	CASKKITRGRGSVTDTQYF	TRBV27	TRBJ2-3
TGTGCCAGTAGTGGATTGCGGTGGCACACTGAAGCTTTCTTT	CASSGLRWHTEAFF	TRBV19	TRBJ1-1
TGCAGTGCTAGATCCGGGACAGGGCTGTCAGAGACCCAGTACTTC	CSARSGTGLSETQYF	TRBV20-1	TRBJ2-5
TGTGCCAGCAGCCAAGGAGTAGCGGGGGGGAGCTCCTACGAGCAGTACTTC	CASSQGVAGGSSYEQYF	TRBV14	TRBJ2-7
TGCAGCGGCCTGTGGTTAGGGGCTTCAAGGTTAGGAAACACCATATATTTT	CSGLWLGASRLGNTIYF	TRBV29-1	TRBJ1-3
TGTGCCTTAACAGAATGCCTAGCCCCGAACACTGAAGCTTTCTTT	CALTECLAPNTEAFF	TRBV24-1	TRBJ1-1
TGTGCCAGCAGCTCGGGGAGGGGGAACACTGAAGCTTTCTTT	CASSSGRGNTEAFF	TRBV11-1	TRBJ1-1
TGTGCCAGCTCACCAGCGGTGGCCTTTACGGGGGGTAGTTACAATGAGCAGTTCTTC	CASSPAVAFTGGSYNEQFF	TRBV18	TRBJ2-1
TGTGCCAAGAATACGTGGCGGCCTGAAAAACTGTTTTTT	CAKNTWRPEKLFF	TRBV27	TRBJ1-4
TGTGCCAGCAGCGCGCGGACAGGGGGGGGGGATAGCAATCAGCCCCAGCATTTT	CASSARTGGGDSNQPQHF	TRBV7-6	TRBJ1-5
TGTGCCACCAGCAGGCGTAATGGGCAGGCGAGGGCCCCCTTTACAGCCGAGACAGATACGCAGTATTTT	CATSRRNGQARAPFTAETDTQYF	TRBV15	TRBJ2-3
TGCGCCAGCAGCCAGTTACCGGGACATACCGGAAACACCATATATTTT	CASSQLPGHTGNTIYF	TRBV4-1	TRBJ1-3
TGTGCCAGCAGCAACGGGGTCAGGGCCTACAATGAGCAGTTCTTC	CASSNGVRAYNEQFF	TRBV13	TRBJ2-1
TGTGCCAGCAGCTTAGTAGGGGGGCGCGGAGGCTACACCTTC	CASSLVGGRGGYTF	TRBV7-2	TRBJ1-2
TGCGCCAGCAGCTTGGCCCCGGGGTACAATGAGCAGTTCTTC	CASSLAPGYNEQFF	TRBV5-1	TRBJ2-1
TGTGCCAGCAGCCAAGTAGACAGAAACTGGAACACTGAAGCTTTCTTT	CASSQVDRNWNTEAFF	TRBV14	TRBJ1-1
TGTGCCAGCAGTCGGCCTATAGAGACCCAGTACTTC	CASSRPIETQYF	TRBV6-5	TRBJ2-5
TGTGCCAGCGGGGGAAGGTTATACAATGAGCAGTTCTTC	CASGGRLYNEQFF	TRBV27	TRBJ2-1
TGTGCCAGCAGCTTGTACTTCTGTGGCTACACCTTC	CASSLYFCGYTF	TRBV7-9	TRBJ1-2
TGTGCCAGCAGCGAGGTTGTGGCGGGGGGGGGGGGGATAAATGAGCAGTTCTTC	CASSEVVAGGGGINEQFF	TRBV7-3	TRBJ2-1
TGTGCCAGCAGCACCACCTCTCCGTGGCACTCCTACGAGCAGTACTTC	CASSTTSPWHSYEQYF	TRBV13	TRBJ2-7
TGTGCCAGCAGCCCGACTGGACAGAACCCCAAGGACAATCAGCCCCAGCATTTT	CASSPTGQNPKDNQPQHF	TRBV13	TRBJ1-5
TGTGCCAGCAGTTCAGGACAAGACACTGAAGCTTTCTTT	CASSSGQDTEAFF	TRBV2	TRBJ1-1
TGTGCCAGCAGCTTAACAAAGCCCTCCAGGGGGTCACCTAATGAAAAACTGTTTTTT	CASSLTKPSRGSPNEKLFF	TRBV7-9	TRBJ1-4
TGTGCCAGCAGTCCTACTGAGAATCAGCCCCAGCATTTT	CASSPTENQPQHF	TRBV7-3	TRBJ1-5
TGTGCCAGCAGGCCGGGAGGTAATGAAAAACTGTTTTTT	CASRPGGNEKLFF	TRBV6-5	TRBJ1-4
TGTGCCAGCAGCAGGTCCGTGGGCTACACCTTC	CASSRSVGYTF	TRBV6-5	TRBJ1-2
TGTGCCAGCAGCGTCCCCCGACCCAGGGGGCGGGACGAGAGAAAAATCCCCGGGTACCAAGAGACCCAGTACTTC	CASSVPRPRGRDERKIPGYQETQYF	TRBV9	TRBJ2-5
TGTGCCATCCTACAGGGATCCCACAAGGAGACCCAGTACTTC	CAILQGSHKETQYF	TRBV27	TRBJ2-5
TGTGCCACCAGTGAGGACAGGGGTAGCAATCAGCCCCAGCATTTT	CATSEDRGSNQPQHF	TRBV24-1	TRBJ1-5
TGTGCCAGCGGTTGGGACAAATGCTACGAGCAGTACTTC	CASGWDKCYEQYF	TRBV28	TRBJ2-7
TGCAGTATCCCCCGGGGGCTATGTTCTGGGGCCAACGTCCTGACTTTC	CSIPRGLCSGANVLTF	TRBV20-1	TRBJ2-6
TGTGCCAGCAGTATCTCGGAAAGCTCCTACGAGCAGTACTTC	CASSISESSYEQYF	TRBV6-1	TRBJ2-7
TGTGCCAGCAGTGACGGGCCCAGGGGGCGCAATGAGCAGTTCTTC	CASSDGPRGRNEQFF	TRBV6-4	TRBJ2-1
TGTGCCCCGGGACAGGGTACCCTGTTCTATGGCTACACCTTC	CAPGQGTLFYGYTF	TRBV2	TRBJ1-2
TGTGCCAGCAGCTTACAAGCCCCACTAGCGGGAGGGCGCTCCTACGAGCAGTACTTC	CASSLQAPLAGGRSYEQYF	TRBV11-2	TRBJ2-7
TGCAGCGTTGACATAAAGAATGAGCAGTTCTTC	CSVDIKNEQFF	TRBV29-1	TRBJ2-1
TGCGCCAGCAGCTCGTGTCCCTCTGTTGGAAACACCATATATTTT	CASSSCPSVGNTIYF	TRBV5-1	TRBJ1-3
TGTGCCAGCAGTCGGACTAGCGGGGTCGGATCATTCTACAATGAGCAGTTCTTC	CASSRTSGVGSFYNEQFF	TRBV6-5	TRBJ2-1
TGTGCCAGCAGTGACTCGACCACCCCGGGGGCGGATGGCTACACCTTC	CASSDSTTPGADGYTF	TRBV6-4	TRBJ1-2
TGTGCCACCAGTTCCGGCAGGGGGGCTCATAGCAATCAGCCCCAGCATTTT	CATSSGRGAHSNQPQHF	TRBV24-1	TRBJ1-5
TGTGCCAGCAGTTTCCATGGAAAGCCGGTCTTC	CASSFHGKPVF	TRBV27	TRBJ2-7
TGTGCCAGCAGCGCCGAGTCCCGGGGCTGGGCCTATAATTCACCCCTCCACTTT	CASSAESRGWAYNSPLHF	TRBV7-2	TRBJ1-6
TGTGCCAGCAGGCGGGGAGGGTACAATGAGCAGTTCTTC	CASRRGGYNEQFF	TRBV11-2	TRBJ2-1
TGTGCCACCAGCAGCTCCACCAGCCGGGACAGGGTAGAGCAGTTCTTC	CATSSSTSRDRVEQFF	TRBV15	TRBJ2-1
TGTGCCAGCAGTGAATTAGGAACAGATACGCAGTATTTT	CASSELGTDTQYF	TRBV25-1	TRBJ2-3
TGTGCCAGCAGCTTCCCGGGGGACTCCTACGAGCAGTACTTC	CASSFPGDSYEQYF	TRBV7-9	TRBJ2-7
TGTGCCAGCAGCGAAACCCAGGGATGCAATACTGAAGCTTTCTTT	CASSETQGCNTEAFF	TRBV7-2	TRBJ1-1
TGTGCCAGCAGCTGGGGGCGGGACGAGCAGTACTTC	CASSWGRDEQYF	TRBV28	TRBJ2-7
TGTGCCAGCAGTTACTCTGGGGATTACAAACTCGAGGATAGCAATCAGCCCCAGCATTTT	CASSYSGDYKLEDSNQPQHF	TRBV6-6	TRBJ1-5
TGTGCCAGCCGGAGGCCGGCCCGCTCAGATACGCAGTATTTT	CASRRPARSDTQYF	TRBV13	TRBJ2-3
TGCGCCAGCAGTGACCGACATTCGAGAAGCTCCTACGAGCAGTACTTC	CASSDRHSRSSYEQYF	TRBV10-1	TRBJ2-7
TGTGCCAGCTCACCTGGATGGCCCCAGGGCAGCACTGAAGCTTTCTTT	CASSPGWPQGSTEAFF	TRBV18	TRBJ1-1
TGTGCCAGCAGTCTACTATCAACAGCAGATACGCAGTATTTT	CASSLLSTADTQYF	TRBV3-1	TRBJ2-3
TGTGCCAGCAGCAAGGTGACAGGAGACTATGGCTACACCTTC	CASSKVTGDYGYTF	TRBV7-6	TRBJ1-2
TGTGCCAGGAGGGTAGACAGGGGTTCCTACGAGCAGTACTTC	CARRVDRGSYEQYF	TRBV2	TRBJ2-7
TGTGCCAGCAGTACGCCGGAGCCTAAGCGGGATTACTATAGCAATCAGCCCCAGCATTTT	CASSTPEPKRDYYSNQPQHF	TRBV27	TRBJ1-5
TGTGCCAGCAGCAAAACTAGCGGGAGATCAGAGACCCAGTACTTC	CASSKTSGRSETQYF	TRBV7-9	TRBJ2-5
TGTGCCAGCATCTTTTCGACCCTCCCGGGACATGGGGAAGAGACCCAGTACTTC	CASIFSTLPGHGEETQYF	TRBV5-4	TRBJ2-5
TGTGCCAGCAGTATTCCCCAGCAGAACACTGAAGCTTTCTTT	CASSIPQQNTEAFF	TRBV28	TRBJ1-1
TGTGCCAGCATCAGACACCCTGGAAACACCATATATTTT	CASIRHPGNTIYF	TRBV2	TRBJ1-3
TGTGCCAGCATGCCCAGTTTCGAGCAGTACTTC	CASMPSFEQYF	TRBV6-5	TRBJ2-7
TGTGCCAGCAGTTTATTATCGAGGCACCATGAAAAACTGTTTTTT	CASSLLSRHHEKLFF	TRBV28	TRBJ1-4
TGTGCCAGCAGTTTATGTCCGCTAGCGGGGAACACCGGGGAGCTGTTTTTT	CASSLCPLAGNTGELFF	TRBV27	TRBJ2-2
TGTGCCAGCAGCCAAGATTACAGGGGGCGGTTGGGCTACACCTTC	CASSQDYRGRLGYTF	TRBV14	TRBJ1-2
TGTGCCAGCAAAATCGCGGCCCGACCCAGAGGCGACGAGCAGTACTTC	CASKIAARPRGDEQYF	TRBV25-1	TRBJ2-7
TGTGCCAGCAGTCCCAGGGGTCCTTACGAGCAGTACTTC	CASSPRGPYEQYF	TRBV6-4	TRBJ2-7
TGTGCCAGCAGCGTAGAAACAGGGGACGGCCAAGAGACCCAGTACTTC	CASSVETGDGQETQYF	TRBV9	TRBJ2-5
TGTGCCAGCAGCTATGACGCAGTCTACACCGGGGAGCTGTTTTTT	CASSYDAVYTGELFF	TRBV13	TRBJ2-2
TGTGCCATAGCACCGACTAGCGAGACCACCGGGGAGCTGTTTTTT	CAIAPTSETTGELFF	TRBV6-3	TRBJ2-2
TGTGCATCGGACGGGACAGGGACTGAAGCTTTCTTT	CASDGTGTEAFF	TRBV24-1	TRBJ1-1
TGTGCCAGCAGTGACGCTAGGACAGCTCCTACGGGCTACACCTTC	CASSDARTAPTGYTF	TRBV2	TRBJ1-2
TGTGCCAGCAGCCCCGCCGGGCGCCACGAGCAGTACTTC	CASSPAGRHEQYF	TRBV7-3	TRBJ2-7
TGTGCCAGCAGTTTGGGACAGGGGGATACGGCTGAAGCTTTCTTT	CASSLGQGDTAEAFF	TRBV28	TRBJ1-1
TGTGCCACCAGGGTTGGGACAGGGAAGGGGGCCACAGATACGCAGTATTTT	CATRVGTGKGATDTQYF	TRBV24-1	TRBJ2-3
TGTGCCAGCAGCGGTGACCACGGGGGTCCAGACCCGGACAATGAGCAGTTCTTC	CASSGDHGGPDPDNEQFF	TRBV7-3	TRBJ2-1
TGCGCCAGCAGCTGTCCGACAGCCGGGGCTAACTATGGCTACACCTTC	CASSCPTAGANYGYTF	TRBV5-1	TRBJ1-2
TGTGCCAGCACCTGCGGGAGAGTTGCCTACGAGCAGTACTTC	CASTCGRVAYEQYF	TRBV6-4	TRBJ2-7
TGTGCCAGGCAGTTACTAGGAGACTCTGGGGCCAACGTCCTGACTTTC	CARQLLGDSGANVLTF	TRBV27	TRBJ2-6
TGTGCCAGCAGTTGGTACCGGGCGGGCCGCTACGAGCAGTACTTC	CASSWYRAGRYEQYF	TRBV12-4	TRBJ2-7
TGCGCCAGCAGCCATCCATCACAGGGCGGGAAGTATCCTAGCAATCAGCCCCAGCATTTT	CASSHPSQGGKYPSNQPQHF	TRBV4-3	TRBJ1-5
TGTGCCAGCAGTTACTCGTCACCCCCATGGACAGGATATGCAACTAATGAAAAACTGTTTTTT	CASSYSSPPWTGYATNEKLFF	TRBV6-5	TRBJ1-4
TGTATGACTAGCTCGAACACCGGGGAGCTGTTTTTT	CMTSSNTGELFF	TRBV6-1	TRBJ2-2
TGCAGCGTTGTTTCTGGGGCCCGGGGACTAGCCCTGCAGTACTTC	CSVVSGARGLALQYF	TRBV29-1	TRBJ2-7
TGTGCCAGCAGCGGGAAGTTTACTGAAGCTTTCTTT	CASSGKFTEAFF	TRBV27	TRBJ1-1
TGTGCCAGCAGCTTCTCCGGGACAACGGCGAACATCTCCTACAATGAGCAGTTCTTC	CASSFSGTTANISYNEQFF	TRBV11-2	TRBJ2-1
TGCAGCGGTCGGTTCACGACAGGAGGGACCTATTTT	CSGRFTTGGTYF	TRBV29-1	TRBJ1-3
TGTGCCAGCAGCCCCCCAGGGGAGCAGCCCCAGCATTTT	CASSPPGEQPQHF	TRBV9	TRBJ1-5
TGCAGTGCTAGAGCCACAGGGGTATACGAGCAGTACTTC	CSARATGVYEQYF	TRBV20-1	TRBJ2-7
TGTGCCAGAATAACCCGGACTGCCCGAGTGTGGGGAGACTCTGGGGCCAACGTCCTGACTTTC	CARITRTARVWGDSGANVLTF	TRBV25-1	TRBJ2-6
TGCAGTGCTAGAGGGAGTGCGGCCGTGGGTCCTAGCAATCAGCCCCAGCATTTT	CSARGSAAVGPSNQPQHF	TRBV20-1	TRBJ1-5
TGCAGCGTTTCCTCTCCCGTTACTGGAAACACCATATATTTT	CSVSSPVTGNTIYF	TRBV29-1	TRBJ1-3
TGTGCCAGCAGTTTGGGGGGCGGGGGGGGCACAGATACGCAGTATTTT	CASSLGGGGGTDTQYF	TRBV12-3	TRBJ2-3
TGCGCCAGCAGCTTGAAGCGGAGTTCGGGGTACGAGCAGTACTTC	CASSLKRSSGYEQYF	TRBV5-1	TRBJ2-7
TGTGCCACCAGTGACAAGCGAATCTCCTTC	CATSDKRISF	TRBV24-1	TRBJ1-2
TGTGCCAATAGGGGGGCCATGAACACTGAAGCTTTCTTT	CANRGAMNTEAFF	TRBV12-4	TRBJ1-1
TGTGCCAGCAGTGAGTCTTCACAGTCCACTGAAGCTTTCTTT	CASSESSQSTEAFF	TRBV6-4	TRBJ1-1
TGTGCCAGCAGTTACATTCCGACCGGGGAGCTGTTTTTT	CASSYIPTGELFF	TRBV27	TRBJ2-2
TGCGCCAGCAGCTGGAGGGTTGGACGGTGCTCCTACAATGAGCAGTTCTTC	CASSWRVGRCSYNEQFF	TRBV5-1	TRBJ2-1
TGCGCCAGCAGCCAAGAAACCGGGCAGGCTAGCACAGATACGCAGTATTTT	CASSQETGQASTDTQYF	TRBV4-1	TRBJ2-3
TGTGCCAGCACCGGGACTAGCGGGCAAGAGACCCAGTACTTC	CASTGTSGQETQYF	TRBV27	TRBJ2-5
TGTGCCAGCAGCTTAGACAGGGGCTACGAGCAGTACTTC	CASSLDRGYEQYF	TRBV7-9	TRBJ2-7
TGCAGTGCTAGAGATCAGTGGTCTAGCGGGGCCTACAATGAGCAGTTCTTC	CSARDQWSSGAYNEQFF	TRBV20-1	TRBJ2-1
TGCGCCAGCGTACGAAAAGGCAGACCGAATGCAAAGGCCCCTCTGGGCTACACCTTC	CASVRKGRPNAKAPLGYTF	TRBV10-1	TRBJ1-2
TGTGCCAGCAGTACGGGCCCTACGCATGAGCAGTTCTTC	CASSTGPTHEQFF	TRBV28	TRBJ2-1
TGTGCCAGCAGCGTAGTCCATAACAGGGCTTTCCCAACTAATGAAAAACTGTTTTTT	CASSVVHNRAFPTNEKLFF	TRBV9	TRBJ1-4
TGTGCCAGCGCCCGGGGTGAAAAACTGTTTTTT	CASARGEKLFF	TRBV6-5	TRBJ1-4
TGTGCCAGCAGCGGGACCCGGGTAACCACTGAAGCTTTCTTT	CASSGTRVTTEAFF	TRBV5-4	TRBJ1-1
TGTGCCAGCAGCTTAGCCAGGGGACAGCCCGAATGGAAATACGAGCAGTACTTC	CASSLARGQPEWKYEQYF	TRBV7-9	TRBJ2-7
TGTGCCACAGGGTACGGCAATCAGCCCCAGCATTTT	CATGYGNQPQHF	TRBV7-9	TRBJ1-5
TGTGCCAGCAGCCCAGGGGGCAGGTTCCCTGAAGCTTTCTTT	CASSPGGRFPEAFF	TRBV7-9	TRBJ1-1
TGTGCCAGCAGCCGTACCGGGGACGTCCATTATGGCTACACCTTC	CASSRTGDVHYGYTF	TRBV5-6	TRBJ1-2
TGTGCCAGCAGCTTAGGGAGGGATTCCTACGAGCAGTACTTC	CASSLGRDSYEQYF	TRBV7-9	TRBJ2-7
TGTGCCAGCAGCTTAGCGCTCATATACAGGGGTTCTGGCGGGAGGAAAGAGGGGGGATGTCAGCCCCAGCATTTT	CASSLALIYRGSGGRKEGGCQPQHF	TRBV7-9	TRBJ1-5
TGTGCCAGCCTTGAGTTTTCAGGGCACGGAACCGGGGAGCTGTTTTTT	CASLEFSGHGTGELFF	TRBV2	TRBJ2-2
TGTGCCAGCAGCTATCGACTATGCTACAATGAGCAGTTCTTC	CASSYRLCYNEQFF	TRBV11-3	TRBJ2-1
TGCGCCAGCAGAAAAGGGGAGGTTCGATCCTACGAGCAGTACTTC	CASRKGEVRSYEQYF	TRBV10-1	TRBJ2-7
TGTGCCAGCAGCTCCCCCCTTCAGGAGCAGTACTTC	CASSSPLQEQYF	TRBV7-3	TRBJ2-7
TGTGCCAGCAGTTGTCCCAGCCATGGAGGATGCAATCAGCCCCAGCATTTT	CASSCPSHGGCNQPQHF	TRBV6-5	TRBJ1-5
TGTGCCAGCGGGAGCCACTTTTACAATGAGCAGTTCTTC	CASGSHFYNEQFF	TRBV6-6	TRBJ2-1
TGTGCCAGCAGTTTACCCCCACTTACAGGGGCGTTAAGCACAGATACGCAGTATTTT	CASSLPPLTGALSTDTQYF	TRBV12-3	TRBJ2-3
TGTGCCAGCCGCAGGGATCCCGAGCAGTACTTC	CASRRDPEQYF	TRBV9	TRBJ2-7
TGTGCCAGCGTAGGGGAACTTGCACCCTATGGCTACACCTTC	CASVGELAPYGYTF	TRBV18	TRBJ1-2
TGTGCCACCAGTGAGGACAGCTTGAATGAGCAGTTCTTC	CATSEDSLNEQFF	TRBV24-1	TRBJ2-1
TGCGCCAGCAGCCAACCGGTAAGCGGGGACAGTGGCCAAGAGACCCAGTACTTC	CASSQPVSGDSGQETQYF	TRBV4-1	TRBJ2-5
TGTGCCAGTACAGGGGACCTCTACACCTTC	CASTGDLYTF	TRBV19	TRBJ1-2
TGTGCCAGCGTACTGAACCCTGACAACTATGGCTACACCTTC	CASVLNPDNYGYTF	TRBV6-1	TRBJ1-2
TGTGCCAGCAGCTTAGGGGCGGGAGAGAATTCACCCCTCCACTTT	CASSLGAGENSPLHF	TRBV7-6	TRBJ1-6
TGTGCCAGCAGTTACTTACGGGACAGACCCCGAGGAGCTGGGGCCAACGTCCTGACTTTC	CASSYLRDRPRGAGANVLTF	TRBV6-6	TRBJ2-6
TGTGCCAGCAGTGACCACCCCGGGGCGGAGGGCTACACCTTC	CASSDHPGAEGYTF	TRBV6-4	TRBJ1-2
TGTGCCACAAGAAGTTGCACAGATACGCAGTATTTT	CATRSCTDTQYF	TRBV24-1	TRBJ2-3
TGTGCCAGCAGTTACTGCAGCAACTTCAGGGAGGCGGGGTTCGGCAATCAGCCCCAGCATTTT	CASSYCSNFREAGFGNQPQHF	TRBV6-5	TRBJ1-5
TGTGCCACCAGTGATGGAGGGGAGGAGACCCAGTACTTC	CATSDGGEETQYF	TRBV24-1	TRBJ2-5
TGTGCCACCAGTGATAGCGGGAGCCGCAATCAGCCCCAGCATTTT	CATSDSGSRNQPQHF	TRBV24-1	TRBJ1-5
TGTGCCTGGAGTTTAACCCCCGGACAGGGATATGGCTACACCTTC	CAWSLTPGQGYGYTF	TRBV30	TRBJ1-2
TGTGCCAGCAGGTCGAGGCCTGATCAGCCCCAGCATTTT	CASRSRPDQPQHF	TRBV6-2	TRBJ1-5
TGCAGCGTCGAGGGACTCATGAACACTGAAGCTTTCTTT	CSVEGLMNTEAFF	TRBV29-1	TRBJ1-1
TGTGCCAGCAGCTTGCCAGCTAGGAAGGGGCAGATCTCGTGGACTTCTAACTATGGCTACACCTTC	CASSLPARKGQISWTSNYGYTF	TRBV5-5	TRBJ1-2
TGTGCCAGCAGCGGTCGGGACAGGGAACATTCCTATAATTCACCCCTCCACTTT	CASSGRDREHSYNSPLHF	TRBV28	TRBJ1-6
TGTGCCTGGCCGCAGCTAGAACCTGGAAACACCATATATTTT	CAWPQLEPGNTIYF	TRBV30	TRBJ1-3
TGTGCCAGCAGGGGGGCGTGGATTGCAACTAATGAAAAACTGTTTTTT	CASRGAWIATNEKLFF	TRBV7-8	TRBJ1-4
TGTGCCAGCAATGGCTTAAAGGGCAGTGAAGCTTTCTTT	CASNGLKGSEAFF	TRBV6-5	TRBJ1-1
TGTGCCAGCAGCTTAATTATCCATTACAGGGTCAGGGACAGATGGAGCTCCTATAATTCACCCCTCCACTTT	CASSLIIHYRVRDRWSSYNSPLHF	TRBV7-3	TRBJ1-6
TGCGCCAGCAGTGACGCCCCGGGACAGGGGGCGCAGAATGAAGCTTTCTTT	CASSDAPGQGAQNEAFF	TRBV10-2	TRBJ1-1
TGCAGTGCTAGAGATCCTCAAATTGCCCCAACGGGACAGGGGGTGACGTTTGAGACCCAGTACTTC	CSARDPQIAPTGQGVTFETQYF	TRBV20-1	TRBJ2-5
TGTGCCAGCAGTTGTCCGAAGAAGAGCCACGAGCAGTACTTC	CASSCPKKSHEQYF	TRBV27	TRBJ2-7
TGTGCCAGCAGCCAACAGGGGGGGTTTGAAGCTTTCTTT	CASSQQGGFEAFF	TRBV3-1	TRBJ1-1
TGTGCCAGCAGCCAAGATAGGTCCGGAAAGGACGGCAATCAGCCCCAGCATTTT	CASSQDRSGKDGNQPQHF	TRBV3-1	TRBJ1-5
TGTGCCAGCAGGCGGGAGGTTGACGAGCAGTACTTC	CASRREVDEQYF	TRBV9	TRBJ2-7
TGTGCCAGCAGTACTGCTTCAGTAGGGACCACTGAAGCTTTCTTT	CASSTASVGTTEAFF	TRBV12-4	TRBJ1-1
TGTGCCAGCAGTTACTTTAAAAGGGGGTCCACAGATACGCAGTATTTT	CASSYFKRGSTDTQYF	TRBV6-5	TRBJ2-3
TGTGCCAGCACATTGGCGACAGAAAGGGGTCCACCAAACACCGGGGAGCTGTTTTTT	CASTLATERGPPNTGELFF	TRBV27	TRBJ2-2
TGTGCTAGTGGTTTTCCCTCACAAGACAGGGGGCCAAAAGCACTGGACCGGTACGAGCAGTACTTC	CASGFPSQDRGPKALDRYEQYF	TRBV12-5	TRBJ2-7
TGTGCCAGCAGTGAACCCCCGAGGAAGAACACTGAAGCTTTCTTT	CASSEPPRKNTEAFF	TRBV6-1	TRBJ1-1
TGTGCCAGGGGACACGTGAACACCGGGGAGCTGTTTTTT	CARGHVNTGELFF	TRBV4-2	TRBJ2-2
TGTGCCAGCAGCTTACCCCGGGGGGCGGCGAGGAGCACAGATACGCAGTATTTT	CASSLPRGAARSTDTQYF	TRBV7-6	TRBJ2-3
TGTGCCAGCAGCTCGTCCGGGGGGGCCGGGTACGAGCAGTACTTC	CASSSSGGAGYEQYF	TRBV5-6	TRBJ2-7
TGTGCCAGCAGTCTGCCTCCCCGCGACGGGATACGGGGCAAGGAATCACCCCTCCACTTT	CASSLPPRDGIRGKESPLHF	TRBV27	TRBJ1-6
TGCAGCGAGTGTCCTCGCCGACAGGGGTCATTCCCGCCCACTGAAGCTTTCTTT	CSECPRRQGSFPPTEAFF	TRBV29-1	TRBJ1-1
TGTGCCACCAGTGATTTGCGCGGGAGTCAAGAGACGTCTCCTAACTATGGCTACACCTTC	CATSDLRGSQETSPNYGYTF	TRBV24-1	TRBJ1-2
TGCGCCAGCAGCTTGGTAAGCGTGAGCAGGGGGCAAGACAATGAGCAGTTCTTC	CASSLVSVSRGQDNEQFF	TRBV5-1	TRBJ2-1
TGTGCTAGTGGTTCGAAACTCAATCAGCCCCAGCATTTT	CASGSKLNQPQHF	TRBV12-5	TRBJ1-5
TGTGCCAGCAGTGACTCGACCGTTCGGGGGGGGGGTAGCACAGATACGCAGTATTTT	CASSDSTVRGGGSTDTQYF	TRBV6-4	TRBJ2-3
TGCAGTGCACTCTCCAAGCCGAGCTCCTACAATGAGCAGTTCTTC	CSALSKPSSYNEQFF	TRBV20-1	TRBJ2-1
TGTGCCAGCAGTTACTCGAGAGCGGGGCTAAGGGGGAATCAGCCCCAGCATTTT	CASSYSRAGLRGNQPQHF	TRBV6-6	TRBJ1-5
TGTGCCAGCAGCAGGAGGCTGGAGTGCAACACAGGGGGCAAGCGGGGACCCTACGAGCAGTACTTC	CASSRRLECNTGGKRGPYEQYF	TRBV7-2	TRBJ2-7
TGCAGTGCTAGAGATCGGCACAACGATACGCAGTATTTT	CSARDRHNDTQYF	TRBV20-1	TRBJ2-3
TGCGCCAGCAGCTTGGCCCTGCGGATATGGGGTGATACGCAGTATTTT	CASSLALRIWGDTQYF	TRBV5-1	TRBJ2-3
TGTGCCAGTAGTATGGGCCCTTGGGGGGGAGCCGGGGAGCTGTTTTTT	CASSMGPWGGAGELFF	TRBV19	TRBJ2-2
TGTGCCAGCAGCCAATCAGTTGCTAGCGGGTACGAGCTGTTTTTT	CASSQSVASGYELFF	TRBV14	TRBJ2-2
TGTGCCAGCAGTTCGGACGCCGGGGAGCTGTTTTTT	CASSSDAGELFF	TRBV25-1	TRBJ2-2
TGTGCCAGCAGCGACGGTGGAGAGACCCAGTACTTC	CASSDGGETQYF	TRBV11-3	TRBJ2-5
TGTGCCAGCAGCATCCGTCAGGGGGGAGCGTACTTC	CASSIRQGGAYF	TRBV13	TRBJ2-5
TGTGCCAGCTGGGAGGGGGTCCAGTACTTC	CASWEGVQYF	TRBV25-1	TRBJ2-5
TGTGCCAGCCCCGCGAGGTTACCGTGGGACTATGGCTACACCTTC	CASPARLPWDYGYTF	TRBV7-3	TRBJ1-2
TGCAGTGACCAGCTTAGGGACAGGGGTAGCACAGATACGCAGTATTTT	CSDQLRDRGSTDTQYF	TRBV20-1	TRBJ2-3
TGTGCCAGCAGCTTAGATCCGGGAGGGGGCTCCTACAATGAGCAGTTCTTC	CASSLDPGGGSYNEQFF	TRBV13	TRBJ2-1
TGTGCCAGCAGCTTGGGCCAGCCCCAGCATTTT	CASSLGQPQHF	TRBV7-9	TRBJ1-5
TGCGCCAGCAGCTTGAGGGGAATCTTATACGAGCAGTACTTC	CASSLRGILYEQYF	TRBV5-1	TRBJ2-7
TGTGCCAGCTCACCTAGGGTACTAGCGGGAGGGCAGGACTACGAGCAGTACTTC	CASSPRVLAGGQDYEQYF	TRBV18	TRBJ2-7
TGTGCCAGCCGATGCGTGGGGGTATGGTACTTC	CASRCVGVWYF	TRBV7-3	TRBJ2-4
TGTGCCACCAGTGCTCGACAGGGGGCGGGAAGCACCGGGGAGCTGTTTTTT	CATSARQGAGSTGELFF	TRBV24-1	TRBJ2-2
TGTGCCAGCGACCTTATTTCGGGGATAGAATCCTATAATTCACCCCTCCACTTT	CASDLISGIESYNSPLHF	TRBV6-5	TRBJ1-6
TGCGCCAGCATGTTATTCCAGTATCACAGGGGAAAGGGGTCATCCTACGAGCAGTACTTC	CASMLFQYHRGKGSSYEQYF	TRBV5-1	TRBJ2-7
TGCAGTGCTAGTGACAGGGAGGGTGAGGGGACAGATACGCAGTATTTT	CSASDREGEGTDTQYF	TRBV20-1	TRBJ2-3
TGTGCCAGCAGGGCTCTTAGTGGGACTGGACGTCCCGAGCAGTACTTC	CASRALSGTGRPEQYF	TRBV6-5	TRBJ2-7
TGTGCCAGCAGTTTAACAGGGTCCTGCACAGATACGCAGTATTTT	CASSLTGSCTDTQYF	TRBV12-3	TRBJ2-3
TGTGCCAGCAGCGTAGGAGGGCCGTACGAGCAGTACTTC	CASSVGGPYEQYF	TRBV9	TRBJ2-7
TGTGCCAGCAGCGACTCTACGAGGGTAGATACGCAGTATTTT	CASSDSTRVDTQYF	TRBV5-4	TRBJ2-3
TGCGCCAGCAGCCAAGAAGACAGGGGTACTACGAACACTGAAGCTTTCTTT	CASSQEDRGTTNTEAFF	TRBV4-3	TRBJ1-1
TGTGCCAGCAGCTTAAGGCGGGCCAAAAACATTCAGTACTTC	CASSLRRAKNIQYF	TRBV7-8	TRBJ2-4
TGTAGCACTAGAGCCGGGGAGCTGTTTTTT	CSTRAGELFF	TRBV7-2	TRBJ2-2
TGTGCCACCAGTGATTCACGAGCCCCGGCTCTCCGATTGAGCACAGATACGCAGTATTTT	CATSDSRAPALRLSTDTQYF	TRBV24-1	TRBJ2-3
TGTGCCACCAGTTGGGGCGAAACAGAAGAGACCCAGTACTTC	CATSWGETEETQYF	TRBV24-1	TRBJ2-5
TGCAGCGTTGAGTCCGTAGGGGTGGGGTCCCCCTACGAGCAGTACTTC	CSVESVGVGSPYEQYF	TRBV29-1	TRBJ2-7
TGTGCCACCAGTGAGGGGACTAGCAATCAGCCCCAGCATTTT	CATSEGTSNQPQHF	TRBV24-1	TRBJ1-5
TGTGCCCGACTAGCGGGGTACAATGAGCAGTTCTTC	CARLAGYNEQFF	TRBV28	TRBJ2-1
TGTGCCAGCAGCATGACAGGGACGATTTTGAACACTGAAGCTTTCTTT	CASSMTGTILNTEAFF	TRBV7-3	TRBJ1-1
TGTGCTAGTGGGCATACAGCCACAGATACGCAGTATTTT	CASGHTATDTQYF	TRBV12-5	TRBJ2-3
TGTGCCAGCATTAGGACAGGGGGCAGCAATCAGCCCCAGCATTTT	CASIRTGGSNQPQHF	TRBV25-1	TRBJ1-5
TGTGCCAGCAACGAACTCAATGAAAAACTGTTTTTT	CASNELNEKLFF	TRBV2	TRBJ1-4
TGTGCCAGCAGCGGGGATCTGGGTCAGCCCCAGCATTTT	CASSGDLGQPQHF	TRBV7-9	TRBJ1-5
TGTGCCAGCAAGGGCCCTCTTTGCAATCAGCCCCAGCATTTT	CASKGPLCNQPQHF	TRBV6-1	TRBJ1-5
TGTGCCAGTACGCCCCAGGGACAGGACGAGCAGTACTTC	CASTPQGQDEQYF	TRBV19	TRBJ2-7
TGTGCCAGCAGTTACGATAGCGGGAAACCGCGCACAGATACGCAGTATTTT	CASSYDSGKPRTDTQYF	TRBV6-6	TRBJ2-3
TGTGCCAGCAGCCACAGGGCTCCGGGGCAAAAACTGTTTTTT	CASSHRAPGQKLFF	TRBV6-5	TRBJ1-4
TGTGCCAGCAGCAAAACAGGGAATATTGAAGCTTTCTTT	CASSKTGNIEAFF	TRBV11-2	TRBJ1-1
TGTGCCTGGAGTGTATGGCCGGGACAGGCATCCTACGAGCAGTACTTC	CAWSVWPGQASYEQYF	TRBV30	TRBJ2-7
TGTGCCAAGGGGAGGAGGACAGGGGGTTTATGTAACTATGGCTACACCTTC	CAKGRRTGGLCNYGYTF	TRBV27	TRBJ1-2
TGCGCCAGCAGCCCTGAAAGTGAGCAGTTCTTC	CASSPESEQFF	TRBV5-1	TRBJ2-1
TGCAGTGCATATGCTCTACGCCACGAGGTCTTC	CSAYALRHEVF	TRBV20-1	TRBJ2-1
TGTGCCAGCAGCTCGGAGGGGCGGCGCTACACCTTC	CASSSEGRRYTF	TRBV11-2	TRBJ1-2
TGTGCCAGCAGCCACAGAGAAGGCTATGAGCAGTACTTC	CASSHREGYEQYF	TRBV14	TRBJ2-7
TGCAAAAAATTTTTTACAAAAAACACCGGGGAGCTGTTTTTT	CKKFFTKNTGELFF	TRBV29-1	TRBJ2-2
TGTGCCACGCACGATTATGAGCAGTTCTTC	CATHDYEQFF	TRBV19	TRBJ2-1
TGTGCCACCAGCTTAGGGTTCACAGATACGCAGTATTTT	CATSLGFTDTQYF	TRBV24-1	TRBJ2-3
TGCAGTGCGCGGGACAGGACCTTATTGCAGCCCCAGCATTTT	CSARDRTLLQPQHF	TRBV20-1	TRBJ1-5
TGTGCCAGTCCTAGTCGGACAGCAGAAAATGGCTACACCTTC	CASPSRTAENGYTF	TRBV19	TRBJ1-2
TGTGCCAGCAGCTTAAGGGGACCTGAAGACGAGCAGTACTTC	CASSLRGPEDEQYF	TRBV7-3	TRBJ2-7
TGTGCCAGCAGTTTACGAAGGGGGACTAGCGGGGTGAACAATGAGCAGTTCTTC	CASSLRRGTSGVNNEQFF	TRBV12-4	TRBJ2-1
TGTGCCACCAGTAAGACAGGGGTCTATGGCTACACCTTC	CATSKTGVYGYTF	TRBV24-1	TRBJ1-2
TGCGCCAGCAGCATGGACAGGGTCCGAGAGACCCAGTACTTC	CASSMDRVRETQYF	TRBV4-1	TRBJ2-5
TGTGCCAGCAGTGGGACTAGCGGGGGGGCCGGAAAGGGCTACGAGCAGTACTTC	CASSGTSGGAGKGYEQYF	TRBV2	TRBJ2-7
TGTGCCAGCAGTTATTCAGGCTTGAGGCGTCGGCCCCAGCATTTT	CASSYSGLRRRPQHF	TRBV6-5	TRBJ1-5
TGTGCCAGGGGTAGTTGGAACACCGGGGAGCTGTTTTTT	CARGSWNTGELFF	TRBV6-2	TRBJ2-2
TGTGCCAGCAGCGACAGGGGGCGCGGTGGTAACCCCCAGTACTTC	CASSDRGRGGNPQYF	TRBV5-4	TRBJ2-5
TGCGCCAGCAGCCAAGATCCCACAGATAGGCAAGAGACCCAGTACTTC	CASSQDPTDRQETQYF	TRBV4-1	TRBJ2-5
TGCAGTGCGGTGGCCCCGAACGGGACAGGGTCAAACATTCAGTACTTC	CSAVAPNGTGSNIQYF	TRBV20-1	TRBJ2-4
TGTGCCACCAGTGATCTAAACCGTCACTATACCACGAAAGTGGACTATGGCTACACCTTC	CATSDLNRHYTTKVDYGYTF	TRBV24-1	TRBJ1-2
TGTGCCAGCAGTTACTCGGGTAAGAAGGGGCCGCCTATCACCGGGGAGCTGTTTTTT	CASSYSGKKGPPITGELFF	TRBV6-5	TRBJ2-2
TGCAGTGCTAGATTCCACAGGCCCAAGCTGAACACTGAAGCTTTCTTT	CSARFHRPKLNTEAFF	TRBV20-1	TRBJ1-1
TGTGCCAGCAGTCGCAGGGGGCGTACCCCAGGACTCGATGGCTACACCTTC	CASSRRGRTPGLDGYTF	TRBV6-5	TRBJ1-2
TGCAGCGGGCCCGCTGGGACAGGGGCCGCTAACTATGGCTACACCTTC	CSGPAGTGAANYGYTF	TRBV29-1	TRBJ1-2
TGTGCCAGCAGCGATGGAGTTAAATATGGCTACACCTTC	CASSDGVKYGYTF	TRBV11-2	TRBJ1-2
TGTGCCAGCACAATGGGGGGGGGGGCCTACGAGCAGTACTTC	CASTMGGGAYEQYF	TRBV6-2	TRBJ2-7
TGTGCCAGCAGCCCCCAGGGGGCGAAATTGTATGGCTACACCTTC	CASSPQGAKLYGYTF	TRBV7-9	TRBJ1-2
TGTGCCAGCAGTGGCCCTCCGGGACTAGCCTATGAGCAGTTCTTC	CASSGPPGLAYEQFF	TRBV25-1	TRBJ2-1
TGTGCCACCAGTGATTTTGAGGGAGATGACACCATATATTTT	CATSDFEGDDTIYF	TRBV24-1	TRBJ1-3
TGTGCCAGCAGTCGCCGGGGCATGCACGAGCAGTACTTC	CASSRRGMHEQYF	TRBV28	TRBJ2-7
TGTGCCAGCAGCTTGGGGGGGGAGAGTATTCAGCCCCAGCATTTT	CASSLGGESIQPQHF	TRBV5-4	TRBJ1-5
TGTGCCAGCAGTGATACTAGAGAGCAGTACTTC	CASSDTREQYF	TRBV6-4	TRBJ2-7
TGTGCCCTCCCGTTCCGGGACGCCCCCAAAAACATTCAGTACTTC	CALPFRDAPKNIQYF	TRBV7-9	TRBJ2-4
TGTGCCAGCAGCTACTCTTCAATTACTTTATCCTACGAGCAGTACTTC	CASSYSSITLSYEQYF	TRBV5-6	TRBJ2-7
TGCGCCAGCAGCCACCCTCCGGGGGTCGGCCTTCAGCCCCAGCATTTT	CASSHPPGVGLQPQHF	TRBV4-1	TRBJ1-5
TGTGCCACCACTTCGGGAGGGGCGTCTGGGGCCAACGTCCTGACTTTC	CATTSGGASGANVLTF	TRBV24-1	TRBJ2-6
TGCGCCAGCAGCTGTGTAAGGGTCTATGGCTACACCTTC	CASSCVRVYGYTF	TRBV5-1	TRBJ1-2
TGTGCCAGCTCACCGCAGGGGTCGGGCTCAGTGGGTCGACAAGAGACCCAGTACTTC	CASSPQGSGSVGRQETQYF	TRBV18	TRBJ2-5
TGCGCCAGCAGCCAACGCCGAGCCGAGGAGTCGAATGCCTACGAGCAGTACTTC	CASSQRRAEESNAYEQYF	TRBV4-1	TRBJ2-7
TGTGCCAGTAGTAGAGAGTACCTCAGTTCCGATTCACCCCTCCACTTT	CASSREYLSSDSPLHF	TRBV19	TRBJ1-6
TGCGCCAGCAGCTGGGACTTAGGGGCCAGCTCTGGAAACACCATATATTTT	CASSWDLGASSGNTIYF	TRBV5-1	TRBJ1-3
TGCAGCCTGCAGGATTTCTACGAGCAGTACTTC	CSLQDFYEQYF	TRBV29-1	TRBJ2-7
TGTGCCAGCAGCGAGGGCAGGGGATGCCACGAGCAGTACTTC	CASSEGRGCHEQYF	TRBV11-2	TRBJ2-7
TGTGCCACCAGTGAACCTAAGGACAGGGGAACTCAGCCCCAGCATTTT	CATSEPKDRGTQPQHF	TRBV24-1	TRBJ1-5
TGTGCCAGTAGTATTTCTACTATGAGCTACGAGCAGTACTTC	CASSISTMSYEQYF	TRBV19	TRBJ2-7
TGTGCCAGCAGCGCCGGACAGGTTAGGGAGCAGTACTTC	CASSAGQVREQYF	TRBV9	TRBJ2-7
TGTGCCACCAGTGATTTCGATCAGGGGGAGTCTTACGAGCAGTACTTC	CATSDFDQGESYEQYF	TRBV24-1	TRBJ2-7
TGCGCCAGCAGCCAAGCACGAGAGGCGGGAGTAGGGTTTAAAGAGACCCAGTACTTC	CASSQAREAGVGFKETQYF	TRBV4-1	TRBJ2-5
TGTGCCAGCAGACTAACGGGGGCCTATGGCTACACCTTC	CASRLTGAYGYTF	TRBV6-2	TRBJ1-2
TGTGCCAGCAGTGGTCCGCAGGGCGAGACCCAGTACTTC	CASSGPQGETQYF	TRBV12-3	TRBJ2-5
TGTGCCAGCAGTGGGGACAGGGCCAACAGCCAGAGTAGCAATCAGCCCCAGCATTTT	CASSGDRANSQSSNQPQHF	TRBV2	TRBJ1-5
TGTGCCACCCCCGGACAGGGGGGGGGAACCGGGGAGCTGTTTTTT	CATPGQGGGTGELFF	TRBV24-1	TRBJ2-2
TGTGCCAGCAGCCGGTCGCAAAGTTTGCCAGCTAACTATGGCTACACCTTC	CASSRSQSLPANYGYTF	TRBV7-3	TRBJ1-2
TGCAGCGAATTCGGACAGGGCACAGATACGCAGTATTTT	CSEFGQGTDTQYF	TRBV29-1	TRBJ2-3
TGTGCCAGCAGCTTGGGGGGGGGCCCGCAAGAGACCCAGTACTTC	CASSLGGGPQETQYF	TRBV7-6	TRBJ2-5
TGCAGTGCTAGCGCACGACTAGCGCGGGCCTACGAGCAGTACTTC	CSASARLARAYEQYF	TRBV20-1	TRBJ2-7
TGTGCCAGCAGTGAGTCCCACTTAGCTTTCTTT	CASSESHLAFF	TRBV2	TRBJ1-1
TGTGCCACCAGCAGAGGGTGCCGGGAGGGACAAGAGACCCAGTACTTC	CATSRGCREGQETQYF	TRBV15	TRBJ2-5
TGTGCCAGCAGCGTCCGTAGGGATCAAGAGACCCAGTACTTC	CASSVRRDQETQYF	TRBV13	TRBJ2-5
TGTGCCAGCAGCCCCCAAAAGGGGCCAGGCATGAACACTGAAGCTTTCTTT	CASSPQKGPGMNTEAFF	TRBV11-1	TRBJ1-1
TGTGCCAGCACAACCCTTATCTGCGGTCGGCCAGCACACGAGCAGTACTTC	CASTTLICGRPAHEQYF	TRBV28	TRBJ2-7
TGTGCCAGCAGCTTCGGGACAGGGGGCACAGATACGCAGTATTTT	CASSFGTGGTDTQYF	TRBV7-9	TRBJ2-3
TGCAGTGCGCCTAGCGGGGGGGCTAGCACAGATACGCAGTATTTT	CSAPSGGASTDTQYF	TRBV20-1	TRBJ2-3
TGTGCCAGCAGCCCCCTGGGACCTGGGGCCAACGTCCTGACTTTC	CASSPLGPGANVLTF	TRBV5-6	TRBJ2-6
TGTGCCAGCAGTACAAGTGGCTACACCTTC	CASSTSGYTF	TRBV12-4	TRBJ1-2
TGTGCCAGCAGCGTACCAGCAAAGGGGGGATGGGATGATCGCAGCTTTCCCGGCTACACCTTC	CASSVPAKGGWDDRSFPGYTF	TRBV7-9	TRBJ1-2
TGTGCCAGCAGTGAACCCATCCCGGACAGGGGAGCGACTCTCGAGCAGTACTTC	CASSEPIPDRGATLEQYF	TRBV6-1	TRBJ2-7
TGTGCCAGCAGCGTAGAACCACGGGGCGGACGATACGAGCAGTACTTC	CASSVEPRGGRYEQYF	TRBV9	TRBJ2-7
TGTGCCAGCAGTCGGCTAGCGGGAGATGAGCAGTTCTTC	CASSRLAGDEQFF	TRBV7-9	TRBJ2-1
TGTGCCAGTAGTACTCCGGCAGACACTGAAGCTTTCTTT	CASSTPADTEAFF	TRBV19	TRBJ1-1
TGTGCCAGCAGCTTGCCCCACCCTTCTACCGGGACAGGGGAAAAACTGTTTTTT	CASSLPHPSTGTGEKLFF	TRBV11-3	TRBJ1-4
TGTGCCAGCAGTGCCCTACAGGGGACCAGCTCCTATAATTCACCCCTCCACTTT	CASSALQGTSSYNSPLHF	TRBV27	TRBJ1-6
TGTGCCAGCTCACCACCGGCTCGGTCTCGGACGAACACTGAAGCTTTCTTT	CASSPPARSRTNTEAFF	TRBV18	TRBJ1-1
TGCGCCAGCAGCCACATCCCGGCTCGGCCCGGGACAGGGGCGCAGCCCCAGCATTTT	CASSHIPARPGTGAQPQHF	TRBV4-1	TRBJ1-5
TGTGCCAGGAGGGCAGAAGGCAATCAGCCCCAGCATTTT	CARRAEGNQPQHF	TRBV9	TRBJ1-5
TGTGCCAGCAGTGAGTCGGGACAGGGTTTATTGAACACTGAAGCTTTCTTT	CASSESGQGLLNTEAFF	TRBV2	TRBJ1-1
TGTGCCTGGCAGGGTGGGGCCGCCAAAAACATTCAGTACTTC	CAWQGGAAKNIQYF	TRBV19	TRBJ2-4
TGTGCCAGCAGCCAAGTTGGACAGGCTAATCAGCCCCAGCATTTT	CASSQVGQANQPQHF	TRBV3-1	TRBJ1-5
TGTGATCACGTGCTCCGGAACGAGCAGTACTTC	CDHVLRNEQYF	TRBV2	TRBJ2-7
TGCGCCAGAACACGGAGTAACGCTGAAGCTTTCTTT	CARTRSNAEAFF	TRBV10-1	TRBJ1-1
TGTACCCCGGACAGAGAAGCTAGTTTTAGCTCCTATAATTCACCCCTCCACTTT	CTPDREASFSSYNSPLHF	TRBV19	TRBJ1-6
TGTGCCAGCAGCAACAGGGGCCACTATGGCTACACCTTC	CASSNRGHYGYTF	TRBV13	TRBJ1-2
TGCGCCAGCAGCGGGGGCGCCTATAGCAATCAGCCCCAGCATTTT	CASSGGAYSNQPQHF	TRBV4-1	TRBJ1-5
TGCGCCAGCATGCGGACCTACGAGCAGTACTTC	CASMRTYEQYF	TRBV10-2	TRBJ2-7
TGTGCCACCAGTGATTTGCCGAGCAATCAGCCCCAGCATTTT	CATSDLPSNQPQHF	TRBV24-1	TRBJ1-5
TGTGCCACCATTGCTTCAGGTAGACAGGGGGGGTCAGAAGGCTACACCTTC	CATIASGRQGGSEGYTF	TRBV15	TRBJ1-2
TGTGCCAGCAGTGACGCCGGATATGAGGTTGAAATGAACACTGAAGCTTTCTTT	CASSDAGYEVEMNTEAFF	TRBV6-4	TRBJ1-1
TGTGCCAGCAGTTTCGGAGGGGGTGAAGCTTTCTTT	CASSFGGGEAFF	TRBV12-4	TRBJ1-1
TGTGGCCGGGACAGTGAAAAACTGTTTTTT	CGRDSEKLFF	TRBV12-3	TRBJ1-4
TGTGCCAGCAGTCGGGGGGAGGGCGAAGTCTCTGGAAACACCATATATTTT	CASSRGEGEVSGNTIYF	TRBV6-5	TRBJ1-3
TGTGCCACCGCACACGTGAGTTCACCCCTCCACTTT	CATAHVSSPLHF	TRBV24-1	TRBJ1-6
TGTGCCAGCCAGGGGCGACCACAGGGGGGAGTGGGAGGCAATCAGCCCCAGCATTTT	CASQGRPQGGVGGNQPQHF	TRBV2	TRBJ1-5
TGTGCCAGCAGTTACCGGGACACACGCGCCGCCAATGAGCAGTTCTTC	CASSYRDTRAANEQFF	TRBV6-5	TRBJ2-1
TGTGCCAGCTCACCACGAGGCTTTCCGTCTCCCTACGAGCAGTACTTC	CASSPRGFPSPYEQYF	TRBV18	TRBJ2-7
TGTGCCAGCAGTGAGGGCCAGGCTCGACTAGCGGACAATGAGCAGTTCTTC	CASSEGQARLADNEQFF	TRBV25-1	TRBJ2-1
TGTGCCAGCAGTTTAATAGCCCCCGGGACAGGGGGCTGGGCTGGGGCCAACGTCCTGACTTTC	CASSLIAPGTGGWAGANVLTF	TRBV12-4	TRBJ2-6
TGTGCCAGCAGTGGGGACGGAAACACCGGGGAGCTGTTTTTT	CASSGDGNTGELFF	TRBV25-1	TRBJ2-2
TGTGCCAGCAGCCTAAGCGGGGGAACTGGTGGCAGGTGGACCTACGAGCAGTACTTC	CASSLSGGTGGRWTYEQYF	TRBV7-3	TRBJ2-7
TGTGCCAGCAGAAACGAACTTGAAAGCACAGATACGCAGTATTTT	CASRNELESTDTQYF	TRBV5-4	TRBJ2-3
TGTGCCAGCAGTTACCCGGGACAGGGGGGGGAGTACGAGCAGTACTTC	CASSYPGQGGEYEQYF	TRBV6-2	TRBJ2-7
TGTGCCAGCAGCCAAGATGGGGGCGTTCCCTATGGCTACACCTTC	CASSQDGGVPYGYTF	TRBV3-1	TRBJ1-2
TGTGCCAGCAAGAGGGCGCCGGGACAGGGGGCCAAAGAGACCCAGTACTTC	CASKRAPGQGAKETQYF	TRBV27	TRBJ2-5
TGTGCCACCTCTCCCGGACGGGCTGGCTACACCTTC	CATSPGRAGYTF	TRBV7-8	TRBJ1-2
TGTGCCAGCAGTTACAAGATGGGGGATGAAGCTTTCTTT	CASSYKMGDEAFF	TRBV6-3	TRBJ1-1
TGTGCCAGCAGCGGGGGACCCATCGGGACAGGGGGCGAAGAGACCCAGTACTTC	CASSGGPIGTGGEETQYF	TRBV13	TRBJ2-5
TGTGCCAGCAGGATTTCGATTGGAAACACCATATATTTT	CASRISIGNTIYF	TRBV12-4	TRBJ1-3
TGTGCCAGCAGCTTAGCGACAGGTGGCTACACCTTC	CASSLATGGYTF	TRBV7-9	TRBJ1-2
TGTGCCAGCAGTTACTCGCCAAGACAGGGGGCGCTTAGCTCCTACGAGCAGTACTTC	CASSYSPRQGALSSYEQYF	TRBV6-5	TRBJ2-7
TGTGCCAGCATAAACAGGGTTCCCAATCAGCCCCAGCATTTT	CASINRVPNQPQHF	TRBV7-3	TRBJ1-5
TGTGCCAGTAGTTCGGCCTCTGGGCGGGTGAACACTGAAGCTTTCTTT	CASSSASGRVNTEAFF	TRBV19	TRBJ1-1
TGTGCGTCCCAGGGGGGGCCGGATCGGTTCGGGGAGCTGTTTTTT	CASQGGPDRFGELFF	TRBV9	TRBJ2-2
TGTGCCAGCAGCTTCACCGACAGTACGTCGTACGAGCAGTACTTC	CASSFTDSTSYEQYF	TRBV9	TRBJ2-7
TGCGCCAGCAGCTCAAGCCCCCGGACAGGGTGTTCCGAGCAGTACTTC	CASSSSPRTGCSEQYF	TRBV5-1	TRBJ2-7
TGTGCCAGCAGTTACTCGAGCAAGAGCGGGAAGAACAATGAAAAACTGTTTTTT	CASSYSSKSGKNNEKLFF	TRBV6-5	TRBJ1-4
TGTGCCAGCAGCTTCAGGGGCCCAAAGCAGCCCCAGCATTTT	CASSFRGPKQPQHF	TRBV5-6	TRBJ1-5
TGTGCCAGCGAGTACGGTGTCGGGGGGGGGGGGTATTCCTACGAGCAGTACTTC	CASEYGVGGGGYSYEQYF	TRBV6-2	TRBJ2-7
TGCGCCAGCAGAAACAGGCTTGGAAACACCATATATTTT	CASRNRLGNTIYF	TRBV5-1	TRBJ1-3
TGCAGTGCTAGCCCCCCCGCGGCAAGCTACGAGCAGTACTTC	CSASPPAASYEQYF	TRBV20-1	TRBJ2-7
TGTGCCAGCAGCCCCCTACTGAAGAGGGGGCAAAAACTGTGCCATGGCTACACCTTC	CASSPLLKRGQKLCHGYTF	TRBV7-9	TRBJ1-2
TGTGCCTCAAACAGGGGGCGAATTTATGGCTACACCTTC	CASNRGRIYGYTF	TRBV3-1	TRBJ1-2
TGCAGCGGTAAGGGAAGAAACACCATATATTTT	CSGKGRNTIYF	TRBV29-1	TRBJ1-3
TGTGCCAGCAGTGTCCGGCGGAGACAGGGAAGCGGAAGCAACTATGGCTACACCTTC	CASSVRRRQGSGSNYGYTF	TRBV2	TRBJ1-2
TGCAGTGCTAGAGGCCCGGGCAGGAGGCTCTACGAGCAGTACTTC	CSARGPGRRLYEQYF	TRBV20-1	TRBJ2-7
TGTGCCAGCAGCTTAGATCGGAACGGGACAGGGGGCTACGAGCAGTACTTC	CASSLDRNGTGGYEQYF	TRBV11-2	TRBJ2-7
TGTGCCAGCAGCCTACCCCCTAGCGGGGGAGGCTACAATGAGCAGTTCTTC	CASSLPPSGGGYNEQFF	TRBV3-1	TRBJ2-1
TGTGCCAGCAGCCAAGATAGCGGACAGGGTAGGAAAGGAAAGGCCTACGAGCAGTACTTC	CASSQDSGQGRKGKAYEQYF	TRBV14	TRBJ2-7
TGCGCCAGCTCGCCTGCCCTAGCCAAAAACATTCAGTACTTC	CASSPALAKNIQYF	TRBV10-1	TRBJ2-4
TGTGCCAGCAGCAAGGACCCTGCGTATGGCTACACCTTC	CASSKDPAYGYTF	TRBV11-2	TRBJ1-2
TGTGCCAGCAGACCTAAACTGGGGGGGCCCGCAGATACGCAGTATTTT	CASRPKLGGPADTQYF	TRBV6-5	TRBJ2-3
TGTGCCAGCAGCTTATCTAGCGGGGGGCTCCCGGTAAATGAGCAGTTCTTC	CASSLSSGGLPVNEQFF	TRBV5-6	TRBJ2-1
TGTGCCAGCAGCCTTGCCCCGCTGCGAGAAAGCTACGAGCAGTACTTC	CASSLAPLRESYEQYF	TRBV14	TRBJ2-7
TGCGCCAGCCTTAGTCTCCGGGACTTAGTCTACGAGCAGTACTTC	CASLSLRDLVYEQYF	TRBV10-1	TRBJ2-7
TGTGCCAGCAGTTTTAGAACCTCAGGGGGTTTGATTCAGCCCCAGCATTTT	CASSFRTSGGLIQPQHF	TRBV28	TRBJ1-5
TGTGCCAGCAGTTCGAGCGGTAGTTTGGGGGCCGGGGAGCTGTTTTTT	CASSSSGSLGAGELFF	TRBV7-3	TRBJ2-2
TGTGCCAGCAGCACTAGTACCTACGAGCAGTACTTC	CASSTSTYEQYF	TRBV6-2	TRBJ2-7
TGTGCCAGCAGTGAACTGAGACAGGGGTTAGGCACTGAAGCTTTCTTT	CASSELRQGLGTEAFF	TRBV25-1	TRBJ1-1
TGTGCCAGGCGGACATCTCCCTACAATGAGCAGTTCTTC	CARRTSPYNEQFF	TRBV28	TRBJ2-1
TGTGCCAGCAGCGTGGACCCTAAACAGGGGGCCGACTCCTACGAGCAGTACTTC	CASSVDPKQGADSYEQYF	TRBV9	TRBJ2-7
TGTGCCAGCAGCCGGGACAGTACTAATGAAAAACTGTTTTTT	CASSRDSTNEKLFF	TRBV9	TRBJ1-4
TGTGCCAGCAGCGGTCGAGCGCGGGGAAATGAGCAGTTCTTC	CASSGRARGNEQFF	TRBV7-9	TRBJ2-1
TGTGCCAGCAGTTACCGTGCGGGGAGCTGCATCTTT	CASSYRAGSCIF	TRBV6-5	TRBJ1-1
TGCGCCAGCAGCTTGGCGGCACTCGATTTCGCGAACACCGGGGAGCTGTTTTTT	CASSLAALDFANTGELFF	TRBV5-1	TRBJ2-2
TGCGCCAGCAGCTGTGAGGTCGGGGGGCGCGAGACCCAGTACTTC	CASSCEVGGRETQYF	TRBV5-1	TRBJ2-5
TGTGCCAGCAGCGGCACCGGGACAGGTGCCTGTTCTGAAGCTTTCTTT	CASSGTGTGACSEAFF	TRBV9	TRBJ1-1
TGTGCCAGCAGTAAGACAGGGAGCAATCAGCCCCAGCATTTT	CASSKTGSNQPQHF	TRBV28	TRBJ1-5
TGTGCCACCAGTGGGGACCATGCCTACGAGCAGTACTTC	CATSGDHAYEQYF	TRBV24-1	TRBJ2-7
TGTGCCAGCAGTTACCTAAGGTTTAAAGAGACCCAGTACTTC	CASSYLRFKETQYF	TRBV6-6	TRBJ2-5
TGTGCCTGGTCCCGAGGGGTTGAATACTCCTACAATGAGCAGTTCTTC	CAWSRGVEYSYNEQFF	TRBV30	TRBJ2-1
TGTGCCAGCACCCGAAGGACGTGCCCCTGCAACACCATATATTTT	CASTRRTCPCNTIYF	TRBV28	TRBJ1-3
TGTGCCAGCAGCTTGGGGTACGGGACAGGGATTAATCAGCCCCAGCATTTT	CASSLGYGTGINQPQHF	TRBV5-4	TRBJ1-5
TGCGCCAGCAGGATCCGGGGAGAGAGCAATCAGCCCCAGCATTTT	CASRIRGESNQPQHF	TRBV5-1	TRBJ1-5
TGCGCCAGCAGCCTTAGGGATTACCGGGACAATGAGCAGTTCTTC	CASSLRDYRDNEQFF	TRBV5-1	TRBJ2-1
TGTGCCAGGGAGGTTGGAGGGGGAAACACCATATATTTT	CAREVGGGNTIYF	TRBV6-2	TRBJ1-3
TGCAGTGCTTTAATACCGACTAGCGGGGGGTACTACGAGCAGTACTTC	CSALIPTSGGYYEQYF	TRBV20-1	TRBJ2-7
TGTGCCAGCATCCCTTGGGTACACACTGAAGCTTTCTTT	CASIPWVHTEAFF	TRBV7-9	TRBJ1-1
TGCGCCAGCAGCAAGGGGGGCGGCATGTTTGAGCAGTTCTTC	CASSKGGGMFEQFF	TRBV5-1	TRBJ2-1
TGTGCCAGCCGCCATAGCGGGGCAGATACGCAGTATTTT	CASRHSGADTQYF	TRBV7-3	TRBJ2-3
TGTGCCAGCAGCCAACCGTTGTCCCGGGACAGGACTGAAGCTTTCTTT	CASSQPLSRDRTEAFF	TRBV3-1	TRBJ1-1
TGTGCCAGCAGCTTACCTTGGGGCCGGAACACTGAAGCTTTCTTT	CASSLPWGRNTEAFF	TRBV7-3	TRBJ1-1
TGTGCCATCACCCCTAGCGGGTCGCTCTACGAGCAGTACTTC	CAITPSGSLYEQYF	TRBV10-3	TRBJ2-7
TGTGCCAGCTCACCAAGGCGGCGGAGCACTGAAGCTTTCTTT	CASSPRRRSTEAFF	TRBV18	TRBJ1-1
TGTGCCAGCTCACCTTTGGCCGAGGGTGGCTACGAGCAGTACTTC	CASSPLAEGGYEQYF	TRBV18	TRBJ2-7
TGTGCCAGCAGCGATAGGGACCCCTACGAGCAGTACTTC	CASSDRDPYEQYF	TRBV6-8	TRBJ2-7
TGTGCCAGCAGCTCTCAGGGGGCTGGGGCCAACGTCCTGACTTTC	CASSSQGAGANVLTF	TRBV7-3	TRBJ2-6
TGTGCCAGCAGGGGCAGCTCCTATAATTCACCCCTCCACTTT	CASRGSSYNSPLHF	TRBV12-4	TRBJ1-6
TGTGCCAGCAGGAACAGGGGGCTCATCAATGAGCAGTTCTTC	CASRNRGLINEQFF	TRBV12-4	TRBJ2-1
TGTGCCTTAGACGAAAGACTAGCGGGGACCTACGAGCAGTACTTC	CALDERLAGTYEQYF	TRBV10-3	TRBJ2-7
TGCGCCAGCAGTCGCCGACCGGGGTCCCACGAGCAGTACTTC	CASSRRPGSHEQYF	TRBV10-1	TRBJ2-7
TGTGCCAGCAGCCCTACTAGGTCCTTGGGCACAGATACGCAGTATTTT	CASSPTRSLGTDTQYF	TRBV11-3	TRBJ2-3
TGTGCCAGCAGTTACGACAGGGGGGCCTCTGGGGCCAACGTCCTGACTTTC	CASSYDRGASGANVLTF	TRBV6-6	TRBJ2-6
TGCGCCAGCAGCTCGGAGGTGCCTGGTAATCAGCCCCAGCATTTT	CASSSEVPGNQPQHF	TRBV5-1	TRBJ1-5
TGTGCCCTAGGGACAGCCATGAACACTGAAGCTTTCTTT	CALGTAMNTEAFF	TRBV7-2	TRBJ1-1
TGTGCCAGCAGCCAAGATCAAGCGCAAGTACCGAAAGAGACCCAGTACTTC	CASSQDQAQVPKETQYF	TRBV3-1	TRBJ2-5
TGTGCCAGCAGCTTGGCCAGGGGGGCCGTTCGGGACAATGAGCAGTTCTTC	CASSLARGAVRDNEQFF	TRBV5-6	TRBJ2-1
TGTGCCAGCATTCTCATGGTTCAGGACGGGAGATATGTAGATACGCAGTATTTT	CASILMVQDGRYVDTQYF	TRBV27	TRBJ2-3
TGCGCCAGCAGAGAAACCAAGCAGGGGGAGGGAGAGGGGGAGTACGAGCAGTACTTC	CASRETKQGEGEGEYEQYF	TRBV10-1	TRBJ2-7
TGTGCCAGCAGCTTAGAGCCTGGCAAAACTAATGAAAAACTGTTTTTT	CASSLEPGKTNEKLFF	TRBV7-9	TRBJ1-4
TGTGCCAGCACCCGCTCACAGACGTTAGGCAATGAGCAGTTCTTC	CASTRSQTLGNEQFF	TRBV6-4	TRBJ2-1
TGTGCCAGCAGTCGACAGGAAGAGACCCAGTACTTC	CASSRQEETQYF	TRBV6-3	TRBJ2-5
TGTGCCAGCCTGCACAGGGGAGGGCCGAAGTACAATGAGCAGTTCTTC	CASLHRGGPKYNEQFF	TRBV28	TRBJ2-1
TGTGCCAGCAGTTCTCAAGCCTACGATTCAGACTTTAGCTACAATGAGCAGTTCTTC	CASSSQAYDSDFSYNEQFF	TRBV12-3	TRBJ2-1
TGTGCCTGGTCACCCAGCAGTCTAGCGTACAATGAGCAGTTCTTC	CAWSPSSLAYNEQFF	TRBV30	TRBJ2-1
TGTGCTAGCAGTCTAGCGGGAGGGGGCACAGATACGCAGTATTTT	CASSLAGGGTDTQYF	TRBV7-7	TRBJ2-3
TGTGCCAGCAGCGTTCAGGGGGCGCCTACTGATTGCACTTTCTATGGCTACACCTTC	CASSVQGAPTDCTFYGYTF	TRBV7-3	TRBJ1-2
TGTGCCAGCAGAGACAGGGACTACGAGCAGTACTTC	CASRDRDYEQYF	TRBV5-6	TRBJ2-7
TGTGCCAGCAGCGGAGTAGGGGAAGAGGGGGTTTTCTACAATCAGCCCCAGCATTTT	CASSGVGEEGVFYNQPQHF	TRBV5-4	TRBJ1-5
TGCAGTGCTGTCGTCCCACTAGCGGGAGAATCGAACACTGAAGCTTTCTTT	CSAVVPLAGESNTEAFF	TRBV20-1	TRBJ1-1
TGTGCCAGCAGCGGAGGGACAGGGAGCAATAATTCACCCCTCCACTTT	CASSGGTGSNNSPLHF	TRBV13	TRBJ1-6
TGCAGTGCTAGAGACCGGACATCCTACGAGCAGTACTTC	CSARDRTSYEQYF	TRBV20-1	TRBJ2-7
TGTGCCAGCAGACGCCACAAAAATACAGGCTTGAGAAGTGTTCGGTGTAGCAATCAGCCCCAGCATTTT	CASRRHKNTGLRSVRCSNQPQHF	TRBV6-4	TRBJ1-5
TGTGCTAGTGGTTTGGTAGTGGGGGGCCCCGAATCCTACGAGCAGTACTTC	CASGLVVGGPESYEQYF	TRBV12-5	TRBJ2-7
TGTGCCAGCAGTCCCCTTGCAAACAGCTACGAGCAGTACTTC	CASSPLANSYEQYF	TRBV25-1	TRBJ2-7
TGCGCCAGCAGCTTAGAGACCAGTACTGATACGCAGTATTTT	CASSLETSTDTQYF	TRBV5-1	TRBJ2-3
TGTGCCAGCAGTTTCCTTTCAACCGGGGGAGGGGCTCAGCCCCAGCATTTT	CASSFLSTGGGAQPQHF	TRBV27	TRBJ1-5
TGTGCCAGTATTCGGACCGGCTACGAGCAGTACTTC	CASIRTGYEQYF	TRBV11-3	TRBJ2-7
TGTGCCAGCAGTTTATCTGTATACAGCACAGATACGCAGTATTTT	CASSLSVYSTDTQYF	TRBV27	TRBJ2-3
TGTGCCAGCATCCCTTTAGACAGAAGGTATGGCTACACCTTC	CASIPLDRRYGYTF	TRBV27	TRBJ1-2
TGCGCCAGCAGTGAGAACAGGGGCGGGACTAACTATGGCTACACCTTC	CASSENRGGTNYGYTF	TRBV10-2	TRBJ1-2
TGCGCCAGCACAGGGGTTTGGGCGTACGAGCAGTACTTC	CASTGVWAYEQYF	TRBV10-1	TRBJ2-7
TGTGCCAGCAGTTATCGAGTAGCAGGGGGCGGGGGTGAAAAACTGTTTTTT	CASSYRVAGGGGEKLFF	TRBV28	TRBJ1-4
TGTGCCAGCAGTGAGGCAGCACAAAGCTACGAGCAGTACTTC	CASSEAAQSYEQYF	TRBV2	TRBJ2-7
TGTGCCAGCACCCGGGGACAGGGTATTCCTCGTGAAAAACTGTTTTTT	CASTRGQGIPREKLFF	TRBV12-4	TRBJ1-4
TGTGCCAGCAGTAGATTCCCCTGGGACTACAACTACGAGCAGTACTTC	CASSRFPWDYNYEQYF	TRBV12-4	TRBJ2-7
TGCGCCAGCAGCCAAGAAGATGGTCCCAGGGATCAGCCCCAGCATTTT	CASSQEDGPRDQPQHF	TRBV4-1	TRBJ1-5
TGTGCCAGCAGGAGCGACAGGCAAAAAGATACGCAGTATTTT	CASRSDRQKDTQYF	TRBV12-4	TRBJ2-3
TGTGCCAGCACCCCCCAATCAGGGACAGCTTGCGATACGCAGTATTTT	CASTPQSGTACDTQYF	TRBV6-3	TRBJ2-3
TGTGCCAGCAGCACCCCAACACCATGGATTGAAGCTTTCTTT	CASSTPTPWIEAFF	TRBV6-5	TRBJ1-1
TGCAGTGCTAGGGTGGCCGGACAGGGCACTGAAGCTTTCTTT	CSARVAGQGTEAFF	TRBV20-1	TRBJ1-1
TGTGCCAGCCAGGGTTCGAACTATGGCTACACCTTC	CASQGSNYGYTF	TRBV5-5	TRBJ1-2
TGCGCCAGCAGCCAATCGGGGGTAGTAAGAAAGCAGTACTTC	CASSQSGVVRKQYF	TRBV4-1	TRBJ2-7
TGTGCCAGTAGTATAGAGACAGGGAGGGTAAACACTGAAGCTTTCTTT	CASSIETGRVNTEAFF	TRBV19	TRBJ1-1
TGTGCCAGCAGCTTCAATGAGCCCACAGGGGGCGAAGCTTTCTTT	CASSFNEPTGGEAFF	TRBV7-3	TRBJ1-1
TGTGCCACCAGGGGGGACATCTCGCTTAGTTACGAGCAGTACTTC	CATRGDISLSYEQYF	TRBV24-1	TRBJ2-7
TGTGCCAGCAGCTGTCGCAGGGTAGAGACCCAGTACTTC	CASSCRRVETQYF	TRBV13	TRBJ2-5
TGTGCCAGCAGCTATGGGACAAGTTCCGGATGCAATCAGCCCCAGCATTTT	CASSYGTSSGCNQPQHF	TRBV7-9	TRBJ1-5
TGTGCCAGCAGCAAAAGCGGGAGCACGGGCAATCAGCCCCAGCATTTT	CASSKSGSTGNQPQHF	TRBV5-5	TRBJ1-5
TGTGCCAGCAGCCGTACCGGGACAATTGAAGCTTTCTTT	CASSRTGTIEAFF	TRBV3-1	TRBJ1-1
TGTGCCACCAGTGATATTGCGACTAGACGCTACGAGCAGTACTTC	CATSDIATRRYEQYF	TRBV24-1	TRBJ2-7
TGTGCCAGCAGCTTATCCGATGGGATCTATGGCTACACCTTC	CASSLSDGIYGYTF	TRBV7-6	TRBJ1-2
TGTGCCAACAGGGGGCTGGGTACCAACACCATATATTTT	CANRGLGTNTIYF	TRBV27	TRBJ1-3
TGTGCCAGGCGGGGACAGGGCTTTCGGGGCTATGGCTACACCTTC	CARRGQGFRGYGYTF	TRBV6-1	TRBJ1-2
TGTGCCAGCGGGGTTTGGACTAGCGGGGGACAGTACGAGCAGTACTTC	CASGVWTSGGQYEQYF	TRBV11-1	TRBJ2-7
TGTGCCAGCAGTTTCAGGGGGTACGGGGTTTTTAGCTCCTATAATTCACCCCTCCACTTT	CASSFRGYGVFSSYNSPLHF	TRBV27	TRBJ1-6
TGTGCCAGCAGCTTAGTACCCCCGAGGACAGGGGATCAGCCCCAGCATTTT	CASSLVPPRTGDQPQHF	TRBV7-6	TRBJ1-5
TGTGCCAGCAGCATGTTGCACAGACAGGGGAGGATCTACGAGCAGTACTTC	CASSMLHRQGRIYEQYF	TRBV7-9	TRBJ2-7
TGCGCCAGCACGGGGGGGAGGCAGTATTTT	CASTGGRQYF	TRBV5-1	TRBJ2-3
TGTGCCAGAGGGTTCGAGCAGTACTTC	CARGFEQYF	TRBV11-2	TRBJ2-7
TGCAGTGCCAGAATGGGGGGGGGTGGCGGGGAGCTGTTTTTT	CSARMGGGGGELFF	TRBV20-1	TRBJ2-2
TGTGCCAGCAGTCGTACCGGGACGTCAGATACGCAGTATTTT	CASSRTGTSDTQYF	TRBV6-1	TRBJ2-3
TGTGCCAGCAGTGCCTTTGCCGGGACTAGCGGGAGCGTAGTCGAGCAGTACTTC	CASSAFAGTSGSVVEQYF	TRBV6-4	TRBJ2-7
TGTGCCAGCTCAAGGGACAGGGGGCATCAGCCCCAGCATTTT	CASSRDRGHQPQHF	TRBV18	TRBJ1-5
TGTGCCAGCAGTTTAATAGACAGGGCCGCCGCTTTCTTT	CASSLIDRAAAFF	TRBV12-3	TRBJ1-1
TGTGCCAGCACCGACAGGGACGAGCAGTACTTC	CASTDRDEQYF	TRBV27	TRBJ2-7
TGCAGCATTAGCTCTAGCGGGAGAAAGCAGCCCCAGCATTTT	CSISSSGRKQPQHF	TRBV29-1	TRBJ1-5
TGTGCCAGCAGCCTCCCAGACCAGAACACTGAAGCTTTCTTT	CASSLPDQNTEAFF	TRBV9	TRBJ1-1
TGTGCCAGCAACCCAAGCCGGGACAAAGAGACCCAGTACTTC	CASNPSRDKETQYF	TRBV18	TRBJ2-5
TGTGCCAGTAGTACTCTAATAGGTGATGAGCAGTTCTTC	CASSTLIGDEQFF	TRBV19	TRBJ2-1
TGTGCCAGCAGCTTATCAAATGAGCGGGATGCAACTAATGAAAAACTGTTTTTT	CASSLSNERDATNEKLFF	TRBV5-5	TRBJ1-4
TGCACCCCAGGGGACACTGAAGCTTTCTTT	CTPGDTEAFF	TRBV20-1	TRBJ1-1
TGCGCCAGCAGCCAAGCCAAAATGTGGACAGGCGCCCCAACTTGCTACGAGCAGTACTTC	CASSQAKMWTGAPTCYEQYF	TRBV4-1	TRBJ2-7
TGCAGTGCTAGAGGAGCTCGAGACGCAGTGGACGGTAATAGCAATCAGCCCCAGCATTTT	CSARGARDAVDGNSNQPQHF	TRBV20-1	TRBJ1-5
TGCGCCAGCAGCTTGGGCAGGGACAGGGCGGGGAGACTCAACTATGGCTACACCTTC	CASSLGRDRAGRLNYGYTF	TRBV5-1	TRBJ1-2
TGTGCCTGGAGCCCGGCCGCAAGCTCTGGAAACACCATATATTTT	CAWSPAASSGNTIYF	TRBV30	TRBJ1-3
TGTGCCAGCAGTTTACGTACTAGCGGGAGGGCCCGGGGGAACGGGGAGCTGTTTTTT	CASSLRTSGRARGNGELFF	TRBV28	TRBJ2-2
TGTGCCAGCAGGGACGGGCAGTTCAGGGGGAATCAGCCCCAGCATTTT	CASRDGQFRGNQPQHF	TRBV6-4	TRBJ1-5
TGCGCCAGCAGCTTGGAACAGGGCCAAGAGACCCAGTACTTC	CASSLEQGQETQYF	TRBV5-1	TRBJ2-5
TGTGCCAGCAGTTTAAGGCGAGTACAAGAGACCCAGTACTTC	CASSLRRVQETQYF	TRBV27	TRBJ2-5
TGTGCCAGCAGCTTGGTTAACCAAGGGGATGGCCCCCAAACCGGGGAGCTGTTTTTT	CASSLVNQGDGPQTGELFF	TRBV5-4	TRBJ2-2
TGTGCCAGCAGCGGGAAGGGCCGCGATCTTAAGGTCGAAAAACTGTTTTTT	CASSGKGRDLKVEKLFF	TRBV9	TRBJ1-4
TGTGCCAGCAGCTCCAATGGACTAGCGGGGGGGCGCAGATACAATGAGCAGTTCTTC	CASSSNGLAGGRRYNEQFF	TRBV11-2	TRBJ2-1
TGTGCCAGCAGTTACTCGATAGGGGGTCCAGGAGGCTACACCTTC	CASSYSIGGPGGYTF	TRBV6-6	TRBJ1-2
TGTGCCAGCAGCCGAGACGAATGCTACGAGCAGTACTTC	CASSRDECYEQYF	TRBV5-6	TRBJ2-7
TGTGCCAGCAGCGTAGCTCGCAGAGGGGGATGGAACTATGGCTACACCTTC	CASSVARRGGWNYGYTF	TRBV9	TRBJ1-2
TGTGCCACCAGCCATCCAGATTCCTACGAGCAGTACTTC	CATSHPDSYEQYF	TRBV24-1	TRBJ2-7
TGTGCCAGCAGTCACAGGGGTAAACCTGAAGCTTTCTTT	CASSHRGKPEAFF	TRBV6-8	TRBJ1-1
TGTGCCAGTAGTATAGAGTTCCCGGGACAGATTGGCTACACCTTC	CASSIEFPGQIGYTF	TRBV19	TRBJ1-2
TGCGCCAGCAGCTTCAGGGTCCTCGGGTGTCAAACTAATGAAAAACTGTTTTTT	CASSFRVLGCQTNEKLFF	TRBV5-1	TRBJ1-4
TGTGCCAGCTTTGAACGGACAGGGGATCCGCCCATATATTTT	CASFERTGDPPIYF	TRBV11-2	TRBJ1-3
TGTGCCAGCAGTTTATGTATTTGGGGACAGGGGGCGCCGGGATCAATCGGGGAGCTGTTTTTT	CASSLCIWGQGAPGSIGELFF	TRBV28	TRBJ2-2
TGTGCCAGCAGCTCTCTTCGGCGGGGGGTGTACTACGAGCAGTACTTC	CASSSLRRGVYYEQYF	TRBV11-2	TRBJ2-7
TGTGCCAGCAGCCTGCCCAAGCGGGGGCCAGAGCAGTTCTTC	CASSLPKRGPEQFF	TRBV7-6	TRBJ2-1
TGCGCCAGCAGCCTGGGGCAATGCAATCAGCCCCAGCATTTT	CASSLGQCNQPQHF	TRBV4-1	TRBJ1-5
TGTGCGATGGACAGGGGGTCGACCGACTATGGCTACACCTTC	CAMDRGSTDYGYTF	TRBV11-3	TRBJ1-2
TGTGCCAGCAGCTTAATGGCAACGGGGCAGAGGGAGACCCAGTACTTC	CASSLMATGQRETQYF	TRBV11-2	TRBJ2-5
TGTGCCAGCACTGTGACACATCAAGAGACCCAGTACTTC	CASTVTHQETQYF	TRBV6-5	TRBJ2-5
TGTGCCAGCAGCTCCAATTACCGCGGGAGCGGCGAGCAGTACTTC	CASSSNYRGSGEQYF	TRBV11-3	TRBJ2-7
TGTGCCAGTACTCATGAGACTAGCGGGGGTGACGAGCAGTACTTC	CASTHETSGGDEQYF	TRBV19	TRBJ2-7
TGTGCCAGCAGTTACTCGGGGATCTGGGCCAGTTCAGGGACCCAGTACTTC	CASSYSGIWASSGTQYF	TRBV6-5	TRBJ2-5
TGTGCCAGCAGCGGGGACCAGGGGTCAACTGAAGCTTTCTTT	CASSGDQGSTEAFF	TRBV13	TRBJ1-1
TGTGCCAGCAGCTTAGAATCGACTAGCGGGGGGATGACCTACGAGCAGTACTTC	CASSLESTSGGMTYEQYF	TRBV7-9	TRBJ2-7
TGTGCCAGCAACCGAAAGGGGGGGGCCAACACCATATATTTT	CASNRKGGANTIYF	TRBV25-1	TRBJ1-3
TGTGCCAGCAGCCGGGCGCCCCGGGAGGGGAGTGCGGATGAAAAACTGTTTTTT	CASSRAPREGSADEKLFF	TRBV6-2	TRBJ1-4
TGTGCCAGCAGCGACAGGGGGGGATGCTCCTACGAGCAGTACTTC	CASSDRGGCSYEQYF	TRBV5-6	TRBJ2-7
TGTGCCAGCAGCCCTAAGAGGCTGCCTTATAGCAATCAGCCCCAGCATTTT	CASSPKRLPYSNQPQHF	TRBV28	TRBJ1-5
TGCGCCAGCAGCCAACCATCCCAACGGGACAGTCCTAACTATGGCTACACCTTC	CASSQPSQRDSPNYGYTF	TRBV4-1	TRBJ1-2
TGTGCCAGCGCTTTTGAACACAGGGGAGACCCGAACACCGGGGAGCTGTTTTTT	CASAFEHRGDPNTGELFF	TRBV27	TRBJ2-2
TGTGCCAGCAGCTTGGATCATGAGGGGCTTCAAAGCTACGAGCAGTACTTC	CASSLDHEGLQSYEQYF	TRBV5-8	TRBJ2-7
TGTGCCAGCAGTTTAAACATCCCTAGAGATACGCAGTATTTT	CASSLNIPRDTQYF	TRBV28	TRBJ2-3
TGTGCCACCAGCGGGAGGGATTACAATGAGCAGTTCTTC	CATSGRDYNEQFF	TRBV15	TRBJ2-1
TGCGCCAGCAGCTTGGAAGGCGGAGTCCACTACGAGCAGTACTTC	CASSLEGGVHYEQYF	TRBV5-1	TRBJ2-7
TGTGCCAGCACAACCCTTTTAGGGGGAGTGTCCTACGAGCAGTACTTC	CASTTLLGGVSYEQYF	TRBV11-3	TRBJ2-7
TGTGCCAGCAGTTGGGGGGGGACAGGGACCGGGTACTTC	CASSWGGTGTGYF	TRBV27	TRBJ2-5
TGTGCCAGCAGTTACGCTCGACTAGCGGGAGATACGCAGTATTTT	CASSYARLAGDTQYF	TRBV6-3	TRBJ2-3
TGTGCCAGCAGTGGGTATCTAAGCAATCAGCCCCAGCATTTT	CASSGYLSNQPQHF	TRBV2	TRBJ1-5
TGTGCCAGCAGCAACGAATCGGACAGGGACGCCTATGGCTACACCTTC	CASSNESDRDAYGYTF	TRBV5-6	TRBJ1-2
TGTGCCAGCAGCGTCCACCTACTAGCGGGAGGTTATAGCAATCAGCCCCAGCATTTT	CASSVHLLAGGYSNQPQHF	TRBV9	TRBJ1-5
TGCGCCAGCAGTGAGCCGGGACAGGGGACCTATGGCTACACCTTC	CASSEPGQGTYGYTF	TRBV10-1	TRBJ1-2
