TGTGCCAGCAGTTTAGTAGCGGGACCCTACGAGCAGTACTTC	CASSLVAGPYEQYF	TRBV6-5	TRBJ2-7
TGCGCCAGCTACTCTGGGACTTGGAACTATGGCTACACCTTC	CASYSGTWNYGYTF	TRBV10-2	TRBJ1-2
TGTGCCAGTAGGAGGGCGGCACTCGAGCAGTACTTC	CASRRAALEQYF	TRBV19	TRBJ2-7
TGTGCCAGCAGCTTCCGGTACAGGGGGCGCGGGACCTACGAGCAGTACTTC	CASSFRYRGRGTYEQYF	TRBV12-3	TRBJ2-7
TGTGCCAGCAGCAAGAGCGCGGACAGGCACCGGGGATCAACTAATGAAAAACTGTTTTTT	CASSKSADRHRGSTNEKLFF	TRBV11-3	TRBJ1-4
TGCGCCAGCAGTCAGGGGGCCACTTATGGCTACACCTTC	CASSQGATYGYTF	TRBV10-1	TRBJ1-2
TGTGCCAGCAGCGTAATCGAGAGCACCCCTGAAGCTTTCTTT	CASSVIESTPEAFF	TRBV9	TRBJ1-1
TGTGCCAGCAGCTGTTCCAGGGGAGATAAAGACTCCTACAATGAGCAGTTCTTC	CASSCSRGDKDSYNEQFF	TRBV5-5	TRBJ2-1
TGTGCCAGCAGCGAGCAACAGCCCTCTGGGGCCAACGTCCTGACTTTC	CASSEQQPSGANVLTF	TRBV9	TRBJ2-6
TGTGCCAGCAGCCCGTCAAAGGGGGACAGACTGTTGAATCCGGAGGGTTGGTACAATGAGCAGTTCTTC	CASSPSKGDRLLNPEGWYNEQFF	TRBV14	TRBJ2-1
TGTGCCAGCAGCGTTGCCTTTAGGCCGGCTACCCGACATTACGAGCAGTACTTC	CASSVAFRPATRHYEQYF	TRBV7-3	TRBJ2-7
TGTGCCAGCCGAGAATCCAGGCTCCCCGGACGGTCCTACGAGCAGTACTTC	CASRESRLPGRSYEQYF	TRBV27	TRBJ2-7
TGTGCCAGCAGCCACGGGGAGGCCCCGAACACCGGGGAGCTGTTTTTT	CASSHGEAPNTGELFF	TRBV14	TRBJ2-2
TGTGCCAGCAGTGCCCGCCCCCTGGAAGCCCAAGAGACCCAGTACTTC	CASSARPLEAQETQYF	TRBV6-4	TRBJ2-5
TGTGCCACTAGGGGAAATGAGCAGTTCTTC	CATRGNEQFF	TRBV15	TRBJ2-1
TGTGCCAGCAGCAAATGGCTAGCACAAGGAGGGTACAATGAGCAGTTCTTC	CASSKWLAQGGYNEQFF	TRBV7-7	TRBJ2-1
TGCGCCAGCAGCGTGCCGGGACTAGCGGGAGGGAATAATTCACCCCTCCACTTT	CASSVPGLAGGNNSPLHF	TRBV4-1	TRBJ1-6
TGTGCCAGCAGCCATGGTTTAGAGGTAGGGGGCTCGTTAGAGACCCAGTACTTC	CASSHGLEVGGSLETQYF	TRBV7-3	TRBJ2-5
TGTGCCAGCAGTTGCCCGGGACTAGCGGAGCAGTACTTC	CASSCPGLAEQYF	TRBV27	TRBJ2-7
TGTGCCAGCAGCCGCCGGGACGATAGCTCCTACGAGCAGTACTTC	CASSRRDDSSYEQYF	TRBV5-5	TRBJ2-7
TGTGCCAGCCAAGGGAGCGAGACCCAGTACTTC	CASQGSETQYF	TRBV7-9	TRBJ2-5
TGTGCCAGTAGTATTTTGTTAGAGGACGAGCAGTACTTC	CASSILLEDEQYF	TRBV19	TRBJ2-7
TGTGCCATCCGGAAGGGGGCTGAAAAACTGTTTTTT	CAIRKGAEKLFF	TRBV10-3	TRBJ1-4
TGTGCCAGCAGGACAGGGAACCGAAGCTCCTACGAGCAGTACTTC	CASRTGNRSSYEQYF	TRBV12-4	TRBJ2-7
TGTGCCAGCAGCTTTAGGAACCGACTAGCTATCTTC	CASSFRNRLAIF	TRBV7-6	TRBJ2-1
TGTGCCAGCAGTTACCCGGGACGTAATGAGCAGTTCTTC	CASSYPGRNEQFF	TRBV6-5	TRBJ2-1
TGCAGCACGACTAGCGGGAGGGCAGAGCCCCAGCATTTT	CSTTSGRAEPQHF	TRBV29-1	TRBJ1-5
TGTGCCAGCAGCCGAATGCCACCGGGTAGGGCGGATCTTTTGGCACGGCCTAGCACAGATACGCAGTATTTT	CASSRMPPGRADLLARPSTDTQYF	TRBV13	TRBJ2-3
TGCGCCAGCAGCGGACAGGTGTCTGGAAACACCATATATTTT	CASSGQVSGNTIYF	TRBV5-1	TRBJ1-3
TGTGCCAGCAGAGCAGGGGGAAGGTACGAGCAGTACTTC	CASRAGGRYEQYF	TRBV6-1	TRBJ2-7
TGTGCCAGCAAAGGTACAGGGCTGAGGACAGATACGCAGTATTTT	CASKGTGLRTDTQYF	TRBV9	TRBJ2-3
TGTGCCAGCAGCAATGGGACAGGAGATGGGAACACTGAAGCTTTCTTT	CASSNGTGDGNTEAFF	TRBV13	TRBJ1-1
TGTGCCAGCAGTTACGGCGATGACGAGCAGTACTTC	CASSYGDDEQYF	TRBV6-5	TRBJ2-7
TGTGCCAGCAGCGGGACTAGCGGGGGGCTAGGCACAGATACGCAGTATTTT	CASSGTSGGLGTDTQYF	TRBV5-4	TRBJ2-3
TGTGCCAGCAGGACCGGGGCGGCAGAGACCCAGTACTTC	CASRTGAAETQYF	TRBV7-3	TRBJ2-5
TGCGCCAGCAGCTTGTCACAAGTACGGGGCCCTGGGAACACCGGGGAGCTGTTTTTT	CASSLSQVRGPGNTGELFF	TRBV5-1	TRBJ2-2
TGTGCCAGCAGCCTCAACTCTAGCGGGATTAATGAGCAGTTCTTC	CASSLNSSGINEQFF	TRBV7-3	TRBJ2-1
TGTGCCAGCAGCCACCCTCAGATTTGCACAGATACGCAGTATTTT	CASSHPQICTDTQYF	TRBV3-1	TRBJ2-3
TGTGCCAGCAGCTTAGGGAGACAAAGGGGGACGAATCTGGCTCGCACAGATACGCAGTATTTT	CASSLGRQRGTNLARTDTQYF	TRBV7-6	TRBJ2-3
TGTGCCAGCATAAAGCCGGGACTGGAATACGAGCAGTACTTC	CASIKPGLEYEQYF	TRBV11-3	TRBJ2-7
TGTGCCAGCAGCTGTAGCGGGGATACGCAGTATTTT	CASSCSGDTQYF	TRBV13	TRBJ2-3
TGTGCCAGCAGCTCTATTAAGGGTGACACTGAAGCTTTCTTT	CASSSIKGDTEAFF	TRBV7-2	TRBJ1-1
TGCGCCAGCAGCGCTGCGCTAAACATTCAGTACTTC	CASSAALNIQYF	TRBV5-1	TRBJ2-4
TGCAGTGCTAGGGGAGACAGGGCTGAAGCTTTCTTT	CSARGDRAEAFF	TRBV20-1	TRBJ1-1
TGTGCCAGCAGCCCAAGGGGGGTTGGCTACACCTTC	CASSPRGVGYTF	TRBV28	TRBJ1-2
TGTGCCAGCAGTTTAGTCGGGACAGGGGTAGGCTACACCTTC	CASSLVGTGVGYTF	TRBV12-4	TRBJ1-2
TGTGCCAGCAGTGAGGGGTCTGTGAATCAGCCCCAGCATTTT	CASSEGSVNQPQHF	TRBV6-5	TRBJ1-5
TGTGCCAGCAGTGAGACAGGGGGACAAGACGAGCAGTACTTC	CASSETGGQDEQYF	TRBV6-4	TRBJ2-7
TGCAGTGCTAGCCTGGGACAGGAGGGTGGCTACACCTTC	CSASLGQEGGYTF	TRBV20-1	TRBJ1-2
TGTGCCTGGCAAATGGCTGAAGCTTTCTTT	CAWQMAEAFF	TRBV30	TRBJ1-1
TGTGCCAGCAGTGACCCGGGACAGGGACAATGGAATCAGCCCCAGCATTTT	CASSDPGQGQWNQPQHF	TRBV6-8	TRBJ1-5
TGTGCCATCAGAGGGATTACGGTGAATGAGCAGTTCTTC	CAIRGITVNEQFF	TRBV10-3	TRBJ2-1
TGTGCCAGCAGCAAAGGACGCTACGAGCAGTACTTC	CASSKGRYEQYF	TRBV13	TRBJ2-7
TGTGCCAGCAGTTTACTAGACAGTCAGTCGACCCAGTACTTC	CASSLLDSQSTQYF	TRBV28	TRBJ2-5
TGTGCCAGCAGCTGTGGGGCGGGTTATGGCTACACCTTC	CASSCGAGYGYTF	TRBV11-3	TRBJ1-2
TGTGCCAGCAGCAATCCCGGGGTCTACGAGCAGTACTTC	CASSNPGVYEQYF	TRBV7-6	TRBJ2-7
TGTGCCTGCATAGGACAGTCGTATCAGCCCCAGCATTTT	CACIGQSYQPQHF	TRBV30	TRBJ1-5
TGCAGTGCTAGAGCTTACGGGACAAATCTGAACACTGAAGCTTTCTTT	CSARAYGTNLNTEAFF	TRBV20-1	TRBJ1-1
TGTGCCAGCAAAGAGTTGGAAAAACTGTTTTTT	CASKELEKLFF	TRBV3-1	TRBJ1-4
TGTGCCAGCAGTAAAGTTTGGGGCTGCTCTGCTAGCACAGATACGCAGTATTTT	CASSKVWGCSASTDTQYF	TRBV27	TRBJ2-3
TGTGCCAGCAGCTTCTTGGAGGGACTAGCGGGCCGGTCGAACACCGGGGAGCTGTTTTTT	CASSFLEGLAGRSNTGELFF	TRBV5-4	TRBJ2-2
TGTGCCAGCAGGGGCCAGATTGACGGGGAGCTGTTTTTT	CASRGQIDGELFF	TRBV27	TRBJ2-2
TGTGCCACCGGGGACAGTTTCGACGAGCAGTACTTC	CATGDSFDEQYF	TRBV28	TRBJ2-7
TGTGCCAGCCTCCCGGGACTAGGGAGAACAGATACGCAGTATTTT	CASLPGLGRTDTQYF	TRBV6-4	TRBJ2-3
TGTGCCAGCAATCTCGGACAGGGCACTGAAGCTTTCTTT	CASNLGQGTEAFF	TRBV28	TRBJ1-1
TGTGCCAGCAGTTACGACAGCGGAGATACGCAGTATTTT	CASSYDSGDTQYF	TRBV6-5	TRBJ2-3
TGCGCCAGCAGCGAACGGACAGACCCCGAGGGCTACACCTTC	CASSERTDPEGYTF	TRBV5-1	TRBJ1-2
TGTGCCAGCAGTTACTCGCCCCCAGGGGAGAAGGGGGCAACTAATGAAAAACTGTTTTTT	CASSYSPPGEKGATNEKLFF	TRBV6-5	TRBJ1-4
TGTGCCAGCAGCCAAGGGGGTACGGGACAGCCCCACGAGCAGTACTTC	CASSQGGTGQPHEQYF	TRBV3-1	TRBJ2-7
TGTGCCAGCAGCCCTTTCAGGGTAACAGAGGGGGGAAACACCATATATTTT	CASSPFRVTEGGNTIYF	TRBV7-3	TRBJ1-3
TGTGCCAGCAGCAGGTACAATGAAAAACTGTTTTTT	CASSRYNEKLFF	TRBV13	TRBJ1-4
TGTGCCAGCAGCTTGTCCCAGCCGATGAACACCGGGGAGCTGTTTTTT	CASSLSQPMNTGELFF	TRBV5-8	TRBJ2-2
TGCAGTGCTATAACCCTCTCCTACGAGCAGTACTTC	CSAITLSYEQYF	TRBV20-1	TRBJ2-7
TGTGCCAGCAGGCAGGGGACTAGCGGGGACAACAATGAGCAGTTCTTC	CASRQGTSGDNNEQFF	TRBV14	TRBJ2-1
TGTGCCAGCAGCTTAGCCCACAGGGGGCCCTACGAGCAGTACTTC	CASSLAHRGPYEQYF	TRBV7-6	TRBJ2-7
TGTGCCAGCAGCACTAGGACTGACAGGGCGAGGTGGGGGAACACTGAAGCTTTCTTT	CASSTRTDRARWGNTEAFF	TRBV7-9	TRBJ1-1
TGTGCCAGCAGTTTACGACAGGGCTACGAGCAGTACTTC	CASSLRQGYEQYF	TRBV27	TRBJ2-7
TGTGCCAGCAGTCCCACTAGGACTCACAATGAGCAGTTCTTC	CASSPTRTHNEQFF	TRBV6-3	TRBJ2-1
TGTGCTCCACCGTTTCAGCCGGGACAGGGGGGTAATTCACCCCTCCACTTT	CAPPFQPGQGGNSPLHF	TRBV7-6	TRBJ1-6
TGTGCCAGCAGCTTGGACAGGGGGAGTCAGTCACCCCTCCACTTT	CASSLDRGSQSPLHF	TRBV5-5	TRBJ1-6
TGTGCCAGCAGTGGGGGACAGGGTGACTATCAGCCCCAGCATTTT	CASSGGQGDYQPQHF	TRBV27	TRBJ1-5
TGCGCCAGCAGCCAAGATACTCGACCCCTAGGCCAGCCTCACGGGGGCAATGAGCAGTTCTTC	CASSQDTRPLGQPHGGNEQFF	TRBV4-1	TRBJ2-1
TGTGCCAGCGGGCCTGCGTTCGGGACTAGCTCCTACAATGAGCAGTTCTTC	CASGPAFGTSSYNEQFF	TRBV6-1	TRBJ2-1
TGTGCCAGCAGCCCGGGCGACGACAGGGTTTCCACTGAAGCTTTCTTT	CASSPGDDRVSTEAFF	TRBV5-4	TRBJ1-1
TGTGCCAGCAGTTCCTCGGGGCCAAATCCCGGGGAGCTGTTTTTT	CASSSSGPNPGELFF	TRBV12-4	TRBJ2-2
TGCGCCAGCAGCCCGGGGGCCCCCTACGAGCAGTACTTC	CASSPGAPYEQYF	TRBV5-1	TRBJ2-7
TGTGCCAGCAGACCGGGAAGAATGCAAGAGACCCAGTACTTC	CASRPGRMQETQYF	TRBV6-5	TRBJ2-5
TGCGCCAGCAGCTCGACAGGGGGCGACACCATATATTTT	CASSSTGGDTIYF	TRBV5-1	TRBJ1-3
TGTGCCAGCAGCGTAGCCGAGATCGAGGGGCCCTACAATGAGCAGTTCTTC	CASSVAEIEGPYNEQFF	TRBV9	TRBJ2-1
TGCAGTGCTAGAGCGGCGGACAGAGGCAATCAGCCCCAGCATTTT	CSARAADRGNQPQHF	TRBV20-1	TRBJ1-5
TGTGCTGGCCGACGTAAAGAGACCCAGTACTTC	CAGRRKETQYF	TRBV7-3	TRBJ2-5
TGCAGCGTACGACGGGGGAGGGGCGCCCCCTACGAGCAGTACTTC	CSVRRGRGAPYEQYF	TRBV29-1	TRBJ2-7
TGTGCCAGCAGCTTAGAAATAGTCCAGTGGTCCACTGAAGCTTTCTTT	CASSLEIVQWSTEAFF	TRBV11-3	TRBJ1-1
TGTGCCTGGCCTAACCTAAACTGGGGGGAGTGGGCCGGGGAGCTGTTTTTT	CAWPNLNWGEWAGELFF	TRBV30	TRBJ2-2
TGCAGCGTTGCTAATCATCTTCAGACCAATCAGCCCCAGCATTTT	CSVANHLQTNQPQHF	TRBV29-1	TRBJ1-5
TGTGCCATCAGCACCGACAAAAGGGCGTACTATGGCTACACCTTC	CAISTDKRAYYGYTF	TRBV10-3	TRBJ1-2
TGTGCCAGCAGTCCTGCGTCAGACGTCGGGCAAGAGACCCAGTACTTC	CASSPASDVGQETQYF	TRBV6-1	TRBJ2-5
TGCGCCAGCAGCCAAGAGGAGGGGGGACAACCCTGGAACACTGAAGCTTTCTTT	CASSQEEGGQPWNTEAFF	TRBV4-1	TRBJ1-1
TGTGCCAGCAACAGCCAGCCGTCCCCCGGAAAACTGTTTTTT	CASNSQPSPGKLFF	TRBV7-6	TRBJ1-4
TGTGCCAGCAGCTTGTCAGGGGGCGCCCGCTACGAGCAGTACTTC	CASSLSGGARYEQYF	TRBV7-3	TRBJ2-7
TGCGCCAGCCCCCGCCTGGCCTACGAGCAGTACTTC	CASPRLAYEQYF	TRBV10-1	TRBJ2-7
TGTGCCAGCAGCCACGACTACGAGCAGTACTTC	CASSHDYEQYF	TRBV4-2	TRBJ2-7
TGCAGGTGGGGGTTGACAGCGCATGAGCAGTTCTTC	CRWGLTAHEQFF	TRBV20-1	TRBJ2-1
TGTGCCAGCAGCTTAGTCAAATATGAACCCCTCCCAGGGCTGGGGGGCGGGCAAGACACAGATACGCAGTATTTT	CASSLVKYEPLPGLGGGQDTDTQYF	TRBV13	TRBJ2-3
TGTGCCAGCAGTGAATCAACTAGCGGGAGGGCGGACTTGAACACTGAAGCTTTCTTT	CASSESTSGRADLNTEAFF	TRBV25-1	TRBJ1-1
TGTGCCAGCAGTTACCGAACGCTAGGGAGAGATGAAAAACTGTTTTTT	CASSYRTLGRDEKLFF	TRBV6-6	TRBJ1-4
TGTGCCAGCAGTTTCCCGGGACTAGGAGGAAATGAGCAGTTCTTC	CASSFPGLGGNEQFF	TRBV12-3	TRBJ2-1
TGCGCCAGCCGGAGAAACTGGTCCTACGAGCAGTACTTC	CASRRNWSYEQYF	TRBV10-1	TRBJ2-7
TGCGCCAGCAGCTGCCCTTACAGGGTTACCTATAGCAATCAGCCCCAGCATTTT	CASSCPYRVTYSNQPQHF	TRBV5-1	TRBJ1-5
TGTGCCAGTAGTGGACAGAGGGGGTGCACAGATACGCAGTATTTT	CASSGQRGCTDTQYF	TRBV19	TRBJ2-3
TGTGCCACCAGTGATTCCCGGGACAGAGGAAAAAGAGGCTACGAGCAGTACTTC	CATSDSRDRGKRGYEQYF	TRBV24-1	TRBJ2-7
TGTGCCAGCAGTGACTCGCTTCAAGGAGGGAATGACGAGCAGTACTTC	CASSDSLQGGNDEQYF	TRBV6-4	TRBJ2-7
TGTGCCAGCAGCTTGGGGACAGTGTTCAATCAGCCCCAGCATTTT	CASSLGTVFNQPQHF	TRBV5-6	TRBJ1-5
TGTGCCAGTGGGCAGGAGCCCTACGAGCAGTACTTC	CASGQEPYEQYF	TRBV27	TRBJ2-7
TGTGCCAGCAGCGTCGGGAAAGCGGGAGCAACCTTCTATGGCTACACCTTC	CASSVGKAGATFYGYTF	TRBV9	TRBJ1-2
TGCAGTGCCTCAGAGGGGGGGCGCAGGTACAATGAGCAGTTCTTC	CSASEGGRRYNEQFF	TRBV20-1	TRBJ2-1
TGCAGCGTTGAATCGGAGGTTTCCTATGGCTACACCTTC	CSVESEVSYGYTF	TRBV29-1	TRBJ1-2
TGTGCCAGTACCGGTGGACAGGGGGCGGATCAGCCCCAGCATTTT	CASTGGQGADQPQHF	TRBV19	TRBJ1-5
TGTGCCAGCAGCAACCCGGGACTTGATGAAAAACTGTTTTTT	CASSNPGLDEKLFF	TRBV7-4	TRBJ1-4
TGTGCCAGCAGTACCCTAGTTTTATTAAACTCTGGAAACACCATATATTTT	CASSTLVLLNSGNTIYF	TRBV6-5	TRBJ1-3
TGTTCATTACTAGAACTAGCGGGAGGGCAGGACGAGCAGTACTTC	CSLLELAGGQDEQYF	TRBV10-3	TRBJ2-7
TGTGCCAGCAGCTTTCGACTAGCGGGAGGGCCCGCGCCCCAAAACATTCAGTACTTC	CASSFRLAGGPAPQNIQYF	TRBV7-4	TRBJ2-4
TGTGCCAGCAGTTGGTTAAGTTGGACAGAGGAAGCTTTCTTT	CASSWLSWTEEAFF	TRBV27	TRBJ1-1
TGTGCCAGCAGTTTACTGGATCAGACAGATACGCAGTATTTT	CASSLLDQTDTQYF	TRBV27	TRBJ2-3
TGTGCCAGTAGTATCCCGAGGGACAGGGAAAATGGCTACACCTTC	CASSIPRDRENGYTF	TRBV19	TRBJ1-2
TGTGCCACCAGTGATACGGGGCGGGGGGTTGAAACCTACGAGCAGTACTTC	CATSDTGRGVETYEQYF	TRBV24-1	TRBJ2-7
TGTGCCAGCAGCTTACCGCGGGAGTCATACGAGCAGTACTTC	CASSLPRESYEQYF	TRBV7-4	TRBJ2-7
TGTGCCAGCACGGGGATGCGGGGGGTGAGACACTATGGCTACACCTTC	CASTGMRGVRHYGYTF	TRBV27	TRBJ1-2
TGTGCCAGCAGCCAAGATGGAGGGAGGGAGCAGTACTTC	CASSQDGGREQYF	TRBV14	TRBJ2-7
TGCGCCAGCAGCCTGGCCCCACAGGGGGCCCCTCGCTATGGCTACACCTTC	CASSLAPQGAPRYGYTF	TRBV5-1	TRBJ1-2
TGTGCCAGCAGCCAACCATCTCTTGGAAACACCATATATTTT	CASSQPSLGNTIYF	TRBV3-1	TRBJ1-3
TGTGCCAGCAGCCATACGAGGAAGACTGAGCAGTACTTC	CASSHTRKTEQYF	TRBV7-3	TRBJ2-7
TGTGCCAGTAGTACTACCTGTTACATTCAGTACTTC	CASSTTCYIQYF	TRBV19	TRBJ2-4
TGTGCCTGGCTTTCGATCTCGGGACAGGGGGATAGCAATCAGCCCCAGCATTTT	CAWLSISGQGDSNQPQHF	TRBV30	TRBJ1-5
TGTGCCAGCAGCTTAGCGGAGCCGGGAGTGCTGCGGCTGGAAGGCTACACCTTC	CASSLAEPGVLRLEGYTF	TRBV7-9	TRBJ1-2
TGCAGTGCTCAACGGGGGGGGGTTAAGAACAATGAGCAGTTCTTC	CSAQRGGVKNNEQFF	TRBV20-1	TRBJ2-1
TGTGCCAGCAGCCAAGAACGGGCAGCAGGGGTCTACGAGCAGTACTTC	CASSQERAAGVYEQYF	TRBV14	TRBJ2-7
TGCGCCAGCAGTTTTAAGACAAGTGGAAACACCATATATTTT	CASSFKTSGNTIYF	TRBV10-2	TRBJ1-3
TGTGCCAGCAGCCAAGGACAGGGGGTGTACGGGGGCCTGACTTTC	CASSQGQGVYGGLTF	TRBV3-1	TRBJ2-6
TGCGCCAGCAGCTTGGGGAAGACAGGGAGTTTGCCAAAAGGGCCCCAGCATTTT	CASSLGKTGSLPKGPQHF	TRBV5-1	TRBJ1-5
TGTGCCAGCAGTGACTCAGGAAGGGGGCCTACTGAAGCTTTCTTT	CASSDSGRGPTEAFF	TRBV6-4	TRBJ1-1
TGCAGCGCTTCAGGGTCCTACGAGCAGTACTTC	CSASGSYEQYF	TRBV29-1	TRBJ2-7
TGTGCCTCCATCCCCCGACAGGTAGAATGTAATTCACCCCTCCACTTT	CASIPRQVECNSPLHF	TRBV30	TRBJ1-6
TGCAGTGCTAGAGCCCCACTAGCGGGACTCAGCACAGATACGCAGTATTTT	CSARAPLAGLSTDTQYF	TRBV20-1	TRBJ2-3
TGCAGTGCCCCTTGGGTCTCGGGCTTAAGCAGAGAGACCCAGTACTTC	CSAPWVSGLSRETQYF	TRBV20-1	TRBJ2-5
TGTGCCAGCAGCAGGCCTGGGGGGGATACGCAGTATTTT	CASSRPGGDTQYF	TRBV9	TRBJ2-3
TGTGCTAGTGGTCGGAATGACACTGAAGCTTTCTTT	CASGRNDTEAFF	TRBV12-5	TRBJ1-1
TGTGCCAGCAGTTTATGGGATGGAAGGGGAAGCAATCAGCCCCAGCATTTT	CASSLWDGRGSNQPQHF	TRBV27	TRBJ1-5
TGTGCCAGCAGCAAAGCCCCGCGGGGGTGGGGGAAGGGCACTGAAGCTTTCTTT	CASSKAPRGWGKGTEAFF	TRBV28	TRBJ1-1
TGTGCCAGCAGTCGGAAATTCCCACCTGACGAGGGGCCAGAAAATGGCTACACCTTC	CASSRKFPPDEGPENGYTF	TRBV12-3	TRBJ1-2
TGTGCCAGCAGCTCACTAGCGGGAGTTGTCATGAACACTGAAGCTTTCTTT	CASSSLAGVVMNTEAFF	TRBV13	TRBJ1-1
TGTGCCAGCAGCCTTCCCTGGGGTCCCGGGACAGACTATGGCTACACCTTC	CASSLPWGPGTDYGYTF	TRBV14	TRBJ1-2
TGTGCCAGCAGTGAACGGAACACCGGGGAGCTGTTTTTT	CASSERNTGELFF	TRBV6-1	TRBJ2-2
TGTGCCAGCAGGACCCCATACGGGACAAAGGGCACCGGGGAGCTGTTTTTT	CASRTPYGTKGTGELFF	TRBV7-3	TRBJ2-2
TGTGCCAGCAGTTCACCCCGGAGTAAAGCGGGAGGCTACGAGCAGTACTTC	CASSSPRSKAGGYEQYF	TRBV6-5	TRBJ2-7
TGCAGCGTAAGGGGGGGTGGGTTCACAGATACGCAGTATTTT	CSVRGGGFTDTQYF	TRBV29-1	TRBJ2-3
TGTGCCAGCAGTGACTCGATAGGGACAGGGGACCAGGAAAAACTGTTTTTT	CASSDSIGTGDQEKLFF	TRBV6-4	TRBJ1-4
TGTGCCAGCAGGGCTCGGGGGGGCCGAAGCTCCTACAATGAGCAGTTCTTC	CASRARGGRSSYNEQFF	TRBV6-1	TRBJ2-1
TGTGCCAGACCCTGGGACAGGGTTTGGGAGCAGTACTTC	CARPWDRVWEQYF	TRBV14	TRBJ2-7
TGTGCCAGCAGCATACGGAATCTAGCGGGGGGCCGTCCCTACGAGCAGTACTTC	CASSIRNLAGGRPYEQYF	TRBV13	TRBJ2-7
TGTGCCAGCAGCTTAGCTACGGTCGGGGGGGCCAATGAGCAGTTCTTC	CASSLATVGGANEQFF	TRBV7-2	TRBJ2-1
TGTGCCAGCACGACAGGGGGCGAGCACTGCTCCTACGAGCAGTACTTC	CASTTGGEHCSYEQYF	TRBV6-3	TRBJ2-7
TGTGCCAGCAGCGAAAGTCGGGGGCCTTACGAGCAGTACTTC	CASSESRGPYEQYF	TRBV13	TRBJ2-7
TGTGCCAGCAGCTTACTCGAGGGACAGCCAGTCTACGAGCAGTACTTC	CASSLLEGQPVYEQYF	TRBV7-4	TRBJ2-7
TGCGCCAGCAGCTTCGCACAGGGCGGGCCCCGCGTCGGATATGGCTACACCTTC	CASSFAQGGPRVGYGYTF	TRBV5-1	TRBJ1-2
TGTGCCAGCAGCGAAGACTTAAAGACCACAGATACGCAGTATTTT	CASSEDLKTTDTQYF	TRBV13	TRBJ2-3
TGTGCCAGCTCATTGGACAGAGCAGCCAAAAACATTCAGTACTTC	CASSLDRAAKNIQYF	TRBV6-4	TRBJ2-4
TGCAGTGCAGGGTTCCGGACAGTTGCGGGTGAGCAGTTCTTC	CSAGFRTVAGEQFF	TRBV20-1	TRBJ2-1
TGTGCCAGCACCAGGGTGTGGCGGGGGGAGTATGGCTACACCTTC	CASTRVWRGEYGYTF	TRBV6-4	TRBJ1-2
TGCAGTGCTAGAGTACGGGCGGGAAAACTGTTTTTT	CSARVRAGKLFF	TRBV20-1	TRBJ1-4
TGTGCCAGCAGTTATAGGGACGAACTGCCCAGAGCTAACTATGGCTACACCTTC	CASSYRDELPRANYGYTF	TRBV6-3	TRBJ1-2
TGTGCCAGAAGGAGGGAGGGGGGGGCCACAGATACGCAGTATTTT	CARRREGGATDTQYF	TRBV2	TRBJ2-3
TGCGCCAGTGGCCTAAGGGTCACAGATACGCAGTATTTT	CASGLRVTDTQYF	TRBV10-1	TRBJ2-3
TGCGCCAGCAGACGAGGACCCTACGAGCAGTACTTC	CASRRGPYEQYF	TRBV10-1	TRBJ2-7
TGCAGCGTTGAAGTTGGGACCACCGAAAAACTGTTTTTT	CSVEVGTTEKLFF	TRBV29-1	TRBJ1-4
TGTGCCACCAGTGATAGGGACCGAGAGGGCTACACCTTC	CATSDRDREGYTF	TRBV24-1	TRBJ1-2
TGCGCCAGCTTGATGACGGATGGGGCGAATCAGCCCCAGCATTTT	CASLMTDGANQPQHF	TRBV5-1	TRBJ1-5
TGCGCCAGCAGCTTGAACAGGGCGGGGTGTCGTCGTGGAAACACCATATATTTT	CASSLNRAGCRRGNTIYF	TRBV5-1	TRBJ1-3
TGTGCCAGCTCACCACTCCCGGACGGTCTTGAGTACTTC	CASSPLPDGLEYF	TRBV18	TRBJ2-7
TGTGCCAGCAGTGAAGCTGGGGGCTTAGCCTACGAGCAGTACTTC	CASSEAGGLAYEQYF	TRBV6-1	TRBJ2-7
TGTGCCAGCAGGAACTACTACACCCTCCACTTT	CASRNYYTLHF	TRBV6-1	TRBJ1-6
TGTGCCAGCAGGGTATACGAGCAGTACTTC	CASRVYEQYF	TRBV3-1	TRBJ2-7
TGCAGTGCAGGTCCATCGGACTTAAACGGTACCTACGAGCAGTACTTC	CSAGPSDLNGTYEQYF	TRBV20-1	TRBJ2-7
TGCGCCAGCAGCTTGGCACTGGACCCAAACACCATATATTTT	CASSLALDPNTIYF	TRBV5-1	TRBJ1-3
TGTGCCAGCAGCGAGGATTTAGACAGTAGCTCTGGAAACACCATATATTTT	CASSEDLDSSSGNTIYF	TRBV5-6	TRBJ1-3
TGTGCCAGCAGCTTCCGGATATGCTCCTACAATGAGCAGTTCTTC	CASSFRICSYNEQFF	TRBV13	TRBJ2-1
TGCGCCAGGGACCCAGCCCAGCATTTT	CARDPAQHF	TRBV10-1	TRBJ1-5
TGTGCCAGCAGCTGGGGAAGTAAGGGGGGGCCGGGGGACGAGCAGTACTTC	CASSWGSKGGPGDEQYF	TRBV13	TRBJ2-7
TGTGCCAGTAGTATCCCACAGGGGCGCTTAGCCAAAAACATTCAGTACTTC	CASSIPQGRLAKNIQYF	TRBV19	TRBJ2-4
TGTGCCAGCAGTGAAGAACCGGGACAGGGGGGGAGGTTTCTTTCGACCACCGGGGAGCTGTTTTTT	CASSEEPGQGGRFLSTTGELFF	TRBV6-1	TRBJ2-2
TGCAGTGCAAGGGGCAGAGGGACTGAAGCTTTCTTT	CSARGRGTEAFF	TRBV20-1	TRBJ1-1
TGTGCCAGCAGTCCCCGGACAGGGGGGCCGAACTATGGCTACACCTTC	CASSPRTGGPNYGYTF	TRBV27	TRBJ1-2
TGCGCCAGCAGTGGGACCACCGGGACGGGACCATACGAGCAGTACTTC	CASSGTTGTGPYEQYF	TRBV10-1	TRBJ2-7
TGTGCCAGCAGGACACTGACTGTTGAAAAACTGTTTTTT	CASRTLTVEKLFF	TRBV9	TRBJ1-4
TGTGCCACCAGTTCCCAGGGAGCCACCCCTGATGGCTACACCTTC	CATSSQGATPDGYTF	TRBV24-1	TRBJ1-2
TGTGCCAGCAGCACCTCCCAGGAACGGACGTCCTACGAGCAGTACTTC	CASSTSQERTSYEQYF	TRBV13	TRBJ2-7
TGTGCCAGCGGAACTCTGGGGAAGGAAGCTTTCTTT	CASGTLGKEAFF	TRBV6-1	TRBJ1-1
TGTGCCAGCAGGGGCTTAGGACTGTTTACTGAAGCTTTCTTT	CASRGLGLFTEAFF	TRBV6-4	TRBJ1-1
TGCAGTGCTAGAAGCCGACGGGACAATGAGCAGTTCTTC	CSARSRRDNEQFF	TRBV20-1	TRBJ2-1
TGTGCCAGCAGCCAAGATAATAAACCGGGACACCCTTATAGCAATCAGCCCCAGCATTTT	CASSQDNKPGHPYSNQPQHF	TRBV14	TRBJ1-5
TGTGCCAGCAGTGGCCGGGGTCCCGGGACTCCTAACAATGAGCAGTTCTTC	CASSGRGPGTPNNEQFF	TRBV6-4	TRBJ2-1
TGTGCCAGCAGCCACGTCCGACTAGCGGCATCTCGCCAAGAGACCCAGTACTTC	CASSHVRLAASRQETQYF	TRBV14	TRBJ2-5
TGCGCCAGCAGCCAAGATCCATTATTGAACACTGAAGCTTTCTTT	CASSQDPLLNTEAFF	TRBV4-1	TRBJ1-1
TGTGCCAGCAGCTTAACGGGGGATGGCCGGGCCCCTGCCAAAAACATTCAGTACTTC	CASSLTGDGRAPAKNIQYF	TRBV11-2	TRBJ2-4
TGTGCCAGCAGTTCGACAGGGGACTATAATTCACCCCTCCACTTT	CASSSTGDYNSPLHF	TRBV27	TRBJ1-6
TGTGCCAGCAGCGTCGGGACTGCGGGAGGGCCGCATAGCAATCAGCCCCAGCATTTT	CASSVGTAGGPHSNQPQHF	TRBV9	TRBJ1-5
TGTGCCAGCAGCGGGAATCCCTTAGGGGAAGACACTGAAGCTTTCTTT	CASSGNPLGEDTEAFF	TRBV13	TRBJ1-1
TGTGCCAGCAGCCCAGGGGTGGAGACCCAGTACTTC	CASSPGVETQYF	TRBV7-3	TRBJ2-5
TGTGCCAGCAGTGAAAGAGGCCGGGGCTACGAGCAGTACTTC	CASSERGRGYEQYF	TRBV25-1	TRBJ2-7
TGTGCCAGCAGTGACTTCGGAGGGGGCAGCGGCTACACCTTC	CASSDFGGGSGYTF	TRBV6-4	TRBJ1-2
TGTGCCAGCAGTTCGGGACTTGGGGCCTACGAGCAGTACTTC	CASSSGLGAYEQYF	TRBV27	TRBJ2-7
TGTGCCAGCAGATACACGCACTATAGCAATCAGCCCCAGCATTTT	CASRYTHYSNQPQHF	TRBV27	TRBJ1-5
TGTGCCAGCCGGCGGTGCTCCTACGAGCAGTACTTC	CASRRCSYEQYF	TRBV6-3	TRBJ2-7
TGTGCCAGCAGCTTGGCGGGAGGTGACAGCTATTCACCCCTCCACTTT	CASSLAGGDSYSPLHF	TRBV5-6	TRBJ1-6
TGTGCCAGCAGCAACCCAGGTTCACCCCTCCACTTT	CASSNPGSPLHF	TRBV9	TRBJ1-6
TGTGCCAGCAGCGGACAGGACAGGGAAGCTTTCTTT	CASSGQDREAFF	TRBV9	TRBJ1-1
TGTGCCAGCAGCACTAATACAAATCAGGGTGGCCATCAGCCCCAGCATTTT	CASSTNTNQGGHQPQHF	TRBV13	TRBJ1-5
TGTGCCAGCAGCCAGGGGGATCAGCCCCAGCATTTT	CASSQGDQPQHF	TRBV7-3	TRBJ1-5
TGCGCCAGGGATGAAGGGAACACCGGGGAGCTGTTTTTT	CARDEGNTGELFF	TRBV10-2	TRBJ2-2
TGCGCCAGCAGTTCCGGACAGGACTCCTATAATTCACCCCTCCACTTT	CASSSGQDSYNSPLHF	TRBV5-1	TRBJ1-6
TGTGCCACCAGTGATTTGTCCCTGAGGACTAGCGGGAGGGCCTCCTACGAGCAGTACTTC	CATSDLSLRTSGRASYEQYF	TRBV24-1	TRBJ2-7
TGCAGTGCCGTGCATGCCCGGATTCTCAATCAGCCCCAGCATTTT	CSAVHARILNQPQHF	TRBV20-1	TRBJ1-5
TGTGCCAGCAGCTTCCGCCGGGATTTCTATGGCTACACCTTC	CASSFRRDFYGYTF	TRBV7-9	TRBJ1-2
TGTGCCAGCAGCTTACAGGGGTCACCTTATGGCTACACCTTC	CASSLQGSPYGYTF	TRBV7-9	TRBJ1-2
TGTGCCACCATTACGTCCGAGCCATGTGGTACTGGACAGCGCTTTAACTATGGCTACACCTTC	CATITSEPCGTGQRFNYGYTF	TRBV24-1	TRBJ1-2
TGCGCCAGCTCTAAGCCCTCGAGGGGGCGGGGAGGGGAAGCTTTCTTT	CASSKPSRGRGGEAFF	TRBV10-2	TRBJ1-1
TGCAGTGCTAGACAAGATCAGCCCCAGCATTTT	CSARQDQPQHF	TRBV20-1	TRBJ1-5
TGTGCCAGCAGCTTAGCTGGGGACAGGGGATTTGGGGGCTACACCTTC	CASSLAGDRGFGGYTF	TRBV11-2	TRBJ1-2
TGTGCCAGCAGTGAAGCGGTGCCCGAGAGACAGGGGCGGAGAGAGACCCAGTACTTC	CASSEAVPERQGRRETQYF	TRBV6-1	TRBJ2-5
TGTGCCAGCAGTATTCCAAGGGAAACCTACGAGCAGTACTTC	CASSIPRETYEQYF	TRBV27	TRBJ2-7
TGTGCCATCAGTGACCGGTCGCCCAGGCAAATAGGCTACACCTTC	CAISDRSPRQIGYTF	TRBV10-3	TRBJ1-2
TGTGCCACCCGGACAGCCTCGGACACCATATATTTT	CATRTASDTIYF	TRBV27	TRBJ1-3
TGTGCCAGCAGCTGTCGGGGCCTGATGAACACTGAAGCTTTCTTT	CASSCRGLMNTEAFF	TRBV7-4	TRBJ1-1
TGTGCCAGCAGCTTAAGACAGGGGAAACTCAATGAGCAGTTCTTC	CASSLRQGKLNEQFF	TRBV7-2	TRBJ2-1
TGTGCCACCAGCAAATCGGACAGGTCCACTGAAGCTTTCTTT	CATSKSDRSTEAFF	TRBV15	TRBJ1-1
TGTGCCACCAGTGATTTGCTACCAGGGGGGGAAGAGCAGTACTTC	CATSDLLPGGEEQYF	TRBV24-1	TRBJ2-7
TGCGCCAGCAGCAGGGGCCTTAACGGGGGCAATCAGCCCCAGCATTTT	CASSRGLNGGNQPQHF	TRBV4-1	TRBJ1-5
TGTGCCAGCAGCCCTAGTAGGGGGCTCTCAACCGAAGCTGAAGCTTTCTTT	CASSPSRGLSTEAEAFF	TRBV7-8	TRBJ1-1
TGTGCCAGCAGTGACAGGGGGGATCAGCCCCAGCATTTT	CASSDRGDQPQHF	TRBV25-1	TRBJ1-5
TGCGCCAGCAGCCAAGACACCGCCGGGGAGCTGTTTTTT	CASSQDTAGELFF	TRBV4-1	TRBJ2-2
TGTGCCACCAGTGAACTGGGGGAACCAAACACCATATATTTT	CATSELGEPNTIYF	TRBV24-1	TRBJ1-3
TGTGCCAGCACTGCCGGGAACTATGGCTACACCTTC	CASTAGNYGYTF	TRBV6-4	TRBJ1-2
TGTGCTAGTGGTTTGGCTGGGGGATCAGATCAGCCCCAGCATTTT	CASGLAGGSDQPQHF	TRBV12-5	TRBJ1-5
TGTGCCAGTAGGGGGGTGACAGGGGGGTATGGCTACACCTTC	CASRGVTGGYGYTF	TRBV19	TRBJ1-2
TGCAGTGCTAGAGATCACAGGGGGGTGAGTCCAGAGCAGTACTTC	CSARDHRGVSPEQYF	TRBV20-1	TRBJ2-7
TGTGCCAGCAGTAGCTACCCCCTAACTGAAGCTTTCTTT	CASSSYPLTEAFF	TRBV6-5	TRBJ1-1
TGTGCCAGCAGCCAAGGGGGGTCGGGACAGGGGGCCCTTTATCATGGCTACACCTTC	CASSQGGSGQGALYHGYTF	TRBV3-1	TRBJ1-2
TGCGCCAGCAGGCCCGGACAAACCCGCTCCTACAATGAGCAGTTCTTC	CASRPGQTRSYNEQFF	TRBV10-1	TRBJ2-1
TGTGCCAGCAGCGGGTGGTGGACAGGGGGCTCGGGGTACGAGCAGTACTTC	CASSGWWTGGSGYEQYF	TRBV7-3	TRBJ2-7
TGTGCCAGCAGTGAAGGGGGACTGGAGCAGTACTTC	CASSEGGLEQYF	TRBV25-1	TRBJ2-7
TGTGCCAGCAACCCCCCCGGGGGGGCCACCTACAATGAGCAGTTCTTC	CASNPPGGATYNEQFF	TRBV6-3	TRBJ2-1
TGCGCCAAGGGACTGGGGGGGGGGCCCTACGAGCAGTACTTC	CAKGLGGGPYEQYF	TRBV5-1	TRBJ2-7
TGTGCCAGCAGTCTCTACCGGGGCGAGCAGTACTTC	CASSLYRGEQYF	TRBV27	TRBJ2-7
TGTGCCAGCAGCTTGGGGGGCTATGGCTACACCTTC	CASSLGGYGYTF	TRBV7-6	TRBJ1-2
TGTGCCAGCAGTGCTGCAGGGTGGAACACCGGGGAGCTGTTTTTT	CASSAAGWNTGELFF	TRBV28	TRBJ2-2
TGTGCCAGCACCCTGACAGGGCGAAAAGTATGCACCATATATTTT	CASTLTGRKVCTIYF	TRBV28	TRBJ1-3
TGTGCCAGCAGCTTGGCCAGGGACCAAGATCAGCCCCAGCATTTT	CASSLARDQDQPQHF	TRBV5-6	TRBJ1-5
TGTGCCAGTAGTGGACACGGGAGCTCCTATAATTCACCCCTCCACTTT	CASSGHGSSYNSPLHF	TRBV19	TRBJ1-6
TGTGCCAGCAGTTGTCCGACAGCTACTAACTATGGCTACACCTTC	CASSCPTATNYGYTF	TRBV6-1	TRBJ1-2
TGTGCCAGCAGGGACAGGGGACGCACCGGGGAGCTGTTTTTT	CASRDRGRTGELFF	TRBV6-8	TRBJ2-2
TGTGCCATCAGGCCGGGTCGTTTGAACACTGAAGCTTTCTTT	CAIRPGRLNTEAFF	TRBV10-3	TRBJ1-1
TGTGCCAGCAGAAGGGGGGCCTCCGGAAACACCATATATTTT	CASRRGASGNTIYF	TRBV7-4	TRBJ1-3
TGTGCCAGCAGTTTACCGGACAGGTTCGGAGGAGGGAACTATGGCTACACCTTC	CASSLPDRFGGGNYGYTF	TRBV12-3	TRBJ1-2
TGTGCCAGCAGTGCGGGAGTGATTATCTACGAGCAGTACTTC	CASSAGVIIYEQYF	TRBV6-1	TRBJ2-7
TGTGCCACCAGCAGAGATCATCCCTCCAGGGGGCATGGCTACACCTTC	CATSRDHPSRGHGYTF	TRBV15	TRBJ1-2
TGCGCCTATGCTAGCGGGCACAATGAGCAGTTCTTC	CAYASGHNEQFF	TRBV4-1	TRBJ2-1
TGTGCCAGCAGCTTAAACCGGGACAGTTGGTCCTACGAGCAGTACTTC	CASSLNRDSWSYEQYF	TRBV7-9	TRBJ2-7
TGTGCCAGCAGCCCACAGAAAGAGAGCTCTGGGGCCAACGTCCTGACTTTC	CASSPQKESSGANVLTF	TRBV7-4	TRBJ2-6
TGTGCCAGCAGCCAAGATCCAGAGAAGGGGGGCAGGGTGCAGTACTTC	CASSQDPEKGGRVQYF	TRBV4-2	TRBJ2-7
TGTGCTGCCGGGGGCCGGCCTAGGTTCCCCTCCTATAATTCACCCCTCCACTTT	CAAGGRPRFPSYNSPLHF	TRBV12-5	TRBJ1-6
TGTGCCAGCAGCGGGGGAGGAAACTCTCAGCCCCAGCATTTT	CASSGGGNSQPQHF	TRBV7-3	TRBJ1-5
TGTGCCAGCAGCGTAGCCTCCGGGACTTGGGCCGGGGAGCTGTTTTTT	CASSVASGTWAGELFF	TRBV9	TRBJ2-2
TGTGCCAGTAGTTCCGCCGGGACAGACCAAGCTTTCTTT	CASSSAGTDQAFF	TRBV19	TRBJ1-1
TGTGCCAGCAGTAGTCGGACCCCGGTTAGTTATCAAGAGACCCAGTACTTC	CASSSRTPVSYQETQYF	TRBV28	TRBJ2-5
TGTGCCAGCGGAGGGGTTCACGAGCAGTACTTC	CASGGVHEQYF	TRBV2	TRBJ2-7
TGTGCCAGTAGTCGTACTAGCGGGAGGGCGGGTGGCTACGAGCAGTACTTC	CASSRTSGRAGGYEQYF	TRBV19	TRBJ2-7
TGTGCCACACTAACGGCAGGCACTAATGAAAAACTGTTTTTT	CATLTAGTNEKLFF	TRBV24-1	TRBJ1-4
TGCAGTGGTAATCACGGGATGAACACTGAAGCTTTCTTT	CSGNHGMNTEAFF	TRBV20-1	TRBJ1-1
TGTGCCAGCAGTCGTTTTCACCTAAGGGGGGGGTATACAAATCAGCCCCAGCATTTT	CASSRFHLRGGYTNQPQHF	TRBV12-4	TRBJ1-5
TGCGCCAGCATCCGCTCGCCAGTCGCTGAAAAACTGTTTTTT	CASIRSPVAEKLFF	TRBV5-1	TRBJ1-4
TGTGCCAGCAGCCTAGCGGGTGTCAATGAGCAGTTCTTC	CASSLAGVNEQFF	TRBV7-3	TRBJ2-1
TGTGCCAGCAGGGGGATCGAGTTAGCGGGACGCTACGAGCAGTACTTC	CASRGIELAGRYEQYF	TRBV27	TRBJ2-7
TGCAGTGCTAGGGACGACAGGGGACTAGAACCGTCCTACGAGCAGTACTTC	CSARDDRGLEPSYEQYF	TRBV20-1	TRBJ2-7
TGTGCCAGCAGCTTCCTCCCAGGGGGACCGGTACTCACGAACACCGGGGAGCTGTTTTTT	CASSFLPGGPVLTNTGELFF	TRBV7-2	TRBJ2-2
TGCGCCAGCAGCTCGGGGAGACATCAGCCCCAGCATTTT	CASSSGRHQPQHF	TRBV10-1	TRBJ1-5
TGTGCCAGCCCCCGCCCTACCTCTAACTATGGCTACACCTTC	CASPRPTSNYGYTF	TRBV7-3	TRBJ1-2
TGTGCCAGCAGCTTAGACGGGGGGAGCACTGAAGCTTTCTTT	CASSLDGGSTEAFF	TRBV11-2	TRBJ1-1
TGCGCCAGCAGCCCCGTTTTAGAGAGGGGGGTGGGGTACGAGCAGTACTTC	CASSPVLERGVGYEQYF	TRBV5-1	TRBJ2-7
TGTGCCAGCAGTTTGGGAACTACAGGAAAGGGGGGTGCAACTAATGAAAAACTGTTTTTT	CASSLGTTGKGGATNEKLFF	TRBV28	TRBJ1-4
TGCAGTGCTAGCCACAGGTCCCTCTATGGCTACACCTTC	CSASHRSLYGYTF	TRBV20-1	TRBJ1-2
TGTGCCAGCAGCTGTCTAACGGGGTCTGGAAACACCATATATTTT	CASSCLTGSGNTIYF	TRBV7-3	TRBJ1-3
TGTGCCAGCAGCCGGCAGGGACTAAACTTAGGGGGGACCGGGGAGCTGTTTTTT	CASSRQGLNLGGTGELFF	TRBV13	TRBJ2-2
TGCGCCAGCAGCTTGAGGAGGGCCCATGGCTACACCTTC	CASSLRRAHGYTF	TRBV5-1	TRBJ1-2
TGTGCCAGCAGCTCGGCCCCGGTGCTGCCGAACAGGGACACCGGGGAGCTGTTTTTT	CASSSAPVLPNRDTGELFF	TRBV7-2	TRBJ2-2
TGCAGTGCTAAAGCGGACGGTCAGCCCCAGCATTTT	CSAKADGQPQHF	TRBV20-1	TRBJ1-5
TGTGCCAGCACGGTCGGTGGGACTAGACACGGCCACAATGAGCAGTTCTTC	CASTVGGTRHGHNEQFF	TRBV7-9	TRBJ2-1
TGTGCCAGTAGTAGGTTTATAACCGGCAATGAGCAGTTCTTC	CASSRFITGNEQFF	TRBV19	TRBJ2-1
TGTGCCAGCAGTTACCCCCGACCTACGGGACTTTTGAACATTCAGTACTTC	CASSYPRPTGLLNIQYF	TRBV6-3	TRBJ2-4
TGTGCCAGCACGGGACCTAGAAGAGACCCGATTCAAGAGACCCAGTACTTC	CASTGPRRDPIQETQYF	TRBV9	TRBJ2-5
TGTGCCAGCAGCAGGGGCAACGAGCAGTACTTC	CASSRGNEQYF	TRBV13	TRBJ2-7
TGTGCCAGCAGCCAGCCCGGGTTAGCTAGCACAGATACGCAGTATTTT	CASSQPGLASTDTQYF	TRBV7-2	TRBJ2-3
TGTGCCAGCAGTTACTCCGGGACGGAAGATACGCAGTATTTT	CASSYSGTEDTQYF	TRBV6-5	TRBJ2-3
TGCGCCAGCAGCCATAGGGGGCGGACGAACACCGGGGAGCTGTTTTTT	CASSHRGRTNTGELFF	TRBV5-1	TRBJ2-2
TGTGCCCCCCACCAAGGGGGGGGGGAGGGAAAGCTAGAGACCCAGTACTTC	CAPHQGGGEGKLETQYF	TRBV28	TRBJ2-5
TGCAGTGCCGTTCACGGTCAGCCCCAGCATTTT	CSAVHGQPQHF	TRBV20-1	TRBJ1-5
TGTGCAGATCAGGGGAACTACGAGCAGTACTTC	CADQGNYEQYF	TRBV9	TRBJ2-7
TGTGCCAGCAGTCTATCCCTCCTGTTGCAAGAGACCCAGTACTTC	CASSLSLLLQETQYF	TRBV28	TRBJ2-5
TGCAGCGTTGGCGCAATGGGGCGAGCAACTAATGAAAAACTGTTTTTT	CSVGAMGRATNEKLFF	TRBV29-1	TRBJ1-4
TGTGCCAGCAGCAGGCCCCGGGACAGCAATCAGCCCCAGCATTTT	CASSRPRDSNQPQHF	TRBV9	TRBJ1-5
TGTGCCACCAGTGTCCCACCCTCTAGGAACACCGGGGAGCTGTTTTTT	CATSVPPSRNTGELFF	TRBV24-1	TRBJ2-2
TGTGCCAGCAGCTTAGCCAGAGCTCCGAGCTATGGCTACACCTTC	CASSLARAPSYGYTF	TRBV11-3	TRBJ1-2
TGTGCCCTATTTTGGGGGGGACAGGGGGATGGCTACACCTTC	CALFWGGQGDGYTF	TRBV24-1	TRBJ1-2
TGTGCCAGCAGCACACCGGGGCGTCAGCCCCAGCATTTT	CASSTPGRQPQHF	TRBV11-2	TRBJ1-5
TGTGCCAGCAGGGAGGACAGGGGGGGCTACACCTTC	CASREDRGGYTF	TRBV11-2	TRBJ1-2
TGTGCCAGCAGCAGGGCAGTTAAGGCTGAAAAACTGTTTTTT	CASSRAVKAEKLFF	TRBV4-2	TRBJ1-4
TGCGCCAGCAGCCCCCTCGACGGAGGCTGGTCCTACGAGCAGTACTTC	CASSPLDGGWSYEQYF	TRBV4-1	TRBJ2-7
TGTGCCAGCAGCTTGAGCCGGGCGGGAGCCTACGAGCAGTACTTC	CASSLSRAGAYEQYF	TRBV5-6	TRBJ2-7
TGTGCCAGCAGCTTGCCTTCCGAACAGGGCAACACTGAAGCTTTCTTT	CASSLPSEQGNTEAFF	TRBV5-5	TRBJ1-1
TGTGCCAGTAGTACTAGCGGGTCGGCGGGCTACGAGCAGTACTTC	CASSTSGSAGYEQYF	TRBV19	TRBJ2-7
TGTGCCAGCAGTGCCCTCAGCCGGGACAGATCCTATGGCTACACCTTC	CASSALSRDRSYGYTF	TRBV6-1	TRBJ1-2
TGTGCCAGCATCGGACGGTGGTTCGCCCCAGCTTTCTTT	CASIGRWFAPAFF	TRBV7-6	TRBJ1-1
TGTGCCAGCAGCACAGGGGGCACAGCTCTGACAAACACCGGGGAGCTGTTTTTT	CASSTGGTALTNTGELFF	TRBV7-2	TRBJ2-2
TGTGCCAGCACCTCCGGGTCCTACGAGCAGTACTTC	CASTSGSYEQYF	TRBV6-1	TRBJ2-7
TGTGCCAGCAGCCGCCGACAGGGGGAAGCCTACGAGCAGTACTTC	CASSRRQGEAYEQYF	TRBV3-1	TRBJ2-7
TGTGCCACCAGCAGGAGCCACGACCGAACAGATACGCAGTATTTT	CATSRSHDRTDTQYF	TRBV15	TRBJ2-3
TGTGCCAGCAATGAGCGGGATAGCAAGTACGAGCAGTACTTC	CASNERDSKYEQYF	TRBV7-9	TRBJ2-7
TGTGCCAGCAGCTTAGCCGGACAGGGGAGAGCTAACTATGGCTACACCTTC	CASSLAGQGRANYGYTF	TRBV11-2	TRBJ1-2
TGTGCCAGCAGGCAGGACAGTTTGGCAACTAATGAAAAACTGTTTTTT	CASRQDSLATNEKLFF	TRBV6-4	TRBJ1-4
TGTGGAAGCAGCGGGGAGAGGGATTCACCCCTCCACTTT	CGSSGERDSPLHF	TRBV28	TRBJ1-6
TGCAGTGAACTAATTTACGAGCAGTACTTC	CSELIYEQYF	TRBV20-1	TRBJ2-7
TGTGCCAGCAGCACCTCCGGGACTAGGGTCGGCAATGAGCAGTTCTTC	CASSTSGTRVGNEQFF	TRBV13	TRBJ2-1
TGTGCCAGCAGGTCCGGTCGGACAGGCCCAGCCAAAAACATTCAGTACTTC	CASRSGRTGPAKNIQYF	TRBV12-4	TRBJ2-4
TGTGCCAGCAGCTTGGCCTCGACAGGGGCCGTCAAAAACATTCAGTACTTC	CASSLASTGAVKNIQYF	TRBV5-6	TRBJ2-4
TGTGATCCAATCAATTTAAGGGCTTTCTTT	CDPINLRAFF	TRBV11-3	TRBJ1-1
TGTGCCACCACGGATGAATCAGGGAATAGTATAGTCCGAAGAAGAGGCGGCTATGGCTACACCTTC	CATTDESGNSIVRRRGGYGYTF	TRBV24-1	TRBJ1-2
TGTGCCAGCAGTTACCCGATTGGGAGGGGGGAGGCGCAGTTCTTC	CASSYPIGRGEAQFF	TRBV6-3	TRBJ2-1
TGTGCCAGCGCTAGCGGGTGGGGGGAGCTGTTTTTT	CASASGWGELFF	TRBV6-3	TRBJ2-2
TGCGCCAGCAGCTTGCACCGGGACAGGGGCAATGAAAAACTGTTTTTT	CASSLHRDRGNEKLFF	TRBV5-1	TRBJ1-4
TGTGCCAGCAGCCCTAGAGCAGATACGCAGTATTTT	CASSPRADTQYF	TRBV9	TRBJ2-3
TGTGCCAGCAGTGACGAAATCGACAGTCCAGAGACCCAGTACTTC	CASSDEIDSPETQYF	TRBV6-4	TRBJ2-5
TGTGCCAGCAGCCAAGGGTCCGAGAAGAAACACACTGAAGCTTTCTTT	CASSQGSEKKHTEAFF	TRBV14	TRBJ1-1
TGCAGTGTGTCCCGGGGGGAGGGACCCTACGAGCAGTACTTC	CSVSRGEGPYEQYF	TRBV20-1	TRBJ2-7
TGTGCCAGCAGGAGACGGGACAGGGCATTCCCTCTAGAGACCCAGTACTTC	CASRRRDRAFPLETQYF	TRBV6-5	TRBJ2-5
TGTGCCACCAGTGATTCCACAGGGAGGCTGTCTTGCTATGGCTACACCTTC	CATSDSTGRLSCYGYTF	TRBV24-1	TRBJ1-2
TGTGCCAGCAAAGTGGGACAGGGGGGAACGACCAAGGGCTACGAGCAGTACTTC	CASKVGQGGTTKGYEQYF	TRBV5-5	TRBJ2-7
TGTGCCAGCAGCCGTCAGATGGGGTACGAGCAGTACTTC	CASSRQMGYEQYF	TRBV9	TRBJ2-7
TGTGCCAGCAATCACCTCCCATCCCCGGGGAACACTGAAGCTTTCTTT	CASNHLPSPGNTEAFF	TRBV6-5	TRBJ1-1
TGTGCCATCCGCGTGCCCCAGCATTTT	CAIRVPQHF	TRBV10-3	TRBJ1-5
TGTGCCCCTAGGAATCCCGTGCCCTCAGATACGCAGTATTTT	CAPRNPVPSDTQYF	TRBV6-5	TRBJ2-3
TGTGCCAGCAGCGTCGCGGGGTTGCAGCCCCAGCATTTT	CASSVAGLQPQHF	TRBV7-8	TRBJ1-5
TGTGCCAGCAGCAGGAGGGAAAGTGGAAACACCATATATTTT	CASSRRESGNTIYF	TRBV13	TRBJ1-3
TGTGCCAGCAGCAGCTCCGGGGGGGGGTGGAGCTCCTACAATGAGCAGTTCTTC	CASSSSGGGWSSYNEQFF	TRBV7-4	TRBJ2-1
TGTGCCACCAGGGTTGGTGGGACAGCTTGGGAGCAGTACTTC	CATRVGGTAWEQYF	TRBV24-1	TRBJ2-7
TGCAGTGCTAGGAACTCGAGACGGACATCCAATCAGCCCCAGCATTTT	CSARNSRRTSNQPQHF	TRBV20-1	TRBJ1-5
TGCAGCGTTGAGCGAATTGGAGAGGGGGCGATTAATGAAAAACTGTTTTTT	CSVERIGEGAINEKLFF	TRBV29-1	TRBJ1-4
TGTGCCAGCAGTGACGTAAAGCTAGCGGTAGATACGCAGTATTTT	CASSDVKLAVDTQYF	TRBV12-4	TRBJ2-3
TGCGCCAGCAGCCAATTGGTTAGCGGGCATACCGAGCAGTACTTC	CASSQLVSGHTEQYF	TRBV4-1	TRBJ2-7
TGTGCCAGCAGGGTTAAGGCTAACACAGGGGGAGGACTTCAGCCCCAGCATTTT	CASRVKANTGGGLQPQHF	TRBV28	TRBJ1-5
TGTGCCAGGCCTTTAGGAATGGCTTTCTTT	CARPLGMAFF	TRBV6-6	TRBJ1-1
TGCGCCAGCAGCTGGAACAGCGAGCAGTACTTC	CASSWNSEQYF	TRBV5-1	TRBJ2-7
TGCGCCAGCAGCTTGGCGAGGGATAGGGGGGGCGCCAGCACAGATACGCAGTATTTT	CASSLARDRGGASTDTQYF	TRBV5-1	TRBJ2-3
TGTGCCAGCAGTGAACCGGACAGGGTGGAAAAACTGTTTTTT	CASSEPDRVEKLFF	TRBV6-4	TRBJ1-4
TGTGCCAGCTCACCGCAGAGGAAAAACTCCTACGAGCAGTACTTC	CASSPQRKNSYEQYF	TRBV18	TRBJ2-7
TGTGCCAGCAGTGATCTCGACTGGCCCCAGCATTTT	CASSDLDWPQHF	TRBV6-4	TRBJ1-5
TGCGCCAGCAGTTATTTAAGGAATGAGCAGTTCTTC	CASSYLRNEQFF	TRBV5-1	TRBJ2-1
TGTGCCTGGAGTGGTCTTAGTATGACTGAAGCTTTCTTT	CAWSGLSMTEAFF	TRBV30	TRBJ1-1
TGTGCCAGCCCGGGGGACTATGAAAAACTGTTTTTT	CASPGDYEKLFF	TRBV6-4	TRBJ1-4
TGCGCCAATGCGGAACGGGGGTCCTGGGAGCAGTACTTC	CANAERGSWEQYF	TRBV10-2	TRBJ2-7
TGTGCCAGCAGCTTGGTTCTGGGGCGGGCCTCTGGGGCCAACGTCCTGACTTTC	CASSLVLGRASGANVLTF	TRBV5-4	TRBJ2-6
TGTGCCAGCAGCTTAGACAGCCCCGAGACCCAGTACTTC	CASSLDSPETQYF	TRBV11-1	TRBJ2-5
TGCACCCAGGGCAGGGGGGGTGGGGGGAGGGCAAACAGGCAGGCTGGGGCCAACGTCCTGACTTTC	CTQGRGGGGRANRQAGANVLTF	TRBV20-1	TRBJ2-6
TGTGCCAGCAGCTGTCCGGGCGTTACTGAAGCTTTCTTT	CASSCPGVTEAFF	TRBV7-6	TRBJ1-1
TGCGCCAGCAGCTTCTGGTGGCGGGGCCGGGGATGTGAAAAACTGTTTTTT	CASSFWWRGRGCEKLFF	TRBV5-1	TRBJ1-4
TGTGCCAGCAGCAGCGTCTCCTCCGTAAACACCGGGGAGCTGTTTTTT	CASSSVSSVNTGELFF	TRBV5-4	TRBJ2-2
TGCAGTGCTACTGAGGGGCATTCAGAATGGTACTTC	CSATEGHSEWYF	TRBV20-1	TRBJ2-5
TGTGCCAGCACCCGTTATCGCAGAAACGAGCAGTACTTC	CASTRYRRNEQYF	TRBV25-1	TRBJ2-7
TGTGCCACCAGTGATCATGGAGCGGGAGGGAGCACGAGGTGTACCTACAATGAGCAGTTCTTC	CATSDHGAGGSTRCTYNEQFF	TRBV24-1	TRBJ2-1
TGCGCCAGCAGCCATTCGGCCCCGGGAGGGCCCTACAAGGCTGAGCAGTTCTTC	CASSHSAPGGPYKAEQFF	TRBV4-3	TRBJ2-1
TGCGCCAGCAGCCAAGAAGGCCCCCGGGACCTACCCGGCTACACCTTC	CASSQEGPRDLPGYTF	TRBV4-3	TRBJ1-2
TGTGCCAGCAGCGTAACCGGAGGGGACAGGGGCGGGAACACCGGGGAGCTGTTTTTT	CASSVTGGDRGGNTGELFF	TRBV9	TRBJ2-2
TGCGCCAGCAGTCCTAGGGCTTTTCAGCCCCAGCATTTT	CASSPRAFQPQHF	TRBV10-1	TRBJ1-5
TGTGCCAGCAGCTCGTTAGGAGGGACGAACACTGAAGCTTTCTTT	CASSSLGGTNTEAFF	TRBV7-3	TRBJ1-1
TGTGCCAGCAGCACACTGACAGGGGGAAACACCGGGGAGCTGTTTTTT	CASSTLTGGNTGELFF	TRBV6-6	TRBJ2-2
TGCGCCAGCAGCTTGGACGACGAGCAGTACTTC	CASSLDDEQYF	TRBV5-1	TRBJ2-7
TGTGCCAGTAGTATAGGGCGCGCGAACACCGGGGAGCTGTTTTTT	CASSIGRANTGELFF	TRBV19	TRBJ2-2
TGTGCCAGTAGTATTGGGGACAGAGGGCCCGAACTGTTTTTT	CASSIGDRGPELFF	TRBV19	TRBJ1-4
TGTGCCAGCAGTTGTCGGATTCTGGAGAGTAGCAATCAGCCCCAGCATTTT	CASSCRILESSNQPQHF	TRBV6-1	TRBJ1-5
TGTGCCAGCAGCTTAAGTTCAGGGAATTCACCCCTCCACTTT	CASSLSSGNSPLHF	TRBV7-3	TRBJ1-6
TGTGCCAGAATTACTAGAGTTAAATACAATGAGCAGTTCTTC	CARITRVKYNEQFF	TRBV28	TRBJ2-1
TGTGCCAGCAGTTCTCAAATTTATCGGAGCTCCTACGAGCAGTACTTC	CASSSQIYRSSYEQYF	TRBV27	TRBJ2-7
TGTGCCAGCAGTTACAGGGACGGAAACAGGGGGCCAACCGGGGAGCTGTTTTTT	CASSYRDGNRGPTGELFF	TRBV6-5	TRBJ2-2
TGTGCCAGCAGCGTGGGCAGAGAGTCCGCCTACGAGCAGTACTTC	CASSVGRESAYEQYF	TRBV7-2	TRBJ2-7
TGTGCCAGCAGCTTACTCCGGGACAGCTACGAGCAGTACTTC	CASSLLRDSYEQYF	TRBV7-9	TRBJ2-7
TGTGCCAGCAGTTACCGAAACCCTAACTATGGCTACACCTTC	CASSYRNPNYGYTF	TRBV6-5	TRBJ1-2
TGCGCCAGTCCGACAGCCACTGAAGCTTTCTTT	CASPTATEAFF	TRBV5-1	TRBJ1-1
TGTGCCAGCAGCGCACGCCTCCGGGACCCGGACAGACCATACGAGCAGTACTTC	CASSARLRDPDRPYEQYF	TRBV3-1	TRBJ2-7
TGTGCCTGGAGTGTACGGCGTTACGGACCCTCCTACGAGCAGTACTTC	CAWSVRRYGPSYEQYF	TRBV30	TRBJ2-7
TGTGCCACCAGTGATTTGCCCCGACCGGACGGGGGGCGGCCTAACTATGGCTACACCTTC	CATSDLPRPDGGRPNYGYTF	TRBV24-1	TRBJ1-2
TGTGCCAGCAGCACGAGGGATCGGGGGCGTGTACATGGCTACACCTTC	CASSTRDRGRVHGYTF	TRBV13	TRBJ1-2
TGTGCCAGCAGCTCCGGGCCCCGAAGGAGCTACGAGCAGTACTTC	CASSSGPRRSYEQYF	TRBV7-8	TRBJ2-7
TGCAGTGCTACAGGGGGCGCCGGGAGAAACACCATATATTTT	CSATGGAGRNTIYF	TRBV20-1	TRBJ1-3
TGTGCCAGCAGCTTAGATTATCTCGGGACTAGCAACACCGGGGAGCTGTTTTTT	CASSLDYLGTSNTGELFF	TRBV7-7	TRBJ2-2
TGTGCCAGCAGCTCCAGAGAGGGGGAGACCCAGTACTTC	CASSSREGETQYF	TRBV5-6	TRBJ2-5
TGCGCCAGACTAGCGGGAGGGCCTACTGAAGCTTTCTTT	CARLAGGPTEAFF	TRBV10-2	TRBJ1-1
TGCGCCAGCAGCCGAGTAAACCACCCAGATACGCAGTATTTT	CASSRVNHPDTQYF	TRBV5-1	TRBJ2-3
TGTGCCAGCAGCCAAGCGAGTCGGGGGCCCTACAATGAGCAGTTCTTC	CASSQASRGPYNEQFF	TRBV4-2	TRBJ2-1
TGTGCCAGCAGTATGGGGGCGCTATATAGCAATCAGCCCCAGCATTTT	CASSMGALYSNQPQHF	TRBV6-5	TRBJ1-5
TGCGCCAGCAGCTTGCGAGCCGGGGACATCCATAGGCGCAATCAGCCCCAGCATTTT	CASSLRAGDIHRRNQPQHF	TRBV5-1	TRBJ1-5
TGTGCCAGCAGACAGAGGGGAGCCGGGGAGCTGTTTTTT	CASRQRGAGELFF	TRBV6-1	TRBJ2-2
TGTGCCAGCAGCGGGCTGACTAGAAGCTCCTACAATGAGCAGTTCTTC	CASSGLTRSSYNEQFF	TRBV5-8	TRBJ2-1
TGCAGTGCTACAATACCTTCGGGACGGGCCGGCCAGAAGACTGAAGCTTTCTTT	CSATIPSGRAGQKTEAFF	TRBV20-1	TRBJ1-1
TGTGCCAGCAGCGTCACCTCTAGATTCACCGGGGAGCTGTTTTTT	CASSVTSRFTGELFF	TRBV13	TRBJ2-2
TGTGCCAGCAGCGGCCAGGAGGGCCCTGGTGACGAGCAGTACTTC	CASSGQEGPGDEQYF	TRBV6-2	TRBJ2-7
TGCGCCAGCAGCTTGGCAACGGGGGGGGAAGCTTTCTTT	CASSLATGGEAFF	TRBV5-1	TRBJ1-1
TGTGCCAGCAGCCCGGGACAGGGGGATCCCGCTGGGGCCAACGTCCTGACTTTC	CASSPGQGDPAGANVLTF	TRBV11-2	TRBJ2-6
TGCAGTGCTATGCGTGACTCCTGCTCTGGAAACACCATATATTTT	CSAMRDSCSGNTIYF	TRBV20-1	TRBJ1-3
TGTGCCAGCAGGAAAACTGCAGGCGGAGTAAGCAATCAGCCCCAGCATTTT	CASRKTAGGVSNQPQHF	TRBV28	TRBJ1-5
TGTGCCAGCAGCTTATCTAGCGGGTCGTCCTCCTACAATGAGCAGTTCTTC	CASSLSSGSSSYNEQFF	TRBV5-5	TRBJ2-1
TGTGCCAGCACCGACGGGGGCGGACCTGCAACTAATGAAAAACTGTTTTTT	CASTDGGGPATNEKLFF	TRBV27	TRBJ1-4
TGCGCCAGCAGCGCGTGGGGGACCCAGTACTTC	CASSAWGTQYF	TRBV5-1	TRBJ2-5
TGTGCCAGCAGGGTCGGACTAGCGGCGAGCACGGGGAGCGAGCAGTACTTC	CASRVGLAASTGSEQYF	TRBV28	TRBJ2-7
TGCAGTGCTAGAGAAAGCGACCAGCGCCACCTCGAAGCTTTCTTT	CSARESDQRHLEAFF	TRBV20-1	TRBJ1-1
TGTGCCAGCAGTTTCGCGGGGCGGGACAGGTTGAACAATGAGCAGTTCTTC	CASSFAGRDRLNNEQFF	TRBV28	TRBJ2-1
TGTGCCAGCAGCTTAGATATTAGTGCCTACGAGCAGTACTTC	CASSLDISAYEQYF	TRBV11-3	TRBJ2-7
TGCAGTGCTAGAGATCACCCCGACAGGGCCGATACGCAGTATTTT	CSARDHPDRADTQYF	TRBV20-1	TRBJ2-3
TGTGCCAGTAGTATACTCGGTGGACAGGCTACAAAACTGTTTTTT	CASSILGGQATKLFF	TRBV19	TRBJ1-4
TGTGCCAGTCGGCCAGCAGAGGGGAGGAGTTCTCCGAAGGGAAGGAATCAGCCCCAGCATTTT	CASRPAEGRSSPKGRNQPQHF	TRBV19	TRBJ1-5
TGTGCCGGGGGGGTGTTCGAGCAGTTCTTC	CAGGVFEQFF	TRBV7-9	TRBJ2-1
TGTGCCAGCAGCAAGAACCTCCGGTCGAATACGCAGTATTTT	CASSKNLRSNTQYF	TRBV13	TRBJ2-3
TGTGCCAGCAGCTCGCCGGAACCACACTCACCCCTCCACTTT	CASSSPEPHSPLHF	TRBV7-3	TRBJ1-6
TGTGCCAGCAGCCGAGGCTACGAGCAGTACTTC	CASSRGYEQYF	TRBV6-2	TRBJ2-7
TGTGCCAGCTCACCACGGCCTACCGAGCATAGTGACAATGAGCAGTTCTTC	CASSPRPTEHSDNEQFF	TRBV18	TRBJ2-1
TGTGCCAGCAGTTTGGCCCGGGGGACAGGGAAATTTAACACTGAAGCTTTCTTT	CASSLARGTGKFNTEAFF	TRBV12-4	TRBJ1-1
TGTGCCAGCAGTGGGACCGCCAATGGCGACAGGAGCGGGAGCCGCTGCACTGAAGCTTTCTTT	CASSGTANGDRSGSRCTEAFF	TRBV25-1	TRBJ1-1
TGTGCCAGCAGCCAGGGCGGTAATTCTGAAGCTTTCTTT	CASSQGGNSEAFF	TRBV9	TRBJ1-1
TGTGCCATCAGTGGGCACTGGGACTCTAGCACAGATACGCAGTATTTT	CAISGHWDSSTDTQYF	TRBV10-3	TRBJ2-3
TGCGCCAGCAGCTTGGAGACAGGGCCGTACGGGGAGCTGTTTTTT	CASSLETGPYGELFF	TRBV5-1	TRBJ2-2
TGTGCCAGCAGCCGGGGCCCCACTGAAGCTTTCTTT	CASSRGPTEAFF	TRBV6-1	TRBJ1-1
TGTGCCAGCAGTTTACCGAGACAGTATTCCAATGAGCAGTTCTTC	CASSLPRQYSNEQFF	TRBV12-3	TRBJ2-1
TGCAGCGTGGTCCGGACGGAAGGCAGCACAGATACGCAGTATTTT	CSVVRTEGSTDTQYF	TRBV29-1	TRBJ2-3
TGCAGCGCTAACAAGTCGGGGAGGGTGCTGGGTCAGCCCCAGCATTTT	CSANKSGRVLGQPQHF	TRBV29-1	TRBJ1-5
TGTGCCAGCTCACCACGGGGTAAGCGGGACTCCATGGCTGAAGCTTTCTTT	CASSPRGKRDSMAEAFF	TRBV18	TRBJ1-1
TGTGCCAGCAGCCAACTTGAAGAGGGCGACCAAGAGACCCAGTACTTC	CASSQLEEGDQETQYF	TRBV3-1	TRBJ2-5
TGTGCCAGCAGCTCAGGGGTCGCCTACGAGCAGTACTTC	CASSSGVAYEQYF	TRBV7-3	TRBJ2-7
TGTGCCAGCAGCCGAAGTAAGGCCGGCACTGAAGCTTTCTTT	CASSRSKAGTEAFF	TRBV3-1	TRBJ1-1
TGTGCCAGCAGCGGCAGAAATGAAAAACTGTTTTTT	CASSGRNEKLFF	TRBV13	TRBJ1-4
TGTGCCAGCAGCGTAGTGGGACCGCAGGAGTACAATCAGCCCCAGCATTTT	CASSVVGPQEYNQPQHF	TRBV9	TRBJ1-5
TGTGCCAGCAGCTTAGATACTGGCTACGAGCAGTACTTC	CASSLDTGYEQYF	TRBV7-4	TRBJ2-7
TGTGCCACCAGTGAGCCGGTCGCAGGACAGGGGTACCAGCCCCAGCATTTT	CATSEPVAGQGYQPQHF	TRBV24-1	TRBJ1-5
TGTGCCAGCAGTTTAATGGAGAAGTACTTC	CASSLMEKYF	TRBV12-3	TRBJ2-5
TGTGCCAGCAGTGAAGCCAGGGGAGTGAGACAGGCCCATAATGAAAAACTGTTTTTT	CASSEARGVRQAHNEKLFF	TRBV6-1	TRBJ1-4
TGTGCCAGCAAGCTTTTTAGGGGCGAAGCGAATGGCTACACCTTC	CASKLFRGEANGYTF	TRBV9	TRBJ1-2
TGTGCCATCAGTGAGTCGAAGAGGGGGTACAATCAGCCCCAGCATTTT	CAISESKRGYNQPQHF	TRBV10-3	TRBJ1-5
TGTGCCAGCAGTTTATTGTTACAGGGGTATACCTCAACTAATGAAAAACTGTTTTTT	CASSLLLQGYTSTNEKLFF	TRBV27	TRBJ1-4
TGTGCCGTCCGTAGTAGGGGCTCCTACAATGAGCAGTTCTTC	CAVRSRGSYNEQFF	TRBV7-2	TRBJ2-1
TGTGCCATCGCCGGGACAGGGGGACCTGAAGCTTTCTTT	CAIAGTGGPEAFF	TRBV7-9	TRBJ1-1
TGTGCTAATGAAGGAGGGTCTCGAGGTGTAATCACAGATACGCAGTATTTT	CANEGGSRGVITDTQYF	TRBV12-5	TRBJ2-3
TGCGCCAGCAGCTTGTCTTGGGCGGGAGATTCTGAAAAACTGTTTTTT	CASSLSWAGDSEKLFF	TRBV5-1	TRBJ1-4
TGCGCCAGCAGATCGTCTAGGGCGACGACTGAAGCTTTCTTT	CASRSSRATTEAFF	TRBV5-1	TRBJ1-1
TGCGCCAGCAGCTTGAAGTGCAGGAGCGGGAACTATGAGCAGTTCTTC	CASSLKCRSGNYEQFF	TRBV5-1	TRBJ2-1
TGCGCCAGCAGCCAAGCCCAACTTGGACAGGGGTGGGGAGGGGGGAGCTCCTATAATTCACCCCTCCACTTT	CASSQAQLGQGWGGGSSYNSPLHF	TRBV4-1	TRBJ1-6
TGTGCCAGCAGCTTGACCCGCTCCGGGGCCTTTCCGGGCACTGAAGCTTTCTTT	CASSLTRSGAFPGTEAFF	TRBV5-4	TRBJ1-1
TGCAGTGCTAGAGGGGGGCGGGACACTGAAGCTTTCTTT	CSARGGRDTEAFF	TRBV20-1	TRBJ1-1
TGTGCCATCAGACTACGCAATCAGCCCCAGCATTTT	CAIRLRNQPQHF	TRBV10-3	TRBJ1-5
TGTGCCATCCGACCCCAGAACAGGGACAATGAGCAGTTCTTC	CAIRPQNRDNEQFF	TRBV12-3	TRBJ2-1
TGTGCCAGCAGCTATGGCATAAGAACCGGGGAGCTGTTTTTT	CASSYGIRTGELFF	TRBV11-3	TRBJ2-2
TGTGCCAGCAGTTTATCCCCGGAGTCAGCAATGAGGAACACTGAAGCTTTCTTT	CASSLSPESAMRNTEAFF	TRBV27	TRBJ1-1
TGCGCCAGCAGGCCCAGGGGCTACGAGCAGTACTTC	CASRPRGYEQYF	TRBV5-1	TRBJ2-7
TGCGCCAGCAGGGGCAGGACAGGACTGCAGTATTTT	CASRGRTGLQYF	TRBV5-1	TRBJ2-3
TGTGCCTGGAGGGTCAGGGGGCGCGAGCGAGAAAAACTGTTTTTT	CAWRVRGREREKLFF	TRBV30	TRBJ1-4
TGCGCCAGCAGCCTAGAGGACGAGCAGTACTTC	CASSLEDEQYF	TRBV4-3	TRBJ2-7
TGTGCCAGCAGCGGCAAAACTAGCGGCTACAATGAGCAGTTCTTC	CASSGKTSGYNEQFF	TRBV14	TRBJ2-1
TGCGCCAGAGGAACACCAGTCCGATCTGGAAACACCATATATTTT	CARGTPVRSGNTIYF	TRBV5-1	TRBJ1-3
TGTGCCAGCAGCGTGGACAGGGGGAACACTGAAGCTTTCTTT	CASSVDRGNTEAFF	TRBV7-9	TRBJ1-1
TGTGCCAGCAGCGATGGGGGGGGGGCCCCCGGGGAGCTGTTTTTT	CASSDGGGAPGELFF	TRBV13	TRBJ2-2
TGTGCCAAAAAACCGGGACGATACCACCGAGCTTTCTTT	CAKKPGRYHRAFF	TRBV6-5	TRBJ1-1
TGTGCCAGCAGTAGGAGTTTTCCCGGGACCCTAAGGACCCAGTACTTC	CASSRSFPGTLRTQYF	TRBV6-1	TRBJ2-5
TGTGCCTGGATTGAAGATACGCAGTATTTT	CAWIEDTQYF	TRBV30	TRBJ2-3
TGTGCCAGCAGTGAAGGACTAGCGGGATTCAGCTCCTACAATGAGCAGTTCTTC	CASSEGLAGFSSYNEQFF	TRBV6-1	TRBJ2-1
TGTGCCAGCAGTTTTTGTGGCGGGGGGGACGGGACCTACAATGAGCAGTTCTTC	CASSFCGGGDGTYNEQFF	TRBV28	TRBJ2-1
TGTGCCAGCAGTTCCAGAGCGGACAATGAGCAGTTCTTC	CASSSRADNEQFF	TRBV27	TRBJ2-1
TGTGCCAGCTCACCACCGGCGGGACGTGCCTACGAGCAGTACTTC	CASSPPAGRAYEQYF	TRBV18	TRBJ2-7
TGCGCCAGCAGCTTGACCCCAACCGACAGGGCGAATCAGCCCCAGCATTTT	CASSLTPTDRANQPQHF	TRBV5-1	TRBJ1-5
TGCAGTGCTCAAGGGACTAGTACCAATGAGCAGTTCTTC	CSAQGTSTNEQFF	TRBV20-1	TRBJ2-1
TGTGCCAGCAGCTTTCCCGTGGGGAACTATACTGAAGCTTTCTTT	CASSFPVGNYTEAFF	TRBV7-3	TRBJ1-1
TGTGCCAGCAGTAAAGGACTAGCGGGTCTTAATGAGCAGTTCTTC	CASSKGLAGLNEQFF	TRBV6-8	TRBJ2-1
TGTGCCACCTCCTGTAAGTATGGACTAGCCTACGAGCAGTACTTC	CATSCKYGLAYEQYF	TRBV15	TRBJ2-7
TGTGCCAGCAGCTCCGGGCCCCTAGCCAAAAACATTCAGTACTTC	CASSSGPLAKNIQYF	TRBV5-5	TRBJ2-4
TGCGCCAGCAGCCCGGGTCCCCGGGGAGGAATAAGCTCCTATAATTCACCCCTCCACTTT	CASSPGPRGGISSYNSPLHF	TRBV5-1	TRBJ1-6
TGTGCCAGCAGCTTATGGAGGGGGCGGTCGGAGCTGTTTTTT	CASSLWRGRSELFF	TRBV11-2	TRBJ2-2
TGTGCCAGCAGCCATTTGCCTAGCGGGAAATCCGGGGAGCTGTTTTTT	CASSHLPSGKSGELFF	TRBV7-9	TRBJ2-2
TGTGCCAGCAGCTCCCAGGGGGGGCTAGTTTTAGCAACTAATGAAAAACTGTTTTTT	CASSSQGGLVLATNEKLFF	TRBV5-6	TRBJ1-4
TGCGCCAGCGCCGGGGTAAAGACAACTAATGAAAAACTGTTTTTT	CASAGVKTTNEKLFF	TRBV4-1	TRBJ1-4
TGTGCCAGCAGCCAAGACCCTTTATGGCAGGTGAATGAAAAACTGTTTTTT	CASSQDPLWQVNEKLFF	TRBV3-1	TRBJ1-4
TGTGCCAGCAGTGACTCGGAGAAGTCGGGGGAGTACGAGCAGTACTTC	CASSDSEKSGEYEQYF	TRBV6-4	TRBJ2-7
TGTGCCAGCAGCCCAAAGAACAATGAGCAGTTCTTC	CASSPKNNEQFF	TRBV3-1	TRBJ2-1
TGTGCCACCAGCAGATGGCGACAAACCTACACCGGGGAGCTGTTTTTT	CATSRWRQTYTGELFF	TRBV15	TRBJ2-2
TGCAGTGCTAGAGATCGGGGGCGGGACAGGATGAACACTGAAGCTTTCTTT	CSARDRGRDRMNTEAFF	TRBV20-1	TRBJ1-1
TGTGCCAGCAGCCAAGGGGCAGGGAGAAAAAACGAGCAGTACTTC	CASSQGAGRKNEQYF	TRBV14	TRBJ2-7
TGTGCCAGCAGCGTCGTGGCCGCTAGGGGCTACAATGAGCAGTTCTTC	CASSVVAARGYNEQFF	TRBV9	TRBJ2-1
TGTGCCAGCAGGCCGGGACTAGCGGACACCGGGGAGCTGTTTTTT	CASRPGLADTGELFF	TRBV6-5	TRBJ2-2
TGTGCCAGCAGTTTATGTCCCGACCATCAGCCCCAGCATTTT	CASSLCPDHQPQHF	TRBV28	TRBJ1-5
TGTGCCACCAGTGATACTGCGGGGACAATCAATGAGCAGTTCTTC	CATSDTAGTINEQFF	TRBV24-1	TRBJ2-1
TGTGCCAGCAGCCCACCCACAGGACCCGCGCTAGCCAAAAACATTCAGTACTTC	CASSPPTGPALAKNIQYF	TRBV3-1	TRBJ2-4
TGTGCCAGCAGCGACTATGGGGACGTGAACACTGAAGCTTTCTTT	CASSDYGDVNTEAFF	TRBV13	TRBJ1-1
TGCGCCAGCAGTGAGACCGCCCGGGAGAGGGGCGGCTACACCTTC	CASSETARERGGYTF	TRBV10-1	TRBJ1-2
TGCGCCAGCAGCTTGGCCAATGGGGAGACCCAGTACTTC	CASSLANGETQYF	TRBV5-1	TRBJ2-5
TGTGCCAGCAGGTGTCAGGGGCAGAGAAACTATGGCTACACCTTC	CASRCQGQRNYGYTF	TRBV27	TRBJ1-2
TGCGCCAGCAGCATTCCAGGGAACTATGGCTACACCTTC	CASSIPGNYGYTF	TRBV5-1	TRBJ1-2
TGTGCCAGCAGCTTGGAACCCCCCTTCGCATGGGGCTACGAGCAGTACTTC	CASSLEPPFAWGYEQYF	TRBV5-4	TRBJ2-7
TGTGCCTGGGAACCTAGGTACTTC	CAWEPRYF	TRBV30	TRBJ2-5
TGTGCCAGCAGCTTAGACCCGACAGGCTGGGCAACTAATGAAAAACTGTTTTTT	CASSLDPTGWATNEKLFF	TRBV7-2	TRBJ1-4
TGTGCCAGCAGCCCCCCAGTTAGACAGGCTTGCTACGAGCAGTACTTC	CASSPPVRQACYEQYF	TRBV7-8	TRBJ2-7
TGTGCCAGCAGTCTCTGGACTAGCGGGCTAGTTTTCGGGGAGCTGTTTTTT	CASSLWTSGLVFGELFF	TRBV12-4	TRBJ2-2
TGTGCCAGCAGTTTAGGTTTTCCCCAACAGGGCTACACTGAAGCTTTCTTT	CASSLGFPQQGYTEAFF	TRBV12-3	TRBJ1-1
TGTGCCAGCAGCTTAACGACAGGGGGCGCTCCAATCCTAGCCAAAAACATTCAGTACTTC	CASSLTTGGAPILAKNIQYF	TRBV7-2	TRBJ2-4
TGTGCCAGCAGTGTGCTGTCCGGGACAGGGAGCAATCAGCCCCAGCATTTT	CASSVLSGTGSNQPQHF	TRBV6-1	TRBJ1-5
TGTGCCAGCAGCGCACGTAGGGGGCTCACTGAAGCTTTCTTT	CASSARRGLTEAFF	TRBV7-4	TRBJ1-1
TGTGCCAGCAGTTATCCTGGGACAGCCAAGAGAGGCTCTGGAAACACCATATATTTT	CASSYPGTAKRGSGNTIYF	TRBV6-5	TRBJ1-3
TGTGCCAGCAGCGGACGGATGTTAGATGCTTCCTACGAGCAGTACTTC	CASSGRMLDASYEQYF	TRBV7-3	TRBJ2-7
TGTGCCAGCAGGCTTACCGGGACAGGGGCCCTTGGCTACACCTTC	CASRLTGTGALGYTF	TRBV12-3	TRBJ1-2
TGTGCCAGCAGCCTCGTCGGTCACGAGCAGTACTTC	CASSLVGHEQYF	TRBV5-5	TRBJ2-7
TGTGCCCCCTCTTCAACCCCAGTCTCCTATAATTCACCCCTCCACTTT	CAPSSTPVSYNSPLHF	TRBV7-9	TRBJ1-6
TGTGCCAGCAGCTCAGGAGTTCAGGGTCGAGAAAAACTGTTTTTT	CASSSGVQGREKLFF	TRBV7-9	TRBJ1-4
TGTGCCAGCAGCTTGGCCCCGGGACTAGCTTTATCCTACGAGCAGTACTTC	CASSLAPGLALSYEQYF	TRBV5-6	TRBJ2-7
TGTGCCAGCAAACAGGGGCCGACCGAAAAACTGTTTTTT	CASKQGPTEKLFF	TRBV27	TRBJ1-4
TGTGCCAGCAGTTACGGACAGGGTCCCTCGGGCTATGGCTACACCTTC	CASSYGQGPSGYGYTF	TRBV6-2	TRBJ1-2
TGTGCCAGCAGCGGCACCTCATGGCCTGCGAGCAATCAGCCCCAGCATTTT	CASSGTSWPASNQPQHF	TRBV7-8	TRBJ1-5
TGTGCCAGCAGCTTAAGGCCCGCGGGAGGGGTGACCCAGTACTTC	CASSLRPAGGVTQYF	TRBV7-2	TRBJ2-5
TGTGCCAGCAGTTTACAGGGGGCCAATCAGCCCCAGCATTTT	CASSLQGANQPQHF	TRBV27	TRBJ1-5
TGTGCCACGAGACGGATAAGGGACGAGTACCGGCAGCCCCAGCATTTT	CATRRIRDEYRQPQHF	TRBV24-1	TRBJ1-5
TGTGCCAGCAGTGGCAATAGCGGCAGCTCTGGCACTGAAGCTTTCTTT	CASSGNSGSSGTEAFF	TRBV2	TRBJ1-1
TGTGCCAGGACAGGGGTCCGTTCCAATGAAAAACTGTTTTTT	CARTGVRSNEKLFF	TRBV10-3	TRBJ1-4
TGTGCCATCAGTCCTTTCGAGGGCCCCCCCTATGGCTACACCTTC	CAISPFEGPPYGYTF	TRBV10-3	TRBJ1-2
TGTGCCCCGCAAACCGGGACAGGTGGCCTCCATAGCAATCAGCCCCAGCATTTT	CAPQTGTGGLHSNQPQHF	TRBV6-2	TRBJ1-5
TGTGCCAGCAGCAATTGGGGGGCGCGGATCAACACCATATATTTT	CASSNWGARINTIYF	TRBV6-4	TRBJ1-3
TGTGCCAGCAGCCAAGAGTCATTCAGGTACACTGAAGCTTTCTTT	CASSQESFRYTEAFF	TRBV3-1	TRBJ1-1
TGTGCCAGCAGCCAAGCAGAGGCTTACTACGAGCAGTACTTC	CASSQAEAYYEQYF	TRBV3-1	TRBJ2-7
TGTGCCAGCACAGAATCCGGGGGGGGTCGCACAGATACGCAGTATTTT	CASTESGGGRTDTQYF	TRBV27	TRBJ2-3
TGTGCCAGCAGCGGGAGGCTAGGCACTGAAGCTTTCTTT	CASSGRLGTEAFF	TRBV7-3	TRBJ1-1
TGTGCCAGCAGCTTGGCCGACCGTGGACTCAATGAGCAGTTCTTC	CASSLADRGLNEQFF	TRBV5-4	TRBJ2-1
TGTGCCAGCAGCTTCACCAGAGTTGGCACAGATACGCAGTATTTT	CASSFTRVGTDTQYF	TRBV11-1	TRBJ2-3
TGTGCCAGCAGTGCGGACGGGACGTCGAACTATGGCTACACCTTC	CASSADGTSNYGYTF	TRBV6-4	TRBJ1-2
TGTGCCAGCAGGGCAGGGGGGACTATAACCTATAGCAATCAGCCCCAGCATTTT	CASRAGGTITYSNQPQHF	TRBV27	TRBJ1-5
TGTGCCAGCAGCTTTCAACAGGGCTACGAGCAGTACTTC	CASSFQQGYEQYF	TRBV7-9	TRBJ2-7
TGTGCTAGTGGTTTGCCCGGAGGGGACAGGGGTAACACTGAAGCTTTCTTT	CASGLPGGDRGNTEAFF	TRBV12-5	TRBJ1-1
TGTGCCAGCAGCCTCGCCGCTAGCGGGTTACATGAGCAGTTCTTC	CASSLAASGLHEQFF	TRBV28	TRBJ2-1
TGTGCCAGCAGTCCCCGCCAATCAACAGGGTCCAGCCACTACGAGCAGTACTTC	CASSPRQSTGSSHYEQYF	TRBV27	TRBJ2-7
TGTGCCAGCAGCGTAAGGCCAGGAGGGCACGGGCTTACCCTCCACTTT	CASSVRPGGHGLTLHF	TRBV9	TRBJ1-6
TGCAGTGCTAGAGCCGATAGCGGCGAGCAGTACTTC	CSARADSGEQYF	TRBV20-1	TRBJ2-7
TGCGCCAGCAGCCCCCGGGACAGGGGAACTGAAGCTTTCTTT	CASSPRDRGTEAFF	TRBV5-1	TRBJ1-1
TGTGCGAGGGCTATGAAGGCCTACGAGCAGTACTTC	CARAMKAYEQYF	TRBV6-2	TRBJ2-7
TGTGCCGACCTGGACAGCCAAACAGATACGCAGTATTTT	CADLDSQTDTQYF	TRBV6-1	TRBJ2-3
TGTGCCAGCACCCGGGGAGCTAACTATGGCTACACCTTC	CASTRGANYGYTF	TRBV27	TRBJ1-2
TGTGCCAGCAGCAGGGTCCCTAGCTCCTACAATGAGCAGTTCTTC	CASSRVPSSYNEQFF	TRBV9	TRBJ2-1
TGTGCCAGACGCCCCCCAGGGGGCCAAGAGACCCAGTACTTC	CARRPPGGQETQYF	TRBV11-3	TRBJ2-5
TGCAGCGTTGACGCAGCGGAAGAGACCCAGTACTTC	CSVDAAEETQYF	TRBV29-1	TRBJ2-5
TGTGCCAGCAACATCCTGCGAGAGTACAATGAGCAGTTCTTC	CASNILREYNEQFF	TRBV6-8	TRBJ2-1
TGTGCCAGCAGGAGGGGACTAGCGGACAATGAGCAGTTCTTC	CASRRGLADNEQFF	TRBV6-6	TRBJ2-1
TGTGCCAGTAGTATAGAGATGGGACAGATTTTCCCCCAGCATTTT	CASSIEMGQIFPQHF	TRBV19	TRBJ1-5
TGTGCCAGCAGCCCCCCAGGGGGAAGCCGGGACAGGCCCACCTACGAGCAGTACTTC	CASSPPGGSRDRPTYEQYF	TRBV7-9	TRBJ2-7
TGTGCCAGCAGCCAACGAATCAGGGCAATCAATCAGCCCCAGCATTTT	CASSQRIRAINQPQHF	TRBV3-1	TRBJ1-5
TGTGCCAGCAGCTGCCGGGGAGAATATGGCTACACCTTC	CASSCRGEYGYTF	TRBV11-3	TRBJ1-2
TGTGCCATAGGGATTAATGGCTACACCTTC	CAIGINGYTF	TRBV2	TRBJ1-2
TGCGCCAGCAGTGAGCCTAGGCCCCAAAATAGCTCCTACGAGCAGTACTTC	CASSEPRPQNSSYEQYF	TRBV10-1	TRBJ2-7
TGTGCCAGCAGCTTAAACGGGGGTGGAGACTACTCCTACAATGAGCAGTTCTTC	CASSLNGGGDYSYNEQFF	TRBV7-4	TRBJ2-1
TGCGCCAGCAGCTTGGCCGGAACAGGATCCTATAATTCACCCCTCCACTTT	CASSLAGTGSYNSPLHF	TRBV5-1	TRBJ1-6
TGTGCCACGCCTCAGTGCGGGACAGATTGGAACTATGGCTACACCTTC	CATPQCGTDWNYGYTF	TRBV10-3	TRBJ1-2
TGTGCCAGCAGTGACTCGAGGCATCGGGGAGGCTCCTACGAGCAGTACTTC	CASSDSRHRGGSYEQYF	TRBV6-4	TRBJ2-7
TGTGCCTCCGGGGGATCAGATACGCAGTATTTT	CASGGSDTQYF	TRBV6-1	TRBJ2-3
TGTGCCAGCAGCATTCACGACAGCGTGTCTGAGACCCAGTACTTC	CASSIHDSVSETQYF	TRBV7-8	TRBJ2-5
TGTGCCAGCGCGGGGGGGGCGGCAGAGACCCAGTACTTC	CASAGGAAETQYF	TRBV6-2	TRBJ2-5
TGTGCCAGCAGCTTAAATGGAAACAGGGACACTGAAGCTTTCTTT	CASSLNGNRDTEAFF	TRBV7-3	TRBJ1-1
TGTGCCAGCAGCCAAGAGGCTCCCGTCGACGGAATAACCAACGCTGAAGCTTTCTTT	CASSQEAPVDGITNAEAFF	TRBV3-1	TRBJ1-1
TGTGCCAAATGGGGAGGGACCACCTTC	CAKWGGTTF	TRBV2	TRBJ1-2
TGTGCCACCAGTGACCACTACAAGTACCAAGAGACCCAGTACTTC	CATSDHYKYQETQYF	TRBV24-1	TRBJ2-5
TGTGCCAGCAGCAAAGGACCAGGTTACGAGCAGTACTTC	CASSKGPGYEQYF	TRBV7-3	TRBJ2-7
TGTGCCAGTAGTCGACAGGGGAAGCGAAACTATGGCTACACCTTC	CASSRQGKRNYGYTF	TRBV19	TRBJ1-2
TGTGCCACCAGTGACCGCAAGGGGTGGTTCTATGGCTACACCTTC	CATSDRKGWFYGYTF	TRBV24-1	TRBJ1-2
TGTGCCAGCAGCAAGACAGGGAAGGGGGACTCCTATAATTCACCCCTCCACTTT	CASSKTGKGDSYNSPLHF	TRBV7-4	TRBJ1-6
TGTGCCAGCAGCTACTCAATGATCACACTTCATTACCCATACAATGAGCAGTTCTTC	CASSYSMITLHYPYNEQFF	TRBV9	TRBJ2-1
TGTGCCACCAGTGAGTCCCGGGACAGGGGGCGGGTCTATGGCTACACCTTC	CATSESRDRGRVYGYTF	TRBV24-1	TRBJ1-2
TGTGCCAGCAGTCCGACAGGGGTTTATCAGCCCCAGCATTTT	CASSPTGVYQPQHF	TRBV28	TRBJ1-5
TGTGCCAGCAGCGATTCCCTGTCCCAACCGGGACTAGCGGGAGGGGCCTATAATTCACCCCTCCACTTT	CASSDSLSQPGLAGGAYNSPLHF	TRBV13	TRBJ1-6
TGTGCCAGCAGTTTATACGCGGGAGAATTCTCTCCCTACGAGCAGTACTTC	CASSLYAGEFSPYEQYF	TRBV27	TRBJ2-7
TGTGCCAGCAGCGGCCCCTTCTTCTCCCGACAGGGGCACGAAAAACTGTTTTTT	CASSGPFFSRQGHEKLFF	TRBV9	TRBJ1-4
TGTGCCAGCAGCCCAAACCGATCTTATGGCTACACCTTC	CASSPNRSYGYTF	TRBV11-3	TRBJ1-2
TGTGCCAGCAGCTTAGCGGCCGATGACACTGAAGCTTTCTTT	CASSLAADDTEAFF	TRBV7-4	TRBJ1-1
TGTGCCAGCATTATAGGGGCAGGGGGGAACACTGAAGCTTTCTTT	CASIIGAGGNTEAFF	TRBV19	TRBJ1-1
TGTGCCAGCAGCGGCGACAGGGGAGATAGCAATCAGCCCCAGCATTTT	CASSGDRGDSNQPQHF	TRBV7-4	TRBJ1-5
TGTGCCAGCAGCTTAAGGAAGGGAAATAGCAACACCGGGGAGCTGTTTTTT	CASSLRKGNSNTGELFF	TRBV7-2	TRBJ2-2
TGTGCCAGCAGCAGGATGGGGGGCTACGAGCAGTACTTC	CASSRMGGYEQYF	TRBV27	TRBJ2-7
TGTGCTAGTGGTTACATGAACACTGAAGCTTTCTTT	CASGYMNTEAFF	TRBV12-5	TRBJ1-1
TGTGCCAGCAGCCACCGCGGGAGTTTTGACGAGCAGTACTTC	CASSHRGSFDEQYF	TRBV28	TRBJ2-7
TGTGCCAGCAGTGGACAGAAAGATGAGCAGTTCTTC	CASSGQKDEQFF	TRBV25-1	TRBJ2-1
TGTGCCAGCAGGTCCCCGAACACTGAAGCTTTCTTT	CASRSPNTEAFF	TRBV6-4	TRBJ1-1
TGTGCCAGCAGCCTAGGGGGGGGAGCTTTCTTT	CASSLGGGAFF	TRBV13	TRBJ1-1
TGTGCCAGCATGGGCCAGCCCCAGCATTTT	CASMGQPQHF	TRBV6-1	TRBJ1-5
TGTGCCAGCAGCTGGGTCCCTGCGGGAGGGGGAATGAACACTGAAGCTTTCTTT	CASSWVPAGGGMNTEAFF	TRBV7-3	TRBJ1-1
TGTGCCAGCAGGGGTAGCAATCAGCCCCAGCATTTT	CASRGSNQPQHF	TRBV2	TRBJ1-5
TGCGCCAGCAGCCCGGGGCGGCATGAGCAGTTCTTC	CASSPGRHEQFF	TRBV5-1	TRBJ2-1
TGTGCCAGCAGCTTAGCGGGGGTATATACTCCGGGGTTGGACATTGGGAACACTGAAGCTTTCTTT	CASSLAGVYTPGLDIGNTEAFF	TRBV11-2	TRBJ1-1
TGTGCCAGCAGTGAAGCCTGTAGGGGCGGGACCAACTACTCTGGAAACACCATATATTTT	CASSEACRGGTNYSGNTIYF	TRBV2	TRBJ1-3
TGTGCCAGCAGTGCATCGAAGACCCGGGCGAACACCGGGGAGCTGTTTTTT	CASSASKTRANTGELFF	TRBV6-4	TRBJ2-2
TGTGCCAGCAGCCAAGATGGCCGGGACAGGGGGCGTTTAGAGACCCAGTACTTC	CASSQDGRDRGRLETQYF	TRBV4-2	TRBJ2-5
TGTGCCAGCAGTTACACCGGGGGAGGTCGGCTCTTCTACGAGCAGTACTTC	CASSYTGGGRLFYEQYF	TRBV6-5	TRBJ2-7
TGTGCCAGCAGCGTAGAAGGGGAGGGGGGAGAGACCCAGTACTTC	CASSVEGEGGETQYF	TRBV9	TRBJ2-5
TGTGCTAGTGGTGGGGGGGGGAGAGACAATGAGCAGTTCTTC	CASGGGGRDNEQFF	TRBV12-5	TRBJ2-1
TGCGCCAGCAGCTTGGGGGGGACAGGGGGTGTTAATGAGCAGTTCTTC	CASSLGGTGGVNEQFF	TRBV5-1	TRBJ2-1
TGCAGTGCTACCCCCTACGAACGGTCTGGAAACACCATATATTTT	CSATPYERSGNTIYF	TRBV20-1	TRBJ1-3
TGTGCTAGTGGTTTGGGAGACAATCAGCCCCAGCATTTT	CASGLGDNQPQHF	TRBV12-5	TRBJ1-5
TGCGCCAGCAGCTTCCCCCTTGGGCTTCCGAATGAGCAGTTCTTC	CASSFPLGLPNEQFF	TRBV10-1	TRBJ2-1
TGTGCCAGCAGTTCTGATCAGGGGGCGGGAAGGAGCTATGGCTACACCTTC	CASSSDQGAGRSYGYTF	TRBV6-5	TRBJ1-2
TGTGCCAGCAGCTTGTGGAGACAGGGAAATAGCAATCAGCCCCAGCATTTT	CASSLWRQGNSNQPQHF	TRBV5-4	TRBJ1-5
TGCAGTGTCAAGGGTCTCCCCTACGAGCAGTACTTC	CSVKGLPYEQYF	TRBV20-1	TRBJ2-7
TGCGCCAGCAGCTCTCGGATCACAAACACCATATATTTT	CASSSRITNTIYF	TRBV5-1	TRBJ1-3
TGTGCCAGCAGCTCAAGGGTGACCTTCCACAATGAGCAGTTCTTC	CASSSRVTFHNEQFF	TRBV11-2	TRBJ2-1
TGTGCCAGCAGCTTGGTCCCCCGGGACAGTTCCTACGAGCAGTACTTC	CASSLVPRDSSYEQYF	TRBV5-6	TRBJ2-7
TGTGCCAGTAGTACCACATCCCCGGGCCGGGGGCTGTACAATGAGCAGTTCTTC	CASSTTSPGRGLYNEQFF	TRBV19	TRBJ2-1
TGTGCCAGCGGCGGGGGACAGCGGGTTATAAATCAGCCCCAGCATTTT	CASGGGQRVINQPQHF	TRBV5-4	TRBJ1-5
TGTGCCAGCAGTACCAACCTCAGGCCCTCTGGAAACACCATATATTTT	CASSTNLRPSGNTIYF	TRBV6-5	TRBJ1-3
TGTGCCAGCAGTTTGGTCTACTGGGACAGGGGGCGATATGACACCGGGGAGCTGTTTTTT	CASSLVYWDRGRYDTGELFF	TRBV27	TRBJ2-2
TGTGCCACCAGTGATTTGGGGCGGGGGGCCAACGTCCTGACTTTC	CATSDLGRGANVLTF	TRBV24-1	TRBJ2-6
TGTGCCAGCACTGACCGGGGCGGAAACACCATATATTTT	CASTDRGGNTIYF	TRBV6-4	TRBJ1-3
TGTGCCAGCAGCCCGCCGGGACAGGATATTAATTCACCCCTCCACTTT	CASSPPGQDINSPLHF	TRBV6-2	TRBJ1-6
TGTGCCAGCAGCAGGGGAAGTGCTAGCGGGTGTAACGAGCAGTACTTC	CASSRGSASGCNEQYF	TRBV7-4	TRBJ2-7
TGTGCCAGCAGCTTAGACCAGGGGGCGGGTGGCTACACCTTC	CASSLDQGAGGYTF	TRBV7-9	TRBJ1-2
TGTGCTAGTGAGAGCCGGGACAGGGGGGGCTACACCTTC	CASESRDRGGYTF	TRBV12-5	TRBJ1-2
TGTGCCAGCAGTTTACCCAGGCAACCCTACGAGCAGTACTTC	CASSLPRQPYEQYF	TRBV27	TRBJ2-7
TGTGCCAGCAGTCTCTTCCCGGGACAAAATCAGCCCCAGCATTTT	CASSLFPGQNQPQHF	TRBV9	TRBJ1-5
TGTGCCAGCAGCCTGGACAGGGGGTGCCCTAACTATGGCTACACCTTC	CASSLDRGCPNYGYTF	TRBV13	TRBJ1-2
TGTGCCAGCAGCAGAAAAGAGGGACAAGGGGATACGAGGAATGAGCAGTTCTTC	CASSRKEGQGDTRNEQFF	TRBV13	TRBJ2-1
TGTGCCAGCAGACTAGACGGGAATGAGCAGTTCTTC	CASRLDGNEQFF	TRBV6-5	TRBJ2-1
TGTGCCAGCAGTTACCAGACAGGGGGATACCGAGATCAGCCCCAGCATTTT	CASSYQTGGYRDQPQHF	TRBV2	TRBJ1-5
TGTGGTGCCGGCAGGCGCAATCAGCCCCAGCATTTT	CGAGRRNQPQHF	TRBV3-1	TRBJ1-5
TGTGCCACCAGCAGTGACAGGGGGCAACCGGGTCAGCCCCAGCATTTT	CATSSDRGQPGQPQHF	TRBV15	TRBJ1-5
TGCGCCAGCAGGATCCAGAGCAATCAGCCCCAGCATTTT	CASRIQSNQPQHF	TRBV10-1	TRBJ1-5
TGTGCCAGCAGCTTAGTGGGGACCCGTGTCCGTAGACAAGAGACCCAGTACTTC	CASSLVGTRVRRQETQYF	TRBV11-2	TRBJ2-5
TGTGCCAGCAGCCAAGACTGGCTGCCGGGGGGGGGCTACGAGCAGTACTTC	CASSQDWLPGGGYEQYF	TRBV14	TRBJ2-7
TGTGCCTGGAGTCTCCCGGGGGGTGAAGCTTTCTTT	CAWSLPGGEAFF	TRBV30	TRBJ1-1
TGTGCCAGCAGCGTGGCCGGGGGTGGGGAGCAGTACTTC	CASSVAGGGEQYF	TRBV7-2	TRBJ2-7
TGTGCCAGCAGCCGGAACAGGAGCACTGAAGCTTTCTTT	CASSRNRSTEAFF	TRBV13	TRBJ1-1
TGTGCCAGCAGCGAGCGGGATTGGGGAAGAGGGCCCCCCCTACCTGGCAATCAGCCCCAGCATTTT	CASSERDWGRGPPLPGNQPQHF	TRBV6-5	TRBJ1-5
TGCGCCAGCAGCCAAGAAGCCCCTCGTATAAACTACGAGCAGTACTTC	CASSQEAPRINYEQYF	TRBV4-1	TRBJ2-7
TGTGCCAGCTCCCGGGACATACAGCAGAGCTCCTACAATGAGCAGTTCTTC	CASSRDIQQSSYNEQFF	TRBV28	TRBJ2-1
TGCAGTGCTAAGTCAGGTGGTAATGCAGAAAACATTCAGTACTTC	CSAKSGGNAENIQYF	TRBV20-1	TRBJ2-4
TGTGCCAGCAGCTTACCCCAGGTGTTTCAGCCCCAGCATTTT	CASSLPQVFQPQHF	TRBV7-3	TRBJ1-5
TGTGCCAGCAGCGCTAGCGGGCCCGGGGAGCTGTTTTTT	CASSASGPGELFF	TRBV5-6	TRBJ2-2
TGTGCCAGCAGTTTTCTGGGGGGGCCCTACGAGCAGTACTTC	CASSFLGGPYEQYF	TRBV6-2	TRBJ2-7
TGTGCCAGCAGTTCGGGACTAGCGGGGAGGCCCACAGATACGCAGTATTTT	CASSSGLAGRPTDTQYF	TRBV13	TRBJ2-3
TGTGCCAGCAGCTGGATGAGAATTCCGGGACGGGAGACCGGGGAGCTGTTTTTT	CASSWMRIPGRETGELFF	TRBV11-3	TRBJ2-2
TGCGCCAGCAGCTGCCTTGGACCGCTTAGACAGGGGGCTGGAAACACCATATATTTT	CASSCLGPLRQGAGNTIYF	TRBV4-1	TRBJ1-3
TGTGCCATCAGTGAGTCAAGGGGGGGGTGCTACGAGCAGTACTTC	CAISESRGGCYEQYF	TRBV10-3	TRBJ2-7
TGTGCCTGGAGTGTATTGTGGGAGCCTAGAAACACCATATATTTT	CAWSVLWEPRNTIYF	TRBV30	TRBJ1-3
TGTGCCTGGAGGGGAGCCCCGGATGAGCAGTTCTTC	CAWRGAPDEQFF	TRBV30	TRBJ2-1
TGTGCCAGCAGCCACTCAGTGGCTACAGGGAGTAACACCGGGGAGCTGTTTTTT	CASSHSVATGSNTGELFF	TRBV11-3	TRBJ2-2
TGTGCCAGCTGCTGCCCCGGGCCCGATGAAAAACTGTTTTTT	CASCCPGPDEKLFF	TRBV7-4	TRBJ1-4
TGTGCCACCAGCAGAGATGACAGGAAATCCAATCAGCCCCAGCATTTT	CATSRDDRKSNQPQHF	TRBV15	TRBJ1-5
TGTGCCAGCAGCACTAGCGGGAGCGGGGTCGCCTACGAGCAGTACTTC	CASSTSGSGVAYEQYF	TRBV7-9	TRBJ2-7
TGCGCCAGCACCAGGGGGGATTGTCAGCCCCAGCATTTT	CASTRGDCQPQHF	TRBV10-1	TRBJ1-5
TGTGCCAGCAGCCAAGCCCAAGGGGGGGACAATGAGCAGTTCTTC	CASSQAQGGDNEQFF	TRBV14	TRBJ2-1
TGTGCCAGCAGGAGCGCGGGAACGGATGAGCAGTTCTTC	CASRSAGTDEQFF	TRBV7-9	TRBJ2-1
TGTGCCAGCAGCTCCCCTAGCGGGGTAAAAGATACGCAGTATTTT	CASSSPSGVKDTQYF	TRBV13	TRBJ2-3
TGTGCCACAATTAAACCGGGTGGGACCTCCTACGAGCAGTACTTC	CATIKPGGTSYEQYF	TRBV6-2	TRBJ2-7
TGTGCCAGCAGCTTGGGGACAGGGGGGGACACTGAAGCTTTCTTT	CASSLGTGGDTEAFF	TRBV7-6	TRBJ1-1
TGTGCCAGCAGTTTGGGTGGGGGTCCCCTTGGCTACAATGAGCAGTTCTTC	CASSLGGGPLGYNEQFF	TRBV28	TRBJ2-1
TGTGCCACCAGCGGGGGGGGCAGGTACGAGCAGTACTTC	CATSGGGRYEQYF	TRBV24-1	TRBJ2-7
TGCGCCAGCAGCTTGAGGAACTTTCCAGGGAGGGAAGAGAACACTGAAGCTTTCTTT	CASSLRNFPGREENTEAFF	TRBV5-1	TRBJ1-1
TGTGCCAGCAGCTTAGGTGGGCGATTCGGGAGGGAATGGAGAGCTTTCTTT	CASSLGGRFGREWRAFF	TRBV7-2	TRBJ1-1
TGCAGTGCTACGGGGGCCAACGAGCAGTACTTC	CSATGANEQYF	TRBV20-1	TRBJ2-7
TGTGCCAAGGCCAGGAGTCCCAACCCAGACGAGCAGTACTTC	CAKARSPNPDEQYF	TRBV6-4	TRBJ2-7
TGTGCCAGCAGTACAGGGACACAGGCCCACCTGAACACTGAAGCTTTCTTT	CASSTGTQAHLNTEAFF	TRBV28	TRBJ1-1
TGTGCCAGCAGCGACCCCCACGGTTACGAGCAGTACTTC	CASSDPHGYEQYF	TRBV6-5	TRBJ2-7
TGTGCCACCCCAAAGGGTATGCATGGCTACACCTTC	CATPKGMHGYTF	TRBV15	TRBJ1-2
TGTGCTAGTGGTTTGGGGGGACAGGGCAATACCCGGTACTTC	CASGLGGQGNTRYF	TRBV12-5	TRBJ2-7
TGTGCCAGCAGCTTGGACCCAAAGAATGAAAAACTGTTTTTT	CASSLDPKNEKLFF	TRBV5-6	TRBJ1-4
TGCGCCAGCAGCCCGTTGGGGTATTCAGAGACCCAGTACTTC	CASSPLGYSETQYF	TRBV4-1	TRBJ2-5
TGTGCCAGCAGCGTAGAGTGGACGATAAACAGGGGCGGTGAAGCTTTCTTT	CASSVEWTINRGGEAFF	TRBV9	TRBJ1-1
TGTGCCAGCAATCTAGCGGGGAACTACGAGCAGTACTTC	CASNLAGNYEQYF	TRBV6-4	TRBJ2-7
TGTGCCACCAGCAGAGCCCCCGGGACTAGGGAGGAGGGTACAGATACGCAGTATTTT	CATSRAPGTREEGTDTQYF	TRBV15	TRBJ2-3
TGTGCCAGCAGTGCCGGGACAGGGGATACTCAGCCCCAGCATTTT	CASSAGTGDTQPQHF	TRBV6-1	TRBJ1-5
TGTGCCAGCAGCCGGGGGGTCTATAATTCACCCCTCCACTTT	CASSRGVYNSPLHF	TRBV9	TRBJ1-6
TGTGCCAGCAGCTTCGGGGGGGGCCGCGTGGTGAACACTGAAGCTTTCTTT	CASSFGGGRVVNTEAFF	TRBV5-8	TRBJ1-1
TGTGCCAGCAGCTCAGGCGGGAGAAGAAAAGAGACCCAGTACTTC	CASSSGGRRKETQYF	TRBV5-4	TRBJ2-5
TGTGCCAGCAGATGGCCTGGACAGGGGGGACCGTACAATGAGCAGTTCTTC	CASRWPGQGGPYNEQFF	TRBV25-1	TRBJ2-1
TGTGCCAGCAGCCCGGGACAGGGCAGAACTGAAGCTTTCTTT	CASSPGQGRTEAFF	TRBV9	TRBJ1-1
TGTGCCAGCAGCACCCCAGGGGGTTGCAAAAACATTCAGTACTTC	CASSTPGGCKNIQYF	TRBV13	TRBJ2-4
TGTGCCAGCAGCGTAGAAAAATCCGGGGAGACCCAGTACTTC	CASSVEKSGETQYF	TRBV9	TRBJ2-5
TGTGCTAGCAGCTTAACAGACAGGGCCTGGGCCCGGTACACCATATATTTT	CASSLTDRAWARYTIYF	TRBV7-7	TRBJ1-3
TGTGCCAGCAGAATTCGACTAGCTCAAGATACGCAGTATTTT	CASRIRLAQDTQYF	TRBV12-4	TRBJ2-3
TGTGCCACCAGCAGATGGGCGGGAGGCGGGGCAGATCGCAGCACAGATACGCAGTATTTT	CATSRWAGGGADRSTDTQYF	TRBV15	TRBJ2-3
TGTGCCTGGAGTTTATGGGGCGGCTATGGCTACACCTTC	CAWSLWGGYGYTF	TRBV30	TRBJ1-2
TGCGCCAGCAGCTACCCCCGGTCAGGGTTATTCACTGAAGCTTTCTTT	CASSYPRSGLFTEAFF	TRBV5-1	TRBJ1-1
TGTGAGGGCTTATTGGGCTACGAGCAGTACTTC	CEGLLGYEQYF	TRBV28	TRBJ2-7
TGTGCCAGCAGCTTAGCCTGGAGGGGGGAGGTCACAGATACGCAGTATTTT	CASSLAWRGEVTDTQYF	TRBV11-2	TRBJ2-3
TGTGCCAGCAGTGACTCGCCACTTTTCCCGACAGGCTTTGGCTACACCTTC	CASSDSPLFPTGFGYTF	TRBV6-4	TRBJ1-2
TGTGCCACCCTCGGACAGGGGCAGCCCCAGCATTTT	CATLGQGQPQHF	TRBV6-6	TRBJ1-5
TGTGCCAGCAAGCCCAGGCTGAATGGAAACACCATATATTTT	CASKPRLNGNTIYF	TRBV7-9	TRBJ1-3
TGTGCCAGCAATGGACAGGGCATTAACACTGAAGCTTTCTTT	CASNGQGINTEAFF	TRBV12-3	TRBJ1-1
TGCAGTGCTAGAGACGATGGCAACACCGGGGAGCTGTTTTTT	CSARDDGNTGELFF	TRBV20-1	TRBJ2-2
TGTGCCTGGAGTGTACACTGGGCCCGTAACCAATCGGGGACCGGGGAGCTGTTTTTT	CAWSVHWARNQSGTGELFF	TRBV30	TRBJ2-2
TGTGCCAGCAGCTACGGACAGGGGGGAACAGATACGCAGTATTTT	CASSYGQGGTDTQYF	TRBV7-9	TRBJ2-3
TGTGCCAGCAAACCGGACAACGGGTCCGGCTACACCTTC	CASKPDNGSGYTF	TRBV3-1	TRBJ1-2
TGTGCCAGCAGTGATAGATTGGCAGGGGGCAATTATAGCAATCAGCCCCAGCATTTT	CASSDRLAGGNYSNQPQHF	TRBV25-1	TRBJ1-5
TGCGCCACAGGGACAGGGGGGGCCAACGTCCTGACTTTC	CATGTGGANVLTF	TRBV10-1	TRBJ2-6
TGTGCCACCAGCGCCGGTGACAACAATCAGCCCCAGCATTTT	CATSAGDNNQPQHF	TRBV15	TRBJ1-5
TGTGCCAGCCTGGGACAGGGTCAGCCCCAGCATTTT	CASLGQGQPQHF	TRBV6-4	TRBJ1-5
TGTGCCAGCAGCTTGGTTGCCTTGGACACTGTAAAGGAATACGAGCAGTACTTC	CASSLVALDTVKEYEQYF	TRBV5-4	TRBJ2-7
TGTGCCAGCAGCGGGACGACTGGCCAAGAGACCCAGTACTTC	CASSGTTGQETQYF	TRBV6-6	TRBJ2-5
TGTGCCAGCAGGTGGACAGGTACTGAGAACACCGGGGAGCTGTTTTTT	CASRWTGTENTGELFF	TRBV13	TRBJ2-2
TGCGCCAGCAGTGATATAACAGGGGGGGGCGGAAACACCATATATTTT	CASSDITGGGGNTIYF	TRBV10-1	TRBJ1-3
TGTGCCACCAGTGAGGTACCAGGGGCCAATCAGCCCCAGCATTTT	CATSEVPGANQPQHF	TRBV24-1	TRBJ1-5
TGTGCCAGCAGCGGTCGGACTAGATCTACTAGCACAGATACGCAGTATTTT	CASSGRTRSTSTDTQYF	TRBV9	TRBJ2-3
TGTGCCAGCATGATGTCCCCATATCGGACTAGATCAGCCTACGAGCAGTACTTC	CASMMSPYRTRSAYEQYF	TRBV6-4	TRBJ2-7
TGTGCCAGCAGCGACCGGGACGGGCAGGCAGATACGCAGTATTTT	CASSDRDGQADTQYF	TRBV9	TRBJ2-3
TGTGCCAGCAGCAAGACAGCGAAAGCAGAGACCCAGTACTTC	CASSKTAKAETQYF	TRBV13	TRBJ2-5
TGCGCCAGCAGGCGACCGCTAGCGGGACGGGACGAGCAGTACTTC	CASRRPLAGRDEQYF	TRBV10-1	TRBJ2-7
TGCAGCGTTGCCCAGCCTGGGGACCCAGAGACCCAGTACTTC	CSVAQPGDPETQYF	TRBV29-1	TRBJ2-5
TGTGCCAGCAGCTTAAGGGGATCCAGTGAAAAACTGTTTTTT	CASSLRGSSEKLFF	TRBV11-2	TRBJ1-4
TGTGCCAGCTCTCAACGGACTGTCGGTATGGTGAATTCACCCCTCCACTTT	CASSQRTVGMVNSPLHF	TRBV18	TRBJ1-6
TGTGCCACCAGTGGCCCGGGACGCCGGAACACTGAAGCTTTCTTT	CATSGPGRRNTEAFF	TRBV24-1	TRBJ1-1
TGTGCCAGCAGCGGGGGGGACTATGGCTACACCTTC	CASSGGDYGYTF	TRBV9	TRBJ1-2
TGCGCCATCAGCATATATTTT	CAISIYF	TRBV5-1	TRBJ1-3
TGTGCCAGCAGAGGTCCGGGGCTTCACACTGAAGCTTTCTTT	CASRGPGLHTEAFF	TRBV27	TRBJ1-1
TGTGCCAGCAGTTTAAAAAGCAGTCGGGTGGGGGACTATGGCTACACCTTC	CASSLKSSRVGDYGYTF	TRBV28	TRBJ1-2
TGTGCCAGCGTTATCAGGGGGCTCCGTGGCTCCTACGAGCAGTACTTC	CASVIRGLRGSYEQYF	TRBV7-3	TRBJ2-7
TGTGCCAGCAGTGACTCGTGTTCGCCACCCTACGAGCAGTACTTC	CASSDSCSPPYEQYF	TRBV6-4	TRBJ2-7
TGCGCCCGTAACCTAGCGGAGTACAATGAGCAGTTCTTC	CARNLAEYNEQFF	TRBV4-1	TRBJ2-1
TGTGCCAGCAGCCAGACGCGGAATGGCACAGATACGCAGTATTTT	CASSQTRNGTDTQYF	TRBV14	TRBJ2-3
TGTGCCAGCAGTGAAGAATGCGGGTCCGGGAGACCGTTCTACGAGCAGTACTTC	CASSEECGSGRPFYEQYF	TRBV6-4	TRBJ2-7
TGTGCCAGCACAACTCAGGAGAGGCTGGAACAGACCCAGTACTTC	CASTTQERLEQTQYF	TRBV25-1	TRBJ2-5
TGTGCCAGCAGGCGCGTTGGAGCTTTCTTT	CASRRVGAFF	TRBV12-3	TRBJ1-1
TGTGCCAGCACCAGGGGGTTGGGGCCGTCACCCCTCCACTTT	CASTRGLGPSPLHF	TRBV6-4	TRBJ1-6
TGTGCCAGCAGCCCCGAACCTCCCCCGGATAGCAATCAGCCCCAGCATTTT	CASSPEPPPDSNQPQHF	TRBV11-2	TRBJ1-5
TGTGCCATCATTTGCGGGACCTACGAGCAGTACTTC	CAIICGTYEQYF	TRBV11-2	TRBJ2-7
TGTGCCAGTAGTATATCCCAGAACATGGGGCCTGCTGAGCAGTACTTC	CASSISQNMGPAEQYF	TRBV19	TRBJ2-7
TGCGCCAGCACGGGACAGGGAGGCGAGCAGTACTTC	CASTGQGGEQYF	TRBV10-2	TRBJ2-7
TGCGCCAATTCACAGCCAGGGACCCAGTACTTC	CANSQPGTQYF	TRBV5-1	TRBJ2-5
TGTGCCAGCAGCCACCCCCAGACTAGCGGGAGGGCCCCCTACAATGAGCAGTTCTTC	CASSHPQTSGRAPYNEQFF	TRBV14	TRBJ2-1
TGTGCCAGCGATGTAAACGATGGGGATGGCTCCTACGAGCAGTACTTC	CASDVNDGDGSYEQYF	TRBV6-3	TRBJ2-7
TGTGCCAGCAGTCGGATAGCATATGAGCAGTTCTTC	CASSRIAYEQFF	TRBV14	TRBJ2-1
TGTGCCAGCAGCCAAGGTTTGCTAGAACCTCACAATGAGCAGTTCTTC	CASSQGLLEPHNEQFF	TRBV14	TRBJ2-1
TGTGCCAGCAGCCACCGGGACGGCCCGGGGTACGAGCAGTACTTC	CASSHRDGPGYEQYF	TRBV7-9	TRBJ2-7
TGTGCCAGCTCACCACCACAGGGGGCGGGGGCCTACGAGCAGTACTTC	CASSPPQGAGAYEQYF	TRBV18	TRBJ2-7
TGTGCCTGGAGTGTCGGCCTCCACAAAACGGGACTCACCGGGGAGCTGTTTTTT	CAWSVGLHKTGLTGELFF	TRBV30	TRBJ2-2
TGCAGCGTCCTCGGGGGATCAGATACGCAGTATTTT	CSVLGGSDTQYF	TRBV29-1	TRBJ2-3
TGTGCCAGCAGTGACGCTGGACAGGGGCGGAATGAAAAACTGTTTTTT	CASSDAGQGRNEKLFF	TRBV6-4	TRBJ1-4
TGTGCCAGCAGCTTGGAAGACGGAAGCAATCAGCCCCAGCATTTT	CASSLEDGSNQPQHF	TRBV7-9	TRBJ1-5
TGCAGTGCTAGAGGAGGCCGGACAGAAAACACTGAAGCTTTCTTT	CSARGGRTENTEAFF	TRBV20-1	TRBJ1-1
TGCGCCAGCAGCCAAGCACAGGCCGGATTTCTTAACTATGGCTACACCTTC	CASSQAQAGFLNYGYTF	TRBV4-1	TRBJ1-2
TGTGTTGTCCTCGATCCTGGGGGAAACACCATATATTTT	CVVLDPGGNTIYF	TRBV11-3	TRBJ1-3
TGTGCCAGCAGCAACTATCAGACCTACGAGCAGTACTTC	CASSNYQTYEQYF	TRBV7-3	TRBJ2-7
TGTGCCAGCAGAGCTAGCGGGATAAACAATGAGCAGTTCTTC	CASRASGINNEQFF	TRBV9	TRBJ2-1
TGTGCCACACAGGGAAAGGCCGGAGGAAGGAAAAACATTCAGTACTTC	CATQGKAGGRKNIQYF	TRBV27	TRBJ2-4
TGTGCCAGCAGCGTAGCCTTTCCCCCCAGGAGCAGTGATTATGGCTACACCTTC	CASSVAFPPRSSDYGYTF	TRBV9	TRBJ1-2
TGTGCCAGCAGCGTCTCAGGGACGGCCTCCTACGAGCAGTACTTC	CASSVSGTASYEQYF	TRBV9	TRBJ2-7
TGTGCCCTTAGGGACAGACATAGGTTCCATGGCTACACCTTC	CALRDRHRFHGYTF	TRBV5-4	TRBJ1-2
TGTGCCAGCAGGCCGGGAACTTTGCGCAATTCACCCCTCCACTTT	CASRPGTLRNSPLHF	TRBV6-3	TRBJ1-6
TGCAGTGCTAGGGGCAAAAATTGTGGCTACACCTTC	CSARGKNCGYTF	TRBV20-1	TRBJ1-2
TGTGCCAGCAGCGATGCCGGACTAGCAGGACGTGAGCAGTTCTTC	CASSDAGLAGREQFF	TRBV11-2	TRBJ2-1
TGTGCCAGCAGTGACTCGGGCCCCCTTGGACAGGGTTCTACTGAAGCTTTCTTT	CASSDSGPLGQGSTEAFF	TRBV6-4	TRBJ1-1
TGTGCCAGCAGTTTAGGAGGGTTCTCCTACGAGCAGTACTTC	CASSLGGFSYEQYF	TRBV28	TRBJ2-7
TGTGCCGTCGGGGCGAAAAAGGGCAATCAGCCCCAGCATTTT	CAVGAKKGNQPQHF	TRBV19	TRBJ1-5
TGTGCCAGCAGCTCAGCCGAGGTTGCTTTCTTT	CASSSAEVAFF	TRBV7-9	TRBJ1-1
TGTGCCAGCAGTCATATCGCCGGCCCGGAAGATACGCAGTATTTT	CASSHIAGPEDTQYF	TRBV9	TRBJ2-3
TGCGCCAGCAGTATTGTTTCTGGGGAACGGCGTGAAGAGACCCAGTACTTC	CASSIVSGERREETQYF	TRBV5-1	TRBJ2-5
TGTGCCAGCACCTGGGGGGAGGTTGAAAAACTGTTTTTT	CASTWGEVEKLFF	TRBV27	TRBJ1-4
TGTGCCAGCAGTTACGCTGGACAGGGTGAAAAACTGTTTTTT	CASSYAGQGEKLFF	TRBV6-2	TRBJ1-4
TGTGCCAGCAGGGGCCCTTGCAATGAGCAGTTCTTC	CASRGPCNEQFF	TRBV2	TRBJ2-1
TGTGCCAGCAGCCAGGATGGCTACACCTTC	CASSQDGYTF	TRBV6-5	TRBJ1-2
TGTGCTAGTGGTTTGAGTCTGGAGGAGATAGATACGCAGTATTTT	CASGLSLEEIDTQYF	TRBV12-5	TRBJ2-3
TGCAGTGCTAGAGAACCCAAGGGTAGTAACTTACCCCCGGGTCTTAACACTGAAGCTTTCTTT	CSAREPKGSNLPPGLNTEAFF	TRBV20-1	TRBJ1-1
TGCAGTGCCCGGCACTATGGCTACACCTTC	CSARHYGYTF	TRBV20-1	TRBJ1-2
TGCGCCAGCAGCGCTTCTAGCGGGATTTCCGAGACCCAGTACTTC	CASSASSGISETQYF	TRBV5-1	TRBJ2-5
TGCGCCAGCAGCTTGGAACCCGGGACACTGGAGTACGAGCAGTACTTC	CASSLEPGTLEYEQYF	TRBV5-1	TRBJ2-7
TGTGCCAGCAGCTTACCGGGGATTGGGGTGCGACTAACTAACTATGGCTACACCTTC	CASSLPGIGVRLTNYGYTF	TRBV7-9	TRBJ1-2
TGTGCCAGCAGCGTTGCCTACCCTCCCGACGAAGCTTTCTTT	CASSVAYPPDEAFF	TRBV7-9	TRBJ1-1
TGTGCCAGCAGTTACAGGCACACTTCTGGAAACACCATATATTTT	CASSYRHTSGNTIYF	TRBV6-6	TRBJ1-3
TGTGCCAGCAGCCTTGGGACTCAGCCCCAGCATTTT	CASSLGTQPQHF	TRBV7-3	TRBJ1-5
TGTGCTAGTGGTTTGGTGTCCTCCCCGCCGGGACAGGGGGGAAATCAGCCCCAGCATTTT	CASGLVSSPPGQGGNQPQHF	TRBV12-5	TRBJ1-5
TGCGCCAGCAGCTACGGGCAGGGGACCTACGAGCAGTACTTC	CASSYGQGTYEQYF	TRBV5-1	TRBJ2-7
TGTGCCAGCACACTTGAGTGCTATGTAGGCAATCAGCCCCAGCATTTT	CASTLECYVGNQPQHF	TRBV9	TRBJ1-5
TGTGCCTGGAGTGTAGGGCCGAAACGGTTTTGCAATCAGCCCCAGCATTTT	CAWSVGPKRFCNQPQHF	TRBV30	TRBJ1-5
TGTGCCAGCAGTTTCGGGGGGCAGGATTCTTCTTCTGAGCAGTTCTTC	CASSFGGQDSSSEQFF	TRBV27	TRBJ2-1
TGTGCCAGCAGTTACTCGACCGAACGGCTCCACCCAACAGCCGTGTCCTCCTACAATGAGCAGTTCTTC	CASSYSTERLHPTAVSSYNEQFF	TRBV6-5	TRBJ2-1
TGTGCCAGCAGCAAAAAAACCCGAGCGGGGAGCAATCAGCCCCAGCATTTT	CASSKKTRAGSNQPQHF	TRBV7-3	TRBJ1-5
TGTGCCACCGGGACGCAGTATTTT	CATGTQYF	TRBV24-1	TRBJ2-3
TGTGCCAGCAGCGGACAGGGGGCAGTGGCCAATGAGCAGTTCTTC	CASSGQGAVANEQFF	TRBV13	TRBJ2-1
TGTGCTAGTGGTTTGCCGACTAGCGGGGGGGAGCAGTTCTTC	CASGLPTSGGEQFF	TRBV12-5	TRBJ2-1
TGTGCCTGGAGTATCGGACCGTATAATTCACCCCTCCACTTT	CAWSIGPYNSPLHF	TRBV30	TRBJ1-6
TGTGCCAGCAGTGACCTCTCAACCCTCCTATTCAGCTCCTACGAGCAGTACTTC	CASSDLSTLLFSSYEQYF	TRBV6-4	TRBJ2-7
TGTGCCAGCAGCCAAAGCCGGGACAGAGATCAGCCCCAGCATTTT	CASSQSRDRDQPQHF	TRBV3-1	TRBJ1-5
TGTGCCAGCCCCCACCGGGACAGGGCTTCACCCCTCCACTTT	CASPHRDRASPLHF	TRBV27	TRBJ1-6
TGTGCCAGCACCCTGACTAGGGGGAGCTCCTACAATGAGCAGTTCTTC	CASTLTRGSSYNEQFF	TRBV6-2	TRBJ2-1
TGTGCCAGCAGCGCCACATGCGGGAGCTACGAGCAGTACTTC	CASSATCGSYEQYF	TRBV13	TRBJ2-7
TGCGCCAGCAGGTCGCCGGGGTTCCTTTACGAGCAGTACTTC	CASRSPGFLYEQYF	TRBV10-1	TRBJ2-7
TGTGCCAGCAGCACTGGGGGTACATTTGAAAAACTGTTTTTT	CASSTGGTFEKLFF	TRBV7-4	TRBJ1-4
TGTGCCAGCATACAGGGGACGGCCCGACATCAGCCCCAGCATTTT	CASIQGTARHQPQHF	TRBV6-4	TRBJ1-5
TGCAGTGCTCCGGTTATAGCGGGTTCCTACAATGAGCAGTTCTTC	CSAPVIAGSYNEQFF	TRBV20-1	TRBJ2-1
TGTGCCAGCAGTTTAGTTCCAACAGTGGACAGGGTGTATTGGGAAAAACTGTTTTTT	CASSLVPTVDRVYWEKLFF	TRBV12-4	TRBJ1-4
TGTGCCAGCAGCGGTGAATTTACGCTTACCTACAATGAGCAGTTCTTC	CASSGEFTLTYNEQFF	TRBV13	TRBJ2-1
TGTGCCAGACAGAGGGCCAATCAGCCCCAGCATTTT	CARQRANQPQHF	TRBV9	TRBJ1-5
TGTGCCAGCAGCCCGGGACAGGGTCAATACTATGGCTACACCTTC	CASSPGQGQYYGYTF	TRBV7-9	TRBJ1-2
TGTGCCAGCAGCCCAAAGGATATCTACGAGCAGTACTTC	CASSPKDIYEQYF	TRBV6-5	TRBJ2-7
TGTGCCAGCAGCCCGCGCATTCGACTTTTTCGGGAAAAACTGTTTTTT	CASSPRIRLFREKLFF	TRBV3-1	TRBJ1-4
TGCGCCAGCAGCTTGGCCCCCGCGGACATCAATCAGCCCCAGCATTTT	CASSLAPADINQPQHF	TRBV5-1	TRBJ1-5
TGTGCCAGCAGTGAACTCCGAGACTACGAGCAGTACTTC	CASSELRDYEQYF	TRBV6-1	TRBJ2-7
TGTGCCTGGAGTGGAGTTGTTTCATGGATCGAGACAAACGTGGCCAAAAACATTCAGTACTTC	CAWSGVVSWIETNVAKNIQYF	TRBV30	TRBJ2-4
TGCAGTGCTCCAGGACTAGAGAGGAGGACCTACGAGCAGTACTTC	CSAPGLERRTYEQYF	TRBV20-1	TRBJ2-7
TGTGCCAGCAGCTTCGGTGCGGTTCTTACAGGGGCCGGGGACTATGGCTACACCTTC	CASSFGAVLTGAGDYGYTF	TRBV5-8	TRBJ1-2
TGTGCCAGCGGGGGAATGGATAGCAATCAGCCCCAGCATTTT	CASGGMDSNQPQHF	TRBV7-3	TRBJ1-5
TGTGCCAGCAGCGGGGGGCTTACCAGCTCCTATAATTCACCCCTCCACTTT	CASSGGLTSSYNSPLHF	TRBV9	TRBJ1-6
TGTGCCTGGAGTCTACGGACTAGAGACAGCTCCTACAATGAGCAGTTCTTC	CAWSLRTRDSSYNEQFF	TRBV30	TRBJ2-1
TGTGCTAGTGCAACGGGACAGGGTTCCGAGAGTCAGCCCCAGCATTTT	CASATGQGSESQPQHF	TRBV12-5	TRBJ1-5
TGTGCCAGCAGACGGCAGCCGGATAGGCTCTACAATGAGCAGTTCTTC	CASRRQPDRLYNEQFF	TRBV6-6	TRBJ2-1
TGTGCCAGCAGCGGAACAGGGGGCCCCGGCTACAATGAGCAGTTCTTC	CASSGTGGPGYNEQFF	TRBV7-3	TRBJ2-1
TGTGCCAGCAGCGCGGACTCCAGGGCCTACGAGCAGTACTTC	CASSADSRAYEQYF	TRBV6-8	TRBJ2-7
TGCAGTGCTAGAGTTTCTACTAGCGGAACAGATACGCAGTATTTT	CSARVSTSGTDTQYF	TRBV20-1	TRBJ2-3
TGTGCCAGCAGCCAAGATAGCGGGGCCACAGCAAGCTATGGCTACACCTTC	CASSQDSGATASYGYTF	TRBV3-1	TRBJ1-2
TGTGCCAGCAGCTATCCCAGCTACGAGCAGTACTTC	CASSYPSYEQYF	TRBV11-2	TRBJ2-7
TGTGCCTTCCCAGGGATGACTGAAGCTTTCTTT	CAFPGMTEAFF	TRBV19	TRBJ1-1
TGTGCCAGCATTGGACGTATCAATGAGCAGTTCTTC	CASIGRINEQFF	TRBV9	TRBJ2-1
TGTGCCAGCCCCATAGGGACAGGGGTATCCGGGTGCAATCAGCCCCAGCATTTT	CASPIGTGVSGCNQPQHF	TRBV19	TRBJ1-5
TGTGCCATCATGCCTACCTCTATCGAGGGGGATCCACCCCTCCACTTT	CAIMPTSIEGDPPLHF	TRBV10-3	TRBJ1-6
TGTGCCAGCAGCTTGGCGATCCAGTTCTACGAGCAGTACTTC	CASSLAIQFYEQYF	TRBV5-4	TRBJ2-7
TGTGCCACCAGTGGGGAGGGGGATGAAGCTTTCTTT	CATSGEGDEAFF	TRBV24-1	TRBJ1-1
TGCAGTGCTCGGGCGACTGGATCAGAGACCCAGTACTTC	CSARATGSETQYF	TRBV20-1	TRBJ2-5
TGCAGCGTTGTTACTAGCGGGAGGGAGGTTCAGCCCCAGCATTTT	CSVVTSGREVQPQHF	TRBV29-1	TRBJ1-5
TGTGCCAGCAGCGTAGGCGACAGGGTTAGGAGGGACACTGAAGCTTTCTTT	CASSVGDRVRRDTEAFF	TRBV9	TRBJ1-1
TGTGCCAGCAGCCAAGCTCGGCAACAGGCACAAGAGACCCAGTACTTC	CASSQARQQAQETQYF	TRBV14	TRBJ2-5
TGTGCCTTCATACAGGGGAGCCCCCGTAATTCACCCCTCCACTTT	CAFIQGSPRNSPLHF	TRBV30	TRBJ1-6
TGTGCCAGCGAACAGGGGGGTGAAAAACTGTTTTTT	CASEQGGEKLFF	TRBV11-3	TRBJ1-4
TGTGCCACCAGTGATGATCCCGGGACAGGGGACACCGGGGAGCTGTTTTTT	CATSDDPGTGDTGELFF	TRBV24-1	TRBJ2-2
TGTGCCAGCAGTGGCCGGGACACCGGAAATCAGCCCCAGCATTTT	CASSGRDTGNQPQHF	TRBV11-3	TRBJ1-5
TGTGCCAGCAGCGAGGACAGGGGTGAGAAGGACACAGATACGCAGTATTTT	CASSEDRGEKDTDTQYF	TRBV9	TRBJ2-3
TGCGCCAGCAGTGAGCCGGAGGGCCAGTACTTC	CASSEPEGQYF	TRBV10-1	TRBJ2-5
TGCGCCAGCAGCCAAGATGAGGGAAAACAGGGCCCGCAGCCCCAGCATTTT	CASSQDEGKQGPQPQHF	TRBV4-1	TRBJ1-5
TGCAGTGCTAGAGATGGGGGGGAGAACCCTGACTACGAGCAGTACTTC	CSARDGGENPDYEQYF	TRBV20-1	TRBJ2-7
TGCGCCAGCAGTGCCACAGGGGACGGTGATACGCAGTATTTT	CASSATGDGDTQYF	TRBV10-1	TRBJ2-3
TGTGCCAGCTCTCAGGGGACAGGGTTGAAAGGAGCTATCACGAGCTCCTACGAGCAGTACTTC	CASSQGTGLKGAITSSYEQYF	TRBV9	TRBJ2-7
TGCGCCAGCAGCCGGGGGGGGGGGCGAAAGGATACGCAGTATTTT	CASSRGGGRKDTQYF	TRBV5-1	TRBJ2-3
TGTGCCAGTAGTCACCTCGGATTACTAGCGGGAGGGGCCTCCTACAATGAGCAGTTCTTC	CASSHLGLLAGGASYNEQFF	TRBV19	TRBJ2-1
TGTGCCAGCAGGCCCAGGTCGGTCTATGAAAAACTGTTTTTT	CASRPRSVYEKLFF	TRBV6-5	TRBJ1-4
TGCGCCAGCACCCCGGTTTTGAGGGCAATGCCCCAGCATTTT	CASTPVLRAMPQHF	TRBV10-1	TRBJ1-5
TGTGCCAGCAGTGACCACCGCTCGCGGGAGACTGTCGCCTACGAGCAGTACTTC	CASSDHRSRETVAYEQYF	TRBV6-4	TRBJ2-7
TGCAGCGGCCCCTTCGGGACAGTGGCCTATAATTCACCCCTCCACTTT	CSGPFGTVAYNSPLHF	TRBV29-1	TRBJ1-6
TGTGCCAGCAGTACCGAGCTTACGGGGGACAGCGACTCTGGAAACACCATATATTTT	CASSTELTGDSDSGNTIYF	TRBV6-4	TRBJ1-3
TGTGCCAGCAGTTTCAGCGTGCGAAACTATGGCTACACCTTC	CASSFSVRNYGYTF	TRBV27	TRBJ1-2
TGCGCCAGCAACTTAGCGGGCTTC	CASNLAGF	TRBV10-2	TRBJ2-5
TGTGCCAGCATAAGTCACCGGGGGGTAGCCAATGAGCAGTTCTTC	CASISHRGVANEQFF	TRBV6-6	TRBJ2-1
TGCGCCAGCAGTAAATGCGGCCGAAGGGCTTTCTTT	CASSKCGRRAFF	TRBV10-1	TRBJ1-1
TGTGCCAGCATTCAGCGGGAGGACCACTATGGCTACACCTTC	CASIQREDHYGYTF	TRBV28	TRBJ1-2
TGTGCCAGCAGCCAAAGGCAGGGACCAGAGACCCAGTACTTC	CASSQRQGPETQYF	TRBV11-1	TRBJ2-5
TGCAGCGTGGGTGTCGGGGTCTCTGGAAACACCATATATTTT	CSVGVGVSGNTIYF	TRBV29-1	TRBJ1-3
TGTGCCAGCAGTAATAGGTTTCCCACTTACAATCAGCCCCAGCATTTT	CASSNRFPTYNQPQHF	TRBV2	TRBJ1-5
TGTGCCAGCAGCGTTGGGGTAGGAGAGCAGTACTTC	CASSVGVGEQYF	TRBV7-3	TRBJ2-7
TGCAGCCTACAGGGGGCGGGCGATACGCAGTATTTT	CSLQGAGDTQYF	TRBV29-1	TRBJ2-3
TGTGCCAGCAGCGGGGGGAAGGGGAGTCGTTCCTACGAGCAGTACTTC	CASSGGKGSRSYEQYF	TRBV13	TRBJ2-7
TGTGCCAGCAGTGACTACAGGTTCCCTAACTTCTACGAGCAGTACTTC	CASSDYRFPNFYEQYF	TRBV6-4	TRBJ2-7
TGCGCCAGCAACAGGGGGGGAGAGAACACTGAAGCTTTCTTT	CASNRGGENTEAFF	TRBV5-1	TRBJ1-1
TGCGCCAGCAGCTTGGAAGATCAGTCGGACAATGAAAAACTGTTTTTT	CASSLEDQSDNEKLFF	TRBV5-1	TRBJ1-4
TGTGCCAGCAGCAGGGGGCGTAGGCCCCAGCATTTT	CASSRGRRPQHF	TRBV7-9	TRBJ1-5
TGTGCCAGCAGCCAAGATTTCGGGGTGTTCAATCAGCCCCAGCATTTT	CASSQDFGVFNQPQHF	TRBV14	TRBJ1-5
TGTGCCAGCAGCGTAGGACCAGCTAACTATGGCTACACCTTC	CASSVGPANYGYTF	TRBV9	TRBJ1-2
TGTGCCAGCAGCCCACTCCGGGACAATAGAAATGAGCAGTTCTTC	CASSPLRDNRNEQFF	TRBV7-6	TRBJ2-1
TGTGCCAGCAGCTTGCCGGGGGGGGAAGAGACCCAGTACTTC	CASSLPGGEETQYF	TRBV11-2	TRBJ2-5
TGTGCCAGCAGTCCCCCCGGCGGGAGCCCGGAAGTAAACATTCAGTACTTC	CASSPPGGSPEVNIQYF	TRBV6-2	TRBJ2-4
TGTGCCAGCAGCTTAACTGGGGTGGGATACGAGCAGTACTTC	CASSLTGVGYEQYF	TRBV7-8	TRBJ2-7
TGTGCCAGCAGCTGGCCCCGGGACAGCCATAGACCGTCTGGAAACACCATATATTTT	CASSWPRDSHRPSGNTIYF	TRBV5-6	TRBJ1-3
TGTGCCAGCAGCCCAACCGGGACAGGGAGGTGTTTCGTCTCCTACGAGCAGTACTTC	CASSPTGTGRCFVSYEQYF	TRBV7-4	TRBJ2-7
TGCAGTGCTAGAGTGGACGCACCTGCTGAAGCTTTCTTT	CSARVDAPAEAFF	TRBV20-1	TRBJ1-1
TGTGCCAGCAGTGTTGGGACAGGGGGCCCCAACTATGGCTACACCTTC	CASSVGTGGPNYGYTF	TRBV6-4	TRBJ1-2
TGCGCCAGCATCCATGGAAGCAATCAGCCCCAGCATTTT	CASIHGSNQPQHF	TRBV10-1	TRBJ1-5
TGTGCCAGCAGCGATCTGGATACAGGGGCTCGGCTAGGCAATCAGCCCCAGCATTTT	CASSDLDTGARLGNQPQHF	TRBV9	TRBJ1-5
TGCGCCAGCAGCTCCCTTTACGGGGCGGACGAGCAGTACTTC	CASSSLYGADEQYF	TRBV5-1	TRBJ2-7
TGTGCCAGCAGTTCCCCCGGGACTAGGGGCGAAAGCTCCTACAATGAGCAGTTCTTC	CASSSPGTRGESSYNEQFF	TRBV9	TRBJ2-1
TGTGCCATATCGAGGATAGGCACAGATACGCAGTATTTT	CAISRIGTDTQYF	TRBV6-1	TRBJ2-3
TGCGCCAGCAGTGACCCGGGGGGGGCGAACACCGGGGAGCTGTTTTTT	CASSDPGGANTGELFF	TRBV10-1	TRBJ2-2
TGCGCCAGCAGCTTACCATGGGACGGGACTCCTGTGGAGACCCAGTACTTC	CASSLPWDGTPVETQYF	TRBV5-1	TRBJ2-5
TGTGCCAGCAGCTCGAGGGAAGTGACCATATATTTT	CASSSREVTIYF	TRBV5-5	TRBJ1-3
TGCGCCAGCAGTGATCGAAGTAAGACACCGGGTCAGCCCCAGCATTTT	CASSDRSKTPGQPQHF	TRBV10-1	TRBJ1-5
TGTGCCACCGTCAGCCGGGACAGGGCCGCAACCTACGAGCAGTACTTC	CATVSRDRAATYEQYF	TRBV24-1	TRBJ2-7
TGCGCCAGCAGCTTGGGGGCCACTGGCACAGATACGCAGTATTTT	CASSLGATGTDTQYF	TRBV4-3	TRBJ2-3
TGTGCCAGTGGGAGCGGATCTGAGCAGTTCTTC	CASGSGSEQFF	TRBV6-1	TRBJ2-1
TGCGCCAGCAGCTTTGTGCCCCCCGGGACAGGGGGCGATACGCAGTATTTT	CASSFVPPGTGGDTQYF	TRBV5-1	TRBJ2-3
TGCAGTGCTGAAGATGCTAAAGCTTTCTTT	CSAEDAKAFF	TRBV20-1	TRBJ1-1
TGTGCCAGCAGCCATGACAGGCCGGGACAGGTGGGCTACGAGCAGTACTTC	CASSHDRPGQVGYEQYF	TRBV13	TRBJ2-7
TGTGCCAGCAGCAATCGAATATGGTCTGGGGCCAACGTCCTGACTTTC	CASSNRIWSGANVLTF	TRBV28	TRBJ2-6
TGTGCCAGCAGCCAAGATCCGGCAAACCGCGCCAGGGGGAAACTGTACTTC	CASSQDPANRARGKLYF	TRBV14	TRBJ2-7
TGTGCCAGCAGTAAGGGGACAGGGCTCTATGGCTACACCTTC	CASSKGTGLYGYTF	TRBV9	TRBJ1-2
TGCAGTGCTAAACCGACAGGGTCGAAGAATGAAAAACTGTTTTTT	CSAKPTGSKNEKLFF	TRBV20-1	TRBJ1-4
TGTGCCAGCAGCCACAGTAGTCTAGCGGGGCCCACACTCTACGAGCAGTACTTC	CASSHSSLAGPTLYEQYF	TRBV14	TRBJ2-7
TGTGCCAGCAGTCCCGCCCAGCAGACAGCGTGTATCGGGGAGCTGTTTTTT	CASSPAQQTACIGELFF	TRBV6-5	TRBJ2-2
TGTGCCAGCTCATCATGGGGGGGCGAGAAGATCAGCACAGATACGCAGTATTTT	CASSSWGGEKISTDTQYF	TRBV18	TRBJ2-3
TGTGCCACCAGCCGGGGTCGAGGGGGCTTGAGCAATGAGCAGTTCTTC	CATSRGRGGLSNEQFF	TRBV15	TRBJ2-1
TGTGCCAGCATACAGGGGGTCTGTCATGGCTACACCTTC	CASIQGVCHGYTF	TRBV25-1	TRBJ1-2
TGTGCCAGCAGCCCCCCCCGCTCCGGGACAGGGGTTGCAAACACAGATACGCAGTATTTT	CASSPPRSGTGVANTDTQYF	TRBV13	TRBJ2-3
TGCGCCAGCAGCGACATTAGACATTCCGAGGAAAGGAGGGCTCACCTCGGCTACGAGCAGTACTTC	CASSDIRHSEERRAHLGYEQYF	TRBV5-1	TRBJ2-7
TGTGCCAGCAGCTTGATATCTAGCGCCTACGAGCAGTACTTC	CASSLISSAYEQYF	TRBV5-4	TRBJ2-7
TGTGCCAGCAGCTTATACGGGACAGAGCTAAATGAGCAGTTCTTC	CASSLYGTELNEQFF	TRBV7-2	TRBJ2-1
TGTGCCAGCAACGGCGTTTACACTGAAGCTTTCTTT	CASNGVYTEAFF	TRBV2	TRBJ1-1
TGTGCCAGCAGCCAAGACCTTGGGTCGCCCAGGGGAAACACCATATATTTT	CASSQDLGSPRGNTIYF	TRBV3-1	TRBJ1-3
TGTGCCAGCGGGACGGACCTGACCCAGTACTTC	CASGTDLTQYF	TRBV12-3	TRBJ2-5
TGTGCCAGCAGTTACTCGAGAAGACAGCTGTTAGCTAACTATGGCTACACCTTC	CASSYSRRQLLANYGYTF	TRBV6-5	TRBJ1-2
TGTGCCAGCAGCCTTCCCCTTAATGCCACGGCACCCCTCCACTTT	CASSLPLNATAPLHF	TRBV7-8	TRBJ1-6
TGCGCCAGCAGCTTGGACTGGGACAGTAGGGACACTGAAGCTTTCTTT	CASSLDWDSRDTEAFF	TRBV5-1	TRBJ1-1
TGTGCCAGCAGACATACAGGGGAAGAGACCCAGTACTTC	CASRHTGEETQYF	TRBV6-1	TRBJ2-5
TGTGCCAGCAGCGGGGGGACGGGTTGCAATCAGCCCCAGCATTTT	CASSGGTGCNQPQHF	TRBV7-3	TRBJ1-5
TGTGCCAGCTCACCACCCGTGGAGGGAGTTTGGCAGCCCCAGCATTTT	CASSPPVEGVWQPQHF	TRBV18	TRBJ1-5
TGTGCCAGCAGCTACGGGACAGGGGTACGTTTTTCCACCGGGGAGCTGTTTTTT	CASSYGTGVRFSTGELFF	TRBV6-4	TRBJ2-2
TGCAGTGCTCAATACCTCGGGGCGGGAGCCTACGAGCAGTACTTC	CSAQYLGAGAYEQYF	TRBV20-1	TRBJ2-7
TGTGCCAGCAGCCCCTCTAGCGAACGGAACACCGGGGAGCTGTTTTTT	CASSPSSERNTGELFF	TRBV7-3	TRBJ2-2
TGTGCCAGTACTAGCGGGATCCCGTTCGGTTGCACAGATACGCAGTATTTT	CASTSGIPFGCTDTQYF	TRBV19	TRBJ2-3
TGCAGTGCTCAATATGGGAGGTGCTCCTACAATGAGCAGTTCTTC	CSAQYGRCSYNEQFF	TRBV20-1	TRBJ2-1
TGTGCCTGGAAAGGGACAGAGACCCAAGAGACCCAGTACTTC	CAWKGTETQETQYF	TRBV30	TRBJ2-5
TGTGCCAGCACCACAGAGAGGGAGCCCCAGCATTTT	CASTTEREPQHF	TRBV6-1	TRBJ1-5
TGTGCCAGCAGTTTGACCAGGGGGGGCTACGAGCAGTACTTC	CASSLTRGGYEQYF	TRBV6-6	TRBJ2-7
TGTGCCAGCAGGCTAGACAGGGTCTACGAGCAGTACTTC	CASRLDRVYEQYF	TRBV11-2	TRBJ2-7
TGCGCCAGTCAGGGGGCGCATGAGCAGTTCTTC	CASQGAHEQFF	TRBV4-1	TRBJ2-1
TGTGCCAGCAGCGGGGGCGATCAGCCCCAGCATTTT	CASSGGDQPQHF	TRBV13	TRBJ1-5
TGCAGTGCTTGCCCCGGGACAGGGAAGGGCTACGAGCAGTACTTC	CSACPGTGKGYEQYF	TRBV20-1	TRBJ2-7
TGTGCCAGTAGTATAGGAATAAACAGGGAAGCTTTCTTT	CASSIGINREAFF	TRBV19	TRBJ1-1
TGTGCCAGCAGCTGGGCAAGGGGCATGTACGAGCAGTACTTC	CASSWARGMYEQYF	TRBV6-2	TRBJ2-7
TGTGCCAGCTCACCACCGCCCAGGGGACACGAGCAGTACTTC	CASSPPPRGHEQYF	TRBV18	TRBJ2-7
TGTGCCAGCAGCCAAGAAGAGCCGCAGGGACCCTTGCAGTATTTT	CASSQEEPQGPLQYF	TRBV3-1	TRBJ2-3
TGCAGTGCAGAGAGGGGATTCCAGCTGAACACCGGGGAGCTGTTTTTT	CSAERGFQLNTGELFF	TRBV20-1	TRBJ2-2
TGCACGATACCGCGGGAGTTTAGAAGCTCCTACGAGCAGTACTTC	CTIPREFRSSYEQYF	TRBV20-1	TRBJ2-7
TGCCTGACAGGGGGCGCGTTCTCGGAGGAGCAGTACTTC	CLTGGAFSEEQYF	TRBV10-1	TRBJ2-7
TGTGCCAGCAGCATCTCCCCGGGACTAGCGGGAGAGCGGATTTCTCTTGAGACCCAGTACTTC	CASSISPGLAGERISLETQYF	TRBV9	TRBJ2-5
TGCAGTGCTAAGTTTGCCAGGGGAAACACTGAAGCTTTCTTT	CSAKFARGNTEAFF	TRBV20-1	TRBJ1-1
TGTGCCAGCAGCTTAATTGAGTCCACCAGGTACCCCCAAGAGACCCAGTACTTC	CASSLIESTRYPQETQYF	TRBV7-3	TRBJ2-5
TGTGCCAGCAGCCAAGCGGGCGAACCGCGTGAAGCTTTCTTT	CASSQAGEPREAFF	TRBV14	TRBJ1-1
TGCGCCAGCAGCTTGGGAATGGTCCAGGGTCGGATGAACACTGAAGCTTTCTTT	CASSLGMVQGRMNTEAFF	TRBV5-1	TRBJ1-1
TGTGCCAGCAGCTACTTATCGATTACGGGAGGAGTCGAGACCCAGTACTTC	CASSYLSITGGVETQYF	TRBV7-6	TRBJ2-5
TGTGCCAGTAGCAAGGGACAGGAACACGAGCAGTACTTC	CASSKGQEHEQYF	TRBV19	TRBJ2-7
TGTGCCATCTGTGGGGGGGGGAGCGAGATCAATGAGCAGTTCTTC	CAICGGGSEINEQFF	TRBV10-3	TRBJ2-1
TGTGCCAGCCAATTAACCGGGACAGGGGCTGAAGCTTTCTTT	CASQLTGTGAEAFF	TRBV25-1	TRBJ1-1
TGTGCCAGCTCACACCAGACAGGGACTGAAGCTTTCTTT	CASSHQTGTEAFF	TRBV18	TRBJ1-1
TGTGCCAGCAGCTCGGCGGAGGTTTATAGCGGCAATGAGCAGTTCTTC	CASSSAEVYSGNEQFF	TRBV9	TRBJ2-1
TGCGCCAGCAGAAGTGCCTCCAGGTCTAAAACTTATTCACCCCTCCACTTT	CASRSASRSKTYSPLHF	TRBV5-1	TRBJ1-6
TGTGCCAGCAGACCGGGACAGGGTAAGGGGGCTTTCTTT	CASRPGQGKGAFF	TRBV6-5	TRBJ1-1
TGTGCCACCAGTGGAAGCGCCTCTTTCGAAACCTACGAGCAGTACTTC	CATSGSASFETYEQYF	TRBV24-1	TRBJ2-7
TGCGCCAGCAGTATGAGTGATAGCAAGAACACTGAAGCTTTCTTT	CASSMSDSKNTEAFF	TRBV10-1	TRBJ1-1
TGTGCCGTGGACAGGGACTTTTCCTACGAGCAGTACTTC	CAVDRDFSYEQYF	TRBV25-1	TRBJ2-7
TGTGCCACCAGTGATTTGTTTAAGCCCCTCCCGGGACAGGCTCCCGGGGAGCTGTTTTTT	CATSDLFKPLPGQAPGELFF	TRBV24-1	TRBJ2-2
TGTGCCAGCAGTCCGGCTTATACCTACGAGCAGTACTTC	CASSPAYTYEQYF	TRBV27	TRBJ2-7
TGTGCCAGCAGTTTCAAAACAGGGGAGGGCACTGAAGCTTTCTTT	CASSFKTGEGTEAFF	TRBV28	TRBJ1-1
TGTGCTAGTGGTTTACGCGGGGGAGCGCAGTACTTC	CASGLRGGAQYF	TRBV12-5	TRBJ2-7
TGTGCCACCAGTGATTTCGGGGGCCACATCCGCTACGAGCAGTACTTC	CATSDFGGHIRYEQYF	TRBV24-1	TRBJ2-7
TGCAGTGCTAGATCCGGGACAGGGGGGCCTGAGACCCAGTACTTC	CSARSGTGGPETQYF	TRBV20-1	TRBJ2-5
TGTGCCAGCAGTTGGACGGACGCCGGAGGAACTTTCGGAACCGGGGAGCTGTTTTTT	CASSWTDAGGTFGTGELFF	TRBV27	TRBJ2-2
TGTGCCAGCAGCACGAATGCAACCGGGGAGCTGTTTTTT	CASSTNATGELFF	TRBV7-2	TRBJ2-2
TGTGCCAGCCCTACGGAGTTTCCCCTCCGGGAGACAGATACGCAGTATTTT	CASPTEFPLRETDTQYF	TRBV6-5	TRBJ2-3
TGTGCCAGCAGCCACACTAAAGGACAGAACACTGAAGCTTTCTTT	CASSHTKGQNTEAFF	TRBV7-4	TRBJ1-1
TGTGCCAGCAGCTTAGATCCCCTAGCGGCCACGGGGGATACGCAGTATTTT	CASSLDPLAATGDTQYF	TRBV7-2	TRBJ2-3
TGTGCCAGTAGTATCTCAAGGACCCCGATAGCTAACTATGGCTACACCTTC	CASSISRTPIANYGYTF	TRBV19	TRBJ1-2
TGTGCCAGCAGCTTAGATAGGTCCTCGAGCTCTGGGGCCAACGTCCTGACTTTC	CASSLDRSSSSGANVLTF	TRBV11-3	TRBJ2-6
TGTGCCAGCAGTGGGAATGTCCGAAGGGGGGGGGATGCGAACACCGGGGAGCTGTTTTTT	CASSGNVRRGGDANTGELFF	TRBV6-1	TRBJ2-2
TGTGCCAGCAGTTCAGCCGACGGGGTCTACGAGCAGTACTTC	CASSSADGVYEQYF	TRBV27	TRBJ2-7
TGTGCCAGCATGAAAGGCGGGGATGGCTACACCTTC	CASMKGGDGYTF	TRBV13	TRBJ1-2
TGCAGTGCTAGCCGAGCCGGCGCTTTCTACGAGCAGTACTTC	CSASRAGAFYEQYF	TRBV20-1	TRBJ2-7
TGTGCTAGTGGTTGTCTAGCGGGAACATTCCTCTGCAATGAGCAGTTCTTC	CASGCLAGTFLCNEQFF	TRBV12-5	TRBJ2-1
TGCGCCAGCAGCTTGACCCCCATTACGTGGTACGAGCAGTACTTC	CASSLTPITWYEQYF	TRBV4-3	TRBJ2-7
TGTGCCAGCAGCGTACCGGGCCGTAGCAATCAGCCCCAGCATTTT	CASSVPGRSNQPQHF	TRBV9	TRBJ1-5
TGTGCCCCGCCGGGACTAGCGGGAGGATACGGCAAGGACGAGCAGTACTTC	CAPPGLAGGYGKDEQYF	TRBV10-3	TRBJ2-7
TGTGCCAGCACAGACTATGGCTACACCTTC	CASTDYGYTF	TRBV2	TRBJ1-2
TGTGCCAGCAGTGAACAGGGGCGGGGCCGCGTTGGCAATGAAAAACTGTTTTTT	CASSEQGRGRVGNEKLFF	TRBV6-1	TRBJ1-4
TGTGCCAGCAGCCAAGAAGAACTAGCGGGAGGGGCCCATGGTCAGCCCCAGCATTTT	CASSQEELAGGAHGQPQHF	TRBV14	TRBJ1-5
TGTGCCAGCAGCAAAGGGGGGGGCCGGGTGGAGACCCAGTACTTC	CASSKGGGRVETQYF	TRBV5-6	TRBJ2-5
TGTGCCATCTTACCCGCGGGCTACACCTTC	CAILPAGYTF	TRBV25-1	TRBJ1-2
TGTGCCAGCAGAAGACTAGCGGGAAACGAGCAGTACTTC	CASRRLAGNEQYF	TRBV11-2	TRBJ2-7
TGCACAAACCAGGGCCCGACCTCCTACAATGAGCAGTTCTTC	CTNQGPTSYNEQFF	TRBV20-1	TRBJ2-1
TGTGCCAGCATACTAGAGGGGACAGGGGACGCTAATGAAAAACTGTTTTTT	CASILEGTGDANEKLFF	TRBV25-1	TRBJ1-4
TGTGCCACTAAATCTCGCACACCCTACGAGCAGTACTTC	CATKSRTPYEQYF	TRBV10-3	TRBJ2-7
TGTGCCAGCAGCCAAGAGAGTCAGGACAGAATCAACTATGGCTACACCTTC	CASSQESQDRINYGYTF	TRBV3-1	TRBJ1-2
TGTGCCAGCAGTGCAAGGTCGGGAAAAAAGCTCAGGGGCTCACCCCTCCACTTT	CASSARSGKKLRGSPLHF	TRBV27	TRBJ1-6
TGTGCCAGCAGTTTGTTTCCACAGGGGATGTACTTC	CASSLFPQGMYF	TRBV12-3	TRBJ2-5
TGTGCCAGCAGCCCAAACCTGACCGAGCAGTACTTC	CASSPNLTEQYF	TRBV11-3	TRBJ2-7
TGTGCCAGCATTTCGGGGGAGTACTTC	CASISGEYF	TRBV6-1	TRBJ2-7
TGTGCCACCCGGGGGGGCGACACAGATACGCAGTATTTT	CATRGGDTDTQYF	TRBV28	TRBJ2-3
TGTGCCACTGGCACAGGCACTGAAGCTTTCTTT	CATGTGTEAFF	TRBV24-1	TRBJ1-1
TGTGCCAGCTCACCGCCGCGGAGAGGCGAAAAACTGTTTTTT	CASSPPRRGEKLFF	TRBV18	TRBJ1-4
TGCGCCAGCAGCCGCCTCCCCGGGACTAGGGAGGGGGAGCTGTTTTTT	CASSRLPGTREGELFF	TRBV5-1	TRBJ2-2
TGTGCCACCAGACAGTGGGGGGGGGCGGGAAACACCATATATTTT	CATRQWGGAGNTIYF	TRBV24-1	TRBJ1-3
TGTGCCAGCACCACTCTGATCGACACCGGGGAGCTGTTTTTT	CASTTLIDTGELFF	TRBV9	TRBJ2-2
TGTGCCAGCAGCTTAGCCGGAGGGCCTGAGGACACTGAAGCTTTCTTT	CASSLAGGPEDTEAFF	TRBV7-2	TRBJ1-1
TGTGCCAATCCCGACAGAAATCAGAACACTGAAGCTTTCTTT	CANPDRNQNTEAFF	TRBV13	TRBJ1-1
TGTGCCAGCAGCTTGGGGACAACAGCCAATCAGCCCCAGCATTTT	CASSLGTTANQPQHF	TRBV5-8	TRBJ1-5
TGTGCCAGCATGGCCCCCGGAGATAGCAATCAGCCCCAGCATTTT	CASMAPGDSNQPQHF	TRBV7-3	TRBJ1-5
TGCGCCAGCAGCTTGGTAAAGGACACATACGAGCAGTACTTC	CASSLVKDTYEQYF	TRBV5-1	TRBJ2-7
TGTGGAAATTCCGGCGGTAGCAATCAGCCCCAGCATTTT	CGNSGGSNQPQHF	TRBV3-1	TRBJ1-5
TGCGCCAGCAGCGGTTCACAGAGAAAACTCTATGGCTACACCTTC	CASSGSQRKLYGYTF	TRBV5-1	TRBJ1-2
TGTGCCAGCAGCTTAGATCGGGTCAGAAAGAGGGAGACCCAGTACTTC	CASSLDRVRKRETQYF	TRBV11-2	TRBJ2-5
TGTGCCAGCGGGGGCATCTACGAGCAGTACTTC	CASGGIYEQYF	TRBV2	TRBJ2-7
TGTGCCAGCAGCCGTACTAGCCAGGAGGAAGAGAAAAAGTCCTACAATGAGCAGTTCTTC	CASSRTSQEEEKKSYNEQFF	TRBV7-8	TRBJ2-1
TGTGCCAGCAGCCAAGACACGGGGGGCAGCACAGATACGCAGTATTTT	CASSQDTGGSTDTQYF	TRBV14	TRBJ2-3
TGTGCCAGCAGCCTCCACAAGGGACTAGCGGGGTACGGCTACGAGCAGTACTTC	CASSLHKGLAGYGYEQYF	TRBV7-8	TRBJ2-7
TGCGCCAGCAGTAGGGGCACTAATGGCTACACCTTC	CASSRGTNGYTF	TRBV10-2	TRBJ1-2
TGCAGTGCTAGAGCCCTAGGGACCTCCTCCTATAATTCACCCCTCCACTTT	CSARALGTSSYNSPLHF	TRBV20-1	TRBJ1-6
TGTGCCAGCAGCTTAGGTGGGACTGAAAAACCCTACGAGCAGTACTTC	CASSLGGTEKPYEQYF	TRBV7-3	TRBJ2-7
