TGTGCCAGCAGCTCCCCCCCCGACTTTAATCAGCCCCAGCATTTT	CASSSPPDFNQPQHF	TRBV7-3	TRBJ1-5
TGTGCCAGCAGTGAAGCACGAACCCCCGCGGGAGGGGGGAATTCACCCCTCCACTTT	CASSEARTPAGGGNSPLHF	TRBV6-1	TRBJ1-6
TGTGCCAGCACCGACAGGGGATACAATGAGCAGTTCTTC	CASTDRGYNEQFF	TRBV7-9	TRBJ2-1
TGTGCCAGCAGTCAGCGGGGGGCCGCAGAGACCCAGTACTTC	CASSQRGAAETQYF	TRBV6-1	TRBJ2-5
TGTGCCACCAGTGATCCAGGGGACGAGAGCTCCTATAATTCACCCCTCCACTTT	CATSDPGDESSYNSPLHF	TRBV24-1	TRBJ1-6
TGTGCCAGCAGCTTCCGACAGGGCGGGTCCTCCTACGAGCAGTACTTC	CASSFRQGGSSYEQYF	TRBV11-2	TRBJ2-7
TGTGCCAGCAGTTTTACGGGTCCTGATAAGGGCTACGAGCAGTACTTC	CASSFTGPDKGYEQYF	TRBV27	TRBJ2-7
TGCACCTTCTACGAGGGGCCCCGCTACAATGAGCAGTTCTTC	CTFYEGPRYNEQFF	TRBV20-1	TRBJ2-1
TGTGCCAGCAGCGACAGGGAGACGAACACCGGGGAGCTGTTTTTT	CASSDRETNTGELFF	TRBV13	TRBJ2-2
TGTGCTAGTGGCGGACAGGGGGCAAGGAGGCAGTACTTC	CASGGQGARRQYF	TRBV12-5	TRBJ2-7
TGCGCCAGCAGTGGGGGCGGGAACACTGAAGCTTTCTTT	CASSGGGNTEAFF	TRBV10-1	TRBJ1-1
TGTGCCAGCAGCCGAAGACCTTCCTACGAGCAGTACTTC	CASSRRPSYEQYF	TRBV7-3	TRBJ2-7
TGTGCCAGCAGCTTGCTAAAGACAGGGGGCCGTCGGAGCAATCAGCCCCAGCATTTT	CASSLLKTGGRRSNQPQHF	TRBV5-6	TRBJ1-5
TGTGCCAGCAGCTTGGCCGAAGGTATTCTGTTCCCCGGGACAGCCGACTCTGGAAACACCATATATTTT	CASSLAEGILFPGTADSGNTIYF	TRBV5-6	TRBJ1-3
TGTGCCAGCAGCCCTGGGGCCCCTAGCGTGAACACTGAAGCTTTCTTT	CASSPGAPSVNTEAFF	TRBV7-2	TRBJ1-1
TGCGCCAGCAGGCGGGACGTCCGGGACCCTATGCAGGAGTCCTACGAGCAGTACTTC	CASRRDVRDPMQESYEQYF	TRBV5-1	TRBJ2-7
TGTGCCAGTAGGAATACAGGGGGAGAGAACACTGAAGCTTTCTTT	CASRNTGGENTEAFF	TRBV19	TRBJ1-1
TGCAGTGCTAGAGGGGACAGGGGGCGTCCTGAAGCTTTCTTT	CSARGDRGRPEAFF	TRBV20-1	TRBJ1-1
TGCGCCAGCAGCTTGAAAGGACAGGAGATTGATACGCAGTATTTT	CASSLKGQEIDTQYF	TRBV5-1	TRBJ2-3
TGTGCTAGTGGTTTTTGTATCCGGGACAGGTACACTGAAGCTTTCTTT	CASGFCIRDRYTEAFF	TRBV12-5	TRBJ1-1
TGTGCCAGCAGTGAGGGACAGGGAATGGGTTTCTACGAGCAGTACTTC	CASSEGQGMGFYEQYF	TRBV6-4	TRBJ2-7
TGCGCCACGGTGAGATTGCGGCGCGATGAAAAACTGTTTTTT	CATVRLRRDEKLFF	TRBV4-3	TRBJ1-4
TGTGCCAGCAGCCAAGCTAGGACCGGGACAGGGGACGGAGAAGAGACCCAGTACTTC	CASSQARTGTGDGEETQYF	TRBV14	TRBJ2-5
TGTGCCAGCAGTGCTCCCGGACAGGGGGCTTATGGCTACACCTTC	CASSAPGQGAYGYTF	TRBV6-6	TRBJ1-2
TGTGCCAGCAGTGAGGCCCGACTAGCGGGGACCTACGAGCAGTACTTC	CASSEARLAGTYEQYF	TRBV2	TRBJ2-7
TGTGCCAGCAGCTTCTTACCTGTTAATGAGCAGTTCTTC	CASSFLPVNEQFF	TRBV7-9	TRBJ2-1
TGTGCCAGTAGTAATCCCAGGACTAGCGGGGGGGCCTTAAAGAACAATGAGCAGTTCTTC	CASSNPRTSGGALKNNEQFF	TRBV19	TRBJ2-1
TGCAGCGGGCCGGGACAGGGGAACCCGGACTACGAGCAGTACTTC	CSGPGQGNPDYEQYF	TRBV29-1	TRBJ2-7
TGTGCCAGCAGCCAAGGACAGGGGGGAGCCTACGAGCAGTACTTC	CASSQGQGGAYEQYF	TRBV14	TRBJ2-7
TGTGCCAGCAGGGAAACCCCGGAGGGTTTTGAAGGACACACCGGGGAGCTGTTTTTT	CASRETPEGFEGHTGELFF	TRBV27	TRBJ2-2
TGTGCCAGCAGTGACAAAGGGGGCTCCACCACAGATACGCAGTATTTT	CASSDKGGSTTDTQYF	TRBV6-4	TRBJ2-3
TGCGCCAGCAGCCAAGCCGAAAGGGGGGTGGGACGGAACTATGGCTACACCTTC	CASSQAERGVGRNYGYTF	TRBV4-1	TRBJ1-2
TGCAGCGTTGAAGGAGACAGGGGACCAGGGATGGGAGATGAGCAGTTCTTC	CSVEGDRGPGMGDEQFF	TRBV29-1	TRBJ2-1
TGTGCCAGCAGTCGGGGACAGCAGTACTTC	CASSRGQQYF	TRBV6-5	TRBJ2-7
TGTGCCACCAGCATTAGGGGGGGGCTGTTTTTT	CATSIRGGLFF	TRBV15	TRBJ2-2
TGTGCCAGCAGCCCAAGCTCTGATAACTATGGCTACACCTTC	CASSPSSDNYGYTF	TRBV6-3	TRBJ1-2
TGTGCCAGCAGCGACCGGCCTCATACGAATCAGCCCCAGCATTTT	CASSDRPHTNQPQHF	TRBV7-3	TRBJ1-5
TGTGCCAGCAATGTCAGGGGGCTTAGTGAAGCTTTCTTT	CASNVRGLSEAFF	TRBV27	TRBJ1-1
TGTGCCAGCAGCCCCTCCGGGACAGGGGCTGAGACCCAGTACTTC	CASSPSGTGAETQYF	TRBV7-9	TRBJ2-5
TGTGCCAGCAGTGGGATTCCTAAGCCGGGACATGAGACCCAGTACTTC	CASSGIPKPGHETQYF	TRBV27	TRBJ2-5
TGTGCCAGCAGTTTATCAGCTGGTCGAATCAATGAGCAGTTCTTC	CASSLSAGRINEQFF	TRBV28	TRBJ2-1
TGTGCCAGCAGCGGCCAGGGGAAGATTGAAGCTTTCTTT	CASSGQGKIEAFF	TRBV7-8	TRBJ1-1
TGTGCCAGCAGCACTGTACTAGCGGAAGTGACCCAGTACTTC	CASSTVLAEVTQYF	TRBV6-1	TRBJ2-5
TGCGCCAGCAGCTTTTCAAGGATGGGCTACGAGCAGTACTTC	CASSFSRMGYEQYF	TRBV5-1	TRBJ2-7
TGTGCCAGCAGTGTCGCACAGGGCCAGCTTGGCAATGAGCAGTTCTTC	CASSVAQGQLGNEQFF	TRBV2	TRBJ2-1
TGTGCCAGCAGTTTCCAAGGGACAGGGTGGACGGACCTATCGGCTGAAGCTTTCTTT	CASSFQGTGWTDLSAEAFF	TRBV12-4	TRBJ1-1
TGTGCCAGCAGCCCCTGGACAGGGGACTCACCCCTCCACTTT	CASSPWTGDSPLHF	TRBV7-3	TRBJ1-6
TGCGCCAGCAGCTTGTTCCCGAGGGGCACAACCTACGAGCAGTACTTC	CASSLFPRGTTYEQYF	TRBV5-1	TRBJ2-7
TGTGCCAGCAGTATAAGACCGGCTCGGGAGAATCGGGGGCGCTCTGGAAACACCATATATTTT	CASSIRPARENRGRSGNTIYF	TRBV27	TRBJ1-3
TGTGCTAGTGGTTTGGTACCCGGCAGTTCCTACAATGAGCAGTTCTTC	CASGLVPGSSYNEQFF	TRBV12-5	TRBJ2-1
TGTGCCAGCATAGACAGGGGAGCTTTCTTT	CASIDRGAFF	TRBV7-3	TRBJ1-1
TGTGCCACCAGCAGCGATTTGGTCAGGGTAAGCAATCAGCCCCAGCATTTT	CATSSDLVRVSNQPQHF	TRBV15	TRBJ1-5
TGCGCCAGCAAAGGCGTGGTCCGGGACAGACCCAATCAGCCCCAGCATTTT	CASKGVVRDRPNQPQHF	TRBV5-1	TRBJ1-5
TGTGCCAGCATCCAGGGGGCTAGTCTTGCAACTAATGAAAAACTGTTTTTT	CASIQGASLATNEKLFF	TRBV6-4	TRBJ1-4
TGTGCCAGCAGCCGCCCGAAAGGGACTGAAGCTTTCTTT	CASSRPKGTEAFF	TRBV3-1	TRBJ1-1
TGTGCCAGCAGCGCCAGGGATGCCAGGATCTTCGAGCAGTACTTC	CASSARDARIFEQYF	TRBV13	TRBJ2-7
TGTGCCAGCAGGGGACAGAACTATGGCTACACCTTC	CASRGQNYGYTF	TRBV6-1	TRBJ1-2
TGTGCCATCAGGCGGGGACTCGGCAGGGTAAATGAGCAGTTCTTC	CAIRRGLGRVNEQFF	TRBV10-3	TRBJ2-1
TGTGCCAGCAGATCGAAGGGGGGGTACGAGCAGTACTTC	CASRSKGGYEQYF	TRBV28	TRBJ2-7
TGTGCCAGCAGCAAGGGTACCGGAGAAAACCCAAGACTAGGGGAGTACTTC	CASSKGTGENPRLGEYF	TRBV7-9	TRBJ2-7
TGTGCCAGTAGTATCCTCTCCCCGGGACAGGGATTCACTGAAGCTTTCTTT	CASSILSPGQGFTEAFF	TRBV19	TRBJ1-1
TGTGCCAGCAGTGAGATCGGTTCTTGGGGGGGCACAGATACGCAGTATTTT	CASSEIGSWGGTDTQYF	TRBV2	TRBJ2-3
TGCAGTGCTAGAGATAAAAACGAGGGTAATGCCCAAGAGACCCAGTACTTC	CSARDKNEGNAQETQYF	TRBV20-1	TRBJ2-5
TGTGCCAGCAGCCCGAAGGACAATGAGCAGTTCTTC	CASSPKDNEQFF	TRBV9	TRBJ2-1
TGTCGTGCCCCGGGGCCGAACACCGGGGAGCTGTTTTTT	CRAPGPNTGELFF	TRBV30	TRBJ2-2
TGTGCCAGCAGCGACAGGGGGGGGACTAGCGGGGATACGCAGTATTTT	CASSDRGGTSGDTQYF	TRBV9	TRBJ2-3
TGTGCCAGCAGCATTAGTCCGGTCTGGACAGGGGGCCCCATTCAGTACTTC	CASSISPVWTGGPIQYF	TRBV5-8	TRBJ2-4
TGTGCCAGCAGTTTGTCCTGTCGAATAGCATACAATGAGCAGTTCTTC	CASSLSCRIAYNEQFF	TRBV12-4	TRBJ2-1
TGTGCCAGCAGCCTCGGAACAGGTCTGGAGCAGGGTTTGGCCAACGTCCTGACTTTC	CASSLGTGLEQGLANVLTF	TRBV13	TRBJ2-6
TGTGCCAGCAGCGGGGACAGGGGGGGGGCTTTCTTT	CASSGDRGGAFF	TRBV7-9	TRBJ1-1
TGTGCCAGCAGTCGGCATAATGAGCAGTTCTTC	CASSRHNEQFF	TRBV28	TRBJ2-1
TGTGCCAGCAGCGACCGGGACAGGGAGAATAGCTCCTACGAGCAGTACTTC	CASSDRDRENSSYEQYF	TRBV7-9	TRBJ2-7
TGCGCCAGCAGCTTGGACAGTGTAGGGTATGGCTACACCTTC	CASSLDSVGYGYTF	TRBV5-1	TRBJ1-2
TGCGCCAGCAGCGGCGGGGGTGGCAATGAGCAGTTCTTC	CASSGGGGNEQFF	TRBV5-1	TRBJ2-1
TGTGCCCTGCGGGAGTGGGCCTATAGGTACAATGAGCAGTTCTTC	CALREWAYRYNEQFF	TRBV6-4	TRBJ2-1
TGTGCCAGCAGTGTTTGGGGTCCCACAGATACGCAGTATTTT	CASSVWGPTDTQYF	TRBV6-2	TRBJ2-3
TGTGCCACCAGTGATTTCCTGGGGCAGTCTGGAAACACCATATATTTT	CATSDFLGQSGNTIYF	TRBV24-1	TRBJ1-3
TGTGCCAGCAGCACCCCCTTGTTCCCACCGGGACTAGCGGGGACCGGGGAGCTGTTTTTT	CASSTPLFPPGLAGTGELFF	TRBV13	TRBJ2-2
TGTGCCACACTTTACCACGGGCAGCCCCCCAAGTTCAGGGGCAAAGACACCGGGGAGCTGTTTTTT	CATLYHGQPPKFRGKDTGELFF	TRBV24-1	TRBJ2-2
TGTGCCAGCAGCAAAAAGTTGCCCCTAGGGGTTTACGAGCAGTACTTC	CASSKKLPLGVYEQYF	TRBV11-3	TRBJ2-7
TGTGCCAGTAGTATACCCCTGGACAGGGCTGAAGCTTTCTTT	CASSIPLDRAEAFF	TRBV19	TRBJ1-1
TGCAGTGCTGTCCCACGGTCCGCCTCCTACGAGCAGTACTTC	CSAVPRSASYEQYF	TRBV20-1	TRBJ2-7
TGTGCCAGCAGCTTAGCGTCGGTGGGACTCTTCTATGGCTACACCTTC	CASSLASVGLFYGYTF	TRBV7-2	TRBJ1-2
TGCAGTGCTAGAGGACAGGGGGACAGGGCGAGATCCTACGAGCAGTACTTC	CSARGQGDRARSYEQYF	TRBV20-1	TRBJ2-7
TGTGCCAGCAGTTTATCCTGTATTTACAATGAGCAGTTCTTC	CASSLSCIYNEQFF	TRBV12-4	TRBJ2-1
TGTGCCAGCAGTTTACTAGCGGTTTCTGATGAGCAGTTCTTC	CASSLLAVSDEQFF	TRBV27	TRBJ2-1
TGTGCTAGTAGGTCCGGGACAGAAAAGGAGATGAACACTGAAGCTTTCTTT	CASRSGTEKEMNTEAFF	TRBV12-5	TRBJ1-1
TGTGCCAGCAGCTCGACAGGGAGATACGAGCAGTACTTC	CASSSTGRYEQYF	TRBV7-2	TRBJ2-7
TGTGCCAGCAGCTTAGATCAAGTTCGGCTACTGGGAGCTTTCTTT	CASSLDQVRLLGAFF	TRBV11-2	TRBJ1-1
TGCGCCACCCCTCCGGACAGGGGGCATGGCTACACCTTC	CATPPDRGHGYTF	TRBV5-1	TRBJ1-2
TGTGCCAGCAACCCAAGCACGTCCTACGAGCAGTACTTC	CASNPSTSYEQYF	TRBV28	TRBJ2-7
TGTGCCAGCAGTGACCGCGGACTCCCCTGCGGGACATGGAGCCGTGGCTACACCTTC	CASSDRGLPCGTWSRGYTF	TRBV6-4	TRBJ1-2
TGTGGAGGGGACAGGGTGCGCAATCAGCCCCAGCATTTT	CGGDRVRNQPQHF	TRBV24-1	TRBJ1-5
TGTGCCACCAGGAAAGGGCGGATCTCCTACGAGCAGTACTTC	CATRKGRISYEQYF	TRBV24-1	TRBJ2-7
TGTGCCAGCTCACCCCGGGATCGAGGGCTAACAACTAATGAAAAACTGTTTTTT	CASSPRDRGLTTNEKLFF	TRBV18	TRBJ1-4
TGTGCCACCAGTGACCGACAGAGTGTTGAAGCTTTCTTT	CATSDRQSVEAFF	TRBV24-1	TRBJ1-1
TGTGCCAGCAGCCTGCCGGGACAGGTGGCAAAAAACACTGAAGCTTTCTTT	CASSLPGQVAKNTEAFF	TRBV5-6	TRBJ1-1
TGTGCCAGTAGTATCATAGGGGGGAACCACGAGCAGTACTTC	CASSIIGGNHEQYF	TRBV19	TRBJ2-7
TGTGCCAGCAGCGTAGCCCCGGGACAGGTTCGAGATAGCAATCAGCCCCAGCATTTT	CASSVAPGQVRDSNQPQHF	TRBV9	TRBJ1-5
TGCAGTGCTAGAGATAGCACCTCCTACGAGCAGTACTTC	CSARDSTSYEQYF	TRBV20-1	TRBJ2-7
TGTGCCAGCAGCTTACGGGGGAGGGGGGAGGTTCCCCTCCACTTT	CASSLRGRGEVPLHF	TRBV7-9	TRBJ1-6
TGTGCCAGCAGCGAAGATCCAGGTGGCTACACCTTC	CASSEDPGGYTF	TRBV9	TRBJ1-2
TGCAGTGCTAGTGGGACTAATTCACCCCTCCACTTT	CSASGTNSPLHF	TRBV20-1	TRBJ1-6
TGTGCCAAAGACAGGGGGACTGGCTACACCTTC	CAKDRGTGYTF	TRBV19	TRBJ1-2
TGCAGTGCTAGAGATCCAGGGGGCACCTCTCGAATGAACACTGAAGCTTTCTTT	CSARDPGGTSRMNTEAFF	TRBV20-1	TRBJ1-1
TGTGCCAGGCTACAGGGGGAGAATCAGCCCCAGCATTTT	CARLQGENQPQHF	TRBV9	TRBJ1-5
TGTGCCAGCAGCATCTTGCCTAGCTACTACGAGCAGTACTTC	CASSILPSYYEQYF	TRBV7-3	TRBJ2-7
TGTGCCAGCAATGGAGGGACCTATTGGTACTATTATAGCAATCAGCCCCAGCATTTT	CASNGGTYWYYYSNQPQHF	TRBV28	TRBJ1-5
TGCGCCAGCAGCCAAACTGGGTCCTACGAGCAGTACTTC	CASSQTGSYEQYF	TRBV4-1	TRBJ2-7
TGTGCCAGCTCACCCTCAAACCGGTGGACAGGGGATACTTTCAAAAACATTCAGTACTTC	CASSPSNRWTGDTFKNIQYF	TRBV18	TRBJ2-4
TGTGCCAGCACTTTCGTCTGGAACACTGAAGCTTTCTTT	CASTFVWNTEAFF	TRBV2	TRBJ1-1
TGTGCCAGCAGGGGGGCCTCAGGGGGGAACACTGAAGCTTTCTTT	CASRGASGGNTEAFF	TRBV6-6	TRBJ1-1
TGTGCCAGTAGTAATAGCCCTTTCCTGGGGAACTATGGCTACACCTTC	CASSNSPFLGNYGYTF	TRBV19	TRBJ1-2
TGTGCCAGCAGCTTGGGTCCTCCCGACGACACTGAAGCTTTCTTT	CASSLGPPDDTEAFF	TRBV5-6	TRBJ1-1
TGTGCCAGCACCCCAGCAGTTTACGAGCAGTACTTC	CASTPAVYEQYF	TRBV12-3	TRBJ2-7
TGCGCCAGCAGCTTGCGAGCATGTCAGCCCCAGCATTTT	CASSLRACQPQHF	TRBV5-1	TRBJ1-5
TGTGCCAGCAGCCAAGGTACGGGGGAGCGTCAGCCCCAGCATTTT	CASSQGTGERQPQHF	TRBV14	TRBJ1-5
TGTGCCAGCATCCCCGAACTCGGCTGGAGGAATGAAAAACTGTTTTTT	CASIPELGWRNEKLFF	TRBV6-4	TRBJ1-4
TGTGCCAGCAGTCGTCTTAGCCCCCTCCGGTTGGAAAAACTGTTTTTT	CASSRLSPLRLEKLFF	TRBV7-9	TRBJ1-4
TGTGCCAGCAGCTTAGAGGGACAGGGCTGCACAGATACGCAGTATTTT	CASSLEGQGCTDTQYF	TRBV7-4	TRBJ2-3
TGTGCCAGCAGCTTATCCGAAGACAGGGGCAGCAAAAACATTCAGTACTTC	CASSLSEDRGSKNIQYF	TRBV5-6	TRBJ2-4
TGCGCCAGCAGCTCGGGCGGTCCTGGGGCCAACGTCCTGACTTTC	CASSSGGPGANVLTF	TRBV4-3	TRBJ2-6
TGTGCCAGCAGCCTCGTAAGCAGGGCTCACTACGAGCAGTACTTC	CASSLVSRAHYEQYF	TRBV7-3	TRBJ2-7
TGTGCCAGCAGTGCGGGGGGGTGGGGAATTAGCACAGATACGCAGTATTTT	CASSAGGWGISTDTQYF	TRBV7-2	TRBJ2-3
TGTGCCAGCTCACTCAAAACTAGCGGGAGGGCTAGGAGGGACAATGAGCAGTTCTTC	CASSLKTSGRARRDNEQFF	TRBV18	TRBJ2-1
TGTGCCAGCAGCGGACAGAAATGGAACACCGGGGAGCTGTTTTTT	CASSGQKWNTGELFF	TRBV11-3	TRBJ2-2
TGCGCCAGCAGCCAAGACCCAGGGGACTGTAGGTTAGGGGAGCTGTTTTTT	CASSQDPGDCRLGELFF	TRBV4-1	TRBJ2-2
TGTGCCAGCAGCTTCAATATCTCCCCGCGGCCTAATGAAAAACTGTTTTTT	CASSFNISPRPNEKLFF	TRBV5-4	TRBJ1-4
TGTGCCAGCAGTTATCGGGGGGGGGGGGTTGTCAATGAGCAGTTCTTC	CASSYRGGGVVNEQFF	TRBV6-9	TRBJ2-1
TGCGCCAGCAGCCAAGTACCAGGGCACCGAAACACTGAAGCTTTCTTT	CASSQVPGHRNTEAFF	TRBV4-3	TRBJ1-1
TGTGCCAGCAGTGACCCGCTAGGGAAAAACATTCAGTACTTC	CASSDPLGKNIQYF	TRBV6-4	TRBJ2-4
TGTGCCATCAGTGTAACGGGGGCCCAGCAGTTCTTC	CAISVTGAQQFF	TRBV10-3	TRBJ2-1
TGTGCCAGCAGTGGCCGGGACACCGGGGAGCTGTTTTTT	CASSGRDTGELFF	TRBV12-4	TRBJ2-2
TGTGCCAGCAGCTTCCGCGTGGACAGGGTGGTTCAGCCCCAGCATTTT	CASSFRVDRVVQPQHF	TRBV7-4	TRBJ1-5
TGTGCCAGCAGCGTAGATTATGGAACTCCGGGACAGGGTAGCCCACCGGCCTCCTCCTATAATTCACCCCTCCACTTT	CASSVDYGTPGQGSPPASSYNSPLHF	TRBV9	TRBJ1-6
TGTGCCTCTAGGGGGACAGAGAGGTACACTGAAGCTTTCTTT	CASRGTERYTEAFF	TRBV9	TRBJ1-1
TGTGCCAGCAGTGCCAGGGACAGGCAACCCAATGAGCAGTTCTTC	CASSARDRQPNEQFF	TRBV12-3	TRBJ2-1
TGTGCCAGCAGAGTTAGGGGGGACGAAAAACTGTTTTTT	CASRVRGDEKLFF	TRBV4-2	TRBJ1-4
TGTGCCATCAGTTTTCAGGGAGGGAAGGGAGATACGCAGTATTTT	CAISFQGGKGDTQYF	TRBV10-3	TRBJ2-3
TGTGCCAGCAGCGAGGAGCGGGATGTTCCCTCTGGAAACACCATATATTTT	CASSEERDVPSGNTIYF	TRBV13	TRBJ1-3
TGTGCCAGCAGATTTCAGGGGGGGGTAGGCGTAGCCAAAAACATTCAGTACTTC	CASRFQGGVGVAKNIQYF	TRBV6-1	TRBJ2-4
TGTGCCACCAGTGATAGAAGGACCGGGGAGCAGTACTTC	CATSDRRTGEQYF	TRBV24-1	TRBJ2-7
TGTGCCAGCAGCTTATACCCGGGACAGGGGGCCCATGGCTACACCTTC	CASSLYPGQGAHGYTF	TRBV7-2	TRBJ1-2
TGTGCCAGCAGTGACACCACCGACCATAGCAATCAGCCCCAGCATTTT	CASSDTTDHSNQPQHF	TRBV6-4	TRBJ1-5
TGCAGCGTTGACTGTAGGTGGGGGGGGAAAATGAACACTGAAGCTTTCTTT	CSVDCRWGGKMNTEAFF	TRBV29-1	TRBJ1-1
TGTGCCAGCAGCGGTAGGAGAATTCTCACTGAAGCTTTCTTT	CASSGRRILTEAFF	TRBV13	TRBJ1-1
TGTGCCAGCAGCTTAGATCGACAGCCCCAGCATTTT	CASSLDRQPQHF	TRBV7-2	TRBJ1-5
TGTGCCAGCAGTTACCCTGGGGGGTTTGCTTTCTTT	CASSYPGGFAFF	TRBV6-4	TRBJ1-1
TGTGCCAGCAGTGAAGCGCTTAGCAGAACCTACGAGCAGTACTTC	CASSEALSRTYEQYF	TRBV2	TRBJ2-7
TGCGCCAGGTGCGCTAGGATACACGAGGTCGTGCAGTTCTTC	CARCARIHEVVQFF	TRBV5-1	TRBJ2-1
TGTGCCAGCACGACAGGGCTTAACCCCTACGAGCAGTACTTC	CASTTGLNPYEQYF	TRBV2	TRBJ2-7
TGTGCCAGTAGTATATTCAGACGGGCCTACGAGCAGTACTTC	CASSIFRRAYEQYF	TRBV19	TRBJ2-7
TGTGCCACGCCGGACAGTGTGACAGATACGCAGTATTTT	CATPDSVTDTQYF	TRBV24-1	TRBJ2-3
TGTGCCAGCAGCGTACCCCTGGGGTATGAGCAGTTCTTC	CASSVPLGYEQFF	TRBV5-6	TRBJ2-1
TGTGCCACCAGCAGGACTACCCAAGAGACCCAGTACTTC	CATSRTTQETQYF	TRBV15	TRBJ2-5
TGCAGCGTTAGCTCCAGGGGAACTGGAAACACCATATATTTT	CSVSSRGTGNTIYF	TRBV29-1	TRBJ1-3
TGTGCCAGCAGAAGAATGAAGGCCCATGGCTACACCTTC	CASRRMKAHGYTF	TRBV6-1	TRBJ1-2
TGTGCCAGCAGTGAAGGAGTACGGACAGGGGTTGTAGTTAGCGAGCAGTACTTC	CASSEGVRTGVVVSEQYF	TRBV2	TRBJ2-7
TGTGCCAGCAGTAGTACCCCACGGGACACACGCGCAGAGAACAATCAGCCCCAGCATTTT	CASSSTPRDTRAENNQPQHF	TRBV28	TRBJ1-5
TGTGCCAGCAGTGCCAGCGGTGGGCCCTCCTACGAGCAGTACTTC	CASSASGGPSYEQYF	TRBV6-4	TRBJ2-7
TGCGCCAGTCACAGAGGACAGTTTTGGCCAGAGCAGTTCTTC	CASHRGQFWPEQFF	TRBV5-1	TRBJ2-1
TGTGCCATCGCAACTCAGGGACCGGAAGGACATGGCTACACCTTC	CAIATQGPEGHGYTF	TRBV10-3	TRBJ1-2
TGTGCCAGCATCGGGGGGCGAAAGTGTGGCTACACCTTC	CASIGGRKCGYTF	TRBV6-5	TRBJ1-2
TGCAGTGCTAGAGATCTCGGCGGCCAAGAGACCCAGTACTTC	CSARDLGGQETQYF	TRBV20-1	TRBJ2-5
TGTGCCAGCAGCTTGACTGGTGGAAACACCATATATTTT	CASSLTGGNTIYF	TRBV7-2	TRBJ1-3
TGTGCCAGCAGCATCACAACGGGGCTGGGGGAATACGAGCAGTACTTC	CASSITTGLGEYEQYF	TRBV7-3	TRBJ2-7
TGTGCCAGCACCGGGGAAGACTATGGCTACACCTTC	CASTGEDYGYTF	TRBV6-5	TRBJ1-2
TGCAGCGTTGGGGTCCTTGACGGCTACGAGCAGTACTTC	CSVGVLDGYEQYF	TRBV29-1	TRBJ2-7
TGTGCCAGCAGCTTGTCCAGGGGGGGGGACTATGGCTACACCTTC	CASSLSRGGDYGYTF	TRBV11-2	TRBJ1-2
TGCGCCAGCAGTTGTTTTAAACCTAGCGGGAGCGGGGAGCTGTTTTTT	CASSCFKPSGSGELFF	TRBV10-2	TRBJ2-2
TGTGCCAGCAGCAACGGGGGACGTGACCCTCACCCGAGCTCCTATAATTCACCCCTCCACTTT	CASSNGGRDPHPSSYNSPLHF	TRBV9	TRBJ1-6
TGTGCCAGCAGGGGGAGGGGGGCCAACGTCCTGACTTTC	CASRGRGANVLTF	TRBV6-4	TRBJ2-6
TGTGCCATCGAAGGGGGGGTAAGGTGCACAGATACGCAGTATTTT	CAIEGGVRCTDTQYF	TRBV10-3	TRBJ2-3
TGTGCCAGCAGCTTAGCCCAAGGGGGGAAGGAAGCTTTCTTT	CASSLAQGGKEAFF	TRBV7-9	TRBJ1-1
TGTGCCAGCAGCCAAGATGACAGCGGATGTGGGGGGAATGAGCAGTTCTTC	CASSQDDSGCGGNEQFF	TRBV14	TRBJ2-1
TGCGCCAGCAGCTGGAGAGGGGGCCGAACTAATGAAAAACTGTTTTTT	CASSWRGGRTNEKLFF	TRBV5-1	TRBJ1-4
TGTGCCAGCATCGGCGGGAGAAGCATGAACACTGAAGCTTTCTTT	CASIGGRSMNTEAFF	TRBV6-2	TRBJ1-1
TGTGCCAGCAGCTTGGGTGGGGGGGGACAGGTGGGCACAGATACGCAGTATTTT	CASSLGGGGQVGTDTQYF	TRBV7-9	TRBJ2-3
TGTGCCGGGGTATCTAATAGCAATCAGCCCCAGCATTTT	CAGVSNSNQPQHF	TRBV10-3	TRBJ1-5
TGTGCCAGCAGCTTAGCGGGGGTGTACGGTCGTGAGCAGTTCTTC	CASSLAGVYGREQFF	TRBV7-9	TRBJ2-1
TGCAGTGCTAGATGTCCAAGTGGGGCCGGGACTAGCGGGAGCTCCTACAATGAGCAGTTCTTC	CSARCPSGAGTSGSSYNEQFF	TRBV20-1	TRBJ2-1
TGTGCCAGCAGCTTGAGCGTCTACGAGCAGTACTTC	CASSLSVYEQYF	TRBV5-4	TRBJ2-7
TGTGCCAGCAGACCCCTTACTAGACAGGGTAAGTTTGGCACAGATACGCAGTATTTT	CASRPLTRQGKFGTDTQYF	TRBV6-6	TRBJ2-3
TGCGCCAGCTTGATATCAGGCGACAAACTGTTTTTT	CASLISGDKLFF	TRBV10-1	TRBJ1-4
TGCAGTGCTAAGATAGGGGCCTACGAGCAGTACTTC	CSAKIGAYEQYF	TRBV20-1	TRBJ2-7
TGTGCCAGCAGCTTGGGACAGGGTAGTCAGACCCAGTACTTC	CASSLGQGSQTQYF	TRBV7-2	TRBJ2-5
TGTGCCAGCAGCTCCCCAGGGCGGAGGGCTAATGAAAAACTGTTTTTT	CASSSPGRRANEKLFF	TRBV7-2	TRBJ1-4
TGTGCCAGCAATAATCTACTCAGGGGGCAGTCCGGGGAGCTGTTTTTT	CASNNLLRGQSGELFF	TRBV11-2	TRBJ2-2
TGCGCCAGCAGCTTCCGACAGTGGCTAGCCAAAAACATTCAGTACTTC	CASSFRQWLAKNIQYF	TRBV5-1	TRBJ2-4
TGTGCCAGCAGCCAAGGGATAAGCGAAAAACTGTTTTTT	CASSQGISEKLFF	TRBV28	TRBJ1-4
TGTGCCAGCCGGGGGACGTCATATGAGCAGTTCTTC	CASRGTSYEQFF	TRBV27	TRBJ2-1
TGTGCCACCAGTGAGGGGTCCTCGATAAAAGTTAGGGGGCGCTACGAGCAGTACTTC	CATSEGSSIKVRGRYEQYF	TRBV24-1	TRBJ2-7
TGTGCCAGCAGTTTTGACCTACTGGGCGGGCACAATGAGCAGTTCTTC	CASSFDLLGGHNEQFF	TRBV27	TRBJ2-1
TGCGCCAGCTACCCCCGGGACGTGGTGGAGACCCAGTACTTC	CASYPRDVVETQYF	TRBV5-1	TRBJ2-5
TGTGCCAGCAGTGGACTAGCGGGGGGGCCAGGAACCGAGCAGTTCTTC	CASSGLAGGPGTEQFF	TRBV11-3	TRBJ2-1
TGCAGCGTCGGTTCAGACGGCAGATATGGCTACACCTTC	CSVGSDGRYGYTF	TRBV29-1	TRBJ1-2
TGCAGTGCTAGAGAACCCGACAGCTCCAGCTCCTATAATTCACCCCTCCACTTT	CSAREPDSSSSYNSPLHF	TRBV20-1	TRBJ1-6
TGTGCCAGCAGTACGGGGCAAGAGACCCAGTACTTC	CASSTGQETQYF	TRBV6-1	TRBJ2-5
TGTGCCAGCAGCTTGGGGCGGGGAGGGGGCCGTAACTATGGCTACACCTTC	CASSLGRGGGRNYGYTF	TRBV7-8	TRBJ1-2
TGTGCCAGGACTGAGTGTGGCTATGGCTACACCTTC	CARTECGYGYTF	TRBV7-9	TRBJ1-2
TGCACAGTCGGCCTTTACAATGAGCAGTTCTTC	CTVGLYNEQFF	TRBV20-1	TRBJ2-1
TGTGCCTGGCGACCTCCAATCCAGGGCGGGTCCTATAATTCACCCCTCCACTTT	CAWRPPIQGGSYNSPLHF	TRBV30	TRBJ1-6
TGTGCCAGCAGCTTATGGGCCCCCCTCTACGAGCAGTACTTC	CASSLWAPLYEQYF	TRBV7-9	TRBJ2-7
TGTGCCACCCGAGGGGGCCATGGCTACACCTTC	CATRGGHGYTF	TRBV24-1	TRBJ1-2
TGTGCCAGCAGCCCCCCTGGTCGGGACAGGGAGGAGCAGTACTTC	CASSPPGRDREEQYF	TRBV5-4	TRBJ2-7
TGTGCCAGCAGCCACAGGGGGCGGGGCTATGGCTACACCTTC	CASSHRGRGYGYTF	TRBV14	TRBJ1-2
TGTGTCCGGGGGAGGGGAGACGAGCAGTACTTC	CVRGRGDEQYF	TRBV9	TRBJ2-7
TGTGCCAGCAGCAGGCGAGACAGTAGAGAGACCCAGTACTTC	CASSRRDSRETQYF	TRBV2	TRBJ2-5
TGCAGTGCTAGCAATCCGAAGACGCGAGGATTCACCCTTAACTATGGCTACACCTTC	CSASNPKTRGFTLNYGYTF	TRBV20-1	TRBJ1-2
TGTGCCAACCAGGCCCCCGCGACAGGGGGGGCTAGCACAGATACGCAGTATTTT	CANQAPATGGASTDTQYF	TRBV24-1	TRBJ2-3
TGCAGTGCTAGAGATCGCTGGGCGACAGGGGAAAACACTGAAGCTTTCTTT	CSARDRWATGENTEAFF	TRBV20-1	TRBJ1-1
TGTGCCTGGAGTAACCGGGGATCAACCTACGAGCAGTACTTC	CAWSNRGSTYEQYF	TRBV30	TRBJ2-7
TGCGCCAGCACTAGGGAACTGGATCAGCCCCAGCATTTT	CASTRELDQPQHF	TRBV10-2	TRBJ1-5
TGTGCCAGCAGAACAAACACAAAGGAGTATGGCTACACCTTC	CASRTNTKEYGYTF	TRBV25-1	TRBJ1-2
TGTGCCAGATGGGACAAACACAAAGAGACCCAGTACTTC	CARWDKHKETQYF	TRBV2	TRBJ2-5
TGTGCCACCAGCAGAGTGGCACAGGGGGCTGAGCAGTACTTC	CATSRVAQGAEQYF	TRBV15	TRBJ2-7
TGTGCCAGCAGCCCTACTCCGGACAGCCCAACTAATGAAAAACTGTTTTTT	CASSPTPDSPTNEKLFF	TRBV7-3	TRBJ1-4
TGTGCCTGGAGGTATAAGTGTCGGGAGATTCCCTATAATTCACCCCTCCACTTT	CAWRYKCREIPYNSPLHF	TRBV30	TRBJ1-6
TGTGCCAGCAGGAGCGGGGGATCCTACGAGCAGTACTTC	CASRSGGSYEQYF	TRBV7-3	TRBJ2-7
TGTGCCCAGAACCCTAGCGACGTGAACACTGAAGCTTTCTTT	CAQNPSDVNTEAFF	TRBV6-1	TRBJ1-1
TGTGCCAGCAGTTTTCATCGTAGGGACGGCACAGATACGCAGTATTTT	CASSFHRRDGTDTQYF	TRBV6-2	TRBJ2-3
TGTGCCAGCAGTGAGGAGACGGGAGTTCAGCCCCAGCATTTT	CASSEETGVQPQHF	TRBV6-1	TRBJ1-5
TGTGCCAGCAGTCGGCGGGGGGCCGGGCTGTTTTTT	CASSRRGAGLFF	TRBV12-4	TRBJ2-2
TGTGCCAGCAGCGCGAGGACCGGGGAGCTGTTTTTT	CASSARTGELFF	TRBV13	TRBJ2-2
TGTGCCAGCAGCGGAGGGACTAGCGGGACCGGGGAGCTGTTTTTT	CASSGGTSGTGELFF	TRBV9	TRBJ2-2
TGTGCCAGCAGCCGTTCAGGGGGGAACTATGGCTACACCTTC	CASSRSGGNYGYTF	TRBV13	TRBJ1-2
TGCGCCAGCAGCGGGCCCGGGGCCGGGGAGCTGTTTTTT	CASSGPGAGELFF	TRBV5-1	TRBJ2-2
TGTGCCAGCAGCAAAACGGGAGTACCCTCCCACCAAGAGACCCAGTACTTC	CASSKTGVPSHQETQYF	TRBV5-4	TRBJ2-5
TGCAGTGCCCCGTCCCGGCCCTCTAATTCACCCCTCCACTTT	CSAPSRPSNSPLHF	TRBV20-1	TRBJ1-6
TGTGCCAGCAGCGGGGCAACTAATGAAAAACTGTTTTTT	CASSGATNEKLFF	TRBV7-2	TRBJ1-4
TGTGCCAGCAGTTTACTCAGGCAGAACACTGAAGCTTTCTTT	CASSLLRQNTEAFF	TRBV27	TRBJ1-1
TGTGCCAGCAGCGGGACAGTGCCAGGTGGGGCCAACGTCCTGACTTTC	CASSGTVPGGANVLTF	TRBV13	TRBJ2-6
TGTGCCACTCCCTATCTTAACTATTTGTTTCATGAGCAGTTCTTC	CATPYLNYLFHEQFF	TRBV10-3	TRBJ2-1
TGTGCCAGCAGACCGGGACTAGCGGGAGGTAGCGGTGGAAACACCATATATTTT	CASRPGLAGGSGGNTIYF	TRBV6-5	TRBJ1-3
TGTGCCAGCAGCCGAGGGGGGACCGGGGAGCTGTTTTTT	CASSRGGTGELFF	TRBV13	TRBJ2-2
TGTGCCAGCAGCTTTCCAGGACAAGCTGATTGGAATCAGCCCCAGCATTTT	CASSFPGQADWNQPQHF	TRBV7-6	TRBJ1-5
TGTGCTAGTGGTCTTCCCAGGAGGGGGAACACTGAAGCTTTCTTT	CASGLPRRGNTEAFF	TRBV12-5	TRBJ1-1
TGTGCCAGCAGTGATCTAAGAGGGTCCTATAATTCACCCCTCCACTTT	CASSDLRGSYNSPLHF	TRBV6-4	TRBJ1-6
TGTGCTGGGGACAGTTCCGATCAGCCCCAGCATTTT	CAGDSSDQPQHF	TRBV6-5	TRBJ1-5
TGCAGTGCTGAGGGGGGAAAAAGGTATTTT	CSAEGGKRYF	TRBV20-1	TRBJ2-3
TGTGCCAGCAGCCTCGACCCACGGGGGGCCCCTAGCGGGGAGCTGTTTTTT	CASSLDPRGAPSGELFF	TRBV7-9	TRBJ2-2
TGTGCCAGCAGCAGTGCATCATCGGGGGGCTTGAGCTCCTACAATGAGCAGTTCTTC	CASSSASSGGLSSYNEQFF	TRBV7-9	TRBJ2-1
TGTGCCATCAGTGTTAAGGGCCCGTGGTCTAATTTCACTGAAGCTTTCTTT	CAISVKGPWSNFTEAFF	TRBV10-3	TRBJ1-1
TGTGCCAGCAGCTTAGAAGGGGGGATCGGGGATGAGCAGTTCTTC	CASSLEGGIGDEQFF	TRBV7-6	TRBJ2-1
TGCAGCGGTCGGCACCAAGAGACCCAGTACTTC	CSGRHQETQYF	TRBV29-1	TRBJ2-5
TGTGCCAGCAGCCCGCCGGGGGGAACTAATGAAAAACTGTTTTTT	CASSPPGGTNEKLFF	TRBV14	TRBJ1-4
TGTGCCAGCAGTGACAGGGGAGCCTACGAGCAGTACTTC	CASSDRGAYEQYF	TRBV2	TRBJ2-7
TGTGCCAGCAGCCCCACTAGCGGTCACTACGAGCAGTACTTC	CASSPTSGHYEQYF	TRBV5-4	TRBJ2-7
TGTGCCACCAGTCCGGGCCAAGAGACCCAGTACTTC	CATSPGQETQYF	TRBV24-1	TRBJ2-5
TGTGCCAGCAGCCAAGATCCAGGACAGGGCCGGGCGACTGAAGCTTTCTTT	CASSQDPGQGRATEAFF	TRBV4-2	TRBJ1-1
TGTGCCAGCAGCAAAAATACCGTAGACCTCCAGCCCCAGCATTTT	CASSKNTVDLQPQHF	TRBV11-3	TRBJ1-5
TGCGCCAGCAGCTTGAAGGGCGGATATGCGCTCACAGATACGCAGTATTTT	CASSLKGGYALTDTQYF	TRBV5-1	TRBJ2-3
TGTGCCAGCAGTAACCCCCCCGCGGGACTAGCGGGCTACGAGCAGTACTTC	CASSNPPAGLAGYEQYF	TRBV13	TRBJ2-7
TGTGCCAGCAGCCGGGCCGGGGGAGGTGAGTACTTC	CASSRAGGGEYF	TRBV13	TRBJ2-5
TGCGCCAGCGGTTCGGGAGTCCAGTACTTC	CASGSGVQYF	TRBV10-1	TRBJ2-5
TGTGCCAGCAGCTGGACTAGCATGCAGTTCTTC	CASSWTSMQFF	TRBV7-4	TRBJ2-1
TGCGCCAGCAGCTTAATCTCTAGCGCCTACGAGCAGTACTTC	CASSLISSAYEQYF	TRBV5-1	TRBJ2-7
TGCGCCCAGAGGGACAAAGGCAATCAGCCCCAGCATTTT	CAQRDKGNQPQHF	TRBV5-1	TRBJ1-5
TGTGCCAGCAGCGGCGTATCGGACGAGCAGTACTTC	CASSGVSDEQYF	TRBV3-1	TRBJ2-7
TGTGCCACCAGTGATCCGCCGGGACAGGGTTCAGCCTACGAGCAGTACTTC	CATSDPPGQGSAYEQYF	TRBV24-1	TRBJ2-7
TGTGCCTGGCCCTTTTTCTCTTCTATACACTACGAGCAGTACTTC	CAWPFFSSIHYEQYF	TRBV30	TRBJ2-7
TGTGCCAGCAGTTTAACGGGGCAGGGGCGCGATAGCAATCAGCCCCAGCATTTT	CASSLTGQGRDSNQPQHF	TRBV27	TRBJ1-5
TGTGCCAGCTCAGTGGGGAAAGCGGGAGGGGCGACTGAAGAGACCCAGTACTTC	CASSVGKAGGATEETQYF	TRBV18	TRBJ2-5
TGTGCCAGCAGCTTATTTCTACCGGGACATGAGCAGTTCTTC	CASSLFLPGHEQFF	TRBV7-6	TRBJ2-1
TGTGCCAGCAGTTACAAAGGACAGGGACCTGGTTATGGCTACACCTTC	CASSYKGQGPGYGYTF	TRBV6-6	TRBJ1-2
TGTGCCAGCAGCTTACAGGGGACCGACGAGTATGGCTACACCTTC	CASSLQGTDEYGYTF	TRBV7-9	TRBJ1-2
TGCGCCAGCAGCTTTTCTCGGTACGGGGGGGACAATGAGCAGTTCTTC	CASSFSRYGGDNEQFF	TRBV5-1	TRBJ2-1
TGTGCCAGCAGCTGGGACAGGGGGCAGAACACTGAAGCTTTCTTT	CASSWDRGQNTEAFF	TRBV5-4	TRBJ1-1
TGTGCCAGCAGAAGCCCGGCGGGAGAGGACGAGCAGTACTTC	CASRSPAGEDEQYF	TRBV7-3	TRBJ2-7
TGTGCCAGCAGCCAAGATCCCGCGCGGGAGGGACGGAGGCCCTACAATGAGCAGTTCTTC	CASSQDPAREGRRPYNEQFF	TRBV4-2	TRBJ2-1
TGTGCCAGCAGGCGGTACCCCAGGCAGTACTTC	CASRRYPRQYF	TRBV2	TRBJ2-5
TGTGCCAGCAGAATTGCCCCGACTAGCGGGAGATGCTCCCGGGATGAAAAACTGTTTTTT	CASRIAPTSGRCSRDEKLFF	TRBV6-5	TRBJ1-4
TGTGCCAGCAGTTGTCTTCGGGGCACAGATACGCAGTATTTT	CASSCLRGTDTQYF	TRBV12-4	TRBJ2-3
TGTGCTAGGGCGGGACTAGAGACCCAGTACTTC	CARAGLETQYF	TRBV28	TRBJ2-5
TGTGCCAGCAGCTGGCTAGCGCTCTACGAGCAGTACTTC	CASSWLALYEQYF	TRBV7-9	TRBJ2-7
TGTGCCTTCATAGCGGGAGGGACCGGGGAGCTGTTTTTT	CAFIAGGTGELFF	TRBV10-3	TRBJ2-2
TGCAGTGCCCAGCCCGGACGCCCCTACACTGAAGCTTTCTTT	CSAQPGRPYTEAFF	TRBV20-1	TRBJ1-1
TGCGCCAGCAGCTTGAAAGGGGGGGGATATGGCTACACCTTC	CASSLKGGGYGYTF	TRBV5-1	TRBJ1-2
TGCAGCGTCGTGTTTCTGGGCAATTCCCCAACTAATGAAAAACTGTTTTTT	CSVVFLGNSPTNEKLFF	TRBV29-1	TRBJ1-4
TGTGCCAGCAGTGACGAGGGGACGAACACCGGGGAGCTGTTTTTT	CASSDEGTNTGELFF	TRBV6-4	TRBJ2-2
TGTGCCAGCAGCATTGCCGGCCTGGGACTAGCGGGACCCTCCTACAATGAGCAGTTCTTC	CASSIAGLGLAGPSYNEQFF	TRBV2	TRBJ2-1
TGTGCCAGCAGAGTGACTGTGGTGAACACTGAAGCTTTCTTT	CASRVTVVNTEAFF	TRBV27	TRBJ1-1
TGTGCCAGCAGTAGCGGGGGGCAGTATTTT	CASSSGGQYF	TRBV11-3	TRBJ2-3
TGTGCCAGCATCCATTGGACAGGGAATAATTCACCCCTCCACTTT	CASIHWTGNNSPLHF	TRBV27	TRBJ1-6
TGTGCCAGCAGCCCACGGACAGGGCCACGGGGACCGTCTGGAAACACCATATATTTT	CASSPRTGPRGPSGNTIYF	TRBV5-8	TRBJ1-3
TGCAAAGACGCTAGCGGGGGGCGGGGATCGAACACCGGGGAGCTGTTTTTT	CKDASGGRGSNTGELFF	TRBV20-1	TRBJ2-2
TGTGCAGAGACCGGGTTAGCGGGCGGGGAGCTGTTTTTT	CAETGLAGGELFF	TRBV5-6	TRBJ2-2
TGCAGTGCTCCCGACCCCGACCGTGACAGCATTCAGTACTTC	CSAPDPDRDSIQYF	TRBV20-1	TRBJ2-4
TGTGCCAGTAGTGCGGGTCTCACAGATACGCAGTATTTT	CASSAGLTDTQYF	TRBV19	TRBJ2-3
TGTGCCAGCAGTTTAAATGGGCCCTATGAGCAGTTCTTC	CASSLNGPYEQFF	TRBV28	TRBJ2-1
TGTGCCAGCAGTGTCTGGGGACGGGGGGCAGACTATGGCTACACCTTC	CASSVWGRGADYGYTF	TRBV7-3	TRBJ1-2
TGCAGTGCCGCACCTGGAGGGACGGCGCAGGGTATACGACAGGGAAAGCCCCAGCATTTT	CSAAPGGTAQGIRQGKPQHF	TRBV20-1	TRBJ1-5
TGTGCCAGCAGCACCATCTGGGGCGGCTACACCTTC	CASSTIWGGYTF	TRBV7-4	TRBJ1-2
TGTGCCAGCAGTGAAGAAGGGCATATGGGAAGGGTAGCCAAAAACATTCAGTACTTC	CASSEEGHMGRVAKNIQYF	TRBV6-1	TRBJ2-4
TGTGCCACCAGTGATTGGTACCAGGGAGAGAACACTGAAGCTTTCTTT	CATSDWYQGENTEAFF	TRBV24-1	TRBJ1-1
TGTGCCTGGGTTACTAGCGGGAGGCCCTACGAGCAGTACTTC	CAWVTSGRPYEQYF	TRBV30	TRBJ2-7
TGTGCCAGCAGCTTGCGCGGTCCCAGTTACAATGAGCAGTTCTTC	CASSLRGPSYNEQFF	TRBV5-6	TRBJ2-1
TGCAGTGCTAGAGACCCGGGACAGGGGCCCGGCAACGAGCAGTACTTC	CSARDPGQGPGNEQYF	TRBV20-1	TRBJ2-7
TGTGCCAGTAGTATAGGGGGTGGGGGCGGAGATACGCAGTATTTT	CASSIGGGGGDTQYF	TRBV19	TRBJ2-3
TGCAGTGCTAATGCAAGGGGGGTGACTGGTCACTCCTACGAGCAGTACTTC	CSANARGVTGHSYEQYF	TRBV20-1	TRBJ2-7
TGTGCCAGCAGTCCTCCGTCAGTGGGGGGGAGTTCCTACGAGCAGTACTTC	CASSPPSVGGSSYEQYF	TRBV6-5	TRBJ2-7
TGTGCCAGCAGCGGCAAGGGGACGGTTTACTTC	CASSGKGTVYF	TRBV7-4	TRBJ2-5
TGTGCCAGCAGGCAACAGGGCCCCTACGAGCAGTACTTC	CASRQQGPYEQYF	TRBV9	TRBJ2-7
TGTGCCAGCAGTTCAGGGACAGGGGAAGAGGGGGCTTTCTTT	CASSSGTGEEGAFF	TRBV27	TRBJ1-1
TGCGCCAGCAGCTTGCTGTATTGGCTCTCTGGAAACACCATATATTTT	CASSLLYWLSGNTIYF	TRBV5-1	TRBJ1-3
TGTGCCAGTAGTCCCCCCGGGGACCTGAGCTACGAGCAGTACTTC	CASSPPGDLSYEQYF	TRBV19	TRBJ2-7
TGCGCCAGCAGCCAAGTGATGGGCTCACGGTATCAGCCCCAGCATTTT	CASSQVMGSRYQPQHF	TRBV4-3	TRBJ1-5
TGTGCCAGCAAACCCCAACTCCCAGGGGCCTTGAAACAGCCCCAGCATTTT	CASKPQLPGALKQPQHF	TRBV7-4	TRBJ1-5
TGTGCCAGCAGCGTAGTTACTAGCGGGAGGGCCTCCGAGCAGTACTTC	CASSVVTSGRASEQYF	TRBV9	TRBJ2-7
TGCGCCAGCACCGTTGCCGGGGGCTTCTTTATGTCCTACGAGCAGTACTTC	CASTVAGGFFMSYEQYF	TRBV10-1	TRBJ2-7
TGCGCCAGCAGCTTGAATGTACCCGGACAGGGATCCTACGAGCAGTACTTC	CASSLNVPGQGSYEQYF	TRBV5-1	TRBJ2-7
TGTGCCAGCAGAGAAGTGGACAGAAACACCATATATTTT	CASREVDRNTIYF	TRBV3-1	TRBJ1-3
TGTGCCAGCATCCGTGACAGGGGGGTAGGAAACACCATATATTTT	CASIRDRGVGNTIYF	TRBV7-3	TRBJ1-3
TGTGCCAGCAGTTCCGAGAGGTCCCACCGCAATCAGCCCCAGCATTTT	CASSSERSHRNQPQHF	TRBV27	TRBJ1-5
TGCGCCAGCAGCTTGGGACCGGGACAGGGGGGTCGACAGAAACACGAGCAGTACTTC	CASSLGPGQGGRQKHEQYF	TRBV5-1	TRBJ2-7
TGCCAGCAGGGAAGGAACACTGAAGCTTTCTTT	CQQGRNTEAFF	TRBV10-1	TRBJ1-1
TGTGCCTGGAGTCTTCGTTATGGGATGTACTTC	CAWSLRYGMYF	TRBV30	TRBJ2-7
TGTGCCAGCAGTGAAAGCTGGTTCTCTAGGGACTGGGCCTACGAGCAGTACTTC	CASSESWFSRDWAYEQYF	TRBV6-1	TRBJ2-7
TGTGCCAGCAGCGGGGCAGGCTACGAGCAGTACTTC	CASSGAGYEQYF	TRBV7-6	TRBJ2-7
TGTGCCAGCAGCGCCCCCCCCCGAGCCGGGGGGAGCGGTGGCGAAGACAATGAGCAGTTCTTC	CASSAPPRAGGSGGEDNEQFF	TRBV13	TRBJ2-1
TGTGCCAGCAGTTTACTCGCGCGGCAGCTTATCCCTCTTACTGAAGCTTTCTTT	CASSLLARQLIPLTEAFF	TRBV28	TRBJ1-1
TGTGCCAGCAGCTACGGCCAGGGGCCCCAAGGCACAGATACGCAGTATTTT	CASSYGQGPQGTDTQYF	TRBV5-4	TRBJ2-3
TGCAGCGTCGGGACTAGCGGCAAAAACATTCAGTACTTC	CSVGTSGKNIQYF	TRBV29-1	TRBJ2-4
TGTGCCACCAGTGCAGGGTTCCCTAGAACCTACAATGAGCAGTTCTTC	CATSAGFPRTYNEQFF	TRBV24-1	TRBJ2-1
TGTGCCAGCAGCCAACCTCTCAGGGGGAACACCGGGGAGCTGTTTTTT	CASSQPLRGNTGELFF	TRBV14	TRBJ2-2
TGTGCTAGCAGACGGGGAAGGGGTGCAACTAATGAAAAACTGTTTTTT	CASRRGRGATNEKLFF	TRBV7-7	TRBJ1-4
TGTGCCAGCATGTGGGACATGAACACTGAAGCTTTCTTT	CASMWDMNTEAFF	TRBV28	TRBJ1-1
TGCAGTGCTAGAGAACGGACGCAAGAGACCCAGTACTTC	CSARERTQETQYF	TRBV20-1	TRBJ2-5
TGTGCCACCAGTTCCCCCGGCCGGAACTCTGGAAACACCATATATTTT	CATSSPGRNSGNTIYF	TRBV24-1	TRBJ1-3
TGTGCCAGCAGCTTAGAGGCAGGGTCAAGCTCTGGAAACACCATATATTTT	CASSLEAGSSSGNTIYF	TRBV7-4	TRBJ1-3
TGTGCGATAAAGGGGAGGCGGAGTCGGGAGAACGAGCAGTACTTC	CAIKGRRSRENEQYF	TRBV27	TRBJ2-7
TGTGCCAGCAGCGTATCACCTACCGGGGCGAACACCGGGGAGCTGTTTTTT	CASSVSPTGANTGELFF	TRBV9	TRBJ2-2
TGTGCCAGCAGCGCGGGGGGCCCCGGTCACAATGAGCAGTTCTTC	CASSAGGPGHNEQFF	TRBV7-6	TRBJ2-1
TGTGCTAGTGGTTTTGATCCACTAGCGGGGGGGGGCACAGATACGCAGTATTTT	CASGFDPLAGGGTDTQYF	TRBV12-5	TRBJ2-3
TGTGCCAGCAGTTGGGACAGCAACGCGACCCAGTACTTC	CASSWDSNATQYF	TRBV12-3	TRBJ2-5
TGTGCCAGCAGCTTAATGCTGCAGGGAAAAGACACTGAAGCTTTCTTT	CASSLMLQGKDTEAFF	TRBV11-3	TRBJ1-1
TGCGCCAGCAGTGATAGACAGGGGGGGGCTCGGACCTATGGCTACACCTTC	CASSDRQGGARTYGYTF	TRBV10-2	TRBJ1-2
TGTGCCAGCACGGGACAGGTGTCTAATCAGCCCCAGCATTTT	CASTGQVSNQPQHF	TRBV6-5	TRBJ1-5
TGTGCCAGCAGCTTGGACCCAGGAGTAGGGGAGCTGTTTTTT	CASSLDPGVGELFF	TRBV5-6	TRBJ2-2
TGTGCCAGCAGCCAACTAGCGGGGGGGCAGGGGCAAGAGACCCAGTACTTC	CASSQLAGGQGQETQYF	TRBV3-1	TRBJ2-5
TGTGCCAGCAGCCAAGCCGGGTATTCTGAAGCTTTCTTT	CASSQAGYSEAFF	TRBV4-2	TRBJ1-1
TGTGCCAGCAGGATAGCAGGGGTTCAATACGAGCAGTACTTC	CASRIAGVQYEQYF	TRBV12-3	TRBJ2-7
TGTGCCAGCAGCTTAGCGACGGGGGCGGGTTCCGAGCAGTACTTC	CASSLATGAGSEQYF	TRBV7-9	TRBJ2-7
TGTGCCAGCAGCATCAGTCGCGGAGGGAGAAGGTCTGGAAACACCATATATTTT	CASSISRGGRRSGNTIYF	TRBV7-4	TRBJ1-3
TGTGCCAGCAGCTTAGTCACGGGTCAGAACACCGGGGAGCTGTTTTTT	CASSLVTGQNTGELFF	TRBV7-4	TRBJ2-2
TGTGCCACCAGTGATACAGGGACGACAGGGGCTAACTATGGCTACACCTTC	CATSDTGTTGANYGYTF	TRBV24-1	TRBJ1-2
TGTGCCAGCTCACCAGGGGTACTAGCGGGAGGACCCTTC	CASSPGVLAGGPF	TRBV18	TRBJ2-7
TGCGCCAGCAGCCAAGATGCGGGAGGTAAACCTGAAGCTTTCTTT	CASSQDAGGKPEAFF	TRBV4-1	TRBJ1-1
TGTGCCACCAGTGATAAGGAGACGGGGACCTCCACTGAAGCTTTCTTT	CATSDKETGTSTEAFF	TRBV24-1	TRBJ1-1
TGCAGCGTTACCCAGCTAGCGGGGGGGCCGGGGGCGAACACCGGGGAGCTGTTTTTT	CSVTQLAGGPGANTGELFF	TRBV29-1	TRBJ2-2
TGTGCCAGCAGTTGCCGGGACTCCTACGAGCAGTACTTC	CASSCRDSYEQYF	TRBV27	TRBJ2-7
TGTGCCAGCAGCGGTGGAGCCAAGGCCGAGCAGTACTTC	CASSGGAKAEQYF	TRBV7-3	TRBJ2-7
TGTGCCAGCAGCGTGTTTGCAGGTACTGAAGCTTTCTTT	CASSVFAGTEAFF	TRBV5-4	TRBJ1-1
TGCGCCAGCAGCTTGCCTTTGATTGGCACAGATACGCAGTATTTT	CASSLPLIGTDTQYF	TRBV5-1	TRBJ2-3
TGTGCCAGCAGCTTAGGCCTAGGAGCCGGGACAGGGGAGGGGAAATGCAATCAGCCCCAGCATTTT	CASSLGLGAGTGEGKCNQPQHF	TRBV13	TRBJ1-5
TGCGCCAGCAGCTTGTACTTTGGCGTGGACCATCAGCCCCAGCATTTT	CASSLYFGVDHQPQHF	TRBV5-1	TRBJ1-5
TGTGCCTCCATTGAGGGTATCACCGCTGAAGCTTTCTTT	CASIEGITAEAFF	TRBV6-3	TRBJ1-1
TGTGCCAGCAGGGGTAAAACGGAGACCCAGTACTTC	CASRGKTETQYF	TRBV6-2	TRBJ2-5
TGCGCCAGCAGCCGTGGCTACCTTACGCGCGGAAATGAGCAGTTCTTC	CASSRGYLTRGNEQFF	TRBV5-1	TRBJ2-1
TGTGCCAGCAGATGGGACAGGGGTAGTCTCTACGAGCAGTACTTC	CASRWDRGSLYEQYF	TRBV12-3	TRBJ2-7
TGTGCCAGCAGTTCATCCCGGAATGAGCAGTTCTTC	CASSSSRNEQFF	TRBV12-3	TRBJ2-1
TGTGCCAGCAAAGACGCAAGTCGCCTAGCCAAAAACATTCAGTACTTC	CASKDASRLAKNIQYF	TRBV7-6	TRBJ2-4
TGTGCCAGCAGCGCGGAGGTTACCACTCAGCCCCAGCATTTT	CASSAEVTTQPQHF	TRBV7-8	TRBJ1-5
TGTGCCAGCAGCCAGGGATCGGGACAGGGGACGCATAGCAATCAGCCCCAGCATTTT	CASSQGSGQGTHSNQPQHF	TRBV3-1	TRBJ1-5
TGTGCCAGCAGTTTCTTATCAACACCTGGGTCCTACGAGCAGTACTTC	CASSFLSTPGSYEQYF	TRBV27	TRBJ2-7
TGTGCCAGCAGTTCCCGAGGCAGGTCCTACAATGAGCAGTTCTTC	CASSSRGRSYNEQFF	TRBV6-3	TRBJ2-1
TGTGCCAGCAGCACACCAGGGTGGGCTGGAAACACCATATATTTT	CASSTPGWAGNTIYF	TRBV13	TRBJ1-3
TGTGCCAGCAGCAGGGGACAGGGCCCGGGGGAATCAAAGGGTTCCGGCACTGAAGCTTTCTTT	CASSRGQGPGESKGSGTEAFF	TRBV7-2	TRBJ1-1
TGTGCCAGCGAATCAGCAAGTGCGGGAGGGGACTATGGCTACACCTTC	CASESASAGGDYGYTF	TRBV6-2	TRBJ1-2
TGTGCCATCTTTGGGCACAATGAGCAGTTCTTC	CAIFGHNEQFF	TRBV6-5	TRBJ2-1
TGTGCCAGCAGCCTACAGGGGCCGAGTCAACATCAGCCCCAGCATTTT	CASSLQGPSQHQPQHF	TRBV6-1	TRBJ1-5
TGTGCCACCAGCCTCGTAAGCTCCTACGAGCAGTACTTC	CATSLVSSYEQYF	TRBV24-1	TRBJ2-7
TGTGCCAGCAGCCATCGAGGGGTAGGCGAGACCCAGTACTTC	CASSHRGVGETQYF	TRBV14	TRBJ2-5
TGTGCCAGCAGTGAATCAGCGGCTAACTATGGCTACACCTTC	CASSESAANYGYTF	TRBV6-1	TRBJ1-2
TGTGCCAGCAAAAGGACCAAGGCCTACGAGCAGTACTTC	CASKRTKAYEQYF	TRBV6-4	TRBJ2-7
TGCAGTGCTAGAGGTACTAGCGGAGTGAAAGGGGGGGGCACAGATACGCAGTATTTT	CSARGTSGVKGGGTDTQYF	TRBV20-1	TRBJ2-3
TGTGCCAGCAGCACAAGGAAGGGGGGGCTGGAGAACTATGGCTACACCTTC	CASSTRKGGLENYGYTF	TRBV9	TRBJ1-2
TGTGCCAGCCGATGGGGCCGGGAGACCCAGTACTTC	CASRWGRETQYF	TRBV19	TRBJ2-5
TGTGCCAGCAGCCTTGGGACCGGCTCTGACAATGAGCAGTTCTTC	CASSLGTGSDNEQFF	TRBV4-2	TRBJ2-1
TGTGCCAGCAGCGGATCTTCAGCCAAAAGCTACGAGCAGTACTTC	CASSGSSAKSYEQYF	TRBV13	TRBJ2-7
TGTGCCAGCAGCCAAGAAACGACGGGACAGGGGGAAGCTTTCTTT	CASSQETTGQGEAFF	TRBV4-2	TRBJ1-1
TGTGCCAGCAGCGGGGTGATGGAGACCCAGTACTTC	CASSGVMETQYF	TRBV9	TRBJ2-5
TGTGCCAGCAGAGGGATCCCCGGGACACGATCTGGAAACACCATATATTTT	CASRGIPGTRSGNTIYF	TRBV11-2	TRBJ1-3
TGTGCCAGCAGCTTACGGTCACAGAAAGGCTACACCTTC	CASSLRSQKGYTF	TRBV11-2	TRBJ1-2
TGTGCCAGCAGCAACAGGGGGTTCTTCTCTGCCCCCACAGATACGCAGTATTTT	CASSNRGFFSAPTDTQYF	TRBV9	TRBJ2-3
TGTGCCAGCAGCTCGGGAAAGGGCAGGAACACTGAAGCTTTCTTT	CASSSGKGRNTEAFF	TRBV27	TRBJ1-1
TGTGCCAGCAGCCAGGGGCAGCCCCAGCATTTT	CASSQGQPQHF	TRBV5-8	TRBJ1-5
TGCGCCAGCAGCTTGGTAATCGGTTGCTCTGGGGCCAACGTCCTGACTTTC	CASSLVIGCSGANVLTF	TRBV5-1	TRBJ2-6
TGTGCCACCCCAATATCCAGGTCAACCGGGACAGGGGACTCGGGTGAGACCCAGTACTTC	CATPISRSTGTGDSGETQYF	TRBV10-3	TRBJ2-5
TGTGCCAGCAGCTTGGAACAGCGGAGATGCTGCACCGGGGAGCTGTTTTTT	CASSLEQRRCCTGELFF	TRBV5-4	TRBJ2-2
TGTGCCAGCAGTTTCCGGGGCGTGAACACCGGGGAGCTGTTTTTT	CASSFRGVNTGELFF	TRBV28	TRBJ2-2
TGTGCCAGCAGTTGCCCCCCAAGCGACAGGGGAAACACCATATATTTT	CASSCPPSDRGNTIYF	TRBV12-4	TRBJ1-3
TGTGCCAGCCGTTCGGCCGGGGGCCACCGCAATCAGCCCCAGCATTTT	CASRSAGGHRNQPQHF	TRBV2	TRBJ1-5
TGTGCCACCAGTGAGCTGCATAGCGGGAGGCCCTACGAGCAGTACTTC	CATSELHSGRPYEQYF	TRBV24-1	TRBJ2-7
TGCAGCGTTGCTGCAACGACAGGCACCGGGGAGCTGTTTTTT	CSVAATTGTGELFF	TRBV29-1	TRBJ2-2
TGTGCCAGCAGCAATGCGGGGATTAATTCACCCCTCCACTTT	CASSNAGINSPLHF	TRBV11-3	TRBJ1-6
TGTGCCAGCAGCCAAGCCGCAAAATGGGGGCGGGAGTTTTCCTACGAGCAGTACTTC	CASSQAAKWGREFSYEQYF	TRBV3-1	TRBJ2-7
TGTGCCAGCGCAAAACCAGGGCCGATGAACACTGAAGCTTTCTTT	CASAKPGPMNTEAFF	TRBV9	TRBJ1-1
TGTGCCAGCAGTTCTCCCGGAAACCCCGGGACTAGCGGGTGTGACGAGCAGTACTTC	CASSSPGNPGTSGCDEQYF	TRBV6-8	TRBJ2-7
TGTGCCAGCAGCTTACGGTCCAGAGCGGGGACCCAGTACTTC	CASSLRSRAGTQYF	TRBV7-2	TRBJ2-5
TGCAGCGTCAAGGGGACAAGGTTTAATGAAAAACTGTTTTTT	CSVKGTRFNEKLFF	TRBV29-1	TRBJ1-4
TGTGCCAGCAGGAGGGCGGGGGGTAATCAGCCCCAGCATTTT	CASRRAGGNQPQHF	TRBV12-4	TRBJ1-5
TGCGCCAGCAGGAAAACGTGGGGTTCCCTCTACACCTTC	CASRKTWGSLYTF	TRBV10-1	TRBJ1-2
TGTGCCAGTAGTCCCAGTGCGGGAGGCACAGATACGCAGTATTTT	CASSPSAGGTDTQYF	TRBV19	TRBJ2-3
TGTGCCAGTCGAGAACAAAGGGGATTCACCGAGCAGTACTTC	CASREQRGFTEQYF	TRBV25-1	TRBJ2-7
TGTGCCAGCAACCGACAGGACGTAGGTGAGCAGTTCTTC	CASNRQDVGEQFF	TRBV27	TRBJ2-1
TGTGCCAGCAGCGATAGGAACGGGGGTTATTGTATACCAACTAATGAAAAACTGTTTTTT	CASSDRNGGYCIPTNEKLFF	TRBV5-6	TRBJ1-4
TGTGCCAGCTCACCCGACTTTCCAGAACCCCGACTCAATCAGCCCCAGCATTTT	CASSPDFPEPRLNQPQHF	TRBV18	TRBJ1-5
TGTGCCAGCAGTCGCATTACGGGGACAGGGGTCAACTATGGCTACACCTTC	CASSRITGTGVNYGYTF	TRBV9	TRBJ1-2
TGTGCCAGCAGCTTGGATAGCAGGAGCCCTGTAAATCAGCCCCAGCATTTT	CASSLDSRSPVNQPQHF	TRBV5-6	TRBJ1-5
TGTGCCAGCAGCCCAAAGGGGACACTAGACAATGAGCAGTTCTTC	CASSPKGTLDNEQFF	TRBV5-5	TRBJ2-1
TGTGCCAGCAGTAAAAGACAGGGACCCACCGGGGAGCTGTTTTTT	CASSKRQGPTGELFF	TRBV28	TRBJ2-2
TGCAAGTTCCTGGCGGTAGGATTTGGTAATGAGCAGTTCTTC	CKFLAVGFGNEQFF	TRBV20-1	TRBJ2-1
TGTGCCAGCAGCTTAGGGCCCACCTTGCCGGGACAGGGAGTCGTTGAAAAACTGTTTTTT	CASSLGPTLPGQGVVEKLFF	TRBV7-6	TRBJ1-4
TGTGCCAGCAGCTCCAAACGGGGGACAGGGGGGGAAATGAACACTGAAGCTTTCTTT	CASSSKRGTGGEMNTEAFF	TRBV7-7	TRBJ1-1
TGTGCCAGCAGCTTCAGGTCTCAGGGGCCCTACGAGCAGTACTTC	CASSFRSQGPYEQYF	TRBV7-3	TRBJ2-7
TGCAGTTTACCAGCGGTTCGGAATAGCAATCAGCCCCAGCATTTT	CSLPAVRNSNQPQHF	TRBV20-1	TRBJ1-5
TGTGCCTGGAGTAATCCGGGACAGACCGGCACAGATACGCAGTATTTT	CAWSNPGQTGTDTQYF	TRBV30	TRBJ2-3
TGTGCCAGCAGTTTTCCCCGGGGGGTAGGTAAGGGTTCCTACGAGCAGTACTTC	CASSFPRGVGKGSYEQYF	TRBV12-3	TRBJ2-7
TGTGCCAGCAGTTTGGGAGGAATTTCCTACGAGCAGTACTTC	CASSLGGISYEQYF	TRBV12-4	TRBJ2-7
TGTGCCACCAGAACCTTAGGACTACATAGCAATCAGCCCCAGCATTTT	CATRTLGLHSNQPQHF	TRBV24-1	TRBJ1-5
TGTGCCAGCAGTTTCCTGGAGAGCGGGGAGGGGTATAGCAATCAGCCCCAGCATTTT	CASSFLESGEGYSNQPQHF	TRBV12-3	TRBJ1-5
TGCGCCAGCAGCTTGAAAGCCGGGGTATATAATGAAAAACTGTTTTTT	CASSLKAGVYNEKLFF	TRBV5-1	TRBJ1-4
TGTGCCACCCCACACCGGAAGGAGCCCCAGCATTTT	CATPHRKEPQHF	TRBV15	TRBJ1-5
TGTGCCACCTTCGTTGGAAACACTGAAGCTTTCTTT	CATFVGNTEAFF	TRBV15	TRBJ1-1
TGTGCCCTGACCTCCAACTATGGCTACACCTTC	CALTSNYGYTF	TRBV19	TRBJ1-2
TGTGCCAGTAAAGAATCCCACCAAGAGACCCAGTACTTC	CASKESHQETQYF	TRBV19	TRBJ2-5
TGTGCCAGCAAAAACAATAGCTCCTACAATGAGCAGTTCTTC	CASKNNSSYNEQFF	TRBV6-5	TRBJ2-1
TGTGCCACCAGTGATTTGCAGGACAGCTACAATGAGCAGTTCTTC	CATSDLQDSYNEQFF	TRBV24-1	TRBJ2-1
TGTGCCACCAGTGAATCAGGGGTCAGATACGGTGCAACTAATGAAAAACTGTTTTTT	CATSESGVRYGATNEKLFF	TRBV24-1	TRBJ1-4
TGTGCCAGCAGTGAATTCGGTTTTCCGGGACTAGCGGGGTGGGATCCCGGGGAGCTGTTTTTT	CASSEFGFPGLAGWDPGELFF	TRBV6-4	TRBJ2-2
TGTGCCAGCAGTTATCCCCTTTCGACGTATAGCAATCAGCCCCAGCATTTT	CASSYPLSTYSNQPQHF	TRBV6-5	TRBJ1-5
TGTGCCAGCAGTTATGTGACCCACACCGACGGTAACAATGAGCAGTTCTTC	CASSYVTHTDGNNEQFF	TRBV6-5	TRBJ2-1
TGTGCCAGCAGCTGGCTACCTAGGGACAGGGGCTCCCCGAATGGCTACACCTTC	CASSWLPRDRGSPNGYTF	TRBV7-2	TRBJ1-2
TGTGCCAGCAGCTTAGACCCAGGGGGCGAACCGGATCATGGCTACACCTTC	CASSLDPGGEPDHGYTF	TRBV7-4	TRBJ1-2
TGCGCCAGCCCGGACTTAGGGTTCTACGAGCAGTACTTC	CASPDLGFYEQYF	TRBV4-1	TRBJ2-7
TGTGCCAGTAGTTGTCCCGCTAGGAATTCACCCCTCCACTTT	CASSCPARNSPLHF	TRBV19	TRBJ1-6
TGTGCCAGCAGCTATCTAGCAGATAGCAATGAGCAGTTCTTC	CASSYLADSNEQFF	TRBV5-5	TRBJ2-1
TGCAGTGCTGTCTGGGAGGAGTGGGGGGTGTGGTACACAGATACGCAGTATTTT	CSAVWEEWGVWYTDTQYF	TRBV20-1	TRBJ2-3
TGCAGCGTTGACGAGGCCAGACTAGCGGGGGGGCCGGGCTACGAGCAGTACTTC	CSVDEARLAGGPGYEQYF	TRBV29-1	TRBJ2-7
TGTGCCAGTAGCCCCGGGGCTTACGACAGGCAAAGCAATCAGCCCCAGCATTTT	CASSPGAYDRQSNQPQHF	TRBV19	TRBJ1-5
TGCAGTGCTGATAGGAACGACAGGGGTAGGAGGGAGAATCAGCCCCAGCATTTT	CSADRNDRGRRENQPQHF	TRBV20-1	TRBJ1-5
TGTGCCACCAGCAGAGCCGGGGGGGTCATGAACACTGAAGCTTTCTTT	CATSRAGGVMNTEAFF	TRBV15	TRBJ1-1
TGTGCCAGCAGCCCCTCCGGCGGCATTTTTGAGACCCAGTACTTC	CASSPSGGIFETQYF	TRBV14	TRBJ2-5
TGCGCCAGCAGTGCCTTCCTCCGGGACCAAAACACTGAAGCTTTCTTT	CASSAFLRDQNTEAFF	TRBV10-2	TRBJ1-1
TGTGCCAGCAGCGCTACGAGGGGGCTCCCGCTTGAAAAACTGTTTTTT	CASSATRGLPLEKLFF	TRBV7-6	TRBJ1-4
TGTGCCAGCAGCCAAAATAGACATGAGCAGTTCTTC	CASSQNRHEQFF	TRBV3-1	TRBJ2-1
TGTGCCAGCAGTTATCCTCGGTTCGGGGAGGGTATCTACGAGCAGTACTTC	CASSYPRFGEGIYEQYF	TRBV6-6	TRBJ2-7
TGTGCCAGCAGCCGCGTTCTTAGGGATTTCCAGAATTCACCCCTCCACTTT	CASSRVLRDFQNSPLHF	TRBV27	TRBJ1-6
TGTGCCAGCAGCTTATCCGTCCGGGGGACGGGCTACAATGAGCAGTTCTTC	CASSLSVRGTGYNEQFF	TRBV7-2	TRBJ2-1
TGTGCCAGCAGCCGGGTGACTAGCGGGAGGGCCCACCAAGAAGGCGGGGGGATGAACACTGAAGCTTTCTTT	CASSRVTSGRAHQEGGGMNTEAFF	TRBV7-9	TRBJ1-1
TGTGCCAGCAGCGTCCATCCGACGGTGTCAGGGGAAAAACTGTTTTTT	CASSVHPTVSGEKLFF	TRBV5-6	TRBJ1-4
TGCGCCAGCAGCCCGGCTGAGCAGTACTTC	CASSPAEQYF	TRBV5-1	TRBJ2-7
TGTGCCAGCAGCGAGGCTACGTACGAGCAGTACTTC	CASSEATYEQYF	TRBV7-9	TRBJ2-7
TGTGCCAGCAGACAAGGCTGGGTAAACGAGCAGTACTTC	CASRQGWVNEQYF	TRBV12-4	TRBJ2-7
TGCAGCGTTGAAGTTCCTAGCGGCCAGGACAATGAGCAGTTCTTC	CSVEVPSGQDNEQFF	TRBV29-1	TRBJ2-1
TGTGCCAGCAGTTTACAAACGCCGGCCAAAGTTGCCTACGAGCAGTACTTC	CASSLQTPAKVAYEQYF	TRBV12-3	TRBJ2-7
TGTGCCTGGACCCGGGCCCTCCTCTACGAGCAGTACTTC	CAWTRALLYEQYF	TRBV30	TRBJ2-7
TGTGCCATCAGTGCAGCGGGGGTCCGGCAAGAGACCCAGTACTTC	CAISAAGVRQETQYF	TRBV10-3	TRBJ2-5
TGTGCCAGCGACGGGGACATTCAGTACTTC	CASDGDIQYF	TRBV6-5	TRBJ2-4
TGTGCCAGCAGGTCGACAGGGCCCTTATACGAGCAGTACTTC	CASRSTGPLYEQYF	TRBV7-9	TRBJ2-7
TGTGCCTGGATAACAGGGGGGGGGGGCCTTCTACACGAGCAGTACTTC	CAWITGGGGLLHEQYF	TRBV30	TRBJ2-7
TGTGCCAGCAGCTTACTACGGGCCAATCAGCCCCAGCATTTT	CASSLLRANQPQHF	TRBV7-9	TRBJ1-5
TGTGCCAGCAGTTTAGAAAATAAGGGTTTGAAGCCCACTACAGATACGCAGTATTTT	CASSLENKGLKPTTDTQYF	TRBV27	TRBJ2-3
TGCAGCGTTGAAGAGAGGAGCTACAATGAGCAGTTCTTC	CSVEERSYNEQFF	TRBV29-1	TRBJ2-1
TGCAGTGCTAGAGATCAGGGGGACAGCGGTGAAGCTTTCTTT	CSARDQGDSGEAFF	TRBV20-1	TRBJ1-1
TGTGCCAGGTGGCAGGGCTCTGGAAACACCATATATTTT	CARWQGSGNTIYF	TRBV6-1	TRBJ1-3
TGTGCCAGCGGAGCCCGGGGCTACACCTTC	CASGARGYTF	TRBV7-3	TRBJ1-2
TGCGCCAGCAAACACCAGGGGGCAATCCGAAAGTACTTC	CASKHQGAIRKYF	TRBV10-1	TRBJ2-7
TGCAGTGCTAGAGAAAATGGGACAGATCGGGATAATTCACCCCTCCACTTT	CSARENGTDRDNSPLHF	TRBV20-1	TRBJ1-6
TGTGCCAGCAGCTCGAATTGGACTAGCGGGGGTAGCTCCTACAATGAGCAGTTCTTC	CASSSNWTSGGSSYNEQFF	TRBV7-4	TRBJ2-1
TGTGCCAGCAGCTTGCCCCGGGGGTCCGTCCCCCTCCACTTT	CASSLPRGSVPLHF	TRBV5-4	TRBJ1-6
TGTGCCAGCAGCGGGCAATGTGGGGGGGCCTTTGATGAGCAGTTCTTC	CASSGQCGGAFDEQFF	TRBV11-2	TRBJ2-1
TGTGCCAGTAGTATGGCACCTCGGGACAGGGTTGACAATGAGCAGTTCTTC	CASSMAPRDRVDNEQFF	TRBV19	TRBJ2-1
TGTGCCAGCAGCCGCGCAATTCAGAAGCTCTACGAGCAGTACTTC	CASSRAIQKLYEQYF	TRBV9	TRBJ2-7
TGCAGCGTTGTTGGCCTCACGACGCGGACCACTGAAGCTTTCTTT	CSVVGLTTRTTEAFF	TRBV29-1	TRBJ1-1
TGTGCCAGCAGCCTTTCGGGACAGGGAGAATATCAGCCCCAGCATTTT	CASSLSGQGEYQPQHF	TRBV11-2	TRBJ1-5
TGTGCCAGCAGCTTCAAGACTAGTAAGTATGAGCAGTTCTTC	CASSFKTSKYEQFF	TRBV7-2	TRBJ2-1
TGTGCCAGCAGAAAGGATCTTGGACAGGGCCGAGACTATGGCTACACCTTC	CASRKDLGQGRDYGYTF	TRBV6-2	TRBJ1-2
TGTGCCAGTTACAGGGATAAAGATACGCAGTATTTT	CASYRDKDTQYF	TRBV24-1	TRBJ2-3
TGCAGTGCTAGGGATCCCCTGAGAACGGCCGGGGAGCTGTTTTTT	CSARDPLRTAGELFF	TRBV20-1	TRBJ2-2
TGTGCCACCAGTGGTTCAGGGGGCAATCAGCCCCAGCATTTT	CATSGSGGNQPQHF	TRBV24-1	TRBJ1-5
TGTGCCAGCACCCCACTGGGTGAGGTCGGCTACACCTTC	CASTPLGEVGYTF	TRBV7-4	TRBJ1-2
TGTGCCAGCAGCTTTTCGCAACCTGAAGCTTTCTTT	CASSFSQPEAFF	TRBV7-4	TRBJ1-1
TGTGCCAGCAGCCAAGGAAAGTCTAATGAAAAACTGTTTTTT	CASSQGKSNEKLFF	TRBV3-1	TRBJ1-4
TGTGCCAGCAGCCCAACCAGGACGGTACCTCGGGGGACTGAAGCTTTCTTT	CASSPTRTVPRGTEAFF	TRBV4-2	TRBJ1-1
TGTGCCATCAGTGAGTCGGTAGACAGGGTTTCCCATTCACCCCTCCACTTT	CAISESVDRVSHSPLHF	TRBV10-3	TRBJ1-6
TGTGCCATCATTGAGGGACTAGCGGGGGGTAATGAGCAGTTCTTC	CAIIEGLAGGNEQFF	TRBV10-3	TRBJ2-1
TGCGCCAGCAGCTTGCGAACCGGGGGCAATCAGCCCCAGCATTTT	CASSLRTGGNQPQHF	TRBV5-1	TRBJ1-5
TGTGCCAGCAGCTTAGAACAGGGCCCTCTGGACACTGAAGCTTTCTTT	CASSLEQGPLDTEAFF	TRBV7-3	TRBJ1-1
TGTGCTAGTGGTTTGGTAAAGTCTCCGGGGGAGACCTACGAGCAGTACTTC	CASGLVKSPGETYEQYF	TRBV12-5	TRBJ2-7
TGTGCCACCAGCAGCGAACCGGGCGAGCAGTACTTC	CATSSEPGEQYF	TRBV15	TRBJ2-7
TGTGCCAGCAGTTACAATCCACTAGCGGGAGCCTCAAACACCGGGGAGCTGTTTTTT	CASSYNPLAGASNTGELFF	TRBV6-2	TRBJ2-2
TGTGCCAGCAGTTATCCGGGGGGGGCGGATCGCACAGATACGCAGTATTTT	CASSYPGGADRTDTQYF	TRBV6-5	TRBJ2-3
TGTGCCAGCAGCTATTATCAGCCCCAGCATTTT	CASSYYQPQHF	TRBV7-9	TRBJ1-5
TGTGCCAGCAGCGCTTTTACAGATAGTACCCTTGCCCCCTACGAGCAGTACTTC	CASSAFTDSTLAPYEQYF	TRBV13	TRBJ2-7
TGTGCCAGCAGCCGACTAAGACAGGGCGGGAAGGAAGCTTTCTTT	CASSRLRQGGKEAFF	TRBV2	TRBJ1-1
TGCAGCGCGTTACATCAGGGGGTACTCTATAATTCACCCCTCCACTTT	CSALHQGVLYNSPLHF	TRBV29-1	TRBJ1-6
TGTGCCAGCTCACCACTCAAAGACAGGGGAGGGGGCCTGTTTTTT	CASSPLKDRGGGLFF	TRBV18	TRBJ1-4
TGTGCCAGCAGCGTAGGCTTCGAATTTGGGAGCTCCTACAATGAGCAGTTCTTC	CASSVGFEFGSSYNEQFF	TRBV9	TRBJ2-1
TGTGCCAGCAGTTACGTTGGGGGCCTGGGAGGTAGATATCAGCCCCAGCATTTT	CASSYVGGLGGRYQPQHF	TRBV6-5	TRBJ1-5
TGCAGTGCTAGCCCCAGAGACAGGGGAGATACGCAGTATTTT	CSASPRDRGDTQYF	TRBV20-1	TRBJ2-3
TGTGCCAGCAGCTTCATTCCTATTCAGGGAAGGAGCTCCTACAATGAGCAGTTCTTC	CASSFIPIQGRSSYNEQFF	TRBV5-4	TRBJ2-1
TGTGCCAGCAGTTACAAGCTCGAGCAGTACTTC	CASSYKLEQYF	TRBV6-5	TRBJ2-7
TGCGCCAGCAGCGAAATAGCGGGAGTTAAAAGCACAGATACGCAGTATTTT	CASSEIAGVKSTDTQYF	TRBV5-1	TRBJ2-3
TGCAGTGCAAGTCAGGGGAGGGATGCCAAAAACATTCAGTACTTC	CSASQGRDAKNIQYF	TRBV20-1	TRBJ2-4
TGTGCCAGCAGCTTAGCGGCCCTTCTGAACACTGAAGCTTTCTTT	CASSLAALLNTEAFF	TRBV7-2	TRBJ1-1
TGTGCCAGCAGTTACCTACCAAGGGGCCGGCTAGCCAAAAACATTCAGTACTTC	CASSYLPRGRLAKNIQYF	TRBV6-8	TRBJ2-4
TGCGCCAGGGATCTTGGACTGAGAGGGAACTATGGCTACACCTTC	CARDLGLRGNYGYTF	TRBV5-1	TRBJ1-2
TGTGCCAGCAGCGAAGGACATAGCTCCTATAATTCACCCCTCCACTTT	CASSEGHSSYNSPLHF	TRBV7-8	TRBJ1-6
TGTGCCAGCAGCGCAATAGACTGGACAGATACGCAGTATTTT	CASSAIDWTDTQYF	TRBV9	TRBJ2-3
TGTGCCTGGAGTGGCCACGGGAGTAACACTGAAGCTTTCTTT	CAWSGHGSNTEAFF	TRBV30	TRBJ1-1
TGCAGTGCTAGGGTAGTCTCCTACGAGCAGTACTTC	CSARVVSYEQYF	TRBV20-1	TRBJ2-7
TGTGCCACCAGTGATTCTAGGACAGGGGCCTCGAATTCACCCCTCCACTTT	CATSDSRTGASNSPLHF	TRBV24-1	TRBJ1-6
TGTGCCAGCAGCGGCCTGGGATCCGGGTACGAGCAGTACTTC	CASSGLGSGYEQYF	TRBV11-3	TRBJ2-7
TGTGCCAGCAGCCTCACTGGGACAGTGAGGTATACTGGAGTTAATTCACCCCTCCACTTT	CASSLTGTVRYTGVNSPLHF	TRBV13	TRBJ1-6
TGTGCCAGCAGCTTAGGAACAGCGAGGGGGATAGGAGAGCAGTTCTTC	CASSLGTARGIGEQFF	TRBV7-9	TRBJ2-1
TGCAGTGCCGGTCCGCGACAGGGGGTATCTAATGAGCAGTTCTTC	CSAGPRQGVSNEQFF	TRBV20-1	TRBJ2-1
TGCAGTGCGGGCCGACCGGGACCCTGGAACACTGAAGCTTTCTTT	CSAGRPGPWNTEAFF	TRBV20-1	TRBJ1-1
TGTGCCAGCAGCCACACCGGACTTGGGTATTACGAGCAGTACTTC	CASSHTGLGYYEQYF	TRBV4-2	TRBJ2-7
TGTGCCAGCAGTTTACCCAGGGGGCAAATCTATGGCTACACCTTC	CASSLPRGQIYGYTF	TRBV27	TRBJ1-2
TGCGCCAGCAGGGAACGGACAGGCGCGCGGCGGCTTAACTCCTACGAGCAGTACTTC	CASRERTGARRLNSYEQYF	TRBV10-1	TRBJ2-7
TGCGCCAGCAGTGAGGTGGGCCCCGGAGGCCACGAGCAGTACTTC	CASSEVGPGGHEQYF	TRBV10-1	TRBJ2-7
TGCACGGTTTACAGTTGGGCGCTCGCCTACAATGAGCAGTTCTTC	CTVYSWALAYNEQFF	TRBV29-1	TRBJ2-1
TGCATGCTGTCCGGGACAGCACTGTACGAGCAGTACTTC	CMLSGTALYEQYF	TRBV20-1	TRBJ2-7
TGCGCCAGCAGCTCCGGGACAGGGTGGGCTGGCTACACCTTC	CASSSGTGWAGYTF	TRBV5-1	TRBJ1-2
TGTGCCAGCAGCTTAGCAATTACGAGCACCGGGGAGCTGTTTTTT	CASSLAITSTGELFF	TRBV13	TRBJ2-2
TGCGCCAGCAGCCGTCAGAATAGCGGGCACGCCCACTCCTACGAGCAGTACTTC	CASSRQNSGHAHSYEQYF	TRBV5-1	TRBJ2-7
TGTGCCAGCAGCGTAACCGGGCGGCATTGCAATCAGCCCCAGCATTTT	CASSVTGRHCNQPQHF	TRBV9	TRBJ1-5
TGTGCCAGCAGCGAGCCGGGACGCTATGGCTACACCTTC	CASSEPGRYGYTF	TRBV13	TRBJ1-2
TGTGCCAGCAGCCCGGAAAGGAGCTACGAGCAGTACTTC	CASSPERSYEQYF	TRBV3-1	TRBJ2-7
TGCGCCAGGGACTACGAGCAGTACTTC	CARDYEQYF	TRBV10-1	TRBJ2-7
TGTGCCAGCAGCTTGGCCCTTGTAGCGCTTAACTACGAGCAGTACTTC	CASSLALVALNYEQYF	TRBV5-4	TRBJ2-7
TGTGCCAGCAGCGGCCCCCCCCAGGGAGTATACAATGAGCAGTTCTTC	CASSGPPQGVYNEQFF	TRBV7-2	TRBJ2-1
TGCGCCAGCAGCCGTCGGGTTTTTCTAGCCAAAAACATTCAGTACTTC	CASSRRVFLAKNIQYF	TRBV4-1	TRBJ2-4
TGCGCCAGCTCCCCTCGCGGCTACACCTTC	CASSPRGYTF	TRBV4-1	TRBJ1-2
TGCGCCAGTCTCTTCGCCTACGAGCAGTACTTC	CASLFAYEQYF	TRBV4-1	TRBJ2-7
TGTGCCAGCAGCATTGGAGGGGCTTTCTTT	CASSIGGAFF	TRBV5-5	TRBJ1-1
TGCAGTGCTAGAGCCTCGGGGGAATCGAACTACGAGCAGTACTTC	CSARASGESNYEQYF	TRBV20-1	TRBJ2-7
TGCGCCAGCCCCCTTTACAATCAGCCCCAGCATTTT	CASPLYNQPQHF	TRBV5-1	TRBJ1-5
TGTGCCAGCAGCCAGGGTCCGGGGGGGAACACTGAAGCTTTCTTT	CASSQGPGGNTEAFF	TRBV6-2	TRBJ1-1
TGTGCCAGCGACCAACGCTGGACAGATACGCAGTATTTT	CASDQRWTDTQYF	TRBV9	TRBJ2-3
TGTGCCAGCAGCCCCCAGGGCGGCTCCGGGGAGCTGTTTTTT	CASSPQGGSGELFF	TRBV28	TRBJ2-2
TGTGCCAGCAGTTACGAGCTTGAAGCTTTCTTT	CASSYELEAFF	TRBV6-5	TRBJ1-1
TGTGCCAGCAGCGCCGGATTCCGGGACAGTAATAGCAATCAGCCCCAGCATTTT	CASSAGFRDSNSNQPQHF	TRBV5-4	TRBJ1-5
TGTTTCGGGGGGGATGAGCAGTTCTTC	CFGGDEQFF	TRBV7-2	TRBJ2-1
TGTGCCAGCAGGAGTCCCTACGAGCAGTACTTC	CASRSPYEQYF	TRBV6-4	TRBJ2-7
TGTGCCATCAGTGCGGGGACTAGCGGGTTCTGGTACCAAGAGACCCAGTACTTC	CAISAGTSGFWYQETQYF	TRBV10-3	TRBJ2-5
TGTGCCATGGACAGGGAGAGGTGCCCAGCTGAAGCTTTCTTT	CAMDRERCPAEAFF	TRBV25-1	TRBJ1-1
TGTGCCAGCAGCGGTCGCGGGAGTCAAAATCAGCCCCAGCATTTT	CASSGRGSQNQPQHF	TRBV7-3	TRBJ1-5
TGCGCCGGACAGGGTGACACTGAAGCTTTCTTT	CAGQGDTEAFF	TRBV10-2	TRBJ1-1
TGTGCCAGCAGCCTAACCGTGCGGGGGGACAACGCCGGGGAGCTGTTTTTT	CASSLTVRGDNAGELFF	TRBV4-2	TRBJ2-2
TGTGCCAGCTCACCACGCAGGGTCAATCAGCCCCAGCATTTT	CASSPRRVNQPQHF	TRBV18	TRBJ1-5
TGTGCCAGTAGAGACGAATGCTACGAGCAGTACTTC	CASRDECYEQYF	TRBV19	TRBJ2-7
TGTGCCAGCAGTTACTCCTGGCTACCCGGCCCCGAGACCCAGTACTTC	CASSYSWLPGPETQYF	TRBV6-5	TRBJ2-5
TGTGCCAGCAGCTTAGATCGCAGGACAGAGGGTGGGGAGCTGTTTTTT	CASSLDRRTEGGELFF	TRBV7-3	TRBJ2-2
TGTGCCACCAGTGATTTGCAAATGAAACTAGCGGGAGGCGAGCAGTACTTC	CATSDLQMKLAGGEQYF	TRBV24-1	TRBJ2-7
TGTGCCAGCAGCGTAGAGGGGTGCAATGAGACCCAGTACTTC	CASSVEGCNETQYF	TRBV9	TRBJ2-5
TGCGCCAGCAAGGGCCTCAGAAATCGACAGGGGGCCGGTTGCTACGAGCAGTACTTC	CASKGLRNRQGAGCYEQYF	TRBV4-1	TRBJ2-7
TGTGCCAGCAGTGAACGGCGTATTCAAACTTCAGATGAGACCCAGTACTTC	CASSERRIQTSDETQYF	TRBV25-1	TRBJ2-5
TGTGCCTGGAGTGTCAATGAGGCTGAAAAACTGTTTTTT	CAWSVNEAEKLFF	TRBV30	TRBJ1-4
TGCGCCAGCAGCCAAGAAGGGGCCTGGGAACGCACAGATACGCAGTATTTT	CASSQEGAWERTDTQYF	TRBV4-1	TRBJ2-3
TGTGCCAGCAGCCCGGGACAGGGACAGGGCGAGACCCAGTACTTC	CASSPGQGQGETQYF	TRBV13	TRBJ2-5
TGTGCCAGCAGCAACCTAGCTAATTTCTATACGCAGTATTTT	CASSNLANFYTQYF	TRBV5-4	TRBJ2-3
TGTGCCACCGCACATACCGGGGTCTGGGGTTCCTACAATGAGCAGTTCTTC	CATAHTGVWGSYNEQFF	TRBV24-1	TRBJ2-1
TGTGCTAGCGAGATATCACCCCTCCACTTT	CASEISPLHF	TRBV7-7	TRBJ1-6
TGTGCCAGCAGTGGGAGGAATGAAAGGGACCCGGGCGATGAAAAACTGTTTTTT	CASSGRNERDPGDEKLFF	TRBV25-1	TRBJ1-4
TGCAGCGTTGTGGGGGTCCTCCCTGAGCAGTTCTTC	CSVVGVLPEQFF	TRBV29-1	TRBJ2-1
TGTGCCAGCAGTTGTGAAGGTCTCGGGGTCATGACCTACGAGCAGTACTTC	CASSCEGLGVMTYEQYF	TRBV6-9	TRBJ2-7
TGTGCCAGCAGTGGGGCGGTAAACACTGAAGCTTTCTTT	CASSGAVNTEAFF	TRBV28	TRBJ1-1
TGTGCCAGCAGCGGACGAAGGAGGGGGTCCTCCTACGAGCAGTACTTC	CASSGRRRGSSYEQYF	TRBV7-9	TRBJ2-7
TGTGCCAGCAGTGGGCGAAGCACTGAAGCTTTCTTT	CASSGRSTEAFF	TRBV2	TRBJ1-1
TGTGCCAGCAGCAGATCTCAGGTAACTGCCAAAAACATTCAGTACTTC	CASSRSQVTAKNIQYF	TRBV5-6	TRBJ2-4
TGTGCCAGCAGTTTAATCACGTACGAGCAGTACTTC	CASSLITYEQYF	TRBV12-4	TRBJ2-7
TGTGCCTCGACAGCGGCGGATTTACCTGGTGCTTTCTTT	CASTAADLPGAFF	TRBV9	TRBJ1-1
TGTGCGATGGAGAGGGGCAATCAGCCCCAGCATTTT	CAMERGNQPQHF	TRBV24-1	TRBJ1-5
TGCGCCAGCAGCTCAGCCGACAGGGGGTTCTACTATGGCTACACCTTC	CASSSADRGFYYGYTF	TRBV5-1	TRBJ1-2
TGTGCCAGCAGAGCCCAACCCGCGGGAGGGGATCTAGCCAAAAACATTCAGTACTTC	CASRAQPAGGDLAKNIQYF	TRBV6-5	TRBJ2-4
TGTGCCAGCAGCCAAGGAAAAGGAAATCTCAGGGGGCGGGCCCAGCATTTT	CASSQGKGNLRGRAQHF	TRBV14	TRBJ1-5
TGCGCCAGCAGCTTTTTCGGACAGCCTAAGTCTGAAGCTTTCTTT	CASSFFGQPKSEAFF	TRBV5-1	TRBJ1-1
TGCAGTGCTAGAGATTCTCGGACATGGCCCCTCCACTTT	CSARDSRTWPLHF	TRBV20-1	TRBJ1-6
TGTGCCAGCAGACACTCAGGGACCCTGGTCTCCTACGAGCAGTACTTC	CASRHSGTLVSYEQYF	TRBV28	TRBJ2-7
TGTGCCAGCAGCTGGTCAAAGGGGAGGGGCAGCAATGAGCAGTTCTTC	CASSWSKGRGSNEQFF	TRBV12-3	TRBJ2-1
TGTGCCAGCAGCTTCCGGGAAATGGCCTACGAGCAGTACTTC	CASSFREMAYEQYF	TRBV7-6	TRBJ2-7
TGTGCCATCAGCGGTAGCGGGGCCTCCGGGGAGCTGTTTTTT	CAISGSGASGELFF	TRBV10-3	TRBJ2-2
TGCAGTGCTACCTGCTGGGGGCTAACAGATACGCAGTATTTT	CSATCWGLTDTQYF	TRBV20-1	TRBJ2-3
TGTGCCTGGACCCGGGACAGAATAGAGGACTATGGCTACACCTTC	CAWTRDRIEDYGYTF	TRBV30	TRBJ1-2
TGTGCCAGCAGCTTAGTGGACAGGGGGGGCTCCTACGAGCAGTACTTC	CASSLVDRGGSYEQYF	TRBV11-2	TRBJ2-7
TGTGCCAGTAGTACCCCTTGTTGGGGTAGGTGCTCTGGGGCCAACGTCCTGACTTTC	CASSTPCWGRCSGANVLTF	TRBV19	TRBJ2-6
TGTGCCAGCAGCCAACCGGGACAGGGAACGCAAGAAGCTTTCTTT	CASSQPGQGTQEAFF	TRBV13	TRBJ1-1
TGTGCCAGCAGCCAAGTTCCTCAAGGGGCCTACGAGCAGTACTTC	CASSQVPQGAYEQYF	TRBV4-2	TRBJ2-7
TGTGCCAGCAGTGACTCGAACGGGTACTATTGGAGGGTCACCAATGAGCAGTTCTTC	CASSDSNGYYWRVTNEQFF	TRBV6-4	TRBJ2-1
TGCGCCAGCAGCGAACCTTTCTATGGCTACACCTTC	CASSEPFYGYTF	TRBV5-1	TRBJ1-2
TGCGCCAGCAGCGGGGAGGGCTATAACGAGCAGTACTTC	CASSGEGYNEQYF	TRBV5-1	TRBJ2-7
TGTGCCACGTATAACGGGGGACACTGGGGACGGACGTCCTACGAGCAGTACTTC	CATYNGGHWGRTSYEQYF	TRBV24-1	TRBJ2-7
TGTGCCAGCAGCCGCGCAGGGTGCTCTGGGGCCAACGTCCTGACTTTC	CASSRAGCSGANVLTF	TRBV7-3	TRBJ2-6
TGTGCCAGCTCGGACAGTGAATTCTGCAATCAGCCCCAGCATTTT	CASSDSEFCNQPQHF	TRBV6-1	TRBJ1-5
TGTGCCAGCAGTGAGATTTCCCAGGGGGGGGACTACGAGCAGTACTTC	CASSEISQGGDYEQYF	TRBV6-1	TRBJ2-7
TGTGCCAGCAGCTTAGCCCTCCGACAGGGTGTTAGCTCCTATAATTCACCCCTCCACTTT	CASSLALRQGVSSYNSPLHF	TRBV7-2	TRBJ1-6
TGTGCCAGCAGCGGGACAGGACACACTGAAGCTTTCTTT	CASSGTGHTEAFF	TRBV13	TRBJ1-1
TGCAGCGTAGGACCCTACCACTCGAGTGCTTCCTGCAATCAGCCCCAGCATTTT	CSVGPYHSSASCNQPQHF	TRBV29-1	TRBJ1-5
TGCAGTGCTAGTGAGGAGGGACGCACAGATACGCAGTATTTT	CSASEEGRTDTQYF	TRBV20-1	TRBJ2-3
TGTGCCAGCAGCTTACCCGGGACAGCCGGCTACACCTTC	CASSLPGTAGYTF	TRBV7-9	TRBJ1-2
TGTGCTAGCAGCTTAGGGAGGAATGAGATGAACACTGAAGCTTTCTTT	CASSLGRNEMNTEAFF	TRBV7-7	TRBJ1-1
TGTGCCACCAGCCCGAGACGGGACGAAAAACTGTTTTTT	CATSPRRDEKLFF	TRBV15	TRBJ1-4
TGCAGTGAGTCTATCCAGGCCCCGAACACTGAAGCTTTCTTT	CSESIQAPNTEAFF	TRBV20-1	TRBJ1-1
TGTGCCAGCAGCCCTCTAGGACGGTATTTT	CASSPLGRYF	TRBV13	TRBJ2-3
TGTGCCAGCAGAATCCACTACGAGCAGTACTTC	CASRIHYEQYF	TRBV11-3	TRBJ2-7
TGTGCCAGCCTACGACTAGCGGTGTTAACCTACGAGCAGTACTTC	CASLRLAVLTYEQYF	TRBV7-9	TRBJ2-7
TGCGCCAGCAGCCGTTCAGGCGATCCCTCTGGAAACACCATATATTTT	CASSRSGDPSGNTIYF	TRBV5-1	TRBJ1-3
TGCGCCAGCCTTTCACTAGCGGGAGTCGGAAAAAATGAAAAACTGTTTTTT	CASLSLAGVGKNEKLFF	TRBV5-1	TRBJ1-4
TGCAGTGCTCTGACACGGACCAATCAGCCCCAGCATTTT	CSALTRTNQPQHF	TRBV20-1	TRBJ1-5
TGTGCCAGCAGCCAGAAAGCAGGACATGGATTGGACGAGGGAATGAGGGCTAGCAATCAGCCCCAGCATTTT	CASSQKAGHGLDEGMRASNQPQHF	TRBV13	TRBJ1-5
TGCGCCATTTTTGGACAGGGAGGTAATTCACCCCTCCACTTT	CAIFGQGGNSPLHF	TRBV5-1	TRBJ1-6
TGTGCCAGCAGCCCCACAAAAGGGGCCGGGACAGGGCGAATAGGCGAGCAGTACTTC	CASSPTKGAGTGRIGEQYF	TRBV13	TRBJ2-7
TGCAGTGCTAGGGGGACTGAGCAGTACTTC	CSARGTEQYF	TRBV20-1	TRBJ2-7
TGCAGTGCGACCCGAGGGGGGGACGTTCGTCATACACGGAACATTCAGTACTTC	CSATRGGDVRHTRNIQYF	TRBV20-1	TRBJ2-4
TGCGCCAGCAGCTTATGTAGCGCCGGGACAGTGGACTATGGCTACACCTTC	CASSLCSAGTVDYGYTF	TRBV5-1	TRBJ1-2
TGTGCCAGTAGTATTCATAGGTACAATGAGCAGTTCTTC	CASSIHRYNEQFF	TRBV19	TRBJ2-1
TGTGCCAGCTCACCACACCCCGGGCAGGGAGAGAGGAACTATGGCTACACCTTC	CASSPHPGQGERNYGYTF	TRBV18	TRBJ1-2
TGTGCCAGCAGTGACGTCCGGGACCGACGAAACTATGGCTACACCTTC	CASSDVRDRRNYGYTF	TRBV6-4	TRBJ1-2
TGTGCCAGCAGCTCCACGTCACGAGTACCCCGGGACAGGGACCCAGAGCAGCCCCAGCATTTT	CASSSTSRVPRDRDPEQPQHF	TRBV7-6	TRBJ1-5
TGTGCCAGCAGCTTACGGGACATTCAGCCCCAGCATTTT	CASSLRDIQPQHF	TRBV11-3	TRBJ1-5
TGCAGCCCCACAGCGGGAGCAGATACGCAGTATTTT	CSPTAGADTQYF	TRBV29-1	TRBJ2-3
TGTGCCCCCGCTAGGCTCGGGGCCAACGTCCTGACTTTC	CAPARLGANVLTF	TRBV7-2	TRBJ2-6
TGTGCCAGCAGCGTCCGGGATGGTAAGCTTAGCTCCTACGAGCAGTACTTC	CASSVRDGKLSSYEQYF	TRBV6-1	TRBJ2-7
TGTGCCAGCAGCCACGTTCTTTACAGGGTACAGCCCCAGCATTTT	CASSHVLYRVQPQHF	TRBV5-4	TRBJ1-5
TGTGCCAGCAGTTTTACTAGCGGGAGGGCCGCCTACGAGCAGTACTTC	CASSFTSGRAAYEQYF	TRBV12-4	TRBJ2-7
TGTGCCACCATCTCTAGCGGGCGCAATGAGCAGTTCTTC	CATISSGRNEQFF	TRBV24-1	TRBJ2-1
TGCGCCAGCAGCCAAGAGCAACACAGGGCACCGCAGTACTTC	CASSQEQHRAPQYF	TRBV4-1	TRBJ2-7
TGTGCCAGCAGCGACAGGTCTTCCGGCGCCCCTGGAAACACCATATATTTT	CASSDRSSGAPGNTIYF	TRBV13	TRBJ1-3
TGCAGTGCGTCGATGCTCGGAGGCTACGAGCAGTACTTC	CSASMLGGYEQYF	TRBV20-1	TRBJ2-7
TGTGCCAGCAGTTTAGCCGGGACAGGCAACACTGAAGCTTTCTTT	CASSLAGTGNTEAFF	TRBV12-4	TRBJ1-1
TGTGCCAGCAGCTTAGGGGGAGGGGGGCTCGGGGAGCTGTTTTTT	CASSLGGGGLGELFF	TRBV7-2	TRBJ2-2
TGTGCCAGCAGCCAGTCAGGGGGGTACGAGCAGTACTTC	CASSQSGGYEQYF	TRBV7-2	TRBJ2-7
TGCGCCAGCAGCCCGAGGCCTCAGCGGGGGGGCGAGCAGTACTTC	CASSPRPQRGGEQYF	TRBV4-3	TRBJ2-7
TGTGCCAGCAGTTCAGCAAACGGCCACACTGAAGCTTTCTTT	CASSSANGHTEAFF	TRBV6-5	TRBJ1-1
TGTGCCAGAACCCCCCCGGCGGACAGGCAGCCCCAGCATTTT	CARTPPADRQPQHF	TRBV6-4	TRBJ1-5
TGTGCCAGCAGCGTGATCCTGGGCCCGTCTGCCTACAATGAGCAGTTCTTC	CASSVILGPSAYNEQFF	TRBV7-3	TRBJ2-1
TGTGCCAGCAGTCCATACCGCCTCGGGCCGGGAAGGACCAGTGAACCACTGACCCCAATGGTAGAGACCCAGTACTTC	CASSPYRLGPGRTSEPLTPMVETQYF	TRBV27	TRBJ2-5
TGTGCCAGCAGCTTGATAGCGGGAGGCCTAGAGAGCTCCTACGAGCAGTACTTC	CASSLIAGGLESSYEQYF	TRBV11-2	TRBJ2-7
TGCGCCAGCAGCTTGGTTGCGGGAGCGCCAAAGGGGCAGACCCAGTACTTC	CASSLVAGAPKGQTQYF	TRBV5-1	TRBJ2-5
TGTGCCAGCAGTGATATCGGGGGTAACGTTAACTATGGCTACACCTTC	CASSDIGGNVNYGYTF	TRBV6-1	TRBJ1-2
TGTGCCAGCATAGTTAGCCGGGACATGGGAGGGGATACGCAGTATTTT	CASIVSRDMGGDTQYF	TRBV2	TRBJ2-3
TGTGCCAGCAGCTTAGGCAACCTCCCTAACCTGACAGGTGCGCCCACAGATACGCAGTATTTT	CASSLGNLPNLTGAPTDTQYF	TRBV7-9	TRBJ2-3
TGTGCCAGCAAAACCCCGACGCGGGAAGCTTTCTTT	CASKTPTREAFF	TRBV6-3	TRBJ1-1
TGTGCCAGCAGTTCCTTCCCCCCGGATTTAGAGACCCAGTACTTC	CASSSFPPDLETQYF	TRBV6-2	TRBJ2-5
TGCGCCAGCAGGGAGAAAAGACAGGATGAGCAGTACTTC	CASREKRQDEQYF	TRBV10-1	TRBJ2-7
TGTGCCAAAGACGTGTACGAGCAGTACTTC	CAKDVYEQYF	TRBV27	TRBJ2-7
TGTGCCAGTAGTATAGATGGTGGGCCAGGGGGCTACGAGCAGTACTTC	CASSIDGGPGGYEQYF	TRBV19	TRBJ2-7
TGTGCCAGCAGTTTACATAAAACCGAGGGTTACTATGGCTACACCTTC	CASSLHKTEGYYGYTF	TRBV28	TRBJ1-2
TGCAGTGCTAGGCCCCAGGCTAGCGGATACGAGCAGTACTTC	CSARPQASGYEQYF	TRBV20-1	TRBJ2-7
TGTGCCATCAATCAAACTAGCGGGAGGGAGAACACTGAAGCTTTCTTT	CAINQTSGRENTEAFF	TRBV10-3	TRBJ1-1
TGTGCCAGCAGTGACTCGGAGCCGGGACAGGGTACTTACCCTGCAACTAATGAAAAACTGTTTTTT	CASSDSEPGQGTYPATNEKLFF	TRBV6-4	TRBJ1-4
TGTGCCAGCAGCCTGACAGGGAGGGGGGGCGATTCACCCCTCCACTTT	CASSLTGRGGDSPLHF	TRBV13	TRBJ1-6
TGTGCCAGCAGCCTCGGGGCCCATGGCTACACCTTC	CASSLGAHGYTF	TRBV5-6	TRBJ1-2
TGTGCCAGCAGTGAAGTTCCGGGACAGGGGCAAACAGATACGCAGTATTTT	CASSEVPGQGQTDTQYF	TRBV2	TRBJ2-3
TGTGCCAGCAGCAATACCCGGTACCAAGAGACCCAGTACTTC	CASSNTRYQETQYF	TRBV28	TRBJ2-5
TGCGCCAGCAGTGAGAGGGACCCGCCTGAAAAACTGTTTTTT	CASSERDPPEKLFF	TRBV10-1	TRBJ1-4
TGTGCCACCAGTAAGACAAATGAGCAGTTCTTC	CATSKTNEQFF	TRBV24-1	TRBJ2-1
TGTGCTAACAAGTGCGGACAGGAATGGGGGGATAGCAATCAGCCCCAGCATTTT	CANKCGQEWGDSNQPQHF	TRBV6-4	TRBJ1-5
TGTGCCAGCAGCCAAGCAGGAGACACCGGGGAGCTGTTTTTT	CASSQAGDTGELFF	TRBV3-1	TRBJ2-2
TGTGCCAGCAGTTACCCAGTGGGGCTTTACGAGCAGTACTTC	CASSYPVGLYEQYF	TRBV6-2	TRBJ2-7
TGTGCCAGCAGTTCCGACAGTCTGGAAAAACTGTTTTTT	CASSSDSLEKLFF	TRBV6-5	TRBJ1-4
TGCGCCAGCCCACGTCGTTATACGGGACTCTACGAGCAGTACTTC	CASPRRYTGLYEQYF	TRBV10-1	TRBJ2-7
TGTGCCTGGAGTGAAACAAGGGGCTCCTACGAGCAGTACTTC	CAWSETRGSYEQYF	TRBV30	TRBJ2-7
TGTGCCAGCAGACGCCTGGTCAGACTAGGGGAGGAGACCCAGTACTTC	CASRRLVRLGEETQYF	TRBV12-4	TRBJ2-5
TGTGCCAGCAGATCCCCTGAGACGGGGACTAATGAAAAACTGTTTTTT	CASRSPETGTNEKLFF	TRBV6-2	TRBJ1-4
TGCAGTGCTAGAGAATACGGGACTCTGCGCTACGAGCAGTACTTC	CSAREYGTLRYEQYF	TRBV20-1	TRBJ2-7
TGTGCCAGCAAGAACCTGGGCCAGGGGGGGCCCCATGAGCAGTTCTTC	CASKNLGQGGPHEQFF	TRBV27	TRBJ2-1
TGTGCCATACTGAAGTACGAGCAGTACTTC	CAILKYEQYF	TRBV10-3	TRBJ2-7
TGTGCCAGCAGCTTAGCTTTAGGCAATGAAAAACTGTTTTTT	CASSLALGNEKLFF	TRBV7-9	TRBJ1-4
TGTGCCAGCAGCCGAGAACTTAACAGGGACACTGAAGCTTTCTTT	CASSRELNRDTEAFF	TRBV7-8	TRBJ1-1
TGCGCCAGCAGTTCTACGCCCGGGGGCAATTCACCCCTCCACTTT	CASSSTPGGNSPLHF	TRBV10-2	TRBJ1-6
TGCGCCAGCAGCTTGGGTGGCCAGTCGACCACCGGGGAGCTGTTTTTT	CASSLGGQSTTGELFF	TRBV5-1	TRBJ2-2
TGTGCCAGCAGCTTATGGCAGGGCCGGCAGTTCTTC	CASSLWQGRQFF	TRBV7-9	TRBJ2-1
TGTGCCAGCAGCCAAGAGCCACTAGCGGGTTGCACAGATACGCAGTATTTT	CASSQEPLAGCTDTQYF	TRBV3-1	TRBJ2-3
TGTGCCAGCAGCCGGACAGAGGGACATTACGGTGGAAACACCATATATTTT	CASSRTEGHYGGNTIYF	TRBV14	TRBJ1-3
TGCAGCGTCAGCCTAGACAGGGGGATGGGTAAAGAGAATTCACCCCTCCACTTT	CSVSLDRGMGKENSPLHF	TRBV29-1	TRBJ1-6
TGTGCCAGCAGCTGGTTGACAGGGGTTCCCTTTAACTATGGCTACACCTTC	CASSWLTGVPFNYGYTF	TRBV7-8	TRBJ1-2
TGTGCCAGCAGTTCCCGTTTCTTAGCTACCTACGAGCAGTACTTC	CASSSRFLATYEQYF	TRBV27	TRBJ2-7
TGTGCCAGCAGTGTCCTCGGGACAGGCTACGAGCAGTACTTC	CASSVLGTGYEQYF	TRBV6-1	TRBJ2-7
TGTGCCAGCAGCTTGGCCCCGGGACGGTATGAAGCTTTCTTT	CASSLAPGRYEAFF	TRBV5-6	TRBJ1-1
TGTGCCAGCAGTTATATGAGCAGGGAAGCTTTCTTT	CASSYMSREAFF	TRBV6-2	TRBJ1-1
TGTGCCAGCAGCCCCCGAAAAACCGGGACTAGACCCCTGGGCTACAATGAGCAGTTCTTC	CASSPRKTGTRPLGYNEQFF	TRBV9	TRBJ2-1
TGTGCCAGCAGCTTAGCTTGGGCCCGCGAGACCCAGTACTTC	CASSLAWARETQYF	TRBV7-9	TRBJ2-5
TGTGCCAGCAGCTCCCTTCTAGGGGGCTTCGGCTATGGCTACACCTTC	CASSSLLGGFGYGYTF	TRBV7-9	TRBJ1-2
TGCGCCAGCAGTGAGTCGGGGGGGGGAGTTGAAGCTTTCTTT	CASSESGGGVEAFF	TRBV10-2	TRBJ1-1
TGTGCCAGCAGCCAGCGAGAGGGGACAGGCTCTCGTGAGACCCAGTACTTC	CASSQREGTGSRETQYF	TRBV3-1	TRBJ2-5
TGTGCCAGCAGCTATCTAGAGGCCCGGGACAGGGGCTACGAGCAGTACTTC	CASSYLEARDRGYEQYF	TRBV11-2	TRBJ2-7
TGTGCCAGCAGTTTAACGCAGGCTCAGCCCCAGCATTTT	CASSLTQAQPQHF	TRBV6-6	TRBJ1-5
TGTGCCAGCAGTGGGGTCTACTGGGGTTACAATGAGCAGTTCTTC	CASSGVYWGYNEQFF	TRBV25-1	TRBJ2-1
TGCAGTGCTAGAGATTTCCGGGACAGCGGTAATGATAGCAATCAGCCCCAGCATTTT	CSARDFRDSGNDSNQPQHF	TRBV20-1	TRBJ1-5
TGTGCCATCAGGGGGCCCAGGGGGAAGGCTAACTACGAGCAGTACTTC	CAIRGPRGKANYEQYF	TRBV10-3	TRBJ2-7
TGTGCCACCCCACGGTCAGGGGTAAATTCACCCCTCCACTTT	CATPRSGVNSPLHF	TRBV15	TRBJ1-6
TGTGCCAACTCTGTGATCTCTGTGCGCTCCGGGACAGGGCCAATTCAAGAGACCCAGTACTTC	CANSVISVRSGTGPIQETQYF	TRBV7-3	TRBJ2-5
TGCGCCAGCAGCCCCAGCCGATACAATGAGCAGTTCTTC	CASSPSRYNEQFF	TRBV4-1	TRBJ2-1
TGCGCCAGCAGCGTACCCAAGGGAGATGGCTACACCTTC	CASSVPKGDGYTF	TRBV5-1	TRBJ1-2
TGTGCCTTCGGCGGGGGCACCGGGGAGCTGTTTTTT	CAFGGGTGELFF	TRBV30	TRBJ2-2
TGTGCCAGCAGCCACAAAATATTGGGCCTGCAAGAGACCCAGTACTTC	CASSHKILGLQETQYF	TRBV3-1	TRBJ2-5
TGTGCCAGCAGTTACAATGGAAGACTAGACCGCTACAATGAGCAGTTCTTC	CASSYNGRLDRYNEQFF	TRBV6-5	TRBJ2-1
TGTGCCAGCAGTTACCACCGAAGACAGGTATACTTC	CASSYHRRQVYF	TRBV6-5	TRBJ1-2
TGTGCCTGGAGTAGGGGTCAGCCCCAGCATTTT	CAWSRGQPQHF	TRBV30	TRBJ1-5
TGTGCCACCAAGACTTGGGGCTCCTACGAGCAGTACTTC	CATKTWGSYEQYF	TRBV19	TRBJ2-7
TGTGCCATCATTGGATGGATTGGCACAGATACGCAGTATTTT	CAIIGWIGTDTQYF	TRBV10-3	TRBJ2-3
TGTGCCAGCAGGTGGAAGGACCGGGACAGGAGCATGAACACTGAAGCTTTCTTT	CASRWKDRDRSMNTEAFF	TRBV6-1	TRBJ1-1
TGTGCCACCAGTGATTTGTTGGTATCTGACAGCTACTCCTACAATGAGCAGTTCTTC	CATSDLLVSDSYSYNEQFF	TRBV24-1	TRBJ2-1
TGTGCCTGGAGACCCCGACAGCTCTACGAGCAGTACTTC	CAWRPRQLYEQYF	TRBV30	TRBJ2-7
TGTGCCAGCAGCAAAGGGCCGAAGTCACCCCTCCACTTT	CASSKGPKSPLHF	TRBV13	TRBJ1-6
TGTGCCATCCCCGGGACTAGCGGGGGTGAGCAGTTCTTC	CAIPGTSGGEQFF	TRBV10-3	TRBJ2-1
TGTGCCAGCAGGATTAGCGGGTGCGGGAACACCGGGGAGCTGTTTTTT	CASRISGCGNTGELFF	TRBV11-3	TRBJ2-2
TGTGCCAGCAGTACGGCCAACGACAGGCCAGCGTACTTC	CASSTANDRPAYF	TRBV12-3	TRBJ2-4
TGTGCCAGCAGTGAACCCACAAGGAATCAGCCCCAGCATTTT	CASSEPTRNQPQHF	TRBV25-1	TRBJ1-5
TGTGCCAGCAGCCCGCATGTCAGGGTAAAGGGACCTAATTCACCCCTCCACTTT	CASSPHVRVKGPNSPLHF	TRBV9	TRBJ1-6
TGCAGTGCCAATCTAACTAGCGGGAGTAATCGATTCTTC	CSANLTSGSNRFF	TRBV20-1	TRBJ2-7
TGTGCCAGTAGCCCATGGCGGGCGGAGGTCGAGCAGTACTTC	CASSPWRAEVEQYF	TRBV19	TRBJ2-7
TGTGCCAGCAGCCAAAGCAGCCGGAATAATTCACCCCTCCACTTT	CASSQSSRNNSPLHF	TRBV3-1	TRBJ1-6
TGTGCCAGCATTCCAAAACTAGCGGGAGAAAGGCACGAGCAGTACTTC	CASIPKLAGERHEQYF	TRBV7-6	TRBJ2-7
TGTGCCAGCAGTGGGGCACCGCGAGTCCTTAATGAAAAACTGTTTTTT	CASSGAPRVLNEKLFF	TRBV27	TRBJ1-4
TGTGCCAGCAGCTTGGGACCCCCTTTCACTGAAGCTTTCTTT	CASSLGPPFTEAFF	TRBV5-5	TRBJ1-1
TGCGCCAGCAGCCCATCCGGTCCCAGGCAGTACGAGCAGTACTTC	CASSPSGPRQYEQYF	TRBV5-1	TRBJ2-7
TGTGCCAGCAGCCAACTTAACCCGGGACAGGGGAATCAGCCCCAGCATTTT	CASSQLNPGQGNQPQHF	TRBV3-1	TRBJ1-5
TGCAGCGACGGCGGACCGGAGACCCAGTACTTC	CSDGGPETQYF	TRBV29-1	TRBJ2-5
TGTGCCAGCAGCCTGACAACAACTGAAGCTTTCTTT	CASSLTTTEAFF	TRBV11-2	TRBJ1-1
TGTGCCACCAGTGACGAAGCTAGTGGCTCCTATAATTCACCCCTCCACTTT	CATSDEASGSYNSPLHF	TRBV24-1	TRBJ1-6
TGTGCCAGCAGCCCATGGAGGGGGTCCAGTGCATCCAGTCAGCCCCAGCATTTT	CASSPWRGSSASSQPQHF	TRBV7-2	TRBJ1-5
TGTGCCTGGACCCCCGCGGGAGCCGGTCAGCCCCAGCATTTT	CAWTPAGAGQPQHF	TRBV30	TRBJ1-5
TGTGCCAGCTACTCACCCTCAGAGACCCAGTACTTC	CASYSPSETQYF	TRBV27	TRBJ2-5
TGTGCCAGCAGTTATGAACGTTGGGTCCAAGAGACCCAGTACTTC	CASSYERWVQETQYF	TRBV6-5	TRBJ2-5
TGTGCCAGCAGCCAAGATAGACAGGGGGCGCTGAACACTGAAGCTTTCTTT	CASSQDRQGALNTEAFF	TRBV3-1	TRBJ1-1
TGTGCCACCAGTGATACGAACTCCCCGGGTAACGAGCAGTACTTC	CATSDTNSPGNEQYF	TRBV24-1	TRBJ2-7
TGCGCCAGCAGCTTAAAGACTAGCGGGAGGGGAGGGGCCCCGCTCACAGATACGCAGTATTTT	CASSLKTSGRGGAPLTDTQYF	TRBV5-1	TRBJ2-3
TGTGCCAGCAGTCCATACGCTTTCTTT	CASSPYAFF	TRBV12-3	TRBJ1-1
TGTGCCAGCAGCTTAGTGCTCGCCAGGGAGCCGCAGGGCTACACCTTC	CASSLVLAREPQGYTF	TRBV7-3	TRBJ1-2
TGCAGTGCTAGAGATCGGCGGACAGGGGCCTTTACTCGTCAAGAGACCCAGTACTTC	CSARDRRTGAFTRQETQYF	TRBV20-1	TRBJ2-5
TGTGCTAGGCCCTCCAATGAGCAGTTCTTC	CARPSNEQFF	TRBV7-7	TRBJ2-1
TGTGCCAGCAGCCCCTGGCTCCGGCCAGCTAACTATGGCTACACCTTC	CASSPWLRPANYGYTF	TRBV5-4	TRBJ1-2
TGCGCCAGCAGCTTAAGGGGGGGGGGCCTGGCCTACGAGCAGTACTTC	CASSLRGGGLAYEQYF	TRBV5-1	TRBJ2-7
TGTGCCAGCAGTGACTCTCCGGGGGCCTACGAGCAGTACTTC	CASSDSPGAYEQYF	TRBV6-4	TRBJ2-7
TGTGCCAGCAGCCGCAGAGCGCTTGCCTACGAGCAGTACTTC	CASSRRALAYEQYF	TRBV3-1	TRBJ2-7
TGTGCCAGCAGGCCCCAGGGCTACGAGCAGTACTTC	CASRPQGYEQYF	TRBV6-5	TRBJ2-7
TGTGCCTGGAGTGCAAGCTGTGGTGAAGCTTTCTTT	CAWSASCGEAFF	TRBV30	TRBJ1-1
TGTGCCAGCGGCAGCGTTTATGAGCAGTTCTTC	CASGSVYEQFF	TRBV7-9	TRBJ2-1
TGCGCCAGCAGCCTCCCCTGGGGGAGCTATAGCAATCAGCCCCAGCATTTT	CASSLPWGSYSNQPQHF	TRBV4-3	TRBJ1-5
TGCGCCAGCAGCTTGGTGGCCTATGGCTACACCTTC	CASSLVAYGYTF	TRBV5-1	TRBJ1-2
TGTGCCATTACCGGACTAGCGGGGGGGCCAGAGACCCAGTACTTC	CAITGLAGGPETQYF	TRBV2	TRBJ2-5
TGCGCCAGCAGCCAATCCGGGGAGGGTAACGATGGCTACACCTTC	CASSQSGEGNDGYTF	TRBV4-1	TRBJ1-2
TGTGCCAGCAGCCACGACAGTTTTGGAAACACTGAAGCTTTCTTT	CASSHDSFGNTEAFF	TRBV3-1	TRBJ1-1
TGTGCCAGTAGACGCGGTACAGATACGCAGTATTTT	CASRRGTDTQYF	TRBV19	TRBJ2-3
TGTGCCAGCAGCTTGGTAAAGGGCCGCACTGAAGCTTTCTTT	CASSLVKGRTEAFF	TRBV5-4	TRBJ1-1
TGTGCCAGCAAGGACAGGGGACTTAACACTGAAGCTTTCTTT	CASKDRGLNTEAFF	TRBV6-4	TRBJ1-1
TGTGCCAGCAGTGACGGGGGGCCGGGACCCTACGAGCAGTACTTC	CASSDGGPGPYEQYF	TRBV6-1	TRBJ2-7
TGTGCCAGCAGCTGGAGGGGATGGGGGGTAGGAAACACCATATATTTT	CASSWRGWGVGNTIYF	TRBV11-3	TRBJ1-3
TGTGCCAGATACGGAAGGGTCGCAGATACGCAGTATTTT	CARYGRVADTQYF	TRBV11-2	TRBJ2-3
TGTGCCAGCAGCACTATTGGACGGGGGATGGTCTACGAGCAGTACTTC	CASSTIGRGMVYEQYF	TRBV6-1	TRBJ2-7
TGTGCCAGCAGCCAAGAGGGTGGGACTAGGTGTAGCTCCTACGAGCAGTACTTC	CASSQEGGTRCSSYEQYF	TRBV3-1	TRBJ2-7
TGTGCCAGCAGTCACAGGGGGGGAAAGAATGTATACACCATATATTTT	CASSHRGGKNVYTIYF	TRBV6-4	TRBJ1-3
TGCGCCAGCACTAGGAACACGGTGTACTTC	CASTRNTVYF	TRBV5-1	TRBJ2-5
TGTGCCACCAGTGAAGGAGTCACAGGGTCGGGCTATAGCAATCAGCCCCAGCATTTT	CATSEGVTGSGYSNQPQHF	TRBV24-1	TRBJ1-5
TGTGCCATACCTAGAGGCGGGGGCGAGCAGTACTTC	CAIPRGGGEQYF	TRBV28	TRBJ2-7
TGTGCCAGCAGCACCACAGGGGGGTCGGCTTACACCGGGGAGCTGTTTTTT	CASSTTGGSAYTGELFF	TRBV7-2	TRBJ2-2
TGTGCCAGCAGGTCCTGGCGGGAGAAGGGACAGCCCCAGCATTTT	CASRSWREKGQPQHF	TRBV16	TRBJ1-5
TGTGCCAGCAGCGAAATAGCGGGGGAGAGGGACTACGAGCAGTACTTC	CASSEIAGERDYEQYF	TRBV13	TRBJ2-7
TGTGCCAGTAGCCGGGGGGGTACCACCGGGGAGCTGTTTTTT	CASSRGGTTGELFF	TRBV19	TRBJ2-2
TGTGCCAGCAGCTACGGGACAGGTCCTAAGGCTTTCTTT	CASSYGTGPKAFF	TRBV7-2	TRBJ1-1
TGTGCCAGCAGTCCTGCGGGAGGTAGGGGCCCTAGCAATCAGCCCCAGCATTTT	CASSPAGGRGPSNQPQHF	TRBV28	TRBJ1-5
TGTGCCAGCAGCGCGTCCCAGGAGGGATCCACAGATACGCAGTATTTT	CASSASQEGSTDTQYF	TRBV9	TRBJ2-3
TGTGCCAGCAGCCATTTCTCCGACAGATCCTACGAGCAGTACTTC	CASSHFSDRSYEQYF	TRBV14	TRBJ2-7
TGTGCCAGCAGCAGGCCGGTTCCGAACCAAGAGACCCAGTACTTC	CASSRPVPNQETQYF	TRBV2	TRBJ2-5
TGTGCCACCCCCGCGGGACTAGTTGATACGCAGTATTTT	CATPAGLVDTQYF	TRBV19	TRBJ2-3
TGTGCCAGCAGCAAACTTCGAGAATGCGAGCAGTACTTC	CASSKLRECEQYF	TRBV5-6	TRBJ2-7
TGTGCCAGCAGCTTTAGGAAGACTAGCGGGCTCTACGAGCAGTACTTC	CASSFRKTSGLYEQYF	TRBV11-2	TRBJ2-7
TGTGCCAGCAGCAAGGCAGGGGGGCGAGGCAATGAGCAGTTCTTC	CASSKAGGRGNEQFF	TRBV7-3	TRBJ2-1
TGTGCCAGGGTCGAAGGACAGGGGGAAGAAGCTTTCTTT	CARVEGQGEEAFF	TRBV19	TRBJ1-1
TGCGCCAGATTCCACTCAGCAGTAAGCAATCAGCCCCAGCATTTT	CARFHSAVSNQPQHF	TRBV10-1	TRBJ1-5
TGCGCCAGCAGCCAGGAGGCCCCTCAGACGAACACTGAAGCTTTCTTT	CASSQEAPQTNTEAFF	TRBV4-1	TRBJ1-1
TGTGCCAGTAGTATCCTAGGGGGCCAATACAATGAGCAGTTCTTC	CASSILGGQYNEQFF	TRBV19	TRBJ2-1
TGTGCCAGCAGTGAAGAGCGCGGGCTCACCGGGGAGCTGTTTTTT	CASSEERGLTGELFF	TRBV6-1	TRBJ2-2
TGTGCCTGGAGTGTACCTGCGACAGTATTTAACTATGGCTACACCTTC	CAWSVPATVFNYGYTF	TRBV30	TRBJ1-2
TGTGCTCGGGACAGAACCGGGAGGACCCTATATGGCTACACCTTC	CARDRTGRTLYGYTF	TRBV7-2	TRBJ1-2
TGTGCCAGCAGGTGGGGGACAGGGATAGACTATGGCTACACCTTC	CASRWGTGIDYGYTF	TRBV6-6	TRBJ1-2
TGTGCCAGCAGGGACTCGTTTGTTGGACAGTGGATTAATTCACCCCTCCACTTT	CASRDSFVGQWINSPLHF	TRBV5-4	TRBJ1-6
TGCAGTGCTAGCTGCAACAACGGGACCGGGCGCACAGATACGCAGTATTTT	CSASCNNGTGRTDTQYF	TRBV20-1	TRBJ2-3
TGTGCCAGCAGCTTAGTGGGTCGTGAAAGGGACAGGGGTAGATGGCCCTCCTACGAGCAGTACTTC	CASSLVGRERDRGRWPSYEQYF	TRBV11-2	TRBJ2-7
TGTGCCAGCAGCGTATCCCCCCTCTATAAGACCCAGTACTTC	CASSVSPLYKTQYF	TRBV7-3	TRBJ2-5
TGTGCCAAGGGGGCCGGGACTGCCGAGCAGTACTTC	CAKGAGTAEQYF	TRBV7-2	TRBJ2-7
TGTGCCAGCAGCTTGTCCACGGGGAGAAAAGAGACCCAGTACTTC	CASSLSTGRKETQYF	TRBV5-6	TRBJ2-5
TGTGCCTGGAGTGGCATCTCTCAGGGGGGAAAGACCCAGTACTTC	CAWSGISQGGKTQYF	TRBV30	TRBJ2-5
TGTGCCAGCAGCTTAGCTAAAAATCTACGTGAGTTCAGGGCCCTTAGCTCCTACAATGAGCAGTTCTTC	CASSLAKNLREFRALSSYNEQFF	TRBV7-9	TRBJ2-1
TGTGCCAGCAGTGAATATACAGGGTGGCGGGAGTCTGGAAACACCATATATTTT	CASSEYTGWRESGNTIYF	TRBV25-1	TRBJ1-3
TGTGCCAGCAGCTTGAAAGGGGGGTCCTCCTACAATGAGCAGTTCTTC	CASSLKGGSSYNEQFF	TRBV7-9	TRBJ2-1
TGTGCCAGCAGCGAGGGGCAGGGCGAGGATAACATTCAGTACTTC	CASSEGQGEDNIQYF	TRBV13	TRBJ2-4
TGTGCCAGCAGCTTAGCGACCCGAGGCCCTGAAGCTTTCTTT	CASSLATRGPEAFF	TRBV11-3	TRBJ1-1
TGTGCCAGCAGTTCGGCATCAGATACGCAGTATTTT	CASSSASDTQYF	TRBV12-4	TRBJ2-3
TGCAGTGCCCCCGGGACTAGCGGTCTAGGGAATGAGCAGTTCTTC	CSAPGTSGLGNEQFF	TRBV20-1	TRBJ2-1
TGTGCCAGCAGTGTAATTCCGGGACGGGGGGATACGCAGTATTTT	CASSVIPGRGDTQYF	TRBV28	TRBJ2-3
TGCGCCAGCAGCACGACTAGCGGACAGGACACAGATACGCAGTATTTT	CASSTTSGQDTDTQYF	TRBV5-1	TRBJ2-3
TGCGCCAGCAGTGAGTCGGGACGGACAGGCACAGATACGCAGTATTTT	CASSESGRTGTDTQYF	TRBV10-1	TRBJ2-3
TGTGCCACCAGCGGGGTGGAACCCTACGAGCAGTACTTC	CATSGVEPYEQYF	TRBV10-3	TRBJ2-7
TGTGCCAGCAGCTGGTACATTAATTCACCCCTCCACTTT	CASSWYINSPLHF	TRBV7-4	TRBJ1-6
TGTGCCACCAGGGGGGCGGACGAGCAGTACTTC	CATRGADEQYF	TRBV24-1	TRBJ2-7
TGTGCCAGCAGCGCCAAGATCCCACAACGGATACGGTGGGTAGCAACTAATGAAAAACTGTTTTTT	CASSAKIPQRIRWVATNEKLFF	TRBV9	TRBJ1-4
TGTGCCAGCAGGGCCAGGGCGACCCCCACTGAAGCTTTCTTT	CASRARATPTEAFF	TRBV6-4	TRBJ1-1
TGCAGTGCTAGAGATCCACAGAAAGGCAATCAGCCCCAGCATTTT	CSARDPQKGNQPQHF	TRBV20-1	TRBJ1-5
TGTGCCAGTAGTATAGCCAGGGGATCTTCTGGGACCTACGAGCAGTACTTC	CASSIARGSSGTYEQYF	TRBV19	TRBJ2-7
TGTGCCAGCAGTAGTCTGGGGGCAGTGTATAGCAATCAGCCCCAGCATTTT	CASSSLGAVYSNQPQHF	TRBV6-4	TRBJ1-5
TGTGCCATCAGGGACTACGAGCAGTACTTC	CAIRDYEQYF	TRBV2	TRBJ2-7
TGTGCCAGCAAGCATTTCAATGAGCAGTTCTTC	CASKHFNEQFF	TRBV2	TRBJ2-1
TGTGCCAGCAGTTTCCCTGGGGCTCGGTGGCACTATGGCTACACCTTC	CASSFPGARWHYGYTF	TRBV27	TRBJ1-2
TGCGCCAGCAGCCGCATCCCTGCCGGGACTAGCGGGAGGGGCTACAATGAGCAGTTCTTC	CASSRIPAGTSGRGYNEQFF	TRBV10-1	TRBJ2-1
TGCGCCAGCAGCTCCCTCCCATCCCGGGACCTGAAGAATAAGGTGGACGAGCAGTACTTC	CASSSLPSRDLKNKVDEQYF	TRBV5-1	TRBJ2-7
TGTGCCAGCAGCGGGGGCGGGAGGGGCCACAATGAGCAGTTCTTC	CASSGGGRGHNEQFF	TRBV11-3	TRBJ2-1
TGTGCCCGAACGGGGGGCTACACCTTC	CARTGGYTF	TRBV10-3	TRBJ1-2
TGCGCCAGCCAATCCATCCTAGCGGCACGTGGAAGGAGTGGGAAGCAAGAGACCCAGTACTTC	CASQSILAARGRSGKQETQYF	TRBV4-3	TRBJ2-5
TGCGCCAGCAGTGAGATACTCTTGGAACTCCCCGAAACGCCAGCAGGGGGCCGAAATAGCAATCAGCCCCAGCATTTT	CASSEILLELPETPAGGRNSNQPQHF	TRBV10-1	TRBJ1-5
TGTGCCAGCAGCCTTTACCGAAGGGGGCGAGACGGGGAGCTGTTTTTT	CASSLYRRGRDGELFF	TRBV6-1	TRBJ2-2
TGTGCCAGCAGCTCGGTGGGGAGGGGGTATGGCTACACCTTC	CASSSVGRGYGYTF	TRBV12-3	TRBJ1-2
TGCGCCAGCAGCCAAGATCTTCCATGGGGAGTGGGCCCCCGGACCGGGGAGCTGTTTTTT	CASSQDLPWGVGPRTGELFF	TRBV4-1	TRBJ2-2
TGTGCCAGCCCGTCGGAGCCCAAGGGCTACACCTTC	CASPSEPKGYTF	TRBV6-1	TRBJ1-2
TGTGCCACCAGTGATATCGGTCTCTTCTTC	CATSDIGLFF	TRBV24-1	TRBJ2-1
TGCGCCAGCAGCTTGGGTCGGGACAGGGACTCCACAGATACGCAGTATTTT	CASSLGRDRDSTDTQYF	TRBV5-1	TRBJ2-3
TGTGCCAGCAGCAAAGAATTTGGGAGGAGGCCCTACGAGCAGTACTTC	CASSKEFGRRPYEQYF	TRBV13	TRBJ2-7
TGTGCCAGCTGGTTTCTCCAGGGGGCGGACACCGGGGAGCTGTTTTTT	CASWFLQGADTGELFF	TRBV6-1	TRBJ2-2
TGCAGCGTTGTGGCCAGGAGGGAGCAGTACTTC	CSVVARREQYF	TRBV29-1	TRBJ2-7
TGTGCCAGCAGCTCCGTGACAATCGTCTACGAGCAGTACTTC	CASSSVTIVYEQYF	TRBV7-4	TRBJ2-7
TGTGCCAGTAGGGACGTACCTTACAGGACTAGCGGGAGCACAGATACGCAGTATTTT	CASRDVPYRTSGSTDTQYF	TRBV19	TRBJ2-3
TGTGCCAGCAGTTACTCGATTCCTAGCGGGAACGAGCAGTACTTC	CASSYSIPSGNEQYF	TRBV6-5	TRBJ2-7
TGCGCCAGCCAGGGGACAACCGGGGAGCTGTTTTTT	CASQGTTGELFF	TRBV10-1	TRBJ2-2
TGTGCCAGCAGATGCACCCAGGGAGATACGCAGTATTTT	CASRCTQGDTQYF	TRBV27	TRBJ2-3
TGTGCCAGCAGTGAAGCGGGAAATGTAGACTCTGGAAACACCATATATTTT	CASSEAGNVDSGNTIYF	TRBV2	TRBJ1-3
TGTGCCAGCAGTCCCATCGGACATGGTTGGACTGCCCACACTGAAGCTTTCTTT	CASSPIGHGWTAHTEAFF	TRBV28	TRBJ1-1
TGTGCCAGCAGCCAAGAGAATAGGGGATCCTACGAGCAGTACTTC	CASSQENRGSYEQYF	TRBV3-1	TRBJ2-7
TGCGCCAGCAGCCGTTGGACTGGTTTAGGGGGGGCTTACACCGGGGAGCTGTTTTTT	CASSRWTGLGGAYTGELFF	TRBV10-1	TRBJ2-2
TGTGCCTGGAGTGTACCTGATCAGGGGGTCCGGGGCTACACCTTC	CAWSVPDQGVRGYTF	TRBV30	TRBJ1-2
TGTGCCAGCAGCCCGTCTCTTGCGAACACCGGGGAGCTGTTTTTT	CASSPSLANTGELFF	TRBV6-5	TRBJ2-2
TGTGCCAGCAGTACACTAGCGGGAGGGGAAGCTTTCTTT	CASSTLAGGEAFF	TRBV2	TRBJ1-1
TGTGCCAGCAGTGACTACCAGCCCCTAACTAGCGCGGACCAAGAGACCCAGTACTTC	CASSDYQPLTSADQETQYF	TRBV6-1	TRBJ2-5
TGCAGTGCTAGAGATTCGAATACCGGGGAGCTGTTTTTT	CSARDSNTGELFF	TRBV20-1	TRBJ2-2
TGTGCCAGCAGCCAGGGTACTACACAGCCCCAGCATTTT	CASSQGTTQPQHF	TRBV6-4	TRBJ1-5
TGTGCCAGCAGCGCTACCAACGGCCGACAGGGGGCTTCAAATTCACCCCTCCACTTT	CASSATNGRQGASNSPLHF	TRBV5-6	TRBJ1-6
TGTGCCAGCAGGAAGACAGGGGGGGAGGTATGCACAGATACGCAGTATTTT	CASRKTGGEVCTDTQYF	TRBV12-4	TRBJ2-3
TGTGCCGTTAACAGGGACGAAGCTTTCTTT	CAVNRDEAFF	TRBV6-5	TRBJ1-1
TGCAGTGCTAGGACAGGGACAGGGGTCGATAATTCACCCCTCCACTTT	CSARTGTGVDNSPLHF	TRBV20-1	TRBJ1-6
TGTGCCAGCAGCTTAGGAGTCCCCGGCGGGGTATACGAGCAGTACTTC	CASSLGVPGGVYEQYF	TRBV7-2	TRBJ2-7
TGTGCCAGCAGTCTAAGTATGACCGGTAGGCTCTATGGCTACACCTTC	CASSLSMTGRLYGYTF	TRBV9	TRBJ1-2
TGTGCCAGCAGTTACTGGCAGGGATACGAGCAGTACTTC	CASSYWQGYEQYF	TRBV6-5	TRBJ2-7
TGTGCCAGCAGCCGTCCCGGGACTGAATTGAACACTGAAGCTTTCTTT	CASSRPGTELNTEAFF	TRBV27	TRBJ1-1
TGTGCCAGCAGCTGTGGGAGTGGGTTGACTAGCGGGGGCGCTCAAGAGACCCAGTACTTC	CASSCGSGLTSGGAQETQYF	TRBV5-4	TRBJ2-5
TGTGCCCCGTGCCAACAGGCAGTACAGGCCGGGGAGCTGTTTTTT	CAPCQQAVQAGELFF	TRBV7-3	TRBJ2-2
TGTGCCACTCCTGGAAGACCCCCTGATAATTCACCCCTCCACTTT	CATPGRPPDNSPLHF	TRBV24-1	TRBJ1-6
TGCAGTGCTAGTAGCGGGGAGCAGTACTTC	CSASSGEQYF	TRBV20-1	TRBJ2-7
TGCAGCGTTGAGAGCCCCAAACCCCGTGCAGGGCCCACTGAAGCTTTCTTT	CSVESPKPRAGPTEAFF	TRBV29-1	TRBJ1-1
TGCAGTGCGCAGGGGAGTGAGCAGTACTTC	CSAQGSEQYF	TRBV20-1	TRBJ2-7
TGTGCCAGCAGTTTTCAAGAGGGGGCTAGGGGGCGCACCGGGGAGCTGTTTTTT	CASSFQEGARGRTGELFF	TRBV27	TRBJ2-2
TGCAGCGTTGCTGACAGGTCTGGGAACACTGAAGCTTTCTTT	CSVADRSGNTEAFF	TRBV29-1	TRBJ1-1
TGCGCCAGCAGCCCCAAGGGGCCCCCATCTTCACCCCTCCACTTT	CASSPKGPPSSPLHF	TRBV5-1	TRBJ1-6
TGTGCCAGCAGCTTTCCAGGACTAAATGAGCAGTTCTTC	CASSFPGLNEQFF	TRBV7-6	TRBJ2-1
TGTGCCAGCAGTGAGGGGACAGAGAACACTGAAGCTTTCTTT	CASSEGTENTEAFF	TRBV25-1	TRBJ1-1
TGCGCCAGCAGCGGCGAGGAATTCCTTAGTAATGAGCAGTTCTTC	CASSGEEFLSNEQFF	TRBV5-1	TRBJ2-1
TGTGCCAGCAGCTTGAGTCCAGTTAAGGAGCAGTTCTTC	CASSLSPVKEQFF	TRBV5-6	TRBJ2-1
TGTGCCAGCAGTATGATCACGGGACACGCTAATGAAAAACTGTTTTTT	CASSMITGHANEKLFF	TRBV28	TRBJ1-4
TGCGCCAGCGGGACGCATAATCTCTTCCAGGGGAAGCCGTACTCCTATAATTCACCCCTCCACTTT	CASGTHNLFQGKPYSYNSPLHF	TRBV4-1	TRBJ1-6
TGTGCCTGGCGGACTTCGGGGCTTTCCTACGAGCAGTACTTC	CAWRTSGLSYEQYF	TRBV30	TRBJ2-7
TGTGCCAGCAGCACGCGGGAGGCAAAGGGCTACACCTTC	CASSTREAKGYTF	TRBV9	TRBJ1-2
TGTGCCAGCAGTTCGAGCATGGAGCAGTACTTC	CASSSSMEQYF	TRBV12-4	TRBJ2-7
TGCAGCGTTGAATCCCGGACAGGGAGCAATCAGCCCCAGCATTTT	CSVESRTGSNQPQHF	TRBV29-1	TRBJ1-5
TGCAGCGTTCTGTGGGACAGGGAACAGGCCGGCTACGAGCAGTACTTC	CSVLWDREQAGYEQYF	TRBV29-1	TRBJ2-7
TGTGCCAGCAGCATACCGCAGACGCCCAGCTCCTACAATGAGCAGTTCTTC	CASSIPQTPSSYNEQFF	TRBV13	TRBJ2-1
TGCGCCAGCAGCTTGGAAGAACTAGCGGGAGAAAACATTCAGTACTTC	CASSLEELAGENIQYF	TRBV5-1	TRBJ2-4
TGCAGCGCCTGGCCAGAGCAGGGAGGGAACACCGGGGAGCTGTTTTTT	CSAWPEQGGNTGELFF	TRBV29-1	TRBJ2-2
TGTGCCAGCAGCGCCCCCCCTTACACAGGGGGCCGGTATGGCTACACCTTC	CASSAPPYTGGRYGYTF	TRBV13	TRBJ1-2
TGCGCCAGCAGCTTTTCCCAACAGGGCTACGAGCAGTACTTC	CASSFSQQGYEQYF	TRBV4-1	TRBJ2-7
TGTGCCAGCAGGGTACTAATGAGGGGAAGTGCTAGCACAGATACGCAGTATTTT	CASRVLMRGSASTDTQYF	TRBV7-4	TRBJ2-3
TGTGCCAGCATAGGAGTTCGGGGGACAGGGGGGCCCTACGAGCAGTACTTC	CASIGVRGTGGPYEQYF	TRBV5-6	TRBJ2-7
TGTGCCAGCAGTTACTATAAGGGGGCCGCAAAAAACAAAGAAGGAGCCAAAAACATTCAGTACTTC	CASSYYKGAAKNKEGAKNIQYF	TRBV6-3	TRBJ2-4
TGTGCCACCAGCAGAGCCTCGTGGTTTAGGGGAAATGAGCAGTTCTTC	CATSRASWFRGNEQFF	TRBV15	TRBJ2-1
TGTGCCAGCAGTTACAGGGGGCTTACTGATGGCTACACCTTC	CASSYRGLTDGYTF	TRBV6-5	TRBJ1-2
TGTGCCAGCAGTTGGTTTCTTGACAGGGGGTCCAGTCTGAGGGTCACCTACGAGCAGTACTTC	CASSWFLDRGSSLRVTYEQYF	TRBV6-3	TRBJ2-7
TGTGCCAGTAGTATACCCCAAGCTGGGGGCTACGAGCAGTACTTC	CASSIPQAGGYEQYF	TRBV19	TRBJ2-7
TGCAGTGGGGTTAGCGGGGGCGAGCAGTACTTC	CSGVSGGEQYF	TRBV20-1	TRBJ2-7
TGTGCCAGCAGCTTGAAAAATCGGCCGTCGACATCACAGCCCCAGCATTTT	CASSLKNRPSTSQPQHF	TRBV5-6	TRBJ1-5
TGCGCCAGCAGTGAGTTTGGAGGGAACCACGAGCAGTACTTC	CASSEFGGNHEQYF	TRBV10-2	TRBJ2-7
TGCGCCAGCAGAAGAAGACAGAAGCTGGGAAACACCATATATTTT	CASRRRQKLGNTIYF	TRBV10-1	TRBJ1-3
TGTGCCAGCAGCGAGCCGGGACAGGGCCCGGATACGCAGTATTTT	CASSEPGQGPDTQYF	TRBV9	TRBJ2-3
TGTGCCAGCAGCTTGACCGATGGTCAGGGGGGATCCTTGACCCAGTACTTC	CASSLTDGQGGSLTQYF	TRBV5-6	TRBJ2-5
TGTGCCAGCATCCGGCCGGAAGGTGAGCAGTTCTTC	CASIRPEGEQFF	TRBV7-9	TRBJ2-1
TGCGCCAGCAGCAACTGGAGGGGAAGTAATCAGCCCCAGCATTTT	CASSNWRGSNQPQHF	TRBV5-1	TRBJ1-5
TGTGCCAGCAGTGCTACTTTAACTAATGAAAAACTGTTTTTT	CASSATLTNEKLFF	TRBV7-3	TRBJ1-4
TGTGCCAGCAGTGGTGTTGGTCGGTCTGGACCCCGCACTGAAGCTTTCTTT	CASSGVGRSGPRTEAFF	TRBV12-4	TRBJ1-1
TGTGCCAGCAGCTCCCGACTAGCGGAGGGCACAGATACGCAGTATTTT	CASSSRLAEGTDTQYF	TRBV5-6	TRBJ2-3
TGCGCCAGCAGCTCAGTAGGGGGGGGGATCTACGAGCAGTACTTC	CASSSVGGGIYEQYF	TRBV5-1	TRBJ2-7
TGTGCCAGCAGTTTAAATCCGACAGGGAACAAAGCTTTCTTT	CASSLNPTGNKAFF	TRBV27	TRBJ1-1
TGTGCCATCAGTGAGTCAGGTCGACAGGGTTTCTACACCTTC	CAISESGRQGFYTF	TRBV10-3	TRBJ1-2
TGTGCCAGCGACGAGACCCAGTACTTC	CASDETQYF	TRBV14	TRBJ2-5
TGTGCCAGCAGTGAGGGGGGACTGGACTATGGCTACACCTTC	CASSEGGLDYGYTF	TRBV25-1	TRBJ1-2
TGTGCCAGCAGTTACCCATTCGGCGACAATGAGCAGTTCTTC	CASSYPFGDNEQFF	TRBV6-6	TRBJ2-1
TGTGCCAGCAGAGCCAGGGAGCGTTTCGGGAACAACACTGAAGCTTTCTTT	CASRARERFGNNTEAFF	TRBV2	TRBJ1-1
TGCAGTGCTAGAGAGGCGGTAGGGATCGATGAGCAGTTCTTC	CSAREAVGIDEQFF	TRBV20-1	TRBJ2-1
TGTGCCAGTAGCTCCCGGGACAGGGGGTCTGGAAACACCATATATTTT	CASSSRDRGSGNTIYF	TRBV19	TRBJ1-3
TGTGCCATATCGAGGCAGCGCAATCAGCCCCAGCATTTT	CAISRQRNQPQHF	TRBV2	TRBJ1-5
TGTGCCAGCAGCGAAGGGTATAGCAATCAGCCCCAGCATTTT	CASSEGYSNQPQHF	TRBV9	TRBJ1-5
TGTGCCAGCAGCGCCCGGGACAGGGGGCCGGTCTTTGAAGCTTTCTTT	CASSARDRGPVFEAFF	TRBV5-6	TRBJ1-1
TGCAGTGCTAGCTTGGGGGATCGGAAGGGCACAGATACGCAGTATTTT	CSASLGDRKGTDTQYF	TRBV20-1	TRBJ2-3
TGCGCCAGCAGCCTACTGACCAGGGAGATGGGGGCGGGGGGCTACACCTTC	CASSLLTREMGAGGYTF	TRBV4-1	TRBJ1-2
TGTGCCAGCAGCGGGGGGGCCCCCCTGTCAACTGAAGCTTTCTTT	CASSGGAPLSTEAFF	TRBV9	TRBJ1-1
TGTGCCAGCAGCCAAGATGCCCTGGGGCAGAATCAGCCCCAGCATTTT	CASSQDALGQNQPQHF	TRBV14	TRBJ1-5
TGTGCCAGCAGTGATCAGGGGGCGCGGAAGATGAACACTGAAGCTTTCTTT	CASSDQGARKMNTEAFF	TRBV7-9	TRBJ1-1
TGTGCCAGCAGTCCCCCAGCGGCCGGGGAGCTGTTTTTT	CASSPPAAGELFF	TRBV25-1	TRBJ2-2
TGCGCCAGCAGCTTGGCCATATTCGTTGAGTTAAGCTCCGGTAACTACGAGCAGTACTTC	CASSLAIFVELSSGNYEQYF	TRBV5-1	TRBJ2-7
TGTGCCAGTAGTACAAAGCAGGTCTGGACTAGCGGGAAATACGAGCAGTACTTC	CASSTKQVWTSGKYEQYF	TRBV19	TRBJ2-7
TGCGCCAGCAGCTTGGCCCACAGGGCCGGAGAGACCCAGTACTTC	CASSLAHRAGETQYF	TRBV5-1	TRBJ2-5
TGTGCCATCAGTGAGGGGGGACAGAACTACGATTCACCCCTCCACTTT	CAISEGGQNYDSPLHF	TRBV10-3	TRBJ1-6
TGTGCCAGCATCCGTGGCAGGGATCAGCCCCAGCATTTT	CASIRGRDQPQHF	TRBV27	TRBJ1-5
TGTGCCAGCAGCTCCGACCACCGACAGGAGCCCCAGCATTTT	CASSSDHRQEPQHF	TRBV11-2	TRBJ1-5
TGTGCCAGCAGTTTGACTCCATCAACCGCCGGGACAGACACTGAAGCTTTCTTT	CASSLTPSTAGTDTEAFF	TRBV28	TRBJ1-1
TGTGCCAGCACGAACAGAGTCAATCAGCCCCAGCATTTT	CASTNRVNQPQHF	TRBV27	TRBJ1-5
TGTGCCAGCAGTTTAGACGAGAACACTGAAGCTTTCTTT	CASSLDENTEAFF	TRBV28	TRBJ1-1
TGTGCCAGCAGCTTGGGGGACATAGGGGGAAACACCATATATTTT	CASSLGDIGGNTIYF	TRBV7-9	TRBJ1-3
TGTGCCAGCCGACGGGAGGAGGACTACGAGCAGTACTTC	CASRREEDYEQYF	TRBV7-3	TRBJ2-7
TGTGCCAGCAGCTTAGCATCTGGGGTGGGGGTCAATCAGCCCCAGCATTTT	CASSLASGVGVNQPQHF	TRBV7-4	TRBJ1-5
TGTGCCAGCACAGCCCGGGGGGGGGGAGAGACCCAGTACTTC	CASTARGGGETQYF	TRBV6-4	TRBJ2-5
TGCAGTGCTAGGGTCTCAACGTACAACAATGAAAAACTGTTTTTT	CSARVSTYNNEKLFF	TRBV20-1	TRBJ1-4
TGTGCCAGCAGTGGGGACTGCAATCAGCCCCAGCATTTT	CASSGDCNQPQHF	TRBV2	TRBJ1-5
TGTGCCAGCAGTTCCGGGGCTATCTCCTACGAGCAGTACTTC	CASSSGAISYEQYF	TRBV12-4	TRBJ2-7
TGCAGCGTTGTTCCCGGGACGGTTGATGAAAAACTGTTTTTT	CSVVPGTVDEKLFF	TRBV29-1	TRBJ1-4
TGTGCTAGTGGGATTTTAGTGACCACCGGGGAGCTGTTTTTT	CASGILVTTGELFF	TRBV12-5	TRBJ2-2
TGTGCCACCAAGGGACAGGGTAATGAAAAACTGTTTTTT	CATKGQGNEKLFF	TRBV10-3	TRBJ1-4
TGTGCCAGTACTAGGGGGGCGGAGCAGTTCTTC	CASTRGAEQFF	TRBV2	TRBJ2-1
TGTGCCAGCGCTACCCCGCCGATAAGCGGCGAGCAGTACTTC	CASATPPISGEQYF	TRBV6-4	TRBJ2-7
TGCGCCAGCTGTACCGGGGCTGTACTGAAGGGCGGCTACACCTTC	CASCTGAVLKGGYTF	TRBV10-1	TRBJ1-2
TGTGCCTGGCACGGGGGGGGCGCCTACGAGCAGTACTTC	CAWHGGGAYEQYF	TRBV30	TRBJ2-7
TGTGCCAGCAGCCGGTCCCCCGGGACAGGATCGTACGGGGAGCTGTTTTTT	CASSRSPGTGSYGELFF	TRBV13	TRBJ2-2
TGCGCCAGTAAGGCTAGTACGATAGTCTCCTACAATGAGCAGTTCTTC	CASKASTIVSYNEQFF	TRBV4-1	TRBJ2-1
TGCAGTGCTAGAGTCGACAGGGGGATCAGGAACACTGAAGCTTTCTTT	CSARVDRGIRNTEAFF	TRBV20-1	TRBJ1-1
TGTGCTAGCAGCTTAGCCCCTAGAGGGGCTTTTCCTACCAACTCTGGAAACACCATATATTTT	CASSLAPRGAFPTNSGNTIYF	TRBV7-7	TRBJ1-3
TGTGCCAGCAGTTTGCGTTCGGACAGGGGGCACCAAGAGACCCAGTACTTC	CASSLRSDRGHQETQYF	TRBV12-3	TRBJ2-5
TGCGCCAGCAGCCTGTCAGCCCGACTAGCGGGCGGGGAGATCTACAATGAGCAGTTCTTC	CASSLSARLAGGEIYNEQFF	TRBV5-1	TRBJ2-1
TGTGCTAGTGGTTTGGTAGGGCCCGGGACAGCCACTGAAGCTTTCTTT	CASGLVGPGTATEAFF	TRBV12-5	TRBJ1-1
TGTGCCAGCAGGGGTGCACTTCTTACCGGGGAGCTGTTTTTT	CASRGALLTGELFF	TRBV6-2	TRBJ2-2
TGTGCCAGGGGACAGGGGACCAACACTGAAGCTTTCTTT	CARGQGTNTEAFF	TRBV10-3	TRBJ1-1
TGTGCCAGCAGTTACCCCTCCTACAATGAGCAGTTCTTC	CASSYPSYNEQFF	TRBV6-5	TRBJ2-1
TGTGCCAGCAGCTCGGTACAGGGTCTGGTCGCGGAGGGTCAGCCCCAGCATTTT	CASSSVQGLVAEGQPQHF	TRBV5-4	TRBJ1-5
TGTGCTAGTGGTTTGGTATCCGGGACAGTCCCCTCTGGAAACACCATATATTTT	CASGLVSGTVPSGNTIYF	TRBV12-5	TRBJ1-3
TGTGCTACGTGGACCTGGGATACGCAGTATTTT	CATWTWDTQYF	TRBV6-5	TRBJ2-3
TGCGCCAGCAGCCAAAACCGGGACAGATTACTGTTTTTT	CASSQNRDRLLFF	TRBV4-1	TRBJ1-4
TGTGCCAGCAGCCTAGCGGATGCCCGTAACCATTTCCCCCCAGATACGCAGTATTTT	CASSLADARNHFPPDTQYF	TRBV7-4	TRBJ2-3
TGTGCCAGCAGTGGCGCGGTAGGGGCTGAGCAGTTCTTC	CASSGAVGAEQFF	TRBV27	TRBJ2-1
TGTGCCAGCAGCGCAAGACTAGCGGGTGGTGTGGAGACCCAGTACTTC	CASSARLAGGVETQYF	TRBV11-2	TRBJ2-5
TGCATCCCTGGGACGAATGAGCAGTTCTTC	CIPGTNEQFF	TRBV20-1	TRBJ2-1
TGCGCCAGCAGCCCTAGCCCACGGAGCTCCTACAATGAGCAGTTCTTC	CASSPSPRSSYNEQFF	TRBV10-1	TRBJ2-1
TGCAGTGCTCCTATAGCGGGAGAAAACGCAACTAATGAAAAACTGTTTTTT	CSAPIAGENATNEKLFF	TRBV20-1	TRBJ1-4
TGTGCCAGCACCAAGCCTAACTATGGCTACACCTTC	CASTKPNYGYTF	TRBV6-6	TRBJ1-2
TGTGCCAGCAAAAGGACGATCGGGCCGAGCAATCAGCCCCAGCATTTT	CASKRTIGPSNQPQHF	TRBV28	TRBJ1-5
TGTAGGTTCCGGGACAAAAACTCAGACACAGATACGCAGTATTTT	CRFRDKNSDTDTQYF	TRBV30	TRBJ2-3
TGTGCCAGCTCTAGCGGGGAGACCCAGTACTTC	CASSSGETQYF	TRBV18	TRBJ2-5
TGCAGTGACGAGGAAACGGACGAGCAGTACTTC	CSDEETDEQYF	TRBV20-1	TRBJ2-7
TGTGCCAGCAGTTCGGAAACTCTGACAGGGGAAGAGACCCAGTACTTC	CASSSETLTGEETQYF	TRBV6-2	TRBJ2-5
TGTGCCAGCAGTTACTCGGTGTCTAGCGGGGAGGAGTACGAGCAGTACTTC	CASSYSVSSGEEYEQYF	TRBV6-6	TRBJ2-7
TGTGCCAGCAGCTTCTCCGGGACTAGCGGGAGTTGGTCCTACGAGCAGTACTTC	CASSFSGTSGSWSYEQYF	TRBV14	TRBJ2-7
TGTGCCAGCAGTTTATATAAACGCCGGGACAGGGGCCGTCAGCCCCAGCATTTT	CASSLYKRRDRGRQPQHF	TRBV27	TRBJ1-5
TGTGCCCAGCCCCTAGCTGGAGATACGCAGTATTTT	CAQPLAGDTQYF	TRBV7-9	TRBJ2-3
TGTGCCAGCACCCCTAGGACAGGGGCCACAGATACGCAGTATTTT	CASTPRTGATDTQYF	TRBV7-3	TRBJ2-3
TGCGCCCCGGACCGGCAGGGCTACGAGCAGTACTTC	CAPDRQGYEQYF	TRBV10-1	TRBJ2-7
TGTGCCAGCTCACCACCCTGGGGGGCGGTCACCGGGGAGCTGTTTTTT	CASSPPWGAVTGELFF	TRBV18	TRBJ2-2
TGTGCCAGGGTGTATACCTTCACCGGGGAGCTGTTTTTT	CARVYTFTGELFF	TRBV10-3	TRBJ2-2
TGTGCCAGCAGTTTCCACTATACTGGTTCCTACAATGAGCAGTTCTTC	CASSFHYTGSYNEQFF	TRBV27	TRBJ2-1
TGTGCCACCAGCAGAGGTATTGGCCGCCGGGACAGGGAATTAGCGACTAACTATGGCTACACCTTC	CATSRGIGRRDRELATNYGYTF	TRBV15	TRBJ1-2
TGTGCCAGCAGCCGGGGAGGTAGCGGTGGAAACACCATATATTTT	CASSRGGSGGNTIYF	TRBV4-2	TRBJ1-3
TGTGCCAGCAGCCAAACCCCGACAGGAGGGGGAGATTCACCCCTCCACTTT	CASSQTPTGGGDSPLHF	TRBV3-1	TRBJ1-6
TGTGCCTGGAGAAGGTACGATCAAGAGACCCAGTACTTC	CAWRRYDQETQYF	TRBV30	TRBJ2-5
TGTGCCAGCAGGGTGGCCCCTCCTCTAATGCGGGAGGAAAAACTGTTTTTT	CASRVAPPLMREEKLFF	TRBV11-3	TRBJ1-4
TGCAGTGCTATGGGACAGGGGGGGGAGAGGCAGTACTTC	CSAMGQGGERQYF	TRBV20-1	TRBJ2-7
TGCGCCAGCAGCCAAGCCTGGGGACAAGCTATAATTTACGAGCAGTACTTC	CASSQAWGQAIIYEQYF	TRBV4-1	TRBJ2-7
TGCGCCAGCAGCCAAGACGGGGACCCTGGATGCAATCAGCCCCAGCATTTT	CASSQDGDPGCNQPQHF	TRBV4-1	TRBJ1-5
TGTGCCAGCAGTCCTCCCGGGGACTATGGCTACACCTTC	CASSPPGDYGYTF	TRBV27	TRBJ1-2
TGCAGCGTTCCACGCGGGGGGGTAGGGGCCAACGTCCTGACTTTC	CSVPRGGVGANVLTF	TRBV29-1	TRBJ2-6
TGTGCCAGCAGGAAATCACGAGAAAAACTGTTTTTT	CASRKSREKLFF	TRBV14	TRBJ1-4
TGTGCCACGGTACGTTTTTATACTGACGAGCAGTACTTC	CATVRFYTDEQYF	TRBV12-3	TRBJ2-7
TGCGCCAGCAGCCAAAGTCGGGGGCCCAGACTAGCCAAAAACATTCAGTACTTC	CASSQSRGPRLAKNIQYF	TRBV4-3	TRBJ2-4
TGTGCCAGCAGCGCCCAGGGACAGCCTACCTACGAGCAGTACTTC	CASSAQGQPTYEQYF	TRBV5-8	TRBJ2-7
TGCGCCAGCAGCAGCGACGGCACCGGGACAGGGGGCCGGGGGGGCTACACCTTC	CASSSDGTGTGGRGGYTF	TRBV5-1	TRBJ1-2
TGCGCCAGCAGTGAGTCCACTAGCGGGAATAACGAGCAGTACTTC	CASSESTSGNNEQYF	TRBV10-1	TRBJ2-7
TGTGCCATCAGTGAGCAGTCTGCCCAGCATTTT	CAISEQSAQHF	TRBV10-3	TRBJ1-5
TGTGCCAGCAGTGGGGCACCGGGACAGACCAATCAGCCCCAGCATTTT	CASSGAPGQTNQPQHF	TRBV2	TRBJ1-5
TGTGCCAGCAGCGGGACAGGGAACTCCTACGAGCAGTACTTC	CASSGTGNSYEQYF	TRBV6-5	TRBJ2-7
TGTGCCAGCAGTTATGACAGGGTTGATGAGCAGTTCTTC	CASSYDRVDEQFF	TRBV6-5	TRBJ2-1
TGTGCCAGCAGCGTAGAACGGACTAGTAGAGAGACCCAGTACTTC	CASSVERTSRETQYF	TRBV9	TRBJ2-5
TGTGCCAGCAGCGATACCTGGGGTGTCGTAGGGTCCTTC	CASSDTWGVVGSF	TRBV5-4	TRBJ1-2
TGCAGTGCTAGACTCATCCTTGGAAACACCATATATTTT	CSARLILGNTIYF	TRBV20-1	TRBJ1-3
TGTGCCAGCAGCACGCTAGCGGGCCGCCAAGAGACCCAGTACTTC	CASSTLAGRQETQYF	TRBV7-3	TRBJ2-5
TGTGCCAGCAGTACCCGGGGAATCATCTCCTACAATGAGCAGTTCTTC	CASSTRGIISYNEQFF	TRBV27	TRBJ2-1
TGTGCCAGTAGAGGGGGGGGTCGGGCCTACAATGAGCAGTTCTTC	CASRGGGRAYNEQFF	TRBV19	TRBJ2-1
TGTGCCAGCAGTGAGCACTCAGGTTGTGAGCAGTTCTTC	CASSEHSGCEQFF	TRBV6-4	TRBJ2-1
TGCGCCAGCAGCCAAGAAGTCGACAATGAAAAACTGTTTTTT	CASSQEVDNEKLFF	TRBV4-3	TRBJ1-4
TGTGCCGAAGGGGACAGGGGGCTTCGCACTGAAGCTTTCTTT	CAEGDRGLRTEAFF	TRBV5-6	TRBJ1-1
TGTGCCAGCAGCTTTAGGGGGAAATTTTGGACTGAAGCTTTCTTT	CASSFRGKFWTEAFF	TRBV7-9	TRBJ1-1
TGTGCCAGCATTGAGACAGCGAGAAGCTCCTATAATTCACCCCTCCACTTT	CASIETARSSYNSPLHF	TRBV6-4	TRBJ1-6
TGTGCCAGCAGCCCTACGGTTGAAGGACAGACCCCAACTAATGAAAAACTGTTTTTT	CASSPTVEGQTPTNEKLFF	TRBV5-6	TRBJ1-4
TGTGCCAGCAGACCAGTAACTAGCGGGAGAAGAGGAGTGAGTGGGGGAGCTTTCTTT	CASRPVTSGRRGVSGGAFF	TRBV6-5	TRBJ1-1
TGTGCCAGCAGCTTAGATATAGCAACAGGGCCAACGCCCTTCTACAATGAGCAGTTCTTC	CASSLDIATGPTPFYNEQFF	TRBV11-3	TRBJ2-1
