TGTGCCAGCAGCTTGCCAGGGACAGGGGATCACGGCTACGAGCAGTACTTC	CASSLPGTGDHGYEQYF	TRBV5-4	TRBJ2-7
TGTGCCAGTGGGATTCGGCGGGGTCGGCCCCAGCATTTT	CASGIRRGRPQHF	TRBV19	TRBJ1-5
TGTGCCAGCAGGGAGGAACAGCCCCCGAGGGACCCCGACGAGCAGTACTTC	CASREEQPPRDPDEQYF	TRBV28	TRBJ2-7
TGCGCCAGCACCTGGCACCCTCCAACTAATGAAAAACTGTTTTTT	CASTWHPPTNEKLFF	TRBV4-1	TRBJ1-4
TGTGCCAGCAGCATTAACGGGACAGGGAACACTGAAGCTTTCTTT	CASSINGTGNTEAFF	TRBV5-6	TRBJ1-1
TGTGCCAGCAGCCGGCAGAAATATAGCAATCAGCCCCAGCATTTT	CASSRQKYSNQPQHF	TRBV7-2	TRBJ1-5
TGTGCCAGCAGCTGCTACCCGGTCGTACGGACTAGGCAGATAAGCTCCTACAATGAGCAGTTCTTC	CASSCYPVVRTRQISSYNEQFF	TRBV11-2	TRBJ2-1
TGTGCCAGCGCGTTGTGCGGCCGACACAATGAGCAGTTCTTC	CASALCGRHNEQFF	TRBV7-9	TRBJ2-1
TGTGCCCTGATAGGCTGCTACGAGCAGTACTTC	CALIGCYEQYF	TRBV30	TRBJ2-7
TGTGCCAGCAGCCATGGACAGGAACAAGAGACCCAGTACTTC	CASSHGQEQETQYF	TRBV13	TRBJ2-5
TGCGCCAGCAGCTGGTGGATAAGCACAGATACGCAGTATTTT	CASSWWISTDTQYF	TRBV5-1	TRBJ2-3
TGTGCCAGCAGAACAGGGAATGGCTACGAGCAGTACTTC	CASRTGNGYEQYF	TRBV28	TRBJ2-7
TGCAGCGTGGGGTGTCGCGGGACAGAGGAGACCCAGTACTTC	CSVGCRGTEETQYF	TRBV29-1	TRBJ2-5
TGTGCCAGCAGCTTGAGTAGATTCAAACCCGACAGTGCTTGGCAGTACTTC	CASSLSRFKPDSAWQYF	TRBV7-2	TRBJ2-7
TGTGCCTGGAGTGTAGACTTGGACAGGGGGCCAGGCCATAGCAATCAGCCCCAGCATTTT	CAWSVDLDRGPGHSNQPQHF	TRBV30	TRBJ1-5
TGTGCCAGCAGCGGGCGTTGGACAGTCGTGAACACTGAAGCTTTCTTT	CASSGRWTVVNTEAFF	TRBV7-3	TRBJ1-1
TGTGCCAGCAGCTTCCTGGGGAGTCTAGATGAAAAACTGTTTTTT	CASSFLGSLDEKLFF	TRBV5-6	TRBJ1-4
TGTGCCAGCAAGGGAAGTACAGGGTTTCTAGATACGCAGTATTTT	CASKGSTGFLDTQYF	TRBV6-4	TRBJ2-3
TGTGCCAGCAGTTTACCAGGGGGGGGGGTTGGCTACGAGCAGTACTTC	CASSLPGGGVGYEQYF	TRBV27	TRBJ2-7
TGTGCCAGCAGTGAGACTTATGAGGCCAAAAACATTCAGTACTTC	CASSETYEAKNIQYF	TRBV6-4	TRBJ2-4
TGCAGTGCTAGTATGGGGGGAGGAAACACCATATATTTT	CSASMGGGNTIYF	TRBV20-1	TRBJ1-3
TGCGCCAGCAATCCCGGGCGGAACACCTACGAGCAGTACTTC	CASNPGRNTYEQYF	TRBV5-1	TRBJ2-7
TGTGCCAGCAGAGGGTCAGGGGGCCGGGGTCGTGAAAAACTGTTTTTT	CASRGSGGRGREKLFF	TRBV2	TRBJ1-4
TGTGCCAGCAGACCTCGGGACGTGGTACCCACTGAAGCTTTCTTT	CASRPRDVVPTEAFF	TRBV2	TRBJ1-1
TGTGCCAGCAGTTCCCTCCGTTCGGGGAATAATTGTGCCCGCACAGATACGCAGTATTTT	CASSSLRSGNNCARTDTQYF	TRBV28	TRBJ2-3
TGTGCCACCAGCAGAGATCAGACTGCCGGGACTAGCGGGGGGGCGCAGTTCTTC	CATSRDQTAGTSGGAQFF	TRBV15	TRBJ2-1
TGCAGTGCTAGACCCACCACTAGCGGGAGCACAGATACGCAGTATTTT	CSARPTTSGSTDTQYF	TRBV20-1	TRBJ2-3
TGCGCCAGCAGCTTGGGGTCGGGTAGCGGGGAGGGTGATGCGAACACCGGGGAGCTGTTTTTT	CASSLGSGSGEGDANTGELFF	TRBV5-1	TRBJ2-2
TGCGCCAGCAGTGTTATCACTAGCAATCAGCCCCAGCATTTT	CASSVITSNQPQHF	TRBV10-1	TRBJ1-5
TGTGCCAGCAGTCCGAACCCTTGGTCCGCGGGACAGTTCACAGATACGCAGTATTTT	CASSPNPWSAGQFTDTQYF	TRBV27	TRBJ2-3
TGTGCTAGTGGTGGGGCCGAAAAACTGTTTTTT	CASGGAEKLFF	TRBV12-5	TRBJ1-4
TGTGCCAGTAGTATAGGGAAGTTCCGAGGGACATCTGATACGCAGTATTTT	CASSIGKFRGTSDTQYF	TRBV19	TRBJ2-3
TGCGCCAGCAGTGAAAACCGTCTTACGGACAGGCTTAGCAATCAGCCCCAGCATTTT	CASSENRLTDRLSNQPQHF	TRBV10-1	TRBJ1-5
TGCGCCAGCAGCTTGCCTGTGGGGGTAAGAAACCCAAGCTCCTACGAGCAGTACTTC	CASSLPVGVRNPSSYEQYF	TRBV5-1	TRBJ2-7
TGCAGCGTTTCCGACTCCTACGAGCAGTACTTC	CSVSDSYEQYF	TRBV29-1	TRBJ2-7
TGTGCCAGCAGCTTACAAGCTAGGGTAGGCTCCTACGAGCAGTACTTC	CASSLQARVGSYEQYF	TRBV7-8	TRBJ2-7
TGTGCCAGCACATCCCGATTTCCGTCCGGGGAGCTGTTTTTT	CASTSRFPSGELFF	TRBV28	TRBJ2-2
TGTGCCAGCAGTGTAAGGCGGTGTTTGGAGGGCTACGAGCAGTACTTC	CASSVRRCLEGYEQYF	TRBV6-1	TRBJ2-7
TGTGCCAGCAGCTACGGGGAGGTGAACACCGGGGAGCTGTTTTTT	CASSYGEVNTGELFF	TRBV9	TRBJ2-2
TGTGCCAGCTATCCGGGACAAATGCACTTGCAGTATTTT	CASYPGQMHLQYF	TRBV11-1	TRBJ2-3
TGTGCCAGCAGTTACTATGGGTGGGACGACCATGAGCAGTTCTTC	CASSYYGWDDHEQFF	TRBV6-5	TRBJ2-1
TGTGCCAGCAGTTTCCCACAGTCCCGATTAGATCAGCCCCAGCATTTT	CASSFPQSRLDQPQHF	TRBV27	TRBJ1-5
TGCGCCAGCATTTTCGGGGGGCTCAATCAGCCCCAGCATTTT	CASIFGGLNQPQHF	TRBV5-1	TRBJ1-5
TGTGCCAGCAGCCGGGGCTACGAGCAGTACTTC	CASSRGYEQYF	TRBV6-5	TRBJ2-7
TGCAGTGCACCGCGGGAGACACTTTACAATGAGCAGTTCTTC	CSAPRETLYNEQFF	TRBV20-1	TRBJ2-1
TGCAGTGCGTTGTTCATCAGGGGACAGCCCCAGCATTTT	CSALFIRGQPQHF	TRBV20-1	TRBJ1-5
TGTGCCAGCAGCCAAGCCCTACCCACCAATGCCAAAAACATTCAGTACTTC	CASSQALPTNAKNIQYF	TRBV3-1	TRBJ2-4
TGTGCCAGTAGTATAAGTCCCCCGGGACAGCGGAGCAATCAGCCCCAGCATTTT	CASSISPPGQRSNQPQHF	TRBV19	TRBJ1-5
TGTGCCAGTAGAGCGGCGGGACGCCCCGAAGAGACCCAGTACTTC	CASRAAGRPEETQYF	TRBV19	TRBJ2-5
TGTGCCAGCAGTCCGGCTGTTCCGGGACAGAATCAGCCCCAGCATTTT	CASSPAVPGQNQPQHF	TRBV6-5	TRBJ1-5
TGTGCCAGCAGGCGCCCCTTTCCCGGGGAGCTGTTTTTT	CASRRPFPGELFF	TRBV9	TRBJ2-2
TGCGCCAGCAGCCAAGTCGAACCCCCAGGGGATCAGCCCCAGCATTTT	CASSQVEPPGDQPQHF	TRBV4-1	TRBJ1-5
TGTGCCAGCAGTTTTAAGGGGGGGGGGTACGAGCAGTACTTC	CASSFKGGGYEQYF	TRBV12-3	TRBJ2-7
TGTGCCAGCAGCGGAGGGGGGGCTCGGGGCAATGAGCAGTTCTTC	CASSGGGARGNEQFF	TRBV7-9	TRBJ2-1
TGCGCCAGCTCGGAGGCGTTCTCCCGCACGTGGGGGGGTTCGGGAGTCGGGGACAATGAGCAGTTCTTC	CASSEAFSRTWGGSGVGDNEQFF	TRBV5-1	TRBJ2-1
TGTGCCTGGAACGACAGGGGCTACGAGCAGTACTTC	CAWNDRGYEQYF	TRBV30	TRBJ2-7
TGCAGTGCTTTGGTTCGGACAGGGGCCTATCAGCCCCAGCATTTT	CSALVRTGAYQPQHF	TRBV20-1	TRBJ1-5
TGTGCCAGCAGCTACGAGCAGTACTTC	CASSYEQYF	TRBV6-5	TRBJ2-7
TGTGCCAGTTCGTGCCAGGGGACTAACTATGGCTACACCTTC	CASSCQGTNYGYTF	TRBV19	TRBJ1-2
TGCGCCAGCAGTGGATGGACAGATATCACTGAAGCTTTCTTT	CASSGWTDITEAFF	TRBV10-1	TRBJ1-1
TGCAGTGCTAGAGAGCGGGAGGTGACCCAGTACTTC	CSAREREVTQYF	TRBV20-1	TRBJ2-5
TGCAGTGCTAGAGCACACCAAGAGACCCAGTACTTC	CSARAHQETQYF	TRBV20-1	TRBJ2-5
TGTGCCAGCAGCAATCCTCGTACCAGGGGGTCAACTAATGAAAAACTGTTTTTT	CASSNPRTRGSTNEKLFF	TRBV5-5	TRBJ1-4
TGTGCCAGCAGCCCGACAGGGGGCCGCTATAGCAATCAGCCCCAGCATTTT	CASSPTGGRYSNQPQHF	TRBV7-2	TRBJ1-5
TGTGCCAGTAGTATTGGGGGCGCGCCGGAGCAGTACTTC	CASSIGGAPEQYF	TRBV19	TRBJ2-7
TGTGCCAGCTCGGACAGCTACGAGCAGTACTTC	CASSDSYEQYF	TRBV7-4	TRBJ2-7
TGCGCCAGCAGCCAAAAGACAGGGGGTGGAATTCGAGCTTTCTTT	CASSQKTGGGIRAFF	TRBV4-1	TRBJ1-1
TGTGCCAGCAGTCCGTTCTTTTATCCATTAGATATCTATGGCTACACCTTC	CASSPFFYPLDIYGYTF	TRBV6-5	TRBJ1-2
TGTGCCAGCAGCGTAGGGACTGAGCAGTTCTTC	CASSVGTEQFF	TRBV9	TRBJ2-1
TGTGCCAGCAGTTTTCAAACAGGGGGACAAAAAGGAGCTTTCTTT	CASSFQTGGQKGAFF	TRBV27	TRBJ1-1
TGTGCCAGCACCGACAGGGGGGGGAGTAATGAAAAACTGTTTTTT	CASTDRGGSNEKLFF	TRBV14	TRBJ1-4
TGTGCCAGCAGCAAGTTGGACAGTGAGGATGAAAAACTGTTTTTT	CASSKLDSEDEKLFF	TRBV7-4	TRBJ1-4
TGCGCCAGCAGCCAAGTCCCCCCGACAGGGTGGTTTAGCAATCAGCCCCAGCATTTT	CASSQVPPTGWFSNQPQHF	TRBV4-3	TRBJ1-5
TGTGCCAGCTCACCGGCGACGGCCACCGGGGAGCTGTTTTTT	CASSPATATGELFF	TRBV18	TRBJ2-2
TGTGCCAGCAGCTCTACAGGGCCGGAGCAGTACTTC	CASSSTGPEQYF	TRBV13	TRBJ2-7
TGCACGGTTGACAGGGGAAATCAGCCCCAGCATTTT	CTVDRGNQPQHF	TRBV29-1	TRBJ1-5
TGTGCCAGCAGTTATGATAACAGGGGAGCGTACGAGCAGTACTTC	CASSYDNRGAYEQYF	TRBV6-5	TRBJ2-7
TGCAGTGCTACAACCTTGATCCTCGATCCAGGTAACACTGAAGCTTTCTTT	CSATTLILDPGNTEAFF	TRBV20-1	TRBJ1-1
TGTGCCAGCAGAACCGAGGTTACTTCCTACGAGCAGTACTTC	CASRTEVTSYEQYF	TRBV27	TRBJ2-7
TGTGCCAGCAGCTTTGCCAATCAGTACTTACTTGAAAAACTGTTTTTT	CASSFANQYLLEKLFF	TRBV7-6	TRBJ1-4
TGTGCCAGCAGCGCAGTCAATGGACAGGGCATGTCCACCGGGGAGCTGTTTTTT	CASSAVNGQGMSTGELFF	TRBV9	TRBJ2-2
TGCGCCAGCAGCTCTCCTCGGACCGGGGAGCTGTTTTTT	CASSSPRTGELFF	TRBV5-1	TRBJ2-2
TGTGCCAGCAGTTTACCGGCGACAGGGGTTGACGAGCAGTACTTC	CASSLPATGVDEQYF	TRBV27	TRBJ2-7
TGTGCCAGTAGTATCGGCAATTCACCCCTCCACTTT	CASSIGNSPLHF	TRBV19	TRBJ1-6
TGTGCCAGCAGCTTACCCCCCGGGACTAGCGGGAGAGACGGGGAGCTGTTTTTT	CASSLPPGTSGRDGELFF	TRBV7-9	TRBJ2-2
TGTGCCAGCAGGGACAACGATAATGAGCAGTTCTTC	CASRDNDNEQFF	TRBV2	TRBJ2-1
TGCAGTGCTAGGGGGGGACATAATGAAAAACTGTTTTTT	CSARGGHNEKLFF	TRBV20-1	TRBJ1-4
TGTGCCACCAGTGATTTTAATTGGGGCTATGGCTACACCTTC	CATSDFNWGYGYTF	TRBV24-1	TRBJ1-2
TGTGCCAGCAGAGTAGGGGTTAAGGGGGAGCAAGAGACCCAGTACTTC	CASRVGVKGEQETQYF	TRBV27	TRBJ2-5
TGTGCCAGCAGCTTGGGCCCTGCCACAGGGCGCGTCCCCTACGAGCAGTACTTC	CASSLGPATGRVPYEQYF	TRBV7-2	TRBJ2-7
TGTGCCAGCACGAGGGGCCTGGAGAACGAGCAGTACTTC	CASTRGLENEQYF	TRBV6-4	TRBJ2-7
TGTGCCAGCAAAAGTGAGTTTGTTCCAGGGGACAGGGCGGAGACTAGCTACGAGCAGTACTTC	CASKSEFVPGDRAETSYEQYF	TRBV6-5	TRBJ2-7
TGTGCCAGCAGCTTATTAGGGCACGAAGCTTTCTTT	CASSLLGHEAFF	TRBV7-7	TRBJ1-1
TGTACCTCCGGGACAGGCTACACCTTC	CTSGTGYTF	TRBV7-9	TRBJ1-2
TGTGCCAGCTCCCCCGGGGGGGGGAACAATGAGCAGTTCTTC	CASSPGGGNNEQFF	TRBV18	TRBJ2-1
TGTGCCAGCAGCTATTCCCTATTCCAGGGATACACTGAAGCTTTCTTT	CASSYSLFQGYTEAFF	TRBV7-2	TRBJ1-1
TGCGCCAGCAACTACGAGCAGTACTTC	CASNYEQYF	TRBV10-1	TRBJ2-7
TGTGCCAGCAGCTTGCCGATGTGGCGGGAGGGCGTCTCCTACAATGAGCAGTTCTTC	CASSLPMWREGVSYNEQFF	TRBV5-5	TRBJ2-1
TGCAGTGCTAGAATGGGGGAAATGTTCGAGCAGTACTTC	CSARMGEMFEQYF	TRBV20-1	TRBJ2-7
TGTGCCAGCAGTATGGGGCATAATTCACCCCTCCACTTT	CASSMGHNSPLHF	TRBV28	TRBJ1-6
TGTGCCAGCAGCGCCGGGCGGCCCACAGATACGCAGTATTTT	CASSAGRPTDTQYF	TRBV7-9	TRBJ2-3
TGTGCCAGCAGTTTACAACAGAAGGCAACTAATGAAAAACTGTTTTTT	CASSLQQKATNEKLFF	TRBV12-4	TRBJ1-4
TGTGCCAGCAGTTTTAGACAGGGCAATGAGCAGTTCTTC	CASSFRQGNEQFF	TRBV27	TRBJ2-1
TGCAGTGCTAGATCCTTCCTGGACAGGAGAGACCGCACCGGCCCCCAGAATAGCAATCAGCCCCAGCATTTT	CSARSFLDRRDRTGPQNSNQPQHF	TRBV20-1	TRBJ1-5
TGTGCCAGCAGCCCTAATCGTTGTCGGAACAACACTGAAGCTTTCTTT	CASSPNRCRNNTEAFF	TRBV7-9	TRBJ1-1
TGTGCCAGCAGCTTAGGGAATGGAGCTATGGGGATCGAGCAGTACTTC	CASSLGNGAMGIEQYF	TRBV7-6	TRBJ2-7
TGCAGTTGGATTCCGGGGGCTGGGGCCAACGTCCTGACTTTC	CSWIPGAGANVLTF	TRBV20-1	TRBJ2-6
TGCGCCAGCAGAACCACTAGCGGGAGGGCAAAGGGTTCTGGAAACACCATATATTTT	CASRTTSGRAKGSGNTIYF	TRBV5-1	TRBJ1-3
TGCGCCAGCAGTGAGACCGTTACGTTGGGACAGGGTTTTAGTAACTATGGCTACACCTTC	CASSETVTLGQGFSNYGYTF	TRBV10-1	TRBJ1-2
TGCGCCAGCAGCCAAGATGTTTCAGTCCCGGGACAGGGCCTAAGGACAAACATTCAGTACTTC	CASSQDVSVPGQGLRTNIQYF	TRBV4-1	TRBJ2-4
TGTGCCAGCTCAGGCCTCTCCTACAATGAGCAGTTCTTC	CASSGLSYNEQFF	TRBV5-8	TRBJ2-1
TGCGCCAGCTTCATCAAGGGGGGCCCCCAAACTACAGATACGCAGTATTTT	CASFIKGGPQTTDTQYF	TRBV10-2	TRBJ2-3
TGTGCCAGCAGCAAGGAGGGAAAAAGGTCGCATGAATCCTATAATTCACCCCTCCACTTT	CASSKEGKRSHESYNSPLHF	TRBV3-1	TRBJ1-6
TGTGCCAGCAGCTTAGCGACCGGGGAGCTGTTTTTT	CASSLATGELFF	TRBV2	TRBJ2-2
TGTGCCAGCAGCGGGCCGCTACAGGGCAATGAGCAGTTCTTC	CASSGPLQGNEQFF	TRBV6-6	TRBJ2-1
TGTGCCAGCAGTTTAGGGAGCGTAAACTTGCCTTATTTT	CASSLGSVNLPYF	TRBV27	TRBJ1-3
TGTGCCAGCAGCCAAGCTGGCCGGGACAGGGGGCGCCCCGGGATTGCTGGAAACACCATATATTTT	CASSQAGRDRGRPGIAGNTIYF	TRBV3-1	TRBJ1-3
TGTGCCAGCAGTGATAAAGGGGGAGAAGAGACCCAGTACTTC	CASSDKGGEETQYF	TRBV27	TRBJ2-5
TGTGCCAGCAGCGACGACGCGGGAGTCGAGCAGTACTTC	CASSDDAGVEQYF	TRBV11-2	TRBJ2-7
TGTGCCAGCAGCCGACCGCATCTGTCTGAAGCTTTCTTT	CASSRPHLSEAFF	TRBV11-3	TRBJ1-1
TGTGCCAGCAGCTCAACTAGCGGGAGGACGCAAGAGACCCAGTACTTC	CASSSTSGRTQETQYF	TRBV13	TRBJ2-5
TGCAGTGCTAGAGGACTAGCGGGAGGGCTCGGGGCCAACGTCCTGACTTTC	CSARGLAGGLGANVLTF	TRBV20-1	TRBJ2-6
TGTGCCAGCAGCCCGGCAGGGAATCAGCCCCAGCATTTT	CASSPAGNQPQHF	TRBV13	TRBJ1-5
TGTGCCAGCAGCTCCTGGGGGTCAAGCTCCTACAATGAGCAGTTCTTC	CASSSWGSSSYNEQFF	TRBV13	TRBJ2-1
TGCAGTGCTAGTCCATACGATCAAAGGGACTGCCCACAGAACACCGGGGAGCTGTTTTTT	CSASPYDQRDCPQNTGELFF	TRBV20-1	TRBJ2-2
TGCGCCAGCAGCTTGGGCTGGGCTGCGGCCAGCTCCTACGAGCAGTACTTC	CASSLGWAAASSYEQYF	TRBV5-1	TRBJ2-7
TGTGCCAGCAGCCCACCTAAACAGAAAGGGGGGACTGAAGCTTTCTTT	CASSPPKQKGGTEAFF	TRBV6-5	TRBJ1-1
TGCGCCAGCCGGGGGGACTGGGAGACCCAGTACTTC	CASRGDWETQYF	TRBV10-1	TRBJ2-5
TGTGCCAGGCAGCTTGACAGGCACACTGAAGCTTTCTTT	CARQLDRHTEAFF	TRBV25-1	TRBJ1-1
TGTGCCAGCAGTGGTCAGGCGGGGAGCAATCAGCCCCAGCATTTT	CASSGQAGSNQPQHF	TRBV6-2	TRBJ1-5
TGTGCCACCAACAGGGGGCTCCCGAACACCGGGGAGCTGTTTTTT	CATNRGLPNTGELFF	TRBV24-1	TRBJ2-2
TGCGCCAGCAGCAGGGGGGGGGACTACGAGCAGTACTTC	CASSRGGDYEQYF	TRBV5-1	TRBJ2-7
TGCGCCAGCAGCGAGGGACTAGCGGGGGGGGCGAACACCGGGGAGCTGTTTTTT	CASSEGLAGGANTGELFF	TRBV5-1	TRBJ2-2
TGTGCCTGGGGGGGCGAGCAGTACTTC	CAWGGEQYF	TRBV30	TRBJ2-7
TGTGCCAGCAGCTTGAACGACAGGGGATTGGCTAAAAACATTCAGTACTTC	CASSLNDRGLAKNIQYF	TRBV5-6	TRBJ2-4
TGTGCCAGCAGCTCGGGGACAGGGAGACTCCTTGAGACCCAGTACTTC	CASSSGTGRLLETQYF	TRBV13	TRBJ2-5
TGTGCCAGCAGCTGCCAGGTGCACAGGGGCAATCAGCCCCAGCATTTT	CASSCQVHRGNQPQHF	TRBV11-2	TRBJ1-5
TGTGCTAGCAGCCAAATAGCGCTAGGCGAGCAGTACTTC	CASSQIALGEQYF	TRBV7-7	TRBJ2-7
TGCGCCAGCAGCTTTCTCAGGGAAGCTTTCTTT	CASSFLREAFF	TRBV5-1	TRBJ1-1
TGTGCCAGCAGTGTAAACCAGGGGGGGAAGCTGCGGGGGAAAAAATACACAGATACGCAGTATTTT	CASSVNQGGKLRGKKYTDTQYF	TRBV7-8	TRBJ2-3
TGTGCCAGCAGTTACGTGCGAGGACTAGCGGGGCACGAGCAGTACTTC	CASSYVRGLAGHEQYF	TRBV27	TRBJ2-7
TGTGCCAGCAGTTTAGCTAGTAAGACAGACTGCACAGATACGCAGTATTTT	CASSLASKTDCTDTQYF	TRBV12-3	TRBJ2-3
TGTGCCTGGGCGGCCGGGACTAGCGGGGGGGCGAACGAGCAGTACTTC	CAWAAGTSGGANEQYF	TRBV30	TRBJ2-7
TGTGCCAGCCGGACAGGGGGGGTCACCGGGGAGCTGTTTTTT	CASRTGGVTGELFF	TRBV7-7	TRBJ2-2
TGTGCCAGCAGCCGGGGGGGGGGCCGGCCCAGCTACGAGCAGTACTTC	CASSRGGGRPSYEQYF	TRBV13	TRBJ2-7
TGTGCCAGCAGCGGGCGAGGGGAAAAACTGTTTTTT	CASSGRGEKLFF	TRBV9	TRBJ1-4
TGTGCCAGCAGCGTGGGGCGAGAGACCCAGTACTTC	CASSVGRETQYF	TRBV6-1	TRBJ2-5
TGCAGTGCTAGAGCCGGGGGGGCTTCTGAAGCTTTCTTT	CSARAGGASEAFF	TRBV20-1	TRBJ1-1
TGTGCCAGTGACGGGCGTGATGGAGACTATGGCTACACCTTC	CASDGRDGDYGYTF	TRBV6-6	TRBJ1-2
TGTGCCAGCAGCGGGCAGGGAGTCCCAGCAACCGGGGAGCTGTTTTTT	CASSGQGVPATGELFF	TRBV7-3	TRBJ2-2
TGTGCCTGGTATAAGGACTATGGCTACACCTTC	CAWYKDYGYTF	TRBV30	TRBJ1-2
TGTGCCAGCAGCCCGCCCGGGGGGCTAAGCAAGGCTAACTATGGCTACACCTTC	CASSPPGGLSKANYGYTF	TRBV7-4	TRBJ1-2
TGTGCCTGGCAGTCGCGGACAGGGGGTAATCAGCCCCAGCATTTT	CAWQSRTGGNQPQHF	TRBV30	TRBJ1-5
TGCGCCAGCAGTGTCGGGACCATCAACACCGGGGAGCTGTTTTTT	CASSVGTINTGELFF	TRBV10-2	TRBJ2-2
TGTGCCAGCAGCTCCGGGACAGGGGGAGATGAAAAACTGTTTTTT	CASSSGTGGDEKLFF	TRBV7-9	TRBJ1-4
TGTGCCAGCAGTGACCGGGGGGAACCCGGCTACACCTTC	CASSDRGEPGYTF	TRBV6-4	TRBJ1-2
TGTGCCAGCAGCTTATTATACACGTCAGAGACCCAGTACTTC	CASSLLYTSETQYF	TRBV11-2	TRBJ2-5
TGTGCCAGCAGCATCCGTTATGTCTGGAGGGCCAAAAACATTCAGTACTTC	CASSIRYVWRAKNIQYF	TRBV12-4	TRBJ2-4
TGTGCCAGCAGTCGAAGCAGGGGGGTGAAGGGGAGCTACGAGCAGTACTTC	CASSRSRGVKGSYEQYF	TRBV6-4	TRBJ2-7
TGTGCCAGCAGCGTCACGTTTAGCGGCCCAGATACGCAGTATTTT	CASSVTFSGPDTQYF	TRBV9	TRBJ2-3
TGCGCCAGATGGGCACCAACTGAAGCTTTCTTT	CARWAPTEAFF	TRBV10-2	TRBJ1-1
TGTGCCAGTGCGGAGCTGAACGAGCAGTACTTC	CASAELNEQYF	TRBV4-2	TRBJ2-7
TGTGCCAGCAGCCGGAACAGCGGAGCTTTCTTT	CASSRNSGAFF	TRBV13	TRBJ1-1
TGTGCCAGCAGGGGCCGCCGGCCCGGCTACACCTTC	CASRGRRPGYTF	TRBV6-5	TRBJ1-2
TGTGCCAGTAGTATAGAAACCCATAAAAACATTCAGTACTTC	CASSIETHKNIQYF	TRBV19	TRBJ2-4
TGCGCCAGCAGACTACCAGTTTACGAGCAGTACTTC	CASRLPVYEQYF	TRBV10-1	TRBJ2-7
TGCAGTGCTAGAGATAGCTGGGGCGTCTACGAGCAGTACTTC	CSARDSWGVYEQYF	TRBV20-1	TRBJ2-7
TGTGCCACCAGCAGAGATAACGGACGGGGCTGTAACTATGGCTACACCTTC	CATSRDNGRGCNYGYTF	TRBV15	TRBJ1-2
TGTGCCAGCATCAAGTCACCGGGCCTACTGAACGAGCAGTACTTC	CASIKSPGLLNEQYF	TRBV6-5	TRBJ2-7
TGTGCCAGCACTCGGGGGGACCGCTCCTACGAGCAGTACTTC	CASTRGDRSYEQYF	TRBV12-3	TRBJ2-7
TGTGCCAGCAGCTTAGGAACACAGGGGGCGGGCTACACCTTC	CASSLGTQGAGYTF	TRBV7-9	TRBJ1-2
TGTGCCAGCAGCTGGATGTACGAGCAGGGGGCCTTTATAAGAAAGAACGCTTTCTTT	CASSWMYEQGAFIRKNAFF	TRBV11-2	TRBJ1-1
TGTGCCTGGAAGGTAACTGAGGGACGCACAGATACGCAGTATTTT	CAWKVTEGRTDTQYF	TRBV30	TRBJ2-3
TGTGCCAGCAGAGGGACTAGCGGGGGCACAGATACGCAGTATTTT	CASRGTSGGTDTQYF	TRBV6-8	TRBJ2-3
TGTGCCAGCAGCCTTCCAGGGTGGCAGCCCCAGCATTTT	CASSLPGWQPQHF	TRBV7-9	TRBJ1-5
TGTGCCAGCTCACCACCCGGGAGAACTGAAGCTTTCTTT	CASSPPGRTEAFF	TRBV18	TRBJ1-1
TGTGCCAGCAGTTGTAGCTTGCCTACGGGTTATGAGCAGTTCTTC	CASSCSLPTGYEQFF	TRBV27	TRBJ2-1
TGTGCCAGCGCGACTTCAGGCAACGAGCAGTACTTC	CASATSGNEQYF	TRBV7-9	TRBJ2-7
TGTGCCAGCAGTGAAATCCGGGTCCCGGGACAGGGAGACACTGAAGCTTTCTTT	CASSEIRVPGQGDTEAFF	TRBV2	TRBJ1-1
TGCGCCAGCAGCAACGGGGTGCGCTCCTACGAGCAGTACTTC	CASSNGVRSYEQYF	TRBV5-1	TRBJ2-7
TGTGCCAGCAGCCTCCGGGACACAAAACTGTTTTTT	CASSLRDTKLFF	TRBV7-9	TRBJ1-4
TGTGCCAGCAGTTTGGACAGGGGGTCGAATGAGCAGTTCTTC	CASSLDRGSNEQFF	TRBV6-2	TRBJ2-1
TGTGCCAGCATTTCGGGACCCCACTATGGCTACACCTTC	CASISGPHYGYTF	TRBV12-3	TRBJ1-2
TGCAGTGCTAGAGTCACGGGTTTCACAGATACGCAGTATTTT	CSARVTGFTDTQYF	TRBV20-1	TRBJ2-3
TGCAGTGCTAGAGATGACTTTCTGGGAGTCAGTGAAGCTTTCTTT	CSARDDFLGVSEAFF	TRBV20-1	TRBJ1-1
TGTGCCAGCCTGGGGGGGATTCGTAGTTACCAGCCCCCCGAGCAGTACTTC	CASLGGIRSYQPPEQYF	TRBV7-2	TRBJ2-7
TGTGCCTGGAGGCTAGGACAGGGGGCGAACACCGGGGAGCTGTTTTTT	CAWRLGQGANTGELFF	TRBV30	TRBJ2-2
TGTGCCAGCAGCTTAGATACGACTAGCGGTAAGCGGAGCTCCTACAATGAGCAGTTCTTC	CASSLDTTSGKRSSYNEQFF	TRBV11-2	TRBJ2-1
TGTGCCAGCACCGGGCTTGACATTCAGTACTTC	CASTGLDIQYF	TRBV12-3	TRBJ2-4
TGTGCCAGCAGTTACGCCCAGCCGGGACAGGTCAACACTGAAGCTTTCTTT	CASSYAQPGQVNTEAFF	TRBV6-5	TRBJ1-1
TGTGCCAGCAGCTTGCGGTATGAGCAGTTCTTC	CASSLRYEQFF	TRBV5-5	TRBJ2-1
TGTGCCAGCAGCTTCGAACTGGGACGGAACTATGGCTACACCTTC	CASSFELGRNYGYTF	TRBV11-2	TRBJ1-2
TGCGCCAGCAGTGCTATACCGGGACGATTAAGCAATCAGCCCCAGCATTTT	CASSAIPGRLSNQPQHF	TRBV10-1	TRBJ1-5
TGCGCCAGCGAGTCCTATGGCTACACCTTC	CASESYGYTF	TRBV10-1	TRBJ1-2
TGTGCCAGCAGCTACCGGGACCCTGCCACCTACGAGCAGTACTTC	CASSYRDPATYEQYF	TRBV9	TRBJ2-7
TGTGCCAGAGGGACTAGCGGGCGACGAAGCACCGGGGAGCTGTTTTTT	CARGTSGRRSTGELFF	TRBV11-3	TRBJ2-2
TGTGCCAGCAGTCGGCTGGGTGCCCCGGAGACCCAGTACTTC	CASSRLGAPETQYF	TRBV6-1	TRBJ2-5
TGTGCCAGCAGCAGGGGGGCCCATGAGCAGTTCTTC	CASSRGAHEQFF	TRBV12-3	TRBJ2-1
TGTGCCAGCAGCTCCGAATGGGAGCCAGCCTCGACCAAAAACATTCAGTACTTC	CASSSEWEPASTKNIQYF	TRBV7-2	TRBJ2-4
TGCAGCGTTGAAAACTTGGACAGCACCGTTCAGCCCCAGCATTTT	CSVENLDSTVQPQHF	TRBV29-1	TRBJ1-5
TGCGCCAGCAGCCAAAGTTTCCTCGGGGGGGACAATGAGCAGTTCTTC	CASSQSFLGGDNEQFF	TRBV4-1	TRBJ2-1
TGTGCCAGCAGTGAGCACAGGATAAACTATGGCTACACCTTC	CASSEHRINYGYTF	TRBV6-4	TRBJ1-2
TGTGCCAGCAGCTTAGCCAGGGGACATCAGCCCCAGCATTTT	CASSLARGHQPQHF	TRBV7-9	TRBJ1-5
TGTGCCTGGAGTGTTTATGCGGCGATCGAGCAGTACTTC	CAWSVYAAIEQYF	TRBV30	TRBJ2-7
TGTGCCAGCAGCCTGGGACAGGGGGCCTCCTATAATTCACCCCTCCACTTT	CASSLGQGASYNSPLHF	TRBV14	TRBJ1-6
TGTGCCAGCAGCTTAGGGGACCGCACCCTAGCGGACAGCAATGAGCAGTTCTTC	CASSLGDRTLADSNEQFF	TRBV7-8	TRBJ2-1
TGCGCCAGCAGCCCAGCAGGGGGCGGCTGTACAGATACGCAGTATTTT	CASSPAGGGCTDTQYF	TRBV4-3	TRBJ2-3
TGTGCCTGGAGGAGTAGAGGGGGGGGGGAGTCCTACGAGCAGTACTTC	CAWRSRGGGESYEQYF	TRBV30	TRBJ2-7
TGCGCCAGCAGCTTACAGGGGACAGGCGGTCCCCCGGCGAACACCGGGGAGCTGTTTTTT	CASSLQGTGGPPANTGELFF	TRBV5-1	TRBJ2-2
TGTGCCAGCAGAATCGGCCAGGTAGGGGAAATTCCTCTAGATACGCAGTATTTT	CASRIGQVGEIPLDTQYF	TRBV28	TRBJ2-3
TGTGCCAGGTTAGAAGGGGACGAGCAGTACTTC	CARLEGDEQYF	TRBV3-1	TRBJ2-7
TGTGCCAGCAGCCAAGGTCTACTTAGGGGCGGACGTTCAGATACGCAGTATTTT	CASSQGLLRGGRSDTQYF	TRBV4-2	TRBJ2-3
TGTGCCAGTAGTATGTTCCGGGACAGGGGTTGTAGGGGCTATGGCTACACCTTC	CASSMFRDRGCRGYGYTF	TRBV19	TRBJ1-2
TGTGCCAGGCAGCCGGGACAGGGTAATCAGCCCCAGCATTTT	CARQPGQGNQPQHF	TRBV5-5	TRBJ1-5
TGTGGGAGAGTGGAGGGCATGTTGGGAGTGCAAGAGACCCAGTACTTC	CGRVEGMLGVQETQYF	TRBV28	TRBJ2-5
TGCGCCAGCAGTGAGCTCTGGACCGCCTACGAGCAGTACTTC	CASSELWTAYEQYF	TRBV10-1	TRBJ2-7
TGTGCCAGCAGCTCCACCGATCGGGGCTATGGCTACACCTTC	CASSSTDRGYGYTF	TRBV7-3	TRBJ1-2
TGTGCCAGCAGTTACTCGTCTAGGGGCGTGTCAGACAATGAGCAGTTCTTC	CASSYSSRGVSDNEQFF	TRBV6-5	TRBJ2-1
TGTGCCAGCAGTGACGGGGGGGTACTTTCAGATACGCAGTATTTT	CASSDGGVLSDTQYF	TRBV6-1	TRBJ2-3
TGTGCCAGCAGCGGCCGGGACATGTTTAATGAGCAGTTCTTC	CASSGRDMFNEQFF	TRBV11-3	TRBJ2-1
TGCAGCGTTGAGAAGCGGGAAAGGAATCAGCCCCAGCATTTT	CSVEKRERNQPQHF	TRBV29-1	TRBJ1-5
TGTGCCAGCCCCCGGGAGGGGGTTGAATACGAGCAGTACTTC	CASPREGVEYEQYF	TRBV6-4	TRBJ2-7
TGTGCCAGCAGTGCGGCAGCGGGCTGCATGAACACTGAAGCTTTCTTT	CASSAAAGCMNTEAFF	TRBV6-4	TRBJ1-1
TGTGCCAGCAGCCCACTCCGACTAGCGGGAGCGGGGAATGAGCAGTTCTTC	CASSPLRLAGAGNEQFF	TRBV7-3	TRBJ2-1
TGTGCCAGCAGCGACGACCGGGGGTATAATTCACCCCTCCACTTT	CASSDDRGYNSPLHF	TRBV7-3	TRBJ1-6
TGTGCCAGCAGGCAAACCTTACTGTCGGACAGGGTATATGGCTACACCTTC	CASRQTLLSDRVYGYTF	TRBV6-1	TRBJ1-2
TGTGCCATCAGCCGCAACTCGTCCGGGGAGCTGTTTTTT	CAISRNSSGELFF	TRBV10-3	TRBJ2-2
TGTGCCAGCAGCTTGGGCCCCCCGTGGGGGGGGTACGAGCAGTACTTC	CASSLGPPWGGYEQYF	TRBV7-8	TRBJ2-7
TGTGCCAGCAGTGAAGGGCGACTAGGCGAGCAGTACTTC	CASSEGRLGEQYF	TRBV2	TRBJ2-7
TGCGCCAGCAGCTGGTACGCAGGGCGGAAGACCCAGTACTTC	CASSWYAGRKTQYF	TRBV5-1	TRBJ2-5
TGTGCCAGCAGTTTACAGGGGGCGACCTCCTCCTACGAGCAGTACTTC	CASSLQGATSSYEQYF	TRBV12-3	TRBJ2-7
TGTGCCAGCAGTGGTGAACCGGGGAAAACACCCCTCCACTTT	CASSGEPGKTPLHF	TRBV28	TRBJ1-6
TGTGCCAGCAGCTTTCCCCCGAGGACAGGGGAATCAGCTTTCTTT	CASSFPPRTGESAFF	TRBV11-3	TRBJ1-1
TGTGCCAGCAGCTTTGCGCAGCTCGGACAGTCGTACGTGAACACCGGGGAGCTGTTTTTT	CASSFAQLGQSYVNTGELFF	TRBV9	TRBJ2-2
TGTGCCAGCAGCCAAGGGCGGGAGCAGTACTTC	CASSQGREQYF	TRBV9	TRBJ2-7
TGTGCCAGCAGCCTCCCAAGTGTAAAATGGGAGGACACTGAAGCTTTCTTT	CASSLPSVKWEDTEAFF	TRBV7-8	TRBJ1-1
TGCAGCGTTGTCGTACGGGACAGACGGTTTGAGCAGTACTTC	CSVVVRDRRFEQYF	TRBV29-1	TRBJ2-7
TGTGCCAGCAGCTTAGCCGGGACAGGGCTCTACGAGCAGTACTTC	CASSLAGTGLYEQYF	TRBV7-4	TRBJ2-7
TGCAGCGTTGAGGGTCGGGGGATCTCCCCCTACGAGCAGTACTTC	CSVEGRGISPYEQYF	TRBV29-1	TRBJ2-7
TGTGCCAGCAGTAACCCGTTGGGGACAGGGGCAAGGAATTCACCCCTCCACTTT	CASSNPLGTGARNSPLHF	TRBV27	TRBJ1-6
TGCAGCGACTGCGACAATGAGCAGTTCTTC	CSDCDNEQFF	TRBV29-1	TRBJ2-1
TGTGCCAGGAAGGACAGATTCCACGATGGCTACACCTTC	CARKDRFHDGYTF	TRBV6-1	TRBJ1-2
TGTGCCAGCAGTTATCCACAGGGGTGGGGACGGCATGGCTACACCTTC	CASSYPQGWGRHGYTF	TRBV6-5	TRBJ1-2
TGTGCCAGCAGCCCCAACAGGGGCTACAATGAGCAGTTCTTC	CASSPNRGYNEQFF	TRBV13	TRBJ2-1
TGTGCCATCACCTCCGCGGGACGGGCTGAGCAGTTCTTC	CAITSAGRAEQFF	TRBV10-3	TRBJ2-1
TGCGCCAGCAGCGGAAGGGCGGACTATGGCTACACCTTC	CASSGRADYGYTF	TRBV5-1	TRBJ1-2
TGTGCCAGCTCACCACCGACTAGCGGGCGGTCGGTCAATGAGCAGTTCTTC	CASSPPTSGRSVNEQFF	TRBV18	TRBJ2-1
TGTGCCAGCAGCCAGGGGGCGATTGGGACCCAGTACTTC	CASSQGAIGTQYF	TRBV27	TRBJ2-5
TGTGCCAGCAGAGGTGGACAGGGGGGAGGGGGCTACGAGCAGTACTTC	CASRGGQGGGGYEQYF	TRBV5-4	TRBJ2-7
TGCAGTGCTAGAGATTCGAGTCCGACCGGGGAGCTGTTTTTT	CSARDSSPTGELFF	TRBV20-1	TRBJ2-2
TGTGCCAGCAGGGGAGCCCGCTCCCCGGGACAGACTAGCAATCAGCCCCAGCATTTT	CASRGARSPGQTSNQPQHF	TRBV7-3	TRBJ1-5
TGTGCCAGCAGGAGCGACCAGATCAATGAGCAGTTCTTC	CASRSDQINEQFF	TRBV6-5	TRBJ2-1
TGCGCCAGCAGCCAAGAGGGGCGCACAAATCCCACAGATACGCAGTATTTT	CASSQEGRTNPTDTQYF	TRBV4-1	TRBJ2-3
TGTGCCAGCAGTGGACTAGGGCCGCCGACCCAGTACTTC	CASSGLGPPTQYF	TRBV6-4	TRBJ2-5
TGTGCCACCAGTGAAGCTTCACTAGAGGGGCGACTGGCCGGGGACGAGCAGTACTTC	CATSEASLEGRLAGDEQYF	TRBV24-1	TRBJ2-7
TGTGCCAGCAGTGAAGTAACGCCCGAGGGTCGACTCGCCAGCAATCAGCCCCAGCATTTT	CASSEVTPEGRLASNQPQHF	TRBV6-1	TRBJ1-5
TGCAGTGCTAGAGGGGACGGCCTGTTCAATCAGCCCCAGCATTTT	CSARGDGLFNQPQHF	TRBV20-1	TRBJ1-5
TGTGCCAGCAGTCAAGGGCAGGGGGCCTACGAGCAGTACTTC	CASSQGQGAYEQYF	TRBV7-9	TRBJ2-7
TGTGCCAGTGACAGCGCTTGGACAGGCCGGGATCAGCCCCAGCATTTT	CASDSAWTGRDQPQHF	TRBV19	TRBJ1-5
TGCAGTGCTACAGGGCCAACCTACGAGCAGTACTTC	CSATGPTYEQYF	TRBV20-1	TRBJ2-7
TGTGCCAGCAGCGAGGACAGGTCCCAGGCGGACAATGAGCAGTTCTTC	CASSEDRSQADNEQFF	TRBV7-3	TRBJ2-1
TGCAGTGCTGGTCAGGGGGCAAGGAACACTGAAGCTTTCTTT	CSAGQGARNTEAFF	TRBV20-1	TRBJ1-1
TGTGCCAGCAGCAACGAGTTTGGAGATTCCTCTGGAAACACCATATATTTT	CASSNEFGDSSGNTIYF	TRBV9	TRBJ1-3
TGTGCCACCAAAGTGGGGGGGGAGCAGTACTTC	CATKVGGEQYF	TRBV19	TRBJ2-7
TGTGCCAGCAGTTTTAGGGACAGTCTTCCCTATGGCTACACCTTC	CASSFRDSLPYGYTF	TRBV6-5	TRBJ1-2
TGTGCCAGCAGCGGGGACAGGGGCTCGGCTGGAAACACCATATATTTT	CASSGDRGSAGNTIYF	TRBV11-3	TRBJ1-3
TGTGCCAGTATACAAAAATGGAGGCTAGCCAAAAACATTCAGTACTTC	CASIQKWRLAKNIQYF	TRBV19	TRBJ2-4
TGTGCCAGCAGGGAACGGAGGCACGAGTATAGCAATCAGCCCCAGCATTTT	CASRERRHEYSNQPQHF	TRBV6-2	TRBJ1-5
TGTGCCAGCAAGCAGAGGAATGAGCAGTTCTTC	CASKQRNEQFF	TRBV7-9	TRBJ2-1
TGTGCCAGCAGTGAAAGAGGGACAGGGGTCACGGGCAATCAGCCCCAGCATTTT	CASSERGTGVTGNQPQHF	TRBV6-4	TRBJ1-5
TGTGCCAGTAGCCCCCAGGGGGCGCCGGGGGAGCAGTTCTTC	CASSPQGAPGEQFF	TRBV19	TRBJ2-1
TGTGCCTGGAGGGGACAGGTAGGAAACTATGGCTACACCTTC	CAWRGQVGNYGYTF	TRBV30	TRBJ1-2
TGTGCCAAACATAGAAACTCCTGGGGACAGGGCTGGGGCTACACCTTC	CAKHRNSWGQGWGYTF	TRBV9	TRBJ1-2
TGTGCCAGCACCCGCCCGACAGGACCTGGTAACTATGGCTACACCTTC	CASTRPTGPGNYGYTF	TRBV7-9	TRBJ1-2
TGCGCCAGCGTCTCTAACGGGACGGATAAGTCGCCCCAGCATTTT	CASVSNGTDKSPQHF	TRBV10-1	TRBJ1-5
TGTGCCTGGAGTGTACAAAGTCGGACAGCCCTAAGCTCCTACAATGAGCAGTTCTTC	CAWSVQSRTALSSYNEQFF	TRBV30	TRBJ2-1
TGCGCCAGCAGCGTCGGACAGCAGTGCTATGGCTACACCTTC	CASSVGQQCYGYTF	TRBV5-1	TRBJ1-2
TGTGCCAGCAGGAATGGGGGGGGGACTGAAGCTTTCTTT	CASRNGGGTEAFF	TRBV11-3	TRBJ1-1
TGTGCCAGCAGCTTAGGTGGGAGGGTTCGCACAGATACGCAGTATTTT	CASSLGGRVRTDTQYF	TRBV11-3	TRBJ2-3
TGTGCCAGCAGGACGACCTACGAGCAGTACTTC	CASRTTYEQYF	TRBV6-1	TRBJ2-7
TGTGCCAGCAGCCAAGGACCGGACAGGCAGGGCTACACCTTC	CASSQGPDRQGYTF	TRBV14	TRBJ1-2
TGCGCCAGCAGCCAAGGCCTCAGGCGTCGCTACGAGCAGTACTTC	CASSQGLRRRYEQYF	TRBV4-1	TRBJ2-7
TGCAGTGCTAGAGGCGTGGACGAAGGTAACTATGGCTACACCTTC	CSARGVDEGNYGYTF	TRBV20-1	TRBJ1-2
TGTGCCACCAGCAGAGGAACTAGCGGGAGGCAGTTCTTC	CATSRGTSGRQFF	TRBV15	TRBJ2-1
TGCAGTGCTAGGAAAAGTGGAGAGTACGAGACCCAGTACTTC	CSARKSGEYETQYF	TRBV20-1	TRBJ2-5
TGTGCCAGCAGTTCGTACGTGAAAAGCATCTCCTACGAGCAGTACTTC	CASSSYVKSISYEQYF	TRBV27	TRBJ2-7
TGTGCCAGCACGGACCGCCTCTTGAGACTGCCCCAGCATTTT	CASTDRLLRLPQHF	TRBV6-4	TRBJ1-5
TGTGCCAGGGGTGGCCCTTTGGGGGGGTGGCGAGAGACCCAGTACTTC	CARGGPLGGWRETQYF	TRBV2	TRBJ2-5
TGCAGTGCTATTCTTCCCATCCGGGACAGGGTCATGGTTAGCAATCAGCCCCAGCATTTT	CSAILPIRDRVMVSNQPQHF	TRBV20-1	TRBJ1-5
TGTCCCTTAGGGGGCTCTGGGGCCAACGTCCTGACTTTC	CPLGGSGANVLTF	TRBV10-3	TRBJ2-6
TGTGCCAGCAGCGTAGGTGTCAGGGAAAACAGGGATTCACCCCTCCACTTT	CASSVGVRENRDSPLHF	TRBV9	TRBJ1-6
TGCGCCAGCAGCTTGTTCACCTCCGGGACAGTTCCTAGCCAACGCGAGCAGTACTTC	CASSLFTSGTVPSQREQYF	TRBV5-1	TRBJ2-7
TGTGCCAGCAGCCGGAGGGACAGCTTC	CASSRRDSF	TRBV3-1	TRBJ2-7
TGTGCTAGTGGTTATCCGGGACTAGGGAAGGCAGATACGCAGTATTTT	CASGYPGLGKADTQYF	TRBV12-5	TRBJ2-3
TGTGCCAGCAGTGGTTACAGGGGGGCTAACTATGGCTACACCTTC	CASSGYRGANYGYTF	TRBV2	TRBJ1-2
TGCGCCAGCAGCTGGGCGGGAGGGACTGAAGCTTTCTTT	CASSWAGGTEAFF	TRBV5-1	TRBJ1-1
TGTGCCAGCAGTAGATCCCTCCACTTT	CASSRSLHF	TRBV2	TRBJ1-6
TGTGCCAGCTTAAGGGTGGACAGGCTGGAAGGGGGCGAAAATGAGCAGTTCTTC	CASLRVDRLEGGENEQFF	TRBV28	TRBJ2-1
TGTGCCAGCAGTGGACTTCGTCCTTTCTACGAGCAGTACTTC	CASSGLRPFYEQYF	TRBV6-2	TRBJ2-7
TGCGCCAGCAGCTTGAAGGACAGACGCTACATGGAGAACACTGAAGCTTTCTTT	CASSLKDRRYMENTEAFF	TRBV5-1	TRBJ1-1
TGCAGTGCTAGACGACCTCCCAGGGGGCCCCTCAATGAGCAGTTCTTC	CSARRPPRGPLNEQFF	TRBV20-1	TRBJ2-1
TGTGCCAGCAATACAGACACCGGGGAGCTGTTTTTT	CASNTDTGELFF	TRBV9	TRBJ2-2
TGTGCCATCAGGGGGGGGAACACCGGGGAGCTGTTTTTT	CAIRGGNTGELFF	TRBV10-3	TRBJ2-2
TGTGCCAGCGCCCGGCTGAACACTGAAGCTTTCTTT	CASARLNTEAFF	TRBV6-5	TRBJ1-1
TGTGCTAGTGGTGAAAGGGGGGGGAGCAGCTCCTACAATGAGCAGTTCTTC	CASGERGGSSSYNEQFF	TRBV12-5	TRBJ2-1
TGTGCCAGCAGTTTCGGACGGGGGTACAATGAGCAGTTCTTC	CASSFGRGYNEQFF	TRBV27	TRBJ2-1
TGTGCCAGCAGTGAGGGGTTTAACTATGGCTACACCTTC	CASSEGFNYGYTF	TRBV28	TRBJ1-2
TGTGCCAGCGAAAAGGGGCCCGGGGGCTCTGGGGCCAACGTCCTGACTTTC	CASEKGPGGSGANVLTF	TRBV6-1	TRBJ2-6
TGTGCCAGCAGCTTAACCTCCGCGGGAGGCGAGACCCAGTACTTC	CASSLTSAGGETQYF	TRBV7-3	TRBJ2-5
TGTGCCAGCAGCTTACGCAGGGGTGAGTCTTACGAGCAGTACTTC	CASSLRRGESYEQYF	TRBV7-7	TRBJ2-7
TGTGCCTGGAGTGCGACAGGGAGCAATCAGCCCCAGCATTTT	CAWSATGSNQPQHF	TRBV30	TRBJ1-5
TGTGCCAGCAGCTTGGCCGCGGGGGGAAATCAGCCCCAGCATTTT	CASSLAAGGNQPQHF	TRBV5-4	TRBJ1-5
TGTGCCAGCTCACCACGTACCGGGACAGTGAACACTGAAGCTTTCTTT	CASSPRTGTVNTEAFF	TRBV18	TRBJ1-1
TGTGCCAGCAGTTGTGACCTCTCTGGGGCCAACGTCCTGACTTTC	CASSCDLSGANVLTF	TRBV28	TRBJ2-6
TGTGCCAGCAGCCAAGAAGCCGGCCTTGAGCGTAGGTACCAAGAGACCCAGTACTTC	CASSQEAGLERRYQETQYF	TRBV14	TRBJ2-5
TGCGCCAGCAGCGTCTATTCCTACAATGAGCAGTTCTTC	CASSVYSYNEQFF	TRBV5-1	TRBJ2-1
TGTGCCAGCAGCTTAACAGGGGGAGGCAATAGCAATCAGCCCCAGCATTTT	CASSLTGGGNSNQPQHF	TRBV7-2	TRBJ1-5
TGTGCCAGCTCACCACGGGACAGGGGGCTGAGGTCTGGGGCCAACGTCCTGACTTTC	CASSPRDRGLRSGANVLTF	TRBV18	TRBJ2-6
TGTGCCAGCTTGACCACTAGCGGGAGGGGCACGAACACCGGGGAGCTGTTTTTT	CASLTTSGRGTNTGELFF	TRBV27	TRBJ2-2
TGTGCCAGCAGCACGAGGGATAGCAATCAGCCCCAGCATTTT	CASSTRDSNQPQHF	TRBV7-4	TRBJ1-5
TGCGCCAGCAGTGCCCAATGGGGGGGCATGGGCTCCTACAATGAGCAGTTCTTC	CASSAQWGGMGSYNEQFF	TRBV10-1	TRBJ2-1
TGTGCCAGCAGCGTAGCAGTCTCACTCGGGCCCCAGCATTTT	CASSVAVSLGPQHF	TRBV9	TRBJ1-5
TGTGCCAGCAGTTACGAACCACAGGGGATCAACACCGGGGAGCTGTTTTTT	CASSYEPQGINTGELFF	TRBV6-5	TRBJ2-2
TGTGCCAGCAGCTACCTGGGGGGGAATGAAAAACTGTTTTTT	CASSYLGGNEKLFF	TRBV7-8	TRBJ1-4
TGTGCCAGCAGCCATTGTCCAGCAAACGCGGAGTCCTATAATTCACCCCTCCACTTT	CASSHCPANAESYNSPLHF	TRBV13	TRBJ1-6
TGTGCCACCAGCAGAGATACTGGACAGGGAGGGGAGCAGTACTTC	CATSRDTGQGGEQYF	TRBV15	TRBJ2-7
TGTGCCAGCAGTTACGGCAGGGGGTGTCTCCCCCCCTACGAGCAGTACTTC	CASSYGRGCLPPYEQYF	TRBV6-6	TRBJ2-7
TGTGCCAGCAGTGAGCGACTAGGCTACCTCGGCCAAGAGACCCAGTACTTC	CASSERLGYLGQETQYF	TRBV2	TRBJ2-5
TGTGCCACCGGGACTAGCGGGAATTCGCAGTTCTTC	CATGTSGNSQFF	TRBV6-2	TRBJ2-1
TGTGCCAGCAGCTTACCAATCCCGTGGGGCGGGAGAGACGACGAGCAGTACTTC	CASSLPIPWGGRDDEQYF	TRBV7-2	TRBJ2-7
TGTGCCAGCAGTTTAGGGAGGATAGGTTTAAACAAGACCTACGAGCAGTACTTC	CASSLGRIGLNKTYEQYF	TRBV12-3	TRBJ2-7
TGTGCCAGTAGACATCTATGGCGGAGGAAGAACAATGAGCAGTTCTTC	CASRHLWRRKNNEQFF	TRBV19	TRBJ2-1
TGCGCCAGCAGCCAAGATTATCCAGGGGTACCCAAAAACATTCAGTACTTC	CASSQDYPGVPKNIQYF	TRBV4-3	TRBJ2-4
TGTGCCATGGGGGGCCCTGACAGCAATCAGCCCCAGCATTTT	CAMGGPDSNQPQHF	TRBV27	TRBJ1-5
TGCGCCAGGGGGGGAGGTGGCCCGAGCTCCTACAATGAGCAGTTCTTC	CARGGGGPSSYNEQFF	TRBV5-1	TRBJ2-1
TGTGCTAGTGGTTGTGGGGGGGCAAGAGGTGAGCAGTTCTTC	CASGCGGARGEQFF	TRBV12-5	TRBJ2-1
TGTGCCAGCGGGGGCCGGGGAGATCCTTCCTACGAGCAGTACTTC	CASGGRGDPSYEQYF	TRBV2	TRBJ2-7
TGTGCCATCAGTGAAGGGACTAGCGGGGGGTGCAATGAGCAGTTCTTC	CAISEGTSGGCNEQFF	TRBV10-3	TRBJ2-1
TGTGCCAGCAGTGAGAGTAGGCTAAATTCACCCCTCCACTTT	CASSESRLNSPLHF	TRBV6-1	TRBJ1-6
TGTGCCAGCAGCGTAGACAAACCGGAGCGGGGGGGCGGGTGGACCGAGGTAGGCACAGATACGCAGTATTTT	CASSVDKPERGGGWTEVGTDTQYF	TRBV9	TRBJ2-3
TGTGCCAGCAGCTTAGCTCACAGGGATGGAACCTACGAGCAGTACTTC	CASSLAHRDGTYEQYF	TRBV7-8	TRBJ2-7
TGTGCCAGCAGGTCGAACCAAGAGACCCAGTACTTC	CASRSNQETQYF	TRBV27	TRBJ2-5
TGTGCCACCAGCATTTCTAGCGGGATATTAACAGATACGCAGTATTTT	CATSISSGILTDTQYF	TRBV15	TRBJ2-3
TGCAGTGCTAAAGCCTATAGCTCCTACGAGCAGTACTTC	CSAKAYSSYEQYF	TRBV20-1	TRBJ2-7
TGCAGTGCCCAGAGGGAAGATGGCTACACCTTC	CSAQREDGYTF	TRBV20-1	TRBJ1-2
TGTAGCTCCAAAAACATTCAGTACTTC	CSSKNIQYF	TRBV10-3	TRBJ2-4
TGTGCCAGCAGTCGGTTGCGTTCCAACTACGAGCAGTACTTC	CASSRLRSNYEQYF	TRBV27	TRBJ2-7
TGTGCCTGGGACCGAAGTGATGGACAGCGAGGGACCACTGAAGCTTTCTTT	CAWDRSDGQRGTTEAFF	TRBV30	TRBJ1-1
TGTGCCACCAGTTTTGAGGCACCCTACGAGCAGTACTTC	CATSFEAPYEQYF	TRBV24-1	TRBJ2-7
TGTGCCAGCAGCGAACCCGACAGCCCGAACACCGGGGAGCTGTTTTTT	CASSEPDSPNTGELFF	TRBV9	TRBJ2-2
TGTGCCTGGAGTGTAAAATGGGGGGGAATTAGGTACGAGCAGTACTTC	CAWSVKWGGIRYEQYF	TRBV30	TRBJ2-7
TGTGCCAGCAGTCTCCGGCTAGAAGCCAAAGCCGATACGCAGTATTTT	CASSLRLEAKADTQYF	TRBV6-5	TRBJ2-3
TGCGCCAGCAGCCACCTACTACGGGGCTACGAGCAGTACTTC	CASSHLLRGYEQYF	TRBV4-1	TRBJ2-7
TGCAGTGCTAGTAAAAAGGGGGGAAGCGAGCAGTACTTC	CSASKKGGSEQYF	TRBV20-1	TRBJ2-7
TGTGCCAGCAGCCAAGAGGACCCGGGCGGGGGGTCCTACAATGAGCAGTTCTTC	CASSQEDPGGGSYNEQFF	TRBV14	TRBJ2-1
TGCGCCAGGACAGGGGCCACCGGGGAGCTGTTTTTT	CARTGATGELFF	TRBV5-1	TRBJ2-2
TGTGCCAGCAAAGTGGGGAGGGGCGGAGGCAAAAACATTCAGTACTTC	CASKVGRGGGKNIQYF	TRBV6-4	TRBJ2-4
TGTGCCAGCAGCACCCTGGGACGAGATCAGCCCCAGCATTTT	CASSTLGRDQPQHF	TRBV5-4	TRBJ1-5
TGTGCCAGCAGCCCACTAGCGGGAGCCCCGTACGAGCAGTACTTC	CASSPLAGAPYEQYF	TRBV7-3	TRBJ2-7
TGTGCCAGCACCCCGGGACAGGGCTACACTGAAGCTTTCTTT	CASTPGQGYTEAFF	TRBV12-3	TRBJ1-1
TGTGCCAGCAGGCGCTCCCGGTTTTATCAGCCCCAGCATTTT	CASRRSRFYQPQHF	TRBV27	TRBJ1-5
TGTGCCAGCAGCATAGCAGGGGGCTACACCTTC	CASSIAGGYTF	TRBV9	TRBJ1-2
TGTGCCAGCAATAAACGAGAGGGACTAGCGGGACAAGAGACCCAGTACTTC	CASNKREGLAGQETQYF	TRBV27	TRBJ2-5
TGTGCCAGCAGCAAAGACAGGCGATATGGCTACACCTTC	CASSKDRRYGYTF	TRBV9	TRBJ1-2
TGTGAGAATAGCAATCAGCCCCAGCATTTT	CENSNQPQHF	TRBV7-2	TRBJ1-5
TGTGCCAGCAGTGACGATTCGGGGCTTAGGAACACTGAAGCTTTCTTT	CASSDDSGLRNTEAFF	TRBV6-4	TRBJ1-1
TGTGCCAGCTGGGCGGGAAACGCGAGCACTGAAGCTTTCTTT	CASWAGNASTEAFF	TRBV28	TRBJ1-1
TGTGCCAGCAGTGATACTGCTAGCGGGCTAAGGGCAGATACGCAGTATTTT	CASSDTASGLRADTQYF	TRBV6-4	TRBJ2-3
TGTGCCAGCAGATGGCAGGCGGGAACTGGCTACACCTTC	CASRWQAGTGYTF	TRBV5-4	TRBJ1-2
TGTGCCAGCAGCCCCAACAGGACGAATAGCAATCAGCCCCAGCATTTT	CASSPNRTNSNQPQHF	TRBV6-2	TRBJ1-5
TGCAGTGCACTCCGGGACAGCTTACGCATTCAGTACTTC	CSALRDSLRIQYF	TRBV20-1	TRBJ2-4
TGCAGCGGGGACAGGGTTCAAGAGACCCAGTACTTC	CSGDRVQETQYF	TRBV29-1	TRBJ2-5
TGTGCCATCAGTGAGGAAGTCGGACACCACTATGGCTACACCTTC	CAISEEVGHHYGYTF	TRBV10-3	TRBJ1-2
TGTGCCAGCAGCTGGACAGGGGTAAATGAAGCTTTCTTT	CASSWTGVNEAFF	TRBV7-8	TRBJ1-1
TGTGCCAGCAGTTTGGGGGGCGCATATAATGAGCAGTTCTTC	CASSLGGAYNEQFF	TRBV6-5	TRBJ2-1
TGTGCCAGCCGCGGTGACACTGAAGCTTTCTTT	CASRGDTEAFF	TRBV9	TRBJ1-1
TGTGCCACCAGTGCGGGACAGGGGGGGGACGAGACCCAGTACTTC	CATSAGQGGDETQYF	TRBV24-1	TRBJ2-5
TGTGCCAGCAGGCAAGTAAGACAGAACTTGCAAGAGACCCAGTACTTC	CASRQVRQNLQETQYF	TRBV28	TRBJ2-5
TGTGCCAGCAGTAAGGGGGCGAGAGGAAACACCATATATTTT	CASSKGARGNTIYF	TRBV25-1	TRBJ1-3
TGTGCCATCAGTGCGACTAGGGGAGTGTACGAGCAGTACTTC	CAISATRGVYEQYF	TRBV10-3	TRBJ2-7
TGTCCGGGAGGGGGGGGCTACACCTTC	CPGGGGYTF	TRBV19	TRBJ1-2
TGCGCCAGCAGCTCAGGGGGCGATGAAAAACTGTTTTTT	CASSSGGDEKLFF	TRBV10-1	TRBJ1-4
TGTGCCAGCAGCATACGGACTTGTTTTAACTCCTATAATTCACCCCTCCACTTT	CASSIRTCFNSYNSPLHF	TRBV9	TRBJ1-6
TGTGCCAGCAGCTTCAGAAGGGGACGAAGCCTGAACACTGAAGCTTTCTTT	CASSFRRGRSLNTEAFF	TRBV7-2	TRBJ1-1
TGTGCCATCTGCCGGGACAGGGGGCGCCCGGCTGGAAACACCATATATTTT	CAICRDRGRPAGNTIYF	TRBV10-3	TRBJ1-3
TGTGCCAGCAGAACGAAGGCGCGAAATGAAAAACTGTTTTTT	CASRTKARNEKLFF	TRBV12-4	TRBJ1-4
TGTGCCAGCAGCGGGAGGTTGCGTGAGACCCAGTACTTC	CASSGRLRETQYF	TRBV27	TRBJ2-5
TGTGCCAGCAGTTACGGCAGGACAGGCAGGTTTCCTGAAGCTTTCTTT	CASSYGRTGRFPEAFF	TRBV28	TRBJ1-1
TGTGCCAGCAGTGACTCGAGACGGGCGAGTAGCTCCTATAATTCACCCCTCCACTTT	CASSDSRRASSSYNSPLHF	TRBV6-4	TRBJ1-6
TGTGCCAGCAGCCGGGTAGGACAGGGGGGAATGTTCTTAACTGAAGCTTTCTTT	CASSRVGQGGMFLTEAFF	TRBV7-2	TRBJ1-1
TGTGCCAGCAGTTTTATTTCGGGACAGTTGCCTGGCTACACCTTC	CASSFISGQLPGYTF	TRBV28	TRBJ1-2
TGTGCCAGCAGCCAAGTGGGGACAAACCGGTCCTACGAGCAGTACTTC	CASSQVGTNRSYEQYF	TRBV14	TRBJ2-7
TGTGCCAGCAGCCAGCCAGACAGAACCGGGATGAACACTGAAGCTTTCTTT	CASSQPDRTGMNTEAFF	TRBV14	TRBJ1-1
TGTGCCAGCAGCCCCAACAGCTATGGCTACACCTTC	CASSPNSYGYTF	TRBV6-4	TRBJ1-2
TGTGCCAGCAGGCTTGGCGCCGGGACAGGGGCCTACGAGCAGTACTTC	CASRLGAGTGAYEQYF	TRBV5-4	TRBJ2-7
TGTGCCAGCACTGCGTGCTGGCCCCCAGATACGCAGTATTTT	CASTACWPPDTQYF	TRBV27	TRBJ2-3
TGTGCTATACTTAAGGGCTTTGAAATTATGAACACTGAAGCTTTCTTT	CAILKGFEIMNTEAFF	TRBV6-5	TRBJ1-1
TGTGCCAGCAGTTTACCCAAGGGGGTCGAGCAGTACTTC	CASSLPKGVEQYF	TRBV27	TRBJ2-7
TGCAGTCGGCGGACAGCCCTTCAACAAGAGACCCAGTACTTC	CSRRTALQQETQYF	TRBV20-1	TRBJ2-5
TGTGCCAGCAGCGCGAAAGGTTACTGGGGGAATCAGCCCCAGCATTTT	CASSAKGYWGNQPQHF	TRBV9	TRBJ1-5
TGTGCCACCGGACTAGAGGCGGGGGATACGCAGTATTTT	CATGLEAGDTQYF	TRBV6-1	TRBJ2-3
TGTGCCTGGAGTGTATCCTTTTGGGGGGGTGCGAATGAGCAGTTCTTC	CAWSVSFWGGANEQFF	TRBV30	TRBJ2-1
TGTGCCAGCAGGCCCGTCGGCCCCTCCTATAATTCACCCCTCCACTTT	CASRPVGPSYNSPLHF	TRBV14	TRBJ1-6
TGCGCCAGCAGCCCGGAGGGTTACAAGGAGCTGTTTTTT	CASSPEGYKELFF	TRBV4-3	TRBJ2-2
TGTGCCAGCAGCTTGCGCAGGCTAACAAATGAGCAGTTCTTC	CASSLRRLTNEQFF	TRBV5-4	TRBJ2-1
TGTGCCAGCAGCCCCGCGGGAGAATCTGAAGCTTTCTTT	CASSPAGESEAFF	TRBV7-2	TRBJ1-1
TGCAGTGCTAGGGGAAGTACCCCACGGGATACCGCAACTAATGAAAAACTGTTTTTT	CSARGSTPRDTATNEKLFF	TRBV20-1	TRBJ1-4
TGTGCCACCAGTGATTTGTGGGCGAAAGCGGGTACTAATGAAAAACTGTTTTTT	CATSDLWAKAGTNEKLFF	TRBV24-1	TRBJ1-4
TGCGCCAGCAGTGAATTAGCGGGCTACGAGCAGTACTTC	CASSELAGYEQYF	TRBV10-1	TRBJ2-7
TGTGCCAGCAGGGGCCAGGACGATTATAATTCACCCCTCCACTTT	CASRGQDDYNSPLHF	TRBV6-5	TRBJ1-6
TGTGCCAGCAGTCCCCTGGGGGGGAGTCAGCCCCAGCATTTT	CASSPLGGSQPQHF	TRBV28	TRBJ1-5
TGTGCCAGTAGTACGGGGAGTTCTACCTACGAGCAGTACTTC	CASSTGSSTYEQYF	TRBV19	TRBJ2-7
TGTGCCAGCAGCTCTGTACTGCGCTATGGCTACACCTTC	CASSSVLRYGYTF	TRBV5-6	TRBJ1-2
TGCGCCTCACGACCGGGACAGGGCTACACCTTC	CASRPGQGYTF	TRBV10-1	TRBJ1-2
TGCAGTGCTAGCACCCAGGGGTGGGGCACTGAAGCTTTCTTT	CSASTQGWGTEAFF	TRBV20-1	TRBJ1-1
TGCACCCGTCCATCACGGGGTAATTCGGACTTC	CTRPSRGNSDF	TRBV20-1	TRBJ2-5
TGTGCCAGCAGTGAAGCTAGTTCACTGGGACAGGGGCCGAATACCGGGGAGCTGTTTTTT	CASSEASSLGQGPNTGELFF	TRBV2	TRBJ2-2
TGTGCCAGCAGTTACTCAAAAGAGGAGGGGGGCCCGAGGGAGCAGTACTTC	CASSYSKEEGGPREQYF	TRBV6-5	TRBJ2-7
TGTGCCACCAGCAGAACGGGGAGGCCAGAGACCCAGTACTTC	CATSRTGRPETQYF	TRBV15	TRBJ2-5
TGTGCCAGCGATACCGGAGGTAAGCAGTTCTTC	CASDTGGKQFF	TRBV7-4	TRBJ2-1
TGCAGTGTTGGAAAGATTCTAGCGGGGCCTATGCCCAATGAGCAGTTCTTC	CSVGKILAGPMPNEQFF	TRBV20-1	TRBJ2-1
TGTGCCAGTAGTGATCCTACGAAGCCGGGACTAGCGGGGGGGCAGGGCCCCTCCTACAATGAGCAGTTCTTC	CASSDPTKPGLAGGQGPSYNEQFF	TRBV19	TRBJ2-1
TGTGCCATCAGTGTCATGACAGGGCGGGTCGTCTTC	CAISVMTGRVVF	TRBV10-3	TRBJ2-1
TGCGCCAGCAGTGAGAACGGGAGGGGACAAGAGACCCAGTACTTC	CASSENGRGQETQYF	TRBV10-1	TRBJ2-5
TGCGCCAGCACTCGGGGGGGCTACGAGCAGTACTTC	CASTRGGYEQYF	TRBV10-1	TRBJ2-7
TGTGCCAGCAGGTACTGGGGCACCTACAATGAGCAGTTCTTC	CASRYWGTYNEQFF	TRBV11-2	TRBJ2-1
TGTGCCACCCTACTAGCGGTCGACAGGGGACCTCTCCAAGAGACCCAGTACTTC	CATLLAVDRGPLQETQYF	TRBV19	TRBJ2-5
TGCGCCAGCCAGATCTCGGGGGAGCATCAGCCCCAGCATTTT	CASQISGEHQPQHF	TRBV5-1	TRBJ1-5
TGTGCCAGCAGTTTATCCCCCTTGAATAGCGGGATGGAGACCTACGAGCAGTACTTC	CASSLSPLNSGMETYEQYF	TRBV27	TRBJ2-7
TGCGCCAAACCAATTGGGACAGATGGAAACACCATATATTTT	CAKPIGTDGNTIYF	TRBV10-1	TRBJ1-3
TGTGCCAGCAGCGTGGTCGACAGGGGGCGCTACGAGCAGTACTTC	CASSVVDRGRYEQYF	TRBV9	TRBJ2-7
TGTGCCAGGTCAAACCGCACCCACAAGGGACAGGGCTCTGGAAACACCATATATTTT	CARSNRTHKGQGSGNTIYF	TRBV19	TRBJ1-3
TGCAGTGCTAGAGCGGCAGGGGGTGGCTACACCTTC	CSARAAGGGYTF	TRBV20-1	TRBJ1-2
TGCAGTGCTAGGAGGGACAGGGGGCCGGTCAATCAGCCCCAGCATTTT	CSARRDRGPVNQPQHF	TRBV20-1	TRBJ1-5
TGCGCCAGCAGCGAAGACAGGGGGTACCAAGAGACCCAGTACTTC	CASSEDRGYQETQYF	TRBV5-1	TRBJ2-5
TGTGCCAGCAGCCCGTTAATCCCGGCCGCGGGGGTTGGCAATCAGCCCCAGCATTTT	CASSPLIPAAGVGNQPQHF	TRBV27	TRBJ1-5
TGTGCCAGCATCGGGGTAGGGCTTATGATGCACACTGAAGCTTTCTTT	CASIGVGLMMHTEAFF	TRBV6-4	TRBJ1-1
TGTGCCAGCAGCACCGTAGACAGGGTAGCTGGAAACACCATATATTTT	CASSTVDRVAGNTIYF	TRBV7-2	TRBJ1-3
TGCAGTGCTAGAGAAACCATAAACAATAGCAATCAGCCCCAGCATTTT	CSARETINNSNQPQHF	TRBV20-1	TRBJ1-5
TGTGCCACCAGTGATTTGCATCTCCACTCTAGAGCCGGGGAGCTGTTTTTT	CATSDLHLHSRAGELFF	TRBV24-1	TRBJ2-2
TGTGCCAGCAGCCGCATTTACTCCTACGAGCAGTACTTC	CASSRIYSYEQYF	TRBV9	TRBJ2-7
TGTGCCAGCAGCTTGAGGGGGAACACAGATACGCAGTATTTT	CASSLRGNTDTQYF	TRBV7-6	TRBJ2-3
TGCAGTGCAGGGAACGAGCAGTACTTC	CSAGNEQYF	TRBV20-1	TRBJ2-7
TGCAGGCCTGAGGGGGGGCTTGCCACAGTAGAGACCCAGTACTTC	CRPEGGLATVETQYF	TRBV29-1	TRBJ2-5
TGTGCCAGCAGCGCCCTGGGAACCTACAATGAGCAGTTCTTC	CASSALGTYNEQFF	TRBV13	TRBJ2-1
TGTGCTTTATACAGGGGAAGTTACAACACTGAAGCTTTCTTT	CALYRGSYNTEAFF	TRBV2	TRBJ1-1
TGTGCCAGCTTAGGCTTGGAGATCTACGAGCAGTACTTC	CASLGLEIYEQYF	TRBV27	TRBJ2-7
TGTGCCAGCTCACCAGGGGGTCCTGGCTACACCTTC	CASSPGGPGYTF	TRBV18	TRBJ1-2
TGTGCCAGCAGCTCGGACGGAAGGGCCGCTGGCTACACCTTC	CASSSDGRAAGYTF	TRBV5-4	TRBJ1-2
TGTGCCAGCAGTGAAGCGCCTCCGGGACCTTTGTACGAGCAGTACTTC	CASSEAPPGPLYEQYF	TRBV6-1	TRBJ2-7
TGTGCCAGTTGGACCCCCCAGGGGTACTCCTACGAGCAGTACTTC	CASWTPQGYSYEQYF	TRBV19	TRBJ2-7
TGTGCCAGCAGCCAAACCACAGGTTTCTACGAGCAGTACTTC	CASSQTTGFYEQYF	TRBV4-2	TRBJ2-7
TGTGCCAGCAGAAGCGGACAATATTGCTCTGGAAACACCATATATTTT	CASRSGQYCSGNTIYF	TRBV16	TRBJ1-3
TGCAATCAGGGGTCTACAGATACGCAGTATTTT	CNQGSTDTQYF	TRBV20-1	TRBJ2-3
TGTGCTAGTTCCCCGGGACAGGTGGAATCCCCGAATGGCTACACCTTC	CASSPGQVESPNGYTF	TRBV12-5	TRBJ1-2
TGTGCCAGCAGTTTCAACCCCCCGACTCCATCGTGTCCTAGGGGCACCGGGGAGCTGTTTTTT	CASSFNPPTPSCPRGTGELFF	TRBV27	TRBJ2-2
TGTGCCAGCAGCTCCGGCCGCCGAGCCTCCTATAATTCACCCCTCCACTTT	CASSSGRRASYNSPLHF	TRBV11-1	TRBJ1-6
TGCGCCAGCAGCCGACCCGACAGCACAGATACGCAGTATTTT	CASSRPDSTDTQYF	TRBV5-1	TRBJ2-3
TGTGCCACCACATTGACACCTTCGGGGCCGTATAATTCACCCCTCCACTTT	CATTLTPSGPYNSPLHF	TRBV24-1	TRBJ1-6
TGTGCCAGCAGTCTCTTGGAGGGACAGGGCTACACCTTC	CASSLLEGQGYTF	TRBV6-1	TRBJ1-2
TGTGCCACCAGCAGAACAGGGGGGGGTTGGGGGTCTGGGGCCAACGTCCTGACTTTC	CATSRTGGGWGSGANVLTF	TRBV15	TRBJ2-6
TGTGCCAGCAGCTTAGTCCTGCGACTAGCGGGAGCCAATGCCTACAATGAGCAGTTCTTC	CASSLVLRLAGANAYNEQFF	TRBV13	TRBJ2-1
TGTGCCAGCAGCTTAGGTCCGCAAGCGGACAGCTACGAGCAGTACTTC	CASSLGPQADSYEQYF	TRBV11-3	TRBJ2-7
TGCAGTGCTAGAGATCGCACAGGGGGGAAGGCCCACTATGGCTACACCTTC	CSARDRTGGKAHYGYTF	TRBV20-1	TRBJ1-2
TGTGCCAGCAGCTTCATGTACGGTCAGGGGGTGAACACTGAAGCTTTCTTT	CASSFMYGQGVNTEAFF	TRBV5-4	TRBJ1-1
TGCAGTGCTAAAAAAGGAGGGACAGCATATGGCTACACCTTC	CSAKKGGTAYGYTF	TRBV20-1	TRBJ1-2
TGTGCCAGCAGTTTATGCTCGTGGACTAGCGGGGAGACCCAGTACTTC	CASSLCSWTSGETQYF	TRBV28	TRBJ2-5
TGTGCCAGCAGCCAAGATTTGAGGAGGGCCGAGGGCACAGATACGCAGTATTTT	CASSQDLRRAEGTDTQYF	TRBV4-2	TRBJ2-3
TGTGCCAGCAGCAAGACAGGGGGAGCAGCTTTCTTT	CASSKTGGAAFF	TRBV5-4	TRBJ1-1
TGTGCCAGCAGCAATGAACAGGTAAATTCACCCCTCCACTTT	CASSNEQVNSPLHF	TRBV9	TRBJ1-6
TGTGCCAGCCTAACTCAAGGGGACTCTCACACCGGGGAGCTGTTTTTT	CASLTQGDSHTGELFF	TRBV9	TRBJ2-2
TGTGCCAGCACCAGGGATGGGGTCTATGGCTACACCTTC	CASTRDGVYGYTF	TRBV6-5	TRBJ1-2
TGTGCCAGCAGCCGGCCAAGACAGAACACTGAAGCTTTCTTT	CASSRPRQNTEAFF	TRBV7-2	TRBJ1-1
TGCGCCAGCAGCTCGGGACATGAAAAACTGTTTTTT	CASSSGHEKLFF	TRBV5-1	TRBJ1-4
TGTGCCAGCATAGGGGGGCAGGATTGGTCCAATCAGCCCCAGCATTTT	CASIGGQDWSNQPQHF	TRBV28	TRBJ1-5
TGCAGTGCTGGGGTACTAGCAGATACGCAGTATTTT	CSAGVLADTQYF	TRBV20-1	TRBJ2-3
TGCGCCAGCAGCCAAGACGTTCGGGACAGGGAAGGCTCGGATGAGCAGTTCTTC	CASSQDVRDREGSDEQFF	TRBV4-3	TRBJ2-1
TGTGCCACCAGTGAGAGGGGGGGTCCCGCTAGGAGCACAGATACGCAGTATTTT	CATSERGGPARSTDTQYF	TRBV24-1	TRBJ2-3
TGTGCCAGCAGTGGTGGGACCGGCCAACACGACGAGGGGTATAATTCACCCCTCCACTTT	CASSGGTGQHDEGYNSPLHF	TRBV25-1	TRBJ1-6
TGTGCCAGCAGCCAAGAGGGGGGACAGGGGTACCAAGAGACCCAGTACTTC	CASSQEGGQGYQETQYF	TRBV14	TRBJ2-5
TGTGCCAGCAGCGTAGCTCGAAGACCCGGGGACACTGGAAACACCATATATTTT	CASSVARRPGDTGNTIYF	TRBV9	TRBJ1-3
TGTGCCAGCAGAGCCTCCGGGACAGAAATCAATTCACCCCTCCACTTT	CASRASGTEINSPLHF	TRBV13	TRBJ1-6
TGTGCCATCACGGACAGGGGGAAGTTGACACCCTACGAGCAGTACTTC	CAITDRGKLTPYEQYF	TRBV10-3	TRBJ2-7
TGTGCCAGCAGTTATCAGGGGTGCCGCAATCAGCCCCAGCATTTT	CASSYQGCRNQPQHF	TRBV6-3	TRBJ1-5
TGTGCCAGTAGTTCTCAACAGGGGGCTAACTATGGCTACACCTTC	CASSSQQGANYGYTF	TRBV19	TRBJ1-2
TGTGCCAGCAGTTTTTCAGCCAGTGAGCAGTACTTC	CASSFSASEQYF	TRBV27	TRBJ2-7
TGCGCCAGCAGCGGTCGAGGGAGTTACAATGAGCAGTTCTTC	CASSGRGSYNEQFF	TRBV5-1	TRBJ2-1
TGTGCCAGCAGTTTATCGGAGGTTTACAATCAGCCCCAGCATTTT	CASSLSEVYNQPQHF	TRBV27	TRBJ1-5
TGTGCCACCAGTGCGTATTCTACGGGGGAGGCCTACGAGCAGTACTTC	CATSAYSTGEAYEQYF	TRBV24-1	TRBJ2-7
TGCGCCAGCAGGCACCTAATAAAAAGTCTTGAAAAACTGTTTTTT	CASRHLIKSLEKLFF	TRBV10-1	TRBJ1-4
TGTGCCACCACCGTATGTGGAAAACCGGGACAGGAAAGGGAGACCCAGTACTTC	CATTVCGKPGQERETQYF	TRBV24-1	TRBJ2-5
TGTGCCAGCGTCACGGACTACCAAGAGACCCAGTACTTC	CASVTDYQETQYF	TRBV9	TRBJ2-5
TGTGCCAGCAGTTACTTCCACCGGGAGTTGACAGATACGCAGTATTTT	CASSYFHRELTDTQYF	TRBV6-5	TRBJ2-3
TGTGCCTGGAGTCCTCGGAGGGAGCAGTACTTC	CAWSPRREQYF	TRBV30	TRBJ2-7
TGTGCCAGCAGCTTACGGCGGGGACAGGGGGCGCTGACCAATGAGCAGTTCTTC	CASSLRRGQGALTNEQFF	TRBV7-6	TRBJ2-1
TGTGCCAGCAGCTGGCCTTATTCCTATAGCAATCAGCCCCAGCATTTT	CASSWPYSYSNQPQHF	TRBV7-9	TRBJ1-5
TGTGCCAGCAGTTCAGGGTGGTTAATACCGGGACAGGGGTCCTACGAGCAGTACTTC	CASSSGWLIPGQGSYEQYF	TRBV27	TRBJ2-7
TGCAGTGCTAGATCCTGGGTTCAGGGGGCCAGAATGACGAGCTCCTACAATGAGCAGTTCTTC	CSARSWVQGARMTSSYNEQFF	TRBV20-1	TRBJ2-1
TGTGCCAGCAGCTTCACTAGCGGGGATACCAACAATGAGCAGTTCTTC	CASSFTSGDTNNEQFF	TRBV27	TRBJ2-1
TGCAGCGTTGCAACAGGGGGCTTTGGGGCTGAAGCTTTCTTT	CSVATGGFGAEAFF	TRBV29-1	TRBJ1-1
TGTGCCAGTAGTATAAACGGCAGCTTGGGTGAGAATGAGCAGTTCTTC	CASSINGSLGENEQFF	TRBV19	TRBJ2-1
TGTGCCAGTAGGAGGGGGGCGATACAGGGGGCTGGAAGCTCCTACAATGAGCAGTTCTTC	CASRRGAIQGAGSSYNEQFF	TRBV19	TRBJ2-1
TGTGCCAGCAGGGGACCCACGAAACCTCCCACAGATACGCAGTATTTT	CASRGPTKPPTDTQYF	TRBV6-5	TRBJ2-3
TGTGCCACCGGGTCAAGACGGGTTAGCACAGATACGCAGTATTTT	CATGSRRVSTDTQYF	TRBV12-4	TRBJ2-3
TGTGCCGGACAGGGCTACGAGCAGTACTTC	CAGQGYEQYF	TRBV7-2	TRBJ2-7
TGTGCCAGCAGTTACTCGACCGGGAGTAGGATGGCCGAGACCCAGTACTTC	CASSYSTGSRMAETQYF	TRBV6-5	TRBJ2-5
TGTGCCAGCATCGGACTGTCCTTAGGGGGGATATCTGGGGCCAACGTCCTGACTTTC	CASIGLSLGGISGANVLTF	TRBV6-1	TRBJ2-6
TGTGCCAGCAGTAGGCACAGGTTTAAATCCGGCTACACCTTC	CASSRHRFKSGYTF	TRBV12-4	TRBJ1-2
TGTGCCAGCCTTCACCGGGGAAGAGGAACTAATTCACCCCTCCACTTT	CASLHRGRGTNSPLHF	TRBV25-1	TRBJ1-6
TGCGCCAGCATCCCGGGACGGACGAACACCGGGGAGCTGTTTTTT	CASIPGRTNTGELFF	TRBV10-2	TRBJ2-2
TGTGCCAGCAGCAATCCTAGACAGGGGAGCTCTGGGGCCAACGTCCTGACTTTC	CASSNPRQGSSGANVLTF	TRBV13	TRBJ2-6
TGCGCCAGCAAGGGGAGGGGGAGGATCAATCAGCCCCAGCATTTT	CASKGRGRINQPQHF	TRBV10-1	TRBJ1-5
TGTGCCAGCATGGTTACCCGGGATCCTAACTGTGGCTACACCTTC	CASMVTRDPNCGYTF	TRBV5-6	TRBJ1-2
TGTGCCAGCAGCGTGTTAGTCCACTACGAGCAGTACTTC	CASSVLVHYEQYF	TRBV13	TRBJ2-7
TGTGCCAGCAGCACAGGGGGGAGGCAGTACTTC	CASSTGGRQYF	TRBV7-7	TRBJ2-7
TGTGCCAGCAGCCAACGTTTGGTTCAAAGGGGGGCACCGTTATACTACGAGCAGTACTTC	CASSQRLVQRGAPLYYEQYF	TRBV3-1	TRBJ2-7
TGTGCCAGTAGTAAGTTGCGGGAACCCCCAGATCCCACTGAAGCTTTCTTT	CASSKLREPPDPTEAFF	TRBV19	TRBJ1-1
TGTGCCAGTATTTACAGAGGGGACTATGGCTACACCTTC	CASIYRGDYGYTF	TRBV19	TRBJ1-2
TGTGCCAGCAGCCCACAAGGGGCGCCCCCAGATACGCAGTATTTT	CASSPQGAPPDTQYF	TRBV7-6	TRBJ2-3
TGTGCCCCCCGCCCGCTAGGGGTAGGCTCTGGAAACACCATATATTTT	CAPRPLGVGSGNTIYF	TRBV7-9	TRBJ1-3
TGCAGTGCTAGAGTCAGGGGAATATCACCCCTCCACTTT	CSARVRGISPLHF	TRBV20-1	TRBJ1-6
TGCAGTGCTAGTGATGGGACAGCAGGGTCTGAGCAGTACTTC	CSASDGTAGSEQYF	TRBV20-1	TRBJ2-7
TGTGCCACCAGCAAACGCCAGTATTTT	CATSKRQYF	TRBV24-1	TRBJ2-3
TGTGCCAGCAGCGATGTAAATATAATTGGCTATGGCTACACCTTC	CASSDVNIIGYGYTF	TRBV9	TRBJ1-2
TGTGCCATCAGGTCCACCTATACCCTTAGAACGACCCAGCCCCAGCATTTT	CAIRSTYTLRTTQPQHF	TRBV10-3	TRBJ1-5
TGTGCCAGCAGCCAACCCCCGGAACCGCACCATCAGCCCCAGCATTTT	CASSQPPEPHHQPQHF	TRBV3-1	TRBJ1-5
TGTGCCACCAGTGGGGGGGGAGCCGAGCAGTACTTC	CATSGGGAEQYF	TRBV24-1	TRBJ2-7
TGTGCCAGCAGTAGGACGGAAGCTTTCTTT	CASSRTEAFF	TRBV28	TRBJ1-1
TGCGCCAGCACGCAGGGCTACACCTTC	CASTQGYTF	TRBV5-1	TRBJ1-2
TGTGCCACAACACTAGTCCCACCAGATACGCAGTATTTT	CATTLVPPDTQYF	TRBV24-1	TRBJ2-3
TGTGCCAGCAGCGTCTTTACTTGTTCCAGGCCACTCTCCTACGAGCAGTACTTC	CASSVFTCSRPLSYEQYF	TRBV13	TRBJ2-7
TGTGCCAGCACCTATTCCAAAACCTCTGGGGCCAACGTCCTGACTTTC	CASTYSKTSGANVLTF	TRBV9	TRBJ2-6
TGTGCCAGCAGCTGGGACATCTACGAGCAGTACTTC	CASSWDIYEQYF	TRBV7-6	TRBJ2-7
TGCGCCAGCAGGCTAGCGGGAAGGACCTACGAGCAGTACTTC	CASRLAGRTYEQYF	TRBV4-1	TRBJ2-7
TGTGCCAGCAGGAAGGACAGGGGGGGTACGGATACCTACGAGCAGTACTTC	CASRKDRGGTDTYEQYF	TRBV5-6	TRBJ2-7
TGTGCCAGCAGCGAATTACACAGGGGTTGCTCAGGGAATCAGCCCCAGCATTTT	CASSELHRGCSGNQPQHF	TRBV7-9	TRBJ1-5
TGTGCCACCAGTGATTTGCCACAATCCGCGGCGGGGGAGACCCAGTACTTC	CATSDLPQSAAGETQYF	TRBV24-1	TRBJ2-5
TGTGCCAGCAGCTGGAAAATAGGTAGGGGGCCTCCAGATACGCAGTATTTT	CASSWKIGRGPPDTQYF	TRBV7-6	TRBJ2-3
TGCAGCGTTGAGGAACCCGGAATCAATGAGCAGTTCTTC	CSVEEPGINEQFF	TRBV29-1	TRBJ2-1
TGCGCCAGCGCAGGGCAGCCCCAGCATTTT	CASAGQPQHF	TRBV10-1	TRBJ1-5
TGCAGTGCTAGAGACAGGAAAACCGGGGAGCTGTTTTTT	CSARDRKTGELFF	TRBV20-1	TRBJ2-2
TGTGCCAGCAGCTTACGACGCCAGTATGGCTACACCTTC	CASSLRRQYGYTF	TRBV9	TRBJ1-2
TGCAGTGCAGCTCGCAATGAGCAGTTCTTC	CSAARNEQFF	TRBV20-1	TRBJ2-1
TGTGCCAGCAGCTTAGTTAATACTAACTATGGCTACACCTTC	CASSLVNTNYGYTF	TRBV7-9	TRBJ1-2
TGTGCCAGCAGTGGCGGGAGCTTAGGCATGAACACTGAAGCTTTCTTT	CASSGGSLGMNTEAFF	TRBV27	TRBJ1-1
TGTGCCAGCAGCCATGAGGGGGGGGTTTCCGAGACCCAGTACTTC	CASSHEGGVSETQYF	TRBV7-8	TRBJ2-5
TGTGCCAGCAGTTACTTGGGGAAGCAAGAGACCCAGTACTTC	CASSYLGKQETQYF	TRBV6-9	TRBJ2-5
TGTGCCAGCGATTGGGACAGTCGAGGGGGGACTGAAGCTTTCTTT	CASDWDSRGGTEAFF	TRBV6-4	TRBJ1-1
TGTGCCATGCGAGTTTACGAGCAGTACTTC	CAMRVYEQYF	TRBV19	TRBJ2-7
TGTGCCAGCAGTTACCCGGACAGATTCGGGAACACTGAAGCTTTCTTT	CASSYPDRFGNTEAFF	TRBV6-6	TRBJ1-1
TGTGCCAGCAGAGCCCCCCGCGAGGGAATGAACACTGAAGCTTTCTTT	CASRAPREGMNTEAFF	TRBV2	TRBJ1-1
TGTGCCAGCAGTTTCCCCCCGGGACAGGGGTTGTCCAGGAACACCGGGGAGCTGTTTTTT	CASSFPPGQGLSRNTGELFF	TRBV28	TRBJ2-2
TGTGCCAGCAGTCATAGAGTGGAGAACGCGGGCACCGGGGAGCTGTTTTTT	CASSHRVENAGTGELFF	TRBV12-4	TRBJ2-2
TGTGCCAGCAGCCCCCGACTAGCGGGTATGAAGACAAACATTCAGTACTTC	CASSPRLAGMKTNIQYF	TRBV11-3	TRBJ2-4
TGCGCCAGCAGCCAGGGGACAGGGGTCGGAGCCAAAAACATTCAGTACTTC	CASSQGTGVGAKNIQYF	TRBV5-1	TRBJ2-4
TGTGCCAGCAGCTTGGTTGAGGACAGGGATCGTGGCTACACCTTC	CASSLVEDRDRGYTF	TRBV5-6	TRBJ1-2
TGTGCCAGCAGCCAGACACAAACAGTTTATAATTCACCCCTCCACTTT	CASSQTQTVYNSPLHF	TRBV3-1	TRBJ1-6
TGTGCCAGCAGTTACCCGCCAGGGGGCTACAATGAGCAGTTCTTC	CASSYPPGGYNEQFF	TRBV6-5	TRBJ2-1
TGTGCCAGCAGCTTAGATAGAAACAACCGGGGAAGGACATCTGGGGTCTACGAGCAGTACTTC	CASSLDRNNRGRTSGVYEQYF	TRBV11-2	TRBJ2-7
TGTGCCAGCAGCCAAGTCTACGCGAGGTCCTACAATGAGCAGTTCTTC	CASSQVYARSYNEQFF	TRBV3-1	TRBJ2-1
TGTGCCAGCAGCACTCGTGAATGCGGGCTCTCCTACGAGCAGTACTTC	CASSTRECGLSYEQYF	TRBV11-3	TRBJ2-7
TGTGCCAGCAGGATGTGTGGTGGCGTTGAGTACAATGAGCAGTTCTTC	CASRMCGGVEYNEQFF	TRBV6-6	TRBJ2-1
TGTGCCAGCAGCAGCTTATATCCAGGCCCGAACTTATCCACCGGGGAGCTGTTTTTT	CASSSLYPGPNLSTGELFF	TRBV5-4	TRBJ2-2
TGTGCCAGCAGCTTAGGGGACAGGGGTTCCCGCGGCTACACCTTC	CASSLGDRGSRGYTF	TRBV11-2	TRBJ1-2
TGCAGTGCTAGAGATACAAGGACAGTCCCTGGAAACACCATATATTTT	CSARDTRTVPGNTIYF	TRBV20-1	TRBJ1-3
TGCAGTGCTGGGGCAGCTAGCGGGAAAGTCTACGAGCAGTACTTC	CSAGAASGKVYEQYF	TRBV20-1	TRBJ2-7
TGTGCCACCAGTGATAGCACGAGAGGACAGGGAGGCAGCAATCAGCCCCAGCATTTT	CATSDSTRGQGGSNQPQHF	TRBV24-1	TRBJ1-5
TGTGCCAGCAGCGTAGCAGGGGACAGGGGGTACGAGCAGTACTTC	CASSVAGDRGYEQYF	TRBV9	TRBJ2-7
TGTGCCAGCAGTTTAGCAGCGGGAAGACAGGCCTCTAGAGACTATGGCTACACCTTC	CASSLAAGRQASRDYGYTF	TRBV27	TRBJ1-2
TGCGCCAGCAGCCCTGTTTCTACCTACGACACGAAGTACGAGCAGTACTTC	CASSPVSTYDTKYEQYF	TRBV5-1	TRBJ2-7
TGTGCCAGCAGCCAAGGTCCGACTATCTTACCAACCGGGGAGCTGTTTTTT	CASSQGPTILPTGELFF	TRBV3-1	TRBJ2-2
TGTGCCAGCAGCTTAATCAAGGACAGGGCTCCTAACAATGAGCAGTTCTTC	CASSLIKDRAPNNEQFF	TRBV7-9	TRBJ2-1
TGTGCCAGCAGGGACAGCACCGGGGAGCTGTTTTTT	CASRDSTGELFF	TRBV6-1	TRBJ2-2
TGTGCCACCAGTGAGCCGGGGACAGGGGTCCGAGCCGCCAAAAACATTCAGTACTTC	CATSEPGTGVRAAKNIQYF	TRBV24-1	TRBJ2-4
TGTGCCAGCAGTTACAATAAGGACAGTTTCCACGAGCAGTACTTC	CASSYNKDSFHEQYF	TRBV6-6	TRBJ2-7
TGTGCCAGCAGCCTAGCACAGGGGGCGAGAGGCTACACCTTC	CASSLAQGARGYTF	TRBV7-4	TRBJ1-2
TGTGCCAGCAGCGGGAGGAGCAATCAGCCCCAGCATTTT	CASSGRSNQPQHF	TRBV7-3	TRBJ1-5
TGCGCCAGCAGCCAAGATCTCCCCCAGGACACAAAGGACAGCTCCTATAATTCACCCCTCCACTTT	CASSQDLPQDTKDSSYNSPLHF	TRBV4-1	TRBJ1-6
TGTGCCAGCAGTGAAGCAGACAGGGAGGACGCAACTAATGAAAAACTGTTTTTT	CASSEADREDATNEKLFF	TRBV6-1	TRBJ1-4
TGTGCCAGTATCCGAACTAGTCAGGGGTCGGAGACCCAGTACTTC	CASIRTSQGSETQYF	TRBV19	TRBJ2-5
TGTGCCAGCAGCCAAGATCTAGCGGGGGGCGAGCAGTACTTC	CASSQDLAGGEQYF	TRBV3-1	TRBJ2-7
TGTGCCAGCAGTTTAGTGCTAGCGGCTAAAGAGACCCAGTACTTC	CASSLVLAAKETQYF	TRBV27	TRBJ2-5
TGTGCCAGCAGCTCCAAGGCGGAAAAACTGTTTTTT	CASSSKAEKLFF	TRBV13	TRBJ1-4
TGCAGCAGATGGGGGGCGTTTTACAATGAGCAGTTCTTC	CSRWGAFYNEQFF	TRBV29-1	TRBJ2-1
TGTGCCAGTAGTGGGACAGGGGGTGGCTACGAGCAGTACTTC	CASSGTGGGYEQYF	TRBV19	TRBJ2-7
TGTGCCAGCAGTGGGGGAGGCTACGAGCAGTACTTC	CASSGGGYEQYF	TRBV6-1	TRBJ2-7
TGCAGTGGCCTCCCCCCCGTGATCCAGGCGAACACTGAAGCTTTCTTT	CSGLPPVIQANTEAFF	TRBV20-1	TRBJ1-1
TGTGCCAGCAGTAACCCGACAGGGGGCAGCTCCTACGAGCAGTACTTC	CASSNPTGGSSYEQYF	TRBV6-6	TRBJ2-7
TGCGCCAGCAGCTTCAACCATGACAGGGGGCCGCCCGAGCAGTACTTC	CASSFNHDRGPPEQYF	TRBV5-1	TRBJ2-7
TGTGCTAGCAGCGGTGGGATTGAAGCTTTCTTT	CASSGGIEAFF	TRBV7-7	TRBJ1-1
TGCGCCAGCAGCCATGGCCTAGCGGGTGTTGAGGTAGAGACCCAGTACTTC	CASSHGLAGVEVETQYF	TRBV4-1	TRBJ2-5
TGTGCCAGTGGGACAGGTGATACGCAGTATTTT	CASGTGDTQYF	TRBV11-3	TRBJ2-3
TGTGCCAGCAGCTTAGGCCGACAGGGGATTTTTGGCTACACCTTC	CASSLGRQGIFGYTF	TRBV7-6	TRBJ1-2
TGTGCCAGTAGTATTGAGCGGGAATCGACCCAGTACTTC	CASSIERESTQYF	TRBV19	TRBJ2-5
TGTGCCAGCAGCTTGGCTAGCTCCTACAATGAGCAGTTCTTC	CASSLASSYNEQFF	TRBV5-4	TRBJ2-1
TGTGCCTGGACCCCCCTCTGGAGCTCCTACAATGAGCAGTTCTTC	CAWTPLWSSYNEQFF	TRBV30	TRBJ2-1
TGTGCCAGCAGCTCGAGCCGGGACAGGGCTACTGAAGCTTTCTTT	CASSSSRDRATEAFF	TRBV7-3	TRBJ1-1
TGTGCAGGCGCCTACGAGCAGTACTTC	CAGAYEQYF	TRBV30	TRBJ2-7
TGCGCCAGCAGCCAAGCCTCGGGACTAGCGGGGGGGCCCACAGATACGCAGTATTTT	CASSQASGLAGGPTDTQYF	TRBV4-1	TRBJ2-3
TGTGCCAGCTCACATTATGGTGCCTACAATGAGCAGTTCTTC	CASSHYGAYNEQFF	TRBV18	TRBJ2-1
TGCGCCAGCGAAACGCCGGGCGTATGGGCCGGCTACACCTTC	CASETPGVWAGYTF	TRBV10-1	TRBJ1-2
TGTGCCAGCAGCTTCCCCCATCGGGGGGGGAAAGAGACCCAGTACTTC	CASSFPHRGGKETQYF	TRBV7-9	TRBJ2-5
TGTGCCAGCAGCGAGGGACTAGCCTACGAGCAGTACTTC	CASSEGLAYEQYF	TRBV13	TRBJ2-7
TGTGCCAGCAGGGCTTCGACAGGCACCTTAGTGAACACTGAAGCTTTCTTT	CASRASTGTLVNTEAFF	TRBV28	TRBJ1-1
TGTGCCAGCACTCGGGGGGAAAGTGAAGCTTTCTTT	CASTRGESEAFF	TRBV12-3	TRBJ1-1
TGTGCCAGCAGCCCCGGACAGGCCTGGAACACTGAAGCTTTCTTT	CASSPGQAWNTEAFF	TRBV9	TRBJ1-1
TGTGCCAGCAGTGACTCCCAAGGGAACACAGATACGCAGTATTTT	CASSDSQGNTDTQYF	TRBV6-4	TRBJ2-3
TGTGCCAGCTTGGACAGGGCGCCCCGACAGCCCCAGCATTTT	CASLDRAPRQPQHF	TRBV9	TRBJ1-5
TGTGCCAGCAGTTTATGGACCCAGCCGGGTATTGGGAACACTGAAGCTTTCTTT	CASSLWTQPGIGNTEAFF	TRBV28	TRBJ1-1
TGCGCCAGCGAACGAGGGACCCACAATGAGCAGTTCTTC	CASERGTHNEQFF	TRBV5-1	TRBJ2-1
TGTGCCAGCAGTGAGGGACCCCTCAAGGCTAGAGTGAAGGCCAAAAACATTCAGTACTTC	CASSEGPLKARVKAKNIQYF	TRBV2	TRBJ2-4
TGTGGAACTATTGTTCAGTACTTC	CGTIVQYF	TRBV2	TRBJ2-7
TGTGCCAGCAGTTACGATAAGAACGACGAATTTGAAGCTTTCTTT	CASSYDKNDEFEAFF	TRBV27	TRBJ1-1
TGTGCCAGCATGACAGAGGACTCTGGAAACACCATATATTTT	CASMTEDSGNTIYF	TRBV6-1	TRBJ1-3
TGTGCCAGCAGTTTAGTACTAGCGGGAGGATCCGGGGAGCTGTTTTTT	CASSLVLAGGSGELFF	TRBV12-4	TRBJ2-2
TGTGCCAGCAGGACTAGATACAATGAGCAGTTCTTC	CASRTRYNEQFF	TRBV3-1	TRBJ2-1
TGTGCCAGCAGTCAACAGGGGACAGATACGCAGTATTTT	CASSQQGTDTQYF	TRBV6-6	TRBJ2-3
TGTGCCAGCAGCCAAGATCGGGAAGCTTTCTTT	CASSQDREAFF	TRBV3-1	TRBJ1-1
TGCGCCAGCAGCCAGGCTAGATGGTTGGGCTACGAGCAGTACTTC	CASSQARWLGYEQYF	TRBV4-1	TRBJ2-7
TGTACACCCCAGGGGGCATCAGAGGGGGAGCAGCCCCAGCATTTT	CTPQGASEGEQPQHF	TRBV19	TRBJ1-5
TGTGCCAGCAGCTTTCAGTGGGTCGAAGAGCAGTACTTC	CASSFQWVEEQYF	TRBV5-4	TRBJ2-7
TGTGCCAGCAGCTGGGGACAGGGGACGTACTACGAGCAGTACTTC	CASSWGQGTYYEQYF	TRBV7-2	TRBJ2-7
TGTGCCAGCAGTGTCCGCCCGGGACACAGGAGGGAGCAGTACTTC	CASSVRPGHRREQYF	TRBV6-4	TRBJ2-7
TGCAGTGACAGGAGCTATGGCTACACCTTC	CSDRSYGYTF	TRBV20-1	TRBJ1-2
TGTGCCAGTAGTCGAAAACTAGCGGGCTTCACAGATACGCAGTATTTT	CASSRKLAGFTDTQYF	TRBV19	TRBJ2-3
TGTGCCAGCAGCATTCCTAGTACGGAGGAGTACGAGCAGTACTTC	CASSIPSTEEYEQYF	TRBV7-6	TRBJ2-7
TGTGCCAGCAGCTTAAGGTCTTGGGACAGGGGAGCCAGCAATCAGCCCCAGCATTTT	CASSLRSWDRGASNQPQHF	TRBV7-3	TRBJ1-5
TGTGCCAGCAGACGTTACGAAGAGCAGTACTTC	CASRRYEEQYF	TRBV12-3	TRBJ2-7
TGTGCCGAGGTCGGGACGGGACATAGCAATCAGCCCCAGCATTTT	CAEVGTGHSNQPQHF	TRBV9	TRBJ1-5
TGTGCCAGCAAACGACAGGGGACAACGGGGAACACTGAAGCTTTCTTT	CASKRQGTTGNTEAFF	TRBV11-3	TRBJ1-1
TGTGCCATCAGTAACCTATACAGGGGGCTACGGAAGGAGCAGTTCTTC	CAISNLYRGLRKEQFF	TRBV10-3	TRBJ2-1
TGTGCCAGCAGGGTCCCCGGGACAGGTTCTAACTATGGCTACACCTTC	CASRVPGTGSNYGYTF	TRBV28	TRBJ1-2
TGTGCCAGCAGCTTCGGGACACCCGGTGAAGCTTTCTTT	CASSFGTPGEAFF	TRBV7-2	TRBJ1-1
TGCGCCAGCAGCCAAGAGTCGTTGGGCCCTGTCCGGCGAATGAACACTGAAGCTTTCTTT	CASSQESLGPVRRMNTEAFF	TRBV4-1	TRBJ1-1
TGCGCCAGCAGCCAAGCTCCCCATGTTGGAGCGGAGGGGAACACCGGGGAGCTGTTTTTT	CASSQAPHVGAEGNTGELFF	TRBV4-1	TRBJ2-2
TGTGCCACCAGTGATTGTAGGACTGAGGGGAACTTGGCCCAGTACTTC	CATSDCRTEGNLAQYF	TRBV24-1	TRBJ2-5
TGTGCCAGCAGCCCGACTAGTGGGACCCAGTACTTC	CASSPTSGTQYF	TRBV11-3	TRBJ2-5
TGTGCCAGCAGCTTGGTTACTAGAACCCGTGACAATGAGCAGTTCTTC	CASSLVTRTRDNEQFF	TRBV5-4	TRBJ2-1
TGTGCCAGCAGCGGGACAGGGTCCTCAGGTGAGACCCAGTACTTC	CASSGTGSSGETQYF	TRBV11-1	TRBJ2-5
TGTGCCAGCAGCCAAGATAGAGGGGGGGCGACAGATACGCAGTATTTT	CASSQDRGGATDTQYF	TRBV4-2	TRBJ2-3
TGTGCCAGCAGCGAGGGGGAGACTGAAGCTTTCTTT	CASSEGETEAFF	TRBV7-3	TRBJ1-1
TGTGCCAGCAGCTTGGATGAAGAACAGGGTAACATTCCGATTGAAGCTTTCTTT	CASSLDEEQGNIPIEAFF	TRBV5-6	TRBJ1-1
TGTGCCAGCAGTGAAAACAAGCCGAAAGGGGGGGGAGGGTCCTACGAGCAGTACTTC	CASSENKPKGGGGSYEQYF	TRBV25-1	TRBJ2-7
TGTGCCAGCAGCCATCACCCCCTGCGGGACAAGGACTCCTATAATTCACCCCTCCACTTT	CASSHHPLRDKDSYNSPLHF	TRBV3-1	TRBJ1-6
TGCAGTGCATGTGGGACAGGGGAGGCTGGAAACACCATATATTTT	CSACGTGEAGNTIYF	TRBV20-1	TRBJ1-3
TGTGCCAGCAGCAGAGGGACTGGATGCCGCACAGATACGCAGTATTTT	CASSRGTGCRTDTQYF	TRBV5-4	TRBJ2-3
TGTGCCAGCAAGGTATCGGTGTTCTTC	CASKVSVFF	TRBV6-5	TRBJ2-1
TGTGCCAGCCCCGGACTAGATTCCTACAATGAGCAGTTCTTC	CASPGLDSYNEQFF	TRBV11-3	TRBJ2-1
TGCAGTGCTAGAGGTAGGACCGACATATACTATGGCTACACCTTC	CSARGRTDIYYGYTF	TRBV20-1	TRBJ1-2
TGCAGTGCTAGCTGGACGGTTAACACCGGGGAGCTGTTTTTT	CSASWTVNTGELFF	TRBV20-1	TRBJ2-2
TGTGCCAGCAGTTTCGTGGGGGACAGAAGACAGTCCTACGAGCAGTACTTC	CASSFVGDRRQSYEQYF	TRBV28	TRBJ2-7
TGTGCCAGCAGTTACAAAGGGCGGCAAAACATTCAGTACTTC	CASSYKGRQNIQYF	TRBV6-6	TRBJ2-4
TGTGCCTGGAGTTTAGCTGCGGACCGAACCTACGAGCAGTACTTC	CAWSLAADRTYEQYF	TRBV30	TRBJ2-7
TGTGCCAGCAGCTTATCGAAATACTGGGGGCGGTGCGAGGGGGGCTTCACTGAAGCTTTCTTT	CASSLSKYWGRCEGGFTEAFF	TRBV5-8	TRBJ1-1
TGTGCCAGCAGTGATAGCCAGTCCTACGAGCAGTACTTC	CASSDSQSYEQYF	TRBV6-4	TRBJ2-7
TGCGCCAGCAGCCAAGTGGTCCGCGACGCCAGGGAGAGCTCCTACAATGAGCAGTTCTTC	CASSQVVRDARESSYNEQFF	TRBV4-1	TRBJ2-1
TGTGCCAGTTGGAGCGGTAACTATGGCTACACCTTC	CASWSGNYGYTF	TRBV19	TRBJ1-2
TGTGCCAGCAGTTTACCCTTCGGGGGGGGACACCCCACCATATATTTT	CASSLPFGGGHPTIYF	TRBV27	TRBJ1-3
TGTGCCAGTTCCTGGGAAGAGACCCAGTACTTC	CASSWEETQYF	TRBV13	TRBJ2-5
TGTGCCAGCAGTTACTGTGTACTTTCTAGCGGGTGCGGGGATGAGCAGTTCTTC	CASSYCVLSSGCGDEQFF	TRBV6-9	TRBJ2-1
TGCGCCAGCTGGGTAGGGAGGCAGCCCCAGCATTTT	CASWVGRQPQHF	TRBV10-1	TRBJ1-5
TGTGCCAGCAGCCCCCCCGGACTAGTTTGGGACGGGGAGCTGTTTTTT	CASSPPGLVWDGELFF	TRBV3-1	TRBJ2-2
TGTGCCAGCAGTAACGTCCCACTAGCGGGAGTTGAGGAAGGTCACCCTACAGATACGCAGTATTTT	CASSNVPLAGVEEGHPTDTQYF	TRBV12-3	TRBJ2-3
TGTGCCAGCAGCGAGAAGGGACAGGGTCAGAACACCGGGGAGCTGTTTTTT	CASSEKGQGQNTGELFF	TRBV9	TRBJ2-2
TGTGCCAGCACCCGACCCCTCACCGGGGAGCTGTTTTTT	CASTRPLTGELFF	TRBV6-4	TRBJ2-2
TGTGCCAGCAGCGCCGGCGGGTCCTACAATGAGCAGTTCTTC	CASSAGGSYNEQFF	TRBV7-9	TRBJ2-1
TGTGCCACCCGGGGGATACGAGAGACCCAGTACTTC	CATRGIRETQYF	TRBV24-1	TRBJ2-5
TGTGCCAGCAGCCAGCAGCCACATCAGCCCCAGCATTTT	CASSQQPHQPQHF	TRBV14	TRBJ1-5
TGTGCCAGCAGTTACTCGCGAAGGAGACAGGGGAACACTGAAGCTTTCTTT	CASSYSRRRQGNTEAFF	TRBV6-2	TRBJ1-1
TGTGCCAGCAGCCCGGGCTTC	CASSPGF	TRBV4-2	TRBJ1-2
TGTGCCAGCAGCTTAGGGGACCGACAGGGGGCATTAATGAACACTGAAGCTTTCTTT	CASSLGDRQGALMNTEAFF	TRBV11-2	TRBJ1-1
TGTGCCAGCATAAGGGGGAGGGGGGAGCTGTTTTTT	CASIRGRGELFF	TRBV12-4	TRBJ2-2
TGTGCCAGCAGGAGGTTTCGCACAGATACGCAGTATTTT	CASRRFRTDTQYF	TRBV2	TRBJ2-3
TGTGCCGGGGTTAGCGGGACGATAAACCATGAGCAGTTCTTC	CAGVSGTINHEQFF	TRBV3-1	TRBJ2-1
TGCAGTGGCGACCGAAACGAGCAGTACTTC	CSGDRNEQYF	TRBV20-1	TRBJ2-7
TGCGCCAGCAGCCCCCCGGCGGGGCCCGAAAAACTGTTTTTT	CASSPPAGPEKLFF	TRBV5-1	TRBJ1-4
TGCAGCGTCGGTTCCCAGGGTGAGACCCAGTACTTC	CSVGSQGETQYF	TRBV29-1	TRBJ2-5
TGTGCCAGCTCACCACGTCTACCCCAACGGACTAGCGGGCCCCGTTGCTCCTACGAGCAGTACTTC	CASSPRLPQRTSGPRCSYEQYF	TRBV18	TRBJ2-7
TGTTCACAGGACGAACCTGACGAGCAGTACTTC	CSQDEPDEQYF	TRBV19	TRBJ2-7
TGCAGTGCTAGAGATGCGACACAGGGGGCAAACACCGGGGAGCTGTTTTTT	CSARDATQGANTGELFF	TRBV20-1	TRBJ2-2
TGTCACCCTCAGGGACCGAACACTGAAGCTTTCTTT	CHPQGPNTEAFF	TRBV6-6	TRBJ1-1
TGTGCCAGCAGTGCGAGGACAGGGAGTGAGCAGTTCTTC	CASSARTGSEQFF	TRBV6-1	TRBJ2-1
TGTGCCAGCAGCTCCGTATGGACTAGCGGGGGTGGCTACGAGCAGTACTTC	CASSSVWTSGGGYEQYF	TRBV5-6	TRBJ2-7
TGTGCCAGCAGCACTGGACATACCCGTGAGCAGTACTTC	CASSTGHTREQYF	TRBV7-3	TRBJ2-7
TGCAGCGTCCCCCCCAACTTC	CSVPPNF	TRBV29-1	TRBJ2-7
TGTGCCACCGGACCCTGGAGGGGAGCCTACGAGCAGTACTTC	CATGPWRGAYEQYF	TRBV24-1	TRBJ2-7
TGCGCCAGCAGCGTGGATGGACTCTCCTACGAGCAGTACTTC	CASSVDGLSYEQYF	TRBV5-1	TRBJ2-7
TGTGCCAGCAGCTCTACCCCCTACGAGCAGTACTTC	CASSSTPYEQYF	TRBV9	TRBJ2-7
TGTGCCAGCAGCTTCCGGCAGGGGCAGAATCAGCCCCAGCATTTT	CASSFRQGQNQPQHF	TRBV5-8	TRBJ1-5
TGTGCCAGCAGTTTAGTACAATTTGGAAAGATCAAGAATAGCAATCAGCCCCAGCATTTT	CASSLVQFGKIKNSNQPQHF	TRBV12-4	TRBJ1-5
TGCGCCAGCAGTGAGGGGACCTGGCCGGCCGTGGGAGCTAACTATGGCTACACCTTC	CASSEGTWPAVGANYGYTF	TRBV10-2	TRBJ1-2
TGCGCCAGCAGAGACAGGGGTATAGACGAAGCTTTCTTT	CASRDRGIDEAFF	TRBV4-1	TRBJ1-1
TGTGCCAGCAGCGGGCCCCCCAGAAACCAAGGACTAGCCGGTGAGCAGTTCTTC	CASSGPPRNQGLAGEQFF	TRBV7-9	TRBJ2-1
TGTGCCAGCAGCCAAGCCTGGCGAAACTATGGCTACACCTTC	CASSQAWRNYGYTF	TRBV4-2	TRBJ1-2
TGTGCCACCAGCAGAGTTCGGGACGGGGGCAAGACTGAAGCTTTCTTT	CATSRVRDGGKTEAFF	TRBV15	TRBJ1-1
TGTGCCAGCACTAGGGGGCCTCCGACAGATACGCAGTATTTT	CASTRGPPTDTQYF	TRBV7-9	TRBJ2-3
TGTGCCAGCAGCCAAGGGACACTAGCGGGAGAGACCCAGTACTTC	CASSQGTLAGETQYF	TRBV5-8	TRBJ2-5
TGTGCCAGCAGCCGGGTCCAAGGGACTAGCGGGCGTAGGCAGCTCGAGACCCAGTACTTC	CASSRVQGTSGRRQLETQYF	TRBV14	TRBJ2-5
TGCGCCAGCAGTTCCCCAACGCCCTACGAGCAGTACTTC	CASSSPTPYEQYF	TRBV5-1	TRBJ2-7
TGTGCCAGCAGCCAAAGGAACCGGGGGTCGGGCTGGAGCTCCTATAATTCACCCCTCCACTTT	CASSQRNRGSGWSSYNSPLHF	TRBV3-1	TRBJ1-6
TGTGCCAGCAGTTTACCCCGAGGGTGGAGCAATCAGCCCCAGCATTTT	CASSLPRGWSNQPQHF	TRBV27	TRBJ1-5
TGTGCCAGCAGCCCTTCCCGGGACGACCAGCCCCAGCATTTT	CASSPSRDDQPQHF	TRBV9	TRBJ1-5
TGTGCCAGCAGTTTACCCCGATGTTCAACCCCCTTCCCCTTCATCTTACGTAGGGGCGAGCAGTACTTC	CASSLPRCSTPFPFILRRGEQYF	TRBV28	TRBJ2-7
TGTGCCAGCAGGGACAGGGCTCAGCCCCAGCATTTT	CASRDRAQPQHF	TRBV27	TRBJ1-5
TGTGCCAGCAGTTGCCCACCTTCACCCCTCCACTTT	CASSCPPSPLHF	TRBV6-1	TRBJ1-6
TGTGCCAGCAGCCAGCGAGCGGGAGGAGAGCAGTACTTC	CASSQRAGGEQYF	TRBV13	TRBJ2-7
TGTGCCAGCACCAGGGCTCGTAACACTGAAGCTTTCTTT	CASTRARNTEAFF	TRBV12-3	TRBJ1-1
TGCGCCAGCAGTGAGCAGGGGTATCAGCCCCAGCATTTT	CASSEQGYQPQHF	TRBV10-1	TRBJ1-5
TGTGCCAGCAGCTTGCCTAGGGGGAGAAAGACCCAGTACTTC	CASSLPRGRKTQYF	TRBV5-4	TRBJ2-5
TGTGCCAGCAGTGATTGTAGGGGACCCCCCTACGAGCAGTACTTC	CASSDCRGPPYEQYF	TRBV6-1	TRBJ2-7
TGTGTTGGGTACCGAAACAGCACAACCTCTGGGGCCAACGTCCTGACTTTC	CVGYRNSTTSGANVLTF	TRBV2	TRBJ2-6
TGTGCCAGCAGTTTACCCGAGTACGAGCAGTACTTC	CASSLPEYEQYF	TRBV12-3	TRBJ2-7
TGTGCCAGCTCACTTGTGTATAGGGTCCTACCTAGCGGGGGGGCCAGGGGGGAGTACAATGAGCAGTTCTTC	CASSLVYRVLPSGGARGEYNEQFF	TRBV18	TRBJ2-1
TGTGCCAGCAGTTCGAACCAAGAGACCCAGTACTTC	CASSSNQETQYF	TRBV6-4	TRBJ2-5
TGTGCCAGCAGCGACAGCGGGACTCCCACCGGGGAGCTGTTTTTT	CASSDSGTPTGELFF	TRBV7-2	TRBJ2-2
TGTGCCAGCAGTGAAGCGCGGCGGGAGGACTACGAGCAGTACTTC	CASSEARREDYEQYF	TRBV2	TRBJ2-7
TGCAGCGGTCCTGGAGTACGCCATACGCAGTATTTT	CSGPGVRHTQYF	TRBV29-1	TRBJ2-3
TGCGCATTTGGAGGCAGAGGGCTTGAGCAGTTCTTC	CAFGGRGLEQFF	TRBV20-1	TRBJ2-1
TGTGCCAGCAGCAAACCCGCCCAGGGGGACGCAAATACCGAGCAGTACTTC	CASSKPAQGDANTEQYF	TRBV7-3	TRBJ2-7
TGTGCCAGCAGGGGAACAGATACGCAGTATTTT	CASRGTDTQYF	TRBV6-6	TRBJ2-3
TGTGCCAGCAGTTATATCTGCCGCACCGGGGAGCTGTTTTTT	CASSYICRTGELFF	TRBV28	TRBJ2-2
TGCAGCGTTGTTGAAGGGGGCGCCGCTCCTTCTTATGGCTACACCTTC	CSVVEGGAAPSYGYTF	TRBV29-1	TRBJ1-2
TGCAGTGCTAGAGATCTCATGCGGGAAGGCAAAAACATTCAGTACTTC	CSARDLMREGKNIQYF	TRBV20-1	TRBJ2-4
TGCGCCAGCAGCTCACAGGTCAATGAGCAGTTCTTC	CASSSQVNEQFF	TRBV5-1	TRBJ2-1
TGTGCCAGCAGTTACCATCTAGGAACTGAAGCTTTCTTT	CASSYHLGTEAFF	TRBV6-5	TRBJ1-1
TGCGCCAGCAGTGAGTTGCCCGGAGGTCGAATTCCTCAAGAGACCCAGTACTTC	CASSELPGGRIPQETQYF	TRBV10-1	TRBJ2-5
TGTGCCTGGGTAGACAAATTCTCCCGAGGCTATGGCTACACCTTC	CAWVDKFSRGYGYTF	TRBV30	TRBJ1-2
TGTGCCAGCAGTTACCCCCAGGCCTACGAGCAGTACTTC	CASSYPQAYEQYF	TRBV6-5	TRBJ2-7
TGTGCCAGCAGCTTAGCGACAGGGAATGAGCAGTTCTTC	CASSLATGNEQFF	TRBV11-1	TRBJ2-1
TGTGCCAGTAGTATAGATCTATCCTATAACAGGGGGCTGGGGCCCCAGCATTTT	CASSIDLSYNRGLGPQHF	TRBV19	TRBJ1-5
TGTGCCAGCAGCCCCAAAGGTATTGAAGCTTTCTTT	CASSPKGIEAFF	TRBV7-3	TRBJ1-1
TGTGCCATCAGTGAGTACCGGGACAACACCGGGGAGCTGTTTTTT	CAISEYRDNTGELFF	TRBV10-3	TRBJ2-2
TGTGCCAGCAGTGACTACGAGAGGACCGGGACAGCCTATAATTCACCCCTCCACTTT	CASSDYERTGTAYNSPLHF	TRBV6-4	TRBJ1-6
TGTGCCAGCAGAGGTCGGGGGACCAGGGAGCTTCGAGTCTATTCACCCCTCCACTTT	CASRGRGTRELRVYSPLHF	TRBV6-4	TRBJ1-6
TGTGCCAGCACCCCGGACAGGGGCGGATTTGGCACAGATACGCAGTATTTT	CASTPDRGGFGTDTQYF	TRBV2	TRBJ2-3
TGTGCCAGCAGCTGTCGACATCAGACATCTGGAAACACCATATATTTT	CASSCRHQTSGNTIYF	TRBV7-6	TRBJ1-3
TGTGCCAGCAAGAGGGACAGGGAACTCTCCTACAATGAGCAGTTCTTC	CASKRDRELSYNEQFF	TRBV27	TRBJ2-1
TGTGCCAGCTCCCGCGGGGTCACTAATGAAAAACTGTTTTTT	CASSRGVTNEKLFF	TRBV5-6	TRBJ1-4
TGTGCCAGCAGCTGGGCGGGGGGCACAGATACGCAGTATTTT	CASSWAGGTDTQYF	TRBV5-5	TRBJ2-3
TGCGCCAGCAGTGAAGCGTTACACAGCGAGCAGTACTTC	CASSEALHSEQYF	TRBV10-2	TRBJ2-7
TGTGCCAGCAGCGACCCGGAGTGGGACAGTCACTGCAGAGTGGAAAACACCATATATTTT	CASSDPEWDSHCRVENTIYF	TRBV7-2	TRBJ1-3
TGCGCCAGCAGCTTGAAGGCGGGACAGAAAGCTTCTGGAAACACCATATATTTT	CASSLKAGQKASGNTIYF	TRBV5-1	TRBJ1-3
TGTGCCAGCAGTCCGGGACTAGCTCGACGCACAGATACGCAGTATTTT	CASSPGLARRTDTQYF	TRBV2	TRBJ2-3
TGTGCCAGCAGCGTTTGGCCCTTTTCCTACAATGAGCAGTTCTTC	CASSVWPFSYNEQFF	TRBV7-9	TRBJ2-1
TGTGCCAGCAGCACCCTAAATGAAAAACTGTTTTTT	CASSTLNEKLFF	TRBV7-9	TRBJ1-4
TGCAGTGCTAAGGGCAATCAGCCCCAGCATTTT	CSAKGNQPQHF	TRBV20-1	TRBJ1-5
TGTGCCAGCAGCCTATATTACGAGCAGTACTTC	CASSLYYEQYF	TRBV7-3	TRBJ2-7
TGCGCCAGCAGCCATGTACGGGGCGGCTACGAGCAGTACTTC	CASSHVRGGYEQYF	TRBV4-3	TRBJ2-7
TGTGCCAGCAGCGGAGGGACCCCTTGGATGGATAGCAATCAGCCCCAGCATTTT	CASSGGTPWMDSNQPQHF	TRBV13	TRBJ1-5
TGTGCCACCAGTGATTTTTCGGTCAGGGCAGGACTGGTAAAAGAGACCCAGTACTTC	CATSDFSVRAGLVKETQYF	TRBV24-1	TRBJ2-5
TGTGCCAGCAGCTTAGCGACCACAGGGGGCAACTACGAGCAGTACTTC	CASSLATTGGNYEQYF	TRBV7-2	TRBJ2-7
TGTGCCATCAGTGAACTAGCGGTTGCCTACAATGAGCAGTTCTTC	CAISELAVAYNEQFF	TRBV10-3	TRBJ2-1
TGTGCCAGCAGCGGGACAGATGGCTACACCTTC	CASSGTDGYTF	TRBV5-6	TRBJ1-2
TGCGCCAGCAGCCAAGAGTATGGGACAGATGGTAGCAATCAGCCCCAGCATTTT	CASSQEYGTDGSNQPQHF	TRBV4-1	TRBJ1-5
TGTGCCAGCCATCCTACAAGCGGGACGAAGGATGGCTACACCTTC	CASHPTSGTKDGYTF	TRBV6-1	TRBJ1-2
TGTGCCAGCAGCCGGTCTGCCAACACAGATACGCAGTATTTT	CASSRSANTDTQYF	TRBV13	TRBJ2-3
TGTGCCAGCAGTCTGGCAGGGACCGGGGAGCTGTTTTTT	CASSLAGTGELFF	TRBV27	TRBJ2-2
TGCATGCGGGGCTGCGGGAATCAGCCCCAGCATTTT	CMRGCGNQPQHF	TRBV29-1	TRBJ1-5
TGTGCCAGCAGCAATACCGATGGTGCTGAAGAGACCCAGTACTTC	CASSNTDGAEETQYF	TRBV5-4	TRBJ2-5
TGTGCCAGCAGCGAAGCTAGCGGGGGGTCAGATACGCAGTATTTT	CASSEASGGSDTQYF	TRBV7-3	TRBJ2-3
TGTGCCAGCAGTTTGCTGACGAACACTGAAGCTTTCTTT	CASSLLTNTEAFF	TRBV12-4	TRBJ1-1
TGTGCCAGCAGCTTACCGAAGGGGGGGTTCTATGGCTACACCTTC	CASSLPKGGFYGYTF	TRBV11-2	TRBJ1-2
TGCAGTGCTAGCACTAGCGGGACGTCCTACAATGAGCAGTTCTTC	CSASTSGTSYNEQFF	TRBV20-1	TRBJ2-1
TGTGCCAGCAGCACAACCGACAGCAACGTTTCTGGCTACACCTTC	CASSTTDSNVSGYTF	TRBV11-2	TRBJ1-2
TGTGCCAGCAGCGGTCCCAAACGAGGCGGGAGACAGGAAGCAGGGAAATACGAGCAGTACTTC	CASSGPKRGGRQEAGKYEQYF	TRBV7-3	TRBJ2-7
TGTGCCATCAGTGACGACGGGGGCAATGAGCAGTTCTTC	CAISDDGGNEQFF	TRBV10-3	TRBJ2-1
TGTGCCAGTAAAGGACCTCAAGAGACCCAGTACTTC	CASKGPQETQYF	TRBV19	TRBJ2-5
TGTGCCAGCAGTTACTCGAACCATTCCTACGAGCAGTACTTC	CASSYSNHSYEQYF	TRBV6-5	TRBJ2-7
TGCGCCAGCAGTGAGTCAAGCCGGGACAGGGTAAGGAGGGGGGCATACGAGCAGTACTTC	CASSESSRDRVRRGAYEQYF	TRBV10-1	TRBJ2-7
TGTGCCAGCAGTGACGTTCTTGACGAGCAGTACTTC	CASSDVLDEQYF	TRBV2	TRBJ2-7
TGCGCCAGCATGGACAGGGGGAGCTCCTATAATTCACCCCTCCACTTT	CASMDRGSSYNSPLHF	TRBV5-1	TRBJ1-6
TGTGCCATCAGTGTCCCCCAGGGATGGGATACGCAGTATTTT	CAISVPQGWDTQYF	TRBV10-3	TRBJ2-3
TGCAGTGCTAGAGATCCGACTAGGTTTTTATCCAGAATTGAAGCTTTCTTT	CSARDPTRFLSRIEAFF	TRBV20-1	TRBJ1-1
TGCAGCCACAGGGCTGAAGCTTTCTTT	CSHRAEAFF	TRBV29-1	TRBJ1-1
TGTGCTAGTGTTCTGACAGGAGAGTATGGCTACACCTTC	CASVLTGEYGYTF	TRBV12-5	TRBJ1-2
TGTGCCAGCAGCCAGATTCAGGGTTCTAACTATGGCTACACCTTC	CASSQIQGSNYGYTF	TRBV5-6	TRBJ1-2
TGTGCCAGCAGGGCGGGCTATGGTCTGCGTACTAGCGACACCGGGGAGCTGTTTTTT	CASRAGYGLRTSDTGELFF	TRBV6-6	TRBJ2-2
TGTGCCAGCTCACCACCACGGTCCTACAATGAGCAGTTCTTC	CASSPPRSYNEQFF	TRBV18	TRBJ2-1
TGTGCCAGCAGCGTAGGGGGGACGGGTCCTAATGAAAAACTGTTTTTT	CASSVGGTGPNEKLFF	TRBV9	TRBJ1-4
TGCAGCAGGCGGCTCTCCTACAATGAGCAGTTCTTC	CSRRLSYNEQFF	TRBV29-1	TRBJ2-1
TGTGCCAGCAGCTTAAGGCGGTCGGATGGCTACACCTTC	CASSLRRSDGYTF	TRBV7-2	TRBJ1-2
TGCAGTGCCCGGGTCGGGACGACGCACCCCTACGAGCAGTACTTC	CSARVGTTHPYEQYF	TRBV20-1	TRBJ2-7
TGTGCCAGCAGCTTGAATCCAGGGGATGGGACCCAGTACTTC	CASSLNPGDGTQYF	TRBV5-4	TRBJ2-5
TGCAGTGCACATAACTGGACAGACGACTACGAGCAGTACTTC	CSAHNWTDDYEQYF	TRBV20-1	TRBJ2-7
TGTGCTAGTGGCCAGGGGGGCCCTAACTATGGCTACACCTTC	CASGQGGPNYGYTF	TRBV12-5	TRBJ1-2
TGTGCCAGCAGGTCCCAGTGCGAACAGGGCTATGAAAAACTGTTTTTT	CASRSQCEQGYEKLFF	TRBV14	TRBJ1-4
TGTGCCAGCAGTAATCTTTTGACGGCTGGCACTGAAGCTTTCTTT	CASSNLLTAGTEAFF	TRBV6-5	TRBJ1-1
TGCAGTGCTAATCTTAACGGCCCATGGGTTGATTATGGCTACACCTTC	CSANLNGPWVDYGYTF	TRBV20-1	TRBJ1-2
TGTGCCAGCAGCTTAGGGACTCCAGGGACAGGGGGCCAGATAGGAACGTCGTTTCCGGCCTACGAGCAGTACTTC	CASSLGTPGTGGQIGTSFPAYEQYF	TRBV7-6	TRBJ2-7
TGTGCCAGCTCCCAAAACGGGATACTGGGCACAGATACGCAGTATTTT	CASSQNGILGTDTQYF	TRBV6-1	TRBJ2-3
TGTGCCAGCAGTTACGGCGACTACCGTCCTAACTATGGCTACACCTTC	CASSYGDYRPNYGYTF	TRBV6-5	TRBJ1-2
TGTGCCAGCAGTTCGCAGCCGGGCAATCAGCCCCAGCATTTT	CASSSQPGNQPQHF	TRBV27	TRBJ1-5
TGTGCCATCAGTGAGGCCATCGAAAAAGAGACCCAGTACTTC	CAISEAIEKETQYF	TRBV10-3	TRBJ2-5
TGTGCCAGCAGCCCCTGGGCTCACGCCTTGCGAACCTACGAGCAGTACTTC	CASSPWAHALRTYEQYF	TRBV14	TRBJ2-7
TGTGCCAGCAGCCAAGCGGGAATCCAAGAGACCCAGTACTTC	CASSQAGIQETQYF	TRBV14	TRBJ2-5
TGTGCCAGCAGTTCCCCTTGTGACCTAGCCAAAAACATTCAGTACTTC	CASSSPCDLAKNIQYF	TRBV6-2	TRBJ2-4
TGTGCCACCATCCCGGGGTCGGTAAACACTGAAGCTTTCTTT	CATIPGSVNTEAFF	TRBV24-1	TRBJ1-1
TGTGCCAGCAGTTCGACCCTTGAGAACACTGAAGCTTTCTTT	CASSSTLENTEAFF	TRBV27	TRBJ1-1
TGCAGTGCTCTAAAGGCCAGGGGTAAGACCACTGAAGCTTTCTTT	CSALKARGKTTEAFF	TRBV20-1	TRBJ1-1
TGCGCCAGCAGCCAAGTCTTCTGGGACGCTCAGCCCCAGCATTTT	CASSQVFWDAQPQHF	TRBV4-3	TRBJ1-5
TGTGCCAGCAGCTCAAACCAATTGACGGGCGAGACCCAGTACTTC	CASSSNQLTGETQYF	TRBV13	TRBJ2-5
TGCAGTGCTAGAGTGGGGGGACGCGGGAACACTGAAGCTTTCTTT	CSARVGGRGNTEAFF	TRBV20-1	TRBJ1-1
TGTGCCGGCCGGGGGCCCAGTGAAGCTTTCTTT	CAGRGPSEAFF	TRBV19	TRBJ1-1
TGTGCCAGCAGCTTTAGCGGGAGGTATCCGAACACTGAAGCTTTCTTT	CASSFSGRYPNTEAFF	TRBV11-2	TRBJ1-1
TGTGCCAGCAGCGGATCCCAGGCGAACACCGGGGAGCTGTTTTTT	CASSGSQANTGELFF	TRBV13	TRBJ2-2
TGCAGTGCTCACCCGGACCCCGGGGGATATGGCTACACCTTC	CSAHPDPGGYGYTF	TRBV20-1	TRBJ1-2
TGCGCCAGCAACAGGACGGGGGCCTACGAGCAGTACTTC	CASNRTGAYEQYF	TRBV10-1	TRBJ2-7
TGTGCCAGCAATTACAGGGTCGAGCAGTACTTC	CASNYRVEQYF	TRBV27	TRBJ2-7
TGTGCCAGCAGTTACTCGGCAGGTCTGGGGGGTGGCTACACCTTC	CASSYSAGLGGGYTF	TRBV6-8	TRBJ1-2
TGTGCCAGCAGGGGGGAGTCGTTGGGGAACTACGAGCAGTACTTC	CASRGESLGNYEQYF	TRBV7-6	TRBJ2-7
TGTGCCACCAGCCGGGGGCTAGCGGGAAATGAGCAGTTCTTC	CATSRGLAGNEQFF	TRBV15	TRBJ2-1
TGTGCCACCAGCAGGAGTTCGGGCCAGGTTGGATGTCCCTACGAGCAGTACTTC	CATSRSSGQVGCPYEQYF	TRBV15	TRBJ2-7
TGCAGCGTAAATCGGGAACAGCCCCAGCATTTT	CSVNREQPQHF	TRBV29-1	TRBJ1-5
TGTGCCAGCAGGGGACTAGCGGGTTTCTTC	CASRGLAGFF	TRBV28	TRBJ2-1
TGTGCCACCAGTGTCCCAAGTCCGGGACAGGGATTCAGCTCCTACGAGCAGTACTTC	CATSVPSPGQGFSSYEQYF	TRBV24-1	TRBJ2-7
TGCAGTGCTAGCCGGACAGGGGAGCAGTACTTC	CSASRTGEQYF	TRBV20-1	TRBJ2-7
TGTGCCAGCAGCCAAGAAATCAAAACAGATAATTCACCCCTCCACTTT	CASSQEIKTDNSPLHF	TRBV14	TRBJ1-6
TGTGCCAGCAGTGTTGGAGCTTCAGACTACAATGAGCAGTTCTTC	CASSVGASDYNEQFF	TRBV25-1	TRBJ2-1
TGTGCCAGCAGCGACAGGGGGGTGTATGGCTACACCTTC	CASSDRGVYGYTF	TRBV9	TRBJ1-2
TGTGCCAACCGCAGGGTAATCGACAATGGCTACACCTTC	CANRRVIDNGYTF	TRBV6-5	TRBJ1-2
TGTGCCAGCAGCTGTCCAGAGGAGGACACGGGTTTAGGGACTGAAGCTTTCTTT	CASSCPEEDTGLGTEAFF	TRBV5-4	TRBJ1-1
TGTGCCAGCAGTTTAGTAGAGGGGGTGGGAACAAATCAGCCCCAGCATTTT	CASSLVEGVGTNQPQHF	TRBV12-3	TRBJ1-5
TGTGCCAGCAGTGGCGGCCCCGGGGCCAACACCGGGGAGCTGTTTTTT	CASSGGPGANTGELFF	TRBV12-4	TRBJ2-2
TGTGCCAGCCGTGCGTGCCCGGGGGAAGGTAATCAGCCCCAGCATTTT	CASRACPGEGNQPQHF	TRBV6-4	TRBJ1-5
TGTGCCAGCAGCAAATTAACCCCACTAGAGGAGATCAATGAGCAGTTCTTC	CASSKLTPLEEINEQFF	TRBV11-3	TRBJ2-1
TGTGCCAGCAGCCACCCAAGGTCGGGGGCGACCCTCCCCAATCAGCCCCAGCATTTT	CASSHPRSGATLPNQPQHF	TRBV14	TRBJ1-5
TGTGCCACCAGTGATGAGCACATTCAGTACTTC	CATSDEHIQYF	TRBV24-1	TRBJ2-4
TGCAGTGCTAGCCTGGTCCCTCAGGGCTCCTACAATGAGCAGTTCTTC	CSASLVPQGSYNEQFF	TRBV20-1	TRBJ2-1
TGTGCCAGCAGTTTGGGGCAATTCATGAACACTGAAGCTTTCTTT	CASSLGQFMNTEAFF	TRBV27	TRBJ1-1
TGCGCCAGCAAAACGTATTGCGCGGGAGTTTTTGAGCAGTTCTTC	CASKTYCAGVFEQFF	TRBV10-2	TRBJ2-1
TGTGCCAGCAGTTACGGAAACCTAGCGGCCGACACCGGGGAGCTGTTTTTT	CASSYGNLAADTGELFF	TRBV6-5	TRBJ2-2
TGCGCCAGCAGCTCCGGGACAGGAAGAACAGAGACCCAGTACTTC	CASSSGTGRTETQYF	TRBV5-1	TRBJ2-5
TGTGCCAGCAGTTACTATATTTCACAGGGCCGGGCCAACGTCCTGACTTTC	CASSYYISQGRANVLTF	TRBV6-9	TRBJ2-6
TGTGCCAGCAGCCAAGATCCCGCTCAACCCTCCAGGGCCGGGGAGCTGTTTTTT	CASSQDPAQPSRAGELFF	TRBV14	TRBJ2-2
TGTGCCCGGTTATCGGGACTAGCGGGCGAACCCTTCGGGGAGCTGTTTTTT	CARLSGLAGEPFGELFF	TRBV11-2	TRBJ2-2
TGTGCCAGCGTTCCAGACTGCTCCTACAATGAGCAGTTCTTC	CASVPDCSYNEQFF	TRBV5-4	TRBJ2-1
TGTGCCAGCAGCGTAGTATTAGTGTACTCCTACAATGAGCAGTTCTTC	CASSVVLVYSYNEQFF	TRBV6-5	TRBJ2-1
TGTGCCAGCAGCGTACCGGGACTAGGTTTATTTACAGATACGCAGTATTTT	CASSVPGLGLFTDTQYF	TRBV7-2	TRBJ2-3
TGTGCAGAACAGGGGTATGGCTACACCTTC	CAEQGYGYTF	TRBV28	TRBJ1-2
TGTGCCAGCAGCACAAGGGGGGCGATTAAGTACTTC	CASSTRGAIKYF	TRBV7-9	TRBJ2-4
TGCGCCAGCAAGAGTCAGACGAAGGGGCCCTATGGCTACACCTTC	CASKSQTKGPYGYTF	TRBV5-1	TRBJ1-2
TGTGCCACCCCACAGGGTAATAACACTGAAGCTTTCTTT	CATPQGNNTEAFF	TRBV15	TRBJ1-1
TGCGCCAGCAGTGAGTCAAAGGTCACCCCCCACAGGGGGGAAGATCAGCCCCAGCATTTT	CASSESKVTPHRGEDQPQHF	TRBV10-1	TRBJ1-5
TGTGCCAGCGGGGCGAACACTGAAGCTTTCTTT	CASGANTEAFF	TRBV18	TRBJ1-1
TGTGCTAGTGGTTTGTTACCGACCCGCTATGGCTACACCTTC	CASGLLPTRYGYTF	TRBV12-5	TRBJ1-2
TGCATCACGGGGTTCACAGATACGCAGTATTTT	CITGFTDTQYF	TRBV20-1	TRBJ2-3
TGTGCCAGCAGCCATCCGAGTCGGGGGCGAAACGAGCAGTACTTC	CASSHPSRGRNEQYF	TRBV3-1	TRBJ2-7
TGTGCCAGCAGCTTTGGTCGGGGCTGGCCTGACACTGAAGCTTTCTTT	CASSFGRGWPDTEAFF	TRBV5-6	TRBJ1-1
TGCAAGGGTGACAGTCGTATGAACACTGAAGCTTTCTTT	CKGDSRMNTEAFF	TRBV20-1	TRBJ1-1
TGTGCCAGCAGCTTGGGACCCACACGGACCGCCGAGAACAATCAGCCCCAGCATTTT	CASSLGPTRTAENNQPQHF	TRBV7-2	TRBJ1-5
TGTGCCAGCAGCTTAGGACCAGGGGCGCCTGAAGCTTTCTTT	CASSLGPGAPEAFF	TRBV7-9	TRBJ1-1
TGCGCCAGCGCCAATTCACTAGCGGAGGGGTCGGGCTCCTACAATGAGCAGTTCTTC	CASANSLAEGSGSYNEQFF	TRBV5-1	TRBJ2-1
TGCGGCCCCCCACCTTTCACTGAAGCTTTCTTT	CGPPPFTEAFF	TRBV20-1	TRBJ1-1
TGCGCCAGCAGCTTGTCGGACAGGGGGGGGGGCTCCTATAATTCACCCCTCCACTTT	CASSLSDRGGGSYNSPLHF	TRBV5-1	TRBJ1-6
TGTGCCAGCAGTTTTATGGGGGGGGGCGACAATGAGCAGTTCTTC	CASSFMGGGDNEQFF	TRBV12-4	TRBJ2-1
TGTGCCAGCAGGCAATACCACCGGGACATCTACGAGCAGTACTTC	CASRQYHRDIYEQYF	TRBV12-4	TRBJ2-7
TGTGCCAGTAGTCCGGTAGATGTCAGGACTTTTACCTACGAGCAGTACTTC	CASSPVDVRTFTYEQYF	TRBV19	TRBJ2-7
TGTGCCAGTAGTGGAGAAGCACCGGACAACTATCAGCCCCAGCATTTT	CASSGEAPDNYQPQHF	TRBV19	TRBJ1-5
TGCGCCAGCAGCTTGAATCCTGGTGGAGATACGCAGTATTTT	CASSLNPGGDTQYF	TRBV5-1	TRBJ2-3
TGTGCCAGCAGCAGACTAGCGGGCTACGAGCAGTACTTC	CASSRLAGYEQYF	TRBV13	TRBJ2-7
TGTGCCAGCAGCAAAGGGGGCGCCTACGAGCAGTACTTC	CASSKGGAYEQYF	TRBV7-9	TRBJ2-7
TGCAGTGCTTGTCAGGGAAACGGTAGCAATCAGCCCCAGCATTTT	CSACQGNGSNQPQHF	TRBV20-1	TRBJ1-5
TGTGCCAGCAGTTCTTACAGGGGGCTGGTTAAGGGAGATACGCAGTATTTT	CASSSYRGLVKGDTQYF	TRBV28	TRBJ2-3
TGCGCCAGCAGCTTGGCCTCCCCAAGGGCGGGCGCCAAAAACATTCAGTACTTC	CASSLASPRAGAKNIQYF	TRBV5-1	TRBJ2-4
TGCAGTGCTTCGGGACAGGGTATTTGCTCTGGAAACACCATATATTTT	CSASGQGICSGNTIYF	TRBV20-1	TRBJ1-3
TGTGCCAGCAGCCAAGACCCCTCAAGGGCCAATGAGCAGTTCTTC	CASSQDPSRANEQFF	TRBV14	TRBJ2-1
TGTGCCAGCTCACCAGGGCCAGGCCTCCTCTACGAGCAGTACTTC	CASSPGPGLLYEQYF	TRBV18	TRBJ2-7
TGTGCCAGCAGCCGGACAGGGGGAGAGACCCAGTACTTC	CASSRTGGETQYF	TRBV9	TRBJ2-5
TGTGCCAGCAGTTTCGGAGGGTGTAGGTATATCCCCAGTAGAGCTTTCTTT	CASSFGGCRYIPSRAFF	TRBV12-4	TRBJ1-1
TGTGCCAGCAGCAGAGAAAACGGGATGGCTAGCACAGATACGCAGTATTTT	CASSRENGMASTDTQYF	TRBV27	TRBJ2-3
TGCAGTGCTGATCGGGGGGCAGGGGGCCCCGTAGACTCTTACGAGCAGTACTTC	CSADRGAGGPVDSYEQYF	TRBV20-1	TRBJ2-7
TGTGCCAGCAGTACGTGTGGGGGCTCCTCCTACGAGCAGTACTTC	CASSTCGGSSYEQYF	TRBV27	TRBJ2-7
TGCGCCACCTTGGGGACTAGCGGGATGGGTCCCCAGTACTTC	CATLGTSGMGPQYF	TRBV10-1	TRBJ2-5
TGTGCCAGCAGTTACTCGACATTGACCAATGAGCAGTTCTTC	CASSYSTLTNEQFF	TRBV6-5	TRBJ2-1
TGTGCCACGGTCCCACAGGGTCCGGGGAATTCACCCCTCCACTTT	CATVPQGPGNSPLHF	TRBV7-9	TRBJ1-6
TGTGCCAGCAGTAACAGAGTCTTCTCCTACGAGCAGTACTTC	CASSNRVFSYEQYF	TRBV6-3	TRBJ2-7
TGCGCCAGCACCTACCTAGACACCTTC	CASTYLDTF	TRBV5-1	TRBJ1-2
TGCGCCAGCAGCTTGACCGGTGGGACAGGGGAAAACACCATATATTTT	CASSLTGGTGENTIYF	TRBV5-1	TRBJ1-3
TGTGCTAGCAGCTTAGTCCACTTCGGGACAGCGGGTTCTGGCTACACCTTC	CASSLVHFGTAGSGYTF	TRBV7-7	TRBJ1-2
TGTGCCAGCCCCGGGACTAGCGGGGTTCGAGGAGCCAAAAACATTCAGTACTTC	CASPGTSGVRGAKNIQYF	TRBV6-2	TRBJ2-4
TGTGCCAGCACCCCGACAGGGCTCTACGAGCAGTACTTC	CASTPTGLYEQYF	TRBV14	TRBJ2-7
TGTGCCAGCAGGAAATTAGGCGAAGGGTCCCTTGTGCCCCAGCATTTT	CASRKLGEGSLVPQHF	TRBV27	TRBJ1-5
TGCGCCAGCAGTGTTGACACACCGGATGAGCAGTTCTTC	CASSVDTPDEQFF	TRBV10-1	TRBJ2-1
TGCGCCAGCAGTGAGGGAGGCAACGGGAGGAACGGCTATGGCTACACCTTC	CASSEGGNGRNGYGYTF	TRBV10-1	TRBJ1-2
TGTGCCAGCAGCGTCCCAGGGGACAGAAAAGCTTTCTTT	CASSVPGDRKAFF	TRBV7-3	TRBJ1-1
TGTGCCAGCAGCGTGACAGGGTCTCTGAGCTACGAGCAGTACTTC	CASSVTGSLSYEQYF	TRBV13	TRBJ2-7
TGCAGTGCTAGAGATTACCAGAGATTTAATCAGCCCCAGCATTTT	CSARDYQRFNQPQHF	TRBV20-1	TRBJ1-5
TGTGCCACCAGTGGTAAGGGGGGGCCTTACGAGCAGTACTTC	CATSGKGGPYEQYF	TRBV24-1	TRBJ2-7
TGTGCCAGTAGGGAACACCTCTTC	CASREHLF	TRBV3-1	TRBJ2-1
TGTGCCTTGCGAGCCTGGAGTGTGGCTGAAGCTTTCTTT	CALRAWSVAEAFF	TRBV19	TRBJ1-1
TGTGCCAGCACACGCTATGGCTACACCTTC	CASTRYGYTF	TRBV7-3	TRBJ1-2
TGTGCCACCAGTGAATTCGGGGGACTAGCGGACGAGCAGTACTTC	CATSEFGGLADEQYF	TRBV24-1	TRBJ2-7
TGTGCCAGCACCGGGACTAAGGACACCGGGGAGCTGTTTTTT	CASTGTKDTGELFF	TRBV10-3	TRBJ2-2
TGTGCCAGCAGCTTAGGGTGGGACAGGCGCGCCTCTGGAAACACCATATATTTT	CASSLGWDRRASGNTIYF	TRBV7-9	TRBJ1-3
TGTGCCAGCAGCCAAGATAAACCGGGACAGGGGGATCAGCCCCAGCATTTT	CASSQDKPGQGDQPQHF	TRBV4-2	TRBJ1-5
TGTGCCAGCAGCTTGACGGCGCTGGCAAACACTGAAGCTTTCTTT	CASSLTALANTEAFF	TRBV5-5	TRBJ1-1
TGTGCCAGCAGCTACACCAGGGGAGTTCGAGATACGCAGTATTTT	CASSYTRGVRDTQYF	TRBV7-8	TRBJ2-3
TGTGCCACCAGTGATCTCTCTCACAGCTCCTACGAGCAGTACTTC	CATSDLSHSSYEQYF	TRBV24-1	TRBJ2-7
TGTGCCGCGCCTGCGACAGCGATCTTC	CAAPATAIF	TRBV30	TRBJ2-1
TGTGCCAGCAGTGTTTGTGACGACCCCTACGAGCAGTACTTC	CASSVCDDPYEQYF	TRBV14	TRBJ2-7
TGTGCCAGCAGATCCAGCCCGTCTAGCTGGTCCTACGAGCAGTACTTC	CASRSSPSSWSYEQYF	TRBV28	TRBJ2-7
TGTGCCAGCAGCGTAGGACACGGTAGCAATCAGCCCCAGCATTTT	CASSVGHGSNQPQHF	TRBV9	TRBJ1-5
TGTGCCTGCGGTCGAGAAGGACAAAACGAGCAGTACTTC	CACGREGQNEQYF	TRBV6-5	TRBJ2-7
TGTAAGGTTCAGTCCCCCCAGCAGGGGGCCTCTGGAAACACCATATATTTT	CKVQSPQQGASGNTIYF	TRBV30	TRBJ1-3
TGCAGCGTTGATCCAGCGGACTTTCGTCCCGAGGAGTATTTT	CSVDPADFRPEEYF	TRBV29-1	TRBJ2-3
TGTGCCAGCAGTTCGGGACAGGACCAAGAGACCCAGTACTTC	CASSSGQDQETQYF	TRBV27	TRBJ2-5
TGTGCCAGCAGCAGGGACAGGGCGGCCCTCCACTTT	CASSRDRAALHF	TRBV7-9	TRBJ1-6
TGCAGTGCTAGAGCCCGCGGGAGCTCTGGGGCCAACGTCCTGACTTTC	CSARARGSSGANVLTF	TRBV20-1	TRBJ2-6
TGTGCCTGGGGACAGGGAATTCATACGCAGTATTTT	CAWGQGIHTQYF	TRBV30	TRBJ2-3
TGCGCCAGCAGCGGGAGGGACGAACCGAGCGGTTTTGGAAGGAGTGACACTGAAGCTTTCTTT	CASSGRDEPSGFGRSDTEAFF	TRBV5-1	TRBJ1-1
TGTGCCAGCAGTGAATCCCTAGCGGGCATTTTGTACGAGCAGTACTTC	CASSESLAGILYEQYF	TRBV6-1	TRBJ2-7
TGTGCCAGGAGCTACGAGCAGTACTTC	CARSYEQYF	TRBV11-2	TRBJ2-7
TGTGCCAGCAGCCAAGATAAACCGAAGACAGATACGCAGTATTTT	CASSQDKPKTDTQYF	TRBV4-2	TRBJ2-3
TGTGCCAGCAGCTTGGCTGCGGGGGGGGAGACCCAGTACTTC	CASSLAAGGETQYF	TRBV11-3	TRBJ2-5
TGTGCCAGCAGTAGTCAGGGCGAAGGAAACACCATATATTTT	CASSSQGEGNTIYF	TRBV28	TRBJ1-3
TGCGCCAGCAGCGGGCGAGGGTGGAAAGTACTCCACACCGGGGAGCTGTTTTTT	CASSGRGWKVLHTGELFF	TRBV5-1	TRBJ2-2
TGTGCCAGCAGCCCATCCCAGGAAGGGCCGGCATACACCGGGGAGCTGTTTTTT	CASSPSQEGPAYTGELFF	TRBV7-8	TRBJ2-2
TGTGCCAGCAGTGACTGGATTCTGGTTGCCTACGAGCAGTACTTC	CASSDWILVAYEQYF	TRBV6-4	TRBJ2-7
TGTGCCAGCAGCCAAGAAGGCCCCGGGACAGGGGCTCCCTACGAGCAGTACTTC	CASSQEGPGTGAPYEQYF	TRBV4-2	TRBJ2-7
TGTGCCACCAGATCCGATTCGGGGGGCCTATTGTATGGCTACACCTTC	CATRSDSGGLLYGYTF	TRBV24-1	TRBJ1-2
TGTGCCAGCAGCGGAGGGGGTTATCTAGCGGGACCTCCAGATACGCAGTATTTT	CASSGGGYLAGPPDTQYF	TRBV7-9	TRBJ2-3
TGTGCCAGCAGCCTTCGGGACCCGGAGGGGGGGGCCAACGTCCTGACTTTC	CASSLRDPEGGANVLTF	TRBV7-3	TRBJ2-6
TGTGCCAGCAGCTACACAGGGCGGCAGCCCCAGCATTTT	CASSYTGRQPQHF	TRBV5-6	TRBJ1-5
TGTGCCAGCAGGAGTACCCTAGCGGGCCTCAATGAGCAGTTCTTC	CASRSTLAGLNEQFF	TRBV12-4	TRBJ2-1
TGTGCCAGCAGCTTGGTAGTCCCCCGGGACAGGGGAGCGAATTCACCCCTCCACTTT	CASSLVVPRDRGANSPLHF	TRBV5-6	TRBJ1-6
TGTGCCAGCAGCTTACCCCGTCGAGGGACTAGCGGGGGCCCTGAGCAGTTCTTC	CASSLPRRGTSGGPEQFF	TRBV7-2	TRBJ2-1
TGTGCCAGCAGTGAATTTCAAGTAGGGACAGCGAACACTGAAGCTTTCTTT	CASSEFQVGTANTEAFF	TRBV25-1	TRBJ1-1
TGCAGTGCTAGCTTTGGCCATCAGCCCCAGCATTTT	CSASFGHQPQHF	TRBV20-1	TRBJ1-5
TGTGCCAGCAGTGACCAGGGAGGCTATGGCTACACCTTC	CASSDQGGYGYTF	TRBV2	TRBJ1-2
TGTGCCAGCAGCTTAGGCAGGGGCCAGCCCCGCCAAGAGACCCAGTACTTC	CASSLGRGQPRQETQYF	TRBV13	TRBJ2-5
TGTGCCAGCAGCCCAGGGCAAAAAAATTTCGAGCAGTACTTC	CASSPGQKNFEQYF	TRBV6-5	TRBJ2-7
TGTGCCAGCAGTTTAAATACAAAAAGGGGGCGTAGAAGAACACAAGATACGCAGTATTTT	CASSLNTKRGRRRTQDTQYF	TRBV27	TRBJ2-3
TGTGCCAGCAGCCAAGGGACCGGGAGTCCAACGATCTACGAGCAGTACTTC	CASSQGTGSPTIYEQYF	TRBV4-2	TRBJ2-7
TGTGCCAGCAGAGACCAGGGTCTGAAGAGGAATGGGAATCAGCCCCAGCATTTT	CASRDQGLKRNGNQPQHF	TRBV27	TRBJ1-5
TGTGCCAGCACTCGGACAGGTGGTCTACTCTCTGGAAACACCATATATTTT	CASTRTGGLLSGNTIYF	TRBV7-9	TRBJ1-3
TGTGCCAGCAGCTCTGGAAAGGGGACTAGCGAAGGGGAGACCCAGTACTTC	CASSSGKGTSEGETQYF	TRBV5-4	TRBJ2-5
TGTGCTAGTGGTTTTAAGTGCAGGGGGAACACTGAAGCTTTCTTT	CASGFKCRGNTEAFF	TRBV12-5	TRBJ1-1
TGTGCCAGCAGCCAAGGGTTTTTGCAGGCTGGGACCGGGGAGCTGTTTTTT	CASSQGFLQAGTGELFF	TRBV3-1	TRBJ2-2
TGTGCCAGCACCTATGGGGATAGGGGCCTAAATGAGCAGTTCTTC	CASTYGDRGLNEQFF	TRBV4-2	TRBJ2-1
TGCAGCGTTGATCGTCCATCGGGACTAGTAGACAATGAGCAGTTCTTC	CSVDRPSGLVDNEQFF	TRBV29-1	TRBJ2-1
TGCAGCGTTGAAGACCCCGCGCTAGCGCCCGATGATAAGTATTTT	CSVEDPALAPDDKYF	TRBV29-1	TRBJ2-3
TGTGCCAGCAGTTTCGGGAGGGTATACGAGCAGTACTTC	CASSFGRVYEQYF	TRBV28	TRBJ2-7
TGTGCCAGTAGTGTTAGGGGACAGGGTCGGAGGAGCTCCTATAATTCACCCCTCCACTTT	CASSVRGQGRRSSYNSPLHF	TRBV19	TRBJ1-6
TGTGCCAGCAGTAAGGCCGGAACGCAGGGGAAGTGGGGCTCTGGGGCCAACGTCCTGACTTTC	CASSKAGTQGKWGSGANVLTF	TRBV27	TRBJ2-6
TGTGCCAGCACCCTGAGGGGGCAGGGCGCCTACGAGCAGTACTTC	CASTLRGQGAYEQYF	TRBV6-4	TRBJ2-7
TGCAGTGCCCAGGGGACAAGGAGTTCGGAGACCCAGTACTTC	CSAQGTRSSETQYF	TRBV20-1	TRBJ2-5
TGTGCCAGCAGCAATTCAGACAGGGGTAGAAACACCATATATTTT	CASSNSDRGRNTIYF	TRBV7-2	TRBJ1-3
TGTGCCAGCAGCGGGACAGACCCGAATGGCTACACCTTC	CASSGTDPNGYTF	TRBV7-3	TRBJ1-2
TGTGCCAGCAGCAGCCTTCGACAGGTGGGTCAGGGATATGGCTACACCTTC	CASSSLRQVGQGYGYTF	TRBV7-9	TRBJ1-2
TGTGCCAGCAGTGAAGCAGGGACGGTCCAAGCTAACTATGGCTACACCTTC	CASSEAGTVQANYGYTF	TRBV6-1	TRBJ1-2
TGTGCCAGCAGCTTGGGGGCTGGCTCTGGGGCCAACGTCCTGACTTTC	CASSLGAGSGANVLTF	TRBV11-3	TRBJ2-6
TGTGCCAGCAGTCTTTCCAGGTTTCAAGGACCCAATCAGCCCCAGCATTTT	CASSLSRFQGPNQPQHF	TRBV6-5	TRBJ1-5
TGCAGTGCTAGAGTTATGGGACAGGGGCCCTACGAGCAGTACTTC	CSARVMGQGPYEQYF	TRBV20-1	TRBJ2-7
TGTGCCAGCAGCGGACTAGCGGGAGGGGAGCAGTACTTC	CASSGLAGGEQYF	TRBV11-3	TRBJ2-7
TGCGCCAGCAGTGAGCGGGACATATTTCCCAGGCCCCAGCATTTT	CASSERDIFPRPQHF	TRBV10-1	TRBJ1-5
TGTGCCAGCACAGGGATGAACCGGGACTTTCCTTCCTATAATTCACCCCTCCACTTT	CASTGMNRDFPSYNSPLHF	TRBV7-9	TRBJ1-6
TGTGCCAGCAACCCGCGGGACAGGTTGAACACTGAAGCTTTCTTT	CASNPRDRLNTEAFF	TRBV6-5	TRBJ1-1
TGTGCCAGCAGCTTCGGCCCAGGACTAGGGGAGCAGTTCTTC	CASSFGPGLGEQFF	TRBV7-8	TRBJ2-1
TGTGCCAGCAGGCTTTGGGACAGGGGGCGAAGTGGGGATGAGCAGTTCTTC	CASRLWDRGRSGDEQFF	TRBV6-8	TRBJ2-1
TGTGCCAGCAGCTTTTACGGTCCAGAAATAGCTTTCTTT	CASSFYGPEIAFF	TRBV7-6	TRBJ1-1
TGCGCCAGCAGCCTCCGGGGGTATTGGCATGAAGCTTTCTTT	CASSLRGYWHEAFF	TRBV4-3	TRBJ1-1
TGCAGCGACTCTTACCCTTCCGGGACAGGAAGGACCTATGAGCAGTACTTC	CSDSYPSGTGRTYEQYF	TRBV29-1	TRBJ2-7
TGTGCCAGCAGTTACTCGAAGATTCAGGAACCAAATAGCAATCAGCCCCAGCATTTT	CASSYSKIQEPNSNQPQHF	TRBV6-5	TRBJ1-5
TGTGCCAGCAGCTTGTGGGGGCGCTCTACTGAAGCTTTCTTT	CASSLWGRSTEAFF	TRBV5-4	TRBJ1-1
TGTGCCAGCAGCTTGGAAGTCAGGGTTTTCCGGGATTTGCTCTCCTACAATGAGCAGTTCTTC	CASSLEVRVFRDLLSYNEQFF	TRBV5-6	TRBJ2-1
TGCGCCAGCAGGCTGGCCACAGAGGGCTACACCTTC	CASRLATEGYTF	TRBV4-1	TRBJ1-2
TGTGCCAGCAGCCCGGCTACACAGGGGACAGATACGCAGTATTTT	CASSPATQGTDTQYF	TRBV7-3	TRBJ2-3
TGCGCCAGCAGCAGGACCCCCCGGGCCACCTCCTATAATTCACCCCTCCACTTT	CASSRTPRATSYNSPLHF	TRBV10-1	TRBJ1-6
TGTGCCAGCAGCCACCGGGACAGGGTCAGTGAACGTGACTATGGCTACACCTTC	CASSHRDRVSERDYGYTF	TRBV14	TRBJ1-2
TGTGCCAGCAGTTACTCGAGGCGGATCACAGATACGCAGTATTTT	CASSYSRRITDTQYF	TRBV6-3	TRBJ2-3
TGCGCCAGCAGCAGGGGATCTAAGTTCGGCAATCAGCCCCAGCATTTT	CASSRGSKFGNQPQHF	TRBV5-1	TRBJ1-5
TGCAGTGCTAGTAGGGTGGGGTTGGGCGGAAATTCACCCCTCCACTTT	CSASRVGLGGNSPLHF	TRBV20-1	TRBJ1-6
TGTGCCAGCAGTACTCAGTACAATGAGCAGTTCTTC	CASSTQYNEQFF	TRBV6-2	TRBJ2-1
TGCAGTGCTAGGTATACGCCCAACGGGTCAGGCTCGGGGGAGCAGTACTTC	CSARYTPNGSGSGEQYF	TRBV20-1	TRBJ2-7
TGCGCCAGCAGCCGAGGGAAGGCCTACGAGCAGTACTTC	CASSRGKAYEQYF	TRBV5-1	TRBJ2-7
TGTGCCAGCACGGAAAGGTGGGAGGGGAGCTCCTACAATGAGCAGTTCTTC	CASTERWEGSSYNEQFF	TRBV6-5	TRBJ2-1
TGTGCCAGCAGTCATGCAGCTTATAGCAATCAGCCCCAGCATTTT	CASSHAAYSNQPQHF	TRBV6-3	TRBJ1-5
TGTGCCAGCAGCCAAGATCTAGTTGCGGGGCCATGGGACTTATATGGCTACACCTTC	CASSQDLVAGPWDLYGYTF	TRBV14	TRBJ1-2
TGCGCCAGCAGTGGAAAATGGGGAAGCAATCAGCCCCAGCATTTT	CASSGKWGSNQPQHF	TRBV10-1	TRBJ1-5
TGTGCCAGCATTGCTATTTTAGGTTGTGGGGACAGGGGGCAGGGGGACTACGAGCAGTACTTC	CASIAILGCGDRGQGDYEQYF	TRBV7-6	TRBJ2-7
TGTGCCAGCAGTGTTCTACAGGGCTCCTACGAGCAGTACTTC	CASSVLQGSYEQYF	TRBV25-1	TRBJ2-7
TGTGCCAGCAGCGGGACTAGTCGCGAGCAGTACTTC	CASSGTSREQYF	TRBV9	TRBJ2-7
TGCGCCAGCAGCCAAGGGACGTACAGCCCTTATGGCTACACCTTC	CASSQGTYSPYGYTF	TRBV4-1	TRBJ1-2
TGTGCCAGCAGTGAGAGCCCACCGGGGGGGTCTTACAATGAGCAGTTCTTC	CASSESPPGGSYNEQFF	TRBV6-4	TRBJ2-1
TGTGCCAGCATGTGGAGGGGTATCTATGGCTACACCTTC	CASMWRGIYGYTF	TRBV7-3	TRBJ1-2
TGTGCCAGCAGCTTGGGGGGGACCTACGAGCAGTACTTC	CASSLGGTYEQYF	TRBV7-7	TRBJ2-7
TGTGCCAGCAGTATGGAGTCTGTTTTGAGGGCTGACGGGACAGATGAGCAGTTCTTC	CASSMESVLRADGTDEQFF	TRBV6-6	TRBJ2-1
TGCAGTGCTAGCAGGGGGACTAGCCCCCCCCCCTACGAGCAGTACTTC	CSASRGTSPPPYEQYF	TRBV20-1	TRBJ2-7
TGTGCCAGCAGTTACCCAGGACTAGCGGCCGGTCTCCAAGAGACCCAGTACTTC	CASSYPGLAAGLQETQYF	TRBV6-2	TRBJ2-5
TGTGCCAGCAGCTTAGGGAGGACAAATGAGCAGTTCTTC	CASSLGRTNEQFF	TRBV7-2	TRBJ2-1
TGCGCCAGCAGCCAAGATGAACACAGGGAGGCACGACCGAACACTGAAGCTTTCTTT	CASSQDEHREARPNTEAFF	TRBV4-1	TRBJ1-1
TGTGCCAGCCTATTGACTAGACTCTTC	CASLLTRLF	TRBV7-9	TRBJ2-1
TGTGCCAGCAGGGGCGCACCGCGACCTAGCAATCAGCCCCAGCATTTT	CASRGAPRPSNQPQHF	TRBV9	TRBJ1-5
TGTGCCACCCGACCGGGACAGGGGGCTGGGGAGACCCAGTACTTC	CATRPGQGAGETQYF	TRBV6-5	TRBJ2-5
TGTGCCAGCAGACTGGTCATATCCAACAGGGGGGAAGGGGGTAACTATGGCTACACCTTC	CASRLVISNRGEGGNYGYTF	TRBV6-6	TRBJ1-2
TGTGCCAGCAGTATACCGGGACTAGCGGGAGCGGGACCCTATGGCTACACCTTC	CASSIPGLAGAGPYGYTF	TRBV2	TRBJ1-2
TGTGCCAGCAGTTTGTCCGGGACAGATTCAGGGCGGGAGCTGTTTTTT	CASSLSGTDSGRELFF	TRBV28	TRBJ2-2
TGCAGTGCTAGATTTCGGCGACTAGCGGGACCCCATACGCAGTATTTT	CSARFRRLAGPHTQYF	TRBV20-1	TRBJ2-3
TGCGCCAGCAGCTGCGCTAGCGGGTCTGGCTTCACAGATACGCAGTATTTT	CASSCASGSGFTDTQYF	TRBV5-1	TRBJ2-3
TGTGCCAGCACGGGGACAGGGGTCTCGGGGGTAATGAACACTGAAGCTTTCTTT	CASTGTGVSGVMNTEAFF	TRBV5-4	TRBJ1-1
