TGTGCCAGCAGTTACAACGAGATGGGGAAGGGACAGGGCGGAGAGACCTACGAGCAGTACTTC	CASSYNEMGKGQGGETYEQYF	TRBV6-6	TRBJ2-7
TGTGCCAGCAGGATCAGGACAGGGGTCACCGGGGAGCTGTTTTTT	CASRIRTGVTGELFF	TRBV7-2	TRBJ2-2
TGTGCCAGCAGCTATTCACTAGTAGTAGCCTACAATGAGCAGTTCTTC	CASSYSLVVAYNEQFF	TRBV7-8	TRBJ2-1
TGTGCCAGCAAAACCCGAGTTCTTGAAAAACTGTTTTTT	CASKTRVLEKLFF	TRBV6-1	TRBJ1-4
TGTGCCAGCAGTGACGTGGCAATGAACACTGAAGCTTTCTTT	CASSDVAMNTEAFF	TRBV6-4	TRBJ1-1
TGTGCCAGCAGCTTACCTTCGACTAGCGGGAGTTGTAACACAGATACGCAGTATTTT	CASSLPSTSGSCNTDTQYF	TRBV7-9	TRBJ2-3
TGTGCCAGCGTGGGGGGGTTCCAAGAGACCCAGTACTTC	CASVGGFQETQYF	TRBV11-3	TRBJ2-5
TGCGCCAGCAGCTTGAGGGCGCAGGGGAGGGGGCGCACAGATACGCAGTATTTT	CASSLRAQGRGRTDTQYF	TRBV5-1	TRBJ2-3
TGTGCTAGTGGTTTACTAGCGAACTGGAGCTCCTACAATGAGCAGTTCTTC	CASGLLANWSSYNEQFF	TRBV12-5	TRBJ2-1
TGTGCCAGCAGCTTAGTACGGTTAGCGGAGACCCAGTACTTC	CASSLVRLAETQYF	TRBV11-2	TRBJ2-5
TGTGCCAGCAGCCAAGATCGCCAGGAGACTAGCGGATGTAGTGAGCAGTTCTTC	CASSQDRQETSGCSEQFF	TRBV4-2	TRBJ2-1
TGTGCCAGTCGGAGGAAGGGATACGAGCAGTACTTC	CASRRKGYEQYF	TRBV7-8	TRBJ2-7
TGTGCCAGCAGCCAAGATGACCCTAGTACCGACAGGGGGGATCAGCCCCAGCATTTT	CASSQDDPSTDRGDQPQHF	TRBV3-1	TRBJ1-5
TGTGCCAGCACGGGGGGTAAGGGAGCTAACTATGGCTACACCTTC	CASTGGKGANYGYTF	TRBV2	TRBJ1-2
TGCAGTGCTAGGGGGGGGATGAACACTGAAGCTTTCTTT	CSARGGMNTEAFF	TRBV20-1	TRBJ1-1
TGTGCCAGCAGCCTACCGGGACCCAATGAGCAGTTCTTC	CASSLPGPNEQFF	TRBV7-3	TRBJ2-1
TGTGCCAGCAGCCAAGATGAACCAGGCGCAACTAATGAAAAACTGTTTTTT	CASSQDEPGATNEKLFF	TRBV14	TRBJ1-4
TGTGCCAGCAGTTTCAGTCCCCCCAATCAGCCCCAGCATTTT	CASSFSPPNQPQHF	TRBV27	TRBJ1-5
TGCATCCCTCGGACAAGACTAGCGGGGTATAGGACAGATACGCAGTATTTT	CIPRTRLAGYRTDTQYF	TRBV20-1	TRBJ2-3
TGTGCCAGCACCACGATTCCGCAAAGGGGTGGAAACACCATATATTTT	CASTTIPQRGGNTIYF	TRBV25-1	TRBJ1-3
TGCGCCAGCAGCTGTGGGACAGGGGATAAGTCTAATGAAAAACTGTTTTTT	CASSCGTGDKSNEKLFF	TRBV5-1	TRBJ1-4
TGCGCCAGCAGTGAGGGGGGGCTCACCGGGGAGCTGTTTTTT	CASSEGGLTGELFF	TRBV10-1	TRBJ2-2
TGTGCCAGTAGTATGGTGACAGAGGCGGGACGAAGGCCGGGACACTATGGCTACACCTTC	CASSMVTEAGRRPGHYGYTF	TRBV19	TRBJ1-2
TGTGCCAGCAGTGGACCCCCAGAGGATCAGCCCCAGCATTTT	CASSGPPEDQPQHF	TRBV27	TRBJ1-5
TGCGCCAGCAGCGGCGGGGGAGGCATCCCCTACGAGCAGTACTTC	CASSGGGGIPYEQYF	TRBV4-1	TRBJ2-7
TGTGCCAGCAGCCTTTACACCAATCAGCCCCAGCATTTT	CASSLYTNQPQHF	TRBV7-3	TRBJ1-5
TGCGCCAGCAGCCAACGGGCCTACCTGCAGGACACCGGGGAGCTGTTTTTT	CASSQRAYLQDTGELFF	TRBV4-1	TRBJ2-2
TGTGCCTGGAGGGAGGATTGTCACGAAAGCAATGAGCAGTTCTTC	CAWREDCHESNEQFF	TRBV30	TRBJ2-1
TGCAGTGCTCCGACAAAGATAGCGGGCAACCAAGAGACCCAGTACTTC	CSAPTKIAGNQETQYF	TRBV20-1	TRBJ2-5
TGTGCCAGCTCACCTGCCAGGGACTGGAACACTGAAGCTTTCTTT	CASSPARDWNTEAFF	TRBV18	TRBJ1-1
TGTGCCAGCAGGAATCACCGGGACAGCCGGGAAAAACTGTTTTTT	CASRNHRDSREKLFF	TRBV9	TRBJ1-4
TGCGCCAGCAGCCAGCAGGGGTATGGCTACACCTTC	CASSQQGYGYTF	TRBV5-1	TRBJ1-2
TGCAGTGCTAGCCGGACCCTCTTAGGGATCCGAACATTGGGCAATGAGCAGTTCTTC	CSASRTLLGIRTLGNEQFF	TRBV20-1	TRBJ2-1
TGTGCCAGCAGCCAGGGACAGACTGGGGCCAACGTCCTGACTTTC	CASSQGQTGANVLTF	TRBV3-1	TRBJ2-6
TGTGCCAGCGTCACCTCCGGGACTAGCGGGAGGGCTATCGAGCAGTACTTC	CASVTSGTSGRAIEQYF	TRBV5-6	TRBJ2-7
TGTGCCAGCAGGGGGACTAGCGAGAAAGAGACCCAGTACTTC	CASRGTSEKETQYF	TRBV6-2	TRBJ2-5
TGTGCCAGCAGTGAATTTCCGGACAGGCAAAGGCCCAACTATGGCTACACCTTC	CASSEFPDRQRPNYGYTF	TRBV25-1	TRBJ1-2
TGTGCCAGCAGCCAAGATTTAGTCAGGGGGTGGGATTGGACGAGAAACATTCAGTACTTC	CASSQDLVRGWDWTRNIQYF	TRBV4-2	TRBJ2-4
TGTGCCAGCAGCTTAGAGGGCCCGGTCGGAAACACCATATATTTT	CASSLEGPVGNTIYF	TRBV7-9	TRBJ1-3
TGTGCCAGCAGCGGACTAGCGGAGGAGGAGCAGTACTTC	CASSGLAEEEQYF	TRBV7-6	TRBJ2-7
TGTGCCAGCAGACGGGCCCCTAACTATGGCTACACCTTC	CASRRAPNYGYTF	TRBV6-4	TRBJ1-2
TGTGCCAGCAGCCACCCCGGGAGGGCTACTGAAGCTTTCTTT	CASSHPGRATEAFF	TRBV4-2	TRBJ1-1
TGTGCCAGCAGTGTTGGCAGAGAGGTAGGGTGCTACGAGCAGTACTTC	CASSVGREVGCYEQYF	TRBV6-1	TRBJ2-7
TGTGCCAGCAGTTACTCTGCGCGCGGGAGGATTAGCTCCTATAATTCACCCCTCCACTTT	CASSYSARGRISSYNSPLHF	TRBV6-5	TRBJ1-6
TGTGCCAGCAGTGACGACGCGGGAGATCCCCGAAATGAGCAGTTCTTC	CASSDDAGDPRNEQFF	TRBV6-4	TRBJ2-1
TGTGCCAGCAGTGAATTTGGGGTAGCGAAGATTCCGGGCCAAAACACTGAAGCTTTCTTT	CASSEFGVAKIPGQNTEAFF	TRBV25-1	TRBJ1-1
TGCGCCAGCAGCCAGGGGGGAGGGAGAGCCAAAAACATTCAGTACTTC	CASSQGGGRAKNIQYF	TRBV4-3	TRBJ2-4
TGTGCCAGCAGCCGAGGCCGGGACAGGGCAAACGGGCTAGCCAAAAACATTCAGTACTTC	CASSRGRDRANGLAKNIQYF	TRBV5-6	TRBJ2-4
TGTGCCAGCAGTGAATTGCGTGACAGCCTCAGCAATCAGCCCCAGCATTTT	CASSELRDSLSNQPQHF	TRBV25-1	TRBJ1-5
TGTGCCAGCAGTGAAATCCGGGACAGGGGGGGTGATGGCTACACCTTC	CASSEIRDRGGDGYTF	TRBV6-1	TRBJ1-2
TGTGCCAGCAGTTACAAAGAGAGGGGGGACGTAGCCAAAAACATTCAGTACTTC	CASSYKERGDVAKNIQYF	TRBV6-5	TRBJ2-4
TGTGCCAGCAGCCTCGGGGGGCTTGAGACCCAGTACTTC	CASSLGGLETQYF	TRBV3-1	TRBJ2-5
TGCAGTGCTAGCTTCTCCTCCAAAAAGGGCAATGGCTACACCTTC	CSASFSSKKGNGYTF	TRBV20-1	TRBJ1-2
TGTGCCAGCAGCTTAATTAAGGGGAAGACTAATGAAAAACTGTTTTTT	CASSLIKGKTNEKLFF	TRBV11-2	TRBJ1-4
TGTGCCAGCAGCTTATTCATGGCGTCATTTCTAGATACGCAGTATTTT	CASSLFMASFLDTQYF	TRBV11-3	TRBJ2-3
TGCGCCAGCAGCCTCAGTCATGAAGCACTAGGAACGCCCAACACCGGGGAGCTGTTTTTT	CASSLSHEALGTPNTGELFF	TRBV4-3	TRBJ2-2
TGTGCCAGTCCAGACACTGAAGCTTTCTTT	CASPDTEAFF	TRBV6-3	TRBJ1-1
TGCAGTAGAGGACAGAACCCCTACGAGCAGTACTTC	CSRGQNPYEQYF	TRBV20-1	TRBJ2-7
TGCAGTGCCGGTTTTCAGGGGCCTGAAGCTTTCTTT	CSAGFQGPEAFF	TRBV20-1	TRBJ1-1
TGTGCCAGCAGCAAGAGAGGGGGCGAGGCTCCGACGTCTTATCAGCCCCAGCATTTT	CASSKRGGEAPTSYQPQHF	TRBV5-6	TRBJ1-5
TGTGCCAGCAGTGGCCCCCACCCTGAAAACATTCAGTACTTC	CASSGPHPENIQYF	TRBV6-4	TRBJ2-4
TGTGCCAGCAGCGTAGGGATCGTCGGGGGGCAAGAGACCCAGTACTTC	CASSVGIVGGQETQYF	TRBV9	TRBJ2-5
TGTGCCAGCAGGGGGGGGATCCTTGAAAAACTGTTTTTT	CASRGGILEKLFF	TRBV6-6	TRBJ1-4
TGTGCCACCAGTGAGTGGCCTTTAACAGGGTATGGCTACACCTTC	CATSEWPLTGYGYTF	TRBV24-1	TRBJ1-2
TGTGCCAGCAGCTTCCCCGTCCGGGACAGGGCTAACACTGAAGCTTTCTTT	CASSFPVRDRANTEAFF	TRBV7-8	TRBJ1-1
TGTGCCAGCAGCGACGGGAATACGCAGTATTTT	CASSDGNTQYF	TRBV7-3	TRBJ2-3
TGTGCCAGCAGGGGGCAAACCCAGTACTTC	CASRGQTQYF	TRBV28	TRBJ2-5
TGCGCCAGCAGTGAACCCGGGGGGGTATTATTGGACTATGGCTACACCTTC	CASSEPGGVLLDYGYTF	TRBV10-2	TRBJ1-2
TGTGCCAGCAGTTACGGCTCCGGGGGCGCTGGCTACACCTTC	CASSYGSGGAGYTF	TRBV6-2	TRBJ1-2
TGCAGTGCTTCAGGTCGGGGGACTGAGCAGTTCTTC	CSASGRGTEQFF	TRBV20-1	TRBJ2-1
TGTGCCAGCAGCCCGACGGGGATTTTAGAGACCCAGTACTTC	CASSPTGILETQYF	TRBV13	TRBJ2-5
TGTGCCTGGAGTCCCAGCCGACAGGGTGCACCTGAAGCTTTCTTT	CAWSPSRQGAPEAFF	TRBV30	TRBJ1-1
TGTGCCAGCAGTTACATAAAGGCTTTCTTT	CASSYIKAFF	TRBV6-5	TRBJ1-1
TGTGCCAGCAGCGGTACAGAACTGGGACTCACGAATCAGCCCCAGCATTTT	CASSGTELGLTNQPQHF	TRBV9	TRBJ1-5
TGTGCCAGCAGTTACTCGCAGGGTCCGCATGAGCAGTTCTTC	CASSYSQGPHEQFF	TRBV6-5	TRBJ2-1
TGCGCCAGCAGCTCGAGAAGGGGGTACTCCTACGAGCAGTACTTC	CASSSRRGYSYEQYF	TRBV5-1	TRBJ2-7
TGTGCCTGGAGCCGGACAGGTGAGGGGGCCTACGAGCAGTACTTC	CAWSRTGEGAYEQYF	TRBV30	TRBJ2-7
TGTGCTAGTGGTTTGCCCCCCCGGGGGGCATACATTCAGTACTTC	CASGLPPRGAYIQYF	TRBV12-5	TRBJ2-4
TGTGCCAGCACTAGCGGGACGGGCATTCAGTACTTC	CASTSGTGIQYF	TRBV6-3	TRBJ2-4
TGTGCCAGCAGTGGCTTGACCGGGCTAGGCTCCTACAATGAGCAGTTCTTC	CASSGLTGLGSYNEQFF	TRBV25-1	TRBJ2-1
TGCAGTGCTAGAGAGGCGGTTCCAGGGGTCTACGAGCAGTACTTC	CSAREAVPGVYEQYF	TRBV20-1	TRBJ2-7
TGTGCCAGCAGCTTAACGCTCCCCTATCGAGAAAGGCTAGCCAAAAACATTCAGTACTTC	CASSLTLPYRERLAKNIQYF	TRBV7-3	TRBJ2-4
TGTGCCAGCAGCGGGCACAGGGACGACTACGAGCAGTACTTC	CASSGHRDDYEQYF	TRBV9	TRBJ2-7
TGTGCCAGCAGTGAAGCTATGACAGACTATTGCAATCAGCCCCAGCATTTT	CASSEAMTDYCNQPQHF	TRBV2	TRBJ1-5
TGTGCCAGCAGCTTCCCGGGACAGGGGGCCTATTCCTACAATGAGCAGTTCTTC	CASSFPGQGAYSYNEQFF	TRBV7-6	TRBJ2-1
TGTGCCACCTTTTCAGGGAACACCGGGGAGCTGTTTTTT	CATFSGNTGELFF	TRBV24-1	TRBJ2-2
TGTGCCAGCAGCAATTTTGAAAATGGGACAAGGTTCTTC	CASSNFENGTRFF	TRBV7-6	TRBJ2-1
TGTGCCAGTAGTAGCAGGGACTCTGGAAACACCATATATTTT	CASSSRDSGNTIYF	TRBV19	TRBJ1-3
TGTGCCACCAGTGCAGTAGATCAGCCCCAGCATTTT	CATSAVDQPQHF	TRBV24-1	TRBJ1-5
TGTGCCAGCAGCTTCGCGTGGTCCTACAATGAGCAGTTCTTC	CASSFAWSYNEQFF	TRBV2	TRBJ2-1
TGTGCCAGCAGCTTTAAGGGGACAGCGAACAATCAGCCCCAGCATTTT	CASSFKGTANNQPQHF	TRBV7-6	TRBJ1-5
TGTGCCACCATCTGCGGGCCTGGAACTGAAGCTTTCTTT	CATICGPGTEAFF	TRBV24-1	TRBJ1-1
TGCAGCGTAAAACCCAGCGGGACCGTCTACGAGCAGTACTTC	CSVKPSGTVYEQYF	TRBV29-1	TRBJ2-7
TGCAGCGTTGGTGGGAGGGGCTGGTATAATTCACCCCTCCACTTT	CSVGGRGWYNSPLHF	TRBV29-1	TRBJ1-6
TGTGCCAGCAGCAACAGCTACGAGCAGTACTTC	CASSNSYEQYF	TRBV13	TRBJ2-7
TGCGCCAGCAGCAGGAAGAGTATCCTAGCGGACAATGAGCAGTTCTTC	CASSRKSILADNEQFF	TRBV10-1	TRBJ2-1
TGTGCCAGCAGCCTCAGGGGACGGTTTAGGCAGCCCCAGCATTTT	CASSLRGRFRQPQHF	TRBV7-9	TRBJ1-5
TGTGCTAGTGGTTTGGTACAACCCGGGACTCAGCCCCAGCATTTT	CASGLVQPGTQPQHF	TRBV12-5	TRBJ1-5
TGTGCCAGCAGCTTACCAACTTGGGACATTATCTTC	CASSLPTWDIIF	TRBV7-2	TRBJ2-1
TGTGCCAGCAGGGATAGGGGACAGGGCGACGAGCAGTACTTC	CASRDRGQGDEQYF	TRBV7-9	TRBJ2-7
TGTGCCAGCAGCCCATTCCAGAGGTTCGTTGAGTCCCCCGGGACAGGGAAAAATCAGCCCCAGCATTTT	CASSPFQRFVESPGTGKNQPQHF	TRBV7-3	TRBJ1-5
TGTGCCAGCATACTGACAGGGGAGTACGAGCAGTACTTC	CASILTGEYEQYF	TRBV28	TRBJ2-7
TGTGCCAGCAGCTTGATACCATTTACGGCTTGCGGGAGACCAAGCTACGAGCAGTACTTC	CASSLIPFTACGRPSYEQYF	TRBV5-6	TRBJ2-7
TGTGCCAGCAGTTCTCAGGGTTCGCTCTCCTATAATTCACCCCTCCACTTT	CASSSQGSLSYNSPLHF	TRBV6-4	TRBJ1-6
TGCAGTGCTAGAGACAGGGGACCGGAGCAGTTCTTC	CSARDRGPEQFF	TRBV20-1	TRBJ2-1
TGCGCCAGCAGCTTGGGGCCCCAGGGCGGTGGCTACACCTTC	CASSLGPQGGGYTF	TRBV5-1	TRBJ1-2
TGCGCCAGCAGTTCTTCTCGGGATGGCAATGAGCAGTTCTTC	CASSSSRDGNEQFF	TRBV10-2	TRBJ2-1
TGTGCCAGCAGGGAGTTGCGACAGGGTTATTCTAATGAAAAACTGTTTTTT	CASRELRQGYSNEKLFF	TRBV6-4	TRBJ1-4
TGTGCCAGCAGGCCCCCTAGGGGGGGGAACCCCAATGAGCAGTTCTTC	CASRPPRGGNPNEQFF	TRBV9	TRBJ2-1
TGTGCCAGCAGGACAGGAGAGAACACTGAAGCTTTCTTT	CASRTGENTEAFF	TRBV13	TRBJ1-1
TGTGCCAGCAGCGTCCCCGACAGAGTATGCAATCAGCCCCAGCATTTT	CASSVPDRVCNQPQHF	TRBV7-8	TRBJ1-5
TGTGCCACCAGTGATTTACCCTTCGCAGGTCCTCGGTACGAGCAGTACTTC	CATSDLPFAGPRYEQYF	TRBV24-1	TRBJ2-7
TGCGCCAGCAGCCTACCCTTCGGCCCGGGGGGTCAGCCCCAGCATTTT	CASSLPFGPGGQPQHF	TRBV4-1	TRBJ1-5
TGTGCCACCAGTGATCCTTTAGTCCTCCGGACTAATGAAAAACTGTTTTTT	CATSDPLVLRTNEKLFF	TRBV24-1	TRBJ1-4
TGTGCCAGCAGCTTAAATCCAACAGGGCTACATAATGAAAAACTGTTTTTT	CASSLNPTGLHNEKLFF	TRBV7-2	TRBJ1-4
TGTGCCAGCAGTTACATTGGGGCTTTTACAGATACGCAGTATTTT	CASSYIGAFTDTQYF	TRBV6-5	TRBJ2-3
TGTGCCAGTCAGGGTCACCTGAACACTGAAGCTTTCTTT	CASQGHLNTEAFF	TRBV19	TRBJ1-1
TGTGCCAGCAAACAGGCCCCCCGGGACCAGGGTAATGAAAAACTGTTTTTT	CASKQAPRDQGNEKLFF	TRBV2	TRBJ1-4
TGTGCCAGCAGCTTCTCAGCAGGGAATAATGAAAAACTGTTTTTT	CASSFSAGNNEKLFF	TRBV7-9	TRBJ1-4
TGTGCCAGCAGCAGGGAATTAGGTCGGGATTGGAAACACTCTGGGGCCAACGTCCTGACTTTC	CASSRELGRDWKHSGANVLTF	TRBV13	TRBJ2-6
TGCGCCAGCAGCCCATGGGGTCCGAACACCGGGGAGCTGTTTTTT	CASSPWGPNTGELFF	TRBV5-1	TRBJ2-2
TGTGCCAGCAGCTACACCCGTTGGTTCCGATCCGGAAGTCAGCCCCAGCATTTT	CASSYTRWFRSGSQPQHF	TRBV13	TRBJ1-5
TGTGCCTGGAGTGTAACCCCCGGGACAATCAGGGCAGGCTACGAGCAGTACTTC	CAWSVTPGTIRAGYEQYF	TRBV30	TRBJ2-7
TGTGCCAGCAGCTTTAAGGGCCCACCGAACACCATATATTTT	CASSFKGPPNTIYF	TRBV7-9	TRBJ1-3
TGTGCCAGCAGTGACGCCGCACCCTTGCGGGAGTGCACAGATACGCAGTATTTT	CASSDAAPLRECTDTQYF	TRBV6-4	TRBJ2-3
TGCAGCGTTGAGCCCGGGGGGTCCCCCGGGGGTAGGTTTAAACTGTTTTTT	CSVEPGGSPGGRFKLFF	TRBV29-1	TRBJ1-4
TGTGCCTGGAGTGTACTAGACAGGGCTCGCTACGAGCAGTACTTC	CAWSVLDRARYEQYF	TRBV30	TRBJ2-7
TGTGCCAGTAGTATCACCAGGGGGCCGACCAATCAGCCCCAGCATTTT	CASSITRGPTNQPQHF	TRBV19	TRBJ1-5
TGTGCCAGCAGCTTGGGAGTTCTTCCGGTAGGGACCCACTCAGATACGCAGTATTTT	CASSLGVLPVGTHSDTQYF	TRBV5-6	TRBJ2-3
TGTGCCAGCAGCTTAGAAGGGGGGGCGGCCGCAACTAACTATGGCTACACCTTC	CASSLEGGAAATNYGYTF	TRBV7-2	TRBJ1-2
TGTGCCAGCAGTTGCCGGGACAGGGTGACGAACACTGAAGCTTTCTTT	CASSCRDRVTNTEAFF	TRBV27	TRBJ1-1
TGTGCCAGCAGCCAAGAGGGGGGGAATGAAAAACTGTTTTTT	CASSQEGGNEKLFF	TRBV3-1	TRBJ1-4
TGTGCCAGCAGCCTACTCTTGCCGGGGGGCTGCACTGAAGCTTTCTTT	CASSLLLPGGCTEAFF	TRBV5-6	TRBJ1-1
TGTGCCAGCAGCCCCGGGACAGGGGGCACGGACAACACTGAAGCTTTCTTT	CASSPGTGGTDNTEAFF	TRBV7-3	TRBJ1-1
TGCGCCAGCAGTGAAAAAAATACAGGCAAAGAGACCCAGTACTTC	CASSEKNTGKETQYF	TRBV10-1	TRBJ2-5
TGTGCCAGCAGCCCAGATGGACCTGAAGCTTTCTTT	CASSPDGPEAFF	TRBV7-3	TRBJ1-1
TGCAGCGTTGAAAGAGGACTGAACACTGAAGCTTTCTTT	CSVERGLNTEAFF	TRBV29-1	TRBJ1-1
TGTGCCAGCAGTGATTGTGAGACTGACCCTCAGCCCCAGCATTTT	CASSDCETDPQPQHF	TRBV2	TRBJ1-5
TGTGCCAGCAGCCTGGACAGGGGGGATGAAAAACTGTTTTTT	CASSLDRGDEKLFF	TRBV5-5	TRBJ1-4
TGTGCCACCAGTGAGGGACAGGGTTTGGACACCGGGGAGCTGTTTTTT	CATSEGQGLDTGELFF	TRBV24-1	TRBJ2-2
TGCGCCAGCCTAAGAGGGGGGGGGTACAATGAGCAGTTCTTC	CASLRGGGYNEQFF	TRBV5-1	TRBJ2-1
TGCGCCAGCAGCAAAACGGAGGGTGGGAGGGTGTTCCCCAGCTCTGGGGCCAACGTCCTGACTTTC	CASSKTEGGRVFPSSGANVLTF	TRBV5-1	TRBJ2-6
TGTGCCAGCAGCTTTGCTAGCTCCTACGAGCAGTACTTC	CASSFASSYEQYF	TRBV7-2	TRBJ2-7
TGTGCCAGCAGCGGACCGGGGACTATCTACACCTTC	CASSGPGTIYTF	TRBV5-4	TRBJ1-2
TGCAGTGCCCAGGGGGAGGGTGCAACTAATGAAAAACTGTTTTTT	CSAQGEGATNEKLFF	TRBV20-1	TRBJ1-4
TGTGCCAGCAGTGAAACTAGCGGGCCCACAGATACGCAGTATTTT	CASSETSGPTDTQYF	TRBV2	TRBJ2-3
TGTGCCAGCAGTTTGGGGTGGGCTGGCAATCAGCCCCAGCATTTT	CASSLGWAGNQPQHF	TRBV12-4	TRBJ1-5
TGCGCCAGCAGCTTTCAGGCACGTAGCGGCCGCTATGGCTACACCTTC	CASSFQARSGRYGYTF	TRBV5-1	TRBJ1-2
TGCAGTGCTCCTAGCGGGCCGGTAGATACGCAGTATTTT	CSAPSGPVDTQYF	TRBV20-1	TRBJ2-3
TGTGCCACCGGACAACTTTCGGCAACTAATGAAAAACTGTTTTTT	CATGQLSATNEKLFF	TRBV24-1	TRBJ1-4
TGTGCCAGCGTGACCAGGGCCCCTAATGAGCAGTTCTTC	CASVTRAPNEQFF	TRBV6-1	TRBJ2-1
TGTGCCACCAGTGATTCGACTTACGAGCAGTACTTC	CATSDSTYEQYF	TRBV24-1	TRBJ2-7
TGCGCCAGCAGCACTTGGGGGGTCCAAGAGACCCAGTACTTC	CASSTWGVQETQYF	TRBV4-1	TRBJ2-5
TGTGCCAGCAGCTTAGCGGTTATGTACGAGCAGTACTTC	CASSLAVMYEQYF	TRBV7-9	TRBJ2-7
TGTGCCAGCAGTCCGGGGACAGGGGACTACAATGAGCAGTTCTTC	CASSPGTGDYNEQFF	TRBV6-4	TRBJ2-1
TGTGCCACCAGCAGATGGAAGGGGGGGAACACCGGGGAGCTGTTTTTT	CATSRWKGGNTGELFF	TRBV15	TRBJ2-2
TGTGCCAGCAGTTTACTGACGACTAGCGGGAGATTCCAAGAGACCCAGTACTTC	CASSLLTTSGRFQETQYF	TRBV28	TRBJ2-5
TGTGCCAGCAGGGTTGGGACAGGGGCCAGGGCCAAAAACATTCAGTACTTC	CASRVGTGARAKNIQYF	TRBV7-2	TRBJ2-4
TGCAGTGCTACTGAGGGACAGGCTTTGAGGGAGGCTAACTATGGCTACACCTTC	CSATEGQALREANYGYTF	TRBV20-1	TRBJ1-2
TGTGCCATCAGCTACGAAATGACAGGGATCACTGAAGCTTTCTTT	CAISYEMTGITEAFF	TRBV10-3	TRBJ1-1
TGCGCCAGCAGCTTGCTAAGACAGGGTCAGCCCCAGCATTTT	CASSLLRQGQPQHF	TRBV5-1	TRBJ1-5
TGTGCCAGCAGCACGGAGACAGCGACGAGAAACTATGGCTACACCTTC	CASSTETATRNYGYTF	TRBV7-9	TRBJ1-2
TGTGCTAGTGGTTTCTCCTCAGGGTTTAGGATCGATAGCAATCAGCCCCAGCATTTT	CASGFSSGFRIDSNQPQHF	TRBV12-5	TRBJ1-5
TGTGCCAGCAGTCTCGAAACTAAAGGCGGGGAGCTGTTTTTT	CASSLETKGGELFF	TRBV25-1	TRBJ2-2
TGTGCCAGCAGTATTTCCCGGACAGGGCTCCGCAATCAGCCCCAGCATTTT	CASSISRTGLRNQPQHF	TRBV27	TRBJ1-5
TGTGCCAGCTCACCATTCATAGGGAGTTCGACGGGAGAATCGCACACCGGGGAGCTGTTTTTT	CASSPFIGSSTGESHTGELFF	TRBV18	TRBJ2-2
TGTGCCAGCAGCGTCTATTATAGCGGGAAATACGAGCAGTACTTC	CASSVYYSGKYEQYF	TRBV9	TRBJ2-7
TGCGCCAGCAGCCTAGGGACTAGCGGAGAGGACACAGATACGCAGTATTTT	CASSLGTSGEDTDTQYF	TRBV5-1	TRBJ2-3
TGCGCCAGCAGCTATTTCAGGGGGGGGGGCAATCAGCCCCAGCATTTT	CASSYFRGGGNQPQHF	TRBV5-1	TRBJ1-5
TGTGCCAGCAGCCCCCGTTCAGGAGGCACCGGGGAGCTGTTTTTT	CASSPRSGGTGELFF	TRBV3-1	TRBJ2-2
TGTGCCAGCAGCCAAGATGTTTTTGGGAACCCATTCGAAAAACTGTTTTTT	CASSQDVFGNPFEKLFF	TRBV14	TRBJ1-4
TGCGCCAGCAGTGGGCCGGGAGGAGTTAGTTCTTTCTTT	CASSGPGGVSSFF	TRBV10-1	TRBJ1-1
TGTGCCTGGTGCGACAGGGATGGGGGGTACTTC	CAWCDRDGGYF	TRBV30	TRBJ2-7
TGTGCCAGCAGCCCTGGTGGGCTAGCGGCAACCCCAAGCGGCTACGAGCAGTACTTC	CASSPGGLAATPSGYEQYF	TRBV28	TRBJ2-7
TGTGCCAGCAGCTTAGTAACAGGGGAGCAAGAGACCCAGTACTTC	CASSLVTGEQETQYF	TRBV7-3	TRBJ2-5
TGCAGCGTCCAAAATTTTGAGGGCGCCTACGAGCAGTACTTC	CSVQNFEGAYEQYF	TRBV29-1	TRBJ2-7
TGTGCCAGCAGCCAAGGGGGGGGCGCTAATGAGCAGTTCTTC	CASSQGGGANEQFF	TRBV14	TRBJ2-1
TGTGCCAGCAGTTACCCTAGCGGCCTTCCCGAGCAGTACTTC	CASSYPSGLPEQYF	TRBV6-2	TRBJ2-7
TGTGCCAGCAGTGAACAGCCAGGCCAGGGGCGTGTAGCTTTCTTT	CASSEQPGQGRVAFF	TRBV6-1	TRBJ1-1
TGTGCCAGCAGCCAAGGGACTAGCGGGGATGAGCAGTTCTTC	CASSQGTSGDEQFF	TRBV14	TRBJ2-1
TGCAGCGGGAGTAGTCCGTACGAGCAGTACTTC	CSGSSPYEQYF	TRBV29-1	TRBJ2-7
TGTGCCAGCAGCGGGGGCGAAGGCTTGCGGGAGACCCAGTACTTC	CASSGGEGLRETQYF	TRBV27	TRBJ2-5
TGTGCCAGCAGTGAGGCGCCATTGCCGGGGGGCGATTCACCCCTCCACTTT	CASSEAPLPGGDSPLHF	TRBV6-5	TRBJ1-6
TGTGCCATCCAGTGGCCCGGGACAGGGGGGGCCACTGAAGCTTTCTTT	CAIQWPGTGGATEAFF	TRBV27	TRBJ1-1
TGTGCCACCAGTTCGATGATACTTGGACGGGTATGGTACCATAGCACAGATACGCAGTATTTT	CATSSMILGRVWYHSTDTQYF	TRBV24-1	TRBJ2-3
TGTGCCAGCAGCCAATCCCGCACAGGCACCATATATTTT	CASSQSRTGTIYF	TRBV3-1	TRBJ1-3
TGTGCCAGCAGCTTAGTGGCACCACCCAAAAACATTCAGTACTTC	CASSLVAPPKNIQYF	TRBV7-2	TRBJ2-4
TGCGCCAGCAGCTTACACCCGGACAGTTTCTATGGCTACACCTTC	CASSLHPDSFYGYTF	TRBV5-1	TRBJ1-2
TGTGCCAGCAGCATGGACAGGGAAAGCACTGAAGCTTTCTTT	CASSMDRESTEAFF	TRBV7-3	TRBJ1-1
TGCGCCAGCAGTGATAGCGGGGAGCAGTACAATGAGCAGTTCTTC	CASSDSGEQYNEQFF	TRBV10-1	TRBJ2-1
TGTGCCACCAGTGTTGAGGGACTGCACTGGATATCCGAAAAACTGTTTTTT	CATSVEGLHWISEKLFF	TRBV24-1	TRBJ1-4
TGTGCCAGCAGCCCCCCGCGGCATAAGGATGAGCAGTTCTTC	CASSPPRHKDEQFF	TRBV13	TRBJ2-1
TGCAGCGTTCCTCGCCGGGGGGGACTAGCGGGGCGCACAGATACGCAGTATTTT	CSVPRRGGLAGRTDTQYF	TRBV29-1	TRBJ2-3
TGTGCCAGCAGGCGAACTTCCAACGGGACAGCAACGATAAGCTCCTACGAGCAGTACTTC	CASRRTSNGTATISSYEQYF	TRBV6-2	TRBJ2-7
TGTGCCACCAAAAAAGGGGGCGTTGGGATTAACTATGGCTACACCTTC	CATKKGGVGINYGYTF	TRBV24-1	TRBJ1-2
TGTGCCAGCAGCTTTGACGCCCCAGACTTAGTCCCCTACGAGCAGTACTTC	CASSFDAPDLVPYEQYF	TRBV7-6	TRBJ2-7
TGCAGCGTTGAAGCCGGGTTAAAAATGGACAGGTCCTACGAGCAGTACTTC	CSVEAGLKMDRSYEQYF	TRBV29-1	TRBJ2-7
TGTGCCAGCAGCTCTCGGGACCCTCCGGGGAGAGAGACCCAGTACTTC	CASSSRDPPGRETQYF	TRBV7-9	TRBJ2-5
TGTGCCAGCACGCTCGTTCCACAGATCAATGAGCAGTTCTTC	CASTLVPQINEQFF	TRBV28	TRBJ2-1
TGCAGTGCTAGATGCGGGAGAACGTCCTACGAGCAGTACTTC	CSARCGRTSYEQYF	TRBV20-1	TRBJ2-7
TGTGCCTGGAGTGTACCGGACTTTCTTAGCGGGCCCTGGGCAGATACGCAGTATTTT	CAWSVPDFLSGPWADTQYF	TRBV30	TRBJ2-3
TGTGCCAGCAGCTTAGCCACGACAGGACAACCTCCAGAGACCCAGTACTTC	CASSLATTGQPPETQYF	TRBV7-8	TRBJ2-5
TGCAGCGTTGCCAACAAGGGGGGCCGCTATGGCTACACCTTC	CSVANKGGRYGYTF	TRBV29-1	TRBJ1-2
TGTGCCAGCAGTGACTATGGCTCTAATGAAAAACTGTTTTTT	CASSDYGSNEKLFF	TRBV6-4	TRBJ1-4
TGTGCCACCAGTGATCCTGGGGCCGACAACGAGCAGTACTTC	CATSDPGADNEQYF	TRBV24-1	TRBJ2-7
TGTGCCACCAGTGATTTTAACCTTTCCGTTTGGGCCTACGAGCAGTACTTC	CATSDFNLSVWAYEQYF	TRBV24-1	TRBJ2-7
TGTGCCAGCAGCACAGGGGTGAACACTGAAGCTTTCTTT	CASSTGVNTEAFF	TRBV6-5	TRBJ1-1
TGCAGTGCTAGCCCGGGTGGCGAGCAGTACTTC	CSASPGGEQYF	TRBV20-1	TRBJ2-7
TGTGCCAGCAGCCTTTGTCCACGCGCCTCGGGGGCGAACTCCTATAATTCACCCCTCCACTTT	CASSLCPRASGANSYNSPLHF	TRBV7-9	TRBJ1-6
TGTGCCAGCAGCGACGGGGCCCAAAGTACCTACGAGCAGTACTTC	CASSDGAQSTYEQYF	TRBV13	TRBJ2-7
TGTGCCGCCAGGGGCAAACCTGAAGCTTTCTTT	CAARGKPEAFF	TRBV6-5	TRBJ1-1
TGTGCCAGCAGCGTGGACAGGACCTCCTACGAGCAGTACTTC	CASSVDRTSYEQYF	TRBV13	TRBJ2-7
TGTGCCAGCCGGGACAGGGGGAGCAATCAGCCCCAGCATTTT	CASRDRGSNQPQHF	TRBV6-4	TRBJ1-5
TGTGCCAGCAGCACCGGACCAGGAGGGAGAACTAATGAAAAACTGTTTTTT	CASSTGPGGRTNEKLFF	TRBV7-9	TRBJ1-4
TGTGCCAGCAGCCTGGGGGGGCCCCCCAGGGGCTTGTACGAGCAGTACTTC	CASSLGGPPRGLYEQYF	TRBV7-9	TRBJ2-7
TGTGCCAGCAGCGGGGGGCCCTTGAGCTCTAACTATGGCTACACCTTC	CASSGGPLSSNYGYTF	TRBV7-6	TRBJ1-2
TGTGCCAGCAGCCCGGGACGCTACGAGCAGTACTTC	CASSPGRYEQYF	TRBV13	TRBJ2-7
TGTGCCAGCAGAGGCAAACGGGGATACAATGAGCAGTTCTTC	CASRGKRGYNEQFF	TRBV6-4	TRBJ2-1
TGCAGTGCGACCCGTAAAAGAGTTACGGCCTACGAGCAGTACTTC	CSATRKRVTAYEQYF	TRBV20-1	TRBJ2-7
TGTGCCAGTAGTATGGCTGTGGGGCCGGGCTATGGCTACACCTTC	CASSMAVGPGYGYTF	TRBV19	TRBJ1-2
TGCGCCAGCAGCCAAGGAAGACAGTGGCGATCCCATGAGCAGTTCTTC	CASSQGRQWRSHEQFF	TRBV4-3	TRBJ2-1
TGTGCCAGCGGGGGCAGCGAGCAGTACTTC	CASGGSEQYF	TRBV6-2	TRBJ2-7
TGTGCCACCAACCCCTGCGCGGAAGGAAAACTGTTTTTT	CATNPCAEGKLFF	TRBV24-1	TRBJ1-4
TGTGCCAGCGTCAGGAATCAGCCCCAGCATTTT	CASVRNQPQHF	TRBV9	TRBJ1-5
TGTGCCAGACATGGACTGGACGAGCAGTACTTC	CARHGLDEQYF	TRBV6-6	TRBJ2-7
TGCAGTGCTAGCGGGAGCGGATTGGGTTGGCATTGCTACGAGCAGTACTTC	CSASGSGLGWHCYEQYF	TRBV20-1	TRBJ2-7
TGTGCCAGCAGCGATCTATTCGACACCGGGGAGCTGTTTTTT	CASSDLFDTGELFF	TRBV5-4	TRBJ2-2
TGTGCCAGCAGCCCCCAGGGAGGGCTTACTCATGAGCAGTTCTTC	CASSPQGGLTHEQFF	TRBV4-2	TRBJ2-1
TGTGCCAGCAGTTTAAGGCGGTCAGTACCCAGGATTGCAACTAATGAAAAACTGTTTTTT	CASSLRRSVPRIATNEKLFF	TRBV12-3	TRBJ1-4
TGCGCCAGCAGCGGACCCGGGAATAGCTCTGGAAACACCATATATTTT	CASSGPGNSSGNTIYF	TRBV5-1	TRBJ1-3
TGTGCCACCAACCCGGGACGAGTGTGTACCCTAGGCTATAGCAATCAGCCCCAGCATTTT	CATNPGRVCTLGYSNQPQHF	TRBV24-1	TRBJ1-5
TGTGCCAGCTCACCAAACAAGGTTAACTATGGCTACACCTTC	CASSPNKVNYGYTF	TRBV18	TRBJ1-2
TGCAGTGCTAGTTCAGCTAGCGGGACCTACAATGAGCAGTTCTTC	CSASSASGTYNEQFF	TRBV20-1	TRBJ2-1
TGTGCCAGCAGCGAAGATACCCAGGGGGCCTACGAGCAGTACTTC	CASSEDTQGAYEQYF	TRBV9	TRBJ2-7
TGCAGTGCTAGGAATGGGACAGGCGGATTCGAGCAGTACTTC	CSARNGTGGFEQYF	TRBV20-1	TRBJ2-7
TGTGCCATCAGTGACCCACTCTTGCTAGCGGGGGGCACAGATACGCAGTATTTT	CAISDPLLLAGGTDTQYF	TRBV10-3	TRBJ2-3
TGTGCCACCAGTGATCAAGGCAGCCAGCCCCAGCATTTT	CATSDQGSQPQHF	TRBV24-1	TRBJ1-5
TGTGCCAGCAGCCAAGGAGTACAGCCCCAGCATTTT	CASSQGVQPQHF	TRBV7-8	TRBJ1-5
TGTGCCAGCAGTGCAGTGGGGGTTGGCACTGAAGCTTTCTTT	CASSAVGVGTEAFF	TRBV6-4	TRBJ1-1
TGTGCCAGCAGGGGACAGGGCCCGTGCAGGCTCGAGCAGTACTTC	CASRGQGPCRLEQYF	TRBV6-4	TRBJ2-7
TGTGCCAGCAGTGAAGAAGCACTAGCGGGAGCAGGGGAGCTGTTTTTT	CASSEEALAGAGELFF	TRBV2	TRBJ2-2
TGTGCCAGCAGCGTAGGGGCGGGACGAAGGGCGCCGAACTCCTACGAGCAGTACTTC	CASSVGAGRRAPNSYEQYF	TRBV13	TRBJ2-7
TGCAGTGCTTCCCTGAGTCAGGATACGCAGTATTTT	CSASLSQDTQYF	TRBV20-1	TRBJ2-3
TGTGCCAGCTCACCACCTGGGACCCCCCTCCACTTT	CASSPPGTPLHF	TRBV18	TRBJ1-6
TGTGCCAGCAGTCCTTTGACAGCAAAACAAGAACTGTTTTTT	CASSPLTAKQELFF	TRBV25-1	TRBJ1-4
TGCGCCAGCAGGCTGGATGTCGGGGTAGAAGCTTTCTTT	CASRLDVGVEAFF	TRBV5-1	TRBJ1-1
TGTGCCAGCAGTTTTCTAGCGGACACCGGGGAGCTGTTTTTT	CASSFLADTGELFF	TRBV27	TRBJ2-2
TGTGCCAGCAGCTTTGTTCGCAGCGCCTCTTGCTACGAGCAGTACTTC	CASSFVRSASCYEQYF	TRBV7-3	TRBJ2-7
TGTGCCAGCAGTGTACGGGGAGCCTACGAGCAGTACTTC	CASSVRGAYEQYF	TRBV7-9	TRBJ2-7
TGTGAGTGGGGCCAAGCTTTCTTT	CEWGQAFF	TRBV28	TRBJ1-1
TGTGCCACCAGGCTCCCGGGACTAGGGGGTGAGCAGTTCTTC	CATRLPGLGGEQFF	TRBV24-1	TRBJ2-1
TGTGCCAGCAGCTCTATCCGACTAGATCCCACAGGGCAGTTCTTC	CASSSIRLDPTGQFF	TRBV11-3	TRBJ2-1
TGTCCCCCGGGAGGGGATACGCAGTATTTT	CPPGGDTQYF	TRBV27	TRBJ2-3
TGTGCCAGCAGCACGGGGTTCGTGAGTCGGGTTTATGGCTACACCTTC	CASSTGFVSRVYGYTF	TRBV13	TRBJ1-2
TGCGCCACTACACAGGGACAGGGATTTAACTCGGTCCGCGAGCAGTACTTC	CATTQGQGFNSVREQYF	TRBV10-1	TRBJ2-7
TGTGCCAGCAGCTTAGATTCTAGCGGGCCCGCAGATACGCAGTATTTT	CASSLDSSGPADTQYF	TRBV7-4	TRBJ2-3
TGTGCCAGCAGCGGTGCGGGACTGTCCTACGAGCAGTACTTC	CASSGAGLSYEQYF	TRBV13	TRBJ2-7
TGTGCCAGCAGTGATCCCTGTGAATATGGCTACACCTTC	CASSDPCEYGYTF	TRBV2	TRBJ1-2
TGTGCCAGCAGTCCGGAAGGGAGGGCCACCCCAAAAGCTTTCTTT	CASSPEGRATPKAFF	TRBV12-3	TRBJ1-1
TGCGCCAGCAGCTTGCAGGGGGAAGAGACCCAGTACTTC	CASSLQGEETQYF	TRBV5-1	TRBJ2-5
TGTGCCAGCAGCTTACGATCCCGAGGTGGGCAGCCCCAGCATTTT	CASSLRSRGGQPQHF	TRBV11-2	TRBJ1-5
TGTGCCAGCAGCTACCTCGGGACAGGGATGTGCGTGCCCCAGCATTTT	CASSYLGTGMCVPQHF	TRBV5-4	TRBJ1-5
TGTGCCAGCAGCGAGTGGCGACAGGGCTACGAGCAGTACTTC	CASSEWRQGYEQYF	TRBV7-3	TRBJ2-7
TGTGCCAGTAAGGAGACAGGGATGTTCAATCAGCCCCAGCATTTT	CASKETGMFNQPQHF	TRBV19	TRBJ1-5
TGTGCCATCAAGAGGGACAGGGGGCTAGGGAACAAAAACATTCAGTACTTC	CAIKRDRGLGNKNIQYF	TRBV10-3	TRBJ2-4
TGTGCCAGCAGCTACCATAACTGGGGGTATGGCTACACCTTC	CASSYHNWGYGYTF	TRBV7-9	TRBJ1-2
TGTGCCAGCAGTTACTTACGAAGGGGCAATCAGCCCCAGCATTTT	CASSYLRRGNQPQHF	TRBV6-6	TRBJ1-5
TGTGCCAGCAGCTTAGACCCTCCAGGCGTTCCAGTTCCGCAGTTCTTC	CASSLDPPGVPVPQFF	TRBV11-2	TRBJ2-1
TGTGCCAGCAGCAGACAGGGCTCCTATAATTCACCCCTCCACTTT	CASSRQGSYNSPLHF	TRBV13	TRBJ1-6
TGTGCCAGCCGGGAGGCTAATTACGAGCAGTACTTC	CASREANYEQYF	TRBV2	TRBJ2-7
TGCGCCAGCAGCCAAGATAAAGGACAGGGGTCACAGCCCCAGCATTTT	CASSQDKGQGSQPQHF	TRBV4-1	TRBJ1-5
TGTGCCAGCAGCAGCAGGGTAACAGATACGCAGTATTTT	CASSSRVTDTQYF	TRBV11-3	TRBJ2-3
TGTGCCTGGAAAAGTCCCCTGGGGTATAAAGAGACCCAGTACTTC	CAWKSPLGYKETQYF	TRBV30	TRBJ2-5
TGTGCCAGCAGTGAACCAAACCGTCATTTGATAACGATTCCTGACAATCAGCCCCAGCATTTT	CASSEPNRHLITIPDNQPQHF	TRBV6-1	TRBJ1-5
TGTGCCAGCAGTTACTCAACCGGGGAAGCAGGTCCCGGGGAGCTGTTTTTT	CASSYSTGEAGPGELFF	TRBV6-5	TRBJ2-2
TGTGCCAGCGGTCCGGGACGGAGTTACGAGCAGTACTTC	CASGPGRSYEQYF	TRBV7-9	TRBJ2-7
TGCGCCAGCGACGAAGCAGGACTAGCGGGGTGGGAGACCCAGTACTTC	CASDEAGLAGWETQYF	TRBV10-1	TRBJ2-5
TGCAGTGCTAGAGTCCAGGTGGATGGCTACACCTTC	CSARVQVDGYTF	TRBV20-1	TRBJ1-2
TGTGCCAGCAGCGGCCGGGGGACGGGCAATCAGCCCCAGCATTTT	CASSGRGTGNQPQHF	TRBV7-9	TRBJ1-5
TGCAGTGCTAGGGGGACAGGGGGGACCGGGGGAACTGAAGCTTTCTTT	CSARGTGGTGGTEAFF	TRBV20-1	TRBJ1-1
TGCGCCAGCAGCCAAGATCGGGGGGGTGGGACCCAGTACTTC	CASSQDRGGGTQYF	TRBV4-1	TRBJ2-5
TGTGCCAGCAGTTATCGCGGACTAGTAGATACGCAGTATTTT	CASSYRGLVDTQYF	TRBV6-3	TRBJ2-3
TGTGCCACCATCAGGACAGCTTACTATGGCTACACCTTC	CATIRTAYYGYTF	TRBV24-1	TRBJ1-2
TGTGCCAGCAAAAGACGGCTATCGAGATCTGGGGCCAACGTCCTGACTTTC	CASKRRLSRSGANVLTF	TRBV6-6	TRBJ2-6
TGTGCCAGCAGTTACAACATAAGCCGACTAGCGGGGGTGTACGAGCAGTACTTC	CASSYNISRLAGVYEQYF	TRBV6-5	TRBJ2-7
TGTGCCTGGTCGGGCTGGCCCCATTTGCCCCAGCATTTT	CAWSGWPHLPQHF	TRBV28	TRBJ1-5
TGTGCCAGCAGTCTTCGGACTACTGAATACAATGAGCAGTTCTTC	CASSLRTTEYNEQFF	TRBV12-4	TRBJ2-1
TGTGCCAGCAGTACGTCTAGTTTGAGCGCCCGCGGGGAGCTGTTTTTT	CASSTSSLSARGELFF	TRBV6-8	TRBJ2-2
TGTGCCCAAGATCAGATTCAGCGGGATAATGAAAAACTGTTTTTT	CAQDQIQRDNEKLFF	TRBV6-6	TRBJ1-4
TGTGCCACCAGCAGGTGGGGGGGACAGGGCATGAACACTGAAGCTTTCTTT	CATSRWGGQGMNTEAFF	TRBV15	TRBJ1-1
TGTGCCAGCAGGGCCGGGATAGGACTAGTGCAGTTCTTC	CASRAGIGLVQFF	TRBV2	TRBJ2-1
TGTGCCAGCATCCCTTGGACAGGGTATGGCTACACCTTC	CASIPWTGYGYTF	TRBV7-3	TRBJ1-2
TGCGCCAGCAGTGGACGGAGGGGGGGAGCTTTCTTT	CASSGRRGGAFF	TRBV10-1	TRBJ1-1
TGCGCCAGCAGCCCTTGGACCCCGTGCACTAGTTACTATGGCTACACCTTC	CASSPWTPCTSYYGYTF	TRBV4-1	TRBJ1-2
TGCAGTGCGATTAAGAGGCGATCACGGACTGAAGCTTTCTTT	CSAIKRRSRTEAFF	TRBV20-1	TRBJ1-1
TGCGCCAGCAGCTCGAGGACCGAAGGCCTTCAGAACACTGAAGCTTTCTTT	CASSSRTEGLQNTEAFF	TRBV5-1	TRBJ1-1
TGCGCCAGCAGCTTGCTGGGACTAGCGGGCCAAGGAAGCACAGATACGCAGTATTTT	CASSLLGLAGQGSTDTQYF	TRBV5-1	TRBJ2-3
TGTGCCAGTTTACAAACCAGGGGGCACGGTAATCAGCCCCAGCATTTT	CASLQTRGHGNQPQHF	TRBV19	TRBJ1-5
TGTGCCTGGGCCCCGGACAGCGCTAATGAAAAACTGTTTTTT	CAWAPDSANEKLFF	TRBV30	TRBJ1-4
TGTGCCAGCAGCTTAGTTCTTAACAGGGTACCCGGCTACACCTTC	CASSLVLNRVPGYTF	TRBV13	TRBJ1-2
TGTGCCAGCAGTTACGCCCCGACAGGGAAATATCAGCCCCAGCATTTT	CASSYAPTGKYQPQHF	TRBV6-2	TRBJ1-5
TGTGCCACCCCGACAGGGGGACCTACAGCTTTCTTT	CATPTGGPTAFF	TRBV24-1	TRBJ1-1
TGTGCCAGCGATCCGGGACAGCTCGCACACCACCAAGAGACCCAGTACTTC	CASDPGQLAHHQETQYF	TRBV6-4	TRBJ2-5
TGCAGTGCTCCGGGGGTGACCTTC	CSAPGVTF	TRBV20-1	TRBJ1-2
TGTGCCAGCAGTCCCGGACGCCGTTGCGAGCAGTACTTC	CASSPGRRCEQYF	TRBV12-3	TRBJ2-7
TGTGCCAGCAGCTCAACACAGGTAGGTGGATACGCCGACGAGCAGTACTTC	CASSSTQVGGYADEQYF	TRBV9	TRBJ2-7
TGTGCCAGCAGTACAGTTAGCTATGGCTACACCTTC	CASSTVSYGYTF	TRBV6-6	TRBJ1-2
TGTGCCAGCAGTCCTCGGGGGTACTATGGCTACACCTTC	CASSPRGYYGYTF	TRBV6-5	TRBJ1-2
TGTGCCAGCAGTGACGTGGCGGGATCGGAGGGGGAAGGCTACGAGCAGTACTTC	CASSDVAGSEGEGYEQYF	TRBV6-4	TRBJ2-7
TGCAGTGCAAGGGGCACTATGAACACTGAAGCTTTCTTT	CSARGTMNTEAFF	TRBV20-1	TRBJ1-1
TGTGCCAGCACAAATAGCGGGATGTACATTCAGTACTTC	CASTNSGMYIQYF	TRBV6-2	TRBJ2-4
TGTGCCAGCAGCTTACACTGGCGAGGGGGTGAGACCCAGTACTTC	CASSLHWRGGETQYF	TRBV7-3	TRBJ2-5
TGTGCCTGGCCTAGGCACTATGGCTACACCTTC	CAWPRHYGYTF	TRBV30	TRBJ1-2
TGTGCCAGTAGTCACCTGGACAGGGCATTACACGAGCAGTACTTC	CASSHLDRALHEQYF	TRBV19	TRBJ2-7
TGTGCCAGCAGTTTAAGCGGACAGGCTTGCAATCAGCCCCAGCATTTT	CASSLSGQACNQPQHF	TRBV27	TRBJ1-5
TGTGCCAGCACAAGGCAAACGACTAGATATCCCGGGGAGCTGTTTTTT	CASTRQTTRYPGELFF	TRBV7-9	TRBJ2-2
TGTGCCAGCAGCTTAGAACGCTGTTACAGGGGCTATGGCTACACCTTC	CASSLERCYRGYGYTF	TRBV7-2	TRBJ1-2
TGCAGTGCTCCACAGGGACTCTATGGCTACACCTTC	CSAPQGLYGYTF	TRBV20-1	TRBJ1-2
TGTGCCAGCAGCTCTACACTAGCGGGAGGATATGGCTACACCTTC	CASSSTLAGGYGYTF	TRBV13	TRBJ1-2
TGTGCCAGCAGTTTCCGTGTTAAGACTAGCGGACACACCGGGGAGCTGTTTTTT	CASSFRVKTSGHTGELFF	TRBV28	TRBJ2-2
TGCGCCAGCAGTAGACCAGAAAACGAGCAGTACTTC	CASSRPENEQYF	TRBV10-1	TRBJ2-7
TGTGCCAGCAGTGGACAGGGGTATAGCAATCAGCCCCAGCATTTT	CASSGQGYSNQPQHF	TRBV28	TRBJ1-5
TGTGCCAGCAGTAAGGGGGCCGAGCAGTTCTTC	CASSKGAEQFF	TRBV6-5	TRBJ2-1
TGTGCCAAGGGAAGGAGGGGAGTAGGCGAGCAGTACTTC	CAKGRRGVGEQYF	TRBV24-1	TRBJ2-7
TGTGCCAGCAGTCGCGACTCTGGCTACGAGCAGTACTTC	CASSRDSGYEQYF	TRBV6-3	TRBJ2-7
TGTGCCAGCAGACGGACACGTCAATCCGAGCAGTACTTC	CASRRTRQSEQYF	TRBV6-5	TRBJ2-7
TGTGCCAGCATATGGGCCCATTCCTACAATGAGCAGTTCTTC	CASIWAHSYNEQFF	TRBV27	TRBJ2-1
TGTGCCAGCAGCGTCGATCACAGCTGGCCTTACGAGCAGTACTTC	CASSVDHSWPYEQYF	TRBV12-3	TRBJ2-7
TGTGCCAGCAGTTTCCCCCACAAACCAATTCAGTACTTC	CASSFPHKPIQYF	TRBV28	TRBJ2-4
TGCGCCAGCAGCTGGCACGTCACCCCCTATGGCTACACCTTC	CASSWHVTPYGYTF	TRBV5-1	TRBJ1-2
TGCGCCAGCAGTCCCCAACCGCAGGGTCAAATACTCCCGTCCAATCAGCCCCAGCATTTT	CASSPQPQGQILPSNQPQHF	TRBV10-1	TRBJ1-5
TGTGCCAGCAGCTATACTTCAAACGAGCAGTACTTC	CASSYTSNEQYF	TRBV7-8	TRBJ2-7
TGTGCCAGCAGTGAAGCCCTGGAGGGACGGTTGAACACTGAAGCTTTCTTT	CASSEALEGRLNTEAFF	TRBV6-4	TRBJ1-1
TGTGCCAGCAGTGAAAAACGGGAGGGCCCTGGGACGGTCGAGCAGTACTTC	CASSEKREGPGTVEQYF	TRBV6-4	TRBJ2-7
TGTGCCAGCAGCGAGCGGGAGAGAAACATTCAGTACTTC	CASSERERNIQYF	TRBV11-2	TRBJ2-4
TGTGCAAGGACCGGGACAGGGGATGCTGGAAACACCATATATTTT	CARTGTGDAGNTIYF	TRBV7-6	TRBJ1-3
TGTGCCAGCAGCGAATGGGTGCGGGAATTGAACGGGGAGCTGTTTTTT	CASSEWVRELNGELFF	TRBV7-3	TRBJ2-2
TGCAGTGCTAGAGAGACATTCAGAAGGTACTATGGCTACACCTTC	CSARETFRRYYGYTF	TRBV20-1	TRBJ1-2
TGTGCCAGTAAACCCTTACAGGGAACTGAAGCTTTCTTT	CASKPLQGTEAFF	TRBV19	TRBJ1-1
TGTGCCAGCAGTAGAGAGAACACCGGGGAGCTGTTTTTT	CASSRENTGELFF	TRBV12-4	TRBJ2-2
TGTGCCAGTAGACAGGGATGGATTTTTAATGAAAAACTGTTTTTT	CASRQGWIFNEKLFF	TRBV19	TRBJ1-4
TGTGCCAGCAGCCAAGGGTGTTACTTTAAAAACAATGAGCAGTTCTTC	CASSQGCYFKNNEQFF	TRBV5-6	TRBJ2-1
TGTGCCAGCAGCTTGCGACAGTTAGGAAATGAGCAGTTCTTC	CASSLRQLGNEQFF	TRBV7-3	TRBJ2-1
TGCGCCAGCAGCTTGCCCCAGGACACCGGGGAGCTGTTTTTT	CASSLPQDTGELFF	TRBV5-1	TRBJ2-2
TGTGCCAGCAGCGATGAAGACAGGGGGCGCAGCAATCAGCCCCAGCATTTT	CASSDEDRGRSNQPQHF	TRBV13	TRBJ1-5
TGCAGTGCTACGTGTGGAATCACCCAGTACTTC	CSATCGITQYF	TRBV20-1	TRBJ2-5
TGTGCCACCACAGGGAATGGACTTGAAAAACTGTTTTTT	CATTGNGLEKLFF	TRBV24-1	TRBJ1-4
TGTGCCAGCAGTGAGGGACCGGACTATCGCGCCTACGAGCAGTACTTC	CASSEGPDYRAYEQYF	TRBV6-1	TRBJ2-7
TGCGCCAGCAGTGTGTGGGGGCCCATGACAGATACGCAGTATTTT	CASSVWGPMTDTQYF	TRBV10-1	TRBJ2-3
TGTGCCAGCAGCCAACACAGGTCCTATAGCAATCAGCCCCAGCATTTT	CASSQHRSYSNQPQHF	TRBV7-6	TRBJ1-5
TGCAGTGCAAGCTTGACAGGGGGCCGGATTTCCTACGAGCAGTACTTC	CSASLTGGRISYEQYF	TRBV20-1	TRBJ2-7
TGCGCCAGCAGTGAGGGGATGGCTTTCTTT	CASSEGMAFF	TRBV10-1	TRBJ1-1
TGTGCCAGCAGCTTGACCGGGACAGGGCGTGCCGGAAACACCATATATTTT	CASSLTGTGRAGNTIYF	TRBV5-4	TRBJ1-3
TGCAGTGCTAGAGATCAACCTCTACGGTGCTACGAGCAGTACTTC	CSARDQPLRCYEQYF	TRBV20-1	TRBJ2-7
TGTGCCAGCGAAGGCAGGGCGAGAGAAAAACTGTTTTTT	CASEGRAREKLFF	TRBV2	TRBJ1-4
TGTGCCAGCAGCTTGCCATCGAAGCGAGAAGTCACCGGGGAGCTGTTTTTT	CASSLPSKREVTGELFF	TRBV5-6	TRBJ2-2
TGTGCCAGCAGTTACTCGAAACTACTAGCGGGAGGGGGCCAGCAGTACTTC	CASSYSKLLAGGGQQYF	TRBV6-2	TRBJ2-7
TGCGCCATCTGGAGTCTGGGGAAGATGTTCTCCTACGAGCAGTACTTC	CAIWSLGKMFSYEQYF	TRBV10-1	TRBJ2-7
TGCAGTGCTCCTTTCCTAGCGGGGAGCTCCTACAATGAGCAGTTCTTC	CSAPFLAGSSYNEQFF	TRBV20-1	TRBJ2-1
TGTGCCAGCAGTCTCTGGACAGGGGGGGCTGAATGGAAAAACATTCAGTACTTC	CASSLWTGGAEWKNIQYF	TRBV6-4	TRBJ2-4
TGCAGTGCTAGAGCAAGGGGGGGCCGCGCTCCTGGCACAGATACGCAGTATTTT	CSARARGGRAPGTDTQYF	TRBV20-1	TRBJ2-3
TGTGCCAGTCCGGGACTAGAGGGTTCCGGGGAGCTGTTTTTT	CASPGLEGSGELFF	TRBV6-5	TRBJ2-2
TGTGCCAGCAGCTTGCGCAGAACGCATTTT	CASSLRRTHF	TRBV5-6	TRBJ1-5
TGTGCCAGCAGCTGCCCCACGACAGCAAAACTCACCGGGGAGCTGTTTTTT	CASSCPTTAKLTGELFF	TRBV11-2	TRBJ2-2
TGTGCCACCCAGGGGTTTCCGGATAATTCACCCCTCCACTTT	CATQGFPDNSPLHF	TRBV9	TRBJ1-6
TGCAGTGCGGGAAACCCGGTGAATCAGCCCCAGCATTTT	CSAGNPVNQPQHF	TRBV20-1	TRBJ1-5
TGTGCCAGCAGCATCAATGCCCCTTCAAACACTGAAGCTTTCTTT	CASSINAPSNTEAFF	TRBV5-5	TRBJ1-1
TGTGCTAGTGGTTTCCGAGACGACAGGGGAACCGAAAAACTGTTTTTT	CASGFRDDRGTEKLFF	TRBV12-5	TRBJ1-4
TGTGCCAGCAGCCCAAAGGGTAAAAGCGGGAGTGGCAATCAGCCCCAGCATTTT	CASSPKGKSGSGNQPQHF	TRBV11-2	TRBJ1-5
TGCGCCAGCAGCATCAGCGGGGGGACAGGGTTCGAGCAGTACTTC	CASSISGGTGFEQYF	TRBV5-1	TRBJ2-7
TGTGCCAGCAGCCACTCCTGTATATGCGTGTCCTATAATTCACCCCTCCACTTT	CASSHSCICVSYNSPLHF	TRBV13	TRBJ1-6
TGTGCCAGAAGCGGGATGGAGACCCAGTACTTC	CARSGMETQYF	TRBV11-2	TRBJ2-5
TGTGCCAGCAGTGTCGTGACAGGGGGCCAATCCTACGAGCAGTACTTC	CASSVVTGGQSYEQYF	TRBV6-5	TRBJ2-7
TGTGCCAGCAGCCATAAAAACCCGGGACTGGGGAAAAACATTCAGTACTTC	CASSHKNPGLGKNIQYF	TRBV14	TRBJ2-4
TGTGCCAGCAGCTTGGTGCGAGGGTACTTC	CASSLVRGYF	TRBV5-4	TRBJ2-4
TGTGCCAGCAGTCCTAGCGGGGTAGTGCAGTTCTTC	CASSPSGVVQFF	TRBV5-5	TRBJ2-1
TGTGCCACCAGCAGAGGTCAGGGCAAAAGCGAGACCCAGTACTTC	CATSRGQGKSETQYF	TRBV15	TRBJ2-5
TGTGCCAGCAGGTCTAGCGGGTGCCATTACGAGCAGTACTTC	CASRSSGCHYEQYF	TRBV7-3	TRBJ2-7
TGTGCCAGCATACACGTCAATGAAAAACTGTTTTTT	CASIHVNEKLFF	TRBV6-4	TRBJ1-4
TGTGCCTTGCACCGACCTAGCGGGGATCCGTACGAGCAGTACTTC	CALHRPSGDPYEQYF	TRBV30	TRBJ2-7
TGTGCCAGCAGCCCCAGAGCGGGGCTAAATGAGCAGTTCTTC	CASSPRAGLNEQFF	TRBV6-1	TRBJ2-1
TGTGCCAGCAGCAACATCACAGGGGCTAGTAGCAATCAGCCCCAGCATTTT	CASSNITGASSNQPQHF	TRBV5-8	TRBJ1-5
TGTGCCAGCAGCTTAGCCGGCCGGGACAGTCACTACGAGCAGTACTTC	CASSLAGRDSHYEQYF	TRBV7-6	TRBJ2-7
TGTGCCAGCAGTTTGCCCCCGCGGTGTGTCGGGACAGGGAGGGTGATTACTGAAGCTTTCTTT	CASSLPPRCVGTGRVITEAFF	TRBV6-2	TRBJ1-1
TGTGCCATCAGGTGGGACAGGGACTACGAGCAGTACTTC	CAIRWDRDYEQYF	TRBV10-3	TRBJ2-7
TGTGCCAAGTGGGGACAGGGGGGTAGCAATCAGCCCCAGCATTTT	CAKWGQGGSNQPQHF	TRBV12-4	TRBJ1-5
TGTGCCAGCAGCTCGCAAAGGGGAGTAAACACTGAAGCTTTCTTT	CASSSQRGVNTEAFF	TRBV7-4	TRBJ1-1
TGTGCCAGCAGCTCTGGGGGAGGGTCCACTGAAGCTTTCTTT	CASSSGGGSTEAFF	TRBV13	TRBJ1-1
TGTGCCAGCGGACGAGACAGGGTGGAAACCTACGAGCAGTACTTC	CASGRDRVETYEQYF	TRBV7-4	TRBJ2-7
TGTGCCAGCAGTGCGCCTGGGTACCATGAGCAGTTCTTC	CASSAPGYHEQFF	TRBV6-4	TRBJ2-1
TGCGCCAGCAGAGGTGGGCCGAAGACAGGTAACCAAGCTTTCTTT	CASRGGPKTGNQAFF	TRBV10-1	TRBJ1-1
TGTGCCAGCAGCTTCACTTACCCGAGGGGGACTAGAAGTCTGAACACTGAAGCTTTCTTT	CASSFTYPRGTRSLNTEAFF	TRBV13	TRBJ1-1
TGTGCCACCAGTGATTTCCTGAACCGGGAGGGCCCTCCCCACTATGGCTACACCTTC	CATSDFLNREGPPHYGYTF	TRBV24-1	TRBJ1-2
TGTGCCACCAGTGATCAGGGCCAACCCCTCACAGATACGCAGTATTTT	CATSDQGQPLTDTQYF	TRBV24-1	TRBJ2-3
TGTGCCAAGCAGAAACAGCTAGTGTGTTATGGCTACACCTTC	CAKQKQLVCYGYTF	TRBV6-1	TRBJ1-2
TGTGCCAGCAGAAACGGGGGCAACAATCAGCCCCAGCATTTT	CASRNGGNNQPQHF	TRBV6-1	TRBJ1-5
TGTGCCAGCAGACGGGGGGTCAATGAGCAGTTCTTC	CASRRGVNEQFF	TRBV28	TRBJ2-1
TGTGCCAGCAGCCAAGATCCTACCCGGACCCCCCGGGGGCGCGAGCAGTACTTC	CASSQDPTRTPRGREQYF	TRBV14	TRBJ2-7
TGCAGCGTTACGACAGCGGTCTACGAGCAGTACTTC	CSVTTAVYEQYF	TRBV29-1	TRBJ2-7
TGTGCCAGCAGCTTTCTGGCGGCCTACGAGCAGTACTTC	CASSFLAAYEQYF	TRBV14	TRBJ2-7
TGTGCCGGAGGGGCGGAAAGCTCCTACAATGAGCAGTTCTTC	CAGGAESSYNEQFF	TRBV27	TRBJ2-1
TGTGCCAGCTCACGATACCGTCGAATTACAGGGTCAGGTCAGCCCCAGCATTTT	CASSRYRRITGSGQPQHF	TRBV18	TRBJ1-5
TGTGCCAGCACCTCGTACCTCTTCGAGGACAATGAGCAGTTCTTC	CASTSYLFEDNEQFF	TRBV9	TRBJ2-1
TGTGCCAGCACCAGGAGGGACTATGGCTACACCTTC	CASTRRDYGYTF	TRBV6-2	TRBJ1-2
TGTGCCAGCAGCCCCTACAGGGCGGGCTACGAGCAGTACTTC	CASSPYRAGYEQYF	TRBV3-1	TRBJ2-7
TGTGCCAGCAGCCAAGAGGGGGACTTAGAGACCCAGTACTTC	CASSQEGDLETQYF	TRBV14	TRBJ2-5
TGCAGTGCTCCCCCTGGGGCGAGTCCCACTGAAGCTTTCTTT	CSAPPGASPTEAFF	TRBV20-1	TRBJ1-1
TGTGCCAGCAGCTTAGAATCAATAATTGCGGGGGCCGAACTTTATGGCTACACCTTC	CASSLESIIAGAELYGYTF	TRBV7-9	TRBJ1-2
TGTGCCAGCAGCAAGATCCCTCGCTCAGCCCCGGGTGGCTACACCTTC	CASSKIPRSAPGGYTF	TRBV3-1	TRBJ1-2
TGCGCCAGCAGTGAGTCGCGGGGGGGGCCACCCTACGAGCAGTACTTC	CASSESRGGPPYEQYF	TRBV10-1	TRBJ2-7
TGCGCCAGCAGCGAAAACGAGACAGGGGGGCTCTATGGCTACACCTTC	CASSENETGGLYGYTF	TRBV5-1	TRBJ1-2
TGCAGCGTTGGTACTCCTGGCGGGCCCAATGAGCAGTTCTTC	CSVGTPGGPNEQFF	TRBV29-1	TRBJ2-1
TGTGCCAGCAGCTTATTGGACAACGAGCAGTACTTC	CASSLLDNEQYF	TRBV7-9	TRBJ2-7
TGTGCCAGCAGTTACAGACAGCGGGGATATAACTATGGCTACACCTTC	CASSYRQRGYNYGYTF	TRBV6-6	TRBJ1-2
TGTGCCTTAGCGTACGAGCAGTACTTC	CALAYEQYF	TRBV5-4	TRBJ2-7
TGTGCCAGCAGCCGCGGAGGGGATCTGCCCGCCTATAATTCACCCCTCCACTTT	CASSRGGDLPAYNSPLHF	TRBV6-6	TRBJ1-6
TGTGCCAGCAGTTTACCTATCTTT	CASSLPIF	TRBV28	TRBJ1-1
TGTGCCAGCAGCCCCCCGAATACTGGTGGTGATACGCAGTATTTT	CASSPPNTGGDTQYF	TRBV7-4	TRBJ2-3
TGTGCCAGCAGGCCGCCCCAGGGGCCTGGAGGGGCCAACGTCCTGACTTTC	CASRPPQGPGGANVLTF	TRBV6-4	TRBJ2-6
TGTGCCAGCAGTTACTTTAGGTTCGGGGGGGTAGAATGCTACGAGCAGTACTTC	CASSYFRFGGVECYEQYF	TRBV6-5	TRBJ2-7
TGTGCCAGCAGCCAAGCCATAACGGGGGGTGCCTACGAGCAGTACTTC	CASSQAITGGAYEQYF	TRBV14	TRBJ2-7
TGCGCCAGCAGCCAAGAACAGGCGCTCGCTTTTAATCAGCCCCAGCATTTT	CASSQEQALAFNQPQHF	TRBV4-1	TRBJ1-5
TGTGCCAGCAGCCCAGACAGGCGGGATAATTCACCCCTCCACTTT	CASSPDRRDNSPLHF	TRBV28	TRBJ1-6
TGTGCCAGCAGCGTAGCATTTTCCCCAGGGTGCCTCTCTGGAAACACCATATATTTT	CASSVAFSPGCLSGNTIYF	TRBV9	TRBJ1-3
TGTGCCAGCAGCCCGGGGACTAGCGGGAATGAGCAGTTCTTC	CASSPGTSGNEQFF	TRBV11-2	TRBJ2-1
TGTGCCAGAAGGGGGGGGGACGAGCAGTACTTC	CARRGGDEQYF	TRBV2	TRBJ2-7
TGTGCCACCAAGACAGGAGCCAATCAGCCCCAGCATTTT	CATKTGANQPQHF	TRBV24-1	TRBJ1-5
TGTGCCAGTAGTATAGAGGGGACAGCGTTCTATGGCTACACCTTC	CASSIEGTAFYGYTF	TRBV19	TRBJ1-2
TGTGCCAGCAGCCAATCGTTCCTCAGGGGTCTTCCAGGACGCGACACCGGGGAGCTGTTTTTT	CASSQSFLRGLPGRDTGELFF	TRBV3-1	TRBJ2-2
TGCGCCAGCAGCCTGCTTCCACCTAGCGGGTCAATCTCCTACGAGCAGTACTTC	CASSLLPPSGSISYEQYF	TRBV4-3	TRBJ2-7
TGTGCCAGCAGCCGTAGCAGGAGCTTCGAAAAACTGTTTTTT	CASSRSRSFEKLFF	TRBV14	TRBJ1-4
TGTGCCAGCAGCCAAGATAGCAATGACAGGGGGGGCCAACAGTGCACAGATACGCAGTATTTT	CASSQDSNDRGGQQCTDTQYF	TRBV4-2	TRBJ2-3
TGTGCCAGTAGTATGCAATCCCCAGGGGAAGAGACCCAGTACTTC	CASSMQSPGEETQYF	TRBV19	TRBJ2-5
TGCGCCAGCAGCTTGGCCGGGGGGGCCAAAGGTTTCAGCTCCTACAATGAGCAGTTCTTC	CASSLAGGAKGFSSYNEQFF	TRBV5-1	TRBJ2-1
TGCGCCAGCAGCAACAGGACAGGGAATGGGGACACTGAAGCTTTCTTT	CASSNRTGNGDTEAFF	TRBV5-1	TRBJ1-1
TGTGCCAGCAGTGGCCACCTGGGGACCTACGAGCAGTACTTC	CASSGHLGTYEQYF	TRBV2	TRBJ2-7
TGCAGTGCTAGGTGGGGACAGGGGGCGCCGGGAAGTACTAGGCTGGAGCCCCAGCATTTT	CSARWGQGAPGSTRLEPQHF	TRBV20-1	TRBJ1-5
TGCAGTGCTAGACGATCAGGGTACTTC	CSARRSGYF	TRBV20-1	TRBJ2-7
TGTGCCAGCAGCTTGGCCGGGACAGGGACCTCCTACGAGCAGTACTTC	CASSLAGTGTSYEQYF	TRBV5-6	TRBJ2-7
TGTGCCAGCAGCTTGGAAAGATCCAGGGGAAGAAACACCATATATTTT	CASSLERSRGRNTIYF	TRBV7-9	TRBJ1-3
TGCGCCAGCATAAGGTTAGTACTAGCAACCAACGAGCAGTACTTC	CASIRLVLATNEQYF	TRBV10-1	TRBJ2-7
TGCGCCAGCAGCTTGGTAGGGGGGCCCGGTAGCTCCTACAATGAGCAGTTCTTC	CASSLVGGPGSSYNEQFF	TRBV5-1	TRBJ2-1
TGTGCCAGCAGTGGGAGGACTAGCGGGCGAACAGTGCGACGTGAGAAAACGAGTGAGCAGTTCTTC	CASSGRTSGRTVRREKTSEQFF	TRBV6-4	TRBJ2-1
TGTGCCAGCGGGACAGAGGCGACTGGGGCCAACGTCCTGACTTTC	CASGTEATGANVLTF	TRBV6-5	TRBJ2-6
TGTGCCAGCAGCCAAGAGCCAGGAATATCCCTCCACTTT	CASSQEPGISLHF	TRBV14	TRBJ1-6
TGTGCCAGCTCACCAAAGCAAGGGGGCTACGAGCAGTACTTC	CASSPKQGGYEQYF	TRBV18	TRBJ2-7
TGTGCCAGCAGCACGGAGGGGGGCTACGAGCAGTACTTC	CASSTEGGYEQYF	TRBV7-9	TRBJ2-7
TGCAGCGTTGTCCCGAGGAAGCCATGCACAGATACGCAGTATTTT	CSVVPRKPCTDTQYF	TRBV29-1	TRBJ2-3
TGCGCCAGCGACCCTCGGGAGGACACTCGCTTC	CASDPREDTRF	TRBV5-1	TRBJ2-7
TGTGCCAGCACCCCCTCCGGGACTAGCCCCTACAATGAGCAGTTCTTC	CASTPSGTSPYNEQFF	TRBV6-1	TRBJ2-1
TGTGCCTCAACAGGGGTTCAGGACGGGTTTTTGGGCGAGCAGTACTTC	CASTGVQDGFLGEQYF	TRBV5-6	TRBJ2-7
TGTGCCAGCAGCCACGCCAGCCGGGACAGTTTAAACTCTGGAAACACCATATATTTT	CASSHASRDSLNSGNTIYF	TRBV14	TRBJ1-3
TGTGCCAGCAGTTTGACTCCCGATGGAGGCAATGAGCAGTTCTTC	CASSLTPDGGNEQFF	TRBV6-2	TRBJ2-1
TGCGCCAGCAGTGAGCCCAGGGGGAACTCCTACGAGCAGTACTTC	CASSEPRGNSYEQYF	TRBV10-1	TRBJ2-7
TGCGCCAGCAGCCAAGAAGAACCCCCGGTGGGCTTTACGCGGGGTTTGCCCCGGAACACCGGGGAGCTGTTTTTT	CASSQEEPPVGFTRGLPRNTGELFF	TRBV4-3	TRBJ2-2
TGTGCCAGCAGTTTAGCGCATCGTATCGGACTTGAAGCTTTCTTT	CASSLAHRIGLEAFF	TRBV12-4	TRBJ1-1
TGTGCCAGCAGCTTACTGTCAGCGGCTCTCTACGAGCAGTACTTC	CASSLLSAALYEQYF	TRBV11-3	TRBJ2-7
TGTGCCGGACTAGTGAGATACTCGCAGTATTTT	CAGLVRYSQYF	TRBV19	TRBJ2-3
TGTGCCAGCGGGGGGAACTCCTACGAGCAGTACTTC	CASGGNSYEQYF	TRBV9	TRBJ2-7
TGTGCCATGGACCGGACCACGGGACAAAACATTCAGTACTTC	CAMDRTTGQNIQYF	TRBV19	TRBJ2-4
TGTGCCAGCACAACAAGACAGGGTACCTACGAGCAGTACTTC	CASTTRQGTYEQYF	TRBV6-4	TRBJ2-7
TGTGCCAGTAGTATTCTATTCGAACTAGGGTCATCCGACACCGGGGAGCTGTTTTTT	CASSILFELGSSDTGELFF	TRBV19	TRBJ2-2
TGTGCCAGCAAGGGCTACGAGCAGTACTTC	CASKGYEQYF	TRBV7-9	TRBJ2-7
TGTGCCAGCAGCTGCTTGTATGGAAACACCATATATTTT	CASSCLYGNTIYF	TRBV7-4	TRBJ1-3
TGTGCCAGCAGCCGGGGACAGGGAAGGGATGAAAAACTGTTTTTT	CASSRGQGRDEKLFF	TRBV25-1	TRBJ1-4
TGCAGTGCTGGGGATGAAAAACTGTTTTTT	CSAGDEKLFF	TRBV20-1	TRBJ1-4
TGTGCCAGCAGAGGAGAAGCCGGGGGGACGGGCAATCAGCCCCAGCATTTT	CASRGEAGGTGNQPQHF	TRBV5-4	TRBJ1-5
TGTGCCAGCAGGATCCCGGGACAGCAAACTGAAGCTTTCTTT	CASRIPGQQTEAFF	TRBV7-3	TRBJ1-1
TGTGCCAGCGGACGCAATCAGCCCCAGCATTTT	CASGRNQPQHF	TRBV9	TRBJ1-5
TGTGCCAGCAGAATAGGGACAGAGCAGTCCAGTCGTGGGTGCTCTGGAAACACCATATATTTT	CASRIGTEQSSRGCSGNTIYF	TRBV6-8	TRBJ1-3
TGTGCCATCAGGTCGGGACGAACCGAGCAGTACTTC	CAIRSGRTEQYF	TRBV10-3	TRBJ2-7
TGCGCCAGCCCGAGGTTAAAGGGATTTGCAACTAATGAAAAACTGTTTTTT	CASPRLKGFATNEKLFF	TRBV5-1	TRBJ1-4
TGCGCCAGCAGCCAAGTCAGCGGCGGCTTAAGCTCCTACAATGAGCAGTTCTTC	CASSQVSGGLSSYNEQFF	TRBV4-3	TRBJ2-1
TGCAGTGCTAGAGCACCCGGGGGGGAGGGGGACCGAACCCCGGAGCAGTTCTTC	CSARAPGGEGDRTPEQFF	TRBV20-1	TRBJ2-1
TGTGCCACCAGTGATCAGCCACATGACCTTGACACTGAAGCTTTCTTT	CATSDQPHDLDTEAFF	TRBV24-1	TRBJ1-1
TGTGCCAAGACCCTAACAGGGCCCTCCTACGAGCAGTACTTC	CAKTLTGPSYEQYF	TRBV19	TRBJ2-7
TGTGCCAGCAGCACGCCGGGACATCAGCCCCAGCATTTT	CASSTPGHQPQHF	TRBV13	TRBJ1-5
TGTGCCAGCAGCCGGACTAGCGGTCCCTACGAGCAGTACTTC	CASSRTSGPYEQYF	TRBV28	TRBJ2-7
TGTGCCAGCAGCGTCGACGTCCCGGTCCCGGGACAGGGGGAAAGGGACGAGCAGTACTTC	CASSVDVPVPGQGERDEQYF	TRBV13	TRBJ2-7
TGCAGTGCTAGGTATGGACAGGGCGGAGGGGGCTACACCTTC	CSARYGQGGGGYTF	TRBV20-1	TRBJ1-2
TGTGCCAGCAGCCAAGATTTACGGAAAAGAACTGAAGCTTTCTTT	CASSQDLRKRTEAFF	TRBV3-1	TRBJ1-1
TGTGCTAGTGGTTTGGCCGGGACAGGGGACACAGATACGCAGTATTTT	CASGLAGTGDTDTQYF	TRBV12-5	TRBJ2-3
TGTGCCGTCGGAACGCCGGGACTAGCCTTAGAGACCCAGTACTTC	CAVGTPGLALETQYF	TRBV11-3	TRBJ2-5
TGTGCCAGCAGCCCGGACAGGGGTGGAGTTAAGCCCCAGCATTTT	CASSPDRGGVKPQHF	TRBV6-3	TRBJ1-5
TGTGCCAGCAGTGAAATAAAGGATCCCAGGGACAAGCGTCTCAATGAGCAGTTCTTC	CASSEIKDPRDKRLNEQFF	TRBV6-1	TRBJ2-1
TGTGCCATCATACAGGGTTTGGGCACCTACGAGCAGTACTTC	CAIIQGLGTYEQYF	TRBV10-3	TRBJ2-7
TGCAGTGCTAGCCAGGGACAGGGCCGGTCCGGGGAGCTGTTTTTT	CSASQGQGRSGELFF	TRBV20-1	TRBJ2-2
TGCGCCAGCAGCCAAGACTCCAAGCTAGCCAGGGACGAGCAGTACTTC	CASSQDSKLARDEQYF	TRBV4-1	TRBJ2-7
TGTGCCAGCCCCTTTCTCCTTGGGGGCACTGAAGCTTTCTTT	CASPFLLGGTEAFF	TRBV12-3	TRBJ1-1
TGTGCCAGCAGAAGCTACGGGGCCTACAATGAGCAGTTCTTC	CASRSYGAYNEQFF	TRBV6-5	TRBJ2-1
TGCGCCAGCAGGACAGTTAAGTGGTCCTATAATTCACCCCTCCACTTT	CASRTVKWSYNSPLHF	TRBV10-2	TRBJ1-6
TGCGCCAGCACCCAAAGAGGGGGCCCCCCCAATCAGCCCCAGCATTTT	CASTQRGGPPNQPQHF	TRBV5-1	TRBJ1-5
TGTGCCAGCAGCTTAATCCACAGGGTGAAACGAGAGTATAGCAATCAGCCCCAGCATTTT	CASSLIHRVKREYSNQPQHF	TRBV7-3	TRBJ1-5
TGTGCCAGCAGTTTCCGGGACAGGAGCCCAAACACTGAAGCTTTCTTT	CASSFRDRSPNTEAFF	TRBV28	TRBJ1-1
TGTGCCAGCAGCCAAGATGGGGGCCCAGAGCCCCAGCATTTT	CASSQDGGPEPQHF	TRBV4-2	TRBJ1-5
TGTGCCAGCAGCAGTGGGGATTACACCGGGGAGCTGTTTTTT	CASSSGDYTGELFF	TRBV6-5	TRBJ2-2
TGTGCCAGCAGCGGGGACCTCGCGAACACCGGGGAGCTGTTTTTT	CASSGDLANTGELFF	TRBV12-3	TRBJ2-2
TGTGCCACGGAAGCTTTCTTT	CATEAFF	TRBV7-9	TRBJ1-1
TGTGCCAGCAGCTTGGCCTGGGGGAACACTGAAGCTTTCTTT	CASSLAWGNTEAFF	TRBV11-2	TRBJ1-1
TGTGCCAGCAGCTTACACCCGCACAGGGCCCCAACTAATGAAAAACTGTTTTTT	CASSLHPHRAPTNEKLFF	TRBV7-9	TRBJ1-4
TGCAGTGCGGAACAGATAGGCACTGAAGCTTTCTTT	CSAEQIGTEAFF	TRBV20-1	TRBJ1-1
TGTGCCAGCAAAGAGCCAGGGAGGGCGGGCGTTAGCACAGATACGCAGTATTTT	CASKEPGRAGVSTDTQYF	TRBV7-4	TRBJ2-3
TGTGCCAGCAGTCCACCGGGGACAGGGGTGGGGGGTCCAACTAATGAAAAACTGTTTTTT	CASSPPGTGVGGPTNEKLFF	TRBV6-8	TRBJ1-4
TGTGCCAGCAGGGGGGGCCCCCTTAATGAGCAGTTCTTC	CASRGGPLNEQFF	TRBV6-5	TRBJ2-1
TGTGCCAGCAGCTGCCGGGACAGAAGCAATCAGCCCCAGCATTTT	CASSCRDRSNQPQHF	TRBV7-7	TRBJ1-5
TGTGCCAGCAGTTTAGACAGGGGGCTTGGTTTGGTCTTT	CASSLDRGLGLVF	TRBV6-3	TRBJ1-1
TGTGCCAGCTCACCAGTCAACCGACAGAGATACGAGCAGTACTTC	CASSPVNRQRYEQYF	TRBV18	TRBJ2-7
TGTGCCAGTAGTATGCTCTTAGCAGGGATGTGCTACAATGAGCAGTTCTTC	CASSMLLAGMCYNEQFF	TRBV19	TRBJ2-1
TGTGCCAGCAGCCCCTACACCCGGGACTGCCAGCCCCAGCATTTT	CASSPYTRDCQPQHF	TRBV7-2	TRBJ1-5
TGTGCCAGCAGCCAACCAAGGTTCGGACAGGGCCAAGAGACCCAGTACTTC	CASSQPRFGQGQETQYF	TRBV14	TRBJ2-5
TGTGCCAGCAGACCCGAGTCCAGGCGCACAGATACGCAGTATTTT	CASRPESRRTDTQYF	TRBV6-5	TRBJ2-3
TGCAGTGAAGCCTGGGTTCTCGCGAACACCGGGGAGCTGTTTTTT	CSEAWVLANTGELFF	TRBV20-1	TRBJ2-2
TGTGCCAGCAGCCTACCTTATGACAGGGGGCTTCTCGCAGATACGCAGTATTTT	CASSLPYDRGLLADTQYF	TRBV9	TRBJ2-3
TGTGCCAGCAGGTTACAGGGGGCCCCAACGAGCAGCAATCAGCCCCAGCATTTT	CASRLQGAPTSSNQPQHF	TRBV27	TRBJ1-5
TGTGCCAGCAGCCTTAAATACAGGGATGAGGCGACTGAAGCTTTCTTT	CASSLKYRDEATEAFF	TRBV3-1	TRBJ1-1
TGCGCCAGCAGCTACCGCAGGGGTTACGAGCAGTACTTC	CASSYRRGYEQYF	TRBV5-1	TRBJ2-7
TGCAGTGCTAAGGCTAGCGGGGTCTTTTACGAGCAGTACTTC	CSAKASGVFYEQYF	TRBV20-1	TRBJ2-7
TGTGCCATCAGTGGACCAAGGGCCCCCCATAGCAATCAGCCCCAGCATTTT	CAISGPRAPHSNQPQHF	TRBV10-3	TRBJ1-5
TGTGCCAGCAGCTCTGAAATGGGGAGCCAGCCCCAGCATTTT	CASSSEMGSQPQHF	TRBV7-8	TRBJ1-5
TGCGCCAGCCGGGGTACAGGGGGCCCACCCTACAATGAGCAGTTCTTC	CASRGTGGPPYNEQFF	TRBV5-1	TRBJ2-1
TGTGCCAGCAGTAAGGTAACCCGGGACAGGGTCGGGTCTAATGAAAAACTGTTTTTT	CASSKVTRDRVGSNEKLFF	TRBV11-3	TRBJ1-4
TGTGCCAGCAGCGGGAAGCTTGGGGTGGCGACTAGCGGGAGCCTCAACTATGGCTACACCTTC	CASSGKLGVATSGSLNYGYTF	TRBV9	TRBJ1-2
TGTGCCAGCAGTGGCCAACAGGGCCCTTTCGAGCCCCAGCATTTT	CASSGQQGPFEPQHF	TRBV2	TRBJ1-5
TGTGCCAGCTCACCCCTAATTTTGACTAAGGATTATGAGCAGTTCTTC	CASSPLILTKDYEQFF	TRBV18	TRBJ2-1
TGTGCCAGCAGCTTAGGATCGGGGGGCGGCGAGCAGTACTTC	CASSLGSGGGEQYF	TRBV7-9	TRBJ2-7
TGCGCCAGCAGCCCCCGCCCACAGGGGATTTACGAGCAGTACTTC	CASSPRPQGIYEQYF	TRBV4-3	TRBJ2-7
TGTGCCACCGAAACGAGCGGGGGGGACACCGGGGAGCTGTTTTTT	CATETSGGDTGELFF	TRBV24-1	TRBJ2-2
TGTGCCAGCAGCTTACTAGCGGGAGCGCAGATTCCGACTGAAGCTTTCTTT	CASSLLAGAQIPTEAFF	TRBV7-2	TRBJ1-1
TGCAGTCCGGTACGGGAGGGAGTTCAGCCCCAGCATTTT	CSPVREGVQPQHF	TRBV20-1	TRBJ1-5
TGTGCCTGGAGTGTAGGGGGGGACCTTGACCCTGAAAAACTGTTTTTT	CAWSVGGDLDPEKLFF	TRBV30	TRBJ1-4
TGTGCCAGCAGTTATGCAGGGGGACGTACGAATGAGCAGTTCTTC	CASSYAGGRTNEQFF	TRBV6-5	TRBJ2-1
TGTGCCAGTAGGACCAGGCGCAACGGACAGCCCCAGCATTTT	CASRTRRNGQPQHF	TRBV19	TRBJ1-5
TGTGCCACCAGTGATCGATGGACAGCCTACGAGCAGTACTTC	CATSDRWTAYEQYF	TRBV24-1	TRBJ2-7
TGTCCCCCAGGGACGAGCTCCTACGAGCAGTACTTC	CPPGTSSYEQYF	TRBV19	TRBJ2-7
TGCGCCAGCAGCTTTCGGGGACAGGGACTGCTAAGAGGAAGGACCCAGTACTTC	CASSFRGQGLLRGRTQYF	TRBV5-1	TRBJ2-5
TGTGCCAGTAGTCCTAACACCTACAGGGGTCTTGAAGCTTTCTTT	CASSPNTYRGLEAFF	TRBV19	TRBJ1-1
TGTGCCAGCAGTTACCCGCCGATGGACAGGGGTGGTCAACGCTATGGCTACACCTTC	CASSYPPMDRGGQRYGYTF	TRBV6-5	TRBJ1-2
TGTGCCAGCCCGCCGGGACAGTATAGCAATCAGCCCCAGCATTTT	CASPPGQYSNQPQHF	TRBV27	TRBJ1-5
TGCGCCAGCAGCTTCACGGGTGGGGAGCTGTTTTTT	CASSFTGGELFF	TRBV5-1	TRBJ2-2
TGCGCCAGCAGCTTGGGGCGAGACAAGAGCTCCAACCACAATGAGCAGTTCTTC	CASSLGRDKSSNHNEQFF	TRBV5-1	TRBJ2-1
TGCGCCAGCAGACTGGGCGTTCCGGGACTAGAGGAGTCCTACGAGCAGTACTTC	CASRLGVPGLEESYEQYF	TRBV4-1	TRBJ2-7
TGTGCCAGCAGCTTCGACCCACGTGATTTTGACGAGCAGTACTTC	CASSFDPRDFDEQYF	TRBV7-3	TRBJ2-7
TGCAGTGCTAGCCCCATAGGGGCCACTGAAGCTTTCTTT	CSASPIGATEAFF	TRBV20-1	TRBJ1-1
TGTGCCAGCAGCAGACCGGGACAGGGGAAAGGGTACGAGCAGTACTTC	CASSRPGQGKGYEQYF	TRBV6-6	TRBJ2-7
TGTGCCACGGGTGCCCCCTCCTACGAGCAGTACTTC	CATGAPSYEQYF	TRBV6-5	TRBJ2-7
TGTGCCAGTAGTACGACTAGCGGGGGCCACGAGACCCAGTACTTC	CASSTTSGGHETQYF	TRBV19	TRBJ2-5
TGTGCCACCAGTGATGCACAGGGGACTAATTCGGGGCGGCGGGCCCTCCACTTT	CATSDAQGTNSGRRALHF	TRBV24-1	TRBJ1-6
TGCGCCAGCTTAGTGATATTGGGGCTGGACAATGAGCAGTTCTTC	CASLVILGLDNEQFF	TRBV5-1	TRBJ2-1
TGTGCCAGCAGCCCTAGTTACAATGAGCAGTTCTTC	CASSPSYNEQFF	TRBV11-2	TRBJ2-1
TGTGCCACCAGTGATGAACAACATAGTGGGGGGTGGTACAATGAGCAGTTCTTC	CATSDEQHSGGWYNEQFF	TRBV24-1	TRBJ2-1
TGTGCCAGCAGGGGGGGGCCTGTCCGCGAGCAGTACTTC	CASRGGPVREQYF	TRBV6-4	TRBJ2-7
TGTGCCAGCAACCTTCGCAATCAGCCCCAGCATTTT	CASNLRNQPQHF	TRBV12-4	TRBJ1-5
TGTGCCAGCAGCTTAGCGCGTTCCTACGAGCAGTACTTC	CASSLARSYEQYF	TRBV11-2	TRBJ2-7
TGCGCCAGCAGCCAAGATCCCGGACAGGGGGGGATCCTTTCACCCCTCCACTTT	CASSQDPGQGGILSPLHF	TRBV4-1	TRBJ1-6
TGCAGCAGGGGGGGGGGCAACACTGAAGCTTTCTTT	CSRGGGNTEAFF	TRBV29-1	TRBJ1-1
TGTGCCAGCAGGCGGGAGGACAATGAGCAGTTCTTC	CASRREDNEQFF	TRBV13	TRBJ2-1
TGTGCCTGGAGTTGGGGTTTGGCCTCTGGAAACACCATATATTTT	CAWSWGLASGNTIYF	TRBV30	TRBJ1-3
TGTGCCAGCAGCGTAGTTCCTAGCGGGAGAGGTCTAACCTACGAGCAGTACTTC	CASSVVPSGRGLTYEQYF	TRBV9	TRBJ2-7
TGTGCCAGCAGAACCCCGGGACAGGGGAACGAAAAACTGTTTTTT	CASRTPGQGNEKLFF	TRBV5-4	TRBJ1-4
TGTGCCACCAGTGGGACAGGGAGGCATGGCTACACCTTC	CATSGTGRHGYTF	TRBV24-1	TRBJ1-2
TGTGCCTGGAGTAAACGGGGACTAGCGGGAGGATTACGTGACTATGGCTACACCTTC	CAWSKRGLAGGLRDYGYTF	TRBV30	TRBJ1-2
TGTGCCATCAGCAATCGGGCGCAAGAGACCCAGTACTTC	CAISNRAQETQYF	TRBV10-3	TRBJ2-5
TGTGCCAGCAGACTAGCGGACAATGAGCAGTTCTTC	CASRLADNEQFF	TRBV6-1	TRBJ2-1
TGTGCCAGCTCACCACGGGGGGCATCCTGCCACACCGGGGAGCTGTTTTTT	CASSPRGASCHTGELFF	TRBV18	TRBJ2-2
TGTGCCAGCAGCCAACAATGCTATTACATTCAGTACTTC	CASSQQCYYIQYF	TRBV3-1	TRBJ2-4
TGTGCCAGCAGCCAGACAATGGGAGGGACAGGAAACACCATATATTTT	CASSQTMGGTGNTIYF	TRBV9	TRBJ1-3
TGCGCCAGCAGCAGCTTAGATACCGGGGCCGTCTATACGCAGTATTTT	CASSSLDTGAVYTQYF	TRBV5-1	TRBJ2-3
TGTGCCAGCAGCCCCCGGGAGCAGTTCTTC	CASSPREQFF	TRBV13	TRBJ2-1
TGTGCCAGCAGCTCGGGCCCTAGGTTACGCCTGGACGAGCAGTACTTC	CASSSGPRLRLDEQYF	TRBV7-2	TRBJ2-7
TGTGCCAGCAGCTTACGCCGTCGGGCAAACATTCAGTACTTC	CASSLRRRANIQYF	TRBV7-9	TRBJ2-4
TGTGCCAGCAGCCTAGTAGGACGACTAGCTTGCCACAATGAGCAGTTCTTC	CASSLVGRLACHNEQFF	TRBV7-6	TRBJ2-1
TGTGCCAGCAGCTCGCTACCCAATGAGCAGTTCTTC	CASSSLPNEQFF	TRBV7-8	TRBJ2-1
TGTGCCAGCAGAGAGAGGGTAACTGGAAACACCATATATTTT	CASRERVTGNTIYF	TRBV13	TRBJ1-3
TGTGCCAGCAGACCCTTAGCAACACAGCCCCAGCATTTT	CASRPLATQPQHF	TRBV13	TRBJ1-5
TGTGCCAGCATACTGGGGGCGCAGTTCTTC	CASILGAQFF	TRBV2	TRBJ2-1
TGTGCCAGCAGTGACGAAGAGCAGGATACGCAGTATTTT	CASSDEEQDTQYF	TRBV6-5	TRBJ2-3
TGTGCCACCAGTGATAACGACAGGGGGCGTGGGGAGACCTACGAGCAGTACTTC	CATSDNDRGRGETYEQYF	TRBV24-1	TRBJ2-7
TGTGCCAGCAGTGAATCGGGACAGGGGCCTCCGAACACTGAAGCTTTCTTT	CASSESGQGPPNTEAFF	TRBV25-1	TRBJ1-1
TGTGCCAGCAGCAGTCAGACAACCGGGGAGCTGTTTTTT	CASSSQTTGELFF	TRBV3-1	TRBJ2-2
TGTGCCAGCAGCTTGGGGACAACTAACTATGGCTACACCTTC	CASSLGTTNYGYTF	TRBV7-9	TRBJ1-2
TGTGCCAGTAGTATTAGGAGTTGGTCTCTGAACACTGAAGCTTTCTTT	CASSIRSWSLNTEAFF	TRBV19	TRBJ1-1
TGTGCCAGCAAGGAGCGGGACGCCTATGGCTACACCTTC	CASKERDAYGYTF	TRBV25-1	TRBJ1-2
TGTGCCAGCAGTGACGGATGTGGGGGGCCCGACCACAAAAACATTCAGTACTTC	CASSDGCGGPDHKNIQYF	TRBV6-4	TRBJ2-4
TGTGCCAGCAACCATAACGGTCGACAGGGTGATGGGGACGCCGTGAACACTGAAGCTTTCTTT	CASNHNGRQGDGDAVNTEAFF	TRBV2	TRBJ1-1
TGTGCCAGGGTGCTGACGATCCCAATGGGGGGGGCCAACGTCCTGACTTTC	CARVLTIPMGGANVLTF	TRBV13	TRBJ2-6
TGTAAGTCAGCCCAGTACTTC	CKSAQYF	TRBV30	TRBJ2-5
TGTGCCAGCAGTTTTCCAGGAAATCAGCCCCAGCATTTT	CASSFPGNQPQHF	TRBV12-3	TRBJ1-5
TGTGCCAGCAGTACTCCCGTGCCCGGGACTAGCGGGAGAGTCACAGATACGCAGTATTTT	CASSTPVPGTSGRVTDTQYF	TRBV28	TRBJ2-3
TGCGCCAACCCCCCACAGGGACGTCAGCCCCAGCATTTT	CANPPQGRQPQHF	TRBV10-2	TRBJ1-5
TGTGCCAGCAGCGTAGGGCTGACAGGGGGCCTTCATAGCAATCAGCCCCAGCATTTT	CASSVGLTGGLHSNQPQHF	TRBV9	TRBJ1-5
TGTGCCAGCAGCGCGGGGGGCGGCAATGAGCAGTTCTTC	CASSAGGGNEQFF	TRBV13	TRBJ2-1
TGTGCCAGCAGCTCACTGTACGAGCAGTACTTC	CASSSLYEQYF	TRBV7-3	TRBJ2-7
TGCGCCAGCAGCGTCCCGGGGGATCAGCCCCAGCATTTT	CASSVPGDQPQHF	TRBV5-1	TRBJ1-5
TGTGCCAGCAGCTTAGGGACAGGGGGGTCCTACGAGCAGTACTTC	CASSLGTGGSYEQYF	TRBV7-9	TRBJ2-7
TGCGCCAGCAGCCAAGAAGAAAAGACCGGAAGACAGCCCCAGCATTTT	CASSQEEKTGRQPQHF	TRBV4-1	TRBJ1-5
TGTGCCAGTAGTATGAGCACTAGCGGGAGGTGTCATGGTGGCTACACCTTC	CASSMSTSGRCHGGYTF	TRBV19	TRBJ1-2
TGTGCCAGCAGCGCATTTTTAGAGACCCAGTACTTC	CASSAFLETQYF	TRBV2	TRBJ2-5
TGTGCCAGCAGTTATATGACAGTACCTCGGACGGATCAGCCCCAGCATTTT	CASSYMTVPRTDQPQHF	TRBV6-2	TRBJ1-5
TGTGCCAGCAGCTTAGCTAAGCGGCTCTCCTACAATGAGCAGTTCTTC	CASSLAKRLSYNEQFF	TRBV7-2	TRBJ2-1
TGTGCCAGCACGACGAGGGTGAACACTGAAGCTTTCTTT	CASTTRVNTEAFF	TRBV28	TRBJ1-1
TGTGCCAGCAGTTCCTGTACGGGACAGGGGGCTGGAAACACCATATATTTT	CASSSCTGQGAGNTIYF	TRBV6-5	TRBJ1-3
TGCGCCAGCAGCCAGTTTCGGGGACAGGGCTCTTACACTGAAGCTTTCTTT	CASSQFRGQGSYTEAFF	TRBV4-1	TRBJ1-1
TGTGCCAGCAGCTTGCCCCAGACGACTAGCGGGATCGGGTCCCTCTGGAGCTCCTACAATGAGCAGTTCTTC	CASSLPQTTSGIGSLWSSYNEQFF	TRBV7-2	TRBJ2-1
TGCGCCAGCAGCTTGAACGACAGGCTAGACTCTGGGGCCAACGTCCTGACTTTC	CASSLNDRLDSGANVLTF	TRBV5-1	TRBJ2-6
TGTGCCAGCAGCCCGGAGACAGACTCGACTGGGGCCAACGTCCTGACTTTC	CASSPETDSTGANVLTF	TRBV5-6	TRBJ2-6
TGTGCCAGCAGCTTACAGCGAAGAGATGGCTACACCTTC	CASSLQRRDGYTF	TRBV7-9	TRBJ1-2
TGCAGTGCTAGCAACTTGGGGACTTTACATCCCCTCTTC	CSASNLGTLHPLF	TRBV20-1	TRBJ2-1
TGCAGTGCTAGGTTTCAGGGCCCGAGTGACTATGGCTACACCTTC	CSARFQGPSDYGYTF	TRBV20-1	TRBJ1-2
TGTGCCAGCAGCCCTCGGACAGGGGGGTTAGGGGCCTACGAGCAGTACTTC	CASSPRTGGLGAYEQYF	TRBV7-3	TRBJ2-7
TGTGCCAGCAGTTTATTTCAGACAGGGGCAAGCTCCTACGAGCAGTACTTC	CASSLFQTGASSYEQYF	TRBV27	TRBJ2-7
TGTGCCCCCAGGGGCCAAAAGACAGTTAACTATGGCTACACCTTC	CAPRGQKTVNYGYTF	TRBV30	TRBJ1-2
TGTGCCACCAGTCGGCGGGAGAATGAGCAGTTCTTC	CATSRRENEQFF	TRBV24-1	TRBJ2-1
TGTGCCAGCAGCTCGAAAAAGGTAAGAGAGACCCAGTACTTC	CASSSKKVRETQYF	TRBV7-2	TRBJ2-5
TGTGCCATCGCCACTACAACCTACGAGCAGTACTTC	CAIATTTYEQYF	TRBV9	TRBJ2-7
TGTGCCAGCAGTGATTGGCCCTCAGTGACTAGCGGGGGTCGGAGCTCCTACAATGAGCAGTTCTTC	CASSDWPSVTSGGRSSYNEQFF	TRBV6-4	TRBJ2-1
TGTGCCAGCAGCCAAGAGGCGGGGAAACTTTCCTATGGCTACACCTTC	CASSQEAGKLSYGYTF	TRBV14	TRBJ1-2
TGTGCCAGTAACGGAGGGGACTATGGCTACACCTTC	CASNGGDYGYTF	TRBV19	TRBJ1-2
TGTGCCAGCAACAGTGGCGTCACCGAGGAGCCAATTGTGCAGTACTTC	CASNSGVTEEPIVQYF	TRBV6-5	TRBJ2-7
TGCAGTGCTAGAACCAGGGAGACTGAAGCTTTCTTT	CSARTRETEAFF	TRBV20-1	TRBJ1-1
TGCAGCGTTGTCGGACAGATGCGGGCTCTCTACTCCTACGAGCAGTACTTC	CSVVGQMRALYSYEQYF	TRBV29-1	TRBJ2-7
TGTGCCAGCAGCGTAGCTCTGGACAGTCCTGAAGCTTTCTTT	CASSVALDSPEAFF	TRBV9	TRBJ1-1
TGTGCCAGCAGCTCTACAAGAACCGGGGGGGGCCAACTCGACTACGAGCAGTACTTC	CASSSTRTGGGQLDYEQYF	TRBV5-6	TRBJ2-7
TGCAGTGCTAGAGATCCCGTTACACTAGGAGAATGTTCGTGCGGAACCTTTGGCTACGAGCAGTACTTC	CSARDPVTLGECSCGTFGYEQYF	TRBV20-1	TRBJ2-7
TGTGCCAGCAGTTACACTCGGGTGTTATACGAGCAGTACTTC	CASSYTRVLYEQYF	TRBV6-5	TRBJ2-7
TGTGCCAGCAACCAAACGGGGGGGGTTCGGCGACCCCCTGGGCAGTACTTC	CASNQTGGVRRPPGQYF	TRBV9	TRBJ2-7
TGTGCCAGCTCACCCTCCAATACTCCCACGAGCTACAATGAGCAGTTCTTC	CASSPSNTPTSYNEQFF	TRBV18	TRBJ2-1
TGCAGCGTTGGGAGGGACTACGAGCAGTACTTC	CSVGRDYEQYF	TRBV29-1	TRBJ2-7
TGTGCCAGCAGTGAACAACCTAGCGGGTACGGAAAACTTTTAATTGGGGCCAACGTCCTGACTTTC	CASSEQPSGYGKLLIGANVLTF	TRBV6-4	TRBJ2-6
TGTGCCAGCAGCCAAGATCCCGTCCACGACAGGGCGGTCGGAGTGAACACTGAAGCTTTCTTT	CASSQDPVHDRAVGVNTEAFF	TRBV4-2	TRBJ1-1
TGTGCCTGGAGAGGTGTGCGGGATTCTTTCTTT	CAWRGVRDSFF	TRBV30	TRBJ1-1
TGTGCCAGCATAGGCTACCGGGGGGAGGATTGGGACACCGGGGAGCTGTTTTTT	CASIGYRGEDWDTGELFF	TRBV28	TRBJ2-2
TGTGCCAGCAGTGGCCCCGCCAGTCAAAAGGGGCCGAATCAAGGGAACGAGCAGTACTTC	CASSGPASQKGPNQGNEQYF	TRBV27	TRBJ2-7
TGTGCCAGCAGTTTATCGCACCCCCCCTGTTCAGCCACAGGGTGTGGTAAGGGTTCTGGAAACACCATATATTTT	CASSLSHPPCSATGCGKGSGNTIYF	TRBV27	TRBJ1-3
TGTGCCAGCAGCTTAGTCCCGTCCGGATTTCTGGATACGCAGTATTTT	CASSLVPSGFLDTQYF	TRBV7-8	TRBJ2-3
TGTGCCTGGAGTGTACGGGCGGCAGATACGCAGTATTTT	CAWSVRAADTQYF	TRBV30	TRBJ2-3
TGTGCCAGCAGCTCGCCCCAGAGGGCCTACGAGCAGTACTTC	CASSSPQRAYEQYF	TRBV7-9	TRBJ2-7
TGTGCCAGCAGTTACGACAGGGGGCGACGGGGCTACACCTTC	CASSYDRGRRGYTF	TRBV6-6	TRBJ1-2
TGTGCCAGCGGGCCCCAGGGGTCCTCCTACGAGCAGTACTTC	CASGPQGSSYEQYF	TRBV6-4	TRBJ2-7
TGTGCCAGCAGAAACAGGGGGGTCACAGATACGCAGTATTTT	CASRNRGVTDTQYF	TRBV27	TRBJ2-3
TGTGCCAGCAGCCATCCGAAAGATACGCAGTATTTT	CASSHPKDTQYF	TRBV3-1	TRBJ2-3
TGTGCCAGCGTTCAGACGGGGAGCGAGGGTCCCACAGATACGCAGTATTTT	CASVQTGSEGPTDTQYF	TRBV6-2	TRBJ2-3
TGTGCCAGCAGTACTTATGGGAATGGCTACACCTTC	CASSTYGNGYTF	TRBV6-1	TRBJ1-2
TGTGCCAGCAGCTTAATTGCCGGGACTCACGAGCAGTACTTC	CASSLIAGTHEQYF	TRBV7-3	TRBJ2-7
TGTGCCAGCAGCACCGGGACCGAGCAGTACTTC	CASSTGTEQYF	TRBV13	TRBJ2-7
TGTGCCAGCAGCGGCACAGGGAGGGGTAGTCCCTATGGCTACACCTTC	CASSGTGRGSPYGYTF	TRBV9	TRBJ1-2
TGTGCCAGCAGTTTAGAACAGGGCGGGTGGAACACCGGGGAGCTGTTTTTT	CASSLEQGGWNTGELFF	TRBV12-4	TRBJ2-2
TGTGCCAGCAGCTTAGTAGGCCCTTTGAATGAGCAGTTCTTC	CASSLVGPLNEQFF	TRBV11-2	TRBJ2-1
TGTGCCAGCAGCTTGCAAGTTGCAGACGACTCACCCCTCCACTTT	CASSLQVADDSPLHF	TRBV5-6	TRBJ1-6
TGTGCCAGCAGGGGGTCGACCGCCAAAAACATTCAGTACTTC	CASRGSTAKNIQYF	TRBV6-5	TRBJ2-4
TGTGCCAGCAGACACCGGGACTTGGGCCAAGAGACCCAGTACTTC	CASRHRDLGQETQYF	TRBV13	TRBJ2-5
TGTGCCAGCTGCAGGGGCCGCAAAAACATTCAGTACTTC	CASCRGRKNIQYF	TRBV7-8	TRBJ2-4
TGTGCCAGGTGGACAGCACCGGGCAATCAGCCCCAGCATTTT	CARWTAPGNQPQHF	TRBV19	TRBJ1-5
TGTGCCAGCAGCCGGAGCGAACCCACTGAAGCTTTCTTT	CASSRSEPTEAFF	TRBV7-2	TRBJ1-1
TGCAGTGCTAGTACCCTCAAAAACATTCAGTACTTC	CSASTLKNIQYF	TRBV20-1	TRBJ2-4
TGTGCCAGCAGCTGTCTCCCTCCTCGGGACGGGTGCGCTTTCTTT	CASSCLPPRDGCAFF	TRBV7-2	TRBJ1-1
TGTGCCTTTCGCCCTCACAGGGGGAAAGACACCCTAGGCTACACCTTC	CAFRPHRGKDTLGYTF	TRBV24-1	TRBJ1-2
TGTGCCAGCAGCTTACTGGGGGGCTTGAGAAACACTGAAGCTTTCTTT	CASSLLGGLRNTEAFF	TRBV11-2	TRBJ1-1
TGTGCCAGCAGCTTAGCCGGGACTAGGGCGGAGACCCAGTACTTC	CASSLAGTRAETQYF	TRBV13	TRBJ2-5
TGTGCCAGCAGTTCACGCTTC	CASSSRF	TRBV6-9	TRBJ2-7
TGCAGTGCTAGATCTCGCCGGGACAGGGACACTGAAGCTTTCTTT	CSARSRRDRDTEAFF	TRBV20-1	TRBJ1-1
TGCGCCAATGGGACCGCCTACGAGCAGTACTTC	CANGTAYEQYF	TRBV4-1	TRBJ2-7
TGTGCCAGGAGGAGAACCTACGAGCAGTACTTC	CARRRTYEQYF	TRBV2	TRBJ2-7
TGTGCCAGCAGCTCCCCGGGAGATACGCAGTATTTT	CASSSPGDTQYF	TRBV7-3	TRBJ2-3
TGTGCCAGCAGCGGAGAACCACAGGGAGCCTACGAGCAGTACTTC	CASSGEPQGAYEQYF	TRBV7-4	TRBJ2-7
TGTGCCACGATCGGGAGGAAATGGGCCAAAAACATTCAGTACTTC	CATIGRKWAKNIQYF	TRBV6-5	TRBJ2-4
TGTGCCAGCAGTACCCCCCGAGGCGGGGTAGAGACCCAGTACTTC	CASSTPRGGVETQYF	TRBV6-1	TRBJ2-5
TGTGCCAGGGGTCCGAGGTACAATGAGCAGTTCTTC	CARGPRYNEQFF	TRBV19	TRBJ2-1
TGTGCCAGCAGTCCTAGCGGGTGGACTGAGTTCTACGAGCAGTACTTC	CASSPSGWTEFYEQYF	TRBV28	TRBJ2-7
TGCAGTGCTTCTAGAAACGAGCAGTACTTC	CSASRNEQYF	TRBV20-1	TRBJ2-7
TGCAGTGCTAGACCCGGGGACATCCCCTACGAGCAGTACTTC	CSARPGDIPYEQYF	TRBV20-1	TRBJ2-7
TGTGCCAGCAGCGTCAGTCTATCACCCCTCCACTTT	CASSVSLSPLHF	TRBV9	TRBJ1-6
TGTGCGCGCCGGCGGGGCTCCTACGAGCAGTACTTC	CARRRGSYEQYF	TRBV6-2	TRBJ2-7
TGTGCCAGCAGACCTTCCCCAGGGGGGGGCTATGGCTACACCTTC	CASRPSPGGGYGYTF	TRBV6-6	TRBJ1-2
TGCGCCAGCAGTGCCTCTGACAACTTTGGAAACACCATATATTTT	CASSASDNFGNTIYF	TRBV10-1	TRBJ1-3
TGTGCCAGCCAGGGGGGTCCAGGTGAGCAGTTCTTC	CASQGGPGEQFF	TRBV28	TRBJ2-1
TGTGCCATCAGTGATCCAGGTCCAACTAATGAAAAACTGTTTTTT	CAISDPGPTNEKLFF	TRBV10-3	TRBJ1-4
TGTGCCAGCTCACCACCGCCACCATCGGGGGGGGGGGGATGGACCTCCAATGAGCAGTTCTTC	CASSPPPPSGGGGWTSNEQFF	TRBV18	TRBJ2-1
TGTGCCAGCAGTTTCACAGGGGACAGGGGGCTCTTGAACACTGAAGCTTTCTTT	CASSFTGDRGLLNTEAFF	TRBV28	TRBJ1-1
TGTGCCAGCAAGACAGGGGGATCTTTGGATAGCAATCAGCCCCAGCATTTT	CASKTGGSLDSNQPQHF	TRBV28	TRBJ1-5
TGTGCCAGCAGCTTAGAGGGGGGTCGGTGCGGCGACAATGAGCAGTTCTTC	CASSLEGGRCGDNEQFF	TRBV7-3	TRBJ2-1
TGTGCCAGCAGCTTCGGGGGATCCGACCAGCCCCAGCATTTT	CASSFGGSDQPQHF	TRBV11-2	TRBJ1-5
TGCGCCAGCAGCCAAGTGGTTAGTGCCTTTAATCCAGGCCGGGTTGGCTACACCTTC	CASSQVVSAFNPGRVGYTF	TRBV4-1	TRBJ1-2
TGTGCCAGCAGCACCACGGAGGCAGGGAGACCCCCGAACGAGCAGTACTTC	CASSTTEAGRPPNEQYF	TRBV3-1	TRBJ2-7
TGTGCCAGCAGCGGTTATCGGCCTACGGACAGGGGATTCCGATATAGCAATCAGCCCCAGCATTTT	CASSGYRPTDRGFRYSNQPQHF	TRBV4-2	TRBJ1-5
TGTGCCAGCAGTGACACCACAGGGTCCTATAATTCACCCCTCCACTTT	CASSDTTGSYNSPLHF	TRBV6-4	TRBJ1-6
TGCGCCAGCAGCTTTGAGTCGGTCATCGTGACGAGCTACGAGCAGTACTTC	CASSFESVIVTSYEQYF	TRBV5-1	TRBJ2-7
TGTGCCAGCAGCGATACAGGGGGCTCCTATAATTCACCCCTCCACTTT	CASSDTGGSYNSPLHF	TRBV7-3	TRBJ1-6
TGTGCCTGGAGTGCCGGTGGAAGGAACTGGGGGGATCAGCCCCAGCATTTT	CAWSAGGRNWGDQPQHF	TRBV30	TRBJ1-5
TGTGCCAGCAGCTCAGGTCGACGGAACAATCAGCCCCAGCATTTT	CASSSGRRNNQPQHF	TRBV5-6	TRBJ1-5
TGCGCCAGCAGCTCCCCCCGCGTTGGGGGGGAAGACCGGGGTGATGAGCAGTTCTTC	CASSSPRVGGEDRGDEQFF	TRBV5-1	TRBJ2-1
TGTGCCAGCAGTTACTGTGCGGACCCCCCGGAACTGGTCCTTGAGACCCAGTACTTC	CASSYCADPPELVLETQYF	TRBV6-2	TRBJ2-5
TGTGCCAGCAGCTCCCGGCGGACTATTCACAATGAGCAGTTCTTC	CASSSRRTIHNEQFF	TRBV11-3	TRBJ2-1
TGCAGCGTTGAAGTTCTACGGCGAGAAGCAGATACGCAGTATTTT	CSVEVLRREADTQYF	TRBV29-1	TRBJ2-3
TGTGCCATCAGTGAGCTCAATAAATCCGGGGCTTGCTACGAGCAGTACTTC	CAISELNKSGACYEQYF	TRBV10-3	TRBJ2-7
TGTGCCAGCAGCTTAGCTCCGACTGGGATGCATCAGCCCCAGCATTTT	CASSLAPTGMHQPQHF	TRBV11-2	TRBJ1-5
TGTGCCAGCAGTCCGGTACAATTTCAGCCCCAGCATTTT	CASSPVQFQPQHF	TRBV6-2	TRBJ1-5
TGTGCCAGCTCCCCTGACAGCAAGTATCAGCCCCAGCATTTT	CASSPDSKYQPQHF	TRBV18	TRBJ1-5
TGTGCCAGCAGCCAGGTCAGGGACAGACATTACAATGAGCAGTTCTTC	CASSQVRDRHYNEQFF	TRBV13	TRBJ2-1
TGTGCCATCAGTTCCCTACAGGGGGGCCTGGACGAGCAGTACTTC	CAISSLQGGLDEQYF	TRBV10-3	TRBJ2-7
TGTGCCAGCAGGTGGACAGCCGACACTGAAGCTTTCTTT	CASRWTADTEAFF	TRBV6-3	TRBJ1-1
TGTGCCAGCAGCTTCCCGATTGGCAATCAGCCCCAGCATTTT	CASSFPIGNQPQHF	TRBV7-4	TRBJ1-5
TGTGCCAGCAGTTTCCGGGACATGGCCTTACAGCCCCAGCATTTT	CASSFRDMALQPQHF	TRBV27	TRBJ1-5
TGCAGTGCTAGTAGCGGGCCGGAATGCTCCTACAATGAGCAGTTCTTC	CSASSGPECSYNEQFF	TRBV20-1	TRBJ2-1
TGTGCCAGCAGCAGACAGGGAGTAGTAAACATTCAGTACTTC	CASSRQGVVNIQYF	TRBV28	TRBJ2-4
TGTGCCAGCAGCCTAGCGGGGGGGCAAGAGACCCAGTACTTC	CASSLAGGQETQYF	TRBV7-3	TRBJ2-5
TGTGCCTGGAGTGGACAGGACGAGACCCAGTACTTC	CAWSGQDETQYF	TRBV30	TRBJ2-5
TGCGCCGTACAGGGTTCTTTCTTAAACGGTTCCGTCAAGGGCTCCAATCAGCCCCAGCATTTT	CAVQGSFLNGSVKGSNQPQHF	TRBV10-1	TRBJ1-5
TGCGCCAGCAGAGTAGCCGGACTGAAGACGATAAGGGCAGAGCAGTACTTC	CASRVAGLKTIRAEQYF	TRBV10-1	TRBJ2-7
TGTGCCAGCAGCTGGCCATTGACAGGGGGCGATTCACCCCTCCACTTT	CASSWPLTGGDSPLHF	TRBV5-4	TRBJ1-6
TGTGCCAGCAGTGAAGCGGATAGGAACGGGACAGTGATCACCTTC	CASSEADRNGTVITF	TRBV6-1	TRBJ1-2
TGTGCCAGCACAAAGTGGGACAGGGATCGATATAGCAATCAGCCCCAGCATTTT	CASTKWDRDRYSNQPQHF	TRBV12-4	TRBJ1-5
TGTGCCACCAGCAGCTTCGGACAGCGTACCTATCAGCCCCAGCATTTT	CATSSFGQRTYQPQHF	TRBV15	TRBJ1-5
TGTGCCTATTGTTTAGGGGTCTTGCCCTACAATGAGCAGTTCTTC	CAYCLGVLPYNEQFF	TRBV30	TRBJ2-1
TGTGCCAGCAGCCAAGGGAGGGTGAGCGGGACGGGCTTTTGCAGGAACACCGGGGAGCTGTTTTTT	CASSQGRVSGTGFCRNTGELFF	TRBV14	TRBJ2-2
TGTGCCAGCAGCTTAGATGTGGGGGGAGGCAGGCTGTTTTTT	CASSLDVGGGRLFF	TRBV11-3	TRBJ2-2
TGTGCCAGCGGCCCTCTGCGGGAGTCGAGAAACGGTAGAGGCACCGGGGAGCTGTTTTTT	CASGPLRESRNGRGTGELFF	TRBV6-1	TRBJ2-2
TGTGCTAGTGGTCTCGTAGTTAATCAGCCCCAGCATTTT	CASGLVVNQPQHF	TRBV12-5	TRBJ1-5
TGTGCCAGCAGCGTAGTAGGACAGCAGCCCCAGCATTTT	CASSVVGQQPQHF	TRBV9	TRBJ1-5
TGTGCCAGCAGAAGCCCTTACACTGAAGCTTTCTTT	CASRSPYTEAFF	TRBV6-5	TRBJ1-1
TGCGCCAGCAGAGGGGACAGGGATTCAACCTCTGGAAACACCATATATTTT	CASRGDRDSTSGNTIYF	TRBV5-1	TRBJ1-3
TGCGCCAGCAGCGGGAGAACCGGGGAGCTGTTTTTT	CASSGRTGELFF	TRBV5-1	TRBJ2-2
TGTGCAACAGGCTTTGACGAGCAGTACTTC	CATGFDEQYF	TRBV6-5	TRBJ2-7
TGTGCCACCAGTGAGGGGGGCAATCAGCCCCAGCATTTT	CATSEGGNQPQHF	TRBV24-1	TRBJ1-5
TGTGCCAGCAGGACAGTGCACACTGAAGCTTTCTTT	CASRTVHTEAFF	TRBV3-1	TRBJ1-1
TGCGCCAGCAGCCAAGGGGGGGGGGGCAATCAGCCCCAGCATTTT	CASSQGGGGNQPQHF	TRBV4-3	TRBJ1-5
TGCAGTGCTAGCCACAGGGGCGGCTACGAGCAGTACTTC	CSASHRGGYEQYF	TRBV20-1	TRBJ2-7
TGCGCCAGCAGCCAAGATGAATTGCAGGGGGCCCGGGGAGCAACTAATGAAAAACTGTTTTTT	CASSQDELQGARGATNEKLFF	TRBV4-1	TRBJ1-4
TGCGCCAGCAGCTGGACGAGTGGGACAGGCACAGATACGCAGTATTTT	CASSWTSGTGTDTQYF	TRBV5-1	TRBJ2-3
TGTGCCAGCAGAGGCGACCGGGGGGGGCGTGGCTACACCTTC	CASRGDRGGRGYTF	TRBV6-5	TRBJ1-2
TGTGCCACCAGTGACCGGGACAGGGTAGATCAGCCCCAGCATTTT	CATSDRDRVDQPQHF	TRBV24-1	TRBJ1-5
TGCGCCAGCGGGGGAGACTTCTACGAGCAGTACTTC	CASGGDFYEQYF	TRBV10-1	TRBJ2-7
TGTGCTAGTGGTTTGACAGTTAGGGGTAGGGAGGGTGATGAGTACGAGCAGTACTTC	CASGLTVRGREGDEYEQYF	TRBV12-5	TRBJ2-7
TGTGCCTGGAGTGTACAGGGGGGTAGGGATAGCAATCAGCCCCAGCATTTT	CAWSVQGGRDSNQPQHF	TRBV30	TRBJ1-5
TGTGCCAGCAGCCTAGACCACACAGATACGCAGTATTTT	CASSLDHTDTQYF	TRBV25-1	TRBJ2-3
TGTGCCAGCAGCGATCTATCGAGCTTCCAGGGGTCCGGCAATCAGCCCCAGCATTTT	CASSDLSSFQGSGNQPQHF	TRBV9	TRBJ1-5
TGTGCCAGCACCGACTCCTACGAGCAGTACTTC	CASTDSYEQYF	TRBV6-5	TRBJ2-7
TGTGCCAGCAGCAACCACACCTGGACAGGGAGAGGCCGCAATCAGCCCCAGCATTTT	CASSNHTWTGRGRNQPQHF	TRBV13	TRBJ1-5
TGTGCCAGCAGTTTATTGACAGGGGGGAGGCGATACGAGCAGTACTTC	CASSLLTGGRRYEQYF	TRBV27	TRBJ2-7
TGTGCCAGCAGCTTAGAGGGAAAGGGATTTTTTGGAAACACCATATATTTT	CASSLEGKGFFGNTIYF	TRBV7-4	TRBJ1-3
TGTGCCACCAGTGAGAACGCCCAGGGGCCTACTGAAGCTTTCTTT	CATSENAQGPTEAFF	TRBV24-1	TRBJ1-1
TGCAGTGCTGTCCACTACCCCGTGTACAATGAGCAGTTCTTC	CSAVHYPVYNEQFF	TRBV20-1	TRBJ2-1
TGTGCTAACCTCAGGGGGGGGGGGGTCCATGAGCAGTTCTTC	CANLRGGGVHEQFF	TRBV12-5	TRBJ2-1
TGTGCCAGCAGTTACTCGAGGCGGACAGGAGTTAACTATGGCTACACCTTC	CASSYSRRTGVNYGYTF	TRBV6-5	TRBJ1-2
TGTGCCATCAGTGAGTTAAGATCCTACGAGCAGTACTTC	CAISELRSYEQYF	TRBV10-3	TRBJ2-7
TGCGCCAGCAGGGGACAGGGGGAGAACACTGAAGCTTTCTTT	CASRGQGENTEAFF	TRBV10-1	TRBJ1-1
TGTGCCCATGCCGGGACAGACGAGCAGTACTTC	CAHAGTDEQYF	TRBV24-1	TRBJ2-7
TGTGCCATCTGCCGTTCCCATCGAGAAGAGACCCAGTACTTC	CAICRSHREETQYF	TRBV10-3	TRBJ2-5
TGTGCCAGCAGCGGGCCTACAAAAGCTTCTTTCGGATACGAGCAGTACTTC	CASSGPTKASFGYEQYF	TRBV9	TRBJ2-7
TGTGCCACCAGTGATTTGGCATTCCACAGGGGCCCTAACTATGGCTACACCTTC	CATSDLAFHRGPNYGYTF	TRBV24-1	TRBJ1-2
TGTGCCAGCAGGGGGGACAGGGCAAAACGCCATCAGCCCCAGCATTTT	CASRGDRAKRHQPQHF	TRBV11-2	TRBJ1-5
TGTGCCCGCAACCGGTTATTAGCGGGTGCCTACAATGAGCAGTTCTTC	CARNRLLAGAYNEQFF	TRBV30	TRBJ2-1
TGTGCCATCAGACCCGACAGGGGATTTAATGAAAAACTGTTTTTT	CAIRPDRGFNEKLFF	TRBV10-3	TRBJ1-4
TGTGCCAGCAGCTCGGTGGGTAGGATGTTCTACGAGCAGTACTTC	CASSSVGRMFYEQYF	TRBV5-4	TRBJ2-7
TGTGCCAGCAGTGACGGTACCCCGGGACAGGGACTGAAAGAGACCCAGTACTTC	CASSDGTPGQGLKETQYF	TRBV6-4	TRBJ2-5
TGTGCCATCAGTGAGACCAGACTAGGGGGGGTCTACGAGCAGTACTTC	CAISETRLGGVYEQYF	TRBV10-3	TRBJ2-7
TGTGCCAGCAGTGACGGGGGGGCAAACCTCTACGAGCAGTACTTC	CASSDGGANLYEQYF	TRBV6-4	TRBJ2-7
TGTGCCCGGACTCACACAGATACGCAGTATTTT	CARTHTDTQYF	TRBV30	TRBJ2-3
TGCAGCGCTCGCTCTAACTATGGCTACACCTTC	CSARSNYGYTF	TRBV29-1	TRBJ1-2
TGCGCCAGCAAGTACAACAGGGGCGACTATGGCTACACCTTC	CASKYNRGDYGYTF	TRBV10-1	TRBJ1-2
TGTGCCAGCAGTCCCGACGAGCCCTACAATGAGCAGTTCTTC	CASSPDEPYNEQFF	TRBV6-3	TRBJ2-1
TGTGCCAGCAGTGTCAGGGGGCGCGCAGCGAGGGAAGCTTTCTTT	CASSVRGRAAREAFF	TRBV6-5	TRBJ1-1
TGTGCCAGCAGCTTCCTGCGAGCCGGGGAGCTGTTTTTT	CASSFLRAGELFF	TRBV5-6	TRBJ2-2
TGTGCCAGCAGCGCCCTGGCAGCTGGAAACACCATATATTTT	CASSALAAGNTIYF	TRBV11-3	TRBJ1-3
TGTGCCAGCAGTTTCTACAGGGGGAAAACTGAAGCTTTCTTT	CASSFYRGKTEAFF	TRBV27	TRBJ1-1
TGTGCCAGCAGCTTAGGGGGACTTGAGGGCAACTATGGCTACACCTTC	CASSLGGLEGNYGYTF	TRBV11-1	TRBJ1-2
TGTGCTAGTGGTTTGGTACGTTTCCACCGGTCTGGGGGAATTCCCCGCGAGCAGTACTTC	CASGLVRFHRSGGIPREQYF	TRBV12-5	TRBJ2-7
TGTGCCAGCAGCTTAAAACAGAACTTCGGACAGGGAATCTCCTACGAGCAGTACTTC	CASSLKQNFGQGISYEQYF	TRBV7-4	TRBJ2-7
TGTGCCAGCAGTGCAAGGGGGGCCGGGGGTGAGCAGTTCTTC	CASSARGAGGEQFF	TRBV6-5	TRBJ2-1
TGCGCCAGCAGAGGACACGTCGTATACGAGCAGTACTTC	CASRGHVVYEQYF	TRBV10-1	TRBJ2-7
TGTGCCAGCAGCCAAGAGTGGAGACCAGGGTTTCCGGCCCAGCATTTT	CASSQEWRPGFPAQHF	TRBV3-1	TRBJ1-5
TGTGCCAGCAGCGCCGGGACAGTCCTAGCCAAAAACATTCAGTACTTC	CASSAGTVLAKNIQYF	TRBV9	TRBJ2-4
TGTGCCAGCAGCTTAGGTCCAGCCGGGACTAGCGGGTGGAAGCCGTATGAGCAGTTCTTC	CASSLGPAGTSGWKPYEQFF	TRBV7-9	TRBJ2-1
TGTGCCAGCAGCGGTTATAACAGGGGGCTGAACTTTCTCACCGGGGAGCTGTTTTTT	CASSGYNRGLNFLTGELFF	TRBV9	TRBJ2-2
TGTGCCAGCAGATTAAGGTACTTC	CASRLRYF	TRBV5-4	TRBJ2-4
TGTGCCACGTACTGCGAAGTCAGCGGGACTTGGGGCTCCTACAATGAGCAGTTCTTC	CATYCEVSGTWGSYNEQFF	TRBV24-1	TRBJ2-1
TGTGCCTGGAGTTATTGTTTTCGCAATGGCTACACCTTC	CAWSYCFRNGYTF	TRBV30	TRBJ1-2
TGCGCCAGCACTTTCCCTACCCGGTGGGCGAACACCGGGGAGCTGTTTTTT	CASTFPTRWANTGELFF	TRBV10-1	TRBJ2-2
TGTGCCAGCAGCCAAGCCCTAGCGCCGGGACAGTATGGCTACACCTTC	CASSQALAPGQYGYTF	TRBV3-1	TRBJ1-2
TGCAGTGCTACCGGGACAGAAGGCCCGAATAATTCACCCCTCCACTTT	CSATGTEGPNNSPLHF	TRBV20-1	TRBJ1-6
TGTGCCAGCAGCTGGGACAGGGGTACAGGTTATATTCCTGGCACAGATACGCAGTATTTT	CASSWDRGTGYIPGTDTQYF	TRBV13	TRBJ2-3
TGTGCCTGGAGCATGGGGACAGTGCACTATGGCTACACCTTC	CAWSMGTVHYGYTF	TRBV30	TRBJ1-2
TGTGCCCGGGACAGGGGGGGCTACACCTTC	CARDRGGYTF	TRBV9	TRBJ1-2
TGTGCCAACTCGGGGCCGATGGGAAAACTGTTTTTT	CANSGPMGKLFF	TRBV14	TRBJ1-4
TGTGCCATCAGTGAGGCCGGGACTAGCGGGAGTGTCCGGGCTAGTTACGAGCAGTACTTC	CAISEAGTSGSVRASYEQYF	TRBV10-3	TRBJ2-7
TGTGCCAGCAGTGGGGCAGTCACGGGGGGTGCAAATTCACCCCTCCACTTT	CASSGAVTGGANSPLHF	TRBV25-1	TRBJ1-6
TGTGCCAGCAGCCAGCCGGGACAGGGCATCAGCCGAGGGAGCTATGGCTACACCTTC	CASSQPGQGISRGSYGYTF	TRBV7-3	TRBJ1-2
TGTGCCAGCAGTGAAGGTAAAGCTTACTATGGCTACACCTTC	CASSEGKAYYGYTF	TRBV25-1	TRBJ1-2
TGTGCCAGCAGTCTCGGGACTAACTATGGCTACACCTTC	CASSLGTNYGYTF	TRBV27	TRBJ1-2
TGCGCCAGCAGCCAAGACCAGCCGAGGGCGCTGAACACTGAAGCTTTCTTT	CASSQDQPRALNTEAFF	TRBV4-1	TRBJ1-1
TGTGCCAGCAGGTTTGAAGACACAGGGGGTTCACCCCTCCACTTT	CASRFEDTGGSPLHF	TRBV6-5	TRBJ1-6
TGCGCCAGCAGCTTGCCCCAGGGGGAGACCCAGTACTTC	CASSLPQGETQYF	TRBV5-1	TRBJ2-5
TGTGCCAGCAGTTTATCAGGCGGCACTGAAGCTTTCTTT	CASSLSGGTEAFF	TRBV27	TRBJ1-1
TGCAGCGTCCCCTACCTGACAGTGCCCACTGAGACCCAGTACTTC	CSVPYLTVPTETQYF	TRBV29-1	TRBJ2-5
TGTGCCAGTAGTGCCGCTAGTCTCTACGAGCAGTACTTC	CASSAASLYEQYF	TRBV19	TRBJ2-7
TGCAGCGTTGAAGAGCAGCCCCCCCGGGAGTCGGGCTCTGGGGCCAACGTCCTGACTTTC	CSVEEQPPRESGSGANVLTF	TRBV29-1	TRBJ2-6
TGTGCCAGCAGTGATAGAGGCATAGCCAAAAACATTCAGTACTTC	CASSDRGIAKNIQYF	TRBV25-1	TRBJ2-4
TGTGCCAGGGTCGGGGCCGACAGGGCGAGGTTTAGCTCCTATAATTCACCCCTCCACTTT	CARVGADRARFSSYNSPLHF	TRBV6-6	TRBJ1-6
TGCGCCAGCAGCTGTGAGGGGCGTCCGGGACATGCCGGCTCCTACGAGCAGTACTTC	CASSCEGRPGHAGSYEQYF	TRBV5-1	TRBJ2-7
TGCAGTGCTCGGGGGCCCCGCCGGGACAGCCCAGGGAATAGCTCCTACAATGAGCAGTTCTTC	CSARGPRRDSPGNSSYNEQFF	TRBV20-1	TRBJ2-1
TGTGCCAACGGCGGCACTGGTCTGCCCCAGCATTTT	CANGGTGLPQHF	TRBV7-9	TRBJ1-5
TGTGCCAGCAGCCGGTTTGACAGGGGGGATGAGCAGTTCTTC	CASSRFDRGDEQFF	TRBV25-1	TRBJ2-1
TGCAGTGCTAGAGATATAAGAGCAGGGGCCGGACGTCCCTACGAGCAGTACTTC	CSARDIRAGAGRPYEQYF	TRBV20-1	TRBJ2-7
TGTGCCAGTAGTTGGGCGGGTCAAGCTTACTGGTGGGGGCATCGTTACGAGCAGTACTTC	CASSWAGQAYWWGHRYEQYF	TRBV19	TRBJ2-7
TGCAGTGCAACTGGAAACACCATATATTTT	CSATGNTIYF	TRBV20-1	TRBJ1-3
TGTGCCAGCAGCTCCTTAGGGACTAGCGGTTCGACTGAGCAGTTCTTC	CASSSLGTSGSTEQFF	TRBV5-4	TRBJ2-1
TGCGCCAGCAGTGACAGCACTAGTTCAGATACGCAGTATTTT	CASSDSTSSDTQYF	TRBV10-1	TRBJ2-3
TGTGCCTGGAGCCCCACAGGGTTAGAGACCCAGTACTTC	CAWSPTGLETQYF	TRBV30	TRBJ2-5
TGTGCCAGCAGCAGGACAGGGGTCTACGAGCAGTACTTC	CASSRTGVYEQYF	TRBV28	TRBJ2-7
TGTGCCAGCAATCCGGGACTAGCGGGACCAGAGACCCAGTACTTC	CASNPGLAGPETQYF	TRBV6-6	TRBJ2-5
TGTGCCAGCAGCCGGACTGGAAACACCATATATTTT	CASSRTGNTIYF	TRBV7-8	TRBJ1-3
TGTGCCAGCAGTGATGGGAGGCTTGGAAACATTCAGTACTTC	CASSDGRLGNIQYF	TRBV6-1	TRBJ2-4
TGTGCCAGCAGCTTTTCCCCGACGGACATCCCTAAGACGGGAAACACCATATATTTT	CASSFSPTDIPKTGNTIYF	TRBV11-2	TRBJ1-3
TGTGCCAGCAGTTACCCAAGGGGGAAATACGAGCAGTACTTC	CASSYPRGKYEQYF	TRBV6-5	TRBJ2-7
TGTGCCAGCAGAATATCAGACGGGTCCTATAATTCACCCCTCCACTTT	CASRISDGSYNSPLHF	TRBV28	TRBJ1-6
TGTGCCAGCAGTGACCAGGACAACGCAGGGGCCAACGTCCTGACTTTC	CASSDQDNAGANVLTF	TRBV6-4	TRBJ2-6
TGTGCCAGCAGACCTCTACTCCCCACAGATACGCAGTATTTT	CASRPLLPTDTQYF	TRBV5-6	TRBJ2-3
TGTGCCAGCAGTGACCGTAACAGGGGGAGGATTTTCTACGAGCAGTACTTC	CASSDRNRGRIFYEQYF	TRBV6-4	TRBJ2-7
TGTGCCAGCAGCTTAGCGCCCGGGACAGGGGTACGATACGAGCAGTACTTC	CASSLAPGTGVRYEQYF	TRBV7-9	TRBJ2-7
TGTGCCAGCAGCTTTTGGGACAGCGGGATGCTTTATCAGCCCCAGCATTTT	CASSFWDSGMLYQPQHF	TRBV5-5	TRBJ1-5
TGTGCCAGCAGTTACTCGAACGACAGGGAAGATACGCAGTATTTT	CASSYSNDREDTQYF	TRBV6-6	TRBJ2-3
TGTGCCAGCAGCTTAGACAGGGGGTTTAGGTATGGCTACACCTTC	CASSLDRGFRYGYTF	TRBV7-2	TRBJ1-2
TGTGCCAGCAGCTTTTCCGGCTATTACAATGAGCAGTTCTTC	CASSFSGYYNEQFF	TRBV7-9	TRBJ2-1
TGTGCCAGCAGCCAGGGAACTGAAGCTTTCTTT	CASSQGTEAFF	TRBV4-2	TRBJ1-1
TGCGCCAGCAGCTTTCGACTAGCGGGTACAGAGAACTCCTACGAGCAGTACTTC	CASSFRLAGTENSYEQYF	TRBV5-1	TRBJ2-7
TGTGCCAGCAGCGGAGAAGACAGGATGGATTGTCAGCCCCAGCATTTT	CASSGEDRMDCQPQHF	TRBV13	TRBJ1-5
TGTGCCAGCACAGGGTGGGTTGAGGAAGGTAGGGGCTACACCTTC	CASTGWVEEGRGYTF	TRBV12-3	TRBJ1-2
TGTGCCAGCTCTAGCCCAATACAGGGGGGATTTTACTATGGCTACACCTTC	CASSSPIQGGFYYGYTF	TRBV18	TRBJ1-2
TGTGCCAGCAGTGTTGCCAGTGGGGCAGCTAACTATGGCTACACCTTC	CASSVASGAANYGYTF	TRBV2	TRBJ1-2
TGCGCCAGCAGCAGAAGGCGAAGGATGAGGGGCTATGGCTACACCTTC	CASSRRRRMRGYGYTF	TRBV5-1	TRBJ1-2
TGCAGTACAGACTATGGCTACACCTTC	CSTDYGYTF	TRBV20-1	TRBJ1-2
TGTGCCAGCAGAGGAGAGAACACCGGGGAGCTGTTTTTT	CASRGENTGELFF	TRBV11-2	TRBJ2-2
TGTGCCAGGGGACAGGGTTCCACCTCGGACTTC	CARGQGSTSDF	TRBV27	TRBJ2-7
TGTGCCAGCAGTCGGCCGGGTCCCACGGAAGATACGCAGTATTTT	CASSRPGPTEDTQYF	TRBV6-5	TRBJ2-3
TGTGCCAGCAGCTTTCTTGCCGGGACCGGTTCGCCCCAGCATTTT	CASSFLAGTGSPQHF	TRBV7-2	TRBJ1-5
TGTGCCAGCAGCTCCGGACGTGGAGAAAAACTGTTTTTT	CASSSGRGEKLFF	TRBV7-8	TRBJ1-4
TGTGCCAGCAGTGAGGAACGGGGGCACACTGAAGCTTTCTTT	CASSEERGHTEAFF	TRBV6-4	TRBJ1-1
TGCGCCAGCAGTGAGGTTCGGACAGGGCTAACTGAAGCTTTCTTT	CASSEVRTGLTEAFF	TRBV10-1	TRBJ1-1
TGTGCCAGGGGCCGGGCCCCTTCGTACTTC	CARGRAPSYF	TRBV18	TRBJ2-5
TGTGCCAGCAGTTACTGGTACGAGCAGTACTTC	CASSYWYEQYF	TRBV6-3	TRBJ2-7
TGTGCCAGCAGTGGACAGGGAGTATGGAACACTGAAGCTTTCTTT	CASSGQGVWNTEAFF	TRBV28	TRBJ1-1
TGTGCCTCCGTTAGGCAAATGAACACTGAAGCTTTCTTT	CASVRQMNTEAFF	TRBV19	TRBJ1-1
TGTGCCAGCTCTAGCACCACCGGGGAGCTGTTTTTT	CASSSTTGELFF	TRBV6-1	TRBJ2-2
TGTGCTAGTGGCCCAGAGGGATCCGAGCAGTACTTC	CASGPEGSEQYF	TRBV12-5	TRBJ2-7
TGTGCCAGCAGCGTGGCGGGAGCGAGCTCCTACAATGAGCAGTTCTTC	CASSVAGASSYNEQFF	TRBV7-9	TRBJ2-1
TGTGCCAGCTATCCTCAGGGGGCTGCGAACAGCTCCTACGAGCAGTACTTC	CASYPQGAANSSYEQYF	TRBV6-1	TRBJ2-7
TGTGCCAGCAGCCTTACCAGAGTTGCGCACGAGCAGTACTTC	CASSLTRVAHEQYF	TRBV12-3	TRBJ2-7
TGCGCCAGCAGCTCTCGCCGATACAATGAGCAGTTCTTC	CASSSRRYNEQFF	TRBV5-1	TRBJ2-1
TGTGCCAGCAGCTGGAGTAACACCTTC	CASSWSNTF	TRBV11-3	TRBJ1-2
TGTGCCATCCGAAGAAGCTCCTACGAGCAGTACTTC	CAIRRSSYEQYF	TRBV6-4	TRBJ2-7
TGCGCCAGCAGACGGGGGGGGGCTCTCCTCTACAATGAGCAGTTCTTC	CASRRGGALLYNEQFF	TRBV10-1	TRBJ2-1
TGCGCCAGCACCCCCGACAGACGAGATCCAAATCAGCCCCAGCATTTT	CASTPDRRDPNQPQHF	TRBV5-1	TRBJ1-5
TGTGCCTGGAGTGTACCCCAAAGAGGGGGGGGCAAAAGAGGAGAGCAGTACTTC	CAWSVPQRGGGKRGEQYF	TRBV30	TRBJ2-7
TGTGCCACATCCAGGACTTATTCACCCCTCCACTTT	CATSRTYSPLHF	TRBV14	TRBJ1-6
TGCAGTGCTAGGACAGGGGCAAAAGGCTACACCTTC	CSARTGAKGYTF	TRBV20-1	TRBJ1-2
TGTGCCAGCAGTGACGTGACCCCGTATGAGCAGTTCTTC	CASSDVTPYEQFF	TRBV6-4	TRBJ2-1
TGTGCCAATCACCCGTGGGGGGCCGCCAAAAACATTCAGTACTTC	CANHPWGAAKNIQYF	TRBV10-3	TRBJ2-4
TGTGCCAGCAGGAGGGGCCGGGACAGGGCGCACTGGACAGGGAATCAGCCCCAGCATTTT	CASRRGRDRAHWTGNQPQHF	TRBV27	TRBJ1-5
TGTGCCACATATCCCTTGCCAGTACAGGGGTATACGCAGTATTTT	CATYPLPVQGYTQYF	TRBV15	TRBJ2-3
TGTTGCCAGTCCCCTAAAAGGGGTCCGATGTTAGCCAAAAACATTCAGTACTTC	CCQSPKRGPMLAKNIQYF	TRBV10-3	TRBJ2-4
TGTGCCAGCAGTTTAATAGCCGAAAAACTGTTTTTT	CASSLIAEKLFF	TRBV12-3	TRBJ1-4
TGTGCCTGGAGTTCGGGGGGCGCGCAAGATACGCAGTATTTT	CAWSSGGAQDTQYF	TRBV30	TRBJ2-3
TGTGCCAGCAGTGAACCTGCGGCGAACACTGAAGCTTTCTTT	CASSEPAANTEAFF	TRBV6-1	TRBJ1-1
TGTGCCAGCAGCTTACCCCAGGCTGAAGCTTTCTTT	CASSLPQAEAFF	TRBV11-3	TRBJ1-1
TGCGCCCCGGGGGGGCAACCAGATACGCAGTATTTT	CAPGGQPDTQYF	TRBV5-1	TRBJ2-3
TGTGCCAGCAGCTTAACAGGGGACACTGAAGCTTTCTTT	CASSLTGDTEAFF	TRBV7-3	TRBJ1-1
TGCAGTGCTAGTCTAGATAATTCACCCCTCCACTTT	CSASLDNSPLHF	TRBV20-1	TRBJ1-6
TGTGCCAGCAGAAGGAGATGTCAGGGGGCCTACGAGCAGTACTTC	CASRRRCQGAYEQYF	TRBV7-3	TRBJ2-7
TGTGCCAGTTCTACCACCGGGACAGCCTATGGCTACACCTTC	CASSTTGTAYGYTF	TRBV4-2	TRBJ1-2
TGTGCCAGCAGTGAGGGGGGGCGAAAGAACACCGGGGAGCTGTTTTTT	CASSEGGRKNTGELFF	TRBV6-4	TRBJ2-2
TGCAGTGCTAGAGATAGGTGCCGGGACAGGGAGAAGAACACTGAAGCTTTCTTT	CSARDRCRDREKNTEAFF	TRBV20-1	TRBJ1-1
TGTGCCAGCAGCGCCTGGGGAGGACGCAGGAAGAATAGCAATCAGCCCCAGCATTTT	CASSAWGGRRKNSNQPQHF	TRBV13	TRBJ1-5
TGCGCCAGGTACTCTTCCAAGGCTGAGCAGTTCTTC	CARYSSKAEQFF	TRBV10-1	TRBJ2-1
TGTGCCAGCAGTTTAAAGGAGGGGGGGGAGGACAGAGAAAAACTGTTTTTT	CASSLKEGGEDREKLFF	TRBV28	TRBJ1-4
TGCAGTGCTAGTACCCAGGACGAGATCTATGGCTACACCTTC	CSASTQDEIYGYTF	TRBV20-1	TRBJ1-2
TGTGCCAGCAGAGTGGGACACACCGGGGAGCTGTTTTTT	CASRVGHTGELFF	TRBV6-5	TRBJ2-2
TGTGGTTGGCCAGGGACTTACTACGAGCAGTACTTC	CGWPGTYYEQYF	TRBV24-1	TRBJ2-7
TGTGCCAGCAGCGGTCGGGGGGGCTACACCTTC	CASSGRGGYTF	TRBV9	TRBJ1-2
TGTGCCAGCACATCCTACGAGCAGTACTTC	CASTSYEQYF	TRBV7-2	TRBJ2-7
TGTGCCAGCAGCTCCCTCCCGGACGTTCCAAATGGCTACACCTTC	CASSSLPDVPNGYTF	TRBV5-4	TRBJ1-2
TGTGCCACCAGACCCAGGAGGGCTCTTGAGACCCAGTACTTC	CATRPRRALETQYF	TRBV24-1	TRBJ2-5
TGTGCCAGCAGTGACTCCCGGGCTTGGAGAGGGACAGATACGCAGTATTTT	CASSDSRAWRGTDTQYF	TRBV6-4	TRBJ2-3
TGTGCCTGGAGTGTAAGGGGGGGGCTATCAGCCTACGAGCAGTACTTC	CAWSVRGGLSAYEQYF	TRBV30	TRBJ2-7
TGCAGTGCCGGAGTCCCGGGGTGTGATCACACCTTC	CSAGVPGCDHTF	TRBV20-1	TRBJ1-2
TGTGCCAGCAGCCCCACCCCCAAGGACAGGGTTAACACTGAAGCTTTCTTT	CASSPTPKDRVNTEAFF	TRBV6-5	TRBJ1-1
TGTGCCAGCAGTGAAGCGGGTCTACGGAACATTCAGTACTTC	CASSEAGLRNIQYF	TRBV6-1	TRBJ2-4
TGCAGTGCTAGTAAAAAATACAGAAGCACAGATACGCAGTATTTT	CSASKKYRSTDTQYF	TRBV20-1	TRBJ2-3
TGTGCCAGCAGCCAAGAGGTACAAGCCAAAAACATTCAGTACTTC	CASSQEVQAKNIQYF	TRBV3-1	TRBJ2-4
TGCAGTGCTCGGAAGGACGGACAGGTTTTACCTGAAGCTTTCTTT	CSARKDGQVLPEAFF	TRBV20-1	TRBJ1-1
TGTGCCAGCAGCCAGATCGAGGGGGGAGTTGACTATGGCTACACCTTC	CASSQIEGGVDYGYTF	TRBV7-8	TRBJ1-2
TGTGCCAGCAGATTTAATTGGACTAAAGGCGAAAAACTGTTTTTT	CASRFNWTKGEKLFF	TRBV12-4	TRBJ1-4
TGTGCCAGCAGTGGACGGAATGAGCAGTTCTTC	CASSGRNEQFF	TRBV6-4	TRBJ2-1
TGTGCCAGCAGTGACTCCCCCACAGAGGCAAGCTCTGGAAACACCATATATTTT	CASSDSPTEASSGNTIYF	TRBV6-4	TRBJ1-3
TGTGCCAGCACCCGGACTAGCGTGACAGATACGCAGTATTTT	CASTRTSVTDTQYF	TRBV6-4	TRBJ2-3
TGTGCCACCAGTGGCCTAAAGCACAATGAGCAGTTCTTC	CATSGLKHNEQFF	TRBV24-1	TRBJ2-1
TGTGCCTCGGGACGAAGCAGCACAGATACGCAGTATTTT	CASGRSSTDTQYF	TRBV24-1	TRBJ2-3
TGTGCCAGCAGCGTAGCCGGGGAACCGAACACCGGGGAGCTGTTTTTT	CASSVAGEPNTGELFF	TRBV9	TRBJ2-2
TGTGCCATGTCTGGGACGGCAAGGAACGAGCAGTACTTC	CAMSGTARNEQYF	TRBV10-3	TRBJ2-7
TGTGCCAGCAGTTTGTCGAAAGCCACGTACTATAATTCACCCCTCCACTTT	CASSLSKATYYNSPLHF	TRBV12-4	TRBJ1-6
TGTGCCAGCAGCTTGACCTCCTCACAGCCCGGGGACACTGAAGCTTTCTTT	CASSLTSSQPGDTEAFF	TRBV5-4	TRBJ1-1
TGTGCCAGCAGCTTGGTTGACACAGATACGCAGTATTTT	CASSLVDTDTQYF	TRBV5-4	TRBJ2-3
TGTGCCAGCAGCCCGACGCCGACTGGGGGGGCCAGCTCCTACGAGCAGTACTTC	CASSPTPTGGASSYEQYF	TRBV7-3	TRBJ2-7
TGCAGTGCTAGAGCCGGGGGGGGGTGGTATATAAGACACAGGACAGATACGCAGTATTTT	CSARAGGGWYIRHRTDTQYF	TRBV20-1	TRBJ2-3
TGTGCCAGCAGCTTGACTACCCGGGGGGGCCTTAAGGCCTACGAGCAGTACTTC	CASSLTTRGGLKAYEQYF	TRBV5-6	TRBJ2-7
TGTGCCAGCAGCTATGGGGGGTCCACTGAAGCTTTCTTT	CASSYGGSTEAFF	TRBV6-3	TRBJ1-1
TGTGCCAAGAGGGACAGGGAGTTTTTCTTCTACGAGCAGTACTTC	CAKRDREFFFYEQYF	TRBV6-3	TRBJ2-7
TGTGCCACCGCGGACAGAGAAAAACTGTTTTTT	CATADREKLFF	TRBV24-1	TRBJ1-4
TGTGCCAGCAGATACCCGAAAAGGGTGAACACTGAAGCTTTCTTT	CASRYPKRVNTEAFF	TRBV6-1	TRBJ1-1
TGTGCCAGCAGCTCCGGGGGACAGATAACGGTCTACGAGCAGTACTTC	CASSSGGQITVYEQYF	TRBV7-9	TRBJ2-7
TGTGCCAGCAGCTACCAAAAAGAGACCCAGTACTTC	CASSYQKETQYF	TRBV7-2	TRBJ2-5
TGTGCCAGTAGTACCTGCGGGACTAGCGGGGGGGCCACGTCTGGTGGAGCTGAGCAGTTCTTC	CASSTCGTSGGATSGGAEQFF	TRBV19	TRBJ2-1
TGTGCCAAAGTTTGTACCGGGGAGCTGTTTTTT	CAKVCTGELFF	TRBV24-1	TRBJ2-2
TGTGCCAGCAGTGATATCAACACCTGCCGGGGAGACGCGGATACGCAGTATTTT	CASSDINTCRGDADTQYF	TRBV27	TRBJ2-3
TGTGCCAGCAGTGAACCCCGGCATTGCAATCAGCCCCAGCATTTT	CASSEPRHCNQPQHF	TRBV25-1	TRBJ1-5
TGCGCCAGCACCCGGACCTGGACAGGGCCTCTGAGGCCCTACGAGCAGTACTTC	CASTRTWTGPLRPYEQYF	TRBV4-1	TRBJ2-7
TGTGCCAGCAGTTCCCTAGGCTCCCCTAGCGGGTCAGGGGGTAACATATGGACAGAGACCCAGTACTTC	CASSSLGSPSGSGGNIWTETQYF	TRBV12-3	TRBJ2-5
TGTGCCACGGTCGAGGGATTGAACACCGGGGAGCTGTTTTTT	CATVEGLNTGELFF	TRBV24-1	TRBJ2-2
TGTGCCAGCAGCTTAGGGGGGCGCTCTGAAACCTGGTACGAGCAGTACTTC	CASSLGGRSETWYEQYF	TRBV7-3	TRBJ2-7
TGCGCCAGCATCGGGGGGGGGGACAATGAGCAGTTCTTC	CASIGGGDNEQFF	TRBV5-1	TRBJ2-1
TGTGCCAGCAGCTTACCTCTAGGACAGGGGGCGGGGGCCCAGAAGAATGAAAAACTGTTTTTT	CASSLPLGQGAGAQKNEKLFF	TRBV11-2	TRBJ1-4
TGCAGTGCCGAACTAGCGGGAGGGGAGACCCAGTACTTC	CSAELAGGETQYF	TRBV20-1	TRBJ2-5
TGCAGCGTTGGGGAGGGAAGATCTTCTTGGGGCTACGAGCAGTACTTC	CSVGEGRSSWGYEQYF	TRBV29-1	TRBJ2-7
TGTGCCATCAGTGAGGGGGGTGGGGGACGCGTGAACACCGGGGAGCTGTTTTTT	CAISEGGGGRVNTGELFF	TRBV10-3	TRBJ2-2
TGTGCCAGCAGTTATGATTGTCTAGCGGGTGGCACTAACAATGAGCAGTTCTTC	CASSYDCLAGGTNNEQFF	TRBV6-3	TRBJ2-1
TGCGCCAGCAGCTTGGGCACCGGGACAGAAGGCTACACCTTC	CASSLGTGTEGYTF	TRBV5-1	TRBJ1-2
TGTGCCAGCAGCTCTGTTTGGACAGACGACTACGAGCAGTACTTC	CASSSVWTDDYEQYF	TRBV5-8	TRBJ2-7
TGTGCCAGCAGTGACTCTGCGGTGAACACTGAAGCTTTCTTT	CASSDSAVNTEAFF	TRBV6-4	TRBJ1-1
TGTGCCAGCAGCTTAACTGTCCCGGGACAGGGGCAGCCCCAGCATTTT	CASSLTVPGQGQPQHF	TRBV7-9	TRBJ1-5
TGTGCCAGCAGACCTGAACTTTTGTGGCGGGGGGGGTCTAACTCTGGGGCCAACGTCCTGACTTTC	CASRPELLWRGGSNSGANVLTF	TRBV27	TRBJ2-6
TGTGCCAGCAGTGAATGCAGGGATCTAGGGTACTATGGCTACACCTTC	CASSECRDLGYYGYTF	TRBV6-1	TRBJ1-2
TGTGCCAGCGGATCCTCCCCCACAGGGGAAGTGGGGACTGAAGCTTTCTTT	CASGSSPTGEVGTEAFF	TRBV27	TRBJ1-1
TGCAGTGCCCCAGGGATGATAGGCAATCAGCCCCAGCATTTT	CSAPGMIGNQPQHF	TRBV20-1	TRBJ1-5
TGTGCCAGCAGCTTAGACTACGGGGGGGGCGAGCAGTACTTC	CASSLDYGGGEQYF	TRBV7-6	TRBJ2-7
TGTGCAGGGGGGGCAAAGCAGTTCTTC	CAGGAKQFF	TRBV7-9	TRBJ2-1
TGTGCCAGCAGCTGCAAGGGGAACTATGGCTACACCTTC	CASSCKGNYGYTF	TRBV13	TRBJ1-2
TGTGCCAGCAGCGTTGGCGGTGGACAGGGGGGGGGCGACACTGAAGCTTTCTTT	CASSVGGGQGGGDTEAFF	TRBV14	TRBJ1-1
TGTGCCAGCAGCTTAGGGTACCGGAGGCAGTCACCCCTCCACTTT	CASSLGYRRQSPLHF	TRBV7-6	TRBJ1-6
TGCAGCGGCAGGCAACACAGGGTTCCGGGCAATCAGCCCCAGCATTTT	CSGRQHRVPGNQPQHF	TRBV29-1	TRBJ1-5
TGCGCCAGCAGCTACCCGATAGCTAGAGGCCGCTACGAGCAGTACTTC	CASSYPIARGRYEQYF	TRBV5-1	TRBJ2-7
TGTGCCAGCAGTTGGGGGGCTGAAGCTTTCTTT	CASSWGAEAFF	TRBV6-6	TRBJ1-1
TGTGCCAGCAGTAAGCCAGGAAACACCATATATTTT	CASSKPGNTIYF	TRBV27	TRBJ1-3
TGTGCCAGCTCCGCTCGATACGAGCAGTACTTC	CASSARYEQYF	TRBV27	TRBJ2-7
TGTGCCAGCAGTTTGGATGGATCCAAAAATAATAACTATGGCTACACCTTC	CASSLDGSKNNNYGYTF	TRBV27	TRBJ1-2
TGTGCCAGCTCACCAACAGGGGGGGGAGGCTACGAGCAGTACTTC	CASSPTGGGGYEQYF	TRBV18	TRBJ2-7
TGTGCCAGCAGTGAGGTTACAGGGCCATTGAACACCGGGGAGCTGTTTTTT	CASSEVTGPLNTGELFF	TRBV6-4	TRBJ2-2
TGTGCCAGCAGTTACCCCGAAGCCAATGAGCAGTTCTTC	CASSYPEANEQFF	TRBV6-5	TRBJ2-1
TGTGCTAGCAGCGGAGAGGCCCAGCCCCAGCATTTT	CASSGEAQPQHF	TRBV7-7	TRBJ1-5
TGTGGGTTTTCAATGAACACTGAAGCTTTCTTT	CGFSMNTEAFF	TRBV2	TRBJ1-1
TGTGCCAGCAGTTATACCCAGGACGACAGGGGGGGACCTGAAGCTTTCTTT	CASSYTQDDRGGPEAFF	TRBV6-5	TRBJ1-1
TGTGCCAGCAGCCAGACAGGGTTTCTGGCGGGGACCGGGGAGCTGTTTTTT	CASSQTGFLAGTGELFF	TRBV9	TRBJ2-2
TGTGCCAGCACCCGGGGGTCCTGGGAAGCTTTCTTT	CASTRGSWEAFF	TRBV5-4	TRBJ1-1
TGTGCCAGCTGTGACAGGGGAACCCAGACCGGGGAGCTGTTTTTT	CASCDRGTQTGELFF	TRBV19	TRBJ2-2
TGCAAACGTATTAACTATGGCTACACCTTC	CKRINYGYTF	TRBV20-1	TRBJ1-2
TGTGCCAGCAGCGGGACGGGAAACTTGGATCAGCCCCAGCATTTT	CASSGTGNLDQPQHF	TRBV7-9	TRBJ1-5
TGTGCCAGCAGCGAGACAGTACGGAACACCGGGGAGCTGTTTTTT	CASSETVRNTGELFF	TRBV9	TRBJ2-2
TGTGCCAGCAGCCAAGATCCATCCGCGTTAGGCTCCTACGAGCAGTACTTC	CASSQDPSALGSYEQYF	TRBV14	TRBJ2-7
TGTGCCAGCAGTTACTGGCCGACAGGCAATCAGCCCCAGCATTTT	CASSYWPTGNQPQHF	TRBV6-5	TRBJ1-5
TGTGCCAGCAGACGACCGCTAGCGGGTAAATCCCCGGACTACGAGCAGTACTTC	CASRRPLAGKSPDYEQYF	TRBV28	TRBJ2-7
TGTGCCAGCAGCTTAGGGGGGACTAGCGGGCGAGTCGGGGAGCTGTTTTTT	CASSLGGTSGRVGELFF	TRBV7-8	TRBJ2-2
TGCGCCAGCAGCTTGGCCACGGCGGGAGCGTGTGAAAAACTGTTTTTT	CASSLATAGACEKLFF	TRBV5-1	TRBJ1-4
TGTGCCAGCAGGACAACCGATGAAAAACTGTTTTTT	CASRTTDEKLFF	TRBV7-9	TRBJ1-4
TGTGCCAGCAGCACTGACGGCCCTAATGAAAAACTGTTTTTT	CASSTDGPNEKLFF	TRBV7-6	TRBJ1-4
TGCAGTGCTAGAGCCAGTCCGTACCAATACAATGAGCAGTTCTTC	CSARASPYQYNEQFF	TRBV20-1	TRBJ2-1
TGTGCCTGGAGTGTAAATAGAGGACTAGCGGGGGGGGCAGAGACCCAGTACTTC	CAWSVNRGLAGGAETQYF	TRBV30	TRBJ2-5
TGTGCCATCAGTGGGGGATCCGGGACAGGGGCGACTTCCTACAATGAGCAGTTCTTC	CAISGGSGTGATSYNEQFF	TRBV10-3	TRBJ2-1
TGTGCCAGCAGCTTGTGGGGGACGGGCTACGAGCAGTACTTC	CASSLWGTGYEQYF	TRBV5-6	TRBJ2-7
TGTGCCAGCAGCTTAGCGTCTCCAGGGGGATCCTTATGCAATCAGCCCCAGCATTTT	CASSLASPGGSLCNQPQHF	TRBV11-2	TRBJ1-5
TGTGCCAGCAGTACGGGAATTTCCTATAATTCACCCCTCCACTTT	CASSTGISYNSPLHF	TRBV14	TRBJ1-6
TGTGCCGCGGGGGAGGGTACTACTTCTCCTGGCTACACCTTC	CAAGEGTTSPGYTF	TRBV10-3	TRBJ1-2
TGTGCCAGCAGCCAAGCACGGTTCTGGGGCCAGCAGCCCCAGCATTTT	CASSQARFWGQQPQHF	TRBV14	TRBJ1-5
TGTGCCAGCAGAGAGAACCGACTAGCGGCAACCTACAATGAGCAGTTCTTC	CASRENRLAATYNEQFF	TRBV28	TRBJ2-1
TGTGCCAGCAGTTTACTGGACGCTGAAGCTTTCTTT	CASSLLDAEAFF	TRBV27	TRBJ1-1
TGTGCCAGCAGCCATGGAGGTGGCCAGAGCTCTGGAAACACCATATATTTT	CASSHGGGQSSGNTIYF	TRBV3-1	TRBJ1-3
TGTGCCAGCAGTTTAGCCGCGCGCGGCCAAGAAGTCCTAATGGGGGAGTATTGTCTTGAGCAGTACTTC	CASSLAARGQEVLMGEYCLEQYF	TRBV27	TRBJ2-7
TGTGCCAGCAGCTTAGCGCAGGCTCCTGGAAACACCATATATTTT	CASSLAQAPGNTIYF	TRBV7-8	TRBJ1-3
TGTGCCAGCAGCAAGGGGGGCTGGGGGGCCGGGGAGCTGTTTTTT	CASSKGGWGAGELFF	TRBV5-8	TRBJ2-2
TGTGCCAGCAGCATGCAGGCAGAAATCATTTGCGAGCAGTACTTC	CASSMQAEIICEQYF	TRBV7-9	TRBJ2-7
TGTGCCACCAGTGATTCCAGGGCCTATGAAGCTTTCTTT	CATSDSRAYEAFF	TRBV24-1	TRBJ1-1
TGTGCCAGCAGTTACTTGATCCGAGCAGGAAAATATAATTCACCCCTCCACTTT	CASSYLIRAGKYNSPLHF	TRBV6-5	TRBJ1-6
TGTGCCAGCAGTTGGTGGAAGATAGCGGGTTTGGTCACCGGGGAGCTGTTTTTT	CASSWWKIAGLVTGELFF	TRBV27	TRBJ2-2
TGTGCCAGCAGCCAAGAGGCGCAGGGGCCCGAATCGGTGAACACTGAAGCTTTCTTT	CASSQEAQGPESVNTEAFF	TRBV14	TRBJ1-1
TGCGCCAGCAGTGTGACCTTTGGCAGCGAGATTGGTGGGGCCAACGTCCTGACTTTC	CASSVTFGSEIGGANVLTF	TRBV10-1	TRBJ2-6
TGTGCCAGCAGTGAAGGTCCGGGACAGGGGAGCACTAATTCACCCCTCCACTTT	CASSEGPGQGSTNSPLHF	TRBV2	TRBJ1-6
TGCGCCAGTACAGGGGGGCTGCCCCCCATCGGGGCTTTCTTT	CASTGGLPPIGAFF	TRBV10-1	TRBJ1-1
TGTGCCAGCAGCGTCGGCGGGAGTGAGAGCTCCTACAATGAGCAGTTCTTC	CASSVGGSESSYNEQFF	TRBV9	TRBJ2-1
TGTGCCAGCAGCCCAGACACTAGCGGGAGGGCTGCTCATGAGCAGTTCTTC	CASSPDTSGRAAHEQFF	TRBV13	TRBJ2-1
TGTGCCAGCAGTGAAACTTCCGGGACTAGCGGGGGGCGTTCTAGCACAGATACGCAGTATTTT	CASSETSGTSGGRSSTDTQYF	TRBV2	TRBJ2-3
TGTGCCAGCAGCTTGGCGGAGGACAGGGGTCGACGAATCTCGCTTAACACCGGGGAGCTGTTTTTT	CASSLAEDRGRRISLNTGELFF	TRBV5-6	TRBJ2-2
TGTGCCAGCGAAGGGGACAGGGGGCCCTACGAGCAGTACTTC	CASEGDRGPYEQYF	TRBV6-4	TRBJ2-7
TGTGCCAGGGCGGACAGGGGTGCTAGCTCCTACAATGAGCAGTTCTTC	CARADRGASSYNEQFF	TRBV7-4	TRBJ2-1
TGTGCCAGCAGTGGGCGCGGGCTTCCCGCAATGTCTAGGCCCTACAATGAGCAGTTCTTC	CASSGRGLPAMSRPYNEQFF	TRBV6-4	TRBJ2-1
TGCGCCAGCAGCCAAGGAAAAGTGTACAATGAGCAGTTCTTC	CASSQGKVYNEQFF	TRBV4-1	TRBJ2-1
TGTGCCAGCAGCGGGGGGACGGGCTACACCTTC	CASSGGTGYTF	TRBV7-3	TRBJ1-2
TGTGCCAGCAGTCGACCCGGACTAGCGGGAAGTAAGAGTCATGAGCAGTTCTTC	CASSRPGLAGSKSHEQFF	TRBV2	TRBJ2-1
TGTGCCAGCAGCCCCCGTGGGACGGACACTGAAGCTTTCTTT	CASSPRGTDTEAFF	TRBV3-1	TRBJ1-1
TGTGCCAGGGGGCCCTACGAGCAGTACTTC	CARGPYEQYF	TRBV25-1	TRBJ2-7
TGTGCCAGCAGCCACCCCCTCGGGACAGGAGCGGAGCTGTTTTTT	CASSHPLGTGAELFF	TRBV4-2	TRBJ2-2
TGTGCCAGCAGCCAAGGGTGGCCCCAGCATTTT	CASSQGWPQHF	TRBV13	TRBJ1-5
TGCAGCGTACTAGACCTTGATTACGAGCAGTACTTC	CSVLDLDYEQYF	TRBV29-1	TRBJ2-7
TGCGCCAGCAGTGACAACCCTCATTCAGGAGGGAACACCATATATTTT	CASSDNPHSGGNTIYF	TRBV10-1	TRBJ1-3
TGTGCCAGCAGTGAACACAGGCAGGGGGGTAACGAGCAGTACTTC	CASSEHRQGGNEQYF	TRBV2	TRBJ2-7
