TGTGCCAGCAGCTCCACAGGGGGCGTTAACACCATATATTTT	CASSSTGGVNTIYF	TRBV5-4	TRBJ1-3
TGCGCCAGCAGCCAACCCCCGGGACAGGGCATTTATGGCTACACCTTC	CASSQPPGQGIYGYTF	TRBV4-1	TRBJ1-2
TGTGCCAGCAGTTGGACTAGGAGGGGGGCGGCCCACGAGCAGTACTTC	CASSWTRRGAAHEQYF	TRBV6-8	TRBJ2-7
TGTGCCTGGAGCCCCCCCCACGACAGGGCGAGGCTGTGCGAGCAGTACTTC	CAWSPPHDRARLCEQYF	TRBV30	TRBJ2-7
TGCGCCAGCAGCCAAGATAAACAGCAACGGGGTTATGGCTACACCTTC	CASSQDKQQRGYGYTF	TRBV4-1	TRBJ1-2
TGTGCCACCAGTGATAAGTCCGTCAGGGGAGCCTACGAGCAGTACTTC	CATSDKSVRGAYEQYF	TRBV24-1	TRBJ2-7
TGTGCCACCAGTGAGCTAAAAAGGGAGGACAGTAGAAGCAATCAGCCCCAGCATTTT	CATSELKREDSRSNQPQHF	TRBV24-1	TRBJ1-5
TGTGCCAGCAGTCTAGCGGGTACCTACGAGCAGTACTTC	CASSLAGTYEQYF	TRBV25-1	TRBJ2-7
TGTGCCACCAGTGATTTTTGGTATCCCGGGACAGGTGGGAACGAGCAGTACTTC	CATSDFWYPGTGGNEQYF	TRBV24-1	TRBJ2-7
TGTGCCAGCAGTTTAGTACAGGGGGGTTATGGAAACACCATATATTTT	CASSLVQGGYGNTIYF	TRBV12-4	TRBJ1-3
TGCGCCAGCTTTCTAGTAGAGACCCAGTACTTC	CASFLVETQYF	TRBV10-1	TRBJ2-5
TGTGCCAGCAGTTACTTCATCTGGACAGGGGGCCCTTCCTACGAGCAGTACTTC	CASSYFIWTGGPSYEQYF	TRBV6-5	TRBJ2-7
TGTGCCAGCAGTGCCCGACAGGGCGAGGAGTATTTT	CASSARQGEEYF	TRBV6-3	TRBJ2-3
TGTGCCAGCAGTTATCGATCGGGTAGCAATGAGCAGTTCTTC	CASSYRSGSNEQFF	TRBV6-3	TRBJ2-1
TGCGCCAGCAGAGTTGTCCAGGGATCCACTGAAGCTTTCTTT	CASRVVQGSTEAFF	TRBV5-1	TRBJ1-1
TGTGCCAGCAGGGGGGCTGGGGTTCTCAATACAGATACGCAGTATTTT	CASRGAGVLNTDTQYF	TRBV6-1	TRBJ2-3
TGTGCCAGCAGTTACCCCGGGACAGGGTACGAGCAGTACTTC	CASSYPGTGYEQYF	TRBV6-5	TRBJ2-7
TGTGCCAGCAGCGCCCGGGACAGTCCGGGATGGGGCTGGGTAGGGGGCTATGGCTACACCTTC	CASSARDSPGWGWVGGYGYTF	TRBV6-2	TRBJ1-2
TGCAGTGCGATTGGGACAGGGGTCCGCCAAGAGACCCAGTACTTC	CSAIGTGVRQETQYF	TRBV20-1	TRBJ2-5
TGTGCCAGCAGCTCGCAGGGCGGAGGTCTTCACTACGAGCAGTACTTC	CASSSQGGGLHYEQYF	TRBV5-4	TRBJ2-7
TGCGCCAGCAGCCAAGATCGGTCGGACAGGGCACGCACAGATACGCAGTATTTT	CASSQDRSDRARTDTQYF	TRBV4-1	TRBJ2-3
TGTGCCAGCAGTGAAGATCTCCCCGGGGACTCGGTGGCCTACGAGCAGTACTTC	CASSEDLPGDSVAYEQYF	TRBV6-1	TRBJ2-7
TGCAGCGTTGACTTAGCGGGTGCCCCCTACAATGAGCAGTTCTTC	CSVDLAGAPYNEQFF	TRBV29-1	TRBJ2-1
TGTGTCCAGCTTGGGAGCACTGAAGCTTTCTTT	CVQLGSTEAFF	TRBV6-4	TRBJ1-1
TGTGCCAGCAGCTTGCAGGAACTTTACACCGGGGAGCTGTTTTTT	CASSLQELYTGELFF	TRBV5-6	TRBJ2-2
TGCGCCAGCAGCCAAGAACTAGCGGGAGCAACGAACGAGCAGTACTTC	CASSQELAGATNEQYF	TRBV4-3	TRBJ2-7
TGTGCCAGCAGCCCAGTGATGTCGTATAGCAATCAGCCCCAGCATTTT	CASSPVMSYSNQPQHF	TRBV28	TRBJ1-5
TGTGCCATAACCGGGCGGATGGGGGGAGGAAACACCTTC	CAITGRMGGGNTF	TRBV5-5	TRBJ1-2
TGTGCCAGCAGCTTTAGGACAGGGTGTGAAAAACTGTTTTTT	CASSFRTGCEKLFF	TRBV5-5	TRBJ1-4
TGTGCCAGCAGCACCGTGGACGACGGGAGTAGCAGCATAGCCCGATGGAACTATGGCTACACCTTC	CASSTVDDGSSSIARWNYGYTF	TRBV7-3	TRBJ1-2
TGTGCCAGCAGTGAAGGTAGGGGAGGGGCCGCCAAAAACATTCAGTACTTC	CASSEGRGGAAKNIQYF	TRBV6-1	TRBJ2-4
TGTGCCAGCAGCTTAAATCTACGGAGGGGGTACACCTTC	CASSLNLRRGYTF	TRBV7-3	TRBJ1-2
TGTGCCAGCACTGAAGAGGACAGGGGGCTTCCTGAAGCTTTCTTT	CASTEEDRGLPEAFF	TRBV2	TRBJ1-1
TGTGCCACGGGACAGGAGCGGAACACTGAAGCTTTCTTT	CATGQERNTEAFF	TRBV10-3	TRBJ1-1
TGTGCCAGCAGTAGTCGAGAAAGGGAATCCTACAATGAGCAGTTCTTC	CASSSRERESYNEQFF	TRBV6-6	TRBJ2-1
TGTGCCAGCAGCGGTACGACCATATTAAATGAGCAGTTCTTC	CASSGTTILNEQFF	TRBV5-6	TRBJ2-1
TGTGCCAGCAGCCAACACCCTGAGCATTCAGGGAGTTCCTACAATGAGCAGTTCTTC	CASSQHPEHSGSSYNEQFF	TRBV9	TRBJ2-1
TGTGCCAGCAGCGTCCCGGTTAATGGGGGGACCGGTAACGATAACATTCAGTACTTC	CASSVPVNGGTGNDNIQYF	TRBV13	TRBJ2-4
TGTGCCAGCAGGAACCGCCTAAAAGACGGAAACACCATATATTTT	CASRNRLKDGNTIYF	TRBV6-4	TRBJ1-3
TGTGCCAGCAGCCAAGAAATGACAGGGGCCGATAGTAGCTCCTACGAGCAGTACTTC	CASSQEMTGADSSSYEQYF	TRBV14	TRBJ2-7
TGCGCCAGCAGCTTAACCCAGGGGGGGGGCGATGGCTACACCTTC	CASSLTQGGGDGYTF	TRBV5-1	TRBJ1-2
TGTGCCAGCACTTCGGGAGAGAATCAGCCCCAGCATTTT	CASTSGENQPQHF	TRBV2	TRBJ1-5
TGTGCCAGCAAGGGGCACAGGGGCGACCCCAATCAGCCCCAGCATTTT	CASKGHRGDPNQPQHF	TRBV18	TRBJ1-5
TGTGCCAGCAGCGACCCAGGGGGCCGCACAGATACGCAGTATTTT	CASSDPGGRTDTQYF	TRBV14	TRBJ2-3
TGTGCCATCGGGGGGGGTTATAGGGCAGATACGCAGTATTTT	CAIGGGYRADTQYF	TRBV7-8	TRBJ2-3
TGTGCCAGCAGCCAAAAAAACCACTTTTTCCCGGATGAGCAGTTCTTC	CASSQKNHFFPDEQFF	TRBV3-1	TRBJ2-1
TGCGCCAGCGGGCGTTCGGGACCATACGAGCAGTACTTC	CASGRSGPYEQYF	TRBV4-1	TRBJ2-7
TGTGCCACCACGGATGAGTCCTACGAGCAGTACTTC	CATTDESYEQYF	TRBV24-1	TRBJ2-7
TGTGCCAGCAGCTTTGAGTCCGGACAGACCCAGCCCCAGCATTTT	CASSFESGQTQPQHF	TRBV7-3	TRBJ1-5
TGTGCCAGCAGGGGGAAGAAGGGGGGCGAAAATGAGCAGTTCTTC	CASRGKKGGENEQFF	TRBV5-6	TRBJ2-1
TGTGCCAGCAGCCAAGTTCCTCCCGGGACAGGGGAAGCCCCTGAAGCTTTCTTT	CASSQVPPGTGEAPEAFF	TRBV3-1	TRBJ1-1
TGTGCCAGCAGCCGAGAGGACTCAAAAGATACGCAGTATTTT	CASSREDSKDTQYF	TRBV7-2	TRBJ2-3
TGCAGCGTTGAAGATCTCGGGGGCGCGATAGACGAGCAGTACTTC	CSVEDLGGAIDEQYF	TRBV29-1	TRBJ2-7
TGTGCCACCGGGGACAATAGCTCGCATCAGCCCCAGCATTTT	CATGDNSSHQPQHF	TRBV6-5	TRBJ1-5
TGTGCCAGCAGTTATTCAGGGTTCTTAAATCAGCCCCAGCATTTT	CASSYSGFLNQPQHF	TRBV6-9	TRBJ1-5
TGTGCCAGCAGAGTTGGTATTCAACAGGGGGCTAATCAGCCCCAGCATTTT	CASRVGIQQGANQPQHF	TRBV12-3	TRBJ1-5
TGCAGTGCTCTCCGTAACAATGAGCAGTTCTTC	CSALRNNEQFF	TRBV20-1	TRBJ2-1
TGCAGTGCTAGGTCGGCAGATGAGCAGTTCTTC	CSARSADEQFF	TRBV20-1	TRBJ2-1
TGTGCCAGCAGTTGGGGGGGGGCAGTCGGGGAGCTGTTTTTT	CASSWGGAVGELFF	TRBV6-5	TRBJ2-2
TGTGCCAGCAGTCCTGACAGGGACCCCAATCAGCCCCAGCATTTT	CASSPDRDPNQPQHF	TRBV6-5	TRBJ1-5
TGTGCCAGCAGTGACCGGGGAAACACCATATATTTT	CASSDRGNTIYF	TRBV6-1	TRBJ1-3
TGTGCCAGCAGCCAAGACCTTCCAAGCGGAAAACAGGGTACCTCGCAGTACTTC	CASSQDLPSGKQGTSQYF	TRBV14	TRBJ2-7
TGTGCCAGTAGTATCCTCGATCCTGGAAACACCATATATTTT	CASSILDPGNTIYF	TRBV19	TRBJ1-3
TGTGCCAGCAGCTCTGAAGTCGGACTTGAGCAGTACTTC	CASSSEVGLEQYF	TRBV7-3	TRBJ2-7
TGTGCCAGCACCTGGGGGGACGGGGAGCTGTTTTTT	CASTWGDGELFF	TRBV14	TRBJ2-2
TGTGCCAGCAGGGGCGGTCCAGGGGGCCGCACCACTGAAGCTTTCTTT	CASRGGPGGRTTEAFF	TRBV28	TRBJ1-1
TGTGCCAGCAGCTTGGGGCGCTTTCCGGGGCCCGGGGAGCTGTTTTTT	CASSLGRFPGPGELFF	TRBV5-6	TRBJ2-2
TGCAGTGCAGGGACAGGGTCCTTCACCTACGAGCAGTACTTC	CSAGTGSFTYEQYF	TRBV20-1	TRBJ2-7
TGTGCCAGCAAGCGCACAGCCAAAAACATTCAGTACTTC	CASKRTAKNIQYF	TRBV6-1	TRBJ2-4
TGTGCCACCCAGCTAGGGGCGCGTCACACTGAAGCTTTCTTT	CATQLGARHTEAFF	TRBV25-1	TRBJ1-1
TGTGCCACCAGCAGAGCATGGGGGGGGGAGCAGTACTTC	CATSRAWGGEQYF	TRBV15	TRBJ2-7
TGTGCCAGCAGTTTAGGCACTTACGAGCAGTACTTC	CASSLGTYEQYF	TRBV12-4	TRBJ2-7
TGTGCCAGCAGTTACGGGGGGGGGGATACGCAGTATTTT	CASSYGGGDTQYF	TRBV6-5	TRBJ2-3
TGTGCCAGCAGCGCCGGGACTTTACTCGGGGGATTTCGTTACGAGCAGTACTTC	CASSAGTLLGGFRYEQYF	TRBV6-4	TRBJ2-7
TGTGCCAGCAGTGAATCCAGGTACGAGCAGTACTTC	CASSESRYEQYF	TRBV6-5	TRBJ2-7
TGTGCCAGCACGCGAAGGGGATGGGCTAATGAAAAACTGTTTTTT	CASTRRGWANEKLFF	TRBV2	TRBJ1-4
TGTGCCACCAGCAGAGGTCCTGGACCTAGTAACACTGAAGCTTTCTTT	CATSRGPGPSNTEAFF	TRBV15	TRBJ1-1
TGTGCCAGCAGCCAAGGTAATAGCGGGTGCTACGAGCAGTACTTC	CASSQGNSGCYEQYF	TRBV14	TRBJ2-7
TGTGCCAGCAGCCAAGGGACAAGGTGGTACGAGCAGTACTTC	CASSQGTRWYEQYF	TRBV3-1	TRBJ2-7
TGTGCCAGGCCCGGGACTAGCGGTCTTGCCTACGAGCAGTACTTC	CARPGTSGLAYEQYF	TRBV6-6	TRBJ2-7
TGCAGCGTTGAGAAAAGAGACGGGTACGAGCAGTACTTC	CSVEKRDGYEQYF	TRBV29-1	TRBJ2-7
TGTGCCACACCTGACCAGACAGGGGTGGTTCCTAATGAAAAACTGTTTTTT	CATPDQTGVVPNEKLFF	TRBV24-1	TRBJ1-4
TGTGCCAGCAGCACCGGACAGGGGCCCGCGGATCAGCCCCAGCATTTT	CASSTGQGPADQPQHF	TRBV7-9	TRBJ1-5
TGCGCCAGCAGTGGTTCCCCGGGACATACCCGTCCTGAAGCTTTCTTT	CASSGSPGHTRPEAFF	TRBV10-2	TRBJ1-1
TGTGCCAGCAGTGGGGACACGGCCTACGAGCAGTACTTC	CASSGDTAYEQYF	TRBV28	TRBJ2-7
TGTGCCATCAGTGTGGAGGAGGGGTCTCATCAGCCCCAGCATTTT	CAISVEEGSHQPQHF	TRBV10-3	TRBJ1-5
TGTGCCAGCAGCCAAGATGCCTGGGTAGAGTTCTCCTACGAGCAGTACTTC	CASSQDAWVEFSYEQYF	TRBV14	TRBJ2-7
TGTGCCAGCAGCCTAGACAGGGAGTCCTACGAGCAGTACTTC	CASSLDRESYEQYF	TRBV4-2	TRBJ2-7
TGCAGCGTTGAGGGGGACTACGAGCAGTACTTC	CSVEGDYEQYF	TRBV29-1	TRBJ2-7
TGTGCCAGCAGTGGCACTAGCGGGACTAGGGGGGGGGGGGAGACCCAGTACTTC	CASSGTSGTRGGGETQYF	TRBV2	TRBJ2-5
TGTGCCATCAGTGAGTACGCTTGTCGTTGGCCGGGACAGGGGTTAATGAACACTGAAGCTTTCTTT	CAISEYACRWPGQGLMNTEAFF	TRBV10-3	TRBJ1-1
TGTGCCAGCATTAGAGACGGGTGGTCCTACGAGCAGTACTTC	CASIRDGWSYEQYF	TRBV7-8	TRBJ2-7
TGCGCCAGCAGCTCGCACAGGGCCTACTGCTACGAGCAGTACTTC	CASSSHRAYCYEQYF	TRBV5-1	TRBJ2-7
TGTGCCAGTAGTAAGGGGTGCTACGAGCAGTACTTC	CASSKGCYEQYF	TRBV19	TRBJ2-7
TGCGCCAGCAGCTTGGCCACAGGGGTCCGGGGCTCCTACGAGCAGTACTTC	CASSLATGVRGSYEQYF	TRBV5-1	TRBJ2-7
TGCGCCAGCAGCTTGAGTGATGCGGGAGCCCACGGGAATGAGCAGTTCTTC	CASSLSDAGAHGNEQFF	TRBV5-1	TRBJ2-1
TGTGCCAGCAGTTTAGCGCAGCTCGACCCTGTAGATACGCAGTATTTT	CASSLAQLDPVDTQYF	TRBV12-4	TRBJ2-3
TGTGCCAGCAGCAGCCGTCCGGCCGGGACTAGAGGGCCCATTCAGTACTTC	CASSSRPAGTRGPIQYF	TRBV11-3	TRBJ2-4
TGTGCCAGCAGCTTCTCAGGGGGATCAGGGGGAAGTCGGTATGGCTACACCTTC	CASSFSGGSGGSRYGYTF	TRBV7-7	TRBJ1-2
TGTGCCAGCAGTTACGGGGGGGGGGTTGGAAACACCATATATTTT	CASSYGGGVGNTIYF	TRBV6-5	TRBJ1-3
TGCGCCAGCAGCCAGACAGAGCAGGCCTACGAGCAGTACTTC	CASSQTEQAYEQYF	TRBV4-1	TRBJ2-7
TGTGCCAGCAGCCCCCTACCGCCGTGTAGCTCCTACAATGAGCAGTTCTTC	CASSPLPPCSSYNEQFF	TRBV3-1	TRBJ2-1
TGTGCCAGCAGCTTAGCCCCGGGGGCACAGAAGAACACTGAAGCTTTCTTT	CASSLAPGAQKNTEAFF	TRBV7-2	TRBJ1-1
TGCGCCAGCAGCCCAAGGGCTGGAAACACCATATATTTT	CASSPRAGNTIYF	TRBV4-1	TRBJ1-3
TGTGCCAGCAGCTTGGCGGTAACTAGCGGGAGAACAGGCCATGAAAAACTGTTTTTT	CASSLAVTSGRTGHEKLFF	TRBV5-5	TRBJ1-4
TGTGCCAGCAGTTACACGGATGGGGGGAAATGCACTGAAGCTTTCTTT	CASSYTDGGKCTEAFF	TRBV6-5	TRBJ1-1
TGTGCCAGCAGGACCTACCCCCCAGAGGTAGCCAAAAACATTCAGTACTTC	CASRTYPPEVAKNIQYF	TRBV6-5	TRBJ2-4
TGTGCCACCCTTAAGGGAAGGGGGGCCTATAATTCACCCCTCCACTTT	CATLKGRGAYNSPLHF	TRBV7-9	TRBJ1-6
TGTGCCAGCAGGAGGAGGGGGCTTACTGAAGCTTTCTTT	CASRRRGLTEAFF	TRBV6-8	TRBJ1-1
TGTGCCATCAGTGAGTCGAATGGGGAAGGGACCTATGGCTACACCTTC	CAISESNGEGTYGYTF	TRBV10-3	TRBJ1-2
TGTGCCACCAGTGATTTGCAACCCCTAGCGGCTTTCTACGAGCAGTACTTC	CATSDLQPLAAFYEQYF	TRBV24-1	TRBJ2-7
TGTGCCAGCAGTTACCTAAGGACAGAAGCTATGAACACTGAAGCTTTCTTT	CASSYLRTEAMNTEAFF	TRBV6-5	TRBJ1-1
TGTGCCAGCAGCGGCACAGGGACTAATGAAAAACTGTTTTTT	CASSGTGTNEKLFF	TRBV9	TRBJ1-4
TGTGCCAGCAGCGGGGGGGGGAACTACGAGCAGTACTTC	CASSGGGNYEQYF	TRBV6-2	TRBJ2-7
TGCAGTGGACGGACTAGCGGGGGGGCCTGGGGGCCATACGAGCAGTACTTC	CSGRTSGGAWGPYEQYF	TRBV20-1	TRBJ2-7
TGTGCCAGCAGCTCCTGTGGTTCGTTCAGGAGCTCCTACAATGAGCAGTTCTTC	CASSSCGSFRSSYNEQFF	TRBV13	TRBJ2-1
TGTGCCAGCATCGGACGGATCACAGATACGCAGTATTTT	CASIGRITDTQYF	TRBV11-3	TRBJ2-3
TGTGCCACCAGTGAAGATTACAGGGTTGCTTTCTTT	CATSEDYRVAFF	TRBV24-1	TRBJ1-1
TGTGCCGGTAGACTAGGGCGCACAGATACGCAGTATTTT	CAGRLGRTDTQYF	TRBV19	TRBJ2-3
TGTGTGGACAGCACGAACACCGGGGAGCTGTTTTTT	CVDSTNTGELFF	TRBV5-6	TRBJ2-2
TGTGCTAGTGGTTTGGTACACTTGACAAGGATTCTTCAAGAGACCCAGTACTTC	CASGLVHLTRILQETQYF	TRBV12-5	TRBJ2-5
TGTGCCAGCAGCTTAGCGATTTGGGGGGGCCCCCAGAATGAGCAGTTCTTC	CASSLAIWGGPQNEQFF	TRBV11-3	TRBJ2-1
TGCAGTGCGGTGGGGACCAGGGAGCAGTACTTC	CSAVGTREQYF	TRBV20-1	TRBJ2-7
TGTGCCAGCAGTCAAAGGACGGGCGCCAATCAGCCCCAGCATTTT	CASSQRTGANQPQHF	TRBV6-1	TRBJ1-5
TGTGCCAGCAGCCAGGGGGGGAGGGCCGACAATGAGCAGTTCTTC	CASSQGGRADNEQFF	TRBV14	TRBJ2-1
TGTGCCAGCACGGACGAGGGGTCTTCGGGTGAAAAACTGTTTTTT	CASTDEGSSGEKLFF	TRBV6-4	TRBJ1-4
TGTGCCAGCAGTTTATCAAGACACGTTAACTATGGCTACACCTTC	CASSLSRHVNYGYTF	TRBV27	TRBJ1-2
TGTGCCAGCAGCTCTTGCTCGCGGGGACAGGGGACAACCGGGGAGCTGTTTTTT	CASSSCSRGQGTTGELFF	TRBV9	TRBJ2-2
TGTGCCAGCAGCCCTACTAGCGGGAGCTCCTACAATGAGCAGTTCTTC	CASSPTSGSSYNEQFF	TRBV6-4	TRBJ2-1
TGTGCCAGCAGCCCCGGGCAGGGGATATGGCCTAATGAGCAGTTCTTC	CASSPGQGIWPNEQFF	TRBV7-7	TRBJ2-1
TGCGCCAGCATTAAGGGGATCACCTTC	CASIKGITF	TRBV10-1	TRBJ1-2
TGCGCCAGCAGCTTGCCGAGCGGGAAGGCCCGCACAGATACGCAGTATTTT	CASSLPSGKARTDTQYF	TRBV5-1	TRBJ2-3
TGTGCCAGCAGCCCCTGGGCGGCCGTGGTATTCCACGAGCAGTACTTC	CASSPWAAVVFHEQYF	TRBV3-1	TRBJ2-7
TGTGCCAGCAGGGGTTCTACAGGGCACACTGAAGCTTTCTTT	CASRGSTGHTEAFF	TRBV6-1	TRBJ1-1
TGTGCCAGCAGCCAAGAACCAGCGGGACACTACTCTGGGGCCAACGTCCTGACTTTC	CASSQEPAGHYSGANVLTF	TRBV3-1	TRBJ2-6
TGTGCCAGCAGTGACGCAGGGAGTGTCCAAGAGACCCAGTACTTC	CASSDAGSVQETQYF	TRBV25-1	TRBJ2-5
TGTGCCAGCAGCTCCCTGAAATGCCCCCGGGACAGTTGGGCCTACGAGCAGTACTTC	CASSSLKCPRDSWAYEQYF	TRBV7-9	TRBJ2-7
TGCGCCAGCAATCAGAATCATTTCTTC	CASNQNHFF	TRBV10-1	TRBJ2-1
TGTGCCGGCGTAGGCAGACAGCAAAGCTCCTACGAGCAGTACTTC	CAGVGRQQSSYEQYF	TRBV9	TRBJ2-7
TGCGCCAGCAGCTTGCCCGAGGAAAGTGATACGCAGTATTTT	CASSLPEESDTQYF	TRBV5-1	TRBJ2-3
TGCGCCAGCAGTATCAATCAGCCCCAGCATTTT	CASSINQPQHF	TRBV10-1	TRBJ1-5
TGTGCCAGCAGCAGCCGGGACTACAGCTGCGATACGCAGTATTTT	CASSSRDYSCDTQYF	TRBV13	TRBJ2-3
TGTGCCAGTAGTATGAGAACAGGGGTCAATGAGCAGTTCTTC	CASSMRTGVNEQFF	TRBV19	TRBJ2-1
TGTGCCAGCCGGGAACCAGGGAATGACTACGAGCAGTACTTC	CASREPGNDYEQYF	TRBV7-3	TRBJ2-7
TGTGCCACCAGTGTCAAGGTGAACACTGAAGCTTTCTTT	CATSVKVNTEAFF	TRBV24-1	TRBJ1-1
TGTGCCAGCAGTGAAGCGACCCAGGGGGGAGAAGCGCACGAGCAGTACTTC	CASSEATQGGEAHEQYF	TRBV6-1	TRBJ2-7
TGCGCCAGCAGCACGACCAGGACGCAAAACATTCAGTACTTC	CASSTTRTQNIQYF	TRBV5-1	TRBJ2-4
TGTGCCAGCAGGTATGGGGGGGGGGAGCAGTACTTC	CASRYGGGEQYF	TRBV28	TRBJ2-7
TGTGCCAGCAGCGGGACAGGGTACGAGCAGTACTTC	CASSGTGYEQYF	TRBV9	TRBJ2-7
TGTGCCAGCAGAAGCCCGGGACAGGGGGCCTATAGATACAAACAAGAGACCCAGTACTTC	CASRSPGQGAYRYKQETQYF	TRBV2	TRBJ2-5
TGCAGTGCTAGCCCCTATTGCGGGGGACACAATGAGCAGTTCTTC	CSASPYCGGHNEQFF	TRBV20-1	TRBJ2-1
TGTGCCAGCAGTTCGCGCAGCAATGAGCAGTTCTTC	CASSSRSNEQFF	TRBV28	TRBJ2-1
TGTGCCAGCAGCTTGTTTTATCTCTTCGGCATTCAGCCCCAGCATTTT	CASSLFYLFGIQPQHF	TRBV5-4	TRBJ1-5
TGTGCCACCAGTGTTTCGGGACGAAATAAGACCCAGTACTTC	CATSVSGRNKTQYF	TRBV24-1	TRBJ2-5
TGTGCCAGCAGGAGGGACAGGGGGCGGCTCACCGTCTATGGCTACACCTTC	CASRRDRGRLTVYGYTF	TRBV9	TRBJ1-2
TGTGCCAGCAGGCCTCTCTACGAGCAGTACTTC	CASRPLYEQYF	TRBV6-1	TRBJ2-7
TGTGCCAGCAGAATGGGACAGCAATGGTCCTACGAGCAGTACTTC	CASRMGQQWSYEQYF	TRBV7-2	TRBJ2-7
TGTGCTAGCAGCTTAGCGCTGGCCAATAGGCGTCTCCTAGACGAGCAGTACTTC	CASSLALANRRLLDEQYF	TRBV7-7	TRBJ2-7
TGTGCCAGCAGCTTGGGGGGTTCCAGCGGGAGGTCCTACGAGCAGTACTTC	CASSLGGSSGRSYEQYF	TRBV5-4	TRBJ2-7
TGTGCCAGCAGCGAATCGGGGAACTACGAGCAGTACTTC	CASSESGNYEQYF	TRBV13	TRBJ2-7
TGTGCCAGCAGCTTATTACAGGGGAATTCACCCCTCCACTTT	CASSLLQGNSPLHF	TRBV7-6	TRBJ1-6
TGTGCCAGCAGCTCCCGGACAGGCACCTTGGCCTTC	CASSSRTGTLAF	TRBV7-3	TRBJ1-2
TGTGCCAGCAGCAGGGGGGACGAGCAGTACTTC	CASSRGDEQYF	TRBV7-3	TRBJ2-7
TGTGCCAGCAGCTTTTGCCGGGACAGGGTCTGGTTGCGGACTAACTATGGCTACACCTTC	CASSFCRDRVWLRTNYGYTF	TRBV5-4	TRBJ1-2
TGTGCTAGTGGTTTGGTTATCGGCAGCGATACGCAGCCCCAGCATTTT	CASGLVIGSDTQPQHF	TRBV12-5	TRBJ1-5
TGTGCCAGCAGCCCATGGGACGGGTACGAGCAGTACTTC	CASSPWDGYEQYF	TRBV11-3	TRBJ2-7
TGTGCCAGCAGCTTAGGTGGCGAGGCAGAAGAGACCCAGTACTTC	CASSLGGEAEETQYF	TRBV7-7	TRBJ2-5
TGTCACCCTTTGGGAGGGACCTCCACAGATACGCAGTATTTT	CHPLGGTSTDTQYF	TRBV7-9	TRBJ2-3
TGTGCCAGCATAGTGCCCCCTAGCGGGAGGGGCCCAGATACGCAGTATTTT	CASIVPPSGRGPDTQYF	TRBV6-4	TRBJ2-3
TGTGCCAGCAGCTCAGGGGGGGCCGGGGAGCTGTTTTTT	CASSSGGAGELFF	TRBV7-3	TRBJ2-2
TGTGCCAGCAGCCAAGGCCCGGGACTAGCGGGGCGAGAGCAGTTCTTC	CASSQGPGLAGREQFF	TRBV14	TRBJ2-1
TGTGCCAGCAGCTTAGAGAGGTGGAGGGGGTCCTATGGCTACACCTTC	CASSLERWRGSYGYTF	TRBV7-4	TRBJ1-2
TGTGCCAGCACCTCCCACAGAAGGCCCAAAAACACTGAAGCTTTCTTT	CASTSHRRPKNTEAFF	TRBV6-4	TRBJ1-1
TGTGCCAGCAGTTACCCACGAAGCAATCAGCCCCAGCATTTT	CASSYPRSNQPQHF	TRBV6-5	TRBJ1-5
TGCGCCAGCAGCCAAGATCGCAGGAATTCTAATACCAATCAGCCCCAGCATTTT	CASSQDRRNSNTNQPQHF	TRBV4-1	TRBJ1-5
TGTGCCCTAGGACAGGGGGGAAACACTGAAGCTTTCTTT	CALGQGGNTEAFF	TRBV27	TRBJ1-1
TGTGCCAGCAGCTTAGGTAACGTTCCCAGGGATCGCTCTGGGGCCAACGTCCTGACTTTC	CASSLGNVPRDRSGANVLTF	TRBV11-2	TRBJ2-6
TGTGCCAGCAGCCAAAGGGAGGCCGGGCGCAATGACGAAATTCTGTACGAGCAGTACTTC	CASSQREAGRNDEILYEQYF	TRBV4-2	TRBJ2-7
TGCGCCCGGGGGATGGAAGGATCTAATGAAAAACTGTTTTTT	CARGMEGSNEKLFF	TRBV5-1	TRBJ1-4
TGTGCCAGCAGCCAAGCGGCAGGACAGGGCTCCTACGAGCAGTACTTC	CASSQAAGQGSYEQYF	TRBV3-1	TRBJ2-7
TGTGCCATCAGTGAACCCCTTTGCTACAATGAGCAGTTCTTC	CAISEPLCYNEQFF	TRBV10-3	TRBJ2-1
TGTGCCAGCAGCTTGAACCCCAGAGTCGACAGGCCTGTGGGGGGGGTTGCAGGGACCTTCTCCTACGAGCAGTACTTC	CASSLNPRVDRPVGGVAGTFSYEQYF	TRBV5-5	TRBJ2-7
TGCGCCAGCAGTGAGAAGGGGAGTAGGCGGGAAGCTTTCTTT	CASSEKGSRREAFF	TRBV10-1	TRBJ1-1
TGTGCCAGCAGCTCGGACAGGGCTGCGGGGAGCAATCAGCCCCAGCATTTT	CASSSDRAAGSNQPQHF	TRBV6-5	TRBJ1-5
TGTGCTAGTGGTTTTCTCTGGCTCGATGGTCCTCGTGAGACCCAGTACTTC	CASGFLWLDGPRETQYF	TRBV12-5	TRBJ2-5
TGTGCCAGCAGTTCGGCCGGGAGGGTCTTGTCTGGGGCCAACGTCCTGACTTTC	CASSSAGRVLSGANVLTF	TRBV28	TRBJ2-6
TGTGCCAGCAGCCTAAGGGATAGCAATCAGCCCCAGCATTTT	CASSLRDSNQPQHF	TRBV7-4	TRBJ1-5
TGCGCCAGCAGTGACCCACAGGGGTCCTTTCCAGATACGCAGTATTTT	CASSDPQGSFPDTQYF	TRBV10-1	TRBJ2-3
TGCGCCAGCAGTCCGGTAAGCCGGGACAGGGGGGGTAACTATGGCTACACCTTC	CASSPVSRDRGGNYGYTF	TRBV10-1	TRBJ1-2
TGTGCCAGCAGGGTCGAGACAGGGGGGGGGAGAGCGCAGTTCTTC	CASRVETGGGRAQFF	TRBV2	TRBJ2-1
TGCGCCAGCAGCAGGTCTGTCCGGGCAACTAATGAAAAACTGTTTTTT	CASSRSVRATNEKLFF	TRBV5-1	TRBJ1-4
TGTGCCAGCAGCGTAGAAAAGTATTCTAAGGAAGCCGGCGAGCAGTACTTC	CASSVEKYSKEAGEQYF	TRBV9	TRBJ2-7
TGTGCCATAACCCAAACAAGCTCTGGGGCCAACGTCCTGACTTTC	CAITQTSSGANVLTF	TRBV27	TRBJ2-6
TGTGCCAGCAGTGAGTCCCGCTGGGGTACGTCGGACAATGAGCAGTTCTTC	CASSESRWGTSDNEQFF	TRBV6-1	TRBJ2-1
TGTGCCAGCAGCTGGTGCCTTGCGACAGGGTGTGGGGAGCAGTACTTC	CASSWCLATGCGEQYF	TRBV7-6	TRBJ2-7
TGTGCCACGTGTGCGGCTCGGGGCACTACTCACACTGAAGCTTTCTTT	CATCAARGTTHTEAFF	TRBV6-4	TRBJ1-1
TGTGCCATCTGGGGGGGCGGTTTTCAAGAGCAGTACTTC	CAIWGGGFQEQYF	TRBV19	TRBJ2-7
TGTGCCAGCAGCTTACTAGGCGCCCAGTCCTACGAGCAGTACTTC	CASSLLGAQSYEQYF	TRBV11-2	TRBJ2-7
TGCAGTGCCTACAATCTCGAGGGGGTACAGCCCCAGCATTTT	CSAYNLEGVQPQHF	TRBV20-1	TRBJ1-5
TGTGCCAGCAGCCAAGATGGGGACAGGGGGAGCTACGAGCAGTACTTC	CASSQDGDRGSYEQYF	TRBV3-1	TRBJ2-7
TGCAGTGCTAGAGCAGGGATCGGCTGGAACACCGGGGAGCTGTTTTTT	CSARAGIGWNTGELFF	TRBV20-1	TRBJ2-2
TGTGCCAGCAGCCCATGGGCCGGGACAGGTCTCTATGGCTACACCTTC	CASSPWAGTGLYGYTF	TRBV13	TRBJ1-2
TGTGCCACCAGTGTGAACAGGTCCCCTAGCACAGATACGCAGTATTTT	CATSVNRSPSTDTQYF	TRBV24-1	TRBJ2-3
TGTGCCAGCAGCGCTACGACCGGAGGGGCGGGATCTAGCAATCAGCCCCAGCATTTT	CASSATTGGAGSSNQPQHF	TRBV13	TRBJ1-5
TGTGCCACCTCTAGCCCTAACAATGAGCAGTTCTTC	CATSSPNNEQFF	TRBV15	TRBJ2-1
TGTGCCAGCAGCTTAATGGTCCATGCCTCCACTAGCGGGAGGGCCCCTGGAAACACCATATATTTT	CASSLMVHASTSGRAPGNTIYF	TRBV7-3	TRBJ1-3
TGTGCCAGCAGCTTCGCGGGACAAAAGAAGCTAGAGACCCAGTACTTC	CASSFAGQKKLETQYF	TRBV11-3	TRBJ2-5
TGTGCCAGCAGCACCGCATCGAAGTTCCAAGAGACCCAGTACTTC	CASSTASKFQETQYF	TRBV7-3	TRBJ2-5
TGTGCCAGCAGCTTGGCAAGCTACAAAAAACGGCAGTACTTC	CASSLASYKKRQYF	TRBV5-5	TRBJ2-5
TGTGCCAGCAGCGTTTCTCGGACTAGCGGGCAACCCTACAATGAGCAGTTCTTC	CASSVSRTSGQPYNEQFF	TRBV5-8	TRBJ2-1
TGTGCCAGCAGCGCGTATCAAAATAGCAATCAGCCCCAGCATTTT	CASSAYQNSNQPQHF	TRBV11-3	TRBJ1-5
TGTGCCATAGTAAGGAGGCCTAGGGGAGGTTACGGCTCTGGAAACACCATATATTTT	CAIVRRPRGGYGSGNTIYF	TRBV10-3	TRBJ1-3
TGTGCCAGCAGCCGAGGTCAGCCCCAGCATTTT	CASSRGQPQHF	TRBV13	TRBJ1-5
TGTGCCAGCAGCTTAAGGAAAACTAGGGGCTTCTACACCTTC	CASSLRKTRGFYTF	TRBV7-4	TRBJ1-2
TGTGCCAGCAGCCAAGCACCAGGGTATGGCTACACCTTC	CASSQAPGYGYTF	TRBV3-1	TRBJ1-2
TGTGCCAGCAGCCTTTGGGGCTGGGGCGAAAAACTGTTTTTT	CASSLWGWGEKLFF	TRBV5-6	TRBJ1-4
TGTGCCAGCAGGGAGGACCAAACATCCTACAATGAGCAGTTCTTC	CASREDQTSYNEQFF	TRBV6-2	TRBJ2-1
TGCGCCAGCAGCGATGGGGGGGGGGGTCTCACAGATACGCAGTATTTT	CASSDGGGGLTDTQYF	TRBV5-1	TRBJ2-3
TGTGCTAGTGGTTTGTATTCCCACAGAAGGGGGCGAGACACCGGGGAGCTGTTTTTT	CASGLYSHRRGRDTGELFF	TRBV12-5	TRBJ2-2
TGCGCCAGCAGAAAACCGGAAATCAATTGCACACGAGATACGCAGTATTTT	CASRKPEINCTRDTQYF	TRBV4-1	TRBJ2-3
TGTGCTAGTGGGAGGACAGTGGGATCCGGCCAAGAGACCCAGTACTTC	CASGRTVGSGQETQYF	TRBV12-5	TRBJ2-5
TGTGCCACCTTCTTGGGACAGGGGTTCCCGAACACTGAAGCTTTCTTT	CATFLGQGFPNTEAFF	TRBV24-1	TRBJ1-1
TGCGCCAGCAGTGAAGGGGCCGGGGATGAAAAACTGTTTTTT	CASSEGAGDEKLFF	TRBV10-1	TRBJ1-4
TGTGCCACAGACAGGGTCGCCAACACCGGGGAGCTGTTTTTT	CATDRVANTGELFF	TRBV15	TRBJ2-2
TGTGCCAGCAGCTGGGTATATGGCTACACCTTC	CASSWVYGYTF	TRBV7-9	TRBJ1-2
TGTGCCAGCAGCTTGGCTGGGGGATCCCACTATGGCTACACCTTC	CASSLAGGSHYGYTF	TRBV6-1	TRBJ1-2
TGTGCCAGCAGCAAAGACCCCGGACCACCTGCTGGAAACACCATATATTTT	CASSKDPGPPAGNTIYF	TRBV11-2	TRBJ1-3
TGTGCCAGTAGTTCTAGAAACCTAGCGGGAGAGGACTTGGGCCAAGAGACCCAGTACTTC	CASSSRNLAGEDLGQETQYF	TRBV19	TRBJ2-5
TGTGCCAGCCGTCAGGGGGTCAATGAGCAGTTCTTC	CASRQGVNEQFF	TRBV25-1	TRBJ2-1
TGTGCCAGCTCACGAATACCTCGTATAATGAGGCGGAACAATGAGCAGTTCTTC	CASSRIPRIMRRNNEQFF	TRBV18	TRBJ2-1
TGTGCCAGCAGCGGAAAAGGTGGGGGGGCAAACTATGGCTACACCTTC	CASSGKGGGANYGYTF	TRBV7-9	TRBJ1-2
TGTGCCAGCAGAAGCAGGGCGGACGAGCAGTACTTC	CASRSRADEQYF	TRBV28	TRBJ2-7
TGCAGTGGACTCGACAGGGGTCTCTACGAGCAGTACTTC	CSGLDRGLYEQYF	TRBV20-1	TRBJ2-7
TGTGCCAGCAGATTCGCCCAGCGGGGCTTAGAGCAGTTCTTC	CASRFAQRGLEQFF	TRBV6-4	TRBJ2-1
TGTGCCAGCAGCCACGTGCGATCGCCAGGACAGGGTCAGCCCCAGCATTTT	CASSHVRSPGQGQPQHF	TRBV9	TRBJ1-5
TGTGCCAGCAGCTTAGATAAAAGGCCAGGGGACAGGGATCAGCCCCAGCATTTT	CASSLDKRPGDRDQPQHF	TRBV7-2	TRBJ1-5
TGTGCCTGGAGCCTCCCTAGCGGTCTGAATGAGCAGTTCTTC	CAWSLPSGLNEQFF	TRBV30	TRBJ2-1
TGTGCCAGCAGTTATAGGGGGGAAACAGCAGATACGCAGTATTTT	CASSYRGETADTQYF	TRBV6-5	TRBJ2-3
TGTGCCAGCAGCACTCCATTGCGGGTAGCGGGGGGGGATGAGCAGTTCTTC	CASSTPLRVAGGDEQFF	TRBV13	TRBJ2-1
TGTGCCAGCAGTGAAACACTGGGCCAAGAGACCCAGTACTTC	CASSETLGQETQYF	TRBV6-1	TRBJ2-5
TGCGCCAGCAGCTTGCGCGTTTCTATTCTAGACAGGGCTGCAGAAAAACTGTTTTTT	CASSLRVSILDRAAEKLFF	TRBV5-1	TRBJ1-4
TGTGCCAGTAGATTAGCCCTCCCACTACGCGGGGGTCAATTAGAGACCCAGTACTTC	CASRLALPLRGGQLETQYF	TRBV19	TRBJ2-5
TGCGCCAGCTCCATGACAGGGAGGGATGCGGCCCAGCCCCAGCATTTT	CASSMTGRDAAQPQHF	TRBV10-1	TRBJ1-5
TGTTCGGTCGAGGGACTAGCGGGGTGGTCCTACGAGCAGTACTTC	CSVEGLAGWSYEQYF	TRBV27	TRBJ2-7
TGTGCCAGTAGTGAAGTCAGGACCTCTGCTCCGTGTAATGAAAAACTGTTTTTT	CASSEVRTSAPCNEKLFF	TRBV19	TRBJ1-4
TGTGCCAGCAGACCCGGCCTCTCTGGACAGGGGGCCCACTCTAACTATGGCTACACCTTC	CASRPGLSGQGAHSNYGYTF	TRBV6-5	TRBJ1-2
TGTGCCAGCAGCGTAGATGCTTTTAGCTCCTATAATTCACCCCTCCACTTT	CASSVDAFSSYNSPLHF	TRBV7-8	TRBJ1-6
TGTGCCAGCAGCCCACCGGGACAGGGGGCTGAGGAAGCTTTCTTT	CASSPPGQGAEEAFF	TRBV9	TRBJ1-1
TGCAGCGTTGTTGGACTAGCGGGTGAGCAGTACTTC	CSVVGLAGEQYF	TRBV29-1	TRBJ2-7
TGCGCCAGCAGCTTGTTCCAGGACACTGAAGCTTTCTTT	CASSLFQDTEAFF	TRBV5-1	TRBJ1-1
TGTGCCAGCAGCCCGACAGTCAGGGGTTCCGGGGAGCTGTTTTTT	CASSPTVRGSGELFF	TRBV7-9	TRBJ2-2
TGTGCCATCAGTCACCCCCAGGGGACTAATGAAAAACTGTTTTTT	CAISHPQGTNEKLFF	TRBV10-3	TRBJ1-4
TGTGCCAGCAGTTACTACTGGCCGACAGGGGACCGGGGCGAGCAGTACTTC	CASSYYWPTGDRGEQYF	TRBV6-6	TRBJ2-7
TGTGCCACCAGTCTGGGGGGAGGGGAGCAGTACTTC	CATSLGGGEQYF	TRBV24-1	TRBJ2-7
TGTGCCAGCAGCCAAGCGCGGACTAGGGGTGCAGCAGATACGCAGTATTTT	CASSQARTRGAADTQYF	TRBV14	TRBJ2-3
TGCAGCGTTGAAGATTGTATCGGGCCGGGCTACACCTTC	CSVEDCIGPGYTF	TRBV29-1	TRBJ1-2
TGTGCCACCCGGGTGGATCAGGGACAGGAGAGGGAGACCCAGTACTTC	CATRVDQGQERETQYF	TRBV15	TRBJ2-5
TGCGCCAGCAGCATCGGACAGGGTTTTTCCTACAATGAGCAGTTCTTC	CASSIGQGFSYNEQFF	TRBV5-1	TRBJ2-1
TGTGCCAGCAGCTTATTGTTTAGGATAGACGAGCAGTACTTC	CASSLLFRIDEQYF	TRBV11-2	TRBJ2-7
TGTGCCATCACTAAGCGGGATTGTTGTGAAAAACTGTTTTTT	CAITKRDCCEKLFF	TRBV10-3	TRBJ1-4
TGCAGTGCTACCGCCCCTGACTACGAGCAGTACTTC	CSATAPDYEQYF	TRBV20-1	TRBJ2-7
TGCGCCAGCAGCCAGCAGCTGTCGAACAACAATGAGCAGTTCTTC	CASSQQLSNNNEQFF	TRBV4-3	TRBJ2-1
TGTGCCAGCAGCCTCCCGGAACCCTCCACAGGCATTGGGACTGAAGCTTTCTTT	CASSLPEPSTGIGTEAFF	TRBV14	TRBJ1-1
TGTGCTAGTGAATTTCTGGAGACCCCAGATACGCAGTATTTT	CASEFLETPDTQYF	TRBV12-5	TRBJ2-3
TGTGCCAGCAGTGACAGTGACAATCAGCCCCAGCATTTT	CASSDSDNQPQHF	TRBV6-4	TRBJ1-5
TGTGCCAGCATGGTCCCCGGTAACAGGGGGGGGCCCTACGAGCAGTACTTC	CASMVPGNRGGPYEQYF	TRBV7-3	TRBJ2-7
TGTGCCAGCAGTTGGTGGGGGCAAAGCTCCTACGAGCAGTACTTC	CASSWWGQSSYEQYF	TRBV6-1	TRBJ2-7
TGCGCCAGCAGCCGGACACAGGGGGCGGAACAGCAGTACTTC	CASSRTQGAEQQYF	TRBV4-1	TRBJ2-7
TGTGCCAGCAGCAGTCCCTCTAACTATGGCTACACCTTC	CASSSPSNYGYTF	TRBV27	TRBJ1-2
TGTGCCAGCAGTCGAATAAGGGGATCCTACGAGCAGTACTTC	CASSRIRGSYEQYF	TRBV6-3	TRBJ2-7
TGTGCCAGCAGCTATGGAGGGTACGAGCAGTACTTC	CASSYGGYEQYF	TRBV5-5	TRBJ2-7
TGTGCCATCAGGGGGGGCTCCTACAATGAGCAGTTCTTC	CAIRGGSYNEQFF	TRBV10-3	TRBJ2-1
TGTGCCAGCAGTTTGGGGACCGGGGAGCTGTTTTTT	CASSLGTGELFF	TRBV27	TRBJ2-2
TGCGCCAGCATCAGGGGCGGCACTGAAGCTTTCTTT	CASIRGGTEAFF	TRBV5-1	TRBJ1-1
TGCGCCAGCAGTGAGCTCCTGACTAGCGGGTCCGAGCAGTACTTC	CASSELLTSGSEQYF	TRBV10-1	TRBJ2-7
TGTGCCAGCAGCTTAGCATCTATAAAGATGGGGACTTCCGAAAAACTGTTTTTT	CASSLASIKMGTSEKLFF	TRBV11-3	TRBJ1-4
TGTGCCAGCAGCTTACCTCACTTATCAGACGGCTACACTGAAGCTTTCTTT	CASSLPHLSDGYTEAFF	TRBV11-2	TRBJ1-1
TGTGCCAGCAGCGTACCAAACCACAGGGCAAGCTTCGAGCAGTACTTC	CASSVPNHRASFEQYF	TRBV9	TRBJ2-7
TGTGCCAGTCGACTAGCGGGCCACAATGAGCAGTTCTTC	CASRLAGHNEQFF	TRBV19	TRBJ2-1
TGTGCCAGCAGCTACCAGGGGGCGCAGTCCGGGACTGAAGCTTTCTTT	CASSYQGAQSGTEAFF	TRBV7-9	TRBJ1-1
TGCGCCAGCAGTGAAGACAGGGGCCAAGAGACCCAGTACTTC	CASSEDRGQETQYF	TRBV10-1	TRBJ2-5
TGTGCCAGCAGTTTATTCAGGGACAGGGGGGGCGAGCAGTACTTC	CASSLFRDRGGEQYF	TRBV27	TRBJ2-7
TGTGCCAGCAGCCCATACACAGGGCTCTACGAGCAGTACTTC	CASSPYTGLYEQYF	TRBV7-4	TRBJ2-7
TGTGCCTCCCTAGCGGGGGGGCCCGACGAGCAGTACTTC	CASLAGGPDEQYF	TRBV30	TRBJ2-7
TGTGCCAGCAGCTTAATGGCGACGCGGGTCCGAACCTACGAGCAGTACTTC	CASSLMATRVRTYEQYF	TRBV7-9	TRBJ2-7
TGTGCCAAGATCCATCAAACTGAAGCTTTCTTT	CAKIHQTEAFF	TRBV2	TRBJ1-1
TGTGCCAGCAGCGTGAATTTAGCGGTAATGAATACGCAGTATTTT	CASSVNLAVMNTQYF	TRBV11-3	TRBJ2-3
TGTGCCAGCAGCCAGTCACCGACGACTGAGCAGTTCTTC	CASSQSPTTEQFF	TRBV14	TRBJ2-1
TGTGCCAGCAGTGATGGGGGACCAGCCACTGAAGCTTTCTTT	CASSDGGPATEAFF	TRBV6-1	TRBJ1-1
TGTGCCAGCAGCTCTATCGGTACAGGGGGGAGCAATCAGCCCCAGCATTTT	CASSSIGTGGSNQPQHF	TRBV11-3	TRBJ1-5
TGTGCCGGAAGGGGAGAGGGGGCGCTAGGAAGAAGACTGAACACTGAAGCTTTCTTT	CAGRGEGALGRRLNTEAFF	TRBV28	TRBJ1-1
TGTGCCAGCAGTTCCAAAACAGGGGGGCGCACAGATACGCAGTATTTT	CASSSKTGGRTDTQYF	TRBV28	TRBJ2-3
TGCAGTGCTAGAGACAGGGCCACTGAAGCTTTCTTT	CSARDRATEAFF	TRBV20-1	TRBJ1-1
TGTGCCAGCAGCCAAGCCAACACGGGGACTAGCGGGTTACGCATGGCAGATACGCAGTATTTT	CASSQANTGTSGLRMADTQYF	TRBV4-2	TRBJ2-3
TGCAGCGTTGAAGATAGGATTCGAAAGTTGGAGGGCCACGAGCAGTACTTC	CSVEDRIRKLEGHEQYF	TRBV29-1	TRBJ2-7
TGTGCCAGCAGTTTAAGGGACAGGGCAAAAAGCTATGGCTACACCTTC	CASSLRDRAKSYGYTF	TRBV28	TRBJ1-2
TGCAGTGCTAGAAATCCCCGAGAGGGACAGTGCAATCAGCCCCAGCATTTT	CSARNPREGQCNQPQHF	TRBV20-1	TRBJ1-5
TGTGCCAGCAGCCGAGTGGACAGATCTGGGGCCAACGTCCTGACTTTC	CASSRVDRSGANVLTF	TRBV14	TRBJ2-6
TGCGCCAGCAGCCGGCCCGGAGGGGGGGACACTGAAGCTTTCTTT	CASSRPGGGDTEAFF	TRBV4-3	TRBJ1-1
TGTGCCAGCAGCTTGAGTCCTCTAATCCGGGACAGGGGGAAAATAAGCTCCTACGAGCAGTACTTC	CASSLSPLIRDRGKISSYEQYF	TRBV5-5	TRBJ2-7
TGTGCCAGCTTAGACAGCGTATTAAGCTCCTACAATGAGCAGTTCTTC	CASLDSVLSSYNEQFF	TRBV5-6	TRBJ2-1
TGTGCCAGCAGCTTACGATCCGGGACAGGGTTGGAGACTCTGTTTTTT	CASSLRSGTGLETLFF	TRBV11-1	TRBJ1-4
TGTGCCAGCAGCTACTCATTGTCTGGAAACACCATATATTTT	CASSYSLSGNTIYF	TRBV7-9	TRBJ1-3
TGCAGTGCTGTTGACAGGGGGCATAGCAATCAGCCCCAGCATTTT	CSAVDRGHSNQPQHF	TRBV20-1	TRBJ1-5
TGCACCTTTAGACTAGCGGGAGACGTGGGCCAGCCCCAGCATTTT	CTFRLAGDVGQPQHF	TRBV20-1	TRBJ1-5
TGTGCCAGCAGGAAGCAGGCCGGGACAGTGCAGAACACTGAAGCTTTCTTT	CASRKQAGTVQNTEAFF	TRBV25-1	TRBJ1-1
TGCGCCAGCAGGGGATTTACGGGGGGGGGGCCCGGGGGGGGGTATTTT	CASRGFTGGGPGGGYF	TRBV5-1	TRBJ2-3
TGTGCCAGCAGCAAGACGGCAGATGGCAACACTGAAGCTTTCTTT	CASSKTADGNTEAFF	TRBV13	TRBJ1-1
TGTGCCAGTAGTATTCCTAAGGGGGGGACAGGCTGGGATAGCGGCACCGGGGAGCTGTTTTTT	CASSIPKGGTGWDSGTGELFF	TRBV19	TRBJ2-2
TGTGCCAGCAGCCAAATTGGCAGGGCCTACGAGCAGTACTTC	CASSQIGRAYEQYF	TRBV3-1	TRBJ2-7
TGTGCCAGCAGGGAAATAGCATCGGGGAGCTCCTACAATGAGCAGTTCTTC	CASREIASGSSYNEQFF	TRBV12-4	TRBJ2-1
TGTGCCAGCAGCTTCGGGACCCACGAGCAGTACTTC	CASSFGTHEQYF	TRBV7-8	TRBJ2-7
TGTGCCAGCCAAGGCCACGCTTTCGGGAGTAGCTCCTACAATGAGCAGTTCTTC	CASQGHAFGSSSYNEQFF	TRBV18	TRBJ2-1
TGTGCCAGCAGCGGGCCTCGTAGGGGGCGGAGCGAGCAGTACTTC	CASSGPRRGRSEQYF	TRBV13	TRBJ2-7
TGTGCCAGCAGCCAACACTCTTGGGGGCCGAACACTGAAGCTTTCTTT	CASSQHSWGPNTEAFF	TRBV3-1	TRBJ1-1
TGCGCCAGCACTTACACGGGGTATCAGCCCCAGCATTTT	CASTYTGYQPQHF	TRBV10-1	TRBJ1-5
TGTGCCACTCCCGGGACTAGTAAACCATCTCTCGAGACCCAGTACTTC	CATPGTSKPSLETQYF	TRBV3-1	TRBJ2-5
TGTGCCAGCGGACTAGACGTTATGGAGGAGCAGTACTTC	CASGLDVMEEQYF	TRBV27	TRBJ2-7
TGTGCCAGCAGTTGTGGACAGGGGTTTGGCATTCAGTACTTC	CASSCGQGFGIQYF	TRBV6-5	TRBJ2-4
TGTGCCAGCAGGACGTCGACAGGGGAATCCTCGACCCAGTACTTC	CASRTSTGESSTQYF	TRBV7-7	TRBJ2-5
TGTGCCAGCGCTTGGACTAGCGGGCGGGCCTTAGCCTACGAGCAGTACTTC	CASAWTSGRALAYEQYF	TRBV12-3	TRBJ2-7
TGTGCCAGCAGTACCGGACTGGAAAACATTCAGTACTTC	CASSTGLENIQYF	TRBV28	TRBJ2-4
TGTGCCAGCAGCTCGGACAGGGCGGGCATGAACACTGAAGCTTTCTTT	CASSSDRAGMNTEAFF	TRBV5-4	TRBJ1-1
TGTGCCAGCAGTCGCCGTCCCCAGGGAATTCAGCCCCAGCATTTT	CASSRRPQGIQPQHF	TRBV28	TRBJ1-5
TGTGCCAGCAGTGATCTGATTCGGGGGCCCCGGGATACGCAGTATTTT	CASSDLIRGPRDTQYF	TRBV6-4	TRBJ2-3
TGTGCCAGCTCACGGGACCCACGTGCTGAGGGATCGGGGAGGAATCAGCCCCAGCATTTT	CASSRDPRAEGSGRNQPQHF	TRBV18	TRBJ1-5
TGTGCCAGCAGTTTCGGGAGGGGGTGGGAGAGGGATACGCAGTATTTT	CASSFGRGWERDTQYF	TRBV27	TRBJ2-3
TGTGCCAGCAGACTCCGTTTTTTTTACAATGAGCAGTTCTTC	CASRLRFFYNEQFF	TRBV5-6	TRBJ2-1
TGTGCCAGCAGTTGGGTTCAAACAGGTGGGTGGCAGCCCCAGCATTTT	CASSWVQTGGWQPQHF	TRBV6-3	TRBJ1-5
TGTGCCAGCACCCTGGAGGGGGGGGCCGGGTCTGGGGCCAACGTCCTGACTTTC	CASTLEGGAGSGANVLTF	TRBV2	TRBJ2-6
TGCAGTGCTAGACCTCCGGATAGCGGGCCCGATACGCAGTATTTT	CSARPPDSGPDTQYF	TRBV20-1	TRBJ2-3
TGTGCTAGTGGTGTCGGGACAGGGGACCGGAGCTCCTACAATGAGCAGTTCTTC	CASGVGTGDRSSYNEQFF	TRBV12-5	TRBJ2-1
TGTGCCACCAGTGATTTGCCCCCGGGACTCAGACACAGGAATAAAGAGACCCAGTACTTC	CATSDLPPGLRHRNKETQYF	TRBV24-1	TRBJ2-5
TGTGCCAGCAGCTGGCCGGGACAGGACCGGGCCTACAATGAGCAGTTCTTC	CASSWPGQDRAYNEQFF	TRBV7-3	TRBJ2-1
TGTGCCAGCAGTGCCCCCTGGGGATTGGCTTCACATAATGAAAAACTGTTTTTT	CASSAPWGLASHNEKLFF	TRBV6-1	TRBJ1-4
TGTGCCAGCAGTGAAGCCGAAATATTTAGGGTTAAAAGCTCCTACGAGCAGTACTTC	CASSEAEIFRVKSSYEQYF	TRBV2	TRBJ2-7
TGCGCCAGCAGCTCGCACAGTGGGGCAGCGGGAAGCAATCAGCCCCAGCATTTT	CASSSHSGAAGSNQPQHF	TRBV5-1	TRBJ1-5
TGTGCCAGCAGTGACGCAGGCAGGATTGGTCTAGCCAAAAACATTCAGTACTTC	CASSDAGRIGLAKNIQYF	TRBV6-4	TRBJ2-4
TGTGCCAGCAGCTGGCCGGGACAGGGGGGCTATGGCTACACCTTC	CASSWPGQGGYGYTF	TRBV7-9	TRBJ1-2
TGTGCCAGCAGTCGCGGTGAATGCAGGATTAACACTGAAGCTTTCTTT	CASSRGECRINTEAFF	TRBV28	TRBJ1-1
TGTGCTAGCAGCTTAGCGGTGAGCGGTTCGGCAGATACGCAGTATTTT	CASSLAVSGSADTQYF	TRBV7-7	TRBJ2-3
TGTGCCAGCAGCGGAACTAGCGGGGAGCTGTTTTTT	CASSGTSGELFF	TRBV7-3	TRBJ2-2
TGCGCCAGCAGCTTCCGATCGACAGGCCGGTCCTACGAGCAGTACTTC	CASSFRSTGRSYEQYF	TRBV5-1	TRBJ2-7
TGTGCCAGCAGTTATATGACAGGGAGCTACGAGCAGTACTTC	CASSYMTGSYEQYF	TRBV6-3	TRBJ2-7
TGTGCCAGCAGAGGTATCAGGGTACCCTACGAGCAGTACTTC	CASRGIRVPYEQYF	TRBV27	TRBJ2-7
TGCGCCAGCAGCCCTCCTGCGGGGTCGATGGGATACGAGCAGTACTTC	CASSPPAGSMGYEQYF	TRBV4-1	TRBJ2-7
TGTGCCAGTAGCAACAGGGTGGGCAATCAGCCCCAGCATTTT	CASSNRVGNQPQHF	TRBV19	TRBJ1-5
TGTGCCTACAGGGAAGTGGGCATGAACACTGAAGCTTTCTTT	CAYREVGMNTEAFF	TRBV24-1	TRBJ1-1
TGTGCTAGTGGTTTAGTGGGGACAGGGTTTCCCTACGAGCAGTACTTC	CASGLVGTGFPYEQYF	TRBV12-5	TRBJ2-7
TGTGCCAGTAAGCGGAGGCGGGGGGAGACCCAGTACTTC	CASKRRRGETQYF	TRBV19	TRBJ2-5
TGTGCCAGCAGCCAAGAGGATCCGCAGGGTCTGAGTAACGGGGAGCTGTTTTTT	CASSQEDPQGLSNGELFF	TRBV4-2	TRBJ2-2
TGTGCCAGCAGCTTAAGCGGATGGCAGAAGGAGGGGCGCGAAAACACTGAAGCTTTCTTT	CASSLSGWQKEGRENTEAFF	TRBV5-6	TRBJ1-1
TGCGCCAGCAGCCAATCCCCAGTCACCTACGAGCAGTACTTC	CASSQSPVTYEQYF	TRBV4-1	TRBJ2-7
TGTGCCATCAGTGTCAAGGGACAGGGAAAAGTGAACACTGAAGCTTTCTTT	CAISVKGQGKVNTEAFF	TRBV10-3	TRBJ1-1
TGTGCCAGCAATCTCGGGGCCCACCCTGAAAAACTGTTTTTT	CASNLGAHPEKLFF	TRBV2	TRBJ1-4
TGTGCCAGCAGGGGGAAGGGACCCTCCTATAATTCACCCCTCCACTTT	CASRGKGPSYNSPLHF	TRBV9	TRBJ1-6
TGTGCCAGCATCGGGGGGAGTACGAACACTGAAGCTTTCTTT	CASIGGSTNTEAFF	TRBV27	TRBJ1-1
TGCGCCAGCAGCGGAAAAACTAGCGGGAGGGCAGGCACAGATACGCAGTATTTT	CASSGKTSGRAGTDTQYF	TRBV5-1	TRBJ2-3
TGTGCCGAAATTCCCGGACCCAAACTGAGGGGGAACTGCTACAATGAGCAGTTCTTC	CAEIPGPKLRGNCYNEQFF	TRBV24-1	TRBJ2-1
TGCGCCAGCAGCCAACCGAGGTCCCGGGACAGGGTGCCGAACACTGAAGCTTTCTTT	CASSQPRSRDRVPNTEAFF	TRBV4-3	TRBJ1-1
TGTGCCAGCAGCGTAGTGGACAGGGCCCATGAGACCCAGTACTTC	CASSVVDRAHETQYF	TRBV9	TRBJ2-5
TGTGCCAGCAGCCACGTCCGTCTCGGAAGAGTAGCTTTCTTT	CASSHVRLGRVAFF	TRBV3-1	TRBJ1-1
TGTGCCAGCAGTTCCCCGGGGGGGGGCCGCTACGAGCAGTACTTC	CASSSPGGGRYEQYF	TRBV6-3	TRBJ2-7
TGTGCCAGCGGAATACCCCAGCCCCAGCATTTT	CASGIPQPQHF	TRBV6-4	TRBJ1-5
TGTGCCAGCAGCGGTGGGGGACCTAACTACGAGCAGTACTTC	CASSGGGPNYEQYF	TRBV13	TRBJ2-7
TGTGCCAGCAGCTGGCCAGGGAGGGCCCAACAAGAGACCCAGTACTTC	CASSWPGRAQQETQYF	TRBV5-4	TRBJ2-5
TGTGCCAGCAGCTACCCGGACAGGGGGCGGAACTACGAGCAGTACTTC	CASSYPDRGRNYEQYF	TRBV5-6	TRBJ2-7
TGTGCCAGCAGTCAGAAGGTGAACACTGAAGCTTTCTTT	CASSQKVNTEAFF	TRBV6-2	TRBJ1-1
TGTGCCAGACCAGGCCCTTACAGCGGGGCCAACGTCCTGACTTTC	CARPGPYSGANVLTF	TRBV19	TRBJ2-6
TGTGCCAGCAGTGAAGCTCCCGGGACTGGGACCGATTATGGCTACACCTTC	CASSEAPGTGTDYGYTF	TRBV2	TRBJ1-2
TGCGCCAGCAACAACAACCCACAGGGACTCTTC	CASNNNPQGLF	TRBV10-1	TRBJ2-1
TGTGCCAGCAGAGGGACGGGGGTGGCTCATCAGCCCCAGCATTTT	CASRGTGVAHQPQHF	TRBV6-3	TRBJ1-5
TGCAGTGCTAACCAAGCACCGGGACAGGTCTCCTACGAGCAGTACTTC	CSANQAPGQVSYEQYF	TRBV20-1	TRBJ2-7
TGTGCCAGCAGCCAAGGCCTGAGACAGGAGCCCCAGCATTTT	CASSQGLRQEPQHF	TRBV14	TRBJ1-5
TGTGCCATCCCCACAGAAGGCAAATGGAGTGGAAACACCATATATTTT	CAIPTEGKWSGNTIYF	TRBV10-3	TRBJ1-3
TGTGCCAGCAGTGAAATGGTAGCTAGCACAGATACGCAGTATTTT	CASSEMVASTDTQYF	TRBV6-1	TRBJ2-3
TGTGCCAGCAGTCCGACGGAGTACGCCAAAAACATTCAGTACTTC	CASSPTEYAKNIQYF	TRBV28	TRBJ2-4
TGTGCCAGCAGCTTCTTGGACATAGGTCAGCCCCAGCATTTT	CASSFLDIGQPQHF	TRBV5-6	TRBJ1-5
TGTGCCACCAGTGATTTCACGGACCTTATACTCGTGGAGACCCAGTACTTC	CATSDFTDLILVETQYF	TRBV24-1	TRBJ2-5
TGTGCCAGCAGCGCCATAGACTACGAGCAGTACTTC	CASSAIDYEQYF	TRBV6-3	TRBJ2-7
TGCAGTGCTAGGGAGCCGGGGACTAGCGGGAGATACAATGAGCAGTTCTTC	CSAREPGTSGRYNEQFF	TRBV20-1	TRBJ2-1
TGTGCCTGGGGGGGATGGGCGGATGGCTACACCTTC	CAWGGWADGYTF	TRBV30	TRBJ1-2
TGTGCCAGTGGAGGGACACTGTTTTTT	CASGGTLFF	TRBV6-4	TRBJ1-4
TGTGCCAGCACCCGGGACAGGGGACATGGTATCGGACTGTGGCAGTACTTC	CASTRDRGHGIGLWQYF	TRBV7-3	TRBJ2-7
TGTGCCAGCAGCCAGGGATACGAGCAGTACTTC	CASSQGYEQYF	TRBV4-2	TRBJ2-7
TGTGCCACCAGTGTACTTCGACAGGGGGCCAATTCACCCCTCCACTTT	CATSVLRQGANSPLHF	TRBV24-1	TRBJ1-6
TGCGCCAGCAGTGAGTCGGGGGGGGCAGATACGCAGTATTTT	CASSESGGADTQYF	TRBV10-1	TRBJ2-3
TGTGCCTGGAGTGTACACCTAGCTAGCGGACACACCGGGGAGCTGTTTTTT	CAWSVHLASGHTGELFF	TRBV30	TRBJ2-2
TGCGCCAGCAGCCAAGGTTCCATAGCGGGGGACAGCACAGATACGCAGTATTTT	CASSQGSIAGDSTDTQYF	TRBV4-1	TRBJ2-3
TGTGCCAGCAGCCCGCTAGGAGATATGGCCAACGTCCTGACTTTC	CASSPLGDMANVLTF	TRBV5-6	TRBJ2-6
TGTGCCAGCAGCCAGGGGGATGAGCAGTTCTTC	CASSQGDEQFF	TRBV7-3	TRBJ2-1
TGTGCCAGCAGCTGGATGCCAGGGACCGACATTGCCGGGGAGCTGTTTTTT	CASSWMPGTDIAGELFF	TRBV7-8	TRBJ2-2
TGTGCCAGCAGTAGCGGGAGTGGCTACGAGCAGTACTTC	CASSSGSGYEQYF	TRBV6-4	TRBJ2-7
TGCGCCAGCAGCTTGGCCCCCCCCTCGATCGGTCGTAGGCTCCAGCCCCAGCATTTT	CASSLAPPSIGRRLQPQHF	TRBV5-1	TRBJ1-5
TGCGCCAGCAGCACACGGGACGATTATGGCTACACCTTC	CASSTRDDYGYTF	TRBV5-1	TRBJ1-2
TGTGCCAGCAGAGAGGGCCTGGGCAACAATGAGCAGTTCTTC	CASREGLGNNEQFF	TRBV14	TRBJ2-1
TGTGCCAGCAGTGAACCACCGGACAGGGGACAGGATCAGCCCCAGCATTTT	CASSEPPDRGQDQPQHF	TRBV25-1	TRBJ1-5
TGTGCCACCAGTGGCACCTTGATCAATTCACCCCTCCACTTT	CATSGTLINSPLHF	TRBV24-1	TRBJ1-6
TGTGCCAGCAGCTGGGGGGGAGGGAATGAGCAGTTCTTC	CASSWGGGNEQFF	TRBV6-5	TRBJ2-1
TGTGCCAGCAGCAAGGACGGAGACAATGAGCAGTTCTTC	CASSKDGDNEQFF	TRBV7-3	TRBJ2-1
TGTGCCCCCCACGGTTGCAGGGGGAAGGAGCAGTACTTC	CAPHGCRGKEQYF	TRBV19	TRBJ2-7
TGTGCCAGCAGCTGGGTGTGGGAAGTTATGCGCGGGTCCACCGGGGAGCTGTTTTTT	CASSWVWEVMRGSTGELFF	TRBV7-4	TRBJ2-2
TGCAGTGCTAGTCCTCAAGGGACACGGGCCCCCTACGAGCAGTACTTC	CSASPQGTRAPYEQYF	TRBV20-1	TRBJ2-7
TGCAGCGTGTACGGTAAGTACACTGAAGCTTTCTTT	CSVYGKYTEAFF	TRBV29-1	TRBJ1-1
TGTGCCAGCAGCTTAGAAACACCTTTTCGAATCTCTGAAGCTTTCTTT	CASSLETPFRISEAFF	TRBV11-2	TRBJ1-1
TGTGCCAGCGCAAACGGGGGGTCCAGACAGGGAATCAATGAGCAGTTCTTC	CASANGGSRQGINEQFF	TRBV7-8	TRBJ2-1
TGTGCCTGGCCCGCGAGCGACGGAACCGGGACTGGCATCGGCAATGAGCAGTTCTTC	CAWPASDGTGTGIGNEQFF	TRBV30	TRBJ2-1
TGTGCCAGAGGGGAGGGGGATAATGCACGAGGAGGAGATACGCAGTATTTT	CARGEGDNARGGDTQYF	TRBV6-1	TRBJ2-3
TGTGCCAGCAGCCGAGAGGGACTAGCGGGGGGGCGAGGGGGTATCTTC	CASSREGLAGGRGGIF	TRBV7-4	TRBJ2-1
TGTGCCAGCAGTTATGACACTTCCTACGAGCAGTACTTC	CASSYDTSYEQYF	TRBV28	TRBJ2-7
TGTGCCAGCAGCCACCCGCCGGGACTAGCGGGAGAAGTCAATGAGCAGTTCTTC	CASSHPPGLAGEVNEQFF	TRBV14	TRBJ2-1
TGTGCCAGCAGCAACGGGGCCATCTATGGCTACACCTTC	CASSNGAIYGYTF	TRBV13	TRBJ1-2
TGTGCCAGCAGAGGACGTTCGAGGCCGCCTGACGGACGAGCCACCTCTGGAAACACCATATATTTT	CASRGRSRPPDGRATSGNTIYF	TRBV27	TRBJ1-3
TGTGCCAGCAGTCCCGCCCGGGACGACTCCTACAATGAGCAGTTCTTC	CASSPARDDSYNEQFF	TRBV2	TRBJ2-1
TGTGCCAGCAGGCAGGGCCTATACCAAGAGACCCAGTACTTC	CASRQGLYQETQYF	TRBV7-3	TRBJ2-5
TGTGCCAGCAGTAACCAGGGGCGAATGGCGATCGAGCAGTACTTC	CASSNQGRMAIEQYF	TRBV28	TRBJ2-7
TGTGCCAGCACCTCCGGGGGGACAGATTTCTACGAGCAGTACTTC	CASTSGGTDFYEQYF	TRBV12-4	TRBJ2-7
TGTGCCAGCAGTCAGACAGGGGGCTACACCTTC	CASSQTGGYTF	TRBV6-6	TRBJ1-2
TGTGCCAGCTCCCAGACAGGGGACACTGAAGCTTTCTTT	CASSQTGDTEAFF	TRBV18	TRBJ1-1
TGCGCCAGCAGCGCTGTTAACAGGGTGAGGAGCAATCAGCCCCAGCATTTT	CASSAVNRVRSNQPQHF	TRBV5-1	TRBJ1-5
TGTGCCACCAGCAGAGCGCTGAAGACCCAGTACTTC	CATSRALKTQYF	TRBV15	TRBJ2-5
TGTGCCAGCAGCCCCCAGGACAGGGACAATGACACTGAAGCTTTCTTT	CASSPQDRDNDTEAFF	TRBV5-6	TRBJ1-1
TGTGCCAGATGCCCCCCCAGGGCAAGGGACGAGCAGTACTTC	CARCPPRARDEQYF	TRBV6-5	TRBJ2-7
TGCGCCAGCAGCCGGGAGGGAATGGGCTATGGCTACACCTTC	CASSREGMGYGYTF	TRBV5-1	TRBJ1-2
TGTGCCAGCAGCTTAAGACTAGCGGGAGGGGCCTACGAGCAGTACTTC	CASSLRLAGGAYEQYF	TRBV7-2	TRBJ2-7
TGTGCCTGGAGTGGCGGTATGATTCGGCCGGGAGTCTACGAGCAGTTCTTC	CAWSGGMIRPGVYEQFF	TRBV30	TRBJ2-1
TGTGCCACCGCGGGAGACGAGCAGTACTTC	CATAGDEQYF	TRBV5-4	TRBJ2-7
TGCGCCAGCAGCTTGCGATCCCAGGGTAACGAGCAGTACTTC	CASSLRSQGNEQYF	TRBV5-1	TRBJ2-7
TGCAGCGTGGAGGACAGGGGACGTACTGAAGCTTTCTTT	CSVEDRGRTEAFF	TRBV29-1	TRBJ1-1
TGTGCCAGCAGCAAGAACTGGGGGAGGGAGCAGCCCCAGCATTTT	CASSKNWGREQPQHF	TRBV11-3	TRBJ1-5
TGTGCCAGCAGTAGGGGATTGAACACTGAAGCTTTCTTT	CASSRGLNTEAFF	TRBV2	TRBJ1-1
TGTGCCCTCCAGGGGGAGTCCTACGAGCAGTACTTC	CALQGESYEQYF	TRBV27	TRBJ2-7
TGTGCCTGGAGTTGTCAGGGGTATGAGGAGCCCTACGAGCAGTACTTC	CAWSCQGYEEPYEQYF	TRBV30	TRBJ2-7
TGCAGTGCTAGAGGTTCGGGCACAGAGACCCAGTACTTC	CSARGSGTETQYF	TRBV20-1	TRBJ2-5
TGTGCTAGTGGTTGTCGACAGGGGAGAGAGACTAGCTCCTACGAGCAGTACTTC	CASGCRQGRETSSYEQYF	TRBV12-5	TRBJ2-7
TGTGCCAGCAGCTCTTGGACAGGGAATAAGTCCTACGAGCAGTACTTC	CASSSWTGNKSYEQYF	TRBV7-3	TRBJ2-7
TGCAGCGTAAGGCCTGTCATATGGGGGGGCGACGACAATGAGCAGTTCTTC	CSVRPVIWGGDDNEQFF	TRBV29-1	TRBJ2-1
TGTGCCAGCAGTTTAATCCTGGACGAATGGACGGCGTGCAGCAAAAACATTCAGTACTTC	CASSLILDEWTACSKNIQYF	TRBV12-3	TRBJ2-4
TGTGCCAGCAGCCGGGGGGGCCAAAGCCCCGAGCAGTACTTC	CASSRGGQSPEQYF	TRBV7-3	TRBJ2-7
TGTGCCAGCAGCACGGCGGTCGGGGACAGGGGGAGGCCAACCGGGGAGCTGTTTTTT	CASSTAVGDRGRPTGELFF	TRBV7-3	TRBJ2-2
TGTGCCAGCAGTTATTCACCCAGGAGGGGCTCTGGAAACACCATATATTTT	CASSYSPRRGSGNTIYF	TRBV27	TRBJ1-3
TGTGCCAGCAGCTTAGGAGCTATTTCTGGAAACACCATATATTTT	CASSLGAISGNTIYF	TRBV7-9	TRBJ1-3
TGCGCCAGCAGCCGAGGGGGACAGGTGTATACAGATACGCAGTATTTT	CASSRGGQVYTDTQYF	TRBV5-1	TRBJ2-3
TGTGCCAGCAGTTTAGAGCTCACGGACAGGGGAATTTCGAGCTCCTACGAGCAGTACTTC	CASSLELTDRGISSSYEQYF	TRBV12-4	TRBJ2-7
TGTGCCAGCAGCACCTCAGGGGCCCCTCAAGCTGAAGCTTTCTTT	CASSTSGAPQAEAFF	TRBV7-2	TRBJ1-1
TGCAGTGCTACGGCGTACATCCGGGCTTTCTTT	CSATAYIRAFF	TRBV20-1	TRBJ1-1
TGCAGCGTCCCGGGACAGGGCTACGAGCAGTACTTC	CSVPGQGYEQYF	TRBV29-1	TRBJ2-7
TGTGCCAGTAGTATTTCGGGGGGCAGCGGGCCCCAGCATTTT	CASSISGGSGPQHF	TRBV19	TRBJ1-5
TGCAGCGTTGCCAGATACCGGGACCCCTACGAGCAGTACTTC	CSVARYRDPYEQYF	TRBV29-1	TRBJ2-7
TGCAGTGCTCTGAAAGGGCCGGATCAGCCCCAGCATTTT	CSALKGPDQPQHF	TRBV20-1	TRBJ1-5
TGTGCCAGCAGCTTGGGGGGGTGGAATCAGCCCCAGCATTTT	CASSLGGWNQPQHF	TRBV7-9	TRBJ1-5
TGTGCCAGCAGCCCTCTCGAGGGGAAAATTGCAACTAATGAAAAACTGTTTTTT	CASSPLEGKIATNEKLFF	TRBV7-6	TRBJ1-4
TGTGCCAGCAGCTATCCCGGGAGTAAAGAGACCCAGTACTTC	CASSYPGSKETQYF	TRBV5-8	TRBJ2-5
TGTGCCACCTGGACCGGCTCTGGGGCCAACGTCCTGACTTTC	CATWTGSGANVLTF	TRBV6-5	TRBJ2-6
TGTGCCAGCAGTGAAAGGCGGGAGGTCGACGCAGCTTTTACCGGGGAGCTGTTTTTT	CASSERREVDAAFTGELFF	TRBV6-4	TRBJ2-2
TGTGCCAGCAGCTTACCTCCATTACTAGCGGGAGCGGATGAAAAACTGTTTTTT	CASSLPPLLAGADEKLFF	TRBV7-9	TRBJ1-4
TGTGCCAGCAGCCCCCAGGGTAGTAGGGGACACGGGTTAGCTTTCTTT	CASSPQGSRGHGLAFF	TRBV13	TRBJ1-1
TGCAGTCCCGGGGAGGGGGGGGGGGGGAGGGCCACTGAAGCTTTCTTT	CSPGEGGGGRATEAFF	TRBV20-1	TRBJ1-1
TGTGCTAGTGGTTTGGCAGGGGGACGTCCTAACTATGGCTACACCTTC	CASGLAGGRPNYGYTF	TRBV12-5	TRBJ1-2
TGTGCCAGCAGCCCCCCAAGGGAGAGGGATGATTACGAGCAGTACTTC	CASSPPRERDDYEQYF	TRBV3-1	TRBJ2-7
TGTGCCAGCAGCTTGGTGTTGGCGGCCTACGAGCAGTACTTC	CASSLVLAAYEQYF	TRBV5-4	TRBJ2-7
TGTGCCACCAGCAGAGCTTTCGGACAGGGTAGAGCAACTAATGAAAAACTGTTTTTT	CATSRAFGQGRATNEKLFF	TRBV15	TRBJ1-4
TGCAGCAGAGGAGGGACGGTATTAGTTGAAGCTTTCTTT	CSRGGTVLVEAFF	TRBV29-1	TRBJ1-1
TGCGCCAGCAGCCGGGACTTAGTTAATTCACCCCTCCACTTT	CASSRDLVNSPLHF	TRBV5-1	TRBJ1-6
TGCGCCAGCAGTGTCAAGGTAAGGCACCAGAGGGGCTACACCTTC	CASSVKVRHQRGYTF	TRBV10-2	TRBJ1-2
TGTGCTAGCAGCTTAGCGAAGTTCGACCCGACAGTGTATGAAAAACTGTTTTTT	CASSLAKFDPTVYEKLFF	TRBV7-7	TRBJ1-4
TGTGCCAGCAGCCGCAGGGGTGTTGGAAACACCATATATTTT	CASSRRGVGNTIYF	TRBV9	TRBJ1-3
TGTGCCAGCAGCCAGCGGGGCTACAATGAGCAGTTCTTC	CASSQRGYNEQFF	TRBV6-4	TRBJ2-1
TGTGCCAGCAGCGACAGGGGACCCTACAATGAGCAGTTCTTC	CASSDRGPYNEQFF	TRBV2	TRBJ2-1
TGTGCCAGCAGCTGTTGGCCCGCGGGAAGGGAGTACTTC	CASSCWPAGREYF	TRBV7-3	TRBJ2-5
TGTGCCAGCAGCGTCCGAGGGAACCGCTACGAGCAGTACTTC	CASSVRGNRYEQYF	TRBV9	TRBJ2-7
TGCAGTGCTCAGGCTAACTCTGGAAACACCATATATTTT	CSAQANSGNTIYF	TRBV20-1	TRBJ1-3
TGTGCCAGCAGTAGGGGGGAAGCCTACGAGCAGTACTTC	CASSRGEAYEQYF	TRBV12-3	TRBJ2-7
TGTGCCAGCAGCTCGGAGGGGGGGGGGGAATGCTCCTACAATGAGCAGTTCTTC	CASSSEGGGECSYNEQFF	TRBV7-9	TRBJ2-1
TGTGCCACCAGTGATCCCGACAGCGAATACAATGAGCAGTTCTTC	CATSDPDSEYNEQFF	TRBV24-1	TRBJ2-1
TGTGCCAGTAGTGGGTCCGGGCACTACGAGCAGTACTTC	CASSGSGHYEQYF	TRBV19	TRBJ2-7
TGCGCCAGCCAGGGGGGGGATAATCCCAATGAGCAGTTCTTC	CASQGGDNPNEQFF	TRBV5-1	TRBJ2-1
TGTGCCAGCAGCTCCCAATTGGGGCTGAACACTGAAGCTTTCTTT	CASSSQLGLNTEAFF	TRBV14	TRBJ1-1
TGTGCCAGCAGCTTAATCCGAAGGTGGGAACCGGAGGATCACAATGAGCAGTTCTTC	CASSLIRRWEPEDHNEQFF	TRBV11-2	TRBJ2-1
TGCAGCGTTGAAACCCGGGACAGGCGCAATCAGCCCCAGCATTTT	CSVETRDRRNQPQHF	TRBV29-1	TRBJ1-5
TGTGCCAGCAGCCAAGAAGGGGGGGCAAGCTACGAGCAGTACTTC	CASSQEGGASYEQYF	TRBV3-1	TRBJ2-7
TGCAGTGCTAGAGATTACTTGTACACTGAAGCTTTCTTT	CSARDYLYTEAFF	TRBV20-1	TRBJ1-1
TGTGCCTGGTGCAGGACAGGGGCTGGAAACACCATATATTTT	CAWCRTGAGNTIYF	TRBV30	TRBJ1-3
TGTGCCAGCAGTTTAACCCTCAGGATTGCTGGAAACACCATATATTTT	CASSLTLRIAGNTIYF	TRBV28	TRBJ1-3
TGCGCCAGCAGCCGGTGGTGCCGGGACAGTGTCAGCTCCTATAATTCACCCCTCCACTTT	CASSRWCRDSVSSYNSPLHF	TRBV5-1	TRBJ1-6
TGCGCCAGCTGGGCGGACAGGGGGCCCCTACAAGAGACCCAGTACTTC	CASWADRGPLQETQYF	TRBV10-1	TRBJ2-5
TGTGCCAGCAGCGGACACAATATAGAAAAACTGTTTTTT	CASSGHNIEKLFF	TRBV13	TRBJ1-4
TGTGCCAGCTTTACAGGGGCTTTCTTT	CASFTGAFF	TRBV6-4	TRBJ1-1
TGTGCCAGCAGCTCCTGGGAGGGGAAGACGGAGACCCAGTACTTC	CASSSWEGKTETQYF	TRBV13	TRBJ2-5
TGCAGTGCTAGGCCCCCCGGGGGTAGGTTCGAGCAGTACTTC	CSARPPGGRFEQYF	TRBV20-1	TRBJ2-7
TGTGCCAGCACCCCCTCGCGTCCCTCCCGGGACAGGGATGAGCAGTTCTTC	CASTPSRPSRDRDEQFF	TRBV6-4	TRBJ2-1
TGTGCCAGCAGTTACTCGGGGACGAGTTCGAAAGAGACCCAGTACTTC	CASSYSGTSSKETQYF	TRBV6-5	TRBJ2-5
TGTGCCAGCAGTTCAGGGCCGGAGAGCAATCAGCCCCAGCATTTT	CASSSGPESNQPQHF	TRBV12-4	TRBJ1-5
TGTGCCAGCAGCCCGCAACCTTTTAGTTCTTGGTGTTACGAGCAGTACTTC	CASSPQPFSSWCYEQYF	TRBV14	TRBJ2-7
TGTGCCACCAGTGATTTGGGACTCCAACATAGGGGGCTCAATCAGCCCCAGCATTTT	CATSDLGLQHRGLNQPQHF	TRBV24-1	TRBJ1-5
TGTGCCAGCAGCTTGCGGGGGACTAGCGGGCAAGAGACCCAGTACTTC	CASSLRGTSGQETQYF	TRBV5-4	TRBJ2-5
TGCGCCAGCAGGGACCAGGGCAAGCACTTGCGTAAGGACGAGCAGTACTTC	CASRDQGKHLRKDEQYF	TRBV10-1	TRBJ2-7
TGTGCCAGCAGCTTCATGGCGGCCTACGAGCAGTACTTC	CASSFMAAYEQYF	TRBV7-4	TRBJ2-7
TGTGCCAGCAGGTCCTGGACAGGCTATGGCTACACCTTC	CASRSWTGYGYTF	TRBV14	TRBJ1-2
TGTGCCAAGGGACAGGGCTTGTGCACTGAAGCTTTCTTT	CAKGQGLCTEAFF	TRBV27	TRBJ1-1
TGTGCCACCAGTGGGCCCGTGTACAATGAGCAGTTCTTC	CATSGPVYNEQFF	TRBV24-1	TRBJ2-1
TGTGCCAGCACGGAAGGGGGCGAGGGGATGAACACTGAAGCTTTCTTT	CASTEGGEGMNTEAFF	TRBV28	TRBJ1-1
TGTGCCAGCAGCTCAGGGATCTACAACACTGAAGCTTTCTTT	CASSSGIYNTEAFF	TRBV13	TRBJ1-1
TGTGCCAGCAGCCCCTCAGGGAGTGCCACTGAAGCTTTCTTT	CASSPSGSATEAFF	TRBV13	TRBJ1-1
TGTGCCAGCAGTTACGTAAGCAACGGGGTCACAGATACGCAGTATTTT	CASSYVSNGVTDTQYF	TRBV6-3	TRBJ2-3
TGTGCCAGCAGCCAACTTATACCGGGACAGGGGCCCTACGAGCAGTACTTC	CASSQLIPGQGPYEQYF	TRBV4-2	TRBJ2-7
TGTGCCAGCAGTGCACCTCGGGAGCAGTTCTTC	CASSAPREQFF	TRBV6-4	TRBJ2-1
TGTGCCAGCAGTGACCTACAGGGGCGAGCTAACTATGGCTACACCTTC	CASSDLQGRANYGYTF	TRBV6-4	TRBJ1-2
TGTGCCAGCAGCTTCCAACACAGGGGGAGCTCCTACAATGAGCAGTTCTTC	CASSFQHRGSSYNEQFF	TRBV13	TRBJ2-1
TGTGCCACCAGCACCGGTATCCGATATTTCACCGGGGAGCTGTTTTTT	CATSTGIRYFTGELFF	TRBV15	TRBJ2-2
TGCAGCGGGCTTCGGACTAGCGGGCCGAGCTACGAGCAGTACTTC	CSGLRTSGPSYEQYF	TRBV29-1	TRBJ2-7
TGTGCCAGCAGCAGGGTGCGGGAGACCTCGGCCTACGAGCAGTACTTC	CASSRVRETSAYEQYF	TRBV7-3	TRBJ2-7
TGTGCCAGCAGCGGCTTGGGAGGCAGCCTTAATGAAAAACTGTTTTTT	CASSGLGGSLNEKLFF	TRBV7-3	TRBJ1-4
TGTGCCAGCAGTGAACTTTTACTGGCCAGAACTAATGAAAAACTGTTTTTT	CASSELLLARTNEKLFF	TRBV6-1	TRBJ1-4
TGTGCCAGCAGCCAAGCTTTCGGGAACAACTATGGCTACACCTTC	CASSQAFGNNYGYTF	TRBV14	TRBJ1-2
TGTGCCAGCAAGCGTCCAGTGACTAAACCCCTCCACTTT	CASKRPVTKPLHF	TRBV28	TRBJ1-6
TGTGCCACCACAGTTACAGAGTACCGAGCTTTCTTT	CATTVTEYRAFF	TRBV24-1	TRBJ1-1
TGTGCCTTGAGTATCGAGGTAGGCTCCTACAATGAGCAGTTCTTC	CALSIEVGSYNEQFF	TRBV30	TRBJ2-1
TGTGCCAGCACCCGAGGCAATCAGCCCCAGCATTTT	CASTRGNQPQHF	TRBV12-3	TRBJ1-5
TGTGCCAGCAGCACTCGGACAGGGTGGGGGGAGCACCCGGGCAATCAGCCCCAGCATTTT	CASSTRTGWGEHPGNQPQHF	TRBV13	TRBJ1-5
TGTGCCAGCAGCTGCCCTGGGGGGCCCGCCTCCTACAATGAGCAGTTCTTC	CASSCPGGPASYNEQFF	TRBV7-2	TRBJ2-1
TGTGCCAGCAGCCACCGGGACTACGAGCAGTACTTC	CASSHRDYEQYF	TRBV7-3	TRBJ2-7
TGTGCCAGCAGCGTTAATGGGGCCGATACGCAGTATTTT	CASSVNGADTQYF	TRBV7-2	TRBJ2-3
TGTGCCAGCAGCGACTCCGCGGGACGGGACAGAGGCTACAATGAGCAGTTCTTC	CASSDSAGRDRGYNEQFF	TRBV13	TRBJ2-1
TGTGCCAGCCGGACAGGGACTAACATTCAGTACTTC	CASRTGTNIQYF	TRBV9	TRBJ2-4
TGTGCCAGCAGCCAAGAGTCCGACAGGGGGTATGGCTACACCTTC	CASSQESDRGYGYTF	TRBV3-1	TRBJ1-2
TGCAGTGCCCCGTTCTCGGACAGTTTCCACTATGGCTACACCTTC	CSAPFSDSFHYGYTF	TRBV20-1	TRBJ1-2
TGTGCCAGCAGTCCCGGGGACACTGAAGCTTTCTTT	CASSPGDTEAFF	TRBV6-1	TRBJ1-1
TGTGCCAGCAGGACGCATGCGGGCCTCTTC	CASRTHAGLF	TRBV14	TRBJ2-1
TGTGCCAGCAGTTCAGATCAGAACTATGGCTACACCTTC	CASSSDQNYGYTF	TRBV12-3	TRBJ1-2
TGTACGAGGTCACATGAGCAGTTCTTC	CTRSHEQFF	TRBV30	TRBJ2-1
TGCGCCAGCAGCCAAAAACAACGGGCGACTCGGAGGAGTTGCAATCAGCCCCAGCATTTT	CASSQKQRATRRSCNQPQHF	TRBV4-1	TRBJ1-5
TGTGCCAGCAGCCCCGATACCCATAAGCGGGGAACTAGCACAGATACGCAGTATTTT	CASSPDTHKRGTSTDTQYF	TRBV13	TRBJ2-3
TGCGCCAGCCTGTTCCCTAGCGGGAGGGATGAGCAGTTCTTC	CASLFPSGRDEQFF	TRBV5-1	TRBJ2-1
TGTGCCAGCAGTTTAGGCGGTACCAAAGGGACTAGGTGTTCACCCCTCCACTTT	CASSLGGTKGTRCSPLHF	TRBV12-3	TRBJ1-6
TGCAGTGCTTACGGCTCGACAGGGTTGTCGGAGACCCAGTACTTC	CSAYGSTGLSETQYF	TRBV20-1	TRBJ2-5
TGTGCCAGCAGCTACGAGCGGGAGCGTGAAGCTTTCTTT	CASSYEREREAFF	TRBV6-4	TRBJ1-1
TGTGCCAGCAGTCCAAGATATCTAGCCACTCTTGAGACCCAGTACTTC	CASSPRYLATLETQYF	TRBV6-4	TRBJ2-5
TGTGCCAGCAGCTTATGTAAGGGGCCTAACTATGGCTACACCTTC	CASSLCKGPNYGYTF	TRBV11-3	TRBJ1-2
TGTGCCACCAGTGAGCGAACACAGAGTGGAAACACCATATATTTT	CATSERTQSGNTIYF	TRBV24-1	TRBJ1-3
TGTGCCAGCAGCTTAGTGACCAAAGGACAAACTGAGCTAGTGGAGCAGTACTTC	CASSLVTKGQTELVEQYF	TRBV11-3	TRBJ2-7
TGTGCCAGCAAATGGGAGGGTCTAGACAATGAGCAGTTCTTC	CASKWEGLDNEQFF	TRBV19	TRBJ2-1
TGTGCCAGCAGCCGGACAGATGGCTACACCTTC	CASSRTDGYTF	TRBV13	TRBJ1-2
TGTGCCAGCAGTGACTCGATTGGCAGTGGGATTAACGCAAAACTGTTTTTT	CASSDSIGSGINAKLFF	TRBV6-4	TRBJ1-4
TGTGCCAATTGGGACGCCGCAGCGGGATTCGGGGTCATGAACACTGAAGCTTTCTTT	CANWDAAAGFGVMNTEAFF	TRBV7-9	TRBJ1-1
TGTGCCAGCGTGTTTCCCGACCTCCCAAGAGAGGGTTACCCAGATACGCAGTATTTT	CASVFPDLPREGYPDTQYF	TRBV6-1	TRBJ2-3
TGTGCCAGCAGTTACTCGATAGGGGGACTAGCGGGTTGCACAGATACGCAGTATTTT	CASSYSIGGLAGCTDTQYF	TRBV6-2	TRBJ2-3
TGCGCCAGCAAAAGACTAGACAAATCCCAAGAGACCCAGTACTTC	CASKRLDKSQETQYF	TRBV5-1	TRBJ2-5
TGTGCCAGCAGCGGGGGGCGGGATGAGCAGTTCTTC	CASSGGRDEQFF	TRBV13	TRBJ2-1
TGTGCCAGCAGCGTAGTTATGAATGAGCAGTTCTTC	CASSVVMNEQFF	TRBV9	TRBJ2-1
TGTGCTAGTGGGACAGGAGCCAAGGGAAACACCATATATTTT	CASGTGAKGNTIYF	TRBV12-5	TRBJ1-3
TGTGCCAGCAGTTACACGCGTTTCCCGGGACTAGCGGGAGCCTACCGCCTAAGGAATGAGCAGTTCTTC	CASSYTRFPGLAGAYRLRNEQFF	TRBV6-9	TRBJ2-1
TGTGCCAGCAGCCGCCGGGACAGGGGGCCCAGTGCAACTAATGAAAAACTGTTTTTT	CASSRRDRGPSATNEKLFF	TRBV6-3	TRBJ1-4
TGCGCCAGCAGTGAACTGGACAGGGAGCGGGCAGGTCTAAAAGAGACCCAGTACTTC	CASSELDRERAGLKETQYF	TRBV10-1	TRBJ2-5
TGCGCCAGCAAGACAGGGTACGGCTACACCTTC	CASKTGYGYTF	TRBV10-1	TRBJ1-2
TGTGCCACCAGCCAAGGGGGGCTAGGCGAGCAGTACTTC	CATSQGGLGEQYF	TRBV15	TRBJ2-7
TGTGCCAGCAGCTTAGAGCTATACCGGGACAGGGGTGGCTACACCTTC	CASSLELYRDRGGYTF	TRBV11-2	TRBJ1-2
TGCGCCAGCAGCTTCGTGGCAAGTAGATATGGCTACACCTTC	CASSFVASRYGYTF	TRBV5-1	TRBJ1-2
TGTGCCAGCAGGGTACGGGAGGTCTCCTACAATGAGCAGTTCTTC	CASRVREVSYNEQFF	TRBV6-5	TRBJ2-1
TGTGCCAGCAGCATCCTCACACTTAGACACGAGCAGTACTTC	CASSILTLRHEQYF	TRBV7-9	TRBJ2-7
TGCAGCCTAGCCTACAATGAGCAGTTCTTC	CSLAYNEQFF	TRBV29-1	TRBJ2-1
TGCAGTGCTAGACGAGGTCCGGGGTTCTATGGCTACACCTTC	CSARRGPGFYGYTF	TRBV20-1	TRBJ1-2
TGTGCCAGCAGCACTAGCGGGCACTCCTACAATGAGCAGTTCTTC	CASSTSGHSYNEQFF	TRBV9	TRBJ2-1
TGTGCCAGCAGAAAGGGACTAGCGGGTGGAAGATATGAGCAGTTCTTC	CASRKGLAGGRYEQFF	TRBV6-5	TRBJ2-1
TGTGCCAGCAGCCTTACAGGGGAAGTGGCGGGCGACACTGAAGCTTTCTTT	CASSLTGEVAGDTEAFF	TRBV2	TRBJ1-1
TGCGCCAGCAGCTTGAATGAGGGGGGGAACACTGAAGCTTTCTTT	CASSLNEGGNTEAFF	TRBV5-1	TRBJ1-1
TGCAGTGCTAGAACCGGGGACCGAGCGAACACTGAAGCTTTCTTT	CSARTGDRANTEAFF	TRBV20-1	TRBJ1-1
TGTGCCAGCAGCCTTACAGCTTTCTTT	CASSLTAFF	TRBV7-9	TRBJ1-1
TGCAGTGCTAGAGAGGGGGACAGGGACAGCGGAGAGACCCAGTACTTC	CSAREGDRDSGETQYF	TRBV20-1	TRBJ2-5
TGTGCCACCAGTGTTGGCAGTCCTGAAGCTTTCTTT	CATSVGSPEAFF	TRBV24-1	TRBJ1-1
TGCGCCAGCAGCGCAGCTCCCAAAAACATTCAGTACTTC	CASSAAPKNIQYF	TRBV4-3	TRBJ2-4
TGTGCCACCTCCTTACATAGCGGTAGCGGGGGGTCTACCACCGGGGAGCTGTTTTTT	CATSLHSGSGGSTTGELFF	TRBV24-1	TRBJ2-2
TGTGCCAGCTCACCACCGGTAACGATCCCAGAGTGCACCGGGGAGCTGTTTTTT	CASSPPVTIPECTGELFF	TRBV18	TRBJ2-2
TGTGCCAGCAGTTGGAAGGGCGGGGGGCTAGCGTTACACGAGCAGTACTTC	CASSWKGGGLALHEQYF	TRBV6-5	TRBJ2-7
TGCAGCGTCCTACCGGAATGCAATCAGCCCCAGCATTTT	CSVLPECNQPQHF	TRBV29-1	TRBJ1-5
TGTGCCAGCAGTCTGCCCCGGCCCGCAGAGACCCAGTACTTC	CASSLPRPAETQYF	TRBV28	TRBJ2-5
TGCGCCAGCAGGGAAAAAGCCGAAGGGTTCGGTTCATCACCCCTCCACTTT	CASREKAEGFGSSPLHF	TRBV5-1	TRBJ1-6
TGTGCCAGCAGCCCTGACACCTGCTCGACAGCCGGTAACACCATATATTTT	CASSPDTCSTAGNTIYF	TRBV3-1	TRBJ1-3
TGTGCCAGCAGCTTACATCAGGGGGCTACCGGGGAGCTGTTTTTT	CASSLHQGATGELFF	TRBV13	TRBJ2-2
TGCGCCATGGTTGCGGGAGAAGCGTGGAATGAGCAGTTCTTC	CAMVAGEAWNEQFF	TRBV5-1	TRBJ2-1
TGCGCCAGCAGCCAAGACCAGGACTTAGGCTACACCTTC	CASSQDQDLGYTF	TRBV4-3	TRBJ1-2
TGTGCCAGCAGCGGTGCGGGAGTAAGGAACAATGAGCAGTTCTTC	CASSGAGVRNNEQFF	TRBV9	TRBJ2-1
TGTGCCAGCAGTCAGGCACAGGGGGATAATGAAAAACTGTTTTTT	CASSQAQGDNEKLFF	TRBV6-5	TRBJ1-4
TGTGCCAGTAGTGGTTCAGATACGCAGTATTTT	CASSGSDTQYF	TRBV19	TRBJ2-3
TGTGCCCCCTCGGGACTAGCGGGAGACAATGAGCAGTTCTTC	CAPSGLAGDNEQFF	TRBV25-1	TRBJ2-1
TGTGCCAGCAGCTGGACTGAAAAACTGTTTTTT	CASSWTEKLFF	TRBV5-6	TRBJ1-4
TGTGCCAGCAGCTTAGAACAGGGAGGGGAAAAACTGTTTTTT	CASSLEQGGEKLFF	TRBV7-9	TRBJ1-4
TGTGCCAGCAGCCCCCCAGTGGAGGGACAGGGGGGTAATAACACTGAAGCTTTCTTT	CASSPPVEGQGGNNTEAFF	TRBV5-4	TRBJ1-1
TGTGCCAGCAGTTGGGGGCCATGCACAGATACGCAGTATTTT	CASSWGPCTDTQYF	TRBV2	TRBJ2-3
TGTGCCATCAGCTGGCTACGGGGATACGAGCAGTACTTC	CAISWLRGYEQYF	TRBV10-3	TRBJ2-7
TGTGCCACCAGCCGGAACAGGGCATCGGGCACTGAAGCTTTCTTT	CATSRNRASGTEAFF	TRBV24-1	TRBJ1-1
TGTGCCAGCCGCGTTTCAGGGGCATGGGGAGACGAAAAACTGTTTTTT	CASRVSGAWGDEKLFF	TRBV6-2	TRBJ1-4
TGTGCCAGCAGTGACTCGAGTCGGGGAAGAAATCAGCCCCAGCATTTT	CASSDSSRGRNQPQHF	TRBV6-4	TRBJ1-5
TGTGCCAGCAGCTTGGCCCCTCTCAGGAGAGGTGTAAATCAGCCCCAGCATTTT	CASSLAPLRRGVNQPQHF	TRBV5-6	TRBJ1-5
TGTGCCAGTAGTATGTGTTACATACTAGCGGGAGCGGGGCGTGAGCAGTTCTTC	CASSMCYILAGAGREQFF	TRBV19	TRBJ2-1
TGCGCCAGCAGCAGGGGGGGGCCAGGTTACAATGAGCAGTTCTTC	CASSRGGPGYNEQFF	TRBV5-1	TRBJ2-1
TGTGCCAGCAGCGTAGCCCGACAGGTAGAGAATGGGAACACCGGGGAGCTGTTTTTT	CASSVARQVENGNTGELFF	TRBV9	TRBJ2-2
TGTGCCAGCAGCCAAAAGCACCCAGAAGCGGGCTTTTCACCCCTCCACTTT	CASSQKHPEAGFSPLHF	TRBV3-1	TRBJ1-6
TGTGCCAGCAGTGGGGGACTAGGACTCAAGGAGACCGGGGAGCTGTTTTTT	CASSGGLGLKETGELFF	TRBV6-1	TRBJ2-2
TGTGCCAGCAGTGTTCTGGAGGACACTGAAGCTTTCTTT	CASSVLEDTEAFF	TRBV2	TRBJ1-1
TGTGCCAGCAGAGAGGGGGGGTGGGCGAACACCGGGGAGCTGTTTTTT	CASREGGWANTGELFF	TRBV27	TRBJ2-2
TGCGCCAGCAATCTAGCGGGAGAAAAGGCCGGACTATGGGTGAGCGAGCAGTACTTC	CASNLAGEKAGLWVSEQYF	TRBV10-1	TRBJ2-7
TGTGCCAGCAGCTTAACGTGCACCTACCTGACTAGCGGGGGCGGGTACAATGAGCAGTTCTTC	CASSLTCTYLTSGGGYNEQFF	TRBV7-2	TRBJ2-1
TGTGCCAGCAGCCAAGATGTCAGGGGGACAGGCTATGGCTACACCTTC	CASSQDVRGTGYGYTF	TRBV4-2	TRBJ1-2
TGTGCCACCAGTGATTTTCTAGCGGGGCCCGACTACAATGAGCAGTTCTTC	CATSDFLAGPDYNEQFF	TRBV24-1	TRBJ2-1
TGTGCCAGCAGCTTAGGTCCGAACGGAGGGGGAGAGACCCAGTACTTC	CASSLGPNGGGETQYF	TRBV7-9	TRBJ2-5
TGTGCCAGTAGGGGACAGGGTCTATACACAGATACGCAGTATTTT	CASRGQGLYTDTQYF	TRBV19	TRBJ2-3
TGTGCCAGCAGTGAATATTTACCGGGACAGGGGAGTGAAGCTTTCTTT	CASSEYLPGQGSEAFF	TRBV25-1	TRBJ1-1
TGCAGTGCTAGAGATGATCTCGGGGGGGGGGATCAGCCCCAGCATTTT	CSARDDLGGGDQPQHF	TRBV20-1	TRBJ1-5
TGTGCCAGCAGCCACCAGGGGGCAGAACGTAGGGCCCAGCATTTT	CASSHQGAERRAQHF	TRBV3-1	TRBJ1-5
TGCAGTGCTAGAAAACAGTACGAGCAGTACTTC	CSARKQYEQYF	TRBV20-1	TRBJ2-7
TGTGCCAGCAGTGGGGGCTATTCCGACTATGGCTACACCTTC	CASSGGYSDYGYTF	TRBV27	TRBJ1-2
TGTGCCAGCACGAATGCTAGCGGAAATACGCAGTATTTT	CASTNASGNTQYF	TRBV2	TRBJ2-3
TGCAGTGCTAGACGAGCAGTCATCGAGCAGTACTTC	CSARRAVIEQYF	TRBV20-1	TRBJ2-7
TGTGCCTGGAAGGACGCAGTAGGGGAGCTGTTTTTT	CAWKDAVGELFF	TRBV30	TRBJ2-2
TGTGCCAGCAGCCGACCACGGACAGGCGAAAATCAGCCCCAGCATTTT	CASSRPRTGENQPQHF	TRBV13	TRBJ1-5
TGTGCCAGCGCCGAGGACAGGGTTGATACTGAAGCTTTCTTT	CASAEDRVDTEAFF	TRBV27	TRBJ1-1
TGTGCCAGCAGCTTAGTACGCCCCAGCTGCAATCAGCCCCAGCATTTT	CASSLVRPSCNQPQHF	TRBV7-2	TRBJ1-5
TGTGCCAGCAGCGGCGATTTTTACCGGTTCACAGAGGATCAGCCCCAGCATTTT	CASSGDFYRFTEDQPQHF	TRBV6-4	TRBJ1-5
TGTGCCAGCAATGGGACGGGACACATCAATGAGCAGTTCTTC	CASNGTGHINEQFF	TRBV13	TRBJ2-1
TGTGCCGGGGGCCGGGACAGGGGGGAGGAATTAAAAGAGACCCAGTACTTC	CAGGRDRGEELKETQYF	TRBV6-1	TRBJ2-5
TGTGCCAGCAGACCTTTACCGACTAGCGGAGGGGGGGAGCTGTTTTTT	CASRPLPTSGGGELFF	TRBV2	TRBJ2-2
TGTGCCAGTAGTAGCGAGACGAACACTGAAGCTTTCTTT	CASSSETNTEAFF	TRBV19	TRBJ1-1
TGTGCCATCAGTGAGCCTACGGGGTACGATACGCAGTATTTT	CAISEPTGYDTQYF	TRBV10-3	TRBJ2-3
TGTGCCATCAGTGAGGGGGGACAGGGAGATAGCAATCAGCCCCAGCATTTT	CAISEGGQGDSNQPQHF	TRBV10-3	TRBJ1-5
TGTGCCAGCAGCCAAGAGCGGGCCGAGACCCCGGGACTAGCGGATCGGGGGGAGGAGACCCAGTACTTC	CASSQERAETPGLADRGEETQYF	TRBV14	TRBJ2-5
TGTGCCAGCAGTGGAGCCCTAGCGGGGGCTAGCACAGATACGCAGTATTTT	CASSGALAGASTDTQYF	TRBV6-1	TRBJ2-3
TGTGCCACCCGCGAACCCAAAATGGGGACGGAGGATACCGGGGAGCTGTTTTTT	CATREPKMGTEDTGELFF	TRBV24-1	TRBJ2-2
TGTGCCAGCAGCCCCGCCTCCCCCCCGGGGACGACAGTTTTCCATCCCGGGGAGCTGTTTTTT	CASSPASPPGTTVFHPGELFF	TRBV9	TRBJ2-2
TGTGCCACCAGTGATTGGACGGGGCCCCAGCATTTT	CATSDWTGPQHF	TRBV24-1	TRBJ1-5
TGTGCCAGCAGCGTACCCAGGGGGCCGGGACTCTGTGGGGACTTC	CASSVPRGPGLCGDF	TRBV9	TRBJ2-7
TGTGCCACCAGTGATTTGCGGGAGATAGGTCCTAACAATCAGCCCCAGCATTTT	CATSDLREIGPNNQPQHF	TRBV24-1	TRBJ1-5
TGTGCCAGCAGTTTAGTCCCGAATGGGGCGCACCAAGCTTTCTTT	CASSLVPNGAHQAFF	TRBV12-4	TRBJ1-1
TGTGCCAGCAGCTTATACATCCGCACGAACACTGAAGCTTTCTTT	CASSLYIRTNTEAFF	TRBV7-2	TRBJ1-1
TGTGCCAAAGACAGGGGGCGCGGAAACACCATATATTTT	CAKDRGRGNTIYF	TRBV28	TRBJ1-3
TGTGCCAGCTCACTCACGGGCTACAATGAGCAGTTCTTC	CASSLTGYNEQFF	TRBV18	TRBJ2-1
TGTGCCAGCAAGAATCCGGGACATAGGAAGAAGTATTTT	CASKNPGHRKKYF	TRBV7-4	TRBJ1-3
TGTGCCATCAGCAATTACACGCTGAACACTGAAGCTTTCTTT	CAISNYTLNTEAFF	TRBV10-3	TRBJ1-1
TGTGCCAGCAGCTCCACTCCGGGACAGTCGGGGCAGCCCCAGCATTTT	CASSSTPGQSGQPQHF	TRBV7-9	TRBJ1-5
TGTGCCAGCAGCGGCACATCTTCAAACAATCAGCCCCAGCATTTT	CASSGTSSNNQPQHF	TRBV7-3	TRBJ1-5
TGTGCCAGCAGTTACGGACTAGCGGGAGTTTCCAAAAACATTCAGTACTTC	CASSYGLAGVSKNIQYF	TRBV6-6	TRBJ2-4
TGTGCCAGCAGCCCATCAGGGACAGGGGCCTCTGGGGCCAACGTCCTGACTTTC	CASSPSGTGASGANVLTF	TRBV13	TRBJ2-6
TGTGCCAGCAGTTTAACCAGCCGGGACAGGGTAGTCGAGCAGTACTTC	CASSLTSRDRVVEQYF	TRBV28	TRBJ2-7
TGTGCCAGCAGTCCGGGGGGCTCAGATACGCAGTATTTT	CASSPGGSDTQYF	TRBV27	TRBJ2-3
TGTGCTAGTGGTTTGGGGCCCAGCAATCAGCCCCAGCATTTT	CASGLGPSNQPQHF	TRBV12-5	TRBJ1-5
TGTGCCAGCAGCCTTTTAGGGGGGTGCTATAATTCACCCCTCCACTTT	CASSLLGGCYNSPLHF	TRBV5-5	TRBJ1-6
TGTGCCAGCAGGGTTCCAACCGGGACAGGGGATACAAACACTGAAGCTTTCTTT	CASRVPTGTGDTNTEAFF	TRBV5-4	TRBJ1-1
TGCAGTGCTACCAGGGGGAGGGCCAACGTCCTGACTTTC	CSATRGRANVLTF	TRBV20-1	TRBJ2-6
TGCGCCAGCAGCCAGAGCAGTCGAGGTAACTATGGCTACACCTTC	CASSQSSRGNYGYTF	TRBV4-3	TRBJ1-2
TGTGCCAGCAGCTTGTGCCCGGGACTAGCCTGCTCCTACAATGAGCAGTTCTTC	CASSLCPGLACSYNEQFF	TRBV5-6	TRBJ2-1
TGTGCCACCGCTCAGGGGGCGACCGGGGAGCTGTTTTTT	CATAQGATGELFF	TRBV6-1	TRBJ2-2
TGTGCCAGCAGCCTCCCGATGCGGGGTTATGGGAATGAGCAGTTCTTC	CASSLPMRGYGNEQFF	TRBV3-1	TRBJ2-1
TGTGCCAGCAGCCCCCCTGGGGATCATAGGGGGAAAAAGACGGGTGAAGCTTTCTTT	CASSPPGDHRGKKTGEAFF	TRBV5-8	TRBJ1-1
TGCGCCAGCAAGGCCTTCCGGGGGGGCTCTCACTACGAGCAGTACTTC	CASKAFRGGSHYEQYF	TRBV5-1	TRBJ2-7
TGCAGTGCTAGAAGCCCCGGGACTAGCGGGATTAGCACAGATACGCAGTATTTT	CSARSPGTSGISTDTQYF	TRBV20-1	TRBJ2-3
TGCGCCAGCAGGGGGGACCAATACAGGGTCGTGAACACTGAAGCTTTCTTT	CASRGDQYRVVNTEAFF	TRBV5-1	TRBJ1-1
TGTGCCAGCAGTTACCGCCGGGACCTCGAGCAGTACTTC	CASSYRRDLEQYF	TRBV6-5	TRBJ2-7
TGTGCCAGCAGTGAATGGAGAGGGGGGAACACTGAAGCTTTCTTT	CASSEWRGGNTEAFF	TRBV6-1	TRBJ1-1
TGTGCCAGCATAGGGTATGACAGGTTACATGGCTACACCTTC	CASIGYDRLHGYTF	TRBV7-4	TRBJ1-2
TGTGCCACCAGTGCGCTGGGCCTGAACTATGGCTACACCTTC	CATSALGLNYGYTF	TRBV24-1	TRBJ1-2
TGTGCCATCAGTGACACCCCGAACAGGGATGAGCAGTTCTTC	CAISDTPNRDEQFF	TRBV10-3	TRBJ2-1
TGTGCCAGCAGTTCTACCCGACCCTGCTACCAAGCTTTCTTT	CASSSTRPCYQAFF	TRBV27	TRBJ1-1
TGTGCCAGCAGCCAAGAGGGAAATCAGCCCCAGCATTTT	CASSQEGNQPQHF	TRBV4-2	TRBJ1-5
TGTGCCACCAGAACAATGGACAGGGTCAATCAGCCCCAGCATTTT	CATRTMDRVNQPQHF	TRBV24-1	TRBJ1-5
TGTGCCAGGGGGACCGGGAAGGGGAAAGCCAAAAACATTCAGTACTTC	CARGTGKGKAKNIQYF	TRBV6-2	TRBJ2-4
TGTGCCAGTAGTGGGAAAGGACAGGGGGATATTTACGAGCAGTACTTC	CASSGKGQGDIYEQYF	TRBV19	TRBJ2-7
TGTGCCAGCAGCTTAGGCAGGACAGTCTACGAGCAGTACTTC	CASSLGRTVYEQYF	TRBV7-9	TRBJ2-7
TGTGCCAGCAGTTTACCGGGGACAGCTCAAACGACTGAAGCTTTCTTT	CASSLPGTAQTTEAFF	TRBV27	TRBJ1-1
TGTGCCAGCAGCAACACACAGGGAGCTTCCTATAATTCACCCCTCCACTTT	CASSNTQGASYNSPLHF	TRBV9	TRBJ1-6
TGTGCCAGCAGCAGGGAAAAACTGTTTTTT	CASSREKLFF	TRBV7-9	TRBJ1-4
TGTGCCAGCAGTGGAGGACGGGGGGAGCTGTTTTTT	CASSGGRGELFF	TRBV25-1	TRBJ2-2
TGTGCCAGTAGCCTAGCGCCTTTCGAGACCTACAATGAGCAGTTCTTC	CASSLAPFETYNEQFF	TRBV19	TRBJ2-1
TGCGCCAGCAGCTGTGGCCGGGACGGGTACTTC	CASSCGRDGYF	TRBV5-1	TRBJ2-7
TGTGCCAGTAGTATATCAAGACAGGTTAACAATGAGCAGTTCTTC	CASSISRQVNNEQFF	TRBV19	TRBJ2-1
TGTGCCAGCAGCTTAGATCTGAGCTCCTACAATGAGCAGTTCTTC	CASSLDLSSYNEQFF	TRBV7-9	TRBJ2-1
TGTGCCAGCAGCCAATCGTCTGCGGACAGGAGCTCCTACGAGCAGTACTTC	CASSQSSADRSSYEQYF	TRBV16	TRBJ2-7
TGTGCCAGCAGTCATAGCAATCAGCCCCAGCATTTT	CASSHSNQPQHF	TRBV6-1	TRBJ1-5
TGCAGTGCTAGAGATACTCAGACCCGTTACGAGACCCAGTACTTC	CSARDTQTRYETQYF	TRBV20-1	TRBJ2-5
TGCAGCGTCGGACATCCTACAATCTACGAGCAGTACTTC	CSVGHPTIYEQYF	TRBV29-1	TRBJ2-7
TGCGCCAGCAGCTCTCGATGGGACAGGCAGCCCCAGCATTTT	CASSSRWDRQPQHF	TRBV5-1	TRBJ1-5
TGTGCCAGCAGCTTGGTCACGGCGGTACTAGGCAGCACAGATACGCAGTATTTT	CASSLVTAVLGSTDTQYF	TRBV5-6	TRBJ2-3
TGTGCCAGCAGCGGAGGGGGCGATGAAGCTTTCTTT	CASSGGGDEAFF	TRBV7-3	TRBJ1-1
TGTGCCAGCTCACTCACAGTTAATTCACCCCTCCACTTT	CASSLTVNSPLHF	TRBV18	TRBJ1-6
TGTGCCAGCAGAGGGGTAGACAGGGGCTCTTCTAGGAGGTCTGAAGCTTTCTTT	CASRGVDRGSSRRSEAFF	TRBV2	TRBJ1-1
TGTGCCAGCAGTTTGGTTACGGGGACCTTCCAGGATAGCAATCAGCCCCAGCATTTT	CASSLVTGTFQDSNQPQHF	TRBV27	TRBJ1-5
TGTGCCAGCAGCTGGCTTCTGACTAGCGGGGGTTACACCGGGGAGCTGTTTTTT	CASSWLLTSGGYTGELFF	TRBV7-3	TRBJ2-2
TGTGCCAGCAGCTTGGCCCTGCCTATGACCTACAATGAGCAGTTCTTC	CASSLALPMTYNEQFF	TRBV5-5	TRBJ2-1
TGTGCCAGCAGTTTTGGAGTTACTCTCCATAGCACAGATACGCAGTATTTT	CASSFGVTLHSTDTQYF	TRBV28	TRBJ2-3
TGTGCCACCAGCAGAGATTGGCCCGGGGAGGACACTGAAGCTTTCTTT	CATSRDWPGEDTEAFF	TRBV15	TRBJ1-1
TGTGCCAGCAGTGGACGACAGGGGGCAATTAATGAAAAACTGTTTTTT	CASSGRQGAINEKLFF	TRBV6-5	TRBJ1-4
TGTGCCAGCAGTTTCTCCAAATTTCAAGAGACAGGGAGTAATCAGCCCCAGCATTTT	CASSFSKFQETGSNQPQHF	TRBV28	TRBJ1-5
TGTGCCACCAGACCTGATGGGGCAGTGCGCTCTGGGGCCAACGTCCTGACTTTC	CATRPDGAVRSGANVLTF	TRBV24-1	TRBJ2-6
TGTGCCAGCAGTTCAAGGCCTTATGGCTACACCTTC	CASSSRPYGYTF	TRBV25-1	TRBJ1-2
TGTGCCAGTAGAATCTACCAAGAGACCCAGTACTTC	CASRIYQETQYF	TRBV19	TRBJ2-5
TGTGCCACCAGCACACAATTCAATCAGCCCCAGCATTTT	CATSTQFNQPQHF	TRBV15	TRBJ1-5
TGTGCCAGCAGCCAACTTCCCGAAGGGACAGACGTCGAGACCCAGTACTTC	CASSQLPEGTDVETQYF	TRBV14	TRBJ2-5
TGTGCCAGCTCCCAGACTAGTTACGATGCCTCCTACGAGCAGTACTTC	CASSQTSYDASYEQYF	TRBV6-1	TRBJ2-7
TGTGCCAGCAGCTTTAAGCCGTCTGCCTACGAGCAGTACTTC	CASSFKPSAYEQYF	TRBV7-9	TRBJ2-7
TGCAGTGCGGCACCTCTGGCGGGAGTGGGCATCGTCTACGAGCAGTACTTC	CSAAPLAGVGIVYEQYF	TRBV20-1	TRBJ2-7
TGTGCCAGCAGCTTAGCCTTAAAGCTAAGGACTAGCGGGGGGAGCTGCTACGAGCAGTACTTC	CASSLALKLRTSGGSCYEQYF	TRBV11-3	TRBJ2-7
TGCGCCAGCCAGCGACGGGGGAACACTGAAGCTTTCTTT	CASQRRGNTEAFF	TRBV5-1	TRBJ1-1
TGTGCCAGCAGGTGTCTCGTTTGCACAGATACGCAGTATTTT	CASRCLVCTDTQYF	TRBV6-6	TRBJ2-3
TGCGCCAGCAGGTTGACAGACTACGAGCAGTACTTC	CASRLTDYEQYF	TRBV10-1	TRBJ2-7
TGTGCCAGCAGCTGGACAGAAAAGAATGAAAAACTGTTTTTT	CASSWTEKNEKLFF	TRBV13	TRBJ1-4
TGTGCCAGCAGCCAAGAGTCAGGGCGGACTAAAGAGACCCAGTACTTC	CASSQESGRTKETQYF	TRBV3-1	TRBJ2-5
TGTGCCAGCTCTCCAGGGGGCGCACCCAGCTCCTATAATTCACCCCTCCACTTT	CASSPGGAPSSYNSPLHF	TRBV18	TRBJ1-6
TGTGCCAGCAGCACGACGTCGAGGGATTCCTACGAGCAGTACTTC	CASSTTSRDSYEQYF	TRBV5-5	TRBJ2-7
TGTGCCAGCAGTTACGGACAGAGGCATTTT	CASSYGQRHF	TRBV6-4	TRBJ1-5
TGCGCCAGCAGCTGGTACATTTACTACGAGCAGTACTTC	CASSWYIYYEQYF	TRBV4-1	TRBJ2-7
TGTGCCACCAATCCGCAAGAGGGGTATAGGGGCTTGGATAGCTCCTATAATTCACCCCTCCACTTT	CATNPQEGYRGLDSSYNSPLHF	TRBV24-1	TRBJ1-6
TGTGCCAGCAGTGAAGACTGGGGGAGTGAGAGCAATCAGCCCCAGCATTTT	CASSEDWGSESNQPQHF	TRBV6-1	TRBJ1-5
TGTGCCATAATTCGGGACAAAAGCGCCTTC	CAIIRDKSAF	TRBV11-3	TRBJ1-2
TGCGCCAGCAGCCCGTATACAGGGGGCAGGGGCTACGAGCAGTACTTC	CASSPYTGGRGYEQYF	TRBV5-1	TRBJ2-7
TGTGCCAGCAGCCCTCAGTGCTTTGACAGAGGGGGGGCCGGGGAGCTGTTTTTT	CASSPQCFDRGGAGELFF	TRBV7-7	TRBJ2-2
TGTGCCAGCAGCCCGCGCTGGACTAGCGGCTGCTCCTACGAGCAGTACTTC	CASSPRWTSGCSYEQYF	TRBV7-4	TRBJ2-7
TGTGCCAGCAGTGTCCCAAGGAAAGGGGCTAATGAGCAGTTCTTC	CASSVPRKGANEQFF	TRBV27	TRBJ2-1
TGCGCCAGCAGCGGTAACTCACGGGTCGCTAGCTCCTACGAGCAGTACTTC	CASSGNSRVASSYEQYF	TRBV5-1	TRBJ2-7
TGTGCCAGCAGTTACTCGACCTTAAGACAGGGGGCCTACGAGCAGTACTTC	CASSYSTLRQGAYEQYF	TRBV6-5	TRBJ2-7
TGTGCCAGCAGCCACAAAGAGGGGCCAGATCAGCCCCAGCATTTT	CASSHKEGPDQPQHF	TRBV3-1	TRBJ1-5
TGTGCCACCAGTGTCGGGGGCACAGATACGCAGTATTTT	CATSVGGTDTQYF	TRBV24-1	TRBJ2-3
TGTGCCAGCAAAAGTCGCGGGGGAGGAAACACCATATATTTT	CASKSRGGGNTIYF	TRBV7-2	TRBJ1-3
TGTGCCAGCAGCCGGCGACTGACCGGGAGCACAGATACGCAGTATTTT	CASSRRLTGSTDTQYF	TRBV7-4	TRBJ2-3
TGTGCCAGCAGCCAACTCCGCTGGTATCACAATGAGCAGTTCTTC	CASSQLRWYHNEQFF	TRBV3-1	TRBJ2-1
TGTGCCACCAGTGTTCCAGGGATGAACACTGAAGCTTTCTTT	CATSVPGMNTEAFF	TRBV24-1	TRBJ1-1
TGCAGTGCACTAGCGGGAGGGCCTCGGGAGGAGGTTATGAACACTGAAGCTTTCTTT	CSALAGGPREEVMNTEAFF	TRBV20-1	TRBJ1-1
TGCAGTGCTAAAAAGAGGACAGGGAACTATGGCTACACCTTC	CSAKKRTGNYGYTF	TRBV20-1	TRBJ1-2
TGCGCCAGCAGCCAAGATTCGGACAGGGAGGAAGGCTCCTATAATTCACCCCTCCACTTT	CASSQDSDREEGSYNSPLHF	TRBV4-3	TRBJ1-6
TGTGCCACCAGTGATTTTAGAACGCGGGGAACGCAGTACTTC	CATSDFRTRGTQYF	TRBV24-1	TRBJ2-7
TGTGCCAGCAACTTCGCCGGGACAGGTGAGCAGTACTTC	CASNFAGTGEQYF	TRBV6-3	TRBJ2-7
TGTGCCAGCAGCTCCCACAGCCTCGGTGGGGAGCTGTTTTTT	CASSSHSLGGELFF	TRBV7-3	TRBJ2-2
TGTGCCAGCAGGGCGTCTTTAGGGGGCAATTATAATGAAAAACTGTTTTTT	CASRASLGGNYNEKLFF	TRBV6-1	TRBJ1-4
TGTGCCAGCAGCCCATGGACGTTACAGCCCCAGCATTTT	CASSPWTLQPQHF	TRBV5-6	TRBJ1-5
TGTCGGATTAACAATGAGCAGTTCTTC	CRINNEQFF	TRBV20-1	TRBJ2-1
TGCAGTGCTAGAGATTCGACTAGCGGGGGGGACAATGAGCAGTTCTTC	CSARDSTSGGDNEQFF	TRBV20-1	TRBJ2-1
TGTGCCAGCCAAACTGTGGGACAGGGGGCGCGCGACGAGCAGTACTTC	CASQTVGQGARDEQYF	TRBV27	TRBJ2-7
TGTGCCTGGAGCGACCGGGGTTTCTCTGGGGCCAACGTCCTGACTTTC	CAWSDRGFSGANVLTF	TRBV30	TRBJ2-6
TGCGCCAGCAGCCAAGATAACAACGGCTCCTACAATGAGCAGTTCTTC	CASSQDNNGSYNEQFF	TRBV4-1	TRBJ2-1
TGTGCCAGCAGCCATTGGGGGGGCACTTTTGAAGTAGGCTACACCGGGGAGCTGTTTTTT	CASSHWGGTFEVGYTGELFF	TRBV13	TRBJ2-2
TGTGCCAGCAGCCAAGATAGGGGTTCCAGCTCCTACGAGCAGTACTTC	CASSQDRGSSSYEQYF	TRBV14	TRBJ2-7
TGTGCCAGCAGCTTAGCTAGGGACGCTAATGGAAACACCATATATTTT	CASSLARDANGNTIYF	TRBV7-9	TRBJ1-3
TGTGCCAGCAGTCTCATTCGCGAGCAGTACTTC	CASSLIREQYF	TRBV6-5	TRBJ2-7
TGTGCCAGTAGTATACCTCAGGTCCTCTATGGCTACACCTTC	CASSIPQVLYGYTF	TRBV19	TRBJ1-2
TGTGCCAGCAGTTTATCCCAGTGGAACCCCACAGGGGCCTACGAGCAGTACTTC	CASSLSQWNPTGAYEQYF	TRBV27	TRBJ2-7
TGTGCCAGCAGTCTGGACAGGGGGGGGAATCAGCCCCAGCATTTT	CASSLDRGGNQPQHF	TRBV12-3	TRBJ1-5
TGTGCCAGCAGCTTATATGGGGCCTCTACTGGCTACACCTTC	CASSLYGASTGYTF	TRBV7-4	TRBJ1-2
TGCGCCAGCAGCCAAGAGCCGGCATGGGGACCCTACGAGCAGTACTTC	CASSQEPAWGPYEQYF	TRBV4-1	TRBJ2-7
TGTGCCAGCAGATGCTCTAGCGGGGGGGACGAGCAGTACTTC	CASRCSSGGDEQYF	TRBV28	TRBJ2-7
TGTGCCAGCAGTTTGAAGCGGCCATTATCTCCTCCCTACGAGCAGTACTTC	CASSLKRPLSPPYEQYF	TRBV12-3	TRBJ2-7
TGTGCCAGTACCCAATCTACTAGCGGGGGCACCGGGGAGCTGTTTTTT	CASTQSTSGGTGELFF	TRBV19	TRBJ2-2
TGTGCCATCAACACACGGAGCAGGGGCTATGGCTACACCTTC	CAINTRSRGYGYTF	TRBV10-3	TRBJ1-2
TGCGCCAGCAGCCCTGGCTGCCCGACAGGGGTAATTTATGGCTACACCTTC	CASSPGCPTGVIYGYTF	TRBV4-1	TRBJ1-2
TGTGCCACCAGTGATTTTGCGAGCCAGGGGGGCCAGTGCCAGTATTTT	CATSDFASQGGQCQYF	TRBV24-1	TRBJ2-3
TGTGCCAGCTCACCAGAGGTAAAAGAAAAACTGTTTTTT	CASSPEVKEKLFF	TRBV18	TRBJ1-4
TGTGCCAGCAGTTTATCTCGGACAGGGCGAATTGGCTACACCTTC	CASSLSRTGRIGYTF	TRBV27	TRBJ1-2
TGTGCCTGGAGTGTTCCGGGACTAGCGGGAACGAACACCGGGGAGCTGTTTTTT	CAWSVPGLAGTNTGELFF	TRBV30	TRBJ2-2
TGTGCCAGCAGTTTATCGGAACCCACCTTTGATGGGAATGAGCAGTTCTTC	CASSLSEPTFDGNEQFF	TRBV12-4	TRBJ2-1
TGTGCCAGCTCCGTTACCTACGAGCAGTACTTC	CASSVTYEQYF	TRBV27	TRBJ2-7
TGTGCCAGCAGCATAACCCGGAACAGTAAAGTTAATCCGACCAATGAGCAGTTCTTC	CASSITRNSKVNPTNEQFF	TRBV9	TRBJ2-1
TGTGCCAGCAGCCAAGGGGGTTTAACTGTAGCGGGCTTGAACACCGGGGAGCTGTTTTTT	CASSQGGLTVAGLNTGELFF	TRBV3-1	TRBJ2-2
TGTGCCAGCAGCTTATCAGGGCACTCCTACGAGCAGTACTTC	CASSLSGHSYEQYF	TRBV7-8	TRBJ2-7
TGCAGTGCTCTAGACAACTCTGGAAACACCATATATTTT	CSALDNSGNTIYF	TRBV20-1	TRBJ1-3
TGTGCCAGCAGCTTGCCCACAGGGCGGAGGCCTTCACCCCTCCACTTT	CASSLPTGRRPSPLHF	TRBV5-6	TRBJ1-6
TGCAGTGCTAGCAAAGGGGGGCTTTCCCAGCCCCAGCATTTT	CSASKGGLSQPQHF	TRBV20-1	TRBJ1-5
TGTGCCAGGGGCAGCAATCAGCCCCAGCATTTT	CARGSNQPQHF	TRBV27	TRBJ1-5
TGTGCCAGCAGCGGGGGTCGAATGGACGGGCATGAGCAGTTCTTC	CASSGGRMDGHEQFF	TRBV11-1	TRBJ2-1
TGTGCCAGCAGTTGTACTAGCGGGAGCCCGAATTCACCCCTCCACTTT	CASSCTSGSPNSPLHF	TRBV6-2	TRBJ1-6
TGTGCCAGCAGCCACCCAGGTTCTGAAGCTTTCTTT	CASSHPGSEAFF	TRBV4-2	TRBJ1-1
TGTGCCAGCAGTGCCCTGTCTTACGCCTACGAGCAGTACTTC	CASSALSYAYEQYF	TRBV25-1	TRBJ2-7
TGTGCCAGCGTATGCGGGAGAGGGGAGCTGTTTTTT	CASVCGRGELFF	TRBV11-3	TRBJ2-2
TGCGCCAGCAAGGAAAGGACAGGAGATACGCAGTATTTT	CASKERTGDTQYF	TRBV5-1	TRBJ2-3
TGTGCCACCAGCCTGGGTGACACCGGGGAGCTGTTTTTT	CATSLGDTGELFF	TRBV24-1	TRBJ2-2
TGTGCCAGCAGTGACTCGACCGAAGGCGACAGGGGGAATAGCAATCAGCCCCAGCATTTT	CASSDSTEGDRGNSNQPQHF	TRBV6-4	TRBJ1-5
TGCGCCAGCAGCCAGGAATTCGTAAAGGGGGGTTACGAGCAGTACTTC	CASSQEFVKGGYEQYF	TRBV4-1	TRBJ2-7
TGTGCCAGCAGTTCCATCCTCCCTACTGAAAAACTGTTTTTT	CASSSILPTEKLFF	TRBV6-5	TRBJ1-4
TGCGCCAGCAGCCCTCCAGGGGAGTTCTACGAGCAGTACTTC	CASSPPGEFYEQYF	TRBV4-3	TRBJ2-7
TGTGCCAGCAGTAGGACTAGCGGAGCAGATACGCAGTATTTT	CASSRTSGADTQYF	TRBV12-3	TRBJ2-3
TGTGCCACCAGCAGAGTTGCGGGGTACGAGCAGTACTTC	CATSRVAGYEQYF	TRBV15	TRBJ2-7
TGTGCCAGCAGCGTCAGGGCTTCACCCCTCCACTTT	CASSVRASPLHF	TRBV6-3	TRBJ1-6
TGCGCCAGCAGCTTGAGCTACGAGCAGTACTTC	CASSLSYEQYF	TRBV5-1	TRBJ2-7
TGTGCCAGCAGCGGTACACCGGAGACGTACCGCTTC	CASSGTPETYRF	TRBV9	TRBJ2-5
TGTGCTAGTGGTTTGGTAGAATGGACTAGCGGGGGGTACCAAGAGACCCAGTACTTC	CASGLVEWTSGGYQETQYF	TRBV12-5	TRBJ2-5
TGTGCCAGTAGTCTAGTAGCGGTCCCGGAGACCCAGTACTTC	CASSLVAVPETQYF	TRBV24-1	TRBJ2-5
TGTGCCAGCAGTACCGGCGTCTCCAGGAGCTCCTACGAGCAGTACTTC	CASSTGVSRSSYEQYF	TRBV12-4	TRBJ2-7
TGTGCCAGCAGCCGACTAGCGGACGAGCAGTACTTC	CASSRLADEQYF	TRBV7-7	TRBJ2-7
TGTGCCAGCAGTTACTCGTATAGCGGAGCGCTTCAAGAGACCCAGTACTTC	CASSYSYSGALQETQYF	TRBV6-2	TRBJ2-5
TGTGCCAGCACGAGGGGGGGGGAGCAGTACTTC	CASTRGGEQYF	TRBV11-3	TRBJ2-7
TGTGCCATCAGCCCTACCCACAGACAGGGCACCACTGAAGCTTTCTTT	CAISPTHRQGTTEAFF	TRBV10-3	TRBJ1-1
TGTGCCAGCAGCCGACAGGGTCTTATCTACAATGAGCAGTTCTTC	CASSRQGLIYNEQFF	TRBV5-4	TRBJ2-1
TGTGCCTGGAGTGGTAGGACAGGGGCGGCAGAGCAGTACTTC	CAWSGRTGAAEQYF	TRBV30	TRBJ2-7
TGCGCCAGCAGTGGGACACGCCGCCCCCGTGATGAAAAACTGTTTTTT	CASSGTRRPRDEKLFF	TRBV10-1	TRBJ1-4
TGCAGCGTGACTCGAAGGGGCCCCGTGGGGAGCACAGATACGCAGTATTTT	CSVTRRGPVGSTDTQYF	TRBV29-1	TRBJ2-3
TGTGCCAGCAGCGACAGGGGGCGCGTCTATGGCTACACCTTC	CASSDRGRVYGYTF	TRBV13	TRBJ1-2
TGTGCCAGTAGTATCGGGACAGGGGAAGCTTTCTTT	CASSIGTGEAFF	TRBV19	TRBJ1-1
TGTGCCAGCACCGGTATGTACAATGAGCAGTTCTTC	CASTGMYNEQFF	TRBV6-4	TRBJ2-1
TGTGCCAGCAGCGCCCCGATCGTGAACACTGAAGCTTTCTTT	CASSAPIVNTEAFF	TRBV7-2	TRBJ1-1
TGTGCCAGCAGTTCTTGCGACAGGGCGGTTAGCAATCAGCCCCAGCATTTT	CASSSCDRAVSNQPQHF	TRBV2	TRBJ1-5
TGTGCCATCATGTCTCAGGGTCTTGGCTGGCCTATGTACCAAGAGACCCAGTACTTC	CAIMSQGLGWPMYQETQYF	TRBV10-3	TRBJ2-5
TGTGCGCGCACCCCATGGGGGCTTCCGGGGGAGGATTCACCCCTCCACTTT	CARTPWGLPGEDSPLHF	TRBV6-2	TRBJ1-6
TGTGCCAGCATTGGCTACGTAGCGGGACGAAGGTTAGATACGCAGTATTTT	CASIGYVAGRRLDTQYF	TRBV27	TRBJ2-3
TGTGCCAGCAGCTTGGATAGCTCCCTTCAACAGGGTACGAGTGGCAATCAGCCCCAGCATTTT	CASSLDSSLQQGTSGNQPQHF	TRBV7-6	TRBJ1-5
TGTGCCAGCAGTGACGGCATTGGACTAGCGGGGCGCAGCTCCTACAATGAGCAGTTCTTC	CASSDGIGLAGRSSYNEQFF	TRBV6-1	TRBJ2-1
TGTGCCACCAGCAGGCCCCCCCCGGCCTCCGGGACAGGGGCATACGAGCAGTACTTC	CATSRPPPASGTGAYEQYF	TRBV15	TRBJ2-7
TGTGCCAGCAGCCTTATCCCCCTAAGCAGCCGGGAGTCCTACGAGCAGTACTTC	CASSLIPLSSRESYEQYF	TRBV11-3	TRBJ2-7
TGTGCCAGCAGCCCCATCGGGGGGGTTAATGAGCAGTTCTTC	CASSPIGGVNEQFF	TRBV7-6	TRBJ2-1
TGTGCCATCAGGCGCAGGCATTGTCGCTACGAGCAGTACTTC	CAIRRRHCRYEQYF	TRBV10-3	TRBJ2-7
TGTGCCTGGAGTGTACTCACAGATCCAGGCACAGATACGCAGTATTTT	CAWSVLTDPGTDTQYF	TRBV30	TRBJ2-3
TGTGCCAGTAGTATAGATTTACGGGGACGGCCCACAGATACGCAGTATTTT	CASSIDLRGRPTDTQYF	TRBV19	TRBJ2-3
TGTGCCAGCAGCTGGCACAGGGCCCGTTTCCGCGACCGAACAAATCAGCCCCAGCATTTT	CASSWHRARFRDRTNQPQHF	TRBV7-2	TRBJ1-5
TGCAGTGCTAGATGCCCCAGGGGGCATATGAACACTGAAGCTTTCTTT	CSARCPRGHMNTEAFF	TRBV20-1	TRBJ1-1
TGTGCCAGCAGCCACGGGACAGATAACTATGGCTACACCTTC	CASSHGTDNYGYTF	TRBV13	TRBJ1-2
TGTGCCAGCAGCCAAGGTCGGAGAAGGCCCCAGCATTTT	CASSQGRRRPQHF	TRBV14	TRBJ1-5
TGTGAGGCCGGGACTAGCTCCTACGAGCAGTACTTC	CEAGTSSYEQYF	TRBV7-9	TRBJ2-7
TGTGCCACCAGTGATTCGGTAAGTAGGTCGTACAATGAGCAGTTCTTC	CATSDSVSRSYNEQFF	TRBV24-1	TRBJ2-1
TGCGCCAGCACGAGAGGCCCCAGTTCAAAACTGTTTTTT	CASTRGPSSKLFF	TRBV10-2	TRBJ1-4
TGTGCCAGCAGTGCAAAAATGCCGGGGGCGAACTATGGCTACACCTTC	CASSAKMPGANYGYTF	TRBV6-1	TRBJ1-2
TGTGCCAGCAGCCAAGAACCTTTTATCGGGGGACAAGGCAATCAGCCCCAGCATTTT	CASSQEPFIGGQGNQPQHF	TRBV14	TRBJ1-5
TGTGCCAGCAGCTTCCAAGGCCTTAGGACTAGCGGGGGGGCCGTCACAGATACGCAGTATTTT	CASSFQGLRTSGGAVTDTQYF	TRBV7-4	TRBJ2-3
TGTGCCACCAGTGATTTGCATGTAGGCGGGACTAGCGGGTTAGAGCAGTTCTTC	CATSDLHVGGTSGLEQFF	TRBV24-1	TRBJ2-1
TGCGCCAGCAGCTTGGACAGTCGCAGGATAGCCAAAAACATTCAGTACTTC	CASSLDSRRIAKNIQYF	TRBV5-1	TRBJ2-4
TGCGCCAGCCCATTAGGGGAGAACCCCACTGAAGCTTTCTTT	CASPLGENPTEAFF	TRBV10-1	TRBJ1-1
TGTGCCAGCAGCCTACTAGCGGTTGAGCTCTACGAGCAGTACTTC	CASSLLAVELYEQYF	TRBV13	TRBJ2-7
TGTGCCACCAGTGACCCGTCCGGGACCGATCCTGGAAACACCATATATTTT	CATSDPSGTDPGNTIYF	TRBV24-1	TRBJ1-3
TGTGCCAGCAGTTGGGGATATGTTGAGCAGTTCTTC	CASSWGYVEQFF	TRBV12-4	TRBJ2-1
TGTGCCAGCAGTTACTCACCAGGGACTAGCGGGGGGGCCGCAGATACGCAGTATTTT	CASSYSPGTSGGAADTQYF	TRBV6-5	TRBJ2-3
TGTGCCAGCAGCAGCGGGGGCCGCTTC	CASSSGGRF	TRBV13	TRBJ2-5
TGTGCCTCACCGGGGCGGCACACCGGGGAGCTGTTTTTT	CASPGRHTGELFF	TRBV30	TRBJ2-2
TGCGCCAGCAGCCAAGACCCCACCGGGGGGGCAACTAATGAAAAACTGTTTTTT	CASSQDPTGGATNEKLFF	TRBV4-3	TRBJ1-4
TGTGCCAGCAGTCTTGGGGAAACAGGGCGTCTCGACACTGAAGCTTTCTTT	CASSLGETGRLDTEAFF	TRBV28	TRBJ1-1
TGTGCCAGTAGACCCGAAGGGGGGGGTAAGAACACTGAAGCTTTCTTT	CASRPEGGGKNTEAFF	TRBV19	TRBJ1-1
TGTGCCAGCAGTTTTCTCTCAGACCTATATAACTATGGCTACACCTTC	CASSFLSDLYNYGYTF	TRBV12-3	TRBJ1-2
TGCGCCAGCATCAAACCGGGACAGGGCCTGAGGTATGGCTACACCTTC	CASIKPGQGLRYGYTF	TRBV10-2	TRBJ1-2
TGTGCCAGCAGCCAAGCCCCACTAGCGGGTTACAATGAGCAGTTCTTC	CASSQAPLAGYNEQFF	TRBV4-2	TRBJ2-1
TGTGCCAGCAGCCGAGAAATAGGGGATAGCACAGATACGCAGTATTTT	CASSREIGDSTDTQYF	TRBV27	TRBJ2-3
TGTGCCAGCAGGAGAGACAGGGAGGGGGACACCGGGGAGCTGTTTTTT	CASRRDREGDTGELFF	TRBV6-2	TRBJ2-2
TGTGCCAGCAGCTTAGCCAGGGGCTATGAGCAGTTCTTC	CASSLARGYEQFF	TRBV7-9	TRBJ2-1
TGTGCCAGCAGCACTACCGGGTCAGAGCAGTACTTC	CASSTTGSEQYF	TRBV9	TRBJ2-7
TGTGCCAGCAGTTACCCGAGGGGGGACAGGGGAGGATCCTATAATTCACCCCTCCACTTT	CASSYPRGDRGGSYNSPLHF	TRBV6-3	TRBJ1-6
TGTGCCAGCAGCCAAACCATAGAAGGGGTCGGGGAGCTGTTTTTT	CASSQTIEGVGELFF	TRBV14	TRBJ2-2
TGTGCCAGCAGCTTGGGTGAAATCAGGGCCGAGCAGTACTTC	CASSLGEIRAEQYF	TRBV7-4	TRBJ2-7
TGTGCCTGGAGGGAGGCCCTGTCCAAAAGTATTCACACTGAAGCTTTCTTT	CAWREALSKSIHTEAFF	TRBV30	TRBJ1-1
TGTGCCAGCTTCCTAGCGGGAGGAACCACGCAGTATTTT	CASFLAGGTTQYF	TRBV7-2	TRBJ2-3
TGCGCCAGCAGCCCGGGGGGTAGCACAGATACGCAGTATTTT	CASSPGGSTDTQYF	TRBV5-1	TRBJ2-3
TGTGCCACCAGTGATTTTTATGCTCAGAACTACGAGCAGTACTTC	CATSDFYAQNYEQYF	TRBV24-1	TRBJ2-7
TGTGCCACCAGGGGGCCCTGTACATTTAAGTGGTATGGCTACACCTTC	CATRGPCTFKWYGYTF	TRBV28	TRBJ1-2
TGCAGTGCTAGAGAGGTCGCGTCCGAAGGGTTTTTCTTC	CSAREVASEGFFF	TRBV20-1	TRBJ2-1
TGTGCCATCAGTGCGGACGAGACAACTGAAGCTTTCTTT	CAISADETTEAFF	TRBV10-3	TRBJ1-1
TGTGCCAGCAGCCCTAGCGGGTCCACAGGCGCCTACGAGCAGTACTTC	CASSPSGSTGAYEQYF	TRBV13	TRBJ2-7
TGCAGTGCTTGGGAACGGACCCGGGACAGGCCTAACTATGGCTACACCTTC	CSAWERTRDRPNYGYTF	TRBV20-1	TRBJ1-2
TGTGCCAGCAGTTTTCCATGGACCCAAGAGACCCAGTACTTC	CASSFPWTQETQYF	TRBV27	TRBJ2-5
TGTGCCAGCAGCGGGAGTGGCCTTCTATGCAATCAGCCCCAGCATTTT	CASSGSGLLCNQPQHF	TRBV2	TRBJ1-5
TGCTCTATGTGCCATTTCGCTGAAGCTTTCTTT	CSMCHFAEAFF	TRBV20-1	TRBJ1-1
TGTGCCAGCAGCGGTACTGTCGAGGGCTACGAGCAGTACTTC	CASSGTVEGYEQYF	TRBV13	TRBJ2-7
TGTGCCAGCAGCGTAGCGGTATCATATTGGGGGGAGGTCACAGATACGCAGTATTTT	CASSVAVSYWGEVTDTQYF	TRBV9	TRBJ2-3
TGTGCTAGTGGGTCACTGCCAGGTGGGGACAGGGGCTGGGACTATGGCTACACCTTC	CASGSLPGGDRGWDYGYTF	TRBV12-5	TRBJ1-2
TGTGCCAGTACCCGAGGGAGAGGGACCCACGAGACCCAGTACTTC	CASTRGRGTHETQYF	TRBV19	TRBJ2-5
TGTGCCAGCAGGCTAGCGGGTGGCCTCACCGGGGAGCTGTTTTTT	CASRLAGGLTGELFF	TRBV6-3	TRBJ2-2
TGTGCCAGCAGTTTTCTAGACGGAAACACCGGGGAGCTGTTTTTT	CASSFLDGNTGELFF	TRBV27	TRBJ2-2
TGTGCCAGCAGTTTAGACCCCTCCGGAGGGTGGTCCTGTGGTTCTCAGCCCCAGCATTTT	CASSLDPSGGWSCGSQPQHF	TRBV27	TRBJ1-5
TGTGCCAGCAGCTTGGGGGAATGTGGAAACACCATATATTTT	CASSLGECGNTIYF	TRBV5-6	TRBJ1-3
TGTGCCAGCAGTTCACAGGAGGAGGTCGGGGCCAACGTCCTGACTTTC	CASSSQEEVGANVLTF	TRBV25-1	TRBJ2-6
TGTGCCAGCAGTAACCCCCGGGCCGGGACTAGCGGGAGTACGTCCTACAATGAGCAGTTCTTC	CASSNPRAGTSGSTSYNEQFF	TRBV27	TRBJ2-1
TGTGCCAGCATAGGTTCAAGCAATCAGCCCCAGCATTTT	CASIGSSNQPQHF	TRBV6-5	TRBJ1-5
TGTGCCAGCAGCGCCCACGGGACTTCACCCCTCCACTTT	CASSAHGTSPLHF	TRBV9	TRBJ1-6
TGTGCCAGCAGCTTACATACAAGTCCCTACGAGCAGTACTTC	CASSLHTSPYEQYF	TRBV11-3	TRBJ2-7
TGTGCCAGCAGTGACAGGGGGCCTTGCAATCAGCCCCAGCATTTT	CASSDRGPCNQPQHF	TRBV25-1	TRBJ1-5
TGCGCCAGCAGCCAAGCCCTAGTGTCCTACAATGAGCAGTTCTTC	CASSQALVSYNEQFF	TRBV4-1	TRBJ2-1
TGCGCCAGCAGCGGCCTAAAACCGGGACAGGGTCATCAGCCCCAGCATTTT	CASSGLKPGQGHQPQHF	TRBV4-3	TRBJ1-5
TGTGCCATCAGTGAGGGGGGAGAGGACGTAGGGTATAGCAATCAGCCCCAGCATTTT	CAISEGGEDVGYSNQPQHF	TRBV10-3	TRBJ1-5
TGTGCCAGCAGTCCTAAAATACCCTTGAATCAGCCCCAGCATTTT	CASSPKIPLNQPQHF	TRBV12-4	TRBJ1-5
TGCGCCAGCAGTGAGACAAGCAGGGGTCATAATTCACCCCTCCACTTT	CASSETSRGHNSPLHF	TRBV10-1	TRBJ1-6
TGTGCCAGTAACCGGAGGAGGGAGCAGTACTTC	CASNRRREQYF	TRBV19	TRBJ2-7
TGTGCCAGCAGGCGAGCTCCCTGGCACTATGGCTACACCTTC	CASRRAPWHYGYTF	TRBV12-3	TRBJ1-2
TGTGCCATTGGGGTCCGGGCAGATACGCAGTATTTT	CAIGVRADTQYF	TRBV27	TRBJ2-3
TGTGCCAGCAGTTTCTTACCTTTAGTGGCGCCCTCTGGAAACACCATATATTTT	CASSFLPLVAPSGNTIYF	TRBV28	TRBJ1-3
TGCGCCAGCAGCCAAGACGGGGGGGCCAGGCAGTTCTTC	CASSQDGGARQFF	TRBV4-3	TRBJ2-1
TGCGCCAGAGGGAAGTCCGACAGGTGGCACGAGCAGTACTTC	CARGKSDRWHEQYF	TRBV10-1	TRBJ2-7
TGTGCAAGCCTGCCACATAACTATGGCTACACCTTC	CASLPHNYGYTF	TRBV9	TRBJ1-2
TGTGCCAGCAGTTACCGAAGGCACAGTTCACCCCTCCACTTT	CASSYRRHSSPLHF	TRBV6-6	TRBJ1-6
TGTGCCAGCAGCGGGGGGTCCACCGGGGAGCTGTTTTTT	CASSGGSTGELFF	TRBV7-9	TRBJ2-2
TGCGCCAGCAATGTCAGGGTCGGACCGCATAATTCACCCCTCCACTTT	CASNVRVGPHNSPLHF	TRBV10-1	TRBJ1-6
TGTGCCAGCAGTTTCGAAGTCGGGGGCAGAGGGGCCTACGAGCAGTACTTC	CASSFEVGGRGAYEQYF	TRBV6-5	TRBJ2-7
TGTGCCAGCAGCGGACTAGCCCACAAGAATGAGCAGTTCTTC	CASSGLAHKNEQFF	TRBV13	TRBJ2-1
TGTGCCAGCAGTTTAATACACTATGGCTACACCTTC	CASSLIHYGYTF	TRBV28	TRBJ1-2
TGTGCCAGCAGCTCTAGAGGGTCGGGGCAGCCCCAGCATTTT	CASSSRGSGQPQHF	TRBV7-7	TRBJ1-5
TGCAGTGCTAGGCTGACAGGCGAGCAGTACTTC	CSARLTGEQYF	TRBV20-1	TRBJ2-7
TGCAGTGCTAAAGGACAGGGACTTCCCACCGGGGAGCTGTTTTTT	CSAKGQGLPTGELFF	TRBV20-1	TRBJ2-2
TGTGCCAGGAGCGGGAGACGCGGGGAGCTGTTTTTT	CARSGRRGELFF	TRBV6-5	TRBJ2-2
TGTGCCAGCAGCGTAGAGCGGCTTCTAGGGGGATCTGGCAATCAGCCCCAGCATTTT	CASSVERLLGGSGNQPQHF	TRBV9	TRBJ1-5
TGTGCCAGCAGGTCCGGCCGGACTTTTTATTATATCAGCAATCAGCCCCAGCATTTT	CASRSGRTFYYISNQPQHF	TRBV12-3	TRBJ1-5
TGTGCCAGCAGGGACAGTGAAGCTTTCTTT	CASRDSEAFF	TRBV6-2	TRBJ1-1
TGTGCCAGCGCACAGGGAGCTAATGAAAAACTGTTTTTT	CASAQGANEKLFF	TRBV25-1	TRBJ1-4
TGTGCCAGCAGCCAAGGGCGGGACGGTGACTACGAGCAGTACTTC	CASSQGRDGDYEQYF	TRBV9	TRBJ2-7
TGTGCCAGTAGTATCCAGAGGGGGGGGGCCCGGAACACCGGGGAGCTGTTTTTT	CASSIQRGGARNTGELFF	TRBV19	TRBJ2-2
TGCGCCAGCAGCAAGCCGGCAGGGAAAGGATGTCAGCCCCAGCATTTT	CASSKPAGKGCQPQHF	TRBV5-1	TRBJ1-5
TGCGCCAGCGGATGGGGACAGCGCACTGAAGCTTTCTTT	CASGWGQRTEAFF	TRBV5-1	TRBJ1-1
TGTGCCAGCAGACCCCTCAATCAGCCCCAGCATTTT	CASRPLNQPQHF	TRBV7-9	TRBJ1-5
TGTGCCAGGCGGGCATTCGCCGGACAGGGCGCTGCAACTAATGAAAAACTGTTTTTT	CARRAFAGQGAATNEKLFF	TRBV28	TRBJ1-4
TGTGCCAGCAGTGACACCCAGAGTTCGACTGGGGCCAACGTCCTGACTTTC	CASSDTQSSTGANVLTF	TRBV6-4	TRBJ2-6
TGTGCCAGCCTACCGGGGGGGGCTTGCTCCTACGAGCAGTACTTC	CASLPGGACSYEQYF	TRBV12-3	TRBJ2-7
TGTGCCAGCAGCCTTGCCGTCAGCGAGCAGTACTTC	CASSLAVSEQYF	TRBV7-4	TRBJ2-7
TGTGCCAGACCAGGCGAGTATTCACCCCTCCACTTT	CARPGEYSPLHF	TRBV6-1	TRBJ1-6
TGTGCCAGCGACAGGATATCCGCCTATAATTCACCCCTCCACTTT	CASDRISAYNSPLHF	TRBV6-4	TRBJ1-6
TGTGACGAGGGAGGTAACTATGGCTACACCTTC	CDEGGNYGYTF	TRBV6-1	TRBJ1-2
TGTGCCATCAGGGCGGGAGCCAGGAGCTCTGGGGCCAACGTCCTGACTTTC	CAIRAGARSSGANVLTF	TRBV10-3	TRBJ2-6
TGTGCCAGCAGTCCAGGTAAGTACCAGGTTTCCCCAATAGCCAAAAACATTCAGTACTTC	CASSPGKYQVSPIAKNIQYF	TRBV28	TRBJ2-4
TGTGCCAGCAGTACAGGATACTCCTACGAGCAGTACTTC	CASSTGYSYEQYF	TRBV27	TRBJ2-7
TGTGCCAGCAGGGGGCGCGTAAACTATGGCTACACCTTC	CASRGRVNYGYTF	TRBV2	TRBJ1-2
TGTGCCAGCAGTGACTCGACCCCCTGGCGGGACAGGACAGGCTATGGCTACACCTTC	CASSDSTPWRDRTGYGYTF	TRBV6-4	TRBJ1-2
TGCGCCAGCAGTGAAACCCGGGAGGATGGCTACACCTTC	CASSETREDGYTF	TRBV10-1	TRBJ1-2
TGCGCCAGCAGCCTGGCGACCTGGACAGGGGACTCTGGAAACACCATATATTTT	CASSLATWTGDSGNTIYF	TRBV5-1	TRBJ1-3
TGCAGTGCTAGATCAGCGGGATTCAATGAGCAGTTCTTC	CSARSAGFNEQFF	TRBV20-1	TRBJ2-1
TGTGCCGGCGGCATTAATGAGCAGTTCTTC	CAGGINEQFF	TRBV10-3	TRBJ2-1
TGTGCCTCCTCAAGGCTGGCCCGTAGCTCTGGAAACACCATATATTTT	CASSRLARSSGNTIYF	TRBV10-3	TRBJ1-3
TGTGCCAGCAGCTTGGGGCCGAGGACAGGGAGCAGACATGAGCAGTTCTTC	CASSLGPRTGSRHEQFF	TRBV5-6	TRBJ2-1
TGTGCCAGCAGCCCCATGAGAGGAAACATGAACACTGAAGCTTTCTTT	CASSPMRGNMNTEAFF	TRBV3-1	TRBJ1-1
TGTGCCAGTAGTATAGCCTTCTTGGGAAGGAATGAGCAGTTCTTC	CASSIAFLGRNEQFF	TRBV19	TRBJ2-1
TGCAGTGCTAGAGTTCGGCCTCAGCGGGAGCTGGGTATAGAGACCCAGTACTTC	CSARVRPQRELGIETQYF	TRBV20-1	TRBJ2-5
TGCAGTGCACAACTCGGACTCGGGGCCCCGTCGCGAGATACGCAGTATTTT	CSAQLGLGAPSRDTQYF	TRBV20-1	TRBJ2-3
TGCAGTGCTATTCTCAACCACGACAGGGGTGAAAGAACAGAGACCCAGTACTTC	CSAILNHDRGERTETQYF	TRBV20-1	TRBJ2-5
TGCGCCAGCAGCTGCGACAGCTGTAATGAAAAACTGTTTTTT	CASSCDSCNEKLFF	TRBV5-1	TRBJ1-4
TGTGCCAGCAGCTCCGGGGCGGTAAGGCTCTCTGGGGCCAACGTCCTGACTTTC	CASSSGAVRLSGANVLTF	TRBV5-6	TRBJ2-6
TGTGCCAGCAGCTTAGGCCAGCTCGGAATTGCTAATTCACCCCTCCACTTT	CASSLGQLGIANSPLHF	TRBV11-2	TRBJ1-6
TGTGCCAGCAGCGACTTACTAGAGACCCAGTACTTC	CASSDLLETQYF	TRBV13	TRBJ2-5
TGTGCCAGCAACCGAGGGGGTGGGGACTATGGCTACACCTTC	CASNRGGGDYGYTF	TRBV6-5	TRBJ1-2
TGCGCCAGCAGCCAATCCCCCACCAGGGCGAACACAGATACGCAGTATTTT	CASSQSPTRANTDTQYF	TRBV4-3	TRBJ2-3
TGTGCCAGCAGCTGGCCAGGGTTTAATCTTAGCACAGATACGCAGTATTTT	CASSWPGFNLSTDTQYF	TRBV7-6	TRBJ2-3
TGTGCCAGCAGCGACAGGAGGGTCAGCGCCTACGAGCAGTACTTC	CASSDRRVSAYEQYF	TRBV7-9	TRBJ2-7
TGTGCCAGCAGCGGCTTCACCTACAATGAGCAGTTCTTC	CASSGFTYNEQFF	TRBV11-2	TRBJ2-1
TGTGCCAGCAGCCAACACGGCAGCTACGAGCAGTACTTC	CASSQHGSYEQYF	TRBV14	TRBJ2-7
TGCAGTGCTAGGGGTCCCAGGCAGCCCTACGAGCAGTACTTC	CSARGPRQPYEQYF	TRBV20-1	TRBJ2-7
TGTGCCAGCAGTTACTCGAAAAGCAATAGGGGGGGGGCGGGGTACAATGAGCAGTTCTTC	CASSYSKSNRGGAGYNEQFF	TRBV6-5	TRBJ2-1
TGCAGTGCTAGGTACTCTTTATACAGGTGCACTGAAGCTTTCTTT	CSARYSLYRCTEAFF	TRBV20-1	TRBJ1-1
TGCGCCAGCAGCTTGGCATCTGGGACTAGCGGGCCTGAGGGACGCTACGAGCAGTACTTC	CASSLASGTSGPEGRYEQYF	TRBV5-1	TRBJ2-7
TGTGCCAGCCGTGAGCCATCCTACAATGAGCAGTTCTTC	CASREPSYNEQFF	TRBV9	TRBJ2-1
TGCGCCAGCAGTTCGGGGACACAGGTCTCTGGAAACACCATATATTTT	CASSSGTQVSGNTIYF	TRBV10-2	TRBJ1-3
TGTGCCAGCAGTGTAGGGCCCGGGGCTTTCTTT	CASSVGPGAFF	TRBV27	TRBJ1-1
TGTGCTAGTGGTTTGGTAGTCGGTGCGGGCCTTTATGAAAAACTGTTTTTT	CASGLVVGAGLYEKLFF	TRBV12-5	TRBJ1-4
TGTGGAACAGGGGTCCGCAAAAACATTCAGTACTTC	CGTGVRKNIQYF	TRBV2	TRBJ2-4
TGCGCCAGCAGCGATGGCAGGGCTGAGTACTTC	CASSDGRAEYF	TRBV10-2	TRBJ2-5
TGCGCCAGCAGTAACCCCGGGGGAAACGAGCAGTACTTC	CASSNPGGNEQYF	TRBV10-1	TRBJ2-7
TGTGCCAGCAGGGATACCGGGGACCGGACGATCTCTGGAAACACCATATATTTT	CASRDTGDRTISGNTIYF	TRBV6-4	TRBJ1-3
TGTGCCAGCAGCCCTTCCAGCAATCAGCCCCAGCATTTT	CASSPSSNQPQHF	TRBV9	TRBJ1-5
TGCGCCATCTCGGGGGAATATAGCAATCAGCCCCAGCATTTT	CAISGEYSNQPQHF	TRBV10-1	TRBJ1-5
TGCAGTGCTAGAGATACGTCCTGGGGACAGGGGGCTTTTCTAGATACGCAGTATTTT	CSARDTSWGQGAFLDTQYF	TRBV20-1	TRBJ2-3
TGTGCCAGCAGCGAGACCCCGGGGGACAAGACCGGGGAGCTGTTTTTT	CASSETPGDKTGELFF	TRBV7-9	TRBJ2-2
TGTGCCAGCCTGGGAACTAATGAAAAACTGTTTTTT	CASLGTNEKLFF	TRBV9	TRBJ1-4
TGTGCCACCCGGAGGACAGGGTATAATTCACCCCTCCACTTT	CATRRTGYNSPLHF	TRBV6-5	TRBJ1-6
TGTGCCAGCAGTTTTATCTTCAGAGCCCCCATTCCCGGAATTGAGCAGTACTTC	CASSFIFRAPIPGIEQYF	TRBV12-4	TRBJ2-7
TGCGCCAGCAGCTGGGGGCGGAGTCTTGATCAGCCCCAGCATTTT	CASSWGRSLDQPQHF	TRBV5-1	TRBJ1-5
TGTGCCAGCAGTGGATCCGAGCAGTACTTC	CASSGSEQYF	TRBV2	TRBJ2-7
TGTGCCAGCCTCGCTGGAAACACCATATATTTT	CASLAGNTIYF	TRBV6-2	TRBJ1-3
TGTGCCAGCAGTTATGGACAGGGTCCAGAGACCCAGTACTTC	CASSYGQGPETQYF	TRBV12-3	TRBJ2-5
TGTGCCAGCAGCTTAGGATTCGTTGGTAGGGTAGCGGGAGGGGACAATGAGCAGTTCTTC	CASSLGFVGRVAGGDNEQFF	TRBV7-2	TRBJ2-1
TGTGCTAGCAGCTTACTATTGGAGCCAGGCTACAATGAGCAGTTCTTC	CASSLLLEPGYNEQFF	TRBV7-7	TRBJ2-1
TGTGCCAGCAGTTGTAGCTGGGCCTACAATGAGCAGTTCTTC	CASSCSWAYNEQFF	TRBV27	TRBJ2-1
TGCGCCAGCCCCCTTCTGGCATCGGGTCGGAGGGATACGCAGTATTTT	CASPLLASGRRDTQYF	TRBV5-1	TRBJ2-3
TGTGCCAGCAGTTTATGTCTAGTTACAGGGCGGGGGATAGTGGGAACTAACATGAACACTGAAGCTTTCTTT	CASSLCLVTGRGIVGTNMNTEAFF	TRBV28	TRBJ1-1
TGTGCCAGCAGCGACAGGGTCCTTGAGACCCAGTACTTC	CASSDRVLETQYF	TRBV6-1	TRBJ2-5
TGTGCCAGCAGCTTGGCTGGGGGGAGCGGGGAGCTGTTTTTT	CASSLAGGSGELFF	TRBV5-6	TRBJ2-2
TGTGCCAGCAGCATACCGGGACAGTTATGGGACACTGAAGCTTTCTTT	CASSIPGQLWDTEAFF	TRBV5-6	TRBJ1-1
TGTGCCAGCAGTGAAACGGCACCAATCCCGAGGGGATTAGATGGCTACACCTTC	CASSETAPIPRGLDGYTF	TRBV6-1	TRBJ1-2
TGCAGTGCTAGAAAAACACCCCGCTCCACTCGTTACGAGCAGTACTTC	CSARKTPRSTRYEQYF	TRBV20-1	TRBJ2-7
TGTGCCAGCAGTTTAGACCTGGTAGCCTACGAGCAGTACTTC	CASSLDLVAYEQYF	TRBV12-4	TRBJ2-7
TGCAGTGCTGGGGGGCGGCAGACCCAGTACTTC	CSAGGRQTQYF	TRBV20-1	TRBJ2-5
TGCGCCAGCAACGTTGTTCCCCTAGCGAGCACAGATACGCAGTATTTT	CASNVVPLASTDTQYF	TRBV5-1	TRBJ2-3
TGTGCCAGCTCAGATGGACAAGCTGGGAGGGCCTACAATGAGCAGTTCTTC	CASSDGQAGRAYNEQFF	TRBV18	TRBJ2-1
TGCGCCAGCAGCCAAGATCCCCCTGGGACAGGCTACGCCTACGAGCAGTACTTC	CASSQDPPGTGYAYEQYF	TRBV4-3	TRBJ2-7
TGTGCCAGCAGCTCGCTGGACAGGGGGAACTACGAGCAGTACTTC	CASSSLDRGNYEQYF	TRBV7-2	TRBJ2-7
TGTGCCAGCAGCCCCCTAGCGGGATATTGCTACGAGCAGTACTTC	CASSPLAGYCYEQYF	TRBV13	TRBJ2-7
TGTGCCAGCAGGTGCAGGACAGCCGGGACAGGGGTCAATGAATGCTCTGGAAACACCATATATTTT	CASRCRTAGTGVNECSGNTIYF	TRBV6-6	TRBJ1-3
TGTGCCAGCAGCTTAGGGGGGTATGAGCAGTTCTTC	CASSLGGYEQFF	TRBV7-3	TRBJ2-1
TGTGCCACCAGTGACCCGACAGGGGAAGCGCAGCCCCAGCATTTT	CATSDPTGEAQPQHF	TRBV24-1	TRBJ1-5
TGTGCCACCAGAACACGGCCGGGACACGGGGCTAACTATGGCTACACCTTC	CATRTRPGHGANYGYTF	TRBV24-1	TRBJ1-2
TGTGCCACCAGTGCTTCCACACAGGTACAAGGCCATGAGCAGTTCTTC	CATSASTQVQGHEQFF	TRBV24-1	TRBJ2-1
TGTGCCAGCGGCTGTATTTCGCCGGGACAGGGTCAGAATCAGCCCCAGCATTTT	CASGCISPGQGQNQPQHF	TRBV27	TRBJ1-5
TGCAGTGCTAGTAACCGGGACCCCCTTGAGCAGTTCTTC	CSASNRDPLEQFF	TRBV20-1	TRBJ2-1
TGTGCCAGCAGTTACTCGATACAGGGGATTGGTTCACCCCTCCACTTT	CASSYSIQGIGSPLHF	TRBV6-5	TRBJ1-6
TGTGCCAGCCGGCTACGGGGGCCGCAGCCCCAGCATTTT	CASRLRGPQPQHF	TRBV27	TRBJ1-5
TGTGCCAGCATTCGGGCAGGGGGGAAAAGCTATGGCTACACCTTC	CASIRAGGKSYGYTF	TRBV6-2	TRBJ1-2
TGTGCCAGCAGCGTGGACAGGGCATCCGGGGAGCTGTTTTTT	CASSVDRASGELFF	TRBV13	TRBJ2-2
TGTGCCAGCAGCTTACCTTGGACTAGCGGCCGGCAGTTCTTC	CASSLPWTSGRQFF	TRBV11-2	TRBJ2-1
TGTGCCATCAGTGCCCCCGGACGTGAGATCAGCACAGATACGCAGTATTTT	CAISAPGREISTDTQYF	TRBV10-3	TRBJ2-3
TGCAGCGTTGGCGTGAGGACAGGGGGCGGCGCCGCCGTCAATCAGCCCCAGCATTTT	CSVGVRTGGGAAVNQPQHF	TRBV29-1	TRBJ1-5
TGTGCCATCAGAAGCCGGGGGACAGTCGGAATCTCCTACGAGCAGTACTTC	CAIRSRGTVGISYEQYF	TRBV10-3	TRBJ2-7
TGTGCCAGCAGCAGATCAGGGGGGTGGAGTCAGCCCCAGCATTTT	CASSRSGGWSQPQHF	TRBV5-6	TRBJ1-5
TGTGCCAGCAGCTTGGAAGAGGGGGTCGAGCAGTACTTC	CASSLEEGVEQYF	TRBV5-6	TRBJ2-7
TGCGCCAGCAGCTCCCTATTCCCGCGGGACAGGGACACTGAAGCTTTCTTT	CASSSLFPRDRDTEAFF	TRBV5-1	TRBJ1-1
TGCAGTGCGGGGGGTGGGACTAGTAGAACTAATCACAATGAGCAGTTCTTC	CSAGGGTSRTNHNEQFF	TRBV20-1	TRBJ2-1
TGTGCCAGTAGTATGAGCGGCGGGGTCTATGGCTACACCTTC	CASSMSGGVYGYTF	TRBV19	TRBJ1-2
TGTGCCAGCTCACCAGACAGGGAAATCTCCTACGAGCAGTACTTC	CASSPDREISYEQYF	TRBV18	TRBJ2-7
TGTGCCAGCAGCATTAAGGAATACGAGACCTACAATGAGCAGTTCTTC	CASSIKEYETYNEQFF	TRBV2	TRBJ2-1
TGTGCCAGCAGCTTAACTAGTTCGGTGCAGGGGGCCAAAAACATTCAGTACTTC	CASSLTSSVQGAKNIQYF	TRBV7-2	TRBJ2-4
TGCGCCAGCAGCCAAGATCCCCCCGTAGAAAACAGCGGGGATGGCTACACCTTC	CASSQDPPVENSGDGYTF	TRBV4-1	TRBJ1-2
TGTGCCACCAGCAGACAGCGCACATGCTACGAGCAGTACTTC	CATSRQRTCYEQYF	TRBV15	TRBJ2-7
TGTGCCAGCAAGGACAGGGGTTCACCCCTCCACTTT	CASKDRGSPLHF	TRBV25-1	TRBJ1-6
TGTGCCAGCAGCTTGTTGCGGGCCGATTCACCCCTCCACTTT	CASSLLRADSPLHF	TRBV5-6	TRBJ1-6
TGTGCCAGCAGCAATAGGACAGAATTCACTGAAGCTTTCTTT	CASSNRTEFTEAFF	TRBV5-8	TRBJ1-1
TGTGCCAGCAGTGAAGAGGACAGGATCACTAATGAAAAACTGTTTTTT	CASSEEDRITNEKLFF	TRBV28	TRBJ1-4
TGTGCCATCAGTCCGATCGCGGGAGGCCACTCTGGAAACACCATATATTTT	CAISPIAGGHSGNTIYF	TRBV10-3	TRBJ1-3
TGTGCCAGTAGCGACGGCTACACCTTC	CASSDGYTF	TRBV7-3	TRBJ1-2
