TGTGCCAGTAGTGGCCCAGTGGGACAGACCTCCTACGAGCAGTACTTC	CASSGPVGQTSYEQYF	TRBV19	TRBJ2-7
TGTGCCAGGGGTGGACCGACAGGGAACAATGAAAAACTGTTTTTT	CARGGPTGNNEKLFF	TRBV28	TRBJ1-4
TGTGCTAGAAAAAAGCACGGCCAGGGGAAAAACTATGGCTACACCTTC	CARKKHGQGKNYGYTF	TRBV12-5	TRBJ1-2
TGTGCCAGCAGCCAACAAGGGATGCGGGGGACGTCTGAGACCCAGTACTTC	CASSQQGMRGTSETQYF	TRBV14	TRBJ2-5
TGCAGCGTCCGGAGACAGGGACTCTCTGGAAACACCATATATTTT	CSVRRQGLSGNTIYF	TRBV29-1	TRBJ1-3
TGTGCCAGCAGCTTAGAAACGGGGGGGGGAGACGACAATGAGCAGTTCTTC	CASSLETGGGDDNEQFF	TRBV7-9	TRBJ2-1
TGTGCCAGCAGTTCGTCCGTGAAGGGGGCCAACGTCCTGACTTTC	CASSSSVKGANVLTF	TRBV6-3	TRBJ2-6
TGCGCCAGCAGCTTGGAGGACAGGGAAGTGGGGAGCTCCTACGAGCAGTACTTC	CASSLEDREVGSSYEQYF	TRBV5-1	TRBJ2-7
TGTGCCAGCAGCCATTTGAGGGGCTGGAATGAGCAGTTCTTC	CASSHLRGWNEQFF	TRBV7-4	TRBJ2-1
TGTGCCAGCAGCCTGCCCGGACAGGGGGAGTCGAACACTGAAGCTTTCTTT	CASSLPGQGESNTEAFF	TRBV7-4	TRBJ1-1
TGTGCCAGCAGCTCTATAACCGGGGGGGAGAGGCAAGAGACCCAGTACTTC	CASSSITGGERQETQYF	TRBV7-9	TRBJ2-5
TGTGCCAGCAGCACCCGACTAGAGGGCTACGAGCAGTACTTC	CASSTRLEGYEQYF	TRBV5-8	TRBJ2-7
TGTGCCAAGGGGACTAACAATGAGCAGTTCTTC	CAKGTNNEQFF	TRBV2	TRBJ2-1
TGTGCCAGCAGTTATTCGACCTCGGAGACCCAGTACTTC	CASSYSTSETQYF	TRBV6-9	TRBJ2-5
TGTGCCAGCTCACAGGGAGGTGAGAACACTGAAGCTTTCTTT	CASSQGGENTEAFF	TRBV27	TRBJ1-1
TGCAGTGCTAGAGATCGGGGACTAGGGGAGACCCAGTACTTC	CSARDRGLGETQYF	TRBV20-1	TRBJ2-5
TGTGCTAGCAAGGGTGGTTGTGACAGGGTGGGATGTAGGCAAAGCTCCTACGAGCAGTACTTC	CASKGGCDRVGCRQSSYEQYF	TRBV7-7	TRBJ2-7
TGTGCCAGCCTGTTGGTAGATTCCTACGAGCAGTACTTC	CASLLVDSYEQYF	TRBV12-3	TRBJ2-7
TGTGCCAGCAGTTGGCGGGGAGGCAACCTGGACTCTAACTATGGCTACACCTTC	CASSWRGGNLDSNYGYTF	TRBV6-5	TRBJ1-2
TGTGCCAGCAGTGAACCCGGATCGGGAGCGGAAGAGACCCAGTACTTC	CASSEPGSGAEETQYF	TRBV6-1	TRBJ2-5
TGTGCCAGCAGCTCCGGGACTAGCGAGGGGGAGGCGATTGGCTACGAGCAGTACTTC	CASSSGTSEGEAIGYEQYF	TRBV12-3	TRBJ2-7
TGTGCCAGCAGCTTCGTCCCCAAATGTCCCGGGGGCAGGGCCAACGTCCTGACTTTC	CASSFVPKCPGGRANVLTF	TRBV11-2	TRBJ2-6
TGCAGTGCCGAAGGACCCCAAGCTTTCTTT	CSAEGPQAFF	TRBV20-1	TRBJ1-1
TGTGCCAGCAACAGCTCCTACGAGCAGTACTTC	CASNSSYEQYF	TRBV2	TRBJ2-7
TGTGCCAGCAGTTACCACAACGGGACTAGCGGGGGGGCAAGGTTCTACAATGAGCAGTTCTTC	CASSYHNGTSGGARFYNEQFF	TRBV6-5	TRBJ2-1
TGCAGTGCTATTGATGAGGGACAGGGGGCCAATCAGCCCCAGCATTTT	CSAIDEGQGANQPQHF	TRBV20-1	TRBJ1-5
TGTGCCAGCAGTTTAAAACCCCGACAGAGCTCCTACAATGAGCAGTTCTTC	CASSLKPRQSSYNEQFF	TRBV12-3	TRBJ2-1
TGCAGTGCGGGCCCCCTAACCCAGATGTGGGAGCAGTTCTTC	CSAGPLTQMWEQFF	TRBV20-1	TRBJ2-1
TGCGCCAGCAGCACCCGGGGTAAGAGCTATGGCTACACCTTC	CASSTRGKSYGYTF	TRBV5-1	TRBJ1-2
TGTGCCAGCAGCTTGGGGTCCATTTACACAGATACGCAGTATTTT	CASSLGSIYTDTQYF	TRBV7-9	TRBJ2-3
TGTGCCAGCAGTTCAGGGGCGGATGAAAAACTGTTTTTT	CASSSGADEKLFF	TRBV6-6	TRBJ1-4
TGTGCCAGCAGCGTAGTGACGGACAGAGCCGAAAACATTCAGTACTTC	CASSVVTDRAENIQYF	TRBV9	TRBJ2-4
TGTGCCAGCAGTACGGGGAACCGCTGTCGCTACAATGAGCAGTTCTTC	CASSTGNRCRYNEQFF	TRBV6-4	TRBJ2-1
TGTGCCAGCAGCCTCATAGGGACGAGCTCCTACGAGCAGTACTTC	CASSLIGTSSYEQYF	TRBV3-1	TRBJ2-7
TGCAGTGCTAGAGCTCTCCGGGCCCGGGGAGGGTCAGGCTACACCTTC	CSARALRARGGSGYTF	TRBV20-1	TRBJ1-2
TGTGCCACCCCACCAGGGGGCTTTCAAGAGACCCAGTACTTC	CATPPGGFQETQYF	TRBV15	TRBJ2-5
TGTGCCAGCAGCCTTGCAAACCCCCGGTCACCGTGCATTCAGTACTTC	CASSLANPRSPCIQYF	TRBV5-5	TRBJ2-4
TGCAGTGCTAGCTTCACAGGGCCTAGCTCCACGAGTTCCTCTGGAAACACCATATATTTT	CSASFTGPSSTSSSGNTIYF	TRBV20-1	TRBJ1-3
TGTGCCAGTAAGTCATTATGGGGGACAGCAAGCAATCAGCCCCAGCATTTT	CASKSLWGTASNQPQHF	TRBV27	TRBJ1-5
TGTGCCAGCAGCAGAGGGGGGGGGGAGATAGCCAAAAACATTCAGTACTTC	CASSRGGGEIAKNIQYF	TRBV13	TRBJ2-4
TGTGCCAGCAGCTATTCTCCCCCTATATCCCCGGGCTCTGGGGCCAACGTCCTGACTTTC	CASSYSPPISPGSGANVLTF	TRBV5-4	TRBJ2-6
TGTGCCAGCACAGGGGTAAACTATGGCTACACCTTC	CASTGVNYGYTF	TRBV7-9	TRBJ1-2
TGTGCCAGCAGAGGACAGGGACATTGGGGGGATCAGCCCCAGCATTTT	CASRGQGHWGDQPQHF	TRBV28	TRBJ1-5
TGCGCCAGTCTCCCTGAAGGCACAGATACGCAGTATTTT	CASLPEGTDTQYF	TRBV5-1	TRBJ2-3
TGTGCCAGCATCGACAGGGCCTTGGGCACATGTAGCAATCAGCCCCAGCATTTT	CASIDRALGTCSNQPQHF	TRBV28	TRBJ1-5
TGTGCCAGCAGCCGTTCACGGACAGGGTTCGATCAGCCCCAGCATTTT	CASSRSRTGFDQPQHF	TRBV11-3	TRBJ1-5
TGCGCCAGCAGCCAAGCACCTAGGACTAGCGGGAGAAAGGACGGTACAGATACGCAGTATTTT	CASSQAPRTSGRKDGTDTQYF	TRBV4-1	TRBJ2-3
TGTGCCAGGTGGACTATTTCTGAAAAACTGTTTTTT	CARWTISEKLFF	TRBV27	TRBJ1-4
TGTGCCAGCTCCGGTAAAAGGGACAGGTACCCTCGGTACGAGCAGTACTTC	CASSGKRDRYPRYEQYF	TRBV12-3	TRBJ2-7
TGTGCCAGCAGCCAAGCAAGACCAGGGACTACCTACAATGAGCAGTTCTTC	CASSQARPGTTYNEQFF	TRBV14	TRBJ2-1
TGCGCCAGCAGCTTGTTAACGGACAGGGCGATGGGCGCAAACATTCAGTACTTC	CASSLLTDRAMGANIQYF	TRBV5-1	TRBJ2-4
TGTGCTCCAAGAGGGGAGGGGCCGGAAAACATTCAGTACTTC	CAPRGEGPENIQYF	TRBV6-2	TRBJ2-4
TGTGCCAGCAGTTTTTTAGGTGACTTCGGGACGCAGCCCCAGCATTTT	CASSFLGDFGTQPQHF	TRBV6-9	TRBJ1-5
TGTGCCAGCAGTTACTCGCCCCAGGGGCAGCCCCAGCATTTT	CASSYSPQGQPQHF	TRBV6-6	TRBJ1-5
TGTGCCAGCAGCCAAGAGACAGATTCACCCCTCCACTTT	CASSQETDSPLHF	TRBV3-1	TRBJ1-6
TGTGCCAGCAGTGGCTACAGGTTCGGAAACACCATATATTTT	CASSGYRFGNTIYF	TRBV11-3	TRBJ1-3
TGCGCCAGCAGCCTCACAGGGAAGACGGGAAGATCTGGCTACACCTTC	CASSLTGKTGRSGYTF	TRBV4-3	TRBJ1-2
TGCAGTGCAAAAAAATTCAGACAATGTGAAGCTTTCTTT	CSAKKFRQCEAFF	TRBV20-1	TRBJ1-1
TGTGCCAGAGGCGAGGGGGGCCTTAACTATGGCTACACCTTC	CARGEGGLNYGYTF	TRBV6-3	TRBJ1-2
TGTGCCAGCAGTTTAACGAGCCTATTAAGGACCAATGAGCAGTTCTTC	CASSLTSLLRTNEQFF	TRBV27	TRBJ2-1
TGTGCCAGCAGCTCCCGAGCTAGCGACCTTGCCTACGAGCAGTACTTC	CASSSRASDLAYEQYF	TRBV5-6	TRBJ2-7
TGCAGCGTTGAAGATCGAGAGGCCTGTGGAAGGGGCGAGCAGTACTTC	CSVEDREACGRGEQYF	TRBV29-1	TRBJ2-7
TGTGCCACGGGGGGAACGTCCACAGATACGCAGTATTTT	CATGGTSTDTQYF	TRBV24-1	TRBJ2-3
TGCAGTGCTAGATCATCGACCGGGACTAAGTGGAATAGCAATCAGCCCCAGCATTTT	CSARSSTGTKWNSNQPQHF	TRBV20-1	TRBJ1-5
TGTGCCAGCAGCGGGGGGGGGGGCGGATCGACCTACGAGCAGTACTTC	CASSGGGGGSTYEQYF	TRBV5-4	TRBJ2-7
TGTGCCAGTCGCTTCGGAGGAGGGGCCCAGTACTTC	CASRFGGGAQYF	TRBV11-3	TRBJ2-5
TGTGCCACCCTAGGGGAAAACATTCAGTACTTC	CATLGENIQYF	TRBV15	TRBJ2-4
TGTGCAGGGAACTACCGGAGGGCCCCCCCTCCGCGAGAGACCCAGTACTTC	CAGNYRRAPPPRETQYF	TRBV28	TRBJ2-5
TGTGCCAGCAGCGTACAGGGGGGGTACGAGCAGTACTTC	CASSVQGGYEQYF	TRBV13	TRBJ2-7
TGTGCCAGCAGCCAAGGACTTAGCAAAGATACGCAGTATTTT	CASSQGLSKDTQYF	TRBV14	TRBJ2-3
TGTGCCGAACTAGCGGGAGAGGAGCGAGAAGACGAGCAGTACTTC	CAELAGEEREDEQYF	TRBV27	TRBJ2-7
TGTGCCAGCAGTTTAACCAGGGGAGCCTACGAGCAGTACTTC	CASSLTRGAYEQYF	TRBV28	TRBJ2-7
TGTGCCAGCAGCCAAGAAGCAGGGGGATGGACTGAAGCTTTCTTT	CASSQEAGGWTEAFF	TRBV14	TRBJ1-1
TGTGCCAGCAGCTTGGTTCCGGACTATAACTATGGCTACACCTTC	CASSLVPDYNYGYTF	TRBV11-2	TRBJ1-2
TGTGCCAGCAGTGACACCGTGGGACAGAGACAAGAGACCCAGTACTTC	CASSDTVGQRQETQYF	TRBV6-4	TRBJ2-5
TGCAGTGCCCCAAGGGACAGGGGGTTACCCTACGAGCAGTACTTC	CSAPRDRGLPYEQYF	TRBV20-1	TRBJ2-7
TGTGCCAGCAGCCAAGCGACAGCTCAGTGCACTGAAGCTTTCTTT	CASSQATAQCTEAFF	TRBV3-1	TRBJ1-1
TGCGCCAGCAGCCCGAAAGCGGGAGATGGCTACACCTTC	CASSPKAGDGYTF	TRBV4-1	TRBJ1-2
TGTGCCAGCAGTTTACCCTATCTTTCCAATGAGCAGTTCTTC	CASSLPYLSNEQFF	TRBV28	TRBJ2-1
TGTGCCAGCAGTGAGGTTCTCCTGAACACTGAAGCTTTCTTT	CASSEVLLNTEAFF	TRBV6-1	TRBJ1-1
TGCGCCAGCAGTACAGTCCGGGATCAGCCCCAGCATTTT	CASSTVRDQPQHF	TRBV10-2	TRBJ1-5
TGTGCCAGCTCACCAGGTGGACTAGCGGAGTACAATGAGCAGTTCTTC	CASSPGGLAEYNEQFF	TRBV18	TRBJ2-1
TGCAGTGCTAGAGGCTCAAGGGGTACCGGGGAGCTGTTTTTT	CSARGSRGTGELFF	TRBV20-1	TRBJ2-2
TGCGCCAGCAGCCTAACAGACAGGGATCAGCCCCAGCATTTT	CASSLTDRDQPQHF	TRBV4-1	TRBJ1-5
TGTGCCACCCTGGTTGGCAATCAGCCCCAGCATTTT	CATLVGNQPQHF	TRBV13	TRBJ1-5
TGTGCCAGCAGCGCGAGCAACACCTACGAGCAGTACTTC	CASSASNTYEQYF	TRBV9	TRBJ2-7
TGTGCCAGCACGCGGTTCTTCTCCTACGAGCAGTACTTC	CASTRFFSYEQYF	TRBV28	TRBJ2-7
TGTGCCAGCAGAGCAGGGAGAGGGGAGACCCAGTACTTC	CASRAGRGETQYF	TRBV6-5	TRBJ2-5
TGTGGGGGCACAGGGGGCGTCGGTCAGCCCCAGCATTTT	CGGTGGVGQPQHF	TRBV27	TRBJ1-5
TGTGCCAGCAGAACGGGACTAGCGGTTTCCAAAAACATTCAGTACTTC	CASRTGLAVSKNIQYF	TRBV11-2	TRBJ2-4
TGCAGCGTCCAATTTAATGAGCAGTTCTTC	CSVQFNEQFF	TRBV29-1	TRBJ2-1
TGCGCCAGCAGCCTGTACGTTGAGGGGGGTACAGGGGGCCACACCGGGGAGCTGTTTTTT	CASSLYVEGGTGGHTGELFF	TRBV5-1	TRBJ2-2
TGTGCTAGTGGTTTGGTGGTCCCAAGGTCCCGGGCAGGGAGCTACGAGCAGTACTTC	CASGLVVPRSRAGSYEQYF	TRBV12-5	TRBJ2-7
TGCGCCAGCAGCTTGGCATCTCAGGGGACAGATACGCAGTATTTT	CASSLASQGTDTQYF	TRBV5-1	TRBJ2-3
TGTGCCAGCAGCGTTTCGGGCCCTACCTGCTATGGCTACACCTTC	CASSVSGPTCYGYTF	TRBV7-3	TRBJ1-2
TGTGCCAGCAGTTACCTCCTAAGAACGTGGGATTCACCCCTCCACTTT	CASSYLLRTWDSPLHF	TRBV6-6	TRBJ1-6
TGTGCCAGCAGCTTAGATCCATGGCTGCAGAAAATGAACACTGAAGCTTTCTTT	CASSLDPWLQKMNTEAFF	TRBV11-2	TRBJ1-1
TGCGCCAGCAGTGAGTGGGACAGGGAGAACACTGAAGCTTTCTTT	CASSEWDRENTEAFF	TRBV10-1	TRBJ1-1
TGTGCCAGCAGCTTAAACAACACTGAAGCTTTCTTT	CASSLNNTEAFF	TRBV7-9	TRBJ1-1
TGTGCCAGAGCGGGGACAGGGCCTTTTCCTGAAGCTTTCTTT	CARAGTGPFPEAFF	TRBV19	TRBJ1-1
TGCAGTGTAAAACTGCGACAGGGGGCCCCGTTACGGTCCGAGCAGTACTTC	CSVKLRQGAPLRSEQYF	TRBV20-1	TRBJ2-7
TGTGCCAGCAGTTACACGGACAGCCGGATGAACACTGAAGCTTTCTTT	CASSYTDSRMNTEAFF	TRBV6-5	TRBJ1-1
TGCGCCAGCAGCTCCATGACCGAGCGGGTCTATGGCTACACCTTC	CASSSMTERVYGYTF	TRBV5-1	TRBJ1-2
TGCGCCAGCAGCCGGACTAGCGGGAGGGAGTATACACGTGCTAGCAATCAGCCCCAGCATTTT	CASSRTSGREYTRASNQPQHF	TRBV4-3	TRBJ1-5
TGTGCCAGTAACCGTCGGGCGGACAGCAGTGCCTACGAGCAGTACTTC	CASNRRADSSAYEQYF	TRBV19	TRBJ2-7
TGCAGTCCCGCGGGAGGTGCCAAAAACATTCAGTACTTC	CSPAGGAKNIQYF	TRBV20-1	TRBJ2-4
TGTGCCAGCAGCCTCGGGGGACAGCGGAACACTGAAGCTTTCTTT	CASSLGGQRNTEAFF	TRBV3-1	TRBJ1-1
TGTGCCACCATAGCATGGTCAGGGGGCACAGATACGCAGTATTTT	CATIAWSGGTDTQYF	TRBV24-1	TRBJ2-3
TGTGCCAGCAGCTTAGCCTCCTCAGCGCAGTATTTT	CASSLASSAQYF	TRBV13	TRBJ2-3
TGTGCCAGTAGGGCGGAGGGGCGAACCAATCAGCCCCAGCATTTT	CASRAEGRTNQPQHF	TRBV19	TRBJ1-5
TGTGCCAGCAGTTACCGGGGTGCGGAATGGTCATTAGGGCGGGGCAATCAGCCCCAGCATTTT	CASSYRGAEWSLGRGNQPQHF	TRBV6-8	TRBJ1-5
TGTGCCAGCAGGCTAATTGGGGGGGCCCAGGGGCAGTTCTTC	CASRLIGGAQGQFF	TRBV27	TRBJ2-1
TGTGCCAGCAGGTCCAGTAAGTGTCAGCCCCAGCATTTT	CASRSSKCQPQHF	TRBV5-4	TRBJ1-5
TGTGCCAGCCCGGGGCTCCAATGGACAGGGGGTAACGACTATGGCTACACCTTC	CASPGLQWTGGNDYGYTF	TRBV6-5	TRBJ1-2
TGTGCCAGCAGCAATCGTGGGGGCATTCAGTACTTC	CASSNRGGIQYF	TRBV5-4	TRBJ2-4
TGCAGCGTTGAGATCAGAGGGGTGACTTCGGATTCACCCCTCCACTTT	CSVEIRGVTSDSPLHF	TRBV29-1	TRBJ1-6
TGTGCCAGCAGCTTAGTCCACGGGGGCCAAGAGACCCAGTACTTC	CASSLVHGGQETQYF	TRBV7-2	TRBJ2-5
TGTGCCAGTTCCGGGACTAGCGGGAGCCACGATACGCAGTATTTT	CASSGTSGSHDTQYF	TRBV6-2	TRBJ2-3
TGTGCCAGCAGCTTACCCGGCCGGAAGGGGCCGAATCAGCCCCAGCATTTT	CASSLPGRKGPNQPQHF	TRBV7-4	TRBJ1-5
TGTGCCAGCAGCGTTGTCTACAGGGAAAACACTGAAGCTTTCTTT	CASSVVYRENTEAFF	TRBV9	TRBJ1-1
TGCAGTGCTAGACTCTTGACCGATGGGGTGATTGGGTATAGCAATCAGCCCCAGCATTTT	CSARLLTDGVIGYSNQPQHF	TRBV20-1	TRBJ1-5
TGTGCCAGCACCTCCTCTGAGCCCTGGTACCTAGCGGGTCAGAATGAGCAGTTCTTC	CASTSSEPWYLAGQNEQFF	TRBV7-9	TRBJ2-1
TGTGCCAGCGGGAGCGGGACTAACACTGAAGCTTTCTTT	CASGSGTNTEAFF	TRBV12-4	TRBJ1-1
TGTGCCAGTAGTATCGAGAAGGGGGGGAACACTGAAGCTTTCTTT	CASSIEKGGNTEAFF	TRBV19	TRBJ1-1
TGTGCCAGCACCCTCCTCACGGGACAGGCCTACGAGCAGTACTTC	CASTLLTGQAYEQYF	TRBV6-4	TRBJ2-7
TGTGCCAGTAGCCCGCGAGGCCCCACTAGCGGGAGCGGTAGCAAACTTAGCTACGAGCAGTACTTC	CASSPRGPTSGSGSKLSYEQYF	TRBV19	TRBJ2-7
TGTGCCACCAGTGAAACTCCGACAGCTAACTATGGCTACACCTTC	CATSETPTANYGYTF	TRBV24-1	TRBJ1-2
TGCGCCAGCAGCCACCGGTTAGAAACTTACACTGAAGCTTTCTTT	CASSHRLETYTEAFF	TRBV4-3	TRBJ1-1
TGTGCCAGCAGTAGGGGGGCCCCTGGCTACACCTTC	CASSRGAPGYTF	TRBV27	TRBJ1-2
TGTGCCAGCAGTGATTCCCCAAGGGGGGGGAACACTGAAGCTTTCTTT	CASSDSPRGGNTEAFF	TRBV2	TRBJ1-1
TGTGCCTGGAGGACGGTAGTTACCGGGGAGCTGTTTTTT	CAWRTVVTGELFF	TRBV30	TRBJ2-2
TGTGCCAGCAGCTTGGTATCAGATAGCCGGGACGAGACCCAGTACTTC	CASSLVSDSRDETQYF	TRBV5-6	TRBJ2-5
TGTGCCACCAGCAGAACCATAGCGGGGGCCAATGAGCAGTTCTTC	CATSRTIAGANEQFF	TRBV15	TRBJ2-1
TGCGCCGAGCGGGACAGCCCTAATTCACCCCTCCACTTT	CAERDSPNSPLHF	TRBV5-1	TRBJ1-6
TGTGCCAGCAGCGACCAGTTGGACAGAAGCACAGATACGCAGTATTTT	CASSDQLDRSTDTQYF	TRBV7-3	TRBJ2-3
TGTGCCAGCAGCGGGGACAGGGATAGATGGACGGGAGAAAAACTGTTTTTT	CASSGDRDRWTGEKLFF	TRBV6-5	TRBJ1-4
TGTGCCAGCATAGGCGGGACCGGTGATCAGCCCCAGCATTTT	CASIGGTGDQPQHF	TRBV19	TRBJ1-5
TGTGCCAGCAGAATCCCTAAGACTACAGATACGCAGTATTTT	CASRIPKTTDTQYF	TRBV12-3	TRBJ2-3
TGTGCCAGCAGCCCCTCAGTATACAATGAGCAGTTCTTC	CASSPSVYNEQFF	TRBV4-2	TRBJ2-1
TGTGCCAGCAGCTTATGGGCAGGGCTTACTACCGGGGAGCTGTTTTTT	CASSLWAGLTTGELFF	TRBV5-6	TRBJ2-2
TGTGCCAGCTCACCACCCCGCACCGGGACAATTAGAGAGACCCAGTACTTC	CASSPPRTGTIRETQYF	TRBV18	TRBJ2-5
TGTGCCAGCAGTGTCGAGGGGGGCTCCACCCACACTGAAGCTTTCTTT	CASSVEGGSTHTEAFF	TRBV6-4	TRBJ1-1
TGTGCCAGCAGCTTGCGGGGCCGTTGCCAGTCCGGTGCCAGACGCAGCGTTGAAAAACTGTTTTTT	CASSLRGRCQSGARRSVEKLFF	TRBV5-6	TRBJ1-4
TGTGCCAGCAGCTTGGCCATGACAGGTCATAGGGAAGGAGACAATGAGCAGTTCTTC	CASSLAMTGHREGDNEQFF	TRBV5-4	TRBJ2-1
TGTGCCAGCACTGGAAGGATTATTTCGCAGTATTTT	CASTGRIISQYF	TRBV28	TRBJ2-3
TGTGCCAGCAGCGAGGGGGTAACGGCCGGGGAGCTGTTTTTT	CASSEGVTAGELFF	TRBV9	TRBJ2-2
TGTGCCAGCAGCCTAATCAGGAACGGGGATCAGCCCCAGCATTTT	CASSLIRNGDQPQHF	TRBV13	TRBJ1-5
TGCAGTGCTAGCCAGGGGGTTATTCATTACACCGGGGAGCTGTTTTTT	CSASQGVIHYTGELFF	TRBV20-1	TRBJ2-2
TGTGCCAGCAGCTTAGCGCATGGGAAGAGGGTCAATCAGCCCCAGCATTTT	CASSLAHGKRVNQPQHF	TRBV7-2	TRBJ1-5
TGTGCCAGCAGTTTACGGAGGGGCGAAAAACTGTTTTTT	CASSLRRGEKLFF	TRBV27	TRBJ1-4
TGCAGTGCGATAAGAACAAACAGGTACAAGAACACTGAAGCTTTCTTT	CSAIRTNRYKNTEAFF	TRBV20-1	TRBJ1-1
TGCAGTGCGGTAGCATATGTTAATAGCTCCTATAATTCACCCCTCCACTTT	CSAVAYVNSSYNSPLHF	TRBV20-1	TRBJ1-6
TGTGCCAGCAGCCTCAGCTACGAGCAGTACTTC	CASSLSYEQYF	TRBV11-2	TRBJ2-7
TGCAGCATCGTGGGGACAGATACGCAGTATTTT	CSIVGTDTQYF	TRBV29-1	TRBJ2-3
TGCAGTGCTAGAGATCTGTTAGCAGCGAGGGACCATGGCTACACCTTC	CSARDLLAARDHGYTF	TRBV20-1	TRBJ1-2
TGTGCCATGAGCAGTAGGGCTAACTATGGCTACACCTTC	CAMSSRANYGYTF	TRBV7-9	TRBJ1-2
TGTGCCAGCAGTTATGGGAACACTACCGGGGAGCTGTTTTTT	CASSYGNTTGELFF	TRBV6-5	TRBJ2-2
TGTGCCAGCATTAAACGATACTCCAGAACCGGGGAGCTGTTTTTT	CASIKRYSRTGELFF	TRBV28	TRBJ2-2
TGTGCCAGCAGCTCCCCGTCCCGGGGGAGGGGCGAAAAACTGTTTTTT	CASSSPSRGRGEKLFF	TRBV13	TRBJ1-4
TGTGCCAGCAGTAGAGGTCCGGGACAGGCCAAAAACATTCAGTACTTC	CASSRGPGQAKNIQYF	TRBV6-1	TRBJ2-4
TGTGCCAGCCCGGTCGGCCGGGACAGGGGCGATGAAGCTTTCTTT	CASPVGRDRGDEAFF	TRBV7-3	TRBJ1-1
TGTGCCAGCAGCTTAGTCCCAGGGTGGTGCAACACCGGGGAGCTGTTTTTT	CASSLVPGWCNTGELFF	TRBV7-6	TRBJ2-2
TGTGCCAGCAGTTTAGAGCATACGCAGTATTTT	CASSLEHTQYF	TRBV27	TRBJ2-3
TGCAGTGCTAGAGGACCGGGGGCCAATGAGCAGTTCTTC	CSARGPGANEQFF	TRBV20-1	TRBJ2-1
TGTGCCAGCAGCCAGGAGGAGTCGTTAGGGTTGGAGACCCAGTACTTC	CASSQEESLGLETQYF	TRBV13	TRBJ2-5
TGTGCCAGCAGTCCCCCCCATAATCCGGGACAGGGGCCCGACACTGAAGCTTTCTTT	CASSPPHNPGQGPDTEAFF	TRBV6-5	TRBJ1-1
TGCAGTGCTAGAGATGGGGGCGGCTTGAACACTGAAGCTTTCTTT	CSARDGGGLNTEAFF	TRBV20-1	TRBJ1-1
TGTGCCTGTCAGGTGGTTATGGGGGCAGTCTACAATGAGCAGTTCTTC	CACQVVMGAVYNEQFF	TRBV30	TRBJ2-1
TGTGCCAGCAGTTTGGGAGGGGCTAATCACAATGAGCAGTTCTTC	CASSLGGANHNEQFF	TRBV28	TRBJ2-1
TGTGCCATCAGTGAGTCTATAACTAGCGGGTTTTCGCTGGCGCAGTTCTTC	CAISESITSGFSLAQFF	TRBV10-3	TRBJ2-1
TGTGCCAGCAGCTTGCCGCCGTCAGGGGACGGCTTC	CASSLPPSGDGF	TRBV7-2	TRBJ2-7
TGTGCCAGCAGTTGGGCTCGACAGGGTAGCTCTGGAAACACCATATATTTT	CASSWARQGSSGNTIYF	TRBV6-2	TRBJ1-3
TGTGCCACCAGTTCCGGGGGCTGCATAGAACATGGCTACACCTTC	CATSSGGCIEHGYTF	TRBV24-1	TRBJ1-2
TGTGCCAGCAGCCTAGCCGTAAGCTCCTACGAGCAGTACTTC	CASSLAVSSYEQYF	TRBV9	TRBJ2-7
TGCGCCAAGATTCTGCTAGATGTCGAGCAGTACTTC	CAKILLDVEQYF	TRBV5-1	TRBJ2-7
TGCGCCAGCAGGTCTGGCGGGGTGCACACTGAAGCTTTCTTT	CASRSGGVHTEAFF	TRBV10-1	TRBJ1-1
TGTGCCAGCAGCTTGGCCAAAGGGACTTTCGGCCCCAGCTCCTACAATGAGCAGTTCTTC	CASSLAKGTFGPSSYNEQFF	TRBV5-5	TRBJ2-1
TGTGCCAGCAGTTGCAGGAGGGCCAGGGAGACCCAGTACTTC	CASSCRRARETQYF	TRBV12-4	TRBJ2-5
TGTGCCATCAGTGAGTTGGGGCTGTATAGCAATCAGCCCCAGCATTTT	CAISELGLYSNQPQHF	TRBV10-3	TRBJ1-5
TGTGCCAGCAGCCAAGAAGGGACAGGGTCCTCCTACGAGCAGTACTTC	CASSQEGTGSSYEQYF	TRBV4-2	TRBJ2-7
TGCACCCTTCCCTCCACTATCACAGATACGCAGTATTTT	CTLPSTITDTQYF	TRBV29-1	TRBJ2-3
TGTGCCAGCAGCTTAAGACCGCAACTAGCGGAGGACGAGCAGTACTTC	CASSLRPQLAEDEQYF	TRBV7-3	TRBJ2-7
TGTGCCAGCAGTTTGGCGAACACTGAAGCTTTCTTT	CASSLANTEAFF	TRBV12-4	TRBJ1-1
TGTGCCAGCAGCCAAGACGGGCGATCTGAAAAACTGTTTTTT	CASSQDGRSEKLFF	TRBV5-4	TRBJ1-4
TGCAGTGCTAGTAATGGGAACTGGAGGACAGGGGATCAGCCCCAGCATTTT	CSASNGNWRTGDQPQHF	TRBV20-1	TRBJ1-5
TGTGCCAGCAGTCAGACATCGACTTTCTTT	CASSQTSTFF	TRBV28	TRBJ1-1
TGTGCCAGCAGCGTAGCGGGACGTGGTCGGAACTCTGGAAACACCATATATTTT	CASSVAGRGRNSGNTIYF	TRBV9	TRBJ1-3
TGTGCCAATGAGGGACGGGTCGATGAGCAGTTCTTC	CANEGRVDEQFF	TRBV11-2	TRBJ2-1
TGTGCCAGCAGCTTATACGTACCAACGAACCAATTGTCAGGGTACGGGACTGAAGCTTTCTTT	CASSLYVPTNQLSGYGTEAFF	TRBV7-9	TRBJ1-1
TGCAGTGCTAGAGAGGACAGGGGATCGAACACCGGGGAGCTGTTTTTT	CSAREDRGSNTGELFF	TRBV20-1	TRBJ2-2
TGTGCCAGTAGTCTCTTCTCCCAGGGGCTAGCGGGACCAAGCAATGAGCAGTTCTTC	CASSLFSQGLAGPSNEQFF	TRBV19	TRBJ2-1
TGCGCCAGCAGCCAAGGGTCGGGACAGGGGGCGCAAAACATTCAGTACTTC	CASSQGSGQGAQNIQYF	TRBV4-1	TRBJ2-4
TGCAGTGCTAGAGAAGACGAGCAGTACTTC	CSAREDEQYF	TRBV20-1	TRBJ2-7
TGTGCCAGCTCAGTTGATTCACCCCTCCACTTT	CASSVDSPLHF	TRBV9	TRBJ1-6
TGTGCCAGCAGCCAAGATGGGTTGGCTTCAGTGAACACTGAAGCTTTCTTT	CASSQDGLASVNTEAFF	TRBV4-2	TRBJ1-1
TGTGCCAGTCGTGACCCGAACACTGAAGCTTTCTTT	CASRDPNTEAFF	TRBV19	TRBJ1-1
TGTGCCAGCAGCTTAGTAACAGGGGCAAAGCCGAACACCGGGGAGCTGTTTTTT	CASSLVTGAKPNTGELFF	TRBV7-6	TRBJ2-2
TGTGCCAGCAGTTGGAAAGGGGGCCGAGGGACAGGGGGAAACACAGATACGCAGTATTTT	CASSWKGGRGTGGNTDTQYF	TRBV27	TRBJ2-3
TGCAGTGCCCCCACAGGGTCCGTATACAATGAGCAGTTCTTC	CSAPTGSVYNEQFF	TRBV20-1	TRBJ2-1
TGTGCCAGCGACTGGACCCCAACTAGCGGGAGAGATACGCAGTATTTT	CASDWTPTSGRDTQYF	TRBV6-4	TRBJ2-3
TGTGCCAGCAGCAGCGGTCCGGGACAAAGGGACAATGAGCAGTTCTTC	CASSSGPGQRDNEQFF	TRBV9	TRBJ2-1
TGTGCCAGCAGTTTAGTAACAGGGGGCGGGTATCAGCCCCAGCATTTT	CASSLVTGGGYQPQHF	TRBV12-4	TRBJ1-5
TGTGCCTGGGACCCTGAAGCTTTCTTT	CAWDPEAFF	TRBV30	TRBJ1-1
TGCAGTGCTATTTCTCGGGCTGGCTACAATGAGCAGTTCTTC	CSAISRAGYNEQFF	TRBV20-1	TRBJ2-1
TGCGCCAGCAGTGAGTGGCACAGCCTCCCCCCGGGTGAAAAACTGTTTTTT	CASSEWHSLPPGEKLFF	TRBV10-1	TRBJ1-4
TGTGCCAGCAGCCAAGGCGAAAAGAAGTCGGGGGGGGGGGACAATGAGCAGTTCTTC	CASSQGEKKSGGGDNEQFF	TRBV14	TRBJ2-1
TGTGCCAGCAGTGAGAGGCGGGACAGTTACACTGAAGCTTTCTTT	CASSERRDSYTEAFF	TRBV6-4	TRBJ1-1
TGTGCCAGCAGCTTTCCAGGGTCCACCTCGGACTATGGCTACACCTTC	CASSFPGSTSDYGYTF	TRBV28	TRBJ1-2
TGCAGTGCTAGTGGGACATCGGGAGCTAACTATGGCTACACCTTC	CSASGTSGANYGYTF	TRBV20-1	TRBJ1-2
TGTGCCAGCAGTGATAGGGACAGGGATCTTGGCGGAGATACGCAGTATTTT	CASSDRDRDLGGDTQYF	TRBV6-1	TRBJ2-3
TGTGCCAGCAGCTTGAGCAGGGGATTCACCGGGGAGCTGTTTTTT	CASSLSRGFTGELFF	TRBV7-9	TRBJ2-2
TGTGCCAGCAGCGGCCGGGACAGGGTGGGTCGGTCAACGAACACCGGGGAGCTGTTTTTT	CASSGRDRVGRSTNTGELFF	TRBV13	TRBJ2-2
TGTGCCAGCAGTTTACGGGGGGGATTTGACTCTAGCTCCTACGAGCAGTACTTC	CASSLRGGFDSSSYEQYF	TRBV12-3	TRBJ2-7
TGCAGCGTTGAAGATTCCCGTCCGAGGTATGGCTACACCTTC	CSVEDSRPRYGYTF	TRBV29-1	TRBJ1-2
TGTGCCAGCAGTTTAGAGGGGACAGGGACTGAAGCTTTCTTT	CASSLEGTGTEAFF	TRBV6-5	TRBJ1-1
TGCGCCAGCAGCTTGGGCCACAGGGTCTGGAATTCACCCCTCCACTTT	CASSLGHRVWNSPLHF	TRBV5-1	TRBJ1-6
TGTGCCAGCAGCTTTGACAGGGGATTTAACTATGGCTACACCTTC	CASSFDRGFNYGYTF	TRBV5-6	TRBJ1-2
TGTGCCAGCAGCTTGGTTCCCATCAGGGACGATCAGCCCCAGCATTTT	CASSLVPIRDDQPQHF	TRBV5-4	TRBJ1-5
TGTGCCAGCAGCTCCCCGACTAGCGGGGAGACCCAGTACTTC	CASSSPTSGETQYF	TRBV13	TRBJ2-5
TGTGCCATCAACCCCCCCTCGGAGCAGTACTTC	CAINPPSEQYF	TRBV10-3	TRBJ2-7
TGTGCCAGCAGCTTAGAGGCGGACGGGGCTAATTCACCCCTCCACTTT	CASSLEADGANSPLHF	TRBV7-2	TRBJ1-6
TGCGCCAGCAGCAACATAACACTAGCGGGTCCCTTACACGAGCAGTACTTC	CASSNITLAGPLHEQYF	TRBV5-1	TRBJ2-7
TGTGCCAGCAGCCAACAGATCGATAATCAGCCCCAGCATTTT	CASSQQIDNQPQHF	TRBV7-3	TRBJ1-5
TGTGCCAGCAGCTGTGCCTCTAGCGGGGTGGGCAACACAGATACGCAGTATTTT	CASSCASSGVGNTDTQYF	TRBV7-3	TRBJ2-3
TGTGCCAGCAGCCAGGGACTAGCGGGAGACAATGAGCAGTTCTTC	CASSQGLAGDNEQFF	TRBV14	TRBJ2-1
TGTGCCAGCAGTGAGTACGCCCTCAGGGTTTGCACTGAAGCTTTCTTT	CASSEYALRVCTEAFF	TRBV6-1	TRBJ1-1
TGTGCCAGCAGCTTAGGAGGTTCCTATGGCTACACCTTC	CASSLGGSYGYTF	TRBV7-9	TRBJ1-2
TGTGCCAGCAGTGAAGTTAAAATTTCCAGGCTAAAAGAGACCCAGTACTTC	CASSEVKISRLKETQYF	TRBV11-3	TRBJ2-5
TGTGCCAGCAGAAAGGGGGGGCGGCGGCAAGAGACCCAGTACTTC	CASRKGGRRQETQYF	TRBV6-3	TRBJ2-5
TGTGCCAGCAGCTTCAGGGGGCTGTACCAAGAGGGGGACGAGCAGTACTTC	CASSFRGLYQEGDEQYF	TRBV7-8	TRBJ2-7
TGTGCCACCAGTTTCAGGGGGGGGGGCTGGCAAGAGACCCAGTACTTC	CATSFRGGGWQETQYF	TRBV24-1	TRBJ2-5
TGTGCCAGCACCCCCGGGACAGGGCTAAATCAGCCCCAGCATTTT	CASTPGTGLNQPQHF	TRBV7-9	TRBJ1-5
TGTGCCAGCAGCCAGTTCATGGATAGCTATGGCTACACCTTC	CASSQFMDSYGYTF	TRBV4-2	TRBJ1-2
TGTGCCAGCAGCGTAGTAATCACTAGCGGGTTAGAAGGCTCCTACAATGAGCAGTTCTTC	CASSVVITSGLEGSYNEQFF	TRBV9	TRBJ2-1
TGTGCCAGCTCACGGACAGCTGTGCGCTCCTCCTACAATGAGCAGTTCTTC	CASSRTAVRSSYNEQFF	TRBV18	TRBJ2-1
TGTGCCAGCAGTGCTAGCGGGATACGCTACGAGCAGTACTTC	CASSASGIRYEQYF	TRBV27	TRBJ2-7
TGTGCCAGCAGCGAACCCCCGGGCCACACTAACACTGAAGCTTTCTTT	CASSEPPGHTNTEAFF	TRBV9	TRBJ1-1
TGTGCCAGCAGTTTATCGCTTGTGCGGGAGGAGGAGTTCCCAAATTACGAGCAGTACTTC	CASSLSLVREEEFPNYEQYF	TRBV27	TRBJ2-7
TGCAGTGCTAAGGACCACAGGCAATATAATGAAAAACTGTTTTTT	CSAKDHRQYNEKLFF	TRBV20-1	TRBJ1-4
TGCAGCGTTGAAGCTCAGCGGGATCATCAGCCCCAGCATTTT	CSVEAQRDHQPQHF	TRBV29-1	TRBJ1-5
TGTGCCAGCAGTTTAGGTAGCGGGTCGAACGAGCAGTACTTC	CASSLGSGSNEQYF	TRBV12-3	TRBJ2-7
TGTGCCAGCAGTTACTCGCGGAGGGAGAAGGACTCTGGGGCCAACGTCCTGACTTTC	CASSYSRREKDSGANVLTF	TRBV6-5	TRBJ2-6
TGTGCCACCAGTGATTTAGGAGGGACTAGCTTCTATGAGCAGTTCTTC	CATSDLGGTSFYEQFF	TRBV24-1	TRBJ2-1
TGTGCCAGCAGTTCGACAAACACAGATACGCAGTATTTT	CASSSTNTDTQYF	TRBV27	TRBJ2-3
TGTGCCAGCACCGGGCCCGTAACCGTGGGCCCGAACACTGAAGCTTTCTTT	CASTGPVTVGPNTEAFF	TRBV5-5	TRBJ1-1
TGTGCCAGCAGCTTAGGTATGAGTCTGACAGATACGCAGTATTTT	CASSLGMSLTDTQYF	TRBV7-2	TRBJ2-3
TGTGCCACCAGCAAAGGGCCCCGGGGGGCGGAGTACTTC	CATSKGPRGAEYF	TRBV15	TRBJ2-7
TGCGCCAGCAGCTTGGTAGTTCAACCGGGTGATCTTACGGGCAATGAGCAGTTCTTC	CASSLVVQPGDLTGNEQFF	TRBV5-1	TRBJ2-1
TGTGCCAGCACCTGGGGGGGGCCGTTAAGCTACGAGCAGTACTTC	CASTWGGPLSYEQYF	TRBV5-4	TRBJ2-7
TGTGCCAGCAGCAGGGCCCGAAGTGAAAAACTGTTTTTT	CASSRARSEKLFF	TRBV13	TRBJ1-4
TGTGCCATCACCCAGGGGGATTATAGCAATCAGCCCCAGCATTTT	CAITQGDYSNQPQHF	TRBV10-3	TRBJ1-5
TGTGCCAGCAGAGTGAAGACAGGGGCGGGTTTTACCAATAGCAATCAGCCCCAGCATTTT	CASRVKTGAGFTNSNQPQHF	TRBV2	TRBJ1-5
TGCAGCGTTGACATAGCGAGACCTAACACCGGGGAGCTGTTTTTT	CSVDIARPNTGELFF	TRBV29-1	TRBJ2-2
TGTGCCAGCAGCGTAGAGGGGTCCCGATTAAATGAGCAGTTCTTC	CASSVEGSRLNEQFF	TRBV9	TRBJ2-1
TGTGCCAGACGACCGACTGAAGCTTTCTTT	CARRPTEAFF	TRBV27	TRBJ1-1
TGCAGTGCTAGTCGGACAGGGGCCTCATATGGCTACACCTTC	CSASRTGASYGYTF	TRBV20-1	TRBJ1-2
TGTGCCACCAGTGGGTCGGACAGGGTTGCGGCAACTAATGAAAAACTGTTTTTT	CATSGSDRVAATNEKLFF	TRBV24-1	TRBJ1-4
TGTGCCTGGAGGGGACAGGGGCGTCCGGCCCGGATGAACACTGAAGCTTTCTTT	CAWRGQGRPARMNTEAFF	TRBV30	TRBJ1-1
TGTGCCAGCAGCTTAGCTTCTAGCGGGGCGGTCGGCACAGATACGCAGTATTTT	CASSLASSGAVGTDTQYF	TRBV11-1	TRBJ2-3
TGTGCCATACTTTCGGGCAACTCTGGAAACACCATATATTTT	CAILSGNSGNTIYF	TRBV25-1	TRBJ1-3
TGTGCCAGCAGTAGCACAGGGGATAATTCACCCCTCCACTTT	CASSSTGDNSPLHF	TRBV12-3	TRBJ1-6
TGTGCCAGCAGCCACCCGCGGTGGGGACGTCACGAGCAGTACTTC	CASSHPRWGRHEQYF	TRBV3-1	TRBJ2-7
TGCAGTGCTAGGGTCGGGGGCGAAGAGCAGTACTTC	CSARVGGEEQYF	TRBV20-1	TRBJ2-7
TGTGCCAGCAGTAATGGAAGACTAGCGGGGGGGGGCACAGATACGCAGTATTTT	CASSNGRLAGGGTDTQYF	TRBV28	TRBJ2-3
TGTGCCAGCAGTGACGCTCGGCTGATCGCCGGGGAGCTGTTTTTT	CASSDARLIAGELFF	TRBV6-4	TRBJ2-2
TGCGCCAGCAGCTTGGCGCCCTCTTCCTACGAGCAGTACTTC	CASSLAPSSYEQYF	TRBV5-1	TRBJ2-7
TGCGCCAGCAGCTTGGAAACCAACCTAACTAGCGGGGCTATGGGGGCCTACAATGAGCAGTTCTTC	CASSLETNLTSGAMGAYNEQFF	TRBV5-1	TRBJ2-1
TGTGCCAGCAGCTTTAAACAGGGGGGTTTAAAGCCCTCTGGAAACACCATATATTTT	CASSFKQGGLKPSGNTIYF	TRBV13	TRBJ1-3
TGTGCCAGCAGCAGGCGGAAGGGCGGCTACACCTTC	CASSRRKGGYTF	TRBV9	TRBJ1-2
TGCAAGTTGACTAGCGGGCACGAGCAGTACTTC	CKLTSGHEQYF	TRBV20-1	TRBJ2-7
TGTGCCTGGAGGAGGCCGGGACAGGGCTACGAAAAACTGTTTTTT	CAWRRPGQGYEKLFF	TRBV30	TRBJ1-4
TGTGCCAGCAGTCCCGGGGCTCACTACGAGCAGTACTTC	CASSPGAHYEQYF	TRBV6-5	TRBJ2-7
TGTGCCAGGAGGGAACCCTACGAGCAGTACTTC	CARREPYEQYF	TRBV6-6	TRBJ2-7
TGTGCCAGCCTAGACGGGGGGGGCTGCAATGAGCAGTTCTTC	CASLDGGGCNEQFF	TRBV7-9	TRBJ2-1
TGTGCCATCAGTATAAGTCAAACGACAGGGAAGAACACTGAAGCTTTCTTT	CAISISQTTGKNTEAFF	TRBV10-3	TRBJ1-1
TGTGCCAGCAGTTTCCGTGGACAGTTGCGTAGCACAGATACGCAGTATTTT	CASSFRGQLRSTDTQYF	TRBV27	TRBJ2-3
TGTGCCAGCAGCCAAGATGGTCCCGACAGACCGGGGCACCAAGAGACCCAGTACTTC	CASSQDGPDRPGHQETQYF	TRBV3-1	TRBJ2-5
TGTGCCAGCAGCTGGAACGCCGGCCTACAGGGGGAAGAGGTCTACGAGCAGTACTTC	CASSWNAGLQGEEVYEQYF	TRBV7-3	TRBJ2-7
TGTGCCAGCAGTGAAGCGTCTTGCCCAGGGACAGGGGTGGGCCAGTACTTC	CASSEASCPGTGVGQYF	TRBV6-1	TRBJ2-5
TGTGCCAGCAGCCAAGGTTTGTGGCCCCGGAATCCTGACCAAGAGACCCAGTACTTC	CASSQGLWPRNPDQETQYF	TRBV14	TRBJ2-5
TGTGCCAGCAGTTTAAAGGGGCGGGATAAGAGGACCCAGTACTTC	CASSLKGRDKRTQYF	TRBV6-5	TRBJ2-5
TGCAGTGCTAGGCCACGGAGCTCTGGAAACACCATATATTTT	CSARPRSSGNTIYF	TRBV20-1	TRBJ1-3
TGTGCCAGCAGCCCTCCTCGGGGGAGCGAGCAGTACTTC	CASSPPRGSEQYF	TRBV7-3	TRBJ2-7
TGCGCCAGCAGCCAAGAGAAACTTACTCCTAAAGGCTATGGCTACACCTTC	CASSQEKLTPKGYGYTF	TRBV4-3	TRBJ1-2
TGCAGTGCTAGACAGGGGAACTCAGTCGCCTATAGCAATCAGCCCCAGCATTTT	CSARQGNSVAYSNQPQHF	TRBV20-1	TRBJ1-5
TGTGCCACCAGTGATGGCTCTTACATGAACACTGAAGCTTTCTTT	CATSDGSYMNTEAFF	TRBV24-1	TRBJ1-1
TGCGCCAGCAGTGAGTTCCAGGGGGCCCGAACGATTACCTATGGCTACACCTTC	CASSEFQGARTITYGYTF	TRBV10-1	TRBJ1-2
TGCGCCAGCAGTGAGTTGATCAGGGACTATGGCTACACCTTC	CASSELIRDYGYTF	TRBV10-1	TRBJ1-2
TGTGCCAGCAGTGCCACAGGGTGCCAAGAGACCCAGTACTTC	CASSATGCQETQYF	TRBV6-4	TRBJ2-5
TGTGCCAGCAGGGTACAGGGGAACGAGCAGTACTTC	CASRVQGNEQYF	TRBV7-9	TRBJ2-7
TGTGCCAGCAGCAACAGGTCTCTCTTTCAGCCCCAGCATTTT	CASSNRSLFQPQHF	TRBV7-3	TRBJ1-5
TGTGCCAGTTTGGCCGGGACAGGGGGGTCTGAAGCTTTCTTT	CASLAGTGGSEAFF	TRBV27	TRBJ1-1
TGTGCCAGCAGTTTACTGCCTCTATGGAGGTCCAGCACAGATACGCAGTATTTT	CASSLLPLWRSSTDTQYF	TRBV28	TRBJ2-3
TGTGCCAGCAGCATTAGGAACTATGGCTACACCTTC	CASSIRNYGYTF	TRBV7-3	TRBJ1-2
TGTGCCAGCAGTAATCTAGCGGGTGGGGAGACCCAGTACTTC	CASSNLAGGETQYF	TRBV6-3	TRBJ2-5
TGTGCCAGCAGTTTTCTCCTGCGGGACAGACTTGGCTACACCTTC	CASSFLLRDRLGYTF	TRBV12-3	TRBJ1-2
TGTGCCACCAGTGAGGGACTAGCGGGGGGGCAGTACTTC	CATSEGLAGGQYF	TRBV24-1	TRBJ2-5
TGTGCCACCAACGACCCGGCCACTTATGAACCCAAGAGCTGGTCTTACGAGCAGTACTTC	CATNDPATYEPKSWSYEQYF	TRBV24-1	TRBJ2-7
TGTGCCAGCAGTTTAATGAAGAAAGGGACTGGGACCGGGAACACCGGGGAGCTGTTTTTT	CASSLMKKGTGTGNTGELFF	TRBV27	TRBJ2-2
TGTGCCAGCAGTTACTCCCGGGCAGGGAGAAGCTCCTACGAGCAGTACTTC	CASSYSRAGRSSYEQYF	TRBV6-5	TRBJ2-7
TGTGCCAGCAGCCAAGATAGCGATAGGATGATCGGGTCGAGCAATCAGCCCCAGCATTTT	CASSQDSDRMIGSSNQPQHF	TRBV4-2	TRBJ1-5
TGTGCCAGCAGGACAACTGGGTTGAGGTTCACAGATACGCAGTATTTT	CASRTTGLRFTDTQYF	TRBV6-5	TRBJ2-3
TGTGCCAGCAGTGAAAACTGCCAGATCCGCAGGAATGAAAAACTGTTTTTT	CASSENCQIRRNEKLFF	TRBV2	TRBJ1-4
TGCGCCAGCAGCCAAGATGTCTTTCTAAGCGGGAATGGAAACGGGGAGCTGTTTTTT	CASSQDVFLSGNGNGELFF	TRBV4-3	TRBJ2-2
TGTGCCAGCTCACCTAAACAGGGGTTAGGAGGAGCAGAGCCCCAGCATTTT	CASSPKQGLGGAEPQHF	TRBV18	TRBJ1-5
TGTGCCAGCAGTTTTAGAGGCCGAGAGCAGTTCTTC	CASSFRGREQFF	TRBV6-5	TRBJ2-1
TGTGCCAGCAGTTTATCACGATGCCGAACTGAAGCTTTCTTT	CASSLSRCRTEAFF	TRBV27	TRBJ1-1
TGTGCCAGCAGAAGGGCCCACCAGCCCCAGCATTTT	CASRRAHQPQHF	TRBV11-2	TRBJ1-5
TGTGCCAGCAGCTGGTCCGGGACACTTTATAGCAATCAGCCCCAGCATTTT	CASSWSGTLYSNQPQHF	TRBV5-6	TRBJ1-5
TGTGCCAGCAGCCAAGGGGGGCCCTACGAGCAGTACTTC	CASSQGGPYEQYF	TRBV3-1	TRBJ2-7
TGTGCCACCAGCAGAGATAGAACTACTAGCGGGGTAGCCGGCCCCCCGTCAGATACGCAGTATTTT	CATSRDRTTSGVAGPPSDTQYF	TRBV15	TRBJ2-3
TGCGCCAGCAGCCCCCGAGGGACAGATACGCAGTATTTT	CASSPRGTDTQYF	TRBV4-1	TRBJ2-3
TGTGCCAGCAGGCTCGGGACTAGCGGGCGTAAGACCTCAGATACGCAGTATTTT	CASRLGTSGRKTSDTQYF	TRBV27	TRBJ2-3
TGTGCCAGCAGCTCCCCAGGCGATAGCAATCAGCCCCAGCATTTT	CASSSPGDSNQPQHF	TRBV7-3	TRBJ1-5
TGTGCCAGCAGCGAATCAGGGCAGGTGTACACTGAAGCTTTCTTT	CASSESGQVYTEAFF	TRBV13	TRBJ1-1
TGTGCCAGCAGCTTAGCGACAGGGGTTTTAGAGACCCAGTACTTC	CASSLATGVLETQYF	TRBV11-3	TRBJ2-5
TGTGCCAGCAGCTCCCTTCTATCCCCTTTTTACGAGCAGTACTTC	CASSSLLSPFYEQYF	TRBV11-3	TRBJ2-7
TGTGCCTGGAAGCTACAGGATATCTATGGCTACACCTTC	CAWKLQDIYGYTF	TRBV30	TRBJ1-2
TGTGCCAGCAGCTCAAAGGTCTTTAAGACAGGGTCGGAAATTAGCAATCAGCCCCAGCATTTT	CASSSKVFKTGSEISNQPQHF	TRBV7-3	TRBJ1-5
TGTGCCAGCAGCTCTTCTATGAACTATGGCTACACCTTC	CASSSSMNYGYTF	TRBV7-3	TRBJ1-2
TGTGCCAGCAGCCAAGAGACCTGTTACACTGAAGCTTTCTTT	CASSQETCYTEAFF	TRBV7-3	TRBJ1-1
TGTGCCAGTAGTATTTATTCCCTTTCTAGCACTATAGATACGCAGTATTTT	CASSIYSLSSTIDTQYF	TRBV19	TRBJ2-3
TGCGCCAGCAGCTTAACAGGGAATGAGCAGTTCTTC	CASSLTGNEQFF	TRBV5-1	TRBJ2-1
TGCGCCAGCAGCTTGCCAAGAGGGGGGTTCCGGGGGAATGAGCAGTTCTTC	CASSLPRGGFRGNEQFF	TRBV5-1	TRBJ2-1
TGCGCCAGCAGCCAAGATGTGGACAGGGGGCTTGGAAAGGGCATAGATACGCAGTATTTT	CASSQDVDRGLGKGIDTQYF	TRBV4-1	TRBJ2-3
TGTGCCAGCAGCGGATTTCCGGAGACCCAGTACTTC	CASSGFPETQYF	TRBV6-6	TRBJ2-5
TGTGCCAGCAGCCGAGGGGGGGCCGTGGACACCGGGGAGCTGTTTTTT	CASSRGGAVDTGELFF	TRBV13	TRBJ2-2
TGTGCCAGCAGTGTACGCGTGACACAGGGGTTTGAGCAGTTCTTC	CASSVRVTQGFEQFF	TRBV6-4	TRBJ2-1
TGTGCCAGCAGTTTATTTCAGGGGAGCTCCTACGAGCAGTACTTC	CASSLFQGSSYEQYF	TRBV27	TRBJ2-7
TGCGCCAGCAGTGATCGGGGGTGCTACACCTTC	CASSDRGCYTF	TRBV10-1	TRBJ1-2
TGTGCCAGCAGCGTCAACTGGTTGCTGTACGAGCAGTACTTC	CASSVNWLLYEQYF	TRBV9	TRBJ2-7
TGTGCCAGCAGCGACCTTTGCGGGGGAGTCTACGAGCAGTACTTC	CASSDLCGGVYEQYF	TRBV5-4	TRBJ2-7
TGCGCCAGCAGTGAGGGGGGCGGGACTAGCGGCATATCGTGGGGCAAAAACATTCAGTACTTC	CASSEGGGTSGISWGKNIQYF	TRBV10-1	TRBJ2-4
TGTGCCACCAGTGAGGTCCTTGTAAACAGGATAGCTGGAAACACCATATATTTT	CATSEVLVNRIAGNTIYF	TRBV24-1	TRBJ1-3
TGTGCCAGTAGTAAGAGGGAAATATGGGAAAAACTGTTTTTT	CASSKREIWEKLFF	TRBV19	TRBJ1-4
TGTGCCAGTAGTATAGGGCGTCCTAGCGGGGGTAGGTCAAACAATGAGCAGTTCTTC	CASSIGRPSGGRSNNEQFF	TRBV19	TRBJ2-1
TGTGCCAGCAGCTTAGGCCCCCGGGGCCTGAGCTCCTACGAGCAGTACTTC	CASSLGPRGLSSYEQYF	TRBV7-4	TRBJ2-7
TGTGCCAGCGGCCCTAAATGTTCACCCCTCCACTTT	CASGPKCSPLHF	TRBV27	TRBJ1-6
TGCGCCAGCAGCTCTCAAGCAGGGAATAATGAAAAACTGTTTTTT	CASSSQAGNNEKLFF	TRBV5-1	TRBJ1-4
TGTGCCAGCAGTTTTCCAATGGGACAGGGGCGAAGTAGGTCTAGCTCCTATAATTCACCCCTCCACTTT	CASSFPMGQGRSRSSSYNSPLHF	TRBV27	TRBJ1-6
TGTGCCAGCAGCTTGCCCCCCAGACAGGGTATTTATGGCTACACCTTC	CASSLPPRQGIYGYTF	TRBV5-6	TRBJ1-2
TGTGCCATCGTACCAGGGAATAGGCAGCAGTTCTTC	CAIVPGNRQQFF	TRBV10-3	TRBJ2-1
TGTGCCAGCAGCTCTCGTGACGCGGGGCGCGACGCCTACGAGCAGTACTTC	CASSSRDAGRDAYEQYF	TRBV5-4	TRBJ2-7
TGTGCCAGCAGCCAAGCATTATTAACTAGCGGGAATGAGCAGTTCTTC	CASSQALLTSGNEQFF	TRBV14	TRBJ2-1
TGTGCCAGTAGTAATTTACAGGGAGATAGCAATCAGCCCCAGCATTTT	CASSNLQGDSNQPQHF	TRBV19	TRBJ1-5
TGTGCCAGCAGCGTCCGACAGGGTGGAGACACTGAAGCTTTCTTT	CASSVRQGGDTEAFF	TRBV7-2	TRBJ1-1
TGTGCCAGTAGTATAGGACTAGCGGGAGGGCCCAGCTACAATGAGCAGTTCTTC	CASSIGLAGGPSYNEQFF	TRBV19	TRBJ2-1
TGCAGTGCTCTGAACTACGAGCAGTACTTC	CSALNYEQYF	TRBV20-1	TRBJ2-7
TGTGCCAGCGGGGGATGGACAGGGATTCCTAACTATGGCTACACCTTC	CASGGWTGIPNYGYTF	TRBV6-1	TRBJ1-2
TGTGCCAGCAGTGAAAAGAACAGAGCCTACAATGAGCAGTTCTTC	CASSEKNRAYNEQFF	TRBV6-4	TRBJ2-1
TGTGCCAGCAGCCAACAGGCCCAGCATTTT	CASSQQAQHF	TRBV3-1	TRBJ1-5
TGCAGTGCTAGCTTAGGGAAGGCCTACGAGCAGTACTTC	CSASLGKAYEQYF	TRBV20-1	TRBJ2-7
TGTGCCAGCAGCACCCTAATTGGAGGCTATGGCTACACCTTC	CASSTLIGGYGYTF	TRBV13	TRBJ1-2
TGCGCCAGCAGCCACGAGGGGGAAGGAACCAATCAGCCCCAGCATTTT	CASSHEGEGTNQPQHF	TRBV4-3	TRBJ1-5
TGTGCCAGCAGCCCTTTGGCACTCTGGCCTAATTCACCCCTCCACTTT	CASSPLALWPNSPLHF	TRBV5-4	TRBJ1-6
TGTGCCAATAGCGGGGACTGGGATACGCAGTATTTT	CANSGDWDTQYF	TRBV2	TRBJ2-3
TGTGCCAGGACAGGAGGGGGTTCACCCCTCCACTTT	CARTGGGSPLHF	TRBV27	TRBJ1-6
TGTGCCAGCAGCCCCCTCGACCAGGGGAGTAACACCGGGGAGCTGTTTTTT	CASSPLDQGSNTGELFF	TRBV6-1	TRBJ2-2
TGTGCCAGCCGTACCCAAAGCGGACACTCTGTTGAAAAACTGTTTTTT	CASRTQSGHSVEKLFF	TRBV9	TRBJ1-4
TGCGCCAGCAGCCGCCAGGCACGAGCCGAAGCTTTCTTT	CASSRQARAEAFF	TRBV4-3	TRBJ1-1
TGCAGTGCTAGAGGATCAGGGCGCAACTCCTACAATGAGCAGTTCTTC	CSARGSGRNSYNEQFF	TRBV20-1	TRBJ2-1
TGTGCCAGCAGGGGGGCTCCCGGGGAGCTGTTTTTT	CASRGAPGELFF	TRBV6-5	TRBJ2-2
TGTGCCACCAGTGACCCTTGGCCGCACAATGAGCAGTTCTTC	CATSDPWPHNEQFF	TRBV24-1	TRBJ2-1
TGTGCCAGCAGTAAAGGGACAGATAGCAATCAGCCCCAGCATTTT	CASSKGTDSNQPQHF	TRBV27	TRBJ1-5
TGTGCTAGTGGATTCGCACCTAAACCAAAACACACCGGGGAGCTGTTTTTT	CASGFAPKPKHTGELFF	TRBV12-5	TRBJ2-2
TGTGCCAGCAGCATTACCCGGACTTACGAGCAGTACTTC	CASSITRTYEQYF	TRBV13	TRBJ2-7
TGCGCCAGCTGTGACCCGGGTGAAACAGGACAGGTCCGCAATCAGCCCCAGCATTTT	CASCDPGETGQVRNQPQHF	TRBV5-1	TRBJ1-5
TGCAGTGCTAGAGATCGACGGAACTCTGGGGCCAACGTCCTGACTTTC	CSARDRRNSGANVLTF	TRBV20-1	TRBJ2-6
TGTGCCAGCAGCGCCAGTTTAAGGGCTAGCGCCCATGAGCAGTTCTTC	CASSASLRASAHEQFF	TRBV5-6	TRBJ2-1
TGCGCCAGCAGCCCAGGACGTTACACTGAAGCTTTCTTT	CASSPGRYTEAFF	TRBV4-1	TRBJ1-1
TGTGCCACCAGCCCCCCGCTGGTAGGCGTGAACTATGGCTACACCTTC	CATSPPLVGVNYGYTF	TRBV15	TRBJ1-2
TGCAGTGCTAGAGCTCCCCTCGGGACAGCGCAGTATTTT	CSARAPLGTAQYF	TRBV20-1	TRBJ2-3
TGCAGTGCTCGTAATCTCGAGGGGTTACCGGAGCAGTACTTC	CSARNLEGLPEQYF	TRBV20-1	TRBJ2-7
TGTGCCAGCAGCGGGGATTTCACGCCCCAGCATTTT	CASSGDFTPQHF	TRBV14	TRBJ1-5
TGTGCCAGCAGTGTTGATCCGACTAGCGGGCAAGATACGCAGTATTTT	CASSVDPTSGQDTQYF	TRBV12-3	TRBJ2-3
TGTGCCAGCAGCTTAGACAACCGGGACAGACCCTATCGTCGTGAGAGCGAGCAGTACTTC	CASSLDNRDRPYRRESEQYF	TRBV11-2	TRBJ2-7
TGCGCCAGTGACAGGACAGGCCCGAAATCTGGGGCCAACGTCCTGACTTTC	CASDRTGPKSGANVLTF	TRBV10-2	TRBJ2-6
TGTGCCACCAGTGAGTGGTCAAGGGGGAACTATTTT	CATSEWSRGNYF	TRBV24-1	TRBJ1-3
TGTACGGGGCAAGAGACCCAGTACTTC	CTGQETQYF	TRBV27	TRBJ2-5
TGTGCCAGCAGCTCAGTAAATAACACTGAAGCTTTCTTT	CASSSVNNTEAFF	TRBV5-4	TRBJ1-1
TGTGCCAGTAGGGCGGAGGCACCCTACGAGCAGTACTTC	CASRAEAPYEQYF	TRBV19	TRBJ2-7
TGTGCCAGCAGCCAAGATCTGGTCTCGGTAGACAATGAGCAGTTCTTC	CASSQDLVSVDNEQFF	TRBV4-2	TRBJ2-1
TGTGCCAGCAGCCAGGGACACTACGAGCAGTACTTC	CASSQGHYEQYF	TRBV13	TRBJ2-7
TGTGCCAGTAGTCCTCGGACAGGGAGGAACACCTTC	CASSPRTGRNTF	TRBV19	TRBJ1-2
TGTGCCAGCCCTGAAGCGAGAATCCCTGCGCAGTTCTTC	CASPEARIPAQFF	TRBV25-1	TRBJ2-1
TGCGCCAGCAGAGGACAGGGGGGACCCAGCAATCAGCCCCAGCATTTT	CASRGQGGPSNQPQHF	TRBV5-1	TRBJ1-5
TGTGCCAGCAGCTTCGACAGGGGGCCTTTGGGCAATGAGCAGTTCTTC	CASSFDRGPLGNEQFF	TRBV7-7	TRBJ2-1
TGCGCCAGCAGATCAGGGGCGGATGGCTACACCTTC	CASRSGADGYTF	TRBV10-1	TRBJ1-2
TGTGCCAGCAGTGACTCGGTTGAGGGGGTCGGCTCCTACAATGAGCAGTTCTTC	CASSDSVEGVGSYNEQFF	TRBV6-4	TRBJ2-1
TGTGCCAGCAAGCGCATATCTATCCGTAGTCGCTATGGCTACACCTTC	CASKRISIRSRYGYTF	TRBV2	TRBJ1-2
TGCAGTACAGCCTACGAGCAGTACTTC	CSTAYEQYF	TRBV29-1	TRBJ2-7
TGTGCCAGCAGCCGGCCGGGGACAGGGGAAGATCAGCCCCAGCATTTT	CASSRPGTGEDQPQHF	TRBV9	TRBJ1-5
TGCAGTGCTAGAGATAGGAAAGGGACAGTTCTCTATGGCTACACCTTC	CSARDRKGTVLYGYTF	TRBV20-1	TRBJ1-2
TGTGCCAGCAGTTTATTCTACCTAGGGACAGGGGGCGGGGAGCAGTACTTC	CASSLFYLGTGGGEQYF	TRBV28	TRBJ2-7
TGTGCCAGCAGCTTATTAGGGCTTATGAACACTGAAGCTTTCTTT	CASSLLGLMNTEAFF	TRBV7-2	TRBJ1-1
TGTGCCAGCAGCGGGGGGGAGTCCTCCTACAATGAGCAGTTCTTC	CASSGGESSYNEQFF	TRBV5-4	TRBJ2-1
TGTGCCAGCAGGCCGACAGGGGTTGGGGGAGAGACCCAGTACTTC	CASRPTGVGGETQYF	TRBV12-3	TRBJ2-5
TGCGCCAGCAGCTTCATGATAATGCAGATGGGTTCCCCCAGCAATCAGCCCCAGCATTTT	CASSFMIMQMGSPSNQPQHF	TRBV5-1	TRBJ1-5
TGTGCCAGCAGTCTTAGAGATTGTCAGCCCCAGCATTTT	CASSLRDCQPQHF	TRBV2	TRBJ1-5
TGCGCCAGCAGCCACAGGGCCTTGCAGCCCCAGCATTTT	CASSHRALQPQHF	TRBV5-1	TRBJ1-5
TGTGCCAGCAGGATCACTACTCAGCCCCAGCATTTT	CASRITTQPQHF	TRBV9	TRBJ1-5
TGCGCCAGCCGCGTGCTCTGGGAGCGGGACAGGGCAACCAACACTGAAGCTTTCTTT	CASRVLWERDRATNTEAFF	TRBV10-1	TRBJ1-1
TGTGCCACCAGCAGAGCCCCAACTGGGGGAAAAACCTACGAGCAGTACTTC	CATSRAPTGGKTYEQYF	TRBV15	TRBJ2-7
TGTGCCAGCAGCCAAGTGGGGGGGGAGACCCAGTACTTC	CASSQVGGETQYF	TRBV3-1	TRBJ2-5
TGTGCCAAACCGGGGTTCCACACGGGGGAGCAGTTCTTC	CAKPGFHTGEQFF	TRBV6-5	TRBJ2-1
TGTGCCAGCCTCCTCGACCCTTATTTAGAAAAACTGTTTTTT	CASLLDPYLEKLFF	TRBV9	TRBJ1-4
TGTGCCAGCAGGGACACACATGAGACCCAGTACTTC	CASRDTHETQYF	TRBV6-8	TRBJ2-5
TGTGCCAGCAGCTACGTCAGGAGGGCCTACGAGCAGTACTTC	CASSYVRRAYEQYF	TRBV7-9	TRBJ2-7
TGCAGTGCGTTCATCCCCGGGCCTAATAGCAATCAGCCCCAGCATTTT	CSAFIPGPNSNQPQHF	TRBV20-1	TRBJ1-5
TGTGCCAGCAGTTTACTCCTCATTGTGACTAGCGGGAGTATTAATGAAAAACTGTTTTTT	CASSLLLIVTSGSINEKLFF	TRBV28	TRBJ1-4
TGTGCCAGCAGTGGCACTGGACAGGGCTACCGCACCGGGGAGCTGTTTTTT	CASSGTGQGYRTGELFF	TRBV25-1	TRBJ2-2
TGCGCCAGCAGCAACGGCTTAGATAGCAATCAGCCCCAGCATTTT	CASSNGLDSNQPQHF	TRBV5-1	TRBJ1-5
TGTGCCAGTAGGGGGACAGCGGGTAATCAGCCCCAGCATTTT	CASRGTAGNQPQHF	TRBV19	TRBJ1-5
TGTGCCAGCACCCGCCTACCAGCGGGTCGCCCAAGTAGGGGATACGAGCAGTACTTC	CASTRLPAGRPSRGYEQYF	TRBV25-1	TRBJ2-7
TGTGCCAGCAGCCTCCCGAATGAGCAGTTCTTC	CASSLPNEQFF	TRBV6-4	TRBJ2-1
TGTGCCACCAGTGATTTCCGTGGGCTAGCGGTGAGGCCTGACAATGAGCAGTTCTTC	CATSDFRGLAVRPDNEQFF	TRBV24-1	TRBJ2-1
TGTGCCAGCAGCTCCCTCCCTAGCGGGTTCAAGCAGTTCTTC	CASSSLPSGFKQFF	TRBV5-8	TRBJ2-1
TGTGCCAGCAGCTTATCGCGGGGCCCTGGAAACACCATATATTTT	CASSLSRGPGNTIYF	TRBV7-3	TRBJ1-3
TGTGCTAGTGGTTTGGATACCTACGAATTAGAAGCTTTCTTT	CASGLDTYELEAFF	TRBV12-5	TRBJ1-1
TGTGCCTGGAGTTCCCTGTCCGAAGGGGGGGAGGGAGGCTACAATGAGCAGTTCTTC	CAWSSLSEGGEGGYNEQFF	TRBV30	TRBJ2-1
TGTGCCAGCAGCGCGGACAGAGGGCAAGAGACCCAGTACTTC	CASSADRGQETQYF	TRBV5-5	TRBJ2-5
TGTGCCAGCAGTTTATCAGGTCATAGAAGAGGCCCCAGCTCCTACAATGAGCAGTTCTTC	CASSLSGHRRGPSSYNEQFF	TRBV28	TRBJ2-1
TGCAGTGCTAGCCGAGGGGACGGGGTTGATGGCTACACCTTC	CSASRGDGVDGYTF	TRBV20-1	TRBJ1-2
TGTGCCAGCAGCCAATTAACCCGGGACACAGAAGAGACCCAGTACTTC	CASSQLTRDTEETQYF	TRBV3-1	TRBJ2-5
TGTGCCAGCAGCCAAGAAGACAGGCTGACCTATAATTCACCCCTCCACTTT	CASSQEDRLTYNSPLHF	TRBV14	TRBJ1-6
TGTGCCAGTAGTGGGGGGCCGAACACCGGGGAGCTGTTTTTT	CASSGGPNTGELFF	TRBV19	TRBJ2-2
TGTGCCAGCAATCCTAAAGGGGGCCGACAGGTCCAACCGAACACTGAAGCTTTCTTT	CASNPKGGRQVQPNTEAFF	TRBV7-3	TRBJ1-1
TGTGCCAGCAGCCCAGGCAAGAGCTCCTACGAGCAGTACTTC	CASSPGKSSYEQYF	TRBV7-3	TRBJ2-7
TGTGCCAGCAGCTTATTAAGGAATGGAAAAAGAACAGCACAGGAGGGAAGAGCTTTCTTT	CASSLLRNGKRTAQEGRAFF	TRBV7-4	TRBJ1-1
TGTGCCAGCAGCTTAGAGACAGGGGGCTGGGGGACTAATGAAAAACTGTTTTTT	CASSLETGGWGTNEKLFF	TRBV11-2	TRBJ1-4
TGTGCCAGCAGCAGGGCTGATGAGCAGTTCTTC	CASSRADEQFF	TRBV12-3	TRBJ2-1
TGTGCCAGCAGCGTCCAGGGGGGCACAGATACGCAGTATTTT	CASSVQGGTDTQYF	TRBV9	TRBJ2-3
TGTGCCAGCAGTGCACCAGGGCAGAACACTGAAGCTTTCTTT	CASSAPGQNTEAFF	TRBV6-4	TRBJ1-1
TGTGCCACCAGTGTCGACAGGGGGAGGAACACTGAAGCTTTCTTT	CATSVDRGRNTEAFF	TRBV24-1	TRBJ1-1
TGCAGTGCTTGGGGGCTAAAGGCCTCCTACAATGAGCAGTTCTTC	CSAWGLKASYNEQFF	TRBV20-1	TRBJ2-1
TGTGCCAGCAGTTACCGCAGGCATGAAGCTTTCTTT	CASSYRRHEAFF	TRBV6-5	TRBJ1-1
TGTGCCAGCAGTGGAGTAGGACACTATAGCAATCAGCCCCAGCATTTT	CASSGVGHYSNQPQHF	TRBV6-6	TRBJ1-5
TGTGCCAGCAGCTCCGAAGCTCCCGGGACTAGCGGTGTAGTCTACGAGCAGTACTTC	CASSSEAPGTSGVVYEQYF	TRBV7-2	TRBJ2-7
TGTGCCAGCACTACTCGGGGGAACAGAGCCTCCTACGAGCAGTACTTC	CASTTRGNRASYEQYF	TRBV6-4	TRBJ2-7
TGTGCCAGCAGTTTCCTCCTAACCTCCCAGAGACAAGAGACCCAGTACTTC	CASSFLLTSQRQETQYF	TRBV27	TRBJ2-5
TGTGCCAGCAGCCAAGGAAACCAGACAGGGAGCAGTGAAGCTTTCTTT	CASSQGNQTGSSEAFF	TRBV14	TRBJ1-1
TGTGCCAGCAGACCTATTCGGGGGGGCCGGCAGTTCTTC	CASRPIRGGRQFF	TRBV5-8	TRBJ2-1
TGCGCCAGCAGTGAGTTCTGGCATCTTCCAGAAAAACTGTTTTTT	CASSEFWHLPEKLFF	TRBV10-1	TRBJ1-4
TGTGCCAGCAGTTTAAGTGGAAACATTCAGTACTTC	CASSLSGNIQYF	TRBV12-4	TRBJ2-4
TGTGCCCCCGCCCCGGACAGGGAACCCGAACAGCCCCAGCATTTT	CAPAPDREPEQPQHF	TRBV10-3	TRBJ1-5
TGTGCCAGCAGTGAATCCTTGGACAGGGGGCTTCACACTGAAGCTTTCTTT	CASSESLDRGLHTEAFF	TRBV25-1	TRBJ1-1
TGTGCCAGCAGTTCGGGGACAGGGGTCGCCAATGAAAAACTGTTTTTT	CASSSGTGVANEKLFF	TRBV6-4	TRBJ1-4
TGTGCCAGCAGTTACTCGACATCTAGCGGGCCTGGTCAAGAGACCCAGTACTTC	CASSYSTSSGPGQETQYF	TRBV6-6	TRBJ2-5
TGTGCCAGCAGCTTGGGGGGTCTAGCCAAAAACATTCAGTACTTC	CASSLGGLAKNIQYF	TRBV5-4	TRBJ2-4
TGTGCCAGCAGCACAGGCCTCGTGGAAAAACTGTTTTTT	CASSTGLVEKLFF	TRBV7-2	TRBJ1-4
TGTGCCAGCAGCCCTAAGACCCAGGGGGCAGCGGATAGCAATCAGCCCCAGCATTTT	CASSPKTQGAADSNQPQHF	TRBV7-2	TRBJ1-5
TGTGCCAGCAGCGTTCCCCAGGGGGGGAATGAAAAACTGTTTTTT	CASSVPQGGNEKLFF	TRBV7-9	TRBJ1-4
TGCGCCAGCAGCTTCTTCCATGGACTAGCGGAGAGTACGTCCTACGAGCAGTACTTC	CASSFFHGLAESTSYEQYF	TRBV5-1	TRBJ2-7
TGTGCCAGCAGCGGCCGACCACGCTCGGGACGATACGAGCAGTACTTC	CASSGRPRSGRYEQYF	TRBV9	TRBJ2-7
TGTGCCAGCAGCTCAACAGGGGATGAAAAACTGTTTTTT	CASSSTGDEKLFF	TRBV6-3	TRBJ1-4
TGTGCCAGCAGTTACCAGGGGGGAGCCCAGCCCCAGCATTTT	CASSYQGGAQPQHF	TRBV6-2	TRBJ1-5
TGTGCCAGTAGTATAGATCTGGGGGGCTGCACCGGGGAGCTGTTTTTT	CASSIDLGGCTGELFF	TRBV19	TRBJ2-2
TGCAGTGCTAGAACTCCTTTCAACAAGGGGATCAATCAGCCCCAGCATTTT	CSARTPFNKGINQPQHF	TRBV20-1	TRBJ1-5
TGCGCCAGCAGTGACCCTAACTACGCGTCCTACGAGCAGTACTTC	CASSDPNYASYEQYF	TRBV10-1	TRBJ2-7
TGTGCCAGCAGTTACTCGCCCGGGGACAGGGCTGATGCCCAGCATTTT	CASSYSPGDRADAQHF	TRBV6-2	TRBJ1-5
TGTGCCAGCAGCCAGCCATCAGGCCTACACCTAGATACGCAGTATTTT	CASSQPSGLHLDTQYF	TRBV11-3	TRBJ2-3
TGTGCCAGCAGCTTAGGGACAAGGGTTACTGAAGCTTTCTTT	CASSLGTRVTEAFF	TRBV7-9	TRBJ1-1
TGTGCCAGCAGACCCCGGGACAGGGGAGATGAAAAACTGTTTTTT	CASRPRDRGDEKLFF	TRBV14	TRBJ1-4
TGTGCCAGCAGTTTGACGGGACCGTGCAATCAGCCCCAGCATTTT	CASSLTGPCNQPQHF	TRBV27	TRBJ1-5
TGTGCCAGCAGTTTAGCTCCGACACAGAACACTGAAGCTTTCTTT	CASSLAPTQNTEAFF	TRBV12-4	TRBJ1-1
TGTGCCAGCAGTGACAACTGGATCCCGGGACTAGCGGGCTCGACGCACTGGGAGCTGTTTTTT	CASSDNWIPGLAGSTHWELFF	TRBV6-4	TRBJ2-2
TGTGCCAGCAGCCAAGATTTCACTCAAAACCGGATCCTCATTCAGTACTTC	CASSQDFTQNRILIQYF	TRBV14	TRBJ2-4
TGTGCCACCAGCAGAGAAAAAAGGGGACGCGTCTTTGCCAAAAACATTCAGTACTTC	CATSREKRGRVFAKNIQYF	TRBV15	TRBJ2-4
TGTGCCAGCAGCAGGGACCGCGGGGAAGGGCAGCAGTTCTTC	CASSRDRGEGQQFF	TRBV25-1	TRBJ2-1
TGTGCCAGCTACCGAAGGACCCTTAATGAAAAACTGTTTTTT	CASYRRTLNEKLFF	TRBV9	TRBJ1-4
TGTGCCAGCAGTTTACAAAGGGGGAACTACGAGCAGTACTTC	CASSLQRGNYEQYF	TRBV27	TRBJ2-7
TGCAGCGTTGCACCCAGCGGGATTAGGTTCGTTTCACCCCTCCACTTT	CSVAPSGIRFVSPLHF	TRBV29-1	TRBJ1-6
TGTGCCACCGCGGGCCCAGGTCCTTGTTCCTACGAGCAGTACTTC	CATAGPGPCSYEQYF	TRBV24-1	TRBJ2-7
TGTGCCAGCAGTCCCGCAACTAGCGGTAGGGCCTACAATGAGCAGTTCTTC	CASSPATSGRAYNEQFF	TRBV6-3	TRBJ2-1
TGCGCCAGCAGCCGGGCGGGGGGGAACAATGAGCAGTTCTTC	CASSRAGGNNEQFF	TRBV5-1	TRBJ2-1
TGTGCCAGCAGCAAGACATGGGACGCTTTCTACGAGCAGTACTTC	CASSKTWDAFYEQYF	TRBV5-4	TRBJ2-7
TGTGCCAGCAGTCCCTTCAAATACGGACCCGTTGGAAACACCATATATTTT	CASSPFKYGPVGNTIYF	TRBV27	TRBJ1-3
TGTGCCACCAGTGTAAGTTCGGGACAGTCCGGAGACTATACGCAGTATTTT	CATSVSSGQSGDYTQYF	TRBV24-1	TRBJ2-3
TGTGCCAGCAGCCCAGACGGGTCTGGAAACACCATATATTTT	CASSPDGSGNTIYF	TRBV13	TRBJ1-3
TGTGCCACCAGCAGACGGGAGGGGGCTAGAGCCTACAATGAGCAGTTCTTC	CATSRREGARAYNEQFF	TRBV15	TRBJ2-1
TGTGCCAGCAGCTCGGAGTCCGGCCCTACCTACGAGCAGTACTTC	CASSSESGPTYEQYF	TRBV13	TRBJ2-7
TGCAGCGTTGAGGCGCTAGCTTTCTTT	CSVEALAFF	TRBV29-1	TRBJ1-1
TGCGCCAGCAGCACAGGGTATGGCTACACCTTC	CASSTGYGYTF	TRBV5-1	TRBJ1-2
TGTGCCAGTACGGGTGACAGGGGGCATGAATTCTACGAGCAGTACTTC	CASTGDRGHEFYEQYF	TRBV19	TRBJ2-7
TGTGCCACAGGACTGCCAAGCCCCCCCTACGAGCAGTACTTC	CATGLPSPPYEQYF	TRBV24-1	TRBJ2-7
TGTGCCAGCATTAGGACTAGGAGAGGGCCCAGGTACTTC	CASIRTRRGPRYF	TRBV7-3	TRBJ2-7
TGTGCCAGCAGCTCCCCCGGGGTCAATGAGCAGTTCTTC	CASSSPGVNEQFF	TRBV7-9	TRBJ2-1
TGTGCCAGCAGGAATGCGCACCAAGCCGATACGCAGTATTTT	CASRNAHQADTQYF	TRBV11-2	TRBJ2-3
TGTGCCAGCTCACCAAAAGAGGGACAGGGGATGAACACTGAAGCTTTCTTT	CASSPKEGQGMNTEAFF	TRBV18	TRBJ1-1
TGTGCTAGTGGTTTGGTAGGGACATTGCGGACTAGCGACATTCAGTACTTC	CASGLVGTLRTSDIQYF	TRBV12-5	TRBJ2-4
TGCGCCAGCAGCTTAAAGAGACCTAGGGGGCCACCCTACAATGAGCAGTTCTTC	CASSLKRPRGPPYNEQFF	TRBV5-1	TRBJ2-1
TGCGCCAGCAGTGAGAGGAGTTCTAGCGCCGGGCTGTACGAGCAGTACTTC	CASSERSSSAGLYEQYF	TRBV10-1	TRBJ2-7
TGCGCCAGCAGTGACACCCAAGCAGGGGAACCACTTAGGTACGAGCAGTACTTC	CASSDTQAGEPLRYEQYF	TRBV10-1	TRBJ2-7
TGCGCCACATCCGGGACAGGGGGAAAAAGGAGGGGCTACAGCAATGAGCAGTTCTTC	CATSGTGGKRRGYSNEQFF	TRBV4-1	TRBJ2-1
TGTGCCACCAAAGGGTTCGGACGGGGTCATTTGAACACTGAAGCTTTCTTT	CATKGFGRGHLNTEAFF	TRBV15	TRBJ1-1
TGCGCCAGCAACTATGCGAGTGCAGTCTTC	CASNYASAVF	TRBV10-1	TRBJ2-1
TGTGCCAGCAGCCGGACGAGGAGTGACGAGCAGTACTTC	CASSRTRSDEQYF	TRBV7-3	TRBJ2-7
TGCAGCGAATGGGTCATCCATTTCTGGCGGGATGAGCAGTTCTTC	CSEWVIHFWRDEQFF	TRBV29-1	TRBJ2-1
TGCAGCGTTGGGGCACTTTGGGCCAAAAGTGACAATCAGCCCCAGCATTTT	CSVGALWAKSDNQPQHF	TRBV29-1	TRBJ1-5
TGTGCCAGCAGCTTTACGCGGGAGGACAGTAGCTCCTACAATGAGCAGTTCTTC	CASSFTREDSSSYNEQFF	TRBV2	TRBJ2-1
TGTGCCAGCAGCCAAGTGTACGAGACTAGAAACGAGCAGTACTTC	CASSQVYETRNEQYF	TRBV3-1	TRBJ2-7
TGTGCCAGCAGTTGTGCGGGAGGCTCGGCCAAAAACATTCAGTACTTC	CASSCAGGSAKNIQYF	TRBV6-5	TRBJ2-4
TGTGCCAGCACGGGTTGGACAGGGGGCGTCATTGGTCAGCCCCAGCATTTT	CASTGWTGGVIGQPQHF	TRBV5-6	TRBJ1-5
TGTGCCAGCCGGAGGGATGACGGGGCCTACGAGCAGTACTTC	CASRRDDGAYEQYF	TRBV12-3	TRBJ2-7
TGTGCCAGCAGCTTAAGGGGGTGCGAGTATAGCAATCAGCCCCAGCATTTT	CASSLRGCEYSNQPQHF	TRBV7-9	TRBJ1-5
TGTGCCAGTAGCTTCGGGGACAGGGGGGGACTAAACACTGAAGCTTTCTTT	CASSFGDRGGLNTEAFF	TRBV19	TRBJ1-1
TGCAGTGCTAGGTATAGGGGGTATGGCTACACCTTC	CSARYRGYGYTF	TRBV20-1	TRBJ1-2
TGTGCTAGTGGTTTGTCCGTGTGGGACAGACAGGACACCTTC	CASGLSVWDRQDTF	TRBV12-5	TRBJ1-2
TGTGCCAGCAGCCAAGACCCGGGACAGGGGGCGAGCTATAGCAATCAGCCCCAGCATTTT	CASSQDPGQGASYSNQPQHF	TRBV4-2	TRBJ1-5
TGTGCCACCAGTGAACAAATCAGTCATGCCAGCAATCAGCCCCAGCATTTT	CATSEQISHASNQPQHF	TRBV24-1	TRBJ1-5
TGTGCCAGCAGCTTGCACAGGGAAGGCAATCAGCCCCAGCATTTT	CASSLHREGNQPQHF	TRBV7-6	TRBJ1-5
TGTGCCAGCAAAGGGACTAGCGGGAGTAACAATGAGCAGTTCTTC	CASKGTSGSNNEQFF	TRBV6-6	TRBJ2-1
TGTGCCAGCAGTTGTGCCGAATACGAACGATTCTCTAGAGACACCGGGGAGCTGTTTTTT	CASSCAEYERFSRDTGELFF	TRBV6-8	TRBJ2-2
TGTGCCAGCAGTGGTCTAGCGGGGGGCGAGCAGTACTTC	CASSGLAGGEQYF	TRBV27	TRBJ2-7
TGTGCCAGCAGCCCGCTAGCGGGAGACAATGAGCAGTTCTTC	CASSPLAGDNEQFF	TRBV7-3	TRBJ2-1
TGTGCCAGCAGCCCGGACCACACAGATACGCAGTATTTT	CASSPDHTDTQYF	TRBV6-1	TRBJ2-3
TGTGCCCGCAGGGGCTACGAGCAGTACTTC	CARRGYEQYF	TRBV19	TRBJ2-7
TGCGCCACTATGGGGGACAAACCGGCCGGCTACACCTTC	CATMGDKPAGYTF	TRBV10-1	TRBJ1-2
TGCAGCGTTTCCACGTCGTGCCGAAGGAATCAGCCCCAGCATTTT	CSVSTSCRRNQPQHF	TRBV29-1	TRBJ1-5
TGTGCCAGCAGACCCGGGGGACCATCTAATGAGCAGTTCTTC	CASRPGGPSNEQFF	TRBV6-5	TRBJ2-1
TGCAGCCTCAGAGGGGGTTATAACTATGGCTACACCTTC	CSLRGGYNYGYTF	TRBV29-1	TRBJ1-2
TGTGCCTATTCGGGGGGTCTTGGCCGTGTGAACACCGGGGAGCTGTTTTTT	CAYSGGLGRVNTGELFF	TRBV30	TRBJ2-2
TGCGCCAGCCTCTCAGACAGGGATGGCACTGAAGCTTTCTTT	CASLSDRDGTEAFF	TRBV5-1	TRBJ1-1
TGCGCCAGCAGCCATCGGATCAGGGACACCGGGGAGCTGTTTTTT	CASSHRIRDTGELFF	TRBV4-1	TRBJ2-2
TGTGCCAGCAGGCGGGAGAGTAATGAGCAGTTCTTC	CASRRESNEQFF	TRBV11-3	TRBJ2-1
TGTGCCTGGAGTGTACTTCCCCCGAGACCCTACAATGAGCAGTTCTTC	CAWSVLPPRPYNEQFF	TRBV30	TRBJ2-1
TGCGCCAGCAGTGAGGGGTTCCGGGAGACAGGGGGGTACACTGAAGCTTTCTTT	CASSEGFRETGGYTEAFF	TRBV10-2	TRBJ1-1
TGTGCCAGCAGCAATGACAGGGGGTTAGAAACTAATGAAAAACTGTTTTTT	CASSNDRGLETNEKLFF	TRBV5-6	TRBJ1-4
TGTGCCATAAGGTGGGGCTCCTACGAGCAGTACTTC	CAIRWGSYEQYF	TRBV27	TRBJ2-7
TGTGCCAGCAGCTTATTGGCTCCGGGGATTTGTACCGGCCAAGAGACCCAGTACTTC	CASSLLAPGICTGQETQYF	TRBV11-2	TRBJ2-5
TGTGCCAGCAGCTACCCAGACAAGACGGGACACCGGGGTGGCTACACCTTC	CASSYPDKTGHRGGYTF	TRBV5-4	TRBJ1-2
TGTGCCAGCACAGTGGGGAGGCATGAGCAGTTCTTC	CASTVGRHEQFF	TRBV7-9	TRBJ2-1
TGTGCCAGCAGCGGGGCCCTACAAGAGACCCAGTACTTC	CASSGALQETQYF	TRBV7-9	TRBJ2-5
TGCTTATGGGGAGAAGGGGTTGGGGAGCTGTTTTTT	CLWGEGVGELFF	TRBV20-1	TRBJ2-2
TGCAGCGACGGAGCGGGAGAAGCAGATACGCAGTATTTT	CSDGAGEADTQYF	TRBV29-1	TRBJ2-3
TGTGCCTGGAGTCAAGTCAGGGACTTAAGACTTTACGAGCAGTACTTC	CAWSQVRDLRLYEQYF	TRBV30	TRBJ2-7
TGTGCCAGCAGCCAAGTCACGGACAGGGCGCCTGATTACGAGCAGTACTTC	CASSQVTDRAPDYEQYF	TRBV3-1	TRBJ2-7
TGTGCCAGCAGTTTAAAGGGGACCATTAGCAATCAGCCCCAGCATTTT	CASSLKGTISNQPQHF	TRBV12-3	TRBJ1-5
TGTGCCAGCGGCCTTACAGGGACAATTAATCCCAACGTCCTGACTTTC	CASGLTGTINPNVLTF	TRBV6-1	TRBJ2-6
TGTGCCAGCAGCTTGGATGCAGGCAATCAGCCCCAGCATTTT	CASSLDAGNQPQHF	TRBV5-6	TRBJ1-5
TGTGCCAGCAGCCAATGTCAGTATTTCAGGGAATATAGCAATCAGCCCCAGCATTTT	CASSQCQYFREYSNQPQHF	TRBV3-1	TRBJ1-5
TGTGCCAGCAGCCCCCAGGGGACCCAGCCCCAGCATTTT	CASSPQGTQPQHF	TRBV3-1	TRBJ1-5
TGTGCCAGCAGCGAAGAAGGGAGGGAAGAGGTATTCACGCAGTATTTT	CASSEEGREEVFTQYF	TRBV13	TRBJ2-3
TGTGCCAGCTCACCAAGGGGCGGACAAGTTAGGTATGGCTACACCTTC	CASSPRGGQVRYGYTF	TRBV18	TRBJ1-2
TGTGCCAGTATGGGGACAGACAATGAGCAGTTCTTC	CASMGTDNEQFF	TRBV19	TRBJ2-1
TGTGCCTGGAGTGCCGACAGGTATGGCTACACCTTC	CAWSADRYGYTF	TRBV30	TRBJ1-2
TGTGCCACCATTCCCGGACTAGCGGGGAGCCCAGATACGCAGTATTTT	CATIPGLAGSPDTQYF	TRBV24-1	TRBJ2-3
TGTGCCAGCAGCGATTGCTCGAGGGAGGACACTGAAGCTTTCTTT	CASSDCSREDTEAFF	TRBV9	TRBJ1-1
TGTGCTAGTGGTTTGCGAGGGGGGGGGGCCGGGGAGCTGTTTTTT	CASGLRGGGAGELFF	TRBV12-5	TRBJ2-2
TGTGCCACCAGTGATACGAAGGGGGGGTTCGGGAGGTACGAGCAGTACTTC	CATSDTKGGFGRYEQYF	TRBV24-1	TRBJ2-7
TGTGCCAGCAGCCACAAAGCCCGGGACAGGGCCCCGGCCTACGAGCAGTACTTC	CASSHKARDRAPAYEQYF	TRBV12-3	TRBJ2-7
TGCGTATGTCCTGAAAATGAGCAGTTCTTC	CVCPENEQFF	TRBV5-1	TRBJ2-1
TGTGAACTCACCGGGACTAGCGGGGAGACCCAGTACTTC	CELTGTSGETQYF	TRBV24-1	TRBJ2-5
TGTGCCAGAGGACGGGGCTACGAGCAGTACTTC	CARGRGYEQYF	TRBV6-5	TRBJ2-7
TGTGCCAGCAGCCACAGGGGCTCCGGGGAGCTGTTTTTT	CASSHRGSGELFF	TRBV3-1	TRBJ2-2
TGTAGGCCCCGGGGCTACACCTTC	CRPRGYTF	TRBV19	TRBJ1-2
TGTGCCAGCAGTGAAGCGACGGGGTGGGCTGAAAAACTGTTTTTT	CASSEATGWAEKLFF	TRBV6-1	TRBJ1-4
TGCAGCCTTTGGGACAGTGGCACCTACGAGCAGTACTTC	CSLWDSGTYEQYF	TRBV29-1	TRBJ2-7
TGTGCCACCAGCCCCCAGGGGATCTCTGGAAACACCATATATTTT	CATSPQGISGNTIYF	TRBV24-1	TRBJ1-3
TGCGCCAGCAGCTCATCTTCTAGATATAGCAATCAGCCCCAGCATTTT	CASSSSSRYSNQPQHF	TRBV5-1	TRBJ1-5
TGTGCCAGCAGCTTAAGACTATTTCTATATAGATATGGCTACACCTTC	CASSLRLFLYRYGYTF	TRBV7-3	TRBJ1-2
TGTGCCAGCCGACTAGCGGGAGAAACACGGAACACTGAAGCTTTCTTT	CASRLAGETRNTEAFF	TRBV6-1	TRBJ1-1
TGTGCCAGCAGCCGGCAGGGGGAAAAACTGTTTTTT	CASSRQGEKLFF	TRBV7-8	TRBJ1-4
TGTGCCAGCAGCCAAGTTGCGGGACAGGGGGCGAACACTGAAGCTTTCTTT	CASSQVAGQGANTEAFF	TRBV14	TRBJ1-1
TGTGCCAGCAGCTTAGGGGGGCAGAAGAGGTTCAGCTCCTATAATTCACCCCTCCACTTT	CASSLGGQKRFSSYNSPLHF	TRBV7-8	TRBJ1-6
TGTGCCAGCAGTCGCAGGGGATACTCTGGGGCCAACGTCCTGACTTTC	CASSRRGYSGANVLTF	TRBV6-1	TRBJ2-6
TGCGCCAGCAGCCAGGAGGGACCCTACGAGCAGTACTTC	CASSQEGPYEQYF	TRBV4-1	TRBJ2-7
TGTGCCAGCAGCCCGACTGCCTACGAGCAGTACTTC	CASSPTAYEQYF	TRBV7-3	TRBJ2-7
TGCAGCGTACGTGATGCCAAAAACATTCAGTACTTC	CSVRDAKNIQYF	TRBV29-1	TRBJ2-4
TGTGCCACGGGTACGGACGAGCAGTACTTC	CATGTDEQYF	TRBV6-3	TRBJ2-7
TGTGCCAGCCAGGCGGGCGCCTACGAGCAGTACTTC	CASQAGAYEQYF	TRBV27	TRBJ2-7
TGTGCCACCAGTGGACAGCTACAACATCAGCCCCAGCATTTT	CATSGQLQHQPQHF	TRBV24-1	TRBJ1-5
TGTGCCAGCATCCCCAGGGAGGGGACCGGGGAGCTGTTTTTT	CASIPREGTGELFF	TRBV6-5	TRBJ2-2
TGTGCCAGCAGACAAAGGTCCGGCTCTGGGGCCAACGTCCTGACTTTC	CASRQRSGSGANVLTF	TRBV28	TRBJ2-6
TGTGCCAGCAGTTTATTTACCCACGTTAGACGCCAGACGTATAGCAATCAGCCCCAGCATTTT	CASSLFTHVRRQTYSNQPQHF	TRBV28	TRBJ1-5
TGTGCCAGCAGTCGGGACAGATACGAGGGTGAAAAACTGTTTTTT	CASSRDRYEGEKLFF	TRBV12-4	TRBJ1-4
TGTGCCTGGAGAGGGTTAGGAAGGTACTACGAGCAGTACTTC	CAWRGLGRYYEQYF	TRBV30	TRBJ2-7
TGTGCCAGCAGCATCCAGTGCAATCAGCCCCAGCATTTT	CASSIQCNQPQHF	TRBV7-4	TRBJ1-5
TGTGCCAGCAGTTACGGGGGCCTCGATCAGCCCCAGCATTTT	CASSYGGLDQPQHF	TRBV6-2	TRBJ1-5
TGTGCCAGCATGTCAAACACTAGCGGCGTGACCTACGAGCAGTACTTC	CASMSNTSGVTYEQYF	TRBV6-5	TRBJ2-7
TGTGCCAGCAGTCGGACAGGGGGGTACGAGCAGTACTTC	CASSRTGGYEQYF	TRBV6-2	TRBJ2-7
TGCAGTGCTATGCAGGGACTAGATTATACGCAGTATTTT	CSAMQGLDYTQYF	TRBV20-1	TRBJ2-3
TGTGCCAGCAGCCACGGTCGGGGGGGGGCCAAAAACATTCAGTACTTC	CASSHGRGGAKNIQYF	TRBV3-1	TRBJ2-4
TGCAGTGCTAGCCCGCCCTTGCTGAACACTGAAGCTTTCTTT	CSASPPLLNTEAFF	TRBV20-1	TRBJ1-1
TGTGCCAGTAATCCGCGTTGTAAGGTGACAGATACGCAGTATTTT	CASNPRCKVTDTQYF	TRBV19	TRBJ2-3
TGTGCCAGCACAGTTAAGGGGGGCTCTGGGGCCAACGTCCTGACTTTC	CASTVKGGSGANVLTF	TRBV5-6	TRBJ2-6
TGCAGTGCTAGAACACCAGACAGGGAGGGGGGGTGTGCAACTAATGAAAAACTGTTTTTT	CSARTPDREGGCATNEKLFF	TRBV20-1	TRBJ1-4
TGTGCCAGTAGTATGTCAAGCGGGAGCTACGAGCAGTACTTC	CASSMSSGSYEQYF	TRBV19	TRBJ2-7
TGTGCCAGCAGTTTATCGAAATCAGCCTCCTACGAGCAGTACTTC	CASSLSKSASYEQYF	TRBV27	TRBJ2-7
TGTGCCATTCTGGGGCGGAGCTCCTATAATTCACCCCTCCACTTT	CAILGRSSYNSPLHF	TRBV28	TRBJ1-6
TGCGCCAGCAGCACGGGAAGGGGGGTTTTGCAGGAGACCCAGTACTTC	CASSTGRGVLQETQYF	TRBV4-1	TRBJ2-5
TGTGCCAGCTCACCATTGGGGGGGTCGAATTCACCCCTCCACTTT	CASSPLGGSNSPLHF	TRBV18	TRBJ1-6
TGCGCCAGCAGCTTGGTCCCCATGACAGGGGGTTTTGAAAAACTGTTTTTT	CASSLVPMTGGFEKLFF	TRBV5-1	TRBJ1-4
TGCAGCGTTGGAACCCAATATAGCCAGTGGGGGGGGCATACGGTTTACGAGACCCAGTACTTC	CSVGTQYSQWGGHTVYETQYF	TRBV29-1	TRBJ2-5
TGTGCCAGCAGTCACCGGGACAGCCATCAGCCCCAGCATTTT	CASSHRDSHQPQHF	TRBV28	TRBJ1-5
TGTGCCAGCAGCGACAGGGAGGCTTCGAATCAGCCCCAGCATTTT	CASSDREASNQPQHF	TRBV13	TRBJ1-5
TGTGCCAGCAGCCCCCGAGGGGGTGTTGCCAAAAACATTCAGTACTTC	CASSPRGGVAKNIQYF	TRBV9	TRBJ2-4
TGTGCCAGCAGTTTGCCGGAGTTTGCCATACCCGGGGGCAATCAGCCCCAGCATTTT	CASSLPEFAIPGGNQPQHF	TRBV27	TRBJ1-5
TGTGCCAGCAGCGACTTGCGGGAGAGCTCCTACAATGAGCAGTTCTTC	CASSDLRESSYNEQFF	TRBV9	TRBJ2-1
TGTGCCAGCAGGGGGGCAGGGCGAGCTTTCTTT	CASRGAGRAFF	TRBV5-4	TRBJ1-1
TGTGCCAGCAGTTTAGGGCGGGCCCGGCAGCCCCAGCATTTT	CASSLGRARQPQHF	TRBV27	TRBJ1-5
TGTGCCAGCAGTTCTTGGGACAGGGTCCCAGGCTACGAGCAGTACTTC	CASSSWDRVPGYEQYF	TRBV6-9	TRBJ2-7
TGTGCCAGCAGCCCCCAGGGCTCCCAAGAGACCCAGTACTTC	CASSPQGSQETQYF	TRBV7-3	TRBJ2-5
TGTGCCAGCCGGCGCAAGGACTACGAGCAGTACTTC	CASRRKDYEQYF	TRBV5-6	TRBJ2-7
TGTGCCAGTAGTATCCTCGGGGCGCAGCCCCAGCATTTT	CASSILGAQPQHF	TRBV19	TRBJ1-5
TGTGCCATATGCGCGGGAGGTGAAAAACTGTTTTTT	CAICAGGEKLFF	TRBV7-6	TRBJ1-4
TGTGCCAGTGGGGCACAGGGATCCCCTCCCCGATACGAGCAGTACTTC	CASGAQGSPPRYEQYF	TRBV19	TRBJ2-7
TGTGCCAGCAGCTTAATCGCGTCAAAAAACGGACGTTCCGAGCAGTACTTC	CASSLIASKNGRSEQYF	TRBV11-3	TRBJ2-7
TGCGCCAGCAGTGTCCCTCGGGACAGGGACGTAACCCAAGAGACCCAGTACTTC	CASSVPRDRDVTQETQYF	TRBV10-1	TRBJ2-5
TGCAGTGCTTCACTAGGATTTACCGGGGAGCTGTTTTTT	CSASLGFTGELFF	TRBV20-1	TRBJ2-2
TGTGCCAGTAGTATATACCATAGCGGCGGGACACAATCCTACGAGCAGTACTTC	CASSIYHSGGTQSYEQYF	TRBV19	TRBJ2-7
TGTGCCAGCAGTACGGGACAGGGGCTTTCTTGGATACACACTGAAGCTTTCTTT	CASSTGQGLSWIHTEAFF	TRBV27	TRBJ1-1
TGTGCCAGCAGCTTACGGACAGGAATGAACACTGAAGCTTTCTTT	CASSLRTGMNTEAFF	TRBV7-2	TRBJ1-1
TGTGCCAGCAGCGGACAGGGGAGGTTCAAGACCCAGTACTTC	CASSGQGRFKTQYF	TRBV7-9	TRBJ2-5
TGTGCCAGCAGTTCCCATAACGAGGGGGACAGAGACGAGCAGTACTTC	CASSSHNEGDRDEQYF	TRBV27	TRBJ2-7
TGTGCCAGCACCGGGTGCTACTACGAGCAGTACTTC	CASTGCYYEQYF	TRBV6-4	TRBJ2-7
TGTGCCAGGATCCGGGACTTAGCGGCCTACGAGCAGTACTTC	CARIRDLAAYEQYF	TRBV27	TRBJ2-7
TGTGCCAGCAGACGAGAGGGAAACACCATATATTTT	CASRREGNTIYF	TRBV6-4	TRBJ1-3
TGTGCCAGCAGTAGATTGAAGGGGGACGGAGGCAATCAGCCCCAGCATTTT	CASSRLKGDGGNQPQHF	TRBV6-6	TRBJ1-5
TGTGCCAGCAGCTGTGGACAGGCGGCTCAGCCCCAGCATTTT	CASSCGQAAQPQHF	TRBV13	TRBJ1-5
TGTGCCCCTTGTGGGCCCATACAGGGCTCTGGGGCCAACGTCCTGACTTTC	CAPCGPIQGSGANVLTF	TRBV5-6	TRBJ2-6
TGTGCCAGCAGCGTAGTTGGAAAGGCGGGACAGAATAGCGACGAAGCTTTCTTT	CASSVVGKAGQNSDEAFF	TRBV9	TRBJ1-1
TGTGCCCCTTGGGGAGCCCCCGGTCACTATGGCTACACCTTC	CAPWGAPGHYGYTF	TRBV28	TRBJ1-2
TGTGCCAGCGCCCAGACAGGGATAATCAACACTGAAGCTTTCTTT	CASAQTGIINTEAFF	TRBV6-5	TRBJ1-1
TGTGCCAGCAGCTTAGCAGGGCGTCTTGCTTTCTTT	CASSLAGRLAFF	TRBV7-2	TRBJ1-1
TGTGCCAGCAGTGTCTCCTACGAATTGGGGTTTTGGGGCTACAATGAGCAGTTCTTC	CASSVSYELGFWGYNEQFF	TRBV6-4	TRBJ2-1
TGTGCCAGCAGCCCGGGACAGGGGATTATGGACTCCTACAATGAGCAGTTCTTC	CASSPGQGIMDSYNEQFF	TRBV11-3	TRBJ2-1
TGCGCCAGCGCACAGGAGAACACTGAAGCTTTCTTT	CASAQENTEAFF	TRBV5-1	TRBJ1-1
TGCAGCGACAAAGAAAATGGGACTAGCGGGCCAAGCTCCTACGAGCAGTACTTC	CSDKENGTSGPSSYEQYF	TRBV29-1	TRBJ2-7
TGCGCCAGCAGCCCGTACGGGCGGTCAGTTCGGGACTCCATCCCTAGCTCCTACAATGAGCAGTTCTTC	CASSPYGRSVRDSIPSSYNEQFF	TRBV4-1	TRBJ2-1
TGTGCCAGCAGCCAAGAGGTTCAGGGCTACGAGCAGTACTTC	CASSQEVQGYEQYF	TRBV3-1	TRBJ2-7
TGCGCCAGCAGTGCAGGGGCCCACGAGCAGTACTTC	CASSAGAHEQYF	TRBV10-1	TRBJ2-7
TGTGCCAGCAGCTTATTCTCCGCAGGGACAAATGAAAAACTGTTTTTT	CASSLFSAGTNEKLFF	TRBV11-1	TRBJ1-4
TGTGCCAGCAGTGAATTTCCGCCCACCCAGAGGGTGGGGGATACGCAGTATTTT	CASSEFPPTQRVGDTQYF	TRBV6-1	TRBJ2-3
TGCGCCAGCAGTACCGGGACACCGATCGGAGCTTTCTTT	CASSTGTPIGAFF	TRBV10-1	TRBJ1-1
TGTGCCAGCAGCTTAGACGGACAGTGCGATGAGCAGTTCTTC	CASSLDGQCDEQFF	TRBV11-3	TRBJ2-1
TGTGCCAGTTCCCCGTGTGAGCAGTACTTC	CASSPCEQYF	TRBV19	TRBJ2-7
TGTGCCAGCAGCGGGGGCGTTCATCAGCCCCAGCATTTT	CASSGGVHQPQHF	TRBV13	TRBJ1-5
TGCAGTGCTAGAGCTAGCGGGCCACACTACAATGAGCAGTTCTTC	CSARASGPHYNEQFF	TRBV20-1	TRBJ2-1
TGTGCCACCAGTGATTCCGGACAGTTCAAAAACATTCAGTACTTC	CATSDSGQFKNIQYF	TRBV24-1	TRBJ2-4
TGTGCCAGCAGAATGGGGAGGAGCAGGGCAACTAATGAAAAACTGTTTTTT	CASRMGRSRATNEKLFF	TRBV12-3	TRBJ1-4
TGTGCCAGCAGCTTACGCCGCGCTTCCCTAAGAATATCGGGCAATGAGCAGTTCTTC	CASSLRRASLRISGNEQFF	TRBV7-6	TRBJ2-1
TGTGCCAGCAGCAGAGTCCGAGTTTCGGGGAATAACTATGGCTACACCTTC	CASSRVRVSGNNYGYTF	TRBV7-9	TRBJ1-2
TGTGCCAGCAGCACCCGGGACAGGGAAGAGACCCAGTACTTC	CASSTRDREETQYF	TRBV12-4	TRBJ2-5
TGTGCCAGCAGCGGGCGTACAGGGGGTTCTTTCACTGAAGCTTTCTTT	CASSGRTGGSFTEAFF	TRBV7-3	TRBJ1-1
TGTGCCAGCAGCGGTCACAAGCTCACCGGGGAGCTGTTTTTT	CASSGHKLTGELFF	TRBV9	TRBJ2-2
TGTGCCAGCAGTTACGGAGTTTTCCCAGTCGCGCAAGAGACCCAGTACTTC	CASSYGVFPVAQETQYF	TRBV6-5	TRBJ2-5
TGTGCCAGCAGTGAAGAGCGGGGGGGCTGGAGAAACACCGGGGAGCTGTTTTTT	CASSEERGGWRNTGELFF	TRBV6-1	TRBJ2-2
TGCAGTGCTACCATAGGACAGGGGGCTACCAATCAGCCCCAGCATTTT	CSATIGQGATNQPQHF	TRBV20-1	TRBJ1-5
TGTGCCAGCAAACTTTCGACAGATACGCAGTATTTT	CASKLSTDTQYF	TRBV6-5	TRBJ2-3
TGTGCCAGCAGCGTATACACCGTCTATGGCTACACCTTC	CASSVYTVYGYTF	TRBV9	TRBJ1-2
TGTGCCAGCAGCCAAGTCAAGGGCTTCCTAGGCTCCTACGAGCAGTACTTC	CASSQVKGFLGSYEQYF	TRBV3-1	TRBJ2-7
TGCAGTGCTGAACAGGAGAGGAACGAGCAGTACTTC	CSAEQERNEQYF	TRBV20-1	TRBJ2-7
TGTGCCAGCAGCCCGGGGGGGCCAGCCGGGGAGCTGTTTTTT	CASSPGGPAGELFF	TRBV7-9	TRBJ2-2
TGTGCCAGCAGCCTTCTGGACGGGGGGTTGGGATACAATGAGCAGTTCTTC	CASSLLDGGLGYNEQFF	TRBV3-1	TRBJ2-1
TGCGCCAGCAGCCCCGCAGCCTTGAACACTGAAGCTTTCTTT	CASSPAALNTEAFF	TRBV5-1	TRBJ1-1
TGTGCCACCTATTCCGGCAGGGTGTACATGAACACTGAAGCTTTCTTT	CATYSGRVYMNTEAFF	TRBV24-1	TRBJ1-1
TGTGCCAGCAGCTTAGATTTCAGATTTAGGCCCGACTCTGGGGCCAACGTCCTGACTTTC	CASSLDFRFRPDSGANVLTF	TRBV11-3	TRBJ2-6
TGTGCCAGCAGTACAGGGAGCTCCTACGAGCAGTACTTC	CASSTGSSYEQYF	TRBV6-4	TRBJ2-7
TGTGCCAGCAGCCAGGTAGAGACCCAGTACTTC	CASSQVETQYF	TRBV7-3	TRBJ2-5
TGTGCCAGCAGCCTACACCGAGATTCACCCCTCCACTTT	CASSLHRDSPLHF	TRBV7-2	TRBJ1-6
TGTGCCAGCCCCCCTCCGGGCAGGGCTCAGCCCCAGCATTTT	CASPPPGRAQPQHF	TRBV28	TRBJ1-5
TGCGCCAGCAGCTTGCGGCCAGGACAGGCCCTCGAGCAGTTCTTC	CASSLRPGQALEQFF	TRBV5-1	TRBJ2-1
TGTGCCAGCATAGAGTGGCCGTACTGGGAATCCTACGAGCAGTACTTC	CASIEWPYWESYEQYF	TRBV28	TRBJ2-7
TGTGCCAGCAGCGTAGCTTATGGGACTAGCGCAGGTAAGACCCAGTACTTC	CASSVAYGTSAGKTQYF	TRBV9	TRBJ2-5
TGTGCCAGCAGCAAGGGTGGATCCCAGTACTTC	CASSKGGSQYF	TRBV7-9	TRBJ2-5
TGCGCCACGATCCCTAGACCGAGACAGGGGGCGCATGGGCAAGAGACCCAGTACTTC	CATIPRPRQGAHGQETQYF	TRBV10-2	TRBJ2-5
TGCAGTGCTAGAGAAACCTATATGGGCTACGAGCAGTACTTC	CSARETYMGYEQYF	TRBV20-1	TRBJ2-7
TGTGCCAGCAGCTTACCCTTTGGGGGCAGTGTCGACAATGAGCAGTTCTTC	CASSLPFGGSVDNEQFF	TRBV7-9	TRBJ2-1
TGCGCCAGCAGCCACGGTCCCGGGACCCAAGAGACCCAGTACTTC	CASSHGPGTQETQYF	TRBV4-3	TRBJ2-5
TGTGCCATCAGCCCCGGGGAGCAGTACTTC	CAISPGEQYF	TRBV10-3	TRBJ2-7
TGTGCCAGCAGCCTAGGGCAGGCCTCCTACGAGCAGTACTTC	CASSLGQASYEQYF	TRBV7-2	TRBJ2-7
TGTGCCAGTAGACGGAGATGCGGGAGCTACGAGCAGTACTTC	CASRRRCGSYEQYF	TRBV19	TRBJ2-7
TGTGCCAGCAGCCAAGGGCCCGTGACGGCGGATTACTCCTACGAGCAGTACTTC	CASSQGPVTADYSYEQYF	TRBV4-2	TRBJ2-7
TGTGCCAGCAGTATCCGGGACAGGGAAGTCGAGCAGTACTTC	CASSIRDREVEQYF	TRBV6-5	TRBJ2-7
TGTGCCATCAGTGAGCCCAGGGGGGGAGATCGGTTCTTATACGAGCAGTACTTC	CAISEPRGGDRFLYEQYF	TRBV10-3	TRBJ2-7
TGCGCCAGCAGCTTGGACCAGACAAGTCGACAGGGGGCCCCGTACTTC	CASSLDQTSRQGAPYF	TRBV5-1	TRBJ2-7
TGTGCCAGCAGCTTGAGTCTGAAGTTCGCCACAGGGAACGCCCCGGCCTACGAGCAGTACTTC	CASSLSLKFATGNAPAYEQYF	TRBV7-9	TRBJ2-7
TGTGCCAGCAGTGATGAAGTTTTTTACGAGCAGTACTTC	CASSDEVFYEQYF	TRBV6-4	TRBJ2-7
TGTGCCACCAGCAGAAAAACTTTGACTCTGAACTCTGGAAACACCATATATTTT	CATSRKTLTLNSGNTIYF	TRBV15	TRBJ1-3
TGTGCCAGTGGTCAGGGGGTGTGTGGCGTTAACACCGGGGAGCTGTTTTTT	CASGQGVCGVNTGELFF	TRBV19	TRBJ2-2
TGCAGTGCTATACCTTCGGAGGGAAACACCATATATTTT	CSAIPSEGNTIYF	TRBV20-1	TRBJ1-3
TGTGCCAGCAGCTCTTCGGGGGGACCGTCCTACAATGAGCAGTTCTTC	CASSSSGGPSYNEQFF	TRBV13	TRBJ2-1
TGTGCCAGCAGCCTTGGTCCGAGGGGAGGGGAGAACACTGAAGCTTTCTTT	CASSLGPRGGENTEAFF	TRBV13	TRBJ1-1
TGTGCCAGCAGCCCTCGACCGGATAGAGAGACCCAGTACTTC	CASSPRPDRETQYF	TRBV7-9	TRBJ2-5
TGTGCCAGCAGTCACCTTTCCGAGGCAGATACGCAGTATTTT	CASSHLSEADTQYF	TRBV27	TRBJ2-3
TGTGCCAGCAGCCTTATCAACAGTGCATACAATGAGCAGTTCTTC	CASSLINSAYNEQFF	TRBV11-2	TRBJ2-1
TGTGCCAGCAGTTTATATCAGCGGGGTAAGAACCAGTTCAATCAGCCCCAGCATTTT	CASSLYQRGKNQFNQPQHF	TRBV28	TRBJ1-5
TGTGCCAGCAGGGCCAACATCGGCGGCTACACCTTC	CASRANIGGYTF	TRBV6-5	TRBJ1-2
TGCAGTGCTAGAGATCTAACCTACGAGCAGTACTTC	CSARDLTYEQYF	TRBV20-1	TRBJ2-7
TGTGCCAGCAGCTTGAAAAAGGGGCTCGAGCAGTACTTC	CASSLKKGLEQYF	TRBV7-4	TRBJ2-7
TGTGCCAGCAGCGTAGATTGTAGGGCGGCCAGGGAGACCCAGTACTTC	CASSVDCRAARETQYF	TRBV9	TRBJ2-5
TGCGCCAGCAGTGTGGTTAGGGGGGGCTACGAGCAGTACTTC	CASSVVRGGYEQYF	TRBV10-1	TRBJ2-7
TGTGCCAGCAGGGCCTACTGGTCAAGGGCGAGCCAAGGCATCTGTAATTCACCCCTCCACTTT	CASRAYWSRASQGICNSPLHF	TRBV6-1	TRBJ1-6
TGTGCCAGCAGCTTCAGGCGAACCCCTCCCAGGACCCCAGGCTACACCTTC	CASSFRRTPPRTPGYTF	TRBV5-6	TRBJ1-2
TGTGCCAGCGCCACTAGCGGGAGTGGGTCCTACGAGCAGTACTTC	CASATSGSGSYEQYF	TRBV19	TRBJ2-7
TGTGCCAGCACCGGGGACAGGGGCCGGCGGGGCTCTGGAAACACCATATATTTT	CASTGDRGRRGSGNTIYF	TRBV9	TRBJ1-3
TGTGCCAGCAGTTTAAGAAACCCAAGACTAGCGCTAGAGTGGGCTAGCACAGATACGCAGTATTTT	CASSLRNPRLALEWASTDTQYF	TRBV28	TRBJ2-3
TGTGCCAGCAGCTGGGGGCCCGGGGGATTCAAGCGGAATGAAAAACTGTTTTTT	CASSWGPGGFKRNEKLFF	TRBV7-3	TRBJ1-4
TGTGCCAGCAGTGAACGGTTTGGGACTAGCGGGAAAGAGACCCAGTACTTC	CASSERFGTSGKETQYF	TRBV2	TRBJ2-5
TGTGCCAGCAGCCATGTCCCACAGGGGCCGATTGCGGGCACAGATACGCAGTATTTT	CASSHVPQGPIAGTDTQYF	TRBV14	TRBJ2-3
TGTGCCTGGACCGGAGGCAAGGGTAAGGGCCGCACTGAAGCTTTCTTT	CAWTGGKGKGRTEAFF	TRBV30	TRBJ1-1
TGCAGCGTTGCGCTGAAAAATCAGCCCCAGCATTTT	CSVALKNQPQHF	TRBV29-1	TRBJ1-5
TGCGCCAGCAGCTTGGGTGGGGAATTGAACACTGAAGCTTTCTTT	CASSLGGELNTEAFF	TRBV5-1	TRBJ1-1
TGTGCCAGCAGTTACTCGGGACTAGGTCAAAGCACCGGGGAGCTGTTTTTT	CASSYSGLGQSTGELFF	TRBV6-2	TRBJ2-2
TGTGCCATCAAAGAACAGGCTAGTGTAGATACGCAGTATTTT	CAIKEQASVDTQYF	TRBV10-3	TRBJ2-3
TGTGCTAGTGGTTTGATAACCGGGACACACCTTTCAATCTTC	CASGLITGTHLSIF	TRBV12-5	TRBJ2-1
TGTGCCAGCAGCCTAACGACTAGGAAGAATGAGCAGTTCTTC	CASSLTTRKNEQFF	TRBV7-4	TRBJ2-1
TGTGCCAGCAGCCACTTCTTGATCAGGGGAGGTTATACTTATTCCGGGGAGCTGTTTTTT	CASSHFLIRGGYTYSGELFF	TRBV14	TRBJ2-2
TGTGCCAGCAGTTTCTTCAATGGGGGGAACGAGCAGTACTTC	CASSFFNGGNEQYF	TRBV28	TRBJ2-7
TGTGCCAGCAGTGAGCCGGGGGGCGAGATTGAGTACGAGCAGTACTTC	CASSEPGGEIEYEQYF	TRBV6-1	TRBJ2-7
TGTGCCAGCAGCCTGGGGGGGGGGCTTACAAATTCCTACGAGCAGTACTTC	CASSLGGGLTNSYEQYF	TRBV14	TRBJ2-7
TGTGCCAGCAGTGGTGGCGGGGGAGAAAAACTGTTTTTT	CASSGGGGEKLFF	TRBV28	TRBJ1-4
TGTGCCAGCACCGGGACAGGGGGGGGTGGCTACACCTTC	CASTGTGGGGYTF	TRBV28	TRBJ1-2
TGTGCCAGCAGACTACAGACAGGGGGAGCAGTGTACGAGCAGTACTTC	CASRLQTGGAVYEQYF	TRBV6-2	TRBJ2-7
TGTGCCAGCAGTGCCCGGGGCTATAATTCACCCCTCCACTTT	CASSARGYNSPLHF	TRBV25-1	TRBJ1-6
TGCGCCAGCAGGGGCTTTAACTATGGCTACACCTTC	CASRGFNYGYTF	TRBV10-2	TRBJ1-2
TGTGCCAGCAGCTACCCGCGGTACTACAATGAGCAGTTCTTC	CASSYPRYYNEQFF	TRBV7-4	TRBJ2-1
TGTGCCAGCAGCTTGGTTAGCTCTGGGGCCAACGTCCTGACTTTC	CASSLVSSGANVLTF	TRBV5-5	TRBJ2-6
TGCGCCAGCAGTGACGGGACAGGGGAGAACGGGACGGACACTGAAGCTTTCTTT	CASSDGTGENGTDTEAFF	TRBV10-2	TRBJ1-1
TGTGCCAACGTCACGGGCCCGGGGTGGGAGAAGCATGAGCAGTTCTTC	CANVTGPGWEKHEQFF	TRBV7-2	TRBJ2-1
TGTGCCAGCAGCTTGTATTCCATGAGAGACCATTACGAGCAGTACTTC	CASSLYSMRDHYEQYF	TRBV5-4	TRBJ2-7
TGTGCCAGCAAAGAGAAAAACACTGAAGCTTTCTTT	CASKEKNTEAFF	TRBV6-2	TRBJ1-1
TGTGCCAGCAGCTATAGGCGGAACCCAGGGCCATTTGTGAACACTGAAGCTTTCTTT	CASSYRRNPGPFVNTEAFF	TRBV7-8	TRBJ1-1
TGTGCCAGCAGAATCAGACAGGGGCTTGAGACCCAGTACTTC	CASRIRQGLETQYF	TRBV11-2	TRBJ2-5
TGTGCCAGCCAGATGGCCACAGTCGGGGAGCTGTTTTTT	CASQMATVGELFF	TRBV6-3	TRBJ2-2
TGCAGCGAATTGGGGGGCTGGACTGAAGCTTTCTTT	CSELGGWTEAFF	TRBV29-1	TRBJ1-1
TGTGCCAGCAGCGTCCCGCTCGGGGATAGAAAGGGCTACGAGCAGTACTTC	CASSVPLGDRKGYEQYF	TRBV13	TRBJ2-7
TGTGCCATCACTGGGACAGGGCTGTTCTACGAGCAGTACTTC	CAITGTGLFYEQYF	TRBV19	TRBJ2-7
TGTGCCAGCAGGGGGGAGGGGGGTAGTTCATACGAGCAGTACTTC	CASRGEGGSSYEQYF	TRBV2	TRBJ2-7
TGTGCCAGCAGCTTAGAGATGTCACAGGGCTACAATGAGCAGTTCTTC	CASSLEMSQGYNEQFF	TRBV7-9	TRBJ2-1
TGTGCCAGCAGTTTACGACTAGCGGGCAACGGCACCGGGGAGCTGTTTTTT	CASSLRLAGNGTGELFF	TRBV27	TRBJ2-2
TGTGCCAGCAGCTTTCGGAAAGCGGTACATACGCAGTATTTT	CASSFRKAVHTQYF	TRBV7-6	TRBJ2-3
TGTGCCAGCAGTGGATTTAGCGGGGCGGGGACAGATACGCAGTATTTT	CASSGFSGAGTDTQYF	TRBV2	TRBJ2-3
TGCAGTGCGACCGCTTTTCCAAATGAGCAGTTCTTC	CSATAFPNEQFF	TRBV20-1	TRBJ2-1
TGTGCCAGTAGGCGGGACAGGGCCCCAGAAAAACTGTTTTTT	CASRRDRAPEKLFF	TRBV19	TRBJ1-4
TGTGCCTGGAGTGTACTCAGGGCAGAGCGCAGCTCCTACGAGCAGTACTTC	CAWSVLRAERSSYEQYF	TRBV30	TRBJ2-7
TGTGCCACCAGCAGTGGACTCCCTAGCGGGAAGAAATACTACGAGCAGTACTTC	CATSSGLPSGKKYYEQYF	TRBV15	TRBJ2-7
TGTGCCAGCAGCAATATCAGGGGGCGAGAGACCCAGTACTTC	CASSNIRGRETQYF	TRBV7-4	TRBJ2-5
TGCAGTGCTAGAGCCCAGGGACAATACGAGCAGTACTTC	CSARAQGQYEQYF	TRBV20-1	TRBJ2-7
TGTGCCAGCAGCTCCCTGGTCTTCAGGGTCGACCCCGGGGAGCTGTTTTTT	CASSSLVFRVDPGELFF	TRBV7-2	TRBJ2-2
TGTGCCAGCAGCACCCGGAGCGGGATTTGCAAAAACATTCAGTACTTC	CASSTRSGICKNIQYF	TRBV13	TRBJ2-4
TGTGCCAGCAGCTTCTGGACAGGGTTCTCTGGAAACACCATATATTTT	CASSFWTGFSGNTIYF	TRBV11-2	TRBJ1-3
TGTGCCGCTACGAGTGACTACGAGCAGTACTTC	CAATSDYEQYF	TRBV2	TRBJ2-7
TGCGCCAGCAGCCAAGATAGGACAGGGACCGAAAAACTGTTTTTT	CASSQDRTGTEKLFF	TRBV4-1	TRBJ1-4
TGTGCCAGCAGTTACGGTATCGATCAGCCCCAGCATTTT	CASSYGIDQPQHF	TRBV6-6	TRBJ1-5
TGTGCCAGCAGCCAAGTCCCACATGGTGACTACGAGCAGTACTTC	CASSQVPHGDYEQYF	TRBV4-2	TRBJ2-7
TGCAGTGCTAGGACCGAGTTGCGACAGGGGGACTCTGGAAACACCATATATTTT	CSARTELRQGDSGNTIYF	TRBV20-1	TRBJ1-3
TGTGCCAGCAGCCAAGGGGACGACTCCTACGAGCAGTACTTC	CASSQGDDSYEQYF	TRBV14	TRBJ2-7
TGTGCCAGCAGCTCGCCTCGGAAGCGTTGTGGCTACACCTTC	CASSSPRKRCGYTF	TRBV5-5	TRBJ1-2
TGCAGTGCTAGAGATCAATCGGCTCTCGGGTCCTACAATGAGCAGTTCTTC	CSARDQSALGSYNEQFF	TRBV20-1	TRBJ2-1
TGTGCCAGCAGCCGACTAGCGGGAGGGGAGCTGTTTTTT	CASSRLAGGELFF	TRBV13	TRBJ2-2
TGTGCCAGCAGCAACGAACCAGGGGGGGCAGAGACCCAGTACTTC	CASSNEPGGAETQYF	TRBV7-9	TRBJ2-5
TGTGCCAGCAGCCCGACGCGGAGAAGGAGACCCACTGAAGCTTTCTTT	CASSPTRRRRPTEAFF	TRBV7-3	TRBJ1-1
TGTGCCAGTAGTTTCGCCCGGGGGGGCTCCTACGAGCAGTACTTC	CASSFARGGSYEQYF	TRBV19	TRBJ2-7
TGCGCCAGCAGTGGGGAGCCCTTATTCTGGGCTAGCGGTTTGTTAGATACGCAGTATTTT	CASSGEPLFWASGLLDTQYF	TRBV10-1	TRBJ2-3
TGTGCCAGCAGCCGTTGGACAGGACGCTATGGCTACACCTTC	CASSRWTGRYGYTF	TRBV7-2	TRBJ1-2
TGTGCCAGCAGCTTAGCAAGGACAGCCATGAACACTGAAGCTTTCTTT	CASSLARTAMNTEAFF	TRBV11-2	TRBJ1-1
TGTGCCAGCAGCAGGTCGCCTGAAGCTTTCTTT	CASSRSPEAFF	TRBV11-1	TRBJ1-1
TGTGCCAGCAGCAGGGTTGGGGTGAATCAGCCCCAGCATTTT	CASSRVGVNQPQHF	TRBV9	TRBJ1-5
TGTGCCAGCAGCGAAAAGGAACAGGGTGATGCAACTAATGAAAAACTGTTTTTT	CASSEKEQGDATNEKLFF	TRBV9	TRBJ1-4
TGTGCCAGCAGCTTACCGGGGGGGGATTCCTACAATGAGCAGTTCTTC	CASSLPGGDSYNEQFF	TRBV7-9	TRBJ2-1
TGTGCCTCGGGGGGCGGGAGAACCGAGACCCAGTACTTC	CASGGGRTETQYF	TRBV19	TRBJ2-5
TGTGCCAGCAGCCAAGTCGGTGCACCCGTTGTCCCGGGGGACGATCAGCCCCAGCATTTT	CASSQVGAPVVPGDDQPQHF	TRBV14	TRBJ1-5
TGCGCCAGCAGTGAAGGAGCGGGACAGGCCTACGAGCAGTACTTC	CASSEGAGQAYEQYF	TRBV10-1	TRBJ2-7
TGCAGTGCTAGAGGATCACTCACCGGGACAGGGGGCGAGTATGAGCAGTTCTTC	CSARGSLTGTGGEYEQFF	TRBV20-1	TRBJ2-1
TGTGCCAGCAGTGACCCGGGGATACGGAACTACACCTTC	CASSDPGIRNYTF	TRBV6-4	TRBJ1-2
TGTGCCAGCAGTAGGACAGGGGCCGAGACCCAGTACTTC	CASSRTGAETQYF	TRBV6-4	TRBJ2-5
TGTGCCAGCAGCTTGGAAGGGACAACACGGGAGACTAGCAATCAGCCCCAGCATTTT	CASSLEGTTRETSNQPQHF	TRBV5-4	TRBJ1-5
TGCAGTGCTAGCAGGACATTGAACACTGAAGCTTTCTTT	CSASRTLNTEAFF	TRBV20-1	TRBJ1-1
TGTGCCAGCAGCCACCAGACCGGGGATGGCTACACCTTC	CASSHQTGDGYTF	TRBV14	TRBJ1-2
TGTGCCAGCAGTTACAGGCAGTCCGAGTACTTC	CASSYRQSEYF	TRBV6-5	TRBJ2-7
TGTGCCACCAATTTCCTGCGGAAGGATGAGCAGTTCTTC	CATNFLRKDEQFF	TRBV24-1	TRBJ2-1
TGTGCCTGGAGTTGTTTACCCAGTTCCCCGTCCCTCCACTTT	CAWSCLPSSPSLHF	TRBV30	TRBJ1-6
TGTGCCAGCAGTTTAAAGCTAGACGGATACTATGGCTACACCTTC	CASSLKLDGYYGYTF	TRBV12-3	TRBJ1-2
TGTGCCTACAACGGCGGGAGGGACCTGGAGCCCCACTCCTACGAGCAGTACTTC	CAYNGGRDLEPHSYEQYF	TRBV6-2	TRBJ2-7
TGTGCCACCCCAGTAGCGGGGCCCACCGGGGAGCTGTTTTTT	CATPVAGPTGELFF	TRBV24-1	TRBJ2-2
TGCAGTGCTAGAGGAACAGGGTGCAGGTACTTC	CSARGTGCRYF	TRBV20-1	TRBJ2-7
TGTGCCAGCAGTTACAAGCGGGGGGCCCTACACACCGGGGAGCTGTTTTTT	CASSYKRGALHTGELFF	TRBV6-3	TRBJ2-2
TGTGCCAGTACCTCCGGGACGAATATCACCGATAACGAGCAGTACTTC	CASTSGTNITDNEQYF	TRBV19	TRBJ2-7
TGCGCCAGCAGCTTCACAGCGGGAGCCCAAATGGACTACGAGCAGTACTTC	CASSFTAGAQMDYEQYF	TRBV5-1	TRBJ2-7
TGTGCCAGCAGCGGTGAGGACGATGAGCAGTTCTTC	CASSGEDDEQFF	TRBV5-5	TRBJ2-1
TGTGCCAGTAGTAACGGGGGGGGAATGCTTGAGACCCAGTACTTC	CASSNGGGMLETQYF	TRBV19	TRBJ2-5
TGCGCCAGCAGCTTGGGGGCTTCCTCCTATAATTCACCCCTCCACTTT	CASSLGASSYNSPLHF	TRBV5-1	TRBJ1-6
TGTGCCAGCGGACAGGAGTACGAGCAGTACTTC	CASGQEYEQYF	TRBV7-3	TRBJ2-7
TGCGCCAGCAGTGAGTCACATATCAGAGCGGGCACAGATACGCAGTATTTT	CASSESHIRAGTDTQYF	TRBV10-1	TRBJ2-3
TGTGCCACCAGTGATTTGCCCCAAGTGGTAGCGGGACAGGACTCTCAAGAGACCCAGTACTTC	CATSDLPQVVAGQDSQETQYF	TRBV24-1	TRBJ2-5
TGCAGTGCTAGGACAGAACCCAATGAAAAACTGTTTTTT	CSARTEPNEKLFF	TRBV20-1	TRBJ1-4
TGCGCCAGCAGCGGCACCCCCTGCGATGTCTCTGGGGCCAACGTCCTGACTTTC	CASSGTPCDVSGANVLTF	TRBV5-1	TRBJ2-6
TGCAGTGCTAGGGGGGCAATCCCCCGAGAGACCCAGTACTTC	CSARGAIPRETQYF	TRBV20-1	TRBJ2-5
TGTGCCTCTGACAAGGCCGGGGAGCTGTTTTTT	CASDKAGELFF	TRBV30	TRBJ2-2
TGTGCCAGCAGCTTAGGACCCGGGAGCGGTGCAACTAATGAAAAACTGTTTTTT	CASSLGPGSGATNEKLFF	TRBV7-9	TRBJ1-4
TGTGCCAGCAGTTTCTCCACAGATTTTGCCGGGACAGGGCTAATAGACCCCAACACTGAAGCTTTCTTT	CASSFSTDFAGTGLIDPNTEAFF	TRBV27	TRBJ1-1
TGTGCCAGCAGCTTCCGAATCGACAGGGGGGGACCCAACTTT	CASSFRIDRGGPNF	TRBV11-3	TRBJ1-1
TGTGCCAGCAGTTTGACGGGGGGGCCACTGGAGTACTTC	CASSLTGGPLEYF	TRBV12-3	TRBJ2-4
TGTGCTAGTGGGGACACCCGGGACAGGGGTTTTTGGGGGGAAGTTGGGGAGCTGTTTTTT	CASGDTRDRGFWGEVGELFF	TRBV12-5	TRBJ2-2
TGCAGTGCTACCGGGACTTACGACTATGGCTACACCTTC	CSATGTYDYGYTF	TRBV20-1	TRBJ1-2
TGTGCCAGCAGCGTAGGATCCTCTAGCGGCAGGCAGTTCTTC	CASSVGSSSGRQFF	TRBV9	TRBJ2-1
TGTGCCCGTCCCGGGGAGCTGTTTTTT	CARPGELFF	TRBV10-3	TRBJ2-2
TGTGCTAGTGGTCACCGTAGCGGGACTCAAGAGACCCAGTACTTC	CASGHRSGTQETQYF	TRBV12-5	TRBJ2-5
TGTGCCAGCACCCAACAGTTTCCGAACACTGAAGCTTTCTTT	CASTQQFPNTEAFF	TRBV6-3	TRBJ1-1
TGCAGTGCTAGACAGGGGGATGTCAGCGTCTACGAGCAGTACTTC	CSARQGDVSVYEQYF	TRBV20-1	TRBJ2-7
TGCGCCAGCAGCCGCCTGGTGACCCAGTACTTC	CASSRLVTQYF	TRBV4-3	TRBJ2-5
TGTGCCAGCAGCCAAGGTGAACAAACCCTCGGCTACACCTTC	CASSQGEQTLGYTF	TRBV3-1	TRBJ1-2
TGTGCCAGTAGTATAGAGCATTCGAACACAGGGATCTCCTACGAGCAGTACTTC	CASSIEHSNTGISYEQYF	TRBV19	TRBJ2-7
TGTGCCAGCAGTGACCACTATTTCAGGGACAGTAATGAAAAACTGTTTTTT	CASSDHYFRDSNEKLFF	TRBV6-4	TRBJ1-4
TGCGCCAGCAGTCCTCCTTACAGTAGTCGCTATGGCTACACCTTC	CASSPPYSSRYGYTF	TRBV5-1	TRBJ1-2
TGTGCCAGCAGTTTACCGGGACTCAAAAACATTCAGTACTTC	CASSLPGLKNIQYF	TRBV6-2	TRBJ2-4
TGTGCCAGCAGCCAAGATCCTCGAAAAAAAGTTGCTTCCGGGACAGGGGTTGTGAACACTGAAGCTTTCTTT	CASSQDPRKKVASGTGVVNTEAFF	TRBV3-1	TRBJ1-1
TGTGCCAGCAGCTTAAAATCCACAGGGGACTACAATGAGCAGTTCTTC	CASSLKSTGDYNEQFF	TRBV11-3	TRBJ2-1
TGTGCCAGCACCAGGGACAGGCGAGTGTATCAGCCCCAGCATTTT	CASTRDRRVYQPQHF	TRBV6-3	TRBJ1-5
TGTGCCAGTAGGGGGGATAACTCCTACGAGCAGTACTTC	CASRGDNSYEQYF	TRBV14	TRBJ2-7
TGTGCCACCAGCAGAGAAGCCCGGACAGGGGAAAATAAATGGACCCAGTACTTC	CATSREARTGENKWTQYF	TRBV15	TRBJ2-5
TGTGCCAGCAGTGAGGACCTGGAGCGGGGACAGGATACGCAGTATTTT	CASSEDLERGQDTQYF	TRBV6-1	TRBJ2-3
TGTGCCAGCAGCTTGGCCCGTATGGTGCAGCCCCAGCATTTT	CASSLARMVQPQHF	TRBV5-6	TRBJ1-5
TGTGCCAGCAGCGTAGCCCTTACTAGCGGCCGGGACAATGAGCAGTTCTTC	CASSVALTSGRDNEQFF	TRBV9	TRBJ2-1
TGCGCCAGCAGGGAAACACAGGGACAAGGGGGGGCTTACTATGGCTACACCTTC	CASRETQGQGGAYYGYTF	TRBV10-1	TRBJ1-2
TGCAGTGCTACAGTGGAAACCACTGAAGCTTTCTTT	CSATVETTEAFF	TRBV20-1	TRBJ1-1
TGTGCCAGCACGGGGGAAGCCACAGATACGCAGTATTTT	CASTGEATDTQYF	TRBV7-9	TRBJ2-3
TGTGCCACCAGTGTGAGGGGGGGAGGCTTGAAAGAGACCCAGTACTTC	CATSVRGGGLKETQYF	TRBV24-1	TRBJ2-5
TGTGCCAGCAGCTTCAGCGGGAAAGCGGAAGAGACCCAGTACTTC	CASSFSGKAEETQYF	TRBV7-9	TRBJ2-5
TGTGCCAGCAGCGACTCAAGAGCCAGGAACCGGGACAGGGCTGAGCGCTCCTACGAGCAGTACTTC	CASSDSRARNRDRAERSYEQYF	TRBV11-3	TRBJ2-7
TGTGCCAGCAGTGCCCTCAACACCTCCTATAATTCACCCCTCCACTTT	CASSALNTSYNSPLHF	TRBV6-4	TRBJ1-6
TGTGCCAGCAGTTTATCTGTAGGGGGGGGGGGCCACCCTAGAACAAGGGATATGAACACTGAAGCTTTCTTT	CASSLSVGGGGHPRTRDMNTEAFF	TRBV28	TRBJ1-1
TGTGCCAGCTTGAACAGGGGGGATCAGCCCCAGCATTTT	CASLNRGDQPQHF	TRBV13	TRBJ1-5
TGCAGTGCGGGAGCGGGGTCCTACGAGCAGTACTTC	CSAGAGSYEQYF	TRBV20-1	TRBJ2-7
TGTGCCAGCAGCTGGCTACAGGGCACAGATACGCAGTATTTT	CASSWLQGTDTQYF	TRBV5-8	TRBJ2-3
TGTGCCAGCAGCTCTACAGTAGTCTACAATGAGCAGTTCTTC	CASSSTVVYNEQFF	TRBV7-3	TRBJ2-1
TGCAGCGTTGAAGACAGTTCGACTAGCGGGGTACCTAGCACAGATACGCAGTATTTT	CSVEDSSTSGVPSTDTQYF	TRBV29-1	TRBJ2-3
TGTGCCAGCAGCGTCCAAAAACTGCGAGGGCCCAGAGCCCATAGCAATCAGCCCCAGCATTTT	CASSVQKLRGPRAHSNQPQHF	TRBV9	TRBJ1-5
TGTGCCAGCAACAGGAAGGGGCTTAGCAATCAGCCCCAGCATTTT	CASNRKGLSNQPQHF	TRBV6-2	TRBJ1-5
TGTGCCATCACCGGGGAGAATTCACCCCTCCACTTT	CAITGENSPLHF	TRBV10-3	TRBJ1-6
TGTGCCCGGACCAGACCCTTTTCGTACAATGAGCAGTTCTTC	CARTRPFSYNEQFF	TRBV27	TRBJ2-1
TGCGCCAGCAGCCAAGATCCCCCCGGACACTTCGGGGAGCTGTTTTTT	CASSQDPPGHFGELFF	TRBV4-1	TRBJ2-2
TGCGCCAGCGTGGGGGGATGCTACGAGCAGTACTTC	CASVGGCYEQYF	TRBV10-1	TRBJ2-7
TGTGCCAGCAGTTACCCAGAAATTATGTCCTATGGCTACACCTTC	CASSYPEIMSYGYTF	TRBV6-5	TRBJ1-2
TGTGCCAGCAGCTTAATAGACCGGAACAGGGTGTCTGAAGCTTTCTTT	CASSLIDRNRVSEAFF	TRBV7-3	TRBJ1-1
TGTGCCAGCAGTTGCGGGAGGAGGGGGACAGATACGCAGTATTTT	CASSCGRRGTDTQYF	TRBV12-3	TRBJ2-3
TGCAGTGCTAACGGGACGGGGACTAGGGAAGCTAACTATGGCTACACCTTC	CSANGTGTREANYGYTF	TRBV20-1	TRBJ1-2
TGTGCCAGCAGTGAAGCGCTTCCGAGGGGCAGCTCTGGAAACACCATATATTTT	CASSEALPRGSSGNTIYF	TRBV6-1	TRBJ1-3
TGTGCCAGCCAACCGGGGGGGGCCAGCGGTGAGCAGTTCTTC	CASQPGGASGEQFF	TRBV3-1	TRBJ2-1
TGTGCCAGCAGCTTAATCGCTAAAAGCGAGCAGTTCTTC	CASSLIAKSEQFF	TRBV7-3	TRBJ2-1
TGTGCCAGCAGGTCCTTGACAGCCACTTCCCCTGAAGCTTTCTTT	CASRSLTATSPEAFF	TRBV7-3	TRBJ1-1
TGCAGCCCGGACAGCTTCTACTCCTACGAGCAGTACTTC	CSPDSFYSYEQYF	TRBV29-1	TRBJ2-7
TGTGCCAGCACCCAGGGGGGGGCCAAAAACATTCAGTACTTC	CASTQGGAKNIQYF	TRBV12-4	TRBJ2-4
TGTGCCAGCAGCCTGGGGTCGACTAGTGGCGAGACCCAGTACTTC	CASSLGSTSGETQYF	TRBV7-3	TRBJ2-5
TGCGCCAGCAGCTTGTTGGGGACTAGCGGGGAGACCCAGTACTTC	CASSLLGTSGETQYF	TRBV5-1	TRBJ2-5
TGTGCCACCAGAGCGACAGGAGAAGAGACCCAGTACTTC	CATRATGEETQYF	TRBV24-1	TRBJ2-5
TGTGCCAGCAGCGGGGGCAATCAGCCCCAGCATTTT	CASSGGNQPQHF	TRBV7-2	TRBJ1-5
TGTGCCAGCAGTGACCCGCTTAGGGATTGGGGGTGGACCGGGGAGCTGTTTTTT	CASSDPLRDWGWTGELFF	TRBV2	TRBJ2-2
TGTGCCAGCAGCCAGTCAACTATGGGACACTATAAGAGCAATCAGCCCCAGCATTTT	CASSQSTMGHYKSNQPQHF	TRBV3-1	TRBJ1-5
TGTGCCAGCAAAGGGGCCGGCGAGCAGTACTTC	CASKGAGEQYF	TRBV2	TRBJ2-7
TGCAGTGATACGGGGGGGACAGACTACAATGAGCAGTTCTTC	CSDTGGTDYNEQFF	TRBV20-1	TRBJ2-1
TGTGCCAGCAGTGAGCGGAGTCGTCCTAGCACAGATACGCAGTATTTT	CASSERSRPSTDTQYF	TRBV28	TRBJ2-3
TGTGCCAGCTCACCACCGAACCAGAGCGCGGGACGAATCCTCGGGCATTTT	CASSPPNQSAGRILGHF	TRBV18	TRBJ1-5
TGTGCCAGCAGTTGGGGTAACCAGGGGGTTACTGAAGCTTTCTTT	CASSWGNQGVTEAFF	TRBV27	TRBJ1-1
TGTGCCAGCAACGGAGGGGGACAGGGGGGCCCCGGCTACACCTTC	CASNGGGQGGPGYTF	TRBV6-4	TRBJ1-2
TGCGCCAGCAGCCAAGATCGCCGATGGGCCCGAGTAGAGACCCAGTACTTC	CASSQDRRWARVETQYF	TRBV4-1	TRBJ2-5
TGTGCCAGTAGTATAGGCCCTGGACAGCCCCAGCATTTT	CASSIGPGQPQHF	TRBV19	TRBJ1-5
TGTGCCAGCAGCAGGCCCGGGGAAAATGACTATGGCTACACCTTC	CASSRPGENDYGYTF	TRBV2	TRBJ1-2
TGTGCCAGCAGCCAAACGGACGGCCAGTACTTC	CASSQTDGQYF	TRBV3-1	TRBJ2-5
TGTGCCAGCAGCGTACTTAACGACTGGGAGCTAGACACTGAAGCTTTCTTT	CASSVLNDWELDTEAFF	TRBV9	TRBJ1-1
TGTGCCAGCAGCTTAGTTTTCACTAGCGGGAGGGTGACCCAGTACTTC	CASSLVFTSGRVTQYF	TRBV11-3	TRBJ2-5
TGCAGTGCTGACAGGGGCGGCTCCACCGGGGAGCTGTTTTTT	CSADRGGSTGELFF	TRBV20-1	TRBJ2-2
TGTGCCACCAGACAGGAAATCGGACTCCAAGAGACCCAGTACTTC	CATRQEIGLQETQYF	TRBV24-1	TRBJ2-5
TGTGCCAGCAGCCGTTTAGGGAGGCGGATCGACTACGAGCAGTACTTC	CASSRLGRRIDYEQYF	TRBV13	TRBJ2-7
TGTGCCAGCAGTTATGCTCGGGCGGTTACCTATGGCTACACCTTC	CASSYARAVTYGYTF	TRBV6-2	TRBJ1-2
TGTGCCAGCAGTTACCAAGGGGAGGGGACTAGCGGGGGGGCCTCTTCCGGGGAGCTGTTTTTT	CASSYQGEGTSGGASSGELFF	TRBV6-5	TRBJ2-2
TGTGCCAGCAGTGACTCGAGGGCCAGGGGACTAGCGGGTGCCAAAAACATTCAGTACTTC	CASSDSRARGLAGAKNIQYF	TRBV6-4	TRBJ2-4
TGTGCCAGCAGCTTGCCCCGGGACAGGGCACACAAAAACATTCAGTACTTC	CASSLPRDRAHKNIQYF	TRBV5-6	TRBJ2-4
TGCGCCAGCAGCCAACAGGGAGGGCATAGCAATCAGCCCCAGCATTTT	CASSQQGGHSNQPQHF	TRBV4-1	TRBJ1-5
TGTGCCAGCAGCCCTCCTAACAGGGCCGAGCAGTACTTC	CASSPPNRAEQYF	TRBV5-4	TRBJ2-7
TGTGCCAGCAGCTCTTTTGTAGAGGGGGGATACGAGCAGTACTTC	CASSSFVEGGYEQYF	TRBV7-9	TRBJ2-7
TGTGCCAGCAGTTGTAGTCGGGGGGGGGCCTTTTACGAGCAGTACTTC	CASSCSRGGAFYEQYF	TRBV6-2	TRBJ2-7
TGCGCCAGCAGTGAGAAGACAGCCATTGGCTACACCTTC	CASSEKTAIGYTF	TRBV10-1	TRBJ1-2
TGTGCCAGCAGTTACCCACAGGTGGACGAAAGCAATCAGCCCCAGCATTTT	CASSYPQVDESNQPQHF	TRBV6-5	TRBJ1-5
TGTGCCAGCAGCAACGAAGGCGGGAGAAGTACCTACGAGCAGTACTTC	CASSNEGGRSTYEQYF	TRBV11-3	TRBJ2-7
TGTGCCAGCAGAGCCAACGCTTACCGGGGTCAGAGAGCCAACACCGGGGAGCTGTTTTTT	CASRANAYRGQRANTGELFF	TRBV2	TRBJ2-2
TGTGCCTGGAGTGTATTGAGACAGCGCGCGAACACTGAAGCTTTCTTT	CAWSVLRQRANTEAFF	TRBV30	TRBJ1-1
TGCAGTGCTAGAGTTCGACAGGGGCCGAAAAAACTGTTTTTT	CSARVRQGPKKLFF	TRBV20-1	TRBJ1-4
TGCGCCAGCAGCGTTCCACCCTTCCGGGACAGCCAAGAGACCCAGTACTTC	CASSVPPFRDSQETQYF	TRBV5-1	TRBJ2-5
TGTGCCAGCAGCACCTACCAGCCCTATGGCTACACCTTC	CASSTYQPYGYTF	TRBV7-3	TRBJ1-2
TGTGCCAGCAGTTACAGAACCAGAAGCTTAGAAAAACTGTTTTTT	CASSYRTRSLEKLFF	TRBV6-5	TRBJ1-4
TGTGCCAGCAGTGACAGCACCGGGACATCCAAGAACACTGAAGCTTTCTTT	CASSDSTGTSKNTEAFF	TRBV6-4	TRBJ1-1
TGCAGTGCTAGAGCTCGTCCGGCTCAGGCGAACACTGAAGCTTTCTTT	CSARARPAQANTEAFF	TRBV20-1	TRBJ1-1
TGTGCTAGCAGCTTAGCCAACGCGACTATGCCCCAGCATTTT	CASSLANATMPQHF	TRBV7-7	TRBJ1-5
TGTGCCACCAGCGCCGGGACCCCCGCTTTCTTT	CATSAGTPAFF	TRBV24-1	TRBJ1-1
TGTGCCAGCAGTAGACTAGCGGTGGAGCAGTACTTC	CASSRLAVEQYF	TRBV6-3	TRBJ2-7
TGTGCCACCAAGGCTAGCGGGCGGGCGTACAATGAGCAGTTCTTC	CATKASGRAYNEQFF	TRBV24-1	TRBJ2-1
TGTGCCAGGCCCGTTCGGACTAGGACCAATGAGCAGTTCTTC	CARPVRTRTNEQFF	TRBV28	TRBJ2-1
TGTGCCAGCAGCCTGCCTTCTAGGTACGAGCAGTACTTC	CASSLPSRYEQYF	TRBV11-3	TRBJ2-7
TGCGCCAGCAGGTCCCGGGGGGCACCTGGAAATGAGCAGTTCTTC	CASRSRGAPGNEQFF	TRBV5-1	TRBJ2-1
TGTGCCAGCAGCTCTAGTCAAGACCTTGGACCTAAGGGATGCCGAGGGGGGGCCAACGTCCTGACTTTC	CASSSSQDLGPKGCRGGANVLTF	TRBV7-3	TRBJ2-6
TGTGCCAGCAGCCAAGAAAGGGGGGACGACTACGAGCAGTACTTC	CASSQERGDDYEQYF	TRBV14	TRBJ2-7
TGCGCCAGCAGTGAGTTGCTACCGGCTGGAAACACCATATATTTT	CASSELLPAGNTIYF	TRBV10-2	TRBJ1-3
TGCAGCGTCCGGACAGGGCGAAACATTCAGTACTTC	CSVRTGRNIQYF	TRBV29-1	TRBJ2-4
TGTGCCAGCCGGTCGGACATGAACACTGAAGCTTTCTTT	CASRSDMNTEAFF	TRBV27	TRBJ1-1
TGCGCCAGCAGCCAAGCACTAGTACTTCTAAGCAATGAGCAGTTCTTC	CASSQALVLLSNEQFF	TRBV4-3	TRBJ2-1
TGTGCCAGCAGTTACAGGATGCCGACCGACGTTGCCACAGATACGCAGTATTTT	CASSYRMPTDVATDTQYF	TRBV6-5	TRBJ2-3
TGTGCCAGCAGTGGAGGGTGGAGGAGTTTAACTGAAGCTTTCTTT	CASSGGWRSLTEAFF	TRBV25-1	TRBJ1-1
TGTGCCAGCTGGGGCGCCGGGGGATACTCACCCCTCCACTTT	CASWGAGGYSPLHF	TRBV27	TRBJ1-6
TGTGCCAGCAAGGACTTTAAAACAAGGTACAATGAGCAGTTCTTC	CASKDFKTRYNEQFF	TRBV12-4	TRBJ2-1
TGTGCCAGCAGCTTATGCCGACCGCGGGAGCTCAATGAGCAGTTCTTC	CASSLCRPRELNEQFF	TRBV7-7	TRBJ2-1
TGTGCCAGCAGGAGTCAGCTTGTTCGTTCTGAAGCTTTCTTT	CASRSQLVRSEAFF	TRBV5-4	TRBJ1-1
TGTGCCAGCTCACCAAGGGGGGGGCCTGGCTACACCTTC	CASSPRGGPGYTF	TRBV18	TRBJ1-2
TGTGCCAGCAGCTTAAGACAGGGGATCGGGGACACTGAAGCTTTCTTT	CASSLRQGIGDTEAFF	TRBV7-3	TRBJ1-1
TGTGCCACCAGTGATCTAAGGACAGGGGGCTCTGGGGCGGCCAATCAGCCCCAGCATTTT	CATSDLRTGGSGAANQPQHF	TRBV24-1	TRBJ1-5
TGTGCCAGCAGCTTGGGGACACTAGAGAGAAACACCATATATTTT	CASSLGTLERNTIYF	TRBV5-4	TRBJ1-3
TGTGCCAGCAGCTGGGCATTACGGCGGGCGGACATTCAGTACTTC	CASSWALRRADIQYF	TRBV7-2	TRBJ2-4
TGTGCCAGCAGTTACTCGCGTAACCCTAGCGGTAATGAGCAGTTCTTC	CASSYSRNPSGNEQFF	TRBV6-6	TRBJ2-1
TGTGCCAGCAGTTCCCACGGGACCGTACACGAGCAGTACTTC	CASSSHGTVHEQYF	TRBV12-3	TRBJ2-7
TGTGCCAGCAGCCCCTCCGGGGGTGCCGCAGATACGCAGTATTTT	CASSPSGGAADTQYF	TRBV5-6	TRBJ2-3
TGTGCCAGCAGGAATGGGGTAAATCAGCCCCAGCATTTT	CASRNGVNQPQHF	TRBV7-3	TRBJ1-5
TGCAGTGCTAGCTGCACCGGGAACACAGATACGCAGTATTTT	CSASCTGNTDTQYF	TRBV20-1	TRBJ2-3
TGTGCCAGCTCACCATTTTGGGGCAAGCCCCAGCATTTT	CASSPFWGKPQHF	TRBV18	TRBJ1-5
TGTGCCAGCAGCTGTAGCATTGGGGAGGTGGCCTCTGGGGCCAACGTCCTGACTTTC	CASSCSIGEVASGANVLTF	TRBV3-1	TRBJ2-6
TGTGCCAGCAGCTATAAGCGGACAGCTTATAGCAATCAGCCCCAGCATTTT	CASSYKRTAYSNQPQHF	TRBV11-2	TRBJ1-5
TGCAGTGCTAGCCCCCAGGGAGGTTTCAGCTCCTACGAGCAGTACTTC	CSASPQGGFSSYEQYF	TRBV20-1	TRBJ2-7
TGTGCCTGGAGTGAAGGGGGGGCCCTCTACGAGCAGTACTTC	CAWSEGGALYEQYF	TRBV30	TRBJ2-7
TGTGCCAGTAGTATAGAATCAGGGTCTCAAGAGACCCAGTACTTC	CASSIESGSQETQYF	TRBV19	TRBJ2-5
TGTGCCAGCAGAGGTTGCGAGACTGGGGCCAACGTCCTGACTTTC	CASRGCETGANVLTF	TRBV12-4	TRBJ2-6
TGCAGCGTTGAAGGCGGGGCTAGCGGGGGCGACGAGCAGTACTTC	CSVEGGASGGDEQYF	TRBV29-1	TRBJ2-7
TGTGCCAGCAGTGACTTCCGAACAAATGGGACAACGGTCTTCTATGGCTACACCTTC	CASSDFRTNGTTVFYGYTF	TRBV6-4	TRBJ1-2
TGTCCGGGGGGGGGGCGGGGCAGGGAGACCCAGTACTTC	CPGGGRGRETQYF	TRBV6-5	TRBJ2-5
TGTGCCACCGTGGGGGAGGGCCGAGGTGTCGACACTGAAGCTTTCTTT	CATVGEGRGVDTEAFF	TRBV15	TRBJ1-1
TGTGCCAGCTCACATGTGGGACTAGGTACGCAGTATTTT	CASSHVGLGTQYF	TRBV18	TRBJ2-3
TGTGCCAGCAGTTATTGCCGGGACTTCAACGAGCAGTACTTC	CASSYCRDFNEQYF	TRBV6-9	TRBJ2-7
TGTGCTAGTGGGCAGGGGCTGGGGGTCTCCTACGAGCAGTACTTC	CASGQGLGVSYEQYF	TRBV12-5	TRBJ2-7
TGTGCCAGCAGCACGAGGACAGGGTCCGCAGATACGCAGTATTTT	CASSTRTGSADTQYF	TRBV7-7	TRBJ2-3
TGTGCCACCAGTGCCGATAGGGACGACTTCTATGGCTACACCTTC	CATSADRDDFYGYTF	TRBV24-1	TRBJ1-2
TGCGCCAGCAGCTTCGGACGGGGGTCTGGGAACACTGAAGCTTTCTTT	CASSFGRGSGNTEAFF	TRBV5-1	TRBJ1-1
TGTGCCAGCAGCCCCGGGACAGGGGGCAGTAAGCCCGGGAACTATGGCTACACCTTC	CASSPGTGGSKPGNYGYTF	TRBV13	TRBJ1-2
TGTGCCAGTAGTATAGTGGGAAAGGCGGATCACGGCCACGCCGATACGCAGTATTTT	CASSIVGKADHGHADTQYF	TRBV19	TRBJ2-3
TGCGCCAGCAGCCACCTCCTGTCCGGGGAGCTGTTTTTT	CASSHLLSGELFF	TRBV4-1	TRBJ2-2
TGTGCCAGCAAAAGGGTTAGTGTCAACACCATATATTTT	CASKRVSVNTIYF	TRBV14	TRBJ1-3
TGCAGCAGCATACTAGCGGGAGGATCAGATACGCAGTATTTT	CSSILAGGSDTQYF	TRBV29-1	TRBJ2-3
TGCAGCGACAGAGGAGAAGGGGGGCAGTACTTC	CSDRGEGGQYF	TRBV29-1	TRBJ2-7
TGTGCCAGCAGTTTAGATGGGGTGACTAGCGGGGGGGCCGACGCTGAGCAGTTCTTC	CASSLDGVTSGGADAEQFF	TRBV28	TRBJ2-1
TGTGCCACCAGTGTTGGTTGGGGAGCGTTATGCAATGAGCAGTTCTTC	CATSVGWGALCNEQFF	TRBV24-1	TRBJ2-1
TGTGCCAGCAGTTACACCCAGCGAGCCTCAGGGGGCGGCTACACCTTC	CASSYTQRASGGGYTF	TRBV6-3	TRBJ1-2
TGCAGTGCTCAGGGGGGGTTGACAGAGACAGATACGCAGTATTTT	CSAQGGLTETDTQYF	TRBV20-1	TRBJ2-3
TGCGCCAGCATGGGGGGGGCCCGGACTAGCACAGATACGCAGTATTTT	CASMGGARTSTDTQYF	TRBV10-2	TRBJ2-3
TGTGCCATCTCTCGTAGCGGGCCTTCTGGGGCCAACGTCCTGACTTTC	CAISRSGPSGANVLTF	TRBV6-5	TRBJ2-6
TGTGCCACCAGTGAGATGTTGAGGACAGGAACCGGCTACACCTTC	CATSEMLRTGTGYTF	TRBV24-1	TRBJ1-2
TGTGCCAGCAGCCCGAAAACTAGCGGGCACCAAGAGACCCAGTACTTC	CASSPKTSGHQETQYF	TRBV7-9	TRBJ2-5
TGTGCCAGCAGTTTGGTCGAGGGGCTCAGCTCCTACAATGAGCAGTTCTTC	CASSLVEGLSSYNEQFF	TRBV27	TRBJ2-1
TGCACGGGCAGGGCTGGGGCCAACGTCCTGACTTTC	CTGRAGANVLTF	TRBV20-1	TRBJ2-6
TGTGCCAGCAGCGACCCCCCGGGACTAGCGGGAGGGAATGAGCAGTTCTTC	CASSDPPGLAGGNEQFF	TRBV13	TRBJ2-1
TGTGCCAGCGTACGGGGGACCACCACCTACGAGCAGTACTTC	CASVRGTTTYEQYF	TRBV6-1	TRBJ2-7
TGTGCCAGCAGCTTAAGTGGTGGACTGGCCGAGCAGTACTTC	CASSLSGGLAEQYF	TRBV11-2	TRBJ2-7
TGTGCCAGCAGGACATGGGGACACCGGGGGGCCGGGCGTAATGAAAAACTGTTTTTT	CASRTWGHRGAGRNEKLFF	TRBV28	TRBJ1-4
TGTGCCAGCAGCTTGAGGACGGGGCATGGCTACACCTTC	CASSLRTGHGYTF	TRBV7-8	TRBJ1-2
TGCAGTGCTAGACCTTGGACAGTTGGCAATCAGCCCCAGCATTTT	CSARPWTVGNQPQHF	TRBV20-1	TRBJ1-5
TGTGCCAGCAGTTACCTTGGACGTCTAGTAGAAAGGAACACTGAAGCTTTCTTT	CASSYLGRLVERNTEAFF	TRBV6-3	TRBJ1-1
TGCGCCAGCAGCCTATGGGGAGAGGGATGGATGAACACTGAAGCTTTCTTT	CASSLWGEGWMNTEAFF	TRBV4-3	TRBJ1-1
TGTGCCAGCAGTTACGGCTCGGCGGCATATGAGCAGTTCTTC	CASSYGSAAYEQFF	TRBV6-6	TRBJ2-1
TGTGCCAGCAGCTTTTTTACAGGGGGCACTCACTATGGCTACACCTTC	CASSFFTGGTHYGYTF	TRBV13	TRBJ1-2
TGTGCCAGCAGCGTTCTCTTAAACGGCTACAATGAGCAGTTCTTC	CASSVLLNGYNEQFF	TRBV11-2	TRBJ2-1
TGCAGTGCTAGATCGGGACAGGGTCAAGGCTACACCTTC	CSARSGQGQGYTF	TRBV20-1	TRBJ1-2
TGTGCCAGCAGTCCAGGGGACGGCTACGAGCAGTACTTC	CASSPGDGYEQYF	TRBV6-5	TRBJ2-7
TGTGCCAGCAGCTTTTGGGACGGGGAAAAACTGTTTTTT	CASSFWDGEKLFF	TRBV7-2	TRBJ1-4
TGTGCCAGCAGCGTGAGGGGGGGGACCTACGAGCAGTACTTC	CASSVRGGTYEQYF	TRBV11-3	TRBJ2-7
TGTGCCACCAGCAGAGTTGCGGGAGGTTTTTTGAGCAATCAGCCCCAGCATTTT	CATSRVAGGFLSNQPQHF	TRBV15	TRBJ1-5
TGCGCCAGCAGCCGGCAAAGCTCCTACAATGAGCAGTTCTTC	CASSRQSSYNEQFF	TRBV5-1	TRBJ2-1
TGTGCCAGCAAAGGGGGGGCCTGCACAGATACGCAGTATTTT	CASKGGACTDTQYF	TRBV6-2	TRBJ2-3
TGTGCCATCATTATCCACAGGGGTTTTAACACTGAAGCTTTCTTT	CAIIIHRGFNTEAFF	TRBV10-3	TRBJ1-1
TGTGCCAGCAGTGACGGACAGCGCCCAAGGACCTACGAGCAGTACTTC	CASSDGQRPRTYEQYF	TRBV6-1	TRBJ2-7
TGCAGTGCTAGCCTGGGGAGGGAACACAATGAGCAGTTCTTC	CSASLGREHNEQFF	TRBV20-1	TRBJ2-1
TGTGCCAGCAGCTTAGAACACTCCCTTCCCGGGAACAATGAGCAGTTCTTC	CASSLEHSLPGNNEQFF	TRBV11-2	TRBJ2-1
TGCGCCAGCAGCCAAGAGGCAGGGGGCGAAAGCGGGGGCTTTGAAAAACTGTTTTTT	CASSQEAGGESGGFEKLFF	TRBV4-1	TRBJ1-4
TGTGCCAGCAGCTCTAGGGGTCAGCCCCAGCATTTT	CASSSRGQPQHF	TRBV5-4	TRBJ1-5
TGTGCTAATCCGGGACTAGATTATACGCAGTATTTT	CANPGLDYTQYF	TRBV12-5	TRBJ2-3
TGTGCCAGCTCACCTCCAAGGGGGGGCCCCCAAGAGACCCAGTACTTC	CASSPPRGGPQETQYF	TRBV18	TRBJ2-5
TGTGCCTGGATCGCTCAAGAGACCCAGTACTTC	CAWIAQETQYF	TRBV27	TRBJ2-5
TGTGCCAGCAGTCCTTTGGACAGCGACCCGGCTTACGTAAATCAGCCCCAGCATTTT	CASSPLDSDPAYVNQPQHF	TRBV27	TRBJ1-5
TGCAGTGCGACCCAACAGGGCACCTACGAGCAGTACTTC	CSATQQGTYEQYF	TRBV20-1	TRBJ2-7
TGTGCCAGCAGTAAAGGGGGGCGTAACGAGCAGTACTTC	CASSKGGRNEQYF	TRBV6-5	TRBJ2-7
TGTGCCAGCAAGTTCCAGAGAGGGTTTAACTATGGCTACACCTTC	CASKFQRGFNYGYTF	TRBV2	TRBJ1-2
TGTGCCAGCAACCAACAGACTTCACCCCTCCACTTT	CASNQQTSPLHF	TRBV7-9	TRBJ1-6
TGTGCCAGCAGCTCGGGGGGCTTCGGCTACACCTTC	CASSSGGFGYTF	TRBV13	TRBJ1-2
TGTGCCATCAGCCCGGGGGGGCTGGGATCCTCCTACAATGAGCAGTTCTTC	CAISPGGLGSSYNEQFF	TRBV10-3	TRBJ2-1
TGTGCCACCAGGCGGGGACACCCAAGCAATCAGCCCCAGCATTTT	CATRRGHPSNQPQHF	TRBV24-1	TRBJ1-5
TGTGCCAGCAGTTACAAAAAAGACAGGGCCTACGAGCAGTACTTC	CASSYKKDRAYEQYF	TRBV6-5	TRBJ2-7
TGTGCCACCAGTGTTTTGGGGACCTACGAGCAGTACTTC	CATSVLGTYEQYF	TRBV24-1	TRBJ2-7
TGTGCCAGCAGTTACTCCATGACGGGACGCGGCAATCAGCCCCAGCATTTT	CASSYSMTGRGNQPQHF	TRBV6-5	TRBJ1-5
TGTGCCAGCAGCCAAGATCCCGGTATGCTAGCCAAAAACATTCAGTACTTC	CASSQDPGMLAKNIQYF	TRBV3-1	TRBJ2-4
TGCGCCAGCAGCTTGGCCCCAAGGGGCGGTCAGCCCCAGCATTTT	CASSLAPRGGQPQHF	TRBV5-1	TRBJ1-5
TGTGCCAGCAGCTTGGTTTGCCGGGACACCCACTATGGCTACACCTTC	CASSLVCRDTHYGYTF	TRBV5-4	TRBJ1-2
TGCAGTGCTAGAGGTTTCGACAATGAGCAGTTCTTC	CSARGFDNEQFF	TRBV20-1	TRBJ2-1
TGTGCCAGTAGTATTCAGACAGGGGATACCGAAGCTTTCTTT	CASSIQTGDTEAFF	TRBV19	TRBJ1-1
TGTGCCAGCAGCCCTCGGGGATTGAAGGGGCAAGAGACCCAGTACTTC	CASSPRGLKGQETQYF	TRBV27	TRBJ2-5
TGCGCCAGCAGCTGGGACAGGGATGAGCAGTTCTTC	CASSWDRDEQFF	TRBV5-1	TRBJ2-1
TGTGCCAGCAGCCTTAATGCACTAGGATACGAGCAGTACTTC	CASSLNALGYEQYF	TRBV7-3	TRBJ2-7
TGTGCTCCAGTACAGAACTATGGCTACACCTTC	CAPVQNYGYTF	TRBV2	TRBJ1-2
TGTGCCAGCAGCTTAGATTCAGCAGTGGGTGGCTACACCTTC	CASSLDSAVGGYTF	TRBV11-3	TRBJ1-2
TGTGCCAGGGGGCTCACCCCCAATGAGCAGTTCTTC	CARGLTPNEQFF	TRBV7-9	TRBJ2-1
TGTGCCAGCACGCCTACAGCCAATCAGCCCCAGCATTTT	CASTPTANQPQHF	TRBV12-4	TRBJ1-5
TGTGCCAGCAGTTACGGGTCCGGGACAGAAGTTTATCAGCCCCAGCATTTT	CASSYGSGTEVYQPQHF	TRBV6-6	TRBJ1-5
TGTGCCAGCAGCAAGATGTTGACAGTATACAATGAGCAGTTCTTC	CASSKMLTVYNEQFF	TRBV5-5	TRBJ2-1
TGCAGCGTTGAAGGGACTAGTAACACTGAAGCTTTCTTT	CSVEGTSNTEAFF	TRBV29-1	TRBJ1-1
