TGTGCCACCACCACGGATGAGACCCAGTACTTC	CATTTDETQYF	TRBV24-1	TRBJ2-5
TGTGCCACCAGCAGAGGGTTCCCCCCCACGGACGAGACCTTCTACGAGCAGTACTTC	CATSRGFPPTDETFYEQYF	TRBV15	TRBJ2-7
TGCAGTGCTAGAGGACTAATGCGGGACAAACCCAACACAGATACGCAGTATTTT	CSARGLMRDKPNTDTQYF	TRBV20-1	TRBJ2-3
TGTGCCAGCAGCTTAGCATGGCCGACACAGGAGAATCAGCCCCAGCATTTT	CASSLAWPTQENQPQHF	TRBV7-2	TRBJ1-5
TGTGCTAGTGGTTTGACAACTAGCGGGAGGGCAACCTACGAGCAGTACTTC	CASGLTTSGRATYEQYF	TRBV12-5	TRBJ2-7
TGCGCCAGCAGTGAGGTGAGGGGGGGGAGAGAGACCCAGTACTTC	CASSEVRGGRETQYF	TRBV10-1	TRBJ2-5
TGTGCCAGCAGAGGCCCCTTAACGGACAGACGGAGGGCTCCTAACAATGAGCAGTTCTTC	CASRGPLTDRRRAPNNEQFF	TRBV5-4	TRBJ2-1
TGTGCCATCACAACCCTAGCGGGGGGGCAACTGGTCTGTACCGGGGAGCTGTTTTTT	CAITTLAGGQLVCTGELFF	TRBV10-3	TRBJ2-2
TGTGCCAGCAGCGGCCCGGACAGAGAAAAACTGTTTTTT	CASSGPDREKLFF	TRBV13	TRBJ1-4
TGCGCCAGCAGCTTGACCAACCAGACTAGCGGGGGGGCCGGGATCGAGCAGTTCTTC	CASSLTNQTSGGAGIEQFF	TRBV5-1	TRBJ2-1
TGTGCCAGCAGTGGGTGGCCGGGACAGGGGATTCAGCCCCAGCATTTT	CASSGWPGQGIQPQHF	TRBV6-4	TRBJ1-5
TGTGCCACCAGTGATTTGAGCAGGAGGAGCCCGGGACAGGCGACAGCAACTAATGAAAAACTGTTTTTT	CATSDLSRRSPGQATATNEKLFF	TRBV24-1	TRBJ1-4
TGTGCCAGCAGCGCATCCACCAGGACAGTGGGACAGGACCAAGAGACCCAGTACTTC	CASSASTRTVGQDQETQYF	TRBV13	TRBJ2-5
TGCAGTGCTAGAGGTCTACAGACAGGACCGGCCTACGAGCAGTACTTC	CSARGLQTGPAYEQYF	TRBV20-1	TRBJ2-7
TGTGCCAGCAGTGAGTATGGGGAATGCTCCTACGAGCAGTACTTC	CASSEYGECSYEQYF	TRBV2	TRBJ2-7
TGTGCCAGCAGCGAATATGAGGCAAGCGGGGAGTCTGAAGCTTTCTTT	CASSEYEASGESEAFF	TRBV7-4	TRBJ1-1
TGCAGCGTTGAGGGACAGAGAGGGTACACCGGGGAGCTGTTTTTT	CSVEGQRGYTGELFF	TRBV29-1	TRBJ2-2
TGTGCCAGCAGCGGCCCACTAGCGGCATACACCGGGGAGCTGTTTTTT	CASSGPLAAYTGELFF	TRBV7-3	TRBJ2-2
TGTGCCAGCAGCTTTGTCGGGACTGGTGAGCAGTTCTTC	CASSFVGTGEQFF	TRBV5-8	TRBJ2-1
TGTGCCAGCAGTGAGGGGTGGCAGTACTTC	CASSEGWQYF	TRBV6-3	TRBJ2-7
TGTGCCAGCACGGGACTAGCCGGGGAGCTGTTTTTT	CASTGLAGELFF	TRBV2	TRBJ2-2
TGTGCCAGCAGCACATGGGGGACAGGGATAGGCTCTGGGGCCAACGTCCTGACTTTC	CASSTWGTGIGSGANVLTF	TRBV13	TRBJ2-6
TGTGCGCTGGGACAGGGGTCTTACTCTGGAAACACCATATATTTT	CALGQGSYSGNTIYF	TRBV24-1	TRBJ1-3
TGTGCCAGCAGCCAAGATTCCACACAGGGGAGACTAGGCTACACCTTC	CASSQDSTQGRLGYTF	TRBV3-1	TRBJ1-2
TGCAGCGTTCCGCGGGGGGATGATAATGAGCAGTTCTTC	CSVPRGDDNEQFF	TRBV29-1	TRBJ2-1
TGCAGTGCTAGAGACGGAGTTGGGAGCACAGCCTACGAGCAGTACTTC	CSARDGVGSTAYEQYF	TRBV20-1	TRBJ2-7
TGTGCCAGCAGTGGCGGAGATTTTCAGCCCCAGCATTTT	CASSGGDFQPQHF	TRBV2	TRBJ1-5
TGCAGCGTTGCAACAGGGGCGAGCAGCGAGCAGTACTTC	CSVATGASSEQYF	TRBV29-1	TRBJ2-7
TGTGCCAGCAGACAGACTGAAGCTTTCTTT	CASRQTEAFF	TRBV6-4	TRBJ1-1
TGTCCTGGTTCTTCACGGACAGGGGGAACGAGTTACGAGCAGTACTTC	CPGSSRTGGTSYEQYF	TRBV10-3	TRBJ2-7
TGCAGTGCTAGAGCCACGACTAGCGGGGGGGAAGAGACCCAGTACTTC	CSARATTSGGEETQYF	TRBV20-1	TRBJ2-5
TGTGCCAGCAGTAAGGGGTCGAGGGGCCTATCGACTGGAAACACCATATATTTT	CASSKGSRGLSTGNTIYF	TRBV2	TRBJ1-3
TGTGCCAGCAGGCCTTTACCTGGGGACCCTACTGAAGCTTTCTTT	CASRPLPGDPTEAFF	TRBV6-6	TRBJ1-1
TGTGCCAGTAGTATCCCACTAGCGGAATTTAATGAGCAGTTCTTC	CASSIPLAEFNEQFF	TRBV19	TRBJ2-1
TGTGCCACAAGGGGCGGAACCAATAGCAATCAGCCCCAGCATTTT	CATRGGTNSNQPQHF	TRBV6-1	TRBJ1-5
TGTGCCAGCAGCTTACCGGAGGGGAATGACACTGAAGCTTTCTTT	CASSLPEGNDTEAFF	TRBV5-6	TRBJ1-1
TGTGCCAGCAGCTTACTGACAGGGCCCGGGGTGGCCTACAATGAGCAGTTCTTC	CASSLLTGPGVAYNEQFF	TRBV7-9	TRBJ2-1
TGTGCCAGCCCCGACTCTAGCAATCAGCCCCAGCATTTT	CASPDSSNQPQHF	TRBV7-6	TRBJ1-5
TGCACCAATTGCGGGGTCGAGGCTTTCGAGCAGTACTTC	CTNCGVEAFEQYF	TRBV20-1	TRBJ2-7
TGTGCCAGCAGTTACTATTCTTACTATGACAATGAGCAGTTCTTC	CASSYYSYYDNEQFF	TRBV6-6	TRBJ2-1
TGTGCCAGCAGTGCCCGGAGACAGGGTTCCTACGAGCAGTACTTC	CASSARRQGSYEQYF	TRBV6-5	TRBJ2-7
TGTGCCAGCAGCTCAGGGGTGCTTGGCGTGGATTCACCCCTCCACTTT	CASSSGVLGVDSPLHF	TRBV7-3	TRBJ1-6
TGTGCTAGTGGTCGCCGGGACAGGGCGCAAGAGACCCAGTACTTC	CASGRRDRAQETQYF	TRBV12-5	TRBJ2-5
TGTGCCAGCAGCAGGGAACATCTGCGAGGGAGCTCTGGAAACACCATATATTTT	CASSREHLRGSSGNTIYF	TRBV13	TRBJ1-3
TGTGCCAGCAGTTACAAGGACAGATCAGAAGCTTTCTTT	CASSYKDRSEAFF	TRBV6-5	TRBJ1-1
TGTGCCATCAGTGAGCCAAACAACAGGGGTTACACCGGGGAGCTGTTTTTT	CAISEPNNRGYTGELFF	TRBV10-3	TRBJ2-2
TGCGCCAGCAGCCAGGACAGGGATTACGAGCAGTACTTC	CASSQDRDYEQYF	TRBV4-1	TRBJ2-7
TGTGCCAGCAGCCAGGGGGGCTACAATCAGCCCCAGCATTTT	CASSQGGYNQPQHF	TRBV14	TRBJ1-5
TGTGCCAGCAGCTGGACCGGGACTAGCGGTTCAGAAGGCAGTACCTACAATGAGCAGTTCTTC	CASSWTGTSGSEGSTYNEQFF	TRBV5-6	TRBJ2-1
TGTGCCAGCAGGCGGGACAGGCCACTAGGCACAGATACGCAGTATTTT	CASRRDRPLGTDTQYF	TRBV2	TRBJ2-3
TGTGCCAGCAGTTACGGGGGGGCCTTTGAGCAGTTCTTC	CASSYGGAFEQFF	TRBV6-6	TRBJ2-1
TGTGCCAGCAGTGAAACACACCAGACTAGCGGGCATGGTGCGGGCTACGAGCAGTACTTC	CASSETHQTSGHGAGYEQYF	TRBV25-1	TRBJ2-7
TGTGCCTGTCAAGTAGAAAGGGGGACCAATGAGCAGTTCTTC	CACQVERGTNEQFF	TRBV30	TRBJ2-1
TGTGCCTGGAGTGCGACTAGGATCGGGGGCACAGATACGCAGTATTTT	CAWSATRIGGTDTQYF	TRBV30	TRBJ2-3
TGTGCCAGCAGCCCCTCGGGGGGGCCATCTCCGCGGCACAATGAGCAGTTCTTC	CASSPSGGPSPRHNEQFF	TRBV5-6	TRBJ2-1
TGCAGTGCGCGGGGGGGCAGCACAGATACGCAGTATTTT	CSARGGSTDTQYF	TRBV20-1	TRBJ2-3
TGTGCCAGCAGTTGTGTGGTCCTGATACAGGGACTAGCGGGGCGCCAAGAGACCCAGTACTTC	CASSCVVLIQGLAGRQETQYF	TRBV6-5	TRBJ2-5
TGCGCCAGCAGCCTCGGGCGGACGAAACTGTTTTTT	CASSLGRTKLFF	TRBV5-1	TRBJ1-4
TGTGCCAGCAGGAGGGTTGTCTGCGGGACTGAGTGCTCCACAGATACGCAGTATTTT	CASRRVVCGTECSTDTQYF	TRBV12-3	TRBJ2-3
TGTGCCAGCAGGGGCAGGCCAGGATATAGCAATCAGCCCCAGCATTTT	CASRGRPGYSNQPQHF	TRBV6-4	TRBJ1-5
TGTGCCAGCTCTCCGCCTAACTGGGACAGGGGGCCGGGAGCCTACGAGCAGTACTTC	CASSPPNWDRGPGAYEQYF	TRBV18	TRBJ2-7
TGCGCCACTTTTTGGGCGGGAGATGAAAAACTGTTTTTT	CATFWAGDEKLFF	TRBV10-2	TRBJ1-4
TGTGCCAGCAGCCAAGATTCCCCAGTTGATAACAGTGAAAAACTGTTTTTT	CASSQDSPVDNSEKLFF	TRBV14	TRBJ1-4
TGTGCCAGCAGTGCGGTTCTCGCGGAAGCCAAAAACATTCAGTACTTC	CASSAVLAEAKNIQYF	TRBV6-1	TRBJ2-4
TGTGCCAGCAGTTTATTACTAGCGGAGGGAAGAAGCCAAGAGACCCAGTACTTC	CASSLLLAEGRSQETQYF	TRBV28	TRBJ2-5
TGTGCCAGCAGCTTAGCGGGGACAGAGACTAACTATGGCTACACCTTC	CASSLAGTETNYGYTF	TRBV7-9	TRBJ1-2
TGCGCCAGCAGCTTGGATTGGGGCCGGAGCAGCTCCTACGAGCAGTACTTC	CASSLDWGRSSSYEQYF	TRBV5-1	TRBJ2-7
TGTGCCAGCAGCTTAGATCCCGAGACCAGCGAGCAGTACTTC	CASSLDPETSEQYF	TRBV11-3	TRBJ2-7
TGCGCCAGCACTCGTGGGACAGAGAACACCGGGGAGCTGTTTTTT	CASTRGTENTGELFF	TRBV10-2	TRBJ2-2
TGTGCCAGCAGTTACAGGCCCTCCCCCCAAGACACTGAAGCTTTCTTT	CASSYRPSPQDTEAFF	TRBV6-5	TRBJ1-1
TGTGCCAGCAGTGGGGGACTTGAGACCCAGTACTTC	CASSGGLETQYF	TRBV2	TRBJ2-5
TGTGCCAGCAGTCGTTATCACCCCGCCTTTGCAACTAATGAAAAACTGTTTTTT	CASSRYHPAFATNEKLFF	TRBV3-1	TRBJ1-4
TGCGCCAGCAGCCAAGAAAAACGGAACACTGAAGCTTTCTTT	CASSQEKRNTEAFF	TRBV4-1	TRBJ1-1
TGCGCCAGCAGCCCACAGGGGGGAACTGAAGCTTTCTTT	CASSPQGGTEAFF	TRBV5-1	TRBJ1-1
TGTGCCAGCAGCTGGGGGGATGGGTCCGGGGAGCTGTTTTTT	CASSWGDGSGELFF	TRBV7-3	TRBJ2-2
TGTGCCAGCAGGGGGCGCACAGATACGCAGTATTTT	CASRGRTDTQYF	TRBV19	TRBJ2-3
TGCGCCAGCAGCCAAGATTGGACAGCCTACGAGCAGTACTTC	CASSQDWTAYEQYF	TRBV4-1	TRBJ2-7
TGCAGCGTTGAGGGTCCCGGGACAGGTACATATGGCTACACCTTC	CSVEGPGTGTYGYTF	TRBV29-1	TRBJ1-2
TGTGCCAGCAGCTTGGTTCAGCGTCAGCCCCAGCATTTT	CASSLVQRQPQHF	TRBV5-4	TRBJ1-5
TGTGCCAGCAGTTACAAGACTAGTTACAATGAGCAGTTCTTC	CASSYKTSYNEQFF	TRBV6-3	TRBJ2-1
TGTGCCAGCATTTGGGACAGCGTTAGGTATGGCTACACCTTC	CASIWDSVRYGYTF	TRBV9	TRBJ1-2
TGTGCCAGCAGCTGTTGGGACAGGGCTGGAAACACCATATATTTT	CASSCWDRAGNTIYF	TRBV7-8	TRBJ1-3
TGTGCCACCAGGCCACGACAGGTAGGAAACACCATATATTTT	CATRPRQVGNTIYF	TRBV24-1	TRBJ1-3
TGTGCCAGCAGTGAATCCGGGACTAGCGGGAAAAGGACAGATACGCAGTATTTT	CASSESGTSGKRTDTQYF	TRBV6-4	TRBJ2-3
TGTGCCAGCAGCCAAGGGGGGGGACTAGACCTCAATGAGCAGTTCTTC	CASSQGGGLDLNEQFF	TRBV4-2	TRBJ2-1
TGTGCCAGCAGTTGGCCACCCTCCTACAATGAGCAGTTCTTC	CASSWPPSYNEQFF	TRBV6-3	TRBJ2-1
TGTGCCAGCAGCTTAGCGACGGTAGACGAGCAGTACTTC	CASSLATVDEQYF	TRBV11-2	TRBJ2-7
TGTGCCTGGAGTGTACGGCCCAGGGACTATGGCTACACCTTC	CAWSVRPRDYGYTF	TRBV30	TRBJ1-2
TGTGCCAGCAAGCAGGGGAAAGAGCAGTACTTC	CASKQGKEQYF	TRBV12-3	TRBJ2-7
TGTGCCAGCAGCCTAGGAGAGTCGCTTGGTCCTGGAGCCCAGTACTTC	CASSLGESLGPGAQYF	TRBV7-3	TRBJ2-5
TGTGCCAGCAGCTTGCCCGCTAGCGGGGGCAATTGCGAGCAGTACTTC	CASSLPASGGNCEQYF	TRBV11-3	TRBJ2-7
TGTGCCACCAGTGATCACGACCGAATCTACGAGCAGTACTTC	CATSDHDRIYEQYF	TRBV24-1	TRBJ2-7
TGCGCCAGCAGCTTGATTGGGGGGGCGACAAATGAGCAGTTCTTC	CASSLIGGATNEQFF	TRBV5-1	TRBJ2-1
TGCGCCAGCAGCCAAGACAAATTGACTAGCGGGTGGGAGCAAGAGACCCAGTACTTC	CASSQDKLTSGWEQETQYF	TRBV4-1	TRBJ2-5
TGCGCCAGCATTACAGGGGGCTGCTACCGGCCAAATAGCAATCAGCCCCAGCATTTT	CASITGGCYRPNSNQPQHF	TRBV10-1	TRBJ1-5
TGTGCCAGCAGAGGGGGGGAGGAAGACTCCTACGAGCAGTACTTC	CASRGGEEDSYEQYF	TRBV27	TRBJ2-7
TGCGCCAGCAGTGAGTATGGGGGACTAGCCAACAATGAGCAGTTCTTC	CASSEYGGLANNEQFF	TRBV10-1	TRBJ2-1
TGTGCCAGTGTGCGGACAGGGGGCTACACCTTC	CASVRTGGYTF	TRBV19	TRBJ1-2
TGCGCCAGCAGCCAAAGGGGGACTAGCGGGGGAGGCACAGATACGCAGTATTTT	CASSQRGTSGGGTDTQYF	TRBV4-3	TRBJ2-3
TGTGCCAGCAGCCGGACAGGCAGAAATCAGCCCCAGCATTTT	CASSRTGRNQPQHF	TRBV7-3	TRBJ1-5
TGCGCCAGCAGCTTGGCTCGGGACAGGGGTGTGGGCTACGAGCAGTACTTC	CASSLARDRGVGYEQYF	TRBV5-1	TRBJ2-7
TGTGCCAGCAGCACGCAGGAGCAGTTCTTC	CASSTQEQFF	TRBV6-5	TRBJ2-1
TGCGCCACAGGGGGCCACACTGAAGCTTTCTTT	CATGGHTEAFF	TRBV4-3	TRBJ1-1
TGCAGCGTTGTGGCTAGAACTGGGACAGGGGGTTGGAGCACTGAAGCTTTCTTT	CSVVARTGTGGWSTEAFF	TRBV29-1	TRBJ1-1
TGTGCCAGCAGCTGTTTCCGCGGGAGCAAGACGAAGACAGATACGCAGTATTTT	CASSCFRGSKTKTDTQYF	TRBV11-3	TRBJ2-3
TGTGCCATCGGAACTAGCGCTTCCGGGGAGCTGTTTTTT	CAIGTSASGELFF	TRBV10-3	TRBJ2-2
TGCGCCAGCCGCCGACCCAAGGGGGAGCAGTACTTC	CASRRPKGEQYF	TRBV4-1	TRBJ2-7
TGCGCCAGCAGCTTGTCGGAAGAGGCGCGGCCGACGTGCAATCAGCCCCAGCATTTT	CASSLSEEARPTCNQPQHF	TRBV5-1	TRBJ1-5
TGTGCCAGCAGGAGGGGGGCAACAGGGGGCACTGAAGCTTTCTTT	CASRRGATGGTEAFF	TRBV11-3	TRBJ1-1
TGTGCCAGCAGTTACGATTTAGGCCGCAGGGGGCAGCGAACAGTTGGCTACACCTTC	CASSYDLGRRGQRTVGYTF	TRBV6-5	TRBJ1-2
TGCAGTGCTAGAGATCGTAGTAGGGGTAGTGGAAACACCATATATTTT	CSARDRSRGSGNTIYF	TRBV20-1	TRBJ1-3
TGTGCCAGCAGTGCCGGGGGTCAGCCCCAGCATTTT	CASSAGGQPQHF	TRBV25-1	TRBJ1-5
TGTGCCAGCCGGTGGCCGGGACTATTTACAAGAGATACGCAGTATTTT	CASRWPGLFTRDTQYF	TRBV6-5	TRBJ2-3
TGTGCCGGTCGACAGGTAATGAACACTGAAGCTTTCTTT	CAGRQVMNTEAFF	TRBV6-4	TRBJ1-1
TGTGCCAGCAGTTTCGTTTCCACAGCGGGCTACACCTTC	CASSFVSTAGYTF	TRBV12-4	TRBJ1-2
TGTGCCAGCAGTTTAGCTACGGACAGGGGTAACGAGCAGTACTTC	CASSLATDRGNEQYF	TRBV12-4	TRBJ2-7
TGTGCCAGCAGCCTTATGAACACTGAAGCTTTCTTT	CASSLMNTEAFF	TRBV6-2	TRBJ1-1
TGTGCCAGCAGCCAATTCCAGGGGCCAACCTACGAGCAGTACTTC	CASSQFQGPTYEQYF	TRBV9	TRBJ2-7
TGTGCCAGCAGTGACGGGACAGGAGGCTCCTACGAGCAGTACTTC	CASSDGTGGSYEQYF	TRBV6-4	TRBJ2-7
TGTGCCAGCAGCCAAGGGGATGGGAAAGCCTATGGCTACACCTTC	CASSQGDGKAYGYTF	TRBV3-1	TRBJ1-2
TGTGCCACGGAGCAGCCAGAGGGCCGATCCTACGAGCAGTACTTC	CATEQPEGRSYEQYF	TRBV6-5	TRBJ2-7
TGTGCCAGCAGTGTTTGCACTAGCGGGAGCAGGGGCTACACCTTC	CASSVCTSGSRGYTF	TRBV12-4	TRBJ1-2
TGTGCCTGGAGTGTCGACTTATGGACTAGCGGGCGGGCGAGGGTCTCCTACGAGCAGTACTTC	CAWSVDLWTSGRARVSYEQYF	TRBV30	TRBJ2-7
TGTGCTAGTGGTTTCCCGCCCGGGGGGGTGGGTCAGCCCCAGCATTTT	CASGFPPGGVGQPQHF	TRBV12-5	TRBJ1-5
TGTGCCAGCCAAGGGATCGGCTACGAGCAGTACTTC	CASQGIGYEQYF	TRBV6-4	TRBJ2-7
TGTGCCAGCATAGGCCACCGGGGGACTGAACAAAGTAATCGTTACGAGCAGTACTTC	CASIGHRGTEQSNRYEQYF	TRBV12-3	TRBJ2-7
TGTGCCAGCAGTGACCCTCGGACAAGCTACGAGCAGTACTTC	CASSDPRTSYEQYF	TRBV6-4	TRBJ2-7
TGTGCCAGCAGCCAAAGAGGGGGACAGGGTCAGCCCCAGCATTTT	CASSQRGGQGQPQHF	TRBV14	TRBJ1-5
TGTGCCAGCAGCCAAGATCTTCCTGAGCAGGGGAATCAGCCCCAGCATTTT	CASSQDLPEQGNQPQHF	TRBV4-2	TRBJ1-5
TGTGCCACCAGTGACGCCGGGACAGGGGTTTCGTGCTACGAGCAGTACTTC	CATSDAGTGVSCYEQYF	TRBV24-1	TRBJ2-7
TGTGCCAGCAGCATAATGGACTCCTACGAGCAGTACTTC	CASSIMDSYEQYF	TRBV11-3	TRBJ2-7
TGTGCCAGCAGTGAAAAAAAAACACCATTGATCGAGCAGTACTTC	CASSEKKTPLIEQYF	TRBV6-1	TRBJ2-7
TGCGCCAGCCCCACGGTCTACATTCAGTACTTC	CASPTVYIQYF	TRBV5-1	TRBJ2-4
TGTGCCAGCAGCTTCGGAGAGGGCTACGAGCAGTACTTC	CASSFGEGYEQYF	TRBV7-6	TRBJ2-7
TGCGCCAGCAGCCAATCAATTTGGCCGCCGGGACTAGTAGTAGCAGATACGCAGTATTTT	CASSQSIWPPGLVVADTQYF	TRBV4-1	TRBJ2-3
TGTGCCAGCAGCCGGGGAACATTGGATAATGAAAAACTGTTTTTT	CASSRGTLDNEKLFF	TRBV7-3	TRBJ1-4
TGTGCCAGCAGGGTAGATGAGCAGTTCTTC	CASRVDEQFF	TRBV6-2	TRBJ2-1
TGTGCTACAAGGACAGATCACTCCTACGAGCAGTACTTC	CATRTDHSYEQYF	TRBV25-1	TRBJ2-7
TGTGCCAGCAGTACGGGGACCGAAGCTTTCTTT	CASSTGTEAFF	TRBV12-4	TRBJ1-1
TGCGCCAGCAGCCTAGGTAAATCCCTAGGGGGGACCCAGTACTTC	CASSLGKSLGGTQYF	TRBV5-1	TRBJ2-5
TGTGCCAGCAGTTCCTCCCTAGGATTGGGTCAGCCCCAGCATTTT	CASSSSLGLGQPQHF	TRBV12-3	TRBJ1-5
TGTGCCAGCAGCTTGCCGCCCAGCGGGAATTGGTACGAGCAGTACTTC	CASSLPPSGNWYEQYF	TRBV5-4	TRBJ2-7
TGTGCCAGCAGCTCAGGACGGCACGGGGGGCAGTACTTC	CASSSGRHGGQYF	TRBV12-3	TRBJ2-7
TGTGCCAGCAGTTACGCGGGGACAGGGGGCGGGGGTCCTAGGGAAATGAACACTGAAGCTTTCTTT	CASSYAGTGGGGPREMNTEAFF	TRBV28	TRBJ1-1
TGTGCCAGCAGTCTCCTTGTGGCCCTCTTTTACATCACTGAAGCTTTCTTT	CASSLLVALFYITEAFF	TRBV12-3	TRBJ1-1
TGCAGTGCTAGAGCCCCCTTACATGGACAGGACACTGAAGCTTTCTTT	CSARAPLHGQDTEAFF	TRBV20-1	TRBJ1-1
TGCAGTGCTCGGGGGGGGAGGAAAGAGACCCAGTACTTC	CSARGGRKETQYF	TRBV20-1	TRBJ2-5
TGCAGTGCTAGAACCGACAGGGTTGCAACTAATGAAAAACTGTTTTTT	CSARTDRVATNEKLFF	TRBV20-1	TRBJ1-4
TGTGCCAGCAGTCCCCCCCCCTCCGGGACAGGGGGGAACGAGCAGTACTTC	CASSPPPSGTGGNEQYF	TRBV6-4	TRBJ2-7
TGTGCCAGCAGCTACGGACGCTATGGCTACACCTTC	CASSYGRYGYTF	TRBV7-2	TRBJ1-2
TGTGCCTGGAAGGGGTATGGCTACACCTTC	CAWKGYGYTF	TRBV30	TRBJ1-2
TGCACGTCCCCGGGACTAGCGGGAGGCACAGATACGCAGTATTTT	CTSPGLAGGTDTQYF	TRBV20-1	TRBJ2-3
TGTGCCAGCAGTCAATTAGTACAGGGATTAAGCGGGACCTACGAGCAGTACTTC	CASSQLVQGLSGTYEQYF	TRBV6-3	TRBJ2-7
TGTGCCAGCAGCCAAGATCTTATTACAGATACGCAGTATTTT	CASSQDLITDTQYF	TRBV4-2	TRBJ2-3
TGTGCCAGCAGCGTGGGGGTTGAAGCTTTCTTT	CASSVGVEAFF	TRBV13	TRBJ1-1
TGCGCCAGCAGCCCGGTAAAACGGTACATTGACCGTCTGCGACAGGACACTGAAGCTTTCTTT	CASSPVKRYIDRLRQDTEAFF	TRBV4-1	TRBJ1-1
TGTGCCAGCAGCCAAGATCCCCGACCTCCGTCCCAGCATTTT	CASSQDPRPPSQHF	TRBV14	TRBJ1-5
TGTGCCTGGAGGAGTCAGGACAGGGGGCGCAATCAGCCCCAGCATTTT	CAWRSQDRGRNQPQHF	TRBV30	TRBJ1-5
TGTGCCAGCAAAAGCGGGAGGGAAGTCTCTGGGGCCAACGTCCTGACTTTC	CASKSGREVSGANVLTF	TRBV6-2	TRBJ2-6
TGCGCCAGCAGCTTGGGAGCGACAGGGAGGGGGCTGAGCTCCTACAATGAGCAGTTCTTC	CASSLGATGRGLSSYNEQFF	TRBV5-1	TRBJ2-1
TGTGCCAGCTCCTCCCGAAGTGCGGATGGCTACACCTTC	CASSSRSADGYTF	TRBV12-3	TRBJ1-2
TGTGCCAGCAGCCGGCGGTCCCACGGTGAGAACACTGAAGCTTTCTTT	CASSRRSHGENTEAFF	TRBV13	TRBJ1-1
TGTGCCAGCAGCTTCTCAGGATACGTCAACATTCAGTACTTC	CASSFSGYVNIQYF	TRBV7-7	TRBJ2-4
TGTGCCAGCAGCGTTGAGACAGGGGCTACACATAGCAATCAGCCCCAGCATTTT	CASSVETGATHSNQPQHF	TRBV7-6	TRBJ1-5
TGTGCCAGCACCGTCTTCGGTATTACGGTTCGCTACAATGAGCAGTTCTTC	CASTVFGITVRYNEQFF	TRBV6-4	TRBJ2-1
TGCGCCAGCCCCGAATACGGGCAGGGGGAGTCTTCTTACTCAAGGACTGAAGCTTTCTTT	CASPEYGQGESSYSRTEAFF	TRBV10-1	TRBJ1-1
TGCGCCAGCAGTGAAAGTGGGCCGGGGGCACCCTACGAGCAGTACTTC	CASSESGPGAPYEQYF	TRBV10-1	TRBJ2-7
TGCAGTGCACCCCCCGGGACAGGGGGGAATCAGCCCCAGCATTTT	CSAPPGTGGNQPQHF	TRBV20-1	TRBJ1-5
TGTGCCAGCAGCTTTCGGGGGGGCAAACAACACGAGCAGTACTTC	CASSFRGGKQHEQYF	TRBV7-6	TRBJ2-7
TGTGCCAGCAGCCCCGTGTTCGGTGCGCAAGAGACCCAGTACTTC	CASSPVFGAQETQYF	TRBV11-2	TRBJ2-5
TGTGCCAGCAGCCAAGCCTTTCCCGGCGACGGGCAGTATTTT	CASSQAFPGDGQYF	TRBV14	TRBJ2-3
TGTGCCAGCAGTAGCCACAGGGGGGCTAATGAAAAACTGTTTTTT	CASSSHRGANEKLFF	TRBV11-3	TRBJ1-4
TGTGCCAGCAGTGACAGCGCAAGCGGGACCGCACGCCACGAGCAGTACTTC	CASSDSASGTARHEQYF	TRBV6-4	TRBJ2-7
TGTGCCAGTAAGTTTGGGCCTTTGGAGTATGGCTACACCTTC	CASKFGPLEYGYTF	TRBV19	TRBJ1-2
TGTGCCACCAGTGATATCAGCCGAGGTACTGGGGCCAACGTCCTGACTTTC	CATSDISRGTGANVLTF	TRBV24-1	TRBJ2-6
TGTGCCACCGGGACTAGGGCCAATGAGCAGTTCTTC	CATGTRANEQFF	TRBV15	TRBJ2-1
TGTGCCAGCAGTTGCGGGACTCTAGGGACTAGCGCTAGGTGCGTGTACGGTGAGCAGTTCTTC	CASSCGTLGTSARCVYGEQFF	TRBV27	TRBJ2-1
TGTGCCAGCAGCGGGAGAGTGTGTCCCTCCTACGAGCAGTACTTC	CASSGRVCPSYEQYF	TRBV7-9	TRBJ2-7
TGTGCCAGCAGCTATGGGAACACTGAAGCTTTCTTT	CASSYGNTEAFF	TRBV7-3	TRBJ1-1
TGTGCCAGCAGAGAGACTTGGGGCGCAAGCAATCAGCCCCAGCATTTT	CASRETWGASNQPQHF	TRBV6-4	TRBJ1-5
TGTGCCACCAGATCAGGAAAATATACTGAAGCTTTCTTT	CATRSGKYTEAFF	TRBV24-1	TRBJ1-1
TGCAGCGTTGAAGGCGGCCCACGCACAGATACGCAGTATTTT	CSVEGGPRTDTQYF	TRBV29-1	TRBJ2-3
TGTGCCAGCAGTTACCCTTTTGGGGGAAGGATGCCGTACACCGGGGAGCTGTTTTTT	CASSYPFGGRMPYTGELFF	TRBV6-5	TRBJ2-2
TGCGCCAGCAGCTTGGAAGGGGGAGAATATGGCTACACCTTC	CASSLEGGEYGYTF	TRBV5-1	TRBJ1-2
TGTGCCATCAGTGACTCATCTGGGAGCGGCAATGAGCAGTTCTTC	CAISDSSGSGNEQFF	TRBV10-3	TRBJ2-1
TGTGCTAGCAGCCCTTTAGAATGGCAGCGGCTAGCCAAAAACATTCAGTACTTC	CASSPLEWQRLAKNIQYF	TRBV7-7	TRBJ2-4
TGTGCCAGCAGTTTACCGGGGAGCTCCTTTAAGGGGGGAAACTATGGCTACACCTTC	CASSLPGSSFKGGNYGYTF	TRBV27	TRBJ1-2
TGCAGTGCAAATCGGCTAGGTCCCTATGGCTACACCTTC	CSANRLGPYGYTF	TRBV20-1	TRBJ1-2
TGTGCCAGCTCACCACATGACAGGTTTGCAACTAATGAAAAACTGTTTTTT	CASSPHDRFATNEKLFF	TRBV18	TRBJ1-4
TGTGCCAGCAGAAAAATCCCGGGGGCGGGGGGCAATCAGCCCCAGCATTTT	CASRKIPGAGGNQPQHF	TRBV7-3	TRBJ1-5
TGCGCCAGCAGCTTGCGGCTGGAGACCTCCGTAGGGAATTCACCCCTCCACTTT	CASSLRLETSVGNSPLHF	TRBV5-1	TRBJ1-6
TGTGCCAGCAGCCAAGATCAACATGACAGGGGGAGTGGAGATACGCAGTATTTT	CASSQDQHDRGSGDTQYF	TRBV3-1	TRBJ2-3
TGTGCCAGCAGCTGTAGGCCTCAGCCCCAGCATTTT	CASSCRPQPQHF	TRBV7-9	TRBJ1-5
TGCAGTGCTAGAGATCTCCCCATCGTCCAGGGGGAAGGCACCGGGGAGCTGTTTTTT	CSARDLPIVQGEGTGELFF	TRBV20-1	TRBJ2-2
TGTGCCAGCAGTTACCCGGGGATGTACGAGCAGTACTTC	CASSYPGMYEQYF	TRBV6-5	TRBJ2-7
TGTGCCAGCAGCTTAAGGGCTGGAATCTACGAGCAGTACTTC	CASSLRAGIYEQYF	TRBV11-2	TRBJ2-7
TGTGCCATCAGTGGTCCCGGACAGGAGGACACTGAAGCTTTCTTT	CAISGPGQEDTEAFF	TRBV10-3	TRBJ1-1
TGTGCCTTGGACAGGCGTAACTATGGCTACACCTTC	CALDRRNYGYTF	TRBV12-5	TRBJ1-2
TGTGCCAGCAGCTCGAGGGAGTATGTCTATGGCTACACCTTC	CASSSREYVYGYTF	TRBV11-1	TRBJ1-2
TGCGCCAGCAGCTTGGCTCCCCCCGGGACTAGCGGGATCCTCTCATACAATGAGCAGTTCTTC	CASSLAPPGTSGILSYNEQFF	TRBV5-1	TRBJ2-1
TGTGCCAGCAGCTTGCGAAAGGGTTATAGCTATGGCTACACCTTC	CASSLRKGYSYGYTF	TRBV5-4	TRBJ1-2
TGTGCCAGCAGTGACTCCAAGGAAGACAGAAGGAACACTGAAGCTTTCTTT	CASSDSKEDRRNTEAFF	TRBV6-4	TRBJ1-1
TGTGCCAGCAGCCAAACTTCAATCCCCCCGGAGCAGTTCTTC	CASSQTSIPPEQFF	TRBV14	TRBJ2-1
TGTGCCAGCAGTGAAGCAGCTGGAGCATACAACACTGAAGCTTTCTTT	CASSEAAGAYNTEAFF	TRBV6-1	TRBJ1-1
TGTGGTCCTAGAGGGGCCCAGTACTTC	CGPRGAQYF	TRBV6-2	TRBJ2-5
TGTGCCAGCAGTCTACCGCAATCCAGGAGTTACCAGCCCCAGCATTTT	CASSLPQSRSYQPQHF	TRBV27	TRBJ1-5
TGTGCCAGCAGCAAGACGATTTACCCAATGAACACTGAAGCTTTCTTT	CASSKTIYPMNTEAFF	TRBV5-6	TRBJ1-1
TGTGCCAGCAGCCCGCTGGTTGTTAGGGACAGGGTCGGATTTGAAGCTTTCTTT	CASSPLVVRDRVGFEAFF	TRBV7-4	TRBJ1-1
TGTGCCAGCAGTTACCCTCACCCACAGGGGGCAGCCCCCGGCTACACCTTC	CASSYPHPQGAAPGYTF	TRBV6-5	TRBJ1-2
TGTGCCAGCAGCTTAGATGCCTCACAGGGGGCGGAAGGAGAAAAACTGTTTTTT	CASSLDASQGAEGEKLFF	TRBV11-3	TRBJ1-4
TGTGCCAGCAGTTTGGGACGGGCTGAAAAACTGTTTTTT	CASSLGRAEKLFF	TRBV27	TRBJ1-4
TGTGCCAGTAGTTTCGGGGGCGAACATATGAACACTGAAGCTTTCTTT	CASSFGGEHMNTEAFF	TRBV19	TRBJ1-1
TGCGCCAGCAGCTCAGGGACACTCTATAGCAATCAGCCCCAGCATTTT	CASSSGTLYSNQPQHF	TRBV5-1	TRBJ1-5
TGTGCCAGCAGTTACTGGAAGGACAGTGGGAATTGCAATCAGCCCCAGCATTTT	CASSYWKDSGNCNQPQHF	TRBV6-3	TRBJ1-5
TGTGCCAGCAGCTGGCCCGGGACAGTAGGCTACACCTTC	CASSWPGTVGYTF	TRBV7-8	TRBJ1-2
TGTGCCAGTACGACAGCTGGGCTTGTGGAGCAGTACTTC	CASTTAGLVEQYF	TRBV19	TRBJ2-7
TGTGCCAGCAGTCCCCTTAGAGGACTAGGAAGAGGAGATACGCAGTATTTT	CASSPLRGLGRGDTQYF	TRBV6-5	TRBJ2-3
TGCGCCAGCAGCCAGGGGGGGAGAATGAACACTGAAGCTTTCTTT	CASSQGGRMNTEAFF	TRBV5-1	TRBJ1-1
TGCGCCAGCACCCACTTTTGGGAGAATGAGCAGTTCTTC	CASTHFWENEQFF	TRBV5-1	TRBJ2-1
TGTGCCAGCAGTGACCGTTCGGGGGGCTCCTACGAGCAGTACTTC	CASSDRSGGSYEQYF	TRBV25-1	TRBJ2-7
TGTGCCACCTTTGGACAATGGGTTGAAGCTTTCTTT	CATFGQWVEAFF	TRBV24-1	TRBJ1-1
TGCAGTGCGACTAGCGGGGGGGGAGAACCAGATACGCAGTATTTT	CSATSGGGEPDTQYF	TRBV20-1	TRBJ2-3
TGTGCCAGCAGCACCCCGACCGGGACAGGGCAGGGGCAGTACTTC	CASSTPTGTGQGQYF	TRBV7-2	TRBJ2-7
TGTGCCTGGAGTGTACGATTGACAGGTTTACCGGCTAACTATGGCTACACCTTC	CAWSVRLTGLPANYGYTF	TRBV30	TRBJ1-2
TGCGCCAGCATAGGGGGACTAGAGCCTGAGCAGTTCTTC	CASIGGLEPEQFF	TRBV5-1	TRBJ2-1
TGCAGCGTTGGTGAACGGGTAGCTTTCTTT	CSVGERVAFF	TRBV29-1	TRBJ1-1
TGTGCCAGTAGTCCGTTCAAGGGGGGCTACGAGCAGTACTTC	CASSPFKGGYEQYF	TRBV19	TRBJ2-7
TGTGCCAGCCGAGATAGCAATCAGCCCCAGCATTTT	CASRDSNQPQHF	TRBV6-6	TRBJ1-5
TGTGCCAGCAGCTCTCGGGGATATCAGCCCCAGCATTTT	CASSSRGYQPQHF	TRBV7-2	TRBJ1-5
TGTGCCCACAAACTAGCGGGCAATGAGCAGTTCTTC	CAHKLAGNEQFF	TRBV27	TRBJ2-1
TGTGCCAGCAGTTACTCTTTGTGGGGAGCCTACGAGCAGTACTTC	CASSYSLWGAYEQYF	TRBV6-6	TRBJ2-7
TGTGCCACCAGTGATTTAATTGGGACACAGTCCGATAGCAATCAGCCCCAGCATTTT	CATSDLIGTQSDSNQPQHF	TRBV24-1	TRBJ1-5
TGTGCCAGCAGCTTGGAACTGCGACAGGAAAGGAACATTCAGTACTTC	CASSLELRQERNIQYF	TRBV5-6	TRBJ2-4
TGTGCCAGCAGCTTAGCCCCCGGGCCTCTGCTGAGGGGGAGGGAAAAACTGTTTTTT	CASSLAPGPLLRGREKLFF	TRBV11-2	TRBJ1-4
TGTGCCAGCAGCTTGCATAGCGGGGATACGCAGTATTTT	CASSLHSGDTQYF	TRBV5-5	TRBJ2-3
TGTGCCAGCAGCCAAGTAGGTTATGGGACAGGGAGAGAGACCCAGTACTTC	CASSQVGYGTGRETQYF	TRBV14	TRBJ2-5
TGTGCCAGCAGTTTAATGACTCGAGGGTACGAGCAGTACTTC	CASSLMTRGYEQYF	TRBV12-3	TRBJ2-7
TGTGCCAACCCGGAGAGTAGATCGTGGATGGACCCTGGGGGCCTTGGGGACAGCTCTAATGAAAAACTGTTTTTT	CANPESRSWMDPGGLGDSSNEKLFF	TRBV12-3	TRBJ1-4
TGCAGTGCTAGGTTATCGGTGGGGACTAGCGCCTCCTTTAGCACAGATACGCAGTATTTT	CSARLSVGTSASFSTDTQYF	TRBV20-1	TRBJ2-3
TGTGCCAGCAGCCGGACAGGGAGACTGAACACTGAAGCTTTCTTT	CASSRTGRLNTEAFF	TRBV7-9	TRBJ1-1
TGTGCCAGCAGCTTAAGGGGACAGTCCGGTGGCTACACCTTC	CASSLRGQSGGYTF	TRBV7-3	TRBJ1-2
TGTGCCAGCAGCGTGAAGAGCGGGAGAAGGAATGAGCAGTTCTTC	CASSVKSGRRNEQFF	TRBV9	TRBJ2-1
TGTGCCAGCAGCTCTTCTTCCGGGACTAGCGCGGGGCAAGAGACCCAGTACTTC	CASSSSSGTSAGQETQYF	TRBV7-3	TRBJ2-5
TGTGCCAGCAGCTTAACGCGCGAGGGAGAGACCCAGTACTTC	CASSLTREGETQYF	TRBV7-4	TRBJ2-5
TGTGCCAGCAGCTTGGCCGAGGGGACTAGCGGGGGACCCCTCTTC	CASSLAEGTSGGPLF	TRBV5-4	TRBJ2-1
TGTGCCACCAACCCCGGGGGCGCCGGGGAGCTGTTTTTT	CATNPGGAGELFF	TRBV24-1	TRBJ2-2
TGTGCCAGCAGCTTAGCGGTCGGGGCGGGTGAAAAACTGTTTTTT	CASSLAVGAGEKLFF	TRBV7-6	TRBJ1-4
TGTGCCAGCAGCAGGTGGATACTAGTTTACAATGAGCAGTTCTTC	CASSRWILVYNEQFF	TRBV5-5	TRBJ2-1
TGTGCCAGCAGCGAGGTCGGGATGGAGACCCAGTACTTC	CASSEVGMETQYF	TRBV5-6	TRBJ2-5
TGTGCCAGCAGCCTAAGAAAATCAGGGAAAGGATTAAGTCAGCCCCAGCATTTT	CASSLRKSGKGLSQPQHF	TRBV5-8	TRBJ1-5
TGTGCCAGCAGATTATGCCTTTCCCTCCCGGGACTAGCGGGAGATCACGAGCAGTACTTC	CASRLCLSLPGLAGDHEQYF	TRBV6-1	TRBJ2-7
TGTGCCAGCAACTTAGGGGTCGTCTACGAGCAGTACTTC	CASNLGVVYEQYF	TRBV27	TRBJ2-7
TGTGCCAGCAGGGTACCCGGGACAGGGGAGACCCAGTACTTC	CASRVPGTGETQYF	TRBV7-9	TRBJ2-5
TGTGCCAGCAGCAATTTATCCCGCCCAGTACTGTTTTTT	CASSNLSRPVLFF	TRBV11-1	TRBJ1-4
TGTGCCAGCAGCACAAGGGGAGGGGGAAAGTATCAGCCCCAGCATTTT	CASSTRGGGKYQPQHF	TRBV5-6	TRBJ1-5
TGTGCCAGCAGAGAGTTCGTCCCGGGACTCGAGGGTAGCAATGGCTACACCTTC	CASREFVPGLEGSNGYTF	TRBV6-6	TRBJ1-2
TGTGCCAGCAGGCCTGGGACAGGGGGTGGCTACACCTTC	CASRPGTGGGYTF	TRBV6-1	TRBJ1-2
TGTGCCAGCAGTGACTCCCAGAGAGCCAGGGAAAACACCGGGGAGCTGTTTTTT	CASSDSQRARENTGELFF	TRBV6-4	TRBJ2-2
TGTGCCACCAGTGATTCACGTCAAGGGAGTAGAATGAACACTGAAGCTTTCTTT	CATSDSRQGSRMNTEAFF	TRBV24-1	TRBJ1-1
TGCGCCAGCAGCGTTTGGGACAGCTTGGGGGGTCAGCCCCAGCATTTT	CASSVWDSLGGQPQHF	TRBV5-1	TRBJ1-5
TGTGCCACCAGCAGAGATGCCCCGGACTACGAGCAGTACTTC	CATSRDAPDYEQYF	TRBV15	TRBJ2-7
TGTGCCATCCCGAGACAGGGCCTCGACTACTACGAGCAGTACTTC	CAIPRQGLDYYEQYF	TRBV10-3	TRBJ2-7
TGTGCCAGCAGCTTTCACAGGGAAAGCGATGGCTACACCTTC	CASSFHRESDGYTF	TRBV7-3	TRBJ1-2
TGTGCCAGCAGTTACTCATTTCCCGGGACAGGGTATGGCTACACCTTC	CASSYSFPGTGYGYTF	TRBV6-2	TRBJ1-2
TGCAGTGCGACAGGGGGCAGCAATCAGCCCCAGCATTTT	CSATGGSNQPQHF	TRBV20-1	TRBJ1-5
TGTGCCAGCAGACTCTTGCGGGAAGGTGCCGGGGAGCTGTTTTTT	CASRLLREGAGELFF	TRBV9	TRBJ2-2
TGTGCCACCAGCAGAGATATGGGAGGACGGCACCTCTACGAGCAGTACTTC	CATSRDMGGRHLYEQYF	TRBV15	TRBJ2-7
TGTGCCAGCAGCGTCAGAGGGGGCGCTATTGATGATGAGCAGTTCTTC	CASSVRGGAIDDEQFF	TRBV9	TRBJ2-1
TGTGCCAGCAGCCCGCCAGCTACCTATGGCTACACCTTC	CASSPPATYGYTF	TRBV6-5	TRBJ1-2
TGTGCCAGCAGCCGACTTTTTAAAGTAGCGGCCTGGAAGGGGGGGTCCTCCTACGAGCAGTACTTC	CASSRLFKVAAWKGGSSYEQYF	TRBV14	TRBJ2-7
TGCAGTGCTAGAGACCCCCGGTACAATGAGCAGTTCTTC	CSARDPRYNEQFF	TRBV20-1	TRBJ2-1
TGTGCCAGCAGCTTGTCAACCAGGGCGATGTCCTACGAGCAGTACTTC	CASSLSTRAMSYEQYF	TRBV5-6	TRBJ2-7
TGTGCCAGCAGAGACCGCAACAGGGCCCCGGGCAATCAGCCCCAGCATTTT	CASRDRNRAPGNQPQHF	TRBV27	TRBJ1-5
TGTGCCAGTAGAACAGGGACAGGGACTCCAGCCAAAAACATTCAGTACTTC	CASRTGTGTPAKNIQYF	TRBV19	TRBJ2-4
TGTGCCAGCAGCTTGGTGAGGGGGGGGAATCAGCCCCAGCATTTT	CASSLVRGGNQPQHF	TRBV7-9	TRBJ1-5
TGTGCCAGCAGCGTAGTCACGGGCTATAGCAATCAGCCCCAGCATTTT	CASSVVTGYSNQPQHF	TRBV9	TRBJ1-5
TGTGCCAGCAGTTACTCGATGATTCCGACGGAGGGCTACACCTTC	CASSYSMIPTEGYTF	TRBV6-6	TRBJ1-2
TGTGCCAGCAGTGAAGCGCCCACCTCTAGCGGGAGTTCCCAAGAGACCCAGTACTTC	CASSEAPTSSGSSQETQYF	TRBV6-1	TRBJ2-5
TGTGCCAGCATATCGGGGGTTCAGCCCCAGCATTTT	CASISGVQPQHF	TRBV14	TRBJ1-5
TGCGCCAGCAGTGCATCACAGTCCCCCACTGAAGCTTTCTTT	CASSASQSPTEAFF	TRBV10-1	TRBJ1-1
TGTGCCAGCAGACCCCGGACTAGCGGGGATTGCACAGATACGCAGTATTTT	CASRPRTSGDCTDTQYF	TRBV27	TRBJ2-3
TGTGCCAGCAGTAGTAGCAGGGCCGGAGGAGGGAATTCACCCCTCCACTTT	CASSSSRAGGGNSPLHF	TRBV6-5	TRBJ1-6
TGTGCCAGTAGTCGCCTGACGGAGACCCAGTACTTC	CASSRLTETQYF	TRBV19	TRBJ2-5
TGTGCCAGCAGTTATGGGGAAGACCACGAATTGATTTACAATGAGCAGTTCTTC	CASSYGEDHELIYNEQFF	TRBV6-5	TRBJ2-1
TGTGCTAGCAGCTTATCCTGGTGGGGACGGGCCTATGGCTACACCTTC	CASSLSWWGRAYGYTF	TRBV7-7	TRBJ1-2
TGTGCCACCAGTGATTTGCAGACGAACACCGGGGAGCTGTTTTTT	CATSDLQTNTGELFF	TRBV24-1	TRBJ2-2
TGTGCCAGCAGTTGCCGGAGACAGGGAGAGCAGTACTTC	CASSCRRQGEQYF	TRBV28	TRBJ2-7
TGTGCCAGCAGTGGGGGGCCAGTCCCCAATGAGCAGTTCTTC	CASSGGPVPNEQFF	TRBV6-5	TRBJ2-1
TGTGCCAGCAGCTTGGGTATCCGGGCCTATGGCTACACCTTC	CASSLGIRAYGYTF	TRBV5-6	TRBJ1-2
TGTGCCAGCTCACCACCGGGGACCGTCTATGGCTACACCTTC	CASSPPGTVYGYTF	TRBV18	TRBJ1-2
TGTGCCAGCAGCGGCTTAGCACAGGGCCATTCACCCCTCCACTTT	CASSGLAQGHSPLHF	TRBV4-2	TRBJ1-6
TGTGCCAGCAGCCGGCTCCCCAGGGAAACAAATGCTTACACAGATACGCAGTATTTT	CASSRLPRETNAYTDTQYF	TRBV3-1	TRBJ2-3
TGCAGCGTTGAGAGTCAGGGGGGGACAACTAATGAAAAACTGTTTTTT	CSVESQGGTTNEKLFF	TRBV29-1	TRBJ1-4
TGTGCCAGCAGCTTGTCCACGACAGGGGGCGCAAGAGAGACCCAGTACTTC	CASSLSTTGGARETQYF	TRBV5-5	TRBJ2-5
TGCGCCAGCAGCGTCGGACCAGGGGGCGGGCTCTATGGCTACACCTTC	CASSVGPGGGLYGYTF	TRBV4-1	TRBJ1-2
TGTGCCACCAGCAGAGAAGCCGGGACCCCGGACAATGAGCAGTTCTTC	CATSREAGTPDNEQFF	TRBV15	TRBJ2-1
TGTGCCAGCAGCCGGGACAGGGTTACCGGGGAGCTGTTTTTT	CASSRDRVTGELFF	TRBV13	TRBJ2-2
TGTGCCAGCAGTGAGGGGGTGAACTGCCGGGGTGGCGATACGCAGTATTTT	CASSEGVNCRGGDTQYF	TRBV6-4	TRBJ2-3
TGTGCCAGCAGTTACGGTTATTCGCGGGGCGTTTGGGTATATGGCTACACCTTC	CASSYGYSRGVWVYGYTF	TRBV6-6	TRBJ1-2
TGCAGTGCACGCAGGGCTAATGAAAAACTGTTTTTT	CSARRANEKLFF	TRBV20-1	TRBJ1-4
TGTGCCAGCAGACGGGGATTCCCTGACACAGATACGCAGTATTTT	CASRRGFPDTDTQYF	TRBV14	TRBJ2-3
TGCGCCAGCAGCCAATCCCGAGAGGGGGACTATGGCTACACCTTC	CASSQSREGDYGYTF	TRBV4-1	TRBJ1-2
TGTGCCAGCAGCCAAGAGGGCCCGGGGGCCTACGAGCAGTACTTC	CASSQEGPGAYEQYF	TRBV3-1	TRBJ2-7
TGTGCCAGCAGCCGCGGCCAGGAGGAAGCTTTCTTT	CASSRGQEEAFF	TRBV9	TRBJ1-1
TGTGCCAGCAGCCCCCAGAGGGAAGGACAGGGGGCGGACTATGGCTACACCTTC	CASSPQREGQGADYGYTF	TRBV5-4	TRBJ1-2
TGTGCCAGCTTCAAGGGACTAGTGGAGACAGATACGCAGTATTTT	CASFKGLVETDTQYF	TRBV7-9	TRBJ2-3
TGTGCCAGCAGTTACAAGGTCTTTGCGGCCTCTAATGAAAAACTGTTTTTT	CASSYKVFAASNEKLFF	TRBV6-5	TRBJ1-4
TGTGCCAGCAGCTTAGCCCTAGCGGGCTCCTACGAGCAGTACTTC	CASSLALAGSYEQYF	TRBV7-2	TRBJ2-7
TGTGCCAGCAGCTTTTTCCCCCGAGGGGGGGGGCGCACCGGGGAGCTGTTTTTT	CASSFFPRGGGRTGELFF	TRBV7-3	TRBJ2-2
TGTGCCATTTCTTCGGTGGGCACTGAAGCTTTCTTT	CAISSVGTEAFF	TRBV12-4	TRBJ1-1
TGTGCCAGCAGCCAAGATTCCCCGGTAAGCCCGACAGGGTTTCCCGAAAAACTGTTTTTT	CASSQDSPVSPTGFPEKLFF	TRBV4-2	TRBJ1-4
TGTGCCAGCAGCAACCGGGTAGAGACCCAGTACTTC	CASSNRVETQYF	TRBV9	TRBJ2-5
TGCGCCAGCAGCATCCGGAGGTATAATTCACCCCTCCACTTT	CASSIRRYNSPLHF	TRBV4-1	TRBJ1-6
TGTGCCAGTAGTATCCGGTCCGGGACAGGGTCGACCCAGCATTTT	CASSIRSGTGSTQHF	TRBV19	TRBJ1-5
TGCGCCAGCAGCTTGCTGGGGGCAGCAGGATCCAATGAGCAGTTCTTC	CASSLLGAAGSNEQFF	TRBV5-1	TRBJ2-1
TGTGCCACCAGTGATTTGGCTCGGGACTACGAGCAGTACTTC	CATSDLARDYEQYF	TRBV24-1	TRBJ2-7
TGTGCCCCGTTACCACGACTAGCGGGAGCGACGGATACCCGGGACTTAAGATCGTACGAGCAGTACTTC	CAPLPRLAGATDTRDLRSYEQYF	TRBV5-6	TRBJ2-7
TGCAGTGCTGGAGGACAGGATTATGGCTACACCTTC	CSAGGQDYGYTF	TRBV20-1	TRBJ1-2
TGTGCCAGCAAAACCGGACAGGGGGCTTCACCCCTCCACTTT	CASKTGQGASPLHF	TRBV11-3	TRBJ1-6
TGTGCCAGCAGCACCTTAGTCGACGGCAATCAGCCCCAGCATTTT	CASSTLVDGNQPQHF	TRBV5-8	TRBJ1-5
TGTGCCAGCAGCTTAATACAGGGGTATGGCTACACCTTC	CASSLIQGYGYTF	TRBV7-9	TRBJ1-2
TGTGCCAGCAGCGTAGCTCTCCTAAAGAGCTACGAGCAGTACTTC	CASSVALLKSYEQYF	TRBV9	TRBJ2-7
TGTGCCAGGAACATCCGAACTAGCGGGAGGGCCGGTGATACCGGGGATAGCACAGATACGCAGTATTTT	CARNIRTSGRAGDTGDSTDTQYF	TRBV9	TRBJ2-3
TGTGCCAGCAGAGCCCCAGGCCTGGAAGCCAAAAACATTCAGTACTTC	CASRAPGLEAKNIQYF	TRBV28	TRBJ2-4
TGTGCCAGCAGCTTGGAGGACAGGGCCGGGATGAACACTGAAGCTTTCTTT	CASSLEDRAGMNTEAFF	TRBV5-4	TRBJ1-1
TGCGCCAGCAGCCAAGGGGGACAGGGGAACTACGAGCAGTACTTC	CASSQGGQGNYEQYF	TRBV4-3	TRBJ2-7
TGTGCTAGTGGTTTGGTAACAGGGGCGGGGGACGAAAAACTGTTTTTT	CASGLVTGAGDEKLFF	TRBV12-5	TRBJ1-4
TGTGCCAGCAGCGCATTCCAAGAGACCCAGTACTTC	CASSAFQETQYF	TRBV9	TRBJ2-5
TGTGCCAGCAGCGGCGGGGGGACTAGCGGGGGGGGGGAGCAGTACTTC	CASSGGGTSGGGEQYF	TRBV7-3	TRBJ2-7
TGCAGCGTTGGAGGGGGGGGTCTCCGGAGGGAGACCCAGTACTTC	CSVGGGGLRRETQYF	TRBV29-1	TRBJ2-5
TGTGCCACCAGTGATTTCTTTCCGGGACATTCCCCGTTTAGCAATCAGCCCCAGCATTTT	CATSDFFPGHSPFSNQPQHF	TRBV24-1	TRBJ1-5
TGTGCCAGCAGTTGTCCACAGGGGGCGGAATACGAGCAGTACTTC	CASSCPQGAEYEQYF	TRBV27	TRBJ2-7
TGTGCCAGCAGCAAAAGTTGTAGGGATGGAAGGAACTATGGCTACACCTTC	CASSKSCRDGRNYGYTF	TRBV6-4	TRBJ1-2
TGTGCCAGCAGACATCGGGACAGGGGGGGGGGCTATGGCTACACCTTC	CASRHRDRGGGYGYTF	TRBV12-3	TRBJ1-2
TGTGCCAGCAGTGCCCGACTAGCGGGGGGGGCCTACGAGCAGTACTTC	CASSARLAGGAYEQYF	TRBV2	TRBJ2-7
TGTGCCAGCAGCCCAGCCAGCCAGTCCGCAGATGAGCAGTTCTTC	CASSPASQSADEQFF	TRBV13	TRBJ2-1
TGTGCCAGCATAAGACAGTGCTACGAGCAGTACTTC	CASIRQCYEQYF	TRBV9	TRBJ2-7
TGTGCCAGCAGTTACATGGCACTTTTGGACAGGGGGGAACAGCCCCAGCATTTT	CASSYMALLDRGEQPQHF	TRBV6-5	TRBJ1-5
TGTGCCAATCGGGGGCGTCGGACCACTGAAGCTTTCTTT	CANRGRRTTEAFF	TRBV3-1	TRBJ1-1
TGTGCCAGCAGCTTGAACGACAGGCACGAAGCTTTCTTT	CASSLNDRHEAFF	TRBV5-6	TRBJ1-1
TGTGCCAGCAGCTTGTTTTCCTCCCCGGGACAGGCCTCCTACGAGCAGTACTTC	CASSLFSSPGQASYEQYF	TRBV5-4	TRBJ2-7
TGTGCCAGCAGTTACCTCTATCCGGGACAGTGGGTGTACTTC	CASSYLYPGQWVYF	TRBV6-2	TRBJ2-7
TGTGCCAGCAGACGACAGGGTGACGGGAACTATGGCTACACCTTC	CASRRQGDGNYGYTF	TRBV5-4	TRBJ1-2
TGCGCCAGCAGCTTGCTCAGTTTCCAAAGGGGGAATCAGCCCCAGCATTTT	CASSLLSFQRGNQPQHF	TRBV5-1	TRBJ1-5
TGTGCCATCGGGGAACCCTACGAGCAGTACTTC	CAIGEPYEQYF	TRBV2	TRBJ2-7
TGTGCCAGCGGGGAGGAGCGGGGGTACGAGCAGTACTTC	CASGEERGYEQYF	TRBV11-3	TRBJ2-7
TGTGCCACCAGTGATGGACACGCTAACTATGGCTACACCTTC	CATSDGHANYGYTF	TRBV24-1	TRBJ1-2
TGCAGTGCACCGGGACAGATGGAAAGGGGAATGAACACTGAAGCTTTCTTT	CSAPGQMERGMNTEAFF	TRBV20-1	TRBJ1-1
TGCAGTGCTAGAGGGGGGTTGGGGGGCAATCAGCCCCAGCATTTT	CSARGGLGGNQPQHF	TRBV20-1	TRBJ1-5
TGTGCCACCAGTATCCAACATACTGAGTACGAGCAGTACTTC	CATSIQHTEYEQYF	TRBV24-1	TRBJ2-7
TGCAGCGTGGGGGAGGGGGGGGAGAGGGGCTACACCTTC	CSVGEGGERGYTF	TRBV29-1	TRBJ1-2
TGTGCCAGCAGTTCAGGAGGACAGGGGATCTTCGACACGGCCTACAATGAGCAGTTCTTC	CASSSGGQGIFDTAYNEQFF	TRBV6-6	TRBJ2-1
TGTGCCACCAGTGACGGTCAAGTAACGTCCGTTTCTGATGAGCAGTTCTTC	CATSDGQVTSVSDEQFF	TRBV24-1	TRBJ2-1
TGTGCCTGGCGGGGGGACAGAAGGGAAGTTGAGCAGTTCTTC	CAWRGDRREVEQFF	TRBV30	TRBJ2-1
TGTGCCAGCAGCATACTAGCGGGAGAGGGAAACATTCAGTACTTC	CASSILAGEGNIQYF	TRBV7-4	TRBJ2-4
TGTGCCAGCAGCGTCCCGGACCACCGGGGGGGTGAGGAGACCCAGTACTTC	CASSVPDHRGGEETQYF	TRBV7-3	TRBJ2-5
TGTGCCAGCAGCGTGGGCGGGTTCGCCTTATGGTTTAATGAAAAACTGTTTTTT	CASSVGGFALWFNEKLFF	TRBV11-3	TRBJ1-4
TGTGCCAGCAGTGACGGGCCCCAATCAGGGGGAACCTACGAGCAGTACTTC	CASSDGPQSGGTYEQYF	TRBV6-4	TRBJ2-7
TGTGCCAGCAGCTTAGACTCCCGGACAGGGAAAGGCTCTGGAAACACCATATATTTT	CASSLDSRTGKGSGNTIYF	TRBV7-2	TRBJ1-3
TGTGCCAGCAGCTGGGAGGGCCTTACAGATACGCAGTATTTT	CASSWEGLTDTQYF	TRBV9	TRBJ2-3
TGTGCCTACGGAACTGAAGCTTTCTTT	CAYGTEAFF	TRBV30	TRBJ1-1
TGTGCCAGCAGCGCGGAACCCGTGAGCTCCTACAATGAGCAGTTCTTC	CASSAEPVSSYNEQFF	TRBV9	TRBJ2-1
TGCAGCGTTGAAGACGGTGGGGGACGGGCCTCTGGGGCCAACGTCCTGACTTTC	CSVEDGGGRASGANVLTF	TRBV29-1	TRBJ2-6
TGCGCCAGCAGCCACCCGGAACTAGAGGGGGATACGCAGTATTTT	CASSHPELEGDTQYF	TRBV4-1	TRBJ2-3
TGCGCCAGCAGGGTACATGGCAAACCCTACGAGCAGTACTTC	CASRVHGKPYEQYF	TRBV5-1	TRBJ2-7
TGTGCCAGCAGAAAGTCCGTCGCCACGGTTCTAGCGGGGCATCGACGGCCCTACGAGCAGTACTTC	CASRKSVATVLAGHRRPYEQYF	TRBV12-4	TRBJ2-7
TGTGCTAGTGGTGACGGGGGCGGAAACACCATATATTTT	CASGDGGGNTIYF	TRBV12-5	TRBJ1-3
TGTGCCAGCAGCCTCTATACCGGGAGTTACTTC	CASSLYTGSYF	TRBV13	TRBJ2-5
TGTGCCAGCAGCTTGGGGATAGGTCAAGAGACCCAGTACTTC	CASSLGIGQETQYF	TRBV5-4	TRBJ2-5
TGTGCCAGCAGCTTACCAACGGCCCCCCCCGATCAGCCCCAGCATTTT	CASSLPTAPPDQPQHF	TRBV7-6	TRBJ1-5
TGTGCCAGCAGTGCCCCCTCGAGAGGGAGGTACTATGGCTACACCTTC	CASSAPSRGRYYGYTF	TRBV27	TRBJ1-2
TGTGCCAGCAGTTACCCTCCAGCATATAGCAATCAGCCCCAGCATTTT	CASSYPPAYSNQPQHF	TRBV6-5	TRBJ1-5
TGTGCCAGCAGCTTATCCCAGAGGGGTAGGGGAGAGGAAGCTTTCTTT	CASSLSQRGRGEEAFF	TRBV7-6	TRBJ1-1
TGTGCCAGCAGCGGGGGCAGGATTTTTCGTTCACCCCTCCACTTT	CASSGGRIFRSPLHF	TRBV11-3	TRBJ1-6
TGTGCCAGCAGCCAAATAGTACCCCGACAGATCGAACGCACTGAAGCTTTCTTT	CASSQIVPRQIERTEAFF	TRBV9	TRBJ1-1
TGTGCCAGCAGTACTACCCCAGATACGCAGTATTTT	CASSTTPDTQYF	TRBV7-3	TRBJ2-3
TGTGCCAGCTCACCGACAGGGGGAGATGAGCAGTTCTTC	CASSPTGGDEQFF	TRBV18	TRBJ2-1
TGTGCCAGCAGTTTAGGTCCAGTCAACAGGGGGAGACGGAACACTGAAGCTTTCTTT	CASSLGPVNRGRRNTEAFF	TRBV12-4	TRBJ1-1
TGTGCCAGCAGCACGGTGGACTACGAGCAGTACTTC	CASSTVDYEQYF	TRBV7-9	TRBJ2-7
TGTGCCATCAAGGGGCTTGAGCAGTTCTTC	CAIKGLEQFF	TRBV10-3	TRBJ2-1
TGTGCCAGTAGCACCAGGGGAGGTTCACCCCTCCACTTT	CASSTRGGSPLHF	TRBV19	TRBJ1-6
TGTGCCAGCAGTTACTCGAGGTCGGGGGAGGTCAATGAGCAGTTCTTC	CASSYSRSGEVNEQFF	TRBV6-2	TRBJ2-1
TGTGCCAGCAGGATGACCGACGCCCGGATGACTAGCGGCTATGGGGACGAGACCCAGTACTTC	CASRMTDARMTSGYGDETQYF	TRBV5-6	TRBJ2-5
TGTGCCAGCAGCCGACGCTCCGGCAATGAGCAGTTCTTC	CASSRRSGNEQFF	TRBV7-8	TRBJ2-1
TGTGCCACCAGTGATCCCCCCCAAAGGGTGAAGAATGAGCAGTTCTTC	CATSDPPQRVKNEQFF	TRBV24-1	TRBJ2-1
TGCGCCAGCAGCCAAGGCTGCGGGAGTGAGATCTCCTACAATGAGCAGTTCTTC	CASSQGCGSEISYNEQFF	TRBV4-1	TRBJ2-1
TGTGCCACCAGCAGAGGCGGTACCGGGACTAGCGGGAGTACCAATCAGCCCCAGCATTTT	CATSRGGTGTSGSTNQPQHF	TRBV15	TRBJ1-5
TGTGCCAGCTCACCAAGGACTAGTAACTATGGCTACACCTTC	CASSPRTSNYGYTF	TRBV18	TRBJ1-2
TGTGCTAGTGGTTTGGTACCCAACTGGACGAAAGCTGACCTCCCGAACACCGGGGAGCTGTTTTTT	CASGLVPNWTKADLPNTGELFF	TRBV12-5	TRBJ2-2
TGTGCCAGCAGCTTAGCCGGGGAAAACTCCTACGAGCAGTACTTC	CASSLAGENSYEQYF	TRBV7-9	TRBJ2-7
TGTGCCAGCAGTGGGGAGAACTCCTACGAGCAGTACTTC	CASSGENSYEQYF	TRBV6-3	TRBJ2-7
TGTGCCAGCGTGGACCCACCGGGGGGCTACGAGCAGTACTTC	CASVDPPGGYEQYF	TRBV25-1	TRBJ2-7
TGCGCCAGCAGGGAGAGGGGAAGGAGGGGGAACACCGGGGAGCTGTTTTTT	CASRERGRRGNTGELFF	TRBV10-1	TRBJ2-2
TGTGCCAGCAGCGGCCGGGACATTCTTGGCTACACCTTC	CASSGRDILGYTF	TRBV7-2	TRBJ1-2
TGTGCCAGCAGTAGCCGGTTCCCAACCTCCTACAATGAGCAGTTCTTC	CASSSRFPTSYNEQFF	TRBV6-4	TRBJ2-1
TGTGCCAGCAGTTTCGGGGGGGCAAATGAGCAGTTCTTC	CASSFGGANEQFF	TRBV2	TRBJ2-1
TGTGCCAGCAGCCATTTTTCCTGGGAGCTAGCGGGCATTCGCTACGAGCAGTACTTC	CASSHFSWELAGIRYEQYF	TRBV7-3	TRBJ2-7
TGTGCCAGCTCCTGCGACTCCGTCCACTACGAGCAGTACTTC	CASSCDSVHYEQYF	TRBV19	TRBJ2-7
TGCGCCAGAGGAAAGACTAGAAGGGGGGAGCTGTTTTTT	CARGKTRRGELFF	TRBV5-1	TRBJ2-2
TGTGCCAGCAGCCACCGGACAGGGTACCATCAGCCCCAGCATTTT	CASSHRTGYHQPQHF	TRBV14	TRBJ1-5
TGTGCCAGCAGCTTAGTCTTCAAGTCCAACAGATTGACTGGAAACACCATATATTTT	CASSLVFKSNRLTGNTIYF	TRBV7-9	TRBJ1-3
TGTGCCACCAGTGATGCACAGGGGTTCCAAGAGACCCAGTACTTC	CATSDAQGFQETQYF	TRBV24-1	TRBJ2-5
TGCCCCAGGCTTAGGGACAGGGGTAATTCACCCCTCCACTTT	CPRLRDRGNSPLHF	TRBV20-1	TRBJ1-6
TGTGCTAGTGGTTTGCCATGCCGGGACAGGGACAAGCTCGAGCAGTACTTC	CASGLPCRDRDKLEQYF	TRBV12-5	TRBJ2-7
TGCGCCAGCAGCCAAGAGATTCGCGGCGGGAATCAGCCCCAGCATTTT	CASSQEIRGGNQPQHF	TRBV4-1	TRBJ1-5
TGTGCCAGCAGTGCACCGGGACAGTCGATGAGCAATCAGCCCCAGCATTTT	CASSAPGQSMSNQPQHF	TRBV2	TRBJ1-5
TGTGCCAGCAGTGAATCGCCGGTTCCGGCCCAGTACTTC	CASSESPVPAQYF	TRBV6-1	TRBJ2-5
TGTGCCAGCAGCCTTAGTAGGAACAATGAGCAGTTCTTC	CASSLSRNNEQFF	TRBV5-6	TRBJ2-1
TGCAGCGTTGAAGAGCCGGGCATAGCGTGCTACGAGCAGTACTTC	CSVEEPGIACYEQYF	TRBV29-1	TRBJ2-7
TGTGCCTGGAGGAGAATAGCGGGGGGGCCTATCTACACCGGGGAGCTGTTTTTT	CAWRRIAGGPIYTGELFF	TRBV30	TRBJ2-2
TGCAGTGCTAGAGATAAGCCCCTAGGGACAGGGCCGGGCTACACCTTC	CSARDKPLGTGPGYTF	TRBV20-1	TRBJ1-2
TGTGCCAGCAGTTTCGCCCGGGGGCCGGAGAATTCACCCCTCCACTTT	CASSFARGPENSPLHF	TRBV27	TRBJ1-6
TGCAGTGCTAGAGAGACAGGGGGCATGGTTGCGGTAAGTGAAGCTTTCTTT	CSARETGGMVAVSEAFF	TRBV20-1	TRBJ1-1
TGTGCCAGCAGCAAAATAGGGACACCCCCACCTGCAACTAATGAAAAACTGTTTTTT	CASSKIGTPPPATNEKLFF	TRBV11-3	TRBJ1-4
TGTCGTCTTCTTGTCACAGATACGCAGTATTTT	CRLLVTDTQYF	TRBV27	TRBJ2-3
TGCGCCAGCGGGGAGAACACTGAAGCTTTCTTT	CASGENTEAFF	TRBV5-1	TRBJ1-1
TGTGCCAGATCAGGGAGGGGATCCGTCACTGAAGCTTTCTTT	CARSGRGSVTEAFF	TRBV7-4	TRBJ1-1
TGTGCCAGCAGTTCCACCGACCCTTGGACAGGGAATAATTCACCCCTCCACTTT	CASSSTDPWTGNNSPLHF	TRBV6-2	TRBJ1-6
TGTGCCAGCAGCCGGGCCCGGGGGGGCGGAGATACGCAGTATTTT	CASSRARGGGDTQYF	TRBV28	TRBJ2-3
TGCAGTGCTAGAATACAACGTGAAAAACTGTTTTTT	CSARIQREKLFF	TRBV20-1	TRBJ1-4
TGCGCCAGCAGCCAAGATGATAGAGCTCGATACGAGCAGTACTTC	CASSQDDRARYEQYF	TRBV4-1	TRBJ2-7
TGTGCCAGCCGGGCCTATGGCTACACCTTC	CASRAYGYTF	TRBV6-5	TRBJ1-2
TGTGCCAGCAGTTACCGACTAGCGGGAGACGAGCAGTACTTC	CASSYRLAGDEQYF	TRBV6-5	TRBJ2-7
TGTGCCAGCAGCCAATCACCCGACAGGAAGGAAAAACTGTTTTTT	CASSQSPDRKEKLFF	TRBV7-4	TRBJ1-4
TGTGCCTGGAAGCCGGGAACATTGATTCCCTACAATGAGCAGTTCTTC	CAWKPGTLIPYNEQFF	TRBV30	TRBJ2-1
TGTGCCACCAGCAGAGATTTTATCAACGACACAGATACGCAGTATTTT	CATSRDFINDTDTQYF	TRBV15	TRBJ2-3
TGTGCCAGCAGCGGACTACAGGGTGAAGCTAACTATGGCTACACCTTC	CASSGLQGEANYGYTF	TRBV13	TRBJ1-2
TGTGCCAGCAGCCAAGATCCCCCAGTGGGGGGGGGGACCTACGAGCAGTACTTC	CASSQDPPVGGGTYEQYF	TRBV3-1	TRBJ2-7
TGTGCCAGCAGCTTAGACGGGACAGGGTGGTTCGAGCAGTACTTC	CASSLDGTGWFEQYF	TRBV7-9	TRBJ2-7
TGTGCCGGACAGGGAGAGAACACTGAAGCTTTCTTT	CAGQGENTEAFF	TRBV10-3	TRBJ1-1
TGCGCCAGCAGCTTGGAAAATGGGGGGGCCTGGACCTACGAGCAGTACTTC	CASSLENGGAWTYEQYF	TRBV5-1	TRBJ2-7
TGTGCCAGCAGCTCGTCGGGACAGGGGCGTTGTCATTCACCCCTCCACTTT	CASSSSGQGRCHSPLHF	TRBV11-3	TRBJ1-6
TGTGCCAGCTGTTTCAGTACTTACGGGAGGGAAAAGGACACAGATACGCAGTATTTT	CASCFSTYGREKDTDTQYF	TRBV2	TRBJ2-3
TGTGCCAGTAGTATGAAACACCAAGGGAGAGGCGTGTATGGCTACACCTTC	CASSMKHQGRGVYGYTF	TRBV19	TRBJ1-2
TGTGCCAGCAGCTTACGTGACGCCCATTATGGGTACAATGAGCAGTTCTTC	CASSLRDAHYGYNEQFF	TRBV7-9	TRBJ2-1
TGTGCCAGCAGCCTCTTCCCGGGAAGGGCTTTCTTT	CASSLFPGRAFF	TRBV14	TRBJ1-1
TGTGCCTGGAGTGTTAAATGTGGACAGGGTTACGACCGCGAGCAGTACTTC	CAWSVKCGQGYDREQYF	TRBV30	TRBJ2-7
TGTGCCAGCAGCAACTCCCCCTGGGGGGCCAACGTCCTGACTTTC	CASSNSPWGANVLTF	TRBV9	TRBJ2-6
TGCGCCATCGGCCCCCAGCATTTT	CAIGPQHF	TRBV5-1	TRBJ1-5
TGCGCCAATCCGGGCACCTTGGGGGGCTACGAGCAGTACTTC	CANPGTLGGYEQYF	TRBV20-1	TRBJ2-7
TGTGCCAGTAGTATAGCCGGCCCTTCTGGAAACACCATATATTTT	CASSIAGPSGNTIYF	TRBV19	TRBJ1-3
TGTGCCAGCAGAGGGGATTCCTACGAGCAGTACTTC	CASRGDSYEQYF	TRBV11-2	TRBJ2-7
TGTGCCACCAGTGTGCCGGACAGGGCGTTGAGTGAAAAACTGTTTTTT	CATSVPDRALSEKLFF	TRBV24-1	TRBJ1-4
TGCGCCAGCAGCCAAGACTCCAGGGGCTGGGGAAAAGGTGGTTACGAGCAGTACTTC	CASSQDSRGWGKGGYEQYF	TRBV4-1	TRBJ2-7
TGCAGTGCTAGAAGACGACTAGCAGAGACCCAGTACTTC	CSARRRLAETQYF	TRBV20-1	TRBJ2-5
TGTGCCACTTGGCCGGGACAGGGGGCCTATGGCTACACCTTC	CATWPGQGAYGYTF	TRBV24-1	TRBJ1-2
TGTGCCAGCAGCCAAGATCAGCGGGGGGGGAGCCAGGGCAACGAGACCCAGTACTTC	CASSQDQRGGSQGNETQYF	TRBV3-1	TRBJ2-5
TGTGCCAGCAGCCTACATTACTGGTTAGACAGGAACTATGGCTACACCTTC	CASSLHYWLDRNYGYTF	TRBV7-3	TRBJ1-2
TGTGCCAGCAGCTTAGGTGGGACAGGGATCAACCTCAATAGCAATCAGCCCCAGCATTTT	CASSLGGTGINLNSNQPQHF	TRBV7-9	TRBJ1-5
TGTGCCAGCAGCGTTGGACAGGGGGGGACCTCCGTCGCCGAGGAGACCCAGTACTTC	CASSVGQGGTSVAEETQYF	TRBV13	TRBJ2-5
TGCGCCAGCAGCTCAGGTAAGCGTGGACACTTGGATACGCAGTATTTT	CASSSGKRGHLDTQYF	TRBV5-1	TRBJ2-3
TGTGCCAGCGAAAACAGGGAGACCCAGTACTTC	CASENRETQYF	TRBV19	TRBJ2-5
TGTGCCAGTAGTATAGGACAGGGGGCCAATCAGCCCCAGCATTTT	CASSIGQGANQPQHF	TRBV19	TRBJ1-5
TGTGCCAGCAGCACCCTGGGACAGGGCTCTGGGGCCAACGTCCTGACTTTC	CASSTLGQGSGANVLTF	TRBV7-3	TRBJ2-6
TGTGCCAGTTCCCTCTATATGGGGGGGCACAATGAGCAGTTCTTC	CASSLYMGGHNEQFF	TRBV19	TRBJ2-1
TGTGCCACCGTCCGAATTAATAGGGGAAGGGAGCAGTACTTC	CATVRINRGREQYF	TRBV15	TRBJ2-7
TGTGCCAGCAGCCAACTAGCGGGCGCGGCCTACGAGCAGTACTTC	CASSQLAGAAYEQYF	TRBV3-1	TRBJ2-7
TGTGCCAGCAGTTCGAAAACGGATACTGAAGCTTTCTTT	CASSSKTDTEAFF	TRBV2	TRBJ1-1
TGCAGCGTTTCCCGGACCGGGGGGACAGCCAAAAACATTCAGTACTTC	CSVSRTGGTAKNIQYF	TRBV29-1	TRBJ2-4
TGTGCCAGCAGTCCCAGGGAAAGGGAGCAGTACTTC	CASSPREREQYF	TRBV6-5	TRBJ2-7
TGTGCCAGTAGTAACCAGTCCCGGACAGGGGCCAGACTGCCCCCGCGGTACGAGCAGTACTTC	CASSNQSRTGARLPPRYEQYF	TRBV19	TRBJ2-7
TGTGCCAGCAGCCGTGAAACCGGGACTAGCGGGGTCCATGTCAAAAACATTCAGTACTTC	CASSRETGTSGVHVKNIQYF	TRBV7-9	TRBJ2-4
TGTGCCACCAGTGTCGAGGGGCGGGAGATTGAGCAGTTCTTC	CATSVEGREIEQFF	TRBV24-1	TRBJ2-1
TGTGCCAGCAGTCGACAGGGGCAGTTCTTC	CASSRQGQFF	TRBV2	TRBJ2-1
TGTGCCAGCAGTTCAGGGGGCACTGGGCCGGAGAACTATGGCTACACCTTC	CASSSGGTGPENYGYTF	TRBV5-6	TRBJ1-2
TGTGCCAGCAGCAAGGCGGGAGTTTTCGAGCAGTACTTC	CASSKAGVFEQYF	TRBV7-9	TRBJ2-7
TGTGCCACCAGCAGTCCGACAGGGCCCCACCGGAGAAGTCAGCCCCAGCATTTT	CATSSPTGPHRRSQPQHF	TRBV15	TRBJ1-5
TGTGCCAGCAGTTCGGGGGGGAGTAGGGGTTGCTATGGCTACACCTTC	CASSSGGSRGCYGYTF	TRBV6-5	TRBJ1-2
TGTGCCAGCAGTTTAGGTCGGTGTCTCAGGCAGGGTCAGCCCCAGCATTTT	CASSLGRCLRQGQPQHF	TRBV12-3	TRBJ1-5
TGTGCCACAGGTGGGGGGGCATGCTACGAGCAGTACTTC	CATGGGACYEQYF	TRBV7-3	TRBJ2-7
TGTGCCAGCAGGCCCGAAGGCGGCTACGAGCAGTACTTC	CASRPEGGYEQYF	TRBV6-3	TRBJ2-7
TGCGCCAGCAGCTGGGCCCTTAATAAGACCCAGTACTTC	CASSWALNKTQYF	TRBV5-1	TRBJ2-5
TGTGCCAGCAGCCGGAGGCTCTGGGATGAGCAGTTCTTC	CASSRRLWDEQFF	TRBV14	TRBJ2-1
TGTGCCAGCAGTTTGACGCATCCCAATGAAAAACTGTTTTTT	CASSLTHPNEKLFF	TRBV27	TRBJ1-4
TGCGCCAGCAGCCAAGACGGGGGACAGGGAAGGCCCCAGCATTTT	CASSQDGGQGRPQHF	TRBV4-3	TRBJ1-5
TGTGCCATCAGTGTGGACAGGCTTTCCTACAATGAGCAGTTCTTC	CAISVDRLSYNEQFF	TRBV10-3	TRBJ2-1
TGCAGTGCTAGCTATCAGGGAACACAGCCCCAGCATTTT	CSASYQGTQPQHF	TRBV20-1	TRBJ1-5
TGTGCCACCAGCAGAGTCTGGACAAATGCCCTTAGTGGTAGCTCCTACGAGCAGTACTTC	CATSRVWTNALSGSSYEQYF	TRBV15	TRBJ2-7
TGCAGCGTCAGGGCCGCGGAAGCCACAGATACGCAGTATTTT	CSVRAAEATDTQYF	TRBV29-1	TRBJ2-3
TGTGCTAGTGGTTTGCCCTCACAGGGAGAGGGCCACGGGGAGTACAATCAGCCCCAGCATTTT	CASGLPSQGEGHGEYNQPQHF	TRBV12-5	TRBJ1-5
TGTGCCAGGAAACGGGGACACTCTGGGGCCAACGTCCTGACTTTC	CARKRGHSGANVLTF	TRBV9	TRBJ2-6
TGTGCCAGCAGCACAGCTTCGGACAGGGGACAGGACTACAATGAGCAGTTCTTC	CASSTASDRGQDYNEQFF	TRBV9	TRBJ2-1
TGCAGTGCAAGGGAGGGGTTGTACGAGCAGTACTTC	CSAREGLYEQYF	TRBV20-1	TRBJ2-7
TGTGCCGGGGCCAAAAACATTCAGTACTTC	CAGAKNIQYF	TRBV2	TRBJ2-4
TGTGCCAGCAGCTTAGTGGGTGGAGGGGGCCAGCCCCAGCATTTT	CASSLVGGGGQPQHF	TRBV11-3	TRBJ1-5
TGTGCCAGCGGGGACAGGTGTTTTGAAATAACTAATGAAAAACTGTTTTTT	CASGDRCFEITNEKLFF	TRBV12-4	TRBJ1-4
TGCGCCAGCAGCCATCACCGGACAGGGGCCAGTGACACCGGGGAGCTGTTTTTT	CASSHHRTGASDTGELFF	TRBV4-1	TRBJ2-2
TGCGCCATCGCGGGAGAAAATATCTACGAGCAGTACTTC	CAIAGENIYEQYF	TRBV4-1	TRBJ2-7
TGCGCCAGCAGCTTGGTTGGACAGGGCTCTGGAAACACCATATATTTT	CASSLVGQGSGNTIYF	TRBV5-1	TRBJ1-3
TGCGCCAGCAGCTTAGTTTTCGACGGGACATGGTCCTTTAATGAAAAACTGTTTTTT	CASSLVFDGTWSFNEKLFF	TRBV5-1	TRBJ1-4
TGTGCTAGTGGTTTCTTCGGTTATCAGGGTTTGACAGATACGCAGTATTTT	CASGFFGYQGLTDTQYF	TRBV12-5	TRBJ2-3
TGTGCCAGCAGCCAGCCAACCGTCCATCGGGGCTACACCTTC	CASSQPTVHRGYTF	TRBV3-1	TRBJ1-2
TGTGCCAGCAGAGGGACAGGGCGTAGTTTCACTGAAGCTTTCTTT	CASRGTGRSFTEAFF	TRBV6-6	TRBJ1-1
TGTGCCAGCAGCCAGGGACAGTTAGATGAAAAACTGTTTTTT	CASSQGQLDEKLFF	TRBV7-7	TRBJ1-4
TGTGCCAGCAGCACGACAGACGGCTACACCTTC	CASSTTDGYTF	TRBV5-6	TRBJ1-2
TGTGCCAGCAGTGACTCGAGAAGGGGGCGCAGGTTTAACACCGGGGAGCTGTTTTTT	CASSDSRRGRRFNTGELFF	TRBV6-4	TRBJ2-2
TGTGCCAGCAGCCGACCAATTAATTCACCCCTCCACTTT	CASSRPINSPLHF	TRBV11-2	TRBJ1-6
TGTGCCAGCAGCCGACAGGGCACTGAAGCTTTCTTT	CASSRQGTEAFF	TRBV7-3	TRBJ1-1
TGTGCCACCAGCAGAAACCGGGAATCGAGGGCAGATACGCAGTATTTT	CATSRNRESRADTQYF	TRBV15	TRBJ2-3
TGTGCCACCCTCAGCTACGAGCAGTACTTC	CATLSYEQYF	TRBV24-1	TRBJ2-7
TGTGCCAGCACCTCACTCCCGCGACAGGGGGCTGGAAACACCATATATTTT	CASTSLPRQGAGNTIYF	TRBV27	TRBJ1-3
TGCGCCAGCAGCTTGCGGGGGGGGGCACTCACCGGGGAGCTGTTTTTT	CASSLRGGALTGELFF	TRBV4-1	TRBJ2-2
TGTGCCAGCAGCCGACGTATCGCGGATGATTACTCTGGGGCCAACGTCCTGACTTTC	CASSRRIADDYSGANVLTF	TRBV11-3	TRBJ2-6
TGTGCCAGGGGGATAAGCTCCTACAATGAGCAGTTCTTC	CARGISSYNEQFF	TRBV2	TRBJ2-1
TGTGCCACCAGCAGAGGACAGTATTCACCCCTCCACTTT	CATSRGQYSPLHF	TRBV15	TRBJ1-6
TGTGCCAGCATGGGGTTCAGGGACTCATCAGGACTAGACGAGCAGTACTTC	CASMGFRDSSGLDEQYF	TRBV6-4	TRBJ2-7
TGCGCCAGCAGCCTAGCGCGGTTCCGCAGAGAGACCCAGTACTTC	CASSLARFRRETQYF	TRBV4-1	TRBJ2-5
TGTGCCAGCAGTTACCCACAGGTGGATGGCTACACCTTC	CASSYPQVDGYTF	TRBV6-6	TRBJ1-2
TGTGCCACCAGCAGCGCAGCCCTCCACTTT	CATSSAALHF	TRBV15	TRBJ1-6
TGCGCCAGCAGCCTAGCTAGCCGGAGCTCCTACGAGCAGTACTTC	CASSLASRSSYEQYF	TRBV10-1	TRBJ2-7
TGTGCCAGCAGCCAAGCCTCTGTGGCATTTGAGAATGAGCAGTTCTTC	CASSQASVAFENEQFF	TRBV14	TRBJ2-1
TGTGCCAGCAGCAAGTTCCGGGACAGGGCGTACTTC	CASSKFRDRAYF	TRBV13	TRBJ2-7
TGTGCCATCAGTGACAGTTTATTCTTT	CAISDSLFF	TRBV10-3	TRBJ1-1
TGTGCTAGTGGCAAGAGGGAGAAACGGGACAGGGATACGCAGTATTTT	CASGKREKRDRDTQYF	TRBV12-5	TRBJ2-3
TGTGCCAGCAGTTTCGTAGCGCCCCGCAGCTCCTACAATGAGCAGTTCTTC	CASSFVAPRSSYNEQFF	TRBV28	TRBJ2-1
TGTGCCAGCAGTGGCCCACAAGGGGGCGAGGGCTCTGGAAACACCATATATTTT	CASSGPQGGEGSGNTIYF	TRBV6-1	TRBJ1-3
TGTGCCAGCAGCAAAGGGCTCTGGATAGGGAATTCCTACGAGCAGTACTTC	CASSKGLWIGNSYEQYF	TRBV6-5	TRBJ2-7
TGTGCCAGCAGTCCCGGACCGGGGGAGGCCAACGTCCTGACTTTC	CASSPGPGEANVLTF	TRBV6-5	TRBJ2-6
TGCGCCAGCAGTTCCCTACTAGGGGGTGGGGCGAATGAAAAACTGTTTTTT	CASSSLLGGGANEKLFF	TRBV10-1	TRBJ1-4
TGTGCCAGCAGTTCCGGGGGGACTGAAGCTTTCTTT	CASSSGGTEAFF	TRBV6-5	TRBJ1-1
TGCAGTGCTAGAGACCATACAGAATTACTAGCGGCGAGGAACACCGGGGAGCTGTTTTTT	CSARDHTELLAARNTGELFF	TRBV20-1	TRBJ2-2
TGTGCCAGCAGCACGGACAGGGGAGGACCCTACGAGCAGTACTTC	CASSTDRGGPYEQYF	TRBV2	TRBJ2-7
TGTGCCAGCAGCCAAGGGGGGGGGGGAGGCTCCTATAATTCACCCCTCCACTTT	CASSQGGGGGSYNSPLHF	TRBV3-1	TRBJ1-6
TGTGCCAGCAGCGACCCGGCAGGTAATTCGAGCTCCTACAATGAGCAGTTCTTC	CASSDPAGNSSSYNEQFF	TRBV3-1	TRBJ2-1
TGCGCCAGCAGCTTGAGGTCTAGAGATACGCAGTATTTT	CASSLRSRDTQYF	TRBV5-1	TRBJ2-3
TGTGCCAGCAGTTTAGGGACCCCGACAGGCCCAGCCAACAATGAGCAGTTCTTC	CASSLGTPTGPANNEQFF	TRBV12-3	TRBJ2-1
TGTGCCAGCAGCTTGGGGGGCCTTCCCGGCTCCTACAATGAGCAGTTCTTC	CASSLGGLPGSYNEQFF	TRBV11-2	TRBJ2-1
TGTGCCAGGCCAGTTCGAGGAACTAATCAGCCCCAGCATTTT	CARPVRGTNQPQHF	TRBV7-9	TRBJ1-5
TGCGCCAGCAGCCGGATAGTAGATACGCAGTATTTT	CASSRIVDTQYF	TRBV5-1	TRBJ2-3
TGTGCCAGCCCCTATCCGGGACAGTATGGCTACACCTTC	CASPYPGQYGYTF	TRBV28	TRBJ1-2
TGTGCCAGCAGCAGCGGGACAGGGTTCTCTGGGGCCAACGTCCTGACTTTC	CASSSGTGFSGANVLTF	TRBV13	TRBJ2-6
TGTGCCAGCAGTTATGTCTCCGGAGGGACGCCCCAGCATTTT	CASSYVSGGTPQHF	TRBV6-3	TRBJ1-5
TGCAGTGCGCAGGGTGGCTACACCTTC	CSAQGGYTF	TRBV20-1	TRBJ1-2
TGCAGTGCAATAGGTCCCAGGCCCGACCCCGGGAAAAGCTCCTACGAGCAGTACTTC	CSAIGPRPDPGKSSYEQYF	TRBV20-1	TRBJ2-7
TGTGCCAGCAGGCAAAGGAGAGTAGACTACGAGCAGTACTTC	CASRQRRVDYEQYF	TRBV6-4	TRBJ2-7
TGTGCCAGCAGTCGGAGGGTCTACGAGCAGTACTTC	CASSRRVYEQYF	TRBV12-3	TRBJ2-7
TGTGCCAGCAGCCGGGGATCCCCAAAAGAGACCCAGTACTTC	CASSRGSPKETQYF	TRBV14	TRBJ2-5
TGTGCCACCAGTGAATGCCCCCATCCGAGCGAGCAGTACTTC	CATSECPHPSEQYF	TRBV24-1	TRBJ2-7
TGCGCCAGCAGCTTGCGAGCAGGCGGGCCTGGCTACGAGCAGTACTTC	CASSLRAGGPGYEQYF	TRBV5-1	TRBJ2-7
TGCAGCGTTGACAGGGGGCGTTGCACTGAAGCTTTCTTT	CSVDRGRCTEAFF	TRBV29-1	TRBJ1-1
TGTGCCAGTAGTAAATTGAACTGGGACACAGATACGCAGTATTTT	CASSKLNWDTDTQYF	TRBV19	TRBJ2-3
TGTGCCAGCAGTTTCCCCTATGACAGGTTAGGGGACACTGAAGCTTTCTTT	CASSFPYDRLGDTEAFF	TRBV28	TRBJ1-1
TGTGCCAGCAGCCAAGAGGCCGACGGGCCCGTTAAACTGTTTTTT	CASSQEADGPVKLFF	TRBV4-2	TRBJ1-4
TGTGCTAGTGGTTTAGCACGTAAGGCGGGGCCGGACGAGCAGTACTTC	CASGLARKAGPDEQYF	TRBV12-5	TRBJ2-7
TGTGCCTGGAGGTCAAACAGGGATACTGAAGCTTTCTTT	CAWRSNRDTEAFF	TRBV30	TRBJ1-1
TGTGCCAGCAGTTACTCGCCTGCAGGCTTTGGAAACACCATATATTTT	CASSYSPAGFGNTIYF	TRBV6-6	TRBJ1-3
TGCGCCAGCAGCGAAAGCGGAAACTATGGCTACACCTTC	CASSESGNYGYTF	TRBV5-1	TRBJ1-2
TGCAGTGCTAGACAAGGGTCGAACACCGGGGAGCTGTTTTTT	CSARQGSNTGELFF	TRBV20-1	TRBJ2-2
TGTGCCCCAGTTGACAGGGGCACTGAAGCTTTCTTT	CAPVDRGTEAFF	TRBV30	TRBJ1-1
TGTGCCAGCAGAACCGGGGACCACAAAACTAGCAATCAGCCCCAGCATTTT	CASRTGDHKTSNQPQHF	TRBV12-4	TRBJ1-5
TGTGCCAGCAGTGCCGATCGGGAGTTAATTGAAGCTTTCTTT	CASSADRELIEAFF	TRBV28	TRBJ1-1
TGTGCCAGCAGTGAAATTCAGGGAGCTGAAGCTTTCTTT	CASSEIQGAEAFF	TRBV6-1	TRBJ1-1
TGCAGCGTTGAACATCCGGGGGATACGCAGTATTTT	CSVEHPGDTQYF	TRBV29-1	TRBJ2-3
TGTGCCAGCAGCTTTAAAGAGCCGACCGCTCTAACGCGCTTGAACAATGAGCAGTTCTTC	CASSFKEPTALTRLNNEQFF	TRBV7-8	TRBJ2-1
TGTGCCAGCAGCAGGATTACTGCGGGGACGACAGATACGCAGTATTTT	CASSRITAGTTDTQYF	TRBV7-9	TRBJ2-3
TGTGCCAGCAGCTTATACGGGGGACAGTTCGACAGCTCTGGAAACACCATATATTTT	CASSLYGGQFDSSGNTIYF	TRBV7-2	TRBJ1-3
TGTGCCAGCAGTGAATCGGGAGGCTCTATTGGCTACACCTTC	CASSESGGSIGYTF	TRBV2	TRBJ1-2
TGTAGGGGGCGGGATGAAGCTTTCTTT	CRGRDEAFF	TRBV19	TRBJ1-1
TGTGCCAGCAGCTTCCGGGACATCGAGGTTTCTTATGGCTACACCTTC	CASSFRDIEVSYGYTF	TRBV7-4	TRBJ1-2
TGTGCCTGGAGCGGGCATGTAAACATTCAGTACTTC	CAWSGHVNIQYF	TRBV30	TRBJ2-4
TGTGCCAGCAGCGTAGATTGGCAGGGGGGGAACACTGAAGCTTTCTTT	CASSVDWQGGNTEAFF	TRBV9	TRBJ1-1
TGCGCCAGCGTCGGGGGGGGCACAGATACGCAGTATTTT	CASVGGGTDTQYF	TRBV10-1	TRBJ2-3
TGTGCCAGCAGCCGCGGTACTAACTATGGCTACACCTTC	CASSRGTNYGYTF	TRBV11-1	TRBJ1-2
TGTGCCAGCAGCGGCTGTCGGTCCAGGGGGCAGACCTACGAGCAGTACTTC	CASSGCRSRGQTYEQYF	TRBV7-9	TRBJ2-7
TGTGCCAGCAGCCAAGTGGGGGGCGTCTATGGCTACACCTTC	CASSQVGGVYGYTF	TRBV3-1	TRBJ1-2
TGTGCCTGGAAGTGCGAAAACATTCAGTACTTC	CAWKCENIQYF	TRBV30	TRBJ2-4
TGTGCCAGCAGCTTGAGAAGAGTCGAGACCCAGTACTTC	CASSLRRVETQYF	TRBV5-6	TRBJ2-5
TGCAGTGCGGAGGAGGGGGGCTGCAATCAGCCCCAGCATTTT	CSAEEGGCNQPQHF	TRBV20-1	TRBJ1-5
TGTGCCAGCAGCAGGGGTAGGCCTAGTTACGTTGGGTCTGATAGGGGGGACAATGAGCAGTTCTTC	CASSRGRPSYVGSDRGDNEQFF	TRBV7-3	TRBJ2-1
TGCAGTGCCAAAAACTACGAGCAGTACTTC	CSAKNYEQYF	TRBV20-1	TRBJ2-7
TGTGCTAGCAGCGGACAGGGCTTCGAGACCCAGTACTTC	CASSGQGFETQYF	TRBV7-7	TRBJ2-5
TGTGCTAGAGGCCCCCGGGGGCGGGAGGTTCTGAACACTGAAGCTTTCTTT	CARGPRGREVLNTEAFF	TRBV12-5	TRBJ1-1
TGTGCCAGCGCAGGAGACTACGAGCAGTACTTC	CASAGDYEQYF	TRBV25-1	TRBJ2-7
TGTGCCAGCTCACCACCCCACGCACCCGAGTATAGCAATCAGCCCCAGCATTTT	CASSPPHAPEYSNQPQHF	TRBV18	TRBJ1-5
TGTGCCAGCAGCCAAGTTGACCCGGGACAGGGGAATGAAAAACTGTTTTTT	CASSQVDPGQGNEKLFF	TRBV4-2	TRBJ1-4
TGTGCCAGCAGCCGTCCCGGAATTCCCAATCAGCCCCAGCATTTT	CASSRPGIPNQPQHF	TRBV4-2	TRBJ1-5
TGTGCCAGCAGTACCAGGGGGGATAATGAAAAACTGTTTTTT	CASSTRGDNEKLFF	TRBV6-1	TRBJ1-4
TGTGCCAGCAGCTCATGCCAAGTGCGGGGCGCCTACGAGCAGTACTTC	CASSSCQVRGAYEQYF	TRBV7-9	TRBJ2-7
TGTGCCTGGAGTAGACTAGCGGGTCTAAAGCGGTCCTACAATGAGCAGTTCTTC	CAWSRLAGLKRSYNEQFF	TRBV30	TRBJ2-1
TGTGCCAGCAGCCTTCGGGACGAAGAAAAACTGTTTTTT	CASSLRDEEKLFF	TRBV13	TRBJ1-4
TGTGCCAGCGGGGAGGCCAATGAGCAGTTCTTC	CASGEANEQFF	TRBV27	TRBJ2-1
TGTGCCAGCAGTTTAGTGGGGCTTACCAACGAGCAGTACTTC	CASSLVGLTNEQYF	TRBV27	TRBJ2-7
TGTGCCAGCAGTTCCCTCCCCCCGCTCGGGACACATGAAAAACTGTTTTTT	CASSSLPPLGTHEKLFF	TRBV28	TRBJ1-4
TGTGCCAGCTCACGATACCAGGGGGCTGGCTCCTACAATGAGCAGTTCTTC	CASSRYQGAGSYNEQFF	TRBV18	TRBJ2-1
TGCAACGGTCTCCAACAGCGAACTGATGGCTACACCTTC	CNGLQQRTDGYTF	TRBV20-1	TRBJ1-2
TGCAGTGCTAGAGGGGGGGGTAGGTACAATGAGCAGTTCTTC	CSARGGGRYNEQFF	TRBV20-1	TRBJ2-1
TGTGCGGGGGTGAACACTGAAGCTTTCTTT	CAGVNTEAFF	TRBV4-2	TRBJ1-1
TGTGCCAGCAGCTTAGTACCGAAGGGGGGCCACCACGGCAAAAACATTCAGTACTTC	CASSLVPKGGHHGKNIQYF	TRBV11-2	TRBJ2-4
TGTGCCAGCAGCCAATGGGGGTCGCGGAAAAGCAAAAACATTCAGTACTTC	CASSQWGSRKSKNIQYF	TRBV12-4	TRBJ2-4
TGTGCCAGTAGTCCCCCTCAGGGGATAGGCTATGGCTACACCTTC	CASSPPQGIGYGYTF	TRBV19	TRBJ1-2
TGCGCCCGAAAGACAGGATTCTTTGTAACCGGGGAGCTGTTTTTT	CARKTGFFVTGELFF	TRBV10-1	TRBJ2-2
TGTGCCAGCAGAAGTTTACCGGGGGCGGACGAGGAAGAGACCCAGTACTTC	CASRSLPGADEEETQYF	TRBV6-5	TRBJ2-5
TGTGCCAGCAGCACTAGCGGGAGAGGGCAAGAGACCCAGTACTTC	CASSTSGRGQETQYF	TRBV13	TRBJ2-5
TGTGCCAGCAGAGCGGGAGAGGAGGGTACTGGTGAAAAACTGTTTTTT	CASRAGEEGTGEKLFF	TRBV7-6	TRBJ1-4
TGTGCCAGCAGTTACTCTGGGGGTCCTGAGACCCAGTACTTC	CASSYSGGPETQYF	TRBV6-6	TRBJ2-5
TGCAGTGCTTGCGGCTGGGGGCGCCCCTCAAGAAAGCAGCCCCAGCATTTT	CSACGWGRPSRKQPQHF	TRBV20-1	TRBJ1-5
TGTGCCAGCAGCGTAGGCAACATCGACGGGACAGAGGGCACAGATACGCAGTATTTT	CASSVGNIDGTEGTDTQYF	TRBV9	TRBJ2-3
TGTGCCAGCAGTGTCCCAAATGGAGAGACTAGCGGGTCCCCTGGCTACAATGAGCAGTTCTTC	CASSVPNGETSGSPGYNEQFF	TRBV28	TRBJ2-1
TGTGCCAGCAGCTTATTGTACGGGACAATCTGTAACTATGGCTACACCTTC	CASSLLYGTICNYGYTF	TRBV7-4	TRBJ1-2
TGTGCCAGCAGCTTACACCGACAGGGGGATTATAGCAATCAGCCCCAGCATTTT	CASSLHRQGDYSNQPQHF	TRBV11-2	TRBJ1-5
TGTGCCAGCAGTTCCCCGAATCGCGTTTTCTACGAGCAGTACTTC	CASSSPNRVFYEQYF	TRBV6-1	TRBJ2-7
TGTGCCAGCAGTACGGAAAGCGGGACAGGGAGTCAGCCCCAGCATTTT	CASSTESGTGSQPQHF	TRBV27	TRBJ1-5
TGTGCCAGCTCAGGCCTGCCTAGCAATCAGCCCCAGCATTTT	CASSGLPSNQPQHF	TRBV18	TRBJ1-5
TGTGCCAGCAGCTACTCGGGACAGCTATTCCAGCCCCAGCATTTT	CASSYSGQLFQPQHF	TRBV5-4	TRBJ1-5
TGCGCCAGCAGCTACAAGGGGGCTAACACTGAAGCTTTCTTT	CASSYKGANTEAFF	TRBV5-1	TRBJ1-1
TGTGCCAGCAGCAGGCGGGACAGGGAACTGGGGAGGAGACCAACTGAAGCTTTCTTT	CASSRRDRELGRRPTEAFF	TRBV7-9	TRBJ1-1
TGTGCCAGCAGGCGGGAGGTTTCCTACGAGCAGTACTTC	CASRREVSYEQYF	TRBV6-5	TRBJ2-7
TGCGCCAGCCTTAAGTTAGGCTGCGTAAGGGACGGGGAGCTGTTTTTT	CASLKLGCVRDGELFF	TRBV5-1	TRBJ2-2
TGTGCCAGCAGCGGGAGGGATAGCAATCAGCCCCAGCATTTT	CASSGRDSNQPQHF	TRBV28	TRBJ1-5
TGTGCCAGCAGCTTAACACCCGGACAGGGGGCGTTTATCTACGAGCAGTACTTC	CASSLTPGQGAFIYEQYF	TRBV7-6	TRBJ2-7
TGTGCCAGCAGCCAAGCCTTAGCGGGGGACTACCCGGAGCTGTTTTTT	CASSQALAGDYPELFF	TRBV4-2	TRBJ2-2
TGTGCCAGCAGCTCACTCGACTGCTACGAGCAGTACTTC	CASSSLDCYEQYF	TRBV11-3	TRBJ2-7
TGCGCCAGCAACATAGCTCACGGCTATGGCTACACCTTC	CASNIAHGYGYTF	TRBV5-1	TRBJ1-2
TGCGCCAGCAGCTTGCTCACGGAGGTCGGGACAGGGGACCGTCCTAACGAGCAGTACTTC	CASSLLTEVGTGDRPNEQYF	TRBV5-1	TRBJ2-7
TGTGCCAGCAGCGGGAGCGGGAATACTGAAGCTTTCTTT	CASSGSGNTEAFF	TRBV9	TRBJ1-1
TGTGCCACCAGTGATTTAGGTCCCAGAGGGGGACGGAGGGGCTACACCTTC	CATSDLGPRGGRRGYTF	TRBV24-1	TRBJ1-2
TGCAGTGCCTGGACTAGCGGGGGAGAGGTCTACGAGCAGTACTTC	CSAWTSGGEVYEQYF	TRBV20-1	TRBJ2-7
TGTGCTAGTGGTTTGGTACGAAAACAGGTTATCTACGAGCAGTACTTC	CASGLVRKQVIYEQYF	TRBV12-5	TRBJ2-7
TGCGCCAGCAGTGCTCCGGGACAGAGGTATGGCTACACCTTC	CASSAPGQRYGYTF	TRBV10-2	TRBJ1-2
TGTGCCAGCAGTTACTCCTCTACACGGGGAAACACCATATATTTT	CASSYSSTRGNTIYF	TRBV6-5	TRBJ1-3
TGTGCCAGCAGACAGGGACAGGGGGCGCGGGGCGGACCCTACGAGCAGTACTTC	CASRQGQGARGGPYEQYF	TRBV12-3	TRBJ2-7
TGCAGCGAGACCACAGACCAGCCTTCTGGAAACACCATATATTTT	CSETTDQPSGNTIYF	TRBV29-1	TRBJ1-3
TGTGCCAGCAGCTTGGAGGCAGACCGGGTAATGCCCATGAACACTGAAGCTTTCTTT	CASSLEADRVMPMNTEAFF	TRBV5-4	TRBJ1-1
TGTGCCAGCAGTTTACGGGGGGGCCCCTCCTCCTACAATGAGCAGTTCTTC	CASSLRGGPSSYNEQFF	TRBV27	TRBJ2-1
TGTGCCAGCAGTGACTCGTGTGTCCTCGCCCTAGCGGGCGGGAGCTCCTACAATGAGCAGTTCTTC	CASSDSCVLALAGGSSYNEQFF	TRBV6-4	TRBJ2-1
TGTGCCAGCAGTTTACTTCTGGGGGGGGGCGGAAACACCGGGGAGCTGTTTTTT	CASSLLLGGGGNTGELFF	TRBV27	TRBJ2-2
TGTGCCAGCAGGTGCGGCGGGGGGGTCTATAATTCACCCCTCCACTTT	CASRCGGGVYNSPLHF	TRBV6-5	TRBJ1-6
TGTGCCAGCAGCGTGCAACGGGGGGGAGCGGAGAGGTACGAGCAGTACTTC	CASSVQRGGAERYEQYF	TRBV9	TRBJ2-7
TGTGCCAGCAGGAGGAGCAGGGAAATGAACACTGAAGCTTTCTTT	CASRRSREMNTEAFF	TRBV6-5	TRBJ1-1
TGTGCCAGCAGCCCATCCGGGACAGATACGCAGTATTTT	CASSPSGTDTQYF	TRBV7-3	TRBJ2-3
TGTGCCAGCAGCAAGGGGACTAGCGGGACATACAATGAGCAGTTCTTC	CASSKGTSGTYNEQFF	TRBV7-9	TRBJ2-1
TGTGCCAGCAGCTCAGGGGGTTACGAGCAGTACTTC	CASSSGGYEQYF	TRBV11-3	TRBJ2-7
TGTGCCAGCAGCCCGTGGGGGTACTATGGCTACACCTTC	CASSPWGYYGYTF	TRBV6-5	TRBJ1-2
TGTGCCACCAGTGATTTGAGCGGGACCATCCAAATGTTGCCCCAGCATTTT	CATSDLSGTIQMLPQHF	TRBV24-1	TRBJ1-5
TGTGCCTGGACACAAGCGGGAGGCACAGATACGCAGTATTTT	CAWTQAGGTDTQYF	TRBV30	TRBJ2-3
TGCAGTGCTCAGGCGGGAGTGGGCTATGGCTACACCTTC	CSAQAGVGYGYTF	TRBV20-1	TRBJ1-2
TGTGCCAGCAGTTGGCAACCCTACGAGCAGTACTTC	CASSWQPYEQYF	TRBV27	TRBJ2-7
TGTGCCAGCAGCGTATATCCAACCCGGGGGGGCGGAAGAGTCGACGAGCAGTACTTC	CASSVYPTRGGGRVDEQYF	TRBV9	TRBJ2-7
TGTGCCAGCAGCTATTTAAGGGACAGGGCACAGGTCTCAGATACGCAGTATTTT	CASSYLRDRAQVSDTQYF	TRBV7-9	TRBJ2-3
TGTGCCAGCAGTTACTCGGCCGTGCCGGCAAACAGCTCCTATAATTCACCCCTCCACTTT	CASSYSAVPANSSYNSPLHF	TRBV6-5	TRBJ1-6
TGTGCCAGCAGCACCGGGGACAAGCAGTACTTC	CASSTGDKQYF	TRBV7-9	TRBJ2-5
TGTGCCAGCAGCTCAAGGGGGCCGGGTGGGGTGAGAGCGATGAACACTGAAGCTTTCTTT	CASSSRGPGGVRAMNTEAFF	TRBV7-3	TRBJ1-1
TGTGCCAGCAGCATAACCGTTAATCGGGAGGGCAGGAACACCGGGGAGCTGTTTTTT	CASSITVNREGRNTGELFF	TRBV6-3	TRBJ2-2
TGTGCCAGCAGACGTTCAAGGGACAGTAATATATGGGAGACCCAGTACTTC	CASRRSRDSNIWETQYF	TRBV11-3	TRBJ2-5
TGCACCGGACAGAGGCCCCAGCATTTT	CTGQRPQHF	TRBV20-1	TRBJ1-5
TGTGCCAGCAGCTTGAGGCTCCCGCGAGCTTTCTTT	CASSLRLPRAFF	TRBV5-6	TRBJ1-1
TGCAGTGCTAGAGATCATAGACCTAACACCGGGGAGCTGTTTTTT	CSARDHRPNTGELFF	TRBV20-1	TRBJ2-2
TGCGCCAGCAGCGGACAGGGGGCACCCGCCGGGGCCAACGTCCTGACTTTC	CASSGQGAPAGANVLTF	TRBV5-1	TRBJ2-6
TGTGCCAGCAGGAAGGACAGTTCCGCCGGTTGCTTCTCTGGGGCCAACGTCCTGACTTTC	CASRKDSSAGCFSGANVLTF	TRBV12-3	TRBJ2-6
TGTGCCAGCAGCCAGATGATCTCCCTCCACTTT	CASSQMISLHF	TRBV7-9	TRBJ1-6
TGTGCCAGCGCCCCTAGCGGGGGTGAGACCCAGTACTTC	CASAPSGGETQYF	TRBV13	TRBJ2-5
TGTGCCAGCAGCGCCGGGGGATCCTACGAGCAGTACTTC	CASSAGGSYEQYF	TRBV9	TRBJ2-7
TGCGCCAGCAGCTTGGGAAGCCCGGCGGATGTGAGTAGCAATCAGCCCCAGCATTTT	CASSLGSPADVSSNQPQHF	TRBV5-1	TRBJ1-5
TGTGCCAGCAGGTCCCGGAACACTGAAGCTTTCTTT	CASRSRNTEAFF	TRBV9	TRBJ1-1
TGCGCCAGCAGCCAAGAGGGGGGGCGGGACCAAGAGACCCAGTACTTC	CASSQEGGRDQETQYF	TRBV4-3	TRBJ2-5
TGCAGCGTCGCGGGGACAAACACAGATACGCAGTATTTT	CSVAGTNTDTQYF	TRBV29-1	TRBJ2-3
TGTGCCACCACCCCGGTTGAGACCCAGTACTTC	CATTPVETQYF	TRBV24-1	TRBJ2-5
TGTGCCAGCAGTGACGGGACAGGCAGGACTAACGCCTACGAGCAGTACTTC	CASSDGTGRTNAYEQYF	TRBV6-4	TRBJ2-7
TGCGCCAGCAGCGGTGTCCGGGACAGGGAGATAGAGACCCAGTACTTC	CASSGVRDREIETQYF	TRBV5-1	TRBJ2-5
TGTGCCAGCAGCTGGGGGACTAGCGGGATAAATGAGCAGTTCTTC	CASSWGTSGINEQFF	TRBV7-3	TRBJ2-1
TGTGCCAGCATCCTACAGGGAAGTAACACTGAAGCTTTCTTT	CASILQGSNTEAFF	TRBV12-4	TRBJ1-1
TGTGCCACCAGATTCGGGGGGCCCGCAGTCTTC	CATRFGGPAVF	TRBV24-1	TRBJ2-1
TGTGCCAGCAGGTGCGGCCCGGGCACAGATACGCAGTATTTT	CASRCGPGTDTQYF	TRBV6-2	TRBJ2-3
TGCGCCAGCAGCTTACGGGATAGGCCCCTCTATGGCTACACCTTC	CASSLRDRPLYGYTF	TRBV5-1	TRBJ1-2
TGTGCCAGCGCTACTAGCGGGTTCGAAAGAGGGGAGCTGTTTTTT	CASATSGFERGELFF	TRBV28	TRBJ2-2
TGTGCCAGCAGTGTGACACAGGGGGCATCCGAGCATTTT	CASSVTQGASEHF	TRBV6-2	TRBJ1-5
TGTGCCAGCAGTGAAAGCTCAGGTTCCGAGGGATTACCTGAAGCTTTCTTT	CASSESSGSEGLPEAFF	TRBV25-1	TRBJ1-1
TGCGCCAGCAGCTTGGGACAGGGCTACACCTTC	CASSLGQGYTF	TRBV5-1	TRBJ1-2
TGCGCCAGCAGTGACGCACGCAGGGATGGCTACACCTTC	CASSDARRDGYTF	TRBV10-1	TRBJ1-2
TGTGCCAGCAGATTTGACAGGGCTGAAGCTTTCTTT	CASRFDRAEAFF	TRBV6-1	TRBJ1-1
TGTGCCAGTAGTATGAGGCAGCAAAAGGACAGGGGGCGAGGGGGAGCTGTGTACCAAGAGACCCAGTACTTC	CASSMRQQKDRGRGGAVYQETQYF	TRBV19	TRBJ2-5
TGTGCCAGTAGTACCTCCTTGCCACGGGAAGCAACAGATACGCAGTATTTT	CASSTSLPREATDTQYF	TRBV19	TRBJ2-3
TGTGCCAGCAGCCAAGATCCCATTTCGGGGCCTCAGCCCCAGCATTTT	CASSQDPISGPQPQHF	TRBV14	TRBJ1-5
TGTGCCAGCAGCCCCAGGGACTATGGCTACACCTTC	CASSPRDYGYTF	TRBV7-2	TRBJ1-2
TGTGCCAGCAGTTACGCTACTGGTGCGAAGAAGAGGTCTGAAGCTTTCTTT	CASSYATGAKKRSEAFF	TRBV6-8	TRBJ1-1
TGTGCCAGCAGCCAAGATATCGGGACTAGCGGGCATCCTGACGAGCAGTACTTC	CASSQDIGTSGHPDEQYF	TRBV14	TRBJ2-7
TGTGCCAGCAGCATACCGTTTCTAGTGGCAGATACGCAGTATTTT	CASSIPFLVADTQYF	TRBV3-1	TRBJ2-3
TGCGCCAGCAGCCAAGAGGGAAGGAATGAAAAACTGTTTTTT	CASSQEGRNEKLFF	TRBV4-3	TRBJ1-4
TGTGCCAGTAGTTCCACGTCCGGGGGGGCCCGAGATACGCAGTATTTT	CASSSTSGGARDTQYF	TRBV19	TRBJ2-3
TGTGCCAGCAGCGCCCATTACGGACTAGCCTCTCAAGAGACCCAGTACTTC	CASSAHYGLASQETQYF	TRBV12-4	TRBJ2-5
TGTGCCATCCCCTGGACAGGAGGGGGCAATCAGCCCCAGCATTTT	CAIPWTGGGNQPQHF	TRBV10-3	TRBJ1-5
TGTGCCAGCAGCCAAGGCGATACTAGCGGGGGGGCCGCATCCTACGAGCAGTACTTC	CASSQGDTSGGAASYEQYF	TRBV3-1	TRBJ2-7
TGTGCCAGCAGCCAAGAACGGCAGCCCCAGCATTTT	CASSQERQPQHF	TRBV14	TRBJ1-5
TGTGCCAGTAGTATGGTAGGTCCTCGAAAGGTAAATTCACCCCTCCACTTT	CASSMVGPRKVNSPLHF	TRBV19	TRBJ1-6
TGTGCCAGCAGCCTACAATTGGGGTTCTACGAGCAGTACTTC	CASSLQLGFYEQYF	TRBV14	TRBJ2-7
TGTGCCAGCAGTTTAGCCCCCCCCTTGTCATCAGTCCGGCAAAGCAATCAGCCCCAGCATTTT	CASSLAPPLSSVRQSNQPQHF	TRBV28	TRBJ1-5
TGTGCCAGCAGCCAAGAAGCAGGGGGGGTTAACACTGAAGCTTTCTTT	CASSQEAGGVNTEAFF	TRBV14	TRBJ1-1
TGTGCCAGCAGCCCGACGTACATCCAGTACTTC	CASSPTYIQYF	TRBV7-9	TRBJ2-5
TGCAGTGCTAGAGTGGCTAGCGGGCCGAACAATGAGCAGTTCTTC	CSARVASGPNNEQFF	TRBV20-1	TRBJ2-1
TGTGCCAGCAGCTGGGACAGGGCCCAGCATTTT	CASSWDRAQHF	TRBV7-9	TRBJ1-5
TGTGCTAGCAGCTTAGCGCTTTCGTGTCCCTACGAGCAGTACTTC	CASSLALSCPYEQYF	TRBV7-7	TRBJ2-7
TGTGCCAGAGACGTCGGGACTAGCGGGGGGGCGCCCACAGATACGCAGTATTTT	CARDVGTSGGAPTDTQYF	TRBV7-2	TRBJ2-3
TGTGCCAGCTCACTGGATGGACTAGCGTCCTACGAGCAGTACTTC	CASSLDGLASYEQYF	TRBV18	TRBJ2-7
TGTGCCAGCGGTCAGGGTAGCAATCAGCCCCAGCATTTT	CASGQGSNQPQHF	TRBV6-4	TRBJ1-5
TGTGCCAGCAATTCCCCGGGGGTAATTTCTAGCACAGATACGCAGTATTTT	CASNSPGVISSTDTQYF	TRBV6-4	TRBJ2-3
TGTGCCAGCAGTTTATTGGCGGGGCGGTCCTACGAGCAGTACTTC	CASSLLAGRSYEQYF	TRBV27	TRBJ2-7
TGCAGTGCTAGCGGTACTAGCGGGCCTATATGCACAGATACGCAGTATTTT	CSASGTSGPICTDTQYF	TRBV20-1	TRBJ2-3
TGTGCCAGCAGATCCGGGACTAGCGGGGGAGGCACAGATACGCAGTATTTT	CASRSGTSGGGTDTQYF	TRBV13	TRBJ2-3
TGTGCCAGTACTTGTAGCTACGTCTTC	CASTCSYVF	TRBV19	TRBJ2-1
TGTGCCAGCAGCAGGGGGACAGGGATTTCACCCCTCCACTTT	CASSRGTGISPLHF	TRBV7-2	TRBJ1-6
TGTGCCAGCAGTTACCCGGGGTCCTGCTACGAGCAGTACTTC	CASSYPGSCYEQYF	TRBV6-5	TRBJ2-7
TGTGCTAGTGGGTCCGGGACAGAAGATACGCAGTATTTT	CASGSGTEDTQYF	TRBV12-5	TRBJ2-3
TGTGCCAGCAGTTTCAAGAGGAACCGATCCTACGAGCAGTACTTC	CASSFKRNRSYEQYF	TRBV28	TRBJ2-7
TGTGCCACCAGCGGAGAACCGGGACAGCACACCGGGGAGCTGTTTTTT	CATSGEPGQHTGELFF	TRBV15	TRBJ2-2
TGTGCCAGCAGCGGGAACGGGGACCCCAATGAGCAGTTCTTC	CASSGNGDPNEQFF	TRBV13	TRBJ2-1
TGCAGCGTTGACCCTCTCGGACTAGCCGTAGTAGCCAAAAACATTCAGTACTTC	CSVDPLGLAVVAKNIQYF	TRBV29-1	TRBJ2-4
TGCAGCGTTGACGGGACAGGCGGGAACACTGAAGCTTTCTTT	CSVDGTGGNTEAFF	TRBV29-1	TRBJ1-1
TGTGCCAGCAGCCCTTGGAGCGGACAGGGAGAGAACACTGAAGCTTTCTTT	CASSPWSGQGENTEAFF	TRBV7-9	TRBJ1-1
TGTGCCAGCAGCGGGTCAGGACAGTTGAGTGGCTACACCTTC	CASSGSGQLSGYTF	TRBV13	TRBJ1-2
TGTGCCAGCAGCCGCGGGAGGGCCCTCGAGCTGGAATGTCGGTGGCCCTCGCAGCCCCAGCATTTT	CASSRGRALELECRWPSQPQHF	TRBV3-1	TRBJ1-5
TGTGCCAGCAGCGGACAGTTAGGCTATGAGCAGTTCTTC	CASSGQLGYEQFF	TRBV13	TRBJ2-1
TGCGCCAGCAGCTTGGGTGGGACTTTGAACACTGAAGCTTTCTTT	CASSLGGTLNTEAFF	TRBV5-1	TRBJ1-1
TGTGCCAGTAGTAATTTACGTACTGGAAACACCATATATTTT	CASSNLRTGNTIYF	TRBV19	TRBJ1-3
TGTGCCAGCAGCCAAAAGGGACAATGGACAGGGTGTCAAGAGACCCAGTACTTC	CASSQKGQWTGCQETQYF	TRBV14	TRBJ2-5
TGTGCCAGCAGCCTAAGGACAGGGGCCATCAACTATGGCTACACCTTC	CASSLRTGAINYGYTF	TRBV13	TRBJ1-2
TGTGCCAGCAGCGGGGGGACTAACTATGGCTACACCTTC	CASSGGTNYGYTF	TRBV13	TRBJ1-2
TGTGCCAGCAGTTACGTGGGGGGGGTCGTGAACACTGAAGCTTTCTTT	CASSYVGGVVNTEAFF	TRBV6-3	TRBJ1-1
TGTGCCAGCAGCGTAGACAGATGGGGGTACACTGAAGCTTTCTTT	CASSVDRWGYTEAFF	TRBV9	TRBJ1-1
TGTGCCACCAGCAGAGATCATAAGACGGACCTAGCCAAAAACATTCAGTACTTC	CATSRDHKTDLAKNIQYF	TRBV15	TRBJ2-4
TGTGCCAGCTCACCGGATCTCGATGAAGCTTTCTTT	CASSPDLDEAFF	TRBV18	TRBJ1-1
TGTGCCAGCAGCAGGATTGGGACAGGGCAGCCCCAGCATTTT	CASSRIGTGQPQHF	TRBV5-5	TRBJ1-5
TGTGCCAGCAGTAAACCACAGGGAAGGTACGAGCAGTACTTC	CASSKPQGRYEQYF	TRBV6-3	TRBJ2-7
TGTGCCAGCAGCTCCCCACAGGGGTGGCCGAACACCGGGGAGCTGTTTTTT	CASSSPQGWPNTGELFF	TRBV13	TRBJ2-2
TGTGCCAGCATCCAGGAGGGACGCTTC	CASIQEGRF	TRBV9	TRBJ1-2
TGTGCCAGCAGCTTAGCGCCGATCGGCTCCTACGAGCAGTACTTC	CASSLAPIGSYEQYF	TRBV7-7	TRBJ2-7
TGTGCCAGCAGTGGGACAGGAGGCTACGAGCAGTACTTC	CASSGTGGYEQYF	TRBV6-4	TRBJ2-7
TGTGCCACCAGTGGCGGCAGGGGCTCGAGCTCCTACGAGCAGTACTTC	CATSGGRGSSSYEQYF	TRBV24-1	TRBJ2-7
TGTGCCAGCAGCCAAGAGGAACCCCTGGAACCATGTATAAGGGACAGGGGACTTGGCTCTGGGGCCAACGTCCTGACTTTC	CASSQEEPLEPCIRDRGLGSGANVLTF	TRBV3-1	TRBJ2-6
TGTGCCAGCAGCCAAGGGGGGGGGGGGAACACTGAAGCTTTCTTT	CASSQGGGGNTEAFF	TRBV14	TRBJ1-1
TGTGCCAGCACAGGACAGATGAGTAGCTCCTACGAGCAGTACTTC	CASTGQMSSSYEQYF	TRBV28	TRBJ2-7
TGTGCCAGCAGCAATGGACTAGCGGGCAAGCCCGGGGAGCTGTTTTTT	CASSNGLAGKPGELFF	TRBV12-3	TRBJ2-2
TGTGCCAGCAGCGTGCCCTCGGGGACAGGGATGAACACTGAAGCTTTCTTT	CASSVPSGTGMNTEAFF	TRBV9	TRBJ1-1
TGTGCCAGCAGCTTCCCTCAGGGGAAGGATCAGCCCCAGCATTTT	CASSFPQGKDQPQHF	TRBV7-4	TRBJ1-5
TGTGCCACCCCGGCCACGGGGCCCAGGAAGAATGAAAAACTGTTTTTT	CATPATGPRKNEKLFF	TRBV24-1	TRBJ1-4
TGTGCTAGCAGCTTAGTGGACCGTGGGGGGGGCTGGGGGCGCTCCTACGAGCAGTACTTC	CASSLVDRGGGWGRSYEQYF	TRBV7-7	TRBJ2-7
TGTGCCAGCAGCCGTGACAGGTCTCATGGCTACACCTTC	CASSRDRSHGYTF	TRBV7-9	TRBJ1-2
TGCAGTGCTATGGCTAGGGGGAGCTCCTACAATGAGCAGTTCTTC	CSAMARGSSYNEQFF	TRBV20-1	TRBJ2-1
TGTGCCAGCTCACCGCGGGAGATTTCCGCCCCTATGGCTAACTATGGCTACACCTTC	CASSPREISAPMANYGYTF	TRBV18	TRBJ1-2
TGTGCCAGCAGTGCCGGGGGGGGGGACTATGGCTACACCTTC	CASSAGGGDYGYTF	TRBV6-4	TRBJ1-2
TGCGCCAGCAGCCAAGAGAAAACACGGACTAGCGGGGTTTACCCCGCCGGGAACACCGGGGAGCTGTTTTTT	CASSQEKTRTSGVYPAGNTGELFF	TRBV4-3	TRBJ2-2
TGCAGTGCCCCGCGGGGGGGGAACTATGGCTACACCTTC	CSAPRGGNYGYTF	TRBV20-1	TRBJ1-2
TGCGCCAGCAATTGGGGGGGAAAAGTCTTATCCTACGAGCAGTACTTC	CASNWGGKVLSYEQYF	TRBV5-1	TRBJ2-7
TGTGCCAGCAGCTCCCAATTGGAGCGCCTGCGCTCCTACGAGCAGTACTTC	CASSSQLERLRSYEQYF	TRBV11-3	TRBJ2-7
TGTGCCAGCAGCTGGGGGGTTCGCCGTGGACTAGACGAAAACATTCAGTACTTC	CASSWGVRRGLDENIQYF	TRBV7-9	TRBJ2-4
TGCGCCAGCAGCCAAGATAGGGATCATGAAGCTTTCTTT	CASSQDRDHEAFF	TRBV4-3	TRBJ1-1
TGCAGTGCTAGTAAGGACCCAAAGTTGAAGCGTAGCAATCAGCCCCAGCATTTT	CSASKDPKLKRSNQPQHF	TRBV20-1	TRBJ1-5
TGCGCCAGCAGCGAGTACACAACCGGACCAAATGAGCAGTTCTTC	CASSEYTTGPNEQFF	TRBV10-1	TRBJ2-1
TGTGCCAGCAGCTTACCCCTTCGTAAGGGGGGAATCAGTGAGGAAAGTGGGGGCCTTTTCCAGCCCCAGCATTTT	CASSLPLRKGGISEESGGLFQPQHF	TRBV7-9	TRBJ1-5
TGCGCCAGCAGCCGGCCCAGGGACGTTAATAACACCGGGGAGCTGTTTTTT	CASSRPRDVNNTGELFF	TRBV4-1	TRBJ2-2
TGTGCCAGCAGTAAGGGACAGGAGGAAGGGTTAGGGCAGTACTTC	CASSKGQEEGLGQYF	TRBV6-1	TRBJ2-7
TGTGCCAGCAGTGAAATGGGGGACGGGACAGAAGGTGGAAACACCATATATTTT	CASSEMGDGTEGGNTIYF	TRBV25-1	TRBJ1-3
TGTGCCAGCAGCACTAAGTCGACTAGCAAACGGGTGTATTTT	CASSTKSTSKRVYF	TRBV11-2	TRBJ2-3
TGCGCCAGCAGCTTGTATTGCAGGCTCCCAGGCTCTGGGGCCAACGTCCTGACTTTC	CASSLYCRLPGSGANVLTF	TRBV5-1	TRBJ2-6
TGCGCCAGCAGAAATTCAATAATCTATGGCTACACCTTC	CASRNSIIYGYTF	TRBV5-1	TRBJ1-2
TGTGCCAGCTCTCGGGACAGGATTAAGAGGAATGAGCAGTTCTTC	CASSRDRIKRNEQFF	TRBV18	TRBJ2-1
TGCGCCAGCAGCGACAGGGGGATTAATGAAAAACTGTTTTTT	CASSDRGINEKLFF	TRBV5-1	TRBJ1-4
TGTGCCAGCAGTTATAACACCCCAACTTCACCCCTCCACTTT	CASSYNTPTSPLHF	TRBV6-9	TRBJ1-6
TGTGCTAGTGGTCGCAAGTGGACAGGCCTATTCCTGCTAGCCAAAAACATTCAGTACTTC	CASGRKWTGLFLLAKNIQYF	TRBV12-5	TRBJ2-4
TGTGCCAGCAGTTACTCGCAAGAGGGACAGGGATACGGCTACTATGGCTACACCTTC	CASSYSQEGQGYGYYGYTF	TRBV6-5	TRBJ1-2
TGTGCCAGTAGTACAGGACCCCAGGGGGAGCTGTTTTTT	CASSTGPQGELFF	TRBV19	TRBJ2-2
TGTGCCAGCAGCCTCCCCTACAGGGGGCAAGCTGATACGCAGTATTTT	CASSLPYRGQADTQYF	TRBV7-2	TRBJ2-3
TGTAAGGGGATTGGCCGTAATCAGCCCCAGCATTTT	CKGIGRNQPQHF	TRBV7-2	TRBJ1-5
TGTGCCACCAGTGAGGCGAAGGTGAGAAGGGTTGTGAACACTGAAGCTTTCTTT	CATSEAKVRRVVNTEAFF	TRBV24-1	TRBJ1-1
TGTTCCCCGGACAATCAGCCCCAGCATTTT	CSPDNQPQHF	TRBV19	TRBJ1-5
TGTGCCACCAGTGATTCGGCAGGGCAGCCCCAGCATTTT	CATSDSAGQPQHF	TRBV24-1	TRBJ1-5
TGTGCCAGCAGGGCCCGTGGGACGGGGAACACCGGGGAGCTGTTTTTT	CASRARGTGNTGELFF	TRBV7-7	TRBJ2-2
TGTGCCAGCAGCCAGCCGGGGGGTCCCACCGGGGAGCTGTTTTTT	CASSQPGGPTGELFF	TRBV4-2	TRBJ2-2
TGCGCCAGCAGCCAAGATCTAGGCCGCGACAGGGGGGACGGGATCCGAGGCTTCTCTGGAAACACCATATATTTT	CASSQDLGRDRGDGIRGFSGNTIYF	TRBV4-1	TRBJ1-3
TGTGCCAGCAGCGTAGGCACTCCTAGCGGGCACGGGGAGCTGTTTTTT	CASSVGTPSGHGELFF	TRBV9	TRBJ2-2
TGTGCCAGCAGTTCCGAACCGGGACTAGGCTCCTACGAGCAGTACTTC	CASSSEPGLGSYEQYF	TRBV6-6	TRBJ2-7
TGTGCCAGGCCGGGACAGGGGACTGAAGCTTTCTTT	CARPGQGTEAFF	TRBV6-4	TRBJ1-1
TGTGCCAGCAGTTCTAAGTTGGAGCAGTTCTTC	CASSSKLEQFF	TRBV13	TRBJ2-1
TGTGCCAGCTCACCACGAGACGAGGTCTTCTGGACTAGCGGGGGGGCCGGGGTACGCTACGAGCAGTACTTC	CASSPRDEVFWTSGGAGVRYEQYF	TRBV18	TRBJ2-7
TGTGCCACCCATGGCGGGGAGGGCTACGAGCAGTACTTC	CATHGGEGYEQYF	TRBV24-1	TRBJ2-7
TGTGCCAGCAGCCGGCATAGTCAGGGGAATCCGGCCTACGAGCAGTACTTC	CASSRHSQGNPAYEQYF	TRBV14	TRBJ2-7
TGTGCCAGTAGTATGGGGGACAATGAAAAACTGTTTTTT	CASSMGDNEKLFF	TRBV19	TRBJ1-4
TGTGCCAGCAGCTTAGACCGGGACAGGGGATACTACACCTTC	CASSLDRDRGYYTF	TRBV7-4	TRBJ1-2
TGTGCCACCAGCAGAGATGGGCAGGGGTTAAAGCCTAACTATGGCTACACCTTC	CATSRDGQGLKPNYGYTF	TRBV15	TRBJ1-2
TGTGCCAGCAGCACCTCAGGGGACTATGGCTACACCTTC	CASSTSGDYGYTF	TRBV13	TRBJ1-2
TGTGCCAGCAGTTTATCGACTGGCCGGGGGGATGAGCAGTTCTTC	CASSLSTGRGDEQFF	TRBV27	TRBJ2-1
TGCGCCTCCTGGACGTCAGCTAACTATGGCTACACCTTC	CASWTSANYGYTF	TRBV4-3	TRBJ1-2
TGTGCCAGCAGCAGAGGGAGTCACGAGGCTTATAGCAATCAGCCCCAGCATTTT	CASSRGSHEAYSNQPQHF	TRBV7-6	TRBJ1-5
TGTGCCAGCAGCTTAGCCAACCAAACTAGCGAGCGCACAGATACGCAGTATTTT	CASSLANQTSERTDTQYF	TRBV7-2	TRBJ2-3
TGTGCCTGGAGTGGGTCTCCTCTGGGCACTGAAGCTTTCTTT	CAWSGSPLGTEAFF	TRBV30	TRBJ1-1
TGTGCCAGCAGCCAAGATTGGGGGGGGGGAGTTGAGACCCAGTACTTC	CASSQDWGGGVETQYF	TRBV3-1	TRBJ2-5
TGCAGTGCTAGAGGGCGGACAGTGACAGATACGCAGTATTTT	CSARGRTVTDTQYF	TRBV20-1	TRBJ2-3
TGTGCCAGCAGCGGTAAGGGACATTGCGAACAGCCCCAGCATTTT	CASSGKGHCEQPQHF	TRBV9	TRBJ1-5
TGTGCCAGCAGCGTCAGTCCGTTAGATAATTCACCCCTCCACTTT	CASSVSPLDNSPLHF	TRBV7-6	TRBJ1-6
TGTGCCAGCAAATCGACCCAGAGCAGCTACGAGCAGTACTTC	CASKSTQSSYEQYF	TRBV14	TRBJ2-7
TGTGCCAGCAGTGAGGCGGGACATGAAGAGACCCAGTACTTC	CASSEAGHEETQYF	TRBV6-1	TRBJ2-5
TGTGCCAGCAGCTGGGGACATAGCTACGAGCAGTACTTC	CASSWGHSYEQYF	TRBV7-9	TRBJ2-7
TGTGCCAGCAGCTCCAGGTGGGGTCGCTACAATGAGCAGTTCTTC	CASSSRWGRYNEQFF	TRBV7-3	TRBJ2-1
TGTGCCAGCAGTCCTGGCACAGATACGCAGTATTTT	CASSPGTDTQYF	TRBV6-4	TRBJ2-3
TGTGCCAGCAGCGGCGGGGTCCCAGGGCCCTACGAGCAGTACTTC	CASSGGVPGPYEQYF	TRBV7-4	TRBJ2-7
TGTGCCATCAGTGACCCAGGGGGGGGGCCCTTCAACAATGAGCAGTTCTTC	CAISDPGGGPFNNEQFF	TRBV10-3	TRBJ2-1
TGTGCCAGCAGCCGAGGGACAAACGGAAAACTGTTTTTT	CASSRGTNGKLFF	TRBV5-4	TRBJ1-4
TGTGCCAGCAGCCTCACAGACAGGGTAAGCTCCTACGAGCAGTACTTC	CASSLTDRVSSYEQYF	TRBV7-6	TRBJ2-7
TGTGCCAGCAAACGCAGGCTAGCCCGTCCTTCACCCCTCCACTTT	CASKRRLARPSPLHF	TRBV7-9	TRBJ1-6
TGTGTCCCCACAGGGGTCTATGGCTACACCTTC	CVPTGVYGYTF	TRBV4-2	TRBJ1-2
TGTGCCACCAGTGAGTTACATGGTCAGACTAGCGGGACCTACGAGCAGTACTTC	CATSELHGQTSGTYEQYF	TRBV24-1	TRBJ2-7
TGTGCCAGCAGCTCATTGGACACAGATACGCAGTATTTT	CASSSLDTDTQYF	TRBV5-4	TRBJ2-3
TGTGCTAGTGGCTCCGGACTAGCGGAGGGCCGTAGAAAAGAGACCCAGTACTTC	CASGSGLAEGRRKETQYF	TRBV12-5	TRBJ2-5
TGTGCCAGCAGCTTTCTCAGGGGTATGTTGGCCTACGAGCAGTACTTC	CASSFLRGMLAYEQYF	TRBV7-3	TRBJ2-7
TGTGCCAGTCCCTCAGGGGGTGAAAAACTGTTTTTT	CASPSGGEKLFF	TRBV19	TRBJ1-4
TGTGCCAGCAGCGGTTGGGTTATCAAGTTCTTC	CASSGWVIKFF	TRBV5-8	TRBJ2-1
TGTGCCAGCAGTGAACCTGGGACTAGCGGGGGGAGAGTAAGCTACGAGCAGTACTTC	CASSEPGTSGGRVSYEQYF	TRBV6-1	TRBJ2-7
TGTGCCACGTTAAGGGCGAAGCCCCAGCATTTT	CATLRAKPQHF	TRBV24-1	TRBJ1-5
TGTGCCAGCACAGGGGGGGGTATCACCTACGAGCAGTACTTC	CASTGGGITYEQYF	TRBV6-5	TRBJ2-7
TGTGCCAGCAGTCTTACTAGCGGGCCCACAGATACGCAGTATTTT	CASSLTSGPTDTQYF	TRBV6-4	TRBJ2-3
TGCGCCAGCAGCCTGGACAGGGGGACGCGTCGGACGCCCCAGCATTTT	CASSLDRGTRRTPQHF	TRBV5-1	TRBJ1-5
TGCAGTGCTAGAGATAGTCGGAGCAGTAAGGAGACCCAGTACTTC	CSARDSRSSKETQYF	TRBV20-1	TRBJ2-5
TGTGCCAGCAGCTCAACCAAGACAGGGGGCATTGTGTTGAACACTGAAGCTTTCTTT	CASSSTKTGGIVLNTEAFF	TRBV5-6	TRBJ1-1
TGCGCCAGTTGCCAGGGTCCCTATGGCTACACCTTC	CASCQGPYGYTF	TRBV4-1	TRBJ1-2
TGTGCCAGCAGCGTAGTTCTAAGGGGGGACTATGGCTACACCTTC	CASSVVLRGDYGYTF	TRBV9	TRBJ1-2
TGCAGTGCTAGGGGGACAGGGGGCTACGAGCAGTACTTC	CSARGTGGYEQYF	TRBV20-1	TRBJ2-7
TGCGCCAGCAGTGAGCAGGGGCAGTACTTC	CASSEQGQYF	TRBV10-2	TRBJ2-7
TGTGCCAGCTTCTACGACAGGGGGACCAAATGTAGGTTAGTTATCAATCAGCCCCAGCATTTT	CASFYDRGTKCRLVINQPQHF	TRBV7-3	TRBJ1-5
TGTGCCGTCGGGGTAACTAATGAAAAACTGTTTTTT	CAVGVTNEKLFF	TRBV10-3	TRBJ1-4
TGTGCCACCATACCTGAATTGCACGAGCAGTACTTC	CATIPELHEQYF	TRBV24-1	TRBJ2-7
TGTGCCAGCAGCTTGGACCGGGACAGAACTGGGTATAATTCACCCCTCCACTTT	CASSLDRDRTGYNSPLHF	TRBV5-4	TRBJ1-6
TGCGCCAGCAAGCCCACAGGCGAAGCTTTCTTT	CASKPTGEAFF	TRBV10-1	TRBJ1-1
TGTGCCATCAGGGACCGGGGGGGGAGCTCCTACGAGCAGTACTTC	CAIRDRGGSSYEQYF	TRBV10-3	TRBJ2-7
TGCAGCGGGACTAGCGGGAATGGGGTAGAGGTCTTC	CSGTSGNGVEVF	TRBV29-1	TRBJ2-1
TGTGCTAGCAGCCGAGGGACACCCTCCTACGAGCAGTACTTC	CASSRGTPSYEQYF	TRBV7-7	TRBJ2-7
TGTGCCAGCACTGGTAAGCCCCCGGGACGCCCTTACGAGCAGTACTTC	CASTGKPPGRPYEQYF	TRBV6-1	TRBJ2-7
TGTGCGGCGGGAGAGGGCTTGCATAGCAATCAGCCCCAGCATTTT	CAAGEGLHSNQPQHF	TRBV6-2	TRBJ1-5
TGCAGTGCTAGAGATGCAGGGACTAGTGGCTACGAGCAGTACTTC	CSARDAGTSGYEQYF	TRBV20-1	TRBJ2-7
TGCGCCAGCAGCTCCCGGGACAGAGGCTTCTTT	CASSSRDRGFF	TRBV5-1	TRBJ1-1
TGTGCCAGCAGCTTAGGGGTGTCTTTTAGAAACTACGAGCAGTACTTC	CASSLGVSFRNYEQYF	TRBV7-2	TRBJ2-7
TGTGGAAAAGCTATAGTCGAGGTCTACGAGCAGTACTTC	CGKAIVEVYEQYF	TRBV25-1	TRBJ2-7
TGTGCCAGCAGCTTAGGCTGCAGGGGGTCCACCGGGGAGCTGTTTTTT	CASSLGCRGSTGELFF	TRBV7-8	TRBJ2-2
TGTGCCAGCAGTTACTCGGACAGCTTTCGTTACCCGTCACCCCTCCACTTT	CASSYSDSFRYPSPLHF	TRBV6-3	TRBJ1-6
TGCGCCAGCAGTGAGGGCGTCGGGGACAAGGGAGAGCAGTTCTTC	CASSEGVGDKGEQFF	TRBV10-1	TRBJ2-1
TGCGCCAGCAGCCGGTGGATAGTTCCCTACGAGCAGTACTTC	CASSRWIVPYEQYF	TRBV5-1	TRBJ2-7
TGTGCCAGCAGTTTATCGGGACTGGAAGAGACCCAGTACTTC	CASSLSGLEETQYF	TRBV27	TRBJ2-5
TGCAGTGCTATGGGCCTCAATCAAGAGACCCAGTACTTC	CSAMGLNQETQYF	TRBV20-1	TRBJ2-5
TGTGCCAGCAGCTTAGTTTCTTTTATACTAGCTTACAGCACAGATACGCAGTATTTT	CASSLVSFILAYSTDTQYF	TRBV7-2	TRBJ2-3
TGTGCCAGCAGTGAAAACCAGAGCGGGACGGATGGCTACACCTTC	CASSENQSGTDGYTF	TRBV6-1	TRBJ1-2
TGCGCCAGCAAGCGGGCCCGGGCCATGAACACTGAAGCTTTCTTT	CASKRARAMNTEAFF	TRBV10-1	TRBJ1-1
TGTGCCAGCAGCTTTTGGCTCTACGAGCAGTACTTC	CASSFWLYEQYF	TRBV7-3	TRBJ2-7
TGCGCCAGCACCCGGGGTTTGTTGAACACTGAAGCTTTCTTT	CASTRGLLNTEAFF	TRBV10-2	TRBJ1-1
TGTGCCAGCAGGAGGACCCTTTGGAGGGGGGAGACGCGGAGTACTGGAAACACCATATATTTT	CASRRTLWRGETRSTGNTIYF	TRBV2	TRBJ1-3
TGTGCCAGCCCTAGGGGTGACTACAATGAGCAGTTCTTC	CASPRGDYNEQFF	TRBV7-3	TRBJ2-1
TGTGCCAGCAGCCAACTGTCTACCCCCTACAATGAGCAGTTCTTC	CASSQLSTPYNEQFF	TRBV3-1	TRBJ2-1
TGTGCCAGCAGCGGAGGACGGACAGTTAATAGCAATCAGCCCCAGCATTTT	CASSGGRTVNSNQPQHF	TRBV7-9	TRBJ1-5
TGTGCCAGCAGCGAACTAGCGGGGGAAGATACGCAGTATTTT	CASSELAGEDTQYF	TRBV27	TRBJ2-3
TGTGCCAGCAGCGGAAATGGGGGGCGCTGGGAGACCCAGTACTTC	CASSGNGGRWETQYF	TRBV9	TRBJ2-5
TGTGCCAGCCAAGGCCGGGACAGGGACAAGACTGAAGCTTTCTTT	CASQGRDRDKTEAFF	TRBV6-4	TRBJ1-1
TGTGCCACCAGTGACCGGGACTTTAGGGGCCGTAGCAATCAGCCCCAGCATTTT	CATSDRDFRGRSNQPQHF	TRBV24-1	TRBJ1-5
TGTGCCAGCAGCGAATCTGTGGGGAACTATGGCTACACCTTC	CASSESVGNYGYTF	TRBV13	TRBJ1-2
TGTGCTAGTGGTTTGGTAGTGGCCCCAGTAGTCGGCTCCTACGAGCAGTACTTC	CASGLVVAPVVGSYEQYF	TRBV12-5	TRBJ2-7
TGTGCCAAGTCGCCTTTTTACCGGGGTGGCAGCTCCTACGAGCAGTACTTC	CAKSPFYRGGSSYEQYF	TRBV7-9	TRBJ2-7
TGTGCCAGCAGCCAAGATGGATCGGACGAAGACTACGAGCAGTACTTC	CASSQDGSDEDYEQYF	TRBV3-1	TRBJ2-7
TGCAGCGAGATTCGGGGGCCCTACGAGCAGTACTTC	CSEIRGPYEQYF	TRBV29-1	TRBJ2-7
TGCAGTGCTAGAGCAAAGGGACAGGTAACGAACACCGGGGAGCTGTTTTTT	CSARAKGQVTNTGELFF	TRBV20-1	TRBJ2-2
TGCGCCAGCAGTTTCGATGGGACATACTCCTACGAGCAGTACTTC	CASSFDGTYSYEQYF	TRBV5-1	TRBJ2-7
TGTGCCAGCCTCCTCCCTAATGGGTATTTT	CASLLPNGYF	TRBV6-3	TRBJ2-3
TGTGCCAGCAGGGGACAGGGGCCTATGGCTGAAGCTTTCTTT	CASRGQGPMAEAFF	TRBV6-5	TRBJ1-1
TGCGCCAGCAGTGAGGGGGACAGGGGGGACAATCAGCCCCAGCATTTT	CASSEGDRGDNQPQHF	TRBV10-1	TRBJ1-5
TGCGCCAGCAGCCACCAGGGGTCGCAGACCGCAACTAATGAAAAACTGTTTTTT	CASSHQGSQTATNEKLFF	TRBV4-3	TRBJ1-4
TGCGCCAGCAGTCTAGCGGGATTCTCGGAAAGCGATTACGAGCAGTACTTC	CASSLAGFSESDYEQYF	TRBV10-1	TRBJ2-7
TGTGCCTGGGACAGGGCGCCCAATCAGCCCCAGCATTTT	CAWDRAPNQPQHF	TRBV30	TRBJ1-5
TGTGCCAGCAGTTTCGGGGGCGGGACTAGGGAAGGAACCAAAAACATTCAGTACTTC	CASSFGGGTREGTKNIQYF	TRBV12-4	TRBJ2-4
TGTGCCAGCTCTAGTCTGGCCAACTATGGCTACACCTTC	CASSSLANYGYTF	TRBV18	TRBJ1-2
TGTGCCAGCAGTTACCCCCTAGCGGGGAGAACCGGGGAGCTGTTTTTT	CASSYPLAGRTGELFF	TRBV6-5	TRBJ2-2
TGTGCCAGCGAGTCTAGATGCGGAGACTACGAGCAGTACTTC	CASESRCGDYEQYF	TRBV9	TRBJ2-7
TGTGCCAGCAGTGATCTGGGAGCCTACCAAGAGACCCAGTACTTC	CASSDLGAYQETQYF	TRBV6-4	TRBJ2-5
TGTGCCAGCAGCTCCGGAGGGGGTTCTGAAGCTTTCTTT	CASSSGGGSEAFF	TRBV5-6	TRBJ1-1
TGTGCCGCCTGGCTAGAGTGCGGGGAGCTGTTTTTT	CAAWLECGELFF	TRBV19	TRBJ2-2
TGTGCCAGCAGCTTAGTGAGTATACCTCCAAGGGGGCTTCCGAACACTGAAGCTTTCTTT	CASSLVSIPPRGLPNTEAFF	TRBV7-2	TRBJ1-1
TGTGCCAGTAACAGGGCATATGGCTACACCTTC	CASNRAYGYTF	TRBV11-2	TRBJ1-2
TGCAGTGCTAGAAAAAGGGGGTGGTCTGGGGCCAACGTCCTGACTTTC	CSARKRGWSGANVLTF	TRBV20-1	TRBJ2-6
TGTGCCAGCAGGTGTACTACAGGGCAGCAGTACTTC	CASRCTTGQQYF	TRBV6-5	TRBJ2-7
TGCGCCAGCAGGTCGACAGGGGGTATTCAGCCCCAGCATTTT	CASRSTGGIQPQHF	TRBV10-1	TRBJ1-5
TGCAGTGCTAGGCCCGCTAGGGGTTCTGAGCAGTTCTTC	CSARPARGSEQFF	TRBV20-1	TRBJ2-1
TGCGCCAGCAGTGAGTCGTCAATACCGGGGGCGGACAGCTCCTACGAGCAGTACTTC	CASSESSIPGADSSYEQYF	TRBV10-2	TRBJ2-7
TGTGCCAGCAGCCGGGCTGGGGACAGGGACTCTGGGGCCAACGTCCTGACTTTC	CASSRAGDRDSGANVLTF	TRBV5-6	TRBJ2-6
TGTGCCAGCAGCTCGCCCGACGTGGGCTACGAGCAGTACTTC	CASSSPDVGYEQYF	TRBV13	TRBJ2-7
TGTGCCACCAGTGATTTGCAGGGGGGTCGGACCTACGAGCAGTACTTC	CATSDLQGGRTYEQYF	TRBV24-1	TRBJ2-7
TGTGCCAGCAGTGTACAGGGGTGGTGGGCAATATATGGCTACACCTTC	CASSVQGWWAIYGYTF	TRBV2	TRBJ1-2
TGTGCCAGCAGATTGCGAGGGTACTTC	CASRLRGYF	TRBV27	TRBJ2-4
TGTGCCAGCAGAGACCCCCGGGGAAAGAACACTGAAGCTTTCTTT	CASRDPRGKNTEAFF	TRBV7-8	TRBJ1-1
TGCGCCAGCAGTGACGAAGCCGCGAAACCGGAAAAACTGTTTTTT	CASSDEAAKPEKLFF	TRBV10-1	TRBJ1-4
TGTGCCAGCAGCAGCAAGAAAGGGGCGGAGGAGTACAATGAGCAGTTCTTC	CASSSKKGAEEYNEQFF	TRBV7-4	TRBJ2-1
TGTGCCAGCAGCCAAGTCACAATACCCTACGAGCAGTACTTC	CASSQVTIPYEQYF	TRBV3-1	TRBJ2-7
TGCGCCAGCAGCTTGGACCAGGGACGTTCTCTAGATACGCAGTATTTT	CASSLDQGRSLDTQYF	TRBV5-1	TRBJ2-3
TGCAGCGTTGCCGGGTGGAGGCGGGGGGTGACCGGGGAGCTGTTTTTT	CSVAGWRRGVTGELFF	TRBV29-1	TRBJ2-2
TGCAGTGCTAGAGGACGTATCTACGAGCAGTACTTC	CSARGRIYEQYF	TRBV20-1	TRBJ2-7
TGTGCCACCAGCGGTGGGGGGAAGGAGAATGGAAGACTAGCGGGTGGAGATACGCAGTATTTT	CATSGGGKENGRLAGGDTQYF	TRBV15	TRBJ2-3
TGTGCCAGCAGGAAGATCGAAACTAATGAAAAACTGTTTTTT	CASRKIETNEKLFF	TRBV7-3	TRBJ1-4
TGCGCCAGCAGCCCGGATTGTAGGGTATTGAACACTGAAGCTTTCTTT	CASSPDCRVLNTEAFF	TRBV4-3	TRBJ1-1
TGTGCCAGCCAAAGTGAAGGGGGGGCCGGGGGGGAAGCTTCAATCTCCTACGAGCAGTACTTC	CASQSEGGAGGEASISYEQYF	TRBV28	TRBJ2-7
TGTGCCAGCAGTGAATCTCCTCGGAGGAGGAGCTCTGGGGCCAACGTCCTGACTTTC	CASSESPRRRSSGANVLTF	TRBV25-1	TRBJ2-6
TGTGCCAGCAGCAACCTACAGGAGTTCTCCTACGAGCAGTACTTC	CASSNLQEFSYEQYF	TRBV14	TRBJ2-7
TGCAGTGCAACGATAGGGCCGACCTATCTTGCTGGAAACACCATATATTTT	CSATIGPTYLAGNTIYF	TRBV20-1	TRBJ1-3
TGTGCCAGCAGCATTGGGGGGCAAGAGACCCAGTACTTC	CASSIGGQETQYF	TRBV13	TRBJ2-5
TGTGCCAGCAGGGGGACCGGGACAGAAGACTCTGGAAACACCATATATTTT	CASRGTGTEDSGNTIYF	TRBV6-1	TRBJ1-3
TGCGCCTACGGTTTAAGGTATGGCTACACCTTC	CAYGLRYGYTF	TRBV10-1	TRBJ1-2
TGTGCCAGCAGCGAAACCCGTGGACTAGCGAGAGAGCAGTTCTTC	CASSETRGLAREQFF	TRBV7-3	TRBJ2-1
TGTGCCAGCAGCTGTGTCGGGACGAAAGCTGAAGCTTTCTTT	CASSCVGTKAEAFF	TRBV7-4	TRBJ1-1
TGTGCCATGATCTGGGAAGTCTTAGGGCAAGAGACCCAGTACTTC	CAMIWEVLGQETQYF	TRBV2	TRBJ2-5
TGTGCCACAAAGGACAGTGGTTGTTCCTACAATGAGCAGTTCTTC	CATKDSGCSYNEQFF	TRBV19	TRBJ2-1
TGTGCCAGCAGCACCCCTGCCTATAACAGGGGATCACTCTTC	CASSTPAYNRGSLF	TRBV7-2	TRBJ2-1
TGTGCCAGCAGCGAGGGGGAACCCGCGAACACCGGGGAGCTGTTTTTT	CASSEGEPANTGELFF	TRBV7-9	TRBJ2-2
TGTGCCAGCAGCTTGACAGGGCCGGTCTACGAGCAGTACTTC	CASSLTGPVYEQYF	TRBV5-6	TRBJ2-7
TGTGCCACCAGTGATTCCTGCTGGGACGGAAATGAAAAACTGTTTTTT	CATSDSCWDGNEKLFF	TRBV24-1	TRBJ1-4
TGCGCCAGCAGCTTGATACCGGACTCCTACGAGCAGTACTTC	CASSLIPDSYEQYF	TRBV5-1	TRBJ2-7
TGCAGTGCTAGCATTGAGGACCGTAAAAACATTCAGTACTTC	CSASIEDRKNIQYF	TRBV20-1	TRBJ2-4
TGTGCCAGCAGCGTCGCCAAGACTAGCGGGGGGGGTCATACGCAGTATTTT	CASSVAKTSGGGHTQYF	TRBV7-3	TRBJ2-3
TGTGCCAGCAGCTGTCCTTGGGACGGTCAGCCCCAGCATTTT	CASSCPWDGQPQHF	TRBV13	TRBJ1-5
TGCGCCAGCAGCCACGCAGGGACACCCCTCCACTTT	CASSHAGTPLHF	TRBV5-1	TRBJ1-6
TGCGCCAGCAGCTGGGAGGCCGGACCCTACGAGCAGTACTTC	CASSWEAGPYEQYF	TRBV5-1	TRBJ2-7
TGTGCCAGCTCACCAAGTCATCGGGAGGGAGTTAGGTACAATGAGCAGTTCTTC	CASSPSHREGVRYNEQFF	TRBV18	TRBJ2-1
TGTGCCAGCAGCCCGGGACAGGGTTTTCGTCGCAATTCACCCCTCCACTTT	CASSPGQGFRRNSPLHF	TRBV7-3	TRBJ1-6
TGTGCCAGCAGTGAAGCGGGGACAGAGAACACTGAAGCTTTCTTT	CASSEAGTENTEAFF	TRBV2	TRBJ1-1
TGTGCCAGCAGCCTTAAGCGGGGCCCAGGGGGGAATCAGCCCCAGCATTTT	CASSLKRGPGGNQPQHF	TRBV11-3	TRBJ1-5
TGTGCCAGCTCCACCAGCGGGTATCGGCGGTACGAGCAGTACTTC	CASSTSGYRRYEQYF	TRBV28	TRBJ2-7
TGTGCCAGCAGAGGAAGAGGGACAAATCAGCCCCAGCATTTT	CASRGRGTNQPQHF	TRBV11-3	TRBJ1-5
TGCAGTGCAAATCCGAGGAAATCGGCCCATAACCCTTGCAGGGACCCCGGGGAGCTGTTTTTT	CSANPRKSAHNPCRDPGELFF	TRBV20-1	TRBJ2-2
TGTGCCATCAGCCCGCCAGTGATCTGCGCCTACGAGCAGTACTTC	CAISPPVICAYEQYF	TRBV10-3	TRBJ2-7
TGTGCCAGCAGTGACTCTACTAGCGGGAGAGGGGCGGATGAAAAACTGTTTTTT	CASSDSTSGRGADEKLFF	TRBV6-4	TRBJ1-4
TGTGCCAGCGTCTCGACTGGCAAGGAGCAGTACTTC	CASVSTGKEQYF	TRBV27	TRBJ2-7
TGTGCCAGCAGCGACGCAGCTTTCTTT	CASSDAAFF	TRBV7-3	TRBJ1-1
TGTGCCAGCAGCCGATACATGACAGGGCCCTATGGCTACACCTTC	CASSRYMTGPYGYTF	TRBV9	TRBJ1-2
TGTGCCAGCAGTTACTCGAGGGAGACAGGGGGGTACAATGAGCAGTTCTTC	CASSYSRETGGYNEQFF	TRBV6-5	TRBJ2-1
TGTGCCAGCAGTCCCCCAAAGCTCCAGGGCCCATACGAGCAGTACTTC	CASSPPKLQGPYEQYF	TRBV6-6	TRBJ2-7
TGTGCCAGCAGTTATCTTACAGGGGCTTCACCCCTCCACTTT	CASSYLTGASPLHF	TRBV6-5	TRBJ1-6
TGCAGTGCTCAAGGGTTGGAGCAGTACTTC	CSAQGLEQYF	TRBV20-1	TRBJ2-7
TGTGCCAGCAGTAAATCTTCCGGGTTCTACGAGCAGTACTTC	CASSKSSGFYEQYF	TRBV6-4	TRBJ2-7
TGCGCCAGCAGCCAAGATCTACAAGCCGACTGGACGACCTCCACAGATACGCAGTATTTT	CASSQDLQADWTTSTDTQYF	TRBV4-1	TRBJ2-3
TGTGCCCCGTGCAGTACAGGGGAGGAGCAGTACTTC	CAPCSTGEEQYF	TRBV19	TRBJ2-7
TGTGCCAGCAGCTTGGGGACAGTTATCCCCGTCGAGCAGTACTTC	CASSLGTVIPVEQYF	TRBV7-9	TRBJ2-7
TGTGCCAGCAGCTCCCATTGGGGCGGACGCACCATATATTTT	CASSSHWGGRTIYF	TRBV7-3	TRBJ1-3
TGTGCCAGCAGCCTAGACAGGGGAGTGCGTCAATACGAGCAGTACTTC	CASSLDRGVRQYEQYF	TRBV5-5	TRBJ2-7
TGTGCCATCAGGACAGGGGCATCAGGGTGTGAAAAACTGTTTTTT	CAIRTGASGCEKLFF	TRBV10-3	TRBJ1-4
TGTGCCAGCAGTGACTCGATGGGGGGGGGAGCCCTGAACACTGAAGCTTTCTTT	CASSDSMGGGALNTEAFF	TRBV6-4	TRBJ1-1
TGTGCCAGCAGCTTACGGGGGATCGCTCCCGGGTACAATGAGCAGTTCTTC	CASSLRGIAPGYNEQFF	TRBV7-8	TRBJ2-1
TGTGCCAGCAGCAACCGGGGTCCCGGTGGCTACACCTTC	CASSNRGPGGYTF	TRBV5-6	TRBJ1-2
TGTGCCAGGACGGGACAGGGCGCTGCGTGCAATCAGCCCCAGCATTTT	CARTGQGAACNQPQHF	TRBV7-9	TRBJ1-5
TGTGCCAGCAGTTACGAGAGACAAGGGGCCTTCAATGAGCAGTTCTTC	CASSYERQGAFNEQFF	TRBV6-5	TRBJ2-1
TGTGCCAGCAGCGCCATCAGGGGATTCATGAACACTGAAGCTTTCTTT	CASSAIRGFMNTEAFF	TRBV11-3	TRBJ1-1
TGTGCCAGCAGCTTAGAACTAGGCTTAGTCTTC	CASSLELGLVF	TRBV7-9	TRBJ2-1
TGTGCCAGAAAGGGGGAATACGAGCAGTACTTC	CARKGEYEQYF	TRBV28	TRBJ2-7
TGTGCCAGCAGCTCCGATTCGACAGGTTATGAAAAACTGTTTTTT	CASSSDSTGYEKLFF	TRBV13	TRBJ1-4
TGCAGTAACGAGAAAGGCTACACCTTC	CSNEKGYTF	TRBV20-1	TRBJ1-2
TGTGCCAGCAGGTGGCGATTTGAAGCTTTCTTT	CASRWRFEAFF	TRBV6-1	TRBJ1-1
TGTGCCAGCAGTGGCCGTCCGGGACCTCGACGACCAAACTATGGCTACACCTTC	CASSGRPGPRRPNYGYTF	TRBV25-1	TRBJ1-2
TGCAGTGCTAGGACAGGGCCGGCGGCCTATGGCTACACCTTC	CSARTGPAAYGYTF	TRBV20-1	TRBJ1-2
TGTGCCAGTCCCGGGGGTTCGAACAATGAGCAGTTCTTC	CASPGGSNNEQFF	TRBV19	TRBJ2-1
TGTGCCAGCAGCGTTGCAGTAGGTCCGGAGACCCAGTACTTC	CASSVAVGPETQYF	TRBV9	TRBJ2-5
TGCGCCAGCAGCTTTTTAACGGTCCGATATGGCTCCTACGAGCAGTACTTC	CASSFLTVRYGSYEQYF	TRBV5-1	TRBJ2-7
TGTGCCACCAGCAGAGATCCACTGGGGGGCCCTTACAAATCGACAGATACGCAGTATTTT	CATSRDPLGGPYKSTDTQYF	TRBV15	TRBJ2-3
TGTGCCAGCAGCCTATATCTGGCCTGGGGGGGAGATTACAATGAGCAGTTCTTC	CASSLYLAWGGDYNEQFF	TRBV4-2	TRBJ2-1
TGTGCCACTGCTGACCTAAACAATGAGCAGTTCTTC	CATADLNNEQFF	TRBV15	TRBJ2-1
TGTGCCACCGCAATAGAAGAGACCCAGTACTTC	CATAIEETQYF	TRBV24-1	TRBJ2-5
TGTGCCAGCAGCTACCCCTTCGGGACTTTGGTCTACGAGCAGTACTTC	CASSYPFGTLVYEQYF	TRBV7-9	TRBJ2-7
TGCGCCAGCAGCTTGGCCTCAGTGAACTATGGCTACACCTTC	CASSLASVNYGYTF	TRBV5-1	TRBJ1-2
TGTGCCAGCAGTTTAGAGATACTCAGAGAAGATTGGGGGACCACTGAAGCTTTCTTT	CASSLEILREDWGTTEAFF	TRBV27	TRBJ1-1
TGCTGGACTAGTTTCACAGATACGCAGTATTTT	CWTSFTDTQYF	TRBV29-1	TRBJ2-3
TGTGCTAGTGGTTTGGTAGGGGGGCTGGGGAACACAGATACGCAGTATTTT	CASGLVGGLGNTDTQYF	TRBV12-5	TRBJ2-3
TGTGGGCGACCTACCCAGACAGCCTACGAGCAGTACTTC	CGRPTQTAYEQYF	TRBV12-3	TRBJ2-7
TGCAGCGTACTTTGGGTGGGCAGCAATCAGCCCCAGCATTTT	CSVLWVGSNQPQHF	TRBV29-1	TRBJ1-5
TGTGCCAGCAGCGGCCAGGGAACAAGCAATCAGCCCCAGCATTTT	CASSGQGTSNQPQHF	TRBV7-2	TRBJ1-5
TGTGCCAGCAGCTTTCAGGGGGGGACTAGGGGGGGGTTATCTAACACTGAAGCTTTCTTT	CASSFQGGTRGGLSNTEAFF	TRBV7-6	TRBJ1-1
TGTGCCAGCAGCATTTCGGGGGCCCCCACACGGGCTCAGGCTAATGAAAAACTGTTTTTT	CASSISGAPTRAQANEKLFF	TRBV13	TRBJ1-4
TGCAGTGCTAGAGAAAAGGAGGTATCGGGATACGAGCAGTACTTC	CSAREKEVSGYEQYF	TRBV20-1	TRBJ2-7
TGTGGGGCTCTAGCGGGTTATGAGCAGTTCTTC	CGALAGYEQFF	TRBV5-6	TRBJ2-1
TGTGCCAGCGCGGGAACGGGCCCCGTGACATCTGAAGCTTTCTTT	CASAGTGPVTSEAFF	TRBV6-5	TRBJ1-1
TGTGCCAGAATTGGACCAACGGATGAGCAGTTCTTC	CARIGPTDEQFF	TRBV25-1	TRBJ2-1
TGTGCCAGTAGTAACGAGAATTCACCCCTCCACTTT	CASSNENSPLHF	TRBV19	TRBJ1-6
TGTGCCAGTAGTACGAAGGGACAGACAGATACGCAGTATTTT	CASSTKGQTDTQYF	TRBV19	TRBJ2-3
TGTGCCAGCAGCCGTCACAGGGCCCAGCCCCAGCATTTT	CASSRHRAQPQHF	TRBV3-1	TRBJ1-5
TGTGCACTATCCGGAGGTCAGCCCCAGCATTTT	CALSGGQPQHF	TRBV15	TRBJ1-5
TGTGCCAGCAGGAGATGGACTACCCGACCTAATGAAAAACTGTTTTTT	CASRRWTTRPNEKLFF	TRBV25-1	TRBJ1-4
TGTGCCAGCCCAGTGAGTTTATATAGCAATCAGCCCCAGCATTTT	CASPVSLYSNQPQHF	TRBV25-1	TRBJ1-5
TGTGCCAGCAGCGTGTCCGGGGGACAGGGGGGGGACTACGAGCAGTACTTC	CASSVSGGQGGDYEQYF	TRBV13	TRBJ2-7
TGTGCCTGGAGTGTACCCACCAGGGGGGGAGAGACCCAGTACTTC	CAWSVPTRGGETQYF	TRBV30	TRBJ2-5
TGCGCCAGCAGTGATTCAGACATACACACTGAAGCTTTCTTT	CASSDSDIHTEAFF	TRBV10-1	TRBJ1-1
TGTGCCAGCAGGTTCCCACCGGGACAGGGCTGGAACACTGAAGCTTTCTTT	CASRFPPGQGWNTEAFF	TRBV6-5	TRBJ1-1
TGTGCCAGCAGCTTGGGACAGGGCGTGAACACTGAAGCTTTCTTT	CASSLGQGVNTEAFF	TRBV7-3	TRBJ1-1
TGTGCCAGTAGTATTCAGGGTCGGAACACTGAAGCTTTCTTT	CASSIQGRNTEAFF	TRBV19	TRBJ1-1
TGTGCTAGTGGCTTACAAGGGTGTGCCGGGGAGCTGTTTTTT	CASGLQGCAGELFF	TRBV12-5	TRBJ2-2
TGCGCCAGCAGCCACCAGGGGACAGGGAATGCCAACTATGGCTACACCTTC	CASSHQGTGNANYGYTF	TRBV4-3	TRBJ1-2
TGTGCCAGCAGTAGCCCCGGGACACCAGAGACCCAGTACTTC	CASSSPGTPETQYF	TRBV6-2	TRBJ2-5
TGTGCCAGCAGCTTGGGGGGGGGGGGGGAGCAGTACTTC	CASSLGGGGEQYF	TRBV5-4	TRBJ2-7
TGTGCCAGCAGCCTTCATAGACAACAAGAGACCCAGTACTTC	CASSLHRQQETQYF	TRBV7-2	TRBJ2-5
TGCGCCAGCAGCAAGGCCGGGACTAGCGGGAGCCGTGGGGGAGTATGCAATCAGCCCCAGCATTTT	CASSKAGTSGSRGGVCNQPQHF	TRBV5-1	TRBJ1-5
TGTGCCAGCAGCTTATATAAAAAGGAGGACTACGAGCAGTACTTC	CASSLYKKEDYEQYF	TRBV7-2	TRBJ2-7
TGTGCCAGCAGTCTAGGGGGGTACGAGCAGTACTTC	CASSLGGYEQYF	TRBV6-3	TRBJ2-7
TGTGCCAGCAGCTTAGGCGGGGCCGAGGCGACTGGCTACACCTTC	CASSLGGAEATGYTF	TRBV7-9	TRBJ1-2
TGTGCCAGCAGCTTGAAACAGGAGGATCCATTTTGGTACCAAGAGACCCAGTACTTC	CASSLKQEDPFWYQETQYF	TRBV11-2	TRBJ2-5
TGTGCCACCAGCAGAGGGCGGACAGGGACCCGCCGACCTGAAGCTTTCTTT	CATSRGRTGTRRPEAFF	TRBV15	TRBJ1-1
TGTGCCAGCAGCTTACGGAAAGGACTAGTAAGGCGGGGGAACGAGCAGTACTTC	CASSLRKGLVRRGNEQYF	TRBV7-3	TRBJ2-7
TGTGCCAGCAGTTTCCAGTCCACTAGCATGAACACTGAAGCTTTCTTT	CASSFQSTSMNTEAFF	TRBV6-2	TRBJ1-1
TGCAGTGCGAATCCGGGACAGATTGTTGCTGAAGCTTTCTTT	CSANPGQIVAEAFF	TRBV20-1	TRBJ1-1
TGCAGTGCTAGAGGGGGCAGGGGGAGCTCCTACGAGCAGTACTTC	CSARGGRGSSYEQYF	TRBV20-1	TRBJ2-7
TGTGCCAGCAGCGTAGTTAACGAGGGTGAGACCCAGTACTTC	CASSVVNEGETQYF	TRBV9	TRBJ2-5
TGTGCCACCAGTGAAGATTCAGGGAAACGAGCCAAAAACATTCAGTACTTC	CATSEDSGKRAKNIQYF	TRBV24-1	TRBJ2-4
TGTGCCAGCAGCCGGAGGGACAGGGGACACTACGAGCAGTACTTC	CASSRRDRGHYEQYF	TRBV3-1	TRBJ2-7
TGTGCCAGCAGTTGGACTTCGCTGCGGAACACTGAAGCTTTCTTT	CASSWTSLRNTEAFF	TRBV12-3	TRBJ1-1
