TGTGCCTTGCCGGACTGGGCCAACGTCCTGACTTTC	CALPDWANVLTF	TRBV24-1	TRBJ2-6
TGTGCCAGCAGGAGTCCCAGGGGGGGACTGTTTTTT	CASRSPRGGLFF	TRBV12-4	TRBJ1-4
TGTGCCAGCAGCAACAGGGGGCCCCAGAGCTACGAGCAGTACTTC	CASSNRGPQSYEQYF	TRBV11-2	TRBJ2-7
TGTGCCAGCAGCCCGGGACAGCTGCCCGAGACCCAGTACTTC	CASSPGQLPETQYF	TRBV13	TRBJ2-5
TGTGCCGTCCGAGCGGGACAGCAATATAGAAACACTGAAGCTTTCTTT	CAVRAGQQYRNTEAFF	TRBV27	TRBJ1-1
TGTGCCAGCAGCCAGAAGAGTCCTTCGTTTGGGACAGGGGGCAGGTCCTACGAGCAGTACTTC	CASSQKSPSFGTGGRSYEQYF	TRBV5-4	TRBJ2-7
TGCAGCGGGACGGAAACGAGCACAGATACGCAGTATTTT	CSGTETSTDTQYF	TRBV29-1	TRBJ2-3
TGCGCCAGTACCCGCCGGGTACAGTGGGCTTACAATGAGCAGTTCTTC	CASTRRVQWAYNEQFF	TRBV10-1	TRBJ2-1
TGTGCCAGCAGCATCCAGCAGGGTGGAAACACCATATATTTT	CASSIQQGGNTIYF	TRBV13	TRBJ1-3
TGTGCCTGGGGGAGCGGGACATTCATTAATGAAAAACTGTTTTTT	CAWGSGTFINEKLFF	TRBV30	TRBJ1-4
TGTGCCAGCAGCAGCAGAGACTCTGGGGCCAACGTCCTGACTTTC	CASSSRDSGANVLTF	TRBV13	TRBJ2-6
TGCGCCAGCAGCCAAGACTCCTACGAGCAGTACTTC	CASSQDSYEQYF	TRBV4-3	TRBJ2-7
TGTGCCAGCAGCGGGGGACAGGGGGCCGAAGAGACCCAGTACTTC	CASSGGQGAEETQYF	TRBV7-3	TRBJ2-5
TGTGCCAGCAGCTTGCTCTCGACCCCACAGGGGAACTATGGCTACACCTTC	CASSLLSTPQGNYGYTF	TRBV5-4	TRBJ1-2
TGTGCCAGCAGACGGATTGAGACCCAGTACTTC	CASRRIETQYF	TRBV9	TRBJ2-5
TGTGCCAGCATTAACAGGGGGGGGGGCGGGCCCCAGCATTTT	CASINRGGGGPQHF	TRBV6-1	TRBJ1-5
TGCGCTCTACGCACTAGCGGGAGTTACATGAACACTGAAGCTTTCTTT	CALRTSGSYMNTEAFF	TRBV10-1	TRBJ1-1
TGTGCCAGCAGCGTTTACAGGGGTCCCCCTCGCTACGAGCAGTACTTC	CASSVYRGPPRYEQYF	TRBV9	TRBJ2-7
TGTGCCAGCAGCTTAGAAGACAGATGCAATCAGCCCCAGCATTTT	CASSLEDRCNQPQHF	TRBV7-9	TRBJ1-5
TGTGCCAGTAACCCTATCAATTTAGGGACAGGGCTTCCGGTGGGTGATAATTCACCCCTCCACTTT	CASNPINLGTGLPVGDNSPLHF	TRBV19	TRBJ1-6
TGTGCCATCAGTGAACCACAGCATGGCTACACCTTC	CAISEPQHGYTF	TRBV10-3	TRBJ1-2
TGCAGTGCTAGTCCCAGGGGGGGGTTGAGTGACACTGAAGCTTTCTTT	CSASPRGGLSDTEAFF	TRBV20-1	TRBJ1-1
TGTGCCAGCAGCTTCGGAGGGTTTGAGGGGAGCTCCTACAATGAGCAGTTCTTC	CASSFGGFEGSSYNEQFF	TRBV13	TRBJ2-1
TGTGCCAGCAGGCCCGACTGGAAGTTTGAGCAGTTCTTC	CASRPDWKFEQFF	TRBV5-4	TRBJ2-1
TGTGCCAGCAGCCAAACCGGGCCCCGGACAGGCCAAAACGAGCAGTACTTC	CASSQTGPRTGQNEQYF	TRBV3-1	TRBJ2-7
TGTGCCAGCAGTGATGGTCGGAGGAGAGAGACCCAGTACTTC	CASSDGRRRETQYF	TRBV25-1	TRBJ2-5
TGCAGTGCTAGAGATCAGGGCGGAGGCGCAACTAATGAAAAACTGTTTTTT	CSARDQGGGATNEKLFF	TRBV20-1	TRBJ1-4
TGTGCCAGCAGCCAAGCTCGCCCCTTAAGGGGGCTGCATAACTATGGCTACACCTTC	CASSQARPLRGLHNYGYTF	TRBV14	TRBJ1-2
TGTGCCAGCAGTATCCTTAGGACAGGGGTCTGCTGTACTGGAGCTAACTATGGCTACACCTTC	CASSILRTGVCCTGANYGYTF	TRBV12-4	TRBJ1-2
TGTGCCAGGCTTGTGGGGGCGCTTTACGAGCAGTACTTC	CARLVGALYEQYF	TRBV7-9	TRBJ2-7
TGTGCCAGCAGCCAAGACGGCGGGGAGGAGCAGTTCTTC	CASSQDGGEEQFF	TRBV3-1	TRBJ2-1
TGTGCCAGCAGCCTTTCATCGGACTCCACCGAGACCCAGTACTTC	CASSLSSDSTETQYF	TRBV14	TRBJ2-5
TGCGCCAGCAGCCAGTTTCCCTGCCACAGTTCGGAGCAGTACTTC	CASSQFPCHSSEQYF	TRBV4-1	TRBJ2-7
TGCGCCAGCAAATTGCGTGTGGGACAGGGTTATCAAGCTAACTATGGCTACACCTTC	CASKLRVGQGYQANYGYTF	TRBV10-1	TRBJ1-2
TGCAGTGCATCTTCAGGGTCGGGACAGGGAGACACCGGGGAGCTGTTTTTT	CSASSGSGQGDTGELFF	TRBV20-1	TRBJ2-2
TGCAGTGCTAGAGGGCCAGAGGAGGGTGGTAGCACAGATACGCAGTATTTT	CSARGPEEGGSTDTQYF	TRBV20-1	TRBJ2-3
TGCGCCAGCAGCCAAGATCCAAGAATTAACCGGGACAGGGGGTTTGGTCAGCCCCAGCATTTT	CASSQDPRINRDRGFGQPQHF	TRBV4-1	TRBJ1-5
TGTGCTAGCAGCTCTCGGACGTGCGGGTGGGGGTCACCCCTCCACTTT	CASSSRTCGWGSPLHF	TRBV7-7	TRBJ1-6
TGTGCCAGCAGCTTGGTCGATTCCTACGAGCAGTACTTC	CASSLVDSYEQYF	TRBV3-1	TRBJ2-7
TGCGCCAGCAGCCAAGGGGGGGGCCGCTACGAGCAGTACTTC	CASSQGGGRYEQYF	TRBV4-3	TRBJ2-7
TGTTACCTGGGGGGCCCGAGCTCCTACAATGAGCAGTTCTTC	CYLGGPSSYNEQFF	TRBV30	TRBJ2-1
TGTGCCAGCAGTTACTCCTGCTCTCCCCCGGACAGGAAGGCCGAGCAGTTCTTC	CASSYSCSPPDRKAEQFF	TRBV6-5	TRBJ2-1
TGCGCCAGCAGTGAGCACTGGCACTCTGAAGCTTTCTTT	CASSEHWHSEAFF	TRBV10-1	TRBJ1-1
TGCGCCAGCAGCTCATCTGACTCAGTATCATCACCCCTCCACTTT	CASSSSDSVSSPLHF	TRBV5-1	TRBJ1-6
TGTGCCAGCAGCTTAATATGTGAGGGACAGGGTTTCGGGCATGGCTACACCTTC	CASSLICEGQGFGHGYTF	TRBV7-9	TRBJ1-2
TGTGCCAGCAGCAGGGGAGGAGGCTACACCTTC	CASSRGGGYTF	TRBV11-1	TRBJ1-2
TGTGCGTACTTCCAACTAGCGGGAGTGTTATACGAGCAGTACTTC	CAYFQLAGVLYEQYF	TRBV11-3	TRBJ2-7
TGTGCCAGCCGGAGGGGGGGGGTGTACTATGGCTACACCTTC	CASRRGGVYYGYTF	TRBV28	TRBJ1-2
TGTGCCAGCAGTTTATCGCCTAAGGGGGACCAGGTAGAGCGTTCGGTTGCGGACTACGAGCAGTACTTC	CASSLSPKGDQVERSVADYEQYF	TRBV27	TRBJ2-7
TGTGCCAGCAGCGGGCGCGGAGGGACGCACAATGAGCAGTTCTTC	CASSGRGGTHNEQFF	TRBV7-4	TRBJ2-1
TGCGCCAGCAGTCTGGACGGGGGGGCGCATAAGGCTAATTCACCCCTCCACTTT	CASSLDGGAHKANSPLHF	TRBV10-1	TRBJ1-6
TGTGCCAGCAGCTTCCCAGTCAGCGGGCTTGAGACCCAGTACTTC	CASSFPVSGLETQYF	TRBV7-6	TRBJ2-5
TGTGCCAGCAGCCAACAGAGCCAGCCCCAGCATTTT	CASSQQSQPQHF	TRBV3-1	TRBJ1-5
TGTGCCAGCAGCCAAAGAGGTCCCAACTATGGCTACACCTTC	CASSQRGPNYGYTF	TRBV13	TRBJ1-2
TGCAGCGTTGCCGACGCCGGGAGTAGTTACGAGCAGTACTTC	CSVADAGSSYEQYF	TRBV29-1	TRBJ2-7
TGTGCCAGCAGCTTAGCGTATCAGGCCTACGAGCAGTACTTC	CASSLAYQAYEQYF	TRBV7-6	TRBJ2-7
TGTGCCAGCAGCCCGAGGGGAGGGTCGGCAAGGGGACCCGGGGAGCTGTTTTTT	CASSPRGGSARGPGELFF	TRBV13	TRBJ2-2
TGTGGAAATCGCGTACACGAGCAGTACTTC	CGNRVHEQYF	TRBV6-4	TRBJ2-7
TGTGCCAGCAGCACGATTTGTTATGGCTACACCTTC	CASSTICYGYTF	TRBV7-4	TRBJ1-2
TGTGCCAGCGCTAGGGGCCACCAAGAGACCCAGTACTTC	CASARGHQETQYF	TRBV14	TRBJ2-5
TGTGCCAGCAGTTTCTTAAGTGAGCAGTTCTTC	CASSFLSEQFF	TRBV28	TRBJ2-1
TGTGCCAGCAGTACGTTTGCCCTCGATAAGGAGCAGTACTTC	CASSTFALDKEQYF	TRBV12-3	TRBJ2-7
TGTGCCAGCAGTTTGCCCGAGGGGGGAGGGGGACGCAATGAGCAGTTCTTC	CASSLPEGGGGRNEQFF	TRBV12-3	TRBJ2-1
TGTGCCAAAAGGCGGGAGCACTACGAGCAGTACTTC	CAKRREHYEQYF	TRBV10-3	TRBJ2-7
TGTGCCAGCAGCAGGGCTTACGAGCAGTACTTC	CASSRAYEQYF	TRBV9	TRBJ2-7
TGTGCCAGCAGCTTGGAAGGGGAGGGCAATCAGCCCCAGCATTTT	CASSLEGEGNQPQHF	TRBV5-4	TRBJ1-5
TGTGCCAGCAGCTTAGCTAACCGACGCTATGGCTACACCTTC	CASSLANRRYGYTF	TRBV7-9	TRBJ1-2
TGTGCCAGCAGCCGCCGGGACTCCACAGATACGCAGTATTTT	CASSRRDSTDTQYF	TRBV5-8	TRBJ2-3
TGTGCCAGCAGTGAAGCCTCCAGTTTTGATAGCGGGATAGCAGATACGCAGTATTTT	CASSEASSFDSGIADTQYF	TRBV6-1	TRBJ2-3
TGTGCCTGGAGGAGGGAGGCTCATTATAATTCACCCCTCCACTTT	CAWRREAHYNSPLHF	TRBV30	TRBJ1-6
TGTGCCACCAGTGCCAAGGGGGTTATGCTTGGCTACACCTTC	CATSAKGVMLGYTF	TRBV24-1	TRBJ1-2
TGTGCCAGCAGCTGGTGGGACTTAGTGTACCAAGAGACCCAGTACTTC	CASSWWDLVYQETQYF	TRBV7-3	TRBJ2-5
TGTGCCAGCAGCTCCCAGGGAGTGAATACCAACACCGGGGAGCTGTTTTTT	CASSSQGVNTNTGELFF	TRBV9	TRBJ2-2
TGCGCCAGCAGCCAAGATGACATCGGGGTAGATGAGCAGTTCTTC	CASSQDDIGVDEQFF	TRBV4-3	TRBJ2-1
TGTGCCAGCAGCATGATAAGGCTCCTGACCGGACGCCACCGGAGCTCCTACAATGAGCAGTTCTTC	CASSMIRLLTGRHRSSYNEQFF	TRBV11-2	TRBJ2-1
TGCGCCAGCAGCTTACGGACGGCACCGGCCTACGAGCAGTACTTC	CASSLRTAPAYEQYF	TRBV5-1	TRBJ2-7
TGTGCCAGCAGGAACAGGGTTGTGAACACTGAAGCTTTCTTT	CASRNRVVNTEAFF	TRBV6-5	TRBJ1-1
TGTGCCAGCCGAAGGGGGGGCCTCTACGAGCAGTACTTC	CASRRGGLYEQYF	TRBV6-4	TRBJ2-7
TGCGCCAGCAGCCAAGATCGTGTGGGTACCGAATCCGGGGGACTAGCGAAGCAAGAGACCCAGTACTTC	CASSQDRVGTESGGLAKQETQYF	TRBV4-1	TRBJ2-5
TGTGCCTGGATCCAGACAGGGGGCGGTGGTATGAACACTGAAGCTTTCTTT	CAWIQTGGGGMNTEAFF	TRBV30	TRBJ1-1
TGCGCCAGCAGCCAAGATTATCAGCCCCAGCATTTT	CASSQDYQPQHF	TRBV4-1	TRBJ1-5
TGTGCCAGCAGCTTGATCAGCGAGACCCAGTACTTC	CASSLISETQYF	TRBV7-9	TRBJ2-5
TGTGCCAGCAGTTCCCGGGACAAGGGCACCGGGGAGCTGTTTTTT	CASSSRDKGTGELFF	TRBV27	TRBJ2-2
TGTGCCAGTAGCCCTCTGACAGGCGTGCAGTTCTTC	CASSPLTGVQFF	TRBV19	TRBJ2-1
TGTGCCAGCAGCTTAGGCCCGCGGTACAATGAGCAGTTCTTC	CASSLGPRYNEQFF	TRBV7-2	TRBJ2-1
TGCAGTGCTAGAGATCCCCGACAGGGGAGGGGAAACTATGGCTACACCTTC	CSARDPRQGRGNYGYTF	TRBV20-1	TRBJ1-2
TGTGCCAGCAGCGTAGACTGGGACAGGGGAAATTTGAACACTGAAGCTTTCTTT	CASSVDWDRGNLNTEAFF	TRBV9	TRBJ1-1
TGTGCCAGCAGCCTACAGGGGGTTAAAGGCTACACCTTC	CASSLQGVKGYTF	TRBV13	TRBJ1-2
TGTGCCAGTAGTATGGCACCCGGGGGCTCTCTCTTC	CASSMAPGGSLF	TRBV19	TRBJ2-1
TGTGCCAGCAGTTTAGCGCGTTCGGCGCGTAGCTCCTACAATGAGCAGTTCTTC	CASSLARSARSSYNEQFF	TRBV12-3	TRBJ2-1
TGCAGTGCGCCTGCCGTTGGTTTAAGGGATAACGCAGATACGCAGTATTTT	CSAPAVGLRDNADTQYF	TRBV20-1	TRBJ2-3
TGTGCCAGAAAGGGGAACACAACCTACGAGCAGTACTTC	CARKGNTTYEQYF	TRBV24-1	TRBJ2-7
TGTGCCAGCAGCCAAGGCCGACTTTCGCCCTCTGGAAACACCATATATTTT	CASSQGRLSPSGNTIYF	TRBV3-1	TRBJ1-3
TGCGCCAGCAGCCAAGAAGAGAAATTGACAACTACGTACAATGAGCAGTTCTTC	CASSQEEKLTTTYNEQFF	TRBV4-1	TRBJ2-1
TGTGCCACCAGTGAGTGGAACGTTCCTCTTGAGGTTAGAGCCGCTGGGGCCAACGTCCTGACTTTC	CATSEWNVPLEVRAAGANVLTF	TRBV24-1	TRBJ2-6
TGTGCCAGGCTGGGACATTATGGCTACACCTTC	CARLGHYGYTF	TRBV10-3	TRBJ1-2
TGTGCCAGCAGCCACCACTCCGGGACAGGGTACGGCGAGCAGTACTTC	CASSHHSGTGYGEQYF	TRBV7-3	TRBJ2-7
TGTGCCAGCAGCAGGATACCCGAGCAGTACTTC	CASSRIPEQYF	TRBV7-2	TRBJ2-7
TGTGCCAGCAGCTTAACCCTGGACGACAGGGGTTCTTCAGACTATAATTCACCCCTCCACTTT	CASSLTLDDRGSSDYNSPLHF	TRBV5-4	TRBJ1-6
TGTGCCAGCAGCTTGCTCGGTCAGGGGAACACTGAAGCTTTCTTT	CASSLLGQGNTEAFF	TRBV7-9	TRBJ1-1
TGTGTGAGGGGGCTCGATGCTGAAGCTTTCTTT	CVRGLDAEAFF	TRBV6-4	TRBJ1-1
TGTGCCAGCAGCCCGGGACAGGGGGCGTATGGCTACACCTTC	CASSPGQGAYGYTF	TRBV7-3	TRBJ1-2
TGTGCCAAATTCACAGGGAGACAGGGGGATCAGCCCCAGCATTTT	CAKFTGRQGDQPQHF	TRBV3-1	TRBJ1-5
TGTGCCAGCAGGGTCCGGGACACCCGGGGGAGCTCCTACGAGCAGTACTTC	CASRVRDTRGSSYEQYF	TRBV14	TRBJ2-7
TGTGCCAGCAGCTCCTGTAGCCGGGGGTGCGCTCAAGAGACCCAGTACTTC	CASSSCSRGCAQETQYF	TRBV7-3	TRBJ2-5
TGTGCCAGCAGCTGCAAGTCGAAAGCCACCTATAATTCACCCCTCCACTTT	CASSCKSKATYNSPLHF	TRBV7-9	TRBJ1-6
TGCGCCAGCAGCTTGGCCGTCCCCCGGGGTGCGTATAGCAATCAGCCCCAGCATTTT	CASSLAVPRGAYSNQPQHF	TRBV5-1	TRBJ1-5
TGTGCCAGCGCACGAGGAAGTGGCTACACCTTC	CASARGSGYTF	TRBV27	TRBJ1-2
TGTGCCAGCAGTTACCCGGGACAGTTCGAGCAGTACTTC	CASSYPGQFEQYF	TRBV6-5	TRBJ2-7
TGTGCCAGCAGTCAAGGACGGTACGAGCAGTACTTC	CASSQGRYEQYF	TRBV28	TRBJ2-7
TGCAGTGCTAGAGATACTGGGGGCCTTGATGGCTACACCTTC	CSARDTGGLDGYTF	TRBV20-1	TRBJ1-2
TGCGCCAGCAGTGGAAACGGCAGATCCTACGAGCAGTACTTC	CASSGNGRSYEQYF	TRBV10-1	TRBJ2-7
TGTGCCACCAGTGAGCCTGGAGCACGGGGGGGAGGGAAGGAGACCCAGTACTTC	CATSEPGARGGGKETQYF	TRBV24-1	TRBJ2-5
TGTGCCAGCAGGAACTTGGGGGGGCAGACGTATGAGCAGTTCTTC	CASRNLGGQTYEQFF	TRBV6-4	TRBJ2-1
TGTGCCACCAGCTTTCAGGGGGCTGAAAAACTGTTTTTT	CATSFQGAEKLFF	TRBV15	TRBJ1-4
TGTGCCAGCAGCTTAAGACGGGACGCGGGATTCGGACTTAAAACCGGGGAGCTGTTTTTT	CASSLRRDAGFGLKTGELFF	TRBV7-3	TRBJ2-2
TGTGCCAGCAGTGATCGACTAGGTAACACCGGGGAGCTGTTTTTT	CASSDRLGNTGELFF	TRBV25-1	TRBJ2-2
TGTGCCACCAGCAGACCCCAACCTACGCGGGACAGGGGGGAGACTGAAGCTTTCTTT	CATSRPQPTRDRGETEAFF	TRBV15	TRBJ1-1
TGTGCCACCGGGACAGCGGAACCTGAAGCTTTCTTT	CATGTAEPEAFF	TRBV24-1	TRBJ1-1
TGTGCCAGCAGGGACGGCAAACCCGGGGAGCTGTTTTTT	CASRDGKPGELFF	TRBV27	TRBJ2-2
TGTGCCAGCAGCTTCCGGGGGTTTGGACCTGGTGCCACCGGGGAGCTGTTTTTT	CASSFRGFGPGATGELFF	TRBV9	TRBJ2-2
TGTGCCAGCAGTGTACTACCGGACAGGGGTGGAGATGGCTACACCTTC	CASSVLPDRGGDGYTF	TRBV27	TRBJ1-2
TGTGCCAGCACTTATACTAGGAATTCACCCCTCCACTTT	CASTYTRNSPLHF	TRBV28	TRBJ1-6
TGTGCCAGCAGAAGACAGGGGGGGGGATACTTC	CASRRQGGGYF	TRBV27	TRBJ2-4
TGTGCCAGCAGTTACTCGAGTAAACAGGGGTACGAGCAGTACTTC	CASSYSSKQGYEQYF	TRBV6-5	TRBJ2-7
TGTGCCAGCAGTGATAGCGGGACTTTTTCTGAAGCTTTCTTT	CASSDSGTFSEAFF	TRBV27	TRBJ1-1
TGTGCCAGCAGCCACTTAGGCCCTAGCGGGCTATACGAGCAGTACTTC	CASSHLGPSGLYEQYF	TRBV7-6	TRBJ2-7
TGTGCCAGCAGTGGGCACCCGAGGAGACACTTAGCCAAAAACATTCAGTACTTC	CASSGHPRRHLAKNIQYF	TRBV2	TRBJ2-4
TGCAGTGCTACCGAAGCGGGGAGAAATAACACCGGGGAGCTGTTTTTT	CSATEAGRNNTGELFF	TRBV20-1	TRBJ2-2
TGCGCCAGCAGCTCCGCAAGGAATCAGCCCCAGCATTTT	CASSSARNQPQHF	TRBV5-1	TRBJ1-5
TGTGCCAGCAGCCACCCGACAGGGGGCGCCGAGCAGTACTTC	CASSHPTGGAEQYF	TRBV3-1	TRBJ2-7
TGTGCCAGTACTAGCACAGATACGCAGTATTTT	CASTSTDTQYF	TRBV7-3	TRBJ2-3
TGCGCCAGCACCGACAGGGGGGTGCGTCAGGCTAACTATGGCTACACCTTC	CASTDRGVRQANYGYTF	TRBV10-2	TRBJ1-2
TGCAGTAAGGAGTGGCTTGACAGGGGGAAATTAGTTCAGCCCCAGCATTTT	CSKEWLDRGKLVQPQHF	TRBV20-1	TRBJ1-5
TGTGCCAGCAGGGGGGGAAGCAGGGGAGTTCACACTGAAGCTTTCTTT	CASRGGSRGVHTEAFF	TRBV7-2	TRBJ1-1
TGCAGTGCTAGGTCCGGGGGGGGACAGACCCAGTACTTC	CSARSGGGQTQYF	TRBV20-1	TRBJ2-5
TGTGCCTGGAGTGGTCTGGACAGGGGAAATGAGCAGTTCTTC	CAWSGLDRGNEQFF	TRBV30	TRBJ2-1
TGCAGTGCTAGGGCCTCCAAAGGGACTGAAGCTTTCTTT	CSARASKGTEAFF	TRBV20-1	TRBJ1-1
TGTGCACGAGGGCGCACAGATACGCAGTATTTT	CARGRTDTQYF	TRBV7-2	TRBJ2-3
TGTGCCAGCAGCCCCACCGGGAACCGGAATACCTACGAGCAGTACTTC	CASSPTGNRNTYEQYF	TRBV7-4	TRBJ2-7
TGTGCCAGCTCACCACCAGGGACAGGGCCGGAGGGTCCGAACACTGAAGCTTTCTTT	CASSPPGTGPEGPNTEAFF	TRBV18	TRBJ1-1
TGTGCCAGCAGCCAAGTCTATGGCTACACCTTC	CASSQVYGYTF	TRBV3-1	TRBJ1-2
TGTGCCAGCAGTGATTCGGCGGGACGTAATTCACCCCTCCACTTT	CASSDSAGRNSPLHF	TRBV2	TRBJ1-6
TGTGCCACCATCGGGGCCCAGTCCTATGGCTACACCTTC	CATIGAQSYGYTF	TRBV24-1	TRBJ1-2
TGTGCCGGCTCTAGGGCAGATACGCAGTATTTT	CAGSRADTQYF	TRBV10-3	TRBJ2-3
TGTGCCAGCAGTTACAAAGGTGTCGGGGGCCGAGGTGGCTACACCTTC	CASSYKGVGGRGGYTF	TRBV6-6	TRBJ1-2
TGTGCCAGCAGCGGCCCTAGAGGCCCCAGAAGGTACAATGAGCAGTTCTTC	CASSGPRGPRRYNEQFF	TRBV13	TRBJ2-1
TGTGCCAGCAGCACCGGCACGGGTTATAACTATGGCTACACCTTC	CASSTGTGYNYGYTF	TRBV7-4	TRBJ1-2
TGTGCCAGCAGTGACTATCGATCTAGCGGGCGACAAAATGAGCAGTTCTTC	CASSDYRSSGRQNEQFF	TRBV6-4	TRBJ2-1
TGTGCCAGCGGGGCGGGGGGGCGAAACACCGGGGAGCTGTTTTTT	CASGAGGRNTGELFF	TRBV5-4	TRBJ2-2
TGCGCCAGCAGCCCCCGGCTCCGAGGGGATACGCAGTATTTT	CASSPRLRGDTQYF	TRBV5-1	TRBJ2-3
TGTGCTAGTGGTTTGATTCATTGGTGGGATGAGCAGTTCTTC	CASGLIHWWDEQFF	TRBV12-5	TRBJ2-1
TGTGCCAGCAGTGTACAGGGGGCAAGCTATGGCTACACCTTC	CASSVQGASYGYTF	TRBV2	TRBJ1-2
TGTGCCAGCAGCCGGGGCCAAACCACTGAAGCTTTCTTT	CASSRGQTTEAFF	TRBV11-3	TRBJ1-1
TGCAGTGCTAGAGGTTGCCTACAGATATTGAGGACAGCCGAGACCCAGTACTTC	CSARGCLQILRTAETQYF	TRBV20-1	TRBJ2-5
TGTGCCAGCAGCTTAGACGAGGACAGGGGGGAGAACACTGAAGCTTTCTTT	CASSLDEDRGENTEAFF	TRBV7-4	TRBJ1-1
TGTGCCAGCAGCTTGGGCCAGAAGGGGCTAGGGGGCAATCAGCCCCAGCATTTT	CASSLGQKGLGGNQPQHF	TRBV5-5	TRBJ1-5
TGTGCCAGCGGTGGACAGCAGGTCGATACGCAGTATTTT	CASGGQQVDTQYF	TRBV6-5	TRBJ2-3
TGCGCCAGCAGCTCAGGGCAGGCACCAACTAATGAAAAACTGTTTTTT	CASSSGQAPTNEKLFF	TRBV5-1	TRBJ1-4
TGTGCCACCCACCCGGGGGGGGCCCGGGAGTACAATGAGCAGTTCTTC	CATHPGGAREYNEQFF	TRBV24-1	TRBJ2-1
TGTGCCAGCAGCGCCACCGTTACCGGTTCTAACACTGAAGCTTTCTTT	CASSATVTGSNTEAFF	TRBV7-3	TRBJ1-1
TGCAGCGTTGAAGGATCTACAGGGGGGGCCGAAAACGAGCAGTACTTC	CSVEGSTGGAENEQYF	TRBV29-1	TRBJ2-7
TGCGCCAGCAGTGAGCCGCACGTCCCCGTCGGGGGGTGGGTCGGGGAGCTGTTTTTT	CASSEPHVPVGGWVGELFF	TRBV10-2	TRBJ2-2
TGCGCCAGCAGTCCAGAAGACAGGGACTGGTACCAAGAGACCCAGTACTTC	CASSPEDRDWYQETQYF	TRBV10-1	TRBJ2-5
TGTGCCAGCAGTCTAGACAGCCCGCCCCAGCATTTT	CASSLDSPPQHF	TRBV27	TRBJ1-5
TGTGCCAGCTATAAACTTCCCAGGGGGCGGATGTCTGGAAACACCATATATTTT	CASYKLPRGRMSGNTIYF	TRBV18	TRBJ1-3
TGTGCCAGCAGCTTACTAGGCCCGGGGCCCCAGCATTTT	CASSLLGPGPQHF	TRBV7-6	TRBJ1-5
TGTGCCAGCAGCCTCAAGGGGGGTAATGACAATGAGCAGTTCTTC	CASSLKGGNDNEQFF	TRBV14	TRBJ2-1
TGTGCCACCAGTGATCCTAAGCGGGAGTGCAATCAGCCCCAGCATTTT	CATSDPKRECNQPQHF	TRBV24-1	TRBJ1-5
TGTGCCAGCAGTGAGAACAGGGGGAGAGGGTACTATGGCTACACCTTC	CASSENRGRGYYGYTF	TRBV6-4	TRBJ1-2
TGTGCCACTAGCGGGCCCAATGAGCAGTTCTTC	CATSGPNEQFF	TRBV12-3	TRBJ2-1
TGTGCCAGCAGCCAAAAAAAGGGGTCTGGGGCCTACGAGCAGTACTTC	CASSQKKGSGAYEQYF	TRBV9	TRBJ2-7
TGCAGCGCCCCGGGACGGGGGGTTAACAATGAGCAGTTCTTC	CSAPGRGVNNEQFF	TRBV29-1	TRBJ2-1
TGTGCCAGCAGTTACTCGACCCTCCTCGAGCACGATATGACTAGGAACAATGAGCAGTTCTTC	CASSYSTLLEHDMTRNNEQFF	TRBV6-5	TRBJ2-1
TGTGCCAGTAGTCAACCAGCTTGGACAGGGCCCTACGAGCAGTACTTC	CASSQPAWTGPYEQYF	TRBV19	TRBJ2-7
TGTGCCAGCAGCCAAGAGGACGCGGGGGCCCTCATGAGCTCCTACAATGAGCAGTTCTTC	CASSQEDAGALMSSYNEQFF	TRBV3-1	TRBJ2-1
TGTGCCAGAGCCCAGACCCACTATGGCTACACCTTC	CARAQTHYGYTF	TRBV19	TRBJ1-2
TGTGCCTTACCATGGGACAGGGTGAGGGCCATGAGTTGCACAGATACGCAGTATTTT	CALPWDRVRAMSCTDTQYF	TRBV10-3	TRBJ2-3
TGTGCCTGGACCGTTATCAGGGGTTCGGTGGGGCAGTTCTTC	CAWTVIRGSVGQFF	TRBV30	TRBJ2-1
TGTGCCAGCAGCGGGGGGCGGGAGCAGTACTTC	CASSGGREQYF	TRBV7-9	TRBJ2-7
TGTGCCAGCAGTCGACTCGCTGAGCAGTTCTTC	CASSRLAEQFF	TRBV3-1	TRBJ2-1
TGTGCCAGCAGCAGGACGGATCTAGAGACCCAGTACTTC	CASSRTDLETQYF	TRBV13	TRBJ2-5
TGCGCCAGCAGTGTTGCCCCTAAAGATCAGCCCCAGCATTTT	CASSVAPKDQPQHF	TRBV10-1	TRBJ1-5
TGTGCCAGCAGCTCGGCTTTGGTACCGGGCTCCTATAATTCACCCCTCCACTTT	CASSSALVPGSYNSPLHF	TRBV5-6	TRBJ1-6
TGTGCCAGCGTCCCTAGCGGGGGGGCCAGGAACACCGGGGAGCTGTTTTTT	CASVPSGGARNTGELFF	TRBV6-5	TRBJ2-2
TGTGCCAGCAGCTCCCGGGTCTGGGCCGGAAGCGGGGAGCTGTTTTTT	CASSSRVWAGSGELFF	TRBV6-1	TRBJ2-2
TGTGCCTGGACTCCCACGATGGCAGATACGCAGTATTTT	CAWTPTMADTQYF	TRBV30	TRBJ2-3
TGTGCCAGCAGCTTGGTACGGGGGCTTAACTATGGCTACACCTTC	CASSLVRGLNYGYTF	TRBV5-8	TRBJ1-2
TGTGCCAGCAGCTTACAGACCAACAGGGGCCCGAGGGATCAGCCCCAGCATTTT	CASSLQTNRGPRDQPQHF	TRBV7-8	TRBJ1-5
TGTGCCAGCACAAGGGGGAGAATCGCATTTCTAGGGGAGCAGTACTTC	CASTRGRIAFLGEQYF	TRBV12-4	TRBJ2-7
TGCAGTGCTAGTACGACAGGGGGATTTACAGAGCAGTTCTTC	CSASTTGGFTEQFF	TRBV20-1	TRBJ2-1
TGTGCCAGCAGCTTAGGAGGGAAGGAAGCATACAATGAGCAGTTCTTC	CASSLGGKEAYNEQFF	TRBV7-2	TRBJ2-1
TGTGCCAGCAGCCAAGATTTACAGGGTATTGAAAAACTGTTTTTT	CASSQDLQGIEKLFF	TRBV14	TRBJ1-4
TGTGCCAGCAGTTACTCCGGGACCGCCCTCTACGAGCAGTACTTC	CASSYSGTALYEQYF	TRBV6-6	TRBJ2-7
TGTGCCAGCAGGAGGATAGGGTTAGGCCAAGAGACCCAGTACTTC	CASRRIGLGQETQYF	TRBV6-1	TRBJ2-5
TGTGCCAGCAGCCAGCAACAAAACTATTCTCAGCCCCAGCATTTT	CASSQQQNYSQPQHF	TRBV7-6	TRBJ1-5
TGTGCCAGCAGAACTCGACTAGCGGGACTTGGGTACACCGGGGAGCTGTTTTTT	CASRTRLAGLGYTGELFF	TRBV2	TRBJ2-2
TGTGCCAGCAGTGAAGCTTTTACGGGGGTGGCCTACGAGCAGTACTTC	CASSEAFTGVAYEQYF	TRBV6-1	TRBJ2-7
TGTGCCAGCAGCTTAAAAGGAGGAGGCTGCAATCAGCCCCAGCATTTT	CASSLKGGGCNQPQHF	TRBV7-9	TRBJ1-5
TGCGCCAGCAGCTGCCAGGGGAGAAATGAAAAACTGTTTTTT	CASSCQGRNEKLFF	TRBV5-1	TRBJ1-4
TGCAGTGCTAGATCGGGGGGGGTGGTAGTCTTACGGAGAGGCTACAATGAGCAGTTCTTC	CSARSGGVVVLRRGYNEQFF	TRBV20-1	TRBJ2-1
TGTGCCAGTCCCTCCCTAGCGGGGGTTCGCACCGGGGAGCTGTTTTTT	CASPSLAGVRTGELFF	TRBV19	TRBJ2-2
TGCAGTGCTAGGACAGGGAATGGGAACACTGAAGCTTTCTTT	CSARTGNGNTEAFF	TRBV20-1	TRBJ1-1
TGCGCCAGCGGGAGTGGACGTGAAAAACTGTTTTTT	CASGSGREKLFF	TRBV4-1	TRBJ1-4
TGTGCCAGCAGTGGCCGGGACGGCTCCCTGAACACTGAAGCTTTCTTT	CASSGRDGSLNTEAFF	TRBV6-2	TRBJ1-1
TGTGCCAGCAGTGGAACAGGTCTTAACACCGGGGAGCTGTTTTTT	CASSGTGLNTGELFF	TRBV25-1	TRBJ2-2
TGTGCCAGCAGTGAATCAGCCCGGGACAGCCCATATGTTCCGCAGTACTTC	CASSESARDSPYVPQYF	TRBV6-1	TRBJ2-7
TGTGCAAATAGCGGGCTCCGGGCGTACAATGAGCAGTTCTTC	CANSGLRAYNEQFF	TRBV27	TRBJ2-1
TGCGCCAGCAGTGAACGAATGGACGGGGAGGATGAGCAGTTCTTC	CASSERMDGEDEQFF	TRBV10-2	TRBJ2-1
TGTGCCAGCAGCTTAGAGTCACAGGGGTTCTATGGCTACACCTTC	CASSLESQGFYGYTF	TRBV7-3	TRBJ1-2
TGTGCCAGCATACTAGCGGGAGGGCCCTATGGCTACACCTTC	CASILAGGPYGYTF	TRBV9	TRBJ1-2
TGTGCTAGTGGCAGGGACCCTGCTAGCACAGATACGCAGTATTTT	CASGRDPASTDTQYF	TRBV12-5	TRBJ2-3
TGTGCCAGCAGCAAAACGGCGGCCAAAAGTAATTCACCCCTCCACTTT	CASSKTAAKSNSPLHF	TRBV9	TRBJ1-6
TGTGCCAGCAGTGGACAGCTGGACACTGAAGCTTTCTTT	CASSGQLDTEAFF	TRBV25-1	TRBJ1-1
TGTGCCAGCAGTTCACAACCCGAAGGGGGAGGCCCTGAGGAAGCTTTCTTT	CASSSQPEGGGPEEAFF	TRBV6-4	TRBJ1-1
TGTGCCAAACGACAGCTTAAGAGAAGGTCTGAAGCTTTCTTT	CAKRQLKRRSEAFF	TRBV6-6	TRBJ1-1
TGCAGTGCTAGAGGAGGTGGTATATACAATGAGCAGTTCTTC	CSARGGGIYNEQFF	TRBV20-1	TRBJ2-1
TGTGCCAGCCCCCTCCGGGGAGGCTACGAGCAGTACTTC	CASPLRGGYEQYF	TRBV6-1	TRBJ2-7
TGCGCTGCGGCCACAGGGGAAAAAGCCGGGGAGCTGTTTTTT	CAAATGEKAGELFF	TRBV10-1	TRBJ2-2
TGTGCCAGTATCCAGGGAATGAATGGCTACACCTTC	CASIQGMNGYTF	TRBV19	TRBJ1-2
TGTGCCACCAGGGTCCAGGGGCGGGAGCCCGAAGCTTTCTTT	CATRVQGREPEAFF	TRBV24-1	TRBJ1-1
TGTGCCAGCAGGGCGGGAAACATTCAGTACTTC	CASRAGNIQYF	TRBV6-5	TRBJ2-4
TGTGCCAGCACAGCGACCAGCGGATCCTATAATTCACCCCTCCACTTT	CASTATSGSYNSPLHF	TRBV6-1	TRBJ1-6
TGTGCCAGCAGCACGGGCGCCTCTGGGGCCAACGTCCTGACTTTC	CASSTGASGANVLTF	TRBV11-2	TRBJ2-6
TGTGCCACCAGTGATACGGGGCATTCGAACACCGGGGAGCTGTTTTTT	CATSDTGHSNTGELFF	TRBV24-1	TRBJ2-2
TGCGCCAGCAAGGACGGGATGTCCTACGAGCAGTACTTC	CASKDGMSYEQYF	TRBV10-2	TRBJ2-7
TGTGCCACCAGCAGAGGATTCGACCTCCACGAGCAGTACTTC	CATSRGFDLHEQYF	TRBV15	TRBJ2-7
TGTGCCAGCAGACATCCTTTCTACGAGCAGTACTTC	CASRHPFYEQYF	TRBV7-6	TRBJ2-7
TGTGCCAGCAGTGCCCAGGGACAGGGGGCGAACACTGAAGCTTTCTTT	CASSAQGQGANTEAFF	TRBV2	TRBJ1-1
TGTGCCAGCAGCTATTGGACAGGGCGAGGGAGAGGGCAGCCCCAGCATTTT	CASSYWTGRGRGQPQHF	TRBV6-5	TRBJ1-5
TGTGCCAGCAGCCCAACTCGAGATACAGATACGCAGTATTTT	CASSPTRDTDTQYF	TRBV9	TRBJ2-3
TGTGCCAGCAGCCAAGAGGGGCGCCCCGGGGAGCTGTTTTTT	CASSQEGRPGELFF	TRBV3-1	TRBJ2-2
TGCGCCAGCAGGGGGCCCAGGGGGCGCCTCCTTCCCTATGGCTACACCTTC	CASRGPRGRLLPYGYTF	TRBV4-3	TRBJ1-2
TGTGCCAGCAGTCCCCTAGATAACAGCCGGAACACTGAAGCTTTCTTT	CASSPLDNSRNTEAFF	TRBV27	TRBJ1-1
TGTGCCAGCAGCTTGCCACCCCGGACAGGGGGCAATCAGCCCCAGCATTTT	CASSLPPRTGGNQPQHF	TRBV5-5	TRBJ1-5
TGCGCCAGCAGGCTGAGGACTAGCGGGCCCTACAATGAGCAGTTCTTC	CASRLRTSGPYNEQFF	TRBV10-2	TRBJ2-1
TGTGCTAGTGTAGAAAAATGCTTC	CASVEKCF	TRBV12-5	TRBJ2-7
TGCGCCAGCAGCAGTCGGGGCGTACAGCCCCAGCATTTT	CASSSRGVQPQHF	TRBV5-1	TRBJ1-5
TGTGCCAGCAGCGTAAAAGAGTGCGGTATTCACGAGCAGTACTTC	CASSVKECGIHEQYF	TRBV13	TRBJ2-7
TGTGCCAGCTCACACGACAGGAGATGTAACTATGGCTACACCTTC	CASSHDRRCNYGYTF	TRBV18	TRBJ1-2
TGCAGTGTGAGCGACAGAGCCCCCCTCCACTTT	CSVSDRAPLHF	TRBV20-1	TRBJ1-6
TGTGCCAGCAGCTTAGTGCAGCCCCTCCCGGGACTTCCGGGAGAGGAAGAGACCCAGTACTTC	CASSLVQPLPGLPGEEETQYF	TRBV7-3	TRBJ2-5
TGTGCCAGTAGTAGGGTCGCTAACGGGGGGGACAGGGGGTTCAGATACGAGCAGTACTTC	CASSRVANGGDRGFRYEQYF	TRBV19	TRBJ2-7
TGTGCCTGGGGCCCCACAGATACGCAGTATTTT	CAWGPTDTQYF	TRBV30	TRBJ2-3
TGCGCCAGCAGTGAGTCCCGTTCCAAGCGATATTCACCCCTCCACTTT	CASSESRSKRYSPLHF	TRBV10-1	TRBJ1-6
TGCGCCAGCAGCAGATTAGGACAGGGTCGGTACTTC	CASSRLGQGRYF	TRBV5-1	TRBJ2-5
TGTGCCACCAGGCGGGGTGAAAAACTGTTTTTT	CATRRGEKLFF	TRBV24-1	TRBJ1-4
TGTGCCAGCAGTGAAGCTACCGAGGTGGTTGGGCGTTTAGGCTACACCTTC	CASSEATEVVGRLGYTF	TRBV6-1	TRBJ1-2
TGTGCTAGTGGTCAAAGTTACGCTAGTCTCTTC	CASGQSYASLF	TRBV12-5	TRBJ2-1
TGTGCCAGCAGTTTTCCCTTCGTCGAGCGGGAACCCCCCGAGCAGTACTTC	CASSFPFVEREPPEQYF	TRBV27	TRBJ2-7
TGTGCCACCAGCAGAGATCCCGCGCGGGAGTCCACCTACGAGCAGTACTTC	CATSRDPARESTYEQYF	TRBV15	TRBJ2-7
TGTGCCCTATGCCGGACAGGGCCCGACCTCTACGAGCAGTACTTC	CALCRTGPDLYEQYF	TRBV24-1	TRBJ2-7
TGTGCCAGCAGCCTCCATCCGCAATCGGGACTAGCCGGAACTTGCTTAGAGACCCAGTACTTC	CASSLHPQSGLAGTCLETQYF	TRBV5-8	TRBJ2-5
TGTGCCAGCAGCTATGGGACAGGGTTGGAACAAGATGGCTACACCTTC	CASSYGTGLEQDGYTF	TRBV11-3	TRBJ1-2
TGCGCCAGCCTCAAGGGGACAGGGCTCAATGAGCAGTTCTTC	CASLKGTGLNEQFF	TRBV10-2	TRBJ2-1
TGTGCGGATGGACAGGGGGGGAGATCCCTCACAGATACGCAGTATTTT	CADGQGGRSLTDTQYF	TRBV15	TRBJ2-3
TGTGCCAGCAGTTTGGGTCGCCAGGGTGCAGAGACTGAAGCTTTCTTT	CASSLGRQGAETEAFF	TRBV27	TRBJ1-1
TGTGCCAGCAGTTACAGGGGGGGGCGGGGCTACGAGCAGTACTTC	CASSYRGGRGYEQYF	TRBV6-6	TRBJ2-7
TGTGCTAGTGGTCGCGTGAACACTGAAGCTTTCTTT	CASGRVNTEAFF	TRBV12-5	TRBJ1-1
TGCAGTGCTAGAATCCGCGGACAGGATGGCTACACCTTC	CSARIRGQDGYTF	TRBV20-1	TRBJ1-2
TGTGCCAGTACCGGGCAGGCTAAGTCCCTCCACTTT	CASTGQAKSLHF	TRBV9	TRBJ1-6
TGTGCCAGCAGCCCATCACAGGGGCCCGGGGGATGGCAGCCCCAGCATTTT	CASSPSQGPGGWQPQHF	TRBV9	TRBJ1-5
TGTGCCAGCAGCCGTAGGTGGTTTAGCGGGATTGGGAAAGCACAAGAGACCCAGTACTTC	CASSRRWFSGIGKAQETQYF	TRBV3-1	TRBJ2-5
TGTGCCAGCAGCCCCCTCAGGGTACTGTTACACTATGGCTACACCTTC	CASSPLRVLLHYGYTF	TRBV7-3	TRBJ1-2
TGTGCCAGTACGATGGACCAAATGAGCTCCTACAATGAGCAGTTCTTC	CASTMDQMSSYNEQFF	TRBV19	TRBJ2-1
TGTGCCAGCAGTTTAGAACGGGGGATCAATGAGCAGTTCTTC	CASSLERGINEQFF	TRBV12-3	TRBJ2-1
TGTGCCAGCAGCTCCCAAGGACAGGCCCGGACCCAGTACTTC	CASSSQGQARTQYF	TRBV7-9	TRBJ2-5
TGTGCCAGCCAGCACTGTACTAGTTCCCCAGGGAGGACCGGGGAGCTGTTTTTT	CASQHCTSSPGRTGELFF	TRBV7-9	TRBJ2-2
TGCAGTGCTAGTGGGGGCAACGGCATGAACACTGAAGCTTTCTTT	CSASGGNGMNTEAFF	TRBV20-1	TRBJ1-1
TGTGCCAGCAGCGTAGCGACGGGGCGTGACGTTGACAGGTATGTAGGGGACAATGAGCAGTTCTTC	CASSVATGRDVDRYVGDNEQFF	TRBV9	TRBJ2-1
TGTGCCAGCAGCACAGCAGGGGAGGCCCTCAAAAACATTCAGTACTTC	CASSTAGEALKNIQYF	TRBV7-6	TRBJ2-4
TGTGCCAGCAGCCTGGATTCGGGGGGGGGGGTCAATGAGCAGTTCTTC	CASSLDSGGGVNEQFF	TRBV27	TRBJ2-1
TGTGCCAGTAGTTTCAAACCTCCATCCTCGACATTCTCTGGGGCCAACGTCCTGACTTTC	CASSFKPPSSTFSGANVLTF	TRBV19	TRBJ2-6
TGCGCCAGCAGTGACGCGCAGCAATGGGACGAGCAGTACTTC	CASSDAQQWDEQYF	TRBV10-2	TRBJ2-7
TGTGCCAGCAGCTTAGCCCCTAGAATTTGGGGGGCTCGAAGGGACACCGGGGAGCTGTTTTTT	CASSLAPRIWGARRDTGELFF	TRBV7-9	TRBJ2-2
TGCGCCAGCAGCTGGGTCCTGCGGGATCCTAGCACAGATACGCAGTATTTT	CASSWVLRDPSTDTQYF	TRBV5-1	TRBJ2-3
TGTGCCAGCAGGACAGGGGGGCCCCAGCATTTT	CASRTGGPQHF	TRBV6-4	TRBJ1-5
TGTGCCAGCAGCTTCCACCTGTCAGTTGATCAGCCCCAGCATTTT	CASSFHLSVDQPQHF	TRBV11-2	TRBJ1-5
TGTGCCAGCAGCGAGACTCATTCACCCCTCCACTTT	CASSETHSPLHF	TRBV5-4	TRBJ1-6
TGTGCCAAAGCGGGACTGGGACGTGGTCGGACAGATACGCAGTATTTT	CAKAGLGRGRTDTQYF	TRBV27	TRBJ2-3
TGCAGCGGATCCCGGGGACCAGGTACGCAGTATTTT	CSGSRGPGTQYF	TRBV29-1	TRBJ2-3
TGCGCCAGCTCGGAGAGGATATTGCAGGTGAACACTGAAGCTTTCTTT	CASSERILQVNTEAFF	TRBV10-1	TRBJ1-1
TGTGCCAGCAGTTTACATAGGCAGTTCTTC	CASSLHRQFF	TRBV27	TRBJ2-1
TGTGCCAGCGATTTCTTAGCCCGGGAGTACTTC	CASDFLAREYF	TRBV27	TRBJ2-7
TGTGCCAGCAGTGAAGGACCTGGACTAGCGCGTATCGGGGAGCTGTTTTTT	CASSEGPGLARIGELFF	TRBV6-1	TRBJ2-2
TGTGCCAGCAGCCCTGCTTCCCGTAGCAATCAGCCCCAGCATTTT	CASSPASRSNQPQHF	TRBV9	TRBJ1-5
TGTGCCAGCAGCCTGGGGACAGCCGCGAATGAGCAGTTCTTC	CASSLGTAANEQFF	TRBV7-9	TRBJ2-1
TGTGCCAGCAGTTGCCAGAGGACAGAAGATGAAAAACTGTTTTTT	CASSCQRTEDEKLFF	TRBV27	TRBJ1-4
TGTGCCAGCACGAACGGCCGCTACGAGCAGTACTTC	CASTNGRYEQYF	TRBV28	TRBJ2-7
TGTGCCAGCAGGGCTTGGGGAGACCACAATGAGCAGTTCTTC	CASRAWGDHNEQFF	TRBV7-9	TRBJ2-1
TGTGCCAGCAGCCTGGGGAATTCCTACGAGCAGTACTTC	CASSLGNSYEQYF	TRBV7-3	TRBJ2-7
TGTGCCAGCAGCCTTAAAAGGAGACTTTTCTACGAGCAGTACTTC	CASSLKRRLFYEQYF	TRBV4-2	TRBJ2-7
TGCGCCAGCAGTGAGCCGTCAGCGGGACTAGAGGTCTCAGCTGGTGAGACCCAGTACTTC	CASSEPSAGLEVSAGETQYF	TRBV10-1	TRBJ2-5
TGTGCCTGGAGTGTCACGGAGAACAATCAGCCCCAGCATTTT	CAWSVTENNQPQHF	TRBV30	TRBJ1-5
TGTGCCAGCAGCTTACCACCGGGGGAAGTACCTAGCTCCTATAATTCACCCCTCCACTTT	CASSLPPGEVPSSYNSPLHF	TRBV11-2	TRBJ1-6
TGTGCCAGCAGCATAGAAGCAGACATCCACTATGGCTACACCTTC	CASSIEADIHYGYTF	TRBV27	TRBJ1-2
TGCAGTGCTATTTTGAGGGGTGGCGAAGCTTTCTTT	CSAILRGGEAFF	TRBV20-1	TRBJ1-1
TGTGCCAGCTCACCAAAGATCGAAACCGGGACGTTGCAAGAGACCCAGTACTTC	CASSPKIETGTLQETQYF	TRBV18	TRBJ2-5
TGCGCCAGGGGGGGGGGGGGGCCCTACGAGCAGTACTTC	CARGGGGPYEQYF	TRBV10-1	TRBJ2-7
TGTGCCACCAGTGATTTGCCCGACCACCTTCTGGGACGCACAGATACGCAGTATTTT	CATSDLPDHLLGRTDTQYF	TRBV24-1	TRBJ2-3
TGTGCCAGCAGCTTAGTAAGGTTACTGGACAGGGCAAGGGCCTATAATTCACCCCTCCACTTT	CASSLVRLLDRARAYNSPLHF	TRBV7-2	TRBJ1-6
TGTGCCAGCAGCTTAGCCAACGGGACTAGCGGGCCCGATACGCAGTATTTT	CASSLANGTSGPDTQYF	TRBV11-3	TRBJ2-3
TGTGCCAGCATTTGGTTGGTAGGTTTAAATCAGCCCCAGCATTTT	CASIWLVGLNQPQHF	TRBV2	TRBJ1-5
TGCAGTGCTCTCCCGGCCACTAGCGGGAGATTCCCCTCCTACAATGAGCAGTTCTTC	CSALPATSGRFPSYNEQFF	TRBV20-1	TRBJ2-1
TGTGCCAGCAGCTACCTTCGGGGATCGGTGGGTCAGCCCCAGCATTTT	CASSYLRGSVGQPQHF	TRBV7-8	TRBJ1-5
TGCGCCAGCAGCCGGGACAGCAAGCCCCAGCATTTT	CASSRDSKPQHF	TRBV5-1	TRBJ1-5
TGCAGTGCCGAATCCCCCAATACGACAGCGACCTACGAGCAGTACTTC	CSAESPNTTATYEQYF	TRBV20-1	TRBJ2-7
TGTGCCAGCAGCAGGACAGGGGGCTCGAGGAGTATTGGCTACACCTTC	CASSRTGGSRSIGYTF	TRBV11-2	TRBJ1-2
TGTGCCACCACTCATCCCTTGAGGGAGGTATACTCCTACGAGCAGTACTTC	CATTHPLREVYSYEQYF	TRBV24-1	TRBJ2-7
TGTGCCAGCAGTTGGGGACAGGGAATAGACTACAATGAGCAGTTCTTC	CASSWGQGIDYNEQFF	TRBV27	TRBJ2-1
TGCGCCAGCAGTTGCTGTCAGGGGGGGCTTCACGAGCAGTACTTC	CASSCCQGGLHEQYF	TRBV10-1	TRBJ2-7
TGTGCCAGCAGCACTGGGTTACGTACTGGAAACACCATATATTTT	CASSTGLRTGNTIYF	TRBV7-4	TRBJ1-3
TGTGCCAGCAGCTCTAGGGTCGAACGGAATCAGCCCCAGCATTTT	CASSSRVERNQPQHF	TRBV7-2	TRBJ1-5
TGTGCCAGCAGCTACAACCTCCGTTACGGGGGGGGAAACAATGAGCAGTTCTTC	CASSYNLRYGGGNNEQFF	TRBV7-9	TRBJ2-1
TGTGCCAGCAGCTCCCCCCACCTGGACAATAGTTCACCCCTCCACTTT	CASSSPHLDNSSPLHF	TRBV5-6	TRBJ1-6
TGTGCCAGCAGCTCACCCCATCGAGATTACATAATGAACACTGAAGCTTTCTTT	CASSSPHRDYIMNTEAFF	TRBV7-2	TRBJ1-1
TGCGCCAGCAGCCAAGATGACCCGCGCATTACAGATACGCAGTATTTT	CASSQDDPRITDTQYF	TRBV4-1	TRBJ2-3
TGTGCCAGCAGCTTAAGAGACCCACTAGTGGCCTACAATGAGCAGTTCTTC	CASSLRDPLVAYNEQFF	TRBV7-6	TRBJ2-1
TGTGCCACCAGTGCTTTCGGGGGGATTCCCGGAGATACGCAGTATTTT	CATSAFGGIPGDTQYF	TRBV24-1	TRBJ2-3
TGTGCCAGCAGCCGACTACTAGGTCACAATGAGCAGTTCTTC	CASSRLLGHNEQFF	TRBV7-9	TRBJ2-1
TGTGCCAGCAGTTTAAGCGGCGACACTGAAGCTTTCTTT	CASSLSGDTEAFF	TRBV27	TRBJ1-1
TGCACCCCAGCTGGGGGAGTTCAGCCCCATCAGCCCCAGCATTTT	CTPAGGVQPHQPQHF	TRBV20-1	TRBJ1-5
TGTGCCACCAGTGAGAGGGACAGGGACTACGAGCAGTACTTC	CATSERDRDYEQYF	TRBV24-1	TRBJ2-7
TGTGCCAGCAGCTCTCTGGGGGCCCATAGTCATGAGCAGTTCTTC	CASSSLGAHSHEQFF	TRBV9	TRBJ2-1
TGTGCCAGCAGCTTGGAGACACCGCCCGGATCCCTCCACTTT	CASSLETPPGSLHF	TRBV5-4	TRBJ1-6
TGCAGCGTTGGGAATCGACAGGGCTTTTCCTACGAGCAGTACTTC	CSVGNRQGFSYEQYF	TRBV29-1	TRBJ2-7
TGCGCCAGCAGCTTGGAGAGAACCCGACAGGGGGCCAATCAGCCCCAGCATTTT	CASSLERTRQGANQPQHF	TRBV5-1	TRBJ1-5
TGCGCCAGCAGCCAAGGGAACAGGGAAGAGACCCAGTACTTC	CASSQGNREETQYF	TRBV4-1	TRBJ2-5
TGTGCCAGCAGCCAGAGTCTAGCCCGCGAGCAGTACTTC	CASSQSLAREQYF	TRBV7-4	TRBJ2-7
TGTGCCAGCAGCTTTGGGACTAGCGGGCCCCTCCCAGATACGCAGTATTTT	CASSFGTSGPLPDTQYF	TRBV5-4	TRBJ2-3
TGTGCCAGCAGTGCAGACAGGGGGCCGGATGGCTACACCTTC	CASSADRGPDGYTF	TRBV6-1	TRBJ1-2
TGTGCCAGCAGCACGAGACAACGGGCCAAAAACATTCAGTACTTC	CASSTRQRAKNIQYF	TRBV7-9	TRBJ2-4
TGTGCCAGCAGTCACAAACAGGCTCCCCGTTGTAACTATGGCTACACCTTC	CASSHKQAPRCNYGYTF	TRBV6-5	TRBJ1-2
TGTGCCAGCACCCCCAGGGGGGCCAATCAGCCCCAGCATTTT	CASTPRGANQPQHF	TRBV7-9	TRBJ1-5
TGTGCCAGCAGGTCCCCTAACGGGACAGCGGGACCTAATGAGCAGTTCTTC	CASRSPNGTAGPNEQFF	TRBV25-1	TRBJ2-1
TGTGCCAGCAGTTTCTGCTCTAATACCCAAGAGACCCAGTACTTC	CASSFCSNTQETQYF	TRBV12-3	TRBJ2-5
TGTGCCAGCAGCCAACGGCTAGGACAGGGACCCAATCAGCCCCAGCATTTT	CASSQRLGQGPNQPQHF	TRBV5-6	TRBJ1-5
TGTGCCAGCAGCCCGTCAGGACCAAGCAATCAGCCCCAGCATTTT	CASSPSGPSNQPQHF	TRBV11-3	TRBJ1-5
TGTGCCAGCAAGAAGCCTAACTCCTACGAGCAGTACTTC	CASKKPNSYEQYF	TRBV3-1	TRBJ2-7
TGTGCCAGCAGTGGCATAAGTTCACCCCTCCACTTT	CASSGISSPLHF	TRBV6-1	TRBJ1-6
TGTGCCAGCAGCTTGGTCCTTTCAACCTTATCATTAGCGGGGATGTACTCCTACAATGAGCAGTTCTTC	CASSLVLSTLSLAGMYSYNEQFF	TRBV5-6	TRBJ2-1
TGTGCCAGCAGCTTAGAATTTAGGGGGTTTAGCAATCAGCCCCAGCATTTT	CASSLEFRGFSNQPQHF	TRBV13	TRBJ1-5
TGTGCCAGCAATACTGGGCCTGTGCAGTACTTC	CASNTGPVQYF	TRBV6-5	TRBJ2-7
TGTGCCAGCGGGGACAGCTATGGCTACACCTTC	CASGDSYGYTF	TRBV6-1	TRBJ1-2
TGTGCCAGCAGTTACCCACACATCTCGGCTGGGGAGCTGTTTTTT	CASSYPHISAGELFF	TRBV6-5	TRBJ2-2
TGTGCCAGCAGCGAACCCCTCAACACAGATACGCAGTATTTT	CASSEPLNTDTQYF	TRBV6-4	TRBJ2-3
TGTGCCAGCAGTGTCTCTGGACAGGGGTCTGAAAAACTGTTTTTT	CASSVSGQGSEKLFF	TRBV6-4	TRBJ1-4
TGTGCCAGCAGTGAAATGAAGTTCCTAGCGGCCTACAATGAGCAGTTCTTC	CASSEMKFLAAYNEQFF	TRBV2	TRBJ2-1
TGTGCCAGCAGCTTATTGGGGACTAGCGGCTCCTACGAGCAGTACTTC	CASSLLGTSGSYEQYF	TRBV11-3	TRBJ2-7
TGTGCCACCAGCAGACCGGACAGCGAATACAATGAGCAGTTCTTC	CATSRPDSEYNEQFF	TRBV15	TRBJ2-1
TGTGCCAGCAGCTTATTAGATCGGGGACCCCGCACAGATACGCAGTATTTT	CASSLLDRGPRTDTQYF	TRBV11-2	TRBJ2-3
TGTGCCAGCAGCCAAACAGGGAGATTTGAAGCTTTCTTT	CASSQTGRFEAFF	TRBV5-6	TRBJ1-1
TGTGCCAGCAGCTGCCGGGGGGGCAGGAAGAACACTGAAGCTTTCTTT	CASSCRGGRKNTEAFF	TRBV7-9	TRBJ1-1
TGTGCCAGCAGCCAAGATACCGACAGGGGGCGGAGGTATAGCAATCAGCCCCAGCATTTT	CASSQDTDRGRRYSNQPQHF	TRBV14	TRBJ1-5
TGTGCCAGCAGCCCATGGACAGCAACCCTTGGCTACACCTTC	CASSPWTATLGYTF	TRBV7-3	TRBJ1-2
TGTGCCAGCAGCTTAAATGCCGGACGAAAGAATCAGCCCCAGCATTTT	CASSLNAGRKNQPQHF	TRBV11-2	TRBJ1-5
TGTGCCAGCAGTGACTCACCTGGGGGGGGTGCCTACGAGCAGTACTTC	CASSDSPGGGAYEQYF	TRBV6-4	TRBJ2-7
TGTGCCAGCAGGAGACAGGGCCCACGGACTGAAGCTTTCTTT	CASRRQGPRTEAFF	TRBV28	TRBJ1-1
TGCAGTGCAAGTCAGGCCGTTGATCAGCCCCAGCATTTT	CSASQAVDQPQHF	TRBV20-1	TRBJ1-5
TGTGCCAGCCGACCCGGTAAGGACGGTCCGGATGAGCAGTTCTTC	CASRPGKDGPDEQFF	TRBV6-1	TRBJ2-1
TGTGCCACCAGTGGGACTAGCGGGAGGGCCCTACCCGGTCAGCCCCAGCATTTT	CATSGTSGRALPGQPQHF	TRBV24-1	TRBJ1-5
TGTGCCAGCAACAGGGGGAGTAGCAATCAGCCCCAGCATTTT	CASNRGSSNQPQHF	TRBV27	TRBJ1-5
TGTGCCAGCAGCTTACAGGGACCTGGCTACACCTTC	CASSLQGPGYTF	TRBV7-9	TRBJ1-2
TGTGCCACAGAGGGAGTCACTGAAGCTTTCTTT	CATEGVTEAFF	TRBV6-2	TRBJ1-1
TGTGCCAGCAGCGCCCCCAGTCAGGCTAAAGAGACCCAGTACTTC	CASSAPSQAKETQYF	TRBV9	TRBJ2-5
TGTGCCAGCTCATTGTTCGGACAGGGACCCAACTATGGCTACACCTTC	CASSLFGQGPNYGYTF	TRBV18	TRBJ1-2
TGTGCCAGCAGCGTAGAGCTAGAGGGCTGGAATCAGCCCCAGCATTTT	CASSVELEGWNQPQHF	TRBV9	TRBJ1-5
TGCAGTGCTAGAGTGGGGACAGGCGGCTATGGCTACACCTTC	CSARVGTGGYGYTF	TRBV20-1	TRBJ1-2
TGTGCCACCAGTTGGACAGAGGGAAACACCATATATTTT	CATSWTEGNTIYF	TRBV24-1	TRBJ1-3
TGCAGCGTTGGGGGACAGTCCTCTGGAAACACCATATATTTT	CSVGGQSSGNTIYF	TRBV29-1	TRBJ1-3
TGCAGTGCTAGAGATAACCCCCCTGGGGTCATCTCTGGAAACACCATATATTTT	CSARDNPPGVISGNTIYF	TRBV20-1	TRBJ1-3
TGTGCCAGCAGCTTGGGAAAAAGGGGGGATGCTTTCTTT	CASSLGKRGDAFF	TRBV11-3	TRBJ1-1
TGTGCCAGCAGTAACATCCCCACAGGGTTTGTCCCGGACTATGGCTACACCTTC	CASSNIPTGFVPDYGYTF	TRBV6-2	TRBJ1-2
TGTGCCAGCAGTCGTCCGGGACAGTGTGACTTC	CASSRPGQCDF	TRBV6-1	TRBJ2-7
TGTGCCAGCAGCTTTAATGAGGAGTCTTATTACGAGCAGTACTTC	CASSFNEESYYEQYF	TRBV5-4	TRBJ2-7
TGCAGTGCTAGAGATCCCGGAGTCGGTCCGTACCAAGAGACCCAGTACTTC	CSARDPGVGPYQETQYF	TRBV20-1	TRBJ2-5
TGTGCCAGCACTAGCGGTGTTTCCTACAATGAGCAGTTCTTC	CASTSGVSYNEQFF	TRBV7-3	TRBJ2-1
TGTGCCAGCAGCCTGGGACAGTTTGGAACCGGGGAGCTGTTTTTT	CASSLGQFGTGELFF	TRBV7-3	TRBJ2-2
TGTGCCACCAGTGATTTTATTTCCGACAGGGGTTGGTTTGATTATGGCTACACCTTC	CATSDFISDRGWFDYGYTF	TRBV24-1	TRBJ1-2
TGTGCCAGCAGCTTGTATACGTCTGGGCGCCGCTCCTACGAGCAGTACTTC	CASSLYTSGRRSYEQYF	TRBV5-5	TRBJ2-7
TGTGCCAACCCATCAGGGGGCGCGAACGAGCAGTACTTC	CANPSGGANEQYF	TRBV19	TRBJ2-7
TGTGCCAGCAGTCCTGGAGGAGGGGGTAACACTGAAGCTTTCTTT	CASSPGGGGNTEAFF	TRBV6-2	TRBJ1-1
TGTGCCAGCAGCTTAGTGTGGCTTGAACTAGCCAGACAGGTAGAGACCCAGTACTTC	CASSLVWLELARQVETQYF	TRBV11-3	TRBJ2-5
TGCAGCTTATGGGGACTCTACGAGCAGTACTTC	CSLWGLYEQYF	TRBV29-1	TRBJ2-7
TGTGCCAGCAGCGTAGTTTTGACCGGGACAACGATAGATAAAGAGACCCAGTACTTC	CASSVVLTGTTIDKETQYF	TRBV9	TRBJ2-5
TGTGCCAGTAGTATACCAAGCGGGAGTTGCTCCTACAATGAGCAGTTCTTC	CASSIPSGSCSYNEQFF	TRBV19	TRBJ2-1
TGTGCCACCAGCGTAGCGGGGATGTATGAGCAGTTCTTC	CATSVAGMYEQFF	TRBV24-1	TRBJ2-1
TGTGCCAAGGGGGGCCCAATAGAAGCTTTCTTT	CAKGGPIEAFF	TRBV9	TRBJ1-1
TGTGCCAGCAGTGAAGTAACAGAGGGGGCGTTGAACACTGAAGCTTTCTTT	CASSEVTEGALNTEAFF	TRBV6-1	TRBJ1-1
TGCGCCAGCTCGACAGGGTCCTCCTCCTACGAGCAGTACTTC	CASSTGSSSYEQYF	TRBV5-1	TRBJ2-7
TGTGCTAGTGGTTGGTTTCGATTTCGGGGAAAGGAAAAACTGTTTTTT	CASGWFRFRGKEKLFF	TRBV12-5	TRBJ1-4
TGTGCCAGCCCGGAGACAGGGGGCCACACCATATATTTT	CASPETGGHTIYF	TRBV6-6	TRBJ1-3
TGTGCCAGCAGCTTAGGGGGACAGTCGGTGAACACTGAAGCTTTCTTT	CASSLGGQSVNTEAFF	TRBV7-2	TRBJ1-1
TGTGCTAGTGGTACCAACGGGACAGGGCACTATGGCTACACCTTC	CASGTNGTGHYGYTF	TRBV12-5	TRBJ1-2
TGTGCCAGCAGTTACGCCGAGTTTAGCAATCAGCCCCAGCATTTT	CASSYAEFSNQPQHF	TRBV6-2	TRBJ1-5
TGTGCCAGCACAGCGGGGTACAATGAGCAGTTCTTC	CASTAGYNEQFF	TRBV6-1	TRBJ2-1
TGCGCCAGCAGCCAAGATTCGGGACTAGCATGTGAACTGACAGATACGCAGTATTTT	CASSQDSGLACELTDTQYF	TRBV4-1	TRBJ2-3
TGTGCCATCAGGTTTGGGGGCATCGCTGGAAACACCATATATTTT	CAIRFGGIAGNTIYF	TRBV10-3	TRBJ1-3
TGTGCCAGCAGCGGGGCTCGTGGGGGCTACGAGCAGTACTTC	CASSGARGGYEQYF	TRBV2	TRBJ2-7
TGTGCCAGCAGCCAATGGGGGAAAACGGTAACTAATGAAAAACTGTTTTTT	CASSQWGKTVTNEKLFF	TRBV7-3	TRBJ1-4
TGTGCTAGTGGTTCACAGGGGCGGGGTCATACTGAAGCTTTCTTT	CASGSQGRGHTEAFF	TRBV12-5	TRBJ1-1
TGTGCCAGCAGCCACGCGGGAGACTCCCAAGAGACCCAGTACTTC	CASSHAGDSQETQYF	TRBV3-1	TRBJ2-5
TGTGCCAGCAGTGAACCGGGGGGTAACAATGAGCAGTTCTTC	CASSEPGGNNEQFF	TRBV6-1	TRBJ2-1
TGCGCCAGCCCGGATACAGGACCCGTTCCAGGGGGCTACACCTTC	CASPDTGPVPGGYTF	TRBV5-1	TRBJ1-2
TGTGCCAGCAGCGGAAAACATTTCGGGACTGAGACCCAGTACTTC	CASSGKHFGTETQYF	TRBV5-4	TRBJ2-5
TGTGCCAGCAGTGACTCGGCCTGGACTACAGACGAGCAGTACTTC	CASSDSAWTTDEQYF	TRBV6-4	TRBJ2-7
TGCGCCAGCAGCTTGGTTCGCTTCAGGGGGCCCACCGGGGAGCTGTTTTTT	CASSLVRFRGPTGELFF	TRBV5-1	TRBJ2-2
TGTGCCAGCAGCTTTTGGCTTGGAAACACCATATATTTT	CASSFWLGNTIYF	TRBV5-4	TRBJ1-3
TGTGCCAGCATCCCGGGGAACTGGGGCGGGGATCTGGCCTACGAGCAGTACTTC	CASIPGNWGGDLAYEQYF	TRBV7-4	TRBJ2-7
TGCGCCAGCAGTTCAGGAAGGGAGCAGTACTTC	CASSSGREQYF	TRBV10-1	TRBJ2-7
TGTGCCATCAACACGCCACAGGGGGGAAGCCTAGCCAAAAACATTCAGTACTTC	CAINTPQGGSLAKNIQYF	TRBV10-3	TRBJ2-4
TGTGCCAGCAGCCCAAGGACGAGGGCTTATGGCTACACCTTC	CASSPRTRAYGYTF	TRBV3-1	TRBJ1-2
TGCAGTGCTTCTCCCCCCACGAGGGGGGTATGGGTTGAGGCGTTGAACACTGAAGCTTTCTTT	CSASPPTRGVWVEALNTEAFF	TRBV20-1	TRBJ1-1
TGTGCCAGCAGCCGTGAACAGGCGGTCACAGCCAGCGACTCTGGGGCCAACGTCCTGACTTTC	CASSREQAVTASDSGANVLTF	TRBV5-4	TRBJ2-6
TGCGCCAGCAGCCAAGATGTAGGGGGACATTCGTTCCCTGGGGCCAACGTCCTGACTTTC	CASSQDVGGHSFPGANVLTF	TRBV4-3	TRBJ2-6
TGTGCCACCAGCAGAGCTCGCGCAGGAGTTCCGACCCAGTACTTC	CATSRARAGVPTQYF	TRBV15	TRBJ2-5
TGTGCCAGCAGTTACACCCGACTAGCGGGAGGGCAGGCTAGCACAGATACGCAGTATTTT	CASSYTRLAGGQASTDTQYF	TRBV6-5	TRBJ2-3
TGTGCCAGCAGTGAGCACAGGGGGAGCTCCTACAATGAGCAGTTCTTC	CASSEHRGSSYNEQFF	TRBV2	TRBJ2-1
TGCGCCAGCAGCTTGGGGAGGAGCGGATTTATTGGGGGCAGCTACGAGCAGTACTTC	CASSLGRSGFIGGSYEQYF	TRBV5-1	TRBJ2-7
TGTGCCAGCAGTGCTACAGGGGGCTCCGGCACTGAAGCTTTCTTT	CASSATGGSGTEAFF	TRBV2	TRBJ1-1
TGTGCCAGTAGTAAATACAGGGACGGCGAGCAGTACTTC	CASSKYRDGEQYF	TRBV19	TRBJ2-7
TGTGCCAGCAGCGTAGCTAAGGGGCGGGGATCCTACGAGCAGTACTTC	CASSVAKGRGSYEQYF	TRBV9	TRBJ2-7
TGTGCCAGCGTGATCACGGAGGGACTAGCGGGGGGCACAGATACGCAGTATTTT	CASVITEGLAGGTDTQYF	TRBV27	TRBJ2-3
TGCAGTGCTAGAGTTTCGGTCGGGACTCCTTTTGCAACTAATGAAAAACTGTTTTTT	CSARVSVGTPFATNEKLFF	TRBV20-1	TRBJ1-4
TGTGCCAGCAGCCACCCCAAAACCAGGGTTGACAATCAGCCCCAGCATTTT	CASSHPKTRVDNQPQHF	TRBV14	TRBJ1-5
TGTGCCAGTGAGACTAGCGGCTACGAGCAGTACTTC	CASETSGYEQYF	TRBV19	TRBJ2-7
TGTGCCAGCTCACCATGCGGACCCTACGAGCAGTACTTC	CASSPCGPYEQYF	TRBV18	TRBJ2-7
TGTGCCAGTAGTATGAAGGACAGGGGTGGGATGAACACTGAAGCTTTCTTT	CASSMKDRGGMNTEAFF	TRBV19	TRBJ1-1
TGTGCCAGCAGTTACCACACAGGGGGCAACGTTCGAGGAAACAACTATGGCTACACCTTC	CASSYHTGGNVRGNNYGYTF	TRBV6-3	TRBJ1-2
TGCAGTCTTGGGGGGGCGTCGGGCGTAGAGACCCAGTACTTC	CSLGGASGVETQYF	TRBV20-1	TRBJ2-5
TGTGCCCCCCGGACAGATCAGCCCCAGCATTTT	CAPRTDQPQHF	TRBV30	TRBJ1-5
TGTGCCAGTAGTAGACGGAGTTTCGGGAACACTGAAGCTTTCTTT	CASSRRSFGNTEAFF	TRBV19	TRBJ1-1
TGTGCCAGCAGATCCGGGGACAGGGGTCAAGGCTATGGCTACACCTTC	CASRSGDRGQGYGYTF	TRBV6-6	TRBJ1-2
TGTGCCAGCAGCTGTTGGGGAGGGGATGCCTATGAAAAACTGTTTTTT	CASSCWGGDAYEKLFF	TRBV11-3	TRBJ1-4
TGTGCCAGCAGGGGGGACAGAACCATATATTTT	CASRGDRTIYF	TRBV27	TRBJ1-3
TGCGCCAGCACCGGGACAGAGGCCTACGAGCAGTACTTC	CASTGTEAYEQYF	TRBV5-1	TRBJ2-7
TGCAGCGTAACAATGAACGAGCAGTACTTC	CSVTMNEQYF	TRBV29-1	TRBJ2-7
TGTGCCAGCAGCGTAGGGTCAGGACTCAACACTGAAGCTTTCTTT	CASSVGSGLNTEAFF	TRBV11-3	TRBJ1-1
TGTGCCAGCAGTTTAACCTCGAGGGATAAGGGAGGGGTAATTAATGAGCAGTTCTTC	CASSLTSRDKGGVINEQFF	TRBV27	TRBJ2-1
TGTGCCCAGTTGTCTACAGGGGAAAAAAAGGGAAACACCATATATTTT	CAQLSTGEKKGNTIYF	TRBV6-1	TRBJ1-3
TGCGCCAGCAGCTTGGTCTTTGGTGGGGGGGTCGCGAACACCGGGGAGCTGTTTTTT	CASSLVFGGGVANTGELFF	TRBV5-1	TRBJ2-2
TGTGCCAGCAGCGAAACGAGAGGGAAACAGCCCCAGCATTTT	CASSETRGKQPQHF	TRBV9	TRBJ1-5
TGTGCTAGTGGTTACGTTATATCCGACAGGGGGTACTACGAGCAGTACTTC	CASGYVISDRGYYEQYF	TRBV12-5	TRBJ2-7
TGTGCCACCAGTGATGCCTGGACAGATAGCAATCAGCCCCAGCATTTT	CATSDAWTDSNQPQHF	TRBV24-1	TRBJ1-5
TGTGCCAGCAGCCCTTCCCGGGGGGCTAGCAATCAGCCCCAGCATTTT	CASSPSRGASNQPQHF	TRBV7-4	TRBJ1-5
TGTGCCAGCAGCGTAGGGGACAGAAGCTACAATGAGCAGTTCTTC	CASSVGDRSYNEQFF	TRBV9	TRBJ2-1
TGTGCCAGCAGTCTGCCGGGGGCGGCTGAAGCTTTCTTT	CASSLPGAAEAFF	TRBV6-8	TRBJ1-1
TGTGCCAGCAGCCTAGCGGTGGACTGGAGTAAAGCCTCCTACAATGAGCAGTTCTTC	CASSLAVDWSKASYNEQFF	TRBV7-3	TRBJ2-1
TGTGCCAGCAGCACGGGGGCCCAGGGAACCGGGGAGCTGTTTTTT	CASSTGAQGTGELFF	TRBV7-3	TRBJ2-2
TGTGCCAGCAGAAAGCTAAATAGCGGGATGGGTACAGAGACCCAGTACTTC	CASRKLNSGMGTETQYF	TRBV6-5	TRBJ2-5
TGTGCCAGTACCGCAGCCCATGGCTACACCTTC	CASTAAHGYTF	TRBV19	TRBJ1-2
TGTGCCAGCAGCAGAGCACGCCAACCTCAGCCCCAGCATTTT	CASSRARQPQPQHF	TRBV13	TRBJ1-5
TGTGCCAGCTGGCAAGACAGGGGAATTCCCGGGGAGCTGTTTTTT	CASWQDRGIPGELFF	TRBV7-9	TRBJ2-2
TGTGCCAGCAGTTTAGCTCCCACAGGGTCCTACAATGAGCAGTTCTTC	CASSLAPTGSYNEQFF	TRBV27	TRBJ2-1
TGTGCCAGCAGCCAAGACAGAGACTCCTACGAGCAGTACTTC	CASSQDRDSYEQYF	TRBV13	TRBJ2-7
TGCGCCAGCAGCCTCCTACATACGGGACAGACATACAATGAGCAGTTCTTC	CASSLLHTGQTYNEQFF	TRBV5-1	TRBJ2-1
TGTGCCACCAGTGATATTACGGCGGGACAGCCAATGGGCAATCAGCCCCAGCATTTT	CATSDITAGQPMGNQPQHF	TRBV24-1	TRBJ1-5
TGTGCCAGCAGCCTAGCGGTAATAGGTGCTGAGCAGTTCTTC	CASSLAVIGAEQFF	TRBV7-3	TRBJ2-1
TGTGCCAGCAGCTTAAGGGATCGGATCATGGAGGAGGGGCCCCAGCATTTT	CASSLRDRIMEEGPQHF	TRBV7-9	TRBJ1-5
TGCAGCGTCAGATTCGGGACTTGCTTTAAAGTTGGGTCCTACAATGAGCAGTTCTTC	CSVRFGTCFKVGSYNEQFF	TRBV29-1	TRBJ2-1
TGTGCCAGCAGCCAGGGGGGACCAGATACGCAGTATTTT	CASSQGGPDTQYF	TRBV14	TRBJ2-3
TGTGCCACCAGTCATTTGGGGAAATATAATTCACCCCTCCACTTT	CATSHLGKYNSPLHF	TRBV24-1	TRBJ1-6
TGTGCCAGAAACGCCGGACACGGACAGGGGCGGGAAGATACGCAGTATTTT	CARNAGHGQGREDTQYF	TRBV28	TRBJ2-3
TGTGCCAGCAGCCAAGTCGGCTTGAACAGCTCTGGAAACACCATATATTTT	CASSQVGLNSSGNTIYF	TRBV4-2	TRBJ1-3
TGCAGTGCTAGATCTGGGGCCCGAACTGAAGCTTTCTTT	CSARSGARTEAFF	TRBV20-1	TRBJ1-1
TGTGCCAGCAGCCAAATAGGGAAGAGACTAGCGGGGCCCCAACCGAGTAGTGATACGCAGTATTTT	CASSQIGKRLAGPQPSSDTQYF	TRBV7-9	TRBJ2-3
TGTGCCAGCACGGGACAGCTTGATACGCAGTATTTT	CASTGQLDTQYF	TRBV12-3	TRBJ2-3
TGCAGTGCTAGAGCACAGGACAGGGAGATAGTTGGAAACACCATATATTTT	CSARAQDREIVGNTIYF	TRBV20-1	TRBJ1-3
TGTGCCAGCAGTTCCACAACTATGAACACTGAAGCTTTCTTT	CASSSTTMNTEAFF	TRBV6-5	TRBJ1-1
TGTGCCAGCAGCTTGCCCAGTAGGAGCTCCTACAATGAGCAGTTCTTC	CASSLPSRSSYNEQFF	TRBV5-6	TRBJ2-1
TGTGCCAGCAGCGTAGCCACTCAGGGGGCGGGCTACACCTTC	CASSVATQGAGYTF	TRBV9	TRBJ1-2
TGTGCCGTACGATTATGGGGTCAAAGGAATCAGCCCCAGCATTTT	CAVRLWGQRNQPQHF	TRBV12-4	TRBJ1-5
TGTGCCAGCAGTTACAGGGGGCAATACAATGAGCAGTTCTTC	CASSYRGQYNEQFF	TRBV6-3	TRBJ2-1
TGTGCCAGCAGCTTTAAATCAGGGGGGACAGGTTGCTATGGCTACACCTTC	CASSFKSGGTGCYGYTF	TRBV7-4	TRBJ1-2
TGTGCCAGCAGTCCTAGCGGGTTCTACGAGCAGTACTTC	CASSPSGFYEQYF	TRBV6-1	TRBJ2-7
TGTGCCAGCAGCCAAGAAGGACAGAGTTACAATGAGCAGTTCTTC	CASSQEGQSYNEQFF	TRBV3-1	TRBJ2-1
TGTGCTAGCAGCTTAGGGGGCGAGTACTTC	CASSLGGEYF	TRBV7-7	TRBJ2-5
TGTGCTAGTGGTCCTACAGGGAAAAATGGCTACACCTTC	CASGPTGKNGYTF	TRBV12-5	TRBJ1-2
TGTGCCAGCAGCCACCAGGGGATCCACGAGCAGTACTTC	CASSHQGIHEQYF	TRBV14	TRBJ2-7
TGTGCCAGCAGCCAACTTGACAGGGGGCCTGGAAACACCATATATTTT	CASSQLDRGPGNTIYF	TRBV5-6	TRBJ1-3
TGTGCCTGGAGTTCAGGGGTTGGCTATGGCTACACCTTC	CAWSSGVGYGYTF	TRBV30	TRBJ1-2
TGTGCCAGCAGCGAGTTCCTGACTAGCGGGGGGCAAGATACGCAGTATTTT	CASSEFLTSGGQDTQYF	TRBV7-6	TRBJ2-3
TGCGCCAGCAGCTTGAAACTGGGGCGGGTGAACACTGAAGCTTTCTTT	CASSLKLGRVNTEAFF	TRBV5-1	TRBJ1-1
TGTGCCAGCTCCACTAGCGGGAGGGCATACGAGCAGTACTTC	CASSTSGRAYEQYF	TRBV27	TRBJ2-7
TGTGCCTCTAGTAAGTGTAGAGTCACTGAAGCTTTCTTT	CASSKCRVTEAFF	TRBV6-1	TRBJ1-1
TGTGCCAGCAGTTTACGCGGGAGCAGCCAATACGAGCAGTACTTC	CASSLRGSSQYEQYF	TRBV6-4	TRBJ2-7
TGCGCCAGCCCCCGGGGGTTGTACTCCTACGAGCAGTACTTC	CASPRGLYSYEQYF	TRBV10-1	TRBJ2-7
TGTGCCAGCAGCGACGGGGGCGCTCACTACGAGCAGTACTTC	CASSDGGAHYEQYF	TRBV13	TRBJ2-7
TGTGCCAGCAGTTTAACCCGGGACAGGGTAGTGAACACTGAAGCTTTCTTT	CASSLTRDRVVNTEAFF	TRBV27	TRBJ1-1
TGTGCCACACACTGTATATGGGATACGCAGTATTTT	CATHCIWDTQYF	TRBV10-3	TRBJ2-3
TGTGCCAGCATCAGACCACTCGGGGGACGGCAGTTCTTC	CASIRPLGGRQFF	TRBV6-4	TRBJ2-1
TGTGCCAGCAGCCCATGGGGGGCATACAATGAGCAGTTCTTC	CASSPWGAYNEQFF	TRBV7-3	TRBJ2-1
TGCAGTGCCCGGAAGGGACTAGCGGGCCATACGCAGTATTTT	CSARKGLAGHTQYF	TRBV20-1	TRBJ2-3
TGCGCAATTACCCCGGGACAGGGTTACCTAAGGCAGCAGAACACTGAAGCTTTCTTT	CAITPGQGYLRQQNTEAFF	TRBV10-1	TRBJ1-1
TGTGCCTCCCCCGCAGGGGGCCAGTACTTC	CASPAGGQYF	TRBV30	TRBJ2-5
TGTGCCAGCAGCGACAGGGGGGAGACTGGGGCCAACGTCCTGACTTTC	CASSDRGETGANVLTF	TRBV5-6	TRBJ2-6
TGTGCCAGGAGGATCAGCCTAGCAGGGAGAATCTTC	CARRISLAGRIF	TRBV24-1	TRBJ2-1
TGCGCCAGCAGCCTCCAGTGGACAGGGGATGGCACTGAAGCTTTCTTT	CASSLQWTGDGTEAFF	TRBV5-1	TRBJ1-1
TGTGCCAGCAGCTTAGCCTCCAGACAGGGGAATGAGCAGTTCTTC	CASSLASRQGNEQFF	TRBV7-8	TRBJ2-1
TGTGCCAGCAGTCTCACAGGGCGGGAAACCGGGGAGCTGTTTTTT	CASSLTGRETGELFF	TRBV27	TRBJ2-2
TGTGCCAGCAGTTTATTTCTTGGGACTAGCGTTTTAGCCAAAAACATTCAGTACTTC	CASSLFLGTSVLAKNIQYF	TRBV12-3	TRBJ2-4
TGTGCCAGCAGCTCGGGCGGGGGCGAGAAGGCAACTAATGAAAAACTGTTTTTT	CASSSGGGEKATNEKLFF	TRBV13	TRBJ1-4
TGTGCCTGGAGTGAGAGCCTACGGGACAGGGTTACTGAAGCTTTCTTT	CAWSESLRDRVTEAFF	TRBV30	TRBJ1-1
TGCAGTGCTCGCTGGGAGCAGTACTTC	CSARWEQYF	TRBV20-1	TRBJ2-7
TGTGCCAGCAGGGGAGGGATCGCTGGAAACACCATATATTTT	CASRGGIAGNTIYF	TRBV6-6	TRBJ1-3
TGTGCCAGCAGTTTACCGTTAGGACAGGGTGGCAATCAGCCCCAGCATTTT	CASSLPLGQGGNQPQHF	TRBV27	TRBJ1-5
TGTGCCAGCAGCGCCAAAATTCAGGTGCAGGGCAATCAGCCCCAGCATTTT	CASSAKIQVQGNQPQHF	TRBV9	TRBJ1-5
TGTGCCAGCAGCCAGAAGTCTAGGACCGTAGAGACCCAGTACTTC	CASSQKSRTVETQYF	TRBV3-1	TRBJ2-5
TGTGCCAGCAGTGAAGTACCTTTGGGGACAGGGGACAGTCCTCGCTACGAGCAGTACTTC	CASSEVPLGTGDSPRYEQYF	TRBV6-1	TRBJ2-7
TGTGCCAGCAGTTTACATCTAGCGGTGGGGTATTTT	CASSLHLAVGYF	TRBV12-3	TRBJ2-3
TGTGCCAAAATAGGCACAGATACGCAGTATTTT	CAKIGTDTQYF	TRBV30	TRBJ2-3
TGTGCCAGCAGCTTAGAGGAGCGACTTGAAAAACTGTTTTTT	CASSLEERLEKLFF	TRBV7-9	TRBJ1-4
TGTGCCACCAGCAGCCGCCTCGGGGTTCAAATTGGCTACACCTTC	CATSSRLGVQIGYTF	TRBV15	TRBJ1-2
TGCAGTGCTAGAGGCATCTACAATGAGCAGTTCTTC	CSARGIYNEQFF	TRBV20-1	TRBJ2-1
TGTGCCAGCAGCTTCCTAGCGGACTACAATGAGCAGTTCTTC	CASSFLADYNEQFF	TRBV7-3	TRBJ2-1
TGTGCCAGTAGTCGAGCTAAGCTCCCCGGGACAAGGGCCTACAATGAGCAGTTCTTC	CASSRAKLPGTRAYNEQFF	TRBV19	TRBJ2-1
TGTGCCTGGAGTGTTATCCCGAGGACAACGACAGGGGGGGACACCTTC	CAWSVIPRTTTGGDTF	TRBV30	TRBJ1-2
TGTGCCAGCACTTCCCCCGCTAGCGGGTACGAGCAGTACTTC	CASTSPASGYEQYF	TRBV11-2	TRBJ2-7
TGTGCCACCACCCCGGAGAGTTGTCCACGCGGGGTGGCTAGCACAGATACGCAGTATTTT	CATTPESCPRGVASTDTQYF	TRBV24-1	TRBJ2-3
TGTGCCAGCAGATTACTCGGACAGGGTTACTGGCCCCAGCATTTT	CASRLLGQGYWPQHF	TRBV6-5	TRBJ1-5
TGTGCTAGTGGTTTGGTCAAGCCCCACTACGGCAATGGCCAGCCCCAGCATTTT	CASGLVKPHYGNGQPQHF	TRBV12-5	TRBJ1-5
TGTGCCAGCAGGGGGGGGTCGAACACCGGGGAGCTGTTTTTT	CASRGGSNTGELFF	TRBV6-2	TRBJ2-2
TGCAGCGGACAGGGGGTTCCCTCTGGAAACACCATATATTTT	CSGQGVPSGNTIYF	TRBV29-1	TRBJ1-3
TGTGCCAGCAGCAAGGAGGGGGACGGGAGGACAGTGCGCTCTGGAAACACCATATATTTT	CASSKEGDGRTVRSGNTIYF	TRBV7-3	TRBJ1-3
TGTGCCACCAAACCGGGAGCGGGGCCCGTTTACGAGCAGTACTTC	CATKPGAGPVYEQYF	TRBV24-1	TRBJ2-7
TGTGCCAGCAGCCGGGCCGGGAGCTCCTACGAGCAGTACTTC	CASSRAGSSYEQYF	TRBV12-4	TRBJ2-7
TGTGCCAGCATCACAGGTCAAGCTAACTATGGCTACACCTTC	CASITGQANYGYTF	TRBV6-3	TRBJ1-2
TGTGCCAGCAGCCCCAGCTTTGAGCAGTACTTC	CASSPSFEQYF	TRBV7-3	TRBJ2-7
TGTGCCACCAGCAGAGCCTGCTATACAGATACGCAGTATTTT	CATSRACYTDTQYF	TRBV15	TRBJ2-3
TGTGCCAGCAGCTTGTCAAGGGAAGACGAATCCACTGAAGCTTTCTTT	CASSLSREDESTEAFF	TRBV6-8	TRBJ1-1
TGCGCCAGCACACCGGGACAGCACTACGAGCAGTACTTC	CASTPGQHYEQYF	TRBV10-1	TRBJ2-7
TGTGCCAGCAGCAGACAAATGACAGGGGCCCCCTACGAGCAGTACTTC	CASSRQMTGAPYEQYF	TRBV13	TRBJ2-7
TGTGCCAGCAGCATCCTGCGCTGGGGGTTTAGCACAGATACGCAGTATTTT	CASSILRWGFSTDTQYF	TRBV12-3	TRBJ2-3
TGCGCCAGCAGCTTGCGGGACAGGGTCTTC	CASSLRDRVF	TRBV5-1	TRBJ2-1
TGTGAGCGGGAGAACGGTATCTATGGCTACACCTTC	CERENGIYGYTF	TRBV7-9	TRBJ1-2
TGTGCCAGCATAGCCAGCACAGATACGCAGTATTTT	CASIASTDTQYF	TRBV12-3	TRBJ2-3
TGCAGTGCTAGAGATGTGGGGGGGCATGAATCACTACCCCATGAGCAGTTCTTC	CSARDVGGHESLPHEQFF	TRBV20-1	TRBJ2-1
TGTGCCAGCCTGTGGGGGCACCCATGGAGGGGCACCTTC	CASLWGHPWRGTF	TRBV5-6	TRBJ1-2
TGTGCCAGCAGCTTAGGGCCGCACTACGAGCAGTACTTC	CASSLGPHYEQYF	TRBV7-9	TRBJ2-7
TGTGCCAGCAGAGACAGGTGGGAGGGGGGCTACGAGCAGTACTTC	CASRDRWEGGYEQYF	TRBV6-2	TRBJ2-7
TGTGCCACCAGTGATGAATACCGGGTAATCTACGAGCAGTACTTC	CATSDEYRVIYEQYF	TRBV24-1	TRBJ2-7
TGTGCCAGCAGTCCGGGACAGGGCTATTCCTACGAGCAGTACTTC	CASSPGQGYSYEQYF	TRBV6-1	TRBJ2-7
TGTGCCAGCAGTGGAAGAGCAGGGTTCGGAAGGGACGAGCAGTACTTC	CASSGRAGFGRDEQYF	TRBV6-4	TRBJ2-7
TGTGCCAGCAACGCTAGGGACAGGGTTCAAATGAACACTGAAGCTTTCTTT	CASNARDRVQMNTEAFF	TRBV6-3	TRBJ1-1
TGTGCCACCAGTGATTTGGACAGCAAAAATCAGCCCCAGCATTTT	CATSDLDSKNQPQHF	TRBV24-1	TRBJ1-5
TGTGCCAGCAGCACCGCCCAGGGTCCAAAAGCTGGAAACACCATATATTTT	CASSTAQGPKAGNTIYF	TRBV13	TRBJ1-3
TGTGCCACCAGCAGAGCACCGGCCAGGGCACAAGTTCCAACGTGGGATTCACCCCTCCACTTT	CATSRAPARAQVPTWDSPLHF	TRBV15	TRBJ1-6
TGTGCTAGTGGTTTGGTATGCCCAGGGGGCAGGGGCTACACCTTC	CASGLVCPGGRGYTF	TRBV12-5	TRBJ1-2
TGTGCCAGCAGTTCACTAGCGGGAGGGCTTTATAGCTCCTACAATGAGCAGTTCTTC	CASSSLAGGLYSSYNEQFF	TRBV27	TRBJ2-1
TGTGCCAGCAGCCCCGACGGTGCTAGCGGGGCCCGAGAGGAATACGAGCAGTACTTC	CASSPDGASGAREEYEQYF	TRBV11-2	TRBJ2-7
TGCGCCAGCAGCTTGCGGAACAAGACAGGGAAGGGGAACACCATATATTTT	CASSLRNKTGKGNTIYF	TRBV5-1	TRBJ1-3
TGTGCCAGCATTTTAGGTAGCACAGATACGCAGTATTTT	CASILGSTDTQYF	TRBV6-2	TRBJ2-3
TGTGCCAGCAGCAAGCAGGGGTACACTGAAGCTTTCTTT	CASSKQGYTEAFF	TRBV11-2	TRBJ1-1
TGTGCCAGCAGTTTTCTTTCTGCAGGGTTGGATGGCTACACCTTC	CASSFLSAGLDGYTF	TRBV12-4	TRBJ1-2
TGCGCCAGCAGCTTGGGAAAGACAGTGGTAGGAGACAATCAGCCCCAGCATTTT	CASSLGKTVVGDNQPQHF	TRBV5-1	TRBJ1-5
TGTGCCAGCAGCCTGTATGGCCATCAGCCCCAGCATTTT	CASSLYGHQPQHF	TRBV3-1	TRBJ1-5
TGTGCCAGCAGTGAGAACCCGGGGGAGAAGCGAACCTACGAGCAGTACTTC	CASSENPGEKRTYEQYF	TRBV25-1	TRBJ2-7
TGTGCCAGCAGCTCCCTGGGGGGGCGGCAAGAGACCCAGTACTTC	CASSSLGGRQETQYF	TRBV7-9	TRBJ2-5
TGTGCCTGGATACGGGGGACCTGGGGCTACACCTTC	CAWIRGTWGYTF	TRBV30	TRBJ1-2
TGTGCCAGCAGCAGGGACAGCTCTGGAAACACCATATATTTT	CASSRDSSGNTIYF	TRBV7-9	TRBJ1-3
TGTGCCAGCAGTTCCGGGCTAGGCGCCAAAAACATTCAGTACTTC	CASSSGLGAKNIQYF	TRBV28	TRBJ2-4
TGCGCCAGCAGTGAACCCGGGACTGAGGTACCCTACGAGCAGTACTTC	CASSEPGTEVPYEQYF	TRBV10-1	TRBJ2-7
TGTGCCAGCAGCCACATTGGTCAGCCCCAGCATTTT	CASSHIGQPQHF	TRBV13	TRBJ1-5
TGTGCCAGCAGCTTGGAGACCGGACGGGACAGCCCCCAGGGATGCTCTGGCTACGAGCAGTACTTC	CASSLETGRDSPQGCSGYEQYF	TRBV5-6	TRBJ2-7
TGTGCCAGCAGCTATTCGTCATGGGACAGAGCAGGGTTTGAAAAACTGTTTTTT	CASSYSSWDRAGFEKLFF	TRBV7-4	TRBJ1-4
TGTGCCAGCGATTCCCCGGGGCCGGAGTGTGGCTACACCTTC	CASDSPGPECGYTF	TRBV28	TRBJ1-2
TGTGCCAGTAGTATAGATGGGGGGGACCAGGGCAGGTCCTACGAGCAGTACTTC	CASSIDGGDQGRSYEQYF	TRBV19	TRBJ2-7
TGTGCCAGCAGCCAAGCCCCGCGGGAGAAGGATGAGCAGTTCTTC	CASSQAPREKDEQFF	TRBV14	TRBJ2-1
TGTGCCAGCAGCGACAGCCCCTACGAGCAGTACTTC	CASSDSPYEQYF	TRBV11-2	TRBJ2-7
TGTGCCAGCTCACCAGTCCCCTCCCTAAGTCGGGGACAGGGGGGGAACACTGAAGCTTTCTTT	CASSPVPSLSRGQGGNTEAFF	TRBV18	TRBJ1-1
TGTGCCAGCAGCTTAAATAACGGGAGACGCGAGCAGTACTTC	CASSLNNGRREQYF	TRBV7-8	TRBJ2-7
TGTGCCAGCCGCGACGGGAGTAAGTACCAAGAGACCCAGTACTTC	CASRDGSKYQETQYF	TRBV27	TRBJ2-5
TGCGCCAGCAGCTTCTCCCGGGACCGGGGTCAGCCCCAGCATTTT	CASSFSRDRGQPQHF	TRBV5-1	TRBJ1-5
TGTGCCAGCAGCTTAGGGATAACTAGCGGGAGGAGTACTAATGAAAAACTGTTTTTT	CASSLGITSGRSTNEKLFF	TRBV7-9	TRBJ1-4
TGTGCCAGCATTGTGGGGACAGCCAATGAAAAACTGTTTTTT	CASIVGTANEKLFF	TRBV27	TRBJ1-4
TGTGCCAGCAGTGGGGGGGGGGCCTATAGCAATCAGCCCCAGCATTTT	CASSGGGAYSNQPQHF	TRBV27	TRBJ1-5
TGTGCCTGGAGTGTAAGGCACAGTGGACAGCCCCAGCATTTT	CAWSVRHSGQPQHF	TRBV30	TRBJ1-5
TGTGCCAGCAGTGACGAAGCGGGTCCCTACGAGCAGTACTTC	CASSDEAGPYEQYF	TRBV6-4	TRBJ2-7
TGCGCCAGCAGCCCAACGGTACCGCGGGAGCACTATAATTCACCCCTCCACTTT	CASSPTVPREHYNSPLHF	TRBV4-3	TRBJ1-6
TGTGCCACCATCAGGACGCTGAACGACGAGCAGTACTTC	CATIRTLNDEQYF	TRBV24-1	TRBJ2-7
TGTGCCACCAGTGAGAGTCGGTCCAATGAGCAGTTCTTC	CATSESRSNEQFF	TRBV24-1	TRBJ2-1
TGCAGTGGGGTCGCCTCCTCTGGAAACACCATATATTTT	CSGVASSGNTIYF	TRBV20-1	TRBJ1-3
TGTGCCAGCAGTTTGGGACGGGTTAGGCCAGACACTGAAGCTTTCTTT	CASSLGRVRPDTEAFF	TRBV27	TRBJ1-1
TGTGCCAGCAGCTTCCGAAGGGACAGGGGCGAGCAGTACTTC	CASSFRRDRGEQYF	TRBV7-3	TRBJ2-7
TGTGCCAGCAGTTTGGGGGGCACGGACGCAACCTCTGGAAACACCATATATTTT	CASSLGGTDATSGNTIYF	TRBV12-4	TRBJ1-3
TGCGCCAGCAGGGGGGGACTGTCCTACAATGAGCAGTTCTTC	CASRGGLSYNEQFF	TRBV10-1	TRBJ2-1
TGCAGTGCTAGCTTCTCCTACAATGAGCAGTTCTTC	CSASFSYNEQFF	TRBV20-1	TRBJ2-1
TGCGCCAGCAGCTTTGGACGGACCTACGAGCAGTACTTC	CASSFGRTYEQYF	TRBV5-1	TRBJ2-7
TGTGCCAGCAGTGACGTCGGGACAGGGTACCTGGTTTATAGCAATCAGCCCCAGCATTTT	CASSDVGTGYLVYSNQPQHF	TRBV6-1	TRBJ1-5
TGTGCCAGCAGCTTTCTACTCAGCTCCTACGAGCAGTACTTC	CASSFLLSSYEQYF	TRBV11-3	TRBJ2-7
TGCAGTGCAAAACACGACAGCTTTCCCGGGGAGCTGTTTTTT	CSAKHDSFPGELFF	TRBV20-1	TRBJ2-2
TGCGCCAGCGGGGGGGGCCTAGCCAAAAACATTCAGTACTTC	CASGGGLAKNIQYF	TRBV10-1	TRBJ2-4
TGTGCCAGCAGCTTGGCCCCCGGGGATGGCAAGCGGAAGTTCGAGCAGTACTTC	CASSLAPGDGKRKFEQYF	TRBV5-4	TRBJ2-7
TGTGCCATCAAACGTGATTACAATGAGCAGTTCTTC	CAIKRDYNEQFF	TRBV10-3	TRBJ2-1
TGTGCCAGCACGGTGAGCGATTGTTGGACTAGCGGGAGCTCCTACGAGCAGTACTTC	CASTVSDCWTSGSSYEQYF	TRBV12-4	TRBJ2-7
TGCGCCAGCAGCTTGGCTATCATCGCGACAGGTCGGCAAGAGACCCAGTACTTC	CASSLAIIATGRQETQYF	TRBV5-1	TRBJ2-5
TGCAGTGCAACAATAAAGCGGGTTCGAGCCTACAATGAGCAGTTCTTC	CSATIKRVRAYNEQFF	TRBV20-1	TRBJ2-1
TGCGCCAGCAGCTTGGTCAGGGACTCTGGGGCCAACGTCCTGACTTTC	CASSLVRDSGANVLTF	TRBV5-1	TRBJ2-6
TGCAGTGCCGTGGGACCATACGAGCAGTACTTC	CSAVGPYEQYF	TRBV20-1	TRBJ2-7
TGTGCCAGCAGCTTAGTGAGGGACAGTTTAGGAGAGGGCACAGATACGCAGTATTTT	CASSLVRDSLGEGTDTQYF	TRBV7-9	TRBJ2-3
TGTGCCACCAGTGGGCCTGGGGAGGTGAGCAATCAGCCCCAGCATTTT	CATSGPGEVSNQPQHF	TRBV24-1	TRBJ1-5
TGTGCCAGCAGTCTCCTGGGACAGGGGGCAGGGACCGGGGAGCTGTTTTTT	CASSLLGQGAGTGELFF	TRBV25-1	TRBJ2-2
TGTGCCAGCAGTGACTGTCCCTTCCCTACCGGGACAGTTTACGAGCAGTACTTC	CASSDCPFPTGTVYEQYF	TRBV25-1	TRBJ2-7
TGTGCCAGCAGCTTAGCGCCTCAGACTGGCCCTTACAGGGGGCCAGGGACCGGGGAGCTGTTTTTT	CASSLAPQTGPYRGPGTGELFF	TRBV7-9	TRBJ2-2
TGTGCCAGCAGTTACTCGAGAATTCCAGGGGGCGCCGGGGAGCTGTTTTTT	CASSYSRIPGGAGELFF	TRBV6-5	TRBJ2-2
TGCAGTGCTAGAGACCTCAAGACAGGAAGTGAAGCTTTCTTT	CSARDLKTGSEAFF	TRBV20-1	TRBJ1-1
TGTGCCAGCAGCGGGGTCCGGGGACCCCAGTACATTCAGTACTTC	CASSGVRGPQYIQYF	TRBV7-9	TRBJ2-4
TGTGCCAGACAAGTCGGACAGGGGCCACCGAACACCGGGGAGCTGTTTTTT	CARQVGQGPPNTGELFF	TRBV6-5	TRBJ2-2
TGTGCCAGCAGCCTAATTTGGCATAGCAATCAGCCCCAGCATTTT	CASSLIWHSNQPQHF	TRBV4-2	TRBJ1-5
TGCAGCGTCAAAGCACGGGACAGGAAGAGCTCCTACAATGAGCAGTTCTTC	CSVKARDRKSSYNEQFF	TRBV29-1	TRBJ2-1
TGTGCCAGCAGGGGGCCGGGACAGGGTTTGAACACTGAAGCTTTCTTT	CASRGPGQGLNTEAFF	TRBV2	TRBJ1-1
TGTGCCAGCAGCCCGACCGTCTACAATGAGCAGTTCTTC	CASSPTVYNEQFF	TRBV13	TRBJ2-1
TGTGCCAGCTCCCCCCGGGGTCATGGGGGGTGGGTGGAGACCCAGTACTTC	CASSPRGHGGWVETQYF	TRBV18	TRBJ2-5
TGTGCCAGCAGCTCCCAGCGGGAGGGGAGCTCTGGGGCCAACGTCCTGACTTTC	CASSSQREGSSGANVLTF	TRBV7-3	TRBJ2-6
TGCGCCAGCAGCTTGGAACCCGGGACAGTTGGTTGGGCCTACGAGCAGTACTTC	CASSLEPGTVGWAYEQYF	TRBV5-1	TRBJ2-7
TGTGCCAGCAGAACCAACTATGGCTACACCTTC	CASRTNYGYTF	TRBV27	TRBJ1-2
TGTGCCAGCAGCCAGGTCCCGAGGGGGAGCTCCTACAATGAGCAGTTCTTC	CASSQVPRGSSYNEQFF	TRBV3-1	TRBJ2-1
TGCAGTGCTAGAGTCCTCCAGACGGCTATCCAGGGACATGGCTACACCTTC	CSARVLQTAIQGHGYTF	TRBV20-1	TRBJ1-2
TGTGCCACCAGTGTGACCCCGGGGACTAGCGGGGACGATAACGAGCAGTACTTC	CATSVTPGTSGDDNEQYF	TRBV24-1	TRBJ2-7
TGCAGTGCTCAGATGGGGGCTGAAAAACTGTTTTTT	CSAQMGAEKLFF	TRBV20-1	TRBJ1-4
TGTGCCAGCATAGGACTAGCGGCCTCGGACAATGAGCAGTTCTTC	CASIGLAASDNEQFF	TRBV7-4	TRBJ2-1
TGCAGTGCTAGCAAAACAGAAGTTAGCAAAAACATTCAGTACTTC	CSASKTEVSKNIQYF	TRBV20-1	TRBJ2-4
TGTGCCTGGCGGCAGCGGGAGGCCGAGCAGTACTTC	CAWRQREAEQYF	TRBV30	TRBJ2-7
TGTGCCAGCAGTTGGCCGCGGGCCGTCGAGCCCCAGCATTTT	CASSWPRAVEPQHF	TRBV6-5	TRBJ1-5
TGTGCCAGCAGCGGTCTCAGGGGGCGACAGGGCTCCTACGAGCAGTACTTC	CASSGLRGRQGSYEQYF	TRBV9	TRBJ2-7
TGTGCCAGCAGCCTCGGGAAAGAGACCCAGTACTTC	CASSLGKETQYF	TRBV14	TRBJ2-5
TGCAGTGCTTACTTCGGTCCACTGTTGACAGGGGGTCAGAATCAGCCCCAGCATTTT	CSAYFGPLLTGGQNQPQHF	TRBV20-1	TRBJ1-5
TGTGCCAGCAGCGGCGGACTAGCGGGGGGGCCGAATTCAGCCAAAAACATTCAGTACTTC	CASSGGLAGGPNSAKNIQYF	TRBV27	TRBJ2-4
TGTGCCAGCAGACCCCGGAGGGTGGGGAGCTCCTACAATGAGCAGTTCTTC	CASRPRRVGSSYNEQFF	TRBV13	TRBJ2-1
TGTGCCAGCAGCTTTTCCGATTACCAGGTGTACGAGCAGTACTTC	CASSFSDYQVYEQYF	TRBV5-6	TRBJ2-7
TGTGCCAGCAGCACCAAGTCGGGGGGGGGCTACACCTTC	CASSTKSGGGYTF	TRBV7-2	TRBJ1-2
TGTGCCAGCACATCTAGCCGCATTCAGTACTTC	CASTSSRIQYF	TRBV27	TRBJ2-4
TGTGCCAGCAGCTTAGGGTCACCGGGGGGGGGTGTTCTCTTC	CASSLGSPGGGVLF	TRBV7-9	TRBJ2-1
TGTGCCAGCAGCAAGACAGGGGCTACGGAAAAACTGTTTTTT	CASSKTGATEKLFF	TRBV9	TRBJ1-4
TGCGCCAGGGCCCCGGGTAATGAAAAACTGTTTTTT	CARAPGNEKLFF	TRBV10-2	TRBJ1-4
TGTGCCAGCAGCGGGAACAATGAGCAGTTCTTC	CASSGNNEQFF	TRBV6-4	TRBJ2-1
TGTGCCAGTAGAGGGACAGGGCAGAACACTGAAGCTTTCTTT	CASRGTGQNTEAFF	TRBV19	TRBJ1-1
TGTGCCAGCAGCCACCCACTCACCGGACTAGCGGCCAGCGGACATCAGTCTGGGGCCAACGTCCTGACTTTC	CASSHPLTGLAASGHQSGANVLTF	TRBV9	TRBJ2-6
TGTGCCAGCAGTTTACCCGAGGGGCGCCTAGGTGAAAAACTGTTTTTT	CASSLPEGRLGEKLFF	TRBV27	TRBJ1-4
TGTGCCAGCAGTGAAAGAGGGAAAAACACTGAAGCTTTCTTT	CASSERGKNTEAFF	TRBV6-1	TRBJ1-1
TGCAGCGTTGAAAGGGGGTCTTTCGACAACAATCAGCCCCAGCATTTT	CSVERGSFDNNQPQHF	TRBV29-1	TRBJ1-5
TGTGCCAGCCGGGGACAGCGGGGCTCCTACGAGCAGTACTTC	CASRGQRGSYEQYF	TRBV5-4	TRBJ2-7
TGTGCCAGCAGTCTCCCCCCCCCGACTGCGGGAGCCTGTCAGCCCCAGCATTTT	CASSLPPPTAGACQPQHF	TRBV6-5	TRBJ1-5
TGTGCCAGCAAAAGCAGACAGGGGGGGCAGCCCCAGCATTTT	CASKSRQGGQPQHF	TRBV9	TRBJ1-5
TGTGCACCCGGACCGGCCTCCTACAATGAGCAGTTCTTC	CAPGPASYNEQFF	TRBV24-1	TRBJ2-1
TGTGCCAGCAGCTTCACCGGGACTAGCGGGAGGACCAGCACAGATACGCAGTATTTT	CASSFTGTSGRTSTDTQYF	TRBV7-2	TRBJ2-3
TGTGCCAGCAGCTTAAATATGACTAGGAAGACGAGCTCCTACAATGAGCAGTTCTTC	CASSLNMTRKTSSYNEQFF	TRBV7-3	TRBJ2-1
TGCGCCAGCAGCGAGGACAGGGGCGAGCAGTACTTC	CASSEDRGEQYF	TRBV10-1	TRBJ2-7
TGCAGTGCTAGCTCAGACAGGGGTTATAATGAAAAACTGTTTTTT	CSASSDRGYNEKLFF	TRBV20-1	TRBJ1-4
TGTGCCAGCAGCTTGCGCCTAGCGGTCACAGATACGCAGTATTTT	CASSLRLAVTDTQYF	TRBV5-6	TRBJ2-3
TGTGCCACCAGCAGAGTCCGGGACAGAGGACTTACCTACGAGCAGTACTTC	CATSRVRDRGLTYEQYF	TRBV15	TRBJ2-7
TGTGCCAGCAGTTGCCCCGAAGGGGAGTGCAATCAGCCCCAGCATTTT	CASSCPEGECNQPQHF	TRBV27	TRBJ1-5
TGTGCCAGCAGCCAACCATTGGGTAAGAATTCACCCCTCCACTTT	CASSQPLGKNSPLHF	TRBV3-1	TRBJ1-6
TGTGCCAGCAGCGGGCGGACACCTCCGGACTCCTACAATGAGCAGTTCTTC	CASSGRTPPDSYNEQFF	TRBV27	TRBJ2-1
TGTGCCAGCAGCTACCGAAATAGACAGGGAGCCTCTGGAAACACCATATATTTT	CASSYRNRQGASGNTIYF	TRBV7-8	TRBJ1-3
TGTGCCAGCAGCTTCGACAGGTTGGCGGACGAGCAGTACTTC	CASSFDRLADEQYF	TRBV7-9	TRBJ2-7
TGTGCCAGCAGCTTTCCCGGGACTAGCGGGCCTCCGACGAACACCGGGGAGCTGTTTTTT	CASSFPGTSGPPTNTGELFF	TRBV13	TRBJ2-2
TGTGCCAGCGGCGGGGGACTAGCGGGCGCCTATTGGGTCTTC	CASGGGLAGAYWVF	TRBV12-3	TRBJ2-1
TGCAGTGCAAAAGGGGGCTTCCCCTACGAGCAGTACTTC	CSAKGGFPYEQYF	TRBV20-1	TRBJ2-7
TGTGCCAGCAGCTTAATCCCAGAGTTGAACACTGAAGCTTTCTTT	CASSLIPELNTEAFF	TRBV7-3	TRBJ1-1
TGTGCCACCAGTGATATTAGGCGAAGGGAGGGGAAAGGGCGTCAAGAGACCCAGTACTTC	CATSDIRRREGKGRQETQYF	TRBV24-1	TRBJ2-5
TGTGCCAGCAGCCGTTCCGACCCACCAAACACTGAAGCTTTCTTT	CASSRSDPPNTEAFF	TRBV13	TRBJ1-1
TGTGCCAGCAGTTTAGTTCGACAGGGCGAGCAGTACTTC	CASSLVRQGEQYF	TRBV12-4	TRBJ2-7
TGTGCCAGCAGCGTAGACCGGACAGGTATAGGGGAGCTGTTTTTT	CASSVDRTGIGELFF	TRBV9	TRBJ2-2
TGTGCCAGCCCCAAACCAAGAGAGGGACAGGGGGCTTCTAACTATGGCTACACCTTC	CASPKPREGQGASNYGYTF	TRBV6-5	TRBJ1-2
TGCGCCAGCAGGACGACGGGACTAGGAGGGGTCTACAATGAGCAGTTCTTC	CASRTTGLGGVYNEQFF	TRBV5-1	TRBJ2-1
TGTGCCACCAGTGCCAGGGATGGCTACACCTTC	CATSARDGYTF	TRBV24-1	TRBJ1-2
TGTGCCAGCAGTTTAAGTGGACAGGGTAAAGAGCAAAGGGACTACGAGCAGTACTTC	CASSLSGQGKEQRDYEQYF	TRBV27	TRBJ2-7
TGCGCCAGCAGCTTGACGGGACAGGGTACCGGCTCCTACGAGCAGTACTTC	CASSLTGQGTGSYEQYF	TRBV5-1	TRBJ2-7
TGTGCCAGCAGTCCGAACGACAGGGGGTCCAGCAATCAGCCCCAGCATTTT	CASSPNDRGSSNQPQHF	TRBV6-5	TRBJ1-5
TGTGCCAGCAGTGCGGGGAATACGCAGTATTTT	CASSAGNTQYF	TRBV27	TRBJ2-3
TGTGCCAGCAGTTTCGACAGGGGGGAGCACTCCTACGAGCAGTACTTC	CASSFDRGEHSYEQYF	TRBV6-5	TRBJ2-7
TGTGCCAGCAGCTTAGAGTTCAGCCGGGGGAGGCAGACAGGGAGTGCAACTAATGAAAAACTGTTTTTT	CASSLEFSRGRQTGSATNEKLFF	TRBV7-9	TRBJ1-4
TGCAGTACCTACAGGTTCTACGAGCAGTACTTC	CSTYRFYEQYF	TRBV20-1	TRBJ2-7
TGTGCCAGCAGAGGTTTCCCCACGGACAGCGGTCCGGAGGTCCTGGCAACTAATGAAAAACTGTTTTTT	CASRGFPTDSGPEVLATNEKLFF	TRBV2	TRBJ1-4
TGTGCCACCATACTCCTAGGGATGAGTGAGCAGTTCTTC	CATILLGMSEQFF	TRBV24-1	TRBJ2-1
TGTGCCAGCGGCCGTTCCGGGGAGCTGTTTTTT	CASGRSGELFF	TRBV7-3	TRBJ2-2
TGTGCCAGATCCAGGACGTACCTAGTACACGGCTCCTACAATGAGCAGTTCTTC	CARSRTYLVHGSYNEQFF	TRBV11-3	TRBJ2-1
TGTGCCAGCAGCTGCCTAGAGGGGCAGTTCTTC	CASSCLEGQFF	TRBV6-4	TRBJ2-1
TGTGCCAGTATTATCCCGAAACGTTCGAGTGCAATATACGAGCAGTACTTC	CASIIPKRSSAIYEQYF	TRBV19	TRBJ2-7
TGTGCCAGCAGCTTAACCCTGGACAGATCTTATCAGCCCCAGCATTTT	CASSLTLDRSYQPQHF	TRBV7-9	TRBJ1-5
TGCGCCAGCAGCCCCTACCCAGGGCCCGACTACGAGCAGTACTTC	CASSPYPGPDYEQYF	TRBV5-1	TRBJ2-7
TGTGCCTGGAGTGTACGAACAGTGAGGGCCCCATCGCAGCCCCAGCATTTT	CAWSVRTVRAPSQPQHF	TRBV30	TRBJ1-5
TGTGCCAGCAGCTTGATAGTGGAGACCGAAGAGCAGTTCTTC	CASSLIVETEEQFF	TRBV5-6	TRBJ2-1
TGTGCCAGCAGCATGAAGAGTACTAGCGGGAGTTCGGAGAGCACAGATACGCAGTATTTT	CASSMKSTSGSSESTDTQYF	TRBV11-3	TRBJ2-3
TGTGCCAGCAGTACGGGACTAGCAATCGCCTACGAGCAGTACTTC	CASSTGLAIAYEQYF	TRBV11-2	TRBJ2-7
TGTGCCAGCAGCTTAGATCCGGGGGGAAGCTCCTACGAGCAGTACTTC	CASSLDPGGSSYEQYF	TRBV11-3	TRBJ2-7
TGTGCCAGCAGCTCATACCACAGGACAGGGGTCCCAGGGTTGGGTGAGCAGTTCTTC	CASSSYHRTGVPGLGEQFF	TRBV5-4	TRBJ2-1
TGTGCCAGCAGCACTGGAACGTCAGCAGGACAGGGGAGGTCGCAAGAGACCCAGTACTTC	CASSTGTSAGQGRSQETQYF	TRBV7-2	TRBJ2-5
TGTGCCAGCAGTGTCTTCCGACAGAGGGTAGCTGAGCGCAATCAGCCCCAGCATTTT	CASSVFRQRVAERNQPQHF	TRBV6-4	TRBJ1-5
TGTGCCACCAGTGATTTATTTTTGGGACAGGAAAAACTGTTTTTT	CATSDLFLGQEKLFF	TRBV24-1	TRBJ1-4
TGTGCCATCAGAGGTAAAGGACAGGGGACTCAGCCCCAGCATTTT	CAIRGKGQGTQPQHF	TRBV10-3	TRBJ1-5
TGTGCCAGCAGTTTATCAGGCTGCGGGGGGACTACCTACGAGCAGTACTTC	CASSLSGCGGTTYEQYF	TRBV27	TRBJ2-7
TGTGCCAGCAGGACCGAGGGCGAGCAGTACTTC	CASRTEGEQYF	TRBV6-4	TRBJ2-7
TGTGCCAGCAGCCCCCCGGGACAAGATAGTGGTCAGCCCCAGCATTTT	CASSPPGQDSGQPQHF	TRBV9	TRBJ1-5
TGTGCCAGCAGCTACGGACAGTACCTATCTGATCAGCCCCAGCATTTT	CASSYGQYLSDQPQHF	TRBV7-6	TRBJ1-5
TGTGCCAGCAGCATTCGGATGATAGAAGATACGCAGTATTTT	CASSIRMIEDTQYF	TRBV7-4	TRBJ2-3
TGTGCCAGCAGCGACAGGGGTTATCGTTACGAGCAGTACTTC	CASSDRGYRYEQYF	TRBV7-9	TRBJ2-7
TGTGCCAGCAGCCATCCCTGGACAGGGTACTATGGCTACACCTTC	CASSHPWTGYYGYTF	TRBV6-5	TRBJ1-2
TGTGCCAGCAGCGCGACTGATAACTATGGCTACACCTTC	CASSATDNYGYTF	TRBV7-9	TRBJ1-2
TGTGCCACCAGTGGAAGACAGGGGGGCTCCTACGAGCAGTACTTC	CATSGRQGGSYEQYF	TRBV24-1	TRBJ2-7
TGTGCCACCAGCAGGTCCCGTTTACTCGGCAATCAGCCCCAGCATTTT	CATSRSRLLGNQPQHF	TRBV15	TRBJ1-5
TGTGCCAGCAGGAGAGCGGTCCGAACAGATACGCAGTATTTT	CASRRAVRTDTQYF	TRBV7-6	TRBJ2-3
TGTGCCAGCAACAGGCTTCAGGGGATAAGTACCGGGGAGCTGTTTTTT	CASNRLQGISTGELFF	TRBV6-5	TRBJ2-2
TGTGCCAGCAGCTTGGGACAGCCAGAGACCCAGTACTTC	CASSLGQPETQYF	TRBV11-3	TRBJ2-5
TGTGCCAGCAGTCGGATCCCCGGGACAGAGACCCAGTACTTC	CASSRIPGTETQYF	TRBV6-5	TRBJ2-5
TGTGCCAGCAGCGCCCGACAGGGACTGGCTCAGCCCCAGCATTTT	CASSARQGLAQPQHF	TRBV13	TRBJ1-5
TGTGCCAGCAAGGAACTGGACAGGGGAAACGAGCAGTACTTC	CASKELDRGNEQYF	TRBV6-5	TRBJ2-7
TGTGCCAGCAGAGAGTTGGCTGGGCACACACACCCGGCAAAGGGAGAGGACCACAATGAGCAGTTCTTC	CASRELAGHTHPAKGEDHNEQFF	TRBV6-5	TRBJ2-1
TGTGCTAGTGGTTTGGTTCGGACAGCCATATATTTT	CASGLVRTAIYF	TRBV12-5	TRBJ1-3
TGTGCCAGCAGCAAAGGGAAGGAGAGGGGAGCCTACGAGCAGTACTTC	CASSKGKERGAYEQYF	TRBV7-3	TRBJ2-7
TGTGCCAGCAGCCAAGACCCATTTCCTGGGCGGATTCGAGACCGAGGCTCCTACGAGCAGTACTTC	CASSQDPFPGRIRDRGSYEQYF	TRBV3-1	TRBJ2-7
TGTGCCAGCAGACTAGCTCTTGAGCAGTTCTTC	CASRLALEQFF	TRBV12-4	TRBJ2-1
TGTGCCAGCAGAATGGGGGGGGCAACTAATGAAAAACTGTTTTTT	CASRMGGATNEKLFF	TRBV6-8	TRBJ1-4
TGCAGTAGGGACAGGGCGTGTGAAGCTTTCTTT	CSRDRACEAFF	TRBV20-1	TRBJ1-1
TGCAGTGCTTGGCGCGGGACAGGGCTGGGGTACGAGCAGTACTTC	CSAWRGTGLGYEQYF	TRBV20-1	TRBJ2-7
TGTGCCAGCAGCCAAGCGGGAGCTGAGTTCTATGGCTACACCTTC	CASSQAGAEFYGYTF	TRBV9	TRBJ1-2
TGTGCCAGCAGCCTTGGGGGTAATGGCTACACCTTC	CASSLGGNGYTF	TRBV13	TRBJ1-2
TGTGCCAGCAGTGGGGCGGGAGCCTACGAGCAGTACTTC	CASSGAGAYEQYF	TRBV2	TRBJ2-7
TGCAGCTTCAAAGGGTCGGGGAAGCAGTACTTC	CSFKGSGKQYF	TRBV29-1	TRBJ2-7
TGTGCCAGCAGCTTTTCTACTTGTTATGAAAAACTGTTTTTT	CASSFSTCYEKLFF	TRBV5-6	TRBJ1-4
TGTGCCAGCAGCCTTCTTAACCCGGGGAGTGAGCAGTTCTTC	CASSLLNPGSEQFF	TRBV3-1	TRBJ2-1
TGCGCCAGCACCGGGACTAGACTAGCCAAAAACATTCAGTACTTC	CASTGTRLAKNIQYF	TRBV4-3	TRBJ2-4
TGTGCCAGCAGCCTCTCACTAGCGGGAGGGGCAAGAGGCAATCAGCCCCAGCATTTT	CASSLSLAGGARGNQPQHF	TRBV6-4	TRBJ1-5
TGTGCCAGCAGCCAAGATGTCCCGAGGGCCACCGGGGAGCTGTTTTTT	CASSQDVPRATGELFF	TRBV3-1	TRBJ2-2
TGTGCCAGCAGTTCCGGGACAGATGTTATTCAGCCCCAGCATTTT	CASSSGTDVIQPQHF	TRBV12-3	TRBJ1-5
TGTGCCAGCAGCCAGAGGGGGAAGTCCGGACGTTGGAGAAATCCGTGCAATGAGCAGTTCTTC	CASSQRGKSGRWRNPCNEQFF	TRBV4-2	TRBJ2-1
TGTGCCACACGGGGACTAGCGGGTATGTCCGGGGAGCTGTTTTTT	CATRGLAGMSGELFF	TRBV24-1	TRBJ2-2
TGCGCCAGCAGCTTGGCACCTCACAGGGTGGCCTACGAGCAGTACTTC	CASSLAPHRVAYEQYF	TRBV5-1	TRBJ2-7
TGCAGTGCTCCGAGATGGACAGGGGTGGTTAGCAATCAGCCCCAGCATTTT	CSAPRWTGVVSNQPQHF	TRBV20-1	TRBJ1-5
TGTGCCAGCAGCTATCCCAGGGGGGAGAAGAGCTATGGCTACACCTTC	CASSYPRGEKSYGYTF	TRBV25-1	TRBJ1-2
TGCGCCAGCAGCCAAGGACCTGGAACAGGGTCCGAGCAGTACTTC	CASSQGPGTGSEQYF	TRBV4-1	TRBJ2-7
TGTGCCAGCAGCTTAAACGGAATTCCCCAGGATAAGTGGCCCTACGAGCAGTACTTC	CASSLNGIPQDKWPYEQYF	TRBV7-2	TRBJ2-7
TGTGCCACCTGTCGGGGAAACACCATATATTTT	CATCRGNTIYF	TRBV24-1	TRBJ1-3
TGTGCCAGCAAAGACTCACCCCTTCCTGGACAGTCGTGTAACGACAATGAGCAGTTCTTC	CASKDSPLPGQSCNDNEQFF	TRBV28	TRBJ2-1
TGTGCCAGCAGCTCGGACAGGGCCTACGAGCAGTACTTC	CASSSDRAYEQYF	TRBV6-4	TRBJ2-7
TGCAGTGCTAGAGTCCAGAGGGATAATGAAAAACTGTTTTTT	CSARVQRDNEKLFF	TRBV20-1	TRBJ1-4
TGTGCCAGCAGCTTAGACCGGACCTTCGGCGTCGTCGCGAACACCGGGGAGCTGTTTTTT	CASSLDRTFGVVANTGELFF	TRBV7-4	TRBJ2-2
TGTGCCAGCAGCTTAGATGGGACTAGCGGAAGATACGCAGCCACCGGGGAGCTGTTTTTT	CASSLDGTSGRYAATGELFF	TRBV11-3	TRBJ2-2
TGTGCCAGCAGTTGTTCGGGGTCGCACTCTGGGGCCAACGTCCTGACTTTC	CASSCSGSHSGANVLTF	TRBV12-4	TRBJ2-6
TGTGCCAGCAGCCGGGGGCAGGATACGCAGTATTTT	CASSRGQDTQYF	TRBV7-3	TRBJ2-3
TGTGCCGGCCGGCAGGACACTGAAGCTTTCTTT	CAGRQDTEAFF	TRBV19	TRBJ1-1
TGTGCCATCAGTGAGTTCCGACTAGGGGAGACCCAGTACTTC	CAISEFRLGETQYF	TRBV10-3	TRBJ2-5
TGCAGCGTTGGCGGGTTTCGACACTACAATGAGCAGTTCTTC	CSVGGFRHYNEQFF	TRBV29-1	TRBJ2-1
TGTGCCAGCAGCTTAGGTCCGGGACTGCAGTATTTT	CASSLGPGLQYF	TRBV11-3	TRBJ2-3
TGTGCCTGGAGAGGGCCGGGCACAGATACGCAGTATTTT	CAWRGPGTDTQYF	TRBV30	TRBJ2-3
TGTGCCAGCAGCCCTAGGAGTGGACCTTGGGATCAGTACTCCTACAATGAGCAGTTCTTC	CASSPRSGPWDQYSYNEQFF	TRBV7-2	TRBJ2-1
TGTGCCAGCCCATCGCTGGACAGGGGTGAAGCTTTCTTT	CASPSLDRGEAFF	TRBV7-3	TRBJ1-1
TGTGCCAGCATCGAGGACACTGAAGCTTTCTTT	CASIEDTEAFF	TRBV5-5	TRBJ1-1
TGTGCCAGCAGTTATGCCAGGGCAGCCCTCCACTTT	CASSYARAALHF	TRBV27	TRBJ1-6
TGCAGTGCTCGAAAACTCTTTTACGAGCAGTACTTC	CSARKLFYEQYF	TRBV20-1	TRBJ2-7
TGTGCCATCAGTGAGAAAGAAGGGAGAGGCTACGAGCAGTACTTC	CAISEKEGRGYEQYF	TRBV10-3	TRBJ2-7
TGTGCCAGCAGCCAAGAACCAGACCGGGACAGGGGGCCCGCTAACTATGGCTACACCTTC	CASSQEPDRDRGPANYGYTF	TRBV14	TRBJ1-2
TGTGCCAGCAGCGTTATACGGGGGCGGACTGAAGCTTTCTTT	CASSVIRGRTEAFF	TRBV7-8	TRBJ1-1
TGTGCCACCAGTGAGCTGGAAAAACTAGCCTACAATGAGCAGTTCTTC	CATSELEKLAYNEQFF	TRBV24-1	TRBJ2-1
TGTGCCACAGTTAGACTAGCGGGGTACTCCTACGAGCAGTACTTC	CATVRLAGYSYEQYF	TRBV24-1	TRBJ2-7
TGTGCCAGCAGTAAGGACTATTTATCCGGGGAGCTGTTTTTT	CASSKDYLSGELFF	TRBV12-4	TRBJ2-2
TGCGCCAGCAGCGTGACAGATAGCTCTGGAAACACCATATATTTT	CASSVTDSSGNTIYF	TRBV5-1	TRBJ1-3
TGTGCCAGACCCCGTACCCGGGGGTTACCTGCTAACTATGGCTACACCTTC	CARPRTRGLPANYGYTF	TRBV6-2	TRBJ1-2
TGTGCCAGCAGCTTGCCCCATGCAGATACGCAGTATTTT	CASSLPHADTQYF	TRBV5-4	TRBJ2-3
TGTGCCAGCAGGTCGTTAACGAACACCGGGGAGCTGTTTTTT	CASRSLTNTGELFF	TRBV12-4	TRBJ2-2
TGTGCCAGCGGTTGCACTAGCGAGACTTGGTTCTTC	CASGCTSETWFF	TRBV2	TRBJ2-1
TGTGCCAGCAGTCGCCCGGGCATAGGCTACACCTTC	CASSRPGIGYTF	TRBV9	TRBJ1-2
TGCGCCAGCAGTGAGTCGAAGGTGGCAGGGGGTAAATCTTATAGCAATCAGCCCCAGCATTTT	CASSESKVAGGKSYSNQPQHF	TRBV10-1	TRBJ1-5
TGTGCCAGCAGTGAATTCCAGGGGGCGGGTAGCTACGAGCAGTACTTC	CASSEFQGAGSYEQYF	TRBV6-4	TRBJ2-7
TGTCGGCAGCAACCTAGCACAGATACGCAGTATTTT	CRQQPSTDTQYF	TRBV11-2	TRBJ2-3
TGCAGTGCTAGAGAGACCGGGCTAGGCACAGATACGCAGTATTTT	CSARETGLGTDTQYF	TRBV20-1	TRBJ2-3
TGTGCCAGCACAGGGGCGACAGATACGCAGTATTTT	CASTGATDTQYF	TRBV6-4	TRBJ2-3
TGCAGTGCTAGAGCCTGTTTGAATCAGCCAGGGGGCCCCGCCTACGAGCAGTACTTC	CSARACLNQPGGPAYEQYF	TRBV20-1	TRBJ2-7
TGTGCCAGCAGTTCTGACGAAGATTCCTATAGCAATCAGCCCCAGCATTTT	CASSSDEDSYSNQPQHF	TRBV27	TRBJ1-5
TGCGCCAGCCGGTCCGGGACTAGCGGGGGATGGGGAAGACGCGGGGAGCTGTTTTTT	CASRSGTSGGWGRRGELFF	TRBV10-1	TRBJ2-2
TGCAGTGCTGGGACAGGCCTTACTAATGAAAAACTGTTTTTT	CSAGTGLTNEKLFF	TRBV20-1	TRBJ1-4
TGTGCTAGCCGAGGGACTAGCCCGAGCTCCTACAATGAGCAGTTCTTC	CASRGTSPSSYNEQFF	TRBV7-7	TRBJ2-1
TGTGCCAGCAGCCGTCCAGGTGATAGCAATCAGCCCCAGCATTTT	CASSRPGDSNQPQHF	TRBV3-1	TRBJ1-5
TGTGCCAGCAGCTCCGGGGGGGGTACAGATACGCAGTATTTT	CASSSGGGTDTQYF	TRBV11-2	TRBJ2-3
TGTGCCAGCAGCGAGACAACCGGGACAGGGGGCTCCTACGAGCAGTACTTC	CASSETTGTGGSYEQYF	TRBV5-5	TRBJ2-7
TGTGCCTGGAGTGTTACTGCCCGGGAGGGGAACAGCAATCAGCCCCAGCATTTT	CAWSVTAREGNSNQPQHF	TRBV30	TRBJ1-5
TGCAGTGCTAGTCCCGCCAGACCTAGCGGGCGGTGGTATAACTACGAGCAGTACTTC	CSASPARPSGRWYNYEQYF	TRBV20-1	TRBJ2-7
TGTGCCAGCAGCCAAGGAATAGCCTACGAGCAGTACTTC	CASSQGIAYEQYF	TRBV4-2	TRBJ2-7
TGTGCCAGCAGTGTTATCGCCCGGGACAGGGGGGTGTCGAGCACAGATACGCAGTATTTT	CASSVIARDRGVSSTDTQYF	TRBV6-4	TRBJ2-3
TGTGCCAGCAGCGTAGGAAGGACAGGTTTGGAGACCCAGTACTTC	CASSVGRTGLETQYF	TRBV9	TRBJ2-5
TGTGCCAGCAGAACCCGGGCGGATGGCGGGGGAACCTACGAGCAGTACTTC	CASRTRADGGGTYEQYF	TRBV6-4	TRBJ2-7
TGTGCCAGCAGCCAAGAACTAGCAGGGTTACCATACGAGCAGTACTTC	CASSQELAGLPYEQYF	TRBV3-1	TRBJ2-7
TGTGCCAGCAGTTTACGGAATGAGCAGTTCTTC	CASSLRNEQFF	TRBV2	TRBJ2-1
TGTGCCAGCAGCCCCCTGACTAGTTTGGTTTGCTCCTACGAGCAGTACTTC	CASSPLTSLVCSYEQYF	TRBV11-2	TRBJ2-7
TGTGCCAGCAGCCAAGATGCAGATGACACCGGGGAGCTGTTTTTT	CASSQDADDTGELFF	TRBV14	TRBJ2-2
TGTGCCAGCAGCCAAGGATCCGAACAGCCCTATGGCTACACCTTC	CASSQGSEQPYGYTF	TRBV14	TRBJ1-2
TGTGCCAGCAGCCCTAACAGGGGCAATCAGCCCCAGCATTTT	CASSPNRGNQPQHF	TRBV13	TRBJ1-5
TGTGCCAGAGCTAAGCGGGGCAATGAGCAGTTCTTC	CARAKRGNEQFF	TRBV13	TRBJ2-1
TGTGCCAGCAGCCAAGATGGATCCGCAGGGGGTAACCACACTGAAGCTTTCTTT	CASSQDGSAGGNHTEAFF	TRBV14	TRBJ1-1
TGTGCCAGCACAGCAGGTGTCCCCTACGAGCAGTACTTC	CASTAGVPYEQYF	TRBV28	TRBJ2-7
TGTGCCAGTAGTATCAGGGGGCGAAACATCTCTGAAAAACTGTTTTTT	CASSIRGRNISEKLFF	TRBV19	TRBJ1-4
TGTGCCACCAGTGATTTGGTTGGAGTAGTAGACGAGCAGTACTTC	CATSDLVGVVDEQYF	TRBV24-1	TRBJ2-7
TGTGCCATCACGATGAACGGCTCCTACAATGAGCAGTTCTTC	CAITMNGSYNEQFF	TRBV10-3	TRBJ2-1
TGTGCCAGCAGCGCTAGTTGTTGTGACGAGCAGTACTTC	CASSASCCDEQYF	TRBV13	TRBJ2-7
TGTGCCAGCCCGGGACGCAGTTGGTATCAGCCCCAGCATTTT	CASPGRSWYQPQHF	TRBV6-5	TRBJ1-5
TGTGCCAGCGCCCCAGGCAAGCTTTCACCCCTCCACTTT	CASAPGKLSPLHF	TRBV28	TRBJ1-6
TGTGCCAGCACTTGCCTTTCCCCCTCGACTAGCTGGGATACGCAGTATTTT	CASTCLSPSTSWDTQYF	TRBV6-1	TRBJ2-3
TGTGCCAGCAGCCGTCAAGGACGGTACTACGAGCAGTACTTC	CASSRQGRYYEQYF	TRBV4-2	TRBJ2-7
TGTGCTAGTGGTTTGGGGGACAGAGTCCACACTGAAGCTTTCTTT	CASGLGDRVHTEAFF	TRBV12-5	TRBJ1-1
TGCAGAGCGGACTGGGTCCTTGACACCTTC	CRADWVLDTF	TRBV20-1	TRBJ1-2
TGCAGTGCTATTGAACATCAGGGGGAGTATGGCTACACCTTC	CSAIEHQGEYGYTF	TRBV20-1	TRBJ1-2
TGTGCCTGGCTTTCACCCCTCCACTTT	CAWLSPLHF	TRBV5-6	TRBJ1-6
TGTGCCAGCAGTTTATGTCCCGGAAGAGACGAGACCCAGTACTTC	CASSLCPGRDETQYF	TRBV28	TRBJ2-5
TGTGCCACCAGTGACTCCCGCGCGGGACACACTGAAGCTTTCTTT	CATSDSRAGHTEAFF	TRBV24-1	TRBJ1-1
TGTGCCAGCAGCTTAGGACTACAGACCCGCACAGATACGCAGTATTTT	CASSLGLQTRTDTQYF	TRBV7-9	TRBJ2-3
TGTGCCACCAGTGATTTGGTTGGATCAGCCTTACATCCGGTGCGAGTTCGATGGCTCCACTTT	CATSDLVGSALHPVRVRWLHF	TRBV24-1	TRBJ1-6
TGTGCCAGCAGTGACTCTTTCCTCCCTCAGGGGGTTGGCTACACCTTC	CASSDSFLPQGVGYTF	TRBV6-4	TRBJ1-2
TGCAGCGTTGAAGAGAAGCCCGGGCGATACGAGCAGTACTTC	CSVEEKPGRYEQYF	TRBV29-1	TRBJ2-7
TGTGCCAGCATCCGAAAACGAATCGCCTCCTACGAGCAGTACTTC	CASIRKRIASYEQYF	TRBV6-5	TRBJ2-7
TGTGCCAGTCCCTTAGCCTACGAGCAGTACTTC	CASPLAYEQYF	TRBV6-2	TRBJ2-7
TGTGCCAGCTCACCACAAATCGTACTAGCGGGAGCCCTGGTTTCACACTCTGGGGCCAACGTCCTGACTTTC	CASSPQIVLAGALVSHSGANVLTF	TRBV18	TRBJ2-6
TGTGCCAGCAGGGTCCCTAGAGCGATCTCTGGGGCCAACGTCCTGACTTTC	CASRVPRAISGANVLTF	TRBV7-4	TRBJ2-6
TGCGCCAGCAGCCCAGTCCCCGGGGGGGGATTGACCCAGTACTTC	CASSPVPGGGLTQYF	TRBV5-1	TRBJ2-5
TGTGCCAGCAGTTTGCCTGGGCCCCGTTACGAGCAGTACTTC	CASSLPGPRYEQYF	TRBV2	TRBJ2-7
TGCAGTGCTAGATTCTTGGGGGGGAGGGTCTACGAGCAGTACTTC	CSARFLGGRVYEQYF	TRBV20-1	TRBJ2-7
TGTGCCAGTAGTATCATCCGCGAGGGAAATTCACCCCTCCACTTT	CASSIIREGNSPLHF	TRBV19	TRBJ1-6
TGCAGTGCTAGAGAGGGGGGAAGCAATCAGCCCCAGCATTTT	CSAREGGSNQPQHF	TRBV20-1	TRBJ1-5
TGCAGTGCTAGAGCTAGAGCCACCCCGTATCGGACTACACAAGAGACCCAGTACTTC	CSARARATPYRTTQETQYF	TRBV20-1	TRBJ2-5
TGCGCCAGCAGTGCGAAAGGGAGCTATGGCTACACCTTC	CASSAKGSYGYTF	TRBV10-1	TRBJ1-2
TGCAGTGCTAGAGGGTGGGTAACTACATCCTACAATGAGCAGTTCTTC	CSARGWVTTSYNEQFF	TRBV20-1	TRBJ2-1
TGTGCCAGCAGTGAACTCACGGACAGAAGCAATCAGCCCCAGCATTTT	CASSELTDRSNQPQHF	TRBV6-1	TRBJ1-5
TGTGCCAGCAGAAAAAGTCGGGAAGGGCGGACGAACACCGGGGAGCTGTTTTTT	CASRKSREGRTNTGELFF	TRBV27	TRBJ2-2
TGTGCCAGGCCCGGGACAGGGGGCGTTGGCTACACCTTC	CARPGTGGVGYTF	TRBV6-1	TRBJ1-2
TGTGCCAGCGTACAGGGGGCGGGAGATGAAGGGGTCTCCTATAATTCACCCCTCCACTTT	CASVQGAGDEGVSYNSPLHF	TRBV2	TRBJ1-6
TGTGCCAGCAGTTTGAGAGACAGGGGACGATCACAGAACACTGAAGCTTTCTTT	CASSLRDRGRSQNTEAFF	TRBV27	TRBJ1-1
TGTGCCACCAGCAGAGATGAAGGGACTAGCGGGTATGAGCAGTTCTTC	CATSRDEGTSGYEQFF	TRBV15	TRBJ2-1
TGCAGCAGACAGGGGGCGCGTCATGGCTACACCTTC	CSRQGARHGYTF	TRBV29-1	TRBJ1-2
TGTGCCAGCAGTCCCCAGGGACACGTCTACGAGCAGTACTTC	CASSPQGHVYEQYF	TRBV9	TRBJ2-7
TGCGCCAGCAGCTTGGCCGCCAGGTCCCAGCCCCAGCATTTT	CASSLAARSQPQHF	TRBV5-1	TRBJ1-5
TGCGCCAGCAGCCATCCGGAGCGGGGGCGACAAGAGACCCAGTACTTC	CASSHPERGRQETQYF	TRBV4-3	TRBJ2-5
TGTGCCAGCAGTATCGGAAAACGGGGAGGGGTCGGGAACACCGGGGAGCTGTTTTTT	CASSIGKRGGVGNTGELFF	TRBV27	TRBJ2-2
TGTGCCAGCAGCTCACCCACAGGGGAGAATTCACCCCTCCACTTT	CASSSPTGENSPLHF	TRBV7-6	TRBJ1-6
TGCGCCAGCCAAAGGACTAGCGGGAGGGTATTTTTGGGTGATACGCAGTATTTT	CASQRTSGRVFLGDTQYF	TRBV10-1	TRBJ2-3
TGTGCCAGCAGCTTAGATTGTCGATTAGGTACAACTAATGAAAAACTGTTTTTT	CASSLDCRLGTTNEKLFF	TRBV11-2	TRBJ1-4
TGCGCCAGGGACCATATCGAGCAGTACTTC	CARDHIEQYF	TRBV5-1	TRBJ2-7
TGTGCCAGCCGTGGAGTTAAGGTCCGTGTAGTTGGCACAGATACGCAGTATTTT	CASRGVKVRVVGTDTQYF	TRBV5-6	TRBJ2-3
TGTGCCAGCAGCTTTGGGGGGGTTATCACAGATACGCAGTATTTT	CASSFGGVITDTQYF	TRBV11-2	TRBJ2-3
TGTGCCAGCAGTGACCAGGGAATGCATTTT	CASSDQGMHF	TRBV25-1	TRBJ1-5
TGTGCCAGCAGCCAAGATATGTGGGGGGGCCTGTCTGAGCAGTTCTTC	CASSQDMWGGLSEQFF	TRBV14	TRBJ2-1
TGTGCCAGCAGCCCCCGGGACAGGGTAGCTTTCTTT	CASSPRDRVAFF	TRBV7-9	TRBJ1-1
TGTGCCATGGACAGTCCTGAAGCTTTCTTT	CAMDSPEAFF	TRBV2	TRBJ1-1
TGCAGCTCACCGGGGGCCAGGCAGTACTTC	CSSPGARQYF	TRBV29-1	TRBJ2-7
TGTGCCAGCAGTTCCGGGGAGTATCAGCCCCAGCATTTT	CASSSGEYQPQHF	TRBV6-6	TRBJ1-5
TGCGCCAGCAGATACCTGCCGGGACAGGGGAGCTCTGGAAACACCATATATTTT	CASRYLPGQGSSGNTIYF	TRBV10-1	TRBJ1-3
TGTGCCAGCAGCTTACGGGGGGAGGCCTACGAGCAGTACTTC	CASSLRGEAYEQYF	TRBV11-3	TRBJ2-7
TGTGCCAGCAGCTTGGTCCACCGGGACAGGGGGTTAGCTGTCCGCGTAGATCACACTGAAGCTTTCTTT	CASSLVHRDRGLAVRVDHTEAFF	TRBV7-2	TRBJ1-1
TGTGCCAGCAGACTCCACGGGCCCAGGGAGCCCCACGAGCAGTACTTC	CASRLHGPREPHEQYF	TRBV6-2	TRBJ2-7
TGCGCCAGCAGTGAGGTGACAGGGGCGACAGTTACCGGGGAGCTGTTTTTT	CASSEVTGATVTGELFF	TRBV10-1	TRBJ2-2
TGTGCCAGCAGCCATCAAGGCTACACCTTC	CASSHQGYTF	TRBV5-4	TRBJ1-2
TGTGCCAGCAGCTCGTACGGGGGGAACACTGAAGCTTTCTTT	CASSSYGGNTEAFF	TRBV5-4	TRBJ1-1
TGTGCCAGCAGTCCGGGACAAGAGGCAGCCAAAAACATTCAGTACTTC	CASSPGQEAAKNIQYF	TRBV6-6	TRBJ2-4
TGTGCCAGCAGTTACTCGATCCCGATAATCCCAGATACGCAGTATTTT	CASSYSIPIIPDTQYF	TRBV6-5	TRBJ2-3
TGTGCCACCAGTCCGGGACTGGGCTACGAGCAGTACTTC	CATSPGLGYEQYF	TRBV24-1	TRBJ2-7
TGTGCCAGCAGCTCCGCCGGGGACACGGAAGCTTTCTTT	CASSSAGDTEAFF	TRBV5-4	TRBJ1-1
TGCGCCATAGGCCACAGGGGGTGCAATGAAAAACTGTTTTTT	CAIGHRGCNEKLFF	TRBV10-1	TRBJ1-4
TGTGCCAGGGTCCAAACTAGGGATAATTGGACCTCCTACGAGCAGTACTTC	CARVQTRDNWTSYEQYF	TRBV7-7	TRBJ2-7
TGTGCCAGCAGTTTAACCAGCAGGGGGAATCGGGGCTCCTACAATGAGCAGTTCTTC	CASSLTSRGNRGSYNEQFF	TRBV27	TRBJ2-1
TGTGCCAGCAGACACAGGGGGCGTTTGGACAATGAGCAGTTCTTC	CASRHRGRLDNEQFF	TRBV6-2	TRBJ2-1
TGCGCCAGCAGCCTATCCTTGGGAACCAAAGATACGCAGTATTTT	CASSLSLGTKDTQYF	TRBV4-3	TRBJ2-3
TGCGCCAGCCTTCGGACGCTTGAGCAGTTCTTC	CASLRTLEQFF	TRBV5-1	TRBJ2-1
TGTGCCCCCGAGCGGGACCGTATTAGTCCGCAGTACTTC	CAPERDRISPQYF	TRBV10-3	TRBJ2-7
TGCAGTGCTAGACCCCCAGGGAGGAGCAATCAGCCCCAGCATTTT	CSARPPGRSNQPQHF	TRBV20-1	TRBJ1-5
TGTGCCTGGAGTACAGAGGGGGGAAACAATGAGCAGTTCTTC	CAWSTEGGNNEQFF	TRBV30	TRBJ2-1
TGTGCCACCAGTGATTCGGGACAGGCGGACTACGAGCAGTACTTC	CATSDSGQADYEQYF	TRBV24-1	TRBJ2-7
TGCAGTGCTAGACCCCTCCTATGGGACACTGAAGCTTTCTTT	CSARPLLWDTEAFF	TRBV20-1	TRBJ1-1
TGTGCCAGCAGCTGGATCAAAGGGGTGGGGGGCTCCTACGAGCAGTACTTC	CASSWIKGVGGSYEQYF	TRBV5-5	TRBJ2-7
TGTGCCAGCAGCGTAGCCGTTGACGTTGCCTACAATCAGCCCCAGCATTTT	CASSVAVDVAYNQPQHF	TRBV9	TRBJ1-5
TGTGCCAGCAGTTATTCCACGCCGGGACAGGGTCGAGGACAACGGGATGGCTACACCTTC	CASSYSTPGQGRGQRDGYTF	TRBV6-9	TRBJ1-2
TGCATGACACCCGCTGGGACTAGCGGGACTAGCTCCTACGAGCAGTACTTC	CMTPAGTSGTSSYEQYF	TRBV20-1	TRBJ2-7
TGTGCCAGCAGCTTAAGTACTAGCGGGAACAATGAGCAGTTCTTC	CASSLSTSGNNEQFF	TRBV7-9	TRBJ2-1
TGTGCCAGCCTCTGGGAGGACGCCCGATACGAGCAGTACTTC	CASLWEDARYEQYF	TRBV6-2	TRBJ2-7
TGTGCCAGCAGCATGACAGGGGGCGTAAGATCCTCCTATAATTCACCCCTCCACTTT	CASSMTGGVRSSYNSPLHF	TRBV7-2	TRBJ1-6
TGTGCCCGGGGGGTTAGGATGAGGAATCAGCCCCAGCATTTT	CARGVRMRNQPQHF	TRBV30	TRBJ1-5
TGTGCCAGCAGTCAGACAGTCATCCTTTGTGCAACTAATGAAAAACTGTTTTTT	CASSQTVILCATNEKLFF	TRBV12-3	TRBJ1-4
TGTGCCACTAGCGGAGGCCAGCAGTACTTC	CATSGGQQYF	TRBV11-3	TRBJ2-7
TGTGCCAGCAGCGGGACAGACGAGCAGTACTTC	CASSGTDEQYF	TRBV11-2	TRBJ2-7
TGTGCCAGCAGAGCGAGGGAGATGAACACTGAAGCTTTCTTT	CASRAREMNTEAFF	TRBV6-1	TRBJ1-1
TGTGCCAGCAGCGTAGCGACGGGGCACGCTGAAGCTTTCTTT	CASSVATGHAEAFF	TRBV9	TRBJ1-1
TGTGCCAGCAGCTTAAGAGCAACTGGCTACACCTTC	CASSLRATGYTF	TRBV7-2	TRBJ1-2
TGCGCCAGCAGCAAGGCGACTCAGGTCCCTAGGTCACCCCTCCACTTT	CASSKATQVPRSPLHF	TRBV4-3	TRBJ1-6
TGCAGTGCTAAGGGGCGGGGACCAAACACCATATATTTT	CSAKGRGPNTIYF	TRBV20-1	TRBJ1-3
TGTGCCATCAGCTGGGTACGACAGGGGTTTACGGACACTGAAGCTTTCTTT	CAISWVRQGFTDTEAFF	TRBV10-3	TRBJ1-1
TGCGCCAGCAGCCATCGGACAGGGAGGTCCTACGAGCAGTACTTC	CASSHRTGRSYEQYF	TRBV4-3	TRBJ2-7
TGTGCCAGCAGCTCGTCTAGGGGGTTAGACCCAACTGAAGCTTTCTTT	CASSSSRGLDPTEAFF	TRBV7-4	TRBJ1-1
TGTGCCAGCAACCAGGTTCTGAACACTGAAGCTTTCTTT	CASNQVLNTEAFF	TRBV5-6	TRBJ1-1
TGTGCCAGCAGCGGAGGGGACGACGAGCAGTACTTC	CASSGGDDEQYF	TRBV7-2	TRBJ2-7
TGTGCCAGCAGCGAATATACGACCTTCGGATTCTACGAGCAGTACTTC	CASSEYTTFGFYEQYF	TRBV7-3	TRBJ2-7
TGCAGCGTGGGCTCCAACGCGGAGGGTGTGACCCAGTACTTC	CSVGSNAEGVTQYF	TRBV29-1	TRBJ2-5
TGCGCCAGCAGCTTGGGTCGGACAGGGGGGTCCTACAATGAGCAGTTCTTC	CASSLGRTGGSYNEQFF	TRBV5-1	TRBJ2-1
TGCGCCAGCAGCTCCCGAAAGACCGAGGTTCCAGGCTACGAGCAGTACTTC	CASSSRKTEVPGYEQYF	TRBV5-1	TRBJ2-7
TGTGCCAGTAGTACCCATTCCGATATTGGACTAGCGCAGTTTGCCAAAAACATTCAGTACTTC	CASSTHSDIGLAQFAKNIQYF	TRBV19	TRBJ2-4
TGTGCCAGCAGTTTGTTAGTTTCAATAAAAGGCTCCTACGAGCAGTACTTC	CASSLLVSIKGSYEQYF	TRBV28	TRBJ2-7
TGTGCCAGCAGAGCGGTCCCCACAGCGGGAAACACCATATATTTT	CASRAVPTAGNTIYF	TRBV6-8	TRBJ1-3
TGTGCCAGCAGCCCTACGACCTTTTCCGGGGAGCTGTTTTTT	CASSPTTFSGELFF	TRBV11-3	TRBJ2-2
TGTGCCTGGAGTATACTGACAGGGTACGCCGGGGAGCTGTTTTTT	CAWSILTGYAGELFF	TRBV30	TRBJ2-2
TGTGCCAGCAGCTTAGGCTTTATTCTCTCCTACAATGAGCAGTTCTTC	CASSLGFILSYNEQFF	TRBV7-9	TRBJ2-1
TGCGCCAGCAGTGGTGGGCGGACAGGGGAATATGGCTACACCTTC	CASSGGRTGEYGYTF	TRBV10-1	TRBJ1-2
TGTGCCAGCAGTTATCGGGTCTACGAGCAGTACTTC	CASSYRVYEQYF	TRBV6-2	TRBJ2-7
TGTGCCACCAGCAGAGATAAGGACAGCAATCAGCCCCAGCATTTT	CATSRDKDSNQPQHF	TRBV15	TRBJ1-5
TGTGCCAGCTCCAGCGGTCATTCCTACAATGAGCAGTTCTTC	CASSSGHSYNEQFF	TRBV18	TRBJ2-1
TGTGCCAGCAAAAACATGGGCGCCGAAACGAGGGGCTTTCCGAGGTATTCCCTTAATGAAAAACTGTTTTTT	CASKNMGAETRGFPRYSLNEKLFF	TRBV6-1	TRBJ1-4
TGTGCCACCAGCACCCAGGGGGGGTATGGCTACACCTTC	CATSTQGGYGYTF	TRBV24-1	TRBJ1-2
TGTGCCAGCACCCTGGGGTACACTGAAGCTTTCTTT	CASTLGYTEAFF	TRBV28	TRBJ1-1
TGTGCCGGGAGATCGGCCCAGCATTTT	CAGRSAQHF	TRBV9	TRBJ1-5
TGTGCCACCGCCGGGACACGGAAAAACATTCAGTACTTC	CATAGTRKNIQYF	TRBV27	TRBJ2-4
TGCGCCAGCAGTGACGGTGGAACTAGCGATTGCATTCAGTACTTC	CASSDGGTSDCIQYF	TRBV10-1	TRBJ2-4
TGTGCCACGGGACAGGCCTACGAGCAGTACTTC	CATGQAYEQYF	TRBV28	TRBJ2-7
TGTGCCAGCAGTAGCCGCAACTTAGGGGAACATGAGCAGTTCTTC	CASSSRNLGEHEQFF	TRBV6-1	TRBJ2-1
TGTGCCAGCAGCCGGTACTTAAGGCGTGTGGATGAGCAGTTCTTC	CASSRYLRRVDEQFF	TRBV14	TRBJ2-1
TGTGCCAGCAGTTTGTTTGGGGCCCGCTACACCTTC	CASSLFGARYTF	TRBV27	TRBJ1-2
TGCAGTGCACTACCCGCCGGGACTAGGGGCTACAATGAGCAGTTCTTC	CSALPAGTRGYNEQFF	TRBV20-1	TRBJ2-1
TGTGCCAGCCTCTGGACGGAGTACTTC	CASLWTEYF	TRBV27	TRBJ2-5
TGTGCCAGCAGCTTAGGAGGACTAGCGGGGGGGGCCTCGTACGAGCAGTACTTC	CASSLGGLAGGASYEQYF	TRBV11-2	TRBJ2-7
TGCGCCAGCATTGAACGGAGGGTGCCTGATACGCAGTATTTT	CASIERRVPDTQYF	TRBV4-1	TRBJ2-3
TGTGCCAGCAGCCGTCGGGGAACGGAGGGTGCCTACGAGCAGTACTTC	CASSRRGTEGAYEQYF	TRBV11-1	TRBJ2-7
TGTGCCAGCAGGACATCTGGGGTGGCCTACGAGCAGTACTTC	CASRTSGVAYEQYF	TRBV27	TRBJ2-7
TGTGCCAGCACCTGCGGGTCCGGCAATCAGCCCCAGCATTTT	CASTCGSGNQPQHF	TRBV28	TRBJ1-5
TGTGCTAGCAGCTTACCCTGGAAGACTAGCGCAGATACGCAGTATTTT	CASSLPWKTSADTQYF	TRBV7-7	TRBJ2-3
TGTGCCAGCTCGGGGGGGCCGTGGGACACGCAGTATTTT	CASSGGPWDTQYF	TRBV12-4	TRBJ2-3
TGTGCCAGCGAGCACACAAACTGGAACTATGGCTACACCTTC	CASEHTNWNYGYTF	TRBV11-2	TRBJ1-2
TGTGCCAGCAGCTTAGACGCGCGAGGACCTAGCACAGATACGCAGTATTTT	CASSLDARGPSTDTQYF	TRBV7-9	TRBJ2-3
TGTGCCAGCAGCTTGATGCGGGAGGCCCGGGAGACCCAGTACTTC	CASSLMREARETQYF	TRBV5-6	TRBJ2-5
TGTGCCAGCAGCTTAGGAACGGAGGACAGGGGGGTGGAAAAACTGTTTTTT	CASSLGTEDRGVEKLFF	TRBV7-4	TRBJ1-4
TGTGCCAGCAGCTCGACCCAAGAGACCCAGTACTTC	CASSSTQETQYF	TRBV7-4	TRBJ2-5
TGTGCCAGCAGCAGCCACAGGGGCAGAATGAACACTGAAGCTTTCTTT	CASSSHRGRMNTEAFF	TRBV13	TRBJ1-1
TGTGCCAGCAGCTTAGGGGGAGAACGGGAGTTCTCTGGAAACACCATATATTTT	CASSLGGEREFSGNTIYF	TRBV11-2	TRBJ1-3
TGTGCCAAAACAGGGGACTACGAGCAGTACTTC	CAKTGDYEQYF	TRBV19	TRBJ2-7
TGTGCCAGCAGCGTGCCAGAGAAGATCGAGCAGTACTTC	CASSVPEKIEQYF	TRBV7-2	TRBJ2-7
TGTGCCACCAGTGATACAGGGATCCGGAACAATGAGCAGTTCTTC	CATSDTGIRNNEQFF	TRBV24-1	TRBJ2-1
TGTGCCAGCAGCCTACGGGCGGATGTTCTGAGCATAAACACTGAAGCTTTCTTT	CASSLRADVLSINTEAFF	TRBV13	TRBJ1-1
TGTGCCAGCAGCGATCGGGCGGAGGACTATGGCTACACCTTC	CASSDRAEDYGYTF	TRBV9	TRBJ1-2
TGCGCCAGCAGCCAAGTCTCGACAACGACAATGAGGGGACCCCTCCACTTT	CASSQVSTTTMRGPLHF	TRBV4-3	TRBJ1-6
TGTGCCAGCCGTTGGAGGTTGGGGGCGGAGAGCAATCAGCCCCAGCATTTT	CASRWRLGAESNQPQHF	TRBV6-4	TRBJ1-5
TGTGCTAGCAGCTCCGAAGAATTACAAGAGACCCAGTACTTC	CASSSEELQETQYF	TRBV7-7	TRBJ2-5
TGTGCCAAGGACAGAATGGGGCAGCCCCAGCATTTT	CAKDRMGQPQHF	TRBV19	TRBJ1-5
TGCGCCAGCACCTCCCGAGGAAAATCCTACGAGCAGTACTTC	CASTSRGKSYEQYF	TRBV10-1	TRBJ2-7
TGTGCCTGGGAGACTAGCCCGAGGAACGAGCAGTACTTC	CAWETSPRNEQYF	TRBV30	TRBJ2-7
TGTGCCATGGACACGGAGCATTGCAACTATGGCTACACCTTC	CAMDTEHCNYGYTF	TRBV5-6	TRBJ1-2
TGTGCCAGCAGTGACCCCCGCCCACAGGGAGGAGGGATTTGGGAAGAAGCTTTCTTT	CASSDPRPQGGGIWEEAFF	TRBV6-4	TRBJ1-1
TGCGCCAGCCCCCCGAACCCGGACAGGGGTAAAGGGGGGAACACTGAAGCTTTCTTT	CASPPNPDRGKGGNTEAFF	TRBV4-1	TRBJ1-1
TGTGCCAGCAGCGTCACTAGCGGGAGTTGGTTCTTGAAGAACACCGGGGAGCTGTTTTTT	CASSVTSGSWFLKNTGELFF	TRBV13	TRBJ2-2
TGCGCCAGCAGTGTAAGCTCATCGAGCAGATCGCCAACTAATGAAAAACTGTTTTTT	CASSVSSSSRSPTNEKLFF	TRBV10-1	TRBJ1-4
TGCGCCCCACTGCGCAGGCGAGGTTTATTCGGGTCTAACTATGGCTACACCTTC	CAPLRRRGLFGSNYGYTF	TRBV10-2	TRBJ1-2
TGTGCCTGGAAGTACGCAGACAGGGGGCTAGAGACCCAGTACTTC	CAWKYADRGLETQYF	TRBV30	TRBJ2-5
TGTGCCATCAGTGCCATAGGGACAGGGGGCTCTGCCTACGAGCAGTACTTC	CAISAIGTGGSAYEQYF	TRBV10-3	TRBJ2-7
TGTGCCAGCAGCAAAGGACTCCTTTCACCCCTCCACTTT	CASSKGLLSPLHF	TRBV12-4	TRBJ1-6
TGTGCCAGCAGCTTGGCGACTATTTGGAACACTGAAGCTTTCTTT	CASSLATIWNTEAFF	TRBV5-6	TRBJ1-1
TGCGCCAGCAGCTTGCATACGGGTTTAGCTTCACCCCTCCACTTT	CASSLHTGLASPLHF	TRBV5-1	TRBJ1-6
TGTGCCAGCAGTTGGCAGGGGGCGACCCCGCCAAAACTGTTTTTT	CASSWQGATPPKLFF	TRBV2	TRBJ1-4
TGTGCCAGCATCCGGCGAGAGCAGTACTTC	CASIRREQYF	TRBV27	TRBJ2-7
TGCGCCAGCAGCTGTGCGGGGCGGGGGGGTAATCAGCCCCAGCATTTT	CASSCAGRGGNQPQHF	TRBV5-1	TRBJ1-5
TGTGCCAGCAGCTTTCATCCCCTTACCAGCGGGAGCGGGGCCAACGTCCTGACTTTC	CASSFHPLTSGSGANVLTF	TRBV7-7	TRBJ2-6
TGTGCCAGCAGCTTACAGATGACTGAGCAGTACTTC	CASSLQMTEQYF	TRBV11-2	TRBJ2-7
TGCGCCAGCAGCTTGAGTTACGGACGGGGCGACGAGCAGTACTTC	CASSLSYGRGDEQYF	TRBV5-1	TRBJ2-7
TGCGCCAGCAGCTTGTCCCCTAACGAGCAGTACTTC	CASSLSPNEQYF	TRBV5-1	TRBJ2-7
TGTGCCAGCATGGGGCCCCAGTACTTC	CASMGPQYF	TRBV6-1	TRBJ2-5
TGTGCCAGCAGCGAGGGGCGCGTGAGCACTGAAGCTTTCTTT	CASSEGRVSTEAFF	TRBV9	TRBJ1-1
TGTGCCAGCAGGAGACGTTGCAAGGACTATGGCTACACCTTC	CASRRRCKDYGYTF	TRBV12-4	TRBJ1-2
TGCGCCAGCAGCTTGAAATGTCAACGAGGGAACTACAATGAGCAGTTCTTC	CASSLKCQRGNYNEQFF	TRBV5-1	TRBJ2-1
TGTGCCAGCTCACCACGCAGGCCGGGACAGGGTAGCACAGATACGCAGTATTTT	CASSPRRPGQGSTDTQYF	TRBV18	TRBJ2-3
TGTGCCAGCAGCGTACAGGGACTAGCGGGGAGGAGCTCCTACGAGCAGTACTTC	CASSVQGLAGRSSYEQYF	TRBV9	TRBJ2-7
TGTGCCAGCAGCCCACCCTCCAGGACCCCCAACCGATGCTCTGGGGCCAACGTCCTGACTTTC	CASSPPSRTPNRCSGANVLTF	TRBV14	TRBJ2-6
TGTGCCAGCAGCCAACACGAACCGGGACGGAACACCGGGGAGCTGTTTTTT	CASSQHEPGRNTGELFF	TRBV3-1	TRBJ2-2
TGTGCCAGTAGTATACACGAGGTTGAAGGGGCTACCTATGGCTACACCTTC	CASSIHEVEGATYGYTF	TRBV19	TRBJ1-2
TGTGCCAGCAGGAACCGGGGGGGCCCCTACAATGAGCAGTTCTTC	CASRNRGGPYNEQFF	TRBV5-5	TRBJ2-1
TGTGCCACAACCCCGGGGGTTATTGAAGCTTTCTTT	CATTPGVIEAFF	TRBV24-1	TRBJ1-1
TGTGCCAGCAGTGACTCGACTTTCCGGGGTGGGAGTCATGAAAAACTGTTTTTT	CASSDSTFRGGSHEKLFF	TRBV6-4	TRBJ1-4
TGTGCCAGCAGCATGGTAGCGGGGTGTGCAGATACGCAGTATTTT	CASSMVAGCADTQYF	TRBV7-9	TRBJ2-3
TGTGCCAGCAGCGGTTGGACTAGCGGGTACTACGAGCAGTACTTC	CASSGWTSGYYEQYF	TRBV28	TRBJ2-7
TGCGCCACCGACGGGGAGAGAGGAGTCTCTGGAAACACCATATATTTT	CATDGERGVSGNTIYF	TRBV4-3	TRBJ1-3
TGTGCCAGCAGCCGGCCGGGACAGGGGCGATATAGCAATCAGCCCCAGCATTTT	CASSRPGQGRYSNQPQHF	TRBV2	TRBJ1-5
TGTGCCAGCAGTGACCAGTGCAATCAGCCCCAGCATTTT	CASSDQCNQPQHF	TRBV6-1	TRBJ1-5
TGCAGTGCTAGCCATGGGACAGGGTCCGAAGGCTACACCTTC	CSASHGTGSEGYTF	TRBV20-1	TRBJ1-2
TGCGCCAGCAGTAGCAGAGAAAAACTGTTTTTT	CASSSREKLFF	TRBV10-1	TRBJ1-4
TGTGCCAGTAAGTCTGAGGGGCAAAAACTGTTTTTT	CASKSEGQKLFF	TRBV19	TRBJ1-4
TGTGCCAGCAGTGAGCTCTGTCGAGGGTCCTACGAGCAGTACTTC	CASSELCRGSYEQYF	TRBV25-1	TRBJ2-7
TGTGCCAGCAGCTCTCCACTGTCCTTGAGAGCCTACGAGCAGTACTTC	CASSSPLSLRAYEQYF	TRBV7-3	TRBJ2-7
TGTGCCAGCTCACGGTACCGGAGTCTGGCTGGAAACACCATATATTTT	CASSRYRSLAGNTIYF	TRBV18	TRBJ1-3
TGCGCCAGCAGCTATGGGGGGGCCTGTAACTATGGCTACACCTTC	CASSYGGACNYGYTF	TRBV5-1	TRBJ1-2
TGCAGCGAAAGACGACAGGGGGCGGAAGAGACCCAGTACTTC	CSERRQGAEETQYF	TRBV29-1	TRBJ2-5
TGCAGTGCTAGAACACCCAGGGGGTGGTTACGGTTAGGTGACACTGAAGCTTTCTTT	CSARTPRGWLRLGDTEAFF	TRBV20-1	TRBJ1-1
TGTGCCAGAATTATCAGACTAGCGGAAGGCCTCAATGAGCAGTTCTTC	CARIIRLAEGLNEQFF	TRBV2	TRBJ2-1
TGTGCCAGCAGCGTACTATACCGGAAGGTGACCCAGTACTTC	CASSVLYRKVTQYF	TRBV9	TRBJ2-5
TGTGCCAGCAGGTTCAGGAGCGAGCAGTACTTC	CASRFRSEQYF	TRBV6-4	TRBJ2-7
TGTGCCAGCAGTGACAGAGGAGGGGGGTACGAGCAGTACTTC	CASSDRGGGYEQYF	TRBV6-1	TRBJ2-7
TGCGCCAGCAGCATAAGCAACAGCCTTTCAGCGGGAGGTCTCGGAGCTTTCTTT	CASSISNSLSAGGLGAFF	TRBV10-2	TRBJ1-1
TGCAGTGCTAGAGATCTACCGGGACAGGGGTGGAATCAGCCCCAGCATTTT	CSARDLPGQGWNQPQHF	TRBV20-1	TRBJ1-5
TGTGCCAGGGCCACGTCACTAGCAAAAGATACGCAGTATTTT	CARATSLAKDTQYF	TRBV28	TRBJ2-3
TGCAGCGTTGAAATCGGGTTCTATGGCTACACCTTC	CSVEIGFYGYTF	TRBV29-1	TRBJ1-2
TGTGCCAGCAGTTTGGACATAGAGCAGTACTTC	CASSLDIEQYF	TRBV6-6	TRBJ2-7
TGTGCCAGCAGGAGACCGTACGAGCAGTACTTC	CASRRPYEQYF	TRBV7-4	TRBJ2-7
TGTGCCAGCAGTTTCGCCCCGGGACTAGCGGGAGTTCAGGCAGATACGCAGTATTTT	CASSFAPGLAGVQADTQYF	TRBV12-3	TRBJ2-3
TGTGCCATCAGTGACGGGCAGAAGACCAGCAATCAGCCCCAGCATTTT	CAISDGQKTSNQPQHF	TRBV10-3	TRBJ1-5
TGCGCCAGCAGCAGTTACGGGGGTTCGGGGGGCACAGATACGCAGTATTTT	CASSSYGGSGGTDTQYF	TRBV5-1	TRBJ2-3
TGCAGTGCTACTAGGGGCTACAATGAGCAGTTCTTC	CSATRGYNEQFF	TRBV20-1	TRBJ2-1
TGTGCCAGCAGTTTATGCTACGAGGAAGAGACCCAGTACTTC	CASSLCYEEETQYF	TRBV28	TRBJ2-5
TGTGCCAGCAGCTCGGGACAGGGGGCCAATGGAGACGTTTACGAGCAGTACTTC	CASSSGQGANGDVYEQYF	TRBV7-6	TRBJ2-7
TGTGCTAGTGGTACCGATCCGGGACCCAGCTCCTACGAGCAGTACTTC	CASGTDPGPSSYEQYF	TRBV12-5	TRBJ2-7
TGTGCCAGCAGTTGGGGATACTCCTACGAGCAGTACTTC	CASSWGYSYEQYF	TRBV6-3	TRBJ2-7
