TGTGCCAGCAGTTACTTGGGACTAGCGTGTTACAATGAGCAGTTCTTC	CASSYLGLACYNEQFF	TRBV6-2	TRBJ2-1
TGTGCCAGCAGCTTGCCCCGGCATGGGCAGTTCTTC	CASSLPRHGQFF	TRBV7-7	TRBJ2-1
TGTGCCAGCAGTGTTTCAGGGCCACTAAATGAGCAGTTCTTC	CASSVSGPLNEQFF	TRBV2	TRBJ2-1
TGTGCCAGCAAGAACCTACGGACTAGCGGGGTAATCCATCCCGCCAAAAACATTCAGTACTTC	CASKNLRTSGVIHPAKNIQYF	TRBV25-1	TRBJ2-4
TGCGCCAGCAGCCAAGATATCAGCTTCCAGCCCCAGCATTTT	CASSQDISFQPQHF	TRBV4-1	TRBJ1-5
TGCGCCAGCAGTGCGGTTAGGGAACCGGGACTAGGAAAATACTTC	CASSAVREPGLGKYF	TRBV10-1	TRBJ2-5
TGTGCCAGCAGTTTACCAGGTGGACTAGGCATGGACAATGAGCAGTTCTTC	CASSLPGGLGMDNEQFF	TRBV28	TRBJ2-1
TGTGCCAGCAGCGAACGGGGACAGCGAACCTACGAGCAGTACTTC	CASSERGQRTYEQYF	TRBV13	TRBJ2-7
TGTGCCAGCAGTTACTTAGCTCCCGAAGGACAGGGTACTTACGAGCAGTACTTC	CASSYLAPEGQGTYEQYF	TRBV6-8	TRBJ2-7
TGCAGTGCTAAGAATTCGGAGACAGGGTACACTGAAGCTTTCTTT	CSAKNSETGYTEAFF	TRBV20-1	TRBJ1-1
TGTGCCAGCAGCGAAGACAGGCGTGGGGGGGAAGAGACCCAGTACTTC	CASSEDRRGGEETQYF	TRBV7-9	TRBJ2-5
TGTGCCAAAAGATTAGCCGTAGAATGCGAGCAGTACTTC	CAKRLAVECEQYF	TRBV6-3	TRBJ2-7
TGCACGTCGGGAGGGGCCCGCACAGATACGCAGTATTTT	CTSGGARTDTQYF	TRBV29-1	TRBJ2-3
TGTGCCAGCAGGACCGGGACAGTAGACGAGCAGTACTTC	CASRTGTVDEQYF	TRBV27	TRBJ2-7
TGTGCCAGCAGCTCCCCCGGGACAGCGCGCTCTGGGGCCAACGTCCTGACTTTC	CASSSPGTARSGANVLTF	TRBV6-5	TRBJ2-6
TGTGCCAGCAGTTCAGGACTAGCGGGGTGCTCCTACAATGAGCAGTTCTTC	CASSSGLAGCSYNEQFF	TRBV27	TRBJ2-1
TGCAGTGCTCAAGAGGGAAGGGGGAGAGGCTACACCTTC	CSAQEGRGRGYTF	TRBV20-1	TRBJ1-2
TGTGCCAGCAGTTATTTGGACTCGAACTTC	CASSYLDSNF	TRBV27	TRBJ2-7
TGTGCCAGCAGCGGACAGGGCTATGGCTACACCTTC	CASSGQGYGYTF	TRBV7-9	TRBJ1-2
TGTGCCACCGGGAGGGGTGGGGCCAACGTCCTGACTTTC	CATGRGGANVLTF	TRBV6-6	TRBJ2-6
TGTGCCAGCAGCCGGGCGGGGTTCTATAGCAATCAGCCCCAGCATTTT	CASSRAGFYSNQPQHF	TRBV7-3	TRBJ1-5
TGTGCCAGCAGTTTTTACAGGGTTCGCGAGCAGTACTTC	CASSFYRVREQYF	TRBV27	TRBJ2-7
TGTGCCAGCTCACCATTCCGGACAGGGGGTAAGACCCAGTACTTC	CASSPFRTGGKTQYF	TRBV18	TRBJ2-5
TGTGCCAGCAGCTTAACGGGGGGGGGCTATCAGTGTAGGAGCTCCTACAATGAGCAGTTCTTC	CASSLTGGGYQCRSSYNEQFF	TRBV7-4	TRBJ2-1
TGCGCCAGCAGCCAGCAGGTTGCGTCGGAGTCGACTAGTGTCCGGGTAAGCGATGAGCAGTACTTC	CASSQQVASESTSVRVSDEQYF	TRBV4-1	TRBJ2-7
TGCAGCGTTGAGGGGTACAACAGGGGGACTGGAAACACCATATATTTT	CSVEGYNRGTGNTIYF	TRBV29-1	TRBJ1-3
TGTGCCAGCAGCTTGGAGGCGACAGTCGATGGCTACACCTTC	CASSLEATVDGYTF	TRBV7-9	TRBJ1-2
TGTGCCAGCAGCCCGTGGGGATACGGCGGGTATGAGCAGTTCTTC	CASSPWGYGGYEQFF	TRBV7-9	TRBJ2-1
TGTGCCAGCAGCCCCGACGGGAGACACGAGCAGTACTTC	CASSPDGRHEQYF	TRBV28	TRBJ2-7
TGTGCCAGCAATAGGAGTGAGCAGTACTTC	CASNRSEQYF	TRBV14	TRBJ2-7
TGTGCCAGAGTTGGGGCTCAGGGGCCCCAGCATTTT	CARVGAQGPQHF	TRBV5-6	TRBJ1-5
TGTGCCAGTAGTATACGGGACAGGGAAAGGGCCTATGGCTACACCTTC	CASSIRDRERAYGYTF	TRBV19	TRBJ1-2
TGTGCCAGCAGCTTAATTACGCAGAAAAAAAATGAGCAGTTCTTC	CASSLITQKKNEQFF	TRBV7-3	TRBJ2-1
TGTGCCAGCAGCTGGTTCCCGGGACAGTCGAAACCTACTGAAGCTTTCTTT	CASSWFPGQSKPTEAFF	TRBV7-3	TRBJ1-1
TGTGCCAGCATACGGGACAACAGCAATCAGCCCCAGCATTTT	CASIRDNSNQPQHF	TRBV11-3	TRBJ1-5
TGTGCCAGCAGCTTGGCGAAGACAGTAACCGGGGAGCTGTTTTTT	CASSLAKTVTGELFF	TRBV5-8	TRBJ2-2
TGCGCCAGCACGGAGCCTTCTTATGAGCAGTTCTTC	CASTEPSYEQFF	TRBV5-1	TRBJ2-1
TGTGCCAGCAAGGTGCGACAGAGGAACACTGAAGCTTTCTTT	CASKVRQRNTEAFF	TRBV6-5	TRBJ1-1
TGTGCCAGCCGTCGGGAAGCTTTCTTT	CASRREAFF	TRBV9	TRBJ1-1
TGTGCCAGCCTTCACGCTCCAAACGATCAGCCCCAGCATTTT	CASLHAPNDQPQHF	TRBV7-3	TRBJ1-5
TGTGCCAGCAGTTTGGACAGGGTGAAAGATACGCAGTATTTT	CASSLDRVKDTQYF	TRBV27	TRBJ2-3
TGCGCCAGCAGCTTGTGTAGTAGTCGGAACAAGGGCCAGCCCCAGCATTTT	CASSLCSSRNKGQPQHF	TRBV5-1	TRBJ1-5
TGTGCCACCAGTGATAGCGGGAGGACCAAAGGGTATGAGCAGTTCTTC	CATSDSGRTKGYEQFF	TRBV24-1	TRBJ2-1
TGTGCCAGCAGCGTACTGGCTATCAAAAACATTCAGTACTTC	CASSVLAIKNIQYF	TRBV13	TRBJ2-4
TGTGCCAGCAGCCAAGAACACTGGACTAGCGGGGGGAGCTCCTACGAGCAGTACTTC	CASSQEHWTSGGSSYEQYF	TRBV14	TRBJ2-7
TGTGCCAGCAGCTTACCCCGACTAGCGGGGGGGCAAGAGACCCAGTACTTC	CASSLPRLAGGQETQYF	TRBV5-6	TRBJ2-5
TGTGCCTGGGGAAGGCCCACAGGGGGCTGTAAAACGTACATTCTCAATGAGCAGTTCTTC	CAWGRPTGGCKTYILNEQFF	TRBV30	TRBJ2-1
TGTGCCACCAGTGATTCCCCCCACCAGGTGAGTCAGGGGGACCTGGAGGGAGCCCAGTACTTC	CATSDSPHQVSQGDLEGAQYF	TRBV24-1	TRBJ2-5
TGCGCCCCGGGGGGAGCTTTCTTT	CAPGGAFF	TRBV4-3	TRBJ1-1
TGTGCCAGCAGCCAAGATCCCGGGAGTAAGAACACAGATACGCAGTATTTT	CASSQDPGSKNTDTQYF	TRBV14	TRBJ2-3
TGTGCCAGCAGCCCGCTCCCGGGACAAAGAGACGGTAGGACCGACAATGAGCAGTTCTTC	CASSPLPGQRDGRTDNEQFF	TRBV11-2	TRBJ2-1
TGTGCCAGCAGGATCCGGGACAGGCCCCACTATGGCTACACCTTC	CASRIRDRPHYGYTF	TRBV27	TRBJ1-2
TGTGCCAGCAGCCTCAGGACAGGATCATCTAATGAAAAACTGTTTTTT	CASSLRTGSSNEKLFF	TRBV7-3	TRBJ1-4
TGCAGTGCACAGGCTGGCTATGGCTACACCTTC	CSAQAGYGYTF	TRBV20-1	TRBJ1-2
TGTGCCAGCAGCAGGTCGAAGACAGGGGTTGAAGCTTTCTTT	CASSRSKTGVEAFF	TRBV9	TRBJ1-1
TGTGCCAGCCAAGGGGGCACTGAAGCTTTCTTT	CASQGGTEAFF	TRBV5-4	TRBJ1-1
TGTGCCAGCACCTACCTCGAGCAGTACTTC	CASTYLEQYF	TRBV12-3	TRBJ2-7
TGTGCCAGCAGTTACTCGAGGCCCGGGACTAGATACAATGAGCAGTTCTTC	CASSYSRPGTRYNEQFF	TRBV6-5	TRBJ2-1
TGTGCCAGCAGCTGGCGGCCCACGAAAACATACAATCAGCCCCAGCATTTT	CASSWRPTKTYNQPQHF	TRBV11-3	TRBJ1-5
TGTGCCAGCACAGCTCAATGCGGGGGGGTGCATACGCAGTATTTT	CASTAQCGGVHTQYF	TRBV6-1	TRBJ2-3
TGTGCCAGCAGCGGGGGAACCGGGAAAACACCTGGCTCTGGGGCCAACGTCCTGACTTTC	CASSGGTGKTPGSGANVLTF	TRBV5-6	TRBJ2-6
TGTGCCACCAACGGGGGATCGGGGGGGGAGTCCCGTCATGAGCAGTTCTTC	CATNGGSGGESRHEQFF	TRBV24-1	TRBJ2-1
TGTGCCAGCAGTTTTCCCAGCCGGGACAGGGAAGCGGCCTGTGCTTTCTTT	CASSFPSRDREAACAFF	TRBV12-3	TRBJ1-1
TGCGCCAGCAGCTTGGGTAAGGGGACAGTAATCACAGATACGCAGTATTTT	CASSLGKGTVITDTQYF	TRBV5-1	TRBJ2-3
TGTGCCAATCAGCCGGGACGGACCAGGTACTATGGCTACACCTTC	CANQPGRTRYYGYTF	TRBV25-1	TRBJ1-2
TGTGCCACCTCTAGCGGGATTTTCAACGAGCAGTACTTC	CATSSGIFNEQYF	TRBV7-6	TRBJ2-7
TGTGCCAGCAGTTTATTGGCCCATCACGTGGGGGGCAATCAGCCCCAGCATTTT	CASSLLAHHVGGNQPQHF	TRBV28	TRBJ1-5
TGCAGTGCATCCGCGGGAGGGCAGTTCTTC	CSASAGGQFF	TRBV20-1	TRBJ2-1
TGTGCCAGCAGCCAGTACCAGGCTTACTCTGGAAACACCATATATTTT	CASSQYQAYSGNTIYF	TRBV3-1	TRBJ1-3
TGTGCCAGCAGGCGCACCGGGGGGGAAGCTTTCTTT	CASRRTGGEAFF	TRBV6-5	TRBJ1-1
TGTGCCAGCAGTGAAACTAGCTACAATGAGCAGTTCTTC	CASSETSYNEQFF	TRBV27	TRBJ2-1
TGTGCCAGCAGTTACGAAGTTACAGGGTCAAGGTGGGCTTTCTTT	CASSYEVTGSRWAFF	TRBV6-3	TRBJ1-1
TGTGCCAGCAGCGGGCGGGGGGCCGAGCAGTACTTC	CASSGRGAEQYF	TRBV7-4	TRBJ2-7
TGTGCCAGCAGTGGGAAGGCTAGCAATCAGCCCCAGCATTTT	CASSGKASNQPQHF	TRBV6-4	TRBJ1-5
TGTGCCAGCAATTTAACAGGTAGGGCTAACTATGGCTACACCTTC	CASNLTGRANYGYTF	TRBV6-5	TRBJ1-2
TGTGCCAGTAGTTGCGTTAAAGCGAACACCGGGGAGCTGTTTTTT	CASSCVKANTGELFF	TRBV19	TRBJ2-2
TGTGCCACCAGTGATTTACAGCGGGAGCTAGCCAAAAACATTCAGTACTTC	CATSDLQRELAKNIQYF	TRBV24-1	TRBJ2-4
TGTGCCAGCAGCTTACTCCAAACGGGTTCCGTTTTTGACACAGATACGCAGTATTTT	CASSLLQTGSVFDTDTQYF	TRBV11-2	TRBJ2-3
TGTGCCAGCAGCGGTAAGTTGGACTCATCCTACGAGCAGTACTTC	CASSGKLDSSYEQYF	TRBV6-4	TRBJ2-7
TGTGCTAGTGGTTTGAAGGACAGGTTAAGGTACTCCTACGAGCAGTACTTC	CASGLKDRLRYSYEQYF	TRBV12-5	TRBJ2-7
TGCAGCGTAATCAAGACAGGGATACACTGCCAAGAGACCCAGTACTTC	CSVIKTGIHCQETQYF	TRBV29-1	TRBJ2-5
TGTGCCTGGAGTCGGTTCCAGAGGATCACAGATACGCAGTATTTT	CAWSRFQRITDTQYF	TRBV30	TRBJ2-3
TGTGCCATCAGTGAGTCTCGGGTCAGGAGCTCCTACGAGCAGTACTTC	CAISESRVRSSYEQYF	TRBV10-3	TRBJ2-7
TGTGCCAGCAGTTACTCGCAAGATGGGAAACAGGGCCCCGAGCAGTACTTC	CASSYSQDGKQGPEQYF	TRBV6-2	TRBJ2-7
TGTGCCAGCAGCGGGTCGCCAGGGAATTCACCCCTCCACTTT	CASSGSPGNSPLHF	TRBV7-6	TRBJ1-6
TGTGCCAGCAGCCCCCCTGAGGACAGGGGAGGCTCTGGAAACACCATATATTTT	CASSPPEDRGGSGNTIYF	TRBV6-6	TRBJ1-3
TGTGCCAGCATCAGACAGCAGGGCTACACCTTC	CASIRQQGYTF	TRBV5-5	TRBJ1-2
TGTGCCAGCAGCTTAAGCCAACAGGGCATGAGCAATCAGCCCCAGCATTTT	CASSLSQQGMSNQPQHF	TRBV7-3	TRBJ1-5
TGTGCCAGCAGCCGAGGGTATCCAGAGTTCACAGATACGCAGTATTTT	CASSRGYPEFTDTQYF	TRBV9	TRBJ2-3
TGCGCCAGCAGCCCCGATAAGGGCGGGGAGCTGTTTTTT	CASSPDKGGELFF	TRBV5-1	TRBJ2-2
TGTGCCAGCAGTTTTCTTCCTTACGAGCAGTACTTC	CASSFLPYEQYF	TRBV28	TRBJ2-7
TGTGCCACATTGGGACAGGGCTACGAGCAGTACTTC	CATLGQGYEQYF	TRBV2	TRBJ2-7
TGTGCCAGCAGTTTCCTGAGGCCGGGGGAGCTGTATGGCTACACCTTC	CASSFLRPGELYGYTF	TRBV12-3	TRBJ1-2
TGTGCCAGCAGTGACCCGGGACTCACTGAAGCTTTCTTT	CASSDPGLTEAFF	TRBV6-5	TRBJ1-1
TGTGCCAGCAGCTTGAGGACGACCTCCAATCAGCACTACGAGCAGTACTTC	CASSLRTTSNQHYEQYF	TRBV5-4	TRBJ2-7
TGTGCCAGCAGTTTCCCTAAGGGGGGCCCTCCCGGAGAGACCCAGTACTTC	CASSFPKGGPPGETQYF	TRBV27	TRBJ2-5
TGTGCCAGCGGGGCCCCAAACACCGGGGAGCTGTTTTTT	CASGAPNTGELFF	TRBV12-3	TRBJ2-2
TGTGCCAGCAGCCAAAGACCCCGGGGGGGCTCCTACGAGCAGTACTTC	CASSQRPRGGSYEQYF	TRBV7-3	TRBJ2-7
TGTGCCAGCAGGAGGACTAGCGGGGGGGCCACAGATACGCAGTATTTT	CASRRTSGGATDTQYF	TRBV6-4	TRBJ2-3
TGCGCCAGCAGCGTGGGGAGGGGGGACTACAATGAGCAGTTCTTC	CASSVGRGDYNEQFF	TRBV5-1	TRBJ2-1
TGCAGTGCTAGAGTGGGACTGTCGATCGAGGATGAGCAGTTCTTC	CSARVGLSIEDEQFF	TRBV20-1	TRBJ2-1
TGTGCCAGCAGCACAGGGCCTATAATCCCGAGCAATCAGCCCCAGCATTTT	CASSTGPIIPSNQPQHF	TRBV13	TRBJ1-5
TGTGCCAGCAGCTTAGTGTCCCGGACTCCCGGATATCAGAACACCGGGGAGCTGTTTTTT	CASSLVSRTPGYQNTGELFF	TRBV7-2	TRBJ2-2
TGTGCCAGCAGCACCCCAGGCTGTCAGGGGGCGTGGCCACACCGGTCCTACGAGCAGTACTTC	CASSTPGCQGAWPHRSYEQYF	TRBV7-3	TRBJ2-7
TGTGCCAGCAGTTTCTCGTGGACCGACTCCTACGAGCAGTACTTC	CASSFSWTDSYEQYF	TRBV27	TRBJ2-7
TGTGCCAGCAGCTTCTGGCCCTACGAGCAGTACTTC	CASSFWPYEQYF	TRBV11-3	TRBJ2-7
TGTGCCATCAGTAACACCCTCGGCGGGAGCTCCTACAATGAGCAGTTCTTC	CAISNTLGGSSYNEQFF	TRBV10-3	TRBJ2-1
TGTGCCAGCAGTGGCGGGTTCTTCGAAAAACTGTTTTTT	CASSGGFFEKLFF	TRBV25-1	TRBJ1-4
TGTGCCAGCAGTTCCGAGGCCGACAGGCAGCCCCAGCATTTT	CASSSEADRQPQHF	TRBV6-1	TRBJ1-5
TGTGCCAGCAGCAGGGGGGGGGGCTCCTACAATGAGCAGTTCTTC	CASSRGGGSYNEQFF	TRBV7-9	TRBJ2-1
TGTGCTGACAGGTTGTCCTACAATGAGCAGTTCTTC	CADRLSYNEQFF	TRBV12-5	TRBJ2-1
TGTGCCACCGTAGACAGGAGCAATCAGCCCCAGCATTTT	CATVDRSNQPQHF	TRBV24-1	TRBJ1-5
TGTGCCAGCAGACTAGCGAAAGGGAGGCAAGAGACCCAGTACTTC	CASRLAKGRQETQYF	TRBV12-3	TRBJ2-5
TGTGCCATCAGTGTTGGGTTCAGGGTTGAGTCCTACGAGCAGTACTTC	CAISVGFRVESYEQYF	TRBV10-3	TRBJ2-7
TGCAGTGCGCCCAGAACTCAAGAGACCCAGTACTTC	CSAPRTQETQYF	TRBV20-1	TRBJ2-5
TGTGCCATCAGTGAGTCACTAGCGGGAGGTTGCTACGAGCAGTACTTC	CAISESLAGGCYEQYF	TRBV10-3	TRBJ2-7
TGTGCCATCAGCCACAGGGACCAAGGGTCAACTAATGAAAAACTGTTTTTT	CAISHRDQGSTNEKLFF	TRBV10-3	TRBJ1-4
TGTGCCAGCAGTTACCAGTTACCACTAGCGGGGGGTAGGAATGAGCAGTTCTTC	CASSYQLPLAGGRNEQFF	TRBV6-6	TRBJ2-1
TGTGCCAGCAGTTTACTAGTTCCCAATGAGCAGTTCTTC	CASSLLVPNEQFF	TRBV12-4	TRBJ2-1
TGTGCCAGCAGTTGCGACATCAGATTTGTTGGAGATACGCAGTATTTT	CASSCDIRFVGDTQYF	TRBV27	TRBJ2-3
TGTGCTAGTGCAGGATCCCAAAGAACTAGGATTAGCTACGAGCAGTACTTC	CASAGSQRTRISYEQYF	TRBV12-5	TRBJ2-7
TGTGCCAGACCCGGAAGTCCCTACGAGCAGTACTTC	CARPGSPYEQYF	TRBV27	TRBJ2-7
TGTGCCAGCAGTTTCCCCAGGACAGGGACCGGCAACTTC	CASSFPRTGTGNF	TRBV27	TRBJ2-7
TGTGCCAGCAGTGATCCCTCCGGGACTAGCCTGAGTCGGTCCTACGAGCAGTACTTC	CASSDPSGTSLSRSYEQYF	TRBV2	TRBJ2-7
TGTGCCAGCGGGGGATGTGAAGAGACCCAGTACTTC	CASGGCEETQYF	TRBV9	TRBJ2-5
TGTGCCAGCAGCGTCACAGGGGGCGGAGGCCCTCGCACCGGGGAGCTGTTTTTT	CASSVTGGGGPRTGELFF	TRBV13	TRBJ2-2
TGTGCCAGCAGCCAAGATGGAGGGGGGGAGTCCTACGAGCAGTACTTC	CASSQDGGGESYEQYF	TRBV3-1	TRBJ2-7
TGTGCCACCAGCCAACTAGCGGATCATCGACAAGAGACCCAGTACTTC	CATSQLADHRQETQYF	TRBV24-1	TRBJ2-5
TGTGCCAGCAGCAATACGGAGACCCAGTACTTC	CASSNTETQYF	TRBV7-9	TRBJ2-5
TGTGCCATCAGAAGTAGTTCGACAGGGGCTGGAAACACCATATATTTT	CAIRSSSTGAGNTIYF	TRBV10-3	TRBJ1-3
TGTGCCAGCAGTGATGGGGGGCGAGATGAGCAGTTCTTC	CASSDGGRDEQFF	TRBV12-4	TRBJ2-1
TGCGCCAGCAGCTCCGACAGGCGTTTAGGTAGGCACACTGAAGCTTTCTTT	CASSSDRRLGRHTEAFF	TRBV5-1	TRBJ1-1
TGCGCCAGCAGCTTGGCCCCGGCCCTCACCGGGGAGCTGTTTTTT	CASSLAPALTGELFF	TRBV5-1	TRBJ2-2
TGTGCCAGCAGTGAAGCCTCGAACAGAAGGTTCTCCTACAATGAGCAGTTCTTC	CASSEASNRRFSYNEQFF	TRBV2	TRBJ2-1
TGTGCCAGCAGGGACAGGAGCGCGGACTATGGCTACACCTTC	CASRDRSADYGYTF	TRBV27	TRBJ1-2
TGCAGTGCTGCCCAGGTACATGGAGAAAATGCAGACGAGCAGTTCTTC	CSAAQVHGENADEQFF	TRBV20-1	TRBJ2-1
TGCGCCAGCAGCTTGACGTGCCCGACAGGCAATCAGCCCCAGCATTTT	CASSLTCPTGNQPQHF	TRBV5-1	TRBJ1-5
TGTGCCAGCAGTTACCTAGGCCGGGACAGGGGGAATGAAAAACTGTTTTTT	CASSYLGRDRGNEKLFF	TRBV6-5	TRBJ1-4
TGTGCCAGCAGCCCCAGCTTTAATAGCAATCAGCCCCAGCATTTT	CASSPSFNSNQPQHF	TRBV13	TRBJ1-5
TGTGCCAGCAGCTTGAAATCCGGGACGCTGCGCTATAATTCACCCCTCCACTTT	CASSLKSGTLRYNSPLHF	TRBV7-6	TRBJ1-6
TGTGCCAGCTGGACAGGGAAGGCCAATCAGCCCCAGCATTTT	CASWTGKANQPQHF	TRBV6-1	TRBJ1-5
TGTGCCAGCAGTTACTCGGTGACAGGGGTTTGGTATGGCTACACCTTC	CASSYSVTGVWYGYTF	TRBV6-3	TRBJ1-2
TGCGCCAGCAGCCACGGACTAGGTAGGGAGCAGTACTTC	CASSHGLGREQYF	TRBV5-1	TRBJ2-7
TGCGCCAGCAGCTCGTGGTCACTAGCGGGCCAAGAGACCCAGTACTTC	CASSSWSLAGQETQYF	TRBV5-1	TRBJ2-5
TGCGCCAGCAGCCAAGATAGGACATTTCAGAACACCGGGGAGCTGTTTTTT	CASSQDRTFQNTGELFF	TRBV4-1	TRBJ2-2
TGTGCCAGCAATGTAAGTGGCGAAGTGGAAAATGAAAAACTGTTTTTT	CASNVSGEVENEKLFF	TRBV7-4	TRBJ1-4
TGCGCCAGCAGCAGCCCAGACGAGCAGTACTTC	CASSSPDEQYF	TRBV5-1	TRBJ2-7
TGTGCCAGCAGCCGCCCACCCGGACAGGAGACCCAGTACTTC	CASSRPPGQETQYF	TRBV6-6	TRBJ2-5
TGTGCCAGCAGCGATGGAGGCCGGGAACCCTCTGGGGCCAACGTCCTGACTTTC	CASSDGGREPSGANVLTF	TRBV7-3	TRBJ2-6
TGTGCCAGCAGCCTTCCCCCCGGGACGGGTGGTCACTATGGCTACACCTTC	CASSLPPGTGGHYGYTF	TRBV9	TRBJ1-2
TGTGCCAGCAGCTTAGAAACACTCTGCAATCAGCCCCAGCATTTT	CASSLETLCNQPQHF	TRBV7-9	TRBJ1-5
TGCAGTGCTTGTTTCTACGGACCTGGCTCCTACGAGCAGTACTTC	CSACFYGPGSYEQYF	TRBV20-1	TRBJ2-7
TGCAGTGCTCTCGGGGGACAGGGGGCCCCGCAAGAGACCCAGTACTTC	CSALGGQGAPQETQYF	TRBV20-1	TRBJ2-5
TGTGCCAGCACCCCCAGGGGGCGAGGGGACGAGCAGTACTTC	CASTPRGRGDEQYF	TRBV28	TRBJ2-7
TGTGCCAGCTTTGCCTTAGGGTATACGCAGTATTTT	CASFALGYTQYF	TRBV6-4	TRBJ2-3
TGTGCCAGCCCCGGAAGATCACCACCGGACACAGATACGCAGTATTTT	CASPGRSPPDTDTQYF	TRBV19	TRBJ2-3
TGTGCCAGCAGCCAAGATCGATTAGCGGTTATATCCTACGAGCAGTACTTC	CASSQDRLAVISYEQYF	TRBV14	TRBJ2-7
TGTGCCAGCAGTGACGGGGCCAGCACCGGGGCCAACGTCCTGACTTTC	CASSDGASTGANVLTF	TRBV6-1	TRBJ2-6
TGTGCCAGCACATCCGGGGCGAACTCCTATAATTCACCCCTCCACTTT	CASTSGANSYNSPLHF	TRBV7-2	TRBJ1-6
TGTGCCAGCAGTGCCCTGAGACAGGGCGGATTAGTGTACCAAGAGACCCAGTACTTC	CASSALRQGGLVYQETQYF	TRBV6-1	TRBJ2-5
TGTGCCAGCAGCGGACTAGCGGGGGGGGAGCAGTTCTTC	CASSGLAGGEQFF	TRBV14	TRBJ2-1
TGTGCCAGCAGTGTTCGGGGGATAGTCTCTGGAAACACCATATATTTT	CASSVRGIVSGNTIYF	TRBV27	TRBJ1-3
TGTGCCAGCTCACCGTGGACAGGGGAGCAGTACTTC	CASSPWTGEQYF	TRBV18	TRBJ2-7
TGTGCCAGCAGCTTACCACGAGTGGGACAGGGGACGAACGAGCAGTACTTC	CASSLPRVGQGTNEQYF	TRBV7-9	TRBJ2-7
TGTGCCAGCAGCGTAGAACAGACATTTGAGTGCTATAATTCACCCCTCCACTTT	CASSVEQTFECYNSPLHF	TRBV9	TRBJ1-6
TGTGCCACCAGCAGAGATAAGCACCCGCAGTATTTT	CATSRDKHPQYF	TRBV15	TRBJ2-3
TGTGCCAGCAGCTTTAGCGGGAGAGAAGAGACCCAGTACTTC	CASSFSGREETQYF	TRBV7-3	TRBJ2-5
TGTGCCAGCAGTCTTACGCAAGAGACCCAGTACTTC	CASSLTQETQYF	TRBV6-4	TRBJ2-5
TGTGCCAGCAGTTGTTCCCAGGGCGGTACAAACTATGGCTACACCTTC	CASSCSQGGTNYGYTF	TRBV28	TRBJ1-2
TGTGCCAGCAGCCAAGGGCTTATACAGGGTGTCTACGAGCAGTACTTC	CASSQGLIQGVYEQYF	TRBV7-3	TRBJ2-7
TGCGCCAGCAACCACCCGGGACGGATAAAAGAGACCCAGTACTTC	CASNHPGRIKETQYF	TRBV5-1	TRBJ2-5
TGCGCCAGCAGCTTGGTGCCGGGGCCGAATGAAAAACTGTTTTTT	CASSLVPGPNEKLFF	TRBV5-1	TRBJ1-4
TGTGCCAGCAGTGGCGATTCAGGACATGAAGCTTTCTTT	CASSGDSGHEAFF	TRBV25-1	TRBJ1-1
TGCGCCAGCAGGGGAGTCAGGAAACCGGGGTGGACTGAAGCTTTCTTT	CASRGVRKPGWTEAFF	TRBV5-1	TRBJ1-1
TGTGCCAGCAGTGACTCGAGAACTGGGGGCTCCTACGAGCAGTACTTC	CASSDSRTGGSYEQYF	TRBV6-4	TRBJ2-7
TGCGCCAGCAGGCCTGGGGGGGGGGGTGGCCAGTACTTC	CASRPGGGGGQYF	TRBV10-1	TRBJ2-5
TGTGCCAGCTCTCCACAGGGGAACACTGAAGCTTTCTTT	CASSPQGNTEAFF	TRBV18	TRBJ1-1
TGTGCCAGCAGTGGTCATAGCCGGAGGGGACCGACTAATTCACCCCTCCACTTT	CASSGHSRRGPTNSPLHF	TRBV6-1	TRBJ1-6
TGCGCCAGCAGCCAAGATAATTCTCCCAGATCCCCGGACTTAGGAAACACCATATATTTT	CASSQDNSPRSPDLGNTIYF	TRBV4-3	TRBJ1-3
TGTGCCAGCAGTTTGGGACAGGGGGCTTCCCCCTATGGCTACACCTTC	CASSLGQGASPYGYTF	TRBV6-3	TRBJ1-2
TGTGCCAGCTCACCACTCGTTGTTGTTGGGCTGGGCACCCATGAAGCTTTCTTT	CASSPLVVVGLGTHEAFF	TRBV18	TRBJ1-1
TGTGCCAGCAGTAGGATGACACGGCCAGAGACCCAGTACTTC	CASSRMTRPETQYF	TRBV6-2	TRBJ2-5
TGTGCCACCGTAGGCAGACTAGCGGGAGATAGCACAGATACGCAGTATTTT	CATVGRLAGDSTDTQYF	TRBV24-1	TRBJ2-3
TGTGCCAGCAGTTACTCGGATCCCAAAGAACGGGGGGGCCTGGGTTACAATGAGCAGTTCTTC	CASSYSDPKERGGLGYNEQFF	TRBV6-3	TRBJ2-1
TGTGCCAGCAGTTTCGGGACTAGCGGGGATGGGGACGGGGAGCTGTTTTTT	CASSFGTSGDGDGELFF	TRBV6-3	TRBJ2-2
TGTGCTAGTGGGGGGCTTGACGAGGAAAAACTGTTTTTT	CASGGLDEEKLFF	TRBV12-5	TRBJ1-4
TGTGCCAGCAGTTCAGGAAGCTATAATTCACCCCTCCACTTT	CASSSGSYNSPLHF	TRBV27	TRBJ1-6
TGCGCCAGCAGCCAAGGTGGACTGGGCTACGAGCAGTACTTC	CASSQGGLGYEQYF	TRBV4-1	TRBJ2-7
TGTGCCAGCAGTTTAATAGAAGACAATCGGACTCCCCAGCCCCAGCATTTT	CASSLIEDNRTPQPQHF	TRBV28	TRBJ1-5
TGCGCCAGCAGCCAAGGTGGGACAGGGGCCGCCTCTGGCTACACCTTC	CASSQGGTGAASGYTF	TRBV4-1	TRBJ1-2
TGTGCCAGCAGCCAAGACAACCCAGGGTGTCCCCCGTCTAGCACAGATACGCAGTATTTT	CASSQDNPGCPPSSTDTQYF	TRBV3-1	TRBJ2-3
TGTGCCTTGACTAGCATTACTGAATGTCAAGAGACCCAGTACTTC	CALTSITECQETQYF	TRBV9	TRBJ2-5
TGCGCCAGCAGCCAAGATATCTTCTTTCGGAGGCTTGGGGAAGACGCTGGGGTGGACTATGGCTACACCTTC	CASSQDIFFRRLGEDAGVDYGYTF	TRBV4-3	TRBJ1-2
TGTGCCAGCAGTTTGGGTAGACAGGGAACAAATTCACCCCTCCACTTT	CASSLGRQGTNSPLHF	TRBV12-3	TRBJ1-6
TGTGCCAGCAGCACTGGGGCCGACCACGAGCAGTACTTC	CASSTGADHEQYF	TRBV7-3	TRBJ2-7
TGTGCCAGCAGCCCGAGTCGTAGGGGGGAGAGGAACACTGAAGCTTTCTTT	CASSPSRRGERNTEAFF	TRBV28	TRBJ1-1
TGTGCCAGCAGCGGGCGGGGGGGGTCCTCCACCGGGGAGCTGTTTTTT	CASSGRGGSSTGELFF	TRBV7-3	TRBJ2-2
TGTGCCAGCAGCCATTCCGGTCGGGGCTCCTACGAGCAGTACTTC	CASSHSGRGSYEQYF	TRBV3-1	TRBJ2-7
TGTGCCCCCCGGGAGGGCCCTGCCTACGAGCAGTACTTC	CAPREGPAYEQYF	TRBV30	TRBJ2-7
TGTGCCAGCACATGTCCCGGGACAGGGGGAGAGACCTCTGGAAACACCATATATTTT	CASTCPGTGGETSGNTIYF	TRBV6-6	TRBJ1-3
TGTGCCAGCGACGATGACAGAGGTGGGAATGAAAAACTGTTTTTT	CASDDDRGGNEKLFF	TRBV7-3	TRBJ1-4
TGTGCCAGCAGCCTCCGGGACAGGGGATCCTATGGCTACACCTTC	CASSLRDRGSYGYTF	TRBV7-3	TRBJ1-2
TGTGCCAGTCCGGGAGATTTATTGGGGAGACGCTATGGCTACACCTTC	CASPGDLLGRRYGYTF	TRBV19	TRBJ1-2
TGTGCCAGTAGTATAGCGCCGACAGGCTACGAGCAGTACTTC	CASSIAPTGYEQYF	TRBV19	TRBJ2-7
TGCGCCAGCAGACTGTGGGGGGCCGAAGCGCATTCCTACGAGCAGTACTTC	CASRLWGAEAHSYEQYF	TRBV10-2	TRBJ2-7
TGTGCCAGCAGCTGTTGGGGAGGTCCCAAGTATGGCTACACCTTC	CASSCWGGPKYGYTF	TRBV13	TRBJ1-2
TGCGCCAGCAGCCAACTGCCGACAGGGTGGGGTAGCGATGACTATGGCTACACCTTC	CASSQLPTGWGSDDYGYTF	TRBV4-3	TRBJ1-2
TGTGCCAATACTAGCCAAGAGACCCAGTACTTC	CANTSQETQYF	TRBV27	TRBJ2-5
TGTGCCAGCAGCTTAATCAGGGGGGGGTCCTACGAGCAGTACTTC	CASSLIRGGSYEQYF	TRBV7-3	TRBJ2-7
TGTGCCAGCAGTTGGAGGGATGAGCAGTACTTC	CASSWRDEQYF	TRBV12-3	TRBJ2-7
TGTGCCAGCAGCCAAGAATTTGACAGGGGTCCAGATACGCAGTATTTT	CASSQEFDRGPDTQYF	TRBV14	TRBJ2-3
TGTGCCAGCAGTTCGACTAGCGGGTCCAGCTCCTACAATGAGCAGTTCTTC	CASSSTSGSSSYNEQFF	TRBV6-4	TRBJ2-1
TGTGCCAGCAGCAATCACCGACAATTCTATGGCTACACCTTC	CASSNHRQFYGYTF	TRBV7-9	TRBJ1-2
TGCGCCAGCAGCTTGGTCAACAAGGGGGCGGTAGAAGCTTTCTTT	CASSLVNKGAVEAFF	TRBV5-1	TRBJ1-1
TGTGCCAGCATCCGACTTTTGCTACTAGAGACCCAGTACTTC	CASIRLLLLETQYF	TRBV2	TRBJ2-5
TGTGCCTGGAGTATGGGGGGGCCTAACGAGCAGTACTTC	CAWSMGGPNEQYF	TRBV30	TRBJ2-7
TGTGCCAGCAGCCTTTTCCGGGACAGTAAAGGCGACGAGCAGTACTTC	CASSLFRDSKGDEQYF	TRBV7-3	TRBJ2-7
TGTGCTAGTGGTTCTTCGGGGTGCATCAATGAGCAGTTCTTC	CASGSSGCINEQFF	TRBV12-5	TRBJ2-1
TGTGCCAGTAGTAGGAAAACGACCGGAGGCCGGAATGAAAAACTGTTTTTT	CASSRKTTGGRNEKLFF	TRBV19	TRBJ1-4
TGTGCCAGCATGGCCGCCTACGAGCAGTACTTC	CASMAAYEQYF	TRBV9	TRBJ2-7
TGTGCCAGCAGTTCCAGTAGCGGGGGGACCCAGTACTTC	CASSSSSGGTQYF	TRBV6-5	TRBJ2-5
TGTGCCTGGAGTGTGACGGGCTACGAGCAGTACTTC	CAWSVTGYEQYF	TRBV30	TRBJ2-7
TGCGCCAGCAGCCATGCCGGCTTGGGAGATCAGCCCCAGCATTTT	CASSHAGLGDQPQHF	TRBV4-1	TRBJ1-5
TGTGCCAGCAGCCAAGATAGTTATGAGCAGTTCTTC	CASSQDSYEQFF	TRBV14	TRBJ2-1
TGTGCCAGCAGCACGATTAACAGGGTCTTAACGCGAGCCAAAAACATTCAGTACTTC	CASSTINRVLTRAKNIQYF	TRBV13	TRBJ2-4
TGTGCCAGCAGCCAAGATCGCCCTCGTTCGACAGGGCCCTTCCCTTCACCCCTCCACTTT	CASSQDRPRSTGPFPSPLHF	TRBV3-1	TRBJ1-6
TGTGCCAGCAGTTTCCCTCGCGGAAACTCCTACGAGCAGTACTTC	CASSFPRGNSYEQYF	TRBV28	TRBJ2-7
TGTGCCACCAGCAGAGATGTGACGAGGGTTCATGAGCAGTTCTTC	CATSRDVTRVHEQFF	TRBV15	TRBJ2-1
TGCAGTGCTAGTTCCACAGGGCCGTGCACAGATACGCAGTATTTT	CSASSTGPCTDTQYF	TRBV20-1	TRBJ2-3
TGTGCCAGCAGCTTAGAGCAGGGGGGGAACACCGGGGAGCTGTTTTTT	CASSLEQGGNTGELFF	TRBV7-9	TRBJ2-2
TGTGCCACCAGGACTGCAACTAATGAAAAACTGTTTTTT	CATRTATNEKLFF	TRBV24-1	TRBJ1-4
TGTGCCAGCAGGCGGACACCCGTGAGCTCCTATAATTCACCCCTCCACTTT	CASRRTPVSSYNSPLHF	TRBV6-6	TRBJ1-6
TGTGCCAGCAGGCCTCAGAGGAGCCGGGCCTATTCACCCCTCCACTTT	CASRPQRSRAYSPLHF	TRBV6-2	TRBJ1-6
TGCGCCAGCAGCCAAGATCCTAGGGGGGGCCAAGGGTACAATGAGCAGTTCTTC	CASSQDPRGGQGYNEQFF	TRBV4-1	TRBJ2-1
TGCAGTCTCAGGGGGCGCCTACACACTGAAGCTTTCTTT	CSLRGRLHTEAFF	TRBV20-1	TRBJ1-1
TGTGCCAGCAGCTTCACATACAACATTCAGTACTTC	CASSFTYNIQYF	TRBV11-2	TRBJ2-4
TGTGCCAGCACGAACCGAGGGGCCCTCATGCCCCAGCATTTT	CASTNRGALMPQHF	TRBV2	TRBJ1-5
TGTGCCAGCAGCCTGGCAAGTAACAGGTTTATTGAAACTCAGCCCCAGCATTTT	CASSLASNRFIETQPQHF	TRBV13	TRBJ1-5
TGCGCCAGCACCAACGGGGGATCCGGGGAGCTGTTTTTT	CASTNGGSGELFF	TRBV10-1	TRBJ2-2
TGTGCCAAAGGGGGGTGGAAAGGTGGAAACATTCAGTACTTC	CAKGGWKGGNIQYF	TRBV13	TRBJ2-4
TGTGCCAGCAGCCAAGGAAACCGGGACAACATGAATCAGCCCCAGCATTTT	CASSQGNRDNMNQPQHF	TRBV4-2	TRBJ1-5
TGCGCCAGCAGCCAAGGGGGCGTGTCCTACGAGCAGTACTTC	CASSQGGVSYEQYF	TRBV4-3	TRBJ2-7
TGTGCCACCAGCAGTCCCGGGGGCAGATACACTGAAGCTTTCTTT	CATSSPGGRYTEAFF	TRBV15	TRBJ1-1
TGTGCCAGCAGCGAGCCAAGGACAGGGAAGGAAGATACGCAGTATTTT	CASSEPRTGKEDTQYF	TRBV11-2	TRBJ2-3
TGTGCCAGCAGTTACTCAAACAAGGGACCCTCCTACAATGAGCAGTTCTTC	CASSYSNKGPSYNEQFF	TRBV6-3	TRBJ2-1
TGTGCCAGCAGCAACCCACTGGGGGGCCTTGAGACCCAGTACTTC	CASSNPLGGLETQYF	TRBV5-6	TRBJ2-5
TGTGCCAGCAGCTTAAGGGGTCTTGCCTACGAGCAGTACTTC	CASSLRGLAYEQYF	TRBV7-2	TRBJ2-7
TGTGCCAGCAAAAGCGCAGGGGACCGAAACACCATATATTTT	CASKSAGDRNTIYF	TRBV6-4	TRBJ1-3
TGTGCCACCAGTGAGGGGAGGGCCAAGGACCTAGACACCGGGGAGCTGTTTTTT	CATSEGRAKDLDTGELFF	TRBV24-1	TRBJ2-2
TGTGCCAGCCCCGGAGACAGGGGGCGAGGGAAAACTGAAGCTTTCTTT	CASPGDRGRGKTEAFF	TRBV7-2	TRBJ1-1
TGCAGTGCTAGAGTTGACAGGCAGGACTCGAACACCGGGGAGCTGTTTTTT	CSARVDRQDSNTGELFF	TRBV20-1	TRBJ2-2
TGTGCCAGCAGCAACACGGGCAATACGAATGAGCAGTTCTTC	CASSNTGNTNEQFF	TRBV13	TRBJ2-1
TGTGCCGGTCCGACAGGAAAGCGGGATTACGAGCAGTACTTC	CAGPTGKRDYEQYF	TRBV6-4	TRBJ2-7
TGCAGCGTTGATCTCTGGGACAGGGGGAATCAGCCCCAGCATTTT	CSVDLWDRGNQPQHF	TRBV29-1	TRBJ1-5
TGTGCCAGTACCGGACAGCAGACCCAGTACTTC	CASTGQQTQYF	TRBV19	TRBJ2-5
TGTGCCAGCAGCCCCTCAAGCAATCAGCCCCAGCATTTT	CASSPSSNQPQHF	TRBV9	TRBJ1-5
TGTGCCAGCAGCGGGCTAGCGGGGAAGGAGACCCAGTACTTC	CASSGLAGKETQYF	TRBV2	TRBJ2-5
TGTGCCAGCAGCTATCTCCCAGGGGCCTACGAGCAGTACTTC	CASSYLPGAYEQYF	TRBV2	TRBJ2-7
TGTGCCAGCAGCCACTGGGACAGGGGACTCTACGAGCAGTACTTC	CASSHWDRGLYEQYF	TRBV3-1	TRBJ2-7
TGCAGTGCTACCCCTGACAGGCCCTTTTCCAATGGCTACACCTTC	CSATPDRPFSNGYTF	TRBV20-1	TRBJ1-2
TGTGCCTGGAGTGTAAAGCCCGACAGGTTGCAAGAGACCCAGTACTTC	CAWSVKPDRLQETQYF	TRBV30	TRBJ2-5
TGCGCCAGCAGCCAACTGACGGACAGGAGTTGTAACTATGGCTACACCTTC	CASSQLTDRSCNYGYTF	TRBV4-1	TRBJ1-2
TGTCACCGGTACTACGAGCAGTACTTC	CHRYYEQYF	TRBV19	TRBJ2-7
TGTGCCAGCAGTCGAGTAGGGCTAAATGAAAAACTGTTTTTT	CASSRVGLNEKLFF	TRBV28	TRBJ1-4
TGTGCCAGCAGCTTGAGAAGGGATAGGGTGAAGAACACTGAAGCTTTCTTT	CASSLRRDRVKNTEAFF	TRBV5-8	TRBJ1-1
TGTGCCAGTAGTCCAAGGGGGGGCCGGTGGGGCAACTATGGCTACACCTTC	CASSPRGGRWGNYGYTF	TRBV19	TRBJ1-2
TGTGCCAGCAGATGTACCGGGACAGGGGGGTCAGGTAACTATGGCTACACCTTC	CASRCTGTGGSGNYGYTF	TRBV28	TRBJ1-2
TGCGCCAGCAGCTTGAGGACAGAGGGGTCCTATAATTCACCCCTCCACTTT	CASSLRTEGSYNSPLHF	TRBV5-1	TRBJ1-6
TGTGCCAGGGGTGGGTACGGGGACCTTAAGGACACTGAAGCTTTCTTT	CARGGYGDLKDTEAFF	TRBV19	TRBJ1-1
TGTGCCAGTAGTATAGAGACAGGTTACTACGAGCAGTACTTC	CASSIETGYYEQYF	TRBV19	TRBJ2-7
TGTGCCAGCAGTCGGGGGTTTGGGAGGGGCCGAGAAGGTGAGCAGTTCTTC	CASSRGFGRGREGEQFF	TRBV6-3	TRBJ2-1
TGTGCCAGCAGTGAACGTTCCAGGGGGTGGAGCAATCAGCCCCAGCATTTT	CASSERSRGWSNQPQHF	TRBV6-1	TRBJ1-5
TGTGCCAGCAGTTTGGCCCCCAGCGGGCAAGCCGGGGAGCTGTTTTTT	CASSLAPSGQAGELFF	TRBV28	TRBJ2-2
TGTGCCAGCAGCCGATCCGGACAGAGGCATGGCTACACCTTC	CASSRSGQRHGYTF	TRBV3-1	TRBJ1-2
TGTGCCAGTAGACGGAGACAGGGAAGTTACCGAAACACCATATATTTT	CASRRRQGSYRNTIYF	TRBV19	TRBJ1-3
TGTGCCAGCAGTTATCCTTTCTTCCGAATTAACCATAGCAATCAGCCCCAGCATTTT	CASSYPFFRINHSNQPQHF	TRBV6-9	TRBJ1-5
TGTGCCAGTGCGAGCAAAAACATTCAGTACTTC	CASASKNIQYF	TRBV19	TRBJ2-4
TGTGCCAGCAGCTTTTGTGCCAGGGGGAACACCGGGGAGCTGTTTTTT	CASSFCARGNTGELFF	TRBV5-4	TRBJ2-2
TGTGCCAGCAGCGAGGCGCCCGAGCAGTACTTC	CASSEAPEQYF	TRBV27	TRBJ2-7
TGTGCCATGTATAGGGGAGGTCAGCCCCAGCATTTT	CAMYRGGQPQHF	TRBV27	TRBJ1-5
TGTGCCACCAGCGGTCAGGGGGTTTCGTGGGCCTACGAGCAGTACTTC	CATSGQGVSWAYEQYF	TRBV15	TRBJ2-7
TGTGCCAGCAGCGCGATCGCTAGGGATCAGCCCCAGCATTTT	CASSAIARDQPQHF	TRBV11-3	TRBJ1-5
TGTGCCAGCGTCCGTATCAGGCGACTAGCGGGGGGCGGGGAGCTGTTTTTT	CASVRIRRLAGGGELFF	TRBV7-4	TRBJ2-2
TGTGCCAGCAGCCGGACAGAGGACTACGAGCAGTACTTC	CASSRTEDYEQYF	TRBV7-9	TRBJ2-7
TGCAGTGCTAGAAAGAAAGAGACCCAGTACTTC	CSARKKETQYF	TRBV20-1	TRBJ2-5
TGTGCCAGCAGGAGAAAGGAATCCGCCCTCCACTTT	CASRRKESALHF	TRBV6-5	TRBJ1-6
TGCGCCAGCAGCCAACCGGGACAGGGGAACATCTTT	CASSQPGQGNIF	TRBV5-1	TRBJ1-1
TGTGCCAGCAACAGGGGCATGAACACTGAAGCTTTCTTT	CASNRGMNTEAFF	TRBV27	TRBJ1-1
TGTGCCAGCAGAGAGTATACTTTGGCAAAGAACACTGAAGCTTTCTTT	CASREYTLAKNTEAFF	TRBV9	TRBJ1-1
TGCAGCGTTGGCTGTACGGGCCCGACAACAAACACTGAAGCTTTCTTT	CSVGCTGPTTNTEAFF	TRBV29-1	TRBJ1-1
TGTGCCAGCTCACCACTTCGGGACAGACGGGAGCTGTTTTTT	CASSPLRDRRELFF	TRBV18	TRBJ2-2
TGTGCCAGCAGCGCTGTTGGGGCCAGTCAGCCCCAGCATTTT	CASSAVGASQPQHF	TRBV9	TRBJ1-5
TGTGCCAGCCGAAGGAATAGGGACATTACTGAAGCTTTCTTT	CASRRNRDITEAFF	TRBV2	TRBJ1-1
TGCAGTGCTACGGATCTCTCGGGGTCCTACGAGCAGTACTTC	CSATDLSGSYEQYF	TRBV20-1	TRBJ2-7
TGTGCCACCAGTGATTTGGCGACAGGGGGCGGCGAGTATGGCTACACCTTC	CATSDLATGGGEYGYTF	TRBV24-1	TRBJ1-2
TGTGCCAGCAGTTATGATAGGGGGCTCGGCATAATCCACTACGAGCAGTACTTC	CASSYDRGLGIIHYEQYF	TRBV6-5	TRBJ2-7
TGTGCCAGCAGCCAAGGCCGGGACAAAGTTGAAAAACTGTTTTTT	CASSQGRDKVEKLFF	TRBV3-1	TRBJ1-4
TGCGCCAGCAGCCAAGATGCCCACTACAATGAGCAGTTCTTC	CASSQDAHYNEQFF	TRBV4-3	TRBJ2-1
TGCGCCAGCAGCCGGGGCTGGGTTCCGGACAAAGATAATTCACCCCTCCACTTT	CASSRGWVPDKDNSPLHF	TRBV5-1	TRBJ1-6
TGTGCCAGCTCACTGGGCTGGGAGACCCAGTACTTC	CASSLGWETQYF	TRBV18	TRBJ2-5
TGTGCCTCGACAGTAGGGGGCTACACCTTC	CASTVGGYTF	TRBV19	TRBJ1-2
TGCAGCGTTGAAGGCCAGATCCTCTACGAGCAGTACTTC	CSVEGQILYEQYF	TRBV29-1	TRBJ2-7
TGTGCCAGCGCCCTTAGGAACGGATATGAGCAGTTCTTC	CASALRNGYEQFF	TRBV28	TRBJ2-1
TGTGCCAGCAGCCCAGCACAGGGGCGCTACGAGCAGTACTTC	CASSPAQGRYEQYF	TRBV7-9	TRBJ2-7
TGTGCCAGCAGTTCGGCTAAGGAATACGGGACAGCCGGATCGGACACCTTC	CASSSAKEYGTAGSDTF	TRBV28	TRBJ1-2
TGTGCCAGCCCAGGCGCGGGAGGGTCGGCCGGGGAGGTTCTTCAGACCCAGTACTTC	CASPGAGGSAGEVLQTQYF	TRBV7-6	TRBJ2-5
TGTGCCAGCTCACCACAATTGACCTCCCCGCCGGGACAGGTGGGCACCGGGGAGCTGTTTTTT	CASSPQLTSPPGQVGTGELFF	TRBV18	TRBJ2-2
TGTGCCAGCGTTCGGGGGGCGGATAAGTACTTC	CASVRGADKYF	TRBV7-3	TRBJ2-5
TGTGCCTGGAGCAGCCCGAATCCCCGACCAAACGGAACTAGCACAGATACGCAGTATTTT	CAWSSPNPRPNGTSTDTQYF	TRBV30	TRBJ2-3
TGTGCCAGCAGCCAAGAGGTGGCGCTCTCCTACAATGAGCAGTTCTTC	CASSQEVALSYNEQFF	TRBV4-2	TRBJ2-1
TGTGCCAGCAGCGCAGGACAGGGGACCCAGCAGTACTTC	CASSAGQGTQQYF	TRBV13	TRBJ2-7
TGTGCCAGCAGCACAAGGAAGGCGACAGGCCTTCTGGGTTACTACGAGCAGTACTTC	CASSTRKATGLLGYYEQYF	TRBV11-2	TRBJ2-7
TGCAGTGCTAGAGAAGGGCCTACACGTCAGCCCCAGCATTTT	CSAREGPTRQPQHF	TRBV20-1	TRBJ1-5
TGTGCCAGCAGTTACTCACTGACACAGGGGTTAGATACGCAGTATTTT	CASSYSLTQGLDTQYF	TRBV6-3	TRBJ2-3
TGCAGTGAGAAGCCCGGGACAGGCGCCTACGAGCAGTACTTC	CSEKPGTGAYEQYF	TRBV20-1	TRBJ2-7
TGCGCCAGCAGTGATCCCCAGGGCCCCACTGAAGCTTTCTTT	CASSDPQGPTEAFF	TRBV10-1	TRBJ1-1
TGTGCCAGCAGCTTACCCACAGGACATGGCTACACCTTC	CASSLPTGHGYTF	TRBV11-3	TRBJ1-2
TGTGCCAGCCCCCTTGGGCCGGGACGGAGATACAATGAGCAGTTCTTC	CASPLGPGRRYNEQFF	TRBV2	TRBJ2-1
TGTGCCAGTAGTCCTAGCAGGGCTACATGTCAGCCCCAGCATTTT	CASSPSRATCQPQHF	TRBV19	TRBJ1-5
TGTGCCAGCAGCTTTGAAGGGGCTTGTGCGAACGAGCAGTACTTC	CASSFEGACANEQYF	TRBV7-2	TRBJ2-7
TGCGCCAGCAGCTTGGCCGCCCCAGAACAGGGGGGTAATTCACCCCTCCACTTT	CASSLAAPEQGGNSPLHF	TRBV5-1	TRBJ1-6
TGTGCCTGGTCAGTGGGGGACTACTCCTACGAGCAGTACTTC	CAWSVGDYSYEQYF	TRBV30	TRBJ2-7
TGTGCCAGCAGCGGGGGGCCATGCTACGAGCAGTACTTC	CASSGGPCYEQYF	TRBV7-2	TRBJ2-7
TGTGCCAGCAGCCAATGGGACCGGTACTCAAATCAGCCCCAGCATTTT	CASSQWDRYSNQPQHF	TRBV3-1	TRBJ1-5
TGTGCCTGGACTGAGGGGAACTTGGTAAATGAGCAGTTCTTC	CAWTEGNLVNEQFF	TRBV30	TRBJ2-1
TGTGCCAGCAGCGTAGGTGGTCAACAGGGTTCAGAGGGTGAAGCTTTCTTT	CASSVGGQQGSEGEAFF	TRBV9	TRBJ1-1
TGCAGTGCTAGAACGGTGGGAGACAGGGGCGAGCAGTACTTC	CSARTVGDRGEQYF	TRBV20-1	TRBJ2-7
TGCAGTGCTTACCGGCCGGATACGCAGTATTTT	CSAYRPDTQYF	TRBV20-1	TRBJ2-3
TGTGCCAGTAGTATTAGGGACAGGGCCACGCAGTATTTT	CASSIRDRATQYF	TRBV19	TRBJ2-3
TGCAGTGCTAGCGTCGGACCTACCTACGAGCAGTACTTC	CSASVGPTYEQYF	TRBV20-1	TRBJ2-7
TGTGCCAGCACCTGTCAGACTAGCGGGGGATTTGGTACCGGGGAGCTGTTTTTT	CASTCQTSGGFGTGELFF	TRBV2	TRBJ2-2
TGTGCCAGCGGATCGGCCGGGGGGAATGAGCAGTTCTTC	CASGSAGGNEQFF	TRBV19	TRBJ2-1
TGTGCCAGCAGGAACACACCACCCCCCTCCGGGAATTACAATGAGCAGTTCTTC	CASRNTPPPSGNYNEQFF	TRBV7-2	TRBJ2-1
TGTGCCATCAGACCGCCCCGGGGACCCACAGATACGCAGTATTTT	CAIRPPRGPTDTQYF	TRBV10-3	TRBJ2-3
TGTGCCAGCGACCGGGACAGGGGGAAGAACACTGAAGCTTTCTTT	CASDRDRGKNTEAFF	TRBV25-1	TRBJ1-1
TGTGCCACCAGTGACCAGGGGACAGGGGGCTCTGGAAACACCATATATTTT	CATSDQGTGGSGNTIYF	TRBV24-1	TRBJ1-3
TGCAGTGCTAGAGCATGGACAGGGCAGGGAAACACCATATATTTT	CSARAWTGQGNTIYF	TRBV20-1	TRBJ1-3
TGCGCCAGCAGTGAAGGACAGGGCGACACTGAAGCTTTCTTT	CASSEGQGDTEAFF	TRBV10-1	TRBJ1-1
TGTGCCAGCAGCCAAGATAATTTCCCTGACTACGAGCAGTACTTC	CASSQDNFPDYEQYF	TRBV4-2	TRBJ2-7
TGTGCCAGTAGTAAAGATCAGGACGTGGAAGAGACCCAGTACTTC	CASSKDQDVEETQYF	TRBV19	TRBJ2-5
TGTGCCAGCTGCCCTCGGACAGGGGGGTATGGCTACACCTTC	CASCPRTGGYGYTF	TRBV6-4	TRBJ1-2
TGCAGTGCGCGGGGGGGCTACAATGAGCAGTTCTTC	CSARGGYNEQFF	TRBV20-1	TRBJ2-1
TGTGCCAGCAGCTTAACCCGGGACAGGGCGGGATACGAGCAGTACTTC	CASSLTRDRAGYEQYF	TRBV7-3	TRBJ2-7
TGTGCCAGCATCCTTAGCGGGAAGGAGCAGTTCTTC	CASILSGKEQFF	TRBV6-2	TRBJ2-1
TGTGCCAGCAGCACCACAGGGGGGGAAGGAAACACCATATATTTT	CASSTTGGEGNTIYF	TRBV6-1	TRBJ1-3
TGCGCCCCGTCATGGAACACTGAAGCTTTCTTT	CAPSWNTEAFF	TRBV10-1	TRBJ1-1
TGCGCCAGCAGCTTGTGGGGGGGACACGCGAATGAGCAGTTCTTC	CASSLWGGHANEQFF	TRBV5-1	TRBJ2-1
TGTGCCAGCAGTTGCCGCCGGACGGACTCCTACGAGCAGTACTTC	CASSCRRTDSYEQYF	TRBV12-3	TRBJ2-7
TGCAGTGCTGATGCCCCAGCTAAGGTCGAGCAGTACTTC	CSADAPAKVEQYF	TRBV20-1	TRBJ2-7
TGCAGTGGGGACAGGGGGCGGAGTTCTAATGAAAAACTGTTTTTT	CSGDRGRSSNEKLFF	TRBV20-1	TRBJ1-4
TGTGCCAGGTCGCAGGCCAACGAGCAGTACTTC	CARSQANEQYF	TRBV6-4	TRBJ2-7
TGTGCCAGCAGTGACAAGGGGGCCTTGATCAACACCTTC	CASSDKGALINTF	TRBV25-1	TRBJ1-2
TGCGCCAGCAGCGTGGGACAGGGCCCTAGCAATCAGCCCCAGCATTTT	CASSVGQGPSNQPQHF	TRBV5-1	TRBJ1-5
TGCGCCAGTTCGGGTAGCAATCAGCCCCAGCATTTT	CASSGSNQPQHF	TRBV10-1	TRBJ1-5
TGTGCCAGCAGCTGCGGGGGATGGCGGGCCCAAACTAACTATGGCTACACCTTC	CASSCGGWRAQTNYGYTF	TRBV5-6	TRBJ1-2
TGTGCCAGCAGCCAAGATCCCCATCGGGCCAGCTTCGGCTACACCTTC	CASSQDPHRASFGYTF	TRBV3-1	TRBJ1-2
TGTCGTTTGTGGGCGGGGGGGACGAACACTGAAGCTTTCTTT	CRLWAGGTNTEAFF	TRBV7-9	TRBJ1-1
TGTGCCAGCACGCCCGGAGGCTACTTC	CASTPGGYF	TRBV6-1	TRBJ2-5
TGTGCCAGCTCACCCAGGCCCTCCTATAATTCACCCCTCCACTTT	CASSPRPSYNSPLHF	TRBV25-1	TRBJ1-6
TGTGCCAGTAGTGGAGGCACCAGAGACGCGGGAGATACGCAGTATTTT	CASSGGTRDAGDTQYF	TRBV19	TRBJ2-3
TGTGCCAGCAGCCTGGCAAATCAGCCCCAGCATTTT	CASSLANQPQHF	TRBV14	TRBJ1-5
TGTGCCATCAGTGAGGGGGCTCAGGGGGCCAACGTCCTGACTTTC	CAISEGAQGANVLTF	TRBV10-3	TRBJ2-6
TGTGCCAGCAGCTTCCCGTGGAAGAAGGGGAGGTCGAACACCGGGGAGCTGTTTTTT	CASSFPWKKGRSNTGELFF	TRBV5-5	TRBJ2-2
TGTGCCAGCAGTTGGAGCCGGCGGGACAGGGCCTACGAGCAGTACTTC	CASSWSRRDRAYEQYF	TRBV6-2	TRBJ2-7
TGTGCCAGCCCGACAGGAAATGCACTGTACTATGGCTACACCTTC	CASPTGNALYYGYTF	TRBV27	TRBJ1-2
TGTGCCGCCTCAGGCGAAGAAGCTTTCTTT	CAASGEEAFF	TRBV30	TRBJ1-1
TGTGCCACCAGTGATTTGTCCCGTGAAGGAAACACCATATATTTT	CATSDLSREGNTIYF	TRBV24-1	TRBJ1-3
TGTGCCAGCAGCCCGAGGACGAGTAGCAAAAACATTCAGTACTTC	CASSPRTSSKNIQYF	TRBV5-5	TRBJ2-4
TGTGCCATCAGTTCCGATCACTCCGGCTGGGAGACCCAGTACTTC	CAISSDHSGWETQYF	TRBV10-3	TRBJ2-5
TGTGCCAGCAGTTTATGCGACTGCACCGCGATGGATGAAAAACTGTTTTTT	CASSLCDCTAMDEKLFF	TRBV28	TRBJ1-4
TGTGCCACCAGTGATTGTCCGACAGGGGGCAGGAGGAGGCATGGCTACACCTTC	CATSDCPTGGRRRHGYTF	TRBV24-1	TRBJ1-2
TGCAGTGCTACACCTATCGGTAACCTGGTATGGAGCTCTGGGGCCAACGTCCTGACTTTC	CSATPIGNLVWSSGANVLTF	TRBV20-1	TRBJ2-6
TGTGCCAGCAGGGGGGGGGGCGAAACCTACGGGTACGAGCAGTACTTC	CASRGGGETYGYEQYF	TRBV6-8	TRBJ2-7
TGTGCCAGCAGCCCCGGGACGAGGCAGCCCCAGCATTTT	CASSPGTRQPQHF	TRBV7-2	TRBJ1-5
TGTGCCAGCAGTTTGGGACGAGAGCGGGACCAAGAGACCCAGTACTTC	CASSLGRERDQETQYF	TRBV12-3	TRBJ2-5
TGTGCCACCAGTGGAAGGGGGGGGACTAGTAGGGAGCAGTTCTTC	CATSGRGGTSREQFF	TRBV24-1	TRBJ2-1
TGTGCCAGCAGCTTCACCGGGCAGCCCCAGCATTTT	CASSFTGQPQHF	TRBV11-2	TRBJ1-5
TGCACGGGCTATGGCTACACCTTC	CTGYGYTF	TRBV10-1	TRBJ1-2
TGTGCCAGCAAACGACAGGCCAGGCAAGAGACCCAGTACTTC	CASKRQARQETQYF	TRBV6-1	TRBJ2-5
TGTGCCAGCAGGAGGACTAGCGGGAGAAACTGCACAGATACGCAGTATTTT	CASRRTSGRNCTDTQYF	TRBV11-3	TRBJ2-3
TGCAGTGTTGACAGGGGGGCTCAGAACACTGAAGCTTTCTTT	CSVDRGAQNTEAFF	TRBV20-1	TRBJ1-1
TGTGCCAGCAGCTGTCTCGACGGGGCTAATGAAAAACTGTTTTTT	CASSCLDGANEKLFF	TRBV7-3	TRBJ1-4
TGTGCCAGCAGTCCCCGGACAGGGATACAGCCCCAGCATTTT	CASSPRTGIQPQHF	TRBV12-4	TRBJ1-5
TGTGCCAGCAGTTCATCGGCTGAAAGGGAGCAGTTCTTC	CASSSSAEREQFF	TRBV28	TRBJ2-1
TGTGCCAGCAGTTACTCGAGGAATCCCAGGGGGCGGATCCACACTGAAGCTTTCTTT	CASSYSRNPRGRIHTEAFF	TRBV6-5	TRBJ1-1
TGCAGTGCTAGAATACGGTTATCAGGGGGGCCTTCACCCCTCCACTTT	CSARIRLSGGPSPLHF	TRBV20-1	TRBJ1-6
TGTGCCACCCCTATTCCTAGCTCCTACAATGAGCAGTTCTTC	CATPIPSSYNEQFF	TRBV2	TRBJ2-1
TGCGCCAGCAGCCAAGATAGACAAGGGGGAACCTGCGAGCAGTACTTC	CASSQDRQGGTCEQYF	TRBV4-3	TRBJ2-7
TGTGCTAGTGGCCTCGGCCGACGGGGGGAGCCGCCTGAGCAGTTCTTC	CASGLGRRGEPPEQFF	TRBV12-5	TRBJ2-1
TGTGCCAGCAGCAGGGGAGGGAGCATCTGGGGTGAAAGCGAGCAGTACTTC	CASSRGGSIWGESEQYF	TRBV9	TRBJ2-7
TGTGCCAGCAGTTCCTCTTTGGACAGGGGGCGGAGGAACACTGAAGCTTTCTTT	CASSSSLDRGRRNTEAFF	TRBV28	TRBJ1-1
TGTGCCAGCAGCCAAAGACGAACCGGTACCTACGAGCAGTACTTC	CASSQRRTGTYEQYF	TRBV3-1	TRBJ2-7
TGTGCCAGCAGTTTAGGAGGGACCCGGACACACGAGCAGTACTTC	CASSLGGTRTHEQYF	TRBV12-4	TRBJ2-7
TGTGCCAGCAGCAGGTTCCCAGGGCCGTCGGAGAACACTGAAGCTTTCTTT	CASSRFPGPSENTEAFF	TRBV16	TRBJ1-1
TGCTACCTGGAGAAAAGGCTCGAGCAGTACTTC	CYLEKRLEQYF	TRBV20-1	TRBJ2-7
TGTGCCAGCAGCCAAGCGGGGGCCTTGAACTATGGCTACACCTTC	CASSQAGALNYGYTF	TRBV14	TRBJ1-2
TGCGCCAGCAGCTTGCTACCCGGGCGGAACACTGAAGCTTTCTTT	CASSLLPGRNTEAFF	TRBV5-1	TRBJ1-1
TGCAGTGCTAGCGGAGGCCCCTACGAGCAGTACTTC	CSASGGPYEQYF	TRBV20-1	TRBJ2-7
TGTGCCAGCAGTTACCTAACCCCAGGGGGCGAGCTTAGCAATCAGCCCCAGCATTTT	CASSYLTPGGELSNQPQHF	TRBV6-3	TRBJ1-5
TGCGCCAGCAGTCCCCGGATGGGGGGCACAGATACGCAGTATTTT	CASSPRMGGTDTQYF	TRBV10-2	TRBJ2-3
TGTGCCAGCAGCACAAGGGGAAGTCCCTCCGGGACAGAGGTTCACAATGAGCAGTTCTTC	CASSTRGSPSGTEVHNEQFF	TRBV5-4	TRBJ2-1
TGCGCCAGCAGTGACCTCCACATGAACACTGAAGCTTTCTTT	CASSDLHMNTEAFF	TRBV10-1	TRBJ1-1
TGTGCCAGCAGCTCCGACAGCTACGAGCAGTACTTC	CASSSDSYEQYF	TRBV2	TRBJ2-7
TGTGCCAGCAGCTTGCCCAGGGCTAAGTACTTC	CASSLPRAKYF	TRBV7-9	TRBJ2-7
TGCAGTGCTAGGATATGGGGGGAAGAAAAACTGTTTTTT	CSARIWGEEKLFF	TRBV20-1	TRBJ1-4
TGTGCCAGCAGCTTGCTAGCGGGCGGTGCTGGGGCCAACGTCCTGACTTTC	CASSLLAGGAGANVLTF	TRBV11-3	TRBJ2-6
TGTGCCAGCAGGCGGGGGCGGAGCAATCAGCCCCAGCATTTT	CASRRGRSNQPQHF	TRBV6-4	TRBJ1-5
TGTGCCAGCAGCGTCTCCGAAGATACGGGACAGCAAGGCTACGAGCAGTACTTC	CASSVSEDTGQQGYEQYF	TRBV13	TRBJ2-7
TGTGCCAGCAGTTACTCAATTCTAAAGACAGGCCGGAACTATGGCTACACCTTC	CASSYSILKTGRNYGYTF	TRBV6-5	TRBJ1-2
TGCAGTGCTACGCCACTTCCCGGAGAGACCCAGTACTTC	CSATPLPGETQYF	TRBV20-1	TRBJ2-5
TGTGCCAGCAGTTACCAGAGGATTGTGAACACTGAAGCTTTCTTT	CASSYQRIVNTEAFF	TRBV6-6	TRBJ1-1
TGTGCCAGCAGTGACTCTTGGGGTCCTGACACTGAAGCTTTCTTT	CASSDSWGPDTEAFF	TRBV27	TRBJ1-1
TGTGCCACCAGAAAGGGTCCTATGAATTCACCCCTCCACTTT	CATRKGPMNSPLHF	TRBV24-1	TRBJ1-6
TGTGCCAGCAGTAGACAGGGAGAGTCTGGGGCCAACGTCCTGACTTTC	CASSRQGESGANVLTF	TRBV28	TRBJ2-6
TGTGCCAGCAGTTATCATAGGGGGGGCAGTGATAGCAATCAGCCCCAGCATTTT	CASSYHRGGSDSNQPQHF	TRBV6-2	TRBJ1-5
TGTGCCAGCAGCCCTGACCGGGAGCAGTACTTC	CASSPDREQYF	TRBV14	TRBJ2-7
TGCGCCTTAGTGGCGGGGGGCTACGAGCAGTACTTC	CALVAGGYEQYF	TRBV10-1	TRBJ2-7
TGCAGTGCTAGGCTAGGGGCAGATACGCAGTATTTT	CSARLGADTQYF	TRBV20-1	TRBJ2-3
TGTGCCAGCAGCTTAGCACAATGTTTCGGCAAGCAGTACTTC	CASSLAQCFGKQYF	TRBV11-2	TRBJ2-7
TGTGCCAGCAGCTTGTCGGGGTTATGGTCCCTTTATTTT	CASSLSGLWSLYF	TRBV5-4	TRBJ2-3
TGTGCCAGCAGCGGAACTAGCGGGCCGAATCGATTCACAGATACGCAGTATTTT	CASSGTSGPNRFTDTQYF	TRBV9	TRBJ2-3
TGCGCCAGCAGCCAAGATCCGACGGACAGTAATTACACTGAAGCTTTCTTT	CASSQDPTDSNYTEAFF	TRBV4-3	TRBJ1-1
TGTGCCAGCAGCTTACCCATACTAGGGGGGGCCACTGAAGCTTTCTTT	CASSLPILGGATEAFF	TRBV7-9	TRBJ1-1
TGCAGTGCTAAGGGACTAGCGGGAGAAAACACCGGGGAGCTGTTTTTT	CSAKGLAGENTGELFF	TRBV20-1	TRBJ2-2
TGTGCTAGTGGTTTAAGGTGGGCCGCCGGGACAGGGACTTGTCCGCATGGCTATGGCTACACCTTC	CASGLRWAAGTGTCPHGYGYTF	TRBV12-5	TRBJ1-2
TGTGCCAGTAGTATAAGGGGGGACTCCCGGACAGGAGTTCATATTCAGTACTTC	CASSIRGDSRTGVHIQYF	TRBV19	TRBJ2-4
TGCGCCAGCAGCCAGGGGGCTAAGGGGATACACGAGCAGTACTTC	CASSQGAKGIHEQYF	TRBV5-1	TRBJ2-7
TGTGCCAGCAGCGGGGAGGGTTGCGTCTTCTATGGCTACACCTTC	CASSGEGCVFYGYTF	TRBV9	TRBJ1-2
TGTGCCAGCAGCGTAGGCCGACTAGCGGGAGCCAGGGCCTCATCCTACAATGAGCAGTTCTTC	CASSVGRLAGARASSYNEQFF	TRBV9	TRBJ2-1
TGTGCCACCAACGTAGGGACAGGGGGCCATTCACCCCTCCACTTT	CATNVGTGGHSPLHF	TRBV24-1	TRBJ1-6
TGTGCGGTAGGGACTAGCGGCTACGAGCAGTACTTC	CAVGTSGYEQYF	TRBV6-4	TRBJ2-7
TGTGCCGGAGAGACAGGGGCTAGCCAATTTCCCGGGGAGCTGTTTTTT	CAGETGASQFPGELFF	TRBV19	TRBJ2-2
TGTGCCAAGTGGGGGGATAGAGAGACCCAGTACTTC	CAKWGDRETQYF	TRBV6-4	TRBJ2-5
TGTGCCAGCTCACCTCAACTAGCGGGAGCCAATCAGCCCCAGCATTTT	CASSPQLAGANQPQHF	TRBV18	TRBJ1-5
TGTGCCAGCACAGGGCGGGAGGCGAACACTGAAGCTTTCTTT	CASTGREANTEAFF	TRBV7-2	TRBJ1-1
TGTGCCAGCAGCTTAGTAGCGGGGGCTACCTGGATGAACACTGAAGCTTTCTTT	CASSLVAGATWMNTEAFF	TRBV11-2	TRBJ1-1
TGTGCCACCACCTTCAACAGACTCTTC	CATTFNRLF	TRBV15	TRBJ2-1
TGTGCCAGCAGCCCAGGGGGGAAGAACACCGGGGAGCTGTTTTTT	CASSPGGKNTGELFF	TRBV7-3	TRBJ2-2
TGCGCCAGCACACTACGAGGGGGAGTCTACGAGCAGTACTTC	CASTLRGGVYEQYF	TRBV10-1	TRBJ2-7
TGTGCCACTCCACACCGGGACAGGCAGTACTTC	CATPHRDRQYF	TRBV19	TRBJ2-7
TGTGCCTCGGTTGGGGGGAGAACTGAAGCTTTCTTT	CASVGGRTEAFF	TRBV19	TRBJ1-1
TGCAGTGCTAGGGCACCTACCGGGACAGCTCGAACCTACGAGCAGTACTTC	CSARAPTGTARTYEQYF	TRBV20-1	TRBJ2-7
TGTGCCAGCAGCAACCGGCTTCTCCTGGGGAGACCTACGCAGTATTTT	CASSNRLLLGRPTQYF	TRBV13	TRBJ2-3
TGTGCCAGCAGCTTACCCGGGACGGACAGTGGTAAACTGACGGATGAGCAGTTCTTC	CASSLPGTDSGKLTDEQFF	TRBV7-6	TRBJ2-1
TGTGCCAGCTCTTTCCATCCGGGACAGGGGGCGGGAACCTCAGCTTTCTTT	CASSFHPGQGAGTSAFF	TRBV6-5	TRBJ1-1
TGTGCCAGCAGCTTGAGAGCGGGCGGCGGGAGAGGGCCCCAGCATTTT	CASSLRAGGGRGPQHF	TRBV7-2	TRBJ1-5
TGTGCCATCACTGTCAGGGGATCGGTTCAGCCCCAGCATTTT	CAITVRGSVQPQHF	TRBV10-3	TRBJ1-5
TGCAGTGCTAGAGAGAAAAGGGGACAGGGTCAATTAAGGGGCTACGAGCAGTACTTC	CSAREKRGQGQLRGYEQYF	TRBV20-1	TRBJ2-7
TGTGCCAGCAGCAGGGCCAATGAAAAACTGTTTTTT	CASSRANEKLFF	TRBV11-3	TRBJ1-4
TGTGCCAGCAGCTTAATGGACAGGAATCAGCCCCAGCATTTT	CASSLMDRNQPQHF	TRBV7-2	TRBJ1-5
TGCAGTGCTAGAGATTACGGGGCGTTCTCCTACGAGCAGTACTTC	CSARDYGAFSYEQYF	TRBV20-1	TRBJ2-7
TGTGCCAGCAGCTTAAAGACCTTAGATGGGAGCCCTCACAATGAGCAGTTCTTC	CASSLKTLDGSPHNEQFF	TRBV7-3	TRBJ2-1
TGTGCCAGCAGCTTAGTCACAGGGGGGGGCGAGTCCGGGGAGCTGTTTTTT	CASSLVTGGGESGELFF	TRBV11-1	TRBJ2-2
TGTGCTAGTGGCCCCGGGAGGGTCTGCGCCACCGGGGAGCTGTTTTTT	CASGPGRVCATGELFF	TRBV12-5	TRBJ2-2
TGCAGCGTTGGACGGGGCCCATCCTACGAGCAGTACTTC	CSVGRGPSYEQYF	TRBV29-1	TRBJ2-7
TGCTCCCGATTGAAGCCCCAGCATTTT	CSRLKPQHF	TRBV20-1	TRBJ1-5
TGCAGTGCTAGAGAAGAAACACTCCCGTCTGGGGCCAACGTCCTGACTTTC	CSAREETLPSGANVLTF	TRBV20-1	TRBJ2-6
TGTGCCAGCTACGGCAGGGGCGAGACCCAGTACTTC	CASYGRGETQYF	TRBV6-2	TRBJ2-5
TGCGCCAGCAGTGCCACCAGGGGAGGCGTCAATCAGCCCCAGCATTTT	CASSATRGGVNQPQHF	TRBV10-2	TRBJ1-5
TGCGCCAGCAGCTCCTCCATTTTAAAACAGGGGAAGGAAAAACTGTTTTTT	CASSSSILKQGKEKLFF	TRBV5-1	TRBJ1-4
TGTGCCAGGCATGGGGGGCAAGGGAGCTATGGCTACACCTTC	CARHGGQGSYGYTF	TRBV19	TRBJ1-2
TGTGCCAAACCACGAGAAGGACTGGGGAGGACAAAGCAATTTCCCTACAATGAGCAGTTCTTC	CAKPREGLGRTKQFPYNEQFF	TRBV6-4	TRBJ2-1
TGTGCCACCAGCAGTTCCCAGATCGTTACCGGGGAGCTGTTTTTT	CATSSSQIVTGELFF	TRBV15	TRBJ2-2
TGTGCCAGCAGCCAAGGCCTCAGCGGGATTTTCTACTACACTGAAGCTTTCTTT	CASSQGLSGIFYYTEAFF	TRBV4-2	TRBJ1-1
TGCGCCAGCAGCTTCCAGGGGAGGGATTACCAGCTGCCGGACAATGAGCAGTTCTTC	CASSFQGRDYQLPDNEQFF	TRBV5-1	TRBJ2-1
TGCGCCAGGGCCACAAAAAGGAACACCGGGGAGCTGTTTTTT	CARATKRNTGELFF	TRBV10-1	TRBJ2-2
TGCGCCAGCAGCTTGGGCCGCGGACAGGGGGCCCTTGTGTGTAATGAAAAACTGTTTTTT	CASSLGRGQGALVCNEKLFF	TRBV5-1	TRBJ1-4
TGTGCCACAGGGCCTAGGGGCTACACCTTC	CATGPRGYTF	TRBV2	TRBJ1-2
TGCAGTGCTAGAGATCCACCGGACACAGGGGGGGCGAAGGTTGGAAACACCATATATTTT	CSARDPPDTGGAKVGNTIYF	TRBV20-1	TRBJ1-3
TGTGCCAGCAGCCAAGATAGGACAGGGGCTGGCTCCTATAATTCACCCCTCCACTTT	CASSQDRTGAGSYNSPLHF	TRBV4-2	TRBJ1-6
TGTGCCAACCGTCAAGGGGTAAACACCGGGGAGCTGTTTTTT	CANRQGVNTGELFF	TRBV9	TRBJ2-2
TGTGCCAGCAGCTTAGATAGGGAGGGGTACAGGCCCAATCAGCCCCAGCATTTT	CASSLDREGYRPNQPQHF	TRBV7-2	TRBJ1-5
TGTGCCAGCAGCTTGCCACCCCGGGGGGGTCAGCCCCAGCATTTT	CASSLPPRGGQPQHF	TRBV5-6	TRBJ1-5
TGTGCCAGTAGGGGGGGCCCTAATTATCCAGAGACCCAGTACTTC	CASRGGPNYPETQYF	TRBV19	TRBJ2-5
TGTGCCAGGGCCAATCTCACAGATACGCAGTATTTT	CARANLTDTQYF	TRBV12-3	TRBJ2-3
TGTGCCAGCAGCTTACCCCCATGCGGGGCGGCTCGAGGCTACGAGCAGTACTTC	CASSLPPCGAARGYEQYF	TRBV11-3	TRBJ2-7
TGTGCCAGCAGCACACAACCAGGGGGCCTCATTGATGGCTACACCTTC	CASSTQPGGLIDGYTF	TRBV13	TRBJ1-2
TGTGCCACCAGTGATTTGAAGGCGGGACATGGCTACACCTTC	CATSDLKAGHGYTF	TRBV24-1	TRBJ1-2
TGTGCCAGCAGCCAAGGTCTTGATACGCAGTATTTT	CASSQGLDTQYF	TRBV7-8	TRBJ2-3
TGCGCCAGCAGCTTGCGAGCTAGCGGGCGGCTCTCTAGGCAAATGGGGTCCTACAATGAGCAGTTCTTC	CASSLRASGRLSRQMGSYNEQFF	TRBV5-1	TRBJ2-1
TGTGCCAGCATCCAAAGCGGACAGAAAAAACCTTCACCCCTCCACTTT	CASIQSGQKKPSPLHF	TRBV2	TRBJ1-6
TGCGCCAGCAGCTTGTTCGACTCCTACAATGAGCAGTTCTTC	CASSLFDSYNEQFF	TRBV5-1	TRBJ2-1
TGTGCCAGCAGTTTAGGGATTGGCGAGCAGTACTTC	CASSLGIGEQYF	TRBV27	TRBJ2-7
TGTGCCAGCAGCTCCCCACGGGCAGGGGCCCGCTACGAGCAGTACTTC	CASSSPRAGARYEQYF	TRBV7-2	TRBJ2-7
TGTGCCACCGGAGTTCTCATTGGGACAGGGTTGGGTCTAACCGAGACCCAGTACTTC	CATGVLIGTGLGLTETQYF	TRBV24-1	TRBJ2-5
TGTGCCAGCAGTGATCCCCCAGGGACGGGCAATCAGCCCCAGCATTTT	CASSDPPGTGNQPQHF	TRBV6-1	TRBJ1-5
TGCGCCAGCAGCCACCGTCCTCGAGAACTGTACGAGCAGTACTTC	CASSHRPRELYEQYF	TRBV4-3	TRBJ2-7
TGTGCCTATACGGCGGACAGGGGAACGAATCAGCCCCAGCATTTT	CAYTADRGTNQPQHF	TRBV24-1	TRBJ1-5
TGTGCCAGCAGCCTCGGGACAGGGAGTGAAGCTTTCTTT	CASSLGTGSEAFF	TRBV9	TRBJ1-1
TGTGCCAGCAGGTTTTGGAACCAGGGCAATCAGCCCCAGCATTTT	CASRFWNQGNQPQHF	TRBV6-1	TRBJ1-5
TGTGCCAGCAGCCAAGATTGGTTTCAACAGGTGTGCTACGAGCAGTACTTC	CASSQDWFQQVCYEQYF	TRBV3-1	TRBJ2-7
TGCGCCAGCAGCACTCCGCATAATCAGCCCCAGCATTTT	CASSTPHNQPQHF	TRBV5-1	TRBJ1-5
TGCGCCAGCAGCCGGATAGGGGGCAGCGGAGCTTTCTTT	CASSRIGGSGAFF	TRBV5-1	TRBJ1-1
TGTGCCAGCAGCGAAGCGGCGGACTCCTACGAGCAGTACTTC	CASSEAADSYEQYF	TRBV13	TRBJ2-7
TGTGCCAGCAGCCCCCCGGGCGGGGGGAACCGAGGTGGGATGAACACCGGGGAGCTGTTTTTT	CASSPPGGGNRGGMNTGELFF	TRBV14	TRBJ2-2
TGTGCCAGCAGTGCATTGAGAGGGGTGGAATACGAGCAGTACTTC	CASSALRGVEYEQYF	TRBV5-6	TRBJ2-7
TGTGCCAGCAGCTCCAGGGGGCCCAACTATGGCTACACCTTC	CASSSRGPNYGYTF	TRBV13	TRBJ1-2
TGTGCCAGCAGCCGTTCAGTCAATAACTATGGCTACACCTTC	CASSRSVNNYGYTF	TRBV14	TRBJ1-2
TGTGCCACCAGTTCCGATTCAGGGGGGAGTGGCTATAATTCACCCCTCCACTTT	CATSSDSGGSGYNSPLHF	TRBV24-1	TRBJ1-6
TGTGCCACCCGGACAGGGTACGAGCAGTACTTC	CATRTGYEQYF	TRBV24-1	TRBJ2-7
TGTGCCAGCAAATGTAGGATAGCCAAAAACATTCAGTACTTC	CASKCRIAKNIQYF	TRBV27	TRBJ2-4
TGTGCCAGTAGTGAGGGGTTCCTGGCCTACGAGCAGTACTTC	CASSEGFLAYEQYF	TRBV19	TRBJ2-7
TGTGCCAGTAGTAGAAGGACAGAATATTATTCACCCCTCCACTTT	CASSRRTEYYSPLHF	TRBV19	TRBJ1-6
TGTGCCAGCAGTTACTCACCCGGGACAGGGGGCGATAAAAGAGACACTGAAGCTTTCTTT	CASSYSPGTGGDKRDTEAFF	TRBV6-2	TRBJ1-1
TGTGCCAGCAGTCGCACCCCCCAGCCCCAGCATTTT	CASSRTPQPQHF	TRBV28	TRBJ1-5
TGTGCCAGCAGTGACCCCCTCACTCCGGGACGGGCACAGTGTTTTATAAACACCATATATTTT	CASSDPLTPGRAQCFINTIYF	TRBV6-4	TRBJ1-3
TGCGCCAGCAGCTTACGGAACTGGACAGCAACGCGGCCTAGCAATCAGCCCCAGCATTTT	CASSLRNWTATRPSNQPQHF	TRBV5-1	TRBJ1-5
TGTGCCAGCAGTTACGTGACAGCACGAGGACCAGCTAGCACAGATACGCAGTATTTT	CASSYVTARGPASTDTQYF	TRBV6-2	TRBJ2-3
TGTGCCAGCAGCCCCTTACTAGATCTGGGGCCGCCGTGTCCCATTCAGCCCTACGAGCAGTACTTC	CASSPLLDLGPPCPIQPYEQYF	TRBV7-3	TRBJ2-7
TGTGCCAGCAGTGACTCGATGGAGGGAAACGCCCGCAGCTCTGGAAACACCATATATTTT	CASSDSMEGNARSSGNTIYF	TRBV6-4	TRBJ1-3
TGCGCCAGCAGCTACCCTCGCCGCGGGAGCAGAGATTCACCCCTCCACTTT	CASSYPRRGSRDSPLHF	TRBV5-1	TRBJ1-6
TGTGCCACCAGAGTCGGGACAGGGAAGGACAATGAGCAGTTCTTC	CATRVGTGKDNEQFF	TRBV24-1	TRBJ2-1
TGTGCCAGCAGTCACATGGAGACAGGGATTGTGAACACTGAAGCTTTCTTT	CASSHMETGIVNTEAFF	TRBV7-3	TRBJ1-1
TGTGCCAGCAGTCTAGACCGGCACCCCCAAGAGACCCAGTACTTC	CASSLDRHPQETQYF	TRBV6-4	TRBJ2-5
TGTGCCAGCAGCTTACAGTGCGGGACTAGTGAAGAGACCCAGTACTTC	CASSLQCGTSEETQYF	TRBV7-2	TRBJ2-5
TGTGCCAGCAGTGAAGCGCTGCCAGGGACAGGAGGTCTATTACGTTCGGACACGGGTCAGCCCCAGCATTTT	CASSEALPGTGGLLRSDTGQPQHF	TRBV6-1	TRBJ1-5
TGTGCCAGCAGTTACGAGAGGGCGTACGAGCAGTACTTC	CASSYERAYEQYF	TRBV6-5	TRBJ2-7
TGTGCCAGTAGGGGCCTAGCGGGGGTAGAGACCCAGTACTTC	CASRGLAGVETQYF	TRBV19	TRBJ2-5
TGCAGTGCAAACGGGGCCGGTGCAACTAATGAAAAACTGTTTTTT	CSANGAGATNEKLFF	TRBV20-1	TRBJ1-4
TGTGCCAGCAGCCTCGGTAGTCCTCCAGAGACCCAGTACTTC	CASSLGSPPETQYF	TRBV2	TRBJ2-5
TGCGCCAGCAGAATTGCCACGAGACATCAGCCCCAGCATTTT	CASRIATRHQPQHF	TRBV5-1	TRBJ1-5
TGTGCCAGCAGCTATATCCAGCCCCAGCATTTT	CASSYIQPQHF	TRBV7-4	TRBJ1-5
TGTGCCAGCAGTCGTCGGGCAGCTAATCTGAGGGAGACCCAGTACTTC	CASSRRAANLRETQYF	TRBV6-5	TRBJ2-5
TGTGCCAGCAGCGCGTCAGGGGCCTGTCGCAATGAGCAGTTCTTC	CASSASGACRNEQFF	TRBV13	TRBJ2-1
TGTGCCAGCAGGTTTGGGGCAAACTATGGCTACACCTTC	CASRFGANYGYTF	TRBV6-6	TRBJ1-2
TGTGCCAGCAGTTTCAGGGGGAATAGCAATCAGCCCCAGCATTTT	CASSFRGNSNQPQHF	TRBV6-6	TRBJ1-5
TGTGCCAGCAGTGTGAGTCCCAGGGGGGCGTCCTACGAGCAGTACTTC	CASSVSPRGASYEQYF	TRBV28	TRBJ2-7
TGCAGTGCGGACCGAGTGCAGTATTTT	CSADRVQYF	TRBV20-1	TRBJ2-3
TGTGCCAGCAGGCCCCGCAGGGGAAATGAAAAACTGTTTTTT	CASRPRRGNEKLFF	TRBV6-5	TRBJ1-4
TGTGCTAGTGGTTTGGTACCGGACAGGGGGCGCAAGCCCCAGCATTTT	CASGLVPDRGRKPQHF	TRBV12-5	TRBJ1-5
TGCGCCAGCAGCTTGGCCGGACTCGGAGCTGAAGCTTTCTTT	CASSLAGLGAEAFF	TRBV5-1	TRBJ1-1
TGTGCCAGCAGTGAGAGGGGGCCCCTCACAGATACGCAGTATTTT	CASSERGPLTDTQYF	TRBV27	TRBJ2-3
TGCGCCATCTTAGGGTTTCAGACAGTTCCCGGACACACTGAAGCTTTCTTT	CAILGFQTVPGHTEAFF	TRBV10-1	TRBJ1-1
TGTGCCAGCAGCGTAGCCCCCGCGGGAGCCAAAACCGGGGAGCTGTTTTTT	CASSVAPAGAKTGELFF	TRBV9	TRBJ2-2
TGTGCCAGCAGCCGACAGCCTAACGGCTATGGCTACACCTTC	CASSRQPNGYGYTF	TRBV3-1	TRBJ1-2
TGTGCCAGCTCACCACACCGTCAGGGAATCGATTACAATGAGCAGTTCTTC	CASSPHRQGIDYNEQFF	TRBV18	TRBJ2-1
TGTGCCAGCAGCCCCAAAAGTCGGGGGCCCTTC	CASSPKSRGPF	TRBV7-3	TRBJ1-2
TGTGCCAGCAGAGTCAGAGGTGAGCAGTTCTTC	CASRVRGEQFF	TRBV25-1	TRBJ2-1
TGTGCCACCATCGGTCCTGGACGCCTCATGAACACTGAAGCTTTCTTT	CATIGPGRLMNTEAFF	TRBV24-1	TRBJ1-1
TGTGCCAGCAGTTTAATGTCGCTAGCGAACTACGAGCAGTACTTC	CASSLMSLANYEQYF	TRBV12-3	TRBJ2-7
TGCGCCAGCAGCCAATTCTCAGTAGGGGGGACAGCTGGAAACACCATATATTTT	CASSQFSVGGTAGNTIYF	TRBV4-1	TRBJ1-3
TGTGCCAGCAGTCCGCTCGCTGGGGCCAACGTCCTGACTTTC	CASSPLAGANVLTF	TRBV6-5	TRBJ2-6
TGTGCCATCAGTGAACAAAAAGGGGCGGGAATGTATAGCAATCAGCCCCAGCATTTT	CAISEQKGAGMYSNQPQHF	TRBV10-3	TRBJ1-5
TGTGCCGGCAGGCAACCTGAAAAACTGTTTTTT	CAGRQPEKLFF	TRBV10-3	TRBJ1-4
TGTGCCAGCAGTGAAAGCGGACAGGGGCGGACGAACACCGGGGAGCTGTTTTTT	CASSESGQGRTNTGELFF	TRBV6-1	TRBJ2-2
TGTGGACGGGGCGCTCCCTACGAGCAGTACTTC	CGRGAPYEQYF	TRBV19	TRBJ2-7
TGTGCCAGCAGCTTACCTCCCCAGGGGGGTAATTCACCCCTCCACTTT	CASSLPPQGGNSPLHF	TRBV11-3	TRBJ1-6
TGTGCCAGCAGTTATGGGATAGCGGGAACCCAAGAGACCCAGTACTTC	CASSYGIAGTQETQYF	TRBV6-6	TRBJ2-5
TGTGCCAGCACCGGGCGGGATGGCTACACCTTC	CASTGRDGYTF	TRBV25-1	TRBJ1-2
TGTGCCAGGGAGGTGTCGACAGATACGCAGTATTTT	CAREVSTDTQYF	TRBV11-3	TRBJ2-3
TGTGCCAGCAGCTTAGGACTAGCGGCAGACACCGGGGAGCTGTTTTTT	CASSLGLAADTGELFF	TRBV7-4	TRBJ2-2
TGTGCCAGCAGCGACAGGGACTACCAACGTAGCAATCAGCCCCAGCATTTT	CASSDRDYQRSNQPQHF	TRBV11-2	TRBJ1-5
TGCAGTGCTAGAGCCCGAGTCCCCCGGGGGGGCGGAACGTGCGGGCAGCCCCAGCATTTT	CSARARVPRGGGTCGQPQHF	TRBV20-1	TRBJ1-5
TGCAGTGAAGGAAACACCGGGGAGCTGTTTTTT	CSEGNTGELFF	TRBV20-1	TRBJ2-2
TGTGCCAGCAGCTTCTCAGTGCTAGACTCTGGGGCCAACGTCCTGACTTTC	CASSFSVLDSGANVLTF	TRBV7-8	TRBJ2-6
TGCGCCAGCAGCCGGGCCGGGCTAAAACGGCACTCCTACGAGCAGTACTTC	CASSRAGLKRHSYEQYF	TRBV5-1	TRBJ2-7
TGCGCCAGCAGTATCAGGGGCCGAGCGACCCAGTACTTC	CASSIRGRATQYF	TRBV5-1	TRBJ2-5
TGTGCCAGCAGCTTAGCCCAACCCCTGAACTACAATCAGCCCCAGCATTTT	CASSLAQPLNYNQPQHF	TRBV11-3	TRBJ1-5
TGCAGTAGGCCACGGAAGCGGGATTGGCGGGAGGATACGCAGTATTTT	CSRPRKRDWREDTQYF	TRBV20-1	TRBJ2-3
TGTGCCAGCAGCCAAGAAGCGCTCAGGGGCGAGACTGAAGCTTTCTTT	CASSQEALRGETEAFF	TRBV3-1	TRBJ1-1
TGTGCCAGCAGCTTAACTCCCCGGGCCTCCTACGAGCAGTACTTC	CASSLTPRASYEQYF	TRBV7-3	TRBJ2-7
TGTGCCAGCAGCTTGACTAGCGGGACCAATTATACGCAGTATTTT	CASSLTSGTNYTQYF	TRBV13	TRBJ2-3
TGTGCCAGCAGTTTCCCCAGGGCCATCCGGGACGAGCAGTACTTC	CASSFPRAIRDEQYF	TRBV27	TRBJ2-7
TGTGCCACCGAACGACTAGCGGGCAAATACTACGTCTACAATGAGCAGTTCTTC	CATERLAGKYYVYNEQFF	TRBV15	TRBJ2-1
TGTGCCAGCACCAATCCGGAGGGGATGAACACTGAAGCTTTCTTT	CASTNPEGMNTEAFF	TRBV6-4	TRBJ1-1
TGTGCCAGCACCTGGCGGGAGGTGCAGTACTTC	CASTWREVQYF	TRBV6-1	TRBJ2-7
TGCGCCAGCAGCTTGGCCTCAGCTAGAGAGCAGTACTTC	CASSLASAREQYF	TRBV5-1	TRBJ2-7
TGTGCCAGCAGCGATAACAGGGTTTCTGAAGCTTTCTTT	CASSDNRVSEAFF	TRBV3-1	TRBJ1-1
TGCGCCAGCAGCCAAGTGGGACAGGAGTGGGAGCAAACCAATCAGCCCCAGCATTTT	CASSQVGQEWEQTNQPQHF	TRBV4-3	TRBJ1-5
TGTGCCAGCAGCCAAGCCAGCATTGATGAAGCTTTCTTT	CASSQASIDEAFF	TRBV4-2	TRBJ1-1
TGTGCCAGCAGCCAAACCCTAGCGGACAGCCACAATCAGCCCCAGCATTTT	CASSQTLADSHNQPQHF	TRBV5-8	TRBJ1-5
TGTGCCAGCAGTTACGTTGGTGTGGGACAGGGGGCTGTTGGAAACACCATATATTTT	CASSYVGVGQGAVGNTIYF	TRBV6-5	TRBJ1-3
TGTGCCAGCAGCCCCCAATCTACTAACTATGGCTACACCTTC	CASSPQSTNYGYTF	TRBV6-6	TRBJ1-2
TGTGCCAGCAGGGTGGGGCAGATCGGGAGCATCTACGAGCAGTACTTC	CASRVGQIGSIYEQYF	TRBV25-1	TRBJ2-7
TGTGCCAGCCCCAGACAGGGGAGTATCTTC	CASPRQGSIF	TRBV5-6	TRBJ2-1
TGTGCCAGCAGCTTAGCCACCGGACTGCCAAACACTGAAGCTTTCTTT	CASSLATGLPNTEAFF	TRBV11-3	TRBJ1-1
TGTGCCAGCAGTTACTCGCGTATGATGTTCGAGCAGTACTTC	CASSYSRMMFEQYF	TRBV6-6	TRBJ2-7
TGTGCCAGCAGATCAGACAGGGTACGGGGGTACACAGATACGCAGTATTTT	CASRSDRVRGYTDTQYF	TRBV11-3	TRBJ2-3
TGTGCCAGCAGTTACTCGAGACCGGCGGGCGAAAAACTGTTTTTT	CASSYSRPAGEKLFF	TRBV6-5	TRBJ1-4
TGTGCCAGCAGCGTAGTCTACCAGACAGACTACGAGCAGTACTTC	CASSVVYQTDYEQYF	TRBV9	TRBJ2-7
TGTGCCAGCAGCTCCGACAGGAACTACGGAAACGAGCAGTACTTC	CASSSDRNYGNEQYF	TRBV5-4	TRBJ2-7
TGTGCCAGCAGCCCCCCATCGAAACATAGCTCCTACAATGAGCAGTTCTTC	CASSPPSKHSSYNEQFF	TRBV7-4	TRBJ2-1
TGCAGTGCTAGAGATGGAGTGGGACTAGCGTACGAGCAGTACTTC	CSARDGVGLAYEQYF	TRBV20-1	TRBJ2-7
TGCGCCAGCAGCTTGGAGACAGGGGGTCCCTACGAGCAGTACTTC	CASSLETGGPYEQYF	TRBV5-1	TRBJ2-7
TGCGCCAGCATGGGACGGGGCGCCAATTCACCCCTCCACTTT	CASMGRGANSPLHF	TRBV4-1	TRBJ1-6
TGTGCCAGCAGGCCGGGACAGGGTCCTTCCACCGGCGACGAGCAGTACTTC	CASRPGQGPSTGDEQYF	TRBV6-4	TRBJ2-7
TGCAGCGTTGAAGATGCAGGGAAATTCGGGGAGCTGTTTTTT	CSVEDAGKFGELFF	TRBV29-1	TRBJ2-2
TGTGCCAGCAGCTCCGGGACGGACATGAACACTGAAGCTTTCTTT	CASSSGTDMNTEAFF	TRBV13	TRBJ1-1
TGTGCCACCCGACGAGTCCAGCCCCAGCATTTT	CATRRVQPQHF	TRBV6-5	TRBJ1-5
TGTGCCAGCAGTTTCTGGGGACGGGGGGCCAACGTCCTGACTTTC	CASSFWGRGANVLTF	TRBV12-3	TRBJ2-6
TGTGCCAGCAGCTTGGGGTCACTTGGGGGGGTCAATCAGCCCCAGCATTTT	CASSLGSLGGVNQPQHF	TRBV5-4	TRBJ1-5
TGTGCCAGCAAGGGCTCGGCGGGGGTCTACAATGAGCAGTTCTTC	CASKGSAGVYNEQFF	TRBV9	TRBJ2-1
TGTGCCAGCAGGACCAGCACTACTAGCGGGAGGTTCTATGGCTACACCTTC	CASRTSTTSGRFYGYTF	TRBV9	TRBJ1-2
TGCGCCAGCAGCCACTCCGGGACTAGCGGGCTTAAAAACATTCAGTACTTC	CASSHSGTSGLKNIQYF	TRBV5-1	TRBJ2-4
TGTGCCAGCAGTTTACGCGCCGGCCTGGGACCGGGGGAGCAGTACTTC	CASSLRAGLGPGEQYF	TRBV12-4	TRBJ2-7
TGTGCCAGCAGTTTACCGACTAGGGGTGCGACGCAGTATTTT	CASSLPTRGATQYF	TRBV12-3	TRBJ2-3
TGTGCCAGCAGTTCCACGTCGACAGACACAGATACGCAGTATTTT	CASSSTSTDTDTQYF	TRBV6-8	TRBJ2-3
TGCGCCAGCAGTGAGACGGGACAGCCCCAGCATTTT	CASSETGQPQHF	TRBV10-1	TRBJ1-5
TGCGCCAGCAGAACAGGGGGCAGGAACACTGAAGCTTTCTTT	CASRTGGRNTEAFF	TRBV5-1	TRBJ1-1
TGTGCCAATATGGGACAGAAACCCTACGAGCAGTACTTC	CANMGQKPYEQYF	TRBV5-4	TRBJ2-7
TGCGCCAGCAGCTTCCCCATCCAGCGTGAGCCCCAGCATTTT	CASSFPIQREPQHF	TRBV5-1	TRBJ1-5
TGTGCCAGCAGCTTAGCGGGGTGGTCTGAAAAACTGTTTTTT	CASSLAGWSEKLFF	TRBV7-6	TRBJ1-4
TGTGCCAGCAGCTGGGGGACGAGCGCTTACGAGCAGTACTTC	CASSWGTSAYEQYF	TRBV7-9	TRBJ2-7
TGTGCCAGCAGGTGGTCACGCGACAGGACCAATCAGCCCCAGCATTTT	CASRWSRDRTNQPQHF	TRBV27	TRBJ1-5
TGTGCCAGCAGCTTCTTAAGAAGACGGGAAACCTACGAGCAGTACTTC	CASSFLRRRETYEQYF	TRBV5-5	TRBJ2-7
TGCAGCGTTGAGGGGACTAGCGGGCGCACAGATACGCAGTATTTT	CSVEGTSGRTDTQYF	TRBV29-1	TRBJ2-3
TGTGCCAGCAGCCAAAGGTTGGCCGACAGGTACGACAATGAGCAGTTCTTC	CASSQRLADRYDNEQFF	TRBV3-1	TRBJ2-1
TGTGCTAGTGGTTTGTCCTCAAGGGGGTCGCCTCAGCAGCCGAACACTGAAGCTTTCTTT	CASGLSSRGSPQQPNTEAFF	TRBV12-5	TRBJ1-1
TGCGCCAGCAGCCATGCCAAACAGATCCAAGAGACCCAGTACTTC	CASSHAKQIQETQYF	TRBV4-1	TRBJ2-5
TGTGCCAGCAGTGAACAACGACAGGTTGGCTACACCTTC	CASSEQRQVGYTF	TRBV2	TRBJ1-2
TGCGCCAGCAGCCAAGATGCTAGGGGGGGCTACGAGCAGTACTTC	CASSQDARGGYEQYF	TRBV4-1	TRBJ2-7
TGTGCCACCGTCCCCGACTCTCCGCCCGTAATTGTAGCCAAAAACATTCAGTACTTC	CATVPDSPPVIVAKNIQYF	TRBV24-1	TRBJ2-4
TGCAGTGCTGGGGACCTTTTTGCCCAAGAGACCCAGTACTTC	CSAGDLFAQETQYF	TRBV20-1	TRBJ2-5
TGTGCCACCAGTGATTTCTGGCCCGGATCGCGTCAGCCCCAGCATTTT	CATSDFWPGSRQPQHF	TRBV24-1	TRBJ1-5
TGCAGCGTTGAAGATCACTTCGGGAGGGACGAAACCGGGGAAAAACTGTTTTTT	CSVEDHFGRDETGEKLFF	TRBV29-1	TRBJ1-4
TGTGCTAGTGGTTTGGTACCTAGGGTCGAGCAGTACTTC	CASGLVPRVEQYF	TRBV12-5	TRBJ2-7
TGTGCCAGAAGGAGGGCCGGGATTGGAGAGACCCAGTACTTC	CARRRAGIGETQYF	TRBV6-4	TRBJ2-5
TGCAGTGCTAGCCGCTCCGGGACAGGGCCCGGGGAGCTGTTTTTT	CSASRSGTGPGELFF	TRBV20-1	TRBJ2-2
TGTGCCAGCAGTTACTCGACAAAGACCAAGCAAGAGACCCAGTACTTC	CASSYSTKTKQETQYF	TRBV6-5	TRBJ2-5
TGTGCCAGCAGGTACGGGGAGCTGTTTTTT	CASRYGELFF	TRBV11-3	TRBJ2-2
TGTGCCAGCAGCTTATCGGGGGTTGGTAACACCGGGGAGCTGTTTTTT	CASSLSGVGNTGELFF	TRBV7-9	TRBJ2-2
TGTGCCAGCAGCTTAGGGACAGGCGGGGAGCTGTTTTTT	CASSLGTGGELFF	TRBV7-9	TRBJ2-2
TGCGCCAGCGGTACGGAGCCTTTGCAGTACTTC	CASGTEPLQYF	TRBV10-1	TRBJ2-7
TGTGCCAGCAGCAGCAAGCGGGACAGCAATGAGCAGTTCTTC	CASSSKRDSNEQFF	TRBV13	TRBJ2-1
TGTGCCTATCGGGTAACCTACAATGAGCAGTTCTTC	CAYRVTYNEQFF	TRBV19	TRBJ2-1
TGTGCCAGCCACAACTATGGCTACACCTTC	CASHNYGYTF	TRBV6-8	TRBJ1-2
TGTGCCAGCAGTGAAGCGCTTTTCAAAGGGCCAGATTCACCCCTCCACTTT	CASSEALFKGPDSPLHF	TRBV6-1	TRBJ1-6
TGCAGTGCCAAGGGGTTCATCTACGAGCAGTACTTC	CSAKGFIYEQYF	TRBV20-1	TRBJ2-7
TGCGCCAGCAGCTTGGAGAGTGCGTCTAACTATGGCTACACCTTC	CASSLESASNYGYTF	TRBV5-1	TRBJ1-2
TGTGCCAGCAGTGAATATTTAACGGTGACGGCGTCAGGAAATCAGCCCCAGCATTTT	CASSEYLTVTASGNQPQHF	TRBV25-1	TRBJ1-5
TGTGCCACCAGTGTAGAGGCCGCCTACAATGAGCAGTTCTTC	CATSVEAAYNEQFF	TRBV24-1	TRBJ2-1
TGTGCCATCAGCATATACAGGGGTGGCTCCTACGAGCAGTACTTC	CAISIYRGGSYEQYF	TRBV10-3	TRBJ2-7
TGCAGTGCTAGAGTTTCGGGACTCGGTGAGCAGTTCTTC	CSARVSGLGEQFF	TRBV20-1	TRBJ2-1
TGTGCCAGCAGTGACCCATTCTCTAGCGGGCTGAAGTACAATGAGCAGTTCTTC	CASSDPFSSGLKYNEQFF	TRBV6-4	TRBJ2-1
TGTGCCAGCAGTTCCTCGAGCAGGGAGTACATTCAGTACTTC	CASSSSSREYIQYF	TRBV6-5	TRBJ2-4
TGCAGTGCGGGGGAGGGACAGGGAAAGACAGATACGCAGTATTTT	CSAGEGQGKTDTQYF	TRBV20-1	TRBJ2-3
TGTGCCAGCAGTTACTGCTACAGCCGGCGGGTTAATGAAAAACTGTTTTTT	CASSYCYSRRVNEKLFF	TRBV6-9	TRBJ1-4
TGCGCCAGCAGCCAAGATCTTATACTAGCATGCTCCTACAATGAGCAGTTCTTC	CASSQDLILACSYNEQFF	TRBV4-1	TRBJ2-1
TGTGCCAGCAGCCAAGAGAAAGAAACCAGAGCCCAGTACTTC	CASSQEKETRAQYF	TRBV3-1	TRBJ2-5
TGTGCCAGCACTAACTTGGGGGCTGAAGCTTTCTTT	CASTNLGAEAFF	TRBV13	TRBJ1-1
TGTGCCACCAGTGATTTGCCGGGGGATCAGTGGATTGGCTACACCTTC	CATSDLPGDQWIGYTF	TRBV24-1	TRBJ1-2
TGCGCCAGCAGCACAGGGAAATTGGACGTGAACACTGAAGCTTTCTTT	CASSTGKLDVNTEAFF	TRBV5-1	TRBJ1-1
TGTGCCAGCAGGGGGACGCCGTCTAATGAAAAACTGTTTTTT	CASRGTPSNEKLFF	TRBV25-1	TRBJ1-4
TGCAGTGCTAGTCGGAGAAGGGTGTACTTC	CSASRRRVYF	TRBV20-1	TRBJ2-7
TGCGCCAGCAGCTTCCAGGCTTCCGGGACAGGGCGGATGCCGAACACTGAAGCTTTCTTT	CASSFQASGTGRMPNTEAFF	TRBV5-1	TRBJ1-1
TGTGCCAGCAGTTTACCACTAAAAGGGGGGCACGAGCAGTACTTC	CASSLPLKGGHEQYF	TRBV12-4	TRBJ2-7
TGTGCCAGCAGTGACGAATTACTGGATCGGGGTTGGAACACCGGGGAGCTGTTTTTT	CASSDELLDRGWNTGELFF	TRBV25-1	TRBJ2-2
TGTGCCAGCAGCCGGGGACAGGGATGGAGGAACACTGAAGCTTTCTTT	CASSRGQGWRNTEAFF	TRBV7-3	TRBJ1-1
TGTGCCAGCTCACAGACTGGGGGCTATGGCTACACCTTC	CASSQTGGYGYTF	TRBV18	TRBJ1-2
TGTGCCAGCAATTCACTTACTAGCGGGACCACAGATACGCAGTATTTT	CASNSLTSGTTDTQYF	TRBV6-4	TRBJ2-3
TGTGCCAGCAGTGGGGTGCAGAGCAATCAGCCCCAGCATTTT	CASSGVQSNQPQHF	TRBV6-1	TRBJ1-5
TGTGCCAGCAGTAAAACGGGACCTACCGGGGAGCTGTTTTTT	CASSKTGPTGELFF	TRBV4-2	TRBJ2-2
TGTGCCACCAGTGCCGTTTTAACCCGGGCGGGGACAGATACGCAGTATTTT	CATSAVLTRAGTDTQYF	TRBV24-1	TRBJ2-3
TGTGCCAGCAGCTTAGCCCGACCTTACGAGAACTATGGCTACACCTTC	CASSLARPYENYGYTF	TRBV7-4	TRBJ1-2
TGTGCCAGCAGCTTGGGGGTTACCACACGAAGCAATGAGCAGTTCTTC	CASSLGVTTRSNEQFF	TRBV5-4	TRBJ2-1
TGCAGTGCTAGAGATGCGACTCATGAGCAGTTCTTC	CSARDATHEQFF	TRBV20-1	TRBJ2-1
TGTGCCAGCAGCCAGGACAGGGATGTAGGTCAGCCCCAGCATTTT	CASSQDRDVGQPQHF	TRBV7-3	TRBJ1-5
TGTGCCATCAGTGGGACAGGTCTTCTAGGCCGCTCCTACGAGCAGTACTTC	CAISGTGLLGRSYEQYF	TRBV10-3	TRBJ2-7
TGTGCCAGCAGTTCACCGGGACTAGTCAATGAGCAGTTCTTC	CASSSPGLVNEQFF	TRBV6-2	TRBJ2-1
TGTGCCAGCAGTTTATATGGGGAAAGGGAAAACACTGAAGCTTTCTTT	CASSLYGERENTEAFF	TRBV27	TRBJ1-1
TGTGCCAGCAGCCAATTGGCTACAGAGGACGGGGGCTCCTACAATGAGCAGTTCTTC	CASSQLATEDGGSYNEQFF	TRBV14	TRBJ2-1
TGCAGTGCTAGATATCCCCAGGGCGAGAACACTGAAGCTTTCTTT	CSARYPQGENTEAFF	TRBV20-1	TRBJ1-1
TGTGCCAGCAGCTTGGGACGGACCAAAACTGAAGCTTTCTTT	CASSLGRTKTEAFF	TRBV5-6	TRBJ1-1
TGTGCCAGCAGGAGCGGGACTAGCGGGTACAATGAGCAGTTCTTC	CASRSGTSGYNEQFF	TRBV6-1	TRBJ2-1
TGTGCCAGCAGCTTGGGATTTCGACCCTACAATGAGCAGTTCTTC	CASSLGFRPYNEQFF	TRBV5-4	TRBJ2-1
TGTGCCAGCAGCTTAGAAGGGGGCGCAGCTTTCTTT	CASSLEGGAAFF	TRBV11-3	TRBJ1-1
TGTGCCAGCAGCTTAGTACAAGGTAAGGACAGGTTGGCCTACGAGCAGTACTTC	CASSLVQGKDRLAYEQYF	TRBV11-2	TRBJ2-7
TGCAGTGCTACTTCCTTCGAGGTAAATGATACTGGAAACACCATATATTTT	CSATSFEVNDTGNTIYF	TRBV20-1	TRBJ1-3
TGTGCCACCAGTGATGAGGGACGTCGGTTTAGTCATGAGCAGTTCTTC	CATSDEGRRFSHEQFF	TRBV24-1	TRBJ2-1
TGCGCCAGCAGCGAAGCCAGTACAGGGCTTGACACAATGAGCTCCTATAATTCACCCCTCCACTTT	CASSEASTGLDTMSSYNSPLHF	TRBV5-1	TRBJ1-6
TGTGCCAGCAGCATTATGCGCGTCGAGCAGTACTTC	CASSIMRVEQYF	TRBV13	TRBJ2-7
TGTGCCAGCAGTGAACTTCAAGCGGGAAAGGGTGGCTACACCTTC	CASSELQAGKGGYTF	TRBV6-4	TRBJ1-2
TGTGCCAGCAGTTACGAGGGGCGAGAGACCCAGTACTTC	CASSYEGRETQYF	TRBV6-8	TRBJ2-5
TGTGCCTGGAGTGTCAAGGGTGCTGTCTCCTACGAGCAGTACTTC	CAWSVKGAVSYEQYF	TRBV30	TRBJ2-7
TGTGCCAGCAGTGCGCCAGGGGCGACCAATCAGCCCCAGCATTTT	CASSAPGATNQPQHF	TRBV6-4	TRBJ1-5
TGCGCCAGCAGCCAAGCCTGCACCTTAGCGACCGGGGAGCTGTTTTTT	CASSQACTLATGELFF	TRBV4-1	TRBJ2-2
TGTGCCATCAGTAGGAAGGACACGAGATATAGCAATCAGCCCCAGCATTTT	CAISRKDTRYSNQPQHF	TRBV10-3	TRBJ1-5
TGTGCCAGCGCCCGTAGCTTAGGCTCTGGGGCCAACGTCCTGACTTTC	CASARSLGSGANVLTF	TRBV12-4	TRBJ2-6
TGTGCCAGCAGTTTATGTCCCGACAGGGTCTTACGTAATTATAGCAATCAGCCCCAGCATTTT	CASSLCPDRVLRNYSNQPQHF	TRBV28	TRBJ1-5
TGCAGTGCTAACAGGGCCTCTGAAGCTTTCTTT	CSANRASEAFF	TRBV20-1	TRBJ1-1
TGTGCCAGCAGCCCAGCGACTTCTACTGAAGCTTTCTTT	CASSPATSTEAFF	TRBV3-1	TRBJ1-1
TGTGCTAGTGGGCGTTGGGGCTACACCTTC	CASGRWGYTF	TRBV12-5	TRBJ1-2
TGTGCCAGCAGTGACCCACTAGCGGGAGGGCGAGGAGATCAGCCCCAGCATTTT	CASSDPLAGGRGDQPQHF	TRBV2	TRBJ1-5
TGTGCCAGCAGAAAAGGGGGGGCCAGTCATGAGCAGTTCTTC	CASRKGGASHEQFF	TRBV27	TRBJ2-1
TGTGCCAGCAGTTTACCTATGAACACTGAAGCTTTCTTT	CASSLPMNTEAFF	TRBV28	TRBJ1-1
TGTGCCAGCTTAGAACTAGCGGGCAGGACCAATGAGCAGTTCTTC	CASLELAGRTNEQFF	TRBV9	TRBJ2-1
TGTGCCAGCAGCCCGGGGCAAGGGGTGGGAGGCGCTTTTAACTATGGCTACACCTTC	CASSPGQGVGGAFNYGYTF	TRBV9	TRBJ1-2
TGTGCCAGCAGTAAGCCGGGGGGACCAAATGAGCAGTTCTTC	CASSKPGGPNEQFF	TRBV6-8	TRBJ2-1
TGCAGTGCCCGGCGCGGGGCGCAGTCACCCCTCCACTTT	CSARRGAQSPLHF	TRBV20-1	TRBJ1-6
TGTGCCAGCAGCACTAGCGGGAGGCACTCCTACGAGCAGTACTTC	CASSTSGRHSYEQYF	TRBV28	TRBJ2-7
TGCGCCAGTGCCCCGGCCTTGGGCAATCAGCCCCAGCATTTT	CASAPALGNQPQHF	TRBV10-1	TRBJ1-5
TGTGCCAGCAGCTCCGGCTTCCCGCCGCATTTT	CASSSGFPPHF	TRBV5-6	TRBJ1-5
TGTGCCAGCTATCCAGGGACAGGGAAGAAAAACACTGAAGCTTTCTTT	CASYPGTGKKNTEAFF	TRBV5-6	TRBJ1-1
TGTGCCAGCAGCACGGGGGGCACTGAAGCTTTCTTT	CASSTGGTEAFF	TRBV13	TRBJ1-1
TGTGCCAGCAGCGGGGACAGAGTCTATGGCTACACCTTC	CASSGDRVYGYTF	TRBV7-3	TRBJ1-2
TGCAGTGGAAATTGCGGGAGGAATGGCTACACCTTC	CSGNCGRNGYTF	TRBV20-1	TRBJ1-2
TGTGCCGTTTGGGACCGCACTGAAGCTTTCTTT	CAVWDRTEAFF	TRBV19	TRBJ1-1
TGTGCCACCAATACTAGACAGGGGAAGGGCGAAAAACTGTTTTTT	CATNTRQGKGEKLFF	TRBV24-1	TRBJ1-4
TGCGTCACTAGCGGTTACCCCGGGGAGCTGTTTTTT	CVTSGYPGELFF	TRBV29-1	TRBJ2-2
TGTGCCAGCAGCGAGGGGACAGTTACCTACGAGCAGTACTTC	CASSEGTVTYEQYF	TRBV7-9	TRBJ2-7
TGTGCCAGCAGGAGCAGGTGGAGTAATTCACCCCTCCACTTT	CASRSRWSNSPLHF	TRBV6-4	TRBJ1-6
TGCAGTGCTAGAGGGGGGGGGCTCACAGATACGCAGTATTTT	CSARGGGLTDTQYF	TRBV20-1	TRBJ2-3
TGTGCCAGCAGCCGAGTGGGACAGGGTGGGGGGCAGAATGAGCAGTTCTTC	CASSRVGQGGGQNEQFF	TRBV7-2	TRBJ2-1
TGTGCCAGCAGCTTCGGACGTGGGAGTTGGGACTATGGCTACACCTTC	CASSFGRGSWDYGYTF	TRBV7-2	TRBJ1-2
TGTGCCAGCAGCTTAACCAGGGGGGCGTGGTTCCTATATCAGCCCCAGCATTTT	CASSLTRGAWFLYQPQHF	TRBV7-3	TRBJ1-5
TGTGCCAGCAGCCAAGATGGCAAGACAGCAGATTATCCTTATGGCTACACCTTC	CASSQDGKTADYPYGYTF	TRBV3-1	TRBJ1-2
TGTGCCAGCAGTGAAAACCCGAAATTAGGGACAGGGTCCTATAATTCACCCCTCCACTTT	CASSENPKLGTGSYNSPLHF	TRBV6-4	TRBJ1-6
TGCAGTGCTCGGGTACGGACACAGTCCGCAGATACGCAGTATTTT	CSARVRTQSADTQYF	TRBV20-1	TRBJ2-3
TGCAGTGCCTGTCGGGGTTTTCGGCGTTATTTCGGGGAGCTGTTTTTT	CSACRGFRRYFGELFF	TRBV20-1	TRBJ2-2
TGTGCCAGCCAAAAGGTGGGACTAGCGGGCTCGAACAATGAGCAGTTCTTC	CASQKVGLAGSNNEQFF	TRBV6-4	TRBJ2-1
TGTGCCAGCAGATCTTGCTCCTACGAGCAGTACTTC	CASRSCSYEQYF	TRBV27	TRBJ2-7
TGTGCCAGCTCCCGAGCGGACCACGACAATGAGCAGTTCTTC	CASSRADHDNEQFF	TRBV18	TRBJ2-1
TGTGCCAGCAGCGGTCGGCGCCGGGGGCGACAGAGGGACGAGCAGTACTTC	CASSGRRRGRQRDEQYF	TRBV13	TRBJ2-7
TGCAGCGTTGCTAAGGGGCTACATGGCTACACCTTC	CSVAKGLHGYTF	TRBV29-1	TRBJ1-2
TGCAGTGCTACGGATAGTGGTACTAGCGGGAGGGGGGTAAACACTGAAGCTTTCTTT	CSATDSGTSGRGVNTEAFF	TRBV20-1	TRBJ1-1
TGTGCCAGCAGCTTACCCTCTAGCGGGGAGTTGGGCACAGATACGCAGTATTTT	CASSLPSSGELGTDTQYF	TRBV11-2	TRBJ2-3
TGTGCCAGCAGTAGGACCCCCAGGAATCAGCCCCAGCATTTT	CASSRTPRNQPQHF	TRBV27	TRBJ1-5
TGTGCCAGCAGCCTTTCGGTTTACCTTCAGCCCCAGCATTTT	CASSLSVYLQPQHF	TRBV3-1	TRBJ1-5
TGTGCCACCAGTGATTTGCAAGCTGCACCCCAGGGGGGGTCCCACCCATACTACGAGCAGTACTTC	CATSDLQAAPQGGSHPYYEQYF	TRBV24-1	TRBJ2-7
TGCAGCGTTGACGAGGGAGAACATCAGCCCCAGCATTTT	CSVDEGEHQPQHF	TRBV29-1	TRBJ1-5
TGTGCCAGCAGTTACTATTCCCTGCCACTAAGGAACACTGAAGCTTTCTTT	CASSYYSLPLRNTEAFF	TRBV6-3	TRBJ1-1
TGCAGTGCTAGCATTCCGGGGGAAGGCTATGGCTACACCTTC	CSASIPGEGYGYTF	TRBV20-1	TRBJ1-2
TGCAGTGCTAGCCGGGGCCCTAACTCCTACGAGCAGTACTTC	CSASRGPNSYEQYF	TRBV20-1	TRBJ2-7
TGTGCCATCAACCTGGAGGTCTTGAACACTGAAGCTTTCTTT	CAINLEVLNTEAFF	TRBV19	TRBJ1-1
TGTGCCAGCAGCGGAGCAGGGGGCGGGGACACTGAAGCTTTCTTT	CASSGAGGGDTEAFF	TRBV13	TRBJ1-1
TGTGCCACCAGTGATTTGCTACGGGACTCCTACAATGAGCAGTTCTTC	CATSDLLRDSYNEQFF	TRBV24-1	TRBJ2-1
TGCGCCAGCAGCCTTAGGGAATATCAGCCCCAGCATTTT	CASSLREYQPQHF	TRBV4-3	TRBJ1-5
TGTGCCAGCAGCGTGCGGACAGAGGGTGGCTGGGTCATGAACACTGAAGCTTTCTTT	CASSVRTEGGWVMNTEAFF	TRBV4-2	TRBJ1-1
TGTGCCAGTAGCCACCCCACCTATTCCGGGACAGAACCATCCTACAATGAGCAGTTCTTC	CASSHPTYSGTEPSYNEQFF	TRBV19	TRBJ2-1
TGTGCCAGCAGCCCTCCCCACGTGAACACTGAAGCTTTCTTT	CASSPPHVNTEAFF	TRBV7-8	TRBJ1-1
TGTGCCAGCAGCTTAGGTAACAGGGGACACGTGGAACCGAACACTGAAGCTTTCTTT	CASSLGNRGHVEPNTEAFF	TRBV7-8	TRBJ1-1
TGCAGTGCGAGTAGATTTGACGAAGAGACCCAGTACTTC	CSASRFDEETQYF	TRBV20-1	TRBJ2-5
TGTGCCAGTCGAGGGGGAACGGGCCACGAGCAGTACTTC	CASRGGTGHEQYF	TRBV6-8	TRBJ2-7
TGTGCCAGCACCGGGGGGGGGGGGATCTCCGGGGAGCTGTTTTTT	CASTGGGGISGELFF	TRBV9	TRBJ2-2
TGTGCCAGATCTTCCGCAGGGGGGGCCGGGGGAGATTTTGCCTACGAGCAGTACTTC	CARSSAGGAGGDFAYEQYF	TRBV2	TRBJ2-7
TGTGCCAGCAGCTTGGGGGGGACCGACAGGGCTTCCGGGGAGCTGTTTTTT	CASSLGGTDRASGELFF	TRBV5-4	TRBJ2-2
TGTGCCACCAGTGATCGAGCGCCCGGGGAGCTGTTTTTT	CATSDRAPGELFF	TRBV24-1	TRBJ2-2
TGTGCCATCAGTGAGACACTTTCCCCGGGACAGTGTTCGTCTGGGGCCAACGTCCTGACTTTC	CAISETLSPGQCSSGANVLTF	TRBV10-3	TRBJ2-6
TGTGCCAGCCCGCCCGGGCCTTATAGGGGGGGGGTTGAGACCCAGTACTTC	CASPPGPYRGGVETQYF	TRBV7-8	TRBJ2-5
TGCAGCGTGAGCCCGGCTACACCTAGGGCTGGGGCCAACGTCCTGACTTTC	CSVSPATPRAGANVLTF	TRBV29-1	TRBJ2-6
TGTGCCAGCAGGCCCCCGACAGAACTATCTGGAAACACCATATATTTT	CASRPPTELSGNTIYF	TRBV6-5	TRBJ1-3
TGTGCCAGCAGTTACAGTTGTTTCTACGAGCAGTACTTC	CASSYSCFYEQYF	TRBV6-2	TRBJ2-7
TGCGCCAGCAGCTGTGATATGGCAACTAGCGGGAGCTACAATGAGCAGTTCTTC	CASSCDMATSGSYNEQFF	TRBV5-1	TRBJ2-1
TGTGCCAGTGCCATGTACTACGAGCAGTACTTC	CASAMYYEQYF	TRBV19	TRBJ2-7
TGCGCCAGCAGCCAAAACTTTGAAGCAGAGTACGAGCAGTACTTC	CASSQNFEAEYEQYF	TRBV4-1	TRBJ2-7
TGTGCCAGCAGTAGCGGGGTTTCTGATGAGCAGTTCTTC	CASSSGVSDEQFF	TRBV13	TRBJ2-1
TGTGCCAGCAGCCACCTAGGAAGACTGCCGCAGTTCTTC	CASSHLGRLPQFF	TRBV14	TRBJ2-1
TGCGCCAGCAGCTACACCATCCCAGACTATGGCTACACCTTC	CASSYTIPDYGYTF	TRBV5-1	TRBJ1-2
TGTGCCAGCAGCCAAGCCTTACTAGCGGACAGCACAGATACGCAGTATTTT	CASSQALLADSTDTQYF	TRBV3-1	TRBJ2-3
TGTGCCAGCAGTTACTCGCCGGTAGGCCGACGGCCTGAAGCTTTCTTT	CASSYSPVGRRPEAFF	TRBV6-5	TRBJ1-1
TGTGCCAGCAGTGCAATACAGGGGGTCCTCCGTAGCAATCAGCCCCAGCATTTT	CASSAIQGVLRSNQPQHF	TRBV27	TRBJ1-5
TGCGCCAGCAGAGACAGGGGGTATGGCTACACCTTC	CASRDRGYGYTF	TRBV4-1	TRBJ1-2
TGTGCCAGCAGCTGCCGTAGCGGGAGGGAAACCTACGAGCAGTACTTC	CASSCRSGRETYEQYF	TRBV7-2	TRBJ2-7
TGTGCCAGCAGTTGTACCGGGACAGGGACAGAGACCCAGTACTTC	CASSCTGTGTETQYF	TRBV12-3	TRBJ2-5
TGTGCCAGCAGCTTAGTTTCTTGGGGGAAGAAAAATCAGCCCCAGCATTTT	CASSLVSWGKKNQPQHF	TRBV11-2	TRBJ1-5
TGTGCCAGCAGTTTATACTTCCAATTCTACGAGCAGTACTTC	CASSLYFQFYEQYF	TRBV12-3	TRBJ2-7
TGCAGCGTTGGGTCCAAGGGTCAAGCTAATGAAAAACTGTTTTTT	CSVGSKGQANEKLFF	TRBV29-1	TRBJ1-4
TGCAGCGTTGAAGAGGTCCATCTCTCCTACGAGCAGTACTTC	CSVEEVHLSYEQYF	TRBV29-1	TRBJ2-7
TGTGCCAGCAGAAGGAGGCACGGACTAGCGTACTCTAGAAATGAGCAGTTCTTC	CASRRRHGLAYSRNEQFF	TRBV14	TRBJ2-1
TGTGCCAGCAGCTTGGGACAGGGGGGAGTTCAGCCCCAGCATTTT	CASSLGQGGVQPQHF	TRBV5-8	TRBJ1-5
TGTGCCAGTAGCGGACAGGGGGGGGCTTTCTTT	CASSGQGGAFF	TRBV19	TRBJ1-1
TGTGCCACCAGTGATTTCGGTTCGAACAAACAGGGCAAGGCTGAAAAACTGTTTTTT	CATSDFGSNKQGKAEKLFF	TRBV24-1	TRBJ1-4
TGTGCCAGCAGCGCGACAGGTCAGCCTTGGGTCACAGATACGCAGTATTTT	CASSATGQPWVTDTQYF	TRBV5-8	TRBJ2-3
TGTGCCAGTAGTATAGCCCCCGGGACAGGGGGGATGGACACTGAAGCTTTCTTT	CASSIAPGTGGMDTEAFF	TRBV19	TRBJ1-1
TGCGCCGAAAGTCATACGGGGGAGGTTGGGAGCACAGATACGCAGTATTTT	CAESHTGEVGSTDTQYF	TRBV10-2	TRBJ2-3
TGCGCCAGCAGCTTGTCTAAGGCCAGACCCTTCAGGCGAGGCATTCAACACGAGCAGTACTTC	CASSLSKARPFRRGIQHEQYF	TRBV5-1	TRBJ2-7
TGTGCCAGCAGCCACACGGGGGATAACACTGAAGCTTTCTTT	CASSHTGDNTEAFF	TRBV14	TRBJ1-1
TGTGCCAGCAGCCCTCAGACTAGCGGTCGGGCCTACGAGCAGTACTTC	CASSPQTSGRAYEQYF	TRBV5-5	TRBJ2-7
TGTGCCAGCAGCCAAGACTGGAGGCATCCCAAGGGGGAGCTGTTTTTT	CASSQDWRHPKGELFF	TRBV14	TRBJ2-2
TGTGCCAGCAGCGACGGACGGTCCTACGAGCAGTACTTC	CASSDGRSYEQYF	TRBV7-9	TRBJ2-7
TGTGCCAGCAGCCCCTCCGGAGGAAAGGTCAAAAACATTCAGTACTTC	CASSPSGGKVKNIQYF	TRBV7-9	TRBJ2-4
TGTGCCATGTTGAGGCCGACTGAAGCTTTCTTT	CAMLRPTEAFF	TRBV11-3	TRBJ1-1
TGTGCCAGCAGCGTCTGGGACAGAGACTCCTACAATGAGCAGTTCTTC	CASSVWDRDSYNEQFF	TRBV14	TRBJ2-1
TGCGCCAGCAGAGCACAGGGGGTTTACGAGCAGTACTTC	CASRAQGVYEQYF	TRBV10-2	TRBJ2-7
TGCAGTGCTAGAGACAGAGGTTCCTACGAGCAGTACTTC	CSARDRGSYEQYF	TRBV20-1	TRBJ2-7
TGTGCCAGCAGTTACCACCAAGTCAAGACAGGGGCTCCGTACTATGGCTACACCTTC	CASSYHQVKTGAPYYGYTF	TRBV6-5	TRBJ1-2
TGTGCCAGTGATGGCTCCCCGGTTCAAGAGACCCAGTACTTC	CASDGSPVQETQYF	TRBV19	TRBJ2-5
TGTGCCAGCAGCGGCAAAAGGACAGGGGGCGGAGCGAACACCGGGGAGCTGTTTTTT	CASSGKRTGGGANTGELFF	TRBV9	TRBJ2-2
TGTGCCAGCAGCTTGAGGTCGGCAGATACGCAGTATTTT	CASSLRSADTQYF	TRBV11-2	TRBJ2-3
TGTGCCAGCCCGGGGACTAGCGGGGACAATGAGCAGTTCTTC	CASPGTSGDNEQFF	TRBV14	TRBJ2-1
TGCGCCAGCTTGGGGGTAGGTGATCAGCCCCAGCATTTT	CASLGVGDQPQHF	TRBV10-2	TRBJ1-5
TGTGCCAGCAGGGGGACCGACTCAAATCAGCCCCAGCATTTT	CASRGTDSNQPQHF	TRBV2	TRBJ1-5
TGTGCCAGCAGTTACCTTGGTAGGAAGGTCTATAGACAGGGGAATGGGGGCTACACCTTC	CASSYLGRKVYRQGNGGYTF	TRBV6-3	TRBJ1-2
TGTGCCAGCAGACGCGGACCAAACAATCACGCGGAGATTAGGCGTAGGGATGAGCAGTTCTTC	CASRRGPNNHAEIRRRDEQFF	TRBV27	TRBJ2-1
TGTGCCAGCACATCAAGGGAGTCGGAGGGAAACACCATATATTTT	CASTSRESEGNTIYF	TRBV6-5	TRBJ1-3
TGCGCCAGCAGCTGCTCGGACAGGGGGAAGAATAGAGGGTGTACGACCCAGCATTTT	CASSCSDRGKNRGCTTQHF	TRBV5-1	TRBJ1-5
TGTGCCAGCAGCTTTCCGCCGAAACATTCCGGGACGGAGCAGTACTTC	CASSFPPKHSGTEQYF	TRBV11-3	TRBJ2-7
TGTGCCAGCAGCCAAAAGGTCGACCCTCAGCCCCAGCATTTT	CASSQKVDPQPQHF	TRBV14	TRBJ1-5
TGTGCCAGCAGCTTTGCACCCGGAGGGAAAGAGACCCAGTACTTC	CASSFAPGGKETQYF	TRBV11-2	TRBJ2-5
TGCAGCGTTGCAAACAGGGAGCGGGTTAACACTGAAGCTTTCTTT	CSVANRERVNTEAFF	TRBV29-1	TRBJ1-1
TGCGCCAGTCCCGACAGGGTCAATCAGCCCCAGCATTTT	CASPDRVNQPQHF	TRBV5-1	TRBJ1-5
TGTGCCAGCTCACGATGGCACAGAGGCTACACCTTC	CASSRWHRGYTF	TRBV18	TRBJ1-2
TGTGCCAGCAGCCCAGGGGGGGGGCACGAGCAGTACTTC	CASSPGGGHEQYF	TRBV3-1	TRBJ2-7
TGTGCCAGCAGCGGGACAGGGAGGACTAAGCCCCAGCATTTT	CASSGTGRTKPQHF	TRBV7-9	TRBJ1-5
TGTGCCTGGAGCCTCGGCCCAGGGTATAGCAATCAGCCCCAGCATTTT	CAWSLGPGYSNQPQHF	TRBV30	TRBJ1-5
TGTGCCACCAGCTCCGAACGAACAGATACGCAGTATTTT	CATSSERTDTQYF	TRBV15	TRBJ2-3
TGCAGTTCCAGGGGGCCAGGCTACGAGCAGTACTTC	CSSRGPGYEQYF	TRBV20-1	TRBJ2-7
TGTGCCAGCATTCAGGGACAGGGGAGGGCGAACACCGGGGAGCTGTTTTTT	CASIQGQGRANTGELFF	TRBV27	TRBJ2-2
TGTGCCAGCAGCTCCCCAGGCGTAGCCAAAAACATTCAGTACTTC	CASSSPGVAKNIQYF	TRBV9	TRBJ2-4
TGTGCCAGCAGTTACCGGGACGGAAAGGAGACCCAGTACTTC	CASSYRDGKETQYF	TRBV6-1	TRBJ2-5
TGCGCCAGCAGCTTGGAGTCTGGGACGAGGGGCGCCAAACAGCCCCAGCATTTT	CASSLESGTRGAKQPQHF	TRBV5-1	TRBJ1-5
TGTGCCAGCTCACAGTCGGGACAGATAGGGGCCCCTAACTATGGCTACACCTTC	CASSQSGQIGAPNYGYTF	TRBV18	TRBJ1-2
TGTGCCTGGAGTGTACGGCTGGACTTCCTTATCACTCCATGCAATCAGCCCCAGCATTTT	CAWSVRLDFLITPCNQPQHF	TRBV30	TRBJ1-5
TGTCGCTATGCAGCAAACATTCAGTACTTC	CRYAANIQYF	TRBV27	TRBJ2-4
TGTGCCAGCAGCCAAGAGACCTCTAAAAGCCGTTCGGGAGGCACAGATACGCAGTATTTT	CASSQETSKSRSGGTDTQYF	TRBV14	TRBJ2-3
TGTGCCAGCAGCTCCGACAGACAGGAAAAACTGTTTTTT	CASSSDRQEKLFF	TRBV6-5	TRBJ1-4
TGTGCCAGCAGTGATCCCTTTCGGGACAGGGGCTACGAGCAGTACTTC	CASSDPFRDRGYEQYF	TRBV2	TRBJ2-7
TGTGCCAGCAGTGCAGAGCCGGGCCACCAGCAGGACCCTAATGAAAAACTGTTTTTT	CASSAEPGHQQDPNEKLFF	TRBV6-6	TRBJ1-4
TGTGCCAGCAGCGGAGTGACCGGGGAGCTGTTTTTT	CASSGVTGELFF	TRBV7-3	TRBJ2-2
TGTGCCAGCAGCCAAGTACGGACAGGGTATGGCTACACCTTC	CASSQVRTGYGYTF	TRBV14	TRBJ1-2
TGTGCCAGCAGCGAACTGAAACAGCCCCAGCATTTT	CASSELKQPQHF	TRBV6-4	TRBJ1-5
TGTGCCTACTGGGGGGTTAGCTCCTACAATGAGCAGTTCTTC	CAYWGVSSYNEQFF	TRBV6-1	TRBJ2-1
TGTGCCAGCAGCGGGGGAGATAAGCCTTACGAGCAGTACTTC	CASSGGDKPYEQYF	TRBV9	TRBJ2-7
TGTGCCAGTAGTATTTACGTGGGGGGTAGCTCCTACAATGAGCAGTTCTTC	CASSIYVGGSSYNEQFF	TRBV19	TRBJ2-1
TGCAGCGTGGTTAAACTAGCGGGAGGGGAGCGGGTTGAGACCCAGTACTTC	CSVVKLAGGERVETQYF	TRBV29-1	TRBJ2-5
TGTGCCAGCAGCAGTACCAGGAACTATGGCTACACCTTC	CASSSTRNYGYTF	TRBV7-3	TRBJ1-2
TGTGCCAGCTCTACTAAAGAGACCCAGTACTTC	CASSTKETQYF	TRBV6-4	TRBJ2-5
TGTGCCAGCAGCCAAGTGGACAGGGCTACTGGGGCCAACGTCCTGACTTTC	CASSQVDRATGANVLTF	TRBV14	TRBJ2-6
TGTGCCACCAGTCCGGGGGCGAAAGGGTGCTATGGCTACACCTTC	CATSPGAKGCYGYTF	TRBV24-1	TRBJ1-2
TGTGCCAGCAGCATGACTATCACCGGGGAGCTGTTTTTT	CASSMTITGELFF	TRBV6-4	TRBJ2-2
TGTGCCAGCAGCTCACAGTACTTCGAGCAGTACTTC	CASSSQYFEQYF	TRBV11-3	TRBJ2-7
TGCAGTGCTCCCATTGTGGCAGGCTACGAGCAGTACTTC	CSAPIVAGYEQYF	TRBV20-1	TRBJ2-7
TGTGCCAGCAGCTGGGACGTATACTTCTCTGGAAACACCATATATTTT	CASSWDVYFSGNTIYF	TRBV11-3	TRBJ1-3
TGCGCAAGGGGGGGGCCCCAGTACTTC	CARGGPQYF	TRBV5-1	TRBJ2-5
TGTGCCAGCAGCGCACCCCGGACTTTCGAGCAGTACTTC	CASSAPRTFEQYF	TRBV9	TRBJ2-7
TGTGCCAGCAGCATTGGGACAGTACAAACCGGGGAGCTGTTTTTT	CASSIGTVQTGELFF	TRBV7-9	TRBJ2-2
TGTGCCAGCGGCGGACAGGGGACCACTGAAGCTTTCTTT	CASGGQGTTEAFF	TRBV9	TRBJ1-1
TGTGCCAGCAGTTACTCAGAACGTAAAGGGGGAATCTCACTCGGGGAGCTGTTTTTT	CASSYSERKGGISLGELFF	TRBV6-5	TRBJ2-2
TGTGCCAGCAGAAAGGGACTCAGAAAAGAGACCCAGTACTTC	CASRKGLRKETQYF	TRBV7-4	TRBJ2-5
TGCGCCAGCAGCCCAGCGGGACCGCGACCCACTTCTGGAAACACCATATATTTT	CASSPAGPRPTSGNTIYF	TRBV5-1	TRBJ1-3
TGTGCCAGCAGCAGGACCCCTTATGGCTACACCTTC	CASSRTPYGYTF	TRBV13	TRBJ1-2
TGCGCCAGCAGCTTGTCAGAATCCAGACTCCCTGAAGCTTTCTTT	CASSLSESRLPEAFF	TRBV5-1	TRBJ1-1
TGCGCCAGCAGACGGGGGGGGGGCAATCAGCCCCAGCATTTT	CASRRGGGNQPQHF	TRBV5-1	TRBJ1-5
TGTGCCAGCCGACCGGGGGGGGAAGGCTCCTACGAGCAGTACTTC	CASRPGGEGSYEQYF	TRBV12-3	TRBJ2-7
TGTGCCAGTACGTCCAGGACAGACGAGCAGTACTTC	CASTSRTDEQYF	TRBV19	TRBJ2-7
TGTGCCAGCAGCGTAGCTCCCAAACGGGACTACACCGGGGAGCTGTTTTTT	CASSVAPKRDYTGELFF	TRBV9	TRBJ2-2
TGCGCCAGCAGCTATACTAGCGGGAGTTTCGGGGATACGCAGTATTTT	CASSYTSGSFGDTQYF	TRBV5-1	TRBJ2-3
TGTGCCAGCAGCGGGCCCTTCGGCACCGGGACTAGCTTTTATTTGAGCAGGGAGCAGTACTTC	CASSGPFGTGTSFYLSREQYF	TRBV11-2	TRBJ2-7
TGTGCCAGCAGAGTCGTACAGGGTTCTAATAGCAATCAGCCCCAGCATTTT	CASRVVQGSNSNQPQHF	TRBV12-3	TRBJ1-5
TGTGCCAGCGGCGGGACTAGGGTTTACATTCAGTACTTC	CASGGTRVYIQYF	TRBV27	TRBJ2-4
TGTGCCAGCAGTTCCTTCCCGGGACAGGGGTGTAGCACAGATACGCAGTATTTT	CASSSFPGQGCSTDTQYF	TRBV6-9	TRBJ2-3
TGTGCCAGCAGCGTAGAGGGCCCTAGCAATCAGCCCCAGCATTTT	CASSVEGPSNQPQHF	TRBV9	TRBJ1-5
TGTGCCAGCAGAGGCAGGAACCTTGGGGGCGAGCAGTACTTC	CASRGRNLGGEQYF	TRBV25-1	TRBJ2-7
TGTCTTTGCCCGGGACAGGGACCATACGAGCAGTACTTC	CLCPGQGPYEQYF	TRBV10-3	TRBJ2-7
TGCGCCAGCAGCCAAGAGCAAACAGGCGAGCCCCAGCATTTT	CASSQEQTGEPQHF	TRBV4-3	TRBJ1-5
TGTGCCACCGGCCCAGTGCGGGGCGGCTACACCTTC	CATGPVRGGYTF	TRBV6-6	TRBJ1-2
TGTGCCAGCAGAAGCCAACGCCGTGGGGGCGGGGCCAATCAGCCCCAGCATTTT	CASRSQRRGGGANQPQHF	TRBV9	TRBJ1-5
TGTGCCAGCTCAGGGGTCTGTGAAAAACTGTTTTTT	CASSGVCEKLFF	TRBV13	TRBJ1-4
TGTGCCAGCAGTTTAAAGTGGGGAGAGCAGTACTTC	CASSLKWGEQYF	TRBV12-4	TRBJ2-7
TGTGCCAGCAGTTCAATCCGAAAAGCTTTCTTT	CASSSIRKAFF	TRBV27	TRBJ1-1
TGTGCATCCTTGTGCGAGCAGTTCTTC	CASLCEQFF	TRBV24-1	TRBJ2-1
TGCAGTGCTAGTAGATTGGGGGGCCGAGAGACCCAGTACTTC	CSASRLGGRETQYF	TRBV20-1	TRBJ2-5
TGTGCCAGCAGCTTGCAAGGGCGTGAGGGTGAGCAGTTCTTC	CASSLQGREGEQFF	TRBV7-3	TRBJ2-1
TGTGCCAGCAGCTTACGGCCCCAGCGGGAATTGAAGGGGGATTCACCCCTCCACTTT	CASSLRPQRELKGDSPLHF	TRBV7-4	TRBJ1-6
TGTGCCAGCAGCCAACGGTTATGGGCCGTTCCTATCCAGTCACCCCTCCACTTT	CASSQRLWAVPIQSPLHF	TRBV4-2	TRBJ1-6
TGTGCCAGCAACAGGGGGGCCTACGAGCAGTACTTC	CASNRGAYEQYF	TRBV7-9	TRBJ2-7
TGTGCCAGCAGTACGAAACCTATAGGCCCGAATGAGCAGTTCTTC	CASSTKPIGPNEQFF	TRBV6-8	TRBJ2-1
TGTGCCAGCAGCATCTTCTCCGCAGGGGACGGGCAGAGCACAGATACGCAGTATTTT	CASSIFSAGDGQSTDTQYF	TRBV13	TRBJ2-3
TGTGCCAGCAGTTACTCGAGAGGTCCTAATGGGACGGTTGGATACTTC	CASSYSRGPNGTVGYF	TRBV6-5	TRBJ2-5
TGTGCCAGTAGTATAGTCCCTTCCAGGAGGAATTCACCCCTCCACTTT	CASSIVPSRRNSPLHF	TRBV19	TRBJ1-6
TGTGCCACGGGACGTAAACTCATTCAGTACTTC	CATGRKLIQYF	TRBV6-6	TRBJ2-4
TGTGCCAGCAGCCCTGGCGCCTACGAGCAGTACTTC	CASSPGAYEQYF	TRBV5-4	TRBJ2-7
TGCGCCAGCAGCCTTGAGGCGCCGGATGAAAAACTGTTTTTT	CASSLEAPDEKLFF	TRBV5-1	TRBJ1-4
TGTGCCAGCAGACTGTACCGGAGCGAGGGCTACACCTTC	CASRLYRSEGYTF	TRBV12-3	TRBJ1-2
TGTGCCAGCAGCTCACCGGGACTAGCTGTGCCTAGCACAGATACGCAGTATTTT	CASSSPGLAVPSTDTQYF	TRBV13	TRBJ2-3
TGTGCCACCAGCAGAGAGAGCCGGGACAGGGGCCGGGGAAAGTATCAGCCCCAGCATTTT	CATSRESRDRGRGKYQPQHF	TRBV15	TRBJ1-5
TGTGCCAGCAGCTTATCGAGAAACAGGGCCTCCTACAATGAGCAGTTCTTC	CASSLSRNRASYNEQFF	TRBV7-2	TRBJ2-1
TGCGCCAGCAGATTATGGACCCCCAATCAGCCCCAGCATTTT	CASRLWTPNQPQHF	TRBV5-1	TRBJ1-5
TGCGCCAGCAGTGAGTCGACTCTCCGTGGGGAAGGGGCCGGGGAGCTGTTTTTT	CASSESTLRGEGAGELFF	TRBV10-1	TRBJ2-2
TGTGCCAGCAGCTTGGCACTGTCTTCTGGCTACACCTTC	CASSLALSSGYTF	TRBV5-6	TRBJ1-2
TGTGCCAGCAGTTCCAAGGAGCCCTCTCGTGTATCTCTTGAGACCCAGTACTTC	CASSSKEPSRVSLETQYF	TRBV6-1	TRBJ2-5
TGTGCCACCAGCAGAGCATCTAGCGGTAGGTTAGCTGCCTACGAGCAGTACTTC	CATSRASSGRLAAYEQYF	TRBV15	TRBJ2-7
TGCGGCCCAACGTACGAGCAGTACTTC	CGPTYEQYF	TRBV20-1	TRBJ2-7
TGTGCCAGCAGTTTACCCGGGGACGTTAAGAGCCGGCCTCAAGACTACGAAGAAAGGGACACTGAAGCTTTCTTT	CASSLPGDVKSRPQDYEERDTEAFF	TRBV28	TRBJ1-1
TGCAGTGCTAGAAAGGTTGGGGGCGTACGTTCTAATGAAAAACTGTTTTTT	CSARKVGGVRSNEKLFF	TRBV20-1	TRBJ1-4
TGCGCCAGCAGCTTACGGTTTCCCTATCGACAGGGGGCTGGCTACACCTTC	CASSLRFPYRQGAGYTF	TRBV5-1	TRBJ1-2
TGTGCCAGCAGGTCCAGTTCCGAGACAAGTCAGCCCCAGCATTTT	CASRSSSETSQPQHF	TRBV12-4	TRBJ1-5
TGCGCCAGACCTGACGGTGAGCAGCCCCAGCATTTT	CARPDGEQPQHF	TRBV10-1	TRBJ1-5
TGTGCCAGCAGTGAAGAAAGGGGGGGCAGCACAGATACGCAGTATTTT	CASSEERGGSTDTQYF	TRBV6-1	TRBJ2-3
TGTGCCAGGCGGGAGAAAGGGGAGACCCAGTACTTC	CARREKGETQYF	TRBV12-3	TRBJ2-5
TGTGCCTGGAGTGTATACGACAGGTCCTACGAGCAGTACTTC	CAWSVYDRSYEQYF	TRBV30	TRBJ2-7
TGTGCCAGCAGCGCGACAGGGGGGGCAAAGGACACTGAAGCTTTCTTT	CASSATGGAKDTEAFF	TRBV7-3	TRBJ1-1
TGTGCCAGCAGTGAATTCTTGGAAGCTTTCTTT	CASSEFLEAFF	TRBV6-4	TRBJ1-1
TGTGCCAGCAGCGGGGCTCGGAGGACAGGGAGCAATCAGCCCCAGCATTTT	CASSGARRTGSNQPQHF	TRBV5-4	TRBJ1-5
TGTGCCAGCACGGTGGGACTAGCGGAAGGACCCGAGACCCAGTACTTC	CASTVGLAEGPETQYF	TRBV27	TRBJ2-5
TGTGCCAGCTACCGGGACAGGGGGATCCACTCGGTCTACACTGAAGCTTTCTTT	CASYRDRGIHSVYTEAFF	TRBV28	TRBJ1-1
TGTGCCAGCAGTTACTCGTTTTACCCGACAGGGGCGGAGCAGTACTTC	CASSYSFYPTGAEQYF	TRBV6-5	TRBJ2-7
TGTGCCATTACTGGACTAGCGGGAAGCAATGAGCAGTTCTTC	CAITGLAGSNEQFF	TRBV6-6	TRBJ2-1
TGCGCCAGCAGTGAGTTTAATTCTCGGGGTTCGTCACCCCTCCACTTT	CASSEFNSRGSSPLHF	TRBV10-1	TRBJ1-6
TGTGCCACCCGGACAGGGATGCCCGTTCCCCCCTCTGGGGCCAACGTCCTGACTTTC	CATRTGMPVPPSGANVLTF	TRBV24-1	TRBJ2-6
TGTGCCAGCAGCCCAGTGGGACTCGTAGATACGCAGTATTTT	CASSPVGLVDTQYF	TRBV7-3	TRBJ2-3
TGTGCCAGCAGTGAATTAAAAAAAGGGACTGGGGAGTACTTC	CASSELKKGTGEYF	TRBV25-1	TRBJ2-7
TGTGCCAGCAGCCAAGATGGCTCTCACTTCTCCTACGAGCAGTACTTC	CASSQDGSHFSYEQYF	TRBV14	TRBJ2-7
TGTGCCAGCAATCCACTAGAGGGCGATGAGCAGTTCTTC	CASNPLEGDEQFF	TRBV9	TRBJ2-1
TGTGCCACCAGTGATTCGGGGGGGTTTGTCAGGAATGAGCAGTTCTTC	CATSDSGGFVRNEQFF	TRBV24-1	TRBJ2-1
TGCGCCAGCAGCCGAACGGGACACTACGAGCAGTACTTC	CASSRTGHYEQYF	TRBV5-1	TRBJ2-7
TGTGCCACAAGAGACACTAGCGGGGGGGATTGGAATGAGCAGTTCTTC	CATRDTSGGDWNEQFF	TRBV24-1	TRBJ2-1
TGTGCCAGCAGCCAATGCCGAGGGAGACAGGGTTCCAATCAGCCCCAGCATTTT	CASSQCRGRQGSNQPQHF	TRBV14	TRBJ1-5
TGTGCCAGTAGTATGGGGGGGGGGTACTATGGCTACACCTTC	CASSMGGGYYGYTF	TRBV19	TRBJ1-2
TGTGCCAGCAGCCAACTCGCCCTCCGGGGCGATAGCAATCAGCCCCAGCATTTT	CASSQLALRGDSNQPQHF	TRBV3-1	TRBJ1-5
TGTGCCAGCATAGACAGGGAGCTAAGGAACTATGGCTACACCTTC	CASIDRELRNYGYTF	TRBV19	TRBJ1-2
TGTGCCAGCACCCGGGACATGGGTAATTCACCCCTCCACTTT	CASTRDMGNSPLHF	TRBV28	TRBJ1-6
TGTGCCAGCAGGGTCAGGGGGAGGAATAATTCACCCCTCCACTTT	CASRVRGRNNSPLHF	TRBV27	TRBJ1-6
TGCAGTCTAGTTCGGGGAACCTCGATGGGCGAGCAGTACTTC	CSLVRGTSMGEQYF	TRBV20-1	TRBJ2-7
TGTGCCAGCAGTTCTTGGTCCAAGCGGGAGGGATCGCAGTATTTT	CASSSWSKREGSQYF	TRBV6-2	TRBJ2-3
TGTGCCAGAAAGGGAGGCTACACCTTC	CARKGGYTF	TRBV19	TRBJ1-2
TGTGCCTGGAGTGTACGGGGGACCGTACGAGGGGGCAATGAGCAGTTCTTC	CAWSVRGTVRGGNEQFF	TRBV30	TRBJ2-1
TGTGCCAGCAGTTGTAGTGGCCCAGGGATAACTGTGCGCAATCAGCCCCAGCATTTT	CASSCSGPGITVRNQPQHF	TRBV27	TRBJ1-5
TGTGCCAGCAGCCTTCCACTTCCATTGTTATCCGGGACAGGGACGCCTAAAGGAAACACCATATATTTT	CASSLPLPLLSGTGTPKGNTIYF	TRBV3-1	TRBJ1-3
TGTGCCAGCAGTTGGGACAGGGGCAGAGACGAGCAGTACTTC	CASSWDRGRDEQYF	TRBV27	TRBJ2-7
TGTGCCCTTAAGGGGAACTATGGCTACACCTTC	CALKGNYGYTF	TRBV30	TRBJ1-2
TGTGCCAGCAGCCCGACACCGACAGTCAGTGAAAAACTGTTTTTT	CASSPTPTVSEKLFF	TRBV7-4	TRBJ1-4
TGTGCCAGCAGCAGGGGACAGGGGAGACACAATGAGCAGTTCTTC	CASSRGQGRHNEQFF	TRBV7-8	TRBJ2-1
TGTGCCAGCAGCTACACAGAGTTGGACAGGGATCGCAATCAGCCCCAGCATTTT	CASSYTELDRDRNQPQHF	TRBV11-2	TRBJ1-5
TGCGCCAGCAGCCAAGATGACGGACAGCAGCCCCAGCATTTT	CASSQDDGQQPQHF	TRBV4-3	TRBJ1-5
TGTGCCAGCAGCTTAAGGAACGTCCGATTCCGGAAGACTAGCGGGAGGAAGACTGAAGCTTTCTTT	CASSLRNVRFRKTSGRKTEAFF	TRBV11-2	TRBJ1-1
TGTGCCAGCAGTCACAGGTGGGGCCACGAGCAGTACTTC	CASSHRWGHEQYF	TRBV28	TRBJ2-7
TGTGCCAGCACCAAGGGGGGGGGAGGGGAGACCCAGTACTTC	CASTKGGGGETQYF	TRBV13	TRBJ2-5
TGTGCCAGCAGTGAAGCGCAACTCCGGGACCGTATGCGTAGCAATCAGCCCCAGCATTTT	CASSEAQLRDRMRSNQPQHF	TRBV6-1	TRBJ1-5
TGTGCCAGCCCGCCGCTAGCGTGCGGAGATACGCAGTATTTT	CASPPLACGDTQYF	TRBV6-2	TRBJ2-3
TGTGATACTCCTGGGGGCCAGGAAGGCACCGGGGAGCTGTTTTTT	CDTPGGQEGTGELFF	TRBV9	TRBJ2-2
TGTGCCAGCAGCGACAGGGCGGGGGGGGAGCTGTTTTTT	CASSDRAGGELFF	TRBV14	TRBJ2-2
TGTGCCAGCAGCCAGAGCCGGATTAACTATGGCTACACCTTC	CASSQSRINYGYTF	TRBV6-2	TRBJ1-2
TGCAGTGCAAAGGGGACCGACGAGCAGTACTTC	CSAKGTDEQYF	TRBV20-1	TRBJ2-7
TGTGCCAGCAGTGGGGGGGTAGACACCGGGGAGCTGTTTTTT	CASSGGVDTGELFF	TRBV12-3	TRBJ2-2
TGCAGTAGGTGGGCCCGGGGTAGGAACACTGAAGCTTTCTTT	CSRWARGRNTEAFF	TRBV20-1	TRBJ1-1
TGTCCTGAGGACAAGGGCACAGATACGCAGTATTTT	CPEDKGTDTQYF	TRBV20-1	TRBJ2-3
TGTGCCACCACTACTAGCGGCTCCTACGAGCAGTACTTC	CATTTSGSYEQYF	TRBV24-1	TRBJ2-7
TGCAGCGTAGGAAGGGGTTTCACAGATACGCAGTATTTT	CSVGRGFTDTQYF	TRBV29-1	TRBJ2-3
TGTGCCAGCAGGTGGGGGTCAGGGGGCTCCTACGAGCAGTACTTC	CASRWGSGGSYEQYF	TRBV12-4	TRBJ2-7
TGTGCCTGGAGTGTACAGGGAATGGACAGGAGGCCGGATACGCAGTATTTT	CAWSVQGMDRRPDTQYF	TRBV30	TRBJ2-3
TGTGCCACCAGCAGAGATGCCGGGACAGGGGTCCTATCAACTAATGAAAAACTGTTTTTT	CATSRDAGTGVLSTNEKLFF	TRBV15	TRBJ1-4
TGTGCCAGCAGAGAAAGGATTACCCTTACCGGGGAGCTGTTTTTT	CASRERITLTGELFF	TRBV6-5	TRBJ2-2
TGTGCCAGCAGATTCCAGGGGACTAGCGGGGAGACCCAGTACTTC	CASRFQGTSGETQYF	TRBV6-1	TRBJ2-5
TGTGCCAGCAGCCTATTACAACGAGGGACGCTGTTTTTT	CASSLLQRGTLFF	TRBV7-3	TRBJ1-4
TGTGCCAGCAGTTACCTAGGGCCAGGAGAGACCCAGTACTTC	CASSYLGPGETQYF	TRBV6-5	TRBJ2-5
TGTGCCAGCAGCCTGTCCGACAGCCCTTACTACGAGCAGTACTTC	CASSLSDSPYYEQYF	TRBV7-3	TRBJ2-7
TGTGCCATCAGTTACCGGGACGAGGATGGCTACACCTTC	CAISYRDEDGYTF	TRBV10-3	TRBJ1-2
TGCGCCAGCAGCCCCTTCCGTATAACTAACTATGGCTACACCTTC	CASSPFRITNYGYTF	TRBV4-1	TRBJ1-2
TGTGCCAGCAGCTTGGCTCGACAGGGGGTTCTGCTACAGGACTACGAGCAGTACTTC	CASSLARQGVLLQDYEQYF	TRBV5-4	TRBJ2-7
TGTGCCAGCAGCTTTCTTGCCAAAAACATACTTCCCCAGGGGAGGTCCCTCTATCAGCCCCAGCATTTT	CASSFLAKNILPQGRSLYQPQHF	TRBV5-6	TRBJ1-5
TGTGCCAGCAGTTCCCGGACTACAGCCGGGGAGCTGTTTTTT	CASSSRTTAGELFF	TRBV12-4	TRBJ2-2
TGTGCCAGCAGTGACTCGCGGACAGGGCGGAGGACGGCTGAAGCTTTCTTT	CASSDSRTGRRTAEAFF	TRBV6-4	TRBJ1-1
TGTGCCAGCAGCACCCCGGGACTAGCGGGGGGGCGTATCCGGCAAGAGACCCAGTACTTC	CASSTPGLAGGRIRQETQYF	TRBV5-5	TRBJ2-5
TGCGCCAGCAGCGTTAGGGATTCGCCTGTCAATCAGCCCCAGCATTTT	CASSVRDSPVNQPQHF	TRBV5-1	TRBJ1-5
TGTGCCAGCAGGGTCACAGGGGCTAATGAAAAACTGTTTTTT	CASRVTGANEKLFF	TRBV6-5	TRBJ1-4
TGTGCCAGCAGCGGGACTAGAGACTCCTACGAGCAGTACTTC	CASSGTRDSYEQYF	TRBV9	TRBJ2-7
TGCGCCAGCAGCTTGGGGGGCGGAATAGCCTTCGAGACCCAGTACTTC	CASSLGGGIAFETQYF	TRBV5-1	TRBJ2-5
TGTGCTAGTGGTCCTTCCTGTCGGGATGAGCAGTTCTTC	CASGPSCRDEQFF	TRBV12-5	TRBJ2-1
TGCGCCAGCAGCTTGGCCACAGGGGACCGCTCCTACGAGCAGTACTTC	CASSLATGDRSYEQYF	TRBV5-1	TRBJ2-7
TGTGCCACCAGTGATTCCAAAAGAAAGGGAAGGGACTTTTCTAGCACAGATACGCAGTATTTT	CATSDSKRKGRDFSSTDTQYF	TRBV24-1	TRBJ2-3
TGTGCCAGCAGCACCCGAGGGGGTACGAGGAACACTGAAGCTTTCTTT	CASSTRGGTRNTEAFF	TRBV28	TRBJ1-1
TGTGCCAGCAGCGAACCCGGGGGTAAAAACATTCAGTACTTC	CASSEPGGKNIQYF	TRBV9	TRBJ2-4
TGTGCCAGCAGCCCGGCCTCGGGACAGGGGGAGGAGAACACCGGGGAGCTGTTTTTT	CASSPASGQGEENTGELFF	TRBV7-9	TRBJ2-2
TGTGCCAGCAGCTTTTCAGGTCCCTCTGGAAACACCATATATTTT	CASSFSGPSGNTIYF	TRBV9	TRBJ1-3
TGCGCCAGCAGCGCAGGGAGGGTTCCGCCTCAGAACACCGGGGAGCTGTTTTTT	CASSAGRVPPQNTGELFF	TRBV4-3	TRBJ2-2
TGTGCCAGCAGTGGGCGGATGAGGAGCTCCTACGAGCAGTACTTC	CASSGRMRSSYEQYF	TRBV27	TRBJ2-7
TGTGCCAGCAGACAGGGATTAGAGCAGTACTTC	CASRQGLEQYF	TRBV7-2	TRBJ2-7
TGCGCCATCTCCCCGGCCTCCTACAATGAGCAGTTCTTC	CAISPASYNEQFF	TRBV10-1	TRBJ2-1
TGCGCCAGCAGTGCCCGTTTTCAGACAGGGATTGAGACCCAGTACTTC	CASSARFQTGIETQYF	TRBV10-1	TRBJ2-5
TGTGCCAGCAGTTGGGGCCCAGGACAGGGGAAAGGCTATGGCTACACCTTC	CASSWGPGQGKGYGYTF	TRBV27	TRBJ1-2
TGTGCCACCGGTGCCCTCTCAGATACGCAGTATTTT	CATGALSDTQYF	TRBV24-1	TRBJ2-3
TGTGCCAGCAGCACCGGTAAGGATACCCTGGAAGAGACCCAGTACTTC	CASSTGKDTLEETQYF	TRBV11-3	TRBJ2-5
TGTGCCAGCAGCTTAAACAGGGGACCAGAGACCCAGTACTTC	CASSLNRGPETQYF	TRBV7-4	TRBJ2-5
TGTGCCAGCAGGGACCCGCTGAGTTGGACCGCCCCGAACACCGGGGAGCTGTTTTTT	CASRDPLSWTAPNTGELFF	TRBV6-5	TRBJ2-2
TGTGCCAGCAGTGACTCGGTCCGGGACAGGGTGAGGAACACCGGGGAGCTGTTTTTT	CASSDSVRDRVRNTGELFF	TRBV6-4	TRBJ2-2
TGCAGTGCTAGCCTCCCCCCCGACTCTCAGCCCCAGCATTTT	CSASLPPDSQPQHF	TRBV20-1	TRBJ1-5
TGTGCCAGCAGTTTGAGGATACCCCAGGTCCCAGGGGTTTGCAATCAGCCCCAGCATTTT	CASSLRIPQVPGVCNQPQHF	TRBV27	TRBJ1-5
TGTGCCAGCTCTCATGTTGGCGGGTGTCTCACGGTTCTCGGGGAGCTGTTTTTT	CASSHVGGCLTVLGELFF	TRBV18	TRBJ2-2
TGCAGCGTTGACAGGACTAGCGGGAGGGATGAGCAGTTCTTC	CSVDRTSGRDEQFF	TRBV29-1	TRBJ2-1
TGTGCCAGCAGCCAAAGCACAGGGGATAGCAATGAGCAGTTCTTC	CASSQSTGDSNEQFF	TRBV3-1	TRBJ2-1
TGTGCCAGCAGCTACAGGGGAAACACTGAAGCTTTCTTT	CASSYRGNTEAFF	TRBV7-8	TRBJ1-1
TGCAGTGCTACCCAGGACTACGAGCAGTACTTC	CSATQDYEQYF	TRBV20-1	TRBJ2-7
TGTGCCAGCAGTTCGATTAAACCCCTAACTAGCGGGAGCGACTCTGGGGCCAACGTCCTGACTTTC	CASSSIKPLTSGSDSGANVLTF	TRBV27	TRBJ2-6
TGCAGTGCTAGGGGCGGCCGGGACAGGGCAAGCAATCAGCCCCAGCATTTT	CSARGGRDRASNQPQHF	TRBV20-1	TRBJ1-5
TGTGCCAGCAGTGACCTTTCCCACCGGGACAGGCATACTGAAGCTTTCTTT	CASSDLSHRDRHTEAFF	TRBV6-4	TRBJ1-1
TGTGCCAGCAGCCGGCAGGGGCGCTACTATGGCTACACCTTC	CASSRQGRYYGYTF	TRBV7-8	TRBJ1-2
TGTGCCATCGACCGGGCTAGCACCGGGGAGCTGTTTTTT	CAIDRASTGELFF	TRBV27	TRBJ2-2
TGTGCCAGCAGCTTGATATTCAGGGTCCGTGGCTCTGGAAACACCATATATTTT	CASSLIFRVRGSGNTIYF	TRBV5-4	TRBJ1-3
TGTGCCACCAGTGACAAACCGTCGGAGTCCAGCAATCAGCCCCAGCATTTT	CATSDKPSESSNQPQHF	TRBV24-1	TRBJ1-5
TGTGCCAGCAGTTTTTCGGAGATTTTGCCCCAAGAGACCCAGTACTTC	CASSFSEILPQETQYF	TRBV27	TRBJ2-5
TGTGCCAGCAGTTCATTGTTAGAGGAAGTTACTGAAGCTTTCTTT	CASSSLLEEVTEAFF	TRBV27	TRBJ1-1
TGCGCCAGCAGCCAAGCCCGGGGGTCGGGCCCTAGCACAGATACGCAGTATTTT	CASSQARGSGPSTDTQYF	TRBV4-3	TRBJ2-3
TGTGCCAGCAGTTTAGGGGGCAAGCAGCCCCAGCATTTT	CASSLGGKQPQHF	TRBV27	TRBJ1-5
TGTGCCAGCAGCCCGCAAGAAATAGCGCAAGACTACGAGCAGTACTTC	CASSPQEIAQDYEQYF	TRBV7-4	TRBJ2-7
TGTGCCAGCAGCTTAGATTACAACGCAGGGCGGGAGGCCAACACCGGGGAGCTGTTTTTT	CASSLDYNAGREANTGELFF	TRBV11-3	TRBJ2-2
TGTGCGGCATACAATGACAGGTACGAGCAGTACTTC	CAAYNDRYEQYF	TRBV5-4	TRBJ2-7
TGCGCCAGCAGCTGGCCCTGGGACCGAGGAAACACCATATATTTT	CASSWPWDRGNTIYF	TRBV5-1	TRBJ1-3
TGTGCCAGTAGTCCGGGGACCTTAAGAGCTAACTATGGCTACACCTTC	CASSPGTLRANYGYTF	TRBV19	TRBJ1-2
TGTGCCAGCAGCCAACTAGGAAGGGACTCGAGGCAGTTCTTC	CASSQLGRDSRQFF	TRBV3-1	TRBJ2-1
TGTGCCAGCAGCTTACAGGATGAAGGGCGTGAAGCTTTCTTT	CASSLQDEGREAFF	TRBV11-3	TRBJ1-1
TGCAGCGTTGAAGACCTGGGGGGGCCTGGACACCAAGAGACCCAGTACTTC	CSVEDLGGPGHQETQYF	TRBV29-1	TRBJ2-5
TGTGCCAGCAGGCCTCCTTACCTATGCCGGGACATCTACGAGCAGTACTTC	CASRPPYLCRDIYEQYF	TRBV28	TRBJ2-7
TGTGCCAGCAGCTTAACAGACGGACGGACAGGGGCCAGGATCCCGGATCAGCCCCAGCATTTT	CASSLTDGRTGARIPDQPQHF	TRBV13	TRBJ1-5
TGTGCCAGCAGCCAAGATTTGGACGGACGACAGGGAGGGATACACGAGCAGTACTTC	CASSQDLDGRQGGIHEQYF	TRBV14	TRBJ2-7
TGTGCCAGCAGAATTCCGGGGGGTCACACTGAAGCTTTCTTT	CASRIPGGHTEAFF	TRBV28	TRBJ1-1
TGTGCTAGTGGTTCCGGGGGACAAGAGACCCAGTACTTC	CASGSGGQETQYF	TRBV12-5	TRBJ2-5
TGCGCCAGCAGCCAAGACGGGGACAGGGGGCCCGTCGAGCAGTACTTC	CASSQDGDRGPVEQYF	TRBV4-1	TRBJ2-7
TGTGCCAGCAGCGACCACCCGGGACAGGGGGGTTTGGGGGGCTACACCTTC	CASSDHPGQGGLGGYTF	TRBV11-2	TRBJ1-2
TGCAGTGCGTCCCGCCGGCCAGATACGCAGTATTTT	CSASRRPDTQYF	TRBV20-1	TRBJ2-3
