TGTGCCAGCAGCTTGGTTCTCCCAGACAGGGGGAGCAATCAGCCCCAGCATTTT	CASSLVLPDRGSNQPQHF	TRBV5-6	TRBJ1-5
TGTGCCAGCAGAACCCCGCTGGCCACCGGGGAGCTGTTTTTT	CASRTPLATGELFF	TRBV7-7	TRBJ2-2
TGTGCCAGCAGTCAGGGAGGCGCTGAGGAGTTCGAGCAGTACTTC	CASSQGGAEEFEQYF	TRBV6-1	TRBJ2-7
TGCGCCAGCAGCCAAGCTCGGGGGGAGGCTAACTATGGCTACACCTTC	CASSQARGEANYGYTF	TRBV4-3	TRBJ1-2
TGCGCCAGCAGCCAATTTTTAGGGGGGGGGGCCAACGTCCTGACTTTC	CASSQFLGGGANVLTF	TRBV4-3	TRBJ2-6
TGTGCCAGCAGCTTAGCGTTCCCCTATGACAGGGGCCACTACGAGCAGTACTTC	CASSLAFPYDRGHYEQYF	TRBV7-2	TRBJ2-7
TGTGCCAGCAGTTGGGACTGCTACGAGCAGTACTTC	CASSWDCYEQYF	TRBV6-1	TRBJ2-7
TGTGCCAGCAGTTACTCATCCCCTCAGGGGGCACATGGCTACACCTTC	CASSYSSPQGAHGYTF	TRBV6-5	TRBJ1-2
TGTGCCAGCGGTAGGACTAGAATTACCGGGGAGCTGTTTTTT	CASGRTRITGELFF	TRBV6-1	TRBJ2-2
TGTGCCAGCAGTGCCCAGGGGTTGAGCAATCAGCCCCAGCATTTT	CASSAQGLSNQPQHF	TRBV27	TRBJ1-5
TGTGCCAGCAGCCAATACGACAGCAGTGTGGAGTACTTC	CASSQYDSSVEYF	TRBV4-2	TRBJ2-5
TGCAGTGCTAGAGCTACATTGGGGGGCGAACGGGACAATGAGCAGTTCTTC	CSARATLGGERDNEQFF	TRBV20-1	TRBJ2-1
TGTGCCAGCAGCGACAGGGTCTACGAGCAGTACTTC	CASSDRVYEQYF	TRBV7-9	TRBJ2-7
TGCGCCAGATCGAGCATAGGGCCCCAGCATTTT	CARSSIGPQHF	TRBV5-1	TRBJ1-5
TGTGCCAGCAGCAATGGCTACACCTTC	CASSNGYTF	TRBV27	TRBJ1-2
TGTGCCAGCAGCCAGGAGGGGGAATTTGCTGAAGCTTTCTTT	CASSQEGEFAEAFF	TRBV3-1	TRBJ1-1
TGTGCCAGCATCAGGTTCTCATGGACTGAGCAGTTCTTC	CASIRFSWTEQFF	TRBV6-5	TRBJ2-1
TGTGCCAGAGGTTCACCGACAGATACGCAGTATTTT	CARGSPTDTQYF	TRBV5-8	TRBJ2-3
TGCAGTGCACTCACAGGGGGGACGCTTGAGCAGTACTTC	CSALTGGTLEQYF	TRBV20-1	TRBJ2-7
TGTGCCAGCAGTGGGCCGGGACAGGTTACTGCCCAGCCCCAGCATTTT	CASSGPGQVTAQPQHF	TRBV7-9	TRBJ1-5
TGTGCCAGCAGCACGCCTGACAGGGGGGTTGGCTACACCTTC	CASSTPDRGVGYTF	TRBV13	TRBJ1-2
TGCAGTGGGACAGGGGTACTCGAGACCCAGTACTTC	CSGTGVLETQYF	TRBV20-1	TRBJ2-5
TGCGCCAGCAGCTTGGGAAGCCGGGTAGACAGGGGCAATCAGCCCCAGCATTTT	CASSLGSRVDRGNQPQHF	TRBV5-1	TRBJ1-5
TGTGCCAGGGGGGTGAACACCGGGGAGCTGTTTTTT	CARGVNTGELFF	TRBV24-1	TRBJ2-2
TGTGCCAGCAGGGACAGCTGTGGTGGCTACACCTTC	CASRDSCGGYTF	TRBV11-3	TRBJ1-2
TGTGCCAGCAGCATGGGGGCTACCTATAATTCACCCCTCCACTTT	CASSMGATYNSPLHF	TRBV5-4	TRBJ1-6
TGTGCCAGCAGCGTAGTACCAAAGGGGACGGGGAGGTACTTC	CASSVVPKGTGRYF	TRBV9	TRBJ2-7
TGTGCCAGCAGTTACTCGAGCGACAGGGGGCGCGCATTTAGCAATCAGCCCCAGCATTTT	CASSYSSDRGRAFSNQPQHF	TRBV6-2	TRBJ1-5
TGTGCCAGCAGAGTAAGTGAACGACAGATGGAAACGCGAGGCTACACCTTC	CASRVSERQMETRGYTF	TRBV6-5	TRBJ1-2
TGTGCCAGCAGCCTGGCTCGCATGAACACTGAAGCTTTCTTT	CASSLARMNTEAFF	TRBV12-3	TRBJ1-1
TGTGCCAGCAATCAAATTCCTGAGTCCGAGCAGTACTTC	CASNQIPESEQYF	TRBV6-5	TRBJ2-7
TGCGCCAGCCCCAGCCGGGACAGGGAGATTCGCAGCTCTGGGGCCAACGTCCTGACTTTC	CASPSRDREIRSSGANVLTF	TRBV10-1	TRBJ2-6
TGTGCCAGCAGCTTGACAGACAAGACAGGGGCGCCCTATGGCTACACCTTC	CASSLTDKTGAPYGYTF	TRBV5-6	TRBJ1-2
TGTGCCAGCAGTCCACCCCAGAGCTCCTACGAGCAGTACTTC	CASSPPQSSYEQYF	TRBV2	TRBJ2-7
TGTGCCAGCAGCCAGAGCTATGGCTACACCTTC	CASSQSYGYTF	TRBV14	TRBJ1-2
TGTGCCAGCAGCTTAGTAGCACGCGTAGACATGAACACTGAAGCTTTCTTT	CASSLVARVDMNTEAFF	TRBV7-9	TRBJ1-1
TGCAGCGTTCCCCCGGGACGGAGTTCCTACGAGCAGTACTTC	CSVPPGRSSYEQYF	TRBV29-1	TRBJ2-7
TGTGCCAGTCGCAGAGCCAGGCCCGGGGAACATTCACCCCTCCACTTT	CASRRARPGEHSPLHF	TRBV19	TRBJ1-6
TGTGCCACCATGCGGTTTCTACGGATCGGCTCTGGGGCCAACGTCCTGACTTTC	CATMRFLRIGSGANVLTF	TRBV24-1	TRBJ2-6
TGTGCCAGCAGCCTGAAACGAGGGCCCGAGTGGGTCAATCAGCCCCAGCATTTT	CASSLKRGPEWVNQPQHF	TRBV14	TRBJ1-5
TGTGCCAGCAAGGGACTAGCGGGACCCTACGAGCAGTACTTC	CASKGLAGPYEQYF	TRBV7-9	TRBJ2-7
TGTGCCAGCAGCCTGTCATTAGAGTGTCCGGGACCCGTTAGCAACAATGAGCAGTTCTTC	CASSLSLECPGPVSNNEQFF	TRBV7-3	TRBJ2-1
TGTGCCAGCAGCGGACAGGGCCACGCGGTCCACACTGAAGCTTTCTTT	CASSGQGHAVHTEAFF	TRBV7-3	TRBJ1-1
TGCAGTGCTTCAGGACAGAGACCCGATCAGCCCCAGCATTTT	CSASGQRPDQPQHF	TRBV20-1	TRBJ1-5
TGTGCCAGCAGTGGGGTACAGGGGGCGGGGGGCAGCTACGAGCAGTACTTC	CASSGVQGAGGSYEQYF	TRBV6-1	TRBJ2-7
TGTGCCAGCAGTCCCGGGACAAGCAATCAGCCCCAGCATTTT	CASSPGTSNQPQHF	TRBV2	TRBJ1-5
TGTGCCTGGAGGAACCCGGGACAGGGCCGAGCCGAAGCTTTCTTT	CAWRNPGQGRAEAFF	TRBV30	TRBJ1-1
TGCGCCAGCAGCCGGACAGGTCATAATTCACCCCTCCACTTT	CASSRTGHNSPLHF	TRBV10-1	TRBJ1-6
TGTGCCAGCAGCTCCCTCCTAGCGGGGGGGCAGGGATTGCGCCCAAGCTCCTACGAGCAGTACTTC	CASSSLLAGGQGLRPSSYEQYF	TRBV7-9	TRBJ2-7
TGTGCCAGCAGTTTATATCCAGGAGGCACCGGGGAGCTGTTTTTT	CASSLYPGGTGELFF	TRBV12-4	TRBJ2-2
TGTGCCAGCAGTGAGTTTCTAGTAGGTTACAATGAGCAGTTCTTC	CASSEFLVGYNEQFF	TRBV6-4	TRBJ2-1
TGTGCCACCGCCGGACAGGGATTGACCAGGACTGAAGCTTTCTTT	CATAGQGLTRTEAFF	TRBV24-1	TRBJ1-1
TGTGCCAGCAGTGACTCATCGGGCCGGAATCAGCCCCAGCATTTT	CASSDSSGRNQPQHF	TRBV6-4	TRBJ1-5
TGTGCCAGCAGTGTTCTCGCGGGGGGGGCGGGACACTCCTACGAGCAGTACTTC	CASSVLAGGAGHSYEQYF	TRBV25-1	TRBJ2-7
TGTGCCACCAGTGTGCCCCGGACTAGCCTCCGTACCTCTGGAAACACCATATATTTT	CATSVPRTSLRTSGNTIYF	TRBV24-1	TRBJ1-3
TGTGCCAGCAGTGGGCCGTCGGGAGGTGGCACAGATACGCAGTATTTT	CASSGPSGGGTDTQYF	TRBV2	TRBJ2-3
TGTGCCAGCAGTGCCTCGCAGACTAGCGGGGAAGATGAGCAGTTCTTC	CASSASQTSGEDEQFF	TRBV6-4	TRBJ2-1
TGCGCCAGCAGCTTGGGCCTCGGCGTAGTAGGCTACACCTTC	CASSLGLGVVGYTF	TRBV5-1	TRBJ1-2
TGTGCCAGCAGCCAAGATGTTGGGACAGGGGATTCACCCCTCCACTTT	CASSQDVGTGDSPLHF	TRBV4-2	TRBJ1-6
TGTGCCACCAGTGAACGGGTATCCGAGCAGTACTTC	CATSERVSEQYF	TRBV24-1	TRBJ2-7
TGTGCCAGCAAGACTAGTACGCAGTATTTT	CASKTSTQYF	TRBV7-9	TRBJ2-3
TGTGCCAGCAGTGAAACAGAGGGCAATGAGCAGTTCTTC	CASSETEGNEQFF	TRBV6-1	TRBJ2-1
TGTGCCAGCAGCTTGGAAGGCGGAGGGAAGGGCTCCTACAATGAGCAGTTCTTC	CASSLEGGGKGSYNEQFF	TRBV5-6	TRBJ2-1
TGCGCCAGCAGCAAACATCGGCAACTAGGGCAGGGCACCGGGGAGCTGTTTTTT	CASSKHRQLGQGTGELFF	TRBV5-1	TRBJ2-2
TGTGCCAGCAGTCCTTCCAAGGAAGCTTTCTTT	CASSPSKEAFF	TRBV27	TRBJ1-1
TGTGCTAGTGGTCCTTGCGGTTCGAACACTGAAGCTTTCTTT	CASGPCGSNTEAFF	TRBV12-5	TRBJ1-1
TGTGCCAGCAGCTGGGACAGGGGGTCCAACTCCTACAATGAGCAGTTCTTC	CASSWDRGSNSYNEQFF	TRBV13	TRBJ2-1
TGCAGTGCTAGTAATTGGGGGGGGGGCTACGAGCAGTACTTC	CSASNWGGGYEQYF	TRBV20-1	TRBJ2-7
TGTGCCAGCAGGTCCGAGGCTCCAGGATCATATTTT	CASRSEAPGSYF	TRBV28	TRBJ1-3
TGTGCCAGCTATGAGCAGTTCTTC	CASYEQFF	TRBV2	TRBJ2-1
TGTGCCAGCAGCCAACGGGGACAGAGAAGGAAAATAGCTTTCTTT	CASSQRGQRRKIAFF	TRBV7-4	TRBJ1-1
TGTGCTAGTGGTCCCCAGGGACGCCAGGCCAAAAACATTCAGTACTTC	CASGPQGRQAKNIQYF	TRBV12-5	TRBJ2-4
TGTGCCAACTCCCAGCCTGGGGTTAGGAATGACGAGCAGTACTTC	CANSQPGVRNDEQYF	TRBV19	TRBJ2-7
TGTGCCAGCAGCTGGCCTCCCTTACCAGTAGGATGGTATGAAAAACTGTTTTTT	CASSWPPLPVGWYEKLFF	TRBV7-2	TRBJ1-4
TGTGCCAGCAGTTTCCGGGGGGGGCTCTCCTACGAGCAGTACTTC	CASSFRGGLSYEQYF	TRBV27	TRBJ2-7
TGTGCCAGCAGTGACTACGCCAGTCCTGGGTGGTCCCTCTATGGCTACACCTTC	CASSDYASPGWSLYGYTF	TRBV6-4	TRBJ1-2
TGTGCCAGCAGCATAGGGTACGAGCAGTACTTC	CASSIGYEQYF	TRBV7-9	TRBJ2-7
TGTGCCACCAGCAGAGATGGACCACCGAACAGGGTTATGGCCTATGGCTACACCTTC	CATSRDGPPNRVMAYGYTF	TRBV15	TRBJ1-2
TGTGCCAGCAGCCAAGAGGGACAGGGTAGTAATGAAAAACTGTTTTTT	CASSQEGQGSNEKLFF	TRBV4-2	TRBJ1-4
TGTGCCAGCAGTGCGGACAGGGGTAACGCCTACGAGCAGTACTTC	CASSADRGNAYEQYF	TRBV6-4	TRBJ2-7
TGTGCCAACTTTAGGAATCCAAGGGTAGGCTACGAGCAGTACTTC	CANFRNPRVGYEQYF	TRBV25-1	TRBJ2-7
TGCGCCAGCAGCGGATCAACACCAAAATTGTTCTACGAGCAGTACTTC	CASSGSTPKLFYEQYF	TRBV5-1	TRBJ2-7
TGTGCATCCGACTGGGGGGGGGGGGTGAACACTGAAGCTTTCTTT	CASDWGGGVNTEAFF	TRBV15	TRBJ1-1
TGCGCCAGCAGCTTGGTTGGGGGCCCCTCCTACAATGAGCAGTTCTTC	CASSLVGGPSYNEQFF	TRBV5-1	TRBJ2-1
TGTGCCAGCAGCTTAGTGTTGACAGGGGACACTGAAGCTTTCTTT	CASSLVLTGDTEAFF	TRBV7-4	TRBJ1-1
TGCGCCAGGGTGGGACGTTATCAGCCCCAGCATTTT	CARVGRYQPQHF	TRBV10-1	TRBJ1-5
TGTGCCAGCAGTTGTCCGCGGGGGGGGATCCACATTCAGTACTTC	CASSCPRGGIHIQYF	TRBV27	TRBJ2-4
TGTGCCAGCAGCAAATTATTAAGTTCCTGGCCCTACGAGCAGTACTTC	CASSKLLSSWPYEQYF	TRBV7-6	TRBJ2-7
TGTGCCACCAGTGGACCCAGGGGGCCAGAGACCCAGTACTTC	CATSGPRGPETQYF	TRBV24-1	TRBJ2-5
TGTGCCAGCAGTGAAACACTAGCGGGAGTCTTCAGTAACTATGGCTACACCTTC	CASSETLAGVFSNYGYTF	TRBV25-1	TRBJ1-2
TGTGCCAGCAGCATGAAAAAGGTCAGGACGAACACTGAAGCTTTCTTT	CASSMKKVRTNTEAFF	TRBV12-4	TRBJ1-1
TGTGCCAGCAGTAGCAGACGAGGCGATCAGCCCCAGCATTTT	CASSSRRGDQPQHF	TRBV27	TRBJ1-5
TGTGCCAGCAGCTTAGGAACCGAGGGACTAGCGGGCAGGGGAGAGACCCAGTACTTC	CASSLGTEGLAGRGETQYF	TRBV7-3	TRBJ2-5
TGTGCCAGCAGCTTAGACCCTATGACGAGAGAGACCCAGTACTTC	CASSLDPMTRETQYF	TRBV7-9	TRBJ2-5
TGTGCCCGTGAAATATTGTACTATGGCTACACCTTC	CAREILYYGYTF	TRBV12-4	TRBJ1-2
TGTGCCAGCTCACCGGGAACGATTAGGAAGTACGAGCAGTACTTC	CASSPGTIRKYEQYF	TRBV18	TRBJ2-7
TGTGCCAGCAACCCGGGACAGGGAAGCTCCGACGCTTTCTTT	CASNPGQGSSDAFF	TRBV6-2	TRBJ1-1
TGCGCCAGCAGCTTGGCACCTGGGCCACCGCGGAAGCAAGAGACCCAGTACTTC	CASSLAPGPPRKQETQYF	TRBV5-1	TRBJ2-5
TGTGCCACAGGGGACACCGGGGAGCTGTTTTTT	CATGDTGELFF	TRBV6-5	TRBJ2-2
TGTGCCAGCATGAAAGCCAGGGGCTATGGCTACACCTTC	CASMKARGYGYTF	TRBV7-3	TRBJ1-2
TGCGCCAGCAGCTATTGGGTAAAGACCTACGAGCAGTACTTC	CASSYWVKTYEQYF	TRBV5-1	TRBJ2-7
TGTGCCTGGAGTGTACCAACAGGGAATGAGCAGTTCTTC	CAWSVPTGNEQFF	TRBV30	TRBJ2-1
TGCAGCGTTGAGACATCTACCCGAACGGGGGCCTACGAGCAGTACTTC	CSVETSTRTGAYEQYF	TRBV29-1	TRBJ2-7
TGTGCCAGCAGCCAGAATGCCCCCCGGGACATAAATGAGCAGTTCTTC	CASSQNAPRDINEQFF	TRBV14	TRBJ2-1
TGTGCCAGCAGTGTACTAGCGGGAGCCCCCCAAGAGACCCAGTACTTC	CASSVLAGAPQETQYF	TRBV6-1	TRBJ2-5
TGCAGTGCGTGGGGGGGGTCCGCCCAGCCCCAGCATTTT	CSAWGGSAQPQHF	TRBV20-1	TRBJ1-5
TGTGCCAGCAGCTTGAGGACTAGCGGGGGGATCCCCTACAATGAGCAGTTCTTC	CASSLRTSGGIPYNEQFF	TRBV5-4	TRBJ2-1
TGTGCCAGCAGCACCCATGTCAGGGAGGCAACTAATGAAAAACTGTTTTTT	CASSTHVREATNEKLFF	TRBV7-9	TRBJ1-4
TGTGCCAGCAGTGACTCGTTGGGGGGTGGGGACAGCGAACGGGGTTGCAATCAGCCCCAGCATTTT	CASSDSLGGGDSERGCNQPQHF	TRBV6-4	TRBJ1-5
TGCGCCATTAAGCCGATAAAGAACACTGAAGCTTTCTTT	CAIKPIKNTEAFF	TRBV10-1	TRBJ1-1
TGTGCCAGCAGGAGAGTTTCGGGACAGAACAATCAGCCCCAGCATTTT	CASRRVSGQNNQPQHF	TRBV25-1	TRBJ1-5
TGTGCCAGCAGCCGCGGGGGGGCGTTGAGAAAAAACACTGAAGCTTTCTTT	CASSRGGALRKNTEAFF	TRBV14	TRBJ1-1
TGTGCCAGCAGCCCCGGAGGGTACTACAATGAGCAGTTCTTC	CASSPGGYYNEQFF	TRBV7-6	TRBJ2-1
TGCGCCAGCAGCTCCAAAGGGGGAAGACATGGCTACACCTTC	CASSSKGGRHGYTF	TRBV5-1	TRBJ1-2
TGTGCCAGCAGTGAACTACCTAGCGGGGCAGTATACAATGAGCAGTTCTTC	CASSELPSGAVYNEQFF	TRBV2	TRBJ2-1
TGTGCCAGCAGTCTCAGGGGACTAGCGGGATATGAACAAGAGACCCAGTACTTC	CASSLRGLAGYEQETQYF	TRBV2	TRBJ2-5
TGTGCCAGCAGTGACCAACAAACGTACGAGCAGTACTTC	CASSDQQTYEQYF	TRBV6-4	TRBJ2-7
TGTGCCAGCAGGACAGGGGGGGATGAAAAACTGTTTTTT	CASRTGGDEKLFF	TRBV27	TRBJ1-4
TGCAGTGCTACCAGTCTCCCCCCGGGACAGGAAACATCAGCTTTCTTT	CSATSLPPGQETSAFF	TRBV20-1	TRBJ1-1
TGTGCCAGCAGTTACCCAAAGTCCAGGGAGCCCCAGCATTTT	CASSYPKSREPQHF	TRBV6-5	TRBJ1-5
TGTGCCAGCTCACAGGGGGTGGACAGCTCTGGGGCCAACGTCCTGACTTTC	CASSQGVDSSGANVLTF	TRBV18	TRBJ2-6
TGCGCCAGCAGCACAGGGCTAGCCTACGAGCAGTACTTC	CASSTGLAYEQYF	TRBV4-1	TRBJ2-7
TGTGCCAGCCGGATAATCTCGAGACAGGGTAACCCCACTGAAGCTTTCTTT	CASRIISRQGNPTEAFF	TRBV5-8	TRBJ1-1
TGCAGTGCTAGAGTCGACTTTCCACTAGAATCTGAAAAACTGTTTTTT	CSARVDFPLESEKLFF	TRBV20-1	TRBJ1-4
TGCGCCAGCAGCGACCACCACAGGGCCAGCAATCAGCCCCAGCATTTT	CASSDHHRASNQPQHF	TRBV5-1	TRBJ1-5
TGCGCCAGCAGCCCAGGAGTTACGAATCATTCACCCCTCCACTTT	CASSPGVTNHSPLHF	TRBV4-1	TRBJ1-6
TGTGCCTGGAGTGCCCCACGCTACAGAGGGAGAAGCTCCTATAATTCACCCCTCCACTTT	CAWSAPRYRGRSSYNSPLHF	TRBV30	TRBJ1-6
TGTGCCAGCAGTGACCAAAAAGGGATGAACACTGAAGCTTTCTTT	CASSDQKGMNTEAFF	TRBV6-4	TRBJ1-1
TGTGGTGAGAAAGTTAACTATGGCTACACCTTC	CGEKVNYGYTF	TRBV6-4	TRBJ1-2
TGCGCCAGCAGCTTGGCGTCACTAGCGGGAGGGCCCTACGAGCAGTACTTC	CASSLASLAGGPYEQYF	TRBV5-1	TRBJ2-7
TGTGCCAGGGCCACTCGCGAGCAGTACTTC	CARATREQYF	TRBV25-1	TRBJ2-7
TGTGCCACCAGTGATTTCGCCGGGGCTAGGATGAGCAATCAGCCCCAGCATTTT	CATSDFAGARMSNQPQHF	TRBV24-1	TRBJ1-5
TGTGCCAGCAGTGGGCCAGGACAGGGAGAAACGTATAGCAATCAGCCCCAGCATTTT	CASSGPGQGETYSNQPQHF	TRBV6-4	TRBJ1-5
TGTGCCAGCAGAAGGGATCTCTGGTGGATAGTCCGGGAGGGCTACAATGAGCAGTTCTTC	CASRRDLWWIVREGYNEQFF	TRBV28	TRBJ2-1
TGTGCCACCAGCGAGATACTATGCGAGCAGTACTTC	CATSEILCEQYF	TRBV15	TRBJ2-7
TGCGCCATGCCCCAGTCGACCCAGTACTTC	CAMPQSTQYF	TRBV10-1	TRBJ2-5
TGTGCCAGCAGTGCCGGGACAGGGGACTCACCCCTCCACTTT	CASSAGTGDSPLHF	TRBV25-1	TRBJ1-6
TGTGCCACCAGCAGTTTAGCGGGAGAGGGGGCATCTGACAATGAGCAGTTCTTC	CATSSLAGEGASDNEQFF	TRBV15	TRBJ2-1
TGCGCCAGCAGCTTAACTTGGACTAGCGGGCCTTACAATGAGCAGTTCTTC	CASSLTWTSGPYNEQFF	TRBV5-1	TRBJ2-1
TGTGCCAGCAGCTTCACAGCGGGACGAAAACTGTTTTTT	CASSFTAGRKLFF	TRBV7-2	TRBJ1-4
TGTGCCAGGGGGGGGTCCGAGACCCAGTACTTC	CARGGSETQYF	TRBV10-3	TRBJ2-5
TGTGCCAGCAGTTTACCTGAGACAGGGTGCACCGGGGAGCTGTTTTTT	CASSLPETGCTGELFF	TRBV12-4	TRBJ2-2
TGTGCCACCAGTGATTGGAAGGGAAGCACTGAAGCTTTCTTT	CATSDWKGSTEAFF	TRBV24-1	TRBJ1-1
TGTGCCAGTCTACCCGGACTTCAGCCCCAGCATTTT	CASLPGLQPQHF	TRBV7-9	TRBJ1-5
TGTGCCAGTAGTATAAATGGGGCCGGGAAACGGCTTGCAACTAATGAAAAACTGTTTTTT	CASSINGAGKRLATNEKLFF	TRBV19	TRBJ1-4
TGTGCCAGCAGCCGGGAGGACAGGCAACCCTATGGCTACACCTTC	CASSREDRQPYGYTF	TRBV7-6	TRBJ1-2
TGTGCCACCAGATCGGACAGAAACATTCAGTACTTC	CATRSDRNIQYF	TRBV24-1	TRBJ2-4
TGTGCCAGTAGTGGCAGGGCTGGTGACGCTGGGAACACCGGGGAGCTGTTTTTT	CASSGRAGDAGNTGELFF	TRBV19	TRBJ2-2
TGTGCCAGCAGCGGGGTGTACGAATTCCGGGGCTACACCTTC	CASSGVYEFRGYTF	TRBV9	TRBJ1-2
TGCGCCAGCAGCGAAAGGGACAGGCATAGCAATCAGCCCCAGCATTTT	CASSERDRHSNQPQHF	TRBV5-1	TRBJ1-5
TGTGCCAGCAGTTTGACAGGCAATGAAAAACTGTTTTTT	CASSLTGNEKLFF	TRBV28	TRBJ1-4
TGTGCCAGCAGACAGGTTATGTACGAGCAGTACTTC	CASRQVMYEQYF	TRBV25-1	TRBJ2-7
TGTGCCAGCAGTGAGGATGACAATGAGCAGTTCTTC	CASSEDDNEQFF	TRBV6-1	TRBJ2-1
TGTGCCTGGAGTGTGAGACAGGGGGCGGGTGGAAACACCATATATTTT	CAWSVRQGAGGNTIYF	TRBV30	TRBJ1-3
TGTGCCAGCACTAACAGGGGAGAAGCTTTCTTT	CASTNRGEAFF	TRBV6-2	TRBJ1-1
TGTGCCAGCAGCGTAGTATTTGGGGGGCCCCGCTCCTACGAGCAGTACTTC	CASSVVFGGPRSYEQYF	TRBV9	TRBJ2-7
TGTGCCAGCAGCTTACTGCTTCGGGCACGGGAAAACTATGGCTACACCTTC	CASSLLLRARENYGYTF	TRBV11-2	TRBJ1-2
TGTGCCAGCAGACCACCGCACCCAGCGGGACTAGGGGGTGAAAAACTGTTTTTT	CASRPPHPAGLGGEKLFF	TRBV27	TRBJ1-4
TGTGCCAGCAGCCAAGGAACCCCTAGCCATTATGAGCAGTTCTTC	CASSQGTPSHYEQFF	TRBV4-2	TRBJ2-1
TGCAGTGCTAGTCCCCGACAGCCTCTGTGCAATCAGCCCCAGCATTTT	CSASPRQPLCNQPQHF	TRBV20-1	TRBJ1-5
TGTGCCACCAGTGATCCTTTCCGGGGGACAGGTTCTAACTATGGCTACACCTTC	CATSDPFRGTGSNYGYTF	TRBV24-1	TRBJ1-2
TGTGCCAGCAGCAGTGATGAACGGCATGAAGCTTTCTTT	CASSSDERHEAFF	TRBV2	TRBJ1-1
TGTGCCAGCAGCTTGACACTAGCGGGAGGGCTGCCTGAAGCTTTCTTT	CASSLTLAGGLPEAFF	TRBV5-8	TRBJ1-1
TGTGCCAGCAGCGGGAGGGTGGCCGATTCCTTC	CASSGRVADSF	TRBV3-1	TRBJ2-5
TGTGCCAGCAGTGTCAATGGAGCGGATGGGAGCACAGATACGCAGTATTTT	CASSVNGADGSTDTQYF	TRBV25-1	TRBJ2-3
TGTGCGCATCGACAGGGAAGGTACAACACTGAAGCTTTCTTT	CAHRQGRYNTEAFF	TRBV5-6	TRBJ1-1
TGTGCCAGCAGTGGATGTTGTGGACAGGGGGATAGCACAGATACGCAGTATTTT	CASSGCCGQGDSTDTQYF	TRBV25-1	TRBJ2-3
TGCGCCAGCGTAAGGGCTGACGAGCAGTACTTC	CASVRADEQYF	TRBV10-1	TRBJ2-7
TGTGCCAGCAGCTTAGATTTAAGGACAGGGCTGACTTGTGTCCACACTGAAGCTTTCTTT	CASSLDLRTGLTCVHTEAFF	TRBV11-3	TRBJ1-1
TGTGCCACCAGTGAGCTATTGGGGGTCTCCTACGAGCAGTACTTC	CATSELLGVSYEQYF	TRBV24-1	TRBJ2-7
TGTGCCAGTAGTATCGGCAGGGTCGATGATCAGCCCCAGCATTTT	CASSIGRVDDQPQHF	TRBV19	TRBJ1-5
TGTGCCAGCAGCAGTTACAGCGGGGGCTACACCTTC	CASSSYSGGYTF	TRBV7-9	TRBJ1-2
TGTGCCAGCAGTCTCGGACGACAGGGCAAGGAAAGCAATCAGCCCCAGCATTTT	CASSLGRQGKESNQPQHF	TRBV6-1	TRBJ1-5
TGCGCCAGCAGCTTGGCCCAACTCCCGGGACTAGATCGAGGGGGGCCTTTTGAGCAGTACTTC	CASSLAQLPGLDRGGPFEQYF	TRBV5-1	TRBJ2-7
TGCGCCAGCAGTGAGCCAGGGACAGGTAGCAATCAGCCCCAGCATTTT	CASSEPGTGSNQPQHF	TRBV10-2	TRBJ1-5
TGTGCCAGCAGTCCAGGGCCACACTCTGGGGCCAACGTCCTGACTTTC	CASSPGPHSGANVLTF	TRBV6-3	TRBJ2-6
TGTGCCAGCAGCCATATGCGATCGAAGTACTTC	CASSHMRSKYF	TRBV5-6	TRBJ2-7
TGTGCCAGCAGTTACCGGGGGGGCGTAAAGTACTTC	CASSYRGGVKYF	TRBV6-8	TRBJ2-5
TGTGCCAGCAGTAGCTTTCTAAGGCGGTACCAAGAGACCCAGTACTTC	CASSSFLRRYQETQYF	TRBV27	TRBJ2-5
TGTGCCAGCAGCGACGGGACAGGGGCCTACGAGCAGTACTTC	CASSDGTGAYEQYF	TRBV11-3	TRBJ2-7
TGTGTACCGGGACAGGCCGGCACAGATACGCAGTATTTT	CVPGQAGTDTQYF	TRBV2	TRBJ2-3
TGTGCCAGCAGCTCCCTGGGGAGCAATCAGCCCCAGCATTTT	CASSSLGSNQPQHF	TRBV11-2	TRBJ1-5
TGCAGTGCTAGAGGTCGGACGGGGCTGTACGAGCAGTACTTC	CSARGRTGLYEQYF	TRBV20-1	TRBJ2-7
TGTGCCAGCAGCGGATACAGGGGACTGGGGGGCTCAACTAATGAAAAACTGTTTTTT	CASSGYRGLGGSTNEKLFF	TRBV13	TRBJ1-4
TGCGCCAGCAGCCAAGCAGCCGGGACTGAAGCTTTCTTT	CASSQAAGTEAFF	TRBV4-1	TRBJ1-1
TGTGCCAGCAGCTACCGTGGGGCCCAAGGGCCGAACAATGAGCAGTTCTTC	CASSYRGAQGPNNEQFF	TRBV7-6	TRBJ2-1
TGTGCCAGCAGTGAAGATGGAAAGGGGCCCCCCTCAGCTAACTATGGCTACACCTTC	CASSEDGKGPPSANYGYTF	TRBV6-1	TRBJ1-2
TGTGCCAGCAGCTTAGGGGCAGGGCAGCTTATCGGGGAGCTGTTTTTT	CASSLGAGQLIGELFF	TRBV7-4	TRBJ2-2
TGCAGTGCTAGACCCGGGCCGTATGGCTACACCTTC	CSARPGPYGYTF	TRBV20-1	TRBJ1-2
TGTGCCAGCGGACAGGGGGCTACCTACGAGCAGTACTTC	CASGQGATYEQYF	TRBV9	TRBJ2-7
TGTGCCAGCAGTTTAGACGCAGGCGCCCAGCATTTT	CASSLDAGAQHF	TRBV12-3	TRBJ1-5
TGTGCCAGCAGCTTAGCAATTGGCACTCGGGGCAATCAGCCCCAGCATTTT	CASSLAIGTRGNQPQHF	TRBV7-4	TRBJ1-5
TGCAGTGATTGCAGGGTTATTCTGACAGATACGCAGTATTTT	CSDCRVILTDTQYF	TRBV20-1	TRBJ2-3
TGTGCCAGCAGCGTGCTCTGGGGTCTCTCCTATAATTCACCCCTCCACTTT	CASSVLWGLSYNSPLHF	TRBV7-6	TRBJ1-6
TGTGCCAGTAGTATGAGGGTCCATCAGCCCCAGCATTTT	CASSMRVHQPQHF	TRBV19	TRBJ1-5
TGTGCCAGCAGTAAACTAGCGGGGGGGCCAACCGGGGAGCTGTTTTTT	CASSKLAGGPTGELFF	TRBV27	TRBJ2-2
TGTGCCAAGGGACAGGGTGTTCAAGAGACCCAGTACTTC	CAKGQGVQETQYF	TRBV19	TRBJ2-5
TGTGCCAGCAGCCAGGGTCTAGCGGGGTCCCTAGCCAAAAACATTCAGTACTTC	CASSQGLAGSLAKNIQYF	TRBV14	TRBJ2-4
TGTGCCAGCAGCAGACGACAAAGCACAGATACGCAGTATTTT	CASSRRQSTDTQYF	TRBV13	TRBJ2-3
TGTGCTGGCCAATCATTTATGAACACTGAAGCTTTCTTT	CAGQSFMNTEAFF	TRBV24-1	TRBJ1-1
TGTGCCAGCAGCGTCGGCCCTAGCGAAAACACCGGGGAGCTGTTTTTT	CASSVGPSENTGELFF	TRBV7-3	TRBJ2-2
TGTGCCAGCAGAACGGCGGATCAATGGATCTATGGCTACACCTTC	CASRTADQWIYGYTF	TRBV12-3	TRBJ1-2
TGCGCCAGCAGCAGGACTAGCGACGAGCAGTACTTC	CASSRTSDEQYF	TRBV4-1	TRBJ2-7
TGTGCCAGCAGTTTTAACCCCACCAGGACTAGCGGGATCGAAGAGACCCAGTACTTC	CASSFNPTRTSGIEETQYF	TRBV11-3	TRBJ2-5
TGTGCCAGCAGTGATCCTCTAAGCTCCTATAATTCACCCCTCCACTTT	CASSDPLSSYNSPLHF	TRBV27	TRBJ1-6
TGTGCCAGCAGCTTAGAAGGAACTGACGCTGAGACCCAGTACTTC	CASSLEGTDAETQYF	TRBV11-2	TRBJ2-5
TGTGCCAGCAGTGCAAGGAGCGGTTTCCTCAGCAATCAGCCCCAGCATTTT	CASSARSGFLSNQPQHF	TRBV27	TRBJ1-5
TGTGCCAGCAGCTTAAATCGCCCTAGGACAGGGCGCAATCAGCCCCAGCATTTT	CASSLNRPRTGRNQPQHF	TRBV7-3	TRBJ1-5
TGCGCCAGCAGCTTGGCGCGGGAGTGGACAGTTTCCTACGAGCAGTACTTC	CASSLAREWTVSYEQYF	TRBV5-1	TRBJ2-7
TGTGCCAGCAGCTGTTCGGGGGCCCGGGGCGTCGAAGAGACCCAGTACTTC	CASSCSGARGVEETQYF	TRBV5-4	TRBJ2-5
TGTGCCAGCAGGGGCCCCATACTTGAGCTAGCCAAAAACATTCAGTACTTC	CASRGPILELAKNIQYF	TRBV5-5	TRBJ2-4
TGTGCCAGCAGTGTCGCCCTAAGCTCTGGAAACACCATATATTTT	CASSVALSSGNTIYF	TRBV28	TRBJ1-3
TGTGCCAGCAGCCAGAGGAATAGAAGCGAGCAGTACTTC	CASSQRNRSEQYF	TRBV11-3	TRBJ2-7
TGTGCCAGCGTCACAGGGTATGGCTACACCTTC	CASVTGYGYTF	TRBV5-4	TRBJ1-2
TGCGCCAGCAGTGAATTAATCCGGACTAGCGGGCCCTACGAGCAGTACTTC	CASSELIRTSGPYEQYF	TRBV10-1	TRBJ2-7
TGTGCCAGCTTTAGGGCGGCCCCCGGGGAGCTGTTTTTT	CASFRAAPGELFF	TRBV27	TRBJ2-2
TGTGCCAGCGGACAGGATGAGCAGTTCTTC	CASGQDEQFF	TRBV12-3	TRBJ2-1
TGTGCCAGCAGCGGGGGCGTCTCCTACGAGCAGTACTTC	CASSGGVSYEQYF	TRBV13	TRBJ2-7
TGTGCCAGCAGTGGCCGGGGGTTTTTTACCTACGAGCAGTACTTC	CASSGRGFFTYEQYF	TRBV27	TRBJ2-7
TGTGCCAGCAGTGCCGGGACTTGGGGGTCACTTGGAAACACCATATATTTT	CASSAGTWGSLGNTIYF	TRBV6-5	TRBJ1-3
TGCCCCCGACAGGGAGCCTACGAGCAGTACTTC	CPRQGAYEQYF	TRBV20-1	TRBJ2-7
TGTGCCACCAGTGATTTGGCCCTCCAGACAGCCGGCTATGGCTACACCTTC	CATSDLALQTAGYGYTF	TRBV24-1	TRBJ1-2
TGCGCCAGCAGCTCTCACAGGTGGGGGCGGGACAGGGGATCAGGTGGCTACACCTTC	CASSSHRWGRDRGSGGYTF	TRBV5-1	TRBJ1-2
TGTGCCAGTAGTAGAAGCGACCTTTACTCCTACGAGCAGTACTTC	CASSRSDLYSYEQYF	TRBV19	TRBJ2-7
TGTGCCAGCAGCTTAGATCTCCTCCGGATGGGGAATGAGCAGTTCTTC	CASSLDLLRMGNEQFF	TRBV11-2	TRBJ2-1
TGTTCGGGGGCGGCTAATGAAAAACTGTTTTTT	CSGAANEKLFF	TRBV11-2	TRBJ1-4
TGTGCCAGCAGCTTAAATCGAGGGGCAAACTATGGCTACACCTTC	CASSLNRGANYGYTF	TRBV7-2	TRBJ1-2
TGTGCCAGCAGTGGGGGATATGGCTACACCTTC	CASSGGYGYTF	TRBV28	TRBJ1-2
TGTGCCACCAGCACACTAGGTAATTTAGGGGACAATGAGCAGTTCTTC	CATSTLGNLGDNEQFF	TRBV15	TRBJ2-1
TGTGCCAGCAGAACTGGACTCCCTGGTAACTATGGCTACACCTTC	CASRTGLPGNYGYTF	TRBV28	TRBJ1-2
TGTGCCAGCAGTTATAGCAGGGGTTTCTCACCCCTCCACTTT	CASSYSRGFSPLHF	TRBV6-5	TRBJ1-6
TGTGCCGGGGCCCTCGGTCTTACTGAAGCTTTCTTT	CAGALGLTEAFF	TRBV27	TRBJ1-1
TGCAGTGCTACCCAAGCTCCGCGAAATCAGCCCCAGCATTTT	CSATQAPRNQPQHF	TRBV20-1	TRBJ1-5
TGTGCCAGCAGCGTATGGGACACCCGGGACGGGAACACTGAAGCTTTCTTT	CASSVWDTRDGNTEAFF	TRBV9	TRBJ1-1
TGTGCCAGCAGCTTGGGGACAGGTTCCTACGAGCAGTACTTC	CASSLGTGSYEQYF	TRBV5-5	TRBJ2-7
TGTGCCAGCTCACCACCCGGGACAGCGAAAAACTATGGCTACACCTTC	CASSPPGTAKNYGYTF	TRBV18	TRBJ1-2
TGTGCTAGTGGAGACAGGACTCGTCAGCCCCAGCATTTT	CASGDRTRQPQHF	TRBV12-5	TRBJ1-5
TGCAGTGCTGACTCCACCACTGAGGGATACAATGAGCAGTTCTTC	CSADSTTEGYNEQFF	TRBV20-1	TRBJ2-1
TGTGCCAGCAGCTTCCCTAAGAAGGCTACCGGGGAGCTGTTTTTT	CASSFPKKATGELFF	TRBV7-8	TRBJ2-2
TGCAGTGCTAAAGGGGGTATCGACTTC	CSAKGGIDF	TRBV20-1	TRBJ1-2
TGCAGTTCCGGGGCCCCCGATACTGGAAACACCATATATTTT	CSSGAPDTGNTIYF	TRBV20-1	TRBJ1-3
TGTGCCATCAAGCGCACCGTTCTCCGGCGCGGGAGAATGGGCTACACCTTC	CAIKRTVLRRGRMGYTF	TRBV10-3	TRBJ1-2
TGTGCCACCTTTTGGAGGGGGGACACCGGGGAGCTGTTTTTT	CATFWRGDTGELFF	TRBV24-1	TRBJ2-2
TGTGCCAGCAGTACTGACAGGACCACTGAAGCTTTCTTT	CASSTDRTTEAFF	TRBV6-5	TRBJ1-1
TGTGCCACCAGTGATTACCCACCCTATCAGTTCCAGGCAGCTAATGAAAAACTGTTTTTT	CATSDYPPYQFQAANEKLFF	TRBV24-1	TRBJ1-4
TGCGCCAGCAGGAAGAGAAGCAATCAGCCCCAGCATTTT	CASRKRSNQPQHF	TRBV10-1	TRBJ1-5
TGTGCCAGCAGAGGGGCACAGGGCTGGGAGGTTCCTGAAGCTTTCTTT	CASRGAQGWEVPEAFF	TRBV28	TRBJ1-1
TGTGCCAGCAGCCCCCTAACAAGATCTAGCAAGAATCTCTGGCAGTTCTTC	CASSPLTRSSKNLWQFF	TRBV11-3	TRBJ2-1
TGTGCCAGCAGCCCGGGGAGTTATAAGGATAATTCACCCCTCCACTTT	CASSPGSYKDNSPLHF	TRBV7-9	TRBJ1-6
TGTGCCAGCATCGGTAAGGAGTTGACTAGCGGAGGCGGGGAGCTGTTTTTT	CASIGKELTSGGGELFF	TRBV27	TRBJ2-2
TGTGCCAGCATCCTGTATTTAGACAGGGTGAGCAATCAGCCCCAGCATTTT	CASILYLDRVSNQPQHF	TRBV27	TRBJ1-5
TGCGCAGACCAGAATCCAGCCACGTCCTACGAGCAGTACTTC	CADQNPATSYEQYF	TRBV5-1	TRBJ2-7
TGTGCCAGCAGCTTAGTAACCCGGGACAGACAAAACACTGAAGCTTTCTTT	CASSLVTRDRQNTEAFF	TRBV7-9	TRBJ1-1
TGTGCCAGTAGCATTAGTAATGGCTACACCTTC	CASSISNGYTF	TRBV19	TRBJ1-2
TGTGCCAGCAGACGGACACGTCACTGGGGCAATCAGCCCCAGCATTTT	CASRRTRHWGNQPQHF	TRBV7-2	TRBJ1-5
TGTGCCAGCAGATGTACTAGCGGGAGCAGGGCACACAAGTTGAACACTGAAGCTTTCTTT	CASRCTSGSRAHKLNTEAFF	TRBV12-3	TRBJ1-1
TGCGCCAGCAGGCATGTGGGGGGGGCTATCACAGATACGCAGTATTTT	CASRHVGGAITDTQYF	TRBV10-1	TRBJ2-3
TGCGCCAGCAGCCAAGGTGGGACTCCTCAAAAAACTGAAGCTTTCTTT	CASSQGGTPQKTEAFF	TRBV4-1	TRBJ1-1
TGTGCCAGCAGCTTTCTAGGGACAGGGTTCTACAATGAGCAGTTCTTC	CASSFLGTGFYNEQFF	TRBV5-4	TRBJ2-1
TGTGCCGCCCATAAACACAGGGGGGGAGAGACCCAGTACTTC	CAAHKHRGGETQYF	TRBV6-1	TRBJ2-5
TGCAGTGCTAGGCGTTTTGAAGCAACTAATGAAAAACTGTTTTTT	CSARRFEATNEKLFF	TRBV20-1	TRBJ1-4
TGTGCCAGCAGCTTATCATCACTAGATTACGGCCAGTACTTC	CASSLSSLDYGQYF	TRBV11-2	TRBJ2-5
TGCGCCAGCAGCTCAGGGGGGGGCTTTAACACCGGGGAGCTGTTTTTT	CASSSGGGFNTGELFF	TRBV5-1	TRBJ2-2
TGTGCCAGCAGCTCCGGTTGCAGGGTAGCAGATACGCAGTATTTT	CASSSGCRVADTQYF	TRBV7-2	TRBJ2-3
TGTGCCAGCAGTGAGGACCGACCAGAGACCCAGTACTTC	CASSEDRPETQYF	TRBV6-1	TRBJ2-5
TGCAGTGCTAGCCGGAAGTGGGGGGACCGGCATGAGCAGTTCTTC	CSASRKWGDRHEQFF	TRBV20-1	TRBJ2-1
TGCAGTGCTAGGAGTATAGAGGGCGACTATGGCTACACCTTC	CSARSIEGDYGYTF	TRBV20-1	TRBJ1-2
TGCAGTGCTAGTGGGGTTTCGGACAGGCGGACCGGGGAGCTGTTTTTT	CSASGVSDRRTGELFF	TRBV20-1	TRBJ2-2
TGCAGTGCGGGGTCTAGGAAGGCCTACGAGCAGTACTTC	CSAGSRKAYEQYF	TRBV20-1	TRBJ2-7
TGTGCCAGCAAAGACAGACAAAAGGGGTCCTCCTACGAGCAGTACTTC	CASKDRQKGSSYEQYF	TRBV28	TRBJ2-7
TGTGCCAGCAGCGGACGTTACGAGCAGTACTTC	CASSGRYEQYF	TRBV6-2	TRBJ2-7
TGTGCCACCAGCGCGCCCAAGGGGAATGAAAAACTGTTTTTT	CATSAPKGNEKLFF	TRBV15	TRBJ1-4
TGTGCCAGCAGTGAACGTCTGGGAAATGAGCAGTTCTTC	CASSERLGNEQFF	TRBV25-1	TRBJ2-1
TGCAGCAGGGTGACAGCAACGGCCTACGAGCAGTACTTC	CSRVTATAYEQYF	TRBV29-1	TRBJ2-7
TGTGCCAGCAGCCCTTGCATCGGGGGGACAGATACGCAGTATTTT	CASSPCIGGTDTQYF	TRBV13	TRBJ2-3
TGTGCCAGCAGCCCGACAAGGGCCAAAAACATTCAGTACTTC	CASSPTRAKNIQYF	TRBV11-3	TRBJ2-4
TGTGCCAGCAGTGCCAGGGGTGGTGAAGCTTTCTTT	CASSARGGEAFF	TRBV2	TRBJ1-1
TGTGCCAGCAGTTACCGGACAGGGTCTGAGCAGTACTTC	CASSYRTGSEQYF	TRBV6-5	TRBJ2-7
TGTGCCAGCAGCTTAGGGCCGGTCGACGGGTTCAATGAAAAACTGTTTTTT	CASSLGPVDGFNEKLFF	TRBV7-9	TRBJ1-4
TGTGCCAGTAGTATGGGGATCCTAACTGAAGCTTTCTTT	CASSMGILTEAFF	TRBV19	TRBJ1-1
TGTGCCAGTCCGAGGGTTACCTACAATGAGCAGTTCTTC	CASPRVTYNEQFF	TRBV4-2	TRBJ2-1
TGCGCCAGCAGCCTAATGACAGGGGACTATCAGCCCCAGCATTTT	CASSLMTGDYQPQHF	TRBV5-1	TRBJ1-5
TGTGCCAGCAGCCCGGTAGGTGCTAACTATGGCTACACCTTC	CASSPVGANYGYTF	TRBV7-3	TRBJ1-2
TGCAGTGCTAGAGATAGCCCCCTAGCGGGTTACAATGAGCAGTTCTTC	CSARDSPLAGYNEQFF	TRBV20-1	TRBJ2-1
TGTGCCAGCAGTGACTCCCCTAGCGGGATGAACACCGGGGAGCTGTTTTTT	CASSDSPSGMNTGELFF	TRBV6-4	TRBJ2-2
TGCGCCAGCAGCTTGGATGCCCGGGACAGGGACACTGAAGCTTTCTTT	CASSLDARDRDTEAFF	TRBV5-1	TRBJ1-1
TGTGCCAGCATAAGGGCCTCCTACGAGCAGTACTTC	CASIRASYEQYF	TRBV25-1	TRBJ2-7
TGTGCCAGCAGTTTCCAGGACGAGCAGTACTTC	CASSFQDEQYF	TRBV6-9	TRBJ2-7
TGTGCCAGCAGCAGGGGGGGGGCAGATACGCAGTATTTT	CASSRGGADTQYF	TRBV5-4	TRBJ2-3
TGTGCCATCCAGCCGGGGACAGTCGGCTATGGCTACACCTTC	CAIQPGTVGYGYTF	TRBV10-3	TRBJ1-2
TGTGCCAGCAGTAGGGCTAGCGGGCGGGGGGTCGGCTCCTACAATGAGCAGTTCTTC	CASSRASGRGVGSYNEQFF	TRBV2	TRBJ2-1
TGTGCCAGCAGCACTTGTGACTACTGTTTGTATCAGCCCCAGCATTTT	CASSTCDYCLYQPQHF	TRBV7-3	TRBJ1-5
TGTGCTCCACTAGTAGTGCGACGGGAAACGGTGTACTTC	CAPLVVRRETVYF	TRBV15	TRBJ2-7
TGCAGTGCTAGCACCCCGGGACAAAACGATGATCTAGCCAAAAACATTCAGTACTTC	CSASTPGQNDDLAKNIQYF	TRBV20-1	TRBJ2-4
TGTGCCAGCAGCTTAACGGGGGGGGGGGACGAGCAGTACTTC	CASSLTGGGDEQYF	TRBV7-3	TRBJ2-7
TGTGCCAGCAGTTTCGACCTAGAAGAGACCCAGTACTTC	CASSFDLEETQYF	TRBV12-4	TRBJ2-5
TGCAGTGCTCTTACGTCCAACGAGCAGTACTTC	CSALTSNEQYF	TRBV20-1	TRBJ2-7
TGTGCCAGCAGTTACGAAACCGGGACAGGAGGGCCTGGAAACACCATATATTTT	CASSYETGTGGPGNTIYF	TRBV6-5	TRBJ1-3
TGTGCCAGCAGCACACGGTCGGGGCATCAGCCCCAGCATTTT	CASSTRSGHQPQHF	TRBV7-3	TRBJ1-5
TGTGCCAGTAGTATGGGGGAAGAAAAACTGTTTTTT	CASSMGEEKLFF	TRBV19	TRBJ1-4
TGTGCCAGCAGGGTTATCCGGGACAGGGACGTTGTTGACACCGGGGAGCTGTTTTTT	CASRVIRDRDVVDTGELFF	TRBV6-5	TRBJ2-2
TGTGCCAGCAGCGTCCAGGGGAAAATTAATGAGCAGTTCTTC	CASSVQGKINEQFF	TRBV9	TRBJ2-1
TGTGCCATCAGTGAGCGAGATACTGATATAGGACTACCCCTAGCCCCAGATACGCAGTATTTT	CAISERDTDIGLPLAPDTQYF	TRBV10-3	TRBJ2-3
TGTGACTGCAGGCGGGTAGCCAAAAACATTCAGTACTTC	CDCRRVAKNIQYF	TRBV25-1	TRBJ2-4
TGTGCCAGCAGCCCCCCGGGACAGAATTACACTGAAGCTTTCTTT	CASSPPGQNYTEAFF	TRBV5-6	TRBJ1-1
TGTGCCAGCAGTGACTCCTACGAGCAGTACTTC	CASSDSYEQYF	TRBV2	TRBJ2-7
TGTGCTAGTGGTGGGACCTCCTACAATGAGCAGTTCTTC	CASGGTSYNEQFF	TRBV12-5	TRBJ2-1
TGTGCCAGCAGGTATGAGCGGGGCATCTACAATGAGCAGTTCTTC	CASRYERGIYNEQFF	TRBV6-5	TRBJ2-1
TGCGCCAGCTTAACAGACACTAGCGGGCAAGCACAGACCTCAACAGATACGCAGTATTTT	CASLTDTSGQAQTSTDTQYF	TRBV10-1	TRBJ2-3
TGTGCCACCAGTGATTGGGGGGACAGGAGAAACATTCAGTACTTC	CATSDWGDRRNIQYF	TRBV24-1	TRBJ2-4
TGTGCCAGCAGCCATCAGGGAAGGACAGGGGTTAACAATGAGCAGTTCTTC	CASSHQGRTGVNNEQFF	TRBV3-1	TRBJ2-1
TGTGCCAGCAGTTACTTGAGAGGGGTTTATACAGATACGCAGTATTTT	CASSYLRGVYTDTQYF	TRBV6-6	TRBJ2-3
TGTGCCACCAGCAGAGTAAAGGGGCACAATGAGCAGTTCTTC	CATSRVKGHNEQFF	TRBV15	TRBJ2-1
TGTGCCAGCAGTTACAGGCCGTCGACTAGCGGCTCCTACAATGAGCAGTTCTTC	CASSYRPSTSGSYNEQFF	TRBV6-5	TRBJ2-1
TGTGCCAGCAGCTTTCGAACCGAAGCCGGGACAGGGGAGTGGCCCCAGCATTTT	CASSFRTEAGTGEWPQHF	TRBV5-8	TRBJ1-5
TGTGCCAGCATCCCCCCCAGGACTAGGGGGGGCTACGAGCAGTACTTC	CASIPPRTRGGYEQYF	TRBV14	TRBJ2-7
TGTGCCAGCAAAAGTGACAGGCGGGAATACGAGCAGTACTTC	CASKSDRREYEQYF	TRBV6-1	TRBJ2-7
TGCAGTGCTACCCCAGGCAGAAGCGGAAATCAGCCCCAGCATTTT	CSATPGRSGNQPQHF	TRBV20-1	TRBJ1-5
TGTGCCAGCAGTTACCCCTGCGAGCGGGAGGACACCGGGGAGCTGTTTTTT	CASSYPCEREDTGELFF	TRBV6-6	TRBJ2-2
TGCAGCGTTGCGGCGCGGGGGGAGCTGTTTTTT	CSVAARGELFF	TRBV29-1	TRBJ2-2
TGTGCCAGTAGTATCCGTGCCTGGACAGTAAGCTATGGCTACACCTTC	CASSIRAWTVSYGYTF	TRBV19	TRBJ1-2
TGCAGTGCTAATCGAGGGCATGGCTACACCTTC	CSANRGHGYTF	TRBV20-1	TRBJ1-2
TGTGCCAGCGCCCAGACCGCGCCCCAGCATTTT	CASAQTAPQHF	TRBV7-6	TRBJ1-5
TGCGCCAGCAGCTTGGCCTTGGGGGGAGAAGAGACCCAGTACTTC	CASSLALGGEETQYF	TRBV5-1	TRBJ2-5
TGTGCCACCAGTGAGTTCGGGGCGCTAGCCAAAAACATTCAGTACTTC	CATSEFGALAKNIQYF	TRBV24-1	TRBJ2-4
TGTGCCACCAGCTCCGGGGGTTCGAACACTGAAGCTTTCTTT	CATSSGGSNTEAFF	TRBV15	TRBJ1-1
TGCGCCAGCAGCCAAGAGAGCACTGAAGCTTTCTTT	CASSQESTEAFF	TRBV4-1	TRBJ1-1
TGTGCCAGCAGCCAAGTAGGTTGGGACAGGGGGCACAATGAGCAGTTCTTC	CASSQVGWDRGHNEQFF	TRBV3-1	TRBJ2-1
TGTGCCAGCAGCCCACAGGGGCTTGCAACTAATGAAAAACTGTTTTTT	CASSPQGLATNEKLFF	TRBV6-6	TRBJ1-4
TGTGCCAGCAGCGTACCAGGGCGTCAACGGGGACAGGGTGCCAAAAACATTCAGTACTTC	CASSVPGRQRGQGAKNIQYF	TRBV9	TRBJ2-4
TGTGCCAGCAGCGCCCAATGTACGGGACCCGGCACAGATACGCAGTATTTT	CASSAQCTGPGTDTQYF	TRBV11-2	TRBJ2-3
TGTGCCAGCAGTTCAGAAGATGTTGCTCAAGAGACCCAGTACTTC	CASSSEDVAQETQYF	TRBV6-5	TRBJ2-5
TGTGCCAGCAGCGTAGCCGAGGACGGGGCAGTAGTCAATTCACCCCTCCACTTT	CASSVAEDGAVVNSPLHF	TRBV9	TRBJ1-6
TGTGCTAGTGGGAGTACTAGCGGGAGGGTGATTTATAGCAATCAGCCCCAGCATTTT	CASGSTSGRVIYSNQPQHF	TRBV12-5	TRBJ1-5
TGTGCCAGCAGTTACAGCCTAGGGAGGAGCAATCAGCCCCAGCATTTT	CASSYSLGRSNQPQHF	TRBV6-5	TRBJ1-5
TGTGCCCCAACTGGACTAGCGGGAAACCGGAGCGAGCAGTACTTC	CAPTGLAGNRSEQYF	TRBV12-3	TRBJ2-7
TGTGCCAGCAGTTTCAGGGGGAGGAACACTGAAGCTTTCTTT	CASSFRGRNTEAFF	TRBV12-3	TRBJ1-1
TGTGCTAGTGGTTTGCGCAAAGGGGGACTAAGTGAAGCTTTCTTT	CASGLRKGGLSEAFF	TRBV12-5	TRBJ1-1
TGCGCCAGCAGCTTGGTCAGGGGACCTCGGGTCTCTGGAAACACCATATATTTT	CASSLVRGPRVSGNTIYF	TRBV5-1	TRBJ1-3
TGTGCCACCGTGACTAGCGGGAATGATGATGAGCAGTTCTTC	CATVTSGNDDEQFF	TRBV24-1	TRBJ2-1
TGTGCCAGCAGGGGGGGGCGGTACGAGCAGTACTTC	CASRGGRYEQYF	TRBV7-2	TRBJ2-7
TGTGCCAGCACAGTCCCCAGGCGCGGGGAGCTGTTTTTT	CASTVPRRGELFF	TRBV11-3	TRBJ2-2
TGTGCCAGCGAGACAGGGGCCGGTCTAAGGGATTGCTCTGGGGCCAACGTCCTGACTTTC	CASETGAGLRDCSGANVLTF	TRBV6-4	TRBJ2-6
TGTGCCAGCTCACCACCAAGGTCTAGCGGGGGGACCTACGAGCAGTACTTC	CASSPPRSSGGTYEQYF	TRBV18	TRBJ2-7
TGCGCCAGCAGCCCCGCGCTGCAAGAGACCCAGTACTTC	CASSPALQETQYF	TRBV5-1	TRBJ2-5
TGTGCCAGCAGTATTACGAATATAAAAAACATTCAGTACTTC	CASSITNIKNIQYF	TRBV12-4	TRBJ2-4
TGTGCCGCGATGGGACCCCGGGGGAGCTCCTACAATGAGCAGTTCTTC	CAAMGPRGSSYNEQFF	TRBV6-3	TRBJ2-1
TGCAGCGTTGCCCCGGAGGTAAGCAGGAGCAATCAGCCCCAGCATTTT	CSVAPEVSRSNQPQHF	TRBV29-1	TRBJ1-5
TGTGCCAGCAGCTCGAGCGGGGAGCTGTTTTTT	CASSSSGELFF	TRBV6-5	TRBJ2-2
TGCGCCAGCAGCCTCCAAGCCGGGGGCTCTAGCAATCAGCCCCAGCATTTT	CASSLQAGGSSNQPQHF	TRBV5-1	TRBJ1-5
TGTGCCAGCATATCGACAGGGGGTAACTATGGCTACACCTTC	CASISTGGNYGYTF	TRBV6-5	TRBJ1-2
TGCGCCAGCAGCCACGAAAGACAGGGAGAGCTTAACACTGAAGCTTTCTTT	CASSHERQGELNTEAFF	TRBV4-1	TRBJ1-1
TGTGCCAGCTCACCAAGCGGTATAGGTAAGGGGTACGAGCAGTACTTC	CASSPSGIGKGYEQYF	TRBV18	TRBJ2-7
TGTGCCAGCAGTGACTCGACAGAGCCATTCCGCCCTGAAGCTTTCTTT	CASSDSTEPFRPEAFF	TRBV6-4	TRBJ1-1
TGTGCCAGCAGTTCCCCGATCCCGACAGGTTCCTATGGCTACACCTTC	CASSSPIPTGSYGYTF	TRBV27	TRBJ1-2
TGTGCCAGCAGTCGACAGGGAACTGAAGCTTTCTTT	CASSRQGTEAFF	TRBV28	TRBJ1-1
TGCAGTGCGAAAGAGTACGTC	CSAKEYV	TRBV20-1	TRBJ2-7
TGTGCCAGCAGTGAATCACGTCCCGCATCGGCCCTCCACTTT	CASSESRPASALHF	TRBV25-1	TRBJ1-6
TGTGCCAGCAGCAAACTCCGCGGGACTTGGAATACGCAGTATTTT	CASSKLRGTWNTQYF	TRBV7-3	TRBJ2-3
TGTGCCAGCAGCCGAGACAACGAGCAGTACTTC	CASSRDNEQYF	TRBV5-4	TRBJ2-7
TGTGCCAGCAGTTACGACTGCGGGAGTCGCCAGCCCCAGCATTTT	CASSYDCGSRQPQHF	TRBV6-5	TRBJ1-5
TGTGCCAGCAGCGCTCCCGAGGACCGCAACTATGGCTACACCTTC	CASSAPEDRNYGYTF	TRBV9	TRBJ1-2
TGTGCCAGCAGCCCCGGGCTGGGACCTGCTTTCTTT	CASSPGLGPAFF	TRBV13	TRBJ1-1
TGTGCCAGCAGCTCCGCCACGGCGACCAATGAGCAGTTCTTC	CASSSATATNEQFF	TRBV7-9	TRBJ2-1
TGTTACCGGGACAAAGACTACGAGCAGTACTTC	CYRDKDYEQYF	TRBV19	TRBJ2-7
TGTGCCACCAGCAGAGATCCGGGGGGGCAGCACGATAACGAGCAGTACTTC	CATSRDPGGQHDNEQYF	TRBV15	TRBJ2-7
TGTGCCAGCAGCTTGTTTACTGACGTTATGACTTGGATGTCCTACGAGCAGTACTTC	CASSLFTDVMTWMSYEQYF	TRBV5-5	TRBJ2-7
TGTGCCAGCAGCCCCCCGGACAGGGGGCCTAACTATGGCTACACCTTC	CASSPPDRGPNYGYTF	TRBV7-3	TRBJ1-2
TGTGCCAGCAACCGCCCCAAGATGGCGGCGAACACTGAAGCTTTCTTT	CASNRPKMAANTEAFF	TRBV27	TRBJ1-1
TGTGCCAGCAGACCCGGAGGTGTTACAGATACGCAGTATTTT	CASRPGGVTDTQYF	TRBV12-3	TRBJ2-3
TGTGCCAGCAGCATGGGACTAGCGGACCGCACAGATACGCAGTATTTT	CASSMGLADRTDTQYF	TRBV7-4	TRBJ2-3
TGTGCCAGTAGTGTTTGTGCAACTAATGAAAAACTGTTTTTT	CASSVCATNEKLFF	TRBV19	TRBJ1-4
TGTGCCAGCAGTGAAGGGGGGGCGAACACCGGGGAGCTGTTTTTT	CASSEGGANTGELFF	TRBV6-3	TRBJ2-2
TGTGCCAGCAGCATCGGAAGGACCTACGAGCAGTACTTC	CASSIGRTYEQYF	TRBV7-2	TRBJ2-7
TGTGCCATCACCGAACAGCCCCAGCATTTT	CAITEQPQHF	TRBV10-3	TRBJ1-5
TGTGCCAGCAGCTCCCCTTGGAGTCAGGGGAGAAGAGCCTACGAGCAGTACTTC	CASSSPWSQGRRAYEQYF	TRBV5-6	TRBJ2-7
TGTGCCAGCAGCACCCTAGACAGGTGGGGCACAGATACGCAGTATTTT	CASSTLDRWGTDTQYF	TRBV7-4	TRBJ2-3
TGTGCCACGGCCTCCCGAAACTATCCCGGAGGGAACTACACAGATACGCAGTATTTT	CATASRNYPGGNYTDTQYF	TRBV24-1	TRBJ2-3
TGCGCCAGCCAAGGGAGGGGGCTCCCAACTAATGAAAAACTGTTTTTT	CASQGRGLPTNEKLFF	TRBV5-1	TRBJ1-4
TGTGCCAGCAGCCGACAGGGCTGGAACACTGAAGCTTTCTTT	CASSRQGWNTEAFF	TRBV25-1	TRBJ1-1
TGTGCCAGCAGTTTCCCTAAGACTAGCGGGGAGCTGTTTTTT	CASSFPKTSGELFF	TRBV27	TRBJ2-2
TGTGCCACCAGTGATTACCCCGACTCCTACAATGAGCAGTTCTTC	CATSDYPDSYNEQFF	TRBV24-1	TRBJ2-1
TGTGCCACAGGGGGTGAGGGCACCATATATTTT	CATGGEGTIYF	TRBV19	TRBJ1-3
TGTGCCAGTAGTATGGACAGGGGATCCCTGGTTATCTTCCCTAATGAAAAACTGTTTTTT	CASSMDRGSLVIFPNEKLFF	TRBV19	TRBJ1-4
TGTGCCAGCAGCCCCTCGACATGGACCGGGGAGCTGTTTTTT	CASSPSTWTGELFF	TRBV7-3	TRBJ2-2
TGTGCCAGCAGCTTGAGGGGGGGTTCGGGATTGGGGGTTATGCAGTACTTC	CASSLRGGSGLGVMQYF	TRBV7-8	TRBJ2-7
TGTGCCAGCAGCTTCGGGACTAGGGAGCTCAATGAGCAGTTCTTC	CASSFGTRELNEQFF	TRBV7-8	TRBJ2-1
TGTGCCAGCAGCGTAGCCTCGATGAGGGGACAGCCCTCCTACGAGCAGTACTTC	CASSVASMRGQPSYEQYF	TRBV9	TRBJ2-7
TGTGCCAGCAGCGGACAGAGGCGTGGAAACACCATATATTTT	CASSGQRRGNTIYF	TRBV7-3	TRBJ1-3
TGTGCCACCGGCCGGGACTCCTACGAGCAGTACTTC	CATGRDSYEQYF	TRBV10-3	TRBJ2-7
TGCACTCTACCGTTCAGGGCCGTCAATCAGCCCCAGCATTTT	CTLPFRAVNQPQHF	TRBV29-1	TRBJ1-5
TGTGCCTGGAGTGTGCTTAGGACCCACTTAAACACCATATATTTT	CAWSVLRTHLNTIYF	TRBV30	TRBJ1-3
TGCGCCAGCAGCCAGCTCGACGGTCGAGGCTACACCTTC	CASSQLDGRGYTF	TRBV4-1	TRBJ1-2
TGCAGTGCACGCATCATCGGCTACACCTTC	CSARIIGYTF	TRBV20-1	TRBJ1-2
TGTGCCAGCAGTTTATTGAATACCTTTTTGACAGGCTACACCTTC	CASSLLNTFLTGYTF	TRBV27	TRBJ1-2
TGTGCCGCGAGGGAGGGACTGCAGTTCTTC	CAAREGLQFF	TRBV19	TRBJ2-1
TGTGCCAGCAGAGAACCGGGGGCCTACAGGTCCACAGATACGCAGTATTTT	CASREPGAYRSTDTQYF	TRBV28	TRBJ2-3
TGTGCCAGCAGTATCGGGACCCAGTACTTC	CASSIGTQYF	TRBV6-5	TRBJ2-5
TGTGCCAGCGCAGGGACACGGGCCTACACTGAAGCTTTCTTT	CASAGTRAYTEAFF	TRBV6-4	TRBJ1-1
TGTGCCACCAGCCCCGGGTACAGGGGGCGCCTGCGAGGCACTGAAGCTTTCTTT	CATSPGYRGRLRGTEAFF	TRBV15	TRBJ1-1
TGTGCCATTCAGCGGGAGTCCTACGAGCAGTACTTC	CAIQRESYEQYF	TRBV28	TRBJ2-7
TGTGCCAGCAGCTTAGCCAGGTCTAGCGATAATGAGCAGTTCTTC	CASSLARSSDNEQFF	TRBV7-2	TRBJ2-1
TGTGCCAGCAGTTACTCCGGACAGGGGGCCTCCTCCTACGAGCAGTACTTC	CASSYSGQGASSYEQYF	TRBV6-3	TRBJ2-7
TGTGCCACCAGTGAATACGCTAGCGGGCCCTTTGCAGATACGCAGTATTTT	CATSEYASGPFADTQYF	TRBV24-1	TRBJ2-3
TGTGCCAGCAGTGAACCCGGGGGTTTAGTAACCTACAATGAGCAGTTCTTC	CASSEPGGLVTYNEQFF	TRBV6-1	TRBJ2-1
TGTGCCACCAATCCCGGGACTTGGCACAATGAGCAGTTCTTC	CATNPGTWHNEQFF	TRBV24-1	TRBJ2-1
TGTGCCAGCAGCCATCTACGACAGGGTCCCCTGAACACTGAAGCTTTCTTT	CASSHLRQGPLNTEAFF	TRBV11-3	TRBJ1-1
TGTGCCAGCAGTACGCTAGCGGCGCCCACTAGCTCCTACAATGAGCAGTTCTTC	CASSTLAAPTSSYNEQFF	TRBV28	TRBJ2-1
TGTGCCAGCGGAACTTTATTAGTATCCTATGGCTACACCTTC	CASGTLLVSYGYTF	TRBV11-3	TRBJ1-2
TGTGCCACCAGTGATCCCCCCTTGGGGCTGGAGGTGACCACGGTTGGCTACACCTTC	CATSDPPLGLEVTTVGYTF	TRBV24-1	TRBJ1-2
TGCAGTGCCAGATATTCCTACGAGCAGTACTTC	CSARYSYEQYF	TRBV20-1	TRBJ2-7
TGTGCCAGCAGCAAACAGGCGTATGAGCAGTTCTTC	CASSKQAYEQFF	TRBV14	TRBJ2-1
TGTGCCAGCAATAGACTCTCCTACAATGAGCAGTTCTTC	CASNRLSYNEQFF	TRBV3-1	TRBJ2-1
TGCGCCAGCAGCCCCTTAGGGGATCAGCCCCAGCATTTT	CASSPLGDQPQHF	TRBV4-1	TRBJ1-5
TGTGCCAGCAGCCACCAGGACAGGGCGAACACCGGGGAGCTGTTTTTT	CASSHQDRANTGELFF	TRBV4-2	TRBJ2-2
TGTGCCAGCAGTGCCGGGACAGGGGGCAGTAACTATGGCTACACCTTC	CASSAGTGGSNYGYTF	TRBV6-4	TRBJ1-2
TGTGCCAGCAGCCGACAGGGAAGCTCCTACAATGAGCAGTTCTTC	CASSRQGSSYNEQFF	TRBV14	TRBJ2-1
TGCGAGATTTTGGGACTAGCGGGGGGGCAGGGGGACTCGGACAATGAGCAGTTCTTC	CEILGLAGGQGDSDNEQFF	TRBV20-1	TRBJ2-1
TGTGCCAGCAGATGTACCACGGGACAGGGTGGTTCACCCCTCCACTTT	CASRCTTGQGGSPLHF	TRBV6-1	TRBJ1-6
TGTGCCAGCAGTGGTAGACTAGTAGAGGCAGATACGCAGTATTTT	CASSGRLVEADTQYF	TRBV27	TRBJ2-3
TGTGCCTGGAGGGCTAGGGACAGAAGGTGCTCTGGGGCCAACGTCCTGACTTTC	CAWRARDRRCSGANVLTF	TRBV30	TRBJ2-6
TGCGCCAGCAGCTTCCTAGGGACCCGACTCAACTATGGCTACACCTTC	CASSFLGTRLNYGYTF	TRBV5-1	TRBJ1-2
TGCAGTGCTAGAGATCTGCCCACAGGAGGGCAGAAGACTGGCTACACCTTC	CSARDLPTGGQKTGYTF	TRBV20-1	TRBJ1-2
TGCAGCGAGGCGGGACCCTTAAACTATGGCTACACCTTC	CSEAGPLNYGYTF	TRBV29-1	TRBJ1-2
TGTGCTAGTGGGGGGACTAGCGGTCGTGGAGGGGAGCTGTTTTTT	CASGGTSGRGGELFF	TRBV12-5	TRBJ2-2
TGCAGTGCTAGAGATTGCTACAGGGGGAGCCCGAACACTGAAGCTTTCTTT	CSARDCYRGSPNTEAFF	TRBV20-1	TRBJ1-1
TGTGCCAGCAGGGGGTTTCTCGAAAAACTGTTTTTT	CASRGFLEKLFF	TRBV9	TRBJ1-4
TGCAGTGCTACCCCCCCTGACACCGGGACAGGTACCATATATTTT	CSATPPDTGTGTIYF	TRBV20-1	TRBJ1-3
TGTGCCAGCAGCTCCGGGACAGCGCAGCCCCAGCATTTT	CASSSGTAQPQHF	TRBV5-4	TRBJ1-5
TGTGCCAGCCCCGGGGAGTTGAACACTGAAGCTTTCTTT	CASPGELNTEAFF	TRBV25-1	TRBJ1-1
TGCGCCAGCAGCAGGGCTTGTCCTCCAGATACGCAGTATTTT	CASSRACPPDTQYF	TRBV5-1	TRBJ2-3
TGTGCCATCAGTGAGTTTGGGGCAAGTGGGGGTGGCTCCTACAATGAGCAGTTCTTC	CAISEFGASGGGSYNEQFF	TRBV10-3	TRBJ2-1
TGTGCCAGCAGGTACCGGAGAGGACTAGGGAATGAGCAGTTCTTC	CASRYRRGLGNEQFF	TRBV6-4	TRBJ2-1
TGTGCCACCAGTGATGGTCCCCGTGGAAACACCATATATTTT	CATSDGPRGNTIYF	TRBV24-1	TRBJ1-3
TGTGCCAGCAGTTACCTTCCAATTACCGAGGGGCCCCAAGAGCAGTACTTC	CASSYLPITEGPQEQYF	TRBV6-5	TRBJ2-7
TGCGCCAGCAGTGCCCCGGGGTCTGGGAGTAACTATGGCTACACCTTC	CASSAPGSGSNYGYTF	TRBV10-1	TRBJ1-2
TGTGCCAGCAGCACAGGGGCCTGGGACCAAAAACTGTTTTTT	CASSTGAWDQKLFF	TRBV13	TRBJ1-4
TGTGCCAGCAGCTTCGGACTTGCTGAAGCTTTCTTT	CASSFGLAEAFF	TRBV7-7	TRBJ1-1
TGTGCCAGCAGCTTGGCCCGACATGGTAGTCTTTACAATGAGCAGTTCTTC	CASSLARHGSLYNEQFF	TRBV5-6	TRBJ2-1
TGTGCCTGGAGTGGGACTAGCGGGGGCGTTCCGACCGAGCAGTACTTC	CAWSGTSGGVPTEQYF	TRBV30	TRBJ2-7
TGTGCCATCAGGGGAAAGGGTACCAGCGGGGAGCTGTTTTTT	CAIRGKGTSGELFF	TRBV10-3	TRBJ2-2
TGTGCCACCAGTGCTAGAAGCTCCTACAATGAGCAGTTCTTC	CATSARSSYNEQFF	TRBV24-1	TRBJ2-1
TGTGCTAGTGGTTTGGTACGGGGAGGTAGCTCCTACGAGCAGTACTTC	CASGLVRGGSSYEQYF	TRBV12-5	TRBJ2-7
TGTGCCAGCAGTGGCCACGGCTCCTACGAGCAGTACTTC	CASSGHGSYEQYF	TRBV6-1	TRBJ2-7
TGTGCCAGCAGGGGGACAGGGGATGGCTACACCTTC	CASRGTGDGYTF	TRBV12-4	TRBJ1-2
TGTGCCAGCAGGGGGGCGGAATTGAACTACGAGCAGTACTTC	CASRGAELNYEQYF	TRBV14	TRBJ2-7
TGTGCCAGCAGTTACTCATCCCCCTTCCGGGGACAGATCCAAAAAGGAAACACCATATATTTT	CASSYSSPFRGQIQKGNTIYF	TRBV6-6	TRBJ1-3
TGTGCCAGCAGGATTGAGCAGTACACTGAAGCTTTCTTT	CASRIEQYTEAFF	TRBV6-5	TRBJ1-1
TGTGCCAGCAGTTACGGGAGGGTTTGTATGATTCAGCCCCAGCATTTT	CASSYGRVCMIQPQHF	TRBV6-2	TRBJ1-5
TGTGCCAGCAGTTTGCCCCCGAGAGGGCTAGCTAACTATGGCTACACCTTC	CASSLPPRGLANYGYTF	TRBV12-3	TRBJ1-2
TGTGCCAGCAGCCAAGACCAAATGAGGGTTAGGGTTGAAAAACTGTTTTTT	CASSQDQMRVRVEKLFF	TRBV14	TRBJ1-4
TGTGCCAGCATAAGCGGGGGGCAATACACCGGGGAGCTGTTTTTT	CASISGGQYTGELFF	TRBV27	TRBJ2-2
TGCGCCAGCGGCTTAGGCGGGAACTCCTACAATGAGCAGTTCTTC	CASGLGGNSYNEQFF	TRBV5-1	TRBJ2-1
TGTGCCACCAGTGATTTGGTCCAATTGGCGATAGATCAGCCCCAGCATTTT	CATSDLVQLAIDQPQHF	TRBV24-1	TRBJ1-5
TGTGCCAGCAGCGTCGAAAGCTTAGCGGGTCTTGCCACAGATACGCAGTATTTT	CASSVESLAGLATDTQYF	TRBV9	TRBJ2-3
TGTGCCAGCAGCTTCATCGGGGCTTTCTTT	CASSFIGAFF	TRBV5-4	TRBJ1-1
TGTGCCAGCAGCTTAGGAAGTTGGCAGCCCCAGCATTTT	CASSLGSWQPQHF	TRBV7-8	TRBJ1-5
TGTGCCAGAGGGGACTTCGGAGTTGGTTCCTACGAGCAGTACTTC	CARGDFGVGSYEQYF	TRBV6-4	TRBJ2-7
TGTGCCAGCAGCTCGGGACACTCGGTGTCCTACGAGCAGTACTTC	CASSSGHSVSYEQYF	TRBV7-8	TRBJ2-7
TGTGCCATAAGATGGGAAGCTTTCTTT	CAIRWEAFF	TRBV27	TRBJ1-1
TGTGCCAGCAGTTGCAATTTCAGGGGAAGGAACACTGAAGCTTTCTTT	CASSCNFRGRNTEAFF	TRBV12-4	TRBJ1-1
TGTGCCATCAGTGGGGACAGGGGGCTGAACTATAGAAAACTGTTTTTT	CAISGDRGLNYRKLFF	TRBV10-3	TRBJ1-4
TGTGCCAGCAGCGCCCAGGGCTACGAGCAGTACTTC	CASSAQGYEQYF	TRBV13	TRBJ2-7
TGCAGTGCTAGAGCCCACCCCCCAGGGACTGAAGCTTTCTTT	CSARAHPPGTEAFF	TRBV20-1	TRBJ1-1
TGTGCCAGTTCTAGCGGTACAGATACGCAGTATTTT	CASSSGTDTQYF	TRBV6-6	TRBJ2-3
TGTGCCAGCAGCTTTACCACCTACGAGCAGTACTTC	CASSFTTYEQYF	TRBV13	TRBJ2-7
TGCGCCAGCAGCTTGTGGCGTTACCACTGGAGGATCTACTATGGCTACACCTTC	CASSLWRYHWRIYYGYTF	TRBV5-1	TRBJ1-2
TGTGCCGGGGACAGGGTTTTGGGCCTGAACACTGAAGCTTTCTTT	CAGDRVLGLNTEAFF	TRBV27	TRBJ1-1
TGTGCCAGCAGCCAAGGGAAGGACAGGCAGTACGAGCAGTACTTC	CASSQGKDRQYEQYF	TRBV3-1	TRBJ2-7
TGCAGTGGGGGGTCCGGGACGTTAGAGACCCAGTACTTC	CSGGSGTLETQYF	TRBV20-1	TRBJ2-5
TGTGCCAGCAGCACAGGTAGGGGGCGGGGATTCACCGGGGAGCTGTTTTTT	CASSTGRGRGFTGELFF	TRBV13	TRBJ2-2
TGTGCCACCAGTGACCCTCTAGAGGGAGAATACAATGAGCAGTTCTTC	CATSDPLEGEYNEQFF	TRBV24-1	TRBJ2-1
TGTGCCAGCAGCTTTAACAATCAGCCCCAGCATTTT	CASSFNNQPQHF	TRBV7-9	TRBJ1-5
TGTGCCAGCAGCCCTCAACAGGGACGGCCCTACGAGCAGTACTTC	CASSPQQGRPYEQYF	TRBV13	TRBJ2-7
TGTGCCAGCAGCACTGAGGTGGGACAGGGGTTACTTAACTATGGCTACACCTTC	CASSTEVGQGLLNYGYTF	TRBV7-2	TRBJ1-2
TGCGCCAGGGCACTACTAAAAGATAGCAATCAGCCCCAGCATTTT	CARALLKDSNQPQHF	TRBV10-2	TRBJ1-5
TGTGCCAGCAGCCCTAGCGGGAAGAAGACCGGGGAGCTGTTTTTT	CASSPSGKKTGELFF	TRBV27	TRBJ2-2
TGTGCCAAACCCGTGACAGGGGTAGACTGCATGAACACTGAAGCTTTCTTT	CAKPVTGVDCMNTEAFF	TRBV25-1	TRBJ1-1
TGTGCCAGCATCGACAGGGGCAAACTTGGGGCCAACGTCCTGACTTTC	CASIDRGKLGANVLTF	TRBV6-1	TRBJ2-6
TGTGCCAGCAGTGGGCGGACCAATCAGCCCCAGCATTTT	CASSGRTNQPQHF	TRBV6-5	TRBJ1-5
TGTGCCAGCAGCGAGGGACAGGGGCTTTTTAAGATGACTGAAGCTTTCTTT	CASSEGQGLFKMTEAFF	TRBV7-4	TRBJ1-1
TGTGCCAGCAGCGTTTCTGGGGGCCCGGGGACAGATACGCAGTATTTT	CASSVSGGPGTDTQYF	TRBV13	TRBJ2-3
TGTGCCAGCAGCTTAGCGCCCTCCGGCACATACGAGCAGTACTTC	CASSLAPSGTYEQYF	TRBV7-9	TRBJ2-7
TGTGCCAGCAGCTTAAGGTTTTATGGTCAGCCCCAGCATTTT	CASSLRFYGQPQHF	TRBV11-3	TRBJ1-5
TGTGCCAGCAGTTACCCTGCCAGGGTGGAAGCTTTCTTT	CASSYPARVEAFF	TRBV6-2	TRBJ1-1
TGTGCCAGCATACGACAGGGCGCCAGCAATCAGCCCCAGCATTTT	CASIRQGASNQPQHF	TRBV6-2	TRBJ1-5
TGTGCCAGCAACAGGGTAGTTACCGGGGAGCTGTTTTTT	CASNRVVTGELFF	TRBV7-2	TRBJ2-2
TGTGCCAGCAGTTACCCCGTGGGCCGGGGGGGCGAGCAGTACTTC	CASSYPVGRGGEQYF	TRBV12-4	TRBJ2-7
TGTGCCAGCAGCTTAGCGCAGGGAGAGACCCAGTACTTC	CASSLAQGETQYF	TRBV7-6	TRBJ2-5
TGTGCCAGCAGCTTGGAGGGGAGGCTAGAGCAGTACTTC	CASSLEGRLEQYF	TRBV11-3	TRBJ2-7
TGCGCCAGCAGTGAGTCCTGGGACAGGAAATACGAGCAGTACTTC	CASSESWDRKYEQYF	TRBV10-1	TRBJ2-7
TGTGCCAGCAGCTTAGTCCCGGGACTAGCGGGCCCACCTAGCACAGATACGCAGTATTTT	CASSLVPGLAGPPSTDTQYF	TRBV7-9	TRBJ2-3
TGTGCCAGCAGTTTGGGGGCCGATGGGAATGAGCAGTTCTTC	CASSLGADGNEQFF	TRBV12-3	TRBJ2-1
TGTGCCAGGTGGATTCAGGTAGAGGGTCAGACCGGGGAGCTGTTTTTT	CARWIQVEGQTGELFF	TRBV19	TRBJ2-2
TGTGCCAGCAGTTACTCGAGGCAGGAATCCCCCGGCTATGGCTACACCTTC	CASSYSRQESPGYGYTF	TRBV6-5	TRBJ1-2
TGTGCCAGCAGCTTTATAGGGGAGGAGGGATATAGCAATCAGCCCCAGCATTTT	CASSFIGEEGYSNQPQHF	TRBV13	TRBJ1-5
TGTGCCAGCAGCTGCGAATTGACATATCAGCCCCAGCATTTT	CASSCELTYQPQHF	TRBV3-1	TRBJ1-5
TGTGCCAGCAGCCCCTCACGGGACAGGGGGCATCCCCGGAACACTGAAGCTTTCTTT	CASSPSRDRGHPRNTEAFF	TRBV14	TRBJ1-1
TGCGCCAGCAGCCTCCCGGGACTAGCGCTAAACCCCTACGAGCAGTACTTC	CASSLPGLALNPYEQYF	TRBV5-1	TRBJ2-7
TGTGCCACCAGTGCCCTAGCGGACTATGGGTCCTACAATGAGCAGTTCTTC	CATSALADYGSYNEQFF	TRBV24-1	TRBJ2-1
TGTGCCAGTAGTGTCCACAGGGGGGGACAGGCTTCGTACGAGCAGTACTTC	CASSVHRGGQASYEQYF	TRBV19	TRBJ2-7
TGTGCCAGCAGTGGGAGGGGTAATGAAAAACTGTTTTTT	CASSGRGNEKLFF	TRBV6-4	TRBJ1-4
TGTGCCAGCTCACCTGACAGATACACTGAAGCTTTCTTT	CASSPDRYTEAFF	TRBV18	TRBJ1-1
TGTGCCAGTAGTATAGCCGAGCCCAAAAACATTCAGTACTTC	CASSIAEPKNIQYF	TRBV19	TRBJ2-4
TGTGCCAGCAGCGTAGAGACGGGGGCTGGGTGGAACACAGGCACAGATACGCAGTATTTT	CASSVETGAGWNTGTDTQYF	TRBV9	TRBJ2-3
TGCGCCAGCAGCTTGGTAGGAAGAAGGACAGCTGGCAATCAGCCCCAGCATTTT	CASSLVGRRTAGNQPQHF	TRBV5-1	TRBJ1-5
TGTGCCAGCAGCCCCCCGTCGACAGTAGCGGGGATAAGCTCCTACGAGCAGTACTTC	CASSPPSTVAGISSYEQYF	TRBV13	TRBJ2-7
TGCAGCGTTGACCGGACTTGCATGAACACTGAAGCTTTCTTT	CSVDRTCMNTEAFF	TRBV29-1	TRBJ1-1
TGTGCCAGCATCCCCCTGGTTGGGCTGGCCAAAAACATTCAGTACTTC	CASIPLVGLAKNIQYF	TRBV27	TRBJ2-4
TGCGCCAGCAGCCAAGTCAGGGGGGAGGAGAACACTGAAGCTTTCTTT	CASSQVRGEENTEAFF	TRBV4-1	TRBJ1-1
TGTGCCAGCAGCCGACGATCGAGGCCCCAGCATTTT	CASSRRSRPQHF	TRBV11-3	TRBJ1-5
TGTGCCAGCAGTGACACGAGGAAATGGCTTAATGAAAAACTGTTTTTT	CASSDTRKWLNEKLFF	TRBV6-4	TRBJ1-4
TGTGCCAGCAGCCCCAACAGGGTAGAGAACACTGAAGCTTTCTTT	CASSPNRVENTEAFF	TRBV7-3	TRBJ1-1
TGTGCCAGCAGCACTAATCAGCCCCAGCATTTT	CASSTNQPQHF	TRBV9	TRBJ1-5
TGTGCCAGCAGTTTGCGTTCTACAGGGGTTTGGCAAGAGACCCAGTACTTC	CASSLRSTGVWQETQYF	TRBV27	TRBJ2-5
TGTGCCAGCACATTCCCTCTAAATAAGTCTGCAACTAATGAAAAACTGTTTTTT	CASTFPLNKSATNEKLFF	TRBV6-5	TRBJ1-4
TGCAGTGCTAGCCCGGTGGGACTCTTC	CSASPVGLF	TRBV20-1	TRBJ2-1
TGTGCCAGCAGCTGGCCTAAGGGGAGCTACGAGCAGTACTTC	CASSWPKGSYEQYF	TRBV7-9	TRBJ2-7
TGTGCCAGCAGTTTACAGAGACTAGGAAGGGGAGAGACCCAGTACTTC	CASSLQRLGRGETQYF	TRBV6-1	TRBJ2-5
TGTGCCAGCATAAGCCTCTATACGCAGTATTTT	CASISLYTQYF	TRBV7-3	TRBJ2-3
TGTGCCATCAGGTCGTCGGGACAGGGGAAGAACACCGGGGAGCTGTTTTTT	CAIRSSGQGKNTGELFF	TRBV10-3	TRBJ2-2
TGTGCCAGCAGCTTAACATCAGGTACGAACACCGGGGAGCTGTTTTTT	CASSLTSGTNTGELFF	TRBV11-2	TRBJ2-2
TGTGCCAGCCAAAAGTTGCCCGAGCCCAACCACGAGCAGTACTTC	CASQKLPEPNHEQYF	TRBV6-6	TRBJ2-7
TGTGCCACCAGTTGTCAGGGGAATCAGCCCCAGCATTTT	CATSCQGNQPQHF	TRBV24-1	TRBJ1-5
TGTGCCAGCAGCCTTAGTTTGTATGGCTACACCTTC	CASSLSLYGYTF	TRBV14	TRBJ1-2
TGCGCCAGCAGCCTTCAGACGAACACTGAAGCTTTCTTT	CASSLQTNTEAFF	TRBV4-1	TRBJ1-1
TGTGCCACCAGTGATTTTCGGTGTCGGGGTCCGGTCTACGAGCAGTACTTC	CATSDFRCRGPVYEQYF	TRBV24-1	TRBJ2-7
TGCGCCAGCAGCCAAGGTGCGACAGGAACGATCTTCACTGAAGCTTTCTTT	CASSQGATGTIFTEAFF	TRBV4-1	TRBJ1-1
TGTGCCAGCAGCCTAGCGGGTCTGTCTAGCACAGATACGCAGTATTTT	CASSLAGLSSTDTQYF	TRBV7-4	TRBJ2-3
TGTGCCAGCAGTAGGGGGGGGCCCCTCATTTCTTTGGGAACATACGAGCAGTACTTC	CASSRGGPLISLGTYEQYF	TRBV6-2	TRBJ2-7
TGTGCCACCAGAGACCTGTCACCGGGACGTTGGGATGGCTACGAGCAGTACTTC	CATRDLSPGRWDGYEQYF	TRBV24-1	TRBJ2-7
TGTGCCAGCAGTGTAAAGGACCTAGGGATGAACACTGAAGCTTTCTTT	CASSVKDLGMNTEAFF	TRBV6-4	TRBJ1-1
TGTGCCAGCAGTTTATACTGGACCGGACAGGGCGAGCAGTACTTC	CASSLYWTGQGEQYF	TRBV28	TRBJ2-7
TGTGCCAGCAGCTTACCACCGGGACAGGGGCTAGCGGGTAATGAAAAACTGTTTTTT	CASSLPPGQGLAGNEKLFF	TRBV11-1	TRBJ1-4
TGTGCCTCAAGGGTCTTTACAGGGAGGACCTACGAGCAGTACTTC	CASRVFTGRTYEQYF	TRBV27	TRBJ2-7
TGCGCCAGCAGCTTGACCCTAGCGGATGAGCAGTTCTTC	CASSLTLADEQFF	TRBV5-1	TRBJ2-1
TGTGCCAGTATAAGCTGTCGGGGGTATAGCTCCTACAATGAGCAGTTCTTC	CASISCRGYSSYNEQFF	TRBV19	TRBJ2-1
TGTGCCAGCAGTGTCCGATCTGCGAACACCGGGGAGCTGTTTTTT	CASSVRSANTGELFF	TRBV25-1	TRBJ2-2
TGCAGTGCTCTCAGGGTGGTAGAGGCTAGGGCCACAGATACGCAGTATTTT	CSALRVVEARATDTQYF	TRBV20-1	TRBJ2-3
TGTGCCAGCAGACGGGAAGGTGGTGAGCAGTTCTTC	CASRREGGEQFF	TRBV27	TRBJ2-1
TGCGCCAGCAACTGCCCTAGCTACTACGAGCAGTACTTC	CASNCPSYYEQYF	TRBV10-1	TRBJ2-7
TGTGCCACCAGCAGCTGGGGGCAAGAGACCCAGTACTTC	CATSSWGQETQYF	TRBV15	TRBJ2-5
TGCGGTGGGGGTGGTGGAACCACTGAAGCTTTCTTT	CGGGGGTTEAFF	TRBV20-1	TRBJ1-1
TGTGCCAGCAGGAACAAAAGAGGGTCCCCCCGTCCGGTCTGTCGGGATCAGCCCCAGCATTTT	CASRNKRGSPRPVCRDQPQHF	TRBV12-4	TRBJ1-5
TGTGCCACCAGTGTACCGACACATCAGCCCCAGCATTTT	CATSVPTHQPQHF	TRBV24-1	TRBJ1-5
TGTGCCAGCAGCGTAGTTCTTCACAGGGCCCGGACTAGCACAGATACGCAGTATTTT	CASSVVLHRARTSTDTQYF	TRBV9	TRBJ2-3
TGTGCCACCAGCGACAGGGGTGGAATATACTACGAGCAGTACTTC	CATSDRGGIYYEQYF	TRBV24-1	TRBJ2-7
TGTGCCAGCAGCGCCCCGGTCGATATTAGTAACTATGGCTACACCTTC	CASSAPVDISNYGYTF	TRBV9	TRBJ1-2
TGTGCCAGCAGTGGGGGGACATTTAGAGGCTACACCTTC	CASSGGTFRGYTF	TRBV6-5	TRBJ1-2
TGTGCCAGCATCCGGGACAAGTTCTCCCTCGTGCCCCAGCATTTT	CASIRDKFSLVPQHF	TRBV6-5	TRBJ1-5
TGTGCCAGCAGTTTATGGGGACAGGAGACGCAGTACTTC	CASSLWGQETQYF	TRBV28	TRBJ2-7
TGTGCCTACCCGGGGGACAATGAGCAGTTCTTC	CAYPGDNEQFF	TRBV24-1	TRBJ2-1
TGTGCCCTCAGTCCAGCGGGAGGTTGTAACTATGGCTACACCTTC	CALSPAGGCNYGYTF	TRBV2	TRBJ1-2
TGCAGTGCCCCGGGACAGGGTTCCCCCACAGATACGCAGTATTTT	CSAPGQGSPTDTQYF	TRBV20-1	TRBJ2-3
TGCGCCAGCAGCGGTTGTACAGCATTAATAGCGGGCACCGGGGAGCTGTTTTTT	CASSGCTALIAGTGELFF	TRBV5-1	TRBJ2-2
TGCAGCGTGAAGTTTAGGACAGGGGGGCCGAACACTGAAGCTTTCTTT	CSVKFRTGGPNTEAFF	TRBV29-1	TRBJ1-1
TGTGCCAGCAGCTTCTTGGGACAGAGCTCTGGGGCCAACGTCCTGACTTTC	CASSFLGQSSGANVLTF	TRBV5-4	TRBJ2-6
TGTGCCAGCAGCGGGTGCGGGAGCTCCTACGAGCAGTACTTC	CASSGCGSSYEQYF	TRBV7-4	TRBJ2-7
TGTGCCAGCAGCTTAGACTTAAGGGGGGGAACACACCCTCAGCCCCAGCATTTT	CASSLDLRGGTHPQPQHF	TRBV7-9	TRBJ1-5
TGTGCCAGCACACTTTACAGGGTGGTCTGGAGTTTAGAGACCCAGTACTTC	CASTLYRVVWSLETQYF	TRBV6-1	TRBJ2-5
TGCAGTGCTAGAGAGTTATTTCCCAAGGGGGGGAATGGCTACACCTTC	CSARELFPKGGNGYTF	TRBV20-1	TRBJ1-2
TGTGCCAGCAGCTTAGTAGCGGGAGTGGGAGAGACCCAGTACTTC	CASSLVAGVGETQYF	TRBV7-6	TRBJ2-5
TGTGCCAGCAGTGTGGGGATTGAAGCTTTCTTT	CASSVGIEAFF	TRBV6-3	TRBJ1-1
TGCGCCAGCAGCCAAGATGCAGGGGGAGGAGGGATGAACACTGAAGCTTTCTTT	CASSQDAGGGGMNTEAFF	TRBV4-1	TRBJ1-1
TGTGCCAGCAGGGCCCGGCTAGGTTGCTACGAGCAGTACTTC	CASRARLGCYEQYF	TRBV7-3	TRBJ2-7
TGTGCCAGCAGCCAAGATAGGAAAAGCCTAGCGGAGGACACCGGGGAGCTGTTTTTT	CASSQDRKSLAEDTGELFF	TRBV4-2	TRBJ2-2
TGCGCCAGAGGGAGGGGTTGTGAAGCCTACGAGCAGTACTTC	CARGRGCEAYEQYF	TRBV10-1	TRBJ2-7
TGTGCCAGCAGCCAAAGGGGAGGTGAGCAGTTCTTC	CASSQRGGEQFF	TRBV14	TRBJ2-1
TGTGCCAGCAGCTATCTATTCTGGCACGAGCAGTACTTC	CASSYLFWHEQYF	TRBV7-2	TRBJ2-7
TGTGCCAGCAGCGGAACCTCTAGTTGCCCGTTAGTCGGCACAGATACGCAGTATTTT	CASSGTSSCPLVGTDTQYF	TRBV7-4	TRBJ2-3
TGTGCCAGCTCTTCAGGGGTGGAAGGCTACACCTTC	CASSSGVEGYTF	TRBV24-1	TRBJ1-2
TGTGCCAGCACATTCGGAAACCGTTCCTACGAGCAGTACTTC	CASTFGNRSYEQYF	TRBV27	TRBJ2-7
TGTGCCAGCAGCTTAGCGCTCCCTTTTAGGGACAGAGAAATCGTGAACACTGAAGCTTTCTTT	CASSLALPFRDREIVNTEAFF	TRBV7-9	TRBJ1-1
TGTGCCAGCAGTAAGTTAGCGGGATGGGACTCCTACGAGCAGTACTTC	CASSKLAGWDSYEQYF	TRBV2	TRBJ2-7
TGTGCCAGCAGATTCTCTCCAGACACCGGGGAGCTGTTTTTT	CASRFSPDTGELFF	TRBV6-2	TRBJ2-2
TGTGCCAGCAGTTATTGTCGACTAGCCAAAAACATTCAGTACTTC	CASSYCRLAKNIQYF	TRBV6-5	TRBJ2-4
TGCGCCAGCAGTGAGGATCTTAGGGACAGGGCCCAGCATTTT	CASSEDLRDRAQHF	TRBV10-1	TRBJ1-5
TGTGCTAGTGGTTTGGCGGACAGTTCCCCCCCGGGACAGGGTTACACTGAAGCTTTCTTT	CASGLADSSPPGQGYTEAFF	TRBV12-5	TRBJ1-1
TGTGCCAGCAGCCGAACAGGGAATGGCTACACCTTC	CASSRTGNGYTF	TRBV13	TRBJ1-2
TGTGCCAGCAGCCAAGATCCAGGGGCTGGCTACACCTTC	CASSQDPGAGYTF	TRBV14	TRBJ1-2
TGTGCCAGCAGCAATTGGACTAGCGGGGGAGTACGCCAAGAGACCCAGTACTTC	CASSNWTSGGVRQETQYF	TRBV13	TRBJ2-5
TGTGCCAGCAGTCATAGCGGGAACAAAGCTTTCTTT	CASSHSGNKAFF	TRBV28	TRBJ1-1
TGTGCCAGCAGCTTGCCGGGACAGGTGGAGCAGTACTTC	CASSLPGQVEQYF	TRBV5-4	TRBJ2-7
TGTGCCAGCGTAGCGGAAACAGATACGCAGTATTTT	CASVAETDTQYF	TRBV7-9	TRBJ2-3
TGTGCCAGCAGTGAAAGAGCCGAGACAGGGGGACATAATTCACCCCTCCACTTT	CASSERAETGGHNSPLHF	TRBV6-1	TRBJ1-6
TGTGCCAGCAGTGATTGCGGCGACATTCAGTACTTC	CASSDCGDIQYF	TRBV6-4	TRBJ2-4
TGTGCCAGCAGCCAAGGAACGTTTTTTGAAGCTTTCTTT	CASSQGTFFEAFF	TRBV3-1	TRBJ1-1
TGTGCCAGCAGTGTGGCAACGGAAGACTCGGAGGAGCAGTACTTC	CASSVATEDSEEQYF	TRBV6-1	TRBJ2-7
TGTGCCAGCAGCTTTGTTCCGGGTGACAGGATCCGTCCCAAAAACATTCAGTACTTC	CASSFVPGDRIRPKNIQYF	TRBV5-6	TRBJ2-4
TGTGCCAGCATTAGACGTATGAATCAGCCCCAGCATTTT	CASIRRMNQPQHF	TRBV5-4	TRBJ1-5
TGTGCCAGCAGCTTAGCCTCTGGGGGCGGCTACACCTTC	CASSLASGGGYTF	TRBV7-9	TRBJ1-2
TGTGCCAGTAGAGAGTTTCCAAGGCACGGGACTTACGAGCAGTACTTC	CASREFPRHGTYEQYF	TRBV19	TRBJ2-7
TGTGCCACCGGACAGGGGGTAGAGCCCCAGCATTTT	CATGQGVEPQHF	TRBV15	TRBJ1-5
TGCAGCGTTGTCCGGGGAACAGACAGAGCTTTCTTT	CSVVRGTDRAFF	TRBV29-1	TRBJ1-1
TGTGCCAGCAGACAGTCCAGCTCCTACGAGCAGTACTTC	CASRQSSSYEQYF	TRBV12-3	TRBJ2-7
TGCGCCAGCAGCAGGGTGGGCCGCCCGGGGGAGAGGTGCAACACCGGGGAGCTGTTTTTT	CASSRVGRPGERCNTGELFF	TRBV5-1	TRBJ2-2
TGTGCCAGCAGCTCTATCAGGGGGAGGGAAGCTTTCTTT	CASSSIRGREAFF	TRBV7-9	TRBJ1-1
TGTGCCGTGGGGCACGCCCAAGAGACCCAGTACTTC	CAVGHAQETQYF	TRBV27	TRBJ2-5
TGTGCCAGCAGTTACTCGGGCAAGGGAAACACCATATATTTT	CASSYSGKGNTIYF	TRBV6-5	TRBJ1-3
TGTGCTAGTGACCCGCGGGAGATGGCGTTAAACACTGAAGCTTTCTTT	CASDPREMALNTEAFF	TRBV12-5	TRBJ1-1
TGTGCTAGTGGATTGTGGGACCAATACGAGCAGTACTTC	CASGLWDQYEQYF	TRBV12-5	TRBJ2-7
TGTGCCAGGGTCGGTAGGGCTAGCACAGATACGCAGTATTTT	CARVGRASTDTQYF	TRBV7-3	TRBJ2-3
TGCGCCAGCAGCCAAGAGTCAGCGGCCCAGCAGTACTTC	CASSQESAAQQYF	TRBV4-3	TRBJ2-7
TGCAGCGGGCAGGGCGGCTACACCTTC	CSGQGGYTF	TRBV29-1	TRBJ1-2
TGTGCCAGCGTTGGGGGGACCCCTTACAATGAGCAGTTCTTC	CASVGGTPYNEQFF	TRBV13	TRBJ2-1
TGTGCCAGCAGTTACGGGACCCGGGGTGGCTACACCTTC	CASSYGTRGGYTF	TRBV6-5	TRBJ1-2
TGCGCCAGCAGCTGCGAAAATCAGCCCCAGCATTTT	CASSCENQPQHF	TRBV5-1	TRBJ1-5
TGTGCCAGCAGCTTAGCCGAAGCGGGAGGCAATCAGCCCCAGCATTTT	CASSLAEAGGNQPQHF	TRBV7-6	TRBJ1-5
TGTGCCAGCAGCTACGGACAGGGTTACTATGGCTACACCTTC	CASSYGQGYYGYTF	TRBV7-3	TRBJ1-2
TGTGCCGGGCCGGCTCCTGATGAAGCTTTCTTT	CAGPAPDEAFF	TRBV24-1	TRBJ1-1
TGTGCCTGGGAAAGGGAGGACACCTACGAGCAGTACTTC	CAWEREDTYEQYF	TRBV30	TRBJ2-7
TGTGCCAGCAGCTCAAGACAGGGGGTCAACACCGGGGAGCTGTTTTTT	CASSSRQGVNTGELFF	TRBV11-1	TRBJ2-2
TGTGCCAGCAGCGGCACAGGGTTTAATCCAACTAATGAAAAACTGTTTTTT	CASSGTGFNPTNEKLFF	TRBV7-2	TRBJ1-4
TGTGCCAGCAGCTCCGGGACAGGGGCTGAAGCTTTCTTT	CASSSGTGAEAFF	TRBV7-9	TRBJ1-1
TGTGCCAGCAGCGAAACGGGGGTTGAGAGGAGTAACCAGCCCCAGCATTTT	CASSETGVERSNQPQHF	TRBV13	TRBJ1-5
TGCGCCAGCAGCCAGGGTCCCAAATGGCCGGGACTAGGCGGGGGGCAAGAGACCCAGTACTTC	CASSQGPKWPGLGGGQETQYF	TRBV4-1	TRBJ2-5
TGTGCCACCAGCAGAGATCGACGGGGCTCGGAATACGAGCAGTACTTC	CATSRDRRGSEYEQYF	TRBV15	TRBJ2-7
TGTGCCAGCAGTGACATAACCAGCACAGATACGCAGTATTTT	CASSDITSTDTQYF	TRBV25-1	TRBJ2-3
TGTGCCAGCAGCCGTACGGAAAAACTGTTTTTT	CASSRTEKLFF	TRBV5-4	TRBJ1-4
TGTGCCAGCAGCTCGGGCCCCATAGAATCCAAAAACATTCAGTACTTC	CASSSGPIESKNIQYF	TRBV11-2	TRBJ2-4
TGCAGTGCTAGAGATCCGGGGACAGGGGGCTACACCTTC	CSARDPGTGGYTF	TRBV20-1	TRBJ1-2
TGTGCCACCAGTGATTCCGGTACGGGACAGGGGCCCGCCTACGAGCAGTACTTC	CATSDSGTGQGPAYEQYF	TRBV24-1	TRBJ2-7
TGTGCCAGCAGTTGGGCCGCTGCAGGATGGTCCACTGAAGCTTTCTTT	CASSWAAAGWSTEAFF	TRBV12-3	TRBJ1-1
TGCAGACAGGGTGTGGATAGTGAAAAACTGTTTTTT	CRQGVDSEKLFF	TRBV20-1	TRBJ1-4
TGTGCCAGCAGCCGCCAGGGAAGGACTTGCGAGACCCAGTACTTC	CASSRQGRTCETQYF	TRBV14	TRBJ2-5
TGTGCCAGCAGGCCCCTAGTCAGTTCAGCTTTCTTT	CASRPLVSSAFF	TRBV5-5	TRBJ1-1
TGTGCCAGCAACCGCGGATATGAGCAGTTCTTC	CASNRGYEQFF	TRBV6-5	TRBJ2-1
TGTGCCAGCAGTGGGGGGGCACGGAGACTAAGCACAGATACGCAGTATTTT	CASSGGARRLSTDTQYF	TRBV27	TRBJ2-3
TGTGCCAGCAGCGAGGGGCGCCTCTATAATTCACCCCTCCACTTT	CASSEGRLYNSPLHF	TRBV7-9	TRBJ1-6
TGTGCCAGCAGTTTGGCTCATCCCAGGGGAACTTTCTTT	CASSLAHPRGTFF	TRBV27	TRBJ1-1
TGTGCCAGCAGTGAAGGGGGTTCCATCGGAGGCAGGGCCTCGCAGCATTTT	CASSEGGSIGGRASQHF	TRBV6-1	TRBJ1-5
TGTGCCAGCAGTGAACAAGTGGGGGCTAGCGAGCAGTACTTC	CASSEQVGASEQYF	TRBV25-1	TRBJ2-7
TGCAGTGCTGGGGGGACTGAAGCTTTCTTT	CSAGGTEAFF	TRBV20-1	TRBJ1-1
TGTGCCTGGAGTGTACACCGACAGGACTGCACAGATACGCAGTATTTT	CAWSVHRQDCTDTQYF	TRBV30	TRBJ2-3
TGCAGTGCTAGAGATCAGTCCGGGACAGATGTATATAGCAATCAGCCCCAGCATTTT	CSARDQSGTDVYSNQPQHF	TRBV20-1	TRBJ1-5
TGTGCCATCAGTGTACGGGGGGGGGTTTCGAGGGAGACCCAGTACTTC	CAISVRGGVSRETQYF	TRBV10-3	TRBJ2-5
TGTGCCAGCAGCGATTGGGACAGGGAATCTGGAAACACCATATATTTT	CASSDWDRESGNTIYF	TRBV6-6	TRBJ1-3
TGTGCCAGCAGTTCCGACCCAGGACAGTTTCCAAATTCACCCCTCCACTTT	CASSSDPGQFPNSPLHF	TRBV27	TRBJ1-6
TGCGCCAGCAGCCCTAGGGTGTCACCCCTCCACTTT	CASSPRVSPLHF	TRBV10-2	TRBJ1-6
TGTGCCAGCAGAGGGCGCTCCTACGAGCAGTACTTC	CASRGRSYEQYF	TRBV2	TRBJ2-7
TGTGCCAGCAGTCAGGGGGGCAGCTCTGGGGCCAACGTCCTGACTTTC	CASSQGGSSGANVLTF	TRBV28	TRBJ2-6
TGTGCCAGCAGCCAAGATCCAGCGCCAGGGCTGCTTCAGCCCCAGCATTTT	CASSQDPAPGLLQPQHF	TRBV14	TRBJ1-5
TGCGCCAGCAGCCAAGCCCGCCAATTCCACTCGCAGAGCAATCAGCCCCAGCATTTT	CASSQARQFHSQSNQPQHF	TRBV4-1	TRBJ1-5
TGCGCCAGCAGCTTCAGTATCCGGGACAGCCTTCCCTCCACTCTTCCCGATTCACCCCTCCACTTT	CASSFSIRDSLPSTLPDSPLHF	TRBV5-1	TRBJ1-6
TGTGCCAGCAGATGGCCGACGGCCGGGGCCGGGAGCAATCAGCCCCAGCATTTT	CASRWPTAGAGSNQPQHF	TRBV6-2	TRBJ1-5
TGTGCCAGCTCTTTTTATAGCGTTAAAAACATTCAGTACTTC	CASSFYSVKNIQYF	TRBV5-6	TRBJ2-4
TGTTTCTACGGCCTCTTC	CFYGLF	TRBV11-2	TRBJ2-1
TGTGCCATCAGTGAGTCGGCACTTGTAAGGGGGGCGCACGGGGAGCTGTTTTTT	CAISESALVRGAHGELFF	TRBV10-3	TRBJ2-2
TGTGCCAGCAGCTTGGGGGTCTGGTTGCCGGGACAGGGGGCGTTCGAAAACGAGCAGTACTTC	CASSLGVWLPGQGAFENEQYF	TRBV5-6	TRBJ2-7
TGTGCCAGCAGTGAGGATACAGGGGGCGGGATTCAGCCCCAGCATTTT	CASSEDTGGGIQPQHF	TRBV2	TRBJ1-5
TGTGCCTGGAAATTTTTCACAAGGGAGGAAGAAAAACTGTTTTTT	CAWKFFTREEEKLFF	TRBV30	TRBJ1-4
TGTGCCATCAGTGTACGGGGGGAGGAAAAACTGTTTTTT	CAISVRGEEKLFF	TRBV10-3	TRBJ1-4
TGTGCTAGTGGGCATGAACAGGGCAGCCTTTCTGGGGCCAACGTCCTGACTTTC	CASGHEQGSLSGANVLTF	TRBV12-5	TRBJ2-6
TGTGCCAGCAGTACGATATCTGAAGCTTTCTTT	CASSTISEAFF	TRBV27	TRBJ1-1
TGTGCCACCACGGGGGATGGGCCTGGCACAGATACGCAGTATTTT	CATTGDGPGTDTQYF	TRBV24-1	TRBJ2-3
TGTGCCAGCAGCGCCTCAGGGCAAGAGACCCAGTACTTC	CASSASGQETQYF	TRBV13	TRBJ2-5
TGTGCCAGCATTGGGGAACGGAAGGGCTACACCTTC	CASIGERKGYTF	TRBV6-5	TRBJ1-2
TGTGCCAGCAGTTACGGACAGGGGGCGTCCTACGAGCAGTACTTC	CASSYGQGASYEQYF	TRBV6-3	TRBJ2-7
TGTGCCAGTACCGGTCTAGCGGGGGGGCCCAGAGGTAATGAGCAGTTCTTC	CASTGLAGGPRGNEQFF	TRBV19	TRBJ2-1
TGCAGTCCCCCCGGTCAGCCCCAGCATTTT	CSPPGQPQHF	TRBV20-1	TRBJ1-5
TGTGCCAGCAGCGTACTCCAGGGCTCTTATGGCTACACCTTC	CASSVLQGSYGYTF	TRBV7-9	TRBJ1-2
TGTGCAGGGGAGGGGGGGTCCACTGAAGCTTTCTTT	CAGEGGSTEAFF	TRBV24-1	TRBJ1-1
TGTGCCAGCAGCTATAGGGGGGCCTCCGTTGGGAATGAGCAGTTCTTC	CASSYRGASVGNEQFF	TRBV5-6	TRBJ2-1
TGTGCCAGCAGCTCCGGCCCACAGGGTCCCCAGCATTTT	CASSSGPQGPQHF	TRBV7-2	TRBJ1-5
TGCGCCAGCAGCCAAGACGGAGGGGGGGTGTGGGAGCAGTTCTTC	CASSQDGGGVWEQFF	TRBV4-1	TRBJ2-1
TGCGCCAGCAGCAGGGGACAGAGAACTAATGAAAAACTGTTTTTT	CASSRGQRTNEKLFF	TRBV5-1	TRBJ1-4
TGTGCCAGCAGTAGGGACGGGGCGCACGAGCAGTACTTC	CASSRDGAHEQYF	TRBV12-4	TRBJ2-7
TGTGCTAGCAGCTTAAGCCCCCACGAAGCTTTCTTT	CASSLSPHEAFF	TRBV7-7	TRBJ1-1
TGTGCCAGCAGGCTCACCTGGCCAAACATTCAGTACTTC	CASRLTWPNIQYF	TRBV11-3	TRBJ2-4
TGTGCCCCCGGAATTGCCTACCAGACTGGAAACACCATATATTTT	CAPGIAYQTGNTIYF	TRBV6-2	TRBJ1-3
TGTGCCAGCAGTTACTACACTAGCGGGAGGGCAACTGAAGCTTTCTTT	CASSYYTSGRATEAFF	TRBV6-5	TRBJ1-1
TGCGCCACCCCTTCCAGGTATCCGACCCCAGCCAAAAACATTCAGTACTTC	CATPSRYPTPAKNIQYF	TRBV5-1	TRBJ2-4
TGCAGTGCTAGAGTGCTATGCTATGGCTACACCTTC	CSARVLCYGYTF	TRBV20-1	TRBJ1-2
TGTGCCAGCAGCATGGGTGTATCTAATTACGAGCAGTACTTC	CASSMGVSNYEQYF	TRBV7-3	TRBJ2-7
TGTGCCAGCAGCGATGGATCTGAACTAGCGGGAGGAACCACAGATACGCAGTATTTT	CASSDGSELAGGTTDTQYF	TRBV9	TRBJ2-3
TGCGCCAGCAGCTTCCGGCCTCTACTCAACATTCAGTACTTC	CASSFRPLLNIQYF	TRBV5-1	TRBJ2-4
TGCGCCAGCAGCTGGGACTTAGGGCGTCCCGGGGAGCTGTTTTTT	CASSWDLGRPGELFF	TRBV5-1	TRBJ2-2
TGTGCCAGCAGTGACACCCAGGGGGCGGAAGAGACCCAGTACTTC	CASSDTQGAEETQYF	TRBV6-4	TRBJ2-5
TGTGCCAGCAGCGGGTCAGGGAGCTCCTATAATTCACCCCTCCACTTT	CASSGSGSSYNSPLHF	TRBV9	TRBJ1-6
TGTGCCAGTAGTATTGGGGAGGGGTATGGCTACACCTTC	CASSIGEGYGYTF	TRBV19	TRBJ1-2
TGCAGTGCTTGGGGGAAGGAGAATGAAAAACTGTTTTTT	CSAWGKENEKLFF	TRBV20-1	TRBJ1-4
TGTGCCACCAGTGGTGCCCCCGACAGGCTCAATAGCAATCAGCCCCAGCATTTT	CATSGAPDRLNSNQPQHF	TRBV24-1	TRBJ1-5
TGTGCCAGCAGCGGAGGTAGACAGGATAAGAGGAACACTGAAGCTTTCTTT	CASSGGRQDKRNTEAFF	TRBV13	TRBJ1-1
TGCAGTGCTAGAGAGGGGGGCCCAGGCGGCTACGAGCAGTACTTC	CSAREGGPGGYEQYF	TRBV20-1	TRBJ2-7
TGCGCCAGCAGCCAAGATAATAGCGGGGGGCCGGGAAACACCATATATTTT	CASSQDNSGGPGNTIYF	TRBV4-3	TRBJ1-3
TGTGCCAGCAGTGACGTCAGTATCCTCTATGGCTACACCTTC	CASSDVSILYGYTF	TRBV6-4	TRBJ1-2
TGCAGTGCTACTTATGGGCTAGTCGGGGTGGAAGTCTACGAGCAGTACTTC	CSATYGLVGVEVYEQYF	TRBV20-1	TRBJ2-7
TGTGCGTCTCGGGACAAGACTGAGACAGATACGCAGTATTTT	CASRDKTETDTQYF	TRBV7-2	TRBJ2-3
TGTGCCAGCCAAACAGGGTCTGATCAGCCCCAGCATTTT	CASQTGSDQPQHF	TRBV13	TRBJ1-5
TGTGCCAGCTCACCGGCAGGGAGGGGCACCGGGGAGCTGTTTTTT	CASSPAGRGTGELFF	TRBV18	TRBJ2-2
TGTGCCAGCAGCTTAGCGAGTGGACTAGCGGGAGAAAATGAAAAACTGTTTTTT	CASSLASGLAGENEKLFF	TRBV7-6	TRBJ1-4
TGCGCCAGCAGCTTGGAGAAGGGGTCCTGGACCCAGTACTTC	CASSLEKGSWTQYF	TRBV5-1	TRBJ2-5
TGTGCCAGTAGTATCAGTAGACACCGGGGGGGGTACGAGCAGTACTTC	CASSISRHRGGYEQYF	TRBV19	TRBJ2-7
TGTGCCAGCATTGTAACATCGGGGCTCTCCTACAATGAGCAGTTCTTC	CASIVTSGLSYNEQFF	TRBV27	TRBJ2-1
TGTGCCAGCAGTGACAGCGGGGCCGACTGGAACTATGGCTACACCTTC	CASSDSGADWNYGYTF	TRBV6-1	TRBJ1-2
TGTGCCAGCAGGGTCCCCCGAGCTCCGGGACAGAGGGGCACTGAAGCTTTCTTT	CASRVPRAPGQRGTEAFF	TRBV5-6	TRBJ1-1
TGCGCCAGCAGCCGGAGACCGGACATTAGAAGGTGGGACACTGAAGCTTTCTTT	CASSRRPDIRRWDTEAFF	TRBV4-3	TRBJ1-1
TGTGCCCCCAGGACAGCCAATGGCTACACCTTC	CAPRTANGYTF	TRBV25-1	TRBJ1-2
TGCGCCAGCAGCCCTGACACCAACGAGCAGTACTTC	CASSPDTNEQYF	TRBV4-1	TRBJ2-7
TGCAGTGCTAGGGGGGGAACAGGGAACTATGGCTACACCTTC	CSARGGTGNYGYTF	TRBV20-1	TRBJ1-2
TGCAGTGCTAGAGAAACTCACGGGACTAGACGAGCCGGGGAGCTGTTTTTT	CSARETHGTRRAGELFF	TRBV20-1	TRBJ2-2
TGTGCCACCAGCAGAGATGCTGAAGACCACGCACAGGGCGATGGCTACACCTTC	CATSRDAEDHAQGDGYTF	TRBV15	TRBJ1-2
TGTGCCAGCACCTGGGCTTTCAATGAGCAGTTCTTC	CASTWAFNEQFF	TRBV9	TRBJ2-1
TGTGCCAGCATAGGGGTTAATGAAAAACTGTTTTTT	CASIGVNEKLFF	TRBV27	TRBJ1-4
TGTGCCAGCAGTCGGACTAGCGGGGGGGCCCGATTCTCAGGGTACTACGAGCAGTACTTC	CASSRTSGGARFSGYYEQYF	TRBV6-5	TRBJ2-7
TGTGCCACTGGGGGGGGCCGGCTAGAGACCCAGTACTTC	CATGGGRLETQYF	TRBV24-1	TRBJ2-5
TGCGCCAGCAGCAGGGTAGCGGAAGGGTCCTACGAGCAGTACTTC	CASSRVAEGSYEQYF	TRBV10-1	TRBJ2-7
TGTGCCAGCAGCTCCGGACCGGGGTTCCTGGACTACAATGAGCAGTTCTTC	CASSSGPGFLDYNEQFF	TRBV11-3	TRBJ2-1
TGTGCCAGCTGGGAAGGCAGGTATAGCAATCAGCCCCAGCATTTT	CASWEGRYSNQPQHF	TRBV27	TRBJ1-5
TGTGCCAGCAGTCGTAGGACAGGGCGGGAGCAGTACTTC	CASSRRTGREQYF	TRBV12-4	TRBJ2-7
TGTGCCAGCAGCAACCGTTACAGGGGACTCGGGGAGCTGTTTTTT	CASSNRYRGLGELFF	TRBV11-3	TRBJ2-2
TGTGCCTGGAGAGTAAGGAGGGGGGGCCAGGAGACCCAGTACTTC	CAWRVRRGGQETQYF	TRBV30	TRBJ2-5
TGTGCCAGCAGCACGGGAGCCTACGAGCAGTACTTC	CASSTGAYEQYF	TRBV7-4	TRBJ2-7
TGTGCCAGCAGTTTCTTTCAAGAGACCCAGTACTTC	CASSFFQETQYF	TRBV12-3	TRBJ2-5
TGTGCCAGCAGCCAAGAGTTAAGCGGGGGAGAGACCCAGTACTTC	CASSQELSGGETQYF	TRBV14	TRBJ2-5
TGTGCCTGGACCTGTGGACTCTACGCTTATAGCAATCAGCCCCAGCATTTT	CAWTCGLYAYSNQPQHF	TRBV30	TRBJ1-5
TGTGCCACCACCCACAGTAGCAATCAGCCCCAGCATTTT	CATTHSSNQPQHF	TRBV24-1	TRBJ1-5
TGTGCCAGCAGCCCGGGGAGGGGTGAGCAGTTCTTC	CASSPGRGEQFF	TRBV6-4	TRBJ2-1
TGTGCCACCAGTGAAAGGGTTCGTGGAAACACCATATATTTT	CATSERVRGNTIYF	TRBV24-1	TRBJ1-3
TGTGCCACCAGTGCCCCAAAGGGGCTCGGTCAGCCCCAGCATTTT	CATSAPKGLGQPQHF	TRBV24-1	TRBJ1-5
TGTGCCACGACCGTTGTCCCAATCCGGGAGGGCCCTCTGGGGCGCGAGCAGTACTTC	CATTVVPIREGPLGREQYF	TRBV24-1	TRBJ2-7
TGTGCCATCAGTGAGTCGATAGCGGGAGATCAAGAGACCCAGTACTTC	CAISESIAGDQETQYF	TRBV10-3	TRBJ2-5
TGTGCCAGCAGCTGGGGGGGAGCCGGTTCACCCCTCCACTTT	CASSWGGAGSPLHF	TRBV4-2	TRBJ1-6
TGTGCCAGCAGGCTAGGCCCCACCTTC	CASRLGPTF	TRBV11-3	TRBJ1-2
TGTGCCAGCAGACCGAGGTCCACGGACAGGGGCTCCTACGAGCAGTACTTC	CASRPRSTDRGSYEQYF	TRBV11-3	TRBJ2-7
TGCAGCGTCCGTCAGGGGGAAAATGGCTACACCTTC	CSVRQGENGYTF	TRBV29-1	TRBJ1-2
TGCGCCAGCAGCTCCCCCTACACAGCGGGGGACGAGCAGTACTTC	CASSSPYTAGDEQYF	TRBV10-2	TRBJ2-7
TGCAGCGTTGAGGGACAGGGGGGGAGGACTCCACCCCTCCACTTT	CSVEGQGGRTPPLHF	TRBV29-1	TRBJ1-6
TGTGCCATCAGTGAGCTAACGGGCCGGAACGGAAGCAATCAGCCCCAGCATTTT	CAISELTGRNGSNQPQHF	TRBV10-3	TRBJ1-5
TGTGCCACCAGCCCCCGGACAGGTCGGACTGAAGCTTTCTTT	CATSPRTGRTEAFF	TRBV15	TRBJ1-1
TGTGCCACCAGACAGGGCCTGAGTTATGGCTACACCTTC	CATRQGLSYGYTF	TRBV24-1	TRBJ1-2
TGTGCCAGCTCTCGATTGGGGGGGAAGAGCTCCTACAATGAGCAGTTCTTC	CASSRLGGKSSYNEQFF	TRBV11-3	TRBJ2-1
TGTGCCAGCAGCAGAGTCCCCGACCCGTGCAATGAGCAGTTCTTC	CASSRVPDPCNEQFF	TRBV7-9	TRBJ2-1
TGTGCCAGCAGCCAGGGGTTCGCCTACGAGCAGTACTTC	CASSQGFAYEQYF	TRBV9	TRBJ2-7
TGTGCCAGCAGCACGGGGCGGGAGATCTACGAGCAGTACTTC	CASSTGREIYEQYF	TRBV13	TRBJ2-7
TGTGCCAGCAGTCGGGGACAGGGCTGCGGTCTGAACACTGAAGCTTTCTTT	CASSRGQGCGLNTEAFF	TRBV27	TRBJ1-1
TGTGCCAGTACTTTCCCCGGGACAGGGGGTCCGAACACTGAAGCTTTCTTT	CASTFPGTGGPNTEAFF	TRBV19	TRBJ1-1
TGCGCCAGCAGCCTAAGACTAGCGGTCGTAAAGGTGAACTACGAGCAGTACTTC	CASSLRLAVVKVNYEQYF	TRBV5-1	TRBJ2-7
TGTGCCAGTAGCATTCAGGCGAGGTACGCCAAAAACATTCAGTACTTC	CASSIQARYAKNIQYF	TRBV19	TRBJ2-4
TGCAGTGCCGGAAGCCGGGACAGGGAAGGCTACACCTTC	CSAGSRDREGYTF	TRBV20-1	TRBJ1-2
TGTGCCAGCAGTGGGGACAGGCCCTATTCACCCCTCCACTTT	CASSGDRPYSPLHF	TRBV6-5	TRBJ1-6
TGTGCCAGCAGCGGCGGAGCAGGGACTTTGTATTTT	CASSGGAGTLYF	TRBV27	TRBJ2-3
TGTGCCAGCAAGAGATGTCCGGTCACTAGCGGGAGGGGGGAGACCCAGTACTTC	CASKRCPVTSGRGETQYF	TRBV11-3	TRBJ2-5
TGTGCCAGTAGTGGGGATGAGACCCAGTACTTC	CASSGDETQYF	TRBV19	TRBJ2-5
TGTGCCAGCAGCTTGTCACAGGGGGGTCCCGGGGAGCTGTTTTTT	CASSLSQGGPGELFF	TRBV11-3	TRBJ2-2
TGTGCCAGCAGCTCCGGGACAGGGGACACTGAAGCTTTCTTT	CASSSGTGDTEAFF	TRBV5-4	TRBJ1-1
TGTGCTAGTGGCCTTAAGGTGGACAGGCCAGGAGAGCAGCCCCAGCATTTT	CASGLKVDRPGEQPQHF	TRBV12-5	TRBJ1-5
TGTGCCAGCAGTTTGTTGGGCCGATTGTACGAGCAGTACTTC	CASSLLGRLYEQYF	TRBV27	TRBJ2-7
TGTGCCAGCAGCTTGAATAGTGAGCAGTTCTTC	CASSLNSEQFF	TRBV5-4	TRBJ2-1
TGTGCCAGCAGCTTGGCGCCAGGGCGCCGAGAGACCCAGTACTTC	CASSLAPGRRETQYF	TRBV5-5	TRBJ2-5
TGCGCCAGCCGCGGAGGGGGGCCACAGGCAATCTACGAGCAGTACTTC	CASRGGGPQAIYEQYF	TRBV10-1	TRBJ2-7
TGTGCCAGCAAGGGGGGGCCCCACGAAAAACTGTTTTTT	CASKGGPHEKLFF	TRBV12-4	TRBJ1-4
TGCGCCAGGTCTAGGGGGACAGGGGCAAGCTCCTACGAGCAGTACTTC	CARSRGTGASSYEQYF	TRBV10-2	TRBJ2-7
TGTGCCAGCAGCTGCGGGGCCCCCTACGAGCAGTACTTC	CASSCGAPYEQYF	TRBV7-3	TRBJ2-7
TGTGCCACCAGCAGTGTAAAGGTGGATGAGCAGTTCTTC	CATSSVKVDEQFF	TRBV24-1	TRBJ2-1
TGCGCCAGCAGTGAGAAAGTGTCTTCAGGGACAGGAGACTATGGCTACACCTTC	CASSEKVSSGTGDYGYTF	TRBV10-1	TRBJ1-2
TGTGCCAGCCCTGGGCAGAACTATGGCTACACCTTC	CASPGQNYGYTF	TRBV9	TRBJ1-2
TGTGCCAGCTCACCCTTCAGTAGGGGGGACCAGTACGAGCAGTACTTC	CASSPFSRGDQYEQYF	TRBV18	TRBJ2-7
TGCAGTGCTAGAGACCTTAGCGGGCGGGTTTCGGAGACCCAGTACTTC	CSARDLSGRVSETQYF	TRBV20-1	TRBJ2-5
TGCGCCAGCAGCTTGCTCCCCCCGAGAGGGATCCCTGAAGCTTTCTTT	CASSLLPPRGIPEAFF	TRBV5-1	TRBJ1-1
TGTGCTAGTGGTTTGACCACACAGGGGAAAGCAATTTCCTACGAGCAGTACTTC	CASGLTTQGKAISYEQYF	TRBV12-5	TRBJ2-7
TGCGCCACGGGGAGCGGGGGGAGTGGGATTTATAGCAATCAGCCCCAGCATTTT	CATGSGGSGIYSNQPQHF	TRBV10-2	TRBJ1-5
TGTGCCAGCAGTTCGTGGGACGTGGATGAAAAACTGTTTTTT	CASSSWDVDEKLFF	TRBV27	TRBJ1-4
TGTGCCAGTAGTATGTTCCCGGTCGGGGGGCGTTCGAGCTCCTACGAGCAGTACTTC	CASSMFPVGGRSSSYEQYF	TRBV19	TRBJ2-7
TGCAGTGCTGGAAAGAACTCCTACGAGCAGTACTTC	CSAGKNSYEQYF	TRBV20-1	TRBJ2-7
TGTGCCAGCAGCTTAGCGAACCCCCGGCCGGAGGGAGGGACAGGGGCTGGAGAGACCCAGTACTTC	CASSLANPRPEGGTGAGETQYF	TRBV7-6	TRBJ2-5
TGTGCCAACGGGGATGGGGGGGAAGCTTGGGAAAAACTGTTTTTT	CANGDGGEAWEKLFF	TRBV7-3	TRBJ1-4
TGTGCCACCGAGTCGGGCGGGAGACCCCGCGACTCTGGAAACACCATATATTTT	CATESGGRPRDSGNTIYF	TRBV15	TRBJ1-3
TGCGCCAGCAGCACCCCTACAGGGGTTTACGAGCAGTACTTC	CASSTPTGVYEQYF	TRBV5-1	TRBJ2-7
TGTGCCAGCTCACCTGGACAGGGGAGCAATGAGCAGTTCTTC	CASSPGQGSNEQFF	TRBV18	TRBJ2-1
TGTGCCAGCAGCTTGGGGTCAGGATGGGACACAGATACGCAGTATTTT	CASSLGSGWDTDTQYF	TRBV5-4	TRBJ2-3
TGTGCCAGCAGCTTGGGAATAAGGGGACTAGCGGGGTACGAGCAGTACTTC	CASSLGIRGLAGYEQYF	TRBV5-6	TRBJ2-7
TGCAGTGCTCGAGTTAGGGTGACTGAAGCTTTCTTT	CSARVRVTEAFF	TRBV20-1	TRBJ1-1
TGCAGCGTTGAAGATCTAGTACTGGGACGTACATATAGCAATCAGCCCCAGCATTTT	CSVEDLVLGRTYSNQPQHF	TRBV29-1	TRBJ1-5
TGTGCCAGCAGCTTAAAGCCGGGATTCTACACTGAAGCTTTCTTT	CASSLKPGFYTEAFF	TRBV7-8	TRBJ1-1
TGTGCCAGCAGCGGAGGGGACAGGGGAGAGACCCAGTACTTC	CASSGGDRGETQYF	TRBV9	TRBJ2-5
TGTGCCAGCAGCGCGGACAGGCCGATGAACACTGAAGCTTTCTTT	CASSADRPMNTEAFF	TRBV28	TRBJ1-1
TGTGCCAGTAGTAAGGGTCGGGACCACAGGGACACTGAAGCTTTCTTT	CASSKGRDHRDTEAFF	TRBV19	TRBJ1-1
TGTGCCAGCACCCTGGACAGGGTATTTGATGAAAAACTGTTTTTT	CASTLDRVFDEKLFF	TRBV9	TRBJ1-4
TGTGCCAGCAGCCGGGTCGGGGGGGGTAACACCGGGGAGCTGTTTTTT	CASSRVGGGNTGELFF	TRBV14	TRBJ2-2
TGTGCCAGCAGTTACACAAACCAAGGGACTAATGAAAAACTGTTTTTT	CASSYTNQGTNEKLFF	TRBV6-5	TRBJ1-4
TGTGCCAGCAGCCAAGATAGTTATTCGGACAGGGTGTTCATGAACACTGAAGCTTTCTTT	CASSQDSYSDRVFMNTEAFF	TRBV3-1	TRBJ1-1
TGTGCCAGCAGGACTAGCGACTCCTACAATGAGCAGTTCTTC	CASRTSDSYNEQFF	TRBV7-9	TRBJ2-1
TGTGCCAGCAGCAAGAGGGTTGGTTCGTACAATGAGCAGTTCTTC	CASSKRVGSYNEQFF	TRBV13	TRBJ2-1
TGTGCCAGCAGTTTGCACATACAGGGGAATCCAACCTCCTACGAGCAGTACTTC	CASSLHIQGNPTSYEQYF	TRBV27	TRBJ2-7
TGTGCTAGTGCAGTCAGGGGGCCTAACTATGGCTACACCTTC	CASAVRGPNYGYTF	TRBV12-5	TRBJ1-2
TGTGCCAGCAGTTTATTCGGAGGCGGGAGCTCTGGAAACACCATATATTTT	CASSLFGGGSSGNTIYF	TRBV27	TRBJ1-3
TGTGCCAGCAGTTATCCCCCTAACGGGAGGCAAGAGACCCAGTACTTC	CASSYPPNGRQETQYF	TRBV6-5	TRBJ2-5
TGTGCCACCAGTGATTTTGGGGGGGGGCCAACTCTTGTTGTTGGCACAGATACGCAGTATTTT	CATSDFGGGPTLVVGTDTQYF	TRBV24-1	TRBJ2-3
TGCGCCAGCAGCTTGAGGAGAAGCGGGACTCTGGCCGGGGAGCTGTTTTTT	CASSLRRSGTLAGELFF	TRBV5-1	TRBJ2-2
TGTGCCAGCAGCTTACCAGAGGTACCGACAGGGGGGTCGGAAGCTTTCTTT	CASSLPEVPTGGSEAFF	TRBV7-8	TRBJ1-1
TGCAGTGTAGGGGGTCAGCCCCAGCATTTT	CSVGGQPQHF	TRBV20-1	TRBJ1-5
TGTGCCAGCAGTGGGAAGCTTCGCGGCGTCTCCTACGAGCAGTACTTC	CASSGKLRGVSYEQYF	TRBV6-3	TRBJ2-7
TGTGCCAGCAGCACGGCTGGACAGGGACCACTTAATCAGCCCCAGCATTTT	CASSTAGQGPLNQPQHF	TRBV13	TRBJ1-5
TGTGCCAGCAGCTTGTCCCTACTCGGTACTGAAGCTTTCTTT	CASSLSLLGTEAFF	TRBV5-4	TRBJ1-1
TGCAGTGCCCGAGAGACCCCCTACGAGCAGTACTTC	CSARETPYEQYF	TRBV20-1	TRBJ2-7
TGTGCCAGCAGGGACAGGGACCACACTGAAGCTTTCTTT	CASRDRDHTEAFF	TRBV7-3	TRBJ1-1
TGTGCCAGCAGCACAAACCACCTAGGGAATCAGCCCCAGCATTTT	CASSTNHLGNQPQHF	TRBV7-9	TRBJ1-5
TGTGCCAGCAGCATGAAGGGGGCGCAGTTCTTC	CASSMKGAQFF	TRBV13	TRBJ2-1
TGTGCCAGCAGCTACAGTCGAGGGAATGAGCAGTTCTTC	CASSYSRGNEQFF	TRBV7-9	TRBJ2-1
TGTGCCACCAGTGACTCGGTTTCACTCTGCAATCAGCCCCAGCATTTT	CATSDSVSLCNQPQHF	TRBV24-1	TRBJ1-5
TGTGCCAGCAGCCAAGGTGGGACAGGCCCTCGAAAGGACGAGCAGTACTTC	CASSQGGTGPRKDEQYF	TRBV14	TRBJ2-7
TGTGCCAGCCACAGGGACATCAATCAGCCCCAGCATTTT	CASHRDINQPQHF	TRBV13	TRBJ1-5
TGTGCCAGCAGTGACTCCCTGAACGGGGGGGGTGGCTACGAGCAGTACTTC	CASSDSLNGGGGYEQYF	TRBV6-4	TRBJ2-7
TGTGCCAGTAGCGAGGACAGGTTTAACGACATGAACACTGAAGCTTTCTTT	CASSEDRFNDMNTEAFF	TRBV19	TRBJ1-1
TGTGCCAGCAGTTTATATCTGAAAGAGTGGGCCAAAAACATTCAGTACTTC	CASSLYLKEWAKNIQYF	TRBV27	TRBJ2-4
TGTGCCAGCAGTGGGGCCGCCAAAAACATTCAGTACTTC	CASSGAAKNIQYF	TRBV6-4	TRBJ2-4
TGTGCCAGCCATCGGGAGGGGCACACTGAAGCTTTCTTT	CASHREGHTEAFF	TRBV2	TRBJ1-1
TGTGCCAGCAGCTTAGTGACCAGGGGGCCTGAGCAGTTCTTC	CASSLVTRGPEQFF	TRBV7-9	TRBJ2-1
TGTGCCAGCAGTTTTAGGGGGAGGGACACTGAAGCTTTCTTT	CASSFRGRDTEAFF	TRBV6-4	TRBJ1-1
TGTGCCAGCAGCCAAGATTGTTCCCTTGGACTGAGAGCGAGATGGTACGAGCAGTACTTC	CASSQDCSLGLRARWYEQYF	TRBV14	TRBJ2-7
TGTGCCAGCATCAAACGCCCCCACAGTAGCAATCAGCCCCAGCATTTT	CASIKRPHSSNQPQHF	TRBV7-3	TRBJ1-5
TGTGCCAGCAGCCAAGAGCGGGAGTATTCGAACACCGGGGAGCTGTTTTTT	CASSQEREYSNTGELFF	TRBV4-2	TRBJ2-2
TGTGCCAGCAGCTCGAAGACTAGGGCCTACGAGCAGTACTTC	CASSSKTRAYEQYF	TRBV5-5	TRBJ2-7
TGTGCCAGCACATGGCGAAGGGACCGGGGGCACGAGCAGTACTTC	CASTWRRDRGHEQYF	TRBV6-5	TRBJ2-7
TGTGCCAGCAGCTTAGATTGGGGCCCTTATGAGCAGTTCTTC	CASSLDWGPYEQFF	TRBV11-2	TRBJ2-1
TGTGCCAGCAGCAGGGGATATAGTGAGGTATTCTTC	CASSRGYSEVFF	TRBV7-9	TRBJ2-1
TGTGCCAGCAGCGTTACATCCTGGGGGCGGGTCAATCAGCCCCAGCATTTT	CASSVTSWGRVNQPQHF	TRBV13	TRBJ1-5
TGTGCCAGCAGCCAAGATGTTAAGGGACTAGCGGGCAACGAGCAGTACTTC	CASSQDVKGLAGNEQYF	TRBV14	TRBJ2-7
TGTGCCAGCAGCTTAGGTAGAGTCTACTACGAGCAGTACTTC	CASSLGRVYYEQYF	TRBV7-9	TRBJ2-7
TGTGCCAGCAGCCGTTCGAGGTTCGGGTCCTACGAGCAGTACTTC	CASSRSRFGSYEQYF	TRBV13	TRBJ2-7
TGTGCCAGCAGCTTGGAATTACTAGCGGGAGTGGTAGACGAGCAGTACTTC	CASSLELLAGVVDEQYF	TRBV5-5	TRBJ2-7
TGTGCCAGCAGTTTGTTTCTGCTGTATCAGCCCCAGCATTTT	CASSLFLLYQPQHF	TRBV27	TRBJ1-5
TGTGCCAGCAGCTTGGACAGCGGGATCACGGCTGGCCTAGCCAAAAACATTCAGTACTTC	CASSLDSGITAGLAKNIQYF	TRBV5-6	TRBJ2-4
TGTGCCAGCTCACCACCCAGGGGCCTAGACTACGAGCAGTACTTC	CASSPPRGLDYEQYF	TRBV18	TRBJ2-7
TGTGCCAGCAGCGGGGGGCCCGTCAACACCGGGGAGCTGTTTTTT	CASSGGPVNTGELFF	TRBV13	TRBJ2-2
TGTGCCAGCAGTGACTTCCCCGGGCTTTATCAGCCCCAGCATTTT	CASSDFPGLYQPQHF	TRBV6-1	TRBJ1-5
TGTGCCTGGACCCCGGGACAGCTTTCCTATAATTCACCCCTCCACTTT	CAWTPGQLSYNSPLHF	TRBV30	TRBJ1-6
TGTGCCAGTAGTTCTTACAGGGATTATGGCTACACCTTC	CASSSYRDYGYTF	TRBV19	TRBJ1-2
TGTGCCAGCAGCTACAGGGTAGAGACCCAGTACTTC	CASSYRVETQYF	TRBV7-9	TRBJ2-5
TGTCATCAGGGCACGGATTCACCCCTCCACTTT	CHQGTDSPLHF	TRBV27	TRBJ1-6
TGTGCCACTCCCCCCGTTCTCGGGACGACCTACGAGCAGTACTTC	CATPPVLGTTYEQYF	TRBV24-1	TRBJ2-7
TGTGCCAGCACGGGGGATAGAAGGGGGGACTATGGCTACACCTTC	CASTGDRRGDYGYTF	TRBV6-5	TRBJ1-2
TGTGCCAGCAGCTCGCCGGGGAATCAGCCCCAGCATTTT	CASSSPGNQPQHF	TRBV5-4	TRBJ1-5
TGTGCCAGGCTCCGCAGGGGCGGGACGAACACTGAAGCTTTCTTT	CARLRRGGTNTEAFF	TRBV5-4	TRBJ1-1
TGCGCCAGCAGCCGCAGTGGCAATCAGCCCCAGCATTTT	CASSRSGNQPQHF	TRBV5-1	TRBJ1-5
TGTGCCAGTAGTATCTGTAGTGACGGGAGGAATCAGCCCCAGCATTTT	CASSICSDGRNQPQHF	TRBV19	TRBJ1-5
TGTGCCAGCAGCTTAGCGATGCGTAGTAAAGTCCTAGCAATTTACCAAGAGACCCAGTACTTC	CASSLAMRSKVLAIYQETQYF	TRBV7-6	TRBJ2-5
TGCAGCGTTGAAAACGGGACTACCGTGACCCGAACAACTAATGAAAAACTGTTTTTT	CSVENGTTVTRTTNEKLFF	TRBV29-1	TRBJ1-4
TGCGCCAGCAACATCCCAAGGGGCGCACTGACCTACGAGCAGTACTTC	CASNIPRGALTYEQYF	TRBV10-1	TRBJ2-7
TGCAGTGAAACTAGGGCGCAGTTCTTC	CSETRAQFF	TRBV20-1	TRBJ2-1
TGTGCCAGCAGTGGGAGGCAGAGGGACACTGAAGCTTTCTTT	CASSGRQRDTEAFF	TRBV27	TRBJ1-1
TGTGCCAGCAGTTACGCCCCGTCCGGGACAGGGGTAAATCAGCCCCAGCATTTT	CASSYAPSGTGVNQPQHF	TRBV6-3	TRBJ1-5
TGTGCCAGCAGCTTGCTACGGGGACTAGCGGAGAAAAAAGTCTACGAGCAGTACTTC	CASSLLRGLAEKKVYEQYF	TRBV7-6	TRBJ2-7
TGTGCCAGACCACATAGGGGGTCAACCTACGAGCAGTACTTC	CARPHRGSTYEQYF	TRBV6-5	TRBJ2-7
TGTGCCAGCAGCGTATCGGACAGGGGGGGATATGGCTACACCTTC	CASSVSDRGGYGYTF	TRBV9	TRBJ1-2
TGTGCCAGCAGCGAACAGTTAGACGAGCAGTACTTC	CASSEQLDEQYF	TRBV7-3	TRBJ2-7
TGCAGTGCCCAGGGACAGGGCGAGCAGTACTTC	CSAQGQGEQYF	TRBV20-1	TRBJ2-7
TGCGCCAGCAGTGAGGTTCCCTACCTAGGAGATACGCAGTATTTT	CASSEVPYLGDTQYF	TRBV10-1	TRBJ2-3
TGTGCCAGCAGCGAGGGGGGGATGGTAAGCTCCTACGAGCAGTACTTC	CASSEGGMVSSYEQYF	TRBV11-3	TRBJ2-7
TGTGCCAGCAGCGGACCGGGCACTGAAGCTTTCTTT	CASSGPGTEAFF	TRBV7-3	TRBJ1-1
TGTGCCAGCAGGCCTTCAGGGGCGCCCCCTGGAAACACCATATATTTT	CASRPSGAPPGNTIYF	TRBV6-5	TRBJ1-3
TGTGCCAGCAGCTTAGCACGGACGGTCCCTTTCGAGCCCCAGCATTTT	CASSLARTVPFEPQHF	TRBV7-2	TRBJ1-5
TGCAGTGCGGAAGTGGCCACTGAAGCTTTCTTT	CSAEVATEAFF	TRBV20-1	TRBJ1-1
TGCGCCAGCAGTGAGTCGGTTAGGGGACTAGCGGGGGGGCCAGGGAATGAGCAGTTCTTC	CASSESVRGLAGGPGNEQFF	TRBV10-1	TRBJ2-1
TGTGCCAGCAGTATCGCAGGTAAAAGCTCCTACGAGCAGTACTTC	CASSIAGKSSYEQYF	TRBV27	TRBJ2-7
TGTGCCAGCAGTTTCGACGGGGGCTGTTATGGCTACACCTTC	CASSFDGGCYGYTF	TRBV12-3	TRBJ1-2
TGTGGGGACAGGGGGCCGGGAGACTACGAGCAGTACTTC	CGDRGPGDYEQYF	TRBV6-4	TRBJ2-7
TGCAGTGCTAGCCGGGGGATTGATTCACCCCTCCACTTT	CSASRGIDSPLHF	TRBV20-1	TRBJ1-6
TGCAGCGTTGGAACCCAGCGGGAGGGGAACACTGAAGCTTTCTTT	CSVGTQREGNTEAFF	TRBV29-1	TRBJ1-1
TGCGCCAGCAGTTTGGGACAGCAAGAGACCCAGTACTTC	CASSLGQQETQYF	TRBV10-1	TRBJ2-5
TGTGCCAGCAGTTACGGAGGACAGGGTCCCGGGGAGCTGTTTTTT	CASSYGGQGPGELFF	TRBV6-2	TRBJ2-2
TGTGCCAGCAGTCCAAACAGGGGGGTCAGCTCCTACAATGAGCAGTTCTTC	CASSPNRGVSSYNEQFF	TRBV27	TRBJ2-1
TGCAGCGACCCCGGGGGGCAGAAGAAGGCGGCAACTAATGAAAAACTGTTTTTT	CSDPGGQKKAATNEKLFF	TRBV29-1	TRBJ1-4
TGTGCCAGCAGTGAACGAACAGGGGCGGAGGTTCCCCAGCATTTT	CASSERTGAEVPQHF	TRBV2	TRBJ1-5
TGTGCCAGCAGCTTAGAAAGCATCCCCAACATTCAGTACTTC	CASSLESIPNIQYF	TRBV11-3	TRBJ2-4
TGTGCCAGCAGCATCCGGCAGGGGGGACCTAATGAAAAACTGTTTTTT	CASSIRQGGPNEKLFF	TRBV7-3	TRBJ1-4
TGTGCCAGCAGCCAAGATCGCCGAGGTCTCTACGAGCAGTACTTC	CASSQDRRGLYEQYF	TRBV14	TRBJ2-7
TGTGCCACCAGCAGTGGCAAGGGGGGGATCCCAGATACGCAGTATTTT	CATSSGKGGIPDTQYF	TRBV15	TRBJ2-3
TGTGCCAGCAGACTAGGAGGGGGGGTCTACGAGCAGTACTTC	CASRLGGGVYEQYF	TRBV6-3	TRBJ2-7
TGTGCCAGCAGTTTATTTTTAGGCCAGGGGGCGGGTTACGAGCAGTACTTC	CASSLFLGQGAGYEQYF	TRBV12-3	TRBJ2-7
TGTGCCACCAGTGATTTCGGGCCAAACAGGGGGGGGGCCCTCCACTTT	CATSDFGPNRGGALHF	TRBV24-1	TRBJ1-6
TGTGCCAGCAGCGGGGGTAACAGGGGAAGTCCAACGACAAGGAGGTATGGCTACACCTTC	CASSGGNRGSPTTRRYGYTF	TRBV13	TRBJ1-2
TGCAGTGCTAGAGTCCGGACTAGCGGGTCCTCTAGCTCCTACAATGAGCAGTTCTTC	CSARVRTSGSSSSYNEQFF	TRBV20-1	TRBJ2-1
TGCGCCAGCAGCTTGACCAGGGCCCGAACCAAAAACATTCAGTACTTC	CASSLTRARTKNIQYF	TRBV5-1	TRBJ2-4
TGTGCCACCACCAGACAGCCCCAGTACTCCTACGAGCAGTACTTC	CATTRQPQYSYEQYF	TRBV24-1	TRBJ2-7
TGTGCCACCAGAGGACAGGACCTAGGCGAGCAGTACTTC	CATRGQDLGEQYF	TRBV24-1	TRBJ2-7
TGCGCCAGCAGCTTGCCTGACGGGGAACAAGCCGAGCAGTACTTC	CASSLPDGEQAEQYF	TRBV5-1	TRBJ2-7
TGTGCCAGCAGCGTTAATTACGGGAATTATGGCTACACCTTC	CASSVNYGNYGYTF	TRBV7-9	TRBJ1-2
TGCAGTGCTAGAGGAAGAGGCAGGGGCGATGAGCAGTTCTTC	CSARGRGRGDEQFF	TRBV20-1	TRBJ2-1
TGTGCCAGCAGTTTATCGGCCGATGGCTACACCTTC	CASSLSADGYTF	TRBV27	TRBJ1-2
TGTGCCAGCAGCTTAGAGAACCAGGATAAGGAAAGAACTGAAGCTTTCTTT	CASSLENQDKERTEAFF	TRBV7-2	TRBJ1-1
TGTGCTAGTGGTTTGGTTTGTGCCGGGACAGGGGCGTCTGGGGCCAACGTCCTGACTTTC	CASGLVCAGTGASGANVLTF	TRBV12-5	TRBJ2-6
TGCGCCAGCACGCTGGGGGGGATGCATTTT	CASTLGGMHF	TRBV5-1	TRBJ1-5
TGTGCCAGCAGCTACCCAGGACACTGGGCAGATACGCAGTATTTT	CASSYPGHWADTQYF	TRBV9	TRBJ2-3
TGTGCCAGCAGTTACGTCCCCGACAGTGGGAACACTGAAGCTTTCTTT	CASSYVPDSGNTEAFF	TRBV6-5	TRBJ1-1
TGTGCCAGCAGCGCTCCCACTAGCGGGAGGGCTTACGAGCAGTACTTC	CASSAPTSGRAYEQYF	TRBV11-2	TRBJ2-7
TGTGCCGGGAGAGGTAATAATGGCTACACCTTC	CAGRGNNGYTF	TRBV11-2	TRBJ1-2
TGTGCCAGACTACTTATGCCCCGTCCGCAAACTTGCGGGAGGCCCTCTGGAAACACCATATATTTT	CARLLMPRPQTCGRPSGNTIYF	TRBV28	TRBJ1-3
TGTGCCAGCAGCCGTAGAACGTCGCAAGAGACCCAGTACTTC	CASSRRTSQETQYF	TRBV5-8	TRBJ2-5
TGTGCCAGCAGCTGGGCGTGGGGGGGGCGCAATGAGCAGTTCTTC	CASSWAWGGRNEQFF	TRBV7-6	TRBJ2-1
TGTGCCAGCAGTTTGTTGTTCAGGGGGCCCACCGGAGCCAAAAACATTCAGTACTTC	CASSLLFRGPTGAKNIQYF	TRBV27	TRBJ2-4
TGTGCCACCAGACGGGGAGCTGGGGATCAGCCCCAGCATTTT	CATRRGAGDQPQHF	TRBV24-1	TRBJ1-5
TGCAGTGCTAGAGGTTCCCGGGACAGGTTGCTTTTTAATGAAAAACTGTTTTTT	CSARGSRDRLLFNEKLFF	TRBV20-1	TRBJ1-4
TGCGCCCGAGCGGGCGTGAACACTGAAGCTTTCTTT	CARAGVNTEAFF	TRBV4-1	TRBJ1-1
TGTGCCAGCAGCCAGGGGTACGAGCAGTACTTC	CASSQGYEQYF	TRBV7-3	TRBJ2-7
TGTGCCAGCAACCTAGCCCCCTACGAGCAGTACTTC	CASNLAPYEQYF	TRBV4-2	TRBJ2-7
TGTGCCAGCAGCCAAGTCATACTATCCAGCAGGGGCTACGAGCAGTACTTC	CASSQVILSSRGYEQYF	TRBV3-1	TRBJ2-7
TGTGCCAGCAGGAGGGACAGAGGCTCCTACGAGCAGTACTTC	CASRRDRGSYEQYF	TRBV7-2	TRBJ2-7
TGTGCCAGCAGCCCCCGACAGCTGTTAGATACGCAGTATTTT	CASSPRQLLDTQYF	TRBV11-2	TRBJ2-3
TGTGCCAGCAGCGTATGGGCCGAGGAGTCCTACGAGCAGTACTTC	CASSVWAEESYEQYF	TRBV9	TRBJ2-7
TGTGCGACTTACGAGCAGTACTTC	CATYEQYF	TRBV6-4	TRBJ2-7
TGTGCCAGTAGGACAGAGCAAGAGACCCAGTACTTC	CASRTEQETQYF	TRBV19	TRBJ2-5
TGTGCCAGCAGCGTCGACTCCCAGGGGGCGGAAGGTTTAGAGCAGTACTTC	CASSVDSQGAEGLEQYF	TRBV13	TRBJ2-7
TGTGCCAGCTCACCACCGAAACCGGAGAGGGGGTGGGAGCAGTACTTC	CASSPPKPERGWEQYF	TRBV18	TRBJ2-7
TGCAGCGCAACCTCGACGGGAGGGGATGGCTACACCTTC	CSATSTGGDGYTF	TRBV29-1	TRBJ1-2
TGCGCCACAGGTCGACAGATAGTACCCTACGAGCAGTACTTC	CATGRQIVPYEQYF	TRBV10-1	TRBJ2-7
TGCGCCAGCGCCACCGACCAGGGACGAGCTTTCTTT	CASATDQGRAFF	TRBV10-1	TRBJ1-1
TGTGCCAGCAGTTTAGCCCCTGGACAGGAAAAGCCCCAGCATTTT	CASSLAPGQEKPQHF	TRBV12-3	TRBJ1-5
TGTGCCAGCATCCATCGGGTGGCCTACGAGCAGTACTTC	CASIHRVAYEQYF	TRBV6-2	TRBJ2-7
TGTGCCAGCAGCCAAGAGGGGGAGACTGCGAATCAGCCCCAGCATTTT	CASSQEGETANQPQHF	TRBV14	TRBJ1-5
TGTGCCTGGAATCCTCGGGCCCCCTATAGCAATCAGCCCCAGCATTTT	CAWNPRAPYSNQPQHF	TRBV30	TRBJ1-5
TGTGCCTGGAGGACCCCACAGAGCTCTGGGGCCAACGTCCTGACTTTC	CAWRTPQSSGANVLTF	TRBV30	TRBJ2-6
TGTGCCAGCAGTAATTTCCGCGCCTGCACAGATACGCAGTATTTT	CASSNFRACTDTQYF	TRBV11-2	TRBJ2-3
TGCAGCGTTGAAGATAGCTTCAGGAGCCATCCCGGGACAGATACGCAGTATTTT	CSVEDSFRSHPGTDTQYF	TRBV29-1	TRBJ2-3
TGTGCCAGCAGCTTAGTGGCTCCTCCCGGGTTCCAGAACACTGAAGCTTTCTTT	CASSLVAPPGFQNTEAFF	TRBV7-2	TRBJ1-1
TGTGCCAGGGACTCGGGAAACATTCAGTACTTC	CARDSGNIQYF	TRBV19	TRBJ2-4
TGTGCCAGAGCGGGAAGGGCGACCTATGGCTACACCTTC	CARAGRATYGYTF	TRBV6-4	TRBJ1-2
TGTGCCTGGAGTTCCGACTACGAGCAGTACTTC	CAWSSDYEQYF	TRBV30	TRBJ2-7
TGTGCCAGCAGCTGGCGGGAGCTCCCAGGCTACACCTTC	CASSWRELPGYTF	TRBV7-9	TRBJ1-2
TGTGCCAGCAGCGTCGGCCGGGACAGGGCAATATCGGTGGAGGGAATAGCCAAAAACATTCAGTACTTC	CASSVGRDRAISVEGIAKNIQYF	TRBV5-5	TRBJ2-4
TGCAGCGTCGGACTAGCGTGTGCCGATGAGCAGTTCTTC	CSVGLACADEQFF	TRBV29-1	TRBJ2-1
TGTGCCAGCAGTTTCGCGACAGGTCCTAGCTACGAGCAGTACTTC	CASSFATGPSYEQYF	TRBV12-4	TRBJ2-7
TGCGCCAGCAGCCAAGATGGGGAAACCGGGACAGGGGTAGAGAACACTGAAGCTTTCTTT	CASSQDGETGTGVENTEAFF	TRBV4-1	TRBJ1-1
TGTGCCAGCAGCAAGTCCCTCCTGGGACAGCACACTGAAGCTTTCTTT	CASSKSLLGQHTEAFF	TRBV13	TRBJ1-1
TGTGCCAGCACAGCCGGGACAGGGGAGTCCTACGAGCAGTACTTC	CASTAGTGESYEQYF	TRBV12-3	TRBJ2-7
TGTGCCAGCAGCTTTGGACTAGCGGGGGGGACCTACGAGCAGTACTTC	CASSFGLAGGTYEQYF	TRBV2	TRBJ2-7
TGTGCCAAGGGACTAGCGGGGGTGCATGAGCAGTTCTTC	CAKGLAGVHEQFF	TRBV19	TRBJ2-1
TGTGCCTGGAGTGTACGAACGCTTACGTACAATGAGCAGTTCTTC	CAWSVRTLTYNEQFF	TRBV30	TRBJ2-1
TGCAGTGCTATCAGACGGTTCAACCCTCGACTAGCGGGGGGCACGATGAACACCGGGGAGCTGTTTTTT	CSAIRRFNPRLAGGTMNTGELFF	TRBV20-1	TRBJ2-2
TGTGCCAGGGCCGCGGGAGAAGAGACCCAGTACTTC	CARAAGEETQYF	TRBV27	TRBJ2-5
TGTGCCAGCAGCATAAAGAGGAGCGGCTGCACAGATACGCAGTATTTT	CASSIKRSGCTDTQYF	TRBV13	TRBJ2-3
TGTGCCAGCAGCATCCATCTGGTAGTACGTGACGAGCAGTACTTC	CASSIHLVVRDEQYF	TRBV7-9	TRBJ2-7
TGTGCCAGCACCCCTTACGAGCAGTACTTC	CASTPYEQYF	TRBV6-5	TRBJ2-7
TGTGCCAGCTTGAAGGGGGCTGGGGGAACGTCACCCCTCCACTTT	CASLKGAGGTSPLHF	TRBV7-4	TRBJ1-6
TGTGCCAGCAGTCAGACCTCCTACGAGCAGTACTTC	CASSQTSYEQYF	TRBV6-4	TRBJ2-7
TGTGCCAGCAGCTTGTTGAAAGAGAAGGGGGGGGGCGAGACCCAGTACTTC	CASSLLKEKGGGETQYF	TRBV5-6	TRBJ2-5
TGTGCCAGCAGCTGGATGTCAACTGCGGGATCGCATCAGCCCCAGCATTTT	CASSWMSTAGSHQPQHF	TRBV5-4	TRBJ1-5
TGTGCCAGCAGCCCGTCCCTGAGGGGCTACGAGCAGTACTTC	CASSPSLRGYEQYF	TRBV4-2	TRBJ2-7
TGTGCCAGCAGCTTGACAGGAGGTAGGGAAACTGAAGCTTTCTTT	CASSLTGGRETEAFF	TRBV5-5	TRBJ1-1
TGTGCCAGCAGCTTAGGTCCGGGGACCGGGAGTGAAGCTTTCTTT	CASSLGPGTGSEAFF	TRBV11-2	TRBJ1-1
TGCGCCAGCAGTCCCCTAGCGGCACCCGGGTACAATGAGCAGTTCTTC	CASSPLAAPGYNEQFF	TRBV10-2	TRBJ2-1
TGTGCCAGCATCCCGGGACAGGGAAATCAGCCCCAGCATTTT	CASIPGQGNQPQHF	TRBV27	TRBJ1-5
TGTGCCAGCAGTCGGGGACGCCCAACTAATGAAAAACTGTTTTTT	CASSRGRPTNEKLFF	TRBV12-4	TRBJ1-4
TGTGCCAGCATTCGGCGGGGGCGCTGTTACGAGCAGTACTTC	CASIRRGRCYEQYF	TRBV6-1	TRBJ2-7
TGTGCCAGCAGCTCAGTCGGAAACACCATATATTTT	CASSSVGNTIYF	TRBV5-5	TRBJ1-3
TGCGCCAGCAGCTTGGCGAGGGAGCAGTACTTC	CASSLAREQYF	TRBV5-1	TRBJ2-7
TGTGCCAGCAGTCCCCAGGGGGGGGACTATGGCTACACCTTC	CASSPQGGDYGYTF	TRBV6-2	TRBJ1-2
TGCAGTGCCGAGTTCAATCAGCCCCAGCATTTT	CSAEFNQPQHF	TRBV20-1	TRBJ1-5
TGTGCCAGCAGCCACAAGCACGGGTTCCAAGGGAATTCCACCGGGGAGCTGTTTTTT	CASSHKHGFQGNSTGELFF	TRBV7-9	TRBJ2-2
TGTGCCATCAGTGAGTTTAGCGGGACTTATGAGCAGTTCTTC	CAISEFSGTYEQFF	TRBV10-3	TRBJ2-1
TGTGCCAGGTCTAGCGGGCCTCCCAATGAGCAGTTCTTC	CARSSGPPNEQFF	TRBV6-4	TRBJ2-1
TGCGCCAGCAGCCACATCCGGGGCTACGAGCAGTACTTC	CASSHIRGYEQYF	TRBV4-1	TRBJ2-7
TGTGCCAGCAGTTGGGGTCCCTACTACGAGCAGTACTTC	CASSWGPYYEQYF	TRBV6-1	TRBJ2-7
TGTGCCAGCAGCGTAGTCCCGACAGGGTCCTACGAGCAGTACTTC	CASSVVPTGSYEQYF	TRBV9	TRBJ2-7
TGTGCCAGCAGCCCTAAGATTTACAACACAGATACGCAGTATTTT	CASSPKIYNTDTQYF	TRBV11-2	TRBJ2-3
TGTGCCAGCAGCCAAGATCACCGGGACAGGGGGCTCAACTCCTTTGGAAACACCATATATTTT	CASSQDHRDRGLNSFGNTIYF	TRBV14	TRBJ1-3
TGCGCCAGCAGCCAAGCCAAAGAGCGACAGGGGGCAAATGAGCAGTTCTTC	CASSQAKERQGANEQFF	TRBV4-1	TRBJ2-1
TGTGCCAATGCAGGGGACTATGGCTACACCTTC	CANAGDYGYTF	TRBV10-3	TRBJ1-2
TGTGCCAGCAGGGACCGGGACAGGGAACCTGAAGCTTTCTTT	CASRDRDREPEAFF	TRBV2	TRBJ1-1
TGCAGTGCAGTCACAGGGGGCCAAGGAACTGAAGCTTTCTTT	CSAVTGGQGTEAFF	TRBV20-1	TRBJ1-1
TGTGCCAGCAGCAAATTCGGGGGGGACACTGAAGCTTTCTTT	CASSKFGGDTEAFF	TRBV7-4	TRBJ1-1
TGTGCCTGGCAGGGGCCCACCGGGGAGCTGTTTTTT	CAWQGPTGELFF	TRBV30	TRBJ2-2
TGTGCCAGCAGTTTATATTGGCCAGCTTTCTTT	CASSLYWPAFF	TRBV27	TRBJ1-1
TGTGCCACCAGTGATCAGGCCCCCTATGCTCACGAGCAGTACTTC	CATSDQAPYAHEQYF	TRBV24-1	TRBJ2-7
TGTGCCAGCAGTCCCCGCGGGAGGGCTGCCTACGAGCAGTACTTC	CASSPRGRAAYEQYF	TRBV6-5	TRBJ2-7
TGTGCCAGCAGTTACTCCACAGGGGAGTGCAATCAGCCCCAGCATTTT	CASSYSTGECNQPQHF	TRBV6-6	TRBJ1-5
TGTGCCTGGGCGATGACAGGGGATGGCTACACCTTC	CAWAMTGDGYTF	TRBV24-1	TRBJ1-2
TGTGCCAACGGAGGGACAGGGGACACTGAAGCTTTCTTT	CANGGTGDTEAFF	TRBV19	TRBJ1-1
TGTGCCAGCAAAGGACACACTGAAGCTTTCTTT	CASKGHTEAFF	TRBV2	TRBJ1-1
TGCAGTGCCGCCTATGGCTACACCTTC	CSAAYGYTF	TRBV20-1	TRBJ1-2
TGTGCCAGCAGCTTACTGGGCAAACCCCATTCGTCCGGGGAGCTGTTTTTT	CASSLLGKPHSSGELFF	TRBV7-4	TRBJ2-2
TGTGCCAGCAGCTTGTCAGACAGGGGGCAAAGAGGGATCTACAATGAGCAGTTCTTC	CASSLSDRGQRGIYNEQFF	TRBV5-5	TRBJ2-1
TGTGCCAGCAGTTTACCAGGGGGGGCCGAGACCCAGTACTTC	CASSLPGGAETQYF	TRBV28	TRBJ2-5
TGTGCCAGCAGCTCGCGGGGGGGGGCGTCGGGCGAGCAGTACTTC	CASSSRGGASGEQYF	TRBV7-3	TRBJ2-7
TGTGCCAGCAGTGATTCCGGGACAGGGAGAATCACAGATACGCAGTATTTT	CASSDSGTGRITDTQYF	TRBV25-1	TRBJ2-3
TGTGCTAGCAGCTTAGTCGCCACGACAGGGGCTGAGCAGTTCTTC	CASSLVATTGAEQFF	TRBV7-7	TRBJ2-1
TGCGCCAGCGCTGGGGAGCCAGAAAAACTGTTTTTT	CASAGEPEKLFF	TRBV5-1	TRBJ1-4
TGTGCCAGCAGCCAAGGTGTGGGTCTTGGACAGCGAGAACCTCAGCCCCAGCATTTT	CASSQGVGLGQREPQPQHF	TRBV3-1	TRBJ1-5
TGTGCCAGCAGTTTGCCCCAGACTAGTCACAATGAGCAGTTCTTC	CASSLPQTSHNEQFF	TRBV28	TRBJ2-1
TGTGCCAGCAGTCCGGGGGGCCCATTCCGCAACGGGGAGCTGTTTTTT	CASSPGGPFRNGELFF	TRBV6-8	TRBJ2-2
TGTGCCAGCAGCTTAGTGGGGACAGGTGGGACCCAGTACTTC	CASSLVGTGGTQYF	TRBV7-4	TRBJ2-5
TGTGCCAGTGGGTGGGGGGGCCTTGGCCAAGAGACCCAGTACTTC	CASGWGGLGQETQYF	TRBV19	TRBJ2-5
TGTGCCAGCAGCCGCCGGGACAACCCCCTCCACTTT	CASSRRDNPLHF	TRBV11-3	TRBJ1-6
TGTGCCAGCAGGAACCCAGGGCGGAACGTGAGGAGCAATCAGCCCCAGCATTTT	CASRNPGRNVRSNQPQHF	TRBV2	TRBJ1-5
TGTGCCAGGGGACTAGCCAGTTCTGAGCAGTACTTC	CARGLASSEQYF	TRBV13	TRBJ2-7
TGTGCCAGCAGCTTAGGGGGTTGGGCTCGATTTTCTGGCTACACCTTC	CASSLGGWARFSGYTF	TRBV7-3	TRBJ1-2
TGTGCCAGCAGTGAATACTACAATGAGCAGTTCTTC	CASSEYYNEQFF	TRBV25-1	TRBJ2-1
TGTGCCAGCAGCCGGGCCGTGCCAGGAGACCAAGGCGGGAAGTGGGTGCCAGATACGCAGTATTTT	CASSRAVPGDQGGKWVPDTQYF	TRBV13	TRBJ2-3
TGTGCCAGCAGCTTTAGGGGGCCCTACGAGCAGTACTTC	CASSFRGPYEQYF	TRBV7-2	TRBJ2-7
TGCAGCGTTGAAGGGACAGAAGGGAGCAATCAGCCCCAGCATTTT	CSVEGTEGSNQPQHF	TRBV29-1	TRBJ1-5
TGTGCCAGCAGATTCTCAAATCCCCAGCGGGAGAAGTCTGGAAACACCATATATTTT	CASRFSNPQREKSGNTIYF	TRBV11-3	TRBJ1-3
TGTGCCAGCAGCTCGGGGTGGGGTAGGCCGTCAGCAGACATGAACACTGAAGCTTTCTTT	CASSSGWGRPSADMNTEAFF	TRBV5-6	TRBJ1-1
TGTGCCAGCAGCTCGGGACTAGCGGGCCCCTCCTACAATGAGCAGTTCTTC	CASSSGLAGPSYNEQFF	TRBV7-3	TRBJ2-1
TGCGCCAGCAGCTGGGTCGGGCGGACTCAGCCCCAGCATTTT	CASSWVGRTQPQHF	TRBV5-1	TRBJ1-5
TGCGCCAGCAGCCAAGCCCGTACGCCTGACGGCTACACCTTC	CASSQARTPDGYTF	TRBV4-3	TRBJ1-2
TGTGCCAGCAGTGGGCTGACAGGGAGGGGCTATGGCTACACCTTC	CASSGLTGRGYGYTF	TRBV6-4	TRBJ1-2
TGCGCCAGCAGCTTCCCAGGGCCCGAGCAGTACTTC	CASSFPGPEQYF	TRBV5-1	TRBJ2-7
TGTGCCAGCAGCCCGGGCCACAAAGACACTGAAGCTTTCTTT	CASSPGHKDTEAFF	TRBV14	TRBJ1-1
TGTGCCGGGAAAGGGGAGGCCTATAATTCACCCCTCCACTTT	CAGKGEAYNSPLHF	TRBV6-5	TRBJ1-6
