TGTGCCAGCAGTTTATTCACTAGCGGAGATGACAATGAGCAGTTCTTC	CASSLFTSGDDNEQFF	TRBV28	TRBJ2-1
TGCGCCAGCAGCCACGACAGGGGGCGCGTGAATCAGCCCCAGCATTTT	CASSHDRGRVNQPQHF	TRBV4-1	TRBJ1-5
TGTGCCAGCAGCTTCCACAACACGGGACTAGGAGCGATCGAGCAGTACTTC	CASSFHNTGLGAIEQYF	TRBV7-4	TRBJ2-7
TGTGCCAGCAGTTTAATCCGCCTCAGGGGCAAAAACATTCAGTACTTC	CASSLIRLRGKNIQYF	TRBV27	TRBJ2-4
TGTGCCAGCAGTTACTCGCGCGGGACAGGGGGCTATGGCTACACCTTC	CASSYSRGTGGYGYTF	TRBV6-3	TRBJ1-2
TGTGCCAGCAGCGGGGAATACAGCTATGGCTACACCTTC	CASSGEYSYGYTF	TRBV7-3	TRBJ1-2
TGCGCCAGCAGCCAAGGGCATACTTCAGGGATTTCTCAGCCCCAGCATTTT	CASSQGHTSGISQPQHF	TRBV4-1	TRBJ1-5
TGTGCCAGCAGCCAAGAGCAGTTAGGGCAGAACACTGAAGCTTTCTTT	CASSQEQLGQNTEAFF	TRBV3-1	TRBJ1-1
TGTGCCAGCAGACTCGGGGAGGGCGGAGATACGCAGTATTTT	CASRLGEGGDTQYF	TRBV13	TRBJ2-3
TGTGCCACCAGCAGAGGGACCGACTTGCAGCAGTTCTTC	CATSRGTDLQQFF	TRBV15	TRBJ2-1
TGTGCCAGCTCACCACTCATGACAGGGCCTCCAACAGATACGCAGTATTTT	CASSPLMTGPPTDTQYF	TRBV18	TRBJ2-3
TGTGCCAGCAGCGAAGGCGTTGTCTACTACGAGCAGTACTTC	CASSEGVVYYEQYF	TRBV3-1	TRBJ2-7
TGTGCCACAATGAAGTTACAGGGGGCAGATACGCAGTATTTT	CATMKLQGADTQYF	TRBV6-5	TRBJ2-3
TGTGCCAGCAGTTCCGCGGTATGGTGCCTGTTCTTC	CASSSAVWCLFF	TRBV27	TRBJ2-1
TGTGCCATCAGGGGACTATTGGGACCAACTAATGAAAAACTGTTTTTT	CAIRGLLGPTNEKLFF	TRBV10-3	TRBJ1-4
TGTGCCAGCAGTGGGGGGGCAGCCAAAAACATTCAGTACTTC	CASSGGAAKNIQYF	TRBV6-3	TRBJ2-4
TGTGCCAGCTCACCACGTGAGACGACAGGCCCATATGAGCAGTTCTTC	CASSPRETTGPYEQFF	TRBV18	TRBJ2-1
TGCAGTGCTGGACAGGGATCCGGAGCGTACTTC	CSAGQGSGAYF	TRBV20-1	TRBJ2-7
TGTGCCAGCAGTTTATTCCGCGACTCCTCTCAAGAGACCCAGTACTTC	CASSLFRDSSQETQYF	TRBV27	TRBJ2-5
TGTGCCAGCAGTGACGCGGACGGGGATGAGCAGTTCTTC	CASSDADGDEQFF	TRBV6-4	TRBJ2-1
TGTGCCAGCAGTTACTCGGGACAGTCTAAGACCCAGTACTTC	CASSYSGQSKTQYF	TRBV6-5	TRBJ2-5
TGTGCCACCCCCAGGGGGGCCGCAGCGGCGCAAGAGACCCAGTACTTC	CATPRGAAAAQETQYF	TRBV24-1	TRBJ2-5
TGCGCCAGCGGGAGGGACAGGGTGTGCTACGAGCAGTACTTC	CASGRDRVCYEQYF	TRBV10-2	TRBJ2-7
TGTGCCAGCAGCTTAGTAGCGACGTCTGCTGGAAACACCATATATTTT	CASSLVATSAGNTIYF	TRBV7-4	TRBJ1-3
TGTGCCAGCCCAGTGTCTCCTGAAGCTTTCTTT	CASPVSPEAFF	TRBV6-3	TRBJ1-1
TGTGCCAGCAGTGAACACCGGCGGGAGGCGATCTACGAGCAGTACTTC	CASSEHRREAIYEQYF	TRBV2	TRBJ2-7
TGTGCCAGCAGTCAGGGAAACTTGGCTGGAAACACCATATATTTT	CASSQGNLAGNTIYF	TRBV28	TRBJ1-3
TGTGCCAGCAGCTTGTTACAGGGCGACCATTCACCCCTCCACTTT	CASSLLQGDHSPLHF	TRBV7-9	TRBJ1-6
TGCAGTGCTAGAGCGCGGGGGGAAGGGACACCAGATTCACCCCTCCACTTT	CSARARGEGTPDSPLHF	TRBV20-1	TRBJ1-6
TGTGCCAGCAGCCGAAGCCGGGACAGGGCAGAGACCCAGTACTTC	CASSRSRDRAETQYF	TRBV4-2	TRBJ2-5
TGTGCCCGAGGCAGGCCCACCGGGACAGAACGGCAGCCCCAGCATTTT	CARGRPTGTERQPQHF	TRBV24-1	TRBJ1-5
TGTGCCAGCCCCCGGGACCGGGAGAACACCGGGGAGCTGTTTTTT	CASPRDRENTGELFF	TRBV28	TRBJ2-2
TGTGCCACCAGTGATCCGGGCTATTGGGGGCGGAATGAGCAGTTCTTC	CATSDPGYWGRNEQFF	TRBV24-1	TRBJ2-1
TGCAACGGGGGGGGGGACGAGCAGTACTTC	CNGGGDEQYF	TRBV20-1	TRBJ2-7
TGTGCCAGCCCTCCGGCTCTGTGTAACACTGAAGCTTTCTTT	CASPPALCNTEAFF	TRBV13	TRBJ1-1
TGCGCCAGCAGTGAATTTCCGGGACAGGGGGCTCATAATGGCTACACCTTC	CASSEFPGQGAHNGYTF	TRBV10-1	TRBJ1-2
TGTGCCAGCAGTTTACCGCCCCCTAGAAATGAGCAGTTCTTC	CASSLPPPRNEQFF	TRBV12-3	TRBJ2-1
TGTGCCAGCAGCCGCGGCGGGGGGGGGGTGTTGTACAATGAGCAGTTCTTC	CASSRGGGGVLYNEQFF	TRBV5-4	TRBJ2-1
TGTGCTAGCAGCCTCCTAGCCGGCCGGGAGAATGAGCAGTTCTTC	CASSLLAGRENEQFF	TRBV7-7	TRBJ2-1
TGTGCCAGCAGTTTTGACACGGTCTCCCCCCAGGGGACGGAACTCAACTATGGCTACACCTTC	CASSFDTVSPQGTELNYGYTF	TRBV12-4	TRBJ1-2
TGTGCCAGCCACCGTTCGGGGGGCTATAATTCACCCCTCCACTTT	CASHRSGGYNSPLHF	TRBV6-3	TRBJ1-6
TGTGCCAGCAGTTACTCCCTTTTACCGTTAAACACTGAAGCTTTCTTT	CASSYSLLPLNTEAFF	TRBV6-5	TRBJ1-1
TGCAGCGCCTCTGGACAGGGGGCGTGGGGCAATCAGCCCCAGCATTTT	CSASGQGAWGNQPQHF	TRBV29-1	TRBJ1-5
TGTGCCAGCAGTCTTTGGGATACGCAGTATTTT	CASSLWDTQYF	TRBV27	TRBJ2-3
TGCGCCAGCAGCACCACAGGGTGCCAGCCCCAGCATTTT	CASSTTGCQPQHF	TRBV5-1	TRBJ1-5
TGTGCCACCAGTGTTTCCCAGGCAAGGTATGGCTACACCTTC	CATSVSQARYGYTF	TRBV24-1	TRBJ1-2
TGTGCCAGCACAGGACATTGGATCGACCCAGCTTCCCGGGGACAGGATAACACTGAAGCTTTCTTT	CASTGHWIDPASRGQDNTEAFF	TRBV6-6	TRBJ1-1
TGTGCCAGCAGCTTATCCGAACCAACGGAAAACACTGAAGCTTTCTTT	CASSLSEPTENTEAFF	TRBV7-9	TRBJ1-1
TGTGCCAGCAGCGTACTCTACTACTATAGCAATCAGCCCCAGCATTTT	CASSVLYYYSNQPQHF	TRBV5-5	TRBJ1-5
TGTGCCAGCAGTGAACGCGGGAGCTTCACTGAAGCTTTCTTT	CASSERGSFTEAFF	TRBV6-1	TRBJ1-1
TGTGCCAGCAGCTTCAAGACACATCTTAGCAATCAGCCCCAGCATTTT	CASSFKTHLSNQPQHF	TRBV5-8	TRBJ1-5
TGTGCAAAGTCCACAAGTAATGAAAAACTGTTTTTT	CAKSTSNEKLFF	TRBV7-9	TRBJ1-4
TGTGCCAGCAGTTTAGGAGGGGGGGCCGGAAACACCATATATTTT	CASSLGGGAGNTIYF	TRBV27	TRBJ1-3
TGTGCCAGCAGCTTGGTGACAAGGGGCCAGCCCCAGCATTTT	CASSLVTRGQPQHF	TRBV5-6	TRBJ1-5
TGTGCTAGTGGTTTGTGGTTCTCGGGGAGCACAGATACGCAGTATTTT	CASGLWFSGSTDTQYF	TRBV12-5	TRBJ2-3
TGTGCCAGCAGAGCGCGGGACTGGGGTGAAGCTTTCTTT	CASRARDWGEAFF	TRBV5-8	TRBJ1-1
TGTGCCACCCCGACCCATACGCAGTATTTT	CATPTHTQYF	TRBV24-1	TRBJ2-3
TGTGCCAGCAGCCCCGGGGATTACACCATATATTTT	CASSPGDYTIYF	TRBV25-1	TRBJ1-3
TGTGCCAGCAGCGACCAGGGGGCGGTTACACGAATAGCTAACTATGGCTACACCTTC	CASSDQGAVTRIANYGYTF	TRBV7-9	TRBJ1-2
TGTGCCAGCAGCGGGGTGACACAGGTTGCCGATGAAGCTTTCTTT	CASSGVTQVADEAFF	TRBV5-8	TRBJ1-1
TGCGCCAGCTCACCCCCGGCTGGCTATGGCTACACCTTC	CASSPPAGYGYTF	TRBV4-3	TRBJ1-2
TGCGCCAGCAGCCAAGCCTCAATAGCGGGACCCTACAATGAGCAGTTCTTC	CASSQASIAGPYNEQFF	TRBV4-3	TRBJ2-1
TGTGCCAGCAGCTTAGTCCCCGAAGAGACCCAGTACTTC	CASSLVPEETQYF	TRBV11-2	TRBJ2-5
TGTGCCAGCAGTTACGGGAAACGGCTTAATAATTCACCCCTCCACTTT	CASSYGKRLNNSPLHF	TRBV6-6	TRBJ1-6
TGTGCCAGCAGCAGACTGCCAGAGAACACCGGGGAGCTGTTTTTT	CASSRLPENTGELFF	TRBV13	TRBJ2-2
TGTGCCAGCAGTTTATTGGGGCCCACGGGACAGCCTGCCAAAAACATTCAGTACTTC	CASSLLGPTGQPAKNIQYF	TRBV27	TRBJ2-4
TGTGCCAGCAGCGTGGCCAGTGCTAACTATGGCTACACCTTC	CASSVASANYGYTF	TRBV7-4	TRBJ1-2
TGTGCCAGCCTGACAGGGAGGTGGGCAGAGACCCAGTACTTC	CASLTGRWAETQYF	TRBV6-5	TRBJ2-5
TGTGCCAGCAGCCAAGCGAGCGTCTTCGGCTATGGCTACACCTTC	CASSQASVFGYGYTF	TRBV14	TRBJ1-2
TGTGCCAGCAGCCAAGGGGACAGGGTTATGGATACGCAGTATTTT	CASSQGDRVMDTQYF	TRBV14	TRBJ2-3
TGCAGTGCTCCAGGGGGGGGCGAACATAGCAATCAGCCCCAGCATTTT	CSAPGGGEHSNQPQHF	TRBV20-1	TRBJ1-5
TGTGCCAGCAGCTTAGTTTCACAGAAACTCGGCCGGCCCTATGGCTACACCTTC	CASSLVSQKLGRPYGYTF	TRBV11-2	TRBJ1-2
TGTGCCAGCAGCCAAGGGGAAAGGACAGGGGTACATTCACCCCTCCACTTT	CASSQGERTGVHSPLHF	TRBV4-2	TRBJ1-6
TGTGCCAGCTCACCAGGGCGACAGGGGAGACTCGGGGGCAAAAACATTCAGTACTTC	CASSPGRQGRLGGKNIQYF	TRBV18	TRBJ2-4
TGTGCCATTACCCAACCCGGGACTAGCGGGGGGGCGGGAACAGATACGCAGTATTTT	CAITQPGTSGGAGTDTQYF	TRBV7-6	TRBJ2-3
TGCAGCGTTGACCCCATAGCGGGAGTTGACGGTTTGCAGTTCTTC	CSVDPIAGVDGLQFF	TRBV29-1	TRBJ2-1
TGTGCCAGCAGTCAATATGTCCATAAACAGGGGTGGAGTAGGTGCTCCCAAAGCTCTGGAAACACCATATATTTT	CASSQYVHKQGWSRCSQSSGNTIYF	TRBV28	TRBJ1-3
TGTGCCAGCAGCGACGGGAGCATTATCTACGAGCAGTACTTC	CASSDGSIIYEQYF	TRBV11-3	TRBJ2-7
TGCAGCGTTGTAGGGGGGTCATCTGGAAACACCATATATTTT	CSVVGGSSGNTIYF	TRBV29-1	TRBJ1-3
TGCGCCAGCAGCTTGGCCAGGGGGCGGTATAGCAATCAGCCCCAGCATTTT	CASSLARGRYSNQPQHF	TRBV5-1	TRBJ1-5
TGTGCCACCAGTGATTTGACAGACAGGGGGGAAGATCAGCCCCAGCATTTT	CATSDLTDRGEDQPQHF	TRBV24-1	TRBJ1-5
TGTGCCAGCAGTGACATACCGAGGGACCAAGAGACCCAGTACTTC	CASSDIPRDQETQYF	TRBV6-4	TRBJ2-5
TGTGCCACCAGCAGAGCGGCCAGAGCGGGAGGTGGGGCCAATGAGCAGTTCTTC	CATSRAARAGGGANEQFF	TRBV15	TRBJ2-1
TGTGCCAGCAGTTTGGGCCGGGAGAGACAGGAGCCCCAGCATTTT	CASSLGRERQEPQHF	TRBV28	TRBJ1-5
TGTGCCAGCAGCTCCATCGACAGGCAGCCCCAGCATTTT	CASSSIDRQPQHF	TRBV5-6	TRBJ1-5
TGTGCCAGCAGTTTATGGGGGGGCACAGATACGCAGTATTTT	CASSLWGGTDTQYF	TRBV27	TRBJ2-3
TGTGCCAAATTCGACGTCGCTAGCAATCAGCCCCAGCATTTT	CAKFDVASNQPQHF	TRBV7-9	TRBJ1-5
TGTGCCAGCAGCGCTGGGAACGGAGATGAGACCCAGTACTTC	CASSAGNGDETQYF	TRBV9	TRBJ2-5
TGTGCCAGCAGCTTAGGGACTAGCGGGGGGGAGAACCCCTACGAGCAGTACTTC	CASSLGTSGGENPYEQYF	TRBV7-8	TRBJ2-7
TGTGCCAGCAGCGGACCAGGGTCCTCTGGGGCCAACGTCCTGACTTTC	CASSGPGSSGANVLTF	TRBV13	TRBJ2-6
TGTGCCAGCAGCAACGGATCCTCCTACGAGCAGTACTTC	CASSNGSSYEQYF	TRBV5-4	TRBJ2-7
TGCAGTGCTAGATTAGTCGAACCAGAATGCTACAATGAGCAGTTCTTC	CSARLVEPECYNEQFF	TRBV20-1	TRBJ2-1
TGCGCCAGCAGTGAGTCATCATCCGGGGGCGCCAATCAGCCCCAGCATTTT	CASSESSSGGANQPQHF	TRBV10-1	TRBJ1-5
TGTGCCAGCAGCATAGAGGCAACTAATGAAAAACTGTTTTTT	CASSIEATNEKLFF	TRBV5-5	TRBJ1-4
TGCAGTGCTACGTCAGGGAAAAGGAATTCACCCCTCCACTTT	CSATSGKRNSPLHF	TRBV20-1	TRBJ1-6
TGTGCCAGCAGCCACAGCCTCGGAAACACCATATATTTT	CASSHSLGNTIYF	TRBV3-1	TRBJ1-3
TGTCTGACAGGGGTTTCTGTGTTAATGGGAGGCTACACCTTC	CLTGVSVLMGGYTF	TRBV6-5	TRBJ1-2
TGTGCCAGCACGAGTTCCAGAAGGGGAAAGCCCGGGGAGCTGTTTTTT	CASTSSRRGKPGELFF	TRBV6-5	TRBJ2-2
TGCGCCAGCAGTGCGCCTAAGGGCATAGACTCTGGAAACACCATATATTTT	CASSAPKGIDSGNTIYF	TRBV10-1	TRBJ1-3
TGCAGTGCTAGATCCTCCCGGATTCTCTCTGGAAACACCATATATTTT	CSARSSRILSGNTIYF	TRBV20-1	TRBJ1-3
TGTGCCAGCAGTTACAGGCAGGACAGGGGGGGTGAGGGAAGCAATCAGCCCCAGCATTTT	CASSYRQDRGGEGSNQPQHF	TRBV6-5	TRBJ1-5
TGTGCCAGCCCGCAGTATGGCTACACCTTC	CASPQYGYTF	TRBV19	TRBJ1-2
TGTGCCAGCAGCTATGGGTCTGAAGCTTTCTTT	CASSYGSEAFF	TRBV7-3	TRBJ1-1
TGTGCCAGCAGCTTATCTCGGGGGGGCTCCCCAAATGAGCAGTTCTTC	CASSLSRGGSPNEQFF	TRBV7-9	TRBJ2-1
TGTGCCCAGTCCGTTTATCAGCCCCAGCATTTT	CAQSVYQPQHF	TRBV19	TRBJ1-5
TGTGCCAGCTCCGAGGGGCGTAGCAATCAGCCCCAGCATTTT	CASSEGRSNQPQHF	TRBV27	TRBJ1-5
TGTGCCAGCAGCTTAGGTGGTAGCGGGAACACAGATACGCAGTATTTT	CASSLGGSGNTDTQYF	TRBV7-2	TRBJ2-3
TGTGCCAGCAGTCTAGGATTCTACGAGCAGTACTTC	CASSLGFYEQYF	TRBV12-4	TRBJ2-7
TGTGCCAGCAGCTTAGAGTGGGACAGGGGGCTAGAGACCCAGTACTTC	CASSLEWDRGLETQYF	TRBV13	TRBJ2-5
TGTGCCAGCAGTGAATCGGTGGACAGGGGTTTTCTTGAAAAACTGTTTTTT	CASSESVDRGFLEKLFF	TRBV6-1	TRBJ1-4
TGTGCCAGCAGACCCAGAGGGACTAGTGAGCAGTTCTTC	CASRPRGTSEQFF	TRBV6-1	TRBJ2-1
TGTGCCACCGCTTCGCCCAGGGCGACTTTTGCCTACGAGCAGTACTTC	CATASPRATFAYEQYF	TRBV24-1	TRBJ2-7
TGTGCCAGCAGTTTAGCAGGGGACAGGGGGCGGCCGGAACTTTACTATGGCTACACCTTC	CASSLAGDRGRPELYYGYTF	TRBV12-4	TRBJ1-2
TGTGCCAGCCGGGGGGGGAATGAAAAACTGTTTTTT	CASRGGNEKLFF	TRBV6-4	TRBJ1-4
TGCGCCAGCAGCTTGAAACGCCTTAGACTTCAGCCCCAGCATTTT	CASSLKRLRLQPQHF	TRBV5-1	TRBJ1-5
TGTGCCAGCATATTTCTGGGACCCACCTACGAGCAGTACTTC	CASIFLGPTYEQYF	TRBV2	TRBJ2-7
TGTGCCAGCAGCTCTTGGGCCGGACAGGTGGGAAACTATGGCTACACCTTC	CASSSWAGQVGNYGYTF	TRBV7-9	TRBJ1-2
TGTGCCAGCAGGCCCCGGGGGGGTCTGGTAGCCAAAAACATTCAGTACTTC	CASRPRGGLVAKNIQYF	TRBV6-1	TRBJ2-4
TGTGCCAGCAGCCAACTTACTCCTAGGGGTAAAGAGAGAAACACCATATATTTT	CASSQLTPRGKERNTIYF	TRBV14	TRBJ1-3
TGTGCCTCTTTTATCGGGCAGGGGTGGCTAATACCGGGGAAGCTCGGCAATGAGCAGTTCTTC	CASFIGQGWLIPGKLGNEQFF	TRBV30	TRBJ2-1
TGTGCCAGCAGCCAGGCAGCAACTAATGAAAAACTGTTTTTT	CASSQAATNEKLFF	TRBV14	TRBJ1-4
TGTGCCAGCGGCCGCTCCTACGAGCAGTACTTC	CASGRSYEQYF	TRBV18	TRBJ2-7
TGTGCCAGCAGTGTAGTGAATTGGACCTACAATGAGCAGTTCTTC	CASSVVNWTYNEQFF	TRBV12-3	TRBJ2-1
TGTGCCAGCAGCCCTGGGAGTAGGGGGAACGAGACCCAGTACTTC	CASSPGSRGNETQYF	TRBV7-9	TRBJ2-5
TGTGCCAGCAGTTACCCGTGTTTACCCGGTGGAGAGACCCAGTACTTC	CASSYPCLPGGETQYF	TRBV6-3	TRBJ2-5
TGTGCCAGCAGAGGGGGACGGCAGTACTTC	CASRGGRQYF	TRBV27	TRBJ2-7
TGTGCCACCCAGGATGGACTAGCATACGAGCAGTACTTC	CATQDGLAYEQYF	TRBV15	TRBJ2-7
TGCAGTGCAGGGGGGAACACCGGGGAGCTGTTTTTT	CSAGGNTGELFF	TRBV20-1	TRBJ2-2
TGTGCCAGCAACAGGGTAAACACTGAAGCTTTCTTT	CASNRVNTEAFF	TRBV6-3	TRBJ1-1
TGTGCCAGCAGTCCAACCGAGGAGGGGGGGGACAATGAGCAGTTCTTC	CASSPTEEGGDNEQFF	TRBV27	TRBJ2-1
TGCAGTGCTGGTGGGGGGCCCTACAATGAGCAGTTCTTC	CSAGGGPYNEQFF	TRBV20-1	TRBJ2-1
TGTGCCATAACAATCCTGACTAGCGCGACCTACGAGCAGTACTTC	CAITILTSATYEQYF	TRBV6-4	TRBJ2-7
TGTGCCAGTTCGGGGGATACGCAGTATTTT	CASSGDTQYF	TRBV19	TRBJ2-3
TGTGCCAGCAGCTTACCATGGACAGCATACACCGGGGAGCTGTTTTTT	CASSLPWTAYTGELFF	TRBV7-9	TRBJ2-2
TGTGCCAGCAGTGTTACTACCGGGACCGGGGGAGCAACTAATGAAAAACTGTTTTTT	CASSVTTGTGGATNEKLFF	TRBV28	TRBJ1-4
TGTGCCAGCAGCCCTCTTCTCCTTTTAGGGTCCTACGAGCAGTACTTC	CASSPLLLLGSYEQYF	TRBV14	TRBJ2-7
TGCGCCAGCAGACGGTCAATGCAGGGATCGTGCTATAGCAATCAGCCCCAGCATTTT	CASRRSMQGSCYSNQPQHF	TRBV10-2	TRBJ1-5
TGTGCCAGCAGTGCGGTCCCAGATACGCAGTATTTT	CASSAVPDTQYF	TRBV6-2	TRBJ2-3
TGCAGTGCTCGGGACGGGACGGGTGAAAAACTGTTTTTT	CSARDGTGEKLFF	TRBV20-1	TRBJ1-4
TGTGCCAGCAGTTTCCGGGGAGCTAACGAGCAGTACTTC	CASSFRGANEQYF	TRBV12-4	TRBJ2-7
TGTGCCAGCAGTTACATGCCATCAGCCAAAAACATTCAGTACTTC	CASSYMPSAKNIQYF	TRBV6-6	TRBJ2-4
TGTGCCAGTAGTATACACCCGGGGCCACACACCGGGGAGCTGTTTTTT	CASSIHPGPHTGELFF	TRBV19	TRBJ2-2
TGTGCCAGCAGTTTGTCTTCTGGGGACGGACGGGGAGAGCAGTACTTC	CASSLSSGDGRGEQYF	TRBV28	TRBJ2-7
TGTGCCACCCAGAAGGGGGACACTGAAGCTTTCTTT	CATQKGDTEAFF	TRBV24-1	TRBJ1-1
TGTGCCAGCAGCTCACTATTGGGGGGTCACGAGCAGTACTTC	CASSSLLGGHEQYF	TRBV11-2	TRBJ2-7
TGTGCCAGCAGCTCGTCCAGGGGTGTCAAATTTAGCAATCAGCCCCAGCATTTT	CASSSSRGVKFSNQPQHF	TRBV5-4	TRBJ1-5
TGTGCCAGCAGTCGGGAGGGAGGAGGGAATAATCAGCCCCAGCATTTT	CASSREGGGNNQPQHF	TRBV6-1	TRBJ1-5
TGTGCCAGCAGCGATAACGGGACAGGCCCGAGTTCCTACGAGCAGTACTTC	CASSDNGTGPSSYEQYF	TRBV13	TRBJ2-7
TGTGCCAGCAGCTTGAACTACAGCAGGGGGCCCGAGCAGTACTTC	CASSLNYSRGPEQYF	TRBV5-4	TRBJ2-7
TGTGCCAGCAGTAGGGGATTTTATGAAAAACTGTTTTTT	CASSRGFYEKLFF	TRBV28	TRBJ1-4
TGTGCCACCAGTGGGTCCCTGAGGGACGGTGACTCCTACGAGCAGTACTTC	CATSGSLRDGDSYEQYF	TRBV24-1	TRBJ2-7
TGTGCCAGCAGAAGCGTAAATCCTATCGGGACAGGGGGCTATGGCTACACCTTC	CASRSVNPIGTGGYGYTF	TRBV2	TRBJ1-2
TGTGCCAGCAGGGACAGCGATCCGATCGGCTACACCTTC	CASRDSDPIGYTF	TRBV25-1	TRBJ1-2
TGTGCCAGCAGGACGAGCGGTCAGGACTTCGAGGGGGAGCAGTACTTC	CASRTSGQDFEGEQYF	TRBV6-3	TRBJ2-7
TGTGCCAGCTGGGTAAGGGACAGGGTTTACCACGAGCAGTTCTTC	CASWVRDRVYHEQFF	TRBV28	TRBJ2-1
TGTGCCACCAGTGATTTGAGTTGGACAGGGGGACGGGCTAATGAAAAACTGTTTTTT	CATSDLSWTGGRANEKLFF	TRBV24-1	TRBJ1-4
TGTGCCAGCATCGCCCCCCTATATTTAGAAGGGTACGAGCAGTACTTC	CASIAPLYLEGYEQYF	TRBV6-5	TRBJ2-7
TGTGCCAGCAGACAGATGAACACTGAAGCTTTCTTT	CASRQMNTEAFF	TRBV2	TRBJ1-1
TGTGCCTGGAGCCCACAGGGGTGGTTAATGAACACTGAAGCTTTCTTT	CAWSPQGWLMNTEAFF	TRBV30	TRBJ1-1
TGCAGTGCTAAACTAGCGGGGGGGCCGGACAATGAGCAGTTCTTC	CSAKLAGGPDNEQFF	TRBV20-1	TRBJ2-1
TGTGCCAGCAGCTTCCAAATCGGACAGAGGACCGGAAACACCATATATTTT	CASSFQIGQRTGNTIYF	TRBV13	TRBJ1-3
TGCGCCAGCATTCCACGGGGGGCTCCATCCTACGAGCAGTACTTC	CASIPRGAPSYEQYF	TRBV5-1	TRBJ2-7
TGTGCCAGCAGTGAAGAGGGGACTAGCGGGGGGAAAGCCTACGAGCAGTACTTC	CASSEEGTSGGKAYEQYF	TRBV6-1	TRBJ2-7
TGCACCGGGTCCGGCAGGGTGGTTGTTAATGAAAAACTGTTTTTT	CTGSGRVVVNEKLFF	TRBV20-1	TRBJ1-4
TGTGCCAGCAGATTAGACAGGGACCTAGCCAAAAACATTCAGTACTTC	CASRLDRDLAKNIQYF	TRBV11-2	TRBJ2-4
TGTGCCAGCAGCTACAGGAATGGCTACACCTTC	CASSYRNGYTF	TRBV12-4	TRBJ1-2
TGCGCCAGCAGCCAAGATTTCGGACGGGGGGCCAGGGCCCATCAGCCCCAGCATTTT	CASSQDFGRGARAHQPQHF	TRBV4-1	TRBJ1-5
TGTGCCAGCAATTTGGGGGGCGATGGCGGGGAAAACATTCAGTACTTC	CASNLGGDGGENIQYF	TRBV6-5	TRBJ2-4
TGTGCCAGCTCACCACGAGCTTGTGGACAGGGAATCTTTTACTCCTACGAGCAGTACTTC	CASSPRACGQGIFYSYEQYF	TRBV18	TRBJ2-7
TGTGCCAGCAGCGAGAGGGGCAATCAGCCCCAGCATTTT	CASSERGNQPQHF	TRBV7-6	TRBJ1-5
TGTGCCAGCAGTTTACAGGGGGAGTGGAGCTATCAGCCCCAGCATTTT	CASSLQGEWSYQPQHF	TRBV28	TRBJ1-5
TGTGCCAGCCCACGACGGCCTGAAAAACTGTTTTTT	CASPRRPEKLFF	TRBV6-5	TRBJ1-4
TGTGCCAGCAGCTCGCGCCGCCATTTTGAAAAACTGTTTTTT	CASSSRRHFEKLFF	TRBV5-8	TRBJ1-4
TGCAGTGCAGGAGGGGGCCTGGCCTACGAGCAGTACTTC	CSAGGGLAYEQYF	TRBV20-1	TRBJ2-7
TGTGCCACCAGTGATTTGGGAGACAGGAGGCGAGCCAAAAACATTCAGTACTTC	CATSDLGDRRRAKNIQYF	TRBV24-1	TRBJ2-4
TGTGCCCTCGGACAGGGCTACGAGCAGTACTTC	CALGQGYEQYF	TRBV30	TRBJ2-7
TGTGCCAGCAGCCCCCGGGGTGGGGAAGGAACCTACACCTTC	CASSPRGGEGTYTF	TRBV7-2	TRBJ1-2
TGTGCCAGCAGCCAGACAGAAATGAACACTGAAGCTTTCTTT	CASSQTEMNTEAFF	TRBV13	TRBJ1-1
TGTGCCAGCAGCTGGCCGCGGGACAGGGGGCTTATCAACCCTACTGAAGCTTTCTTT	CASSWPRDRGLINPTEAFF	TRBV5-8	TRBJ1-1
TGTGCCAGCAGCCAAGCTTTTATATATGGCTACACCTTC	CASSQAFIYGYTF	TRBV14	TRBJ1-2
TGTGCCAGCAGCCCCAGGGGCCAGTCGACGGGAGTAGCTGAAGCTTTCTTT	CASSPRGQSTGVAEAFF	TRBV3-1	TRBJ1-1
TGTGCCAGCAGTTTATTTGGGGGGGCGGCGGATACGCAGTATTTT	CASSLFGGAADTQYF	TRBV27	TRBJ2-3
TGTGCCAGTAGTGGGACCGGGACCTCTGGGGCCAACGTCCTGACTTTC	CASSGTGTSGANVLTF	TRBV19	TRBJ2-6
TGCCTCTCCAACCACAGGGGCTACGAGCAGTACTTC	CLSNHRGYEQYF	TRBV20-1	TRBJ2-7
TGCGCCAGCAGCGGGGGGCCTGTTCTAAGCCATGACTACGAGCAGTACTTC	CASSGGPVLSHDYEQYF	TRBV5-1	TRBJ2-7
TGTGCTAGTGGTTTGCCGTGGGGGGACTCTAATCAGCCCCAGCATTTT	CASGLPWGDSNQPQHF	TRBV12-5	TRBJ1-5
TGTGCCAGCGCCAGATGTATAATTGCCTACAATGAGCAGTTCTTC	CASARCIIAYNEQFF	TRBV11-3	TRBJ2-1
TGTGCCAGCAGTTCTGAGGGGGCCTTCAATGAGCAGTTCTTC	CASSSEGAFNEQFF	TRBV6-5	TRBJ2-1
TGTGCCAGCAGTGAATTCATAACAGGGCTATCACCCCTCCACTTT	CASSEFITGLSPLHF	TRBV2	TRBJ1-6
TGTGCCAGCACCCGACTGTGGTACTATCCCTCCTACGAGCAGTACTTC	CASTRLWYYPSYEQYF	TRBV6-4	TRBJ2-7
TGCGCCAGCAGTGAGGTCACGACGTATCAGCCCCAGCATTTT	CASSEVTTYQPQHF	TRBV10-1	TRBJ1-5
TGTGCCAGCGGTCCTGGGGGGCGTGGCTACAATGAGCAGTTCTTC	CASGPGGRGYNEQFF	TRBV6-2	TRBJ2-1
TGTGCCAGCAGCCTATTGGGACTAGCGGGAGCTTACTCCTACGAGCAGTACTTC	CASSLLGLAGAYSYEQYF	TRBV14	TRBJ2-7
TGTGCCAGCAGTTACAACCGGTTTGGCTACACCTTC	CASSYNRFGYTF	TRBV6-5	TRBJ1-2
TGTGCCAGCAGCTTAGTACTGACAGAGATTAAATTTCAGCCCCAGCATTTT	CASSLVLTEIKFQPQHF	TRBV7-2	TRBJ1-5
TGTGCCACCAGGCTGGGGAAGGCCAGCTCCTACGAGCAGTACTTC	CATRLGKASSYEQYF	TRBV24-1	TRBJ2-7
TGCGCCAGCTCGACAGGCCATCAGCGGGGGAGGGCCAATCAGCCCCAGCATTTT	CASSTGHQRGRANQPQHF	TRBV10-1	TRBJ1-5
TGTGCCAGCAGAACACAGTCAGACTTAGATACGCAGTATTTT	CASRTQSDLDTQYF	TRBV28	TRBJ2-3
TGCAGTGCTAGACCGCCACTACGACAGGGGAATAATTCACCCCTCCACTTT	CSARPPLRQGNNSPLHF	TRBV20-1	TRBJ1-6
TGTGCCAGCAGTTTATCAACTCGTAAATCCGACAGAGGTTACAATGAGCAGTTCTTC	CASSLSTRKSDRGYNEQFF	TRBV27	TRBJ2-1
TGTGCCAGCAGACAGAATAATGAAAAACTGTTTTTT	CASRQNNEKLFF	TRBV12-3	TRBJ1-4
TGTGCCAGCATCAGGGCTCCCTACGAGCAGTACTTC	CASIRAPYEQYF	TRBV12-3	TRBJ2-7
TGTGCCACCCATGTCCCTGAGGACGAGCAGTACTTC	CATHVPEDEQYF	TRBV24-1	TRBJ2-7
TGCAGTGCGGGGGAAAAGGCCAATCAGCCCCAGCATTTT	CSAGEKANQPQHF	TRBV20-1	TRBJ1-5
TGTGCCAGCAGCCGTATAGGGAAGTCGAACACCGGGGAGCTGTTTTTT	CASSRIGKSNTGELFF	TRBV5-6	TRBJ2-2
TGCAGTGCTACTGGACAGTCGACCTGGGGCCCTGGCTACACCTTC	CSATGQSTWGPGYTF	TRBV20-1	TRBJ1-2
TGTGCCAGCAGGCCGATGATAGATACGCAGTATTTT	CASRPMIDTQYF	TRBV6-5	TRBJ2-3
TGCAGCGTAGGGGTGTTTCACATTCAGTACTTC	CSVGVFHIQYF	TRBV29-1	TRBJ2-4
TGTGCCCCCAACAATCAGGGGCGGCCGGCCTACAATGAGCAGTTCTTC	CAPNNQGRPAYNEQFF	TRBV10-3	TRBJ2-1
TGTGCCAGCAGCTTGTTAGCTGACAGACCCCAAGAGACCCAGTACTTC	CASSLLADRPQETQYF	TRBV11-3	TRBJ2-5
TGCGCCAGGGACAGGGCGAATGAGCAGTTCTTC	CARDRANEQFF	TRBV10-1	TRBJ2-1
TGTGCCAGCAGTTTACAAAGGGGTAGCACTGAAGCTTTCTTT	CASSLQRGSTEAFF	TRBV27	TRBJ1-1
TGTGCCAGCAGCGGTCCGGTAGTCTCCTACGAGCAGTACTTC	CASSGPVVSYEQYF	TRBV7-9	TRBJ2-7
TGCAGTTTGACAGGGGGGGGCTACACCTTC	CSLTGGGYTF	TRBV20-1	TRBJ1-2
TGTGCCAGCAGCGTACCATCCGACACCGGGGAGCTGTTTTTT	CASSVPSDTGELFF	TRBV9	TRBJ2-2
TGTGCCAGCAGTCAGAGGAGGGGGGGAATAGGCCGTAACAATGAGCAGTTCTTC	CASSQRRGGIGRNNEQFF	TRBV6-6	TRBJ2-1
TGTGCCAGCAGAAGGACAGGGCGGCGTCCAGAACCACCCGACACAGATACGCAGTATTTT	CASRRTGRRPEPPDTDTQYF	TRBV3-1	TRBJ2-3
TGTGCCAGCAACCCTAAGGGAGAGGTGAACACTGAAGCTTTCTTT	CASNPKGEVNTEAFF	TRBV28	TRBJ1-1
TGTGCCAGCAGTGAAGCTCCCGTCACACAGGGCCGGTGCTATGGCTACACCTTC	CASSEAPVTQGRCYGYTF	TRBV6-1	TRBJ1-2
TGCGCCAGCAGTGAGCCCCCGGGGACAGGTGGCTACACCTTC	CASSEPPGTGGYTF	TRBV10-1	TRBJ1-2
TGTGCCAGCAGTCAGGGGCTGACCTACGAGCAGTACTTC	CASSQGLTYEQYF	TRBV25-1	TRBJ2-7
TGTGCCAGCAGCCAAGACGGGGAAGGGCTAAACACCGGGGAGCTGTTTTTT	CASSQDGEGLNTGELFF	TRBV14	TRBJ2-2
TGTGCCACCAGCAAAGAGGGCCCGGGACTAGCAGGGAGCTCAGATACGCAGTATTTT	CATSKEGPGLAGSSDTQYF	TRBV15	TRBJ2-3
TGTGCCAGCAGCAGGGGCGGAAATCAGCCCCAGCATTTT	CASSRGGNQPQHF	TRBV7-4	TRBJ1-5
TGTGCCAGCAGGCCCCTACGTGAAGCTTTCTTT	CASRPLREAFF	TRBV2	TRBJ1-1
TGTGCCAGCAGGGGTCCTAAGCGGGAGAACCTCACAGATACGCAGTATTTT	CASRGPKRENLTDTQYF	TRBV6-5	TRBJ2-3
TGTGCCAGCAGCGTGCGGGGACTTCAATACACCGGGGAGCTGTTTTTT	CASSVRGLQYTGELFF	TRBV11-2	TRBJ2-2
TGTGCCAGTAGTACGCGGAGCGGGAGAAAAGGCACAGATACGCAGTATTTT	CASSTRSGRKGTDTQYF	TRBV19	TRBJ2-3
TGTGCCAGCTCACTGGTCAGGGGGCACTTGAATGAAAAACTGTTTTTT	CASSLVRGHLNEKLFF	TRBV18	TRBJ1-4
TGTGCCAGCAGCGTAGTCTGGGACACCTACGAGCAGTACTTC	CASSVVWDTYEQYF	TRBV9	TRBJ2-7
TGTGCCAGCAGCTGCCACCAGGGCTGTGGCCGCAATCAGCCCCAGCATTTT	CASSCHQGCGRNQPQHF	TRBV7-2	TRBJ1-5
TGTGCCATCAGTGTGACCGGGTCTGGAAACACCATATATTTT	CAISVTGSGNTIYF	TRBV10-3	TRBJ1-3
TGTGCCAGCAGACAGGGGAGCCCCATCGACTCTAATGAAAAACTGTTTTTT	CASRQGSPIDSNEKLFF	TRBV27	TRBJ1-4
TGCAGCGTTGGGGGTAGCACAGATACGCAGTATTTT	CSVGGSTDTQYF	TRBV29-1	TRBJ2-3
TGTGCCAGCAAGTGCACAGGTCTAAAACAGCCCCAGCATTTT	CASKCTGLKQPQHF	TRBV27	TRBJ1-5
TGCAGCGTGGGGAGGGACACGGGAGGTAGCAATCAGCCCCAGCATTTT	CSVGRDTGGSNQPQHF	TRBV29-1	TRBJ1-5
TGTGCCAGCAGTCGGACATCAGGGGGTAGAGAGACCCAGTACTTC	CASSRTSGGRETQYF	TRBV12-4	TRBJ2-5
TGTGCCAGCAGGCCAGACAGGGGTCGCTACAATGAGCAGTTCTTC	CASRPDRGRYNEQFF	TRBV3-1	TRBJ2-1
TGTGCCAGCAGCCAAGATGTGACGGGACTAGCGCGCACCGGGGAGCTGTTTTTT	CASSQDVTGLARTGELFF	TRBV3-1	TRBJ2-2
TGTGCCAGCACAAAGGCGCGAGCGAACACCGGGGAGCTGTTTTTT	CASTKARANTGELFF	TRBV7-2	TRBJ2-2
TGTGCCAGCAGTTACGTCGGGACATCGAATCAGCCCCAGCATTTT	CASSYVGTSNQPQHF	TRBV6-5	TRBJ1-5
TGTGCCAGCAGCAGGGGAACAGGAGGGGTAACCATTCAGTACTTC	CASSRGTGGVTIQYF	TRBV7-9	TRBJ2-4
TGTGCCAGCAGCAAGGAGAGTGCTCGCAACTATGGCTACACCTTC	CASSKESARNYGYTF	TRBV9	TRBJ1-2
TGTGCCAGCAGTCCTATTCAAGAGACCCAGTACTTC	CASSPIQETQYF	TRBV6-6	TRBJ2-5
TGTGCCACCAGTGATTTAAACCCTCGGACAGATACCTACGAGCAGTACTTC	CATSDLNPRTDTYEQYF	TRBV24-1	TRBJ2-7
TGTGCCAGCAGCGTAGCCGCTAGCGGGGCCTACGAGCAGTACTTC	CASSVAASGAYEQYF	TRBV9	TRBJ2-7
TGTGCCAGGGGGGTAAGCACAGATACGCAGTATTTT	CARGVSTDTQYF	TRBV6-1	TRBJ2-3
TGCGCCAGGGGCGACCTCCACGAGCAGTACTTC	CARGDLHEQYF	TRBV5-1	TRBJ2-7
TGTGCCAGCAGCTTAGAGGATGCTGGCTACACCTTC	CASSLEDAGYTF	TRBV7-2	TRBJ1-2
TGCGCCAGCAGCTTGGGAGTTGAAGGGGGTCACGAGCAGTACTTC	CASSLGVEGGHEQYF	TRBV5-1	TRBJ2-7
TGTGCCACCAGTGATTGCCGGCGGCAGACTAAGGCAGATACGCAGTATTTT	CATSDCRRQTKADTQYF	TRBV24-1	TRBJ2-3
TGTGCCAGCGGGAAGGTCGGACAGGGGGTACCCTACGAGCAGTACTTC	CASGKVGQGVPYEQYF	TRBV13	TRBJ2-7
TGTGCCACCAGTGATTTTCAGGGGAGACAGTACTTC	CATSDFQGRQYF	TRBV24-1	TRBJ2-5
TGTGCCTGGTTGGCCGAGGCTCGGGACAGTACTCTTTATGGCTACACCTTC	CAWLAEARDSTLYGYTF	TRBV30	TRBJ1-2
TGCAGCACAGACCGGGCGGGAGCCCCAAGCACAGATACGCAGTATTTT	CSTDRAGAPSTDTQYF	TRBV29-1	TRBJ2-3
TGTGCCAGCAGTCGGGAGGGTAACAGGGAATGGGAGACCCAGTACTTC	CASSREGNREWETQYF	TRBV2	TRBJ2-5
TGTGCCAGCAGCTTGGTCCTCCCTTTCTACGAGCAGTACTTC	CASSLVLPFYEQYF	TRBV5-4	TRBJ2-7
TGTGCCAGCAGTGATGTTCTTGTAATTCCGGCGGCCGGAGGTTCTGGCTACACCTTC	CASSDVLVIPAAGGSGYTF	TRBV6-1	TRBJ1-2
TGTGCCAGCAGCTTGGCTGGAGCCGGGACTAGCGGGGTGGGGTTCCAAGAGACCCAGTACTTC	CASSLAGAGTSGVGFQETQYF	TRBV5-4	TRBJ2-5
TGTGCCAGCAGTGATGAGCCAGTAAAACATTGGGAGACTGAGTACGAGCAGTACTTC	CASSDEPVKHWETEYEQYF	TRBV6-4	TRBJ2-7
TGCGCCAGCCCCAGGGGGGGGGTCCATGCCTACGAGCAGTACTTC	CASPRGGVHAYEQYF	TRBV5-1	TRBJ2-7
TGTGCCACCAGTGGGGGAGGTCGGACGCCCCTCAATCAGCCCCAGCATTTT	CATSGGGRTPLNQPQHF	TRBV24-1	TRBJ1-5
TGTGCCAGCAGACGTCCACCACCGGGAATATACGAGCAGTACTTC	CASRRPPPGIYEQYF	TRBV6-4	TRBJ2-7
TGTGCCACCAGTGATCGTGGAATTAACACCGGGGAGCTGTTTTTT	CATSDRGINTGELFF	TRBV24-1	TRBJ2-2
TGTGCCAGCAGCTTAGCAAGGGGGCCCCGCTCCTACAATGAGCAGTTCTTC	CASSLARGPRSYNEQFF	TRBV7-9	TRBJ2-1
TGTGCCAGCAGTGGCTTATCGGGGTCGAACACCATATATTTT	CASSGLSGSNTIYF	TRBV6-4	TRBJ1-3
TGTGCCAGTAGTATCCCCCCTAACAGGGGGCGCTACGAGCAGTACTTC	CASSIPPNRGRYEQYF	TRBV19	TRBJ2-7
TGCAGTGCTAGACCGGGGGCTTTATCCTACGAGCAGTACTTC	CSARPGALSYEQYF	TRBV20-1	TRBJ2-7
TGCGCCAGCAGTGAGAGTATTTGGGAGCAGTACTTC	CASSESIWEQYF	TRBV10-1	TRBJ2-7
TGTGCCAGCAGCATCCCGGACAGTCGCGAGCAGTACTTC	CASSIPDSREQYF	TRBV13	TRBJ2-7
TGTGCCAGCGGACAGATCTCTACTGAAGCTTTCTTT	CASGQISTEAFF	TRBV12-4	TRBJ1-1
TGTGCCAGCAGCTTAGATGTTCCGGGAGGGCGGTCCTATAATTCACCCCTCCACTTT	CASSLDVPGGRSYNSPLHF	TRBV11-2	TRBJ1-6
TGTGCCAGCAGCTTGTCTGTGGATGTAGAGACCCAGTACTTC	CASSLSVDVETQYF	TRBV11-3	TRBJ2-5
TGTGCCAGCAGCCAAGAAATGGGAGGACAGTTCACAGATACGCAGTATTTT	CASSQEMGGQFTDTQYF	TRBV3-1	TRBJ2-3
TGTGCCAGCAGCTTAGATACCAAGGGGGTAGAGACCCAGTACTTC	CASSLDTKGVETQYF	TRBV11-3	TRBJ2-5
TGTGCCAGCAGCTTAGATCTGATCCCCAATCAGCCCCAGCATTTT	CASSLDLIPNQPQHF	TRBV7-9	TRBJ1-5
TGTGCCAGGGTCGGACAGGGGATGGGAAACACTGAAGCTTTCTTT	CARVGQGMGNTEAFF	TRBV6-6	TRBJ1-1
TGTGCCAGCAGTTACTCGAATCAGGGTGCAACTAATGAAAAACTGTTTTTT	CASSYSNQGATNEKLFF	TRBV6-6	TRBJ1-4
TGTGCCAGCAGTCCAGGGGCTTATGGGGGTTCGGACACTGAAGCTTTCTTT	CASSPGAYGGSDTEAFF	TRBV28	TRBJ1-1
TGTGCCAGCAGCCAATGGTCGCAGGGGGCCATCGACCAGCCCCAGCATTTT	CASSQWSQGAIDQPQHF	TRBV16	TRBJ1-5
TGTGCCAGCAGTGAACGTACGGCCACAGATACGCAGTATTTT	CASSERTATDTQYF	TRBV6-1	TRBJ2-3
TGCAGTGCTAGAGATAGAGACAGGCTCCATAACTATGGCTACACCTTC	CSARDRDRLHNYGYTF	TRBV20-1	TRBJ1-2
TGTGCCACCACAGTCTATGGCTACACCTTC	CATTVYGYTF	TRBV24-1	TRBJ1-2
TGTGCCAGCAGCTCGGGTTGCGACGAGCAGTACTTC	CASSSGCDEQYF	TRBV13	TRBJ2-7
TGTGCCAGCAGCAGCCCGCGGGGAAGCAAAGCCATCACCGGGACAGGGAGGGCCTACGAGCAGTACTTC	CASSSPRGSKAITGTGRAYEQYF	TRBV7-9	TRBJ2-7
TGTGCCAGCAGCTGCCTACAGGGCTCCCCCAGAGAGCAGTACTTC	CASSCLQGSPREQYF	TRBV7-7	TRBJ2-7
TGTGCCAGCAGTAGCCCTCTGACCCAAGACTTTGAGCAGTTCTTC	CASSSPLTQDFEQFF	TRBV27	TRBJ2-1
TGTGCCATCAGTGAGAGGAGGAGGGGAACTGAAGCTTTCTTT	CAISERRRGTEAFF	TRBV10-3	TRBJ1-1
TGTGCCAGCATCGCGATCCGGAGCTTCGGGGCCAACGTCCTGACTTTC	CASIAIRSFGANVLTF	TRBV11-3	TRBJ2-6
TGTGCCAGCAGTCGGGGCAAGTACTATGGCTACACCTTC	CASSRGKYYGYTF	TRBV7-2	TRBJ1-2
TGTGCCAGCAGTGAACGGGGCCACATTCAGTACTTC	CASSERGHIQYF	TRBV6-1	TRBJ2-4
TGTGCCAGCAGCCAAGGGACAGGGGGCTACACCTTC	CASSQGTGGYTF	TRBV3-1	TRBJ1-2
TGCGCCAGCAGCCAAGACGCCCTGGGGTCCCAGCACATGAACACTGAAGCTTTCTTT	CASSQDALGSQHMNTEAFF	TRBV4-1	TRBJ1-1
TGCGCCAGCAGTGACGGACGAGACGAGCAGTACTTC	CASSDGRDEQYF	TRBV10-1	TRBJ2-7
TGCAGTGCCTTACTTGGACTAGCGGGTGTTACTCTCTCCTACAATGAGCAGTTCTTC	CSALLGLAGVTLSYNEQFF	TRBV20-1	TRBJ2-1
TGCAGCGTTGAAGATCTTGGAAGAGGTGGGGATTTACTTTCCTATAATTCACCCCTCCACTTT	CSVEDLGRGGDLLSYNSPLHF	TRBV29-1	TRBJ1-6
TGCGCCAGCACGCTTGGGACAGGCTATCAGCCCCAGCATTTT	CASTLGTGYQPQHF	TRBV10-2	TRBJ1-5
TGTGCCAGCAGCACCCGAATTAGCGGGTACAATGAGCAGTTCTTC	CASSTRISGYNEQFF	TRBV13	TRBJ2-1
TGTGCCAGCAGCTCCAAGGGAGAAGACAGGGCGCAAGAGACCCAGTACTTC	CASSSKGEDRAQETQYF	TRBV7-3	TRBJ2-5
TGTGCCAGCAGCTTGCGTCGGGAGGGCCCCTACGAGCAGTACTTC	CASSLRREGPYEQYF	TRBV5-4	TRBJ2-7
TGTGCCAGCGCCAGGGCTGGGGTTGGCTACACCTTC	CASARAGVGYTF	TRBV7-2	TRBJ1-2
TGTGCCAGTAGGGGCCGGAATGTTAATTCACCCCTCCACTTT	CASRGRNVNSPLHF	TRBV19	TRBJ1-6
TGTGCCAGCAGCTTAGGCGTATCAGGGTTCTATGGCTACACCTTC	CASSLGVSGFYGYTF	TRBV7-9	TRBJ1-2
TGTGCCAGCAGCGTAGTTTTGACGCGGACCTACAATGAGCAGTTCTTC	CASSVVLTRTYNEQFF	TRBV9	TRBJ2-1
TGCGCCAGCAGTGACGGAAGGGGACAGGGAATGAACACTGAAGCTTTCTTT	CASSDGRGQGMNTEAFF	TRBV10-2	TRBJ1-1
TGTGCCCGGGTGTGCACAGATACGCAGTATTTT	CARVCTDTQYF	TRBV9	TRBJ2-3
TGTGCCAGCAGTCCAAGGGGGCGCAAAAACACTGAAGCTTTCTTT	CASSPRGRKNTEAFF	TRBV25-1	TRBJ1-1
TGTGCCAGCAGCGTTCACAGGGGAGGGGGGGGCACAGATACGCAGTATTTT	CASSVHRGGGGTDTQYF	TRBV9	TRBJ2-3
TGTGCCAGCAGAACGACGGGGCGGACTAGCACAGATACGCAGTATTTT	CASRTTGRTSTDTQYF	TRBV7-3	TRBJ2-3
TGTGCCAGCAGCCAAGGATCCCCCCTACCTACTAGCGGGAGAGCTGGGGCCAACGTCCTGACTTTC	CASSQGSPLPTSGRAGANVLTF	TRBV14	TRBJ2-6
TGTGCCAGCAGCCCGACTAGTCCCGTTCAGAGGAACGAGCAGTACTTC	CASSPTSPVQRNEQYF	TRBV7-9	TRBJ2-7
TGTGCCAGCAGTTACTCGCCACTAGTTTCCGACGAGCAGTACTTC	CASSYSPLVSDEQYF	TRBV6-3	TRBJ2-7
TGCGCCAGCAGCCTAGCGGGATACCAAGAGACCCAGTACTTC	CASSLAGYQETQYF	TRBV4-3	TRBJ2-5
TGTGCCAGTAGTCCTGTCAGGGGACAGGGGGCATCCGCTTTCTTT	CASSPVRGQGASAFF	TRBV19	TRBJ1-1
TGTGCCAGCAGTTTACCTGGCCCAGGGACCAACCAAGGCTACACCTTC	CASSLPGPGTNQGYTF	TRBV27	TRBJ1-2
TGTGCCAGCAAGTCCCGGGCCGACCGGGGGCTCTACGAGCAGTACTTC	CASKSRADRGLYEQYF	TRBV6-4	TRBJ2-7
TGTGCCAGCAGACGTGGGGTTTACTTTAGCTCTGGGGCCAACGTCCTGACTTTC	CASRRGVYFSSGANVLTF	TRBV7-9	TRBJ2-6
TGTGCCACCAGTGTCGAGGGGGGGACTAATCAGCCCCAGCATTTT	CATSVEGGTNQPQHF	TRBV24-1	TRBJ1-5
TGCAGCGTTGACAGGGTGGGGACAGACTATGGCTACACCTTC	CSVDRVGTDYGYTF	TRBV29-1	TRBJ1-2
TGTGCCACCAGTGATGGTCCGTATGACAGGGGAGGGGAGACCCAGTACTTC	CATSDGPYDRGGETQYF	TRBV24-1	TRBJ2-5
TGTGCCAGCACCTGCTACAGGGCCAAGCGGAACTATGGCTACACCTTC	CASTCYRAKRNYGYTF	TRBV28	TRBJ1-2
TGTGCCACCAGTGAAGATGCCCTCTCCCCGGGTAGGCTTAATCGAAGAGCTCAAACCTCCTACGAGCAGTACTTC	CATSEDALSPGRLNRRAQTSYEQYF	TRBV24-1	TRBJ2-7
TGCAGTGCTAATTGGCTTTTAGACAGGACTCTGAACACTGAAGCTTTCTTT	CSANWLLDRTLNTEAFF	TRBV20-1	TRBJ1-1
TGTGCCAGCAGGAAGCAGGGCACGAGCTCCTACAATGAGCAGTTCTTC	CASRKQGTSSYNEQFF	TRBV28	TRBJ2-1
TGTGCCACCAGCGTGGGACAGGGGGGCAATCAGCCCCAGCATTTT	CATSVGQGGNQPQHF	TRBV24-1	TRBJ1-5
TGTGCCAGCAGTCCCGTGGGGTTTACAGATACGCAGTATTTT	CASSPVGFTDTQYF	TRBV6-3	TRBJ2-3
TGCGCCAGCAGACAGGGGGAGAATACAGATACGCAGTATTTT	CASRQGENTDTQYF	TRBV10-1	TRBJ2-3
TGTGCCAGCAGTACCGGGACCTGGTATGGCTACACCTTC	CASSTGTWYGYTF	TRBV27	TRBJ1-2
TGTGCCAGCAGCGAAAACTGCATAGTCGGGGTAGCCAAAAACATTCAGTACTTC	CASSENCIVGVAKNIQYF	TRBV13	TRBJ2-4
TGTGCCTGGTGGACTACCTTGACCCAGTACTTC	CAWWTTLTQYF	TRBV30	TRBJ2-5
TGCAGTGCTAGTACGGTTATGGGACTCCCGAGTAACAATCAGCCCCAGCATTTT	CSASTVMGLPSNNQPQHF	TRBV20-1	TRBJ1-5
TGCAGTGCTAGGACGCGCCTTGAGACTACCGGGGAGCTGTTTTTT	CSARTRLETTGELFF	TRBV20-1	TRBJ2-2
TGTGCCAGCAGGTCGGGGACCGTAGAGACCCAGTACTTC	CASRSGTVETQYF	TRBV2	TRBJ2-5
TGCGCCAGCAGCTTGATCTGTAACAGGGTCTTCGACACAGATACGCAGTATTTT	CASSLICNRVFDTDTQYF	TRBV5-1	TRBJ2-3
TGTGCCAGCAGTCCCAGGTACAATGAGCAGTTCTTC	CASSPRYNEQFF	TRBV6-5	TRBJ2-1
TGTGCCAGCGTTCGGGACAGTTACGAGCAGTACTTC	CASVRDSYEQYF	TRBV6-5	TRBJ2-7
TGTGCCAGCAGCTTAGGGCTTCCCGGGACAGGCTGGTCCCATGAGCAGTTCTTC	CASSLGLPGTGWSHEQFF	TRBV7-8	TRBJ2-1
TGTGCCAGCAGTTACTTCAGGACATTGGTTACCTACGAGCAGTACTTC	CASSYFRTLVTYEQYF	TRBV6-5	TRBJ2-7
TGTGCCAGTAGTATAAGGAGGGGGCCCGACTATGGCTACACCTTC	CASSIRRGPDYGYTF	TRBV19	TRBJ1-2
TGTGCCAGCAGTGGAACTAGCGGGGGGGGAGGAGAGACCCAGTACTTC	CASSGTSGGGGETQYF	TRBV6-3	TRBJ2-5
TGTGCCAGCAGTGACGTGTTCAAGGGACGGAACACTGAAGCTTTCTTT	CASSDVFKGRNTEAFF	TRBV6-4	TRBJ1-1
TGTGCCAGCAGCTTAGCCCAGGGACAGGCCTACGAGCAGTACTTC	CASSLAQGQAYEQYF	TRBV7-2	TRBJ2-7
TGTGCCACCAGTGCCGCTAAACGGCTGGATAACTATGGCTACACCTTC	CATSAAKRLDNYGYTF	TRBV24-1	TRBJ1-2
TGTGCCAGCAGTGACAAAAGACAGGGATTGAACACTGAAGCTTTCTTT	CASSDKRQGLNTEAFF	TRBV6-4	TRBJ1-1
TGTGCCAGCAGTTTACCGAGGTGTGCGGGAGGGAGCTCCTACGAGCAGTACTTC	CASSLPRCAGGSSYEQYF	TRBV12-4	TRBJ2-7
TGTGCCAGCAGTGACTCTTATGGAAACACCATATATTTT	CASSDSYGNTIYF	TRBV6-4	TRBJ1-3
TGCAGCGTTGAAAGGAGGGAGGGCGGGGAGACCCAGTACTTC	CSVERREGGETQYF	TRBV29-1	TRBJ2-5
TGTGGGGGTCAGGGTAGGGTACCGAATGGCTACACCTTC	CGGQGRVPNGYTF	TRBV10-3	TRBJ1-2
TGTGCCAGCAGCCGACAGAACGAGCAGTACTTC	CASSRQNEQYF	TRBV3-1	TRBJ2-7
TGTGCCACCAATCTCGACACAGATACGCAGTATTTT	CATNLDTDTQYF	TRBV24-1	TRBJ2-3
TGTGCCACTTATGGGGGGACCGAGCAGTACTTC	CATYGGTEQYF	TRBV24-1	TRBJ2-7
TGCACCAGCAGGGACAGGACCTATGGCTACACCTTC	CTSRDRTYGYTF	TRBV20-1	TRBJ1-2
TGTGCCAGCAGGCCATTCGGGGGAGGGACCTACAATGAGCAGTTCTTC	CASRPFGGGTYNEQFF	TRBV12-3	TRBJ2-1
TGTGCCAGGACTAGGAGAAACATTCAGTACTTC	CARTRRNIQYF	TRBV6-4	TRBJ2-4
TGCGCCAGCAGCTTGGAATCCTGTGGCAGGGTGGCCTACGAGCAGTACTTC	CASSLESCGRVAYEQYF	TRBV5-1	TRBJ2-7
TGTGCCAGCAGCTTCTGTCTTCCCGATGAAGAGACCCAGTACTTC	CASSFCLPDEETQYF	TRBV11-3	TRBJ2-5
TGTGCCAGCAGCCGGCGATTGGGGACTAGCCCTTGGACCTCCTACGAGCAGTACTTC	CASSRRLGTSPWTSYEQYF	TRBV14	TRBJ2-7
TGTGCCAGCTCACATATTTTCCTTTACACGGCCGGGACAAGCTCTGGAAACACCATATATTTT	CASSHIFLYTAGTSSGNTIYF	TRBV18	TRBJ1-3
TGTGCCAGCAGCGGGGCGCTGTTTGCTAGCGGGGAGACCCAGTACTTC	CASSGALFASGETQYF	TRBV7-9	TRBJ2-5
TGTGCCAGCAGTTTAAGTATGTCGAGCTCGACAGGGGAGGATAGCAATCAGCCCCAGCATTTT	CASSLSMSSSTGEDSNQPQHF	TRBV27	TRBJ1-5
TGCGCCAGCAGCAGACCGGGACTAGACTACGAGCAGTACTTC	CASSRPGLDYEQYF	TRBV5-1	TRBJ2-7
TGCGGCACCCTGCAGTGTTCTAACTATGGCTACACCTTC	CGTLQCSNYGYTF	TRBV10-1	TRBJ1-2
TGTGCCAGCAGTGGTAGGTCCATTTCTAGCAATCAGCCCCAGCATTTT	CASSGRSISSNQPQHF	TRBV6-4	TRBJ1-5
TGTGCCAGCATCGTTACCGGATTCTTCCATGCTTTCTTT	CASIVTGFFHAFF	TRBV6-3	TRBJ1-1
TGTGCCAGCAGTTACTCTGGGACAAACTATGGCTACACCTTC	CASSYSGTNYGYTF	TRBV6-9	TRBJ1-2
TGTGCCAGCAGCCATGTATTGGGACTTGCTAATGAAAAACTGTTTTTT	CASSHVLGLANEKLFF	TRBV14	TRBJ1-4
TGTGCCAGCAGCCCGATTCGTCCAGGGACCTCCCATAATCTAAGCACAGATACGCAGTATTTT	CASSPIRPGTSHNLSTDTQYF	TRBV2	TRBJ2-3
TGTGCCAGCAGCTGTCAGGGCCGGGACGATGGCTACACCTTC	CASSCQGRDDGYTF	TRBV7-3	TRBJ1-2
TGCGCCAGCAGCCCCTCAGACCATTCAGAGACCCAGTACTTC	CASSPSDHSETQYF	TRBV4-3	TRBJ2-5
TGTGCCAGCAGTTTAATCCTAGCGGAGACCCAGTACTTC	CASSLILAETQYF	TRBV27	TRBJ2-5
TGCAGCGTGAGTTACAGGGACTATAATTCACCCCTCCACTTT	CSVSYRDYNSPLHF	TRBV29-1	TRBJ1-6
TGCAGTGCTATGGGGGGGCCTGAGACCCAGTACTTC	CSAMGGPETQYF	TRBV20-1	TRBJ2-5
TGTGCCAGCTCACCACTACTAGAAAGTTTCACCGGGGAGCTGTTTTTT	CASSPLLESFTGELFF	TRBV18	TRBJ2-2
TGTGCCAGTCAGCCAAGCCAGCGGGAGGGCTACTACTTC	CASQPSQREGYYF	TRBV19	TRBJ2-4
TGTGCCAGAGGGGTCGGGGTCACAGATACGCAGTATTTT	CARGVGVTDTQYF	TRBV7-2	TRBJ2-3
TGTGGGGGGCGCCCTAACTATGGCTACACCTTC	CGGRPNYGYTF	TRBV11-3	TRBJ1-2
TGTGCCAGCAGTGCTGGGGCCTGGTATGGCTACACCTTC	CASSAGAWYGYTF	TRBV6-4	TRBJ1-2
TGTGCCAGCAGCGCGGGCTACTATGGCTACACCTTC	CASSAGYYGYTF	TRBV9	TRBJ1-2
TGTGCCAGCAGCCCAGGCACAGGGAAATCCAGGTCACCCCTCCACTTT	CASSPGTGKSRSPLHF	TRBV7-4	TRBJ1-6
TGTGCCAGCAGCTTGAACGCGGGGAGACTTCTAGCTTTCTTT	CASSLNAGRLLAFF	TRBV7-4	TRBJ1-1
TGTGCTAGCAGCTTAGGAATTCGTCCTAAGGGCTTCGAGCAGTACTTC	CASSLGIRPKGFEQYF	TRBV7-7	TRBJ2-7
TGTGCCAGCAGCCAAGAACGACAGGGTACCTATGGCTACACCTTC	CASSQERQGTYGYTF	TRBV3-1	TRBJ1-2
TGTGCCAGCTCTCTAGCGGGGCTAGCCAAAAACATTCAGTACTTC	CASSLAGLAKNIQYF	TRBV11-3	TRBJ2-4
TGTGCCAGCAAGCGACATAATTCACCCCTCCACTTT	CASKRHNSPLHF	TRBV7-2	TRBJ1-6
TGTGCCAGCAGCCCCGGGATATTCAGGACAGCTTTCAGACTGTGTCAGCCCCAGCATTTT	CASSPGIFRTAFRLCQPQHF	TRBV13	TRBJ1-5
TGTGCCAGCCAGGAACCACTGTTTTTT	CASQEPLFF	TRBV6-3	TRBJ1-4
TGTGCCAGCAGCCCCACTAGCGGGCGCTGCTCGAACACCGGGGAGCTGTTTTTT	CASSPTSGRCSNTGELFF	TRBV7-3	TRBJ2-2
TGTGCCAGCATCCCCCAATTTAACACAGATACGCAGTATTTT	CASIPQFNTDTQYF	TRBV6-5	TRBJ2-3
TGTGCCAGCAGCTTAGAACCGACTAATGGACAGGGGCCGACAGATACGCAGTATTTT	CASSLEPTNGQGPTDTQYF	TRBV7-2	TRBJ2-3
TGTGCCATCAGGGGGCCCTTGGGCTACACCTTC	CAIRGPLGYTF	TRBV2	TRBJ1-2
TGTGCCAGACAGGGCATACGGGAGCAGTACTTC	CARQGIREQYF	TRBV2	TRBJ2-7
TGTGCCAGCAGCCAAGAACGTCACGCTGGGAACGAGCAGTACTTC	CASSQERHAGNEQYF	TRBV14	TRBJ2-7
TGTGCCAGCAGCCCTCTAAAAGTGAGCTCCTACGAGCAGTACTTC	CASSPLKVSSYEQYF	TRBV13	TRBJ2-7
TGTGCCAGCGTCGGGCCAGGGCGTGGCTACACCTTC	CASVGPGRGYTF	TRBV2	TRBJ1-2
TGTGCCAGCATATCGACTAGCCCGGGACCCTCCTACGAGCAGTACTTC	CASISTSPGPSYEQYF	TRBV6-3	TRBJ2-7
TGTGCTAGTGGTAAGGGGGAGGACTACGAGCAGTACTTC	CASGKGEDYEQYF	TRBV12-5	TRBJ2-7
TGTGCCAGCAGCGCAACAACAGGGAGCACCAATGAAAAACTGTTTTTT	CASSATTGSTNEKLFF	TRBV9	TRBJ1-4
TGTGCCATAGGCGGTGGCTACAATGAGCAGTTCTTC	CAIGGGYNEQFF	TRBV28	TRBJ2-1
TGTGCCAGCAGTCCCCCCAGCTGGAGTCGGGGAGAGCCCCAGCATTTT	CASSPPSWSRGEPQHF	TRBV6-2	TRBJ1-5
TGTGCCAGCAGCGGAATGACCCATCCAGGTAGAGCAGGGGTTGTTAACTATGGCTACACCTTC	CASSGMTHPGRAGVVNYGYTF	TRBV9	TRBJ1-2
TGCAGTGCTATTATGGGGGGCCCGGGGAGGGGCACCGGGGAGCTGTTTTTT	CSAIMGGPGRGTGELFF	TRBV20-1	TRBJ2-2
TGTGCCAGCAGTTTGAAAGAGTGTGGCTACACCTTC	CASSLKECGYTF	TRBV27	TRBJ1-2
TGTGCCAGCAGTTTACCGGGGACAGGGGTAATTGCTTTCTTT	CASSLPGTGVIAFF	TRBV12-4	TRBJ1-1
TGTGCCACCAAGCTAGCGGGGGTCGCGAACACCGGGGAGCTGTTTTTT	CATKLAGVANTGELFF	TRBV24-1	TRBJ2-2
TGTGCCATCAGTTTAACAGGGGGCTACGAGCAGTACTTC	CAISLTGGYEQYF	TRBV10-3	TRBJ2-7
TGTGCCAGCAGCGCAGGGATTCTGTTTTTT	CASSAGILFF	TRBV9	TRBJ1-4
TGTGCCAGTAGTCCGGGACAGGGGGCGTGTGACTATGGCTACACCTTC	CASSPGQGACDYGYTF	TRBV19	TRBJ1-2
TGTGCCAGCAGTATCGGAGAGGGTCTTACGGTGGAAAAGCAAGAGACCCAGTACTTC	CASSIGEGLTVEKQETQYF	TRBV27	TRBJ2-5
TGTGCCAGCAAATACAGGGCAGGGGAGGGAAACGAGCAGTACTTC	CASKYRAGEGNEQYF	TRBV9	TRBJ2-7
TGCAGTGCTATCAGGACAGGTAAGGATGGCTACACCTTC	CSAIRTGKDGYTF	TRBV20-1	TRBJ1-2
TGTGCCAGCAGTGACCGTCACCGGACAGGGTACCCCCGCCATGGAAACACCATATATTTT	CASSDRHRTGYPRHGNTIYF	TRBV6-4	TRBJ1-3
TGTGCCATTTCGGCGGGACAGAGGTCCTCCTACGAGCAGTACTTC	CAISAGQRSSYEQYF	TRBV7-6	TRBJ2-7
TGTGCCAGCAGCTGTCACGGGGCTGTTACCAGCAATCAGCCCCAGCATTTT	CASSCHGAVTSNQPQHF	TRBV7-3	TRBJ1-5
TGTGCCAGCAGAGGACAGGGTTACGAGCAGTACTTC	CASRGQGYEQYF	TRBV14	TRBJ2-7
TGCAGTGCCCCACTCCCTCACCGGCGGGAGAATTATAGCAATCAGCCCCAGCATTTT	CSAPLPHRRENYSNQPQHF	TRBV20-1	TRBJ1-5
TGTGCCAGCAGCTTAGCTCTTCTAGCGGGCTCCTACAATGAGCAGTTCTTC	CASSLALLAGSYNEQFF	TRBV7-2	TRBJ2-1
TGTGCCACCAGTGTCAAGGTAGACTGGGCTGGGGCCAACGTCCTGACTTTC	CATSVKVDWAGANVLTF	TRBV24-1	TRBJ2-6
TGTGCCAGCAGTAGCTGGGGTGGAAACACCATATATTTT	CASSSWGGNTIYF	TRBV12-4	TRBJ1-3
TGTGCCAGCAGCTACGACACTAGCGGGAGCGGCTCCTACAATGAGCAGTTCTTC	CASSYDTSGSGSYNEQFF	TRBV13	TRBJ2-1
TGTGCCGAACACAGGGATGGCTACACCTTC	CAEHRDGYTF	TRBV30	TRBJ1-2
TGTGCCAGCAGCTTAGCGGGTCCGACAGGGGGAGGGTGGGCTAATGAAAAACTGTTTTTT	CASSLAGPTGGGWANEKLFF	TRBV7-7	TRBJ1-4
TGTGCCTGTAGGGAAGAGACCCAGTACTTC	CACREETQYF	TRBV30	TRBJ2-5
TGTGCCAGCTCACTGACCCCAGACAGGGCTCACGAGCAGTACTTC	CASSLTPDRAHEQYF	TRBV18	TRBJ2-7
TGTGCCAGCAGCACCCCAATCCGGGGGGGGGTGCTTAGAAAGTCCTACAATGAGCAGTTCTTC	CASSTPIRGGVLRKSYNEQFF	TRBV7-8	TRBJ2-1
TGTGCCACCAGGCGAACGCGCGGGACACCGCCTGAAGCTTTCTTT	CATRRTRGTPPEAFF	TRBV24-1	TRBJ1-1
TGCGCCAGCAGCCACGGACTAGCGGGGCCGTACAATGAGCAGTTCTTC	CASSHGLAGPYNEQFF	TRBV4-1	TRBJ2-1
TGTGCCAGCAGCAAAGACTGTTATAATGAAAAACTGTTTTTT	CASSKDCYNEKLFF	TRBV11-3	TRBJ1-4
TGTGCCTGGAGTGTACAGGTGAACGGCAATCAGCCCCAGCATTTT	CAWSVQVNGNQPQHF	TRBV30	TRBJ1-5
TGTGCCAGCAGTGACGATCGACAGGGGCTCTATAGCAATCAGCCCCAGCATTTT	CASSDDRQGLYSNQPQHF	TRBV6-4	TRBJ1-5
TGTGCCATCAGAGCGGTCCCCGGGGGCTACTCTCAGCCCCAGCATTTT	CAIRAVPGGYSQPQHF	TRBV10-3	TRBJ1-5
TGTGCCAGCAGGAGTACCTCAGGATGGGGAATGGGCTACACCTTC	CASRSTSGWGMGYTF	TRBV6-1	TRBJ1-2
TGTGCCACCAGTGATTTTAGGGGTTACAATGAGCAGTTCTTC	CATSDFRGYNEQFF	TRBV24-1	TRBJ2-1
TGTGCCAGCAGCCTACACAAGGGGTTCTCTGGGGCCAACGTCCTGACTTTC	CASSLHKGFSGANVLTF	TRBV14	TRBJ2-6
TGTGCCAGCACACGGACAGCGTCGTTTCAGCCCCAGCATTTT	CASTRTASFQPQHF	TRBV28	TRBJ1-5
TGTGCCAGCAGTGAAGGGGGAGGGAACACTGAAGCTTTCTTT	CASSEGGGNTEAFF	TRBV2	TRBJ1-1
TGTGCCAGCAGTAACAGGGGGCTGTGTCAGCCCCAGCATTTT	CASSNRGLCQPQHF	TRBV6-2	TRBJ1-5
TGCAGTGCCTTCATGGGGGGCCCAGATCAGCCCCAGCATTTT	CSAFMGGPDQPQHF	TRBV20-1	TRBJ1-5
TGTGCCAGCATCCTACAGGGAGCTAACTATGGCTACACCTTC	CASILQGANYGYTF	TRBV6-5	TRBJ1-2
TGTGCCAGCAGCCATACAGCTGGAAACACCATATATTTT	CASSHTAGNTIYF	TRBV3-1	TRBJ1-3
TGCAGTGCTCCGGGCCGGGGGTCAAATCAGCCCCAGCATTTT	CSAPGRGSNQPQHF	TRBV20-1	TRBJ1-5
TGCAGCGTTGAGGGGAGTGGGGACAGGGAGATATACGAGCAGTACTTC	CSVEGSGDREIYEQYF	TRBV29-1	TRBJ2-7
TGTGCCAGCAGTTTACGGGGCATTAATCAGCCCCAGCATTTT	CASSLRGINQPQHF	TRBV28	TRBJ1-5
TGTGCCAGCAGTTTATCGCGTCTCCAAACGAGAGAGACCCAGTACTTC	CASSLSRLQTRETQYF	TRBV27	TRBJ2-5
TGTGCCAGCAGTAGTACTTTCCCGGAGACCCAGTACTTC	CASSSTFPETQYF	TRBV27	TRBJ2-5
TGTGCCAGCAGTTACTCCCGAATGGACAGGGGCCTCCTGAGAGCGGGGGAGACCCAGTACTTC	CASSYSRMDRGLLRAGETQYF	TRBV6-3	TRBJ2-5
TGCAGCAACAGGCGGGGTTTAAGCAATCAGCCCCAGCATTTT	CSNRRGLSNQPQHF	TRBV29-1	TRBJ1-5
TGTGCCAGCAGTGTGCGGCGGGAGTCGTCCTACAATGAGCAGTTCTTC	CASSVRRESSYNEQFF	TRBV27	TRBJ2-1
TGTGCCACCAGATACACTTCGGGCTACACCTTC	CATRYTSGYTF	TRBV24-1	TRBJ1-2
TGTGCCAGCAGCCCCCCTCCCCGGGGGCCCGTAACTGAAGCTTTCTTT	CASSPPPRGPVTEAFF	TRBV12-4	TRBJ1-1
TGCAGTGCACCCAACTATGGCTACACCTTC	CSAPNYGYTF	TRBV20-1	TRBJ1-2
TGCAGTGCTAGAGAAATACCGACAGGGGTATCTAATGAAAAACTGTTTTTT	CSAREIPTGVSNEKLFF	TRBV20-1	TRBJ1-4
TGCAGTGCTAGAGAGACAGGGGTCGCGTGGGAAGCTTTCTTT	CSARETGVAWEAFF	TRBV20-1	TRBJ1-1
TGTGCCAGCAGGGCCCGGGACAGGGGTTACGAGCAGTACTTC	CASRARDRGYEQYF	TRBV5-6	TRBJ2-7
TGTGCCAGCAGTTATCATTGTCACTATAACGAGCAGTACTTC	CASSYHCHYNEQYF	TRBV6-1	TRBJ2-7
TGCGCCAGCAGCTTCGACTTCCATTCACCCCTCCACTTT	CASSFDFHSPLHF	TRBV5-1	TRBJ1-6
TGCAGTGCTAGAGTTGGGGGACTTAGTCCTTCAGCCGGGGAGCTGTTTTTT	CSARVGGLSPSAGELFF	TRBV20-1	TRBJ2-2
TGTGCCAGCAGCCCAGGCGTTAGCTCCTACGAGCAGTACTTC	CASSPGVSSYEQYF	TRBV6-1	TRBJ2-7
TGCAGTGCTAGCCCCGGACGGGACACTGAAGCTTTCTTT	CSASPGRDTEAFF	TRBV20-1	TRBJ1-1
TGCGCCAGCAGCCAAGGTAGCCGACCAGTGTACGAGCAGTACTTC	CASSQGSRPVYEQYF	TRBV4-1	TRBJ2-7
TGTGCCAGCAGCGGGGGGTGCAGGTTGAACACTGAAGCTTTCTTT	CASSGGCRLNTEAFF	TRBV9	TRBJ1-1
TGCAGTGCTAGAGGGACGGGGGCTACTGGAGAGATCTTC	CSARGTGATGEIF	TRBV20-1	TRBJ2-1
TGTGCCAGCAGCCCCAGGGCGGGCTCCTATAATTCACCCCTCCACTTT	CASSPRAGSYNSPLHF	TRBV7-3	TRBJ1-6
TGTGCCAGCAGGAGGGACAGGGATCAGCCCCAGCATTTT	CASRRDRDQPQHF	TRBV12-4	TRBJ1-5
TGTGCCAGCAGTTTACATTTTGGGGGGCAAGCGAACACTGAAGCTTTCTTT	CASSLHFGGQANTEAFF	TRBV27	TRBJ1-1
TGCAGTGCTAGCCCGGACAGGCTGGGAGTCGAGCAGTACTTC	CSASPDRLGVEQYF	TRBV20-1	TRBJ2-7
TGTGCCAGCAGTGAACGACAGGGGCCCCGGGTTGAAAATGAAAAACTGTTTTTT	CASSERQGPRVENEKLFF	TRBV25-1	TRBJ1-4
TGTGCCAGCAGCTGTGCCCCGTCTTGCAGTCCTCCGGGACAGGGTCAGCCCCAGCATTTT	CASSCAPSCSPPGQGQPQHF	TRBV7-2	TRBJ1-5
TGTGCCTGGAGTGCCCCACAGGGGGATGAGCAGTTCTTC	CAWSAPQGDEQFF	TRBV30	TRBJ2-1
TGCAGTGCTAGAGCTCCGGGACAGATCTACGAGCAGTACTTC	CSARAPGQIYEQYF	TRBV20-1	TRBJ2-7
TGTGCCAGCAGCGTAGAACCTGAGGGGAGAATGGATCAGCCCCAGCATTTT	CASSVEPEGRMDQPQHF	TRBV9	TRBJ1-5
TGCGCCAGCTATGGGACGTTGAATCATGCAACTAATGAAAAACTGTTTTTT	CASYGTLNHATNEKLFF	TRBV10-1	TRBJ1-4
TGTGCCAGCAGCCAAGGACGGAACAGCGGAGCCGTATACACTGAAGCTTTCTTT	CASSQGRNSGAVYTEAFF	TRBV3-1	TRBJ1-1
TGTGCCAGCAGCGTAAAACCGGCCCTAACACAAGAGACCCAGTACTTC	CASSVKPALTQETQYF	TRBV9	TRBJ2-5
TGTGCCAGCAGCGGGGGCGAATATGGCTACACCTTC	CASSGGEYGYTF	TRBV7-2	TRBJ1-2
TGTGCCCCGGGCAAGAGGGGTCGCTATAATTCACCCCTCCACTTT	CAPGKRGRYNSPLHF	TRBV30	TRBJ1-6
TGTGCAAAGACAGGGCCCGGGAATCAGCCCCAGCATTTT	CAKTGPGNQPQHF	TRBV2	TRBJ1-5
TGTGCCAGCATACCCCAGGGTCATGAGACCCAGTACTTC	CASIPQGHETQYF	TRBV28	TRBJ2-5
TGTGCCAGCATCGGACAGTCGGGGGTATCCGTCTATGGCTACACCTTC	CASIGQSGVSVYGYTF	TRBV9	TRBJ1-2
TGTGCCACGGGCGGGGCCACCTTCACTGAAGCTTTCTTT	CATGGATFTEAFF	TRBV28	TRBJ1-1
TGTGCCAGCAGCCAACGTGAGGGGGCTAGCACAGATACGCAGTATTTT	CASSQREGASTDTQYF	TRBV14	TRBJ2-3
TGTGCCAGCAGCATTGGCCCAGACACTGAAGCTTTCTTT	CASSIGPDTEAFF	TRBV28	TRBJ1-1
TGTGCCAGCTTCTTATTATTCTCCACAGGGTCTGACACTGAAGCTTTCTTT	CASFLLFSTGSDTEAFF	TRBV11-3	TRBJ1-1
TGTGCCAGCAGTTTCCCTAACAGGGGAAGGCAAGAGACCCAGTACTTC	CASSFPNRGRQETQYF	TRBV27	TRBJ2-5
TGTGCCAGCAGTTTGTCCAGGGGTGGCCCAGAAAATCAGCCCCAGCATTTT	CASSLSRGGPENQPQHF	TRBV27	TRBJ1-5
TGTGCCAGCAGCCACCAGGGTGCTAATGAAAAACTGTTTTTT	CASSHQGANEKLFF	TRBV7-9	TRBJ1-4
TGTGCCAGCAGCGCAAACAGGGGTGTGGCTTTCTTT	CASSANRGVAFF	TRBV4-2	TRBJ1-1
TGTGCTAGTGGTTTAATTCACGAATCCCAGCATTTT	CASGLIHESQHF	TRBV12-5	TRBJ1-5
TGCAGTGCTCCCCAGCCTAGCGGGGCGGGTGAGCAGTTCTTC	CSAPQPSGAGEQFF	TRBV20-1	TRBJ2-1
TGTGCCAGCAGCTTATTAGCACACTATTGGAACACTGAAGCTTTCTTT	CASSLLAHYWNTEAFF	TRBV7-9	TRBJ1-1
TGTGCCAGTAGTATTGCGCTCGTGGGGGAGCCCGACGAGCAGTACTTC	CASSIALVGEPDEQYF	TRBV19	TRBJ2-7
TGTGCCAGCAGCGACTCCCCGACAGGGGGCTGCTCCTACGAGCAGTACTTC	CASSDSPTGGCSYEQYF	TRBV9	TRBJ2-7
TGCGCCAGCAGTTTCCAGGGACTAGCGGGAGTGGAGACCCAGTACTTC	CASSFQGLAGVETQYF	TRBV10-1	TRBJ2-5
TGTGCCAGCAGCTTAGAGGGACAGGGCTCCTACAATGAGCAGTTCTTC	CASSLEGQGSYNEQFF	TRBV7-6	TRBJ2-1
TGTGCCAGCAGCCAAAACCGGCCCTACAATGAGCAGTTCTTC	CASSQNRPYNEQFF	TRBV3-1	TRBJ2-1
TGTGCCTGGAGGTCCCCGACAGGGGGCCAGAGACCCCAGTACTTC	CAWRSPTGGQRPQYF	TRBV30	TRBJ2-5
TGTGCCAGCAGTGACACCGGATTAAGGAGCTCCTACAATGAGCAGTTCTTC	CASSDTGLRSSYNEQFF	TRBV6-4	TRBJ2-1
TGTGCCAGCAGTTACTACCCACCTGTAAACACCGGGGAGCTGTTTTTT	CASSYYPPVNTGELFF	TRBV6-5	TRBJ2-2
TGTGCCAGCCAGGGACGACGCTGCACTGAAGCTTTCTTT	CASQGRRCTEAFF	TRBV7-3	TRBJ1-1
TGTGCCAGCAGTGAGACAGCTGAAGCTTTCTTT	CASSETAEAFF	TRBV25-1	TRBJ1-1
TGTGCCAGCAGCGGGCGGGGAAGTGTTGGGTACAATGAGCAGTTCTTC	CASSGRGSVGYNEQFF	TRBV9	TRBJ2-1
TGTGCCAGCAGTGATGGGGGGGGGACGTTTGAGACCCAGTACTTC	CASSDGGGTFETQYF	TRBV6-4	TRBJ2-5
TGTGCCAGCAGCCCTCCCGGGACGTCGGGAGGCGGCTCCTACAATGAGCAGTTCTTC	CASSPPGTSGGGSYNEQFF	TRBV7-3	TRBJ2-1
TGTGCCAGTAGTAGCGGGACACTAGAAGCTAACTATGGCTACACCTTC	CASSSGTLEANYGYTF	TRBV19	TRBJ1-2
TGTGCCAGCAGCGTTCTGGGACGGGCATACTACTCCTACGAGCAGTACTTC	CASSVLGRAYYSYEQYF	TRBV7-4	TRBJ2-7
TGTGCCTGGAGTGGAGAGTGTATACAGCCCCAGCATTTT	CAWSGECIQPQHF	TRBV30	TRBJ1-5
TGTGCCAGCAGTGACTCGCTCAGCGCAACTAATGAAAAACTGTTTTTT	CASSDSLSATNEKLFF	TRBV6-4	TRBJ1-4
TGCAGTGCTGTTCCGTCGGGGGAGCAGCTAGCCAAAAACATTCAGTACTTC	CSAVPSGEQLAKNIQYF	TRBV20-1	TRBJ2-4
TGTGCCAGCAGCCAAAACCCCGGGACAGCGATGACTGAAGCTTTCTTT	CASSQNPGTAMTEAFF	TRBV7-2	TRBJ1-1
TGTGCCAGCCGGTTGGACCTATCTGGAAACACCATATATTTT	CASRLDLSGNTIYF	TRBV7-2	TRBJ1-3
TGCGCCACCGGGAGGACAGGGCGCAATCAGCCCCAGCATTTT	CATGRTGRNQPQHF	TRBV10-1	TRBJ1-5
TGTGCCAGCAGCTGTGCAGAGCCGCGGGAGTGCGAAGCCGGGGAGCTGTTTTTT	CASSCAEPRECEAGELFF	TRBV11-1	TRBJ2-2
TGTGCCAGCAGCTCTAGCGGGCAAGGCTCTGGGGCCAACGTCCTGACTTTC	CASSSSGQGSGANVLTF	TRBV7-9	TRBJ2-6
TGTGCCAGCAGTGGCGGGTGCTCACAGGTTGAAAAACTGTTTTTT	CASSGGCSQVEKLFF	TRBV6-8	TRBJ1-4
TGCGCCAGCAGCCAAGATAGGGACAGCCCGCCCTACGAGCAGTACTTC	CASSQDRDSPPYEQYF	TRBV4-1	TRBJ2-7
TGTGCCAGCAGTCAGGGGCCTAGAATCTACGAGCAGTACTTC	CASSQGPRIYEQYF	TRBV27	TRBJ2-7
TGTGCCAGCAGCTATACCCCCCAGGAGCAGTTCTTC	CASSYTPQEQFF	TRBV13	TRBJ2-1
TGCGCCAGCAGCTTGGAGTTCTTGGGACTAGCGGGTACAGATACGCAGTATTTT	CASSLEFLGLAGTDTQYF	TRBV5-1	TRBJ2-3
TGCGCCAGCAGAATGCTGCGGGAGGGCTATGGCTACACCTTC	CASRMLREGYGYTF	TRBV5-1	TRBJ1-2
TGTGCCAGCAGCGACCGGGTAAATTCACCCCTCCACTTT	CASSDRVNSPLHF	TRBV13	TRBJ1-6
TGTGCCAGCAGCTTAGGGAGACCGACACAGGGGGCCCCTTTCTTT	CASSLGRPTQGAPFF	TRBV7-9	TRBJ1-1
TGCAGTGCTATGCGGGCGACTTATCGTAGGCCCATGAACACTGAAGCTTTCTTT	CSAMRATYRRPMNTEAFF	TRBV20-1	TRBJ1-1
TGCAGTGCAGGGGTGGTAGTTTCCCGCGAGCAGTACTTC	CSAGVVVSREQYF	TRBV20-1	TRBJ2-7
TGCGCCAGCAGCCAAGCAGGACTAGCGGGGCTTGGTTACACCGGGGAGCTGTTTTTT	CASSQAGLAGLGYTGELFF	TRBV4-1	TRBJ2-2
TGTGCCAGCAGCTTAGAGCCCACAGGGTTGCCCCAGCATTTT	CASSLEPTGLPQHF	TRBV7-9	TRBJ1-5
TGCGCCAGCAGCTTGCCCCACATTTTGGGACTAGCGGGGGTTGAGACCCAGTACTTC	CASSLPHILGLAGVETQYF	TRBV5-1	TRBJ2-5
TGTGCCAGCAGGACAGGGAACTATGGCTACACCTTC	CASRTGNYGYTF	TRBV27	TRBJ1-2
TGTGCCAGTAGTAACCGGGGCACTTCTGGAAACACCATATATTTT	CASSNRGTSGNTIYF	TRBV19	TRBJ1-3
TGTGCCAGCAGTGCTTACAGGGGGGTGAACACTGAAGCTTTCTTT	CASSAYRGVNTEAFF	TRBV27	TRBJ1-1
TGTGCCACCAGTGAAGGACTACCTAACGCCCTAGCGGGCAATGAGCAGTTCTTC	CATSEGLPNALAGNEQFF	TRBV24-1	TRBJ2-1
TGTGCCAGCAGCCACAAAATTTTAAACACCGGGGAGCTGTTTTTT	CASSHKILNTGELFF	TRBV5-5	TRBJ2-2
TGTGCCAGCGTGCTAGGGGAAAACATTCAGTACTTC	CASVLGENIQYF	TRBV25-1	TRBJ2-4
TGTGCCAGCAGGCCGACTAGCGGAGCGGGGGAGCAGTACTTC	CASRPTSGAGEQYF	TRBV6-4	TRBJ2-7
TGCAGTGCTAGCCTGAAAGGGACGAGAGAGACCCAGTACTTC	CSASLKGTRETQYF	TRBV20-1	TRBJ2-5
TGTGCCAGCCCCGGGACAGGGTTAGAACAGCATTTT	CASPGTGLEQHF	TRBV19	TRBJ1-5
TGTGCCAGCAGCTTGCCAGGGAGGAACACCGGGGAGCTGTTTTTT	CASSLPGRNTGELFF	TRBV5-8	TRBJ2-2
TGTGCTAGCAGCTTATTCCGCTCGGCTCCCAGCCCACAGAATTTACAGGGGGGGGTATACTATGGCTACACCTTC	CASSLFRSAPSPQNLQGGVYYGYTF	TRBV7-7	TRBJ1-2
TGTGCCAGCAGCGTTCGGGGAGGCCAAAATGAAAAACTGTTTTTT	CASSVRGGQNEKLFF	TRBV9	TRBJ1-4
TGCAGTGCTAGAGATGAATCGGGAAGAGTTGCGAACACCGGGGAGCTGTTTTTT	CSARDESGRVANTGELFF	TRBV20-1	TRBJ2-2
TGTGCCAGCAGCTTAGATGCTAGGTGGAGTTATACGCAGTATTTT	CASSLDARWSYTQYF	TRBV11-2	TRBJ2-3
TGTGCCAGCAGCCGGCTATGGGGGTCTACAGCTAACTATGGCTACACCTTC	CASSRLWGSTANYGYTF	TRBV13	TRBJ1-2
TGTGCCAGCAACAGGGGCGGAAACACTGAAGCTTTCTTT	CASNRGGNTEAFF	TRBV27	TRBJ1-1
TGTGCCAGCTCACCACCCCGGGCGCAGGGACCGGGACTTGGGAATTCACCCCTCCACTTT	CASSPPRAQGPGLGNSPLHF	TRBV18	TRBJ1-6
TGTGCCAGTAGCAATGCAGGGCTAAATTCCGGGGAGCTGTTTTTT	CASSNAGLNSGELFF	TRBV19	TRBJ2-2
TGTGCCAGCAGTCACATCCTACCCCAAGAGACCCAGTACTTC	CASSHILPQETQYF	TRBV6-5	TRBJ2-5
TGCGCCAGCAAGGGGGGTACATTTCAGCCCCAGCATTTT	CASKGGTFQPQHF	TRBV10-1	TRBJ1-5
TGCGCCAGAGCCTCCGGCGCTACATATGGCTACACCTTC	CARASGATYGYTF	TRBV5-1	TRBJ1-2
TGTGCCAGCAGCAAGGGTGGGACTAGCGGGTTCGACAATGAGCAGTTCTTC	CASSKGGTSGFDNEQFF	TRBV9	TRBJ2-1
TGTGCCAGCCAAGCTCGGATGCAGTACTTC	CASQARMQYF	TRBV6-1	TRBJ2-7
TGTGCCAGCAGGTCTGCAGGGGGAGTTGAAGCTTTCTTT	CASRSAGGVEAFF	TRBV6-6	TRBJ1-1
TGCAGTGCCAACAGGGGGGAAGATACGCAGTATTTT	CSANRGEDTQYF	TRBV20-1	TRBJ2-3
TGTGCCAGCAGCAAAATGAGGGACTGGGAAAACTCTCCAAATCAGCCCCAGCATTTT	CASSKMRDWENSPNQPQHF	TRBV7-7	TRBJ1-5
TGTGCCAGCAGCTTGGTAGAACAAATGAACACTGAAGCTTTCTTT	CASSLVEQMNTEAFF	TRBV5-4	TRBJ1-1
TGTGCCAGCAGTTTCCGCCCTTGGGGGGCTATCCGAGCCTACGAGCAGTACTTC	CASSFRPWGAIRAYEQYF	TRBV27	TRBJ2-7
TGTGCCAGCAGTTTAAGTTCGACAGGGGGTAACACTGAAGCTTTCTTT	CASSLSSTGGNTEAFF	TRBV12-3	TRBJ1-1
TGTGCCTGGACAGGGTCCTACAATGAGCAGTTCTTC	CAWTGSYNEQFF	TRBV30	TRBJ2-1
TGCGCCATCTTGGGGGGTCGGGCCAACGTCCTGACTTTC	CAILGGRANVLTF	TRBV10-2	TRBJ2-6
TGTGCCAGCAGCACAAGGGCAGAAAGCTACAATGAGCAGTTCTTC	CASSTRAESYNEQFF	TRBV7-3	TRBJ2-1
TGTGCCAGCAGTGAAAAAAACAACTCCGGGACAGGGGAGGGAGGGGGGAACACTGAAGCTTTCTTT	CASSEKNNSGTGEGGGNTEAFF	TRBV6-1	TRBJ1-1
TGTGCCAGCAGCCGACAGGGGCTCAATCAGCCCCAGCATTTT	CASSRQGLNQPQHF	TRBV7-6	TRBJ1-5
TGTGCCAGCAGCGCATGGGACAGGGGTGCCTCCTACGAGCAGTACTTC	CASSAWDRGASYEQYF	TRBV9	TRBJ2-7
TGCAGCGTCCTATGGGACTGGGCTTTCTTT	CSVLWDWAFF	TRBV29-1	TRBJ1-1
TGTGCCAGCAGTTCTCGGCATAGGAATCAGCCCCAGCATTTT	CASSSRHRNQPQHF	TRBV12-4	TRBJ1-5
TGCGCCAGCAGGGCCTATACTTTGGGGACCACTGAAGCTTTCTTT	CASRAYTLGTTEAFF	TRBV5-1	TRBJ1-1
TGTGCCAGTACGACACATTATAACTATGGCTACACCTTC	CASTTHYNYGYTF	TRBV19	TRBJ1-2
TGTGCCAGCACCGAACCAGGGGGCGCCCTCCCCTACGAGCAGTACTTC	CASTEPGGALPYEQYF	TRBV12-3	TRBJ2-7
TGTGCCAGCAGTGACCATATTTCTCGTGTGAGGGCCTCTGGAAACACCATATATTTT	CASSDHISRVRASGNTIYF	TRBV6-4	TRBJ1-3
TGTGCCATCAGTGAGTGTACTCTTATCGAGACCCAGTACTTC	CAISECTLIETQYF	TRBV10-3	TRBJ2-5
TGCAGCGTTGTCCTCTCCCAGGGGTTTCTCCGCTACACCTTC	CSVVLSQGFLRYTF	TRBV29-1	TRBJ1-2
TGCGCCAGCAGCGCACCCCGTACCTATACCGGGGAGCTGTTTTTT	CASSAPRTYTGELFF	TRBV4-1	TRBJ2-2
TGCATTTCCGGGGGCTGGTATGGCTACACCTTC	CISGGWYGYTF	TRBV20-1	TRBJ1-2
TGTGCCAGCAGCGGACCGGGACTCGGCAATCAGCCCCAGCATTTT	CASSGPGLGNQPQHF	TRBV7-2	TRBJ1-5
TGTGCCTGGAGTGTACCGGTAGGAGATACGCAGTATTTT	CAWSVPVGDTQYF	TRBV30	TRBJ2-3
TGTGCCAGCAGTGACTCCCTAGGGGACAATGAGCAGTTCTTC	CASSDSLGDNEQFF	TRBV6-1	TRBJ2-1
TGTGCCAGCGCTGACCTTAGCAATCAGCCCCAGCATTTT	CASADLSNQPQHF	TRBV7-9	TRBJ1-5
TGTGCCAGCAGCTTTCAGGGGGGAGAGACCCAGTACTTC	CASSFQGGETQYF	TRBV5-4	TRBJ2-5
TGTGCCAGCAGTGACTTACTGGGGGGGGGAGACATTCAGTACTTC	CASSDLLGGGDIQYF	TRBV6-4	TRBJ2-4
TGTGCCAGCAGTCGACAATGGGGGGGGAGCGGGGACACAGATACGCAGTATTTT	CASSRQWGGSGDTDTQYF	TRBV6-5	TRBJ2-3
TGTGCCAGCAGTTACTGGCAACAGGGGGGGCTGTTTTTT	CASSYWQQGGLFF	TRBV6-6	TRBJ1-4
TGCAGTGCTAGGCCGGTCCACCCGAGAGTACTCCAGCCCCAGCATTTT	CSARPVHPRVLQPQHF	TRBV20-1	TRBJ1-5
TGTGCCAGCAGTGTTGGGGGGGATCCGTACAATGAGCAGTTCTTC	CASSVGGDPYNEQFF	TRBV6-4	TRBJ2-1
TGTGCCAGCAGCTTTACAGGGAACACTGAAGCTTTCTTT	CASSFTGNTEAFF	TRBV7-6	TRBJ1-1
TGCAGCGTTGAGCAGCAAGGGGTTCAGCCCCAGCATTTT	CSVEQQGVQPQHF	TRBV29-1	TRBJ1-5
TGTGCCAGCAGTCCATGGGGGGGCAGGGACGTCTACGAGCAGTACTTC	CASSPWGGRDVYEQYF	TRBV27	TRBJ2-7
TGTGCCAGCACCCCGTTGGGGGTTTCCTACGAGCAGTACTTC	CASTPLGVSYEQYF	TRBV6-4	TRBJ2-7
TGTGCCAGCATAGGCGGACGGCCCCAGCATTTT	CASIGGRPQHF	TRBV10-3	TRBJ1-5
TGTGCCTTAGCGGGAGATACGCAGTATTTT	CALAGDTQYF	TRBV10-3	TRBJ2-3
TGTGCCAGCAGCTTGACCGGTCCGCCCCTTGCCGGGACAGGGGTTCCCCAGCATTTT	CASSLTGPPLAGTGVPQHF	TRBV11-3	TRBJ1-5
TGCGCCAGCAGGTTTGGACATCGCTATGGCTACACCTTC	CASRFGHRYGYTF	TRBV10-1	TRBJ1-2
TGTGCCAGCAAACGTAGGGGCACCTACGAGCAGTACTTC	CASKRRGTYEQYF	TRBV28	TRBJ2-7
TGTGCCATCGAAGAACTCCCTAGACCAGTCGAGCAGTACTTC	CAIEELPRPVEQYF	TRBV10-3	TRBJ2-7
TGTGCGTACGAGCAGTACTTC	CAYEQYF	TRBV6-4	TRBJ2-7
TGTGCCACCAGTGTACAGGCTAGGTACGAGCAGTACTTC	CATSVQARYEQYF	TRBV24-1	TRBJ2-7
TGTGCCAGCAGTGAAGAACACGACTGGTGGTACACCATATATTTT	CASSEEHDWWYTIYF	TRBV2	TRBJ1-3
TGTGCCACCAGTGCGCGGACGGACGGTGGTTGTGAGCAGTTCTTC	CATSARTDGGCEQFF	TRBV24-1	TRBJ2-1
TGCAGTGAGGTTCCCCAGCTATGGGAAAAACTGTTTTTT	CSEVPQLWEKLFF	TRBV20-1	TRBJ1-4
TGTGCCATCAGTGCCTCAGGGGACAATCAGCCCCAGCATTTT	CAISASGDNQPQHF	TRBV10-3	TRBJ1-5
TGTGCCAGCAGCACAGGATGGGACTCTGGAAACACCATATATTTT	CASSTGWDSGNTIYF	TRBV7-4	TRBJ1-3
TGTGCCAGCAGTCGCGGGACTAGCGAGAAAAGCACAGATACGCAGTATTTT	CASSRGTSEKSTDTQYF	TRBV6-4	TRBJ2-3
TGTGCCAGCAGTCGTGACGACAGCTTCCAGCCCCAGCATTTT	CASSRDDSFQPQHF	TRBV28	TRBJ1-5
TGTGCCAGCAGCTGGACATGTGATGGCTACACCTTC	CASSWTCDGYTF	TRBV7-9	TRBJ1-2
TGCAGTGCTGGTTGCCTCGAGTTAGGAGCCAAAAACATTCAGTACTTC	CSAGCLELGAKNIQYF	TRBV20-1	TRBJ2-4
TGTGCCAGCTCACCACGGGAGGAGGGCACAGATACGCAGTATTTT	CASSPREEGTDTQYF	TRBV18	TRBJ2-3
TGCGCCAGCAGCGGGGAGTTCGGCTACACCTTC	CASSGEFGYTF	TRBV4-3	TRBJ1-2
TGTGCCAGCAGCTTACCCAATGCGGGTTTGACCTACGAGCAGTACTTC	CASSLPNAGLTYEQYF	TRBV7-7	TRBJ2-7
TGTGCCAGCAGGACGGGACATGCCGGAGGGGATTCCGGCTACACCTTC	CASRTGHAGGDSGYTF	TRBV6-2	TRBJ1-2
TGTGCCAGCAGCGAGGAGGGCTATGGCTACACCTTC	CASSEEGYGYTF	TRBV7-9	TRBJ1-2
TGTGCCAGCAGTTGGCGGGGTAGGAAGACCCAGTACTTC	CASSWRGRKTQYF	TRBV6-6	TRBJ2-5
TGTGCCAGCAGCTCGACTAGCGGGAGCGGATACGAGCAGTACTTC	CASSSTSGSGYEQYF	TRBV7-4	TRBJ2-7
TGCGCCAGCAGCTATGTGACTAGCGGGCTGGCCAATGAGCAGTTCTTC	CASSYVTSGLANEQFF	TRBV5-1	TRBJ2-1
TGTGCCAGCAGCTTCTATATCCCCGACTACGAGCAGTACTTC	CASSFYIPDYEQYF	TRBV7-6	TRBJ2-7
TGTGCCAGCAGCTTAATGGACAGGGAAGGTGAAGCTTTCTTT	CASSLMDREGEAFF	TRBV7-3	TRBJ1-1
TGTGCCAGTAGGTGCCCGGGACAGGGGTATAGCTCTGGAAACACCATATATTTT	CASRCPGQGYSSGNTIYF	TRBV19	TRBJ1-3
TGTGCCAGCAGTTACCCCGCCGAACAGAACACTGAAGCTTTCTTT	CASSYPAEQNTEAFF	TRBV6-5	TRBJ1-1
TGTGCCAGCATTCAGGGGGCGGGCGGCCCTGGAAACACCATATATTTT	CASIQGAGGPGNTIYF	TRBV28	TRBJ1-3
TGTGCCACCTTGATAGTAAATGAAAAACTGTTTTTT	CATLIVNEKLFF	TRBV15	TRBJ1-4
TGTGCCAGCAGGGGGGCCTGCCGGAATTCACCCCTCCACTTT	CASRGACRNSPLHF	TRBV5-6	TRBJ1-6
TGTGCCACCAGGGGACCAGGGGTGGTCGAGCAGTACTTC	CATRGPGVVEQYF	TRBV5-5	TRBJ2-7
TGCAGTGCGGTTGGGGGCGCAGGTAAATATACGCAGTATTTT	CSAVGGAGKYTQYF	TRBV20-1	TRBJ2-3
TGTGCCATCAGATCCGAGCAGGGCAGGGGTCTTAGCCACACTGAAGCTTTCTTT	CAIRSEQGRGLSHTEAFF	TRBV10-3	TRBJ1-1
TGTGCCACCAGTGATTTGAGAGCGGGAATGGATGGCTACACCTTC	CATSDLRAGMDGYTF	TRBV24-1	TRBJ1-2
TGTGCCAGCAGCTTAAAGCCAAAATTAGGGCAGAAGTCCTACGAGCAGTACTTC	CASSLKPKLGQKSYEQYF	TRBV7-8	TRBJ2-7
TGTGCCAGCATGCGGCGGAGAAGTAACAAAGGAACCGGGGAGCTGTTTTTT	CASMRRRSNKGTGELFF	TRBV6-5	TRBJ2-2
TGCGCCAGCGTTCAGCGACAGGGGTTCACTGAAGCTTTCTTT	CASVQRQGFTEAFF	TRBV5-1	TRBJ1-1
TGTGCCAGCAGCACAGGTTCTTATGGCTACACCTTC	CASSTGSYGYTF	TRBV11-3	TRBJ1-2
TGTGCCAGCAGCCCTAGCGGGGAATCCCCATACTACGAGCAGTACTTC	CASSPSGESPYYEQYF	TRBV12-3	TRBJ2-7
TGTGCCAGCAGCCGGTATACAACTAATGAAAAACTGTTTTTT	CASSRYTTNEKLFF	TRBV13	TRBJ1-4
TGTGCCAGCAGTTGTGGGGGTTACGAGCAGTACTTC	CASSCGGYEQYF	TRBV12-4	TRBJ2-7
TGTGCCAGCAGCTATGGACTAGCGGCAACGTTCGCAGATACGCAGTATTTT	CASSYGLAATFADTQYF	TRBV7-3	TRBJ2-3
TGTGCCAGCAGCCAGGGCCGATCACCCCTCCACTTT	CASSQGRSPLHF	TRBV3-1	TRBJ1-6
TGTGCCAAAAGCAAGGTACTGTTTTTT	CAKSKVLFF	TRBV10-3	TRBJ1-4
TGTGCCAGCAGCGCGGGAAGGGTACCCTACGAGCAGTACTTC	CASSAGRVPYEQYF	TRBV7-4	TRBJ2-7
TGTGCCAGCAGCCAAGACGACGGGGGGACATACGAGCAGTACTTC	CASSQDDGGTYEQYF	TRBV4-2	TRBJ2-7
TGTGCCAGCCGCGTGCGGTTCGGTAGCTCCTACAATGAGCAGTTCTTC	CASRVRFGSSYNEQFF	TRBV2	TRBJ2-1
TGTGCCTCAAGAGGGGAGGCGGAAGGAGAGGACTATGGCTACACCTTC	CASRGEAEGEDYGYTF	TRBV12-3	TRBJ1-2
TGTGCCAGCAGCCCGGGGGCGGAAGAGACCCAGTACTTC	CASSPGAEETQYF	TRBV5-4	TRBJ2-5
TGTGCCAGCAGCCAAAAGAGAGGGACAGGGGGCGTGCCCTCTGGAAACACCATATATTTT	CASSQKRGTGGVPSGNTIYF	TRBV3-1	TRBJ1-3
TGTGCCAGCAGCTTAGGGGTTACACATAGGACTGAAGCTTTCTTT	CASSLGVTHRTEAFF	TRBV11-3	TRBJ1-1
TGCAGTGCTAGACTAGAGTGTGATACGCAGTATTTT	CSARLECDTQYF	TRBV20-1	TRBJ2-3
TGTGCCAGCAGTTATGTAGGAGCGGGACCGGGTCCCGGGGAGCTGTTTTTT	CASSYVGAGPGPGELFF	TRBV6-5	TRBJ2-2
TGTGCCTGGGGCTGTGGGGGGCTTAACACTGAAGCTTTCTTT	CAWGCGGLNTEAFF	TRBV9	TRBJ1-1
TGCAGTGCACCTCTTACAGGGAAGTCCTATGGCTACACCTTC	CSAPLTGKSYGYTF	TRBV20-1	TRBJ1-2
TGTGCTAGCAGTAGACAGGGGAATGGAAACACCATATATTTT	CASSRQGNGNTIYF	TRBV7-7	TRBJ1-3
TGTGCCAGCAGAGGGACCCTCCGGGACGCCGGTCGGAATGAGCAGTTCTTC	CASRGTLRDAGRNEQFF	TRBV7-3	TRBJ2-1
TGTGCCAGCAGTTTGACAGGGGGAGGAGATCAGCCCCAGCATTTT	CASSLTGGGDQPQHF	TRBV27	TRBJ1-5
TGTGCCATTGGGACAGGGACGCCCGCTTTCTTT	CAIGTGTPAFF	TRBV9	TRBJ1-1
TGTGCCAGCAGCGACAGGGGGCCCAGGCACTATGGCTACACCTTC	CASSDRGPRHYGYTF	TRBV11-3	TRBJ1-2
TGTGCCATCAGTGACCGCAGTGACCGGGACACTGAAGCTTTCTTT	CAISDRSDRDTEAFF	TRBV10-3	TRBJ1-1
TGCAGTGCTTGCGGGAGGACCCTTTATGGCTACACCTTC	CSACGRTLYGYTF	TRBV20-1	TRBJ1-2
TGTGCCAGCAGCGTAGCCGTCGCTTATCCGGGGAATAGCAATCAGCCCCAGCATTTT	CASSVAVAYPGNSNQPQHF	TRBV9	TRBJ1-5
TGTGCCAATCCGTCTCCGGGAGGGGTGGTGGGCTATGGCTACACCTTC	CANPSPGGVVGYGYTF	TRBV11-2	TRBJ1-2
TGTGCCATCAGCGGACATCAGCCCCAGCATTTT	CAISGHQPQHF	TRBV10-3	TRBJ1-5
TGTGCCAGCAGGGGAGCATTGGGTAGAAACACCGGGGAGCTGTTTTTT	CASRGALGRNTGELFF	TRBV28	TRBJ2-2
TGTGCCAGCAGCCGCCGGGACAGGGGGCGGCCTGATACGCAGTATTTT	CASSRRDRGRPDTQYF	TRBV7-8	TRBJ2-3
TGTGCCAGCAGTCTCAACGCAGGGGTTCGCAATCAGCCCCAGCATTTT	CASSLNAGVRNQPQHF	TRBV6-4	TRBJ1-5
TGTGCCAGCAGTGACTCGACCCGGACCTTT	CASSDSTRTF	TRBV6-4	TRBJ1-1
TGTGCCAGCAGCTTAGTTGTAACGGCCTTCCCTGTGGAGTCTGAAGCTTTCTTT	CASSLVVTAFPVESEAFF	TRBV7-9	TRBJ1-1
TGCAGTGCTTACAGGGAATGGAACGAGACCCAGTACTTC	CSAYREWNETQYF	TRBV20-1	TRBJ2-5
TGTGCCAGCAGCCGAGGCTACACTCTGTACAATGAGCAGTTCTTC	CASSRGYTLYNEQFF	TRBV7-8	TRBJ2-1
TGTGCCAGCAGCCGCACTGGGGATTCGGGAGCAACTAATGAAAAACTGTTTTTT	CASSRTGDSGATNEKLFF	TRBV7-3	TRBJ1-4
TGTGCTAGCAGCTTGGCAGATACAGATACGCAGTATTTT	CASSLADTDTQYF	TRBV7-7	TRBJ2-3
TGTGCCAGTAGTATTCGGGGGCCTTACTCCTACAATGAGCAGTTCTTC	CASSIRGPYSYNEQFF	TRBV19	TRBJ2-1
TGTGCCAGCACCCGGGACAGGCTATGGAGGAACACCGGGGAGCTGTTTTTT	CASTRDRLWRNTGELFF	TRBV25-1	TRBJ2-2
TGTGCCAGCAGAGTGGGGGGGGAGAAAAATCAGCCCCAGCATTTT	CASRVGGEKNQPQHF	TRBV27	TRBJ1-5
TGTGCCAGCAGCGTGGACATTCGCGCAGATACGCAGTATTTT	CASSVDIRADTQYF	TRBV9	TRBJ2-3
TGTGCCAGCAGTTTATTTTCGGGACAGGGCGGTGGTAGCTCCTACGAGCAGTACTTC	CASSLFSGQGGGSSYEQYF	TRBV12-3	TRBJ2-7
TGCGCCAGCACCAGGGGGGGGGCCTACGAGCAGTACTTC	CASTRGGAYEQYF	TRBV5-1	TRBJ2-7
TGTGCCAGCAGTGAAATCATCGAACTCCGACAGGGCTCAATCGTGAACACTGAAGCTTTCTTT	CASSEIIELRQGSIVNTEAFF	TRBV6-1	TRBJ1-1
TGTGCCAGCAGCCAAGATTTTCATTGGGGCAACCCTCAAGAGACCCAGTACTTC	CASSQDFHWGNPQETQYF	TRBV4-2	TRBJ2-5
TGTGCCATCAGTTATACTCAGCGCAATCAGCCCCAGCATTTT	CAISYTQRNQPQHF	TRBV10-3	TRBJ1-5
TGTGCCATCTTCAGAAACACCATATATTTT	CAIFRNTIYF	TRBV27	TRBJ1-3
TGTGCTAGTGTCGGACAGGGGGGTAGGCCAAACTATGGCTACACCTTC	CASVGQGGRPNYGYTF	TRBV12-5	TRBJ1-2
TGTGCCAGCAGCCAAGACGGCGTATGCAGCTCCTACGAGCAGTACTTC	CASSQDGVCSSYEQYF	TRBV9	TRBJ2-7
TGTGCCAGCAGCTTCGGGACACCGGGCATGGAAAAACTGTTTTTT	CASSFGTPGMEKLFF	TRBV13	TRBJ1-4
TGTGCCAGCACCAGGACTAGCGCCTACAATGAGCAGTTCTTC	CASTRTSAYNEQFF	TRBV7-9	TRBJ2-1
TGTGCCATCAGTGAACCTCCTGGACAGGTAGGCCAAGAGACCCAGTACTTC	CAISEPPGQVGQETQYF	TRBV10-3	TRBJ2-5
TGCAGTGCTAGGACAGGGTCCGGGCAGTACTTC	CSARTGSGQYF	TRBV20-1	TRBJ2-7
TGCGCCAGCAGCTTGCCGGGGGGTTCCTACGAGCAGTACTTC	CASSLPGGSYEQYF	TRBV5-1	TRBJ2-7
TGTGCCAGCAGCCAGCCTCGCGATTCGGCTGTGACGGGCGGCTATGGCTACACCTTC	CASSQPRDSAVTGGYGYTF	TRBV14	TRBJ1-2
TGTGCCAGCAGCGTTGCCAACGAGACTAGTTTATACAATGAGCAGTTCTTC	CASSVANETSLYNEQFF	TRBV5-6	TRBJ2-1
TGTGCCAGCACCTTAACAGGGAAGGGATATGAAAAACTGTTTTTT	CASTLTGKGYEKLFF	TRBV12-4	TRBJ1-4
TGTGCCATCACACGTGGCTACACCTTC	CAITRGYTF	TRBV19	TRBJ1-2
TGTGCCAGTAGTATGGCGGACAGGAGAAGACGAAAACAGCATTTT	CASSMADRRRRKQHF	TRBV19	TRBJ1-5
TGTGCCAGCACCCGGGACGGGGGGGAGCTGTTTTTT	CASTRDGGELFF	TRBV6-2	TRBJ2-2
TGTGCCAGCAGCCCAAGGGGACAGGGGGATCGACTTACCGGGGAGCTGTTTTTT	CASSPRGQGDRLTGELFF	TRBV13	TRBJ2-2
TGTGCCAGCAGCCCTGTACCCCCCTCTAGCGGGGTCTGGGACGAAGAGACCCAGTACTTC	CASSPVPPSSGVWDEETQYF	TRBV3-1	TRBJ2-5
TGTGCCAGTAGTATTGGTAGATGCTGTTACAGGGGCCCTGAAGCTTTCTTT	CASSIGRCCYRGPEAFF	TRBV19	TRBJ1-1
TGTGCCTGGAGTGTATGGAAGAGACAGGGACCCCATGGCTACACCTTC	CAWSVWKRQGPHGYTF	TRBV30	TRBJ1-2
TGTGCCAGCAGTGCGGGGCCGCCGGAAGGCTGGGCCTACAATGAGCAGTTCTTC	CASSAGPPEGWAYNEQFF	TRBV6-4	TRBJ2-1
TGTGCCAGCAGTGACGCACCAAAGGCCACTGAAGCTTTCTTT	CASSDAPKATEAFF	TRBV6-4	TRBJ1-1
TGTGCCAGCAGCTTAGCCCGGAGGGGGCCCCAGTCCTCCTACGAGCAGTACTTC	CASSLARRGPQSSYEQYF	TRBV11-3	TRBJ2-7
TGTGCCAGCAGCCCTTTGGCGGGAGGCTCCTACAATGAGCAGTTCTTC	CASSPLAGGSYNEQFF	TRBV7-3	TRBJ2-1
TGTGCCAGCAGCTTAACGGGGGACCGCGTCGGCCGAAACACCATATATTTT	CASSLTGDRVGRNTIYF	TRBV7-4	TRBJ1-3
TGTGCCAGCAGTGCCGACGGTTCACCCCTCCACTTT	CASSADGSPLHF	TRBV2	TRBJ1-6
TGTGCCAGCAGACCCCCGGGACAGGGCTACACCTTC	CASRPPGQGYTF	TRBV2	TRBJ1-2
TGTGCCAGCTTTGCCACTAGCGGGAGGGCTCCAGACACCTTC	CASFATSGRAPDTF	TRBV28	TRBJ1-2
TGTGCCAGCAGTGCCGCAGCCCCCGTGGTAGCTTTCTTT	CASSAAAPVVAFF	TRBV6-1	TRBJ1-1
TGCAGTGCTAGCCAACGTGTGTCCTACGAGCAGTACTTC	CSASQRVSYEQYF	TRBV20-1	TRBJ2-7
TGCAGTGCTAGATGGGGTTTTAATGAAAAACTGTTTTTT	CSARWGFNEKLFF	TRBV20-1	TRBJ1-4
TGCGCCAGCAGTGAGACCGAGGGGGCCTACGAGCAGTACTTC	CASSETEGAYEQYF	TRBV10-1	TRBJ2-7
TGTGCCAAGAAGCCGGGACCAAAAACTGAAGCTTTCTTT	CAKKPGPKTEAFF	TRBV6-3	TRBJ1-1
TGTGCCAGCAGCAAAAGCGGTGGTTACGAGCAGTACTTC	CASSKSGGYEQYF	TRBV13	TRBJ2-7
TGTGCCAGCAGCCAAGATCCCACAGGTGATCAGCCCCAGCATTTT	CASSQDPTGDQPQHF	TRBV3-1	TRBJ1-5
TGCGCCAGCAGCCAAGCCTGGGTTAATCGACAGTCTTTCGTGGACTTCGATGGGCACTATGGCTACACCTTC	CASSQAWVNRQSFVDFDGHYGYTF	TRBV4-1	TRBJ1-2
TGTGCCAGCAGCGTAGGTGGGGGACAGGGAATCACCGGGGAGCTGTTTTTT	CASSVGGGQGITGELFF	TRBV9	TRBJ2-2
TGTGCCAGCAGCTTGGAAAAGCCCGACAGGGGACATAACTATGGCTACACCTTC	CASSLEKPDRGHNYGYTF	TRBV5-6	TRBJ1-2
TGTGCCAGCAGCCAAGATAGCCCTGTAAGGGCCCGGAAGGGCTACGAGCAGTACTTC	CASSQDSPVRARKGYEQYF	TRBV14	TRBJ2-7
TGCAGTGCTACTCGAGGGACAGGGGGGGGAGGGAGCTGGGAGAACACTGAAGCTTTCTTT	CSATRGTGGGGSWENTEAFF	TRBV20-1	TRBJ1-1
TGTGCCAGCAGCAAAGGGGGGTCTAGGGAGACCCAGTACTTC	CASSKGGSRETQYF	TRBV13	TRBJ2-5
TGTGCCAGCAGCTGCCCCAGCGGGAGCGGCGCCGAGCAGTACTTC	CASSCPSGSGAEQYF	TRBV9	TRBJ2-7
TGTGCCACCAGCGGAGACAGGGGAAGCAATCAGCCCCAGCATTTT	CATSGDRGSNQPQHF	TRBV24-1	TRBJ1-5
TGTGCCACCAGTGATCCGGCCGCACCCGAGACCCAGTACTTC	CATSDPAAPETQYF	TRBV24-1	TRBJ2-5
TGCAGCGTTGCGGGGGGAACCGGCACAGATACGCAGTATTTT	CSVAGGTGTDTQYF	TRBV29-1	TRBJ2-3
TGCAGTGCTAGAGCAGGACAGTGCCAGCCCCAGCATTTT	CSARAGQCQPQHF	TRBV20-1	TRBJ1-5
TGTGCCAGCAGCCTTCAGAGGGGACAGGGTTACGAGCAGTACTTC	CASSLQRGQGYEQYF	TRBV5-6	TRBJ2-7
TGCAGTGCTAGGATGACAGGGTTCTATGGCTACACCTTC	CSARMTGFYGYTF	TRBV20-1	TRBJ1-2
TGCGCCAGCAGCTTTTCCGGGGACGGCCCCTACGAGCAGTACTTC	CASSFSGDGPYEQYF	TRBV5-1	TRBJ2-7
TGTGCCACCAGTGATTTGCCCAAGGGACAGGGGATGCAAGAGACCCAGTACTTC	CATSDLPKGQGMQETQYF	TRBV24-1	TRBJ2-5
TGCAGTGCTAGAGAACCGGCGCAGGTCGGACAGGGGTGGAAGGCTGAAGCTTTCTTT	CSAREPAQVGQGWKAEAFF	TRBV20-1	TRBJ1-1
TGTGCCAGCAGAGGCGGGACAGTTGAGCAGTACTTC	CASRGGTVEQYF	TRBV6-1	TRBJ2-7
TGTGCCAGTAGTATCAGCATCTACACCATATATTTT	CASSISIYTIYF	TRBV19	TRBJ1-3
TGTGCCAGCAGGACCAGCGGGACGACCGGGGAGCTGTTTTTT	CASRTSGTTGELFF	TRBV28	TRBJ2-2
TGTGCCAGCAGTGGACGGGGGGCCTACGAGCAGTACTTC	CASSGRGAYEQYF	TRBV27	TRBJ2-7
TGTGCCACCAGTTCGTCAATTGGCTACACCTTC	CATSSSIGYTF	TRBV24-1	TRBJ1-2
TGTGCCAGCAGCCAAGAGGACCGTGACAGCCGGGAGACCCAGTACTTC	CASSQEDRDSRETQYF	TRBV3-1	TRBJ2-5
TGTGCCAGCAGCCCGGTCTGCGAAGAGGGGGGGCGTCAATACAGCCCCTTC	CASSPVCEEGGRQYSPF	TRBV9	TRBJ1-2
TGTGCCAGCAGCTTGGACAGCCTACCGGATCGGGGATACGAGCAGTACTTC	CASSLDSLPDRGYEQYF	TRBV5-4	TRBJ2-7
TGTGCCAGCAGCAGGGGGCGGAGCAATCAGCCCCAGCATTTT	CASSRGRSNQPQHF	TRBV6-5	TRBJ1-5
TGTGCCAGCAGCCAAGCCACCGGGGACTTGTCAAAGCCCCAGCATTTT	CASSQATGDLSKPQHF	TRBV4-2	TRBJ1-5
TGTGCCAGCAGCGACCCTCAGGAAAGGACAGGGGGCGTGGCGTTATACACTGAAGCTTTCTTT	CASSDPQERTGGVALYTEAFF	TRBV9	TRBJ1-1
TGTGCCAGCAGCCAAGTCGGACAGGGGTCTGGAAACACCATATATTTT	CASSQVGQGSGNTIYF	TRBV14	TRBJ1-3
TGTGCCAGGTGGGACAGTGGAGCTTTCTTT	CARWDSGAFF	TRBV3-1	TRBJ1-1
TGCGCCAGCAGCCCCGTAGGGACTAGGAGCTACGAGCAGTACTTC	CASSPVGTRSYEQYF	TRBV5-1	TRBJ2-7
TGCAGTGCTAGACCCTTGTTCCCGGACAGTAACTATGGCTACACCTTC	CSARPLFPDSNYGYTF	TRBV20-1	TRBJ1-2
TGTGCCACCTCTCAGGGGACAGGGGGCGCGCATGAGCAGTTCTTC	CATSQGTGGAHEQFF	TRBV24-1	TRBJ2-1
TGTGCCAGCAACCACCGGGGAGGATGCTACCAGCCCCAGCATTTT	CASNHRGGCYQPQHF	TRBV11-2	TRBJ1-5
TGTGCCAGTAGAGAACCTACTAGCGGGGGGGCGCATTTTCGGAAACGAGAATACGAGCAGTACTTC	CASREPTSGGAHFRKREYEQYF	TRBV19	TRBJ2-7
TGCGCCAGCAGCCAAGATCCAACCCTCTTTTATAGCAATCAGCCCCAGCATTTT	CASSQDPTLFYSNQPQHF	TRBV4-1	TRBJ1-5
TGTGCCAGCAGACTAGCGGGCGAGCAGTACTTC	CASRLAGEQYF	TRBV6-6	TRBJ2-7
TGCGCCAGCAGTGTTCCCGGGCCGACCGCCGGCGAGCCCCAGCATTTT	CASSVPGPTAGEPQHF	TRBV10-1	TRBJ1-5
TGCAGTGCTGTTGTCTTGAAAGAGACCCAGTACTTC	CSAVVLKETQYF	TRBV20-1	TRBJ2-5
TGTGCCAGCACACCCGGGGTGACAGGGGATGAAGCTTTCTTT	CASTPGVTGDEAFF	TRBV6-6	TRBJ1-1
TGTGCCAGCTCACGCATTAGAACTCTGACTAGCACAGATACGCAGTATTTT	CASSRIRTLTSTDTQYF	TRBV18	TRBJ2-3
TGTGCCAGCAGCACGAGGACAAGGGATAATTCACCCCTCCACTTT	CASSTRTRDNSPLHF	TRBV7-4	TRBJ1-6
TGTGCCAGCAGTGCCTACAGGGTTACTGAAACGGAGCTGTTTTTT	CASSAYRVTETELFF	TRBV27	TRBJ2-2
TGCAGTGCGTACCCAACAGGGATGGATGAGCAGTTCTTC	CSAYPTGMDEQFF	TRBV20-1	TRBJ2-1
TGCAGCGTTGGGTTCGGGCACACTGAAGCTTTCTTT	CSVGFGHTEAFF	TRBV29-1	TRBJ1-1
TGTGCCAGCAGTGACTCGGACAGGGCAAGAGAGACCCAGTACTTC	CASSDSDRARETQYF	TRBV6-4	TRBJ2-5
TGCAGTGCAAGGGGACATGCCGGGAACGAGACCCAGTACTTC	CSARGHAGNETQYF	TRBV20-1	TRBJ2-5
TGTGCCACCAGTGCGGACGGAGGGTTCTACGAGCAGTACTTC	CATSADGGFYEQYF	TRBV24-1	TRBJ2-7
TGTGCCAGCAGCTCTCCCCCAGGGCAGGGGAAAGAGACCCAGTACTTC	CASSSPPGQGKETQYF	TRBV9	TRBJ2-5
TGTGCCACCAGCAGAGATGCAGCGCCCAGGGGCAATGAGCAGTTCTTC	CATSRDAAPRGNEQFF	TRBV15	TRBJ2-1
TGTGCCAGCAGTTACTGCGGGGGGGTCTACGAGCAGTACTTC	CASSYCGGVYEQYF	TRBV6-2	TRBJ2-7
TGCAGTGCTAGAGGACCCAACCGGCAGTCACGCTCTGGAAACACCATATATTTT	CSARGPNRQSRSGNTIYF	TRBV20-1	TRBJ1-3
TGTGCCAGCAAACTCCCCCCCCAGGGGAACACTGAAGCTTTCTTT	CASKLPPQGNTEAFF	TRBV28	TRBJ1-1
TGTGCCAGCAGCCGGCGAGATTTTGGGTGGGATCAGCCCCAGCATTTT	CASSRRDFGWDQPQHF	TRBV6-2	TRBJ1-5
TGTGCCAGCGGAAGACACAGGGGACGAGACGCTTTCTTT	CASGRHRGRDAFF	TRBV28	TRBJ1-1
TGTGCCAGCCCCAAGCACCCCCCGACACATAATTCACCCCTCCACTTT	CASPKHPPTHNSPLHF	TRBV6-5	TRBJ1-6
TGTGCCAGTAGTATACCCGGGGGACTAGCGGGAGGGATCGAGCAGTACTTC	CASSIPGGLAGGIEQYF	TRBV19	TRBJ2-7
TGTGCCAGCAGTTACCTGGATACGGGAGACGTCTCTGGAAACACCATATATTTT	CASSYLDTGDVSGNTIYF	TRBV6-5	TRBJ1-3
TGCGCCAGCAGCAGTCAGGGAGGAGAGGACTCCTACGAGCAGTACTTC	CASSSQGGEDSYEQYF	TRBV5-1	TRBJ2-7
TGTGCCGTGCTACTAGCGGGAGGAAACTACGAGCAGTACTTC	CAVLLAGGNYEQYF	TRBV6-5	TRBJ2-7
TGTGCCAGCAGTTATCTGACGACTCAAACTAATCAGCCCCAGCATTTT	CASSYLTTQTNQPQHF	TRBV6-6	TRBJ1-5
TGTGCCAGCAGCAGTGGACGTGCCGGGACAGGGGGGAGCAATCAGCCCCAGCATTTT	CASSSGRAGTGGSNQPQHF	TRBV5-6	TRBJ1-5
TGTGCCAGCAAAGTGGGGAGGAACACTGAAGCTTTCTTT	CASKVGRNTEAFF	TRBV28	TRBJ1-1
TGTGCCAGCTCACCAACCTACTTGCTGAATGAGCAGTTCTTC	CASSPTYLLNEQFF	TRBV18	TRBJ2-1
TGTGCCAGCAGCGATTCTGAGATGAACACTGAAGCTTTCTTT	CASSDSEMNTEAFF	TRBV13	TRBJ1-1
TGTGCCAGCAGTTCAGAACACTCCACAGATACGCAGTATTTT	CASSSEHSTDTQYF	TRBV12-4	TRBJ2-3
TGTGCCAGCAGCGGTAGTAGGCCTGGTCCTAGAGACCCCGTATATCTAGCCAAAAACATTCAGTACTTC	CASSGSRPGPRDPVYLAKNIQYF	TRBV5-6	TRBJ2-4
TGCGCCAGCAGCCCTGGTGGGGGGGGGCCCCACTTGGAGCAGTTCTTC	CASSPGGGGPHLEQFF	TRBV4-1	TRBJ2-1
TGTGCCAGAACTGACAGGGACTTC	CARTDRDF	TRBV6-6	TRBJ2-7
TGCAGTGCCTCCCCCCATCAGGGTAACTACGAGCAGTACTTC	CSASPHQGNYEQYF	TRBV20-1	TRBJ2-7
TGTGCCAGGAAACTAGCGGGAGACGAAACACGCCGGATCTTC	CARKLAGDETRRIF	TRBV25-1	TRBJ2-1
TGTGCCAGCAGTGAACTAGTTCTGGTCTCCTACAATGAGCAGTTCTTC	CASSELVLVSYNEQFF	TRBV6-1	TRBJ2-1
TGTGCCAGCAGCGTAACCGCCTACAATGAGCAGTTCTTC	CASSVTAYNEQFF	TRBV6-2	TRBJ2-1
TGCGCCAGCAGTGAGGGGGAATCAGACAGGGGGCTCCAGTCCGAGAACACTGAAGCTTTCTTT	CASSEGESDRGLQSENTEAFF	TRBV10-2	TRBJ1-1
TGTGCCAGCAGCAAGATGTGGAGCAATCAGCCCCAGCATTTT	CASSKMWSNQPQHF	TRBV7-2	TRBJ1-5
TGTGCCAGCAGACACAGGGGCCAGCCCCAGCATTTT	CASRHRGQPQHF	TRBV6-4	TRBJ1-5
TGTGCCAAGGGTCCCCATGCTTACCGGGACAGGGGGACCCAGCCCCAGCATTTT	CAKGPHAYRDRGTQPQHF	TRBV28	TRBJ1-5
TGCGCCAGCAGCTCAGAGGGCTCCTACGAGCAGTACTTC	CASSSEGSYEQYF	TRBV5-1	TRBJ2-7
TGTGCCAGCAGCCCGACCGCAGCTAACTATGGCTACACCTTC	CASSPTAANYGYTF	TRBV7-2	TRBJ1-2
TGTGCCACCAGCAGACGGAACTTCAATGAGCAGTTCTTC	CATSRRNFNEQFF	TRBV15	TRBJ2-1
TGTGCCAATGGGGTTAAATACGAGCAGTACTTC	CANGVKYEQYF	TRBV5-6	TRBJ2-7
TGTGCCAGCAGCGAATGGACAGGGGTCTGGCCACTGTTTTTT	CASSEWTGVWPLFF	TRBV13	TRBJ1-4
TGCGCCAGCAGCCAAGCATCGGGGGGCGTGACCTACGAGCAGTACTTC	CASSQASGGVTYEQYF	TRBV4-1	TRBJ2-7
TGTGCCAGCAGTGCCACTGGAGGGTCAACCGGGGAGCTGTTTTTT	CASSATGGSTGELFF	TRBV6-1	TRBJ2-2
TGCGCCAGCAGGGCGTTCTCGCTGTGGGAAAAACTGTTTTTT	CASRAFSLWEKLFF	TRBV4-1	TRBJ1-4
TGTGCCAGCAATATTCGGGACAGGGGGTCACCCCTCCACTTT	CASNIRDRGSPLHF	TRBV27	TRBJ1-6
TGTGCCACCAGCAGGCACGCGGGAGATCAAAGCTCCTACGAGCAGTACTTC	CATSRHAGDQSSYEQYF	TRBV15	TRBJ2-7
TGTGCCAGCAGCTTTAAGGGGCGAAGTGGTCACACCATATATTTT	CASSFKGRSGHTIYF	TRBV7-8	TRBJ1-3
TGTGCCAGCAGCGACAGGGCGAACACCGGGGAGCTGTTTTTT	CASSDRANTGELFF	TRBV5-6	TRBJ2-2
TGTGCCTGGTCGGTTGGTAAGCATCAGGGGGACCACGAGCAGTACTTC	CAWSVGKHQGDHEQYF	TRBV30	TRBJ2-7
TGTGCCAGCAGCACTAGGATCCCCTCGAAGAAACAGGGTAGCTCCTACGAGCAGTACTTC	CASSTRIPSKKQGSSYEQYF	TRBV7-4	TRBJ2-7
TGTGCCAGCAGCTTAATCGTCGTAGTAGGTGGCAGGGTCGGCGGGGAGCTGTTTTTT	CASSLIVVVGGRVGGELFF	TRBV11-2	TRBJ2-2
TGTGCCAGCAGCAAGACCAGGGCTTTCTACGAGCAGTACTTC	CASSKTRAFYEQYF	TRBV5-4	TRBJ2-7
TGTGCCAGCAGCCCAAGGGGGGGCCAGGGAAAGGTGTACGAGCAGTACTTC	CASSPRGGQGKVYEQYF	TRBV7-9	TRBJ2-7
TGTGCCAGCAGTGATCCTACACAGATCTACGAGCAGTACTTC	CASSDPTQIYEQYF	TRBV6-4	TRBJ2-7
TGTGCCAGCAGATCTAAGACGACTGGGGGCAATGAGCAGTTCTTC	CASRSKTTGGNEQFF	TRBV27	TRBJ2-1
TGCAGTGCTCCAAGGGGGGGTCGGGGGTCCTACGAGCAGTACTTC	CSAPRGGRGSYEQYF	TRBV20-1	TRBJ2-7
TGTGCCAGCGCGAAGGGTAATGAGCAGTTCTTC	CASAKGNEQFF	TRBV27	TRBJ2-1
TGTGCCAGCAGTTGGACGTCCGAGCCCAGAAACACCATATATTTT	CASSWTSEPRNTIYF	TRBV6-5	TRBJ1-3
TGTGCCACCAGTGATCTTGAAGCTAACCCGCGGAATCGGTGCACAGATACGCAGTATTTT	CATSDLEANPRNRCTDTQYF	TRBV24-1	TRBJ2-3
TGTGCCACCAGCAGAGAACAGTGCCTTGGGAATCAGCCCCAGCATTTT	CATSREQCLGNQPQHF	TRBV15	TRBJ1-5
TGTGCCAGCAGCTGGCCTGGGCCCACCACTACCTCATATTTT	CASSWPGPTTTSYF	TRBV5-4	TRBJ2-3
TGTGCCAGAGTGAGGGCTTGGATCAATCAGCCCCAGCATTTT	CARVRAWINQPQHF	TRBV6-1	TRBJ1-5
TGCGCCAGCAGCCATGTAGTCGTGTACAATGAGCAGTTCTTC	CASSHVVVYNEQFF	TRBV4-1	TRBJ2-1
TGTGCTAGTGGTTATAGGGTCAGGAGCTCCTACGAGCAGTACTTC	CASGYRVRSSYEQYF	TRBV12-5	TRBJ2-7
TGTGCCAGCACCCAGAGTCCTGAAGCTTTCTTT	CASTQSPEAFF	TRBV6-5	TRBJ1-1
TGTGCCAGCAGTCGGAACCGGGACGGGGGTGATACGCAGTATTTT	CASSRNRDGGDTQYF	TRBV27	TRBJ2-3
TGTGCCAGCCACCGGGGCGCAACTAATGAAAAACTGTTTTTT	CASHRGATNEKLFF	TRBV28	TRBJ1-4
TGTGCCAGCCCCCCACAGGGGATTGAGCAGTACTTC	CASPPQGIEQYF	TRBV6-5	TRBJ2-7
TGTGCCAGCAGCTATTTGAGGCGGGAGTTTATGAAAAACATTCAGTACTTC	CASSYLRREFMKNIQYF	TRBV11-3	TRBJ2-4
TGTGCCAGCAGCCGGGTTTTGGGGGTTTATGGCTACACCTTC	CASSRVLGVYGYTF	TRBV7-9	TRBJ1-2
TGTGCCAGCAGTGAAGCATACAGCGGGTGGAGGAAGATGAACGATGAGCAGTTCTTC	CASSEAYSGWRKMNDEQFF	TRBV6-1	TRBJ2-1
TGTGCCAGTAGTATAGGACCCGCGGGGGGGTCCCAGCATTTT	CASSIGPAGGSQHF	TRBV19	TRBJ1-5
TGCGCCAGCAGCCAAGAGAGCCAGGACGAAAACGAGCAGTACTTC	CASSQESQDENEQYF	TRBV4-1	TRBJ2-7
TGTGCCAGCAGCAAAACAGGGCAAGGTACCGACTCTGGGGCCAACGTCCTGACTTTC	CASSKTGQGTDSGANVLTF	TRBV7-3	TRBJ2-6
TGCAGCGGGTATAATAGAGGGAGCGTCGAGGATTCACCCCTCCACTTT	CSGYNRGSVEDSPLHF	TRBV29-1	TRBJ1-6
TGTGCCGCGGGGGATAACTATGGCTACACCTTC	CAAGDNYGYTF	TRBV7-6	TRBJ1-2
TGTGCCAGCAGCTTGGACATCCTTGTAGCGGGGGGAGGGGTGTACAATGAGCAGTTCTTC	CASSLDILVAGGGVYNEQFF	TRBV5-4	TRBJ2-1
TGTGCCAGCAGCGTAGAGGGGGGCGTATACACTGAAGCTTTCTTT	CASSVEGGVYTEAFF	TRBV9	TRBJ1-1
TGTGCCAGCAGCTCCGGACAGGGCTCCTTTCGGTGCTACGAGCAGTACTTC	CASSSGQGSFRCYEQYF	TRBV7-9	TRBJ2-7
TGTGCCAGCAGTTACTCCGGGGGGTTCACTGAAGCTTTCTTT	CASSYSGGFTEAFF	TRBV6-2	TRBJ1-1
TGTGCCAGCAGACAGGGTCGTGAAGCTTTCTTT	CASRQGREAFF	TRBV3-1	TRBJ1-1
TGTGCCACCCGGAGGGCGAACGAGCAGTACTTC	CATRRANEQYF	TRBV9	TRBJ2-7
TGTGCCAGCACCGGAGGCGAGCAGTACTTC	CASTGGEQYF	TRBV6-4	TRBJ2-7
TGTGCCAGCAGCGTAGGGGACACCGGGGAGCTGTTTTTT	CASSVGDTGELFF	TRBV9	TRBJ2-2
TGTGCCAGCAGCTCGAAGGGAGGGTCCTATAGCAATCAGCCCCAGCATTTT	CASSSKGGSYSNQPQHF	TRBV7-9	TRBJ1-5
TGTGCCAGCAGCTTTTGGACTTTGTATGGCTACACCTTC	CASSFWTLYGYTF	TRBV7-9	TRBJ1-2
TGTGCCAGCAGTGTGGGGTGCGGGCCCTACGAGCAGTACTTC	CASSVGCGPYEQYF	TRBV12-3	TRBJ2-7
TGTGCCAGCAGCTTACAGGGCGGGTCGTCCTACGAGCAGTACTTC	CASSLQGGSSYEQYF	TRBV7-3	TRBJ2-7
TGTGCCACCAGCCCGCTAGCGGGGATAGTAGACTACGAGCAGTACTTC	CATSPLAGIVDYEQYF	TRBV15	TRBJ2-7
TGTGCCAGCAGCCAAGATCAACGGGCACGGGGAGTAGACAGCTTC	CASSQDQRARGVDSF	TRBV3-1	TRBJ2-7
TGTGCCAGCAGGGGAGAGGACAGCCAGGACACCGGGGAGCTGTTTTTT	CASRGEDSQDTGELFF	TRBV7-2	TRBJ2-2
TGCGCCAGCAGGGCCGGAGGGGACCATCAGCCCCAGCATTTT	CASRAGGDHQPQHF	TRBV5-1	TRBJ1-5
TGTGCCAGCAACGGCGGGGGGGCCTACGAGCAGTACTTC	CASNGGGAYEQYF	TRBV12-4	TRBJ2-7
TGTGCCACCAGTGATTTGCAGGCTGGCTACACCTTC	CATSDLQAGYTF	TRBV24-1	TRBJ1-2
TGTGCCAGCAGTTTCGAAGGGCCCGACTATGGCTACACCTTC	CASSFEGPDYGYTF	TRBV12-3	TRBJ1-2
TGTGCCAGCAGCGGACCCCCGGGACAGGGTGCAACTAATGAAAAACTGTTTTTT	CASSGPPGQGATNEKLFF	TRBV7-2	TRBJ1-4
TGTGCTCTTAAAAGGGATTATGAAAAACTGTTTTTT	CALKRDYEKLFF	TRBV27	TRBJ1-4
TGTGCCAGCAACGCCCTTGGGCTGAAAGAGCAGTACTTC	CASNALGLKEQYF	TRBV6-4	TRBJ2-7
TGTGCCAGCAGCCTCCTTTGGGAAACGGGGCCTAAATATGGCTACACCTTC	CASSLLWETGPKYGYTF	TRBV6-6	TRBJ1-2
TGCAGTGCGCCGGACGGAATGAACACTGAAGCTTTCTTT	CSAPDGMNTEAFF	TRBV20-1	TRBJ1-1
TGTCACCCGGGGCTGAATGAAAAACTGTTTTTT	CHPGLNEKLFF	TRBV6-1	TRBJ1-4
TGTGCCAGCAGTGGACAGGGTGTGCAGTTCTTC	CASSGQGVQFF	TRBV5-6	TRBJ2-1
TGTGCCAGCAGTGACCGTACAGACGAATCCTACGAGCAGTACTTC	CASSDRTDESYEQYF	TRBV6-4	TRBJ2-7
TGTGCCAGGGGGAACACCGGGGAGCTGTTTTTT	CARGNTGELFF	TRBV6-4	TRBJ2-2
TGTGCCAGCAGCAAGTTTTCAGGGAGGGGCTACACCTTC	CASSKFSGRGYTF	TRBV7-3	TRBJ1-2
TGTGCCAGCAGCTTGGGGTGTCACGGACAGGGGACCTATTCAACTAATGAAAAACTGTTTTTT	CASSLGCHGQGTYSTNEKLFF	TRBV5-8	TRBJ1-4
TGTGCCAGCACTCCCGGGACACACCGCAATCAGCCCCAGCATTTT	CASTPGTHRNQPQHF	TRBV9	TRBJ1-5
TGTGCCAGCTCACCACCAACTGAGCAGTACTTC	CASSPPTEQYF	TRBV18	TRBJ2-7
TGTGCCAGCAGACGTCATACCGGGACAGGTGTCCGGACAGATACGCAGTATTTT	CASRRHTGTGVRTDTQYF	TRBV27	TRBJ2-3
TGTGCCAGCAGTTTGGATCATTTGAGCTATTACGAGCAGTACTTC	CASSLDHLSYYEQYF	TRBV27	TRBJ2-7
TGTGCCAGCAGCTTAAGGCGGAAGGACTTCAGATACGAGCAGTACTTC	CASSLRRKDFRYEQYF	TRBV7-6	TRBJ2-7
TGTGCCGATTCCAAGGGTTACAATGAAAAACTGTTTTTT	CADSKGYNEKLFF	TRBV9	TRBJ1-4
TGTGCCAGCACTCCAGGACAGGGTTCGAAGCCGAATTCCTACGAGCAGTACTTC	CASTPGQGSKPNSYEQYF	TRBV11-3	TRBJ2-7
TGCGCCAGCAGAAGTATAAAGTCTGGCCAAGAGACCCAGTACTTC	CASRSIKSGQETQYF	TRBV10-1	TRBJ2-5
TGTGCCAGCAGCTCAGGGGCAGCCAAAAACATTCAGTACTTC	CASSSGAAKNIQYF	TRBV7-8	TRBJ2-4
TGTGCCAAATACAGGGGGTTGGATATCTCTGGGGCCAACGTCCTGACTTTC	CAKYRGLDISGANVLTF	TRBV27	TRBJ2-6
TGTGCCAGCAGCTTGGCCAAGGGGTGCCCGGACAGAACAGATACGCAGTATTTT	CASSLAKGCPDRTDTQYF	TRBV5-6	TRBJ2-3
TGTGCCACCAGTGAAACACAGTGGGGGAACACTGAAGCTTTCTTT	CATSETQWGNTEAFF	TRBV24-1	TRBJ1-1
TGTGCCAGCAGTGAAAGGGCCCCGGGACAGGGGGGAAAGGTGGGCACAGATACGCAGTATTTT	CASSERAPGQGGKVGTDTQYF	TRBV6-4	TRBJ2-3
TGCGCCAGCAGCTTCTGGACGGGAGGGGAGCTGTTTTTT	CASSFWTGGELFF	TRBV5-1	TRBJ2-2
TGTGCCAGTAGTATTACCGATTTGGCGGGACAGCGGGCCTACGAGCAGTACTTC	CASSITDLAGQRAYEQYF	TRBV19	TRBJ2-7
TGTGCCAGCTCGCCAATGCTAGCGGGGGGGCATCTCGGGGAGCTGTTTTTT	CASSPMLAGGHLGELFF	TRBV18	TRBJ2-2
TGTGCCAGCAGCGAATCCAGGGCGGTGGGCTATCCTTTGAGACTCTCCTACAATGAGCAGTTCTTC	CASSESRAVGYPLRLSYNEQFF	TRBV11-3	TRBJ2-1
TGTGCCAGCAGTTTAGGGGTCGCATCTGGCTACACCTTC	CASSLGVASGYTF	TRBV28	TRBJ1-2
TGTGCCAGCAGCTTAGACTACAGGGGGGGGAAGGGGCAGCCCCAGCATTTT	CASSLDYRGGKGQPQHF	TRBV11-3	TRBJ1-5
TGTGCCAGGGAGGGACAGAGGGATTACGAGCAGTACTTC	CAREGQRDYEQYF	TRBV7-9	TRBJ2-7
TGTGCCAGCATGACCGGGGATGGCAATCAGCCCCAGCATTTT	CASMTGDGNQPQHF	TRBV6-4	TRBJ1-5
TGTGCCAGTAAATCCACTAGCGGGAGCACGTCTGAAGCTTTCTTT	CASKSTSGSTSEAFF	TRBV19	TRBJ1-1
TGTGCCATCAGTGGAGGACAGGGTTGGGGCCAAGAGACCCAGTACTTC	CAISGGQGWGQETQYF	TRBV10-3	TRBJ2-5
TGTGCCAGTAGTATGGTTCTCGGCGGGGAGCTGTTTTTT	CASSMVLGGELFF	TRBV19	TRBJ2-2
TGTGCCAGCAGCTATCCCCCAGGGCCGATTTATGGCTACACCTTC	CASSYPPGPIYGYTF	TRBV7-6	TRBJ1-2
TGTGCCAGCAGCGGGTCCCGAGGTTTCGACGAGCAGTACTTC	CASSGSRGFDEQYF	TRBV7-3	TRBJ2-7
TGTGCCAGCAGCAGGCTGTCCGGACTAGCACTCTACGAGCAGTACTTC	CASSRLSGLALYEQYF	TRBV7-2	TRBJ2-7
TGTGCCAGCAGCGCTACGTATCTGGGGCATGAGCAGTTCTTC	CASSATYLGHEQFF	TRBV9	TRBJ2-1
TGTGCCAGCGGGCCTAGCAATCAGCCCCAGCATTTT	CASGPSNQPQHF	TRBV12-3	TRBJ1-5
TGTGCCATTGGGGACAGGGGTCAAGAGACCCAGTACTTC	CAIGDRGQETQYF	TRBV6-5	TRBJ2-5
TGTGCCAGCAGCTTGCTATGTGCATACAGGCGAGATCAGCCCCAGCATTTT	CASSLLCAYRRDQPQHF	TRBV5-6	TRBJ1-5
TGTGCCAGCTCACCACAATTGGACAGGGGTATCAGCTCCTACGAGCAGTACTTC	CASSPQLDRGISSYEQYF	TRBV18	TRBJ2-7
TGCAGTGCTGGGGAATGCGGGGGGGCAGGATACTACCAGGACTACGAGCAGTACTTC	CSAGECGGAGYYQDYEQYF	TRBV20-1	TRBJ2-7
TGTGCCAGCAGTTTCCTAGGGACAGGGTCTTACCAGCCCCAGCATTTT	CASSFLGTGSYQPQHF	TRBV27	TRBJ1-5
TGTGCCAGCAGATTGCGCCAGAAAGAGATGAACACTGAAGCTTTCTTT	CASRLRQKEMNTEAFF	TRBV14	TRBJ1-1
TGTGCCAGCAGTCCCAGGGAACGTGGGACCGGGGAGCTGTTTTTT	CASSPRERGTGELFF	TRBV2	TRBJ2-2
TGTGCCAGCAGTGAAGCGGGGAAACTAGCGGGAGTTGCCAAAAACATTCAGTACTTC	CASSEAGKLAGVAKNIQYF	TRBV6-1	TRBJ2-4
TGTCCCTGGGGAGTTCGTGATGAGCAGTTCTTC	CPWGVRDEQFF	TRBV7-9	TRBJ2-1
TGCGCCAGCAGCCAAGAAGCTCCCCAAAATAGCGACAGGGGACAAGCCTACGAGCAGTACTTC	CASSQEAPQNSDRGQAYEQYF	TRBV4-1	TRBJ2-7
TGTGCCAGCAGTTGCGGGCAGACTGAAGCTTTCTTT	CASSCGQTEAFF	TRBV6-8	TRBJ1-1
TGTGCCAGCTCACCACCCCTAGACTTCTCCGACAATCAGCCCCAGCATTTT	CASSPPLDFSDNQPQHF	TRBV18	TRBJ1-5
TGCAGCGTAGGTACATGCAAAAAAGATACGCAGTATTTT	CSVGTCKKDTQYF	TRBV29-1	TRBJ2-3
TGTGCCAGCAGCCAAGTGCCTGACGATACGCAGTATTTT	CASSQVPDDTQYF	TRBV14	TRBJ2-3
TGTGCCAGCAGCACCGGAGTGGGCATTACGCAGTATTTT	CASSTGVGITQYF	TRBV13	TRBJ2-3
TGCGCCAGCAGCTGTAGGACTAACGTTAGCGGGGCCGGCACCGGGGAGCTGTTTTTT	CASSCRTNVSGAGTGELFF	TRBV5-1	TRBJ2-2
TGTGCCAGCAGTTTCGATGAGGGGCGCGATAGCAATCAGCCCCAGCATTTT	CASSFDEGRDSNQPQHF	TRBV28	TRBJ1-5
TGCGCCAGCAGGGGAGTGGGGGCGAATAGCAATCAGCCCCAGCATTTT	CASRGVGANSNQPQHF	TRBV5-1	TRBJ1-5
TGTGCCAGCAGTAGTCACAGGGGGGGGTGCACAGATACGCAGTATTTT	CASSSHRGGCTDTQYF	TRBV6-5	TRBJ2-3
TGTGCCAGCAGAGGTCCCGGGACACAAGGTGAGCAGTTCTTC	CASRGPGTQGEQFF	TRBV7-3	TRBJ2-1
TGTGCCACCAGTGACGGTCAAGACCGGGCCAATCAGCCCCAGCATTTT	CATSDGQDRANQPQHF	TRBV24-1	TRBJ1-5
TGTGCCAGCAGCTTGATCCCCGGTAAAGGTCAGCCCCAGCATTTT	CASSLIPGKGQPQHF	TRBV7-2	TRBJ1-5
TGTGCCAGCAGCTTTCGCTGGACAGGGGCCTACGAGCAGTACTTC	CASSFRWTGAYEQYF	TRBV13	TRBJ2-7
TGTGCCACCAGTGAGGATGGGCTCGAGCAGTACTTC	CATSEDGLEQYF	TRBV24-1	TRBJ2-7
TGTGCCAAACCGACGCAGGTCAGCCGCTCTGGGGCCAACGTCCTGACTTTC	CAKPTQVSRSGANVLTF	TRBV6-4	TRBJ2-6
TGCGCCAGCAGCTTCGAGGGTAACACCGGGGAGCTGTTTTTT	CASSFEGNTGELFF	TRBV5-1	TRBJ2-2
TGTGCCAGCAGTTTACATGAATACGAGCAGTACTTC	CASSLHEYEQYF	TRBV28	TRBJ2-7
TGTGCCAGCAGCCAAACCCGGCGGGACAGCCCTCCTGGAAACACCATATATTTT	CASSQTRRDSPPGNTIYF	TRBV14	TRBJ1-3
TGCAGTGCTAGCCGTCAGGCGAGTTATAGCAATCAGCCCCAGCATTTT	CSASRQASYSNQPQHF	TRBV20-1	TRBJ1-5
TGTGCCAGCAGTTTACGCGGGGGAAGAGACTACAATGAGCAGTTCTTC	CASSLRGGRDYNEQFF	TRBV28	TRBJ2-1
TGTGCCAGCAGTGAATGCCTTCAGGGAGGGTATAGCAATCAGCCCCAGCATTTT	CASSECLQGGYSNQPQHF	TRBV25-1	TRBJ1-5
TGTGCCACCAGTGATTCGTTGACTAGCGGGGGGGACGAGCAGTACTTC	CATSDSLTSGGDEQYF	TRBV24-1	TRBJ2-7
TGTGCCACCAGTGATTCCCCCGGGACAGGGAAGCCGGCGCACTATGGCTACACCTTC	CATSDSPGTGKPAHYGYTF	TRBV24-1	TRBJ1-2
TGTGCCAGCAGCTTAGGTCTCAGATTAATAGACAGGGGGGGGGGGAATAATGAAAAACTGTTTTTT	CASSLGLRLIDRGGGNNEKLFF	TRBV7-6	TRBJ1-4
TGCAGCGTTGCCCTCTCCCGACAGTCTGGAAACACCATATATTTT	CSVALSRQSGNTIYF	TRBV29-1	TRBJ1-3
TGTGCCAGCAGTGAATATCGGGTATACGAGCAGTACTTC	CASSEYRVYEQYF	TRBV25-1	TRBJ2-7
TGTGCCAGCAGCTCCAATGACCGGGGACAGGGGATTACCGGGGAGCTGTTTTTT	CASSSNDRGQGITGELFF	TRBV7-6	TRBJ2-2
TGTGCCACCAGCAGACCTTTACTTTCGGACAGGGCCGGTCTAATGAACACTGAAGCTTTCTTT	CATSRPLLSDRAGLMNTEAFF	TRBV15	TRBJ1-1
TGTGCCAGCAGCCACCGCAGCGACGGAAGGACTGAAGCTTTCTTT	CASSHRSDGRTEAFF	TRBV9	TRBJ1-1
TGTGCCAGCAGCCAATCGGTTGGGACTAGCGGGGATTACGAGCAGTACTTC	CASSQSVGTSGDYEQYF	TRBV3-1	TRBJ2-7
TGTGCCAGCAGTTATGACAGGGTTCCCTGGAACACTGAAGCTTTCTTT	CASSYDRVPWNTEAFF	TRBV6-5	TRBJ1-1
TGTGCCAGTAGTCCCCTATACGAGCAGTACTTC	CASSPLYEQYF	TRBV19	TRBJ2-7
TGTGCCAGCAGCTGGTTTGTTGCACAGGGTTTGACAGCTTTCTTT	CASSWFVAQGLTAFF	TRBV7-9	TRBJ1-1
TGTGCCAGCAGTCCCCTAGCGGGTAGCACAGATACGCAGTATTTT	CASSPLAGSTDTQYF	TRBV27	TRBJ2-3
TGTGCCAGCAGAAACTCGGGGGAACCTGGAAACACCATATATTTT	CASRNSGEPGNTIYF	TRBV6-1	TRBJ1-3
TGCGCCAGCACCCACTCAGGCTCGGGACTAGCGGGGATATACGAGCAGTACTTC	CASTHSGSGLAGIYEQYF	TRBV4-1	TRBJ2-7
TGCGCCAGCAGAGTAGGCGAAGGAGGGCCCCCCGGCTATGGCTACACCTTC	CASRVGEGGPPGYGYTF	TRBV10-2	TRBJ1-2
TGTGCCAGCAGCCGGCGGGCCGGGTTCTACACTGAAGCTTTCTTT	CASSRRAGFYTEAFF	TRBV13	TRBJ1-1
TGTGCCAGCAGTTACGCCATTAACCAGGGGGCACCCCACAATGAGCAGTTCTTC	CASSYAINQGAPHNEQFF	TRBV6-6	TRBJ2-1
TGTGCCAGCAGTCAGGGGGGAAAAAACATTCAGTACTTC	CASSQGGKNIQYF	TRBV27	TRBJ2-4
TGTGCCACCAGTACGGACAGGTCCTACAATGAGCAGTTCTTC	CATSTDRSYNEQFF	TRBV24-1	TRBJ2-1
TGTGCCAGCAGCCAAGCCCGGGGGGAGACCTACAATGAGCAGTTCTTC	CASSQARGETYNEQFF	TRBV4-2	TRBJ2-1
TGTGCCAGCAGTGCCGTGCGGAAGATGACTAGCGGGGGGGCCCAGCCTTCACAAGAGCAGTTCTTC	CASSAVRKMTSGGAQPSQEQFF	TRBV6-4	TRBJ2-1
TGTGCCAGCACGACTTCGGGACTCTCCTACGAGCAGTACTTC	CASTTSGLSYEQYF	TRBV9	TRBJ2-7
TGTGCCAGCAGTCAGGGTCTCAGGCAGTACTTC	CASSQGLRQYF	TRBV6-8	TRBJ2-7
TGTGTTCTGGGGGGGCGCGTGAGGTACGAGCAGTACTTC	CVLGGRVRYEQYF	TRBV5-4	TRBJ2-7
TGTGCCAGCAGAGATAAGGGGGAGGAAGGGGCCAACGTCCTGACTTTC	CASRDKGEEGANVLTF	TRBV27	TRBJ2-6
TGTGCCAGCTCCATCCGGGACGGTGTCTACGAGCAGTACTTC	CASSIRDGVYEQYF	TRBV11-3	TRBJ2-7
TGTGCCAGCAGAGTTCTATATGTGCGGGAAGGGGACTCCTACGAGCAGTACTTC	CASRVLYVREGDSYEQYF	TRBV11-2	TRBJ2-7
TGTGCCAGCAGCTTCAAACGGGATCCCTCCTACGAGCAGTACTTC	CASSFKRDPSYEQYF	TRBV11-3	TRBJ2-7
TGTGCCAGCAGGGGTCGCCCTGTGGGACCCAAAAGCTATGGCTACACCTTC	CASRGRPVGPKSYGYTF	TRBV7-3	TRBJ1-2
TGTGCCAGCAGCCATCGCCCCGGGCCCCCCTACGAGCAGTACTTC	CASSHRPGPPYEQYF	TRBV14	TRBJ2-7
TGTGCCAGCAGCGGGGACAGGGCCTTCCGCATGAACACTGAAGCTTTCTTT	CASSGDRAFRMNTEAFF	TRBV13	TRBJ1-1
TGTGCCAGCAGCCCTTTGACTCCACATGGGGGGGGAGCTTTCCACACCGGGGAGCTGTTTTTT	CASSPLTPHGGGAFHTGELFF	TRBV9	TRBJ2-2
TGCGCCAGGGTGTCACCCCAGCGGGAGCAGACAAACACTGAAGCTTTCTTT	CARVSPQREQTNTEAFF	TRBV5-1	TRBJ1-1
TGCAGCGCTGTCAGGGGGCTGCGGAATAGCAATCAGCCCCAGCATTTT	CSAVRGLRNSNQPQHF	TRBV29-1	TRBJ1-5
TGTGCCAGCAGTGCGCAGGGGGCTAACTATGGCTACACCTTC	CASSAQGANYGYTF	TRBV6-1	TRBJ1-2
TGTGCCAGCAGCTTGTACGAGTTAACGGGGGGGCGGGAAGGCACAGATACGCAGTATTTT	CASSLYELTGGREGTDTQYF	TRBV7-9	TRBJ2-3
TGTGCCAGCAGTCGGACAGAAACTAACTATGGCTACACCTTC	CASSRTETNYGYTF	TRBV6-5	TRBJ1-2
TGTGCCAGCAGCCCAACTTCGGATGATGGCTACACCTTC	CASSPTSDDGYTF	TRBV13	TRBJ1-2
TGTGCTAGTGGTTTGTTAGGGACTAGCGGGTCTCCTCCCTACCCCAATGAGCAGTTCTTC	CASGLLGTSGSPPYPNEQFF	TRBV12-5	TRBJ2-1
TGCGCCAGCAGCCAACCGACATCGGACTCCTACAATGAGCAGTTCTTC	CASSQPTSDSYNEQFF	TRBV4-1	TRBJ2-1
TGTGCCAGCAGTGAATATCCCAAGGTCGGGAGCGAGCAGTACTTC	CASSEYPKVGSEQYF	TRBV25-1	TRBJ2-7
TGTGCCAGCATAAATTCATGTAAGACCCAGTACTTC	CASINSCKTQYF	TRBV7-3	TRBJ2-5
TGTGCCAGCAGCAAGGGACTAGCGGGGTGCTACGAGCAGTACTTC	CASSKGLAGCYEQYF	TRBV7-3	TRBJ2-7
TGCGCCAGCAGTGAGTCAACAATGAGACGTTACAATGAGCAGTTCTTC	CASSESTMRRYNEQFF	TRBV10-1	TRBJ2-1
TGTGCCAGCAACCAGGGCGGTCCCGACGAGCAGTACTTC	CASNQGGPDEQYF	TRBV27	TRBJ2-7
TGTGCCAGCAGCTGTCCACAGCCCACAGGGTCACCAACAAGGGCTGGAAACACCATATATTTT	CASSCPQPTGSPTRAGNTIYF	TRBV5-6	TRBJ1-3
TGTGCCAGCAGTTATAAACGGATGCCCTTCAATGAAGCTTTCTTT	CASSYKRMPFNEAFF	TRBV6-5	TRBJ1-1
TGTGCCAGCAGCGAACAGGGGGCCTCTAATGAAAAACTGTTTTTT	CASSEQGASNEKLFF	TRBV9	TRBJ1-4
TGCAGTGCTAGAATTGAGTTACCTAGCACAGATACGCAGTATTTT	CSARIELPSTDTQYF	TRBV20-1	TRBJ2-3
TGTGCCAGCAGCTTCGGCAGGGGACTTGATAGCAATCAGCCCCAGCATTTT	CASSFGRGLDSNQPQHF	TRBV11-3	TRBJ1-5
TGTGCCAGCAGACTCGGCCCCAGGGGGACCTACGAGCAGTACTTC	CASRLGPRGTYEQYF	TRBV7-3	TRBJ2-7
TGCGCCAATGTCTCGGGGCAAAATTCACCCCTCCACTTT	CANVSGQNSPLHF	TRBV10-1	TRBJ1-6
TGTGCCAGCAGGCGGGGGCGACCCGAGCAGTACTTC	CASRRGRPEQYF	TRBV6-3	TRBJ2-7
TGTGCCAGCAGCTTCCGGGACAGGGACCCACTAAACACCGGGGAGCTGTTTTTT	CASSFRDRDPLNTGELFF	TRBV7-2	TRBJ2-2
TGCAGTGCTAGCCGTCCACAGTCTCTAGAGACCCAGTACTTC	CSASRPQSLETQYF	TRBV20-1	TRBJ2-5
TGCAGCGGCCCACTAGCGGGAGCCTACGAGCAGTACTTC	CSGPLAGAYEQYF	TRBV29-1	TRBJ2-7
TGTGCCAGCAGCGTAGAGACGGGACAGTGTAGCAATCAGCCCCAGCATTTT	CASSVETGQCSNQPQHF	TRBV9	TRBJ1-5
TGTGCCAGCAGCGCCGGTAGCGGGGTAGGTTGCCAAGAGACCCAGTACTTC	CASSAGSGVGCQETQYF	TRBV13	TRBJ2-5
TGTGCCAGCAGTCCCCCGGGACTAGGGAAATTGAGAAACACAGATACGCAGTATTTT	CASSPPGLGKLRNTDTQYF	TRBV28	TRBJ2-3
TGTGCCAGCAGCGGCCATTGCGAACCCGTAGCCAAAAACATTCAGTACTTC	CASSGHCEPVAKNIQYF	TRBV13	TRBJ2-4
TGTGCCAGCAACGGGGCCCCGGCGGACAGCAATTCCACTGAAGCTTTCTTT	CASNGAPADSNSTEAFF	TRBV7-2	TRBJ1-1
TGTGCCATCAGTGACGGGGCGACAGGGACAGATACGCAGTATTTT	CAISDGATGTDTQYF	TRBV10-3	TRBJ2-3
TGCGCCAGCAGCTTGGAGCGGGGGGGCAAACTCACAGATACGCAGTATTTT	CASSLERGGKLTDTQYF	TRBV5-1	TRBJ2-3
TGTGCCAGCAGCCGGCCTCTCGGGGGTATTGACTATGGCTACACCTTC	CASSRPLGGIDYGYTF	TRBV4-2	TRBJ1-2
TGTGCCAGCAGGAGCGGGATTGGAGAGCAGTTCTTC	CASRSGIGEQFF	TRBV6-8	TRBJ2-1
TGTGCCAGCAGTGACCAGGCCGGGGAGCTGTTTTTT	CASSDQAGELFF	TRBV6-4	TRBJ2-2
TGTGCCAGTAGCGTACCGAAGGCGGGGGTGGAAAAACTGTTTTTT	CASSVPKAGVEKLFF	TRBV19	TRBJ1-4
TGTGCCAGCAGTCCGCGTATCTACGAGCAGTACTTC	CASSPRIYEQYF	TRBV6-5	TRBJ2-7
TGTGCCACCAGGTCGCCTCCGCGCTCACTAGCGAGCACAGATACGCAGTATTTT	CATRSPPRSLASTDTQYF	TRBV24-1	TRBJ2-3
TGTGCCAGCAGCGCGATCGGGGGACTGGATGAAAAACTGTTTTTT	CASSAIGGLDEKLFF	TRBV9	TRBJ1-4
TGTGCCAGCAGCCCGCCCCGTATGAGGGGGTTGTACAATGAGCAGTTCTTC	CASSPPRMRGLYNEQFF	TRBV5-6	TRBJ2-1
TGTGCCAGCAAACGACAGGCTAATGAGCAGTTCTTC	CASKRQANEQFF	TRBV6-5	TRBJ2-1
TGTGCCAGCAGCTTCGGCGGAACCGGGACTAGCGGGAGTCTTCTTGAGAATGAGCAGTTCTTC	CASSFGGTGTSGSLLENEQFF	TRBV7-3	TRBJ2-1
TGTGCCAGCAGCTTATTTCTAGGTCGTAATTCCGAGGAGCAGTACTTC	CASSLFLGRNSEEQYF	TRBV7-9	TRBJ2-7
TGTGCCAGCAGTGACTCGAGTAAAAACCTTGTCTTCAGTTCCTTC	CASSDSSKNLVFSSF	TRBV6-4	TRBJ2-7
TGTGCCAGCAGACTAAGGACGGAAGAGACCCAGTACTTC	CASRLRTEETQYF	TRBV6-1	TRBJ2-5
TGTGGGGGACACTATGGCTACACCTTC	CGGHYGYTF	TRBV19	TRBJ1-2
TGTGCCAGCAGTCAAAAAGTACTAGACTTCGGCGGATACAATGAGCAGTTCTTC	CASSQKVLDFGGYNEQFF	TRBV6-1	TRBJ2-1
TGTGCCATCATCCGTAGGGGAAAGGCGGTGGCCGGGGAGCTGTTTTTT	CAIIRRGKAVAGELFF	TRBV10-3	TRBJ2-2
TGTGCCAGCAGTGACTCGCCGATCTACGTTCCCTCCTACGAGCAGTACTTC	CASSDSPIYVPSYEQYF	TRBV6-4	TRBJ2-7
TGTGCCGGGAGAGAGGCCTACGAGCAGTACTTC	CAGREAYEQYF	TRBV6-5	TRBJ2-7
TGTGCCACCCATCCAGACAATTCACCCCTCCACTTT	CATHPDNSPLHF	TRBV24-1	TRBJ1-6
TGCAGTGCTACCAGAGGGGGGTCCACCGAGCAGTACTTC	CSATRGGSTEQYF	TRBV20-1	TRBJ2-7
TGTGCCAGCTTGGGGGGGTTCGTCTACGAGCAGTACTTC	CASLGGFVYEQYF	TRBV7-3	TRBJ2-7
TGTGCCAGCAGACCTGACTGCCGGGATGAGCAGTTCTTC	CASRPDCRDEQFF	TRBV2	TRBJ2-1
TGTGCCACCAGTGCGTTGAGTGAGACCCAGTACTTC	CATSALSETQYF	TRBV24-1	TRBJ2-5
TGTGCCTGGCGACGTGCAGGGGCCCCTACTTTGAACACTGAAGCTTTCTTT	CAWRRAGAPTLNTEAFF	TRBV30	TRBJ1-1
TGTGCCAGCAGCCGCAGGGGGCGGTACTCCTACGAGCAGTACTTC	CASSRRGRYSYEQYF	TRBV7-3	TRBJ2-7
TGTGCCAGCAGCCCCCGTGGGCCGAGTCGGGACACAGATACGCAGTATTTT	CASSPRGPSRDTDTQYF	TRBV3-1	TRBJ2-3
TGCGCCAGCAGCCAAGGTCCGGGGCTTAGCCGGGACAGGCCTTTGCTCCTCACAGATACGCAGTATTTT	CASSQGPGLSRDRPLLLTDTQYF	TRBV4-1	TRBJ2-3
TGTGCCAGCAGGGTGAGCGGGAGCACAGAGGAGCCCCAGCATTTT	CASRVSGSTEEPQHF	TRBV7-2	TRBJ1-5
