TGTGCTAGTGCCCACTGGGGCCTCTTTCAGCCCCAGCATTTT	CASAHWGLFQPQHF	TRBV12-5	TRBJ1-5
TGTGCCAGCAGTGACAAAAGGGGGCAAGGCTATGGCTACACCTTC	CASSDKRGQGYGYTF	TRBV6-1	TRBJ1-2
TGCGCCAGCAGCTTGGCGGAGGAACCACTAGCGGACTTTCGCACCGGGGAGCTGTTTTTT	CASSLAEEPLADFRTGELFF	TRBV5-1	TRBJ2-2
TGTGCCAGCAGTTACAGGGGGGTGGTGAGAAACACCATATATTTT	CASSYRGVVRNTIYF	TRBV6-5	TRBJ1-3
TGCGCCAGCAGCCAACCTGAGCCGGGACTAGCGGGCTGGCCCTCTAGCACAGATACGCAGTATTTT	CASSQPEPGLAGWPSSTDTQYF	TRBV4-1	TRBJ2-3
TGTGCCACCAGTGTGTACCAGACCCAGTACTTC	CATSVYQTQYF	TRBV24-1	TRBJ2-5
TGTGCCAGCGGGACTAGGAGCACAGATACGCAGTATTTT	CASGTRSTDTQYF	TRBV27	TRBJ2-3
TGTGCCAGCCAAGGACACGAGCAGTACTTC	CASQGHEQYF	TRBV9	TRBJ2-7
TGCGCCAGCAGCTTGGACGCGGGGAACACTGAAGCTTTCTTT	CASSLDAGNTEAFF	TRBV5-1	TRBJ1-1
TGTGCCAGCAGTGACTCGAGGGGGGCGCATGGCTACACCTTC	CASSDSRGAHGYTF	TRBV6-4	TRBJ1-2
TGTGCCACCAGCAGAGCCCCGGCTGGAAGGTTAATGAACACTGAAGCTTTCTTT	CATSRAPAGRLMNTEAFF	TRBV15	TRBJ1-1
TGTGCCAGCAGCTTAACGAAGCTGATCGGCGAGCAGTACTTC	CASSLTKLIGEQYF	TRBV7-3	TRBJ2-7
TGCAGTGCTCGATTTAATCAGCCCCAGCATTTT	CSARFNQPQHF	TRBV20-1	TRBJ1-5
TGCGCCAGCAGCCAATTGGACAGGGTGGGAGAGACCCAGTACTTC	CASSQLDRVGETQYF	TRBV4-3	TRBJ2-5
TGTGCCAGCAGCTTACAGTCTCGGAAACCGCCCTACGAGCAGTACTTC	CASSLQSRKPPYEQYF	TRBV7-3	TRBJ2-7
TGTGCCAGCAGCCAGACACAAGCGTTGCGATATAGCAATCAGCCCCAGCATTTT	CASSQTQALRYSNQPQHF	TRBV3-1	TRBJ1-5
TGCAGCGTTGGGCAGCCCCAGCATTTT	CSVGQPQHF	TRBV29-1	TRBJ1-5
TGTGCCAGCCTTCAGCGGGAGGACTATGGCTACACCTTC	CASLQREDYGYTF	TRBV27	TRBJ1-2
TGCGCCAGCAGCTTAGGACCTTGGGACTGCTCTGGGGCCAACGTCCTGACTTTC	CASSLGPWDCSGANVLTF	TRBV5-1	TRBJ2-6
TGTGCCAGCAGCTCCCCGGGACTAGCGGGGTCTTCAAACGAGCAGTACTTC	CASSSPGLAGSSNEQYF	TRBV7-6	TRBJ2-7
TGTGCCAGTAGTAACCACCCTGGGGGGGCCATGCCCTACAATGAGCAGTTCTTC	CASSNHPGGAMPYNEQFF	TRBV19	TRBJ2-1
TGCAGTGCGGGGGGACAGGAGCGGCCAGGGGGCAGGGAGTCCAAAGACCAGCCCCAGCATTTT	CSAGGQERPGGRESKDQPQHF	TRBV20-1	TRBJ1-5
TGTGCCAGCGGTTGTAATGGGGGGCCGACAGAAGATACGCAGTATTTT	CASGCNGGPTEDTQYF	TRBV6-4	TRBJ2-3
TGTGCCATCAGTGACGCCGGGACTAGGGGGGAGCTGTTTTTT	CAISDAGTRGELFF	TRBV10-3	TRBJ2-2
TGTGCCAGCAGTCAATGGGGACCAGTTAATAAGGCTGAAGCTTTCTTT	CASSQWGPVNKAEAFF	TRBV12-4	TRBJ1-1
TGTGCCAGCGGGGAGGGGGCTCAGGAGTACGAGCAGTACTTC	CASGEGAQEYEQYF	TRBV3-1	TRBJ2-7
TGTGCCAGCAGCCAAGAAACCCAGTACTTC	CASSQETQYF	TRBV14	TRBJ2-7
TGTGCCAGCAGCGTAGTAAGCCCATTATGGGGGCTTCGGACCCAGTACTTC	CASSVVSPLWGLRTQYF	TRBV9	TRBJ2-5
TGCAGTGCTAGCACAGGGGGCCCTGGAAACACCATATATTTT	CSASTGGPGNTIYF	TRBV20-1	TRBJ1-3
TGCAGTGCTGACCGGGACGAGTTAGTCACAGATACGCAGTATTTT	CSADRDELVTDTQYF	TRBV20-1	TRBJ2-3
TGTGCCAGCAGTTACCAGGGAGATTATAGCAATCAGCCCCAGCATTTT	CASSYQGDYSNQPQHF	TRBV6-2	TRBJ1-5
TGTGCCAGCAGCCCAAACCTGAGGATACTAGCGGGAGGGCTGGATGGCACAGATACGCAGTATTTT	CASSPNLRILAGGLDGTDTQYF	TRBV7-3	TRBJ2-3
TGTGCCAGCAGCCAGGGGTCCTATGAAGCTTTCTTT	CASSQGSYEAFF	TRBV7-9	TRBJ1-1
TGTGCCAGCAGCCAAGATTATCATAGTGACAATGAGCAGTTCTTC	CASSQDYHSDNEQFF	TRBV14	TRBJ2-1
TGTGCCAGCAGCACTAATTCTTCTAGCGGGGTAGCCAAAAACATTCAGTACTTC	CASSTNSSSGVAKNIQYF	TRBV13	TRBJ2-4
TGTGCCAGCAGCAGGGGGGCCTATAATTCACCCCTCCACTTT	CASSRGAYNSPLHF	TRBV9	TRBJ1-6
TGTGCCATCATCCCCAACCAACCCTCGGGGGCGTTGACTGAAGCTTTCTTT	CAIIPNQPSGALTEAFF	TRBV10-3	TRBJ1-1
TGTGCCAGCTCAAGCTCGGGCTTGTGCGGGGAGCTGTTTTTT	CASSSSGLCGELFF	TRBV9	TRBJ2-2
TGCGCCAGCAGCTTGGGGTTGGCGGGAAGGACCTACGAGCAGTACTTC	CASSLGLAGRTYEQYF	TRBV5-1	TRBJ2-7
TGTGCCAGCAGCTTGTTCCTGTATCCTCGACTAGCGGGGATCCGGCGGAATGAGCAGTTCTTC	CASSLFLYPRLAGIRRNEQFF	TRBV7-9	TRBJ2-1
TGTGCCAGCAGCTTAGCTTGTAGGGCCTACGAGCAGTACTTC	CASSLACRAYEQYF	TRBV7-6	TRBJ2-7
TGTGCCAGCAGGGGGGGACTAGCGGGTTGGATACCACTCTACAATGAGCAGTTCTTC	CASRGGLAGWIPLYNEQFF	TRBV7-9	TRBJ2-1
TGCGCCAGCAGTGACAGGGGGCGGACCCACGGGGCCAACGTCCTGACTTTC	CASSDRGRTHGANVLTF	TRBV10-1	TRBJ2-6
TGTGCCAGCATTACTTGGGGGGACAATAGGAACACTGAAGCTTTCTTT	CASITWGDNRNTEAFF	TRBV9	TRBJ1-1
TGTGCCAGCAGCTTGGGAGGTAATGTACGGGGGTGTTCCCTCCTAAAGAATGGGCAGTTCTTC	CASSLGGNVRGCSLLKNGQFF	TRBV5-6	TRBJ2-1
TGTGCCAGTAGTATAGGGACAGGGACTTATAATTCACCCCTCCACTTT	CASSIGTGTYNSPLHF	TRBV19	TRBJ1-6
TGCAGTGCTAGAGTGGGGGAGCCCCGAAGTTTGGGGGGGGCAATCTCTTCGAACACTGAAGCTTTCTTT	CSARVGEPRSLGGAISSNTEAFF	TRBV20-1	TRBJ1-1
TGTGCCAGCAGCGGGTTTCTTGGGACAGGGGCCTGTGGCAGCAATCAGCCCCAGCATTTT	CASSGFLGTGACGSNQPQHF	TRBV13	TRBJ1-5
TGTGCCAGCAGCAAATCTTGGACAGACTTGGATGAGACCCAGTACTTC	CASSKSWTDLDETQYF	TRBV7-9	TRBJ2-5
TGTGCCACCAGCAGAGATTTGGCAGGGTGCAATCAGCCCCAGCATTTT	CATSRDLAGCNQPQHF	TRBV15	TRBJ1-5
TGTGGCTACCGCGGACACCTTTTTGAGCAAGAGACCCAGTACTTC	CGYRGHLFEQETQYF	TRBV6-4	TRBJ2-5
TGTGCCTGGAGGGCGCCGGGACAGGAACATCAGCCCCAGCATTTT	CAWRAPGQEHQPQHF	TRBV30	TRBJ1-5
TGTGCCAGCAGCTTAGACCGGAGTGTATGCACAGATACGCAGTATTTT	CASSLDRSVCTDTQYF	TRBV7-9	TRBJ2-3
TGTGCCACCAGTGACGTACGGTTCTCGGGGCAGCAGTACTTC	CATSDVRFSGQQYF	TRBV24-1	TRBJ2-7
TGTGCCAGCAGCCGGGGTTATGGCTACACCTTC	CASSRGYGYTF	TRBV13	TRBJ1-2
TGTGCCACCAGTGACCCAGTTTACAGGGGGCCGGGGAGGATCTACGAGCAGTACTTC	CATSDPVYRGPGRIYEQYF	TRBV24-1	TRBJ2-7
TGTGCCAGCAGTGCGGGCCGGGACAGGGGGTTTCAGCCCCAGCATTTT	CASSAGRDRGFQPQHF	TRBV6-1	TRBJ1-5
TGTGCCAGCAGTGACTCGATCACCGCACCTAGGCCGGGGGAGACCCAGTACTTC	CASSDSITAPRPGETQYF	TRBV6-4	TRBJ2-5
TGTGCCAGTCTAGGGATGTCCCGCGAGCAGTACTTC	CASLGMSREQYF	TRBV12-3	TRBJ2-7
TGTGCCAGCAGCTTAGGAGCAGTTGGCACCATATATTTT	CASSLGAVGTIYF	TRBV7-3	TRBJ1-3
TGTGCCCCCGTCCCCAGTGCCACAGATACGCAGTATTTT	CAPVPSATDTQYF	TRBV7-7	TRBJ2-3
TGTGCCAGCAGCCCGGGACGCGGTAAGGCGTACCAAGAGACCCAGTACTTC	CASSPGRGKAYQETQYF	TRBV7-9	TRBJ2-5
TGCGCCAGCAGCGGTTTCCTAGGGAAGCATCAGCCCCAGCATTTT	CASSGFLGKHQPQHF	TRBV5-1	TRBJ1-5
TGTGCCAGCAGCGTAGAGTTGGACAGCGGCACTGAAGCTTTCTTT	CASSVELDSGTEAFF	TRBV9	TRBJ1-1
TGTGCCACCAGTGGAGGGACCCGAGACAGCTCCTACAATGAGCAGTTCTTC	CATSGGTRDSSYNEQFF	TRBV24-1	TRBJ2-1
TGTGCCAGCAGTGAGGAAATCGGACAGAGGTACGAGCAGTACTTC	CASSEEIGQRYEQYF	TRBV6-1	TRBJ2-7
TGCGCCAGCAGCTTGGACACCCCCCGAGAGCAGTATTTT	CASSLDTPREQYF	TRBV5-1	TRBJ2-3
TGCAGTGCTAGAGACAGACCTGGAAACACCATATATTTT	CSARDRPGNTIYF	TRBV20-1	TRBJ1-3
TGCAGTGCCGGGATCGGGGCAGGACCTCCTACCAACATTCAGTACTTC	CSAGIGAGPPTNIQYF	TRBV20-1	TRBJ2-4
TGTGCCAGCAGCTCGTTAGCAACAGGGGGTGATAACGAAAAACTGTTTTTT	CASSSLATGGDNEKLFF	TRBV7-9	TRBJ1-4
TGCAGCGTTAGTGTCTACAGGTTTGGAGATACGCAGTATTTT	CSVSVYRFGDTQYF	TRBV29-1	TRBJ2-3
TGTGCCAGCAGCCAAGATGCCCCCCGACAGCAAGAGACCCAGTACTTC	CASSQDAPRQQETQYF	TRBV3-1	TRBJ2-5
TGTGCCAGCAGTTACAAAACCCGGCAAAGCTACAATGAGCAGTTCTTC	CASSYKTRQSYNEQFF	TRBV6-8	TRBJ2-1
TGTGCCAGCAGCCGACCGGGACTAGCGGAGCCCTACAATGAGCAGTTCTTC	CASSRPGLAEPYNEQFF	TRBV7-4	TRBJ2-1
TGTGCCAGCAGCACAGTCGGCCAAGAGACCCAGTACTTC	CASSTVGQETQYF	TRBV14	TRBJ2-5
TGTGCCAGCAGGCGCGGGACAGGGGGAGAAGAAAAACTGTTTTTT	CASRRGTGGEEKLFF	TRBV6-4	TRBJ1-4
TGTGCCAGCAGCGCACGGGAGGGGGCCGGCACAGATACGCAGTATTTT	CASSAREGAGTDTQYF	TRBV7-8	TRBJ2-3
TGTGCCAGCAGTGCCTTGGGGTGCACCGGGGAGCTGTTTTTT	CASSALGCTGELFF	TRBV12-3	TRBJ2-2
TGTGCCAGCAGCCAAGTTGACGGGATTACGCAGTATTTT	CASSQVDGITQYF	TRBV3-1	TRBJ2-3
TGCAGCGTTGAAGAGAGCGTCGGGGAGGGTGAGCAGTTCTTC	CSVEESVGEGEQFF	TRBV29-1	TRBJ2-1
TGTGCCAGCAGTTCCCGGGAGGGCTCACCCCTCCACTTT	CASSSREGSPLHF	TRBV12-3	TRBJ1-6
TGTGCCACCAGTGATTTGATGGGACTAGCGGGACGGCAGTATTTT	CATSDLMGLAGRQYF	TRBV24-1	TRBJ2-3
TGCGCCAGCAGCTTGGGGGTCTACGACAGCTGGAATTCACCCCTCCACTTT	CASSLGVYDSWNSPLHF	TRBV5-1	TRBJ1-6
TGTGCCAGCAGCCAAGGCCTAGCGGGATGGTCCTACGAGCAGTACTTC	CASSQGLAGWSYEQYF	TRBV3-1	TRBJ2-7
TGCAGTGCTAGAGAGGGCTGGGACAGGGAATATGAGCAGTTCTTC	CSAREGWDREYEQFF	TRBV20-1	TRBJ2-1
TGCAGTGCTAGAGAAGTGGGGACAGGGATTTTAAGCAATCAGCCCCAGCATTTT	CSAREVGTGILSNQPQHF	TRBV20-1	TRBJ1-5
TGTGCCAGCAGAAGGCGGGACTGTTGGAGAGAGGAGTACTTC	CASRRRDCWREEYF	TRBV6-3	TRBJ2-5
TGTGCCAGCAGTTTATCGGCGTGTTCCCTAGGTGAGACGAGGGAGACCCAGTACTTC	CASSLSACSLGETRETQYF	TRBV27	TRBJ2-5
TGTGCCAGCAGCTTTACCCGGACTAGCGGGCCCTTC	CASSFTRTSGPF	TRBV11-3	TRBJ2-5
TGTGCCAGCAAATCCGGGGGGGCCATACGATCCTACAATGAGCAGTTCTTC	CASKSGGAIRSYNEQFF	TRBV25-1	TRBJ2-1
TGTGCCAGCAGCACCGGGGGAGTCACAGATACGCAGTATTTT	CASSTGGVTDTQYF	TRBV7-3	TRBJ2-3
TGCAGTGCACCCCCAGGCGTTGCGACTGAAGCTTTCTTT	CSAPPGVATEAFF	TRBV20-1	TRBJ1-1
TGCAGTGCTAGAGATAGCGGGCTGGCCAAAGATGAGCAGTTCTTC	CSARDSGLAKDEQFF	TRBV20-1	TRBJ2-1
TGCAGTGCCTCCGGGGTCAATGAGCAGTTCTTC	CSASGVNEQFF	TRBV20-1	TRBJ2-1
TGTGCCCCCGACAGGGGAGGACCCCAGCATTTT	CAPDRGGPQHF	TRBV6-1	TRBJ1-5
TGTGCCTCTTCCCGTGGACAGGGGTACTATGGCTACACCTTC	CASSRGQGYYGYTF	TRBV25-1	TRBJ1-2
TGTGCCAGCAGCCAAGAGGATCGCCAAGAGACCCAGTACTTC	CASSQEDRQETQYF	TRBV14	TRBJ2-5
TGTGCCAGCAGCTTGGCCCCCCGAGGCCGGCAAGGACAGGGGGGCCTAATCGCCCTCCACTTT	CASSLAPRGRQGQGGLIALHF	TRBV5-5	TRBJ1-6
TGTGCCACCAGAATTATCCGGACCCGGGAAAAACTGTTTTTT	CATRIIRTREKLFF	TRBV24-1	TRBJ1-4
TGCGCCAGCGACGGGACAGGGGTGAATGAAAAACTGTTTTTT	CASDGTGVNEKLFF	TRBV4-1	TRBJ1-4
TGTGCCAGCAGGAGCGGGAGTGCCGTCCTCTCCTACGAGCAGTACTTC	CASRSGSAVLSYEQYF	TRBV7-4	TRBJ2-7
TGTGCCAGCAGTGAACTAAGGTCGACTAGCGTGAAGCTCCCCTACAATGAGCAGTTCTTC	CASSELRSTSVKLPYNEQFF	TRBV6-1	TRBJ2-1
TGTGCCATCAGACTTGGTGGGGCAACGGACTACGAGCAGTACTTC	CAIRLGGATDYEQYF	TRBV10-3	TRBJ2-7
TGCAGTGCTAGAGAAGGCAGGGCCTACGAGCAGTACTTC	CSAREGRAYEQYF	TRBV20-1	TRBJ2-7
TGTGCCAGCAGTTACCTTTGGAGGGGGGGCGAGCAGGGATACGAGCAGTACTTC	CASSYLWRGGEQGYEQYF	TRBV6-5	TRBJ2-7
TGTGCCACCAGTGAATGGACAGGGATTGTTTTTCCTTCCTACGAGCAGTACTTC	CATSEWTGIVFPSYEQYF	TRBV24-1	TRBJ2-7
TGTGCCAGCAGCGGGGGCCCACGTTCGTGGAACACCGGGGAGCTGTTTTTT	CASSGGPRSWNTGELFF	TRBV7-2	TRBJ2-2
TGCGCCAGCAGCAAACACGCGGGTCCGGAGCGCACCGGGGAGCTGTTTTTT	CASSKHAGPERTGELFF	TRBV5-1	TRBJ2-2
TGTGCCATCAGATGGACTAGCGGGGTGGAGACCCAGTACTTC	CAIRWTSGVETQYF	TRBV10-3	TRBJ2-5
TGTGCCAGCAGACACTTGGGGAAAGAGACCCAGTACTTC	CASRHLGKETQYF	TRBV12-4	TRBJ2-5
TGTGCCAGCAGAAGGACTAGCGGGATCGAGGTAGATACGCAGTATTTT	CASRRTSGIEVDTQYF	TRBV6-2	TRBJ2-3
TGCGCCAGCAGCTACCGGACATACAATGAGCAGTTCTTC	CASSYRTYNEQFF	TRBV5-1	TRBJ2-1
TGTGCCAGCAGAGATGGGGCCAGCAATCAGCCCCAGCATTTT	CASRDGASNQPQHF	TRBV12-3	TRBJ1-5
TGCGCCAGCAGCCCCCCGGGCGGTAATGAAAAACTGTTTTTT	CASSPPGGNEKLFF	TRBV4-1	TRBJ1-4
TGTGCCAGCAGCGGGAGGGACAGGGGAAGCAATCAGCCCCAGCATTTT	CASSGRDRGSNQPQHF	TRBV7-3	TRBJ1-5
TGTGCCAGCAGCGTTCTCGGGGAGGTGCCCGGCTACGAGCAGTACTTC	CASSVLGEVPGYEQYF	TRBV3-1	TRBJ2-7
TGTGCCAGCAGTGAATGGGCCGCGGGGTCGGACCATAATTCACCCCTCCACTTT	CASSEWAAGSDHNSPLHF	TRBV25-1	TRBJ1-6
TGTGCTAGTGGTTTTTCCAGAGCGGGACCCGGGGTAGAGACCCAGTACTTC	CASGFSRAGPGVETQYF	TRBV12-5	TRBJ2-5
TGTGCCAGCAGTTTAACCGTTCTTAAGTCCTACGAGCAGTACTTC	CASSLTVLKSYEQYF	TRBV28	TRBJ2-7
TGTGCCTGGAGTCGGGACGGCCAAGAGACCCAGTACTTC	CAWSRDGQETQYF	TRBV30	TRBJ2-5
TGTGCCAGCAGTGACTCGATGCATTGGGGTTCACCCCTCCACTTT	CASSDSMHWGSPLHF	TRBV6-4	TRBJ1-6
TGTGCCTGGACCGTGGGGGACAGGGATTACGAGCAGTACTTC	CAWTVGDRDYEQYF	TRBV30	TRBJ2-7
TGTGCCAGCAGTGACTGGCATGAAAAACTGTTTTTT	CASSDWHEKLFF	TRBV6-1	TRBJ1-4
TGTGCCAGCAGTTCCACCTTACCTAACTATGGCTACACCTTC	CASSSTLPNYGYTF	TRBV6-2	TRBJ1-2
TGCAGTGCTCACAGTCGTCACCCGGGACGAGGGGCAACTAATGAAAAACTGTTTTTT	CSAHSRHPGRGATNEKLFF	TRBV20-1	TRBJ1-4
TGTGCCAGCAGTTCAGCGGTACCCCGCGAGGGCACAGATACGCAGTATTTT	CASSSAVPREGTDTQYF	TRBV27	TRBJ2-3
TGCGCCAGCAGCTTGGGCGGGGGGGTACAGGGCTACGAGCAGTACTTC	CASSLGGGVQGYEQYF	TRBV5-1	TRBJ2-7
TGTGCCAGCAGTTTATCGGGTGGGGATAATAATAACTATGGCTACACCTTC	CASSLSGGDNNNYGYTF	TRBV27	TRBJ1-2
TGTGCCAGCAGCACTGAGCACCCTACGGACACAGATACGCAGTATTTT	CASSTEHPTDTDTQYF	TRBV7-4	TRBJ2-3
TGCGCCAGCAGCCACTGGGACCGGGCCTACGAGCAGTACTTC	CASSHWDRAYEQYF	TRBV4-1	TRBJ2-7
TGCAGTGCTAGAGACTTTAGCGGGTCTTCCTACAATGAGCAGTTCTTC	CSARDFSGSSYNEQFF	TRBV20-1	TRBJ2-1
TGTGCCAGTAGTATGGAGACCTCCTACAATGAGCAGTTCTTC	CASSMETSYNEQFF	TRBV19	TRBJ2-1
TGTGCCAGCAGTGGAAAGACAGGAATCTACGTCGGAGGAACTAATGAAAAACTGTTTTTT	CASSGKTGIYVGGTNEKLFF	TRBV27	TRBJ1-4
TGTGCCAGCAGTTTGGCCCGGATGAATGAGCAGTTCTTC	CASSLARMNEQFF	TRBV27	TRBJ2-1
TGTGCCTGGACCCCGTGGGGGGTTACCCGCACAGATACGCAGTATTTT	CAWTPWGVTRTDTQYF	TRBV30	TRBJ2-3
TGTGCCAGCAGCTTGCGACAGGGCTCGAGGCATTTT	CASSLRQGSRHF	TRBV5-5	TRBJ1-5
TGCGCCAGCAGTGAGTATGGTGAAACACAGCGGGGACAGGGAGAGCAGTACTTC	CASSEYGETQRGQGEQYF	TRBV10-2	TRBJ2-7
TGCGCCAGCAGCTTGGACTCCGGACAGAGGGTGCTGAACACTGAAGCTTTCTTT	CASSLDSGQRVLNTEAFF	TRBV5-1	TRBJ1-1
TGTGCCAGCAGCCGACGGGCGGGGCGAGCTTTCTTT	CASSRRAGRAFF	TRBV7-3	TRBJ1-1
TGTGCCAGCAGCCAAGGCCGGGGCCGGGGGGTTACAAGCGCTTTCTTT	CASSQGRGRGVTSAFF	TRBV3-1	TRBJ1-1
TGTGCCAGCGGACACGAGGACGCAGATACGCAGTATTTT	CASGHEDADTQYF	TRBV19	TRBJ2-3
TGCAGTGCGCCGGGGGATCAGCCCCAGCATTTT	CSAPGDQPQHF	TRBV20-1	TRBJ1-5
TGTGCCAGCAGTTTACGGGGGCCGGCCTATGGCTACACCTTC	CASSLRGPAYGYTF	TRBV28	TRBJ1-2
TGTGCCAGCAGCTTATTATGGGGAACTGGAAACACCATATATTTT	CASSLLWGTGNTIYF	TRBV7-8	TRBJ1-3
TGTGCCAGTAGTAGGGGAGACAGGGAAGAGACCCAGTACTTC	CASSRGDREETQYF	TRBV19	TRBJ2-5
TGTGCCAGCAGCAGTGGGCGGGGAAACGAGCAGTACTTC	CASSSGRGNEQYF	TRBV9	TRBJ2-7
TGTGCCAGCAGCTTAGAATCTTTAGGGGCCCCGACTGAAGCTTTCTTT	CASSLESLGAPTEAFF	TRBV7-2	TRBJ1-1
TGTGCCAGCAGCTTAGCTCGGGGGACAGTGTGGGTGGGCTCTGGGGCCAACGTCCTGACTTTC	CASSLARGTVWVGSGANVLTF	TRBV13	TRBJ2-6
TGCAAGACCGGGAAGGGGGCGGGCAATCAGCCCCAGCATTTT	CKTGKGAGNQPQHF	TRBV20-1	TRBJ1-5
TGCAGTGCTGGGGCCGACAGGGATGAGCAGTTCTTC	CSAGADRDEQFF	TRBV20-1	TRBJ2-1
TGTGCCATCCCAGGGGATATGATTCACTATGGCTACACCTTC	CAIPGDMIHYGYTF	TRBV5-5	TRBJ1-2
TGTGCCTGGAGTGTACGCCTTATCGGGACTAGATTCCAATTGACAGTCACAGATACGCAGTATTTT	CAWSVRLIGTRFQLTVTDTQYF	TRBV30	TRBJ2-3
TGTGCCAGCAGCTTAATGGAGAATGCCAGCTCTGGGGCCAACGTCCTGACTTTC	CASSLMENASSGANVLTF	TRBV7-3	TRBJ2-6
TGTGCCAGCAGTAAAGCGGGAATACACGAGCAGTACTTC	CASSKAGIHEQYF	TRBV12-4	TRBJ2-7
TGTGCCAGCAGCTTGACAGGAGCGGATGAGCAGTTCTTC	CASSLTGADEQFF	TRBV7-2	TRBJ2-1
TGTGCCAGCAAAATTCCAGGGGATTCCTCTGGGGCCAACGTCCTGACTTTC	CASKIPGDSSGANVLTF	TRBV28	TRBJ2-6
TGTGCCAGCAGCTCCTCGGACCCGGACAATCAGCCCCAGCATTTT	CASSSSDPDNQPQHF	TRBV5-6	TRBJ1-5
TGTGCCACCGAAGGACAGGGAAGATATAGCAATCAGCCCCAGCATTTT	CATEGQGRYSNQPQHF	TRBV24-1	TRBJ1-5
TGTGCCAGCAGCTACCGTGGAGTGTCGAATTACGAGCAGTACTTC	CASSYRGVSNYEQYF	TRBV5-4	TRBJ2-7
TGTGCCAGCAGCTTACTTTTAGCGGGGAGTTCATACAATGAGCAGTTCTTC	CASSLLLAGSSYNEQFF	TRBV5-6	TRBJ2-1
TGTGCCAGCAGTGACTCGGAGCACAGGGACAGTTATGGAAACACCATATATTTT	CASSDSEHRDSYGNTIYF	TRBV6-4	TRBJ1-3
TGTGCCAGCAGTTACTCGAAAAACAGTAATTCACCCCTCCACTTT	CASSYSKNSNSPLHF	TRBV6-5	TRBJ1-6
TGTGCCAGCAGACCGAGGGACAGGGGTAGGGGCTCTGGAAACACCATATATTTT	CASRPRDRGRGSGNTIYF	TRBV9	TRBJ1-3
TGTGCCAGCAGCCAACCCAAGACAGGGTTTCTAGGCTATGGCTACACCTTC	CASSQPKTGFLGYGYTF	TRBV7-9	TRBJ1-2
TGTGCCAGCAGGGTCGAGCAGTACTTC	CASRVEQYF	TRBV6-1	TRBJ2-7
TGCGCCAGCAGCCCCTTAGTAACCTCCTACGAGCAGTACTTC	CASSPLVTSYEQYF	TRBV5-1	TRBJ2-7
TGTGCCAGCAGCCTGGACGCGAGCACAGATACGCAGTATTTT	CASSLDASTDTQYF	TRBV9	TRBJ2-3
TGTGCCAGCCACCGGAGGCGCCAGCCCCAGCATTTT	CASHRRRQPQHF	TRBV6-2	TRBJ1-5
TGTGCCTGGGTCCGGACAGGGACTAATGAAAAACTGTTTTTT	CAWVRTGTNEKLFF	TRBV30	TRBJ1-4
TGTGCCAGCAGTATTCCTGGGGGGGCCGCAGATACGCAGTATTTT	CASSIPGGAADTQYF	TRBV6-6	TRBJ2-3
TGTGCCAGCAGCAGTCCCTCCCCAGGGGGGTGGACAGATGGCTACACCTTC	CASSSPSPGGWTDGYTF	TRBV13	TRBJ1-2
TGCGCCAGCCAGCGGGACGGGCTAATGAACACTGAAGCTTTCTTT	CASQRDGLMNTEAFF	TRBV10-1	TRBJ1-1
TGTGCCAGCAGTCACCCGGTGGGACTAGAGATCCTCGGGGAGCTGTTTTTT	CASSHPVGLEILGELFF	TRBV6-1	TRBJ2-2
TGCGCCAGCAGCTTCAAAAAGGGAGACATTGGTGGGAGGGTGAACACTGAAGCTTTCTTT	CASSFKKGDIGGRVNTEAFF	TRBV5-1	TRBJ1-1
TGTGCCAGCAGTGAACGCCAGGGAGGAGTTAACGAGCAGTACTTC	CASSERQGGVNEQYF	TRBV2	TRBJ2-7
TGTGCCAGCAGTGATGGGAAAGGGGGAGGCTCCTACGAGCAGTACTTC	CASSDGKGGGSYEQYF	TRBV2	TRBJ2-7
TGTGCCAGCAGCTTAGCAGGTAGCGGGCAGCTACCCTACAATGAGCAGTTCTTC	CASSLAGSGQLPYNEQFF	TRBV11-1	TRBJ2-1
TGTGCCAGCAGCCAAGATTTCGAGAAGGGGACAGGGGGCTTGGAACTGTTCAAAAACATTCAGTACTTC	CASSQDFEKGTGGLELFKNIQYF	TRBV3-1	TRBJ2-4
TGCGCCAGCAGCTTGGAACGAGCGGGAGAGCCGAACACTGAAGCTTTCTTT	CASSLERAGEPNTEAFF	TRBV5-1	TRBJ1-1
TGTGCCAGCAGAGAACCCCCTGGCTACGAGCAGTACTTC	CASREPPGYEQYF	TRBV6-3	TRBJ2-7
TGCGCCAGCAGCTTGGCTGTGTTGGGGGTTTACACTGAAGCTTTCTTT	CASSLAVLGVYTEAFF	TRBV5-1	TRBJ1-1
TGTGCCAGCAGTAGTCTGACAGGGGGGGGGACCGGGGAGCTGTTTTTT	CASSSLTGGGTGELFF	TRBV6-2	TRBJ2-2
TGTGCCTGGAGTGTATTAAACAGGGGAAGATGGGGCAATCAGCCCCAGCATTTT	CAWSVLNRGRWGNQPQHF	TRBV30	TRBJ1-5
TGTGCCAGCAGTTTCCCCCCTCCCTGGCTGCCCTACAATGAGCAGTTCTTC	CASSFPPPWLPYNEQFF	TRBV27	TRBJ2-1
TGTGCCAGCAGCCAGGGGGTTACCAAAAACATTCAGTACTTC	CASSQGVTKNIQYF	TRBV11-2	TRBJ2-4
TGTGCCAGCATTTACAGGGGCGAGCAGTACTTC	CASIYRGEQYF	TRBV6-5	TRBJ2-7
TGTGCCAGCAGCTTGGCCTTAGAATCATCAGAGACCCAGTACTTC	CASSLALESSETQYF	TRBV5-8	TRBJ2-5
TGTGCCAGCAGCTTAGCTTTTCCCAGGCGGAACTACGAGCAGTACTTC	CASSLAFPRRNYEQYF	TRBV7-4	TRBJ2-7
TGTGCCAGCAGCCAAGATCCCCAGGGGCGGAAAGGGGGTTATCAGCCCCAGCATTTT	CASSQDPQGRKGGYQPQHF	TRBV3-1	TRBJ1-5
TGTGCCAGCAACAAAACGGGACAGGGGGGGCCCCCAGCTTTCTTT	CASNKTGQGGPPAFF	TRBV6-1	TRBJ1-1
TGTGCCAGCAGCCTGGGGACAGGGGGCGCCTACGAGCAGTACTTC	CASSLGTGGAYEQYF	TRBV11-2	TRBJ2-7
TGTGCCAGCAGAAGCGACAGGGACGAGAAACACTCTGGGGCCAACGTCCTGACTTTC	CASRSDRDEKHSGANVLTF	TRBV7-2	TRBJ2-6
TGTGCCACCAGTGATATGGAGACAGGTGGGGGGCCTCCGGGCTGGGCCAAAAACATTCAGTACTTC	CATSDMETGGGPPGWAKNIQYF	TRBV24-1	TRBJ2-4
TGTGCCAACCAGGCTGGGGCATGCTATGGCTACACCTTC	CANQAGACYGYTF	TRBV6-1	TRBJ1-2
TGTGCCAGCAGCTTCCCCCCCGGGACAGCCGACACCATATATTTT	CASSFPPGTADTIYF	TRBV11-2	TRBJ1-3
TGTGCCAGCAGCGGGACAGGGCAAGGAAATCAGCCCCAGCATTTT	CASSGTGQGNQPQHF	TRBV7-6	TRBJ1-5
TGTGCCAGCAGCTTAAGGGTGCATCAGCCCCAGCATTTT	CASSLRVHQPQHF	TRBV7-8	TRBJ1-5
TGTGCCAGCAGCATGCAGGGACCCTATAATTCACCCCTCCACTTT	CASSMQGPYNSPLHF	TRBV7-3	TRBJ1-6
TGCGCCAGCAGCTTGCACCATCCGGACAGGGACAGAGGCTATGGCTACACCTTC	CASSLHHPDRDRGYGYTF	TRBV5-1	TRBJ1-2
TGTGCCAGCAGCTACACAGGGGGCGGGACCAATCAGCCCCAGCATTTT	CASSYTGGGTNQPQHF	TRBV2	TRBJ1-5
TGTGCCAGCAGCTTACCCCAAGACAGGGAGAGGCAGGACGAGCAGTACTTC	CASSLPQDRERQDEQYF	TRBV7-6	TRBJ2-7
TGTGCCACCAGCAGCTCCGGGACAGGGGAGCCGTCCCATCAGCCCCAGCATTTT	CATSSSGTGEPSHQPQHF	TRBV15	TRBJ1-5
TGTGCCAGCAGTTCCGGGGGGGCCGGCGGAGTCACAGATACGCAGTATTTT	CASSSGGAGGVTDTQYF	TRBV6-2	TRBJ2-3
TGTGCCAGCAGTGGAGAACTTCCGGGGACAGGATGTGGGGACTATGGCTACACCTTC	CASSGELPGTGCGDYGYTF	TRBV2	TRBJ1-2
TGCGGGACAGGGCTTACTGAAGCTTTCTTT	CGTGLTEAFF	TRBV20-1	TRBJ1-1
TGTGCCACCAGGTCCGGGACAGGGAAGTACGAGCAGTACTTC	CATRSGTGKYEQYF	TRBV24-1	TRBJ2-7
TGTGCCAGCAGCGGAGGCTCAGAGACCCAGTACTTC	CASSGGSETQYF	TRBV9	TRBJ2-5
TGTGCCAGCAGCTCCGGACTAGAGCGGGCCTACGAGCAGTACTTC	CASSSGLERAYEQYF	TRBV11-2	TRBJ2-7
TGTGCCAGCAGCGTGCGTCGCCCCAGGCCGCAGTTCTTC	CASSVRRPRPQFF	TRBV9	TRBJ2-1
TGTGCCAGCGCGAGGGGGCCCCCTAGGAACACCATATATTTT	CASARGPPRNTIYF	TRBV12-3	TRBJ1-3
TGTGCCAGCAGCCGGGAAGGCCGCAGCAATCAGCCCCAGCATTTT	CASSREGRSNQPQHF	TRBV12-3	TRBJ1-5
TGCGCCAGCTGGGGAGTACTAGCGGGAGGGCGTACCTACGAGCAGTACTTC	CASWGVLAGGRTYEQYF	TRBV5-1	TRBJ2-7
TGTGCCAGCAGGGGAGGGGACCCGGCACCCCTCCACTTT	CASRGGDPAPLHF	TRBV6-1	TRBJ1-6
TGTGCCAGCAGCTTAGGCTCCAGGACTCGGAAAAACATTCAGTACTTC	CASSLGSRTRKNIQYF	TRBV7-9	TRBJ2-4
TGCAGCGTTGATAGAGGACGATTCGGCTCCAATGAGCAGTTCTTC	CSVDRGRFGSNEQFF	TRBV29-1	TRBJ2-1
TGTGCCAGCAGTCCGGCGGACAGGGGATGCTATGGCTACACCTTC	CASSPADRGCYGYTF	TRBV6-4	TRBJ1-2
TGTGCCAGCAGCCAAAGGACTAGCGGGGGGGCCGCTTTCTACGAGCAGTACTTC	CASSQRTSGGAAFYEQYF	TRBV9	TRBJ2-7
TGTGCCAGCAGCTATCGTCCCGGGACTCTAGCTTTCTTT	CASSYRPGTLAFF	TRBV7-3	TRBJ1-1
TGCGCCGTCTTCGTGACAAGTCAGACCCAGTACTTC	CAVFVTSQTQYF	TRBV5-1	TRBJ2-5
TGTGCCATAGGGGAAGGGTACGAGCAGTACTTC	CAIGEGYEQYF	TRBV9	TRBJ2-7
TGTGCCAGCAGATGGACAGCATATAGCAATCAGCCCCAGCATTTT	CASRWTAYSNQPQHF	TRBV6-1	TRBJ1-5
TGTGCCAGCAGTTACACACCCTGGTCCCTCCACTTT	CASSYTPWSLHF	TRBV6-6	TRBJ1-6
TGTGCCAGCAGCTTAAAGGACAGGGAGACTGAAGCTTTCTTT	CASSLKDRETEAFF	TRBV7-9	TRBJ1-1
TGTGCCAGCAGCGTACACAGGTCGACCCAGTACTTC	CASSVHRSTQYF	TRBV13	TRBJ2-5
TGTGCCAGCAAAGGCTATGCCAAATTGATTCGACAGTCCCCAATCAACTATGGCTACACCTTC	CASKGYAKLIRQSPINYGYTF	TRBV28	TRBJ1-2
TGCAGCGTTACTACACCCTCAAGAACCCGCGACAATGAGCAGTTCTTC	CSVTTPSRTRDNEQFF	TRBV29-1	TRBJ2-1
TGCGCCAGCAGCTTGGTTGGGGGTCCTGTTAGAGACTACGAGCAGTACTTC	CASSLVGGPVRDYEQYF	TRBV5-1	TRBJ2-7
TGCGCCAGCCAAGTGAGCAGGGCGGGGGAGTACTTC	CASQVSRAGEYF	TRBV5-1	TRBJ2-7
TGTGCCAGCAGCTTGGAGGAACCGGAAACGGGATCCTACGAGCAGTACTTC	CASSLEEPETGSYEQYF	TRBV7-3	TRBJ2-7
TGTGCCAGCAGCTGGAGACGGCGCTACGAGCAGTACTTC	CASSWRRRYEQYF	TRBV7-6	TRBJ2-7
TGTGCCAGCAGTTTCTGGGCTCTCAATCAGCCCCAGCATTTT	CASSFWALNQPQHF	TRBV6-5	TRBJ1-5
TGTGCCAGCAGTGAAACCCGAGAGCAGTACTTC	CASSETREQYF	TRBV6-1	TRBJ2-7
TGTGCCAGCAGTGGCGAACAGGGCCCTGAGTACTTC	CASSGEQGPEYF	TRBV6-1	TRBJ2-4
TGTGCCAGCAGTGACCCTGGGGGGAGCTGGTACGAGCAGTACTTC	CASSDPGGSWYEQYF	TRBV6-4	TRBJ2-7
TGTGCCAGCTCTAATGTTAGAAGGGGGGGCGGTGGGGCCAACGTCCTGACTTTC	CASSNVRRGGGGANVLTF	TRBV18	TRBJ2-6
TGTGCCAGTAATTCCGGGACAGGGGCACGGGCTATGGATGAGCAGTTCTTC	CASNSGTGARAMDEQFF	TRBV19	TRBJ2-1
TGTTACAAATGCAATCAGCCCCAGCATTTT	CYKCNQPQHF	TRBV27	TRBJ1-5
TGTGCCAGCAGCCCACCGGGACAGGGCTCGGTCTCTGGAAACACCATATATTTT	CASSPPGQGSVSGNTIYF	TRBV7-6	TRBJ1-3
TGTGCCAGCAGTGATGGGACCATCCTAGAGACCCAGTACTTC	CASSDGTILETQYF	TRBV6-4	TRBJ2-5
TGCAGTGCTAGAGAGGGACAGGGCAAGTTTCGCTATGGCTACACCTTC	CSAREGQGKFRYGYTF	TRBV20-1	TRBJ1-2
TGTGCCTGGAGTGTAGAGGTGCCTCTCAGCCCCTCCTACGAGCAGTACTTC	CAWSVEVPLSPSYEQYF	TRBV30	TRBJ2-7
TGCAGTGCTCCGACAGGGGGGAGAGACCTGAACACTGAAGCTTTCTTT	CSAPTGGRDLNTEAFF	TRBV20-1	TRBJ1-1
TGTGCCAGTAGTTACCCTCCTGGGGAAGGGGTCTATGGCTACACCTTC	CASSYPPGEGVYGYTF	TRBV19	TRBJ1-2
TGCATTCTGGGGGACAGCACTTGCAATCAGCCCCAGCATTTT	CILGDSTCNQPQHF	TRBV29-1	TRBJ1-5
TGTGCCAGCAGAAAGGATTACCTTGGGTCATTTTACTTC	CASRKDYLGSFYF	TRBV6-4	TRBJ1-2
TGTGCCAGCTCACCACCGGTCGTCCAAGGGGCCGGTTCCCAGTACTTC	CASSPPVVQGAGSQYF	TRBV18	TRBJ2-5
TGTGATACGACAGGAAACACCATATATTTT	CDTTGNTIYF	TRBV28	TRBJ1-3
TGTGCCAGCAGCTTTCGTTGTCCGGAGGTGGAGGCGAACACCGGGGAGCTGTTTTTT	CASSFRCPEVEANTGELFF	TRBV7-6	TRBJ2-2
TGTGCCAGCAGTTACTCTACCGGGGAGACTAGCGGGAGGGCGCGGCACAATGAGCAGTTCTTC	CASSYSTGETSGRARHNEQFF	TRBV27	TRBJ2-1
TGTGCCAGCAGCGCGGACAGGACCGTTTGGCCTGGAAACACCATATATTTT	CASSADRTVWPGNTIYF	TRBV13	TRBJ1-3
TGTGCCAGCAACAGAGGCTATGGCTACACCTTC	CASNRGYGYTF	TRBV13	TRBJ1-2
TGTGCCATCGAGACAGGCGATATTGATGAAAAACTGTTTTTT	CAIETGDIDEKLFF	TRBV27	TRBJ1-4
TGTGCCAGCAGTGAGGAGGGGACGGTTGCTTTCTTT	CASSEEGTVAFF	TRBV6-4	TRBJ1-1
TGTGCCAGCAGTGACCGAAAGACAGGGTATGGCTACACCTTC	CASSDRKTGYGYTF	TRBV6-4	TRBJ1-2
TGTGCCAGCGACCGGGACAGGGACACTGAAGCTTTCTTT	CASDRDRDTEAFF	TRBV28	TRBJ1-1
TGTGCCAGCAGCGTAGGCGCTCGGTACTCCTACAATGAGCAGTTCTTC	CASSVGARYSYNEQFF	TRBV9	TRBJ2-1
TGTGCCAGCACCCTTCATCAGGGCACCTACGAGCAGTACTTC	CASTLHQGTYEQYF	TRBV11-3	TRBJ2-7
TGTGCCAGCAGCCCAATTCCAGGGGATGAGCAGTTCTTC	CASSPIPGDEQFF	TRBV25-1	TRBJ2-1
TGCGCCAGCAGTGAGGGTCCGGGGGGGGGGAACACTGAAGCTTTCTTT	CASSEGPGGGNTEAFF	TRBV10-1	TRBJ1-1
TGTGCCAGCAGCTTAGCGGGGAGCAAAAACATTCAGTACTTC	CASSLAGSKNIQYF	TRBV11-3	TRBJ2-4
TGTGCCTATCACAGGGGTTGGCCCTCACCCCTCCACTTT	CAYHRGWPSPLHF	TRBV19	TRBJ1-6
TGCAGCGTATTCGGGGCGGGAAGGAATCAGCCCCAGCATTTT	CSVFGAGRNQPQHF	TRBV29-1	TRBJ1-5
TGTGCCAGCAGTAGTACATGCCAACAGCCCCAGCATTTT	CASSSTCQQPQHF	TRBV27	TRBJ1-5
TGTGCCAGCAGCCAAGGGCGGCGTTCAGGGGCTAATGAAAAACTGTTTTTT	CASSQGRRSGANEKLFF	TRBV14	TRBJ1-4
TGTGCCAGGGCGCCGGACCCCCTGGATCAGCCCCAGCATTTT	CARAPDPLDQPQHF	TRBV6-5	TRBJ1-5
TGTGCCAGCAGCACCGGACAGCCACATGGCACTGAAGCTTTCTTT	CASSTGQPHGTEAFF	TRBV7-3	TRBJ1-1
TGTGCCAGCAGTGGCGGCCGTAAAAACACCGGGGAGCTGTTTTTT	CASSGGRKNTGELFF	TRBV6-6	TRBJ2-2
TGCGCCAGCAGCTTATACTCCAGGGCAGCTTACGAGCAGTACTTC	CASSLYSRAAYEQYF	TRBV4-3	TRBJ2-7
TGTGCCAGCAGCTGGTCCATCCCCACATTTAACAACACTGAAGCTTTCTTT	CASSWSIPTFNNTEAFF	TRBV5-6	TRBJ1-1
TGTGCCAGTAGTATAGCGGGTCTCCGAACGCAGTATTTT	CASSIAGLRTQYF	TRBV19	TRBJ2-3
TGTGCCAGCAGCCCGGGACAGGGGCTATTTAGCACTGTTGGAAACACCATATATTTT	CASSPGQGLFSTVGNTIYF	TRBV7-6	TRBJ1-3
TGTGCCAGCAGCTTAGGACCACAGACCCCGAAGCGAAAGCCCGGCTACACCTTC	CASSLGPQTPKRKPGYTF	TRBV11-2	TRBJ1-2
TGTGCCAGCAGCCTCTCTGGGGCCAACGTCCTGACTTTC	CASSLSGANVLTF	TRBV11-3	TRBJ2-6
TGTGCCAGCAGTTTAGACCGGGACAGGGCAGAGACCCAGTACTTC	CASSLDRDRAETQYF	TRBV28	TRBJ2-5
TGTGCCCAGATCTCCTACAATGAGCAGTTCTTC	CAQISYNEQFF	TRBV19	TRBJ2-1
TGTGCCAGCAGTTTAGTTCAAGGGAGTACTTGGGATAATGAAAAACTGTTTTTT	CASSLVQGSTWDNEKLFF	TRBV28	TRBJ1-4
TGTGCCAGCAGCGTAGCGGGGGATGAGCAGTTCTTC	CASSVAGDEQFF	TRBV13	TRBJ2-1
TGTGCCAGCAGCTCTGGGACAGGGGGTGCTGGAAACACCATATATTTT	CASSSGTGGAGNTIYF	TRBV5-6	TRBJ1-3
TGTGCCATCAAGGGGACAGGGCCCCCGGCCAAAGCGAACACCGGGGAGCTGTTTTTT	CAIKGTGPPAKANTGELFF	TRBV10-3	TRBJ2-2
TGTGCCAGCAGTCCCCCGGGCTGCAATGAGCAGTTCTTC	CASSPPGCNEQFF	TRBV6-8	TRBJ2-1
TGCGCCAGCAGCTTGGTGACCCGGACCTCTGGGGACTACAATGAGCAGTTCTTC	CASSLVTRTSGDYNEQFF	TRBV5-1	TRBJ2-1
TGCGCCAGCAGGAGGGATCAGCCCCAGCATTTT	CASRRDQPQHF	TRBV5-1	TRBJ1-5
TGTGCCAGCAGCTTGTCACCCAGGGGTAGCAATCAGCCCCAGCATTTT	CASSLSPRGSNQPQHF	TRBV5-8	TRBJ1-5
TGTGCCAGCTCAGAGAGCCGATGTAGTCTGACCTACAATGAGCAGTTCTTC	CASSESRCSLTYNEQFF	TRBV18	TRBJ2-1
TGCGCCAGCAGCTTGACGCGGACTAATGAAAAACTGTTTTTT	CASSLTRTNEKLFF	TRBV5-1	TRBJ1-4
TGTGCCGAGCGGGACTGGGGGGAGCTGTTTTTT	CAERDWGELFF	TRBV5-5	TRBJ2-2
TGTGCCAGCAGCTCTTACTGGAGCGACTCCTACGAGCAGTACTTC	CASSSYWSDSYEQYF	TRBV5-6	TRBJ2-7
TGTGCCAGCAGGTCAGGACGTACCTACGAGCAGTACTTC	CASRSGRTYEQYF	TRBV7-6	TRBJ2-7
TGTGCCAGCCGTCCGGACAGGGGGGATGAGCAGTTCTTC	CASRPDRGDEQFF	TRBV27	TRBJ2-1
TGTGCCAGCAGAACCTCTCACAGGGTGGGCTCTGGGGCCAACGTCCTGACTTTC	CASRTSHRVGSGANVLTF	TRBV5-6	TRBJ2-6
TGTGCCAGCAGCGATCCCCGGGGGGGCCGTAACAATGAGCAGTTCTTC	CASSDPRGGRNNEQFF	TRBV5-5	TRBJ2-1
TGTGCCAGCACGCACAGGGGTCGCAATCAGCCCCAGCATTTT	CASTHRGRNQPQHF	TRBV27	TRBJ1-5
TGCGCCAGCAGCCAAGATACGCAGGGAGTTGCCTGGGTCGAAAAACTGTTTTTT	CASSQDTQGVAWVEKLFF	TRBV4-1	TRBJ1-4
TGTGCCACCAGTGCTGTGATTACGGGACAGGGTGGGACACGACAGAACACCGGGGAGCTGTTTTTT	CATSAVITGQGGTRQNTGELFF	TRBV24-1	TRBJ2-2
TGTGCCAGCAGCCGTTTCTCAGGGCTGGTCTATGGCTACACCTTC	CASSRFSGLVYGYTF	TRBV11-2	TRBJ1-2
TGTGCCTGGAGTCGGCGCATGGGGTGCACTGAAGCTTTCTTT	CAWSRRMGCTEAFF	TRBV30	TRBJ1-1
TGTGTACAATGGGGGGAGCTGTTTTTT	CVQWGELFF	TRBV14	TRBJ2-2
TGTGCTAGTGGGACAGGTAAGAGGAACACTGAAGCTTTCTTT	CASGTGKRNTEAFF	TRBV12-5	TRBJ1-1
TGTGCCGGGACATTATCAAGGCCAGATACGCAGTATTTT	CAGTLSRPDTQYF	TRBV19	TRBJ2-3
TGTGCCAGCAGCTGTCAACACGAGTCTTTAAACCACACTGAAGCTTTCTTT	CASSCQHESLNHTEAFF	TRBV5-6	TRBJ1-1
TGTGCCCAGGGGAACAGAGGTAGCACAGATACGCAGTATTTT	CAQGNRGSTDTQYF	TRBV28	TRBJ2-3
TGTGCCAGCAGCGTACACAGGGGGCGGTACGAGCAGTACTTC	CASSVHRGRYEQYF	TRBV5-8	TRBJ2-7
TGCAGTGCCAGCCCGGCAGATACGCAGTATTTT	CSASPADTQYF	TRBV20-1	TRBJ2-3
TGTGCCACCAGCAGAGATCGGAGGGACAGGAGGAAAAACTATGGCTACACCTTC	CATSRDRRDRRKNYGYTF	TRBV15	TRBJ1-2
TGTGCCAGCGCACCCCCTATTGGTCTAGGGACTAGCGGGCCGGGGACGAACACCGGGGAGCTGTTTTTT	CASAPPIGLGTSGPGTNTGELFF	TRBV5-6	TRBJ2-2
TGTGCCAGCAGCGTACAGTATAGCAATCAGCCCCAGCATTTT	CASSVQYSNQPQHF	TRBV7-2	TRBJ1-5
TGCAGCGTGCCGGAAAGACATAGCAATCAGCCCCAGCATTTT	CSVPERHSNQPQHF	TRBV29-1	TRBJ1-5
TGTGCCAGCAGCCTCCGACAGGGGGGAAACATTCAGTACTTC	CASSLRQGGNIQYF	TRBV14	TRBJ2-4
TGTGCCAGCAGAGGGACTAGCGGGGGCGCCTACGAGCAGTACTTC	CASRGTSGGAYEQYF	TRBV27	TRBJ2-7
TGTGCCAGCAGCCAAGAGGCGTTGGACCCCTACGAGCAGTACTTC	CASSQEALDPYEQYF	TRBV3-1	TRBJ2-7
TGTGCCAGCAGCTGTGGGGCCCTAGGGGATACGCAGTATTTT	CASSCGALGDTQYF	TRBV7-3	TRBJ2-3
TGCAGCGTTGATCCTAGCGGGGGGGCACGATTGAATGAGCAGTTCTTC	CSVDPSGGARLNEQFF	TRBV29-1	TRBJ2-1
TGTGCCAAACGGGGGCGAGATTCTGGGGCCAACGTCCTGACTTTC	CAKRGRDSGANVLTF	TRBV19	TRBJ2-6
TGTGCCAGCAGCTTAGAGGACGTACCGGGTAGCAATCAGCCCCAGCATTTT	CASSLEDVPGSNQPQHF	TRBV11-2	TRBJ1-5
TGCGCCAGCAGCCAAGATTATATAGGGGGGCTCGGCTACACCTTC	CASSQDYIGGLGYTF	TRBV4-1	TRBJ1-2
TGTGCCAGCAGCCAAGACGGCCAGGGAGGGTTCCGGGTCGGTACGCAGTATTTT	CASSQDGQGGFRVGTQYF	TRBV3-1	TRBJ2-3
TGCGCCAGCAGCTTGGAAGTCGAGCTCAGTTTGCCTGAAGCTTTCTTT	CASSLEVELSLPEAFF	TRBV5-1	TRBJ1-1
TGTGCCAGCAGAGTTATAGCGGGGGAGCAGTTCTTC	CASRVIAGEQFF	TRBV6-2	TRBJ2-1
TGTGCTAGTGGTTTGCCGAGAATTAACTATGGCTACACCTTC	CASGLPRINYGYTF	TRBV12-5	TRBJ1-2
TGTGCCAGCAGTTACTCAGCTCCCCGACAGGGGGCTAAAAACACTGAAGCTTTCTTT	CASSYSAPRQGAKNTEAFF	TRBV6-2	TRBJ1-1
TGTGCCAGCAGCTCCATAAGGCGACAGGGGACCGGGGAGCTGTTTTTT	CASSSIRRQGTGELFF	TRBV9	TRBJ2-2
TGTGCCACCTTAGAGGGCCCCCTCCACTTT	CATLEGPLHF	TRBV6-1	TRBJ1-6
TGTGCCAGCAGCGGTTATGACAGAACGGGGGCTGGGGCCAACGTCCTGACTTTC	CASSGYDRTGAGANVLTF	TRBV5-4	TRBJ2-6
TGTGCCAGCAACCAACCGGGACTAGCGGGAGGGGAGTACTTC	CASNQPGLAGGEYF	TRBV6-4	TRBJ2-7
TGTGCCAGCAGCTTAGACATTTCCGGGACATCTCTCGAACGCTACGAGCAGTACTTC	CASSLDISGTSLERYEQYF	TRBV11-3	TRBJ2-7
TGTGCCAGCAGCTTGGTTGTGGGACAGGGACTGCGACAGCCCCAGCATTTT	CASSLVVGQGLRQPQHF	TRBV5-4	TRBJ1-5
TGTGCCAGCAGCCAAGGCGCGGGGGGCGAGCAGTACTTC	CASSQGAGGEQYF	TRBV3-1	TRBJ2-7
TGTGCTAGTGGTCAGGTCCTAACAGGGACCAGCTATGGCTACACCTTC	CASGQVLTGTSYGYTF	TRBV12-5	TRBJ1-2
TGCGCCAGCAGCCAAAAAACGGTAGAAACGCCTCCGACAGGGGTGAGCGAGTATTTT	CASSQKTVETPPTGVSEYF	TRBV4-3	TRBJ2-3
TGTGCCACCATAGCGGAAGGACAAGAGACCCAGTACTTC	CATIAEGQETQYF	TRBV27	TRBJ2-5
TGCGCCAGCAGTGGCGCGGTCCCCCCAACGAACGAGCAGTACTTC	CASSGAVPPTNEQYF	TRBV10-1	TRBJ2-7
TGTGCCAGCAGTTACCGGACGCTCGCCAATCAGCCCCAGCATTTT	CASSYRTLANQPQHF	TRBV6-2	TRBJ1-5
TGTGCCAGCAGCCAGGACAGGGGCTACTACGAGCAGTACTTC	CASSQDRGYYEQYF	TRBV7-3	TRBJ2-7
TGTGCCAGCAGGCGAGGCTACACCTTC	CASRRGYTF	TRBV6-3	TRBJ1-2
TGTGCCAGCAGCAACCTTGATACGCAGTATTTT	CASSNLDTQYF	TRBV7-8	TRBJ2-3
TGTGCCAGCATGGATTGCAACGGACAGTATGGAGAAGAGACCCAGTACTTC	CASMDCNGQYGEETQYF	TRBV5-4	TRBJ2-5
TGTGCCAGCAGCTTAAGTGTTAGATTTCCGGATGGGACCGGGGAGCTGTTTTTT	CASSLSVRFPDGTGELFF	TRBV7-3	TRBJ2-2
TGTGCCACCAGCATCACAGGGGGCCAGGAAACTGAAGCTTTCTTT	CATSITGGQETEAFF	TRBV15	TRBJ1-1
TGTGCCAGCAGCTTAGGGTTGATGGGGCAATACAATGAGCAGTTCTTC	CASSLGLMGQYNEQFF	TRBV7-8	TRBJ2-1
TGCGCCAGCAGCTACACGGCAGGGTATCCAGATACGCAGTATTTT	CASSYTAGYPDTQYF	TRBV5-1	TRBJ2-3
TGTGCCAGCAAATCCAGGGGTCGAAACTATGGCTACACCTTC	CASKSRGRNYGYTF	TRBV6-1	TRBJ1-2
TGCAGTGCATCGGGGACGAACACTGAAGCTTTCTTT	CSASGTNTEAFF	TRBV20-1	TRBJ1-1
TGTGCCAGCAGCATGAGGGACATTTCATACAATGAGCAGTTCTTC	CASSMRDISYNEQFF	TRBV6-2	TRBJ2-1
TGTGCCAGCAGTTTACCCGGGACAGGGGATGAGCAGTTCTTC	CASSLPGTGDEQFF	TRBV27	TRBJ2-1
TGTGCCAGCAGCCTGCTAGCGGGATTTGGCGGGCTATTGGCTTGGGAGAGCTCCTACAATGAGCAGTTCTTC	CASSLLAGFGGLLAWESSYNEQFF	TRBV5-4	TRBJ2-1
TGCAGTGCTTTTGGGACTAGCGGGAGCACAGATACGCAGTATTTT	CSAFGTSGSTDTQYF	TRBV20-1	TRBJ2-3
TGTGCCAGCAGCTTAAGACCCAGAAGGACGGGCCTCTACGAGCAGTACTTC	CASSLRPRRTGLYEQYF	TRBV11-1	TRBJ2-7
TGTGCCAGCAGCCAAGGGGCAGGGGAGGGCTACGAGCAGTACTTC	CASSQGAGEGYEQYF	TRBV5-6	TRBJ2-7
TGTGCCAGCAGGCGGCAGGGGGAGGTGAACACTGAAGCTTTCTTT	CASRRQGEVNTEAFF	TRBV28	TRBJ1-1
TGTGCCCTATATAGGGGGAGCTCTAACTATGGCTACACCTTC	CALYRGSSNYGYTF	TRBV7-8	TRBJ1-2
TGTGCCAGCAGTCGGACCAATTCGACAGGGAGTGGGTATGGCTACACCTTC	CASSRTNSTGSGYGYTF	TRBV13	TRBJ1-2
TGTGCCAGCAGCTCCCGGGACAGAGGGACCCAGTACTTC	CASSSRDRGTQYF	TRBV5-4	TRBJ2-5
TGCGCCAGCAGTGCCCAAATGAAGGGGGGCTTTGAAACCGGGGAGCTGTTTTTT	CASSAQMKGGFETGELFF	TRBV5-1	TRBJ2-2
TGTGCCAGCCGAAGGCGAGGGAAGAGTCAGCCCCAGCATTTT	CASRRRGKSQPQHF	TRBV6-5	TRBJ1-5
TGCAGTGCTAAATCGTCAGGGGTTGAGGGGCCCTACGAGCAGTACTTC	CSAKSSGVEGPYEQYF	TRBV20-1	TRBJ2-7
TGTGCCAGCAGCCGGTGGAGGAACACTGAAGCTTTCTTT	CASSRWRNTEAFF	TRBV14	TRBJ1-1
TGTGCCAGCAGCCCGGTATCCGGGACGAGGGAAGAGACCCAGTACTTC	CASSPVSGTREETQYF	TRBV7-8	TRBJ2-5
TGCGCCAGCAGCCCAAAGTTCCAGGGGGAGCTGTTTTTT	CASSPKFQGELFF	TRBV4-3	TRBJ2-2
TGCAGTGCTAGAGATGACAGGGGGCACAAGATCATTAACGAGCAGTACTTC	CSARDDRGHKIINEQYF	TRBV20-1	TRBJ2-7
TGTGCCAGCAGGGTATATACAGGGTACCTCCACTTT	CASRVYTGYLHF	TRBV28	TRBJ1-6
TGTGCCATCAGTGGCACCCGTCTAGCGGGGGGCCGCTACGAGCAGTACTTC	CAISGTRLAGGRYEQYF	TRBV10-3	TRBJ2-7
TGTGCCAGCAGCACGGACATAAGCCTTATGATACGCCAAGAGACCCAGTACTTC	CASSTDISLMIRQETQYF	TRBV13	TRBJ2-5
TGTGCTAGTGGTTTGGAACTCCTCTTTAGTGGAGGCAATCAGCCCCAGCATTTT	CASGLELLFSGGNQPQHF	TRBV12-5	TRBJ1-5
TGTGCCAGCAGTAAGGGACAGGGGAACACCGGGGAGCTGTTTTTT	CASSKGQGNTGELFF	TRBV27	TRBJ2-2
TGCGCCAGCAGCTTTTTTAGAGCGTCAATAGGCTACACCTTC	CASSFFRASIGYTF	TRBV5-1	TRBJ1-2
TGCGCCAGCAGATATTCCTATAGCGGGAAGACCCTCACAGATACGCAGTATTTT	CASRYSYSGKTLTDTQYF	TRBV5-1	TRBJ2-3
TGTGCCAGCTCCGCGGGACTAGCGCAGACCCAGTACTTC	CASSAGLAQTQYF	TRBV6-1	TRBJ2-5
TGTGCCAGGATGGGCCTGGAAAGTCCCCTTTCAGACAGATACAATCAGCCCCAGCATTTT	CARMGLESPLSDRYNQPQHF	TRBV10-3	TRBJ1-5
TGCGCCAGCTCCCCCGGCGGAGCGTTGGAGACCCAGTACTTC	CASSPGGALETQYF	TRBV10-1	TRBJ2-5
TGCAGTGCCCCAGAGGGACAGGGGGCCTCGCAGTACTTC	CSAPEGQGASQYF	TRBV20-1	TRBJ2-7
TGTGCCATCAGTCCGTCTAGCGGGCTCTACGAGCAGTACTTC	CAISPSSGLYEQYF	TRBV10-3	TRBJ2-7
TGTGCCAGCAGTGACCTACAGTTCCGGAACAGGGGGCGCTACGAGCAGTACTTC	CASSDLQFRNRGRYEQYF	TRBV6-1	TRBJ2-7
TGTGCCAGCAGCTTTCTACGGTGGACAGGGTTACGGAAAAACATTCAGTACTTC	CASSFLRWTGLRKNIQYF	TRBV11-3	TRBJ2-4
TGTGCCAGCAGTGACCGTGAATCACCCCTCCACTTT	CASSDRESPLHF	TRBV6-4	TRBJ1-6
TGTGCCTGGATCAAACCAACTAGCGGGAGAAGGGGGGCTTTCTTT	CAWIKPTSGRRGAFF	TRBV30	TRBJ1-1
TGTGCCAGCGGACGGGGGATCGAGACCCAGTACTTC	CASGRGIETQYF	TRBV7-3	TRBJ2-5
TGTGCCATCAGTGAGGCCAGAGATTTGCCAACTAATGAAAAACTGTTTTTT	CAISEARDLPTNEKLFF	TRBV10-3	TRBJ1-4
TGCGCCAGCAGCGACCTCCCCGAAGCGTCCACAGATACGCAGTATTTT	CASSDLPEASTDTQYF	TRBV5-1	TRBJ2-3
TGTGCCAGCAGTTCGGGGCCGGGGGCTTTCTTT	CASSSGPGAFF	TRBV12-4	TRBJ1-1
TGTGCCAGCAGCCAAGAAGGGACAAGGCACCCTGTGGGGTCCAATGAGCAGTTCTTC	CASSQEGTRHPVGSNEQFF	TRBV4-2	TRBJ2-1
TGTGCCAGCAGCTTAGGGACAGGGCCCTCCTACGAGCAGTACTTC	CASSLGTGPSYEQYF	TRBV7-2	TRBJ2-7
TGTGCCAGCAGCCCGGTCAATAGGGAAACCTGCACTGAAGCTTTCTTT	CASSPVNRETCTEAFF	TRBV7-3	TRBJ1-1
TGTGCCACCAGTTCAAAGATCCACGAGAAGCGGGCGAACACCGGGGAGCTGTTTTTT	CATSSKIHEKRANTGELFF	TRBV24-1	TRBJ2-2
TGTGCCAGCATCGAGACTGGCACAGATACGCAGTATTTT	CASIETGTDTQYF	TRBV5-6	TRBJ2-3
TGTGCCACCAGTGATTGCCCGACAGGACAGACCGGCTACACCTTC	CATSDCPTGQTGYTF	TRBV24-1	TRBJ1-2
TGTGCCTGGAGTGTTCCAGGGGGCGTAGATGGCTACACCTTC	CAWSVPGGVDGYTF	TRBV30	TRBJ1-2
TGCAGTGCTAGCCCCCGTACGGGGGCAGACAGAGAGACCCAGTACTTC	CSASPRTGADRETQYF	TRBV20-1	TRBJ2-5
TGTGCCAGCAGCTGTCGGTGCCACAAATACGAGCAGTACTTC	CASSCRCHKYEQYF	TRBV13	TRBJ2-7
TGTGCCAGCCTATCCGAGCCCGGGAGGACTGAAGCTTTCTTT	CASLSEPGRTEAFF	TRBV13	TRBJ1-1
TGTGCCAGCAGCTCAGTCTCGCCGGGGGGGGGGGAGCTGTTTTTT	CASSSVSPGGGELFF	TRBV11-3	TRBJ2-2
TGTGCCAGCATTCGAGTCTACAATGAGCAGTTCTTC	CASIRVYNEQFF	TRBV27	TRBJ2-1
TGTGCCAGCAGCCAAGACATTCAGGGTTATGAGCAGTACTTC	CASSQDIQGYEQYF	TRBV14	TRBJ2-7
TGTGCCAGCAGTGAAGACTTTGGGATGTTTCCCTCCTACGAGCAGTACTTC	CASSEDFGMFPSYEQYF	TRBV6-1	TRBJ2-7
TGCGCCAGCAGCCACAGGGAAGATAGCAATCAGCCCCAGCATTTT	CASSHREDSNQPQHF	TRBV4-1	TRBJ1-5
TGTGCCAGCAGTGTGAAGTCCTGGGGCGGTGAGCAGTTCTTC	CASSVKSWGGEQFF	TRBV6-1	TRBJ2-1
TGTGCCAGCAGCTGTAAACGGTGGACAGGGAAGGCTGGAAACACCATATATTTT	CASSCKRWTGKAGNTIYF	TRBV14	TRBJ1-3
TGTGCCAGCAGTCGCAGTGGGAGAAGATACAACTTC	CASSRSGRRYNF	TRBV28	TRBJ2-7
TGTGCCAGCAGCTTAGGGCGCAGCTGGGGGCCCCGAAATGAAAAACTGTTTTTT	CASSLGRSWGPRNEKLFF	TRBV7-3	TRBJ1-4
TGTGCCAGCAGCCTAGCGATCAATGAGCAGTTCTTC	CASSLAINEQFF	TRBV7-3	TRBJ2-1
TGTGCCAGCAGGCTGGATCTCAGACAGGAGACCCAGTACTTC	CASRLDLRQETQYF	TRBV27	TRBJ2-5
TGCGCCAGAAGCAATAGACAGGGACCCGGGAATCAGCCCCAGCATTTT	CARSNRQGPGNQPQHF	TRBV5-1	TRBJ1-5
TGTGCCAGCAGCCAAGGCCACAGGGCATACAATGAGCAGTTCTTC	CASSQGHRAYNEQFF	TRBV3-1	TRBJ2-1
TGCGCCTCTATTTCAGATACGCAGTATTTT	CASISDTQYF	TRBV10-2	TRBJ2-3
TGCGCCAGCAGTGGACCCATGGACAGGGGTCCATGTAACTATGGCTACACCTTC	CASSGPMDRGPCNYGYTF	TRBV10-2	TRBJ1-2
TGCGCCAGCAGCCAAGGGAAACCCCCAGGACAGGCTGTGGTCGCCGAGCAGTACTTC	CASSQGKPPGQAVVAEQYF	TRBV4-1	TRBJ2-7
TGTGCCAGCAGCTTGGGGCCACAGGGGGCGGTCACTGAAGCTTTCTTT	CASSLGPQGAVTEAFF	TRBV7-9	TRBJ1-1
TGTGCCAGCAGTGACCCTCACCTATCTTTGCCGCAGTACTTC	CASSDPHLSLPQYF	TRBV6-4	TRBJ2-7
TGTGCCAGCAGTGAATTAGAAGCCCCCGGGCACTATGATGGCTACACCTTC	CASSELEAPGHYDGYTF	TRBV2	TRBJ1-2
TGTGCCAGCAGGGGGGGGGGGGGCACAGATACGCAGTATTTT	CASRGGGGTDTQYF	TRBV6-5	TRBJ2-3
TGTGCCTGGAGTGTATGGATCAGGAGACCCTACAATGAGCAGTTCTTC	CAWSVWIRRPYNEQFF	TRBV30	TRBJ2-1
TGTGCCAGCCCGGAGGCTAGGTACGAGCAGTACTTC	CASPEARYEQYF	TRBV7-9	TRBJ2-7
TGTGCCAGCAGCTCGGGGAGGGGATGCGGGGAGCTGTTTTTT	CASSSGRGCGELFF	TRBV11-3	TRBJ2-2
TGTGCCAGCAGTGAAGCGCCGGGTAGTCCGTCCCCAGAAGTTGAAACCAAAAACATTCAGTACTTC	CASSEAPGSPSPEVETKNIQYF	TRBV2	TRBJ2-4
TGTGCCTGGAGTCCCCCCGGCCGAATCGAGCAGTTCTTC	CAWSPPGRIEQFF	TRBV30	TRBJ2-1
TGTGCCAGCAGTTATGAGAAACCGCGGGAGCTAGGGAATGAGCAGTTCTTC	CASSYEKPRELGNEQFF	TRBV6-5	TRBJ2-1
TGTGCCAGCAGCACTACCCACAGGGATGAAAAACTGTTTTTT	CASSTTHRDEKLFF	TRBV6-6	TRBJ1-4
TGTGCCAGCAGGGGTCTCGTCCTGACTTTC	CASRGLVLTF	TRBV6-5	TRBJ2-6
TGCGCCAACAGGGGGCCCATGAACACTGAAGCTTTCTTT	CANRGPMNTEAFF	TRBV4-3	TRBJ1-1
TGTGCCAGCGCAGGTAGAACTGAAAAACTGTTTTTT	CASAGRTEKLFF	TRBV7-2	TRBJ1-4
TGCGCCAGCAGCCAAGGTTCGGGAGGCAACAATGGGGCAAGGGCAGATACGCAGTATTTT	CASSQGSGGNNGARADTQYF	TRBV4-1	TRBJ2-3
TGTGCCACGGCCTGTGGGACAGCGGGCCTCCGCCATTACAATGAGCAGTTCTTC	CATACGTAGLRHYNEQFF	TRBV6-4	TRBJ2-1
TGTGCCAGTAGTATAGCCATGTTTCGGCCGAATGAGCAGTTCTTC	CASSIAMFRPNEQFF	TRBV19	TRBJ2-1
TGTGCCAGCAGTTCTCGCAGAATGAACCATCAGCCCCAGCATTTT	CASSSRRMNHQPQHF	TRBV6-3	TRBJ1-5
TGTGCCAGCAGGATTCTTGGGGATAAAACTAGCGGGAGGGCTTGCTACGAGCAGTACTTC	CASRILGDKTSGRACYEQYF	TRBV6-3	TRBJ2-7
TGTGCCAGCACATCTCAGAACGCTTTCTTT	CASTSQNAFF	TRBV6-6	TRBJ1-1
TGCGCCACCCCCGGGAACGAGCAGTACTTC	CATPGNEQYF	TRBV10-1	TRBJ2-7
TGTGCCATCCAGTGGGCCCCAGTTGGAAGGAACACTGAAGCTTTCTTT	CAIQWAPVGRNTEAFF	TRBV9	TRBJ1-1
TGTGCCACCAGCAGAGCCGGGGTCTACGAGCAGTACTTC	CATSRAGVYEQYF	TRBV15	TRBJ2-7
TGCAGCGCCTCCCAGGGTGAGCAGTACTTC	CSASQGEQYF	TRBV29-1	TRBJ2-7
TGTGCCCGGGCGCCTGGCAATCAGCCCCAGCATTTT	CARAPGNQPQHF	TRBV19	TRBJ1-5
TGTGCCAGCAGCCAAGATGAATTAGGGGTGGACACTATGAACACTGAAGCTTTCTTT	CASSQDELGVDTMNTEAFF	TRBV4-2	TRBJ1-1
TGTGCCAGCAGCCACAAGGACATAGGGTTATTTGGTTATAATTCACCCCTCCACTTT	CASSHKDIGLFGYNSPLHF	TRBV7-3	TRBJ1-6
TGTGCCAGTAGTATAGGCGGGTCTCAAAACATTCAGTACTTC	CASSIGGSQNIQYF	TRBV19	TRBJ2-4
TGCAGTGCTAGTCCTGTCTCCCCGAGGGGCAAAACTAAACATGAAAAACTGTTTTTT	CSASPVSPRGKTKHEKLFF	TRBV20-1	TRBJ1-4
TGTGCCAGCAGCCAAGCCGGGACTAGCGGGGATGAGCAGTTCTTC	CASSQAGTSGDEQFF	TRBV3-1	TRBJ2-1
TGTGCCAGCTCACCACAAGACGTTAAGTATTTT	CASSPQDVKYF	TRBV18	TRBJ2-3
TGCGCCAGCAGTGAGTCCCGGGACAGGGGGGATGAAGCTTTCTTT	CASSESRDRGDEAFF	TRBV10-2	TRBJ1-1
TGTGCCAGCAGCTTACTAGGCCAAGGCGAGCAGTACTTC	CASSLLGQGEQYF	TRBV11-2	TRBJ2-7
TGTGCCAGCAGTTTATCGGTACGCAAAAAAAAGTTGAACACCGGGGAGCTGTTTTTT	CASSLSVRKKKLNTGELFF	TRBV28	TRBJ2-2
TGTGCCACCAGGGGGTCTGCTAATGAAAAACTGTTTTTT	CATRGSANEKLFF	TRBV24-1	TRBJ1-4
TGCAGTGCTAGGGGTAGAGGGGAGACCCAGTACTTC	CSARGRGETQYF	TRBV20-1	TRBJ2-5
TGTGCCAGCGGGACAGAGGGGACCGGGGAGCTGTTTTTT	CASGTEGTGELFF	TRBV19	TRBJ2-2
TGTGCCAGCAGTTCCTCCGGGACAGGGCCCACTGAAGCTTTCTTT	CASSSSGTGPTEAFF	TRBV27	TRBJ1-1
TGTGCCAGCAGCTTAGCTCCATGTAGCGGGACCCCGTGGAGCTCCTACAATGAGCAGTTCTTC	CASSLAPCSGTPWSSYNEQFF	TRBV7-9	TRBJ2-1
TGTGCCAGCAGCTTAGCCGGATGGGGACAGAATGAAAAACTGTTTTTT	CASSLAGWGQNEKLFF	TRBV7-4	TRBJ1-4
TGCAGTGCTAGAGTCTGGAGGGGTAGAGCGTACAACGTCTACAATGAGCAGTTCTTC	CSARVWRGRAYNVYNEQFF	TRBV20-1	TRBJ2-1
TGTGCCAGCAGCGCCTGGAAAAACCAGTGGCGAAACGCCAAAAACATTCAGTACTTC	CASSAWKNQWRNAKNIQYF	TRBV7-9	TRBJ2-4
TGTGCCAGCAGCTCACGGACAGGGGGCCCATCGAATGAAAAACTGTTTTTT	CASSSRTGGPSNEKLFF	TRBV5-6	TRBJ1-4
TGTGCCAGCAGCTTAGGGGTAGACATAATTAACGAGCAGTACTTC	CASSLGVDIINEQYF	TRBV11-3	TRBJ2-7
TGCGCCAGCAGCTTCAAAGGTCCGGGACAGGGGGGCTATGCTGCAACTAATGAAAAACTGTTTTTT	CASSFKGPGQGGYAATNEKLFF	TRBV5-1	TRBJ1-4
TGTGCCAGCAGTGACCAGCTAGGACCCCCTAACTATGGCTACACCTTC	CASSDQLGPPNYGYTF	TRBV25-1	TRBJ1-2
TGTGCCAGCAGCGCTAGCCCTTACGAGCAGTACTTC	CASSASPYEQYF	TRBV9	TRBJ2-7
TGTGCCTGGAATTCGGGACAGGGACTGGGGAACACCGGGGAGCTGTTTTTT	CAWNSGQGLGNTGELFF	TRBV30	TRBJ2-2
TGTGCCAGCAGGAATGGGAAATGGGACAGGGCCGACACTGAAGCTTTCTTT	CASRNGKWDRADTEAFF	TRBV6-5	TRBJ1-1
TGTGCTAGCAGCTTAGGACTAGAGTACTTC	CASSLGLEYF	TRBV7-7	TRBJ2-4
TGTGCCACCAGTGACCACTACTTAATAGCTTTCTTT	CATSDHYLIAFF	TRBV24-1	TRBJ1-1
TGCAGTGCTAGGGTGATTAGGGAATATGGCTACACCTTC	CSARVIREYGYTF	TRBV20-1	TRBJ1-2
TGTGCCAGCAACCTACAGCTGTGCTACGAGCAGTACTTC	CASNLQLCYEQYF	TRBV7-8	TRBJ2-7
TGTGCCAGCAGCCTCGGGGGGCACACTGAAGCTTTCTTT	CASSLGGHTEAFF	TRBV5-4	TRBJ1-1
TGTGCCACCAGTGATTTGGGGGGGTATTGCAAAAACATTCAGTACTTC	CATSDLGGYCKNIQYF	TRBV24-1	TRBJ2-4
TGTGCCAGCTCCATTCCAGGGTTGCCGCTCGGCACAGATACGCAGTATTTT	CASSIPGLPLGTDTQYF	TRBV7-9	TRBJ2-3
TGTGCCAGCAGTGCAACAGGACCTCGGCAGTTCTTC	CASSATGPRQFF	TRBV2	TRBJ2-1
TGTGCCACCAGCAGAGATCTACAGGGGATGTGGACCCAGTACTTC	CATSRDLQGMWTQYF	TRBV15	TRBJ2-5
TGTGCCAGCAGTTGGGGCGGCCGGAACACTGAAGCTTTCTTT	CASSWGGRNTEAFF	TRBV27	TRBJ1-1
TGTGCCAGCGATTGGTGGACCCCTAACAATCAGCCCCAGCATTTT	CASDWWTPNNQPQHF	TRBV6-4	TRBJ1-5
TGCAGTGCTAGGGACGAGAGACCGGTCAAGATGGCAGATACGCAGTATTTT	CSARDERPVKMADTQYF	TRBV20-1	TRBJ2-3
TGTGCCATCAGACTACTATTACCACTAGATCATAGCTCCTACGAGCAGTACTTC	CAIRLLLPLDHSSYEQYF	TRBV10-3	TRBJ2-7
TGTGCTAGTGGACCCGTGGGGGACGTGATGAACACTGAAGCTTTCTTT	CASGPVGDVMNTEAFF	TRBV12-5	TRBJ1-1
TGTGCCAGCCAGGGCAGGGCTGGAGAGGGAAAGGCCGCCCTCCACTTT	CASQGRAGEGKAALHF	TRBV5-4	TRBJ1-6
TGTGCCAGCACTTCCGTTGGGGGGGGTCATATGAACACCGGGGAGCTGTTTTTT	CASTSVGGGHMNTGELFF	TRBV7-9	TRBJ2-2
TGCGCCAGCAGCTTGGTTGGAATCGGCAAACATGGCTACACCTTC	CASSLVGIGKHGYTF	TRBV5-1	TRBJ1-2
TGCGCCCATTCGTCCTTCGGACAGGGGGGTCCCTACGAGCAGTACTTC	CAHSSFGQGGPYEQYF	TRBV5-1	TRBJ2-7
TGTGCCAGCAGAGGCGTTGGGGATTGCACAGATACGCAGTATTTT	CASRGVGDCTDTQYF	TRBV6-4	TRBJ2-3
TGTGCCAGCAAACCGGGGGCCGTTGGCGGTCAGCCCCAGCATTTT	CASKPGAVGGQPQHF	TRBV28	TRBJ1-5
TGTGCCAGCAGCCAAGGTCCCCGTGTATGGAACGAGCAGTACTTC	CASSQGPRVWNEQYF	TRBV14	TRBJ2-7
TGCAGCGCCCAGGGGGCGCCTAGAGCTTTCTTT	CSAQGAPRAFF	TRBV29-1	TRBJ1-1
TGTGCCAGCAGCTTACAGGGGGGCGAGCAGTACTTC	CASSLQGGEQYF	TRBV11-2	TRBJ2-7
TGCAGCGTTGGGAACCATTCACCCCTCCACTTT	CSVGNHSPLHF	TRBV29-1	TRBJ1-6
TGTGCCAGCAGCGGGGGGTTATACAATGAGCAGTTCTTC	CASSGGLYNEQFF	TRBV7-8	TRBJ2-1
TGTGCCAGTAGTATTGCCCCCGGGACGCGGGAGCTGTTTTTT	CASSIAPGTRELFF	TRBV19	TRBJ2-2
TGCAGTGCTCCAGGGAGCAAAAACATTCAGTACTTC	CSAPGSKNIQYF	TRBV20-1	TRBJ2-4
TGTGCCAGCAGTTCTTGGAACCCGGGGGCCTACGAGCAGTACTTC	CASSSWNPGAYEQYF	TRBV6-5	TRBJ2-7
TGTGCCAGCAGCGTACCCGTAATCGGGACGACCTATCCTGAAGCTTTCTTT	CASSVPVIGTTYPEAFF	TRBV9	TRBJ1-1
TGCGCCAGCACCGGAGGGGATTTCAATGAGCAGTTCTTC	CASTGGDFNEQFF	TRBV10-1	TRBJ2-1
TGTGCCAGCAGTCTCACTACTGAAGCTTTCTTT	CASSLTTEAFF	TRBV12-4	TRBJ1-1
TGTGCCGGCGGGGGAAACCCTGGAAACACCATATATTTT	CAGGGNPGNTIYF	TRBV7-2	TRBJ1-3
TGTGCCAGTAGGGAAGGGGGCCTAACTGAAGCTTTCTTT	CASREGGLTEAFF	TRBV19	TRBJ1-1
TGTGCCAGCAGTTACCGCCCGAATAGGCCTTGCTCCTACAATGAGCAGTTCTTC	CASSYRPNRPCSYNEQFF	TRBV6-5	TRBJ2-1
TGTGCCACCAGTGATTTCGAGGGGGCAACTAATGAAAAACTGTTTTTT	CATSDFEGATNEKLFF	TRBV24-1	TRBJ1-4
TGTGCCAGCAGCCCCCCCGGGACGGGCACCGGGGAGCTGTTTTTT	CASSPPGTGTGELFF	TRBV13	TRBJ2-2
TGCGCCAGCAGTGAGTCACGGGAGTCCGCTCTAGCGGGCAAATTGGGGTTCACCGGGGAGCTGTTTTTT	CASSESRESALAGKLGFTGELFF	TRBV10-1	TRBJ2-2
TGTGCCAGCAGCTTGGCAAGCGACCGAGGAAACACTGAAGCTTTCTTT	CASSLASDRGNTEAFF	TRBV5-8	TRBJ1-1
TGTGCCAGCAGTGGGACATACGAGCAGTACTTC	CASSGTYEQYF	TRBV6-2	TRBJ2-7
TGCAGCGGAAACAGGGGTGATCAGCCCCAGCATTTT	CSGNRGDQPQHF	TRBV29-1	TRBJ1-5
TGTGCCAGCAGCGAGGACGCCAGGCTGAGCCGGGAGCTGTTTTTT	CASSEDARLSRELFF	TRBV7-9	TRBJ2-2
TGTGCCAGCAGTAACCCCGAGGGGAGCAATCAGCCCCAGCATTTT	CASSNPEGSNQPQHF	TRBV12-4	TRBJ1-5
TGTGCCACCAGCAGGGGACGATGTAACTATGGCTACACCTTC	CATSRGRCNYGYTF	TRBV24-1	TRBJ1-2
TGTGCCAGCAGCGAGTACCAGGGGGACAACACTGAAGCTTTCTTT	CASSEYQGDNTEAFF	TRBV13	TRBJ1-1
TGTGCCAGCAGTGGTGACAGGAGAAGCAATCAGCCCCAGCATTTT	CASSGDRRSNQPQHF	TRBV28	TRBJ1-5
TGTGCCAGCAGCTGGGGGGGCCCCTACGAGCAGTACTTC	CASSWGGPYEQYF	TRBV7-8	TRBJ2-7
TGTGCCAGCAGCAGTCAACGGCGGAGTAATGAAAAACTGTTTTTT	CASSSQRRSNEKLFF	TRBV7-3	TRBJ1-4
TGTGCCAGCAGCTTGACAGAAAGGGCTGGTCAGCCCCAGCATTTT	CASSLTERAGQPQHF	TRBV5-4	TRBJ1-5
TGTGCCAACACCGGGGTCTACGAGCAGTACTTC	CANTGVYEQYF	TRBV2	TRBJ2-7
TGTGCCAGCAGTGAAGTCCCTGGGGGACTAGCAACTAATGAAAAACTGTTTTTT	CASSEVPGGLATNEKLFF	TRBV6-1	TRBJ1-4
TGTGCCAGCAGTGACGACGGAGCTAGCGGGAGCAGCGAGCAGTACTTC	CASSDDGASGSSEQYF	TRBV6-4	TRBJ2-7
TGTGCCAGCAGCGTAGTTTTGCAGGGGCACGAGCAGTACTTC	CASSVVLQGHEQYF	TRBV9	TRBJ2-7
TGTGCCACCAGCCGTAGGACAGGGAAATACAATGAGCAGTTCTTC	CATSRRTGKYNEQFF	TRBV15	TRBJ2-1
TGCAGTGCTGGGGACAGGGGTCCTAATTCACCCCTCCACTTT	CSAGDRGPNSPLHF	TRBV20-1	TRBJ1-6
TGTGCCAGCAGTTCCGCCATTGGGGGGTCGCCGCCCAAAAACATTCAGTACTTC	CASSSAIGGSPPKNIQYF	TRBV12-4	TRBJ2-4
TGTGCCAGCAGCCTTGGGGGGGCTCAGCAGTACTTC	CASSLGGAQQYF	TRBV7-9	TRBJ2-7
TGTGCCAGCAGCCCCCCTCGAAATGAAAAACTGTTTTTT	CASSPPRNEKLFF	TRBV5-6	TRBJ1-4
TGCGCCAGCAGCTTGGGTTCGGGGGGCAATCAGCCCCAGCATTTT	CASSLGSGGNQPQHF	TRBV5-1	TRBJ1-5
TGTGCCAGCAGCCCGGGGACTCAGGCTTTCTTT	CASSPGTQAFF	TRBV6-1	TRBJ1-1
TGTGCCAGCAGCGTAGGGAACCAATCTAGTGACCCCGAGCAGTACTTC	CASSVGNQSSDPEQYF	TRBV9	TRBJ2-7
TGCAGTGCTAGAGATATGTCGGGAGATACGGGGTATGGCTACACCTTC	CSARDMSGDTGYGYTF	TRBV20-1	TRBJ1-2
TGTGCCAGCAGTCGACGGGGAGCATACGAGCAGTACTTC	CASSRRGAYEQYF	TRBV28	TRBJ2-7
TGCAGCGTTGAAGATGTGACAGGGTTGGGAGGTTACGAGCAGTACTTC	CSVEDVTGLGGYEQYF	TRBV29-1	TRBJ2-7
TGTGCCAGCAGTTACGCCGGACTAGCGGGGGGGAACGGAACAGATACGCAGTATTTT	CASSYAGLAGGNGTDTQYF	TRBV6-5	TRBJ2-3
TGTGCCAGCAGCACCGGGACCAGGGAAGAGACCCAGTACTTC	CASSTGTREETQYF	TRBV13	TRBJ2-5
TGCGCCAGCAGCCAGTGTCTACGGTCAAATCAGCCCCAGCATTTT	CASSQCLRSNQPQHF	TRBV4-1	TRBJ1-5
TGTGCCAGCAGCTTGGGGGGTAGACACCGAAACACCATATATTTT	CASSLGGRHRNTIYF	TRBV5-4	TRBJ1-3
TGTGCCAGCAGCTTACACATGTACGAGCAGTACTTC	CASSLHMYEQYF	TRBV7-2	TRBJ2-7
TGTGCCACCAGCAGACACCAGGGGGGGATATATTTT	CATSRHQGGIYF	TRBV15	TRBJ1-3
TGCGCCAGCAGCCAAGGAACGGGGGAGCAGTACTTC	CASSQGTGEQYF	TRBV4-1	TRBJ2-7
TGTGCCAGCAGCGGGGGGGGGTCCGGGCACGAGCAGTACTTC	CASSGGGSGHEQYF	TRBV12-4	TRBJ2-7
TGTGCCAGCAGCGCAACGACAGGGTCGAATGAAAAACTGTTTTTT	CASSATTGSNEKLFF	TRBV7-3	TRBJ1-4
TGTGCCAGCAGTGATGTACGGGACTACGAGCAGTACTTC	CASSDVRDYEQYF	TRBV6-1	TRBJ2-7
TGTGCCAGCAGCTACCTGACATATGGCTACACCTTC	CASSYLTYGYTF	TRBV11-2	TRBJ1-2
TGTGCCAGCAGTTTTCGGGATAACATTCAGTACTTC	CASSFRDNIQYF	TRBV27	TRBJ2-4
TGTGCCAGCAGTTACGTTAGGGGGAACACTGAAGCTTTCTTT	CASSYVRGNTEAFF	TRBV6-5	TRBJ1-1
TGTGCCAGCAGCGTGCCTAAAGGGGGCCCCATTTCCTACGAGCAGTACTTC	CASSVPKGGPISYEQYF	TRBV9	TRBJ2-7
TGTGCCAGCAGCTCAGGTGGCAGGGCGGGGGAAAGGGAGCAGTACTTC	CASSSGGRAGEREQYF	TRBV11-3	TRBJ2-7
TGCAGTGCTAGAGATCGGGGGCAAGAGACCCAGTACTTC	CSARDRGQETQYF	TRBV20-1	TRBJ2-5
TGCAGTGCTAGGGGAGTGGGACGTTGTAGACAAGAGACCCAGTACTTC	CSARGVGRCRQETQYF	TRBV20-1	TRBJ2-5
TGTGCCAGTAGTATGGCAGGGGGAACGAACTCTGGGGCCAACGTCCTGACTTTC	CASSMAGGTNSGANVLTF	TRBV19	TRBJ2-6
TGTGCCAGCAGTGAAACGGGGGGACGTGAGCAGTACTTC	CASSETGGREQYF	TRBV6-1	TRBJ2-7
TGTGCCAGCAGCTTAGAGAGGGCCCCAGGGGGCGAGCAGTACTTC	CASSLERAPGGEQYF	TRBV7-9	TRBJ2-7
TGTGCCACAGGACCGACCCAGTACTTC	CATGPTQYF	TRBV6-4	TRBJ2-5
TGTGCCAGCTGTGCTAGTTACGAGCAGTACTTC	CASCASYEQYF	TRBV5-4	TRBJ2-7
TGTGCCAGCAGTTCCGGAGATAAGTACGAGCAGTACTTC	CASSSGDKYEQYF	TRBV6-2	TRBJ2-7
TGTGCCAGCAGCTTGGCGGGGCTCGACAATGAGCAGTTCTTC	CASSLAGLDNEQFF	TRBV5-6	TRBJ2-1
TGTGCCAGCAGTCTTCATTCGTCAGGGGGGATGGAGGAGTATGGCTACACCTTC	CASSLHSSGGMEEYGYTF	TRBV12-3	TRBJ1-2
TGTGCCAGCAGCCAACGGACAGGGACGTGGAACACTGAAGCTTTCTTT	CASSQRTGTWNTEAFF	TRBV7-6	TRBJ1-1
TGTGCCAGCCACAGGGCTCCAAAAACTGAAGCTTTCTTT	CASHRAPKTEAFF	TRBV19	TRBJ1-1
TGCAGCGCAAAATCCTCCCAGGGACATTACAATCAGCCCCAGCATTTT	CSAKSSQGHYNQPQHF	TRBV29-1	TRBJ1-5
TGTGCCACAACCCGACACAGGGCCTACGAGCAGTACTTC	CATTRHRAYEQYF	TRBV24-1	TRBJ2-7
TGTGCCACCAGCAGGAGACAGGGGACTGAAGCTTTCTTT	CATSRRQGTEAFF	TRBV15	TRBJ1-1
TGTGCCAGCTACCATCAGCCCCAGCATTTT	CASYHQPQHF	TRBV9	TRBJ1-5
TGTGCCAGCAGCTACCATTCGGGACTAGCCTCGAACTACAATGAGCAGTTCTTC	CASSYHSGLASNYNEQFF	TRBV5-6	TRBJ2-1
TGCAGCGTTGATCCTTCCCCATGGGGGCGCCTGGAAAAACTGTTTTTT	CSVDPSPWGRLEKLFF	TRBV29-1	TRBJ1-4
TGCAGTGCTAGACAGGGTAGAAGTGCAACTAATGAAAAACTGTTTTTT	CSARQGRSATNEKLFF	TRBV20-1	TRBJ1-4
TGTGCCAGCAGCCTACCCGGGACAGGGCGGCAGCCCCAGCATTTT	CASSLPGTGRQPQHF	TRBV9	TRBJ1-5
TGTGCCAGCAGCAAACAACATCAGCCCCAGCATTTT	CASSKQHQPQHF	TRBV9	TRBJ1-5
TGTGCCAGCAGCGGACCGGGACGAAACAATGAGCAGTTCTTC	CASSGPGRNNEQFF	TRBV11-3	TRBJ2-1
TGTGCCAGCAGCCACGGAATAGTGTCCGGGACTCCTTATCAGCCCCAGCATTTT	CASSHGIVSGTPYQPQHF	TRBV7-3	TRBJ1-5
TGTGCCACCAGCAGAGACGGACAGGGGCGCCCCTATGGCTACACCTTC	CATSRDGQGRPYGYTF	TRBV15	TRBJ1-2
TGTGCCACCAGCAGAGCCAGGGGTACAGGGGCCTACGAGCAGTACTTC	CATSRARGTGAYEQYF	TRBV15	TRBJ2-7
TGTGCCAGCAGATCCTCACGACAGGGTCCGAACTATGGCTACACCTTC	CASRSSRQGPNYGYTF	TRBV28	TRBJ1-2
TGTGCCACCACTTGGGGGGTGAACACCGGGGAGCTGTTTTTT	CATTWGVNTGELFF	TRBV24-1	TRBJ2-2
TGTGCCAGCAGCGCCCTCGTAAGGGGGGACTCTGCCCAGCATTTT	CASSALVRGDSAQHF	TRBV9	TRBJ1-5
TGCGCCAGCGGGTCGGGGAACAACGAGCAGTACTTC	CASGSGNNEQYF	TRBV10-2	TRBJ2-7
TGTGCCACCAGTGATTTAAGCCATCGGAGGACACGGCTGGACACCGGGGAGCTGTTTTTT	CATSDLSHRRTRLDTGELFF	TRBV24-1	TRBJ2-2
TGTGCCACCTCCCTGCTGGGGGGCTGGGAGACCCAGTACTTC	CATSLLGGWETQYF	TRBV15	TRBJ2-5
TGCGCCAGCATGCCATGGCTAGCGCCGCCCTACAATGAGCAGTTCTTC	CASMPWLAPPYNEQFF	TRBV10-1	TRBJ2-1
TGTGCCACCAGTGATTTGCTTCGGGGAGGTCACAGAGAGACCCAGTACTTC	CATSDLLRGGHRETQYF	TRBV24-1	TRBJ2-5
TGTGCCAGCAGTGTGAGCCGGGACAGGGTGAACACTGAAGCTTTCTTT	CASSVSRDRVNTEAFF	TRBV6-4	TRBJ1-1
TGTGCCAGCAGTTACCTAGGAAACCGGACGGCCAAAAACATTCAGTACTTC	CASSYLGNRTAKNIQYF	TRBV6-5	TRBJ2-4
TGTGCCAGCAGCTTGGGCAGGGGGCGTTACGAGCAGTACTTC	CASSLGRGRYEQYF	TRBV5-5	TRBJ2-7
TGCGCCAGCAGCCCTAGGGGGTGGTCGACCGGGGAGCTGTTTTTT	CASSPRGWSTGELFF	TRBV5-1	TRBJ2-2
TGTGCCATCAACTCAGGGGGGGCCAACTATGGCTACACCTTC	CAINSGGANYGYTF	TRBV10-3	TRBJ1-2
TGTGCCAGCAGCCAAGAGGTGGGGCCGTACCCTAACTATGGCTACACCTTC	CASSQEVGPYPNYGYTF	TRBV14	TRBJ1-2
TGCAGTGCTAGATTACCAGACAGGGCGACCCTCCACTTT	CSARLPDRATLHF	TRBV20-1	TRBJ1-6
TGTGCCAGCCACGGGGGGGGTGGAATTGACAATGAGCAGTTCTTC	CASHGGGGIDNEQFF	TRBV7-9	TRBJ2-1
TGTGCCAGCAGCCCAAGTAGCACCAGGGATACGCAGTATTTT	CASSPSSTRDTQYF	TRBV6-5	TRBJ2-3
TGCAGCCGCCCGGGTACCGGTTCCAGGCTCTATGGCTACACCTTC	CSRPGTGSRLYGYTF	TRBV29-1	TRBJ1-2
TGTGCCAGCAGCTTGAGTCGGGAGGATGAGCAGTTCTTC	CASSLSREDEQFF	TRBV5-5	TRBJ2-1
TGTGCCAGCAGTTATGGCTATTCTTATCAGCCCCAGCATTTT	CASSYGYSYQPQHF	TRBV6-5	TRBJ1-5
TGTGCCAGCAGCCAAGATACTAGCGGGAGCTCCTACGAGCAGTACTTC	CASSQDTSGSSYEQYF	TRBV3-1	TRBJ2-7
TGTGCTAGCAGCTTGGCTAGCGGGGGCTACAATGAGCAGTTCTTC	CASSLASGGYNEQFF	TRBV7-7	TRBJ2-1
TGTGCCAGCAGCCCTGCGGGCGGGGGCTACACCTTC	CASSPAGGGYTF	TRBV11-3	TRBJ1-2
TGTGCCAGCAGCTTCGGTTTTTCAACACAGGGGGCGAGGGAGGGTGAAAAACTGTTTTTT	CASSFGFSTQGAREGEKLFF	TRBV7-2	TRBJ1-4
TGTGCCATCACGCGGGATACTGGCTACGAGCAGTACTTC	CAITRDTGYEQYF	TRBV10-3	TRBJ2-7
TGTGCCAGCAGCTTCCCCGACAGGGGGAGTAACTATGGCTACACCTTC	CASSFPDRGSNYGYTF	TRBV7-6	TRBJ1-2
TGTGCCAGCTCACCACCCCCACAGGTGGGAGGGGCCAGGGGAGAGACCCAGTACTTC	CASSPPPQVGGARGETQYF	TRBV18	TRBJ2-5
TGTGCCACCAGTGATTTACGGGTATGTGGGACAGGGAGTCTGGCCCGATACTATGGCTACACCTTC	CATSDLRVCGTGSLARYYGYTF	TRBV24-1	TRBJ1-2
TGTGCCAGCAGCTCCGGGACCGGGGATCAGCCCCAGCATTTT	CASSSGTGDQPQHF	TRBV7-9	TRBJ1-5
TGTGCCAGCAGCCCCACAATGGGGCGGCAAGAGACCCAGTACTTC	CASSPTMGRQETQYF	TRBV7-9	TRBJ2-5
TGCAGCGTTGCCTCCTTTGGGGGGGAGCAGTACTTC	CSVASFGGEQYF	TRBV29-1	TRBJ2-7
TGTGCCAGCATTACTGTAACAGCCCGGGTTGCTAGGGAAGCTTTCTTT	CASITVTARVAREAFF	TRBV6-4	TRBJ1-1
TGTGCCTGGAGTGACCGACCTACCCACAATGAGCAGTTCTTC	CAWSDRPTHNEQFF	TRBV30	TRBJ2-1
TGTGCCAGCAGCTTAGATCAAAACACCCTGACCCTAACCGGGGAGCTGTTTTTT	CASSLDQNTLTLTGELFF	TRBV11-2	TRBJ2-2
TGTGCCGCTATCAGGGGACAGAATTATGGCTACACCTTC	CAAIRGQNYGYTF	TRBV11-3	TRBJ1-2
TGTGCCTGGACCACCCGGGACAAAAACTACGAGCAGTACTTC	CAWTTRDKNYEQYF	TRBV30	TRBJ2-7
TGTGCCAGCAGCGTAGTTCCAGACAGGGCAGCTTTCTTT	CASSVVPDRAAFF	TRBV9	TRBJ1-1
TGTGCCACCAGTGCCAAACCCGGGACAGGGTTCCCAGGGACTGAAGCTTTCTTT	CATSAKPGTGFPGTEAFF	TRBV24-1	TRBJ1-1
TGTGCCAGCAGCTTATCTCAGGCTAGTAGCGAGCAGTTCTTC	CASSLSQASSEQFF	TRBV7-3	TRBJ2-1
TGCAGTGCTAGAATTCAGGGACAGGCTACGGCCCATTCACCCCTCCACTTT	CSARIQGQATAHSPLHF	TRBV20-1	TRBJ1-6
TGTGCCAGTAGTAGGGCGGCGGCAGCTGTGGGTAGCAATCAGCCCCAGCATTTT	CASSRAAAAVGSNQPQHF	TRBV19	TRBJ1-5
TGCAGTGCTAGATCGGAACTAGCGGGAGGGCTTTCGGGCTATCAGCCCCAGCATTTT	CSARSELAGGLSGYQPQHF	TRBV20-1	TRBJ1-5
TGCAGTGCTAGAGGAATGGGGTTTCAAGAGACCCAGTACTTC	CSARGMGFQETQYF	TRBV20-1	TRBJ2-5
TGTGCTAGTGGTTTGGTACAGGAGGGGGTGTCTGAAGCTTTCTTT	CASGLVQEGVSEAFF	TRBV12-5	TRBJ1-1
TGTGCCATCAGTGAGTCAACTAGCGGGCCCGGGGAGCTGTTTTTT	CAISESTSGPGELFF	TRBV10-3	TRBJ2-2
TGTGCCTTTCCGTCGTGTAGCTACAATGAGCAGTTCTTC	CAFPSCSYNEQFF	TRBV30	TRBJ2-1
TGTGCCAGCAGCCAGTCTAGCGGGGAAGACGAGCAGTACTTC	CASSQSSGEDEQYF	TRBV14	TRBJ2-7
TGTGCCAGTAGGTCGGCCAACGGGACAGGGAGGTTCGGTAGGCCCCAGCATTTT	CASRSANGTGRFGRPQHF	TRBV19	TRBJ1-5
TGCGCCAGCATCCCGGCCCTAGAGGGACAGTTAGTCAAAAACATTCAGTACTTC	CASIPALEGQLVKNIQYF	TRBV10-2	TRBJ2-4
TGTGCCAGCAGCTCAGGCGACGGGGATCAGCCCCAGCATTTT	CASSSGDGDQPQHF	TRBV5-5	TRBJ1-5
TGTGCCAGCTCACCGGCGGAGCAGGGCGTCAATGAGCAGTTCTTC	CASSPAEQGVNEQFF	TRBV18	TRBJ2-1
TGTGCCAGCAGCTTAGGGCCTAAGGGCCCATTGGCGACGGCTGAAGCTTTCTTT	CASSLGPKGPLATAEAFF	TRBV11-3	TRBJ1-1
TGTGCCAGCAGCTTGCCAGCCGCCCGAGAAGGACAGGGGCACTACATGAACACTGAAGCTTTCTTT	CASSLPAAREGQGHYMNTEAFF	TRBV5-4	TRBJ1-1
TGTGCCACCAGAGCGGACACGGAAGACAATGAGCAGTTCTTC	CATRADTEDNEQFF	TRBV24-1	TRBJ2-1
TGCGCCAGCAGCTGGACAGGGTGCTGTAGAGAAAAACTGTTTTTT	CASSWTGCCREKLFF	TRBV5-1	TRBJ1-4
TGTGCCAGTAGACGCCCGGTTAGGGGTGATTCACCCCTCCACTTT	CASRRPVRGDSPLHF	TRBV19	TRBJ1-6
TGCGCCAGCAGCCAACTGGGCGGGGGGTTCACGGCCTACAATGAGCAGTTCTTC	CASSQLGGGFTAYNEQFF	TRBV4-3	TRBJ2-1
TGTGCCAGCAGCCTTCCGCCCTTGACAGGACGTAGCAATCAGCCCCAGCATTTT	CASSLPPLTGRSNQPQHF	TRBV3-1	TRBJ1-5
TGTGCCACCGGGAACAGAACGCGGGAGACCCAGTACTTC	CATGNRTRETQYF	TRBV15	TRBJ2-5
TGTGCCAGTAGTATGGGTCCGGGACAGTCGTCCTACGAGCAGTACTTC	CASSMGPGQSSYEQYF	TRBV19	TRBJ2-7
TGCGCCAGCAGCGGTGGCGGGGCTCTCTACAATGAGCAGTTCTTC	CASSGGGALYNEQFF	TRBV5-1	TRBJ2-1
TGTGCCAGCCTCCCAGGGAACTGTCTTGAGCAGTTCTTC	CASLPGNCLEQFF	TRBV6-5	TRBJ2-1
TGCGCCAGCAGCCATATCCCGGGACAGGCCTTCTCTGGAAACACCATATATTTT	CASSHIPGQAFSGNTIYF	TRBV4-1	TRBJ1-3
TGTGCCAGCAGTTCTCCCATGTTACCCATGAACACTGAAGCTTTCTTT	CASSSPMLPMNTEAFF	TRBV6-3	TRBJ1-1
TGTGCCAGCAGCGCCAGGCGTGACCCCGGGGAGCTGTTTTTT	CASSARRDPGELFF	TRBV13	TRBJ2-2
TGCAGTGCTAGAAAGGGGTGGGACCCCCTCCAAGATAATCAGCCCCAGCATTTT	CSARKGWDPLQDNQPQHF	TRBV20-1	TRBJ1-5
TGTGCCAGCAGGGTGATCCACAGGACAGAACAGAATGAGCAGTTCTTC	CASRVIHRTEQNEQFF	TRBV6-1	TRBJ2-1
TGTGCTAGCAGCTTAGGGGGGGGGCGGAATGAGCAGTTCTTC	CASSLGGGRNEQFF	TRBV7-7	TRBJ2-1
TGTGCCAGCAGCCGGACAGTAAGGGGAGGCTTCTACGAGCAGTACTTC	CASSRTVRGGFYEQYF	TRBV13	TRBJ2-7
TGCAGTGCTAGAGTAGAGGGACAGGGGTGCTCCTACGAGCAGTACTTC	CSARVEGQGCSYEQYF	TRBV20-1	TRBJ2-7
TGCGCCAGCAGCCAAGCCCCCCCGACGAAGGGCAAGGCTAACTATGGCTACACCTTC	CASSQAPPTKGKANYGYTF	TRBV4-1	TRBJ1-2
TGTGCCAGCAGTCGGGAACACACTGAAGCTTTCTTT	CASSREHTEAFF	TRBV2	TRBJ1-1
TGTGCCAGCAGCGGAGAAGGGCGTACCCGGCGGTCTGGGGCCAACGTCCTGACTTTC	CASSGEGRTRRSGANVLTF	TRBV11-3	TRBJ2-6
TGTGCCAGTAAACAGACAGGGGGGAGCCTGCATAGCAATCAGCCCCAGCATTTT	CASKQTGGSLHSNQPQHF	TRBV19	TRBJ1-5
TGTGCCAGCAGTTACCCCCGCTCGATGGCAGATACGCAGTATTTT	CASSYPRSMADTQYF	TRBV6-2	TRBJ2-3
TGTGCCAGCAGTGAGGAGCGGGACGACCAGTACGAGCAGTACTTC	CASSEERDDQYEQYF	TRBV27	TRBJ2-7
TGCGCCAGCCAGGGGGGGCGCTACGAGCAGTACTTC	CASQGGRYEQYF	TRBV10-1	TRBJ2-7
TGTGCCAGCAGTTCCCAGGGCTTTGATACGCAGTATTTT	CASSSQGFDTQYF	TRBV27	TRBJ2-3
TGTGCCAGCAGCAAATTTTCGAGGGTGTGCTACGAGCAGTACTTC	CASSKFSRVCYEQYF	TRBV5-6	TRBJ2-7
TGTGCCACCAGTGATTTCTTTGCGGGTGCCGCACCAGATACGCAGTATTTT	CATSDFFAGAAPDTQYF	TRBV24-1	TRBJ2-3
TGTGCCAGCAGCTTCAACTTCCCCGGGCCTCCCTGTTTGTGCTCCTATAATTCACCCCTCCACTTT	CASSFNFPGPPCLCSYNSPLHF	TRBV7-2	TRBJ1-6
TGTGCCATCATGGATCAGCTAGGAAATGAGCAGTTCTTC	CAIMDQLGNEQFF	TRBV10-3	TRBJ2-1
TGTGCCAGCAGTCTGGACAACGAGCAGTTCTTC	CASSLDNEQFF	TRBV6-5	TRBJ2-1
TGTGCCAGCTTTCCCGAAGATAGGGAGGGAGCAGTCTCTGGTGTAGATACGCAGTATTTT	CASFPEDREGAVSGVDTQYF	TRBV6-1	TRBJ2-3
TGTGCCAGCCCCGGACGAACAAACGAGCAGTACTTC	CASPGRTNEQYF	TRBV7-3	TRBJ2-7
TGTGCCAGCAGCTTCAATAATCCGACCCAGTACTTC	CASSFNNPTQYF	TRBV6-5	TRBJ2-5
TGTGCCAGCAGTTTGTTTGACAGGGGTTATCTGAACACTGAAGCTTTCTTT	CASSLFDRGYLNTEAFF	TRBV28	TRBJ1-1
TGTGCCAGCAGTTACTCCGTCGGGCCGCCCAAAAACATTCAGTACTTC	CASSYSVGPPKNIQYF	TRBV6-3	TRBJ2-4
TGTGCCTGGAGTGTGTTTCCCTCTAGCTACGAGCAGTACTTC	CAWSVFPSSYEQYF	TRBV30	TRBJ2-7
TGTGCCAGCAGCGCGTCTCACGACACCGGGGAGCTGTTTTTT	CASSASHDTGELFF	TRBV13	TRBJ2-2
TGTGCCAGCAGCTTAGGACAGGCTTTGACTGAAGCTTTCTTT	CASSLGQALTEAFF	TRBV7-3	TRBJ1-1
TGCGCCAGCAGCCACCCCGACCGTGATCTCGAAAAACTGTTTTTT	CASSHPDRDLEKLFF	TRBV4-1	TRBJ1-4
TGTGCCAGCAGCAAAGTCAGGGTCGATGGCTACACCTTC	CASSKVRVDGYTF	TRBV13	TRBJ1-2
TGCGCCAGCAGCCAAGATCACCCGCCCGGAGCCAAAAACATTCAGTACTTC	CASSQDHPPGAKNIQYF	TRBV4-1	TRBJ2-4
TGTGCCAGCAGCGCTAAGCGGGAAGGGGACGAGCAGTACTTC	CASSAKREGDEQYF	TRBV6-5	TRBJ2-7
TGTGCCAGCAGTGAAAGATCCCCGGGACGAGGATATGGCTACACCTTC	CASSERSPGRGYGYTF	TRBV25-1	TRBJ1-2
TGTGCCAGCAGGTTCCGGGCGGGGGCGCACAACTATGGCTACACCTTC	CASRFRAGAHNYGYTF	TRBV6-1	TRBJ1-2
TGCAGCGTGAGGGGTGCTTTGAACACCGGGGAGCTGTTTTTT	CSVRGALNTGELFF	TRBV29-1	TRBJ2-2
TGTGCCAGCAGTGAAGTTCGGTGGGATGCAAGCTCCTACGAGCAGTACTTC	CASSEVRWDASSYEQYF	TRBV6-1	TRBJ2-7
TGTGCCACCAGTCCGGGACAGGGTTACCCGGAGTACGAGCAGTACTTC	CATSPGQGYPEYEQYF	TRBV24-1	TRBJ2-7
TGTGCCAGCAGCGGGGGAGAGGGAAACACCATATATTTT	CASSGGEGNTIYF	TRBV13	TRBJ1-3
TGTGCCAGCAGCCGAGTCGTGTATCCGTACAATGAGCAGTTCTTC	CASSRVVYPYNEQFF	TRBV27	TRBJ2-1
TGCGCCAGCACGAAAGAAGCGGGGGGGGTCGCTGAGCAGTTCTTC	CASTKEAGGVAEQFF	TRBV10-2	TRBJ2-1
TGTGCCAGCAGTTACGGGACTAGGACCCCCTACGAGCAGTACTTC	CASSYGTRTPYEQYF	TRBV6-2	TRBJ2-7
TGTGCCAGCAGGGGACTAGCGGTCTATTCCTACAATGAGCAGTTCTTC	CASRGLAVYSYNEQFF	TRBV25-1	TRBJ2-1
TGTGCCAGCAGCTTGGATACCGGGACTAGCGGGAGAGGGAACGAGCAGTACTTC	CASSLDTGTSGRGNEQYF	TRBV5-6	TRBJ2-7
TGTGCCAGCAGTTACGCCGGACAGGGGGAGGGGCAAGAGACCCAGTACTTC	CASSYAGQGEGQETQYF	TRBV6-5	TRBJ2-5
TGTGCCAGCAGCTTACTCCTACGGAATGAAGCTTTCTTT	CASSLLLRNEAFF	TRBV11-3	TRBJ1-1
TGTGCCAGCAGCTTAATGAGTTATGGCTACACCTTC	CASSLMSYGYTF	TRBV7-9	TRBJ1-2
TGTGCCTGGAGTTCCTCCCCCTCCAGGGCCACAACTCGAGGCTGGGCAGATACGCAGTATTTT	CAWSSSPSRATTRGWADTQYF	TRBV30	TRBJ2-3
TGTGCCAGCAGTTATGGCTTTTACGAGCAGTACTTC	CASSYGFYEQYF	TRBV27	TRBJ2-7
TGTGCCTGGACTTTAAGGTATTTT	CAWTLRYF	TRBV30	TRBJ2-3
TGTGCCAGTAGCGGGACAAGGGGGATTGGAAACACCATATATTTT	CASSGTRGIGNTIYF	TRBV19	TRBJ1-3
TGTGCCAGCAGCGGGATTCCACCCCAGTACTTC	CASSGIPPQYF	TRBV27	TRBJ2-5
TGTGCCAGCAGCTCGTTGACGAGGACTAATGAAAAACTGTTTTTT	CASSSLTRTNEKLFF	TRBV7-3	TRBJ1-4
TGCGCCAGCAGCTCCAGGGGCCCCGGTCGGAAAACTGAAGCTTTCTTT	CASSSRGPGRKTEAFF	TRBV5-1	TRBJ1-1
TGCAGTGCGGGTCGGGCCCGTGAAAAACTGTTTTTT	CSAGRAREKLFF	TRBV20-1	TRBJ1-4
TGTGCCACCAGTCCGACCGGGGTGAACACTGAAGCTTTCTTT	CATSPTGVNTEAFF	TRBV24-1	TRBJ1-1
TGTGCCAGCAGCTTAGCTCCGGGACAGGGATCCAGCACAGATACGCAGTATTTT	CASSLAPGQGSSTDTQYF	TRBV7-4	TRBJ2-3
TGTGCCAGCAGCTTGGGGGGGGAGTCAGATACGCAGTATTTT	CASSLGGESDTQYF	TRBV7-3	TRBJ2-3
TGTGCCAGCAGACCTGGACATTGTGGAGCCTACGAGCAGTACTTC	CASRPGHCGAYEQYF	TRBV6-3	TRBJ2-7
TGTGCCAGTAGTATACCCTTAACGGGGAGGAGATGGAACACCGGGGAGCTGTTTTTT	CASSIPLTGRRWNTGELFF	TRBV19	TRBJ2-2
TGCAGTGCTAGAGACTCGAGGTGGGACAACAACACTGAAGCTTTCTTT	CSARDSRWDNNTEAFF	TRBV20-1	TRBJ1-1
TGTGCCACCTTGGACAGGGGGATCTACGAGCAGTACTTC	CATLDRGIYEQYF	TRBV24-1	TRBJ2-7
TGTGCCAGCAGCCGGCGGCACAAAGAGCAGTACTTC	CASSRRHKEQYF	TRBV27	TRBJ2-7
TGTGCCAGCGGTAACGGTGTAAAAGCTGGGAATCAGCCCCAGCATTTT	CASGNGVKAGNQPQHF	TRBV27	TRBJ1-5
TGCGCCAGCCGGAGTGCCTACGAGCAGTACTTC	CASRSAYEQYF	TRBV10-1	TRBJ2-7
TGTGCCAGCAGCCCCTCGCTAGCAGCACAAAGCTCCTACAATGAGCAGTTCTTC	CASSPSLAAQSSYNEQFF	TRBV7-3	TRBJ2-1
TGTGCCAGCAGTGACCCCCCGGAGGGCACCTACGAGCAGTACTTC	CASSDPPEGTYEQYF	TRBV6-4	TRBJ2-7
TGCGCCAGCAGTGAGAACCCCAGGGGTCACGAGCAGTACTTC	CASSENPRGHEQYF	TRBV10-1	TRBJ2-7
TGTGCCAGCAGCTTACACTGTCAAATGGGACAAAACAATGAGCAGTTCTTC	CASSLHCQMGQNNEQFF	TRBV11-2	TRBJ2-1
TGTGCCAGTAGTGGTCTCGGACTAGCTCTCTTAATCCCCTACAATGAGCAGTTCTTC	CASSGLGLALLIPYNEQFF	TRBV19	TRBJ2-1
TGTGCCAGCAGGGAAAACAGGGGGTACGAGCAGTACTTC	CASRENRGYEQYF	TRBV14	TRBJ2-7
TGTGCCAGCTCCCCCGCTAGCGGGTCTGACTGCACAGATACGCAGTATTTT	CASSPASGSDCTDTQYF	TRBV6-4	TRBJ2-3
TGTGCCAGCAGCCCAGGGGTTTCCACAGATACGCAGTATTTT	CASSPGVSTDTQYF	TRBV13	TRBJ2-3
TGCGCCAGCAGCCCCGGCGAGTACTTC	CASSPGEYF	TRBV5-1	TRBJ2-5
TGTCTTTCTAGCGGGCTCCGGTATGAGCAGTTCTTC	CLSSGLRYEQFF	TRBV7-9	TRBJ2-1
TGTGCCAGCAGCTTCCCTAGCGACCAGCCCCAGCATTTT	CASSFPSDQPQHF	TRBV7-9	TRBJ1-5
TGTGCCAGCAGTTTATCGGGACAGGGCCAAGTTGGCTACACCTTC	CASSLSGQGQVGYTF	TRBV27	TRBJ1-2
TGTGCCAGCAGCCAAGATAGGAGGACGACTTCCTACGAGCAGTACTTC	CASSQDRRTTSYEQYF	TRBV14	TRBJ2-7
TGTCTTCACAGCCAATACGAGCAGTACTTC	CLHSQYEQYF	TRBV14	TRBJ2-7
TGCGCCAGCAGCTGCGTAGATACCGGGGAGCTGTTTTTT	CASSCVDTGELFF	TRBV5-1	TRBJ2-2
TGTGCCAGCAGTGAACGCCGGGACAGGGTAGACACCGGGGAGCTGTTTTTT	CASSERRDRVDTGELFF	TRBV2	TRBJ2-2
TGTGCCAGCAGGAGACAGGGGTTAGAAATGAACACTGAAGCTTTCTTT	CASRRQGLEMNTEAFF	TRBV6-4	TRBJ1-1
TGTGCCAGCAGCTTGCTCGGGGGGCCCAACACCGGGGAGCTGTTTTTT	CASSLLGGPNTGELFF	TRBV11-2	TRBJ2-2
TGTGCCAGCAGCCCCCGGACAGGGGGGCTTATGGGCTACAATGAGCAGTTCTTC	CASSPRTGGLMGYNEQFF	TRBV6-5	TRBJ2-1
TGTGCCAGCAGTTCCCGCCCCTACGAGCAGTACTTC	CASSSRPYEQYF	TRBV27	TRBJ2-7
TGTGCCAGCAGCGTCATGGGGGCCTCAGCTAACTATGGCTACACCTTC	CASSVMGASANYGYTF	TRBV9	TRBJ1-2
TGTGCCAGCAGCGTAGAATCCAGGGGATGTAGCAATCAGCCCCAGCATTTT	CASSVESRGCSNQPQHF	TRBV9	TRBJ1-5
TGCCTTAACGGTAATAAGGGAGGGGATAACTATGGCTACACCTTC	CLNGNKGGDNYGYTF	TRBV6-1	TRBJ1-2
TGTGCCAGCAGCACAGGGGGCCAACAGCCCCAGCATTTT	CASSTGGQQPQHF	TRBV9	TRBJ1-5
TGTGCCACCAGTCCCTTCCCATCGAAGGTCTCCTACGAGCAGTACTTC	CATSPFPSKVSYEQYF	TRBV24-1	TRBJ2-7
TGCGCCAGCAGTATCCCTAGCGGGGGGCAAGAGACCCAGTACTTC	CASSIPSGGQETQYF	TRBV10-1	TRBJ2-5
TGCGCCAGCAGTGAGTCCGAGGGACAGGGAGCACTACAGTACTTC	CASSESEGQGALQYF	TRBV10-2	TRBJ2-5
TGCAGTGAGGCAGAAAAACTGTTTTTT	CSEAEKLFF	TRBV20-1	TRBJ1-4
TGTGCCGTCATTTACTATGGCTACACCTTC	CAVIYYGYTF	TRBV6-4	TRBJ1-2
TGTGCCAGCAGCCCTAGGGCAGATACGCAGTATTTT	CASSPRADTQYF	TRBV5-8	TRBJ2-3
TGCAGTGCGCGGATCCCGGGACAGGGCCTCGGGGAGCTGTTTTTT	CSARIPGQGLGELFF	TRBV20-1	TRBJ2-2
TGTGCCAGCAGGGCGCGGGAGCTAGGTAATGGCGGGCCCGCTGACAGGGAGACCCAGTACTTC	CASRARELGNGGPADRETQYF	TRBV6-2	TRBJ2-5
TGTGCCAGCAGATTGGGGTTCCGGCCCTCCTACAATGAGCAGTTCTTC	CASRLGFRPSYNEQFF	TRBV6-6	TRBJ2-1
TGTGCCAGTAGTATACCCCACGGGGTCTACGAGCAGTACTTC	CASSIPHGVYEQYF	TRBV19	TRBJ2-7
TGTGCCAGCAGCTTATCCTCCCCAGGTACGTCTAGGGCGACAGGGGGGTACGTTGAGGATACGCAGTATTTT	CASSLSSPGTSRATGGYVEDTQYF	TRBV5-4	TRBJ2-3
TGTGCCAGCAGCTTAGAGAAAACCCCCCAGCGGGAGAAATTCTACGAGCAGTACTTC	CASSLEKTPQREKFYEQYF	TRBV7-6	TRBJ2-7
TGTGCCAGCAGCGTCAGCGGGAGTACCAACGATACGCAGTATTTT	CASSVSGSTNDTQYF	TRBV5-4	TRBJ2-3
TGTGCCAGCAGCTTGGACGAACTCTGGACGGTCTGCACTGAAGCTTTCTTT	CASSLDELWTVCTEAFF	TRBV5-5	TRBJ1-1
TGTGCCAGGCCGAGCATAGGGGTTAGCAATCAGCCCCAGCATTTT	CARPSIGVSNQPQHF	TRBV30	TRBJ1-5
TGTGCCACGAGGAGGGAAGACGTGGGACTAGCCAAAAACATTCAGTACTTC	CATRREDVGLAKNIQYF	TRBV6-6	TRBJ2-4
TGTGCCAGCAGTTACTGGGAGCCCCCGAGAAAAGACGACGCTGCCCTCCACTTT	CASSYWEPPRKDDAALHF	TRBV6-5	TRBJ1-6
TGTGCCAGCAGTTACATTTTGGACAGGGGGGGGGCTTTCTTT	CASSYILDRGGAFF	TRBV6-2	TRBJ1-1
TGTGCCAGCAGTGACGGGACAGGAGGGGGAAACACCATATATTTT	CASSDGTGGGNTIYF	TRBV6-4	TRBJ1-3
TGTGCCAGCAGCTCGAGCGGGAAAAGCAATCAGCCCCAGCATTTT	CASSSSGKSNQPQHF	TRBV5-6	TRBJ1-5
TGTGCCAGCATGGACCTGACTAGCGGGTACGAGCAGTACTTC	CASMDLTSGYEQYF	TRBV7-2	TRBJ2-7
TGTGCCAGCAGCACCCTAGTAGCGGTTCCGAACACCGGGGAGCTGTTTTTT	CASSTLVAVPNTGELFF	TRBV9	TRBJ2-2
TGTGCCACCTACGCAGGACAGAGGGCAGATACGCAGTATTTT	CATYAGQRADTQYF	TRBV24-1	TRBJ2-3
TGTGCCAGCGCCGGGGATCAAACCTACGAGCAGTACTTC	CASAGDQTYEQYF	TRBV6-5	TRBJ2-7
TGTGCCAGCAGCGGACAGGGGTACACCGGGGAGCTGTTTTTT	CASSGQGYTGELFF	TRBV7-6	TRBJ2-2
TGCGCCAGCAGCTCGGGGACTAGCGGGTCTGGGGCCAACGTCCTGACTTTC	CASSSGTSGSGANVLTF	TRBV5-1	TRBJ2-6
TGTGCCAGCAGCCAAGCGACAGGGGGGGCGGGCTACGAGCAGTACTTC	CASSQATGGAGYEQYF	TRBV14	TRBJ2-7
TGTGCCTGGACAGGGGTCCAGGGCCCCCCTCCCCAGCCCCAGCATTTT	CAWTGVQGPPPQPQHF	TRBV30	TRBJ1-5
TGTGCCAGCAGTGCACTTTTGGGCGACAATCAGCCCCAGCATTTT	CASSALLGDNQPQHF	TRBV6-1	TRBJ1-5
TGTGCCAGCAGTGAAACCAGCCCGGGGGGGTCTGAGCAGTTCTTC	CASSETSPGGSEQFF	TRBV6-1	TRBJ2-1
TGTGCCAGCAGGTATCCACGTCGGTCTGGTAGCAATCAGCCCCAGCATTTT	CASRYPRRSGSNQPQHF	TRBV7-9	TRBJ1-5
TGTGCCAGCAGCTTAGGGCAGGGGCTGATATATTTT	CASSLGQGLIYF	TRBV11-2	TRBJ1-3
TGTGCCAGCACAAAACACCGGGGAGGTAATAGCAATCAGCCCCAGCATTTT	CASTKHRGGNSNQPQHF	TRBV27	TRBJ1-5
TGTGCCAGCAGCGTAGGAGGTAGCGGGAAACTCTGCTACGAGCAGTACTTC	CASSVGGSGKLCYEQYF	TRBV9	TRBJ2-7
TGCGCCAGCAGCTTGACGGGAGGGGATAGGGACCGTTGCACAGATACGCAGTATTTT	CASSLTGGDRDRCTDTQYF	TRBV5-1	TRBJ2-3
TGTGCCAGCAGAGCCCCACTAAGTGAGACCCAGTACTTC	CASRAPLSETQYF	TRBV6-1	TRBJ2-5
TGTGCCAGCATTGACGTCTTGGCCTACGAGCAGTACTTC	CASIDVLAYEQYF	TRBV27	TRBJ2-7
TGTGCCAGCAGCTTAGAGAGGGACAGCCGGGGTAATTCACCCCTCCACTTT	CASSLERDSRGNSPLHF	TRBV7-2	TRBJ1-6
TGTGCCAGCAGTGACAGCGCGACTGAAGCTTTCTTT	CASSDSATEAFF	TRBV6-1	TRBJ1-1
TGCGCCAGCAGTGAGTCCCGCGGGAGCAGGGGAAGCTCCTACGAGCAGTACTTC	CASSESRGSRGSSYEQYF	TRBV10-1	TRBJ2-7
TGCGCCAGCAGCCAAGATCAACCAAAGACCGAGACAGAGAGGGGCACTGAAGCTTTCTTT	CASSQDQPKTETERGTEAFF	TRBV4-1	TRBJ1-1
TGTGCCAGCAGAGGACGGGAGCAGCCCCAGCATTTT	CASRGREQPQHF	TRBV6-1	TRBJ1-5
TGTGCCAGCAGATTGGACAGGGGGGATGAGCAGTTCTTC	CASRLDRGDEQFF	TRBV7-6	TRBJ2-1
TGCAGCGTTCCCGGGGACACATTGCGCAATGAGCAGTTCTTC	CSVPGDTLRNEQFF	TRBV29-1	TRBJ2-1
TGTGCCAGCAGCGGGTTAGGGGCTGAAGCTTTCTTT	CASSGLGAEAFF	TRBV3-1	TRBJ1-1
TGTGCCAGCAGCTTATGTTCTCCTGGAGGTAACTATAGGACTCTGCCGGGACGCTACGAGCAGTACTTC	CASSLCSPGGNYRTLPGRYEQYF	TRBV7-2	TRBJ2-7
TGTGCCAGCAGTTGGGGGGAATCAGATACGCAGTATTTT	CASSWGESDTQYF	TRBV6-5	TRBJ2-3
TGTGCCAGCAGCTTAACAGGGGATCAGCCCCAGCATTTT	CASSLTGDQPQHF	TRBV7-6	TRBJ1-5
TGTGCCAGCAGCTTGATGAATGGGGACAGGGGTGCAACTAATGAAAAACTGTTTTTT	CASSLMNGDRGATNEKLFF	TRBV5-6	TRBJ1-4
TGTGCCATCACCCGGCCGAGGGCGGGGACCGGGGAGCTGTTTTTT	CAITRPRAGTGELFF	TRBV10-3	TRBJ2-2
TGTGCCAGCAGTTTAACCTCCTCCGGACAGGGGACGAACACTGAAGCTTTCTTT	CASSLTSSGQGTNTEAFF	TRBV12-3	TRBJ1-1
TGTGCCAGCAGCCAAGCCCCCGACCAGTCACTAGTGCGGGAGTTACTAGCGGGGACGGACACCGGGGAGCTGTTTTTT	CASSQAPDQSLVRELLAGTDTGELFF	TRBV3-1	TRBJ2-2
TGTGCCTGGAGTCCCGAGACAGGGTGGTGCTCCTACGAGCAGTACTTC	CAWSPETGWCSYEQYF	TRBV30	TRBJ2-7
TGTGCCAGCAGCCATGACAGGGTAGGCACTGAAGCTTTCTTT	CASSHDRVGTEAFF	TRBV11-2	TRBJ1-1
TGTGCCAGCAGCGGATCAGGGACCCACACTGAAGCTTTCTTT	CASSGSGTHTEAFF	TRBV7-8	TRBJ1-1
TGCGCCAGCACGAAGCGGGCAGTCCGGTGGAACACCGGGGAGCTGTTTTTT	CASTKRAVRWNTGELFF	TRBV5-1	TRBJ2-2
TGTGCCAGCAGCTTGCCCTCTGTCGAGGAGGGGGAGACCCAGTACTTC	CASSLPSVEEGETQYF	TRBV5-4	TRBJ2-5
TGTGCCAGCAGTCGACAGGTGAGCTATGGCTACACCTTC	CASSRQVSYGYTF	TRBV27	TRBJ1-2
TGTGCCAGTACGGGCGAGGGGGGGCCAGAGACCCAGTACTTC	CASTGEGGPETQYF	TRBV19	TRBJ2-5
TGTGCCAGCAAAGATTTTGAGGAGTCCACGTCCAAAAACATTCAGTACTTC	CASKDFEESTSKNIQYF	TRBV9	TRBJ2-4
TGTGCCAGCGGAGAGTACGTTGGACTAGCGGGGCTTCCTTACGAGCAGTACTTC	CASGEYVGLAGLPYEQYF	TRBV12-4	TRBJ2-7
TGTGCCAGCAGCTTAGCGACCCCCGGCAATCAGCCCCAGCATTTT	CASSLATPGNQPQHF	TRBV7-9	TRBJ1-5
TGTGCCACCCGGGAAACTGATACGCAGTATTTT	CATRETDTQYF	TRBV27	TRBJ2-3
TGCAGCGTTGGCCGTCTGGTACATAGCAATCAGCCCCAGCATTTT	CSVGRLVHSNQPQHF	TRBV29-1	TRBJ1-5
TGTGCCACCAGTGCTAGGACTAGCGGGGAAAGCTCCTACAATGAGCAGTTCTTC	CATSARTSGESSYNEQFF	TRBV24-1	TRBJ2-1
TGTGCCAGCAGCCAAGAGAAGGGGGCTCCAACTAATGAAAAACTGTTTTTT	CASSQEKGAPTNEKLFF	TRBV14	TRBJ1-4
TGTGCCAGCAGCTTGAGGGACAGGGGGCCAACTAATGAAAAACTGTTTTTT	CASSLRDRGPTNEKLFF	TRBV5-5	TRBJ1-4
TGTGCCAGCAGCGGGGGGCTCACGAGGAAGTATCAGCCCCAGCATTTT	CASSGGLTRKYQPQHF	TRBV5-4	TRBJ1-5
TGTGCCAGCAGCCTCAGGGGGCGCGCCCGAAACACTGAAGCTTTCTTT	CASSLRGRARNTEAFF	TRBV7-3	TRBJ1-1
TGTGCCAGCAGTTGTTCGGACAGGGGCGGGTCGGGCTCTGGAAACACCATATATTTT	CASSCSDRGGSGSGNTIYF	TRBV27	TRBJ1-3
TGCAGTGCTAGAGATCAGGACTCCTACAATGAGCAGTTCTTC	CSARDQDSYNEQFF	TRBV20-1	TRBJ2-1
TGTGCCACCAGTGCCCTCCCTAGCGGGAGGGGAGATACGCAGTATTTT	CATSALPSGRGDTQYF	TRBV24-1	TRBJ2-3
TGCGCCAGCAGGCTAAAGAATCACGTTACAGATACGCAGTATTTT	CASRLKNHVTDTQYF	TRBV10-2	TRBJ2-3
TGTGCCAGCAGCAAACCAATGGGGGGGAAGTCGAACACCGGGGAGCTGTTTTTT	CASSKPMGGKSNTGELFF	TRBV7-2	TRBJ2-2
TGTGCCACCAGTGATGCCCAGGGGGGAACGAATAATGAAAAACTGTTTTTT	CATSDAQGGTNNEKLFF	TRBV24-1	TRBJ1-4
TGTGCCAGCAGTTGGAAAGGGGGACTGACCCTAACCTACAATGAGCAGTTCTTC	CASSWKGGLTLTYNEQFF	TRBV12-3	TRBJ2-1
TGTGCCAGCAGCTTAGCCGTAGGGGTCTCCTACGAGCAGTACTTC	CASSLAVGVSYEQYF	TRBV11-3	TRBJ2-7
TGTGCCAGCAGCCAAGGCTGCAGGACTAGCGGGACAATTCTCGGAGGGGAGCAGTACTTC	CASSQGCRTSGTILGGEQYF	TRBV14	TRBJ2-7
TGTGCCAGCAGCCAAGAAGGCCTAGCCTCCAGTGAACAAGAGACCCAGTACTTC	CASSQEGLASSEQETQYF	TRBV14	TRBJ2-5
TGTGCCAGCAGCTTATCACGGGACAGCAATCAGCCCCAGCATTTT	CASSLSRDSNQPQHF	TRBV7-3	TRBJ1-5
TGTGCCATCACTACCCGGACAGGGAGAGAGTTTGGCTCCTATAATTCACCCCTCCACTTT	CAITTRTGREFGSYNSPLHF	TRBV10-3	TRBJ1-6
TGTGCTAGTGGTTTCGGGTGGCTCTACGAGCAGTACTTC	CASGFGWLYEQYF	TRBV12-5	TRBJ2-7
TGTGCCAGCAGCGGCAGGGGTATTGAGACTCCTGAAGCTTTCTTT	CASSGRGIETPEAFF	TRBV6-4	TRBJ1-1
TGTGCCAGCAGCCAAGGATGGATCAGGGGCGCAAATGAGCAGTTCTTC	CASSQGWIRGANEQFF	TRBV4-2	TRBJ2-1
TGCGCCAGCAGCTTGATCAAAACCGGGTACGAGCAGTACTTC	CASSLIKTGYEQYF	TRBV5-1	TRBJ2-7
TGCAGTGCTCGCCAAACGGACAGGGGGTACGAGCAGTACTTC	CSARQTDRGYEQYF	TRBV20-1	TRBJ2-7
TGTGCCAGCAGTTCTCCCTGGCTCGACAATGAGCAGTTCTTC	CASSSPWLDNEQFF	TRBV27	TRBJ2-1
TGCGCCAGCAGCTTGGGGTGGATCGGAGGGGTCCGGAGGAGATTCCAAAATGAGCAGTTCTTC	CASSLGWIGGVRRRFQNEQFF	TRBV5-1	TRBJ2-1
TGTGCCAGCGGGACAGGGAAACCTTGGACGGTCGGGTGGTCGTCCTACAATGAGCAGTTCTTC	CASGTGKPWTVGWSSYNEQFF	TRBV13	TRBJ2-1
TGTGCCAGCAGCGGCCCCTACCTAGCGGGCTCCTACGAGCAGTACTTC	CASSGPYLAGSYEQYF	TRBV11-1	TRBJ2-7
TGTGCCAGCAGCACGACCGCAGATACGCAGTATTTT	CASSTTADTQYF	TRBV7-2	TRBJ2-3
TGCAGTGCGTGGCTACCCCCTCTGATCTATGAGCAGTTCTTC	CSAWLPPLIYEQFF	TRBV20-1	TRBJ2-1
TGTGCCAGCAGTCCCGCGCGGGGGGGCGTTTCCTACGAGCAGTACTTC	CASSPARGGVSYEQYF	TRBV25-1	TRBJ2-7
TGTGCCAGCTCACCCCAGGACAGGGGGCGCTCAGAGACCCAGTACTTC	CASSPQDRGRSETQYF	TRBV18	TRBJ2-5
TGCGCCAGCAGACAGGGACTCAATCAGCCCCAGCATTTT	CASRQGLNQPQHF	TRBV5-1	TRBJ1-5
TGTGCCAGCAGCTCTAGCCTCACGACAGGGGGCCTAGCCTACGAGCAGTACTTC	CASSSSLTTGGLAYEQYF	TRBV3-1	TRBJ2-7
TGTGCCAGCAGCCACGGTTCGGACTACGAGCAGTACTTC	CASSHGSDYEQYF	TRBV14	TRBJ2-7
TGCAGTGCGACCAATGGTCCATATAGCAATCAGCCCCAGCATTTT	CSATNGPYSNQPQHF	TRBV20-1	TRBJ1-5
TGTGCCAGCAGCTCGCTAGCGGGAGCAATGGGGGGAGGCTACGAGCAGTACTTC	CASSSLAGAMGGGYEQYF	TRBV7-3	TRBJ2-7
TGTGCCACCAGTGATTTGGACCAAGGGGTTGACGGGTCCAGCTCCTACGAGCAGTACTTC	CATSDLDQGVDGSSSYEQYF	TRBV24-1	TRBJ2-7
TGTGCGCGACTGCGCACAGATACGCAGTATTTT	CARLRTDTQYF	TRBV15	TRBJ2-3
TGTGCCAGCATTGCATCGATGGACGACGAGCAGTACTTC	CASIASMDDEQYF	TRBV11-3	TRBJ2-7
TGTGCCAGCAGCTCACCAGGGCATAATGAAAAACTGTTTTTT	CASSSPGHNEKLFF	TRBV11-1	TRBJ1-4
TGTGCCAGCAGTTCCAAACAGGGGTCAGAGGGCTCTGGAAACACCATATATTTT	CASSSKQGSEGSGNTIYF	TRBV28	TRBJ1-3
TGTGCCAGCAGCCCCCCTCTGGGGGCCACCGGGGAGCTGTTTTTT	CASSPPLGATGELFF	TRBV11-2	TRBJ2-2
TGTGCCAGCAGCGTAGGGGTGGGGGGGCAGTCCTACAATGAGCAGTTCTTC	CASSVGVGGQSYNEQFF	TRBV9	TRBJ2-1
TGTGCCAGCAGCTTGGGGGGGACTTCCACTGAAGCTTTCTTT	CASSLGGTSTEAFF	TRBV5-5	TRBJ1-1
TGTGCCAGCAGCCCGACGGGTGAGCAGTTCTTC	CASSPTGEQFF	TRBV7-4	TRBJ2-1
TGTGCCAGCAGCTTTCCGGCCTGGTATAGCAATCAGCCCCAGCATTTT	CASSFPAWYSNQPQHF	TRBV11-2	TRBJ1-5
TGTGCCAGCAGCTTCCCCTTGTCGACAGTAGTTAGTGACAATGAGCAGTTCTTC	CASSFPLSTVVSDNEQFF	TRBV7-2	TRBJ2-1
TGTGCCAGCAAGATCAGGGGGGAGGAAAACATTCAGTACTTC	CASKIRGEENIQYF	TRBV6-6	TRBJ2-4
TGTGCCAGCAGTTTATCCACAGAGTTCTCCAACTATGGCTACACCTTC	CASSLSTEFSNYGYTF	TRBV12-3	TRBJ1-2
TGTGCCAGCATTGCAAGGGGGTGTGGTAGACCGGCCCTGAACATTCAGTACTTC	CASIARGCGRPALNIQYF	TRBV6-1	TRBJ2-4
TGTGCCACCAGTGATTCACCGGGACGCCCCACAGATACGCAGTATTTT	CATSDSPGRPTDTQYF	TRBV24-1	TRBJ2-3
TGTGCCAGCAGTTACGCCGGATCGAGGGGCAGGTGCACAGATACGCAGTATTTT	CASSYAGSRGRCTDTQYF	TRBV6-5	TRBJ2-3
TGTGCCAGCAGCTTCCGCGGGGGGGGGCCCGAGCAGTACTTC	CASSFRGGGPEQYF	TRBV7-3	TRBJ2-7
TGTGCCAGCAGTGGAAGCGACAGGGGGCGGGGAGCTAGCACAGATACGCAGTATTTT	CASSGSDRGRGASTDTQYF	TRBV6-4	TRBJ2-3
TGTGCCAGCAGTGCCAGAAGGGACTTGGTCGGGTCCCACTACACTGAAGCTTTCTTT	CASSARRDLVGSHYTEAFF	TRBV2	TRBJ1-1
TGTGCCAGCAGTGGTCGCGGGAGTAGTGGAAACACCATATATTTT	CASSGRGSSGNTIYF	TRBV2	TRBJ1-3
TGTGCCAGCAGCGTAGTTGGGGGGGGCTGTGGCTACACCTTC	CASSVVGGGCGYTF	TRBV9	TRBJ1-2
TGTGCCAGCGGTGGGGGGCGGGGCCTCGAGCAGTACTTC	CASGGGRGLEQYF	TRBV6-4	TRBJ2-7
TGTGCCACCAGCAGAGATCTTTTCGGGACAGGGGTGACAACTAATGAAAAACTGTTTTTT	CATSRDLFGTGVTTNEKLFF	TRBV15	TRBJ1-4
TGTGCCCCGGACAGGGGCTACACCTTC	CAPDRGYTF	TRBV2	TRBJ1-2
TGTGCCAGTAGTATCGCTGGACGGTACAACTACAACACTGAAGCTTTCTTT	CASSIAGRYNYNTEAFF	TRBV19	TRBJ1-1
TGTGCCAGCAGTGACGGACAGAAGCAGACCCAGTACTTC	CASSDGQKQTQYF	TRBV6-4	TRBJ2-5
TGTGCCATCAGACTCCCGGGACAGTTTAACTGGAACACTGAAGCTTTCTTT	CAIRLPGQFNWNTEAFF	TRBV10-3	TRBJ1-1
TGTGCCAGCAGCTCGTGGGGGTCCTTCGAGCAGTACTTC	CASSSWGSFEQYF	TRBV11-3	TRBJ2-7
TGTGCCAGCAGTGCCCCTCGCCTTAGGAAGCGCGGGATCAACACCGGGGAGCTGTTTTTT	CASSAPRLRKRGINTGELFF	TRBV6-4	TRBJ2-2
TGTGCCAGCAGTTACTCGAGGACGTTAAAGGAGGCCTACGAGCAGTACTTC	CASSYSRTLKEAYEQYF	TRBV6-6	TRBJ2-7
TGTGCCACCAGTGGGGAGGAGTCCCAGCCCCAGCATTTT	CATSGEESQPQHF	TRBV24-1	TRBJ1-5
TGCGCCAGCAGCAGTACCGCACGGGGGGGACGATACTACGAGCAGTACTTC	CASSSTARGGRYYEQYF	TRBV5-1	TRBJ2-7
TGTGCCAGCAGTTTACCTCCTACTTGTATAAGACAGGGGGCGCAGGATCAGCCCCAGCATTTT	CASSLPPTCIRQGAQDQPQHF	TRBV28	TRBJ1-5
TGTGCCAGCTCACCACGTCGGAGGTCTCAGTATTTT	CASSPRRRSQYF	TRBV18	TRBJ2-3
TGTGCCAGCAGGAAACAAGACAGGATGAACACTGAAGCTTTCTTT	CASRKQDRMNTEAFF	TRBV27	TRBJ1-1
TGTGCCAGCAGCGTAGAGCTACACAGGGCGTGGCTGTACGAGCAGTACTTC	CASSVELHRAWLYEQYF	TRBV9	TRBJ2-7
TGTGCCAGCAGCGCGGGAGGAACTCTGACTGAAGCTTTCTTT	CASSAGGTLTEAFF	TRBV5-5	TRBJ1-1
TGTGCCAGCAGGGAGTTAAGATGCAGTCCCTACGAGCAGTACTTC	CASRELRCSPYEQYF	TRBV5-5	TRBJ2-7
TGCAGTGCTAGGGTTCATCCCTCCGCGGGACTAGCGGGGGGAGTCTACAATGAGCAGTTCTTC	CSARVHPSAGLAGGVYNEQFF	TRBV20-1	TRBJ2-1
TGTGCCAGCCCGGGGGAGAATGGCTACACCTTC	CASPGENGYTF	TRBV7-3	TRBJ1-2
TGTGCCAGCAGTATCGTCCGGGACAGGGGAGATATCTACGAGCAGTACTTC	CASSIVRDRGDIYEQYF	TRBV6-5	TRBJ2-7
TGTGCCAGCAGCCCCCAGGGGCCGGAAAAACTGTTTTTT	CASSPQGPEKLFF	TRBV13	TRBJ1-4
TGTGCCAGCAGCCCCCCAGGGGGAGGGTTCTGCAGCTCCTACGAGCAGTACTTC	CASSPPGGGFCSSYEQYF	TRBV5-6	TRBJ2-7
TGTGCCAGCAGTTACTCGTCGGAGCACTTGTACGAGCAGTACTTC	CASSYSSEHLYEQYF	TRBV6-8	TRBJ2-7
TGTGCCTGGACCGCTTGGATCGAGCAGTACTTC	CAWTAWIEQYF	TRBV30	TRBJ2-7
TGTGCCAGCAGTTACATCCCAAGCAGGGGGCAATACGAGCAGTACTTC	CASSYIPSRGQYEQYF	TRBV6-3	TRBJ2-7
TGTGCCAGCAGCGGAAAAGGGAGGGCGCATGAGCAGTTCTTC	CASSGKGRAHEQFF	TRBV9	TRBJ2-1
TGCGCCAGCAGGGTAGGGGGGGCCAACGTCCTGACTTTC	CASRVGGANVLTF	TRBV10-1	TRBJ2-6
TGCGCCAGCAGCTTGTCCGTAAGGGTTGAGCAGTACTTC	CASSLSVRVEQYF	TRBV5-1	TRBJ2-7
TGTGCCAGCAGCTTACAGGGAAGCTACGAGCAGTACTTC	CASSLQGSYEQYF	TRBV5-5	TRBJ2-7
TGCGCCAGCAACAGGGGCGAAAAACTGTTTTTT	CASNRGEKLFF	TRBV10-1	TRBJ1-4
TGTGCCAGCAGTTTTCGGGTAACGTTATACGAGCAGTACTTC	CASSFRVTLYEQYF	TRBV12-3	TRBJ2-7
TGTGCCAGCAGCCGGGGAGCGGGAACTGGGGCAGATACGCAGTATTTT	CASSRGAGTGADTQYF	TRBV4-2	TRBJ2-3
TGCAGTGCTAGCCTATTCCTTCTCTCAGGCCGGGCCAAAAACATTCAGTACTTC	CSASLFLLSGRAKNIQYF	TRBV20-1	TRBJ2-4
TGTGCCAGCAAGTCTGAAGTGGGCCCTGAGACTGAGCAGTTCTTC	CASKSEVGPETEQFF	TRBV6-4	TRBJ2-1
TGCGCCAGCAGGGGTGGACTAGAGGAGCAGTTCTTC	CASRGGLEEQFF	TRBV5-1	TRBJ2-1
TGCAGCAAGGGAGGGGCTGGCTACACCTTC	CSKGGAGYTF	TRBV29-1	TRBJ1-2
TGTGCCACCAGTGATTTGCCCGGGACTAGAGACTACGAGCAGTACTTC	CATSDLPGTRDYEQYF	TRBV24-1	TRBJ2-7
TGCGCCAGCAGCCCGCTAGGGGATGGAAACACCATATATTTT	CASSPLGDGNTIYF	TRBV5-1	TRBJ1-3
TGTGCCAGCAGCCAAGATCCAGGACAGACATTGCTGTTTTTT	CASSQDPGQTLLFF	TRBV14	TRBJ1-4
TGTGCCAGCAGCTTATATCTGACAGGGGGGGGGCACACTGAAGCTTTCTTT	CASSLYLTGGGHTEAFF	TRBV11-1	TRBJ1-1
TGCGCCAGCAGCCCGGGGGACTATGAATCCTACGAGCAGTACTTC	CASSPGDYESYEQYF	TRBV4-3	TRBJ2-7
TGTGCCACCAAATGTATAGCGGGAGGGTGTCAAGAGACCCAGTACTTC	CATKCIAGGCQETQYF	TRBV24-1	TRBJ2-5
TGTGCCAGCGGAGGTGAGGCAGGGCATAATCAGCCCCAGCATTTT	CASGGEAGHNQPQHF	TRBV27	TRBJ1-5
TGTGCCCAAAACAGGGGGCGCACCCGAAACACCATATATTTT	CAQNRGRTRNTIYF	TRBV19	TRBJ1-3
TGTGCCAGCACCGGTCGGCATAAATACTTC	CASTGRHKYF	TRBV9	TRBJ2-7
TGTGCAAAAGGCCCAGGGGAAGGGGAGGGTACCGGGGAGCTGTTTTTT	CAKGPGEGEGTGELFF	TRBV2	TRBJ2-2
TGTGCCAGCAGCTTGAGTACTAGCGGAGGAAATGAGCAGTTCTTC	CASSLSTSGGNEQFF	TRBV5-6	TRBJ2-1
TGTGCCTCCCCAAAGTTTACTAGCGGGTACAATGAGCAGTTCTTC	CASPKFTSGYNEQFF	TRBV7-9	TRBJ2-1
TGTGCCAGCAGCTTCAACCAGGGATCAGTGAACACTGAAGCTTTCTTT	CASSFNQGSVNTEAFF	TRBV13	TRBJ1-1
TGCGCCAGCAGCCAAGAACGCGGGACAGGGTGCCGGGACGAGCAGTACTTC	CASSQERGTGCRDEQYF	TRBV4-3	TRBJ2-7
TGTGCCAGCAGCCAAAAGACAGTCATCTACGAGCAGTACTTC	CASSQKTVIYEQYF	TRBV11-3	TRBJ2-7
TGTGCCAGCAGCCCGGGGGGGCTCAGTAAAACCTACGAGCAGTACTTC	CASSPGGLSKTYEQYF	TRBV2	TRBJ2-7
TGTGCCAGTAGTAGACAGGGGGAGGTCTACGAGCAGTACTTC	CASSRQGEVYEQYF	TRBV19	TRBJ2-7
TGTGCCAGCAGCTTAGGGGGGGAAAGGAATTATTCACCCCTCCACTTT	CASSLGGERNYSPLHF	TRBV7-2	TRBJ1-6
TGTGCCAGCCGGACAGGCAGGACACCCCAGCATTTT	CASRTGRTPQHF	TRBV6-4	TRBJ1-5
TGTGCCAGCAGCGTTGGAATTCGGACCGACACTAGGGGCACAGATACGCAGTATTTT	CASSVGIRTDTRGTDTQYF	TRBV9	TRBJ2-3
TGTGCCAGCAGTTTCCTTCAGGGAGGGTACCCCTCTAAGGAATCCACCTACGAGCAGTACTTC	CASSFLQGGYPSKESTYEQYF	TRBV12-3	TRBJ2-7
TGTGCCAGCAGCTTCCGCCTGAAGTCCGGTTCCTTCTACGAGCAGTACTTC	CASSFRLKSGSFYEQYF	TRBV7-3	TRBJ2-7
TGTGCCAGCAGCCGTGGGCGCTCTGGAAACACCATATATTTT	CASSRGRSGNTIYF	TRBV13	TRBJ1-3
TGTGCCCACCGGGAAATCTCCTACGAGCAGTACTTC	CAHREISYEQYF	TRBV3-1	TRBJ2-7
TGTGCCAGCAGCTTAGCAGGAGTGCCTCATAATTCACCCCTCCACTTT	CASSLAGVPHNSPLHF	TRBV7-2	TRBJ1-6
TGTGCCAGCAGTTTTACACAGGGAAGTGAAGCTTTCTTT	CASSFTQGSEAFF	TRBV12-3	TRBJ1-1
TGTGCCAGCAGCCCGAACCGGCAGTTTGGCTACACCTTC	CASSPNRQFGYTF	TRBV3-1	TRBJ1-2
TGTGCCAGCAGTCCAGGTATTCCGGGATGGCTCCCTCATGGGGCCAACGTCCTGACTTTC	CASSPGIPGWLPHGANVLTF	TRBV28	TRBJ2-6
TGTGCCAGCACCCCACCGCTAGGGAACTATGGCTACACCTTC	CASTPPLGNYGYTF	TRBV2	TRBJ1-2
TGCAGTGCTAGACCAGGTTTTTACAGGCCTCCTGAAGCTTTCTTT	CSARPGFYRPPEAFF	TRBV20-1	TRBJ1-1
TGTGCCAGTAGCGAAATACCTGGACAGTTCTATGGCTACACCTTC	CASSEIPGQFYGYTF	TRBV19	TRBJ1-2
TGTGCCAGCAGCTTAGAGAAGGGGGGGACAGAGACCCAGTACTTC	CASSLEKGGTETQYF	TRBV7-2	TRBJ2-5
TGTGCCAGCAGCTTGAGGGAGCGGGAGGTCGGGGAGCTGTTTTTT	CASSLREREVGELFF	TRBV5-6	TRBJ2-2
TGCAGTGCTATAACCAGCGGCTACGCTCCGAACACCGGGGAGCTGTTTTTT	CSAITSGYAPNTGELFF	TRBV20-1	TRBJ2-2
TGTGCACCTCTTGTCGACAGGGTTTGCTACGAGCAGTACTTC	CAPLVDRVCYEQYF	TRBV3-1	TRBJ2-7
TGTGCCAGCAAAGGGGGGGCCTCATACGAGCAGTACTTC	CASKGGASYEQYF	TRBV6-1	TRBJ2-7
TGTGCCAACCTGTTCGGCCCGGGGTACAATGAGCAGTTCTTC	CANLFGPGYNEQFF	TRBV6-3	TRBJ2-1
TGCAGCGTTGGGCCCCCGACAGGCCTCTATGGCTACACCTTC	CSVGPPTGLYGYTF	TRBV29-1	TRBJ1-2
TGTGCCAGTAGTATAGGTTTGGCTTGGACTGTTGCTAACTATGGCTACACCTTC	CASSIGLAWTVANYGYTF	TRBV19	TRBJ1-2
TGTGCCAGCAGCTTACCAAGGACACTTTTGAACACTGAAGCTTTCTTT	CASSLPRTLLNTEAFF	TRBV7-2	TRBJ1-1
TGTGCCAGCAGCCAAGGGGTAAACGGGATGGCGAACACCGGGGAGCTGTTTTTT	CASSQGVNGMANTGELFF	TRBV14	TRBJ2-2
TGTGCCAGCAGGGGGGGCGCGGCTTTCTTT	CASRGGAAFF	TRBV12-4	TRBJ1-1
TGTGCCAGCAGTGGCATAAGTCTGGGCTACGAGCAGTACTTC	CASSGISLGYEQYF	TRBV27	TRBJ2-7
TGTGCCCCAAAGGCGGTCACTGAAGCTTTCTTT	CAPKAVTEAFF	TRBV19	TRBJ1-1
TGTGCCAGCCGACCGGACGGTCTACATACACCTAACTATGGCTACACCTTC	CASRPDGLHTPNYGYTF	TRBV6-2	TRBJ1-2
TGTGCCAGCAGGGGTCTACAAGGGATTTGGAGCGGGGCCATATATTTT	CASRGLQGIWSGAIYF	TRBV28	TRBJ1-3
TGTGCCAGCAGCCCACGACAGTACTATGGCTACACCTTC	CASSPRQYYGYTF	TRBV7-9	TRBJ1-2
TGTGCCAGCAGTGTCCTTTCTGAACGTCGGGAGGGCTATGGCTACACCTTC	CASSVLSERREGYGYTF	TRBV6-5	TRBJ1-2
TGTGCCAGCAGTGTGCGGGAACGGACAGGGGTTGACTTTCATAGGATACCAGATACGCAGTATTTT	CASSVRERTGVDFHRIPDTQYF	TRBV6-1	TRBJ2-3
TGTGCCAGCTCACCAGTGGCCTTCTTTGCAGGGCTAACTAATGAAAAACTGTTTTTT	CASSPVAFFAGLTNEKLFF	TRBV18	TRBJ1-4
TGTGCCAGCACAAATCCCAGGGGGCTTTTTGCGGCTAACTATGGCTACACCTTC	CASTNPRGLFAANYGYTF	TRBV27	TRBJ1-2
TGCAGCGTCGTTTCCCCATGGGACTCGAACACTGAAGCTTTCTTT	CSVVSPWDSNTEAFF	TRBV29-1	TRBJ1-1
TGTGCCAGCAGTTTGCCAAAACTGGTAGGGTCACCCCTCCACTTT	CASSLPKLVGSPLHF	TRBV12-4	TRBJ1-6
TGTGCCAGCAGTCCTGGCGGGACAGGGGGTTTGCAGTTCTTC	CASSPGGTGGLQFF	TRBV2	TRBJ2-1
TGTGCCAGCAGTTTCCATAATAGTTACTTCAATCAGCCCCAGCATTTT	CASSFHNSYFNQPQHF	TRBV12-4	TRBJ1-5
TGTGCTAGTGGTATCCTATGGGGGCGCGAATCGGCTTTCTTT	CASGILWGRESAFF	TRBV12-5	TRBJ1-1
TGTGCCAGCAGCGTAGGCGTAGAAAGAACAGGAAGGGAGACAGATACGCAGTATTTT	CASSVGVERTGRETDTQYF	TRBV9	TRBJ2-3
TGTGCCAGCAGCTTAGTAACATGCTACGAGCAGTACTTC	CASSLVTCYEQYF	TRBV7-3	TRBJ2-7
TGTGCCACCAGTGATTTCCTTAGACAGCCCCAGCATTTT	CATSDFLRQPQHF	TRBV24-1	TRBJ1-5
TGTGCCAGCAGCTTACAAGGGGAGAAGGGCTACACCTTC	CASSLQGEKGYTF	TRBV7-7	TRBJ1-2
TGTGCCAGCAGTCTGCTGGATACGCAGTATTTT	CASSLLDTQYF	TRBV6-2	TRBJ2-3
TGCGCCAGCAGCACAGGGACACGAACACCAAGCACAGATACGCAGTATTTT	CASSTGTRTPSTDTQYF	TRBV5-1	TRBJ2-3
TGCAGCGTTGAGGGGGCACTAGCGGGAACCTACGAGCAGTACTTC	CSVEGALAGTYEQYF	TRBV29-1	TRBJ2-7
TGTGCCAGCAGTTACCCGCGGTTCACAGGGGTCGTGAACACTGAAGCTTTCTTT	CASSYPRFTGVVNTEAFF	TRBV6-5	TRBJ1-1
TGTGCCACCAGTGATTTGGCGTCCATCAATTTCAATGAGCAGTTCTTC	CATSDLASINFNEQFF	TRBV24-1	TRBJ2-1
TGCGCCAGCAGCTTGGACAGCTTTCACGAGCAGTACTTC	CASSLDSFHEQYF	TRBV5-1	TRBJ2-7
TGCGCCAGCAGCCCGGAGAGGGGGGGAGCCATCTCCAATCAGCCCCAGCATTTT	CASSPERGGAISNQPQHF	TRBV4-3	TRBJ1-5
TGTGCCAGCAGTTGGGGGGACGTTAGGGGAAGGGCTTTGTATTTT	CASSWGDVRGRALYF	TRBV12-3	TRBJ2-3
TGCAGCGTTGACCGGGACAGGGGAACAGCCGGGGAGCTGTTTTTT	CSVDRDRGTAGELFF	TRBV29-1	TRBJ2-2
TGTGCCAGCAGCAGGGTTCCGCCAGAAAGCTACGAGCAGTACTTC	CASSRVPPESYEQYF	TRBV7-2	TRBJ2-7
TGTGCCAGCTCACCCCCCCCCCCGCTGAGGGGGGTCTGGGCCGGGGGTTACCCCCGGGGCCGGAACACTGAAGCTTTCTTT	CASSPPPPLRGVWAGGYPRGRNTEAFF	TRBV18	TRBJ1-1
TGCAGTGCTCACCCTACAGACCTTGTTGTCTCTGGGGCCAACGTCCTGACTTTC	CSAHPTDLVVSGANVLTF	TRBV20-1	TRBJ2-6
TGTGCCAGCAGCTGCACTAGCGGGAGGGCCCCGACCTACGAGCAGTACTTC	CASSCTSGRAPTYEQYF	TRBV7-9	TRBJ2-7
TGCGCCAGCAGTGCATGGGGCAGGTACAATGAGCAGTTCTTC	CASSAWGRYNEQFF	TRBV10-1	TRBJ2-1
TGTGCCAGCAGCAATAGGCATACAATGGGCACAGATACGCAGTATTTT	CASSNRHTMGTDTQYF	TRBV9	TRBJ2-3
TGTGCCAGCAGTTTCCCCTACAAGTTGATTCGGAGCTACAATGAGCAGTTCTTC	CASSFPYKLIRSYNEQFF	TRBV27	TRBJ2-1
TGTGCCAGCAGCCCGGGCGGGACGTTTCAAGAGACCCAGTACTTC	CASSPGGTFQETQYF	TRBV7-3	TRBJ2-5
TGTGCCATCAGGGCACAGGGGCGCCGGGGGTTTCAGCCCCAGCATTTT	CAIRAQGRRGFQPQHF	TRBV10-3	TRBJ1-5
TGTGCCAGCAGCTGCAAGGGACGTGCAGGGATAGGGCTAACCACAGCTTTCTTT	CASSCKGRAGIGLTTAFF	TRBV5-4	TRBJ1-1
TGTGCCAGCAGTTACCGCCACCGTGGAAACTATGGCTACACCTTC	CASSYRHRGNYGYTF	TRBV6-5	TRBJ1-2
TGTGCCAGCAGCTCCGCTCCGGGATATCACTGCCTCCGAGGCTCTGCCTACGAGCAGTACTTC	CASSSAPGYHCLRGSAYEQYF	TRBV7-9	TRBJ2-7
TGTGCCAGCAGCGTCGGGAGGGTGGTTAATGAAAAACTGTTTTTT	CASSVGRVVNEKLFF	TRBV7-7	TRBJ1-4
TGCGCCAGCAGCCCCGCAGTACCTAATGAAAAACTGTTTTTT	CASSPAVPNEKLFF	TRBV5-1	TRBJ1-4
TGTGCCAGGTCCCCAGGGCGGGACATTAGCCGTGATCAGCCCCAGCATTTT	CARSPGRDISRDQPQHF	TRBV19	TRBJ1-5
TGTGCCAGCAGCTTAGGGCGAGACGAGCAGTACTTC	CASSLGRDEQYF	TRBV7-3	TRBJ2-7
TGTGCCAGAAGGACGGGGCCCTGTTACATTCAGTACTTC	CARRTGPCYIQYF	TRBV6-1	TRBJ2-4
TGTGCCAGCAGTGACTCGAGAACAGAAGCTTTCTTT	CASSDSRTEAFF	TRBV27	TRBJ1-1
TGTGCCAGCAGCCGGACCCCCCAGGGATCTCGCAATCAGCCCCAGCATTTT	CASSRTPQGSRNQPQHF	TRBV12-4	TRBJ1-5
TGTGCCAGCTCACCCCTGACCACAGGGGTCTGGGAAGCAAACACTGAAGCTTTCTTT	CASSPLTTGVWEANTEAFF	TRBV18	TRBJ1-1
TGCAGTGCTCCGGGACAGCGGTGTGGCACAGATACGCAGTATTTT	CSAPGQRCGTDTQYF	TRBV20-1	TRBJ2-3
TGTGCCAGCAGCCTTTCTGAGGGGGGGAACCACGAGCAGTACTTC	CASSLSEGGNHEQYF	TRBV7-2	TRBJ2-7
TGTGCCAGCAGTGGCCGAGGGAACGTGGGCACAGATACGCAGTATTTT	CASSGRGNVGTDTQYF	TRBV12-3	TRBJ2-3
TGTGCCAGCAGGACAGGGACTGAAGCTTTCTTT	CASRTGTEAFF	TRBV6-4	TRBJ1-1
TGTGCCAGCAGCCTAAGGGACAGATCGGTTTCCTACGAGCAGTACTTC	CASSLRDRSVSYEQYF	TRBV13	TRBJ2-7
TGTGCCAGCAGCTTAGCAGGGGGGGATGAAAAACTGTTTTTT	CASSLAGGDEKLFF	TRBV7-6	TRBJ1-4
TGTGCCAGCTCACCAGCGTCGGGTGGGACAGCTTTTAACACTGAAGCTTTCTTT	CASSPASGGTAFNTEAFF	TRBV18	TRBJ1-1
TGTGCCAGCAGCCTACCGGGACTAGCGGGGGGTGCCTACAATGAGCAGTTCTTC	CASSLPGLAGGAYNEQFF	TRBV6-1	TRBJ2-1
TGTGCCAGCAGCGGCCTGCTAGTCGTTGGAAACACCATATATTTT	CASSGLLVVGNTIYF	TRBV11-3	TRBJ1-3
TGTGCCAGTAGTCGGCACCCTAGCAGCTTCGTTAACAGTAATTCACCCCTCCACTTT	CASSRHPSSFVNSNSPLHF	TRBV19	TRBJ1-6
TGTGCCAGCAGTGTTCTACCTCAGGGGGCTTTCTTT	CASSVLPQGAFF	TRBV6-4	TRBJ1-1
TGTGCCAGCAGCTTCGGGGGAGAGGATTCACCCCTCCACTTT	CASSFGGEDSPLHF	TRBV13	TRBJ1-6
TGTGCCAGCACTAGCGGGAGGTACAGCACAGATACGCAGTATTTT	CASTSGRYSTDTQYF	TRBV6-2	TRBJ2-3
TGTGCCAGCAGCCCTCTTCAGGGGGCCTGGCTTGAAAAACTGTTTTTT	CASSPLQGAWLEKLFF	TRBV28	TRBJ1-4
TGTGCCAGCATCATCGAAGACGAGCAGTACTTC	CASIIEDEQYF	TRBV11-3	TRBJ2-7
TGCGCCAGCGCCACCCAGGGAACAGTCACCGGGGAGCTGTTTTTT	CASATQGTVTGELFF	TRBV10-1	TRBJ2-2
TGTGCCAGCACCTTCTGTACGCGGGACAGTACCATATATTTT	CASTFCTRDSTIYF	TRBV6-5	TRBJ1-3
TGCGCCAGCGGGGGAGGTTGCGTTGGGCGCAATCAGCCCCAGCATTTT	CASGGGCVGRNQPQHF	TRBV10-1	TRBJ1-5
TGTGCCAGCAGCAGGTGGAAGACAGGGTGGTTTGATAATATGAACACTGAAGCTTTCTTT	CASSRWKTGWFDNMNTEAFF	TRBV13	TRBJ1-1
TGTGCCAGCAGTGACGACCGGGGCAATCAGCCCCAGCATTTT	CASSDDRGNQPQHF	TRBV6-4	TRBJ1-5
TGTGCCAGCAGTTACTCGACCGGGACAGGCGCGGCATTCTCGCAGCCCCAGCATTTT	CASSYSTGTGAAFSQPQHF	TRBV6-8	TRBJ1-5
TGTGCCAGCAGCAGTCGGGAACGGGGGGGTAGAACCGGGGAGCTGTTTTTT	CASSSRERGGRTGELFF	TRBV13	TRBJ2-2
TGTGCCAGCAGCTGGACTAGCGGGGGGGCAGGGAATGAGCAGTTCTTC	CASSWTSGGAGNEQFF	TRBV7-9	TRBJ2-1
TGCAGCAGGGGGACTAGTTGCACAGATACGCAGTATTTT	CSRGTSCTDTQYF	TRBV29-1	TRBJ2-3
TGTGCCACCGATGGTCTGGGACACTACGAGCAGTACTTC	CATDGLGHYEQYF	TRBV15	TRBJ2-7
TGTGCCAGCAGCTTAGGGGGGAAGGATGGCTACACCTTC	CASSLGGKDGYTF	TRBV5-6	TRBJ1-2
TGTGCCAGCAGCTTAGCCGCGCGGGAGTTTCAGCCCCAGCATTTT	CASSLAAREFQPQHF	TRBV11-3	TRBJ1-5
TGTGCCAGCAGTTTCTGGGGGGGCTGGAGTGGAAACACCGGGGAGCTGTTTTTT	CASSFWGGWSGNTGELFF	TRBV12-3	TRBJ2-2
TGTGCCAGCAGGGGAGTTGCGGGACAAGAGACCCAGTACTTC	CASRGVAGQETQYF	TRBV5-6	TRBJ2-5
TGCGCCAGCAGGAGACCGTCCGGAAAGCAGTCGTCCTACGAGCAGTACTTC	CASRRPSGKQSSYEQYF	TRBV10-1	TRBJ2-7
TGCAGCGTTGAGTGGTCCGGCCCTAGCACAGATACGCAGTATTTT	CSVEWSGPSTDTQYF	TRBV29-1	TRBJ2-3
TGTGCCAGCAGTAATTCCGGACGAACGAACACCTTC	CASSNSGRTNTF	TRBV6-2	TRBJ1-2
TGTGCCAGCAGTGAAATTTTACGGGACAGCTCCTATAATTCACCCCTCCACTTT	CASSEILRDSSYNSPLHF	TRBV6-4	TRBJ1-6
TGTGCCAGCAGCCCGGGACAGAATCTGGGAGAGACCCAGTACTTC	CASSPGQNLGETQYF	TRBV7-8	TRBJ2-5
TGCAGTGCGGGGGTTTGGGAGCAGTACTTC	CSAGVWEQYF	TRBV20-1	TRBJ2-7
TGCGCCAGCAGCAAGGACAGGTCCGGGGAGCTGTTTTTT	CASSKDRSGELFF	TRBV10-1	TRBJ2-2
TGTGCCAGCAGTTACTCGTTTCAGCAGGGCTATGGCTACACCTTC	CASSYSFQQGYGYTF	TRBV6-5	TRBJ1-2
TGTGCCAGCAGGATGCGGACTAGCGGAAGGACGAACACCGGGGAGCTGTTTTTT	CASRMRTSGRTNTGELFF	TRBV11-2	TRBJ2-2
TGTGCCAACAGACAGGTCACTGAAGCTTTCTTT	CANRQVTEAFF	TRBV19	TRBJ1-1
TGTGCTAGCAGCTTAGAACCAGGCAGGGTAATTAACACTGAAGCTTTCTTT	CASSLEPGRVINTEAFF	TRBV7-7	TRBJ1-1
TGTGCCAGCAGTTGGACTCGGGTCAGGGAGGCTGGGGCCAACGTCCTGACTTTC	CASSWTRVREAGANVLTF	TRBV12-3	TRBJ2-6
TGCAGTGCTCCCGCGGACAGGGGCGAGCAGTACTTC	CSAPADRGEQYF	TRBV20-1	TRBJ2-7
TGCAGTGCTAGCCAGTTCATTGACACAGATACGCAGTATTTT	CSASQFIDTDTQYF	TRBV20-1	TRBJ2-3
TGTGCCAGCAGCAGGGACAGGGGCAATGAAAAACTGTTTTTT	CASSRDRGNEKLFF	TRBV7-3	TRBJ1-4
TGTGCCAGCAGAGAACGCGGGGTGGCGGGCTGGCAGCCCCAGCATTTT	CASRERGVAGWQPQHF	TRBV6-1	TRBJ1-5
TGTGCCAGCAGGAGGGACAGCTGGGCCAAGAACACTGAAGCTTTCTTT	CASRRDSWAKNTEAFF	TRBV14	TRBJ1-1
TGCAGTGCTAGAGCTGAGGGGGCCAACGTCCTGACTTTC	CSARAEGANVLTF	TRBV20-1	TRBJ2-6
