TGTGCCACCAGCCCCGGAATCGCAGGGGGACCAAATCAGCCCCAGCATTTT	CATSPGIAGGPNQPQHF	TRBV15	TRBJ1-5
TGTGCCAGCAGTGGGGGAGAAAGTCTAGATGAGCAGTTCTTC	CASSGGESLDEQFF	TRBV6-1	TRBJ2-1
TGTGCCAGCAGTTTCGGGTACGCCCACAGGGGGGCGCGAGCTAACTATGGCTACACCTTC	CASSFGYAHRGARANYGYTF	TRBV12-3	TRBJ1-2
TGTGCCAGCAGCGTTAAGGCACGTGGCTACACCTTC	CASSVKARGYTF	TRBV9	TRBJ1-2
TGCGCCAGCAGCTTCAGAGAGGGACTAGCGGGTACGCAGTATTTT	CASSFREGLAGTQYF	TRBV5-1	TRBJ2-3
TGTGCCAGCATAAGTGTCGAGCAGTACTTC	CASISVEQYF	TRBV14	TRBJ2-7
TGTGCCATCAGGGCTATAGTCTACGAGCAGTACTTC	CAIRAIVYEQYF	TRBV10-3	TRBJ2-7
TGCGCCAGCAGCCAACAGAGCGAGGGGGCGACTTCTAATGAAAAACTGTTTTTT	CASSQQSEGATSNEKLFF	TRBV4-1	TRBJ1-4
TGTGCCAGCAGCAGGAATCGTGGGAAGGAGACCCAGTACTTC	CASSRNRGKETQYF	TRBV13	TRBJ2-5
TGTGCCATCAGTGAGTCGACCCCCCTAGTGCGGGAGCAGTACTTC	CAISESTPLVREQYF	TRBV10-3	TRBJ2-7
TGCATGCAGAACAGCGGGAAGCGGGATTCACCCCTCCACTTT	CMQNSGKRDSPLHF	TRBV29-1	TRBJ1-6
TGTGCCAGCAGCTACGCACACCCGTTCGGGGAGCTGTTTTTT	CASSYAHPFGELFF	TRBV3-1	TRBJ2-2
TGCGCCAGCAGCAAGGGAAGAAACACCATATATTTT	CASSKGRNTIYF	TRBV4-1	TRBJ1-3
TGCGCCAGCAGCCAAGAGGGTGGAGAGCGGTACTCCACAGATACGCAGTATTTT	CASSQEGGERYSTDTQYF	TRBV4-1	TRBJ2-3
TGTGCCAGCTTTGGTTATTTGCAGTACTTC	CASFGYLQYF	TRBV12-3	TRBJ2-7
TGTGCCTGGAGAAGGGGGCGGGTCGTGAACACTGAAGCTTTCTTT	CAWRRGRVVNTEAFF	TRBV30	TRBJ1-1
TGTGCCAGCAGTTTTATGAAGCGGGCCTACGAGCAGTACTTC	CASSFMKRAYEQYF	TRBV28	TRBJ2-7
TGTGCCACCAGCAGAGAGACAACTGAAGCTTTCTTT	CATSRETTEAFF	TRBV15	TRBJ1-1
TGTGCCAGCAGCCACTCCGGGGCCCGCAGGGGCTACACCTTC	CASSHSGARRGYTF	TRBV3-1	TRBJ1-2
TGTGCCAGCAGCTTAGACTGGACTCCCCGGCAGTACTTC	CASSLDWTPRQYF	TRBV7-6	TRBJ2-7
TGTGCCAGCAGCGTACGGGGGGGTCCCTACGAGCAGTACTTC	CASSVRGGPYEQYF	TRBV7-9	TRBJ2-7
TGTGCCAGCTTAGCGGGTAGTCACAATGAGCAGTTCTTC	CASLAGSHNEQFF	TRBV3-1	TRBJ2-1
TGTGCCAGCAGCTTGGCCGCCGGGACAGGGCACAATCAGCCCCAGCATTTT	CASSLAAGTGHNQPQHF	TRBV5-6	TRBJ1-5
TGCAGCGCAACTAGCGGGAGGTTTAATGAGCAGTTCTTC	CSATSGRFNEQFF	TRBV29-1	TRBJ2-1
TGTGCCAGCAGGGGATCCCGGGGTGGAGTCTCCTACGAGCAGTACTTC	CASRGSRGGVSYEQYF	TRBV6-4	TRBJ2-7
TGCGCCATAAGGGCTATCACCGGGGAGCTGTTTTTT	CAIRAITGELFF	TRBV10-2	TRBJ2-2
TGTGCCAGCAGCCCAAGAGGGTCGAGGGCAGATACGCAGTATTTT	CASSPRGSRADTQYF	TRBV9	TRBJ2-3
TGTGCCAGCAGCGGTTACTCGGGGACGTCTAGCTCTGGAAACACCATATATTTT	CASSGYSGTSSSGNTIYF	TRBV7-3	TRBJ1-3
TGCGCCAGCAGCCAAGATCAGGAGTTGCCCGGGACGAGCACCGGGGAGCTGTTTTTT	CASSQDQELPGTSTGELFF	TRBV4-1	TRBJ2-2
TGTGCCAGCAGCGTAGAGGACCCCGGGAGGGGAGGGTATGAGCAGTTCTTC	CASSVEDPGRGGYEQFF	TRBV9	TRBJ2-1
TGCGCCAGCAGCCGACCCAGGACCGGAAACACCATATATTTT	CASSRPRTGNTIYF	TRBV5-1	TRBJ1-3
TGTGCCAGCAGCCGGGAAAAGAGGGGGGACAGCGGTACCCAGTACTTC	CASSREKRGDSGTQYF	TRBV13	TRBJ2-5
TGTGCCAGCAGCGGGAGGGTTAAGGTCGAGCAGTACTTC	CASSGRVKVEQYF	TRBV9	TRBJ2-7
TGTGCCAGCAGTGAAGAAGTTTCTGGGACAGGGAGGCGTTACACCGGGGAGCTGTTTTTT	CASSEEVSGTGRRYTGELFF	TRBV6-1	TRBJ2-2
TGCAGCGTCCTAAACTTGACAGGGCCCGAAGCTAACTATGGCTACACCTTC	CSVLNLTGPEANYGYTF	TRBV29-1	TRBJ1-2
TGTGCCAGCAGTTACTCGCTTCGGGACAGGCGAGGTGAAGCTTTCTTT	CASSYSLRDRRGEAFF	TRBV6-5	TRBJ1-1
TGTGCCAGCCGACTACTAGGGGCACAAGAGACCCAGTACTTC	CASRLLGAQETQYF	TRBV6-1	TRBJ2-5
TGTGCCAGCGCCCACAGCAAAGGGATCCCCCAAATATCGGAGACCCAGTACTTC	CASAHSKGIPQISETQYF	TRBV12-3	TRBJ2-5
TGTGCCAGCAGCTTAAGTCTACTAGCGGGAGAATACACAGATACGCAGTATTTT	CASSLSLLAGEYTDTQYF	TRBV11-2	TRBJ2-3
TGTGCTGGTGGGACTAGCTCCTCCTACGAGCAGTACTTC	CAGGTSSSYEQYF	TRBV6-4	TRBJ2-7
TGTGCCAGCAGCGACTTCTACGAGCAGTACTTC	CASSDFYEQYF	TRBV12-4	TRBJ2-7
TGTGCCAGGGACTCTTCTGGAAACACCATATATTTT	CARDSSGNTIYF	TRBV25-1	TRBJ1-3
TGTGCCAGCAGGTTCCGTACTAGCGGGAGGGCGTGTTCCGGCTCCTACGAGCAGTACTTC	CASRFRTSGRACSGSYEQYF	TRBV12-4	TRBJ2-7
TGTGCCAGCAGAAAACTAGCGGGGAGTTGGCAGTTCTTC	CASRKLAGSWQFF	TRBV7-3	TRBJ2-1
TGTGCCAGCAGCTTCCGACAACAAGAGACCCAGTACTTC	CASSFRQQETQYF	TRBV7-3	TRBJ2-5
TGCAGTGCTAGGTCTATGGGAGCTTTCTTT	CSARSMGAFF	TRBV20-1	TRBJ1-1
TGCAGGACAGATCCCAATTCACCCCTCCACTTT	CRTDPNSPLHF	TRBV20-1	TRBJ1-6
TGTGCCAGCTATCGGGGGTTCAATCAGCCCCAGCATTTT	CASYRGFNQPQHF	TRBV2	TRBJ1-5
TGTGCCAGCAGCGAACGCCTATATGGCTACACCTTC	CASSERLYGYTF	TRBV6-4	TRBJ1-2
TGCGCCAGCAGCTTGGGCGGATTTGGACACAAAGACGAGCAGTACTTC	CASSLGGFGHKDEQYF	TRBV5-1	TRBJ2-7
TGTGCCAGCAGCTTAGATACAAAAACGGACAGGGTGGAAGCTAACTATGGCTACACCTTC	CASSLDTKTDRVEANYGYTF	TRBV11-2	TRBJ1-2
TGTGCCAGCAGGCCGGGGGACAGGGGGCTGGGGGCTAATGAAAAACTGTTTTTT	CASRPGDRGLGANEKLFF	TRBV6-3	TRBJ1-4
TGCGCCAGCAGCCAAGCGGTGGGACAGGATGCTGAAGCTTTCTTT	CASSQAVGQDAEAFF	TRBV4-1	TRBJ1-1
TGTGCCAGCTGCTGGGGAACGTACCAAGAGACCCAGTACTTC	CASCWGTYQETQYF	TRBV9	TRBJ2-5
TGTGCTAGTGGTTTGACGGTGGCCGTTTTACGCATGAACACTGAAGCTTTCTTT	CASGLTVAVLRMNTEAFF	TRBV12-5	TRBJ1-1
TGTGCCAGCAGTGGCCCCCAACTAGCGGGACCGGAGAGCTCTGGGGCCAACGTCCTGACTTTC	CASSGPQLAGPESSGANVLTF	TRBV27	TRBJ2-6
TGTGCCAGCAGCAACAGCGGGAGTTACGAGCAGTACTTC	CASSNSGSYEQYF	TRBV6-2	TRBJ2-7
TGCGCCAGCAGCTACAGTCTGATGAACACTGAAGCTTTCTTT	CASSYSLMNTEAFF	TRBV5-1	TRBJ1-1
TGCGCCAGCAGCTTGGCCACTCCGGGATACTACGAGCAGTACTTC	CASSLATPGYYEQYF	TRBV5-1	TRBJ2-7
TGTGCCAGCAGTCCCACCCACCCGCCCCAGCATTTT	CASSPTHPPQHF	TRBV28	TRBJ1-5
TGTGCCAGCTCACCTTACAGGGGACAGGAGAACACTGAAGCTTTCTTT	CASSPYRGQENTEAFF	TRBV18	TRBJ1-1
TGTGCCAGCAGTGGAGACGACAGGGGGGGCTCCTACAATGAGCAGTTCTTC	CASSGDDRGGSYNEQFF	TRBV27	TRBJ2-1
TGTGCCAGCAGCTTGCCCCCCCGTACGTATCTTAATTCACCCCTCCACTTT	CASSLPPRTYLNSPLHF	TRBV5-6	TRBJ1-6
TGTGCCAGCAGTGACTCCCAACTAGAAACCAGCTCCTACGAGCAGTACTTC	CASSDSQLETSSYEQYF	TRBV6-4	TRBJ2-7
TGCAGTGCTCAGGGGGCGTGGACCAATGAGCAGTTCTTC	CSAQGAWTNEQFF	TRBV20-1	TRBJ2-1
TGTGCCAGCAGTGAAGACGCTCACAATGAGCAGTTCTTC	CASSEDAHNEQFF	TRBV2	TRBJ2-1
TGTGCCAGCAGTTTCACAGGCAATCAGCCCCAGCATTTT	CASSFTGNQPQHF	TRBV12-4	TRBJ1-5
TGCGCCAGCAGGCGAAGGTCCTACGAGCAGTACTTC	CASRRRSYEQYF	TRBV5-1	TRBJ2-7
TGTGCCAGCAGCGCATACGTAGAGAGCAATCAGCCCCAGCATTTT	CASSAYVESNQPQHF	TRBV7-6	TRBJ1-5
TGCGCCAGTATTCACAGGGCTCATCAGCCCCAGCATTTT	CASIHRAHQPQHF	TRBV10-1	TRBJ1-5
TGTGCCAGCAGCCAGGGAGGCCACAGGGGAAGAGTGAATGAAAAACTGTTTTTT	CASSQGGHRGRVNEKLFF	TRBV3-1	TRBJ1-4
TGTGCCAGCTCACCACAGGGACCCTACAATGAGCAGTTCTTC	CASSPQGPYNEQFF	TRBV18	TRBJ2-1
TGTGCCAGCAGTTTACTAGCGGGAGCCGAGACCCAGTACTTC	CASSLLAGAETQYF	TRBV28	TRBJ2-5
TGTGCCAGCAGTGGGTTGGGGGTGATCCCTGAGCAGTTCTTC	CASSGLGVIPEQFF	TRBV7-9	TRBJ2-1
TGTGCCAGCAGCATTAACTTGGGGGAGGGGTCGGGATACGCGATGAACACTGAAGCTTTCTTT	CASSINLGEGSGYAMNTEAFF	TRBV11-3	TRBJ1-1
TGTGCCAGCAGTTACTCCGAGGAGCTGGGGGGTGACTATGGCTACACCTTC	CASSYSEELGGDYGYTF	TRBV6-5	TRBJ1-2
TGTGCCAGCAAGCCGGGCCCTCCGGGGAACACTGAAGCTTTCTTT	CASKPGPPGNTEAFF	TRBV6-5	TRBJ1-1
TGTGCCAGCGTCCGATCCTCTGACTCGGAGGTTCGTGCTAACTATGGCTACACCTTC	CASVRSSDSEVRANYGYTF	TRBV9	TRBJ1-2
TGTGCCAGCATTGGGACTAGCGGGGACATTAGAGAGACCCAGTACTTC	CASIGTSGDIRETQYF	TRBV7-3	TRBJ2-5
TGCGCCAGCAGCTTTACACTGCGGGAGCCTGTATGGCCCCAGCATTTT	CASSFTLREPVWPQHF	TRBV4-3	TRBJ1-5
TGCAGTGCTCGGACAGGGTTCCTGAACACTGAAGCTTTCTTT	CSARTGFLNTEAFF	TRBV20-1	TRBJ1-1
TGTGCCAGCGGACCAGGGGGGATTAATCCCTCTGCTGGAAACACCATATATTTT	CASGPGGINPSAGNTIYF	TRBV5-8	TRBJ1-3
TGTGCCAGGGACCGCCAGCCCCAGCATTTT	CARDRQPQHF	TRBV6-3	TRBJ1-5
TGTGCCAGCAGTGACCATGACAGGCCATCTAATCAGCCCCAGCATTTT	CASSDHDRPSNQPQHF	TRBV2	TRBJ1-5
TGTTTGACCGGGGAGCTGTTTTTT	CLTGELFF	TRBV20-1	TRBJ2-2
TGTGCCAGTCCCTCCTGGTTTAAGGAAGAGGGTGTCTCCCTGGAGCAGTACTTC	CASPSWFKEEGVSLEQYF	TRBV6-5	TRBJ2-7
TGTGCCACCAGTGCAGGGGGTCCTAATGGTCAGTACTTC	CATSAGGPNGQYF	TRBV24-1	TRBJ2-5
TGTGCCAGCAGCTTAGATCGGGCTAGCGGGCGTAGCACAGATACGCAGTATTTT	CASSLDRASGRSTDTQYF	TRBV11-2	TRBJ2-3
TGTGCCAGCAGCTTTACTCCAAACCTCACAGATACGCAGTATTTT	CASSFTPNLTDTQYF	TRBV7-8	TRBJ2-3
TGTGCCAGCAGCCAAGATACTGGGGTCGATACGCAGTATTTT	CASSQDTGVDTQYF	TRBV3-1	TRBJ2-3
TGTGCCAGCAGTGGGAACGCGGGAGCGGCCAAAAACATTCAGTACTTC	CASSGNAGAAKNIQYF	TRBV12-3	TRBJ2-4
TGTGCCAGCTCACCTCTTACCTCTTCAGGAGATACGCAGTATTTT	CASSPLTSSGDTQYF	TRBV18	TRBJ2-3
TGCAGTGCTAGATCCAGGGAGAACACTGAAGCTTTCTTT	CSARSRENTEAFF	TRBV20-1	TRBJ1-1
TGTGCCAGCAGTTTAGAGGCACTAGCGGGAGACTTC	CASSLEALAGDF	TRBV28	TRBJ2-7
TGTGCCAGCAGCTTAGAGGCAGGGAGGAACCCCGGCGAGACCCAGTACTTC	CASSLEAGRNPGETQYF	TRBV7-8	TRBJ2-5
TGCAGCAGACCGGGACGTGCAACTAATGAAAAACTGTTTTTT	CSRPGRATNEKLFF	TRBV29-1	TRBJ1-4
TGTGCCAGCAGCTTGACTAGCGGGAGCGAGCAGTACTTC	CASSLTSGSEQYF	TRBV5-4	TRBJ2-7
TGTGCCAGCAGTTTACCTCGACAGGGCCGGGAATACGAGCAGTACTTC	CASSLPRQGREYEQYF	TRBV28	TRBJ2-7
TGCGCCAGCCTGGAGGGAACAGATACGCAGTATTTT	CASLEGTDTQYF	TRBV10-2	TRBJ2-3
TGTGCCAGTAGTAGTAGACCTAACGAGCAGTACTTC	CASSSRPNEQYF	TRBV19	TRBJ2-7
TGCAGCGTTGTTGCAGGGGCCTCTGGAAACACCATATATTTT	CSVVAGASGNTIYF	TRBV29-1	TRBJ1-3
TGTGCCAGCGGAGACAGGGGCAATCAGCCCCAGCATTTT	CASGDRGNQPQHF	TRBV27	TRBJ1-5
TGTGCCAGCACTCGACAAGAAACCACCCGGCGCACAGATACGCAGTATTTT	CASTRQETTRRTDTQYF	TRBV7-2	TRBJ2-3
TGTGCCAGCAGCCAACGGGGGCAGGGGGGGGGGAGCACAGATACGCAGTATTTT	CASSQRGQGGGSTDTQYF	TRBV3-1	TRBJ2-3
TGTGCCAGCAGTGACTCGCCGGGACTAGCGGGAGAAAGCTCCTACAATGAGCAGTTCTTC	CASSDSPGLAGESSYNEQFF	TRBV6-4	TRBJ2-1
TGCGCCAGCAGCCAATTTGTTCCTGGACTTTGGATGTATTTT	CASSQFVPGLWMYF	TRBV4-1	TRBJ2-3
TGTGCCACGGATTTACAAGCCTCAAGAACTGAAGCTTTCTTT	CATDLQASRTEAFF	TRBV24-1	TRBJ1-1
TGTGCCAGCAGCCACCGCCAGGGGAAGTACGAGCAGTACTTC	CASSHRQGKYEQYF	TRBV7-9	TRBJ2-7
TGCGCCAGCAGCACCGTTCCTGACAGGGGGCGATTTAAGCAACTCGCAATGTACAATGAGCAGTTCTTC	CASSTVPDRGRFKQLAMYNEQFF	TRBV5-1	TRBJ2-1
TGCGCCAGCAGCCAAGCCGAGGGGGGTCGTGAAGCTTTCTTT	CASSQAEGGREAFF	TRBV4-1	TRBJ1-1
TGTGCCAGCAGCTTTCCCGGAGGGACAGGGGTCAATGGCACTGAAGCTTTCTTT	CASSFPGGTGVNGTEAFF	TRBV13	TRBJ1-1
TGCAGTGCTAATCGCCGAGGTGATACGCAGTATTTT	CSANRRGDTQYF	TRBV20-1	TRBJ2-3
TGCAGCGTAGCACGCGGAGTTAGTATTGCGGCCTACGAGCAGTACTTC	CSVARGVSIAAYEQYF	TRBV29-1	TRBJ2-7
TGTGCCAGCAGCTTCGAGTACAATGAGCAGTTCTTC	CASSFEYNEQFF	TRBV11-3	TRBJ2-1
TGTGCCAGCAGTTACTGGGCTCCCGGGACTAGCCCAGAAAGCGTCTACGAGCAGTACTTC	CASSYWAPGTSPESVYEQYF	TRBV6-3	TRBJ2-7
TGCAGTGCTAGCCCCGCCCAACAGATGTGGTGCAGGCCTGAAGCTTTCTTT	CSASPAQQMWCRPEAFF	TRBV20-1	TRBJ1-1
TGCGCCAGCATTTGGACTAGCGGGAAACACGGGGAGCTGTTTTTT	CASIWTSGKHGELFF	TRBV10-2	TRBJ2-2
TGTGCCAGCAGTTTATCGCGGGAGGGAACCGAAAAACTGTTTTTT	CASSLSREGTEKLFF	TRBV27	TRBJ1-4
TGTGCCAGCAGTGAAGCGTTCCGACAGGGGGGCTTGTCTTCTAGGCCCCAGCATTTT	CASSEAFRQGGLSSRPQHF	TRBV6-1	TRBJ1-5
TGCAGTGCTAGAAAGCCTACGGGACAGGGACAAGAGACCCAGTACTTC	CSARKPTGQGQETQYF	TRBV20-1	TRBJ2-5
TGCGCCAGCAGTGAGCGACAGGGTAATCAGCCCCAGCATTTT	CASSERQGNQPQHF	TRBV10-2	TRBJ1-5
TGCGCCAGCAGTGAGGGGCCCCACAGGGGGCGGTGGTGTTCACCCCTCCACTTT	CASSEGPHRGRWCSPLHF	TRBV10-1	TRBJ1-6
TGTGCCAGCAGCTCGTCCGGGACAGGGGCGGCCTACAATGAGCAGTTCTTC	CASSSSGTGAAYNEQFF	TRBV7-6	TRBJ2-1
TGTGCCAGCGACAGGGGGGATGGACCTAATGAAAAACTGTTTTTT	CASDRGDGPNEKLFF	TRBV28	TRBJ1-4
TGTGCCAGCGCCCGGTTAAGGGGGGGGAATGAAAAACTGTTTTTT	CASARLRGGNEKLFF	TRBV2	TRBJ1-4
TGTGCCAGCAGCCCCGAGACACCAAGGCTCTCTGGGGCCAACGTCCTGACTTTC	CASSPETPRLSGANVLTF	TRBV5-8	TRBJ2-6
TGTGCCAGCAGAGGACGAGGTAGTAGCACAGATACGCAGTATTTT	CASRGRGSSTDTQYF	TRBV7-3	TRBJ2-3
TGTGCCAGCAGTTTCGGGACAGGGATCCCATGTAGCTGGGGCTACACCTTC	CASSFGTGIPCSWGYTF	TRBV28	TRBJ1-2
TGTGCCAGCAGCGTTGCTATTAGGCGGGAGACTTCTGGCTACACCTTC	CASSVAIRRETSGYTF	TRBV9	TRBJ1-2
TGTGCCATCAAGGAGCGGGAGGGGCTCTACGAGCAGTACTTC	CAIKEREGLYEQYF	TRBV10-3	TRBJ2-7
TGTGCCACCAGCAGAGATAATCATCGGGGGGGGGGCCCCAATCAGCCCCAGCATTTT	CATSRDNHRGGGPNQPQHF	TRBV15	TRBJ1-5
TGTGCCAGCAGCTCGCCCATAAGGGGGGGCCCCGGAATTCCGTCCTACGAGCAGTACTTC	CASSSPIRGGPGIPSYEQYF	TRBV9	TRBJ2-7
TGTGCCAGCAAGGGGACTAGCGGACTCGGGGAGCTGTTTTTT	CASKGTSGLGELFF	TRBV25-1	TRBJ2-2
TGTGCTAGTGGTTACCAGGACGAGCAGTACTTC	CASGYQDEQYF	TRBV12-5	TRBJ2-7
TGTGCCAGCAGCCGGACAGGGTACGGGGAGCTGTTTTTT	CASSRTGYGELFF	TRBV9	TRBJ2-2
TGTGCCAGCAGCCGTACAGGGGGTAGGGGACATCAGCCCCAGCATTTT	CASSRTGGRGHQPQHF	TRBV7-4	TRBJ1-5
TGCAGTGCTAGAGGGATTTTGGGGGACTTTGCTGAAGCTTTCTTT	CSARGILGDFAEAFF	TRBV20-1	TRBJ1-1
TGTGCCAGCAGCAGGGGGACGGGGAAAGATAATGAAAAACTGTTTTTT	CASSRGTGKDNEKLFF	TRBV7-9	TRBJ1-4
TGTGCCAGCTGGGGGCCTTGCACTGAAGCTTTCTTT	CASWGPCTEAFF	TRBV5-8	TRBJ1-1
TGCAGTGCTAGACCCAGCGAGACAGCCCCCAGAACTGAAGCTTTCTTT	CSARPSETAPRTEAFF	TRBV20-1	TRBJ1-1
TGTGCCAGCAGTTCCCAGGGGAGAACTGAAGCTTTCTTT	CASSSQGRTEAFF	TRBV27	TRBJ1-1
TGTGCCAGCAGTGAAGACAGGGTGGGAAACACTGAAGCTTTCTTT	CASSEDRVGNTEAFF	TRBV6-4	TRBJ1-1
TGTGCCATACCGGGTTTTTACAATGAGCAGTTCTTC	CAIPGFYNEQFF	TRBV6-4	TRBJ2-1
TGTGCTAGTGCATTAGCGGGAGGCCATCAGCCCCAGCATTTT	CASALAGGHQPQHF	TRBV12-5	TRBJ1-5
TGTGCCTGCTTGGACAGGGGACTATGGGGGGCTGGGGCCAACGTCCTGACTTTC	CACLDRGLWGAGANVLTF	TRBV10-3	TRBJ2-6
TGTGCCAGCAGCTTGGGGGGGCCTTGGTACGAGCAGTACTTC	CASSLGGPWYEQYF	TRBV5-6	TRBJ2-7
TGTGCCAGCAGTTTCGGGGGGCCGGGACAGTTCTTTGGGAACACTGAAGCTTTCTTT	CASSFGGPGQFFGNTEAFF	TRBV27	TRBJ1-1
TGTGCCAGCAGCTTGGGGTTGGACCACACTGAAGCTTTCTTT	CASSLGLDHTEAFF	TRBV5-4	TRBJ1-1
TGTGCCAGCAGCTGCACCCGGAGGTCGCTCTACGAGCAGTACTTC	CASSCTRRSLYEQYF	TRBV5-6	TRBJ2-7
TGTGCCAGCTTGGCCCACGGACTGTTCACCGGGGAGCTGTTTTTT	CASLAHGLFTGELFF	TRBV7-3	TRBJ2-2
TGTGCCAGGCGGGGGGGTCTTGCCCAGTACTTC	CARRGGLAQYF	TRBV6-5	TRBJ2-5
TGTGCCAGCAGCAGTGGCGGTGCGTCGGCCAAAAACATTCAGTACTTC	CASSSGGASAKNIQYF	TRBV14	TRBJ2-4
TGTGCCAGCTCCTCCCAACCATTAGCTTTCTTT	CASSSQPLAFF	TRBV12-4	TRBJ1-1
TGTGCCAGCGGAACCTGGGGGCCACATACGCAGTATTTT	CASGTWGPHTQYF	TRBV27	TRBJ2-3
TGTGCCAGCAGCGACGGGCCCAACCTAGCGGGATCCTACGAGCAGTACTTC	CASSDGPNLAGSYEQYF	TRBV6-5	TRBJ2-7
TGTGCCAGCAGCCCCACAAGCGTCTCCTACGAGCAGTACTTC	CASSPTSVSYEQYF	TRBV3-1	TRBJ2-7
TGTGCCAGCCCGGGGCCTCCGCCCCAGCATTTT	CASPGPPPQHF	TRBV7-9	TRBJ1-5
TGTGCCAGTAGTATACCCACCCTCCTGACGACAGGCGCCCTCTTC	CASSIPTLLTTGALF	TRBV19	TRBJ2-1
TGCAGTGCCCCCAGAACGGACAGGGTCTACGAGCAGTACTTC	CSAPRTDRVYEQYF	TRBV20-1	TRBJ2-7
TGTGCCAGCAGGACAGGGAAACTGTTTTTT	CASRTGKLFF	TRBV25-1	TRBJ1-4
TGTGCCAGCAGCGTAGCTCCAGGAAGCAATCAGCCCCAGCATTTT	CASSVAPGSNQPQHF	TRBV9	TRBJ1-5
TGTGCCAGCAGCCCGGGTACAGGCCAGTCTGCGTACAAGGGGAACACTGAAGCTTTCTTT	CASSPGTGQSAYKGNTEAFF	TRBV3-1	TRBJ1-1
TGTGCCTGGAGTGTACTCTCCGGACAGGGAGCTTTCTTT	CAWSVLSGQGAFF	TRBV30	TRBJ1-1
TGCGCCAGCAGCTTGGTGCGGGGAAGCACAGATACGCAGTATTTT	CASSLVRGSTDTQYF	TRBV5-1	TRBJ2-3
TGTGCCAGCTCACTTTCGGACCTAGCAGCCTACGAGCAGTACTTC	CASSLSDLAAYEQYF	TRBV18	TRBJ2-7
TGTGCCAGCAGCAGCACTAGCGGGAGGCACGAGCAGTACTTC	CASSSTSGRHEQYF	TRBV4-2	TRBJ2-7
TGCAGTGCCTGTAACAGGGTGAGGAAATCTGGGGCCAACGTCCTGACTTTC	CSACNRVRKSGANVLTF	TRBV20-1	TRBJ2-6
TGTGCCAGCAGGAACGTTGGGACAGGGAAACCCACTGAAGCTTTCTTT	CASRNVGTGKPTEAFF	TRBV11-2	TRBJ1-1
TGTGCCAGCGTTTCTTACCAAGAGACCCAGTACTTC	CASVSYQETQYF	TRBV7-9	TRBJ2-5
TGCAGCGTTGAAAGTGTCTTCTTCCAGGGAATGGGGAACACCATATATTTT	CSVESVFFQGMGNTIYF	TRBV29-1	TRBJ1-3
TGTGCCAGCAGCGGACAGGGGGGATTTCCCTTGACTGATGGCTACACCTTC	CASSGQGGFPLTDGYTF	TRBV5-6	TRBJ1-2
TGTGCCAGTATAGGACAGGGGAAGTTCTACGAGCAGTACTTC	CASIGQGKFYEQYF	TRBV19	TRBJ2-7
TGCAGTGCTAGAGTCCGATCGGGGACAGAAGAAAAACTGTTTTTT	CSARVRSGTEEKLFF	TRBV20-1	TRBJ1-4
TGTGCCAGCAGTGAAGATACCAATCCGGAGCCGGAGCAGTACTTC	CASSEDTNPEPEQYF	TRBV6-1	TRBJ2-7
TGTGCCAGCAGGTTAGGGGGGCGACAGAACACTGAAGCTTTCTTT	CASRLGGRQNTEAFF	TRBV6-4	TRBJ1-1
TGTGCCAGCAATACGTCTGATATTAATGAGCAGTTCTTC	CASNTSDINEQFF	TRBV6-2	TRBJ2-1
TGTGCCAGCAGAAAGGACAGGGGCGTTTTGAACACCGGGGAGCTGTTTTTT	CASRKDRGVLNTGELFF	TRBV2	TRBJ2-2
TGCAGTGCGAATCGAGGGGGGGAGGGAGATACGCAGTATTTT	CSANRGGEGDTQYF	TRBV20-1	TRBJ2-3
TGCGCCAGCAGCCAAGCCAGTTGGAGCGGGAGATGGGGCCACACCGGGGAGCTGTTTTTT	CASSQASWSGRWGHTGELFF	TRBV4-1	TRBJ2-2
TGTGCCTGGAAGGTAGAAATCCGGGGGGGAAATGAGCAGTTCTTC	CAWKVEIRGGNEQFF	TRBV30	TRBJ2-1
TGTGCCAGCAGCTCCCAGGACAGGGGGTACTTC	CASSSQDRGYF	TRBV5-4	TRBJ1-2
TGCAGTGCTAGAGTTGACGGAGACGAGCAGTACTTC	CSARVDGDEQYF	TRBV20-1	TRBJ2-7
TGCAGTGCTAGAATTCCCGTGGGAGGGAGGTCCTACGAGCAGTACTTC	CSARIPVGGRSYEQYF	TRBV20-1	TRBJ2-7
TGTGCCAGCACCCCTTCTGCGGACAGGGGGGGTAATTCACCCCTCCACTTT	CASTPSADRGGNSPLHF	TRBV2	TRBJ1-6
TGTGCCAGCAGCTTTGCCGGACAGGACTACGAGCAGTACTTC	CASSFAGQDYEQYF	TRBV13	TRBJ2-7
TGTGCCACCAGTGATTTGAAGGGACTAGCGGGCTCCTACGAGCAGTACTTC	CATSDLKGLAGSYEQYF	TRBV24-1	TRBJ2-7
TGTGCCACCAGTGATTCCCAGGTAGTGGTTTCACCCCTCCACTTT	CATSDSQVVVSPLHF	TRBV24-1	TRBJ1-6
TGTGCCAGCAGCCAAGATAGACCGGGACTTTTGACAGATACGCAGTATTTT	CASSQDRPGLLTDTQYF	TRBV3-1	TRBJ2-3
TGTGCCAGCAGCTTAGCCCCGGCAGGACTGAATCAGCCCCAGCATTTT	CASSLAPAGLNQPQHF	TRBV11-3	TRBJ1-5
TGTGCCATCCTGACAGGATTCCCCAAAAACATTCAGTACTTC	CAILTGFPKNIQYF	TRBV28	TRBJ2-4
TGTGCCAGCAGCTTAGCCGCTGGACCCAGGACAAGCTACAATGAGCAGTTCTTC	CASSLAAGPRTSYNEQFF	TRBV7-8	TRBJ2-1
TGTGCCACCAGTGCGGGACAGGGCCAGAACTATGGCTACACCTTC	CATSAGQGQNYGYTF	TRBV24-1	TRBJ1-2
TGTGCCACCTTCATGGGACAGGGCAATCAGCCCCAGCATTTT	CATFMGQGNQPQHF	TRBV24-1	TRBJ1-5
TGTGCCAGCAGCCTAGAAGGGGCCCAGGAGACCCAGTACTTC	CASSLEGAQETQYF	TRBV6-4	TRBJ2-5
TGTGCCAGCAGCGAAGTTAATAGGGTTCCAGGCGGGGTGAACGGGGGGGAGACCCAGTACTTC	CASSEVNRVPGGVNGGETQYF	TRBV13	TRBJ2-5
TGTGCCAGCAGGCACGCGGATCCGGGACTAGGGCCGCGGGGTAGCACAGATACGCAGTATTTT	CASRHADPGLGPRGSTDTQYF	TRBV7-9	TRBJ2-3
TGCAGTGCTAGAGATCTCCGCAGGTCCTACGAGCAGTACTTC	CSARDLRRSYEQYF	TRBV20-1	TRBJ2-7
TGTGCCACCCGGACAGGGCGGACGGCCAACGTCCTGACTTTC	CATRTGRTANVLTF	TRBV4-2	TRBJ2-6
TGTGCCAGCAGCCTCGCAGGGAATAGCTACGAGCAGTACTTC	CASSLAGNSYEQYF	TRBV3-1	TRBJ2-7
TGTGCCAGCAGCTTAGCCGGGAGGGGGGGGGGAAACTATGGCTACACCTTC	CASSLAGRGGGNYGYTF	TRBV11-3	TRBJ1-2
TGTGCCAGCAGCCTTGGTTCGAAGCTACCCGCCAAAAACATTCAGTACTTC	CASSLGSKLPAKNIQYF	TRBV27	TRBJ2-4
TGTGCCAGCAGCTTACTTAAAAGGACAGTTTTGAACACTGAAGCTTTCTTT	CASSLLKRTVLNTEAFF	TRBV11-2	TRBJ1-1
TGTGCCAGCAGTTCCGGGTGCGGGGGGGAAGCTAGAAACACCATATATTTT	CASSSGCGGEARNTIYF	TRBV6-2	TRBJ1-3
TGTGCCAGCAGCCGGGTGGGGGGGCTTATGGACAATGAGCAGTTCTTC	CASSRVGGLMDNEQFF	TRBV11-1	TRBJ2-1
TGTGCCAGTCGGGTGCCGGGACAGGTTACATCATCATCACCCCTCCACTTT	CASRVPGQVTSSSPLHF	TRBV6-5	TRBJ1-6
TGTGCCTGGAGTGTCATAATGACTAGCCCCTACGAGCAGTACTTC	CAWSVIMTSPYEQYF	TRBV30	TRBJ2-7
TGTGCCAGCAGTGACACCAGGGAGACTGAAGCTTTCTTT	CASSDTRETEAFF	TRBV6-4	TRBJ1-1
TGCGCCAGCAGCCAACTCGACAGGGTGGCCAATCAGCCCCAGCATTTT	CASSQLDRVANQPQHF	TRBV4-1	TRBJ1-5
TGTGCCAGCTCACCTCCCACACACACCGGGGAGCTGTTTTTT	CASSPPTHTGELFF	TRBV18	TRBJ2-2
TGTGCCAGCCCAGGGGGCGGACCCCAAGAGACCCAGTACTTC	CASPGGGPQETQYF	TRBV28	TRBJ2-5
TGTGCCAGCAGTGACGACAGGGGGATTAAGGAGGAAAAACTGTTTTTT	CASSDDRGIKEEKLFF	TRBV6-4	TRBJ1-4
TGTGCCAGCAGTGAAGACCGCGACAATGAGCAGTTCTTC	CASSEDRDNEQFF	TRBV6-1	TRBJ2-1
TGTGCCAGCAGAGGCCGCCAGGGAAAGACCGGGGAGCTGTTTTTT	CASRGRQGKTGELFF	TRBV6-1	TRBJ2-2
TGTGCCAGCAGCTTAGGGGGTACTCCAAAGGGACTAGCGGATAACTACAATGAGCAGTTCTTC	CASSLGGTPKGLADNYNEQFF	TRBV7-8	TRBJ2-1
TGTGCCAGCAGTGCCTCTAGGGGGGCCACCTACGAGCAGTACTTC	CASSASRGATYEQYF	TRBV25-1	TRBJ2-7
TGTGCCAGCAGCACGGGGAAGGAGTATAGCTCCTACGAGCAGTACTTC	CASSTGKEYSSYEQYF	TRBV11-2	TRBJ2-7
TGTGCCAGCAGGATGGGCCACTATGGCTACACCTTC	CASRMGHYGYTF	TRBV6-2	TRBJ1-2
TGTGCCAGCTTCCTCCCCGGGAGGAACACCGGGGAGCTGTTTTTT	CASFLPGRNTGELFF	TRBV25-1	TRBJ2-2
TGTGCCACCAGGCCAGCTGGTAATGAGCAGTTCTTC	CATRPAGNEQFF	TRBV24-1	TRBJ2-1
TGTGCCAGCAGTGACCCCCGTGCGGAGCGCGAGACCCAGTACTTC	CASSDPRAERETQYF	TRBV6-4	TRBJ2-5
TGTAAAAAATGGCGGGCACTGGGGACCCAAGAGACCCAGTACTTC	CKKWRALGTQETQYF	TRBV19	TRBJ2-5
TGTGCCAGCCCTACAGGGGTCGCGTATAGCAATCAGCCCCAGCATTTT	CASPTGVAYSNQPQHF	TRBV2	TRBJ1-5
TGCGCCAGCAGCTTGCGACAGGGGGGAGGATCCTGCCCGAACACTGAAGCTTTCTTT	CASSLRQGGGSCPNTEAFF	TRBV5-1	TRBJ1-1
TGTGCCAGCAGCCTACGGACAGGTTCCTACAATGAGCAGTTCTTC	CASSLRTGSYNEQFF	TRBV7-4	TRBJ2-1
TGTGCCAGCAGTTTACCCTTTAGGTTAACCGGGACGGGTTCACCCCTCCACTTT	CASSLPFRLTGTGSPLHF	TRBV12-3	TRBJ1-6
TGTGCCAGCAGTTTCCCGTTCGGGACTAGCGAGGGAGCCAACTACGAGCAGTACTTC	CASSFPFGTSEGANYEQYF	TRBV12-4	TRBJ2-7
TGCAGTGCTAGATTTCCCAGGGTAGGCCCTCCCTTCGTATGTAATGAGCAGTTCTTC	CSARFPRVGPPFVCNEQFF	TRBV20-1	TRBJ2-1
TGTGCCAGCAGGGACAGGGGGCCCACCTACGAGCAGTACTTC	CASRDRGPTYEQYF	TRBV27	TRBJ2-7
TGTGCCAGCAGCGGCGGGGGGGCTTCAGATACGCAGTATTTT	CASSGGGASDTQYF	TRBV13	TRBJ2-3
TGTGCCAGCAGTTCCGGACAGCGTAACATTCAGTACTTC	CASSSGQRNIQYF	TRBV6-4	TRBJ2-4
TGTGCCAGCAGTTATTTGGATCAGACAGGGGATAGCAGGAACACTGAAGCTTTCTTT	CASSYLDQTGDSRNTEAFF	TRBV11-3	TRBJ1-1
TGCGCCAGCAGACAACTAGCGGGCGAGGGCTGCACAGATACGCAGTATTTT	CASRQLAGEGCTDTQYF	TRBV10-2	TRBJ2-3
TGTGCCAGCAGCTACAACGACCGGGGACATGAGCAGTTCTTC	CASSYNDRGHEQFF	TRBV5-4	TRBJ2-1
TGTGCCAGCAGCTTAACGTCTTTTCAGGGACAGGAAAAACTGTTTTTT	CASSLTSFQGQEKLFF	TRBV7-3	TRBJ1-4
TGTGCCAGTTTGGTAGCGGGAGGAAATAGCAATCAGCCCCAGCATTTT	CASLVAGGNSNQPQHF	TRBV3-1	TRBJ1-5
TGTGCCAGCAGCCTTAACAGGCAGTTCTTC	CASSLNRQFF	TRBV3-1	TRBJ2-1
TGTGCCAGCAGAACCAGACAATCAACAGATACGCAGTATTTT	CASRTRQSTDTQYF	TRBV5-4	TRBJ2-3
TGTGCCAGCAGCAGGGGACCGCGCTCTGGAAACACCATATATTTT	CASSRGPRSGNTIYF	TRBV13	TRBJ1-3
TGCGCCAGCAGCCAAGATCCAGGAGACAGGGACAGCAATCAGCCCCAGCATTTT	CASSQDPGDRDSNQPQHF	TRBV4-3	TRBJ1-5
TGTGCCAGCAGTGGGGGGGAGCTGTTTTTT	CASSGGELFF	TRBV2	TRBJ2-2
TGTGCCATCACCATTAGCTCCTACGAGCAGTACTTC	CAITISSYEQYF	TRBV10-3	TRBJ2-7
TGTGCCAGCAGCGACTCCAATTCGACAGGAGCTGAAGCTTTCTTT	CASSDSNSTGAEAFF	TRBV13	TRBJ1-1
TGCGCCAGCAGCCTTCCTCTGTCAGGGGGGGAAACAGATACGCAGTATTTT	CASSLPLSGGETDTQYF	TRBV4-1	TRBJ2-3
TGTGCCAGCAGCAATCCCGGGACAGCGCGTGGTGGGTTCGGAATGAACACTGAAGCTTTCTTT	CASSNPGTARGGFGMNTEAFF	TRBV2	TRBJ1-1
TGTGCCAGCAGTTGGAAGGTTACCGGGACAGGGGTTGTCGAGCAGTACTTC	CASSWKVTGTGVVEQYF	TRBV27	TRBJ2-7
TGTGCCAGCAGTGTGACTAATAGCAATCAGCCCCAGCATTTT	CASSVTNSNQPQHF	TRBV27	TRBJ1-5
TGTGCCAGCAGCCAAGAGGTGGGACGGTACAATGAGCAGTTCTTC	CASSQEVGRYNEQFF	TRBV3-1	TRBJ2-1
TGTGCCAGCAGTGAAGCCCAAACCCGGGACAGGAATCTCTTC	CASSEAQTRDRNLF	TRBV6-4	TRBJ2-1
TGTGCCCCCGTCACACCGGGGCGGGTTTCCTACAATGAGCAGTTCTTC	CAPVTPGRVSYNEQFF	TRBV25-1	TRBJ2-1
TGTGCCAGCAGTAGCCACGGGGGTACTGAAGCTTTCTTT	CASSSHGGTEAFF	TRBV6-1	TRBJ1-1
TGTGCCAGCAGTTTACAGGTGGACAGGGGGAACACTGAAGCTTTCTTT	CASSLQVDRGNTEAFF	TRBV27	TRBJ1-1
TGCAGCGTTGGTACGAGACCCCGCGGGAGAAGCGAGCAGTACTTC	CSVGTRPRGRSEQYF	TRBV29-1	TRBJ2-7
TGTGCCAGCAGCCACTTGGACAGGGGTTCCTACGAGCAGTACTTC	CASSHLDRGSYEQYF	TRBV9	TRBJ2-7
TGTGCCAGCAGGACCCAGGGGGGGAATGGCTACACCTTC	CASRTQGGNGYTF	TRBV7-9	TRBJ1-2
TGCAGTGCTGGATACGGGACAACCGCTTTCTTT	CSAGYGTTAFF	TRBV20-1	TRBJ1-1
TGCAGCCCGGCGGACGACTCCATGGCGGGATGGCCCGGGGAGCTGTTTTTT	CSPADDSMAGWPGELFF	TRBV29-1	TRBJ2-2
TGTGCCAGCAGTTACAACACACAATACAGGCTAGCCAAAAACATTCAGTACTTC	CASSYNTQYRLAKNIQYF	TRBV6-2	TRBJ2-4
TGTGCCCGCCCCAGGGGTTACGAGCAGTACTTC	CARPRGYEQYF	TRBV27	TRBJ2-7
TGCGCCAGCAGTGAGTCAGGGTTAGGGCCGGATGGCTACACCTTC	CASSESGLGPDGYTF	TRBV10-1	TRBJ1-2
TGTGCCAGCAGCAAGGTATTACAAAGAAAACTGTTTTTT	CASSKVLQRKLFF	TRBV9	TRBJ1-4
TGTGCCACCAGGAATAGGGGGCTCTCCACTGAAGCTTTCTTT	CATRNRGLSTEAFF	TRBV24-1	TRBJ1-1
TGTGCCAGCAGCTTACTAGCCGACTCCTACAATGAGCAGTTCTTC	CASSLLADSYNEQFF	TRBV11-3	TRBJ2-1
TGCAGTGCTAGTCGACTAGCGGCCACAATCAATGAGCAGTTCTTC	CSASRLAATINEQFF	TRBV20-1	TRBJ2-1
TGTGCCAGCAGTTTTGTAACACTGGGACTGAGCTATGGCTACACCTTC	CASSFVTLGLSYGYTF	TRBV28	TRBJ1-2
TGTGCCAGCAGGACGGACATGAGGGAAAAACTGTTTTTT	CASRTDMREKLFF	TRBV9	TRBJ1-4
TGTGCCAGCAGAAGTCCACAGGGGGCTTCCAACACCGGGGAGCTGTTTTTT	CASRSPQGASNTGELFF	TRBV27	TRBJ2-2
TGTGCCAGCAGCGTAGCAAAGGGACAGGGGGGCGCCTGGGGCTACACCTTC	CASSVAKGQGGAWGYTF	TRBV9	TRBJ1-2
TGCAGTGCTCTCTACAAGGGGCTAGACAATGAGCAGTTCTTC	CSALYKGLDNEQFF	TRBV20-1	TRBJ2-1
TGTGCCAGCAGCCATACGGCCAATCAAGAGACCCAGTACTTC	CASSHTANQETQYF	TRBV4-2	TRBJ2-5
TGTGCCTGGAATTGGGGGCTTAAATTTCCCGGGGAGCTGTTTTTT	CAWNWGLKFPGELFF	TRBV30	TRBJ2-2
TGTGCCAGCAGTTTACCAGGGGAGAGCTCCTACGAGCAGTACTTC	CASSLPGESSYEQYF	TRBV28	TRBJ2-7
TGTGCCAGCTCATCCCGTCAGGGGAGGAGCAATCAGCCCCAGCATTTT	CASSSRQGRSNQPQHF	TRBV18	TRBJ1-5
TGTGCCAGCAGCGGGACCCCCGGGACAGGCTTGACCTACGAGCAGTACTTC	CASSGTPGTGLTYEQYF	TRBV9	TRBJ2-7
TGTGCCAGCCAAACTAGCGGGCGGGTACACGAGCAGTACTTC	CASQTSGRVHEQYF	TRBV25-1	TRBJ2-7
TGCGCCAGCCTAGCCCCCGACAGGCAAGAGGCGTTGAACACTGAAGCTTTCTTT	CASLAPDRQEALNTEAFF	TRBV5-1	TRBJ1-1
TGTGCCAGCAGCGGGAAGACAGGGTTTACGCCCCAGCATTTT	CASSGKTGFTPQHF	TRBV5-6	TRBJ1-5
TGTGCCTGGCGGGGGCTTTCATATAGCAATCAGCCCCAGCATTTT	CAWRGLSYSNQPQHF	TRBV30	TRBJ1-5
TGTGCCTGGAGTGTCTCAGGGACTAGCGGGCTGCTCCGAACAGATACGCAGTATTTT	CAWSVSGTSGLLRTDTQYF	TRBV30	TRBJ2-3
TGCGCCAGCAGCTTGGCCCCGGCCTCAGTCTGGGCCGAAAAACTGTTTTTT	CASSLAPASVWAEKLFF	TRBV5-1	TRBJ1-4
TGTGCCATCAGTGACAACAGACCGATGGACACTGAAGCTTTCTTT	CAISDNRPMDTEAFF	TRBV10-3	TRBJ1-1
TGCGCCAGCAGCTCTCCCCGGTGGACGCGGGCTAACTATGGCTACACCTTC	CASSSPRWTRANYGYTF	TRBV5-1	TRBJ1-2
TGTGCCTGGAGGACTTTCAGGGACGGGGGGCGCAAATACGAGCAGTACTTC	CAWRTFRDGGRKYEQYF	TRBV30	TRBJ2-7
TGTGCCACCAGCTATGAGACTAGCGGGGATTGTACGCAGTATTTT	CATSYETSGDCTQYF	TRBV15	TRBJ2-3
TGCCTCGGGCCGGGACTAGCGGGAGACTATGGCTACACCTTC	CLGPGLAGDYGYTF	TRBV20-1	TRBJ1-2
TGTGCCAGCAGCCTAGAGGTAGAGACCCAGTACTTC	CASSLEVETQYF	TRBV7-2	TRBJ2-5
TGTGCCACCAGCAGAAGTTACGTCAGGCTAAATAACTATGGCTACACCTTC	CATSRSYVRLNNYGYTF	TRBV15	TRBJ1-2
TGTGCCAGCAGTTGGCGGGGCTCAAGCACAGATACGCAGTATTTT	CASSWRGSSTDTQYF	TRBV6-2	TRBJ2-3
TGTGCCAGCAGCCCTGAGGGGCTAACCAATCAGCCCCAGCATTTT	CASSPEGLTNQPQHF	TRBV3-1	TRBJ1-5
TGCAGTGCTAGATGGGACAGGTATGGCTACACCTTC	CSARWDRYGYTF	TRBV20-1	TRBJ1-2
TGTGCCAGCAGCCCCCCACTGTCTCACAGGTTAGCTAACTATGGCTACACCTTC	CASSPPLSHRLANYGYTF	TRBV7-6	TRBJ1-2
TGTGCCATGGCTAAACGTCGGGGTTGGGGCATTCTGGATGAAAAACTGTTTTTT	CAMAKRRGWGILDEKLFF	TRBV6-2	TRBJ1-4
TGTGCCAGCAGCCACCAGGAGGTGTGGAAGAACACTGAAGCTTTCTTT	CASSHQEVWKNTEAFF	TRBV12-4	TRBJ1-1
TGTGCCAGCCCGGACACGACTGGGGGTTCACCCCTCCACTTT	CASPDTTGGSPLHF	TRBV2	TRBJ1-6
TGTGCCAGCAGTTGGGCAGGGTGGGACTCTGGAAACACCATATATTTT	CASSWAGWDSGNTIYF	TRBV6-5	TRBJ1-3
TGTGCCAGCTCACCGAGCAGGGGGCGAGGGCCAGGCTACACCTTC	CASSPSRGRGPGYTF	TRBV18	TRBJ1-2
TGTGCCAGCAGCGCCCCCACACTTTACAATGAGCAGTTCTTC	CASSAPTLYNEQFF	TRBV13	TRBJ2-1
TGTGCCAGCAGCTTACTAGCGGAACGGGACGAGCAGTACTTC	CASSLLAERDEQYF	TRBV7-7	TRBJ2-7
TGTGCTAGTGCGTCAGTTGGCCCCTTTGGAAACACCATATATTTT	CASASVGPFGNTIYF	TRBV12-5	TRBJ1-3
TGTGCCAGCAGCCGTGACGGGGGAGCCAAAAACATTCAGTACTTC	CASSRDGGAKNIQYF	TRBV7-7	TRBJ2-4
TGCGCCAGCAGCCATAAGGAGAGCTGTGAGCAGTTCTTC	CASSHKESCEQFF	TRBV4-1	TRBJ2-1
TGCAGTGCTAGAGACTGGACAGGCGAGCAGTACTTC	CSARDWTGEQYF	TRBV20-1	TRBJ2-7
TGCAGCGTTGAAGCCGTTAGACAGGGAAGTTTGATTTGTATGCAAGAGACCCAGTACTTC	CSVEAVRQGSLICMQETQYF	TRBV29-1	TRBJ2-5
TGCGCCAGCAGGTTCGATGGGTCGGGACAGGGGAAACCGACTAATGAAAAACTGTTTTTT	CASRFDGSGQGKPTNEKLFF	TRBV5-1	TRBJ1-4
TGCGCCAGCAGCCGACGGGCTAAAGCCTACGAGCAGTACTTC	CASSRRAKAYEQYF	TRBV5-1	TRBJ2-7
TGTGCCAGCAGCTTGGGTTACCAGGGCTACAGGGGGGAGCTGTTTTTT	CASSLGYQGYRGELFF	TRBV5-8	TRBJ2-2
TGTGCCAGCAGCTGGGTTGAGCGGGATCCCACCGGGGAGCTGTTTTTT	CASSWVERDPTGELFF	TRBV5-4	TRBJ2-2
TGTACCCCCGGTCAGGGGGGGACCGGGGAGCTGTTTTTT	CTPGQGGTGELFF	TRBV30	TRBJ2-2
TGTGCCAGCAGCTCAGGGGGCCGTAATGAAAAACTGTTTTTT	CASSSGGRNEKLFF	TRBV7-2	TRBJ1-4
TGTGCCAGCAGCTTTACCGGGACAGTATTTGGCTACACCTTC	CASSFTGTVFGYTF	TRBV11-3	TRBJ1-2
TGCAGTGCTACTCCGCCCTACGTAGGGCCCTCGGTATTCACCGGGGAGCTGTTTTTT	CSATPPYVGPSVFTGELFF	TRBV20-1	TRBJ2-2
TGCAGCGTTGCCCGGAGACTAGCGGTTGCATACAATGAGCAGTTCTTC	CSVARRLAVAYNEQFF	TRBV29-1	TRBJ2-1
TGTGCCACCAGCAGAGATTCGGACAGGGGGAACACTGAAGCTTTCTTT	CATSRDSDRGNTEAFF	TRBV15	TRBJ1-1
TGCGCCAGAAGAACAACAGGGAAGACCCAGTACTTC	CARRTTGKTQYF	TRBV5-1	TRBJ2-5
TGTGCCACCAGTCTGGGGGGGGATGGCTACGAGCAGTACTTC	CATSLGGDGYEQYF	TRBV24-1	TRBJ2-7
TGTGCCAGCAGCCGCGGCGGGGAGAGGTTAGCCAATAGACACCCTTGTTGGAACACTGAAGCTTTCTTT	CASSRGGERLANRHPCWNTEAFF	TRBV11-3	TRBJ1-1
TGTGCCATCAGTCCAACAGGGTTGCCCAAAAACATTCAGTACTTC	CAISPTGLPKNIQYF	TRBV10-3	TRBJ2-4
TGCAGTCCAGGGGGAGTTAGCGAGCAGTACTTC	CSPGGVSEQYF	TRBV20-1	TRBJ2-7
TGTGCCAGTAGTAGGCGGACTAGCGGGCGGAACACCGGGGAGCTGTTTTTT	CASSRRTSGRNTGELFF	TRBV19	TRBJ2-2
TGTGCCACCAGTGATTTGCATCCAGTTGAGGCCTACGAGCAGTACTTC	CATSDLHPVEAYEQYF	TRBV24-1	TRBJ2-7
TGCGCCAGCAGCGTGGCAGGTCCAAGGACGGGACCCCACTTC	CASSVAGPRTGPHF	TRBV5-1	TRBJ2-7
TGTGCCAGCAGCTGTGGACAGCTATATAATTCACCCCTCCACTTT	CASSCGQLYNSPLHF	TRBV5-5	TRBJ1-6
TGTGCCAGCAGGGGGCGAAGCAATCAGCCCCAGCATTTT	CASRGRSNQPQHF	TRBV7-9	TRBJ1-5
TGCGCCAGCAGCCAAGACCTCCACGCGGGACAGGGGACGTATGGCTACACCTTC	CASSQDLHAGQGTYGYTF	TRBV4-3	TRBJ1-2
TGTGCCAGCAGCCAAGATTCTTGGATCTTCGTCTCTGGAAACACCATATATTTT	CASSQDSWIFVSGNTIYF	TRBV14	TRBJ1-3
TGTGCCAGCAGTTTGAAAGGGGCTAACCGCTATGGCTACACCTTC	CASSLKGANRYGYTF	TRBV12-3	TRBJ1-2
TGCGCCAGCAGCTTCACCCTCCCACGAGGAGGGGGAAACACCATATATTTT	CASSFTLPRGGGNTIYF	TRBV5-1	TRBJ1-3
TGTGCCTGGAGTGTAAACCAAGACACTGCTTTCTTT	CAWSVNQDTAFF	TRBV30	TRBJ1-1
TGTGCCACCAGGACTAAGGATCAGCCCCAGCATTTT	CATRTKDQPQHF	TRBV15	TRBJ1-5
TGTCCTAGACAGGGGGGGAACTCCTACGAGCAGTACTTC	CPRQGGNSYEQYF	TRBV10-3	TRBJ2-7
TGTGCCAGCAGCCCGGGGGGGGCAAGGAGGAGCCTTGAGACCCAGTACTTC	CASSPGGARRSLETQYF	TRBV27	TRBJ2-5
TGTGCCAACAGGGAGGACACTGAAGCTTTCTTT	CANREDTEAFF	TRBV9	TRBJ1-1
TGTGCCAGCAGCGGGACAGGCATCTACGAGCAGTACTTC	CASSGTGIYEQYF	TRBV7-7	TRBJ2-7
TGCGCCAGCAGCCCAACTACCTTTAGGGCCCAAGCAGATACGCAGTATTTT	CASSPTTFRAQADTQYF	TRBV5-1	TRBJ2-3
TGTGCCAGGAACCCTTATTCCCACACCATCAGCAATGAGCAGTTCTTC	CARNPYSHTISNEQFF	TRBV7-9	TRBJ2-1
TGTGCCAGCAGCGGTACACCGTACTACGAGCAGTACTTC	CASSGTPYYEQYF	TRBV11-3	TRBJ2-7
TGTGCTAGAACAGGGAGGGATGGCTACACCTTC	CARTGRDGYTF	TRBV12-5	TRBJ1-2
TGTGCCAGCAGCTTAGAAATCGGACAGGGGGATAGCTATGGCTACACCTTC	CASSLEIGQGDSYGYTF	TRBV11-2	TRBJ1-2
TGTGCCAGTAGTATCGGACTCCCTAATTCACCCCTCCACTTT	CASSIGLPNSPLHF	TRBV19	TRBJ1-6
TGTGCCAGCAGCCGAGGGCTTACTTTGGAGACCCAGTACTTC	CASSRGLTLETQYF	TRBV7-6	TRBJ2-5
TGTGCCAGCAGTCCCACCATCCCTGGTTCAGTCGATGAGACCCAGTACTTC	CASSPTIPGSVDETQYF	TRBV12-3	TRBJ2-5
TGTGCCAGCAGCGGACAGTACGCCCAGCATTTT	CASSGQYAQHF	TRBV13	TRBJ1-5
TGTGCCAGCAGCCTAGGGGGGAGCAGACTTCAGCCCCAGCATTTT	CASSLGGSRLQPQHF	TRBV13	TRBJ1-5
TGTGCCAGCAGCACCCTAGGCAATCAGCCCCAGCATTTT	CASSTLGNQPQHF	TRBV13	TRBJ1-5
TGTGCCAGCAGCCCTACCGACAGGGGGAGACCTGAAGCTTTCTTT	CASSPTDRGRPEAFF	TRBV14	TRBJ1-1
TGCAGTGCTAGAAGGGGAACAGTAAGGGATGAGCAGTTCTTC	CSARRGTVRDEQFF	TRBV20-1	TRBJ2-1
TGCGCCAGCAGCTTGGTCGGGTACGAGCAGTACTTC	CASSLVGYEQYF	TRBV5-1	TRBJ2-7
TGTGCCAGCAGGCTGACAGGGCGGGTTAGCAATCAGCCCCAGCATTTT	CASRLTGRVSNQPQHF	TRBV11-3	TRBJ1-5
TGTGCCAGCTCCTCGGCTGGCCGGGACACTGAAGCTTTCTTT	CASSSAGRDTEAFF	TRBV12-4	TRBJ1-1
TGTGCCAGCAGCTTGAGGGGACAGGGAAAAGAGACCCAGTACTTC	CASSLRGQGKETQYF	TRBV5-5	TRBJ2-5
TGCGCCAGCAGCTTGGGGGGAATAAGGGACGTTTACACTGAAGCTTTCTTT	CASSLGGIRDVYTEAFF	TRBV5-1	TRBJ1-1
TGTGCCAGCAAGGCGAGCGAGACCCAGTACTTC	CASKASETQYF	TRBV6-5	TRBJ2-5
TGCGCCAGCAGCAGAGAAAACGGACAGGGGGGGTGGTATAGCAATCAGCCCCAGCATTTT	CASSRENGQGGWYSNQPQHF	TRBV5-1	TRBJ1-5
TGCGCCAGCAGCTGCAGACGGAACACCGGGGAGCTGTTTTTT	CASSCRRNTGELFF	TRBV5-1	TRBJ2-2
TGTGCCAGCAGCCCCCCTCTGGGAGGACCCCTCCACTTT	CASSPPLGGPLHF	TRBV13	TRBJ1-6
TGTGCCAGCAGCCAAGATCGGGATCTCTCTGGGGCCAACGTCCTGACTTTC	CASSQDRDLSGANVLTF	TRBV3-1	TRBJ2-6
TGTGCCAGCAGCCCCCCAAGTTACTGTCCTAATCAGCCCCAGCATTTT	CASSPPSYCPNQPQHF	TRBV5-4	TRBJ1-5
TGCAGTGCTAGAGATCCTTTTCGGATATTCCCCGTAGTAAAAGAGACCCAGTACTTC	CSARDPFRIFPVVKETQYF	TRBV20-1	TRBJ2-5
TGTGCCATTTCCAAGGGGAGGAACACTGAAGCTTTCTTT	CAISKGRNTEAFF	TRBV6-5	TRBJ1-1
TGCGCCAGCAGTTGGTTCCAGGGTGACGAGCAGTACTTC	CASSWFQGDEQYF	TRBV10-1	TRBJ2-7
TGTGCCAGTAGTATGTCGCGGGACGGGAACGGGGCTTTCTTT	CASSMSRDGNGAFF	TRBV19	TRBJ1-1
TGTGCCAGCAGCGATGCTAGGGGCTATGGCTACACCTTC	CASSDARGYGYTF	TRBV9	TRBJ1-2
TGCGCCAGCAGCTCTGGGGCGGGTAAACTAGCGGGGGGTACCGTAACCGGGGAGCTGTTTTTT	CASSSGAGKLAGGTVTGELFF	TRBV5-1	TRBJ2-2
TGCAGTGCTAAACACAGGGGGCTCTACAATGAGCAGTTCTTC	CSAKHRGLYNEQFF	TRBV20-1	TRBJ2-1
TGTGCCAGCAGCCAAGCAGGGACTCCCCCTAGCACAGATACGCAGTATTTT	CASSQAGTPPSTDTQYF	TRBV3-1	TRBJ2-3
TGTGCCAGCAGCTCTCCTCCACAGCGTTCAGGGGATGAGCAGTTCTTC	CASSSPPQRSGDEQFF	TRBV7-3	TRBJ2-1
TGCGCCAGCAGCTTGTACCATAATAGCGAGTGGTATGAGCAGTTCTTC	CASSLYHNSEWYEQFF	TRBV5-1	TRBJ2-1
TGTGCCAGCAGCCAAGTTCTAGAGACTGAAGCTTTCTTT	CASSQVLETEAFF	TRBV3-1	TRBJ1-1
TGTGGTCCGACAGAATTCCTGTCGTACGAGCAGTACTTC	CGPTEFLSYEQYF	TRBV12-3	TRBJ2-7
TGCGCCAGCAGCGCCTGGGGGGGAGGCTCAGATACGCAGTATTTT	CASSAWGGGSDTQYF	TRBV5-1	TRBJ2-3
TGTGCCAGCAGCCCGAGGGAGGAAAGCAATCAGCCCCAGCATTTT	CASSPREESNQPQHF	TRBV5-6	TRBJ1-5
TGTGCCAGCAGTAAACCATTCGGGAGAAACACTGAAGCTTTCTTT	CASSKPFGRNTEAFF	TRBV6-1	TRBJ1-1
TGCTTACGGAATGGGAGGGGGAGCTATGGCTACACCTTC	CLRNGRGSYGYTF	TRBV20-1	TRBJ1-2
TGTGCCTGGAGCCTTGGGGGGTTTCAGCCCCAGCATTTT	CAWSLGGFQPQHF	TRBV30	TRBJ1-5
TGTGCCAGCAGCTTGCCCCCCAGGGAAAGTTTTCTGAACACTGAAGCTTTCTTT	CASSLPPRESFLNTEAFF	TRBV7-2	TRBJ1-1
TGCGCCAGCAGCTTCACCCCTCGGGGGGACAAGCCCCAGCATTTT	CASSFTPRGDKPQHF	TRBV5-1	TRBJ1-5
TGTGCCAGCAGCCAATCACTAAGACGGGGGGGCGCCGGGGAGCTGTTTTTT	CASSQSLRRGGAGELFF	TRBV3-1	TRBJ2-2
TGCAGTGCTACAGGGGGCGGCGAGCAGTACTTC	CSATGGGEQYF	TRBV20-1	TRBJ2-7
TGTGCCAGCAGCCACAGTACAGGGGTAAGAGTAGCCTACAATGAGCAGTTCTTC	CASSHSTGVRVAYNEQFF	TRBV3-1	TRBJ2-1
TGTGCCAGCAGGTCCAGGGGGGAAAATAACTATGGCTACACCTTC	CASRSRGENNYGYTF	TRBV6-1	TRBJ1-2
TGTGCCAGTCAGGGCGCTTACGAGCAGTACTTC	CASQGAYEQYF	TRBV19	TRBJ2-7
TGTGCCTCGCGACAGGGGGCTCAGCCCCAGCATTTT	CASRQGAQPQHF	TRBV6-2	TRBJ1-5
TGCGCCAGCAGTTCAGTAGTTTCGGACCGGTACGAGCAGTACTTC	CASSSVVSDRYEQYF	TRBV10-1	TRBJ2-7
TGCGCCAGCAGCCAAGTCCCGGACAGGCGGAAAGCCTACGAGCAGTACTTC	CASSQVPDRRKAYEQYF	TRBV4-3	TRBJ2-7
TGTGGGATCGCCGGGGACGAGGGCACGGATCCAGCCAAAAACATTCAGTACTTC	CGIAGDEGTDPAKNIQYF	TRBV12-3	TRBJ2-4
TGTGCCATCAGTGAGTCGTGCGGAGCCGGGGAGCTGTTTTTT	CAISESCGAGELFF	TRBV10-3	TRBJ2-2
TGCGCCAGCAGCCAAGGGGCGGGAGGTGGCACAGATACGCAGTATTTT	CASSQGAGGGTDTQYF	TRBV4-1	TRBJ2-3
TGTGCCAGCAGCTGGGGGGGTCCAGCCGGGGAGCTGTTTTTT	CASSWGGPAGELFF	TRBV5-4	TRBJ2-2
TGTGCCAGCAGTGATCAGGTTCGTTCCAAAAACATTCAGTACTTC	CASSDQVRSKNIQYF	TRBV6-4	TRBJ2-4
TGCAGTGCACTCCTCTATCAGACCTATAATTCACCCCTCCACTTT	CSALLYQTYNSPLHF	TRBV20-1	TRBJ1-6
TGTGCCAGTAGTATTAGACATGAAAAACTGTTTTTT	CASSIRHEKLFF	TRBV19	TRBJ1-4
TGTGCCAGCAGCGTAGCCGCAGTCGATCATAGCAATCAGCCCCAGCATTTT	CASSVAAVDHSNQPQHF	TRBV9	TRBJ1-5
TGCGCCAGCAGCCAATTAGGGCCATATACTGAAGCTTTCTTT	CASSQLGPYTEAFF	TRBV4-3	TRBJ1-1
TGTGCCAGCAGCCGCAGAGAGACCCAGTACTTC	CASSRRETQYF	TRBV6-8	TRBJ2-5
TGTGCCAGCAGCTTAGGGCCCGGGGTGTTCCGGTTCTCCCCCTATGGCTACACCTTC	CASSLGPGVFRFSPYGYTF	TRBV7-9	TRBJ1-2
TGTGCCAGCAGCTTAGCTCAGAAGGACCGATTAGGCACTGAAGCTTTCTTT	CASSLAQKDRLGTEAFF	TRBV7-4	TRBJ1-1
TGTGCCAGCAGCAACTCGGGAAGGGAATTTCAGCCCCAGCATTTT	CASSNSGREFQPQHF	TRBV13	TRBJ1-5
TGTGCTAGCAGCTTAAAGCCCCCCATAGCGGGCAGTTCCTACGAGCAGTACTTC	CASSLKPPIAGSSYEQYF	TRBV7-7	TRBJ2-7
TGTGCCAGCAGTTTACTAGGGGACTACGAGCAGTACTTC	CASSLLGDYEQYF	TRBV27	TRBJ2-7
TGTGCCAGCAGCTTAATGGTCCTCCACGGAAACTATGGCTACACCTTC	CASSLMVLHGNYGYTF	TRBV7-6	TRBJ1-2
TGTGCCAGCTGGTTCAAGCCTTTGACTTTGATGAACACTGAAGCTTTCTTT	CASWFKPLTLMNTEAFF	TRBV28	TRBJ1-1
TGTGCCACCAACTTACGGGACAGGGTCAACTATGGCTACACCTTC	CATNLRDRVNYGYTF	TRBV24-1	TRBJ1-2
TGTGCCAGCACGGGAGAGGGCCCAGATACGCAGTATTTT	CASTGEGPDTQYF	TRBV7-2	TRBJ2-3
TGTGCCAGCTCACCAATATTCAGGGAGAACACTGAAGCTTTCTTT	CASSPIFRENTEAFF	TRBV18	TRBJ1-1
TGCGCCAGCAGCCAACGCCTAACCCAGAACATTCAGTACTTC	CASSQRLTQNIQYF	TRBV4-3	TRBJ2-4
TGTGCCAGCAGTTATGAGGGGACATTCACCATATATTTT	CASSYEGTFTIYF	TRBV6-3	TRBJ1-3
TGCGCCAGCAGTAAATCCCCCATTGGCTACGAGCAGTACTTC	CASSKSPIGYEQYF	TRBV5-1	TRBJ2-7
TGTGCTACAAGATTCATACGACAGGGCTCGGGCTACACCTTC	CATRFIRQGSGYTF	TRBV12-5	TRBJ1-2
TGTGCCAGTAGTATTGTCGGCGACTACGAGCAGTACTTC	CASSIVGDYEQYF	TRBV19	TRBJ2-7
TGTGCCAGCAGCAAATACAGGCCCGGCTACACCTTC	CASSKYRPGYTF	TRBV7-9	TRBJ1-2
TGTGCCAGCAGCCAAGGCCGGGACAGGGTTCTTAATGGCTACACCTTC	CASSQGRDRVLNGYTF	TRBV14	TRBJ1-2
TGTGCCAGCAGGCACCCGGGACACACCTACGAGCAGTACTTC	CASRHPGHTYEQYF	TRBV28	TRBJ2-7
TGTGCCAGCAACCGCGGGCGGGTCACAGATACGCAGTATTTT	CASNRGRVTDTQYF	TRBV7-8	TRBJ2-3
TGTGGGCTAGCGGGTCCGAACACCGGGGAGCTGTTTTTT	CGLAGPNTGELFF	TRBV7-9	TRBJ2-2
TGTGCCAGCGCAGGGAACCCGGAGCAGTACTTC	CASAGNPEQYF	TRBV2	TRBJ2-7
TGTGCCAGCTCCGGGGAATTCAGTAATGAAAAACTGTTTTTT	CASSGEFSNEKLFF	TRBV18	TRBJ1-4
TGCAGTGCTTGGTCGAGCTCCTACGAGCAGTACTTC	CSAWSSSYEQYF	TRBV20-1	TRBJ2-7
TGCAGTGCAAGCAGGGTGGGCCCCTCCTACGAGCAGTACTTC	CSASRVGPSYEQYF	TRBV20-1	TRBJ2-7
TGTGCCAGCAGCTCTAGCGGGGTCGGGAGTAGGGCGCGGGTCCGGGATGAGGAGACCCAGTACTTC	CASSSSGVGSRARVRDEETQYF	TRBV7-2	TRBJ2-5
TGTGCCAGCAGCGCCAGAGGACTAGCGGGCGGTCCTCTATACGAGCAGTACTTC	CASSARGLAGGPLYEQYF	TRBV13	TRBJ2-7
TGTGCCAGCAGCAATCTCGGCGGAGTGGGCTACACCTTC	CASSNLGGVGYTF	TRBV7-9	TRBJ1-2
TGTGCTAGTGGTTTGGTTGGACAGGAAACAGATACGCAGTATTTT	CASGLVGQETDTQYF	TRBV12-5	TRBJ2-3
TGTGCCAGTAGTAAAACACGGGAATTCGAGCAGTACTTC	CASSKTREFEQYF	TRBV19	TRBJ2-7
TGTGCCAGCAGACAGGTAGTAATGGCTGAAGCTTTCTTT	CASRQVVMAEAFF	TRBV27	TRBJ1-1
TGTGCCTACAGGGGGTCGAGTGAAAAACTGTTTTTT	CAYRGSSEKLFF	TRBV19	TRBJ1-4
TGTGCCAGCAGCTCCGCCCAGGGGGGAGCTTTCTTT	CASSSAQGGAFF	TRBV13	TRBJ1-1
TGTGCCAGCATTCACAGGGAAAGGAACACTGAAGCTTTCTTT	CASIHRERNTEAFF	TRBV6-4	TRBJ1-1
TGTGCCAGCAGTCCTCCTAGGGACGAGCAGTACTTC	CASSPPRDEQYF	TRBV6-1	TRBJ2-7
TGTGCCACTGACCAGGATGGCTACACCTTC	CATDQDGYTF	TRBV28	TRBJ1-2
TGTGCCAGCAGGTCACCGGGGCGCATGTCCTACGAGCAGTACTTC	CASRSPGRMSYEQYF	TRBV7-6	TRBJ2-7
TGCGCCAGCAGCTGGAGGGAAAGTTCTGGGGCCAACGTCCTGACTTTC	CASSWRESSGANVLTF	TRBV5-1	TRBJ2-6
TGCAGTGCTAGAGGATTAGGGGGCATACGTGGCTACACCTTC	CSARGLGGIRGYTF	TRBV20-1	TRBJ1-2
TGTGCCAATGACCGGACAGGGCGTATGAACACTGAAGCTTTCTTT	CANDRTGRMNTEAFF	TRBV19	TRBJ1-1
TGTGCCAGCAGCCCGGAGCCACGCACAGATACGCAGTATTTT	CASSPEPRTDTQYF	TRBV3-1	TRBJ2-3
TGTGCCACCAGAGTCCGGGACACGATTGGTAACTATGGCTACACCTTC	CATRVRDTIGNYGYTF	TRBV24-1	TRBJ1-2
TGTGCCAGCAGGGTTAGGTACAATGAGCAGTTCTTC	CASRVRYNEQFF	TRBV7-9	TRBJ2-1
TGTGCCAGTAGTAGCCGCCTCATAGGGACAGCACAAGGCACAGATACGCAGTATTTT	CASSSRLIGTAQGTDTQYF	TRBV19	TRBJ2-3
TGTGCCAGCTGGTCGTCAGGGGGGGCTTGCACAGATACGCAGTATTTT	CASWSSGGACTDTQYF	TRBV7-3	TRBJ2-3
TGTGCCAGCAGTTTCCCGGAAAAAAACATTCAGTACTTC	CASSFPEKNIQYF	TRBV27	TRBJ2-4
TGCGCCAGCAGCCAAGTAGGGGGGGGGGCCTACAATGAGCAGTTCTTC	CASSQVGGGAYNEQFF	TRBV4-1	TRBJ2-1
TGTGCCAGCAGTTACCCATCACCCACCGGGACCTACGAGCAGTACTTC	CASSYPSPTGTYEQYF	TRBV6-5	TRBJ2-7
TGTGCCAGCAGCTTAGCCTTGGGACGGCTATTCCTATCCTACGAGCAGTACTTC	CASSLALGRLFLSYEQYF	TRBV11-1	TRBJ2-7
TGTGCCAGCAGCTTAGGGGTTCGGGACAGGGCCTACGAGCAGTACTTC	CASSLGVRDRAYEQYF	TRBV7-9	TRBJ2-7
TGTGCCAGCACCCCCGTGGACACTAGCACAGATACGCAGTATTTT	CASTPVDTSTDTQYF	TRBV5-4	TRBJ2-3
TGTGCCTGGACTAACCAGGGAAGGGACAGGGAAGGCTCCTACGAGCAGTACTTC	CAWTNQGRDREGSYEQYF	TRBV30	TRBJ2-7
TGTGCCAGCAGCGTCGGACAGGGGACACACTACGAGCAGTACTTC	CASSVGQGTHYEQYF	TRBV5-6	TRBJ2-7
TGTGCCAGCAGCTTATCGACGAGTCAGGGGGATAGCAATCAGCCCCAGCATTTT	CASSLSTSQGDSNQPQHF	TRBV7-9	TRBJ1-5
TGTGCCAGCACAGATGGACTAGCGGGTGAGCAGTTCTTC	CASTDGLAGEQFF	TRBV7-3	TRBJ2-1
TGTGCCTTCCGACAGGGCGGCTTGCAGTACTTC	CAFRQGGLQYF	TRBV5-4	TRBJ2-7
TGTGCCAGCTCACCCAGCGCCTACGAGCAGTACTTC	CASSPSAYEQYF	TRBV18	TRBJ2-7
TGTGCCAGTACCCGGGTCTCAAGCTCTGGGGCCAACGTCCTGACTTTC	CASTRVSSSGANVLTF	TRBV19	TRBJ2-6
TGTGCCAGCAGTTACCCGAGACAGGGAACGGGGAGGAACTACGAGCAGTACTTC	CASSYPRQGTGRNYEQYF	TRBV6-6	TRBJ2-7
TGTGCCAGCAGCCAGAATCGATACTATGGCTACACCTTC	CASSQNRYYGYTF	TRBV7-4	TRBJ1-2
TGCAGTGCTACAGGGGGGCGGCGCTACGAGCAGTACTTC	CSATGGRRYEQYF	TRBV20-1	TRBJ2-7
TGTGCCAGCAGCTCGGGACAGGGCGCCAATGAGCAGTTCTTC	CASSSGQGANEQFF	TRBV5-6	TRBJ2-1
TGCGCCAGCAGACTGAGTTCGGGGACGTATGAGCAGTTCTTC	CASRLSSGTYEQFF	TRBV5-1	TRBJ2-1
TGTGCCGGAGAGAGGGACAGGGGCCGATCCCAGTACTTC	CAGERDRGRSQYF	TRBV19	TRBJ2-5
TGCGCCAGCAGCCATTTCTCATCCTCGGACAGGCCGGAAAAACTGTTTTTT	CASSHFSSSDRPEKLFF	TRBV4-3	TRBJ1-4
TGTGCCAGCAGTGGCGGGCTGGGTCTTCCCGGGACACGGGGAGACTTTTCACCCCTCCACTTT	CASSGGLGLPGTRGDFSPLHF	TRBV12-3	TRBJ1-6
TGCAGTGCTTGCCGGATGGGGGTAACGTGCATTGGGACTGGGGCCAACGTCCTGACTTTC	CSACRMGVTCIGTGANVLTF	TRBV20-1	TRBJ2-6
TGCGCCAGCAGCCCCCAGCGGGAAGATGGCTACACCTTC	CASSPQREDGYTF	TRBV10-1	TRBJ1-2
TGTGCCAGCAGCTCAGAGGAACTAGCTATTAACACCGGGGAGCTGTTTTTT	CASSSEELAINTGELFF	TRBV11-1	TRBJ2-2
TGTGCCAGCAGCCCCCAGGGGGCCCCCTGTTACGAGCAGTACTTC	CASSPQGAPCYEQYF	TRBV7-4	TRBJ2-7
TGTGCCAGCAGTTACGGGGGTGGGTACGAGCAGTACTTC	CASSYGGGYEQYF	TRBV28	TRBJ2-7
TGTGCCAGCAGGTCCCGGCTGGGGGGTAGGAGCTACGAGCAGTACTTC	CASRSRLGGRSYEQYF	TRBV13	TRBJ2-7
TGTGCCTCGCCATCCGGGGAGCTGTTTTTT	CASPSGELFF	TRBV5-5	TRBJ2-2
TGTGCCAGCAGTTTGAGTGGACTAGCGGGCCCTGCAGATACGCAGTATTTT	CASSLSGLAGPADTQYF	TRBV28	TRBJ2-3
TGTGCCACCAGCAGAGCCCAGCTGTGGAGCGAGCAGTACTTC	CATSRAQLWSEQYF	TRBV15	TRBJ2-7
TGTGCCAGAGGGGGGGACAGTCAGGGATCCTACGAGCAGTACTTC	CARGGDSQGSYEQYF	TRBV27	TRBJ2-7
TGTGCCAGCAGCTTAAAGTGGTCGGGTAAACAGGGGGGGAGGGGCAAAAACATTCAGTACTTC	CASSLKWSGKQGGRGKNIQYF	TRBV7-9	TRBJ2-4
TGCGCCAGCAGTGGTCGGGGTCGCCAAGAGACCCAGTACTTC	CASSGRGRQETQYF	TRBV10-1	TRBJ2-5
TGTGCCAGCAGTGAAGGGCAGACAGCTATCGGCTCCTACGAGCAGTACTTC	CASSEGQTAIGSYEQYF	TRBV6-1	TRBJ2-7
TGCGCCAGCAGTGAGTCAACTAGCGGACGCACAGATACGCAGTATTTT	CASSESTSGRTDTQYF	TRBV10-1	TRBJ2-3
TGCTACCGGGACAGCCTGAACACTGAAGCTTTCTTT	CYRDSLNTEAFF	TRBV20-1	TRBJ1-1
TGTGCCAGCAGCCAAGCCGCTAGTCATGGCTACACCTTC	CASSQAASHGYTF	TRBV3-1	TRBJ1-2
TGTGCCAGCAGCCCCCTGCTAGCGGGTAACAATGAGCAGTTCTTC	CASSPLLAGNNEQFF	TRBV7-4	TRBJ2-1
TGTGCCACCAGTGATGACGGACATTACTATGGCTACACCTTC	CATSDDGHYYGYTF	TRBV24-1	TRBJ1-2
TGTGCCAGCAGCTTAGCGGGCGACGGCGGGAGGACTAATGAAAAACTGTTTTTT	CASSLAGDGGRTNEKLFF	TRBV7-6	TRBJ1-4
TGTGCCAGCAGCGTTCCCCCATCATGTGGCGGGAGCAGGACGAACCCCTACGAGCAGTACTTC	CASSVPPSCGGSRTNPYEQYF	TRBV7-4	TRBJ2-7
TGTGCCTGGAGTCCGAGACAGGGGTTCCCCTCTGGGGCCAACGTCCTGACTTTC	CAWSPRQGFPSGANVLTF	TRBV30	TRBJ2-6
TGTGCCAGCAGTGACAGGGGCCGAGAGACCCAGTACTTC	CASSDRGRETQYF	TRBV6-5	TRBJ2-5
TGTGCCAGCAGCTTATTAGCGGGAGCAAGTGATCAGGAGACCCAGTACTTC	CASSLLAGASDQETQYF	TRBV5-8	TRBJ2-5
TGTGCCACCAGTGTCCTCCCCCGACCCAACCGGGACCTGGGACAAGGCAACTATGGCTACACCTTC	CATSVLPRPNRDLGQGNYGYTF	TRBV24-1	TRBJ1-2
TGTGCCACCAGTGCCCTAACTAGAACAGATACGCAGTATTTT	CATSALTRTDTQYF	TRBV24-1	TRBJ2-3
TGCGCCAGCAGGAAGGTGGACAGGGGGGAGGCTGAAGCTTTCTTT	CASRKVDRGEAEAFF	TRBV10-1	TRBJ1-1
TGCAGTGCTAATCCTAGCGGGGAGACAGATACGCAGTATTTT	CSANPSGETDTQYF	TRBV20-1	TRBJ2-3
TGTGCCAGCAGTTACAACAGCGGGGCATTGTCCTACGAGCAGTACTTC	CASSYNSGALSYEQYF	TRBV6-5	TRBJ2-7
TGTGCTAGTGGTTTGGTCCGGCAGTTTGAGTATGGCTACACCTTC	CASGLVRQFEYGYTF	TRBV12-5	TRBJ1-2
TGTGCCAGCAGCCAAGATGATGACGAGTTCGTAGGCAGACAAGAGACCCAGTACTTC	CASSQDDDEFVGRQETQYF	TRBV4-2	TRBJ2-5
TGTGCCAGCACGCCCCAAGCTCACAGGGTCTCCCAGGGAAAGACCCAGTACTTC	CASTPQAHRVSQGKTQYF	TRBV6-6	TRBJ2-5
TGCGCCAGCAGCTTGTCGGAAGGCGGCGGGAGCACAGATACGCAGTATTTT	CASSLSEGGGSTDTQYF	TRBV5-1	TRBJ2-3
TGTGCCAGCAGTGGAGGGTTTGACGAGCAGTACTTC	CASSGGFDEQYF	TRBV27	TRBJ2-7
TGCAGTGCTAGCATACCTGGACAGAGGCGAAACTATGGCTACACCTTC	CSASIPGQRRNYGYTF	TRBV20-1	TRBJ1-2
TGTGCCAGCAGTTACCAATTCCCCAAGGGGCGCAATCAGCCCCAGCATTTT	CASSYQFPKGRNQPQHF	TRBV6-2	TRBJ1-5
TGTGCCAGCAGTATAGCCGGGGAGCTGTTTTTT	CASSIAGELFF	TRBV6-1	TRBJ2-2
TGCGCCAGCAGCCAAGATAATGAACGGGTGTTGGTCGAGGCCACTGAAGCTTTCTTT	CASSQDNERVLVEATEAFF	TRBV4-1	TRBJ1-1
TGTGCCAGCGACCCGGGACTAGCGCACAATGAGCAGTTCTTC	CASDPGLAHNEQFF	TRBV7-8	TRBJ2-1
TGTGCCAGCTCACCAAGCGGGAACACTGAAGCTTTCTTT	CASSPSGNTEAFF	TRBV18	TRBJ1-1
TGCGCCAGCAGCGCGGGAGAGCCCTACGAGCAGTACTTC	CASSAGEPYEQYF	TRBV4-1	TRBJ2-7
TGTGCCAGCAGCTCGGGACAGTGTCAACTCTATGGCTACACCTTC	CASSSGQCQLYGYTF	TRBV5-8	TRBJ1-2
TGTGCCAGCAGCGGGACAGGGTCTGGCTACACCTTC	CASSGTGSGYTF	TRBV7-9	TRBJ1-2
TGTGCCAGCAGCCTGGGAACCCCCGGGACAGGAATAGCCGGGGAGCTGTTTTTT	CASSLGTPGTGIAGELFF	TRBV5-4	TRBJ2-2
TGTGCCTGGAGTGTAGGCTATTCTCCGGACCTGAGGACCTCCTACGAGCAGTACTTC	CAWSVGYSPDLRTSYEQYF	TRBV30	TRBJ2-7
TGTGCCAGCAGTGGACAGTACGGGTATTTT	CASSGQYGYF	TRBV27	TRBJ2-3
TGTGCCAGCAGTGGTGCCCGTGAGGGGGGCTACGAGCAGTACTTC	CASSGAREGGYEQYF	TRBV2	TRBJ2-7
TGTGCCAGCAGTTTATCGGGCCCTACCCTTGACAGGGCGTTGGCCCTTGTCTATGGCTACACCTTC	CASSLSGPTLDRALALVYGYTF	TRBV27	TRBJ1-2
TGTGCCAGCAGCTTCCGGAAATGCACAGATACGCAGTATTTT	CASSFRKCTDTQYF	TRBV5-4	TRBJ2-3
TGTGCCAGCAGTCCCACAGGGGAAAGTGAAGCTTTCTTT	CASSPTGESEAFF	TRBV27	TRBJ1-1
TGTGCCAGCACAGTCAGGGCTTCCCAGCCCCAGCATTTT	CASTVRASQPQHF	TRBV7-3	TRBJ1-5
TGTGCCAGCAGCTCCTCGCGTAACGAGCAGTACTTC	CASSSSRNEQYF	TRBV7-2	TRBJ2-7
TGCAGTGCTGCGCGGGAGCCAGAGACCCAGTACTTC	CSAAREPETQYF	TRBV20-1	TRBJ2-5
TGTGCCAGCAGCTGGTGTGGGATCAAGAGCTCCTACGAGCAGTACTTC	CASSWCGIKSSYEQYF	TRBV5-6	TRBJ2-7
TGTGCCAGCAGGGGGCGGGGCGAGACCCAGTACTTC	CASRGRGETQYF	TRBV6-4	TRBJ2-5
TGTGCCAGCAGCTCAGGGGCGGGAGATCCTGGAGATACGCAGTATTTT	CASSSGAGDPGDTQYF	TRBV13	TRBJ2-3
TGTGCCAGCAGCTTGGCCTGGATGGGTAGCAATCAGCCCCAGCATTTT	CASSLAWMGSNQPQHF	TRBV5-6	TRBJ1-5
TGTGCCAGCAGATCTCTGGGGCAACCCTACGAGCAGTACTTC	CASRSLGQPYEQYF	TRBV11-3	TRBJ2-7
TGTGCCAGCAGCAAAATTAATTGGGGCCGATTTAACTATGGCTACACCTTC	CASSKINWGRFNYGYTF	TRBV7-4	TRBJ1-2
TGTGCCACGGGGTGGGACAGTAGCAATCAGCCCCAGCATTTT	CATGWDSSNQPQHF	TRBV24-1	TRBJ1-5
TGTGCCAGCAGCTTATTAGGGGCGTCAGGGCCTAGCGGGCTTTCAGATACGCAGTATTTT	CASSLLGASGPSGLSDTQYF	TRBV7-9	TRBJ2-3
TGTGCCATCCAGGGAAATGGAAACACCATATATTTT	CAIQGNGNTIYF	TRBV6-3	TRBJ1-3
TGCAGTGCTAGAGATCCCAGGGTTATGAACACTGAAGCTTTCTTT	CSARDPRVMNTEAFF	TRBV20-1	TRBJ1-1
TGTGCCAGCAGCACCCAGCGGGAGCACGAGCAGTACTTC	CASSTQREHEQYF	TRBV13	TRBJ2-7
TGTGCCAGTAGACCCCAGGGGCATAGCAATCAGCCCCAGCATTTT	CASRPQGHSNQPQHF	TRBV19	TRBJ1-5
TGTGCCAGCAGCGCGGGTAAACGGGGACAGATGAGGAACACTGAAGCTTTCTTT	CASSAGKRGQMRNTEAFF	TRBV7-4	TRBJ1-1
TGCGCCAGCGAAACCCAAGCTACTGAAGCTTTCTTT	CASETQATEAFF	TRBV10-2	TRBJ1-1
TGTGCCAGCAGCAGTCTGAGGGCCCGAACTGAAGCTTTCTTT	CASSSLRARTEAFF	TRBV7-9	TRBJ1-1
TGTGCCAGCAGTCCCTACCCAGAGCAGTTCTTC	CASSPYPEQFF	TRBV6-5	TRBJ2-1
TGTGCCAGCAGCCCCGGGGGCACTGAAGCTTTCTTT	CASSPGGTEAFF	TRBV11-3	TRBJ1-1
TGCGCCAGCAGCTCATTTGACGAGCAGTACTTC	CASSSFDEQYF	TRBV10-1	TRBJ2-7
TGTGCCTGGACCTTCCCGGGGGTCTCGGGCGGAGGGTATAATTCACCCCTCCACTTT	CAWTFPGVSGGGYNSPLHF	TRBV30	TRBJ1-6
TGTGCCAGCAGTTTAATTCTACACAGGGCTGGCAATCAGCCCCAGCATTTT	CASSLILHRAGNQPQHF	TRBV12-4	TRBJ1-5
TGTGCCAGTAGTATAGACCCTAATGGATGTGATAGCAATCAGCCCCAGCATTTT	CASSIDPNGCDSNQPQHF	TRBV19	TRBJ1-5
TGCGCCAGCAGTGAGCGACAGGGGTCGATTTTGGGCGGCTACACCTTC	CASSERQGSILGGYTF	TRBV10-1	TRBJ1-2
TGCAGTGCTAGAGAGGTAGGGACAGGGGGGGCTCCCTACACCTTC	CSAREVGTGGAPYTF	TRBV20-1	TRBJ1-2
TGTGCCAGCACGGGACAGGGGGAACGTGGCCCTGAAGCTTTCTTT	CASTGQGERGPEAFF	TRBV2	TRBJ1-1
TGTGCCAGCAGTACTACAGGGGGCGGGCAAGAGACCCAGTACTTC	CASSTTGGGQETQYF	TRBV7-3	TRBJ2-5
TGTGCCAGCAGCCAAGAGTCTAGAGGGACAGATACGCAGTATTTT	CASSQESRGTDTQYF	TRBV14	TRBJ2-3
TGCGCCAGCAGCCAAATTAGGGACAGGCCTGGGGCCAACGTCCTGACTTTC	CASSQIRDRPGANVLTF	TRBV4-1	TRBJ2-6
TGTGCCAGCAGCTCACCCTTCGAGGGAGGAAACACCATATATTTT	CASSSPFEGGNTIYF	TRBV7-4	TRBJ1-3
TGCGCCAGCAGCACAGGGTCGTTCTACGAGCAGTACTTC	CASSTGSFYEQYF	TRBV5-1	TRBJ2-7
TGTGCCACCAGGGAAGCCCGAAGGAAGTATGGCTACACCTTC	CATREARRKYGYTF	TRBV24-1	TRBJ1-2
TGTGCCAGCGGAAACATCCCCGGGACACAGCCCCAGCATTTT	CASGNIPGTQPQHF	TRBV9	TRBJ1-5
TGCGCCAGCAGCTTGGTGGAACAGGGGGACGAGGCTGGAAACACCATATATTTT	CASSLVEQGDEAGNTIYF	TRBV5-1	TRBJ1-3
TGTGCCAGCTCACCACAGGCCTTGGACAGGGGGGGGAGCTCCTATAATTCACCCCTCCACTTT	CASSPQALDRGGSSYNSPLHF	TRBV18	TRBJ1-6
TGTGCCAGCAGCACAGGACCTGTGGGCTACACCTTC	CASSTGPVGYTF	TRBV9	TRBJ1-2
TGCGCCAGCGAAATGAGAGCGAACACCGGGGAGCTGTTTTTT	CASEMRANTGELFF	TRBV4-1	TRBJ2-2
TGCGCCAGCAGTGAGCTTCTTCCTAATCAGCCCCAGCATTTT	CASSELLPNQPQHF	TRBV10-1	TRBJ1-5
TGCGCCATGTGTCCAGAGCAGCCCCAGCATTTT	CAMCPEQPQHF	TRBV10-1	TRBJ1-5
TGTGCCAGCAGTTACCTCCTCGACAGGGACTTCTTT	CASSYLLDRDFF	TRBV6-5	TRBJ1-1
TGCAGCGTTGTTGGGGGGAGGACCGGCACAGATACGCAGTATTTT	CSVVGGRTGTDTQYF	TRBV29-1	TRBJ2-3
TGTGCCAGCAGCTCCGACAGGGGTGACACCGGGGAGCTGTTTTTT	CASSSDRGDTGELFF	TRBV5-6	TRBJ2-2
TGCGCCAGCAGCCTTGGGGGGCATGAGGCGAACACCGGGGAGCTGTTTTTT	CASSLGGHEANTGELFF	TRBV4-1	TRBJ2-2
TGTGCCAGCAGCTCATACAGGGGGCGCTCTGGAAACACCATATATTTT	CASSSYRGRSGNTIYF	TRBV6-4	TRBJ1-3
TGTGCCAGCAGCTGCCGACAGGGGGGTACCGGCTACACCTTC	CASSCRQGGTGYTF	TRBV7-9	TRBJ1-2
TGTGCCACCAAAAGGGGCCCTCGGAGGACAGATACGCAGTATTTT	CATKRGPRRTDTQYF	TRBV24-1	TRBJ2-3
TGCAGCGTTGAAGTAGAGAGTGGCAATGAGCAGTTCTTC	CSVEVESGNEQFF	TRBV29-1	TRBJ2-1
TGCAGTGCTAGCGGTGAGGGACAGACAGATACGCAGTATTTT	CSASGEGQTDTQYF	TRBV20-1	TRBJ2-3
TGCAGTGCTCTAAGGGGTGAAACCTACGAGCAGTACTTC	CSALRGETYEQYF	TRBV20-1	TRBJ2-7
TGTGCCAGCAGCTTGGGACCCCGGGACAGGGACACTGAAGCTTTCTTT	CASSLGPRDRDTEAFF	TRBV5-6	TRBJ1-1
TGTGCCACCAGCAGACCCAGGGGGCGAGATTACGAGCAGTACTTC	CATSRPRGRDYEQYF	TRBV15	TRBJ2-7
TGTGCCAGCAGACCCGGACGAAGCACAGATACGCAGTATTTT	CASRPGRSTDTQYF	TRBV6-4	TRBJ2-3
TGTGCCAGCAGGGACCTGGGGGGCCCAGGAGAGACCCAGTACTTC	CASRDLGGPGETQYF	TRBV7-9	TRBJ2-5
TGTGCCAGCAGCCAAGACGTCTGGGGCTCCTACAATGAGCAGTTCTTC	CASSQDVWGSYNEQFF	TRBV14	TRBJ2-1
TGTGCCAGAGTATTGGGACTAGCGGGTTCTACCACCGGGGAGCTGTTTTTT	CARVLGLAGSTTGELFF	TRBV6-3	TRBJ2-2
TGTGCCACCAGTCAAAGCGGCTGCTGCACAGATACGCAGTATTTT	CATSQSGCCTDTQYF	TRBV24-1	TRBJ2-3
TGTGCCAGCAGCTTAAGAGGGCCTACCGATCAGCCCCAGCATTTT	CASSLRGPTDQPQHF	TRBV11-2	TRBJ1-5
TGTGCCATCAGTGATCTCATAGCGGGAATTAATTACTCTGGGGCCAACGTCCTGACTTTC	CAISDLIAGINYSGANVLTF	TRBV10-3	TRBJ2-6
TGCGCCAGCAGACGGTGTCGGACAGGAGAGACCCAGTACTTC	CASRRCRTGETQYF	TRBV5-1	TRBJ2-5
TGTGCCAGCAGTGCCCTCGACAGGAACACCTTC	CASSALDRNTF	TRBV25-1	TRBJ1-2
TGCAGTGCTAGTTCCCAACTAGCGCTAGGGAACTACGAGCAGTACTTC	CSASSQLALGNYEQYF	TRBV20-1	TRBJ2-7
TGTGCCAGCAGCGTAGACGCGGGAGCGAACTATGGCTACACCTTC	CASSVDAGANYGYTF	TRBV9	TRBJ1-2
TGTGCCAGCAGGTCCGACGGGAGCACAGATACGCAGTATTTT	CASRSDGSTDTQYF	TRBV6-4	TRBJ2-3
TGCGCCAGCAGCTTGAGTGGGGGGCTTTACACCGGGGAGCTGTTTTTT	CASSLSGGLYTGELFF	TRBV5-1	TRBJ2-2
TGTGCCAGTAGTCACTTTTGGACAGGGAGGGATAGTCGAGAGACCCAGTACTTC	CASSHFWTGRDSRETQYF	TRBV19	TRBJ2-5
TGCACCAGGATCTGTACATTAAGCTTTAATTCACCCCTCCACTTT	CTRICTLSFNSPLHF	TRBV20-1	TRBJ1-6
TGTGCCTGGCCTCGCTGGGACAGGGCCCAGCCACTTTACAATGAGCAGTTCTTC	CAWPRWDRAQPLYNEQFF	TRBV30	TRBJ2-1
TGTGCCAGCAGTTCTATACAGGGAACCGCCTCCTACGAGCAGTACTTC	CASSSIQGTASYEQYF	TRBV27	TRBJ2-7
TGTGCCAGCAGCTTCACTAGGTCAAGTCCAGGGGGCTACACCTTC	CASSFTRSSPGGYTF	TRBV11-2	TRBJ1-2
TGTGCCAGCAGTGAATATGATAGGTCGGAAGTTCAAGAGACCCAGTACTTC	CASSEYDRSEVQETQYF	TRBV25-1	TRBJ2-5
TGTGCCAGCAGCCCCGGGGGGGGGGAAACCAAAAACATTCAGTACTTC	CASSPGGGETKNIQYF	TRBV7-3	TRBJ2-4
TGCGCCAGCAGCCAAGTTATGGGGCAAAGAAACACTGAAGCTTTCTTT	CASSQVMGQRNTEAFF	TRBV4-1	TRBJ1-1
TGTGCCAGCAGCTGCGGGGGGGCGAGCTCTGGAAACACCATATATTTT	CASSCGGASSGNTIYF	TRBV5-6	TRBJ1-3
TGTGCCAGCCGAGGGAGGGGGCGGTACACAGATACGCAGTATTTT	CASRGRGRYTDTQYF	TRBV5-6	TRBJ2-3
TGCGCCAGCAGCCCTGAGGAGCTCCGGAGAATCTACACCTTC	CASSPEELRRIYTF	TRBV5-1	TRBJ1-2
TGTGCCAGCTCACCGGCCAGGACTAGCGGGACCTACGAGCAGTACTTC	CASSPARTSGTYEQYF	TRBV18	TRBJ2-7
TGCGCCAGCAGCACTAGCGGGAGTAGAAAAAGAGGCTACGAGCAGTACTTC	CASSTSGSRKRGYEQYF	TRBV5-1	TRBJ2-7
TGTGCCAGCAGCCCTGGGACAGACACTGAAGCTTTCTTT	CASSPGTDTEAFF	TRBV11-3	TRBJ1-1
TGTGCCAGCAGCTTAGTAGATGGTGCCAACCTTCAGCCCCAGCATTTT	CASSLVDGANLQPQHF	TRBV7-2	TRBJ1-5
TGTGCCAGCAGAGGCCGCAGGGGGGTGGTGAACACTGAAGCTTTCTTT	CASRGRRGVVNTEAFF	TRBV7-3	TRBJ1-1
TGTGCCAGCAGCTGCTCAGACAGGGGGAGAAATAATTCACCCCTCCACTTT	CASSCSDRGRNNSPLHF	TRBV7-8	TRBJ1-6
TGTGCCAGCATTAGGAGGGGAAATGAGCAGTTCTTC	CASIRRGNEQFF	TRBV6-4	TRBJ2-1
TGTGCCAGCAGTTACAGGCCCGTAACCCTTGGCACAGATACGCAGTATTTT	CASSYRPVTLGTDTQYF	TRBV6-5	TRBJ2-3
TGCGCCAGCAGCCAAGTACCTGAACTAGCGGGGGACTACGAGCAGTACTTC	CASSQVPELAGDYEQYF	TRBV4-1	TRBJ2-7
TGTGCCAGCTCGGCGAAGTACTTC	CASSAKYF	TRBV18	TRBJ2-4
TGTGCCAGCAGCTTGCACCTTCGAAACGGCTACACCTTC	CASSLHLRNGYTF	TRBV5-4	TRBJ1-2
TGCGCCAGCAGCTTGGATTTAGGGCTGATAGAAAAACTGTTTTTT	CASSLDLGLIEKLFF	TRBV5-1	TRBJ1-4
TGTGCCACCAGTGAGGCGCGGCACTTCGAAAGCAATCAGCCCCAGCATTTT	CATSEARHFESNQPQHF	TRBV24-1	TRBJ1-5
TGTGCCACCAGTGATTTTACTAGCGGGAGGCCGGCCACAGATACGCAGTATTTT	CATSDFTSGRPATDTQYF	TRBV24-1	TRBJ2-3
TGCGCCAGCAGTGAGGAGGGGGGCGCTTTCTTT	CASSEEGGAFF	TRBV10-1	TRBJ1-1
TGTGCCAGCAGCTTAGAAAATTGGGACAGGTGGGTGGGTAGTGGCTACACCTTC	CASSLENWDRWVGSGYTF	TRBV7-6	TRBJ1-2
TGTGCCAGCAGCCAAGATGTAAAGCGGCAAGAGACCCAGTACTTC	CASSQDVKRQETQYF	TRBV3-1	TRBJ2-5
TGCAGTGCGAGGGGGATTCTCCTGGGGGGGTCCAGATCTAATGAAAAACTGTTTTTT	CSARGILLGGSRSNEKLFF	TRBV20-1	TRBJ1-4
TGCAGTGCTAGCGGGGGGCCGACAGGGTACGAGCAGTACTTC	CSASGGPTGYEQYF	TRBV20-1	TRBJ2-7
TGTGCCAGCAGCAACGTCAGGGCTTACAATCAGCCCCAGCATTTT	CASSNVRAYNQPQHF	TRBV7-9	TRBJ1-5
TGTGCCAGCAGTGAAGCGCTTGAAAGGACAGTCCATGGCTACACCTTC	CASSEALERTVHGYTF	TRBV6-1	TRBJ1-2
TGTGCCAGCAGTGACGACTGGTACAATGAGCAGTTCTTC	CASSDDWYNEQFF	TRBV6-4	TRBJ2-1
TGTGCTAGTGGTTTGGGAGGGAATGGGGGGAGCTCCTATAATTCACCCCTCCACTTT	CASGLGGNGGSSYNSPLHF	TRBV12-5	TRBJ1-6
TGTGCCAGCAGCTCGCCGGGACAGAAGTCAGATACGCAGTATTTT	CASSSPGQKSDTQYF	TRBV13	TRBJ2-3
TGTGCCAGCGCCCCCGGTGCGGGGTACAATGAGCAGTTCTTC	CASAPGAGYNEQFF	TRBV27	TRBJ2-1
TGTGCCATCACGGTCAATTGGGCCCCCAACCGCAATCAGCCCCAGCATTTT	CAITVNWAPNRNQPQHF	TRBV10-3	TRBJ1-5
TGTGCCAGCAGCTTGAATAAGGCACTGCGTAACTCCTACGAGCAGTACTTC	CASSLNKALRNSYEQYF	TRBV5-6	TRBJ2-7
TGTGCCACGCTACATGAGCAGTTCTTC	CATLHEQFF	TRBV24-1	TRBJ2-1
TGCGCCAGCAAACCGGGTAGGCAGTATTTT	CASKPGRQYF	TRBV5-1	TRBJ2-3
TGTGCCAGGACTCTCGGACAGGGGGGCGGGGAGCTGTTTTTT	CARTLGQGGGELFF	TRBV27	TRBJ2-2
TGCAGTGCTGACGTGGGGGGTGAGAATCAGCCCCAGCATTTT	CSADVGGENQPQHF	TRBV20-1	TRBJ1-5
TGTGCCAGCTCACCTATCTTCGGAGGAAGCCAAGAGACCCAGTACTTC	CASSPIFGGSQETQYF	TRBV18	TRBJ2-5
TGTGCCAGCAGGACAGGGGGCGGGAATGAAAAACTGTTTTTT	CASRTGGGNEKLFF	TRBV5-6	TRBJ1-4
TGTGCCCGTGCAGGGGAAAAACTGTTTTTT	CARAGEKLFF	TRBV30	TRBJ1-4
TGTGCCAGCAGCAGATTGGCGAAAGATTGCCCGAACACCGGGGAGCTGTTTTTT	CASSRLAKDCPNTGELFF	TRBV6-1	TRBJ2-2
TGTGCCAGCAGTTTCGATGCTGGCCCATGTGAGCAGTACTTC	CASSFDAGPCEQYF	TRBV27	TRBJ2-7
TGTGCCTACTCCTACAATGAGCAGTTCTTC	CAYSYNEQFF	TRBV12-5	TRBJ2-1
TGCGCCAGCAGTGGTAGATGCCCGAGCGTGAACACTGAAGCTTTCTTT	CASSGRCPSVNTEAFF	TRBV10-1	TRBJ1-1
TGTGCCAGCAGCGTAGCTGCGGGGTTGGGCAGGGGCATACCCGGGACTGGAAACTATGGCTACACCTTC	CASSVAAGLGRGIPGTGNYGYTF	TRBV9	TRBJ1-2
TGTGCCACCAGTGATTGCAGGCGGAATCCGGGACAGGGGCATAGCAATCAGCCCCAGCATTTT	CATSDCRRNPGQGHSNQPQHF	TRBV24-1	TRBJ1-5
TGCGCCAGCAGTGAGGTTGACAGCGGAAACACCATATATTTT	CASSEVDSGNTIYF	TRBV10-1	TRBJ1-3
TGTGCCAGCAGCTCTCCGGGACAGGGGGCGCACTCGGGCTACACCTTC	CASSSPGQGAHSGYTF	TRBV9	TRBJ1-2
TGTGCCAGCAGTTACTCGACCCGGTCACCGTCCGACAGATTCCCTCAACTGGCGGACTCATCCTATAATTCACCCCTCCACTTT	CASSYSTRSPSDRFPQLADSSYNSPLHF	TRBV6-6	TRBJ1-6
TGCGCCAGCAGCTTGGGACGGGGAGTCATTCAGTACTTC	CASSLGRGVIQYF	TRBV5-1	TRBJ2-4
TGCGCCAGCAGTGAGGGCCAGGGGCTGGGCGAGCAGTACTTC	CASSEGQGLGEQYF	TRBV10-1	TRBJ2-7
TGCGCCAGCAGCTGGTCCTCTAGCGGTGGCACAGATACGCAGTATTTT	CASSWSSSGGTDTQYF	TRBV5-1	TRBJ2-3
TGTGCCAGCAGTGCTGGGATCGAGCAGTACTTC	CASSAGIEQYF	TRBV6-4	TRBJ2-7
TGTGCCAGCTCACCGAGGGGTGGGTATGGCTACACCTTC	CASSPRGGYGYTF	TRBV18	TRBJ1-2
TGCAGTGCTGGTCCCGCACGTAACAGCTCCTACAATGAGCAGTTCTTC	CSAGPARNSSYNEQFF	TRBV20-1	TRBJ2-1
TGTGCCAGCAGCGCGACAGGGGAGGCCACTGAAGCTTTCTTT	CASSATGEATEAFF	TRBV13	TRBJ1-1
TGTGCCAGCAGCTTAGCGTGGGGGGGGGAGCGCTACGAGCAGTACTTC	CASSLAWGGERYEQYF	TRBV7-9	TRBJ2-7
TGTGCCAGCAGTGAGGAAGGGGAGGGCTCCACAGCTTTCTTT	CASSEEGEGSTAFF	TRBV6-1	TRBJ1-1
TGCAGTGCTAGGTCGGGGGGGGGCTACGAGCAGTACTTC	CSARSGGGYEQYF	TRBV20-1	TRBJ2-7
TGTGCCAGCAGTGACTATACCCTGAGACAGGGTCCCTACGAGCAGTACTTC	CASSDYTLRQGPYEQYF	TRBV25-1	TRBJ2-7
TGTGCCAGCAGTGAGCCGTGGGACAGGGGAACGGCGGACGAGCAGTACTTC	CASSEPWDRGTADEQYF	TRBV6-4	TRBJ2-7
TGTGCCAGAGACACAGGGTGGTGGGGCTACGAGCAGTACTTC	CARDTGWWGYEQYF	TRBV6-1	TRBJ2-7
TGTGCCAGCATGTTTGGGAGGCAGATCTACGAGCAGTACTTC	CASMFGRQIYEQYF	TRBV27	TRBJ2-7
TGTGCCAGCAGCCCTGACAGGGGATCATCTACTAGGGCAACTAATGAAAAACTGTTTTTT	CASSPDRGSSTRATNEKLFF	TRBV9	TRBJ1-4
TGTGCCAGCAGTAGGGATGGGGGGCGTATGAAGAAAACCTACGAGCAGTACTTC	CASSRDGGRMKKTYEQYF	TRBV27	TRBJ2-7
TGTGCCAGCAGCTCAGTACTCGGGACATCGAACACCGGGGAGCTGTTTTTT	CASSSVLGTSNTGELFF	TRBV5-8	TRBJ2-2
TGTGCCAGCAGCGGAACCCAGGGGACATCCCAGCATTTT	CASSGTQGTSQHF	TRBV6-1	TRBJ1-5
TGTGCCAGCAGCTTGTTCCGACAGGTAGGTACTAGCACAGATACGCAGTATTTT	CASSLFRQVGTSTDTQYF	TRBV5-6	TRBJ2-3
TGTGCCATCGTGGGGAAAGCATCTGGGACCCAGTACTTC	CAIVGKASGTQYF	TRBV10-3	TRBJ2-5
TGTGCCAGTAGCACGTTGGGGGCAGAGATGAACACTGAAGCTTTCTTT	CASSTLGAEMNTEAFF	TRBV19	TRBJ1-1
TGTGCCAGCAGTAGAAAGACGGGACAGGGGTGGAGGAACACTGAAGCTTTCTTT	CASSRKTGQGWRNTEAFF	TRBV28	TRBJ1-1
TGTGCCTGGAGTGTACCAAGACAGAATCAGCCCCAGCATTTT	CAWSVPRQNQPQHF	TRBV30	TRBJ1-5
TGTGCCAGCAGTGAACGCCAAACCCCAGGTAGTAGACTAGAGTACGAGCAGTACTTC	CASSERQTPGSRLEYEQYF	TRBV6-4	TRBJ2-7
TGTGCCAGCAGCATCATGACGGTATATCAGCCCCAGCATTTT	CASSIMTVYQPQHF	TRBV6-4	TRBJ1-5
TGTGCCAGCAGCTTAGTCATAACCGGGCCCAATCAGCCCCAGCATTTT	CASSLVITGPNQPQHF	TRBV7-6	TRBJ1-5
TGTGCCAGCAGTTTAGTCTGGGGTGAGAGCTCTGGGGCCAACGTCCTGACTTTC	CASSLVWGESSGANVLTF	TRBV27	TRBJ2-6
TGTGCCAGCTATCTCGTATCCTACGAGCAGTACTTC	CASYLVSYEQYF	TRBV28	TRBJ2-7
TGTGCCAGCAGGGGACTTGGGGGCAATAATTCACCCCTCCACTTT	CASRGLGGNNSPLHF	TRBV6-2	TRBJ1-6
TGTGCCAGCAGCCGAGGGAGGGACTTGTACTTC	CASSRGRDLYF	TRBV7-9	TRBJ2-5
TGTGCCAGCAGCCGCGACAGACTGAAAGGGGGCTACACCTTC	CASSRDRLKGGYTF	TRBV13	TRBJ1-2
TGTGCCAAGAAAAGCCGTACTAGCGGGAGGGCTCAGCCCCAGCATTTT	CAKKSRTSGRAQPQHF	TRBV6-1	TRBJ1-5
TGTGCCAGCAGCAATCCCGAGGGGGGGGGGGGGTCCAATGAGCAGTTCTTC	CASSNPEGGGGSNEQFF	TRBV7-9	TRBJ2-1
TGCAGCGCAGCCTGGCTACGGGCGAAGATTAACTATGGCTACACCTTC	CSAAWLRAKINYGYTF	TRBV29-1	TRBJ1-2
TGCGCCAGCAGCCAAGACGTACCTTCTGAAATAGCGGGCCGCTACAATGAGCAGTTCTTC	CASSQDVPSEIAGRYNEQFF	TRBV4-1	TRBJ2-1
TGTGCCAGCAGCTTGGGACAGGGGATCTTCGGGAATCAGCCCCAGCATTTT	CASSLGQGIFGNQPQHF	TRBV7-9	TRBJ1-5
TGCGCCAGCAGCCTCCGGGACTACAATGAGCAGTTCTTC	CASSLRDYNEQFF	TRBV4-1	TRBJ2-1
TGTGCTAGTGGTGGGACTAGGTACAATGAGCAGTTCTTC	CASGGTRYNEQFF	TRBV12-5	TRBJ2-1
TGTGCCAGCAGCTCTCTCACGGGAAACACTGAAGCTTTCTTT	CASSSLTGNTEAFF	TRBV11-3	TRBJ1-1
TGTGCCAGCAGACACCACAGGGTAACCGGGGAGCTGTTTTTT	CASRHHRVTGELFF	TRBV13	TRBJ2-2
TGTGCCAGCATCCCCCCGGACAGGGACGGGAACCCGCATTTT	CASIPPDRDGNPHF	TRBV27	TRBJ1-5
TGTGCCTGGAGTGCCGGGACAGTTGAGAAGAACACTGAAGCTTTCTTT	CAWSAGTVEKNTEAFF	TRBV30	TRBJ1-1
TGTGCCAGCAGCGGAGCGGTCCACATGACCTTCGGAGATGAGCAGTTCTTC	CASSGAVHMTFGDEQFF	TRBV9	TRBJ2-1
TGCGCCAGCAGCTTGGCCGGGGGGGGGCCCGGAGAAGGAGATACGCAGTATTTT	CASSLAGGGPGEGDTQYF	TRBV5-1	TRBJ2-3
TGTGCCAGCATCGCCTTTGACAGGGGGCCCGCGTGCACTGAAGCTTTCTTT	CASIAFDRGPACTEAFF	TRBV27	TRBJ1-1
TGTGCCAGCAGCCCCCGGGACTCGAATTCACCCCTCCACTTT	CASSPRDSNSPLHF	TRBV5-4	TRBJ1-6
TGCGCCACCCACCCGAACAGACAAGAGACCCAGTACTTC	CATHPNRQETQYF	TRBV5-1	TRBJ2-5
TGTGCCAGCAGCGAAATGGACAGCGTGGGAGCTAACTATGGCTACACCTTC	CASSEMDSVGANYGYTF	TRBV13	TRBJ1-2
TGCGCCAGCAGTGAGTCGTCGTACAGGGGCGAAAATCAGCCCCAGCATTTT	CASSESSYRGENQPQHF	TRBV10-2	TRBJ1-5
TGCAGCGTTCAGGGGCTCGACACTGAAGCTTTCTTT	CSVQGLDTEAFF	TRBV29-1	TRBJ1-1
TGTGCCAGCAGATGCCTGGTCGGACAAGAGACCCAGTACTTC	CASRCLVGQETQYF	TRBV12-4	TRBJ2-5
TGTGCCAGCAGCGACAGGGCCGATCAGCCCCAGCATTTT	CASSDRADQPQHF	TRBV9	TRBJ1-5
TGTGCCACCAGTGATTTGAAAGCTAGCGGGGATATATTATCGGGGACGTTAAGCTCCTACAATGAGCAGTTCTTC	CATSDLKASGDILSGTLSSYNEQFF	TRBV24-1	TRBJ2-1
TGCGCCAGCAGCCAAGTGACAGGGGTAACGGTTGAGCAGTTCTTC	CASSQVTGVTVEQFF	TRBV4-3	TRBJ2-1
TGCGCCAGCAGCTTAAGAAAGACATCTAACACTGAAGCTTTCTTT	CASSLRKTSNTEAFF	TRBV5-1	TRBJ1-1
TGTGCCAGCAGCGTCCACCCGGGGGCGGTGGGAGAGAACACTGAAGCTTTCTTT	CASSVHPGAVGENTEAFF	TRBV25-1	TRBJ1-1
TGTGCCAGCAGCTTAGGACAGGCTTCTGAAGCTTTCTTT	CASSLGQASEAFF	TRBV7-2	TRBJ1-1
TGTGCCACCAGTGCACTAGTGTTATACGAGCAGTACTTC	CATSALVLYEQYF	TRBV24-1	TRBJ2-7
TGCAGTGCTAGAGATGACAACCCGGCCGCATTCGGGACAGTCAACTACGAGCAGTACTTC	CSARDDNPAAFGTVNYEQYF	TRBV20-1	TRBJ2-7
TGTGCTAGTGGTTTGTACCGTTGGGGGGGCACAGATACGCAGTATTTT	CASGLYRWGGTDTQYF	TRBV12-5	TRBJ2-3
TGCGCCAGCAGCTTGGCCGAACCACAGGGCTACGAGCAGTACTTC	CASSLAEPQGYEQYF	TRBV5-1	TRBJ2-7
TGTGCCAGCAGCTTAGAACAAAAAACCAACAGGGGGCCGCCCACCACTGAAGCTTTCTTT	CASSLEQKTNRGPPTTEAFF	TRBV7-2	TRBJ1-1
TGCGCCAGCAGCTTGTTGAATGACGAGCAGTACTTC	CASSLLNDEQYF	TRBV5-1	TRBJ2-7
TGTGCCAGCAGACAGGGACAGGGGGCGGGAAACACCATATATTTT	CASRQGQGAGNTIYF	TRBV27	TRBJ1-3
TGCAGCGCTGGGACAGGGAGTTACAATGAGCAGTTCTTC	CSAGTGSYNEQFF	TRBV29-1	TRBJ2-1
TGCGCCAGCAGCCCACGGTTCGGGTCCTACTCACCAGGGGGACGGGTAGCCGACCACTCTGGAAACACCATATATTTT	CASSPRFGSYSPGGRVADHSGNTIYF	TRBV4-1	TRBJ1-3
TGTGCCAGTCTTTGGACCGGACGCTCCTACGAGCAGTACTTC	CASLWTGRSYEQYF	TRBV13	TRBJ2-7
TGTGCCAGCAGTTACTGGCGACAGGCCTACGAGCAGTACTTC	CASSYWRQAYEQYF	TRBV6-5	TRBJ2-7
TGTGCCAGCAGCCCTCAGGGGTTCGTGGAGCTGATTTCGTCCAATTCACCCCTCCACTTT	CASSPQGFVELISSNSPLHF	TRBV11-3	TRBJ1-6
TGCAGTGCTAGAAACCGATGGACTAGAGGCTACGAGCAGTACTTC	CSARNRWTRGYEQYF	TRBV20-1	TRBJ2-7
TGTGCCAGCAGTTACTCGTCTAGGGGAAAAGATCAGCCCCAGCATTTT	CASSYSSRGKDQPQHF	TRBV6-8	TRBJ1-5
TGTGCCAGCACCCCGGGACAGGGACCCAATGAAAAACTGTTTTTT	CASTPGQGPNEKLFF	TRBV6-6	TRBJ1-4
TGTGCCAGCCTCTGGGGGCGCAACTATGGCTACACCTTC	CASLWGRNYGYTF	TRBV2	TRBJ1-2
TGTGCCAGCAGGAGGTTCGGAAGAGGGAACACTGAAGCTTTCTTT	CASRRFGRGNTEAFF	TRBV27	TRBJ1-1
TGCGCCAGCAGCTCCGCCTATCACAGGGCGGAGAGCACCGGGGAGCTGTTTTTT	CASSSAYHRAESTGELFF	TRBV5-1	TRBJ2-2
TGTGCCAGCAGCGCCCGGGACAGGGAGGAAAGCAATCAGCCCCAGCATTTT	CASSARDREESNQPQHF	TRBV11-2	TRBJ1-5
TGCGCCAGCAGTAAGAAGGGGGTGGAAAAACTGTTTTTT	CASSKKGVEKLFF	TRBV10-1	TRBJ1-4
TGTGCCAGCAGCTTAAGGTACTCTGGAAACACCATATATTTT	CASSLRYSGNTIYF	TRBV7-3	TRBJ1-3
TGTGCCAGCAGCTTAGCGAAAAGGACAGGGCTTAGCTCCTATAATTCACCCCTCCACTTT	CASSLAKRTGLSSYNSPLHF	TRBV7-8	TRBJ1-6
TGTGCCACCAGCTGGGTCTCCTACGAGCAGTACTTC	CATSWVSYEQYF	TRBV15	TRBJ2-7
TGTGCCAGCATGGGACAGGGGAGGGAAGCTTTCTTT	CASMGQGREAFF	TRBV7-2	TRBJ1-1
TGTGCCAGCAGAGGCAGGGAGAACGAGCCCCAGCATTTT	CASRGRENEPQHF	TRBV27	TRBJ1-5
TGTGCCAGCAGTGGGGCTCTTCTCAAATGGGGGCCCCAGCCCCAGCATTTT	CASSGALLKWGPQPQHF	TRBV6-4	TRBJ1-5
TGTGCCACCAGTGATAAGGGTGTATTGCTAGCCAAAAACATTCAGTACTTC	CATSDKGVLLAKNIQYF	TRBV24-1	TRBJ2-4
TGCACACCCACAGGGGGCCAGCCCCAGCATTTT	CTPTGGQPQHF	TRBV20-1	TRBJ1-5
TGCAGTGCTAGGACTATAAGCCCCGAGAACACTGAAGCTTTCTTT	CSARTISPENTEAFF	TRBV20-1	TRBJ1-1
TGTGCCAGCAGTTTGACTAGCGGAGACCAGGGGAATGAGCAGTTCTTC	CASSLTSGDQGNEQFF	TRBV27	TRBJ2-1
TGTGCCAGCAGCTTCTCGCGGGGTCTAGGAAACAATGAGCAGTTCTTC	CASSFSRGLGNNEQFF	TRBV7-2	TRBJ2-1
TGTGCCAGCAGAGTTGTGAGAAACACCGGGGAGCTGTTTTTT	CASRVVRNTGELFF	TRBV12-4	TRBJ2-2
TGCGCCAGCAGCTGGGTCCTGGGAACTAGCGGGAGGGCTACATCCTACAATGAGCAGTTCTTC	CASSWVLGTSGRATSYNEQFF	TRBV5-1	TRBJ2-1
TGTGCCAGCAGTTACCGTCCGATTTCCCGGACAGGGTGTAACACTGAAGCTTTCTTT	CASSYRPISRTGCNTEAFF	TRBV6-2	TRBJ1-1
TGCGCCAGCAGCCCAACCGATTACGAGCAGTACTTC	CASSPTDYEQYF	TRBV5-1	TRBJ2-7
TGTGCCAGCAGCCATCGGAATGCCCCGGGACTATTCTCCTACGAGCAGTACTTC	CASSHRNAPGLFSYEQYF	TRBV3-1	TRBJ2-7
TGTGCCAGCAGCTTGGATCGGCCCAGGGGGAGTGGCGAGCAGTACTTC	CASSLDRPRGSGEQYF	TRBV5-4	TRBJ2-7
TGTGCCAGCAGCTTAGAAACCTACGGGGGGGTCCCCCGCACAGATACGCAGTATTTT	CASSLETYGGVPRTDTQYF	TRBV7-9	TRBJ2-3
TGTGCCAGCAGCCAAGATCCGGGAGAAACTGAAGCTTTCTTT	CASSQDPGETEAFF	TRBV3-1	TRBJ1-1
TGCGCCAGCTGGGTGATACAGGGCCGGGCTGAAGCTTTCTTT	CASWVIQGRAEAFF	TRBV10-1	TRBJ1-1
TGTGCCAGTAGTATGGGGGCGTTTTTGTATGGCTACACCTTC	CASSMGAFLYGYTF	TRBV19	TRBJ1-2
TGTGCCAGCATTCGAAAAATCGGGGCGACAGAGACCCAGTACTTC	CASIRKIGATETQYF	TRBV7-9	TRBJ2-5
TGCGCCAGCAAGGGGGGGAGCCAAGAGACCCAGTACTTC	CASKGGSQETQYF	TRBV10-2	TRBJ2-5
TGCAGTGCTAGAGCAACAGCCTACGAGCAGTACTTC	CSARATAYEQYF	TRBV20-1	TRBJ2-7
TGTGCCAGCTCACCAGACAGGGCCTGCGCCGGGGAGCTGTTTTTT	CASSPDRACAGELFF	TRBV18	TRBJ2-2
TGCAGTGCTAGTTTAGCGGGAGGGAGGGCGCGGGGTGAGCAGTTCTTC	CSASLAGGRARGEQFF	TRBV20-1	TRBJ2-1
TGTGCCAGCAGCCCCGGCTGCGAGCAGTACTTC	CASSPGCEQYF	TRBV5-8	TRBJ2-7
TGTGCCAGCAGTGGTCTACAGGGTTTTTGGGCAACTAATGAAAAACTGTTTTTT	CASSGLQGFWATNEKLFF	TRBV25-1	TRBJ1-4
TGTGCCACCAGCAGAGATCCCTACAGGGCCGGTGGCTACACCTTC	CATSRDPYRAGGYTF	TRBV15	TRBJ1-2
TGTGCCAGCGGTCCCCCCGTCGGCCACGGAGCGGAGGGGGGGGAGAACACTGAAGCTTTCTTT	CASGPPVGHGAEGGENTEAFF	TRBV6-5	TRBJ1-1
TGTGCCAGCACGCGGCGGTTTTCGGAAAAACTGTTTTTT	CASTRRFSEKLFF	TRBV7-3	TRBJ1-4
TGTGCCAGCAGCTTAGCGGAGACCGACAGGGCGATAGGTGGGGGGGCAACTAATGAAAAACTGTTTTTT	CASSLAETDRAIGGGATNEKLFF	TRBV7-9	TRBJ1-4
TGTGCCAGCAGCCCAACATTCCATAGCAATCAGCCCCAGCATTTT	CASSPTFHSNQPQHF	TRBV7-9	TRBJ1-5
TGCAGTGCTAGAGATCAAAACTGCCCGAGGCGGGAGGAGACCCAGTACTTC	CSARDQNCPRREETQYF	TRBV20-1	TRBJ2-5
TGTGCCAGCAGGTCAGGGGGGGAGACCTACGAGCAGTACTTC	CASRSGGETYEQYF	TRBV27	TRBJ2-7
TGCGCCAGCAGTGACCAACCGGGACTAGCGCGTCATGAGCAGTTCTTC	CASSDQPGLARHEQFF	TRBV10-1	TRBJ2-1
TGCGCCAGCAGCTTGGAAGGGGAAGGAAATGAGCAGTACTTC	CASSLEGEGNEQYF	TRBV5-1	TRBJ2-7
TGTGCCAGCAGCTGCGGGGCGGGTAGGGGCGGGGGCTACGAGCAGTACTTC	CASSCGAGRGGGYEQYF	TRBV7-2	TRBJ2-7
TGCGCCAGCAGCTTGTCCGGGACTAGCGGGGGGGCACCGCAGTACTTC	CASSLSGTSGGAPQYF	TRBV5-1	TRBJ2-7
TGTGCCAGCAGCTGCTCCCCCCCAGATGGGGAGAGGACCCATGAAGCTTTCTTT	CASSCSPPDGERTHEAFF	TRBV7-7	TRBJ1-1
TGTGCCAGCAGTGACATGGGGGCGAACACTGAAGCTTTCTTT	CASSDMGANTEAFF	TRBV6-4	TRBJ1-1
TGCAGTGCTAGACCCAGTGGCTCTGGGGCCAACGTCCTGACTTTC	CSARPSGSGANVLTF	TRBV20-1	TRBJ2-6
TGTGCCAGCTCACCAAATAGCGGGCCCACAGATACGCAGTATTTT	CASSPNSGPTDTQYF	TRBV18	TRBJ2-3
TGCAGGGGGGGCCGATACGAGCAGTACTTC	CRGGRYEQYF	TRBV20-1	TRBJ2-7
TGTGCCAGCAGCTTCCCAGGGCTCTCCTACGAGCAGTACTTC	CASSFPGLSYEQYF	TRBV7-4	TRBJ2-7
TGTGCCAGTAAAACGGGGGGAAGAGCTTTCTTT	CASKTGGRAFF	TRBV19	TRBJ1-1
TGTGCCAGCAGCGTAGGCCCTCAGGCGGACACTACTAATGAAAAACTGTTTTTT	CASSVGPQADTTNEKLFF	TRBV7-2	TRBJ1-4
TGTGCCAGCAGTTTTGGACCGAGTAACTATGGCTACACCTTC	CASSFGPSNYGYTF	TRBV11-3	TRBJ1-2
TGTGCCAGCAATGTGGACAGGGGGCTGCGATCTATTTACGAGCAGTACTTC	CASNVDRGLRSIYEQYF	TRBV12-3	TRBJ2-7
TGTGCCAGCAGCCAAGCCGGGAGGAACTATGGCTACACCTTC	CASSQAGRNYGYTF	TRBV3-1	TRBJ1-2
TGTGCCAGCAGTGACTCAAAAGCCAGCTTCTATGGCTACACCTTC	CASSDSKASFYGYTF	TRBV6-4	TRBJ1-2
TGTGCCAGCGAGGGACGGGTTCGCTCTGGAAACACCATATATTTT	CASEGRVRSGNTIYF	TRBV3-1	TRBJ1-3
TGCGCCAGCAGCCAAGCGTTCTTCAGCACTGAAGCTTTCTTT	CASSQAFFSTEAFF	TRBV4-1	TRBJ1-1
TGTGCCAGCAGAGTTCACCCAGGGGACCGAAACCGGAATGGCTACACCTTC	CASRVHPGDRNRNGYTF	TRBV7-7	TRBJ1-2
TGTGGGGACAGGGGGTGGGATGGCTACACCTTC	CGDRGWDGYTF	TRBV7-9	TRBJ1-2
TGTGCCAGCAGCCGCGGCGGTGTTGAGACCCAGTACTTC	CASSRGGVETQYF	TRBV13	TRBJ2-5
TGTGCCAGCAGAAGGCAGGGGGGGGATGGCTACACCTTC	CASRRQGGDGYTF	TRBV6-1	TRBJ1-2
TGTGCCAGTGTTAGTGAGAGCCCCGGCTACACCTTC	CASVSESPGYTF	TRBV19	TRBJ1-2
TGTGCCAGCAGCAACAGGGGACCCCTTTACTCCTACGAGCAGTACTTC	CASSNRGPLYSYEQYF	TRBV5-6	TRBJ2-7
TGTGCTAGTATACCCTGCAGGGGGGCTAGAGCCTACGAGCAGTACTTC	CASIPCRGARAYEQYF	TRBV12-5	TRBJ2-7
TGTGCCAATTCAGGGGGTCCTTCACCCCTCCACTTT	CANSGGPSPLHF	TRBV19	TRBJ1-6
TGCGCCAGCAGCCACGGAGGGCCCACTGAAGCTTTCTTT	CASSHGGPTEAFF	TRBV4-3	TRBJ1-1
TGTGCCAGCAGTTACCTGTCCGACGGGGCTTACCACGAGCAGTACTTC	CASSYLSDGAYHEQYF	TRBV6-5	TRBJ2-7
TGCAGTGCCCTCCTCTGGGACAGGGTGCCCTACGAGCAGTACTTC	CSALLWDRVPYEQYF	TRBV20-1	TRBJ2-7
TGCAGTGCCCCCGGGGAGGGGAGGAGGAAGGCCTATAATTCACCCCTCCACTTT	CSAPGEGRRKAYNSPLHF	TRBV20-1	TRBJ1-6
TGTGCCAGCAGCCACAGGGCGTACGAGCAGTACTTC	CASSHRAYEQYF	TRBV2	TRBJ2-7
TGCGCCAGCAGCAAGGGGCGAGATACCCAAGAGACCCAGTACTTC	CASSKGRDTQETQYF	TRBV5-1	TRBJ2-5
TGTGCCAGCAGAACTAGCGGGTGCTCAGGCTACAATGAGCAGTTCTTC	CASRTSGCSGYNEQFF	TRBV6-3	TRBJ2-1
TGTGCCAGCAGCGTAGAGTCCGGGACGAGGAACACTGAAGCTTTCTTT	CASSVESGTRNTEAFF	TRBV9	TRBJ1-1
TGTGCCAGCAACCCCGGTTTTAACACTGAAGCTTTCTTT	CASNPGFNTEAFF	TRBV27	TRBJ1-1
TGTGCCAGCAGTGAATCATCCAGGGGGGGGCAAGAGACCCAGTACTTC	CASSESSRGGQETQYF	TRBV25-1	TRBJ2-5
TGTGCCAGCAGTTGGAAGTCTAGCGGGACCGATGAGCAGTTCTTC	CASSWKSSGTDEQFF	TRBV27	TRBJ2-1
TGTGCCACCAGTGGACACAGGGGGCGGAACACTGAAGCTTTCTTT	CATSGHRGRNTEAFF	TRBV24-1	TRBJ1-1
TGCGCCAGCAGCAGCAACCGGACAAGGTCACCCCTCCACTTT	CASSSNRTRSPLHF	TRBV5-1	TRBJ1-6
TGTGCCAGCAGCCATCAGGGGGCCAATGAGCAGTTCTTC	CASSHQGANEQFF	TRBV2	TRBJ2-1
TGCGCCAGCAGCTGGGTCAAGGTGCAGCGGGAGAAACCAGAGACCCAGTACTTC	CASSWVKVQREKPETQYF	TRBV5-1	TRBJ2-5
TGCAGTGCTAGAGATCATACCCCCCGGGACAGGGAGCAGTACTTC	CSARDHTPRDREQYF	TRBV20-1	TRBJ2-7
TGTGCCAGCAGTTTGTCGAGTGGGAATCCTAATACGGACGGACCCTATGGCTACACCTTC	CASSLSSGNPNTDGPYGYTF	TRBV6-6	TRBJ1-2
TGTGCCAGCAGTGAATCACGAGGGCGGGGCCTCGAGCAGTACTTC	CASSESRGRGLEQYF	TRBV25-1	TRBJ2-7
TGTGCCAGCAGTCACGTGCGAACTGAAGCTTTCTTT	CASSHVRTEAFF	TRBV6-2	TRBJ1-1
TGTGCCAGTACTAGAAGGGGGGGTTACGAGCAGTACTTC	CASTRRGGYEQYF	TRBV19	TRBJ2-7
TGTGCCAGCAGCTTAGCCGGGACCAGGAACACTGAAGCTTTCTTT	CASSLAGTRNTEAFF	TRBV11-2	TRBJ1-1
TGCGCCAGCAGCTTGTCGAGGGGATATAATTCACCCCTCCACTTT	CASSLSRGYNSPLHF	TRBV5-1	TRBJ1-6
TGTGCCACCAGTGATCCCCGCGGCCGGGAGCAGTACTTC	CATSDPRGREQYF	TRBV24-1	TRBJ2-5
TGTGCCAGCAGTACTTCCTTAGTAAGGGGTAATTATGACACTGAAGCTTTCTTT	CASSTSLVRGNYDTEAFF	TRBV6-2	TRBJ1-1
TGTGCCATCAGTGAAGACCTTAAAACCCGCGGGAGGAATGAGCAGTTCTTC	CAISEDLKTRGRNEQFF	TRBV10-3	TRBJ2-1
TGTGCCAGCAGAATAGGTAGTGGCTATGGCTACACCTTC	CASRIGSGYGYTF	TRBV27	TRBJ1-2
TGCAGCGCTCGGACTAGAATAGTCGAGCAGTACTTC	CSARTRIVEQYF	TRBV29-1	TRBJ2-7
TGTGCCAGCAGTAGGAAGTGGACCGGGGAGCTGTTTTTT	CASSRKWTGELFF	TRBV2	TRBJ2-2
TGTGCCAGCAGCCCCGGGCCCGCGAACACTGAAGCTTTCTTT	CASSPGPANTEAFF	TRBV13	TRBJ1-1
TGTGCCAGCAGTTACAATAACGGGGGGACATCCCATTCACCCCTCCACTTT	CASSYNNGGTSHSPLHF	TRBV6-2	TRBJ1-6
TGTGCCTGGAGTGAGGGACAGAACGAGCAGTACTTC	CAWSEGQNEQYF	TRBV30	TRBJ2-7
TGTGCCAGCAGCCAAGAAACGACAGGTGCTTCACCCCTCCACTTT	CASSQETTGASPLHF	TRBV3-1	TRBJ1-6
TGTGCCAGCAGCCAAGGGGGGCGGGGAGATGGCTACACCTTC	CASSQGGRGDGYTF	TRBV4-2	TRBJ1-2
TGTGCCAGCAGCTTAAGACAGGGCTACGAGCAGTACTTC	CASSLRQGYEQYF	TRBV11-3	TRBJ2-7
TGTGCCAGCAGCACAGGGGGATGGAGGATTAGCAATCAGCCCCAGCATTTT	CASSTGGWRISNQPQHF	TRBV7-4	TRBJ1-5
TGTGCCAGCAGTACCCGATCAGGGACAACAGATACGCAGTATTTT	CASSTRSGTTDTQYF	TRBV6-3	TRBJ2-3
TGTGCCAGCAGCGGGGAGGGGGGGACAGAGCAGTACTTC	CASSGEGGTEQYF	TRBV9	TRBJ2-7
TGTGCCAGCAGCCTACTGGGACTGTTCCTCTACGAGCAGTACTTC	CASSLLGLFLYEQYF	TRBV5-6	TRBJ2-7
TGTGCCACCAGTGATTACCTAGCACGAGGCTACAATGAGCAGTTCTTC	CATSDYLARGYNEQFF	TRBV24-1	TRBJ2-1
TGTGCCAGCAGCCTGGACAGGACATCCAGCTCCTATAATTCACCCCTCCACTTT	CASSLDRTSSSYNSPLHF	TRBV28	TRBJ1-6
TGCGCCAGCAGCACGAGACAGGGCGGCTTGAACACTGAAGCTTTCTTT	CASSTRQGGLNTEAFF	TRBV5-1	TRBJ1-1
TGTGCCAGCAGTTACTCGGACCTAGCGGGCCAAGTTGGACGCACAGATACGCAGTATTTT	CASSYSDLAGQVGRTDTQYF	TRBV6-5	TRBJ2-3
TGTGCCAGCAGCTTGGATGGGGGGGCGACGGGCACAGATACGCAGTATTTT	CASSLDGGATGTDTQYF	TRBV5-5	TRBJ2-3
TGTGCCAGCAGCTTGCTTCCCAGGGTTAAACTTGGCTACACCTTC	CASSLLPRVKLGYTF	TRBV5-6	TRBJ1-2
TGTGCCAGCAGGCGAAAGGGGGGGGGGCACGAGCAGTACTTC	CASRRKGGGHEQYF	TRBV7-4	TRBJ2-7
TGTGCCACCAGTGATTTGGCCGTGGAGGACAGGGAATCCGGGGAGCTGTTTTTT	CATSDLAVEDRESGELFF	TRBV24-1	TRBJ2-2
TGTGCCAGCGGGACGTCTCCAGGGACAGGGCAGTGCTATGGCTACACCTTC	CASGTSPGTGQCYGYTF	TRBV6-6	TRBJ1-2
TGTGCCAGCAGCTTACCAAGGACAGGCCACGAGGAGATTGAAAAACTGTTTTTT	CASSLPRTGHEEIEKLFF	TRBV7-2	TRBJ1-4
TGTGCACACGGTACTGGGAACACTGAAGCTTTCTTT	CAHGTGNTEAFF	TRBV4-2	TRBJ1-1
TGCAGCGCTGAGACGAGGGAGACCCAGTACTTC	CSAETRETQYF	TRBV29-1	TRBJ2-5
TGCGCCAGCAGCTTAACACAGGGTGGGCACCAAGAGACCCAGTACTTC	CASSLTQGGHQETQYF	TRBV5-1	TRBJ2-5
TGCGCCAGCAGTGAGAAGGAGGGGGGGTGCAACACTGAAGCTTTCTTT	CASSEKEGGCNTEAFF	TRBV10-1	TRBJ1-1
TGTGCCACCAGCAGAGAGATGGGCCACGCAACTAATGAAAAACTGTTTTTT	CATSREMGHATNEKLFF	TRBV15	TRBJ1-4
TGCGCCAGCAGTGATGGTACAGTAAGGGAGACCCAGTACTTC	CASSDGTVRETQYF	TRBV10-1	TRBJ2-5
TGTGCCAGCAGACCCGATGGGCCGTACCAAGAGACCCAGTACTTC	CASRPDGPYQETQYF	TRBV12-4	TRBJ2-5
TGTGCCAGCAGTTTGTTTTTGACGTACAATGAGCAGTTCTTC	CASSLFLTYNEQFF	TRBV27	TRBJ2-1
TGTGCCAGCAGCTTAGAAAACGGCCTCAATGAGCAGTTCTTC	CASSLENGLNEQFF	TRBV7-2	TRBJ2-1
TGTGCCAGCAGCTTGGGAGGGGGGGAGACCCAGTACTTC	CASSLGGGETQYF	TRBV5-5	TRBJ2-5
TGTGCCAGCAGCTCTGGAACCGGGGAGCTGTTTTTT	CASSSGTGELFF	TRBV28	TRBJ2-2
TGTGCCAGCATCCCCTCTGGGCCGCGTGGCTACACCTTC	CASIPSGPRGYTF	TRBV7-2	TRBJ1-2
TGTGCCTGGAGGGAGGGGGGAGGGCAGGGAGAGACCCAGTACTTC	CAWREGGGQGETQYF	TRBV30	TRBJ2-5
TGTGCCATCAGAAGGGAGACAGGGTATGTTTATCAGCCCCAGCATTTT	CAIRRETGYVYQPQHF	TRBV10-3	TRBJ1-5
TGTGCCAGCTCACCTGTGCCTTGCCCAGGAGACGGCTACACCTTC	CASSPVPCPGDGYTF	TRBV18	TRBJ1-2
TGTGCCAGCAGCTTAACTATACCCCCACAGAGCGGGAGGACCTACGAGCAGTACTTC	CASSLTIPPQSGRTYEQYF	TRBV7-8	TRBJ2-7
TGTGCCAGCAGTCAACTTCGACGCGAGCAGTACTTC	CASSQLRREQYF	TRBV27	TRBJ2-7
TGTGCCAGCCCTCCGCGGGAGCAGCCCTACAATGAGCAGTTCTTC	CASPPREQPYNEQFF	TRBV27	TRBJ2-1
TGTGCCATACGGGTTTGTCGAGGGAACACTGAAGCTTTCTTT	CAIRVCRGNTEAFF	TRBV10-3	TRBJ1-1
TGTGCCAGCAGGAGACGCGGGGCCCCAGAGCAGTTCTTC	CASRRRGAPEQFF	TRBV6-4	TRBJ2-1
TGTGCCAGCAGTGACCTCACAGGGGAGACCCAGTACTTC	CASSDLTGETQYF	TRBV25-1	TRBJ2-5
TGTGCCAGCAGCGTAGCTCCGCCAGGGACCAGCTATAATTCACCCCTCCACTTT	CASSVAPPGTSYNSPLHF	TRBV9	TRBJ1-6
TGTGCCAGTAGTATCCCCAGGGGTTCGCAGTACTTC	CASSIPRGSQYF	TRBV19	TRBJ2-7
TGTGCCAGCTATCCCCCCAAGGGAAACCGAACGATTAACCCGGGACAAGGCTACGAGCAGTACTTC	CASYPPKGNRTINPGQGYEQYF	TRBV25-1	TRBJ2-7
TGTGCCACCAGCAGTTTGCCCGGCCATGAGCAGTTCTTC	CATSSLPGHEQFF	TRBV15	TRBJ2-1
TGTGCCAGCAGAAATATTTACACGAGGAGAACGTCCTACGAGCAGTACTTC	CASRNIYTRRTSYEQYF	TRBV14	TRBJ2-7
TGCGCCAGCAGCCTTACTAGCGGGAGGAAATCCCGCGAGCAGTACTTC	CASSLTSGRKSREQYF	TRBV4-3	TRBJ2-7
TGTGCCATCACGCCAACCATGACAGCCTGGGTGCATGGCTACACCTTC	CAITPTMTAWVHGYTF	TRBV10-3	TRBJ1-2
TGCGCCAGCAGCTTGGAATCAGGGGGCAATCAGCCCCAGCATTTT	CASSLESGGNQPQHF	TRBV5-1	TRBJ1-5
TGTGCCAGCAGCGTACTCTATAAGGACAATCAGCCCCAGCATTTT	CASSVLYKDNQPQHF	TRBV9	TRBJ1-5
TGTGCCAGCAGCCCCCGGGACAGGAACTATGGCTACACCTTC	CASSPRDRNYGYTF	TRBV6-2	TRBJ1-2
TGCAGTGCTAGAGAAAATCCTTCCTGGGGAAAAAATGAGCAGTTCTTC	CSARENPSWGKNEQFF	TRBV20-1	TRBJ2-1
TGTGTATGCGGACTAGCCTCCTACGAGCAGTACTTC	CVCGLASYEQYF	TRBV27	TRBJ2-7
TGTGCTAGTGGGAATCTAAAAGGGCCGTACCAATTAGAGACCCAGTACTTC	CASGNLKGPYQLETQYF	TRBV12-5	TRBJ2-5
TGTGCCAGCAGTCCCCTACCCAGCCAGGGATGGCGCACAGATACGCAGTATTTT	CASSPLPSQGWRTDTQYF	TRBV6-2	TRBJ2-3
TGTGCCACCAGTGATTTGCACCGACCGGGAGACGGGGAGCTGTTTTTT	CATSDLHRPGDGELFF	TRBV24-1	TRBJ2-2
TGTGCCATCAGTGAGCGAGGACTAGCGGGCCCCTACGAGCAGTACTTC	CAISERGLAGPYEQYF	TRBV10-3	TRBJ2-7
TGCGCCAGCAGATCGATCCACAGGGGGCCGATACTTAATTCACCCCTCCACTTT	CASRSIHRGPILNSPLHF	TRBV5-1	TRBJ1-6
TGTGCCAGCAGCCACAGGGGGTTTTACACTGAAGCTTTCTTT	CASSHRGFYTEAFF	TRBV11-2	TRBJ1-1
TGTGCCAGCAGCCCAACGTTTCCGGGACTACAGTACTTC	CASSPTFPGLQYF	TRBV13	TRBJ2-4
TGTGCCAGCAGTGGATCCGATTTAAGCGAGGCGAACACCGGGGAGCTGTTTTTT	CASSGSDLSEANTGELFF	TRBV6-4	TRBJ2-2
TGTGCTAGTGGTTGCTGCGGGGGGGGTGCTTTCTTT	CASGCCGGGAFF	TRBV12-5	TRBJ1-1
TGTGCCAGATTCTCTGGGGGGGGGCCCGGTAAAGAGACCCAGTACTTC	CARFSGGGPGKETQYF	TRBV12-3	TRBJ2-5
TGTGCCAGCAGCACCTTCGGAGCCCGTGAGGGGAGGGCCTCTGGAAACACCATATATTTT	CASSTFGAREGRASGNTIYF	TRBV13	TRBJ1-3
TGTGCCAGCAGTTTATGGGAACAGGGGTATCTCACAGATACGCAGTATTTT	CASSLWEQGYLTDTQYF	TRBV12-4	TRBJ2-3
TGTGCCAGCAGTGGGCAGGTTGGAAACACCATATATTTT	CASSGQVGNTIYF	TRBV28	TRBJ1-3
TGCGCCATCCCCGTACAGGGAGAAGAGACCCAGTACTTC	CAIPVQGEETQYF	TRBV10-1	TRBJ2-5
TGTGCCAGCAGCAACTCAGGGGCACACGAGCAGTACTTC	CASSNSGAHEQYF	TRBV13	TRBJ2-7
TGTGCCAGCAGCCAAGACCCAAGACAGGGGGCCTACGAGCAGTACTTC	CASSQDPRQGAYEQYF	TRBV14	TRBJ2-7
TGTGCCAGCAGCAATCGGGGTCGATATCAAACGAACACCGGGGAGCTGTTTTTT	CASSNRGRYQTNTGELFF	TRBV9	TRBJ2-2
TGTGCCAGCAGCTTGGCAAACCAGGGGGCTCCGAATAGCAATCAGCCCCAGCATTTT	CASSLANQGAPNSNQPQHF	TRBV5-6	TRBJ1-5
TGTGCCAGCAGTTACACCCGATTCAGTGTCCAGTATGAGCAGTTCTTC	CASSYTRFSVQYEQFF	TRBV6-9	TRBJ2-1
TGTGCCAGCTCACCTTCACGGGGTAGACTCTATGGCTACACCTTC	CASSPSRGRLYGYTF	TRBV18	TRBJ1-2
TGTGCCAGTCTTCAAGGACAGCGGAGCTACAATGAGCAGTTCTTC	CASLQGQRSYNEQFF	TRBV19	TRBJ2-1
TGTGCCAGCAGCCCGGGACAGGGTACCTACGAGCAGTACTTC	CASSPGQGTYEQYF	TRBV13	TRBJ2-7
TGCGCCAGAGGAGGGGCCGACTACGAGCAGTACTTC	CARGGADYEQYF	TRBV5-1	TRBJ2-7
TGCGCCAGCAGCTTGGCCGTCTCCCTAAGGTCGGGGAACTCAGAGACCCAGTACTTC	CASSLAVSLRSGNSETQYF	TRBV5-1	TRBJ2-5
TGTGCCAGCCTTCAGACGGGCTCTGGAAACACCATATATTTT	CASLQTGSGNTIYF	TRBV6-4	TRBJ1-3
TGCAGCGTTGCCGTTAGTCTAGCTGACGAGCAGTACTTC	CSVAVSLADEQYF	TRBV29-1	TRBJ2-7
TGCAGTGCTAGACAATACGAGCAGTACTTC	CSARQYEQYF	TRBV20-1	TRBJ2-7
TGTGCCTGGAACAGGGGGTATCAGCCCCAGCATTTT	CAWNRGYQPQHF	TRBV30	TRBJ1-5
TGTGCCAGCAGGGAAAAGAACTCGACAGGGAGTGTTTGTGGCTACACCTTC	CASREKNSTGSVCGYTF	TRBV27	TRBJ1-2
TGTGCTAGTGGTTTGGTAGACCGGCCTAGCGGGAGTGTACATGAGCAGTTCTTC	CASGLVDRPSGSVHEQFF	TRBV12-5	TRBJ2-1
TGTGCCAGCAGCGAGTCGGGGGCCATCTTC	CASSESGAIF	TRBV5-4	TRBJ2-1
TGTGCCAGCAGTTACTTCTGTGACAGGGAATATAGCAATCAGCCCCAGCATTTT	CASSYFCDREYSNQPQHF	TRBV6-5	TRBJ1-5
TGTGCCAGCAGTTTACGAGGGGAACCCCCCCAGCATTTT	CASSLRGEPPQHF	TRBV12-4	TRBJ1-5
TGTGCCAGCAGCAGACAGGGGAGCTCTGGGGCCAACGTCCTGACTTTC	CASSRQGSSGANVLTF	TRBV6-5	TRBJ2-6
TGTGCCAGCAGCTTAATCAGGGGGGGCAATGAGCAGTTCTTC	CASSLIRGGNEQFF	TRBV5-4	TRBJ2-1
TGTGCCAGCAGTTACGCTTCCTCAGGGGTAGAAGAGGGAGATACGCAGTATTTT	CASSYASSGVEEGDTQYF	TRBV6-6	TRBJ2-3
TGTGCCAGCAGCTTAGGATTCTCTGAAGCTTTCTTT	CASSLGFSEAFF	TRBV7-2	TRBJ1-1
TGTGCCAGCAGTCCCCCCAAAGGGGAGTTTGGGGAAGAGACCCAGTACTTC	CASSPPKGEFGEETQYF	TRBV6-4	TRBJ2-5
TGTGCCAGCAGTTTATGGCGGGTCCGGGTACGTCGATACAATGAGCAGTTCTTC	CASSLWRVRVRRYNEQFF	TRBV27	TRBJ2-1
TGTGCCAGCAGTGACTCAAAAAGGAGTTACAATGAGCAGTTCTTC	CASSDSKRSYNEQFF	TRBV2	TRBJ2-1
TGTGCCAGCAGGGGAAGCGGGATTCCGTACGAGCAGTACTTC	CASRGSGIPYEQYF	TRBV6-3	TRBJ2-7
TGCAGTGCTATGGACCCCCGTACAGATAACTATGGCTACACCTTC	CSAMDPRTDNYGYTF	TRBV20-1	TRBJ1-2
TGCGCCAGAACTCCAGAAACCTACGAGCAGTACTTC	CARTPETYEQYF	TRBV4-1	TRBJ2-7
TGTGCCAGCAGCCCGGGACTAGCGGGAGTGACCTACGAGCAGTACTTC	CASSPGLAGVTYEQYF	TRBV5-4	TRBJ2-7
TGTGCCAGCAGTGACGACGGGGACGAGCAGTACTTC	CASSDDGDEQYF	TRBV6-4	TRBJ2-7
TGTGCCAGCAGTGACTCAGAGGCTCGACAGAAGAATGAAAAACTGTTTTTT	CASSDSEARQKNEKLFF	TRBV6-4	TRBJ1-4
TGTGCCACCAGTGATACACAGGGCGGCGATGGCTACACCTTC	CATSDTQGGDGYTF	TRBV24-1	TRBJ1-2
TGCAGTGCTAGCAGGAGGCCCAGCAATCAGCCCCAGCATTTT	CSASRRPSNQPQHF	TRBV20-1	TRBJ1-5
TGTGCCAGCAGTCAACCGGGACTAGTCTGCTACGAGCAGTACTTC	CASSQPGLVCYEQYF	TRBV12-3	TRBJ2-7
TGCGCCAGCAGCCAAGATTCCTCCGCGCTAGCGGGCGGAGTCGACGAGCAGTACTTC	CASSQDSSALAGGVDEQYF	TRBV4-3	TRBJ2-7
TGTGCCAGTAACTGGGAAACATCACCCCTCCACTTT	CASNWETSPLHF	TRBV19	TRBJ1-6
TGTGCCAGCAGCTTAGCGGGACAGGGGGCGACCTACGAGCAGTACTTC	CASSLAGQGATYEQYF	TRBV11-3	TRBJ2-7
TGCGCCAGCAGCTTCAACCGGGCCAGCACCGGGGAGCTGTTTTTT	CASSFNRASTGELFF	TRBV5-1	TRBJ2-2
TGTGCCAGCGCTGACAGCACACCCGAGCAGTACTTC	CASADSTPEQYF	TRBV7-3	TRBJ2-7
TGTGCCAGCAGTTTAGGCGTCGTAGCATTCACAGATACGCAGTATTTT	CASSLGVVAFTDTQYF	TRBV27	TRBJ2-3
TGTGCCAGCAGCCAAGAAGAGGACCGGAAGTCCGGCCGGGAGATGAACACTGAAGCTTTCTTT	CASSQEEDRKSGREMNTEAFF	TRBV14	TRBJ1-1
TGTGCCCATTCTTCTAAGGCAGGAGCTTTCTTT	CAHSSKAGAFF	TRBV7-6	TRBJ1-1
TGTGCCAGCTCACTGTACACAAATGGCTACACCTTC	CASSLYTNGYTF	TRBV18	TRBJ1-2
TGTGCCAGCAGCGGCACTCACAGGGGTTTAAACACCATATATTTT	CASSGTHRGLNTIYF	TRBV2	TRBJ1-3
TGTGCCAGCAGTGTGGGAGGGACTAGCGGGAGAGCCACAGATACGCAGTATTTT	CASSVGGTSGRATDTQYF	TRBV28	TRBJ2-3
TGTGCCAGCAGCTTAGTTAAAAGTAAATCCTACAATGAGCAGTTCTTC	CASSLVKSKSYNEQFF	TRBV7-2	TRBJ2-1
TGTGCCACCAGCAGAGAGGACAGGGGGCGGGGCTGCAATCAGCCCCAGCATTTT	CATSREDRGRGCNQPQHF	TRBV15	TRBJ1-5
TGTGCCAGCAGCTCAGAGACCACTGAAGCTTTCTTT	CASSSETTEAFF	TRBV7-8	TRBJ1-1
TGCAGCGAGGGGACAGGCTGCGAGACCCAGTACTTC	CSEGTGCETQYF	TRBV29-1	TRBJ2-5
TGTGCCAGCAGTTTCCCCGACAGGGTGACACTGTTTTTT	CASSFPDRVTLFF	TRBV27	TRBJ1-4
TGCGCCAGCGAGACTAGGGACGAGCAGTACTTC	CASETRDEQYF	TRBV10-1	TRBJ2-7
TGCAGTGCAGGCTCGCAGGGGGCGCGCACCGGGGAGCTGTTTTTT	CSAGSQGARTGELFF	TRBV20-1	TRBJ2-2
TGTGCCAGCAGCAAGAGCCCCAGGGACGGGACAGGGTTTCGCGCTCAGCCCCAGCATTTT	CASSKSPRDGTGFRAQPQHF	TRBV7-6	TRBJ1-5
TGCGCCAATCCGGGACAGGGAGCTAAATCCTACGAGCAGTACTTC	CANPGQGAKSYEQYF	TRBV5-1	TRBJ2-7
TGTGCCAGCCCCCGAGAGAGGGGGGGCCCTTACAATGAGCAGTTCTTC	CASPRERGGPYNEQFF	TRBV7-3	TRBJ2-1
TGTGCCAGCAGTTGTACAAAACCGACAGGGGAAGGTGGAGCTAACTATGGCTACACCTTC	CASSCTKPTGEGGANYGYTF	TRBV28	TRBJ1-2
TGTCCCAACACGGCCCCCCAAGAGACCCAGTACTTC	CPNTAPQETQYF	TRBV20-1	TRBJ2-5
TGTGCCAGCCCGAGACAGCGAATGGGCGGCTACACCTTC	CASPRQRMGGYTF	TRBV7-3	TRBJ1-2
TGTGCCAGCAGTATCGAGGACTACAATGAGCAGTTCTTC	CASSIEDYNEQFF	TRBV14	TRBJ2-1
TGCGCCAGCAGCTTGCCTTCCACCCGGTCTAGGACCTACGAGCAGTACTTC	CASSLPSTRSRTYEQYF	TRBV5-1	TRBJ2-7
TGTGCCAGCAGTGACTCTTCCTGGGGGTCTTCCTACGAGCAGTACTTC	CASSDSSWGSSYEQYF	TRBV6-4	TRBJ2-7
TGTGCCAGCAGCCAAGATTATCAAAGTTGGCGGGTACAAGAGACCCAGTACTTC	CASSQDYQSWRVQETQYF	TRBV14	TRBJ2-5
TGTGCCAGCCGCAGGCCTCCACAAAATCAGCCCCAGCATTTT	CASRRPPQNQPQHF	TRBV6-6	TRBJ1-5
TGTGCCAGCAGCCGCCCCCCCCCGACTAGCGGGCTAGAGCAGTACTTC	CASSRPPPTSGLEQYF	TRBV7-4	TRBJ2-7
TGTGCCACCACACGGGACAGGGGGCCCCAGCATTTT	CATTRDRGPQHF	TRBV15	TRBJ1-5
TGCAGTGCGGATCGGGACGTCGAACCCTACGAGCAGTACTTC	CSADRDVEPYEQYF	TRBV20-1	TRBJ2-7
TGCAGGATTAGAGGCAGGATGAAAGCTTTCTTT	CRIRGRMKAFF	TRBV20-1	TRBJ1-1
TGTGCCGCAAGTAAGTTATCACCCCTCCACTTT	CAASKLSPLHF	TRBV3-1	TRBJ1-6
TGTGCCAGCAGGGTTCCCGGGTCCCGACCCGCTAACACCGGGGAGCTGTTTTTT	CASRVPGSRPANTGELFF	TRBV6-1	TRBJ2-2
TGTGCCACCAGTGATACGGGCCGACAATTCAACACCGGGGAGCTGTTTTTT	CATSDTGRQFNTGELFF	TRBV24-1	TRBJ2-2
TGTGCCATCAACAGCAAGGCATGGATCCCTTTCACCTACAATGAGCAGTTCTTC	CAINSKAWIPFTYNEQFF	TRBV10-3	TRBJ2-1
TGTGCCAGCAGCTTATCTTGGAGACAGGGCATTCAGCCCCAGCATTTT	CASSLSWRQGIQPQHF	TRBV7-8	TRBJ1-5
TGTGCCAGCAGCGTTGTTAGTAGCGGGAGCGAGACCCAGTACTTC	CASSVVSSGSETQYF	TRBV9	TRBJ2-5
TGTGCCAGCTACCGATGTAAGGAATGGTATAGCAATCAGCCCCAGCATTTT	CASYRCKEWYSNQPQHF	TRBV27	TRBJ1-5
TGTGCCAGCAGGTCAGAGCGGGAGGGGCAGCCCCAGCATTTT	CASRSEREGQPQHF	TRBV7-9	TRBJ1-5
TGCGCCGTTTCACAGGGGGCCACCGGGGAGCTGTTTTTT	CAVSQGATGELFF	TRBV10-1	TRBJ2-2
TGCGCCAGCCGCGGAGGGTCTAACTATGGCTACACCTTC	CASRGGSNYGYTF	TRBV10-1	TRBJ1-2
TGTGCCAGCAGAACCGGACAGCCCAGTTGGGAGTATGGCTACACCTTC	CASRTGQPSWEYGYTF	TRBV12-4	TRBJ1-2
TGTGCCAGCAGTGACCCAGGGGGCTACACCTTC	CASSDPGGYTF	TRBV2	TRBJ1-2
TGCGCCATCCAAAAGGGGAACTATGGCTACACCTTC	CAIQKGNYGYTF	TRBV10-1	TRBJ1-2
TGTGCCAGCAGCTTAGGGGCCGACGGGGTGTTTCAGCCCCAGCATTTT	CASSLGADGVFQPQHF	TRBV7-9	TRBJ1-5
TGTGCCAGCAGCCACGCAAGGGTAAACCAGAGGGATACGCAGTATTTT	CASSHARVNQRDTQYF	TRBV9	TRBJ2-3
TGTGCCAGCAGTGGGTTCGAACGCCCAACGGGGAAGGTGAGAATGGTCCAGACGTCACCCCTCCACTTT	CASSGFERPTGKVRMVQTSPLHF	TRBV28	TRBJ1-6
TGCGCCAGCAGCGGAGCCCCCAACACCGGGGAGCTGTTTTTT	CASSGAPNTGELFF	TRBV5-1	TRBJ2-2
TGCGCCAGCACGCGGTATCGTCAGCCCCAGCATTTT	CASTRYRQPQHF	TRBV10-1	TRBJ1-5
TGTGCCAGCACGAGCGGTACAGGAGTCAATCAGCCCCAGCATTTT	CASTSGTGVNQPQHF	TRBV28	TRBJ1-5
TGCGGTCGTTCGGTGGCAGGGAAGGTCCATCAGCCCCAGCATTTT	CGRSVAGKVHQPQHF	TRBV10-1	TRBJ1-5
TGTGCCTGGAGGGGTCGCGAAAAACTGTTTTTT	CAWRGREKLFF	TRBV30	TRBJ1-4
TGCGCCAGCAGTGAACCTAGGGGGGGAGAGTTTTATAATTCACCCCTCCACTTT	CASSEPRGGEFYNSPLHF	TRBV10-1	TRBJ1-6
TGTGCCAGCGGGCCAGATACGCAGTATTTT	CASGPDTQYF	TRBV14	TRBJ2-3
TGCAGTGCAGACAGGGATGGGAACTATGGCTACACCTTC	CSADRDGNYGYTF	TRBV20-1	TRBJ1-2
TGTGGTAGGGGGCTTTATACTGAAGCTTTCTTT	CGRGLYTEAFF	TRBV9	TRBJ1-1
TGTGCCAGCAGAAAGGGGGGGGCGGTGGGGGAAAACACTGAAGCTTTCTTT	CASRKGGAVGENTEAFF	TRBV28	TRBJ1-1
TGTGCCAGCAGCCCAAGTGGACAGGGCAGCTCCTATAATTCACCCCTCCACTTT	CASSPSGQGSSYNSPLHF	TRBV3-1	TRBJ1-6
TGTGCCAGCAGTGATCCGGGACAAAAGGTAGAGACCCAGTACTTC	CASSDPGQKVETQYF	TRBV6-4	TRBJ2-5
TGTGCCAGGAACGTCGACGAGCAGTACTTC	CARNVDEQYF	TRBV9	TRBJ2-7
TGCGCCAGCAGCTCCCAATACGAGGGAGGGGATAGCAATCAGCCCCAGCATTTT	CASSSQYEGGDSNQPQHF	TRBV5-1	TRBJ1-5
TGTGCCATCAGTGAGTCTGTCCGGAGATCGATCTCCTACGAGCAGTACTTC	CAISESVRRSISYEQYF	TRBV10-3	TRBJ2-7
TGTGCCAGCATTTCAGGGCTCAATCAGCCCCAGCATTTT	CASISGLNQPQHF	TRBV28	TRBJ1-5
TGCGCCAGCAGCCAAGATCCCGAAGACAAAAACATTCAGTACTTC	CASSQDPEDKNIQYF	TRBV4-1	TRBJ2-4
TGCAGTGCTAGAGGCGGGACTTGGACAGAAAGCTCTGGAAACACCATATATTTT	CSARGGTWTESSGNTIYF	TRBV20-1	TRBJ1-3
TGTGCCAGCGACACGGGGACTAGCGGGGCAAGCGGGGAGCAGTACTTC	CASDTGTSGASGEQYF	TRBV9	TRBJ2-7
TGTGCCAGCAGTGACTCGAAACCTGGCAACAATGAGCAGTTCTTC	CASSDSKPGNNEQFF	TRBV6-4	TRBJ2-1
TGTGCCAGCAGTGAATCGACGAAGGACCGAGGAGCTTTCTTT	CASSESTKDRGAFF	TRBV25-1	TRBJ1-1
TGTGCCTGGAATCCAAGGGCCATGGGGCGCCAGCCCCAGCATTTT	CAWNPRAMGRQPQHF	TRBV30	TRBJ1-5
TGCAGCGTTGCCGCTGGGACAAATAGCAATCAGCCCCAGCATTTT	CSVAAGTNSNQPQHF	TRBV29-1	TRBJ1-5
TGTGCCAGCAGAATCCGGGCTGGGGGAATATCACCCCTCCACTTT	CASRIRAGGISPLHF	TRBV2	TRBJ1-6
TGCGCCAGCAGCCTCCCGGGACGGTTCGGGGAGCTGTTTTTT	CASSLPGRFGELFF	TRBV4-1	TRBJ2-2
TGTGCCAGCAGCGGAGCACCTACACTAGCGGGTACGCAGTATTTT	CASSGAPTLAGTQYF	TRBV13	TRBJ2-3
TGCAGCGTCCCATTCTGGTATAGCAATCAGCCCCAGCATTTT	CSVPFWYSNQPQHF	TRBV29-1	TRBJ1-5
TGCAGTGCATGCGGGACCCGAGTAGCCTACGAGCAGTACTTC	CSACGTRVAYEQYF	TRBV20-1	TRBJ2-7
TGTGCCAGCAGCTTGCCCCAGACAGCTTCCCCTGAAGCTTTCTTT	CASSLPQTASPEAFF	TRBV5-4	TRBJ1-1
TGTGCCAGCAGTTTACTTACAGGGGGCGATTTGCCTCCCATGAACACTGAAGCTTTCTTT	CASSLLTGGDLPPMNTEAFF	TRBV12-3	TRBJ1-1
TGTGCCAGTAGCAGGAGGGGCAACGACTGGGGAACCAAGCAGTTCTTC	CASSRRGNDWGTKQFF	TRBV19	TRBJ2-1
TGTGCCAGCAGTGAATTCACGAATAGCACAGATACGCAGTATTTT	CASSEFTNSTDTQYF	TRBV6-1	TRBJ2-3
TGCGCCAGCAGCCAAGATCTGGCACGGTATGGCTACACCTTC	CASSQDLARYGYTF	TRBV4-1	TRBJ1-2
TGCAGTGCTACCAAAGTCAGCGGCTTGGCACCTACCGACACTGAAGCTTTCTTT	CSATKVSGLAPTDTEAFF	TRBV20-1	TRBJ1-1
TGCAGTGCTAGCAGTGGGGGGTACTTC	CSASSGGYF	TRBV20-1	TRBJ2-5
TGTGCCAGTAGTACGCGGACTAAGGATCTGTTTTTT	CASSTRTKDLFF	TRBV19	TRBJ1-4
TGCAGTCCTCTAAAAATCTTCAAGGGGGCGCGTTATTTCTACGAGCAGTACTTC	CSPLKIFKGARYFYEQYF	TRBV20-1	TRBJ2-7
TGCGCCAGCAGCCCCAGGGGGCGCGAGCAGTACTTC	CASSPRGREQYF	TRBV5-1	TRBJ2-7
TGTGCTAGCAGCGCTCAGGGGGCCCAAGGAATCAATCAGCCCCAGCATTTT	CASSAQGAQGINQPQHF	TRBV7-7	TRBJ1-5
TGTGCCAGCAGTTTGGGACGGATCGCGAACACCGGGGAGCTGTTTTTT	CASSLGRIANTGELFF	TRBV28	TRBJ2-2
TGCGCCAGCCAGGGAACGGCGGGAGGAGCCTGGTCCTACGAGCAGTACTTC	CASQGTAGGAWSYEQYF	TRBV5-1	TRBJ2-7
TGTGCCAGCAGCATTCCGGGGGCCTATGGCTACACCTTC	CASSIPGAYGYTF	TRBV11-3	TRBJ1-2
TGCGCCAGCAGCTTGCACAGGGGGGACAATGAGCAGTTCTTC	CASSLHRGDNEQFF	TRBV5-1	TRBJ2-1
TGCGCCAGCAGCTTGGCGTCTGCGTTGCACACTGAAGCTTTCTTT	CASSLASALHTEAFF	TRBV5-1	TRBJ1-1
TGTGCCAGTTTCTACGGTTTCCCGCATTCACCCCTCCACTTT	CASFYGFPHSPLHF	TRBV19	TRBJ1-6
TGCAGTGCTAGCTTCCTAACGCGGGAGCTTGGCCAAGAGACCCAGTACTTC	CSASFLTRELGQETQYF	TRBV20-1	TRBJ2-5
TGTGCCAGCGCCCGAGCTGGGGGCGTCACAGACGGGGAGCTGTTTTTT	CASARAGGVTDGELFF	TRBV3-1	TRBJ2-2
TGCGCCAGCAGCGCCCCGAACACCGGGGAGCTGTTTTTT	CASSAPNTGELFF	TRBV5-1	TRBJ2-2
TGCAGCGTTGCTTTGATAACAGGGGGGAGGCCCGTCTATGGCTACACCTTC	CSVALITGGRPVYGYTF	TRBV29-1	TRBJ1-2
TGTGCTAGTCCCCCGGACAGAGGGAGAGAAAAACTGTTTTTT	CASPPDRGREKLFF	TRBV12-5	TRBJ1-4
TGTGCCAGCAGTTACGGCCGGCAGTACAATGAGCAGTTCTTC	CASSYGRQYNEQFF	TRBV27	TRBJ2-1
TGTGCCAGCAGCGTAGAAATTTCAGGGGGTAGGGGTTCCTACGAGCAGTACTTC	CASSVEISGGRGSYEQYF	TRBV9	TRBJ2-7
TGTGCCAGCAGCCCGGGGGAAGGACCACGGAACACTGAAGCTTTCTTT	CASSPGEGPRNTEAFF	TRBV13	TRBJ1-1
TGTGCCAGCAGCGGGGGAGAGCAGTTCTTC	CASSGGEQFF	TRBV11-2	TRBJ2-1
TGTGCCAGCAGCTTGTACAGCGGGGGCCGGAGCTCCTACGAGCAGTACTTC	CASSLYSGGRSSYEQYF	TRBV5-6	TRBJ2-7
TGTGCCAGCAGCTTATTCCGACTAGGTGGCACAGATACGCAGTATTTT	CASSLFRLGGTDTQYF	TRBV7-3	TRBJ2-3
TGCGCCAGCACCCCGTGGCACACTGAAGCTTTCTTT	CASTPWHTEAFF	TRBV10-2	TRBJ1-1
