TGTGCCAGCAGCGGACAGCTTGAAAAACTGTTTTTT	CASSGQLEKLFF	TRBV9	TRBJ1-4
TGTGCCACCAGCAGAGTCGGGGGAGGCCAAGAGACCCAGTACTTC	CATSRVGGGQETQYF	TRBV15	TRBJ2-5
TGCGCCAGCAGCCACCCGACAGGGGGCCATATCCAAGAGACCCAGTACTTC	CASSHPTGGHIQETQYF	TRBV4-1	TRBJ2-5
TGTGCCAGCATTTCAAAGGACAGTGGCTACACCTTC	CASISKDSGYTF	TRBV27	TRBJ1-2
TGTGCCACCAGTGATTCTGAGGGGTACGAGCAGTACTTC	CATSDSEGYEQYF	TRBV24-1	TRBJ2-7
TGTGCCAGCAGCTTAGGCCTTCGCAGGGAAACCTACGAGCAGTACTTC	CASSLGLRRETYEQYF	TRBV7-4	TRBJ2-7
TGTGCCAGCAGTGAAAGCAGGGGCGTAAACGAGCAGTACTTC	CASSESRGVNEQYF	TRBV6-1	TRBJ2-7
TGCAGTGCTAGAGATGTAGGGACAGACTATGGCTACACCTTC	CSARDVGTDYGYTF	TRBV20-1	TRBJ1-2
TGTGCCAGCAGTGACAGGGAGAGTCAGCCCCAGCATTTT	CASSDRESQPQHF	TRBV6-1	TRBJ1-5
TGTGCCAGCAGCCTAGGGAGGAGAATTAGCAATCAGCCCCAGCATTTT	CASSLGRRISNQPQHF	TRBV6-3	TRBJ1-5
TGTGCCAATCGCCCTCCCCGGGGGACAGATACGCAGTATTTT	CANRPPRGTDTQYF	TRBV6-4	TRBJ2-3
TGTGCCACCACAGGGGTTGTGAACACTGAAGCTTTCTTT	CATTGVVNTEAFF	TRBV24-1	TRBJ1-1
TGTGCCAGCAGCTCAGCCTGGTGGTGGAACACAGATACGCAGTATTTT	CASSSAWWWNTDTQYF	TRBV11-3	TRBJ2-3
TGCGCCAGCAGCTCGAATCCTAGCGTCAAGGGTGAGACCCAGTACTTC	CASSSNPSVKGETQYF	TRBV5-1	TRBJ2-5
TGTGCCAGTACCGGGGGCTCCCTTGTCGAGCAGTACTTC	CASTGGSLVEQYF	TRBV19	TRBJ2-7
TGCAGCGTTGATTATCGGGGGGTCGGGGAGCTGTTTTTT	CSVDYRGVGELFF	TRBV29-1	TRBJ2-2
TGTGCCAAGGCTAGCGGGCCAGAGAGCTCCTACGAGCAGTACTTC	CAKASGPESSYEQYF	TRBV6-4	TRBJ2-7
TGTGCCAGCAGTTTATTCGGGACAGGGGCGTACTTC	CASSLFGTGAYF	TRBV12-4	TRBJ2-7
TGTGCTAGTGGTTGTAGACTGTCAGGGGTGAGGGGAGAAAAACTGTTTTTT	CASGCRLSGVRGEKLFF	TRBV12-5	TRBJ1-4
TGTGCCAGCAGTTCCGGGGGGTTGCACCAGAAGCTAGAGACCCAGTACTTC	CASSSGGLHQKLETQYF	TRBV28	TRBJ2-5
TGTCCACCCAATTTGCTTCAGGAAGAGACCCAGTACTTC	CPPNLLQEETQYF	TRBV27	TRBJ2-5
TGCAGTGAGACAGGGGCTCGGAACACTGAAGCTTTCTTT	CSETGARNTEAFF	TRBV20-1	TRBJ1-1
TGCAGTGCTAGAGATCTGACTAGTCAGGAAAACATTCAGTACTTC	CSARDLTSQENIQYF	TRBV20-1	TRBJ2-4
TGTGCCAGCAGTTCCTACCAGGGGACAATGAACACTGAAGCTTTCTTT	CASSSYQGTMNTEAFF	TRBV27	TRBJ1-1
TGTGCCAGCAGTTTACTAGCGGGATTCACCGGGGAGCTGTTTTTT	CASSLLAGFTGELFF	TRBV12-3	TRBJ2-2
TGTGCCAGCTCCACTAGCGGGAGGTGGAGCAACTACTCCTACGAGCAGTACTTC	CASSTSGRWSNYSYEQYF	TRBV27	TRBJ2-7
TGTGCCTGGAGTGATTCCTGGAGGGGGGGAGGCCAAGAGACCCAGTACTTC	CAWSDSWRGGGQETQYF	TRBV30	TRBJ2-5
TGTGCCAGCAGCCCAAGATCCACGAAAGGCTACACCTTC	CASSPRSTKGYTF	TRBV11-3	TRBJ1-2
TGTGCCAGCCCACTAGCGAAAAACTACGAGCAGTACTTC	CASPLAKNYEQYF	TRBV5-8	TRBJ2-7
TGCGCCAGCAAACTGAAACGACTAGCGGGGGGGCCCGGGTACAATGAGCAGTTCTTC	CASKLKRLAGGPGYNEQFF	TRBV10-1	TRBJ2-1
TGTGCCACCAGCCATCGGGACAGCTCTTGCGAGCAGTACTTC	CATSHRDSSCEQYF	TRBV15	TRBJ2-7
TGTGCCAGCAGTTTATCCCGAAAAATACCCTATGGCTACACCTTC	CASSLSRKIPYGYTF	TRBV28	TRBJ1-2
TGTGCCAACAGGGCCGGGACAGGGGGCAACTACACTGAAGCTTTCTTT	CANRAGTGGNYTEAFF	TRBV28	TRBJ1-1
TGCAGTGCACGGCGGACTAGTGTTAAAGGGGAGCAGTACTTC	CSARRTSVKGEQYF	TRBV20-1	TRBJ2-7
TGTGCCAGCAGCAGGGGGCCCCCCAATGAGCAGTTCTTC	CASSRGPPNEQFF	TRBV14	TRBJ2-1
TGCGCCAGCACTAAAGGGGACAGGCCCTATGGCTACACCTTC	CASTKGDRPYGYTF	TRBV10-1	TRBJ1-2
TGTGCCAGCAGCTGGGGACAGGGGCCGAACCTATGGTGGGCTAATGAAAAACTGTTTTTT	CASSWGQGPNLWWANEKLFF	TRBV7-9	TRBJ1-4
TGTGCCAGCACTTGGACAGGGGATCAGCCCCAGCATTTT	CASTWTGDQPQHF	TRBV14	TRBJ1-5
TGTGCCAGCAGTGTTAGAGTGGGGACATCCCCCGTTATCGAAGAGGGAGAAAGTAATAGCTCCTACAATGAGCAGTTCTTC	CASSVRVGTSPVIEEGESNSSYNEQFF	TRBV6-4	TRBJ2-1
TGTGCCAGCAGATGGAACGGGAATTCACCCCTCCACTTT	CASRWNGNSPLHF	TRBV6-2	TRBJ1-6
TGTGCCAGCAGGCTACCGCAAAGCGAGCAGTACTTC	CASRLPQSEQYF	TRBV7-4	TRBJ2-7
TGTGCCAGCAGGGCGTATAGCAATCAGCCCCAGCATTTT	CASRAYSNQPQHF	TRBV6-5	TRBJ1-5
TGTGCCAGCACAGGCAGGGTCCTACTCACAGATACGCAGTATTTT	CASTGRVLLTDTQYF	TRBV6-1	TRBJ2-3
TGTGCCAGCAGCATTCACAAAGGACTAGCGGGGGGTCGTATTAATGAGCAGTTCTTC	CASSIHKGLAGGRINEQFF	TRBV5-6	TRBJ2-1
TGTGCCAGCAGCTTCCCCTGGGAGGGTAGGAACACTGAAGCTTTCTTT	CASSFPWEGRNTEAFF	TRBV11-2	TRBJ1-1
TGTGCCAGCTCACCAGGGGGGGACCCCCTCAGCTACGAGCAGTACTTC	CASSPGGDPLSYEQYF	TRBV18	TRBJ2-7
TGTGCCAGCAAAAAACCGGGGGGGGCCGGCTATGGCTACACCTTC	CASKKPGGAGYGYTF	TRBV6-3	TRBJ1-2
TGTGCCAGCAGTGAAGCAAGTGGACAGAACTTCTACGAGCAGTACTTC	CASSEASGQNFYEQYF	TRBV6-1	TRBJ2-7
TGTGCCACAAGCGACAGTTTCTACGAGCAGTACTTC	CATSDSFYEQYF	TRBV27	TRBJ2-7
TGTGCCACCCAGCCGGTTCTAACTGAAGCTTTCTTT	CATQPVLTEAFF	TRBV24-1	TRBJ1-1
TGTGCCAGCAGCGGCGAATCCCTAAGGATAGAAGCTTTCTTT	CASSGESLRIEAFF	TRBV7-6	TRBJ1-1
TGTGCCAGCAGCGTAGATGGACAGGGCCCCACCGGGGAGCTGTTTTTT	CASSVDGQGPTGELFF	TRBV9	TRBJ2-2
TGTGCCACAGTGGCCTCGATCTACGAGCAGTACTTC	CATVASIYEQYF	TRBV24-1	TRBJ2-7
TGCGCCAGCAGGCCACCCCTGAATAGTAGTAATCAGCCCCAGCATTTT	CASRPPLNSSNQPQHF	TRBV10-1	TRBJ1-5
TGTGCCAGCAGCCCCCCCTCGGCTGAGCCCCAGCATTTT	CASSPPSAEPQHF	TRBV3-1	TRBJ1-5
TGCAGTGCTAGGATTGGTACGAACACTGAAGCTTTCTTT	CSARIGTNTEAFF	TRBV20-1	TRBJ1-1
TGTGCCAGCAGCGTAGACCAGGGGGCCAAAAACATTCAGTACTTC	CASSVDQGAKNIQYF	TRBV9	TRBJ2-4
TGTGCCGTACTAAGGTCTAGCACAGATACGCAGTATTTT	CAVLRSSTDTQYF	TRBV19	TRBJ2-3
TGCAGCGTTAGGGACTCCTACGAGCAGTACTTC	CSVRDSYEQYF	TRBV29-1	TRBJ2-7
TGTGCCAGCAGGCCCGGAAATCACTTAGCTAACTATGGCTACACCTTC	CASRPGNHLANYGYTF	TRBV6-2	TRBJ1-2
TGTGCCAGCAGTGTCTGCGGGTTGCCCAATGAGCAGTTCTTC	CASSVCGLPNEQFF	TRBV7-9	TRBJ2-1
TGTGCCAGCAGTTACTCGACCTTCCTCCGAGACACTGAAGCTTTCTTT	CASSYSTFLRDTEAFF	TRBV6-5	TRBJ1-1
TGCGCCAGCAGTGCCGAAAGAGGGTGGTCCTACGAGCAGTACTTC	CASSAERGWSYEQYF	TRBV10-1	TRBJ2-7
TGCGCCAGCAGCCAAGCCCTAGCGGGAGGGTTCTACAATGAGCAGTTCTTC	CASSQALAGGFYNEQFF	TRBV4-1	TRBJ2-1
TGTGCCAGTAGACCAGTTTATGGCTACACCTTC	CASRPVYGYTF	TRBV19	TRBJ1-2
TGTGCCAGCTCACTTCCCGGGACAACTGAAGCTTTCTTT	CASSLPGTTEAFF	TRBV18	TRBJ1-1
TGTGCCAGCCCCCCTAGCGGTGGGAATGAGCAGTTCTTC	CASPPSGGNEQFF	TRBV27	TRBJ2-1
TGTGCCAGCTCACGGGGACAATCGAATGGCTACACCTTC	CASSRGQSNGYTF	TRBV18	TRBJ1-2
TGCAGTGCTAGACCGGACCCACAGGGGGCCATGCCTGGGGCCAACGTCCTGACTTTC	CSARPDPQGAMPGANVLTF	TRBV20-1	TRBJ2-6
TGTGCCATCATACTAGCAGCAGATACGCAGTATTTT	CAIILAADTQYF	TRBV10-3	TRBJ2-3
TGTGCCAGCAGTAGGGGACAGGGGGAAATGAACACTGAAGCTTTCTTT	CASSRGQGEMNTEAFF	TRBV28	TRBJ1-1
TGCAGCGTTCGGTCCGCGACAGGGAACGACCTTAGCAATCAGCCCCAGCATTTT	CSVRSATGNDLSNQPQHF	TRBV29-1	TRBJ1-5
TGTGCCAGTAGTAGGCGGACAGGGCTCCTACGGTATAGCAATCAGCCCCAGCATTTT	CASSRRTGLLRYSNQPQHF	TRBV19	TRBJ1-5
TGTGCCAGCAGTTTATGCGTCCCGGGACAATACACTGAAGCTTTCTTT	CASSLCVPGQYTEAFF	TRBV28	TRBJ1-1
TGTGCCAGCAGCCAAGATAGCCTGGAGGGGAATCCCTTC	CASSQDSLEGNPF	TRBV3-1	TRBJ1-2
TGTGCCAGCAGCTTAGAGGGAAACGAGCAGTACTTC	CASSLEGNEQYF	TRBV7-3	TRBJ2-7
TGCGCCAGCAGCTTGGCGAGGGACAAAGAAGCTTTCTTT	CASSLARDKEAFF	TRBV5-1	TRBJ1-1
TGCAGTGCTAGAGTGCGGAGGGAAGAGACCCAGTACTTC	CSARVRREETQYF	TRBV20-1	TRBJ2-5
TGTGCCAGCAGTACTAGCGGGAGGAAGTTCCTGCAGTTCTTC	CASSTSGRKFLQFF	TRBV6-5	TRBJ2-1
TGTGCCAGCCGACAGGGGTGTTACGAGCAGTACTTC	CASRQGCYEQYF	TRBV7-9	TRBJ2-7
TGTGCCAGCCGTCCTAGAGAGCTTTTCTCCTACAATGAGCAGTTCTTC	CASRPRELFSYNEQFF	TRBV6-4	TRBJ2-1
TGTGCCAGCAGTGATACCTCCCGGGAGGAACGGGGGGGCAATGAGCAGTTCTTC	CASSDTSREERGGNEQFF	TRBV2	TRBJ2-1
TGTGCCACCAGTGATCGAGACCTCGGGGCTGGCTACACCTTC	CATSDRDLGAGYTF	TRBV24-1	TRBJ1-2
TGTGCCAGCAGTGAATCTAAAGGGGGCTCACAGAATGGCTACACCTTC	CASSESKGGSQNGYTF	TRBV6-1	TRBJ1-2
TGTGCCAGCAGTGAAGCCCTAGGGACAGGGGGCACTCGGTTTAACACTGAAGCTTTCTTT	CASSEALGTGGTRFNTEAFF	TRBV2	TRBJ1-1
TGTGCCAGCCCAGGGTTCACAGATACGCAGTATTTT	CASPGFTDTQYF	TRBV27	TRBJ2-3
TGTGCCACCCGCGGGACAGGGGCGAAGGGTCAGCCCCAGCATTTT	CATRGTGAKGQPQHF	TRBV6-3	TRBJ1-5
TGTGCCAGTGGGGAGAGCTATGGCTACACCTTC	CASGESYGYTF	TRBV6-5	TRBJ1-2
TGTGCCAGCAGCTTAGCCGGGGCTGGTGAAAAACTGTTTTTT	CASSLAGAGEKLFF	TRBV7-9	TRBJ1-4
TGCAGTGCTTCCACAGGGTTAATCAATCAGCCCCAGCATTTT	CSASTGLINQPQHF	TRBV20-1	TRBJ1-5
TGTGCCAGCAGCCAAGATATGGGACTAGCGGGCACGACCCAGTACTTC	CASSQDMGLAGTTQYF	TRBV14	TRBJ2-5
TGTGCTAGTGGTGGGGGGATGACAGGGGGGGGCAGGTACGAGCAGTACTTC	CASGGGMTGGGRYEQYF	TRBV12-5	TRBJ2-7
TGTGCCAGCAGTCCGGTTATCTACGAGCAGTACTTC	CASSPVIYEQYF	TRBV2	TRBJ2-7
TGCGCCAGCAGCTTGCCCCCGTCGGTCTTC	CASSLPPSVF	TRBV5-1	TRBJ2-1
TGTGCCAGCAGCTTAGGAACGAGCTCATCAGAGACCCAGTACTTC	CASSLGTSSSETQYF	TRBV11-3	TRBJ2-5
TGTGCCAGCACCCCAGGGCGGGGCGAGCAGTACTTC	CASTPGRGEQYF	TRBV27	TRBJ2-7
TGTGCCAGCAGCCAGACTAGCGGGATTAGCACAGATACGCAGTATTTT	CASSQTSGISTDTQYF	TRBV4-2	TRBJ2-3
TGTGCCAGCAGCCCGTATGGGTTCGGGGAGCTGTTTTTT	CASSPYGFGELFF	TRBV7-9	TRBJ2-2
TGTGCCAGCAGTGACATGAATGAATACAGGAGGGAAAAACTGTTTTTT	CASSDMNEYRREKLFF	TRBV6-4	TRBJ1-4
TGTGCCAGCAGCTATCTCGGGAGGGGCATCGGGCCGGAATTAAACTATGGCTACACCTTC	CASSYLGRGIGPELNYGYTF	TRBV7-6	TRBJ1-2
TGTGCCAGCAGGGGACAGAACCCGACTCAGCCCCAGCATTTT	CASRGQNPTQPQHF	TRBV4-2	TRBJ1-5
TGCGCCAGCAGTGAGGACCGGAGTACCAGCAATCAGCCCCAGCATTTT	CASSEDRSTSNQPQHF	TRBV10-1	TRBJ1-5
TGTGCCAGCAGTTCTAGGGGGGACTACGAGCAGTACTTC	CASSSRGDYEQYF	TRBV28	TRBJ2-7
TGTGCCAGCATCAGGACTAGGGACAATGAGCAGTTCTTC	CASIRTRDNEQFF	TRBV27	TRBJ2-1
TGTGCCATTACCGGGACCCCAAAAGATACGCAGTATTTT	CAITGTPKDTQYF	TRBV6-5	TRBJ2-3
TGTGCCAGCAGCTACCTACCTAGGGGCCGGTACGAGCAGTACTTC	CASSYLPRGRYEQYF	TRBV5-6	TRBJ2-7
TGTGCCGGACAGGGGGGAAACTATGGCTACACCTTC	CAGQGGNYGYTF	TRBV6-4	TRBJ1-2
TGTGCCAGCAGCTTACTGGGTACGGGTGGAAACACCATATATTTT	CASSLLGTGGNTIYF	TRBV7-3	TRBJ1-3
TGTGCCAGCAGTGATGTAGCGGGATTTCCCCATGAGCAGTTCTTC	CASSDVAGFPHEQFF	TRBV2	TRBJ2-1
TGTGCCAGCAGCTTATCCTACGAATTGGACTATGGCTACACCTTC	CASSLSYELDYGYTF	TRBV11-1	TRBJ1-2
TGTGCCAGCAGGCGGACAGGGCCGGCCGATACGCAGTATTTT	CASRRTGPADTQYF	TRBV27	TRBJ2-3
TGTGCCAGCAGCTTAGCTGACAGGGATAAGGCTGAAGCTTTCTTT	CASSLADRDKAEAFF	TRBV7-9	TRBJ1-1
TGTGCCAGCACTTCCAGGAAGGGCGGGCGTTATGGCTACACCTTC	CASTSRKGGRYGYTF	TRBV6-8	TRBJ1-2
TGTGCCTGGAGAGTCGGGTACGAGCAGTACTTC	CAWRVGYEQYF	TRBV30	TRBJ2-7
TGTGCCAGCATGGCAGGAAGCACAGATACGCAGTATTTT	CASMAGSTDTQYF	TRBV25-1	TRBJ2-3
TGTGCCAGCAGTCGATTGAGTAATGCGGGGGGCTACACCTTC	CASSRLSNAGGYTF	TRBV6-5	TRBJ1-2
TGTGCCAGCAGCCAAGGACTGGGGACGGGAGAGGCCACAATTGACGAGCAGTACTTC	CASSQGLGTGEATIDEQYF	TRBV3-1	TRBJ2-7
TGCGCCAGCAGTGTGGGCACGGCAGGCCCCCTGAACACTGAAGCTTTCTTT	CASSVGTAGPLNTEAFF	TRBV10-2	TRBJ1-1
TGTGCCAGCACCAAGTCCAGGGGGATTAAGTACTATGGCTACACCTTC	CASTKSRGIKYYGYTF	TRBV14	TRBJ1-2
TGCGCCAGCAGCAAGCGGGGTAATCAGCCCCAGCATTTT	CASSKRGNQPQHF	TRBV10-1	TRBJ1-5
TGTGCCAGCAGTGGGGAAGGGGCTGGAAACACCATATATTTT	CASSGEGAGNTIYF	TRBV6-8	TRBJ1-3
TGTGCCAGTTATAGGTCCGGATCGTTTCGGGTGATGGGGAATGAAAAACTGTTTTTT	CASYRSGSFRVMGNEKLFF	TRBV19	TRBJ1-4
TGTGCCAGCAGCCAAGATAAAGCCGGGACAGGGAGACTCTACGAGCAGTACTTC	CASSQDKAGTGRLYEQYF	TRBV3-1	TRBJ2-7
TGTGCCACAGACGGGGACCTAGTTACCGGGGAGCTGTTTTTT	CATDGDLVTGELFF	TRBV19	TRBJ2-2
TGTGCCAGCGGCCCGGCCAGCAATCAGCCCCAGCATTTT	CASGPASNQPQHF	TRBV7-8	TRBJ1-5
TGCAGCGCCAGGGGGGACTCCCAGTACTTC	CSARGDSQYF	TRBV29-1	TRBJ2-5
TGTGCCAGCAGTGAATTCGGTAGGGGGCAAGCCAAGGGAGCTAACTATGGCTACACCTTC	CASSEFGRGQAKGANYGYTF	TRBV25-1	TRBJ1-2
TGTGCCAGCAGTTCCCACCGGTTTGGACAGGGGGCAAATACCGGGGAGCTGTTTTTT	CASSSHRFGQGANTGELFF	TRBV6-5	TRBJ2-2
TGTGCCAGCAGGGTATGGGGGCCCTCAGGCGGAGAGACCCAGTACTTC	CASRVWGPSGGETQYF	TRBV11-2	TRBJ2-5
TGTGCCAGCAGTTTAAGGGGGACGCACAAGCCCCAGCATTTT	CASSLRGTHKPQHF	TRBV12-4	TRBJ1-5
TGTGTATTCGGCCGGGACAGGGGGGGTACCTACGAGCAGTACTTC	CVFGRDRGGTYEQYF	TRBV7-9	TRBJ2-7
TGTGCCAGCAGCCAAGGAGGGGGCCCCGCTAGCAATCAGCCCCAGCATTTT	CASSQGGGPASNQPQHF	TRBV4-2	TRBJ1-5
TGTGCCAGCACGGAGAGGGACAATCAGCCCCAGCATTTT	CASTERDNQPQHF	TRBV28	TRBJ1-5
TGTGCCAGCAGTTTCGGGACTAGCTTAACTCCCACAGATACGCAGTATTTT	CASSFGTSLTPTDTQYF	TRBV12-3	TRBJ2-3
TGTGCCAGCAGTTTACCTGGACTAGCGGGGGGGCGTCGAAAGTACTTC	CASSLPGLAGGRRKYF	TRBV28	TRBJ2-4
TGTGCCAACCCCAGGGGCATGAACACTGAAGCTTTCTTT	CANPRGMNTEAFF	TRBV10-3	TRBJ1-1
TGCGCCAGCAGGGCCCGACACGAGCAGTACTTC	CASRARHEQYF	TRBV5-1	TRBJ2-7
TGTGCCAGCAGCTTACGTGTACCGGGCACCGGGGAGCTGTTTTTT	CASSLRVPGTGELFF	TRBV7-2	TRBJ2-2
TGCGCCAGCAGCCAAGACCCGACAGGGGTGGGGTCTGGAAACACCATATATTTT	CASSQDPTGVGSGNTIYF	TRBV4-1	TRBJ1-3
TGTGCCTGGACGAAGTTGGGGGGGCCCCGCGGGAGCTCCTACAATGAGCAGTTCTTC	CAWTKLGGPRGSSYNEQFF	TRBV30	TRBJ2-1
TGTGCCAGAGTTCTGGGAGGGGGATCCTCTGGAAACACCATATATTTT	CARVLGGGSSGNTIYF	TRBV6-6	TRBJ1-3
TGTGCCAGCAGCTCCTGGAGTTTCCGATACGAGCAGTACTTC	CASSSWSFRYEQYF	TRBV11-1	TRBJ2-7
TGTGCCAGCAGCCAAGATCCAAAGAGAACCGGGACTAGCGGCTACGCCACAGATACGCAGTATTTT	CASSQDPKRTGTSGYATDTQYF	TRBV14	TRBJ2-3
TGCGCCAGCAGCCAAGCGGGGGGGGATGGAACGGAAGGGTGCTCCTATAATTCACCCCTCCACTTT	CASSQAGGDGTEGCSYNSPLHF	TRBV4-1	TRBJ1-6
TGCGCCAGCTTGCCCCTAGCGGGAGCAATAAATGAGCAGTTCTTC	CASLPLAGAINEQFF	TRBV5-1	TRBJ2-1
TGTGCCAGCATTTCGCAACAGCGGTTGACCCAGTACTTC	CASISQQRLTQYF	TRBV12-3	TRBJ2-5
TGTGCCAGCAGTGTCGACAGGGATGAGCAGTACTTC	CASSVDRDEQYF	TRBV25-1	TRBJ2-7
TGTGCCAGCAGCCGGACAGCGGATGGCTACACCTTC	CASSRTADGYTF	TRBV3-1	TRBJ1-2
TGTGCCAGGACAGATGGCTACACCTTC	CARTDGYTF	TRBV27	TRBJ1-2
TGTGCCAGCACCCGGCAGGACAGCCGCGAGCAGTACTTC	CASTRQDSREQYF	TRBV2	TRBJ2-7
TGTGCCAGCAGTTTAGAGGAACCCCCGTGGAACGGGACGGGTAACTATGGCTACACCTTC	CASSLEEPPWNGTGNYGYTF	TRBV12-3	TRBJ1-2
TGTGCCAGCAGCGGAAGGGTAGGATTATCCTACGAGCAGTACTTC	CASSGRVGLSYEQYF	TRBV13	TRBJ2-7
TGTGCCAGCACGTCGGACCGGGGCCGGTGCTACGAGCAGTACTTC	CASTSDRGRCYEQYF	TRBV28	TRBJ2-7
TGTGCCAGCAGCCTCCAGGGGGAAAAACTGTTTTTT	CASSLQGEKLFF	TRBV2	TRBJ1-4
TGTGCCAGCGAAGGCCCTCCCTTTGGACAGGAGAATGGCACCTGCTCCTACGAGCAGTACTTC	CASEGPPFGQENGTCSYEQYF	TRBV6-3	TRBJ2-7
TGTGCCAGCAATTGGGGCCGCAATCAGCCCCAGCATTTT	CASNWGRNQPQHF	TRBV5-4	TRBJ1-5
TGTGCCAGCAGCTCGACCCGGGACGGGTTCGAGCAGTACTTC	CASSSTRDGFEQYF	TRBV7-2	TRBJ2-7
TGTGCCAGCAGTTACCTCCGAGGGGGGCGCCAGAACACTGAAGCTTTCTTT	CASSYLRGGRQNTEAFF	TRBV6-6	TRBJ1-1
TGCAGCGTTGATAGGAACAGCTCCTACAATGAGCAGTTCTTC	CSVDRNSSYNEQFF	TRBV29-1	TRBJ2-1
TGCAGTGCTAGAGAAGTCGTAACCCTCCTGGATACGCAGTATTTT	CSAREVVTLLDTQYF	TRBV20-1	TRBJ2-3
TGCAGTGCTAGCCCCAGGGGGAAGAAGAAGTACTTC	CSASPRGKKKYF	TRBV20-1	TRBJ2-5
TGTGCCAGCAGCTTATACAGGGGAGTTTCACCCCTCCACTTT	CASSLYRGVSPLHF	TRBV7-2	TRBJ1-6
TGTGCCAGCAGCCTAGGACAGGGCGGCTCTTCTTTTCACATGAACACTGAAGCTTTCTTT	CASSLGQGGSSFHMNTEAFF	TRBV13	TRBJ1-1
TGTGCCAGCAGCCAAGCCGGGGACTGGGGCTACGAGCAGTACTTC	CASSQAGDWGYEQYF	TRBV14	TRBJ2-7
TGTGCCAGCAGCCAACCCTATCGGGACAATGAGCAGTTCTTC	CASSQPYRDNEQFF	TRBV3-1	TRBJ2-1
TGTGCCAGCAGTTCGGAGGGAGCCCCACCCCTCCACTTT	CASSSEGAPPLHF	TRBV28	TRBJ1-6
TGTGCCAGCAGTTTAAAGGGCTGGGGGGGCTATGGCTACACCTTC	CASSLKGWGGYGYTF	TRBV28	TRBJ1-2
TGCAGTGCCAACAGGGGGGACACTGAAGCTTTCTTT	CSANRGDTEAFF	TRBV20-1	TRBJ1-1
TGTGCCAGCGGGCCCGGGACTAGGGGAAATGAGCAGTTCTTC	CASGPGTRGNEQFF	TRBV9	TRBJ2-1
TGCAGTGCTAGTTCCCGACTAGCGGCTTCGGGGGCGAACATTCAGTACTTC	CSASSRLAASGANIQYF	TRBV20-1	TRBJ2-4
TGCAGCGTTGAACTCTACGGCGCGGGGGGCAGGAAAAATGGCTACACCTTC	CSVELYGAGGRKNGYTF	TRBV29-1	TRBJ1-2
TGTGCCAGCAGCCCACTTGAAGGGGCGTTTCGTGAAAAACTGTTTTTT	CASSPLEGAFREKLFF	TRBV14	TRBJ1-4
TGCGCCAGCAGCCAAGAAGCAGCCAACACTGAAGCTTTCTTT	CASSQEAANTEAFF	TRBV4-3	TRBJ1-1
TGCGCCAGCTTACGGGGGGCCGGGGAGCTGTTTTTT	CASLRGAGELFF	TRBV5-1	TRBJ2-2
TGTGCCTGGAGTGTACCGGGGTGGGGGCAGCCCCAGCATTTT	CAWSVPGWGQPQHF	TRBV30	TRBJ1-5
TGTGCCAGCAGCCGCTGGGCGGGGGAAGTTCATGGCTACACCTTC	CASSRWAGEVHGYTF	TRBV7-4	TRBJ1-2
TGTGCCAGCAGCCTTCTCGGTCCCGAGTACAATGAGCAGTTCTTC	CASSLLGPEYNEQFF	TRBV3-1	TRBJ2-1
TGTGCCATCAGGACACAGGGGTCCCTAACTAGCACAGATACGCAGTATTTT	CAIRTQGSLTSTDTQYF	TRBV10-3	TRBJ2-3
TGTGCCAGCAGTTACTCGAGCACAGGGAGGAATCAGCCCCAGCATTTT	CASSYSSTGRNQPQHF	TRBV6-2	TRBJ1-5
TGTGCCAGCAGCGTAGGCCCAAGGCTGTCTGAGCAGTTCTTC	CASSVGPRLSEQFF	TRBV9	TRBJ2-1
TGTGCCAGCAGCCAGCGGGAGGACCCCGACAATGAAAAACTGTTTTTT	CASSQREDPDNEKLFF	TRBV9	TRBJ1-4
TGTGCCAGCAGGGGCTGGCACAGGGGGCGGTCGGGGACATATGGCTACACCTTC	CASRGWHRGRSGTYGYTF	TRBV28	TRBJ1-2
TGTGCCAGCAGCACCCCGACTATAGGCTACACCTTC	CASSTPTIGYTF	TRBV11-2	TRBJ1-2
TGTGCCAGCAGCGGGACTAGTGCGAGGATGAATGAGCAGTTCTTC	CASSGTSARMNEQFF	TRBV12-3	TRBJ2-1
TGTGCCAGCAGCTTACCGGTAGCCCGACAGGGGGCAGGCTACGAGCAGTACTTC	CASSLPVARQGAGYEQYF	TRBV11-3	TRBJ2-7
TGTGCCTGGAGTGTCCCCACAGGGGGCACGAACTATGGCTACACCTTC	CAWSVPTGGTNYGYTF	TRBV30	TRBJ1-2
TGCAGTGCTAGCCAGCAGGGGGAAATAGAAAAACTGTTTTTT	CSASQQGEIEKLFF	TRBV20-1	TRBJ1-4
TGTGCCAGCAAGGTGAAGGGGACGGCCTACGAGCAGTACTTC	CASKVKGTAYEQYF	TRBV6-6	TRBJ2-7
TGTGCCACCCTTTTAAAGAAGGGAAGGCAAGAGACCCAGTACTTC	CATLLKKGRQETQYF	TRBV15	TRBJ2-5
TGTGCCAGCTTTACCTACATAGGCTCCTACGAGCAGTACTTC	CASFTYIGSYEQYF	TRBV28	TRBJ2-7
TGTGCCAGCAGCTGTCGGGAACTCAGCTCCTACAATGAGCAGTTCTTC	CASSCRELSSYNEQFF	TRBV7-9	TRBJ2-1
TGTGCCAGCAGTCCGGGACAGGGTAAGTCTGGAAACACCATATATTTT	CASSPGQGKSGNTIYF	TRBV27	TRBJ1-3
TGCGCCAGCAGCTTACCCAGACATTTCCTCGTCGCAGATACGCAGTATTTT	CASSLPRHFLVADTQYF	TRBV5-1	TRBJ2-3
TGTGCCAGCAGCTTTACCGGGACTAGCGGGGTCAATGAGCAGTTCTTC	CASSFTGTSGVNEQFF	TRBV7-9	TRBJ2-1
TGCGCCAGCAGAGGGATAAACACTGAAGCTTTCTTT	CASRGINTEAFF	TRBV5-1	TRBJ1-1
TGTGCCAGCACTACCAGGGTGAGTCAGCCCCAGCATTTT	CASTTRVSQPQHF	TRBV7-9	TRBJ1-5
TGTGCCAGCTCCAGGACATGTCGCAATCAGCCCCAGCATTTT	CASSRTCRNQPQHF	TRBV6-4	TRBJ1-5
TGTGCCACCAGTGATTTCATTTATGGCTACACCTTC	CATSDFIYGYTF	TRBV24-1	TRBJ1-2
TGTGCCAGCAGCCCGACTTGGATAGGAAGGGGGACCGCCTACAATGAGCAGTTCTTC	CASSPTWIGRGTAYNEQFF	TRBV13	TRBJ2-1
TGTGCCAGCAGTGAGAACCGACTAGCGGGGTTCGAGCAGTTCTTC	CASSENRLAGFEQFF	TRBV6-4	TRBJ2-1
TGTGCCAGCAGCTTACCGGCAGGGTCCTCCTACGAGCAGTACTTC	CASSLPAGSSYEQYF	TRBV7-9	TRBJ2-7
TGTGCCAGCAGTCTAGCGGGCTTCCAGACCCAGTACTTC	CASSLAGFQTQYF	TRBV6-5	TRBJ2-5
TGCGCCAGCAGCCGGGGAAAAAGTAGCTCCTACGAGCAGTACTTC	CASSRGKSSSYEQYF	TRBV5-1	TRBJ2-7
TGTGCCACCAGGAACCTAGGGGGAGGAGAAAAACTGTTTTTT	CATRNLGGGEKLFF	TRBV24-1	TRBJ1-4
TGTGCCAGCAGTTACTCAGCCAGCTACGAGCAGTACTTC	CASSYSASYEQYF	TRBV6-5	TRBJ2-7
TGTGCCGCCCCGGTGGGACAGGAAGAAGCTTTCTTT	CAAPVGQEEAFF	TRBV6-1	TRBJ1-1
TGTGCCAGCAGCTGGAGGGGTGGGGACAGATTTTCGAACACTGAAGCTTTCTTT	CASSWRGGDRFSNTEAFF	TRBV13	TRBJ1-1
TGTGCCAGCAGTTACGACAGGGAGGGCACGCAGTATTTT	CASSYDREGTQYF	TRBV6-5	TRBJ2-3
TGTGCCAGCAGTGGACACGGGAAGCAGTACTTC	CASSGHGKQYF	TRBV6-1	TRBJ2-7
TGCAGTGCTCCCGTAAGGTCCTTTGGCATTCAGTACTTC	CSAPVRSFGIQYF	TRBV20-1	TRBJ2-4
TGCAGTGCTGCGGACAGGGCCTCCAATTCACCCCTCCACTTT	CSAADRASNSPLHF	TRBV20-1	TRBJ1-6
TGTGCCAGCAGCGCCCGGGACAGCAGGGTGCCCTACGAGCAGTACTTC	CASSARDSRVPYEQYF	TRBV7-9	TRBJ2-7
TGTGCCAGCTCACTAGGACAGGAGATTGACTACGAGCAGTACTTC	CASSLGQEIDYEQYF	TRBV18	TRBJ2-7
TGCGCCAGCAGCTTGTCCCCTACCCCGTACGGTGAAGCTTTCTTT	CASSLSPTPYGEAFF	TRBV5-1	TRBJ1-1
TGTGCTAGTGGTTCCGGGGTATGCTCCTACGAGCAGTACTTC	CASGSGVCSYEQYF	TRBV12-5	TRBJ2-7
TGTGCCAGCAGTCAGGGCACAGGAAGGCGGGTCACAGATACGCAGTATTTT	CASSQGTGRRVTDTQYF	TRBV6-1	TRBJ2-3
TGTGCCAGCAGTTACGGGCTCCAGGCCCACTCCTACAATGAGCAGTTCTTC	CASSYGLQAHSYNEQFF	TRBV6-5	TRBJ2-1
TGTGCCAGGGGGGGCTTTTATAGCTCTGGAAACACCATATATTTT	CARGGFYSSGNTIYF	TRBV14	TRBJ1-3
TGTGCCAGCTCACTCCCTAGGAGGACTAGCGGGGTTACCGGGGAGCTGTTTTTT	CASSLPRRTSGVTGELFF	TRBV18	TRBJ2-2
TGTGCCACCAGGACCGACAGTTGTATCTATGGCTACACCTTC	CATRTDSCIYGYTF	TRBV24-1	TRBJ1-2
TGTGCCAGCAGCTCTTTCGCGGGCTACACCTTC	CASSSFAGYTF	TRBV5-6	TRBJ1-2
TGCGCCAGCAAAATAGAGGGAGCAACTAATGAAAAACTGTTTTTT	CASKIEGATNEKLFF	TRBV10-1	TRBJ1-4
TGTGCCAGCAGTTTTCCCGGGGATCAGCCCCAGCATTTT	CASSFPGDQPQHF	TRBV27	TRBJ1-5
TGTGCCAGCTCACCAATAGACGATTACGAGCAGTACTTC	CASSPIDDYEQYF	TRBV18	TRBJ2-7
TGCGCCAGCAGCTTGGCCAACAGGGACTCCACTGAAGCTTTCTTT	CASSLANRDSTEAFF	TRBV5-1	TRBJ1-1
TGTGCCAGCAGTTATTCTACCTGGGTCGAAAACATTCAGTACTTC	CASSYSTWVENIQYF	TRBV6-5	TRBJ2-4
TGCGCCAGCAGTGAGGGGACGGAAACTTCACCCCTCCACTTT	CASSEGTETSPLHF	TRBV10-1	TRBJ1-6
TGTGCCATTCGAGCGGGAGGGGAGGGCTACGAGCAGTACTTC	CAIRAGGEGYEQYF	TRBV19	TRBJ2-7
TGCGCCAGCAGCCAAGGAGAGAAGGCTGGAAACACCATATATTTT	CASSQGEKAGNTIYF	TRBV4-1	TRBJ1-3
TGTGCCAGCAGCAAGCCTAGCGGGAATGAGCAGTTCTTC	CASSKPSGNEQFF	TRBV7-8	TRBJ2-1
TGTGCCAGCAGTTACGCCATCTACCTGACACGGGATGGCTACACCTTC	CASSYAIYLTRDGYTF	TRBV6-5	TRBJ1-2
TGTGCCAGCAGCTTATTCCTACATAACGAGCAGTACTTC	CASSLFLHNEQYF	TRBV5-6	TRBJ2-7
TGTGCCAGCAGCGGGATCCTAACAGGGACGACTCTTCGGAACACTGAAGCTTTCTTT	CASSGILTGTTLRNTEAFF	TRBV13	TRBJ1-1
TGTGCCAGCAGTGAAATCTCTCCGGGTCAGCCCCAGCATTTT	CASSEISPGQPQHF	TRBV6-1	TRBJ1-5
TGTGCCAGCAGTGAATGCCGGGACGGTACGCAGTATTTT	CASSECRDGTQYF	TRBV2	TRBJ2-3
TGTGCCAGCAGCTTCTTCTTCCGGGGCCCGCCCTACGAGCAGTACTTC	CASSFFFRGPPYEQYF	TRBV7-4	TRBJ2-7
TGTGCCAGCAGCCAAGTTACCCCTACATACGAGCAGTACTTC	CASSQVTPTYEQYF	TRBV3-1	TRBJ2-7
TGTGCCAGCAGCCCCCGGGACAGGGAGGGCAACGAGCAGTACTTC	CASSPRDREGNEQYF	TRBV5-4	TRBJ2-7
TGTGCCAGCAGCCCGAGGGGAGGGACTAGCTATATCTACGAGCAGTACTTC	CASSPRGGTSYIYEQYF	TRBV7-2	TRBJ2-7
TGTGCCAGCAGCAAAATTGACAGGGGTCAAGAGACCCAGTACTTC	CASSKIDRGQETQYF	TRBV13	TRBJ2-5
TGTGCCACCAGTGATCTCCCCGGAGAAGCGGGACCAGAGACCCAGTACTTC	CATSDLPGEAGPETQYF	TRBV24-1	TRBJ2-5
TGTGCCAGCAGCTTGCCACAGGGGGCTCACCCCAATCAGCCCCAGCATTTT	CASSLPQGAHPNQPQHF	TRBV5-4	TRBJ1-5
TGTGCCAGCAGTGACTCGGGGAGAACGGTGGAGCAGTACTTC	CASSDSGRTVEQYF	TRBV6-4	TRBJ2-7
TGCGCCAGCAGCTTTTTGGCCGGATATAGCAATCAGCCCCAGCATTTT	CASSFLAGYSNQPQHF	TRBV5-1	TRBJ1-5
TGCTACTTCGTAGGGTCTAGCACAGATACGCAGTATTTT	CYFVGSSTDTQYF	TRBV20-1	TRBJ2-3
TGTGCCAGCAGCAGGCACCGGGACATTGAAGCTTTCTTT	CASSRHRDIEAFF	TRBV7-4	TRBJ1-1
TGCAGGGTGGACAGTCAGCCCCAGCATTTT	CRVDSQPQHF	TRBV20-1	TRBJ1-5
TGTGCCAGCAGCTGGGGATATGGAGGAAACACCATATATTTT	CASSWGYGGNTIYF	TRBV7-2	TRBJ1-3
TGCGCCAGCAGCCAAGATCTGTCCGGAGGCGGAGACAGGGGGGAGTATCAGCCCCAGCATTTT	CASSQDLSGGGDRGEYQPQHF	TRBV4-1	TRBJ1-5
TGTGCCAGCGTAAGGGTGGGACAAGTAAGCTCCTACAATGAGCAGTTCTTC	CASVRVGQVSSYNEQFF	TRBV28	TRBJ2-1
TGTGCCAGCAGCTTAAAGAATGGGCGGGAGGAGCGGGGAGCCTACGAGCAGTACTTC	CASSLKNGREERGAYEQYF	TRBV7-7	TRBJ2-7
TGCGCCAGCAGCCCCAGGGAGGATGAGCAGTTCTTC	CASSPREDEQFF	TRBV4-1	TRBJ2-1
TGTGCCAGCAGCTTAGGGCAGGGAGGGTGTAGAAATCACTACTATGGCTACACCTTC	CASSLGQGGCRNHYYGYTF	TRBV7-4	TRBJ1-2
TGTGCCAGCAGCTTAGTACATTCTGAGCAGTTCTTC	CASSLVHSEQFF	TRBV11-2	TRBJ2-1
TGCGCCAGCAGTGAGGCCGGGGGACGGACTGAAGCTTTCTTT	CASSEAGGRTEAFF	TRBV10-1	TRBJ1-1
TGTGCCAGCAGCGTCAGACGTCCTGGGGCCAACGTCCTGACTTTC	CASSVRRPGANVLTF	TRBV11-3	TRBJ2-6
TGTGCCAGCAGCGACAGGGCCGACACCAAACTGTTTTTT	CASSDRADTKLFF	TRBV14	TRBJ1-4
TGTGCCAGCAGCCCCCTCGGACAGGGGGCGGAGGTTAGAGCGGGGGAAGCTTTCTTT	CASSPLGQGAEVRAGEAFF	TRBV3-1	TRBJ1-1
TGTGCCAGCAGCTGGAGAGGAAATGAGCAGTTCTTC	CASSWRGNEQFF	TRBV7-7	TRBJ2-1
TGTGCCAGCATCGGAGGGGCTCCAGATACGCAGTATTTT	CASIGGAPDTQYF	TRBV13	TRBJ2-3
TGTGCCACGGGGCCGGGACTAGCGGGAGGCGTCTCCTACGAGCAGTACTTC	CATGPGLAGGVSYEQYF	TRBV6-1	TRBJ2-7
TGTGCCAGCAGCAAAGGCCTACTAGCGGGAGGGCTTGTTCCCGCCAAAAACATTCAGTACTTC	CASSKGLLAGGLVPAKNIQYF	TRBV7-6	TRBJ2-4
TGTGCCAGCAGTGACCAGCCGGACCCGGGGGCGGTCTACGAGCAGTACTTC	CASSDQPDPGAVYEQYF	TRBV6-4	TRBJ2-7
TGTGCCAGCAGCTCGCAGCGGGAGGGGACTAGCACAGATACGCAGTATTTT	CASSSQREGTSTDTQYF	TRBV14	TRBJ2-3
TGCGCCAGCAGCCGGCGACAGGGTGAAAAACTGTTTTTT	CASSRRQGEKLFF	TRBV5-1	TRBJ1-4
TGTGCCAGCAGCTTGATGGGTATACTAGATACGCAGTATTTT	CASSLMGILDTQYF	TRBV5-8	TRBJ2-3
TGCAGTGCTAGGACCCATGGGGGGGGGGTCCAGTACGAGCAGTACTTC	CSARTHGGGVQYEQYF	TRBV20-1	TRBJ2-7
TGTGCCAGCAGCTTCTTTCGACTCAACCGTCGGGCTAATGAAAAACTGTTTTTT	CASSFFRLNRRANEKLFF	TRBV7-2	TRBJ1-4
TGTGCCAGCAGCCCTGACAGGGACGAGCAGTACTTC	CASSPDRDEQYF	TRBV2	TRBJ2-7
TGTGCCATCAGGGGCCAGGGGCCTCGGTACGAGCAGTACTTC	CAIRGQGPRYEQYF	TRBV10-3	TRBJ2-7
TGTGCCAGCAGTTATTCTCGTTTACAGGGTGGACGGTTCCTAGCCAAAAACATTCAGTACTTC	CASSYSRLQGGRFLAKNIQYF	TRBV6-5	TRBJ2-4
TGTGCCAGCAGCCCATACCGATATATCCATACGTGTGGCTATGGCTACACCTTC	CASSPYRYIHTCGYGYTF	TRBV4-2	TRBJ1-2
TGTGCCATCAGTGACTGTGGGGGCGGAGGAAGAAAGCACGCTGGAAACACCATATATTTT	CAISDCGGGGRKHAGNTIYF	TRBV10-3	TRBJ1-3
TGTGCCAGCAGCTTGGCCCGGGACAGGGGCCTAGACGAGCAGTACTTC	CASSLARDRGLDEQYF	TRBV5-4	TRBJ2-7
TGTGCCAGCAGTGTTGCGGGTACCACTGAAGCTTTCTTT	CASSVAGTTEAFF	TRBV25-1	TRBJ1-1
TGTGCCAGCAGCGAAACGACAGGGGGGGAATGGAACACTGAAGCTTTCTTT	CASSETTGGEWNTEAFF	TRBV9	TRBJ1-1
TGCAGCGTTGAGCGGGTACGCTACGAGCAGTACTTC	CSVERVRYEQYF	TRBV29-1	TRBJ2-7
TGCGCCAGCAGCTTGGGGGGGTGCCTAATTAACTATGGCTACACCTTC	CASSLGGCLINYGYTF	TRBV5-1	TRBJ1-2
TGCGCCATCAGTAGGCACTATGGCTACACCTTC	CAISRHYGYTF	TRBV5-1	TRBJ1-2
TGTGCCAGCAGCGAATGGACAGGGAATGAGACCCAGTACTTC	CASSEWTGNETQYF	TRBV7-8	TRBJ2-5
TGTGCCAGCAGCTTGGGGAACCACACTGAAGCTTTCTTT	CASSLGNHTEAFF	TRBV5-4	TRBJ1-1
TGTGCCAGCAGCTTGTTATACAGGAATCAGCCCCAGCATTTT	CASSLLYRNQPQHF	TRBV5-6	TRBJ1-5
TGTGCCAGCACGGGGGACTATGGCTACACCTTC	CASTGDYGYTF	TRBV28	TRBJ1-2
TGTGCCAGCAGTTTATGGGATCACGGCCCAAACATTCAGTACTTC	CASSLWDHGPNIQYF	TRBV27	TRBJ2-4
TGTGCCAGCACGACTAGAAGCCCGATCTTC	CASTTRSPIF	TRBV7-3	TRBJ2-1
TGTGCCAGCCACCAAACACGCAACCCGGGACAGGGGTGCTCTGGGGCCAACGTCCTGACTTTC	CASHQTRNPGQGCSGANVLTF	TRBV6-5	TRBJ2-6
TGTGCCACCAGCAGAGATCCCATTACTACCGATACGCAGTATTTT	CATSRDPITTDTQYF	TRBV15	TRBJ2-3
TGCGCCAGCAGCCATAAGGGGACAGGAGACTACGAGCAGTACTTC	CASSHKGTGDYEQYF	TRBV4-1	TRBJ2-7
TGTGCCAGCAGTGACTCCTTGGAACTAGTTGGCTACGAGCAGTACTTC	CASSDSLELVGYEQYF	TRBV6-4	TRBJ2-7
TGTGCCACCCTCGATCTCCCGTACAAGGAAAAACTGTTTTTT	CATLDLPYKEKLFF	TRBV15	TRBJ1-4
TGTGCCAGCAGCCAAGCGTTCGCGGGCAGTCAGCCCCAGCATTTT	CASSQAFAGSQPQHF	TRBV3-1	TRBJ1-5
TGTGCCACCGGACAGGGTTTCTATAATTCACCCCTCCACTTT	CATGQGFYNSPLHF	TRBV19	TRBJ1-6
TGTGCCAGCAAGGACCTTGGACAAGGTCGCAATCAGCCCCAGCATTTT	CASKDLGQGRNQPQHF	TRBV27	TRBJ1-5
TGCGCCAGCAGGCCCCCGGGGGGTCGCTCCCCCTACAATGAGCAGTTCTTC	CASRPPGGRSPYNEQFF	TRBV4-1	TRBJ2-1
TGTGCCAGCAGCCCGGGACAGGATAGCAATCAGCCCCAGCATTTT	CASSPGQDSNQPQHF	TRBV7-4	TRBJ1-5
TGCGCCAGCAGCCGAGACAGGGGGCAGGGGAACACTGAAGCTTTCTTT	CASSRDRGQGNTEAFF	TRBV4-1	TRBJ1-1
TGCATTGGGGACAGGGTGTTACATGAGCAGTTCTTC	CIGDRVLHEQFF	TRBV20-1	TRBJ2-1
TGTGCCAGCAGTCTCCGGGACAGGGTAAACAATGAGCAGTTCTTC	CASSLRDRVNNEQFF	TRBV28	TRBJ2-1
TGTGCCAGCAGCTGTTGGGACAGGGGAGCGGCCTACGAGCAGTACTTC	CASSCWDRGAAYEQYF	TRBV11-2	TRBJ2-7
TGCAGTGCTAGAGATCCGGAAGGGGCTTATCGGTATGGCTACACCTTC	CSARDPEGAYRYGYTF	TRBV20-1	TRBJ1-2
TGCGCCAGCAGCCGTTCCGACGTAGGGATGAACACTGAAGCTTTCTTT	CASSRSDVGMNTEAFF	TRBV5-1	TRBJ1-1
TGCGCCAGCAGCTTACAGGGACTAGCGGGAGTGAACCCCGGAGAGACCCAGTACTTC	CASSLQGLAGVNPGETQYF	TRBV5-1	TRBJ2-5
TGTGCCACCTACCGAGGGAGAGGGAACACTGAAGCTTTCTTT	CATYRGRGNTEAFF	TRBV24-1	TRBJ1-1
TGTGCCAGCAGCTTGGCAGGGGTGATGAACACTGAAGCTTTCTTT	CASSLAGVMNTEAFF	TRBV5-6	TRBJ1-1
TGTGCCAGCAGCGTCCCCTGGGGGCAACCGAACACTGAAGCTTTCTTT	CASSVPWGQPNTEAFF	TRBV14	TRBJ1-1
TGTGCCAGCAGTTACTCGACCTTAAGTGGAGTCCGGCCAACTAATGAAAAACTGTTTTTT	CASSYSTLSGVRPTNEKLFF	TRBV6-5	TRBJ1-4
TGTGCCAGCAGTGCCAAGGGACTAGCGGGTCCCAATGAGCAGTTCTTC	CASSAKGLAGPNEQFF	TRBV6-2	TRBJ2-1
TGTGCCAGCAGCTTAGGGGTAAGATACAATGAGCAGTTCTTC	CASSLGVRYNEQFF	TRBV7-8	TRBJ2-1
TGTGCCAGCAGCTTAGGATCAACCGGTCGGACCGGGGGTAGACACCAGCCCCAGCATTTT	CASSLGSTGRTGGRHQPQHF	TRBV7-9	TRBJ1-5
TGTGCCAGCAGCTTAACGAGTGGGGGGACTTACACCGGGGAGCTGTTTTTT	CASSLTSGGTYTGELFF	TRBV7-3	TRBJ2-2
TGCAGTGCGGGTGGGACAGGGGGCTACACCTTC	CSAGGTGGYTF	TRBV20-1	TRBJ1-2
TGTGCCAGCACTCGGAACAGCTCCTACAATGAGCAGTTCTTC	CASTRNSSYNEQFF	TRBV6-4	TRBJ2-1
TGCAGTGCTAGAAAGCGTAACCAGGGCGATGGCTGGAACACTGAAGCTTTCTTT	CSARKRNQGDGWNTEAFF	TRBV20-1	TRBJ1-1
TGTGCCACCAGCCTGGCCCTAGCGGGCAAGGAAGAGACCCAGTACTTC	CATSLALAGKEETQYF	TRBV15	TRBJ2-5
TGTGCCAGCACTGTGGGAGTTGAGACCCAGTACTTC	CASTVGVETQYF	TRBV25-1	TRBJ2-5
TGTGCCAGCAGTGAAGTCGATCCGGGTCAGCCCCAGCATTTT	CASSEVDPGQPQHF	TRBV6-1	TRBJ1-5
TGTGCCAGCAGCTTAGATGTGCCGGGGGGGGGCTACGAGCAGTACTTC	CASSLDVPGGGYEQYF	TRBV11-2	TRBJ2-7
TGTGCCAGCAGTTGGGCCGGTAGGGAGGGACACGACAAAACGAACACCGGGGAGCTGTTTTTT	CASSWAGREGHDKTNTGELFF	TRBV27	TRBJ2-2
TGTGCCAGCAGTGACCCCGACAACCACTATGGCTACACCTTC	CASSDPDNHYGYTF	TRBV6-4	TRBJ1-2
TGTGCCAGCAGCCTCCCATGGGGGGACGAGCAGTACTTC	CASSLPWGDEQYF	TRBV7-3	TRBJ2-7
TGTGCCAGCCCTTCTTGGCAGGGGATGCGTACCGAGATCGCTTTCTTT	CASPSWQGMRTEIAFF	TRBV6-5	TRBJ1-1
TGTGCCACCAGTGCCGCTATTTTCGATCAGCCCCAGCATTTT	CATSAAIFDQPQHF	TRBV24-1	TRBJ1-5
TGTGCCAGCAGTTACTCCATCAGAGATACGCAGTATTTT	CASSYSIRDTQYF	TRBV6-8	TRBJ2-3
TGTGCCAGCAGTGACGGACAGGGGATGAACACTGAAGCTTTCTTT	CASSDGQGMNTEAFF	TRBV2	TRBJ1-1
TGTGCCAGCAGGCAAAAGCAAAAGTTTCTAGGGATCACAGATACGCAGTATTTT	CASRQKQKFLGITDTQYF	TRBV12-3	TRBJ2-3
TGTGCCAGCAGACGAGGACTAGCGGGTAGGTACCAAGAGACCCAGTACTTC	CASRRGLAGRYQETQYF	TRBV9	TRBJ2-5
TGTGCCAGCAGCCGAAAACCATCCCGGGCACAAGAGACCCAGTACTTC	CASSRKPSRAQETQYF	TRBV9	TRBJ2-5
TGTGCCAGCAAACCAGGGTATCGGCACGCCAAAAACATTCAGTACTTC	CASKPGYRHAKNIQYF	TRBV9	TRBJ2-4
TGCAGTGCTAGGGGACTCTTC	CSARGLF	TRBV20-1	TRBJ2-1
TGTGCCAGCAGCTTGGAAGTTGGGGGGAGCGACGAGCAGTACTTC	CASSLEVGGSDEQYF	TRBV5-4	TRBJ2-7
TGTGCCAGCACGGGGACAGAGGTCGCTGGGGCCAACGTCCTGACTTTC	CASTGTEVAGANVLTF	TRBV7-8	TRBJ2-6
TGTGCCAGCATGGGGGGCGAGGGGTGTTTGGGTCAGCCCCAGCATTTT	CASMGGEGCLGQPQHF	TRBV12-3	TRBJ1-5
TGTGCCATCAGTGAGTACTTCCTGACGGTAGACGAGCAGTACTTC	CAISEYFLTVDEQYF	TRBV10-3	TRBJ2-7
TGTGCCAGCAGGTGGACAGGGGACCTCGAGCAGTACTTC	CASRWTGDLEQYF	TRBV27	TRBJ2-7
TGCGCCAGCAGCTTGATCGGGGACGAGCAGTACTTC	CASSLIGDEQYF	TRBV5-1	TRBJ2-7
TGTGCCAGCAGCTCCGATCCGGGGGGGTGTACTCTTCAGAGCTCCTACAATGAGCAGTTCTTC	CASSSDPGGCTLQSSYNEQFF	TRBV11-3	TRBJ2-1
TGCAGTGCTAGAGTCAGGAGCCGGGACAGGGACAATGAGCAGTTCTTC	CSARVRSRDRDNEQFF	TRBV20-1	TRBJ2-1
TGCAGTGCTCGACCAGGCAATCAGCCCCAGCATTTT	CSARPGNQPQHF	TRBV20-1	TRBJ1-5
TGTGCCAGCAGTGAAATAATATGGACAGACGAGCAGTACTTC	CASSEIIWTDEQYF	TRBV6-4	TRBJ2-7
TGCAGTGCTAGACCCTCGGGGGACTTGCCCTCTGGGGCCAACGTCCTGACTTTC	CSARPSGDLPSGANVLTF	TRBV20-1	TRBJ2-6
TGTGCCAGCTCACCCCAGCGTTTGACAGGTCGCGAGCAGTACTTC	CASSPQRLTGREQYF	TRBV18	TRBJ2-7
TGTGCCAGCGGGAAGGGGTACGCCTACGAGCAGTACTTC	CASGKGYAYEQYF	TRBV11-1	TRBJ2-7
TGCAGTGCTAAGACAATCCAGGGATCCTACAATGAGCAGTTCTTC	CSAKTIQGSYNEQFF	TRBV20-1	TRBJ2-1
TGTGCCAGCAGCCCTCACAGGGGTGACGAGCAGTACTTC	CASSPHRGDEQYF	TRBV4-2	TRBJ2-7
TGTGCCAGCAGCCAAGACCACCTAGGGGATACTGAAGCTTTCTTT	CASSQDHLGDTEAFF	TRBV14	TRBJ1-1
TGTGCCAGCAGCTTAAGGGGGGGGCATGGCGTAACTTCAGAGACCCAGTACTTC	CASSLRGGHGVTSETQYF	TRBV7-3	TRBJ2-5
TGTGCCAGTAGTATCCGGTCGGCGGAAAACACTGAAGCTTTCTTT	CASSIRSAENTEAFF	TRBV19	TRBJ1-1
TGTGCCAGCAGCCCGGGACAGGGCGACTACGAGCAGTACTTC	CASSPGQGDYEQYF	TRBV13	TRBJ2-7
TGCAGTGCTAGCCTGAAGAACGGGGCGAACAGCTCCTATGAGCAGTTCTTC	CSASLKNGANSSYEQFF	TRBV20-1	TRBJ2-1
TGTGCCAGCCTCTACGGGGGCCATTCCCAAATTATAGGTTATGAGCAGTACTTC	CASLYGGHSQIIGYEQYF	TRBV7-9	TRBJ2-7
TGTGCCAGCAGCTTGTCCGAGCTCACAGACAATGAGCAGTTCTTC	CASSLSELTDNEQFF	TRBV13	TRBJ2-1
TGTGCCAGCAGCTCTAAAGGGCGGGTCGATACGCAGTATTTT	CASSSKGRVDTQYF	TRBV9	TRBJ2-3
TGTGCCAGCAGCTACTCATTTATGAACACTGAAGCTTTCTTT	CASSYSFMNTEAFF	TRBV5-4	TRBJ1-1
TGCAGTGCTAGGGCACGAAGGGTGACAGGGGTTCTTACAGATACGCAGTATTTT	CSARARRVTGVLTDTQYF	TRBV20-1	TRBJ2-3
TGTGCCAGCAGCTTAGTCGAAGGACAGGGTCGGAACTATGGCTACACCTTC	CASSLVEGQGRNYGYTF	TRBV7-7	TRBJ1-2
TGTGCCTTCCTATACCCTGGAAACACCATATATTTT	CAFLYPGNTIYF	TRBV30	TRBJ1-3
TGTGCCAGCAGTTACGGGCTCGGGCGGCCGGTAGCGGTACCAGAGACCCAGTACTTC	CASSYGLGRPVAVPETQYF	TRBV6-5	TRBJ2-5
TGTGCCAGCAGCCAAGAAATCGTTCACTCCTACGAGCAGTACTTC	CASSQEIVHSYEQYF	TRBV4-2	TRBJ2-7
TGTGCCACCTCTTCTGCAGGGGTCCCCTACGAGCAGTACTTC	CATSSAGVPYEQYF	TRBV24-1	TRBJ2-7
TGTGCCAGTGCACGGCGGGGGGGCACTGAAGCTTTCTTT	CASARRGGTEAFF	TRBV19	TRBJ1-1
TGTGCCTGGATGGCCAAGGTCTTCCGGGGCGAAAAACTGTTTTTT	CAWMAKVFRGEKLFF	TRBV30	TRBJ1-4
TGTGCCAGCAGAATCTCAGGGGGCCTTAGGTGGAACACCGGGGAGCTGTTTTTT	CASRISGGLRWNTGELFF	TRBV27	TRBJ2-2
TGTGCCAGTCAGGACGGTTTAAGCAATCAGCCCCAGCATTTT	CASQDGLSNQPQHF	TRBV6-6	TRBJ1-5
TGTGCCAGCAGCTTTCTCGACTCGGGTGGAAGCGTGCCCCAGCATTTT	CASSFLDSGGSVPQHF	TRBV11-3	TRBJ1-5
TGTGCCACCAGTGATTTACAAGATGCAACTAATGAAAAACTGTTTTTT	CATSDLQDATNEKLFF	TRBV24-1	TRBJ1-4
TGTGCCAGCAGGAGGAGGTACCCCGCTCCATCCCGGGACAGGGGGAAGCTGACCTACGAGCAGTACTTC	CASRRRYPAPSRDRGKLTYEQYF	TRBV7-4	TRBJ2-7
TGCGCCAGCAGCTTGAAAGAAAGCGGGCGGGGCTATGGCTACACCTTC	CASSLKESGRGYGYTF	TRBV5-1	TRBJ1-2
TGTGCCAGCAGTTACTCGAAGTTCCGGGACAGGGGGAATCAGCCCCAGCATTTT	CASSYSKFRDRGNQPQHF	TRBV6-5	TRBJ1-5
TGTGCCAGCAACCCTTCCGGGGGGGACCAGATAACCGGGGAGCTGTTTTTT	CASNPSGGDQITGELFF	TRBV27	TRBJ2-2
TGTGCCAGCAGCCAAGACGGGGTGAATTCACCCCTCCACTTT	CASSQDGVNSPLHF	TRBV4-2	TRBJ1-6
TGTGCCAGCAGTCGAAGGGGAAGGGGCTACACCTTC	CASSRRGRGYTF	TRBV25-1	TRBJ1-2
TGTGCCAGCAGCTTAAGGGCGCGGCTATGGAGCAATCAGCCCCAGCATTTT	CASSLRARLWSNQPQHF	TRBV7-9	TRBJ1-5
TGCAGTGCTAGAGCCGGACGCGTTCAGCCCCAGCATTTT	CSARAGRVQPQHF	TRBV20-1	TRBJ1-5
TGTGCCAGCCTTCCGGGACAGGGGCCCCCCTACGAGCAGTACTTC	CASLPGQGPPYEQYF	TRBV7-9	TRBJ2-7
TGTGCCAGCAGCTACAAGCGGGACGACGAGCAGTACTTC	CASSYKRDDEQYF	TRBV7-9	TRBJ2-7
TGTGCCAGCAGTGGGCCGCGGGAGCCTTCTTACACCGGGGAGCTGTTTTTT	CASSGPREPSYTGELFF	TRBV6-1	TRBJ2-2
TGCAGTGCTAGTTCGGGTGAACGGGATCTGAATTCACCCCTCCACTTT	CSASSGERDLNSPLHF	TRBV20-1	TRBJ1-6
TGTGCCACTCCACTCCTCAACGAGCAGTACTTC	CATPLLNEQYF	TRBV24-1	TRBJ2-7
TGTGCCAGCAGCCGGAAGGCGGGGGGCGGCTCTGGGGCCAACGTCCTGACTTTC	CASSRKAGGGSGANVLTF	TRBV11-2	TRBJ2-6
TGTGCCAGCAGCCCTCAGGGGGGAGCAGATACGCAGTATTTT	CASSPQGGADTQYF	TRBV7-4	TRBJ2-3
TGTGCCATCAGTGACCATCAGGGATCGTACGAGCAGTACTTC	CAISDHQGSYEQYF	TRBV10-3	TRBJ2-7
TGTGCCTGGATCGAACAGGGCTACACCTTC	CAWIEQGYTF	TRBV30	TRBJ1-2
TGTGCCAGCAGCTTGGGGTGCACGGGAGTTACGAGCATTCAGTACTTC	CASSLGCTGVTSIQYF	TRBV5-6	TRBJ2-4
TGTGCCAGCAGTGAAGGTGACGGATATAGCAATCAGCCCCAGCATTTT	CASSEGDGYSNQPQHF	TRBV2	TRBJ1-5
TGTGCCACCATTGCGACTAGCTACGAGCAGTACTTC	CATIATSYEQYF	TRBV24-1	TRBJ2-7
TGTGCCAGCAGCCAAGACCCCGGGGGGATCGTGAATCAGCCCCAGCATTTT	CASSQDPGGIVNQPQHF	TRBV3-1	TRBJ1-5
TGTGCCAGCAGTCACACTAAGGGGCGCGAGACCCAGTACTTC	CASSHTKGRETQYF	TRBV28	TRBJ2-5
TGTGCCAGCAGCCTAACTGGGAACACCGGGGAGCTGTTTTTT	CASSLTGNTGELFF	TRBV13	TRBJ2-2
TGTGCCAGCAGCCAAGAGCCGGTGGGGACCGATAGTTTAGGCACTGAAGCTTTCTTT	CASSQEPVGTDSLGTEAFF	TRBV3-1	TRBJ1-1
TGCGCCGTTGTGACCGGGACTAGCGGGGGGGTTAACGAGCAGTACTTC	CAVVTGTSGGVNEQYF	TRBV10-2	TRBJ2-7
TGTGCCACCAGTGATTGGGACATCCCTATCACTGAAGCTTTCTTT	CATSDWDIPITEAFF	TRBV24-1	TRBJ1-1
TGTGCCAGCATCGACTGGGAGACCCAGTACTTC	CASIDWETQYF	TRBV27	TRBJ2-5
TGTGCCAGCATAAAAGACAGGAATTCACCCCTCCACTTT	CASIKDRNSPLHF	TRBV28	TRBJ1-6
TGCGCCAGCAGCCAAGCCCAGTGCACAGGGGTGTGTCCCACTGAAGCTTTCTTT	CASSQAQCTGVCPTEAFF	TRBV4-1	TRBJ1-1
TGTGCCAGCTCACAGGGGGATCAGCCCCAGCATTTT	CASSQGDQPQHF	TRBV18	TRBJ1-5
TGTGCCAGCAGCCCCAAGCCGGGACAGGGAAGCCGCAATCAGCCCCAGCATTTT	CASSPKPGQGSRNQPQHF	TRBV6-4	TRBJ1-5
TGTGCCAGCAGCTATGGGGAAGGCTACACCTTC	CASSYGEGYTF	TRBV7-9	TRBJ1-2
TGTGCCAGCAGTATTTACGAGCGGGATCCCGGCGAGCAGTACTTC	CASSIYERDPGEQYF	TRBV12-4	TRBJ2-7
TGTGCCAGCAGCTTGTCCGTACCGGGACAGGGGACCGAGATGAGAAACACCATATATTTT	CASSLSVPGQGTEMRNTIYF	TRBV5-6	TRBJ1-3
TGTGCCAGCAGCTTAGTAGCGGGACAGGTCACTGAAGCTTTCTTT	CASSLVAGQVTEAFF	TRBV7-8	TRBJ1-1
TGTGCCACACGGAGGGAGTCCAGCCAGTACTTC	CATRRESSQYF	TRBV28	TRBJ2-5
TGCGCCAGCAGCCAGGTTAACGAGCAGTACTTC	CASSQVNEQYF	TRBV5-1	TRBJ2-7
TGTGCCAGCAGCTGGACAGGGAGGTTTGGGGTCTACGAGCAGTACTTC	CASSWTGRFGVYEQYF	TRBV13	TRBJ2-7
TGTGCCAGCAGATCCGAGTCACCGGGACAGGAGGGAACTCAGCCCCAGCATTTT	CASRSESPGQEGTQPQHF	TRBV6-4	TRBJ1-5
TGTGCCAGCAGTTACTCGACTCTTAGCGGGATCGTTTGCTACGAGCAGTACTTC	CASSYSTLSGIVCYEQYF	TRBV6-5	TRBJ2-7
TGTGCCAGCAGCCTCTGCCTAGGCGGGACTGGAAACACCATATATTTT	CASSLCLGGTGNTIYF	TRBV7-3	TRBJ1-3
TGCGCCACTCCGAAGGGACTAGATGTGACTAGCACAGATACGCAGTATTTT	CATPKGLDVTSTDTQYF	TRBV10-1	TRBJ2-3
TGTGCCAGTAGTATGCAAGCCCCTAAGACGAGAACGCACAATGGCTACACCTTC	CASSMQAPKTRTHNGYTF	TRBV19	TRBJ1-2
TGCAGTGCTAGAGATGTCGGGTTAAACACTGAAGCTTTCTTT	CSARDVGLNTEAFF	TRBV20-1	TRBJ1-1
TGTGCCAGCAGTTTTGGGGGCTACGAGCAGTACTTC	CASSFGGYEQYF	TRBV27	TRBJ2-7
TGCGCCAGCATAGGACAATCGCCTGGAGACAGGACTGCTTTCTTT	CASIGQSPGDRTAFF	TRBV5-1	TRBJ1-1
TGTGCCACGTTAGTTTATGGCTACACCTTC	CATLVYGYTF	TRBV19	TRBJ1-2
TGTGCCAGCAGTTACTCGACCCTCCGAGGGACAGATACGCAGTATTTT	CASSYSTLRGTDTQYF	TRBV6-2	TRBJ2-3
TGTGCCAGCAGCGGAGGGCCTGGGCAGGAGGGAAAAAGCAATCAGCCCCAGCATTTT	CASSGGPGQEGKSNQPQHF	TRBV11-2	TRBJ1-5
TGTGCCAGCAGTTACTCGAGAAGGGGAGAACATGGCTTC	CASSYSRRGEHGF	TRBV6-5	TRBJ2-5
TGTGCCAGCAGCCAAGATAGCGGGTTAGCAGATGAGCAGTTCTTC	CASSQDSGLADEQFF	TRBV4-2	TRBJ2-1
TGCGCCAGCAGCCAAGCAGGCTATCCGAGTCTTGGGCCGAAGTACGAGCAGTACTTC	CASSQAGYPSLGPKYEQYF	TRBV4-1	TRBJ2-7
TGCGCCAGCAGCAACAGAATCAGGGAAAAACTGTTTTTT	CASSNRIREKLFF	TRBV5-1	TRBJ1-4
TGTGCCAGCAGTTGTTTTTTTCTTGTCTGTAAGCCTGGGCATCTTCTAGCTTTGCAGCCCCAGCATTTT	CASSCFFLVCKPGHLLALQPQHF	TRBV6-6	TRBJ1-5
TGCGCCAGCAGCTACCATGTGCGGTGCCGGATCGACAATGAGCAGTTCTTC	CASSYHVRCRIDNEQFF	TRBV5-1	TRBJ2-1
TGTGCCAGCAGCTTGTCCATTAAAACGGTGAGGGATAGCTCCTACGAGCAGTACTTC	CASSLSIKTVRDSSYEQYF	TRBV5-6	TRBJ2-7
TGTGCCATCATAGTACAGGGTCCCTATCAAGCCTACGAGCAGTACTTC	CAIIVQGPYQAYEQYF	TRBV10-3	TRBJ2-7
TGTGCCAGCAGTGACTCTCTGCCGGGGCTGTGTTCACCCCTCCACTTT	CASSDSLPGLCSPLHF	TRBV6-4	TRBJ1-6
TGTGCCACCAGCAGAGCCGGGACAGAGCACACCGGGGAGCTGTTTTTT	CATSRAGTEHTGELFF	TRBV15	TRBJ2-2
TGCGCCAGCAGCATGAGGCAGCCCCAGCATTTT	CASSMRQPQHF	TRBV5-1	TRBJ1-5
TGCAGTGCCGGGACAGGGCCGAGTGAAAAACTGTTTTTT	CSAGTGPSEKLFF	TRBV20-1	TRBJ1-4
TGCGCCAGCAAGGAGGAGGCTCCCCGACAGACTGAAGCTTTCTTT	CASKEEAPRQTEAFF	TRBV10-1	TRBJ1-1
TGTGCCAGCAGCAGAGCGGGGGGGACGGGGGAATGGATGGGTAACACCGGGGAGCTGTTTTTT	CASSRAGGTGEWMGNTGELFF	TRBV7-4	TRBJ2-2
TGCAGCGGGACAGGGGTCACAGATACGCAGTATTTT	CSGTGVTDTQYF	TRBV29-1	TRBJ2-3
TGTGCCACCAGCTCCCCGGGACAGGGGAACCCCGGGTATAGCAATCAGCCCCAGCATTTT	CATSSPGQGNPGYSNQPQHF	TRBV15	TRBJ1-5
TGTGCCAGCAGCATCACGGACAGCTACTATGGCTACACCTTC	CASSITDSYYGYTF	TRBV7-8	TRBJ1-2
TGTGCCACCGGGACTAGGGATGGGTTTCCCCAGTACTTC	CATGTRDGFPQYF	TRBV19	TRBJ2-5
TGTGCCAGTATTATCACAGATACGCAGTATTTT	CASIITDTQYF	TRBV6-5	TRBJ2-3
TGTGCCAGCTGTCGGGGACACCCGAGGCAGTTCTTC	CASCRGHPRQFF	TRBV28	TRBJ2-1
TGCGCCAGCAGCTTGGATCCTCGACGGCATGGGGTGGGCACCGGGGAGCTGTTTTTT	CASSLDPRRHGVGTGELFF	TRBV5-1	TRBJ2-2
TGTGCCAGCAGCCGTTTACCAGGGGCCAATAGCAATCAGCCCCAGCATTTT	CASSRLPGANSNQPQHF	TRBV14	TRBJ1-5
TGTGCCACCAGTGGGGACGTCACTGAAGCTTTCTTT	CATSGDVTEAFF	TRBV24-1	TRBJ1-1
TGTGCCAGCAGTGAATGCAGGGCCCTAGCCAAAAACATTCAGTACTTC	CASSECRALAKNIQYF	TRBV6-1	TRBJ2-4
TGTGCCAGCAGCTCTAGCGGGGTAACAGATACGCAGTATTTT	CASSSSGVTDTQYF	TRBV25-1	TRBJ2-3
TGTGCCACGGCGACTAGCTACGAGCAGTACTTC	CATATSYEQYF	TRBV19	TRBJ2-7
TGTGCCAGCAGTGACTATACCAGCAGGGCAGAGCAGTACTTC	CASSDYTSRAEQYF	TRBV25-1	TRBJ2-7
TGTGCCACCAGCAGAGATCCAAGGGGGAACACCGGGGAGCTGTTTTTT	CATSRDPRGNTGELFF	TRBV15	TRBJ2-2
TGCGCCAGCAGCCAGTCGGCCTGTTGGGACCAGTATAGCAATCAGCCCCAGCATTTT	CASSQSACWDQYSNQPQHF	TRBV4-1	TRBJ1-5
TGTGCCAGCAGCTTAGTCCACACTAGCGGGAGGGGGCGAAGGGCTACTGAAGCTTTCTTT	CASSLVHTSGRGRRATEAFF	TRBV7-4	TRBJ1-1
TGCAGTGCTAGAAACAGGGGCCTCTATGGCTACACCTTC	CSARNRGLYGYTF	TRBV20-1	TRBJ1-2
TGTGCCAGCAGCCGGGCAGCAGGCAATCAGCCCCAGCATTTT	CASSRAAGNQPQHF	TRBV13	TRBJ1-5
TGTGCCAGCAGCCAAGGGGGCGTTCGGGGAACCGGGGAGCTGTTTTTT	CASSQGGVRGTGELFF	TRBV11-2	TRBJ2-2
TGTGCCAGCAGCGTAACCGGTACTCGGTCTAGCACAGATACGCAGTATTTT	CASSVTGTRSSTDTQYF	TRBV9	TRBJ2-3
TGTGCCAGCAGGCGGGGGGAAGGACAGGGGGGGGGCACAGATACGCAGTATTTT	CASRRGEGQGGGTDTQYF	TRBV28	TRBJ2-3
TGTGCCAGCAGCAAACAGGCGGACTCCTACGAGCAGTACTTC	CASSKQADSYEQYF	TRBV13	TRBJ2-7
TGTGCCAGCTCACGGAGACAGTATGGCTACACCTTC	CASSRRQYGYTF	TRBV18	TRBJ1-2
TGTGCCAGCTCACCTGCGGTGGGGGGACTTCATCATGAGCAGTTCTTC	CASSPAVGGLHHEQFF	TRBV18	TRBJ2-1
TGTGCCAGCAGCCTAGGGGGGCGGGGGCCCCCCCTCGCCAGCTCCTACGAGCAGTACTTC	CASSLGGRGPPLASSYEQYF	TRBV3-1	TRBJ2-7
TGTGCCAGCCCGAAAGAACGGAGGACCGGGGAGCTGTTTTTT	CASPKERRTGELFF	TRBV7-3	TRBJ2-2
TGTGCCAGCAGGGGGACTAGCGGGGGCTACAATGAGCAGTTCTTC	CASRGTSGGYNEQFF	TRBV27	TRBJ2-1
TGTGCCAGCAGATCGTCCTACGAGCAGTACTTC	CASRSSYEQYF	TRBV6-4	TRBJ2-7
TGTGCCAGCACGAATCATGCGGTTCCCGGGACCTGTTATGGCTACACCTTC	CASTNHAVPGTCYGYTF	TRBV7-7	TRBJ1-2
TGTGCCTGCGGGGGACTAGCGGGCGCACGGTACAATGAGCAGTTCTTC	CACGGLAGARYNEQFF	TRBV30	TRBJ2-1
TGCGCCAGCAGCACGCACCTACTTCCCCAGCCCCAGCATTTT	CASSTHLLPQPQHF	TRBV5-1	TRBJ1-5
TGCACCGGGTATCTGTGGGGAGAGACCCAGTACTTC	CTGYLWGETQYF	TRBV20-1	TRBJ2-5
TGTGCCAGTAGTATCTATAAGACAGGGGCGACAGTTCAGCCCCAGCATTTT	CASSIYKTGATVQPQHF	TRBV19	TRBJ1-5
TGTGCCAGTACGCAGGGGGGCGAGCGCTACGAGCAGTACTTC	CASTQGGERYEQYF	TRBV19	TRBJ2-7
TGTGCCAGCAGCTTACCTACCGGGACAGATGAGCAGTTCTTC	CASSLPTGTDEQFF	TRBV11-2	TRBJ2-1
TGTGCCAGCTCAACAGGGGTGGTCACTGAAGCTTTCTTT	CASSTGVVTEAFF	TRBV18	TRBJ1-1
TGTGCCAGCAGCACGGGACAGGGGCGGGTCACTGAAGCTTTCTTT	CASSTGQGRVTEAFF	TRBV13	TRBJ1-1
TGCGCCAGCAGCCAATGCGTGGTACTAGCGGGAGTAGCCGTCTCTGGGGCCAACGTCCTGACTTTC	CASSQCVVLAGVAVSGANVLTF	TRBV4-3	TRBJ2-6
TGCAGCGGTATTCTCTTAGGGGACAGGGGCTGGGCGGCAACTAATGAAAAACTGTTTTTT	CSGILLGDRGWAATNEKLFF	TRBV29-1	TRBJ1-4
TGTGCCAGCTCACCACCGATTATTCATCCCCGTGAAGCTTTCTTT	CASSPPIIHPREAFF	TRBV18	TRBJ1-1
TGTGCCAGTCAAGGACAGGGGGCGAGAGGCGATCAGCCCCAGCATTTT	CASQGQGARGDQPQHF	TRBV19	TRBJ1-5
TGTGCCAGCAGCTGGGGGGGAGGTTGGGTTCAGCCCCAGCATTTT	CASSWGGGWVQPQHF	TRBV5-4	TRBJ1-5
TGCAGTGCTAGAGTTAACAAAAATCAGACAGAGGAGCAGTACTTC	CSARVNKNQTEEQYF	TRBV20-1	TRBJ2-7
TGCGCCAGCAGCCAGACACCCGAGCTGGTACCTGAAGCTTTCTTT	CASSQTPELVPEAFF	TRBV4-1	TRBJ1-1
TGTGCCAGCAGCGTAGAACCGGGGGGTCACGCCTACGAGCAGTACTTC	CASSVEPGGHAYEQYF	TRBV9	TRBJ2-7
TGCAGTGCTAGAGATGTAGGACCGGCGAGTCCAACTGGATGTAACTATGGCTACACCTTC	CSARDVGPASPTGCNYGYTF	TRBV20-1	TRBJ1-2
TGCGCCAGCAGCTTCTTCCCCGATTGGGGACAGGGTTGCAATGGAAACACCATATATTTT	CASSFFPDWGQGCNGNTIYF	TRBV5-1	TRBJ1-3
TGTGCCAGCAGCTGGGAGAGGTACGAGCAGTACTTC	CASSWERYEQYF	TRBV7-6	TRBJ2-7
TGTGCCAGCAGCTCCATACAGGACTTCCCTTTAGATACGCAGTATTTT	CASSSIQDFPLDTQYF	TRBV7-9	TRBJ2-3
TGCAGTACAGAAAAAACAGTTGAGCAGTTCTTC	CSTEKTVEQFF	TRBV20-1	TRBJ2-1
TGCGCCAGCAGCCACAGGGGTTTAGGGAACACTGAAGCTTTCTTT	CASSHRGLGNTEAFF	TRBV4-1	TRBJ1-1
TGCGCCAGCAGGGTACTAAGGGAGCAGTTCTTC	CASRVLREQFF	TRBV10-1	TRBJ2-1
TGTGCCAGCATCGCACAGCGTGGGGGAAGCTCCTACAATGAGCAGTTCTTC	CASIAQRGGSSYNEQFF	TRBV6-5	TRBJ2-1
TGTGCCAGCAGCTTCAGGCCATGGAGGAGAGGACGGACACCAGGCTACACCTTC	CASSFRPWRRGRTPGYTF	TRBV11-3	TRBJ1-2
TGTTTTCCACAGGGCGACCTCGAAAAACTGTTTTTT	CFPQGDLEKLFF	TRBV14	TRBJ1-4
TGTGTTTGGTCCAAATCCGGGACAGAGGGCGAGCAGTACTTC	CVWSKSGTEGEQYF	TRBV24-1	TRBJ2-7
TGCGCCAGCAGCCAATGGGGGGCGTGCCGGGATTACTACGAGCAGTACTTC	CASSQWGACRDYYEQYF	TRBV4-1	TRBJ2-7
TGTGCCAGCAGCGGAGGGGGCAATTCACCCCTCCACTTT	CASSGGGNSPLHF	TRBV13	TRBJ1-6
TGTGCCAGCAGTAAGCTGGGACAGGGGTACTCTGGGGCCAACGTCCTGACTTTC	CASSKLGQGYSGANVLTF	TRBV6-1	TRBJ2-6
TGCAGTGCTAGACACAGGCGGGTTCAGCCCCAGCATTTT	CSARHRRVQPQHF	TRBV20-1	TRBJ1-5
TGCGCCAGCAGTGGTGGCTTATCGGGACAGGGTTGGGCCTACGAGCAGTACTTC	CASSGGLSGQGWAYEQYF	TRBV10-1	TRBJ2-7
TGCAGCTCCGAGGGTTATGAGCAGTTCTTC	CSSEGYEQFF	TRBV29-1	TRBJ2-1
TGTGCCTGGACTGTAGCGGGTTTAAGTTACAATGAGCAGTTCTTC	CAWTVAGLSYNEQFF	TRBV30	TRBJ2-1
TGCGCCAGCAGTGAGTCGGCCCCGCAGTCTGTGAACACTGAAGCTTTCTTT	CASSESAPQSVNTEAFF	TRBV10-1	TRBJ1-1
TGTGCCAGCAGCGGACTAGCGGGACCCTCCTACAATGAGCAGTTCTTC	CASSGLAGPSYNEQFF	TRBV7-3	TRBJ2-1
TGTGCCAGCAGTGACTCCCCGACATGCCCAGATACGCAGTATTTT	CASSDSPTCPDTQYF	TRBV6-4	TRBJ2-3
TGCAGCGACCTCCTGTCAGATACGCAGTATTTT	CSDLLSDTQYF	TRBV29-1	TRBJ2-3
TGTGCCAGCAGCCCGGGACCGGGACAACTTGGAATCACTGAAGCTTTCTTT	CASSPGPGQLGITEAFF	TRBV5-6	TRBJ1-1
TGTGCCAGCAGCCAAGAAGGACAGGGGCGAGGGGTGCGAGGCTACACCTTC	CASSQEGQGRGVRGYTF	TRBV3-1	TRBJ1-2
TGCAGCGTTGAACCAGAGCAAGAGACCCAGTACTTC	CSVEPEQETQYF	TRBV29-1	TRBJ2-5
TGTGCCACCAGTACTCAACCAGGACAACTCTCTGGAAACACCATATATTTT	CATSTQPGQLSGNTIYF	TRBV24-1	TRBJ1-3
TGTGCCAGCAGCCATCCCACGGGGGCCGGGGGGGAGACCCAGTACTTC	CASSHPTGAGGETQYF	TRBV14	TRBJ2-5
TGCAGTGCTCCCACAGGGGAAGAGACCCAGTACTTC	CSAPTGEETQYF	TRBV20-1	TRBJ2-5
TGTGCCACCAGTGCCCGCCGGACAGGACCCGATTCTAACTATGGCTACACCTTC	CATSARRTGPDSNYGYTF	TRBV24-1	TRBJ1-2
TGTGCCAGCAGTAGGGTTCGGGGGCCCGCAAATGAGCAGTTCTTC	CASSRVRGPANEQFF	TRBV28	TRBJ2-1
TGTGCCAGCAGGGGGCACTCGAAGGGGGGACCCTACGAGCAGTACTTC	CASRGHSKGGPYEQYF	TRBV6-1	TRBJ2-7
TGCGCCAGCAGCTCTCGGACTAGAACAACCGGGGAGCTGTTTTTT	CASSSRTRTTGELFF	TRBV5-1	TRBJ2-2
TGTGCCAGCAGCCCGGGACACGCCGCCTACAATGAGCAGTTCTTC	CASSPGHAAYNEQFF	TRBV13	TRBJ2-1
TGTGCCACCAATAGAGCCGGGACAGGGAGACGCCAAGAGACCCAGTACTTC	CATNRAGTGRRQETQYF	TRBV19	TRBJ2-5
TGTGCCAGCAGCCTTGGGGCTCGTTACGAGCAGTACTTC	CASSLGARYEQYF	TRBV13	TRBJ2-7
TGTGCCAGCCTTAAGGGCCCCCGGGAAACCGGGGAGCTGTTTTTT	CASLKGPRETGELFF	TRBV7-2	TRBJ2-2
TGTGCTAGTGGCAACACAGGGCAGCCCCAGCATTTT	CASGNTGQPQHF	TRBV12-5	TRBJ1-5
TGTGCCAGCAGTTGCTTGGGCTCGGGGGAAAAACCCTACGAGCAGTACTTC	CASSCLGSGEKPYEQYF	TRBV28	TRBJ2-7
TGTGCCGACTCGGACAGGGTGGAGAGCAATCAGCCCCAGCATTTT	CADSDRVESNQPQHF	TRBV30	TRBJ1-5
TGTGCCAGCATCAGGGGTCGGATGAACACTGAAGCTTTCTTT	CASIRGRMNTEAFF	TRBV7-7	TRBJ1-1
TGTGCCAGCAGTTCCCACGACAGAGCGAGGCCCCAGCATTTT	CASSSHDRARPQHF	TRBV27	TRBJ1-5
TGCGCCAGCCGGATCGGTTGCTACGAGCAGTACTTC	CASRIGCYEQYF	TRBV4-1	TRBJ2-7
TGCGCCAGCAGCCATAACCTATTAGACAATGAGCAGTTCTTC	CASSHNLLDNEQFF	TRBV4-1	TRBJ2-1
TGTGCCAGCAGCCAAGTCACAGCGGCGGAGCTCTACGAGCAGTACTTC	CASSQVTAAELYEQYF	TRBV4-2	TRBJ2-7
TGTGCCAGCAGTGCAGAGGACGGGGGGGCAAAACCCCGGTACAGAGACGCGTACGAGCAGTACTTC	CASSAEDGGAKPRYRDAYEQYF	TRBV28	TRBJ2-7
TGTGCCAGCAGTGCTCCACAGGGGGATGAAAAACTGTTTTTT	CASSAPQGDEKLFF	TRBV6-2	TRBJ1-4
TGTGCCAGCAGCCCTTTCCCGCCCTCAAAAATTACCGGGCCCCTGCCGGGCTACACCTTC	CASSPFPPSKITGPLPGYTF	TRBV5-4	TRBJ1-2
TGCGCCAGCAGCCACAGGGGGCTTAATTCACCCCTCCACTTT	CASSHRGLNSPLHF	TRBV4-1	TRBJ1-6
TGTGCCACCAGTGATTTCGGTCTAAATGAGCAGTTCTTC	CATSDFGLNEQFF	TRBV24-1	TRBJ2-1
TGTGCCAGCAGTTTTTGGGCCAAAAACATTCAGTACTTC	CASSFWAKNIQYF	TRBV12-4	TRBJ2-4
TGTGCCAGCAGCTTAAGTTGGGGGGACAGGGTAAGCTCTGGGGCCAACGTCCTGACTTTC	CASSLSWGDRVSSGANVLTF	TRBV7-9	TRBJ2-6
TGCAGCGTTGACCCGGGACCTAGGATGGGCTATGGCTACACCTTC	CSVDPGPRMGYGYTF	TRBV29-1	TRBJ1-2
TGCAGCGTATCCGGGACGGGTGAAAAACTGTTTTTT	CSVSGTGEKLFF	TRBV29-1	TRBJ1-4
TGTGCCAGCAGTTTAAAGCCTGCGCCATACCCAGATACGCAGTATTTT	CASSLKPAPYPDTQYF	TRBV27	TRBJ2-3
TGTGCCACCAGCACCCCATGGATTTACAATGAGCAGTTCTTC	CATSTPWIYNEQFF	TRBV15	TRBJ2-1
TGTGCCAGCAGCCAAGCCCATGAGCAGTACTTC	CASSQAHEQYF	TRBV4-2	TRBJ2-7
TGTGCCAGCAGCACCCCGAAGGGGGGCTCCGGGGAGCTGTTTTTT	CASSTPKGGSGELFF	TRBV7-3	TRBJ2-2
TGTGCCACCGCCTCAGGGGTGAATAACACCGGGGAGCTGTTTTTT	CATASGVNNTGELFF	TRBV24-1	TRBJ2-2
TGTGCCAGCAGACCGTTCGCCCCGCGGGGGGGAGCCAGAGGCTACGAGCAGTACTTC	CASRPFAPRGGARGYEQYF	TRBV6-5	TRBJ2-7
TGCGCCAGCAGCGCCAACACAGATACGCAGTATTTT	CASSANTDTQYF	TRBV10-1	TRBJ2-3
TGTGCCAGCAGCACAGGGGGCGCAAAAGCTAACTATGGCTACACCTTC	CASSTGGAKANYGYTF	TRBV9	TRBJ1-2
TGTGCCAGCAGCCTTCCGGGGGACGAGCAGTACTTC	CASSLPGDEQYF	TRBV7-9	TRBJ2-7
TGCAGCGGACAGGGTTCCTATAGCAATCAGCCCCAGCATTTT	CSGQGSYSNQPQHF	TRBV29-1	TRBJ1-5
TGCAGTGCTAGAGATCGAGCCCAGGGGGAGAATGAGCAGTTCTTC	CSARDRAQGENEQFF	TRBV20-1	TRBJ2-1
TGTGCCACCGAAAGGGGACAGCACTACCGTACTAATGAAAAACTGTTTTTT	CATERGQHYRTNEKLFF	TRBV24-1	TRBJ1-4
TGCAGTGCTGGGGACGAGCAGTACTTC	CSAGDEQYF	TRBV20-1	TRBJ2-7
TGTGCCAGCAGCGCAGGGTTGAGCAATCAGCCCCAGCATTTT	CASSAGLSNQPQHF	TRBV7-3	TRBJ1-5
TGTGCCAGCAGTTTCCCTCGGGGGGGCGGCGAGCAGTACTTC	CASSFPRGGGEQYF	TRBV27	TRBJ2-7
TGTGCCAGCAGCTTAGGGACACCATACTATGGCTACACCTTC	CASSLGTPYYGYTF	TRBV7-2	TRBJ1-2
TGTGCCAGCAGTGAAGTGACTAGCGGCGGAGAAGAGCAGTACTTC	CASSEVTSGGEEQYF	TRBV6-4	TRBJ2-7
TGTGCCAGCACTCAGGGCTTGGGGCTTTCACCCCTCCACTTT	CASTQGLGLSPLHF	TRBV12-3	TRBJ1-6
TGTGCCAGCAGCACTCTCCAGGAGAAAGGCTACACCTTC	CASSTLQEKGYTF	TRBV9	TRBJ1-2
TGTGCCACCAGTGAGCAGGGCTTTCGCAACTATGGCTACACCTTC	CATSEQGFRNYGYTF	TRBV24-1	TRBJ1-2
TGTGCCAGCAGTGACCCCCTGGGGACGTCGACCGGGGAGCTGTTTTTT	CASSDPLGTSTGELFF	TRBV6-3	TRBJ2-2
TGCGCCAGCAGCTTTCTCCCCCGGGCTTACAATGAGCAGTTCTTC	CASSFLPRAYNEQFF	TRBV5-1	TRBJ2-1
TGTGCCAGCAGCGGCCCGACTAGCAGGGGATTCACAGATACGCAGTATTTT	CASSGPTSRGFTDTQYF	TRBV7-3	TRBJ2-3
TGTGCCAGCAGTGAATGGGACGGGCCGGCAGGGCGGAGCAATCAGCCCCAGCATTTT	CASSEWDGPAGRSNQPQHF	TRBV25-1	TRBJ1-5
TGTGCCAGCAGAGTCGGGGCCTTGGCAACTAATGAAAAACTGTTTTTT	CASRVGALATNEKLFF	TRBV7-3	TRBJ1-4
TGTGCCAGCAGCTTTCAGGGCAGGGGGTTTACCGGTTCTGAGCAGTTCTTC	CASSFQGRGFTGSEQFF	TRBV7-9	TRBJ2-1
TGTGCCAGCAGCGTAGCTAGTTTCAGGGACACTGAAGCTTTCTTT	CASSVASFRDTEAFF	TRBV9	TRBJ1-1
TGTGCCAGCAGCGTCCCTGGACTAGCGAGGGTAGCCAAAAACATTCAGTACTTC	CASSVPGLARVAKNIQYF	TRBV7-8	TRBJ2-4
TGCGCCAGCAGCTTGTATGGACAGGGCCGCCACACTGAAGCTTTCTTT	CASSLYGQGRHTEAFF	TRBV5-1	TRBJ1-1
TGTGCCAGCTTACAGGGATCTGTGTATCAGCCCCAGCATTTT	CASLQGSVYQPQHF	TRBV11-3	TRBJ1-5
TGTGCCAGCAGTCTAATAAGGGGCTATGGCTACACCTTC	CASSLIRGYGYTF	TRBV6-5	TRBJ1-2
TGTGCCATCGGAGCCAGATCCGAATTTCAGCCCCAGCATTTT	CAIGARSEFQPQHF	TRBV10-3	TRBJ1-5
TGTGCCAGCAGTGCCATTGGATCAGACCGGACCAATGAGCAGTTCTTC	CASSAIGSDRTNEQFF	TRBV6-8	TRBJ2-1
TGTGCCAGCAATCGGGATACGAGGGCCAGGAGAAGCCCGGCCTACGAGCAGTACTTC	CASNRDTRARRSPAYEQYF	TRBV27	TRBJ2-7
TGCGCCAGCAGCTGCGCGGGGGGGCAACCTGAGCAGTTCTTC	CASSCAGGQPEQFF	TRBV5-1	TRBJ2-1
TGTGCCAGCAGTAGGCTCCAAGAGACCCAGTACTTC	CASSRLQETQYF	TRBV6-5	TRBJ2-5
TGTGCCTGGAGCAATCAGCCCCAGCATTTT	CAWSNQPQHF	TRBV30	TRBJ1-5
TGTGCCAGCAGTGCTACCCCCCAAAGGACTTGTACAGCTAACTATGGCTACACCTTC	CASSATPQRTCTANYGYTF	TRBV6-4	TRBJ1-2
TGTGCCAGCCTGGGGGGGGGCGACGGGCCGAACACAGATACGCAGTATTTT	CASLGGGDGPNTDTQYF	TRBV7-3	TRBJ2-3
TGTGCCTGGACTAGCGGGCGCACCGGGGAGCTGTTTTTT	CAWTSGRTGELFF	TRBV30	TRBJ2-2
TGTGCCAGCAGCTCCTCGGGGGGGGTTCGCAATCAGCCCCAGCATTTT	CASSSSGGVRNQPQHF	TRBV5-4	TRBJ1-5
TGTGCCAGCACCCCGCCCAGGGGTCAGACCTACAATGAGCAGTTCTTC	CASTPPRGQTYNEQFF	TRBV6-4	TRBJ2-1
TGTGCCAGCAGCCAAGTCGGAAGGAGCGGTCGACCCCGAGACGAGCAGTACTTC	CASSQVGRSGRPRDEQYF	TRBV3-1	TRBJ2-7
TGTGCCAGCAGCTTACGAGGACTGACTGGGAACACTGAAGCTTTCTTT	CASSLRGLTGNTEAFF	TRBV11-2	TRBJ1-1
TGTGCCAGCAGCAGCAAAAGGGACAGAGTCTACGAGCAGTACTTC	CASSSKRDRVYEQYF	TRBV13	TRBJ2-7
TGTGCCAGCAGCCGGGAAGGGAACACTGAAGCTTTCTTT	CASSREGNTEAFF	TRBV3-1	TRBJ1-1
TGTGCCAGCAGTCCCGGGACGTGCGATGAAAAACTGTTTTTT	CASSPGTCDEKLFF	TRBV28	TRBJ1-4
TGTGCCAGCAGCGTAGATAGGGCTCCCTGCAATCAGCCCCAGCATTTT	CASSVDRAPCNQPQHF	TRBV9	TRBJ1-5
TGTGCCAGCAGTTTCCATAGGGGCGATCAGCCCCAGCATTTT	CASSFHRGDQPQHF	TRBV12-4	TRBJ1-5
TGTGCCAGCAGTTACCCGGTTAATCTAGCGGGGTCGGGGGACGGGGAGCTGTTTTTT	CASSYPVNLAGSGDGELFF	TRBV6-5	TRBJ2-2
TGTGCCAGCAGTTTATGTGACCCAGGGGTGAGTCCACTAGCCAAAAACATTCAGTACTTC	CASSLCDPGVSPLAKNIQYF	TRBV28	TRBJ2-4
TGTGCCAGCAGAACACAGGGTCCTTCGTACAATGAGCAGTTCTTC	CASRTQGPSYNEQFF	TRBV6-4	TRBJ2-1
TGCAGTGCTGGGGAGGCTCCGCAGTTCTTC	CSAGEAPQFF	TRBV20-1	TRBJ2-1
TGTGCCAGCAGTTTACCCGGGGAAGCCAAGAACACTGAAGCTTTCTTT	CASSLPGEAKNTEAFF	TRBV27	TRBJ1-1
TGTGCCACCCCCCGCGGATCTGGGGCCGAGTACGAGCAGTACTTC	CATPRGSGAEYEQYF	TRBV7-9	TRBJ2-7
TGTGCCAGTACGGGACAGGGGTGGAGATCTGTAAAACTGTTTTTT	CASTGQGWRSVKLFF	TRBV27	TRBJ1-4
TGTGCCAGCAGTGACTCTGAACTAGCGGGAGGGCGGGACTATGGCTACACCTTC	CASSDSELAGGRDYGYTF	TRBV6-4	TRBJ1-2
TGTGCCAGCGGGACGTTCCCTGAAGCTTTCTTT	CASGTFPEAFF	TRBV12-4	TRBJ1-1
TGTGCCAGCAGCGCCACCCTGGAGGGGTGGCGCACCGGGGAGCTGTTTTTT	CASSATLEGWRTGELFF	TRBV9	TRBJ2-2
TGTGCCAGCCGCCCGAGGGGAGAGACCCAGTACTTC	CASRPRGETQYF	TRBV5-6	TRBJ2-5
TGTGCCAGCACGGAGGGAGGGGTCAATCAGCCCCAGCATTTT	CASTEGGVNQPQHF	TRBV2	TRBJ1-5
TGTGCCAGCAGCCAGGGTTTCTATACCTACGAGCAGTACTTC	CASSQGFYTYEQYF	TRBV18	TRBJ2-7
TGTGCCAGCAGTGAAGCGTTATCCGGGGGAACTACCTATGGCTACACCTTC	CASSEALSGGTTYGYTF	TRBV6-1	TRBJ1-2
TGTGCCAGCTCCTGGACAGCTCAGCCCCAGCATTTT	CASSWTAQPQHF	TRBV6-1	TRBJ1-5
TGTGCCACCAGTGAGATCAGGGGAGCTAACTATGGCTACACCTTC	CATSEIRGANYGYTF	TRBV24-1	TRBJ1-2
TGTGCCAGCAGCCAAGCAAGCAGGGAGAGACCCTACGAGCAGTACTTC	CASSQASRERPYEQYF	TRBV14	TRBJ2-7
TGTGCCAGCAGTTACATAGACAGGGGGCTCCTCACTGAAGCTTTCTTT	CASSYIDRGLLTEAFF	TRBV6-5	TRBJ1-1
TGCAGCGTTGACCCTTGGGGGGTCAATGAAAAACTGTTTTTT	CSVDPWGVNEKLFF	TRBV29-1	TRBJ1-4
TGTGCCAGCAGCTTAGGGACTAGCGTATATGAGCAGTTCTTC	CASSLGTSVYEQFF	TRBV7-2	TRBJ2-1
TGTGCCAGCAGCGGCACCATACCGGGACAGAACACTGAAGCTTTCTTT	CASSGTIPGQNTEAFF	TRBV13	TRBJ1-1
TGTGCCAGCACATTTTCCGCAGGGGTGACGGAACTGTTTTTT	CASTFSAGVTELFF	TRBV5-5	TRBJ1-4
TGCGCCAGCAGCCAAGCCCGGGAAGGACATAATCAGCCCCAGCATTTT	CASSQAREGHNQPQHF	TRBV4-1	TRBJ1-5
TGCAGTGCTAGAGATGTGAAGGTTGGGACGGGTTTTCATGGCTACACCTTC	CSARDVKVGTGFHGYTF	TRBV20-1	TRBJ1-2
TGTGCCTGCCTCCGGGACACCGGGGAGCTGTTTTTT	CACLRDTGELFF	TRBV30	TRBJ2-2
TGTGCCAGCAGCTTCGGGGGTACGGAATCGTTATACACTGAAGCTTTCTTT	CASSFGGTESLYTEAFF	TRBV5-6	TRBJ1-1
TGTGCCAGCAGCTTATACTCCAGGGCAGGGCCCGCCTCTGGAAACACCATATATTTT	CASSLYSRAGPASGNTIYF	TRBV7-2	TRBJ1-3
TGTGCCAGCTACCACAATGAGCAGTTCTTC	CASYHNEQFF	TRBV5-8	TRBJ2-1
TGTGCCGGTAGGGGGGGTCTCAATCAGCCCCAGCATTTT	CAGRGGLNQPQHF	TRBV6-1	TRBJ1-5
TGCAGCGTTGAAGATCTCTGGGGGCAGGGGGAAGGGGGGAATGAAAAACTGTTTTTT	CSVEDLWGQGEGGNEKLFF	TRBV29-1	TRBJ1-4
TGTGCCAGCAGAAAGGGGGTAGAGACCCAGTACTTC	CASRKGVETQYF	TRBV28	TRBJ2-5
TGTGCCAGCAGCTTGGCCTGGTTAGGAGGAGGTGCGTATGGCTACACCTTC	CASSLAWLGGGAYGYTF	TRBV5-5	TRBJ1-2
TGTGCGGGAGGGACGGCCTATGGCTACACCTTC	CAGGTAYGYTF	TRBV2	TRBJ1-2
TGTGCCAGCAGTTTATCGGGTACGCGACGATGGAATGAGCAGTTCTTC	CASSLSGTRRWNEQFF	TRBV27	TRBJ2-1
TGTGCCAGCAGCCGGAGGGGGTGGGCCAAAAACATTCAGTACTTC	CASSRRGWAKNIQYF	TRBV6-2	TRBJ2-4
TGTGCCAGCAGTGAGGGGGGGGAAACGCTCAGGAAAACTGGAAACACCATATATTTT	CASSEGGETLRKTGNTIYF	TRBV2	TRBJ1-3
TGTGCCAGCAGCCTTATTTGGACTAGCGGGGGACCCAGATACAATGAGCAGTTCTTC	CASSLIWTSGGPRYNEQFF	TRBV3-1	TRBJ2-1
TGTGCCAGCAGCTTAGGGCCAGGGGTTAGGGGTCAGCCCCAGCATTTT	CASSLGPGVRGQPQHF	TRBV7-8	TRBJ1-5
TGTGCCAGTACCCGGGACAGGGGATTGAACACTGAAGCTTTCTTT	CASTRDRGLNTEAFF	TRBV19	TRBJ1-1
TGTGCCAGCAGCTACTTCTGGGCCCGTGAGCAGTTCTTC	CASSYFWAREQFF	TRBV5-6	TRBJ2-1
TGTGCCAGCAGTTTACTTCTCCGGGACAGGGGTACTAATGAAAAACTGTTTTTT	CASSLLLRDRGTNEKLFF	TRBV12-4	TRBJ1-4
TGTGCCAGCAGCCAAGATACCCTGGAACCTCCCGGGAGTCAGCCCCAGCATTTT	CASSQDTLEPPGSQPQHF	TRBV14	TRBJ1-5
TGTGCCACGCCCCCAGGTGAAAGCTCCTACGAGCAGTACTTC	CATPPGESSYEQYF	TRBV24-1	TRBJ2-7
TGTGCCAGCAGCTTAGAGCCCGAGAAACGCGCAGATACGCAGTATTTT	CASSLEPEKRADTQYF	TRBV7-4	TRBJ2-3
TGTGCCAGTAGGAGACAGGGGGCAGGTAGCAATCAGCCCCAGCATTTT	CASRRQGAGSNQPQHF	TRBV19	TRBJ1-5
TGTGCCAGCAGCTACCAGGGGCCCCTCCACTTT	CASSYQGPLHF	TRBV11-2	TRBJ1-6
TGCGCCAGCAGACCGGGACAGGGGTGGGGCTACACCTTC	CASRPGQGWGYTF	TRBV4-1	TRBJ1-2
TGTGTAGGCCCCTTCTCTGGGGCCAACGTCCTGACTTTC	CVGPFSGANVLTF	TRBV2	TRBJ2-6
TGTGCCAGCAGCCCCGGACAGGGTATCTATGGCTACACCTTC	CASSPGQGIYGYTF	TRBV13	TRBJ1-2
TGCAGCGTTGAAGCCGCGGGGCGAAAGGCCAACGTCCTGACTTTC	CSVEAAGRKANVLTF	TRBV29-1	TRBJ2-6
TGTGCCTGGAGTATATTCAGGGACCTGAACACTGAAGCTTTCTTT	CAWSIFRDLNTEAFF	TRBV30	TRBJ1-1
TGTGCCAGCAGTCGACCTCCCCGGGAGGTCTTC	CASSRPPREVF	TRBV14	TRBJ2-1
TGTGCCTGGAGCAGGGTCCCGGGACAGGGGAATACGAACACCGGGGAGCTGTTTTTT	CAWSRVPGQGNTNTGELFF	TRBV30	TRBJ2-2
TGCAGTGCTAGAGGAACAGGGACCGAATCAGGCTACACCTTC	CSARGTGTESGYTF	TRBV20-1	TRBJ1-2
TGTGCCAGCAGTTTACGAACGAGGGAAGAGACCCAGTACTTC	CASSLRTREETQYF	TRBV27	TRBJ2-5
TGTGCCAGCATTGTGATTTGGACAGGGGGAGGAGGCTACGAGCAGTACTTC	CASIVIWTGGGGYEQYF	TRBV6-4	TRBJ2-7
TGTGCCAGCCCCGGACAGTATAGCAATCAGCCCCAGCATTTT	CASPGQYSNQPQHF	TRBV6-4	TRBJ1-5
TGTGCCAGCAGGGCCGGGACTAGCGGGAGGGGGACCCAAGAGACCCAGTACTTC	CASRAGTSGRGTQETQYF	TRBV7-9	TRBJ2-5
TGTGCCAGCAGCGGGACTAGACCTTACGAGCAGTACTTC	CASSGTRPYEQYF	TRBV13	TRBJ2-7
TGCAGTGCTAGAGGGACAGGGGCGAATTCACCCCTCCACTTT	CSARGTGANSPLHF	TRBV20-1	TRBJ1-6
TGCAGTGCTATTTGGGACAGTGGAGAGACCCAGTACTTC	CSAIWDSGETQYF	TRBV20-1	TRBJ2-5
TGCAGCGCAACCAGGGACTATTCAGATACGCAGTATTTT	CSATRDYSDTQYF	TRBV29-1	TRBJ2-3
TGTGCCAGCAAATCGACTAGCGGATTTATCGGGTACAATGAGCAGTTCTTC	CASKSTSGFIGYNEQFF	TRBV5-4	TRBJ2-1
TGTGCCAGCAGTGCTCCGGGACAGCGAGTAGGCTACACCTTC	CASSAPGQRVGYTF	TRBV2	TRBJ1-2
TGCAGTGCTAGCACCGGACCAGGGGTGGTTCCAAATCAGCCCCAGCATTTT	CSASTGPGVVPNQPQHF	TRBV20-1	TRBJ1-5
TGCGCCAGCAGTGAGCCTTGGGGCCAGGAGACCCAGTACTTC	CASSEPWGQETQYF	TRBV10-1	TRBJ2-5
TGTGCCAGCAGCTCCGGACATGTACCGGGACAAGCTGAAGCTTTCTTT	CASSSGHVPGQAEAFF	TRBV11-2	TRBJ1-1
TGTGCCAGTGGGCGAGGCGGGACAAACCTAAGAATGGGAGAGACCCAGTACTTC	CASGRGGTNLRMGETQYF	TRBV19	TRBJ2-5
TGTGCCAGCAGCCCCCCCTATAACACCGGGGAGCTGTTTTTT	CASSPPYNTGELFF	TRBV3-1	TRBJ2-2
TGTGCCAGCAGCCACAGGGGAGCTGGCTCAACTAATGAAAAACTGTTTTTT	CASSHRGAGSTNEKLFF	TRBV3-1	TRBJ1-4
TGTGCCAGCAGCTCAACTTTCGCCGGGGAGCTGTTTTTT	CASSSTFAGELFF	TRBV11-2	TRBJ2-2
TGTGCCAGCAGCCGACAGGGGGAGTCTTCCCGGAGTCAGCCCCAGCATTTT	CASSRQGESSRSQPQHF	TRBV7-9	TRBJ1-5
TGTGCCAGCAGTTACAGTGGAACCCTACATTCTAGCAATCAGCCCCAGCATTTT	CASSYSGTLHSSNQPQHF	TRBV6-3	TRBJ1-5
TGCGCCAGCAGGGGGACAGGGTATTGCCCCCAGTACTTC	CASRGTGYCPQYF	TRBV10-1	TRBJ2-5
TGTGCCAGCAGCCGTGATGGGGCACGACGTCAGTGGAACACTGAAGCTTTCTTT	CASSRDGARRQWNTEAFF	TRBV7-9	TRBJ1-1
TGCAGTGCTAGACCCCTCCGGGACATCCGGAATACGCAGTATTTT	CSARPLRDIRNTQYF	TRBV20-1	TRBJ2-3
TGTGCCAGCAGCTTAGGCCCGGGACAGGGGCTCTACGAGCAGTACTTC	CASSLGPGQGLYEQYF	TRBV7-2	TRBJ2-7
TGCAGTGCTAGAGCCAGGGGGGGCCTGAGCGACAATGAGCAGTTCTTC	CSARARGGLSDNEQFF	TRBV20-1	TRBJ2-1
TGTGCCAGTAGTATAGTACGTGGGGTATGGACGAACACCGGGGAGCTGTTTTTT	CASSIVRGVWTNTGELFF	TRBV19	TRBJ2-2
TGTGCCAGCAGGCCCCTCGCTGGGGCCAACGTCCTGACTTTC	CASRPLAGANVLTF	TRBV6-2	TRBJ2-6
TGTGCCAGCAGATGGACTAGCGGGTTACAAGAGACCCAGTACTTC	CASRWTSGLQETQYF	TRBV6-4	TRBJ2-5
TGCGCCACAGGTGGCTACACCTTC	CATGGYTF	TRBV10-1	TRBJ1-2
TGCGCCAGCAGTAACCCCAGGGATGGAGGGTTTTGGGGGGGTTTTAAGGACAATCAGCCCCAGCATTTT	CASSNPRDGGFWGGFKDNQPQHF	TRBV10-2	TRBJ1-5
TGTGCCAGCAGTGATATCTTTCCAGGGGGTTGCGGAAACACCATATATTTT	CASSDIFPGGCGNTIYF	TRBV6-4	TRBJ1-3
TGCGCCAGCAGCGGGTCCCGGGACAGGGAATCACCCCTCCACTTT	CASSGSRDRESPLHF	TRBV5-1	TRBJ1-6
TGTGCCAGCAGTTTGGCTCCCCCTCGGGACAGGGGGCACGGCTCTGGAAACACCATATATTTT	CASSLAPPRDRGHGSGNTIYF	TRBV27	TRBJ1-3
TGTGCCAAGGGACAGGGGGCAACTAATGAAAAACTGTTTTTT	CAKGQGATNEKLFF	TRBV27	TRBJ1-4
TGCGCCAGCAGCCAAGATGGCCAGGGTCCCTTGTCGTATGGCTACACCTTC	CASSQDGQGPLSYGYTF	TRBV4-1	TRBJ1-2
TGTGCCAGCAGCGCCGTGAGCGGTGGCTACGAGCAGTACTTC	CASSAVSGGYEQYF	TRBV9	TRBJ2-7
TGTGCCAGCAGCCAAGATGTCCCCCAGGGAACGGTGAACACTGAAGCTTTCTTT	CASSQDVPQGTVNTEAFF	TRBV4-2	TRBJ1-1
TGCGCCAGCATACTGGAGGGGGGGCATGAGCAGTTCTTC	CASILEGGHEQFF	TRBV10-1	TRBJ2-1
TGTGCCAGCAGCTTAGATCCCTGTCCCCGAATGAGACTCACTGAAGCTTTCTTT	CASSLDPCPRMRLTEAFF	TRBV11-2	TRBJ1-1
TGTGCCAGCAGTTTATCTTCCGATACGCAGTATTTT	CASSLSSDTQYF	TRBV27	TRBJ2-3
TGCAGTGGCTGCGAGGCGGGGGTGCAGCCCCAGCATTTT	CSGCEAGVQPQHF	TRBV20-1	TRBJ1-5
TGTGCCAGATCGACCCGGCCCAATGAGCAGTTCTTC	CARSTRPNEQFF	TRBV25-1	TRBJ2-1
TGTGCCAGCAGTCCTGTCAGGCCAGGCTACACCTTC	CASSPVRPGYTF	TRBV27	TRBJ1-2
TGTGCCAAAGCCGGGACAGGGGGCGCCCCGCTGAACACTGAAGCTTTCTTT	CAKAGTGGAPLNTEAFF	TRBV18	TRBJ1-1
TGTGCCAGCAGCTTCCTTTCCCGACACACAGATACGCAGTATTTT	CASSFLSRHTDTQYF	TRBV11-2	TRBJ2-3
TGTGCCAGCAGCTATGAAGGTCGGGCTGATTCACCCCTCCACTTT	CASSYEGRADSPLHF	TRBV7-2	TRBJ1-6
TGCAGCGTTGGGGGGGGACACAATGAGCAGTTCTTC	CSVGGGHNEQFF	TRBV29-1	TRBJ2-1
TGCAAGGGGGCGAGGTTTCCAAGCAATCAGCCCCAGCATTTT	CKGARFPSNQPQHF	TRBV20-1	TRBJ1-5
TGCAGTGCTAGGTGGAGGAGGGTACAGAACACTGAAGCTTTCTTT	CSARWRRVQNTEAFF	TRBV20-1	TRBJ1-1
TGTGCCAGCAGTTTAAGCGGGACAGGGAAAATGAACACTGAAGCTTTCTTT	CASSLSGTGKMNTEAFF	TRBV27	TRBJ1-1
TGTGCTAGTGGTTTGGTAGACCCGGGACGACGGGGACGTACAGATACGCAGTATTTT	CASGLVDPGRRGRTDTQYF	TRBV12-5	TRBJ2-3
TGCGCCAGCAGCCAATCAGCGGCTGACAGCCTCCGGGGTGGAAACACCATATATTTT	CASSQSAADSLRGGNTIYF	TRBV5-1	TRBJ1-3
TGCGCCAGCAGCCCGGGTAGGGACAATGAGCAGTTCTTC	CASSPGRDNEQFF	TRBV4-3	TRBJ2-1
TGTGCCAGCGTCCGGATCGCCCAGCATTTT	CASVRIAQHF	TRBV25-1	TRBJ1-5
TGTGCCAGCACCGACAGGGGTAGTTCTGGGGCCAACGTCCTGACTTTC	CASTDRGSSGANVLTF	TRBV6-1	TRBJ2-6
TGTGCCAGCAGTTACTCCCGGGGGCTTACGAGCAATCAGCCCCAGCATTTT	CASSYSRGLTSNQPQHF	TRBV6-5	TRBJ1-5
TGTGCCAGCAGCCCACTAGCGGGAGGAAAAAATCAGCCCCAGCATTTT	CASSPLAGGKNQPQHF	TRBV11-3	TRBJ1-5
TGTGCCAGCAGTTTCCTCAAGATCGTTGTCGTCTCACGCAATCAGCCCCAGCATTTT	CASSFLKIVVVSRNQPQHF	TRBV28	TRBJ1-5
TGTGCCAGCTCACCACCGCAGGAAATCGGAAACACCATATATTTT	CASSPPQEIGNTIYF	TRBV18	TRBJ1-3
TGTGCCAGCAGTTACTTAGGTGGGACAGATGAAGCTTTCTTT	CASSYLGGTDEAFF	TRBV6-5	TRBJ1-1
TGCGCCAGCAGCTCGACGGACCATGAGCAGTTCTTC	CASSSTDHEQFF	TRBV5-1	TRBJ2-1
TGTGCCAGCAGGGGAGCGGTTGCAGGTCACGGGGAGCTGTTTTTT	CASRGAVAGHGELFF	TRBV11-3	TRBJ2-2
TGTGCCAGCAGGGACAGGGTCGAGGCAGATACGCAGTATTTT	CASRDRVEADTQYF	TRBV9	TRBJ2-3
TGCGCCAGCAGCTTGGGAGGGCCTCCCCAAGAGACCCAGTACTTC	CASSLGGPPQETQYF	TRBV5-1	TRBJ2-5
TGTGCCAGCAGCTTTCCGAGGGAGCGGGAGGCCGTCTCCTACAATGAGCAGTTCTTC	CASSFPREREAVSYNEQFF	TRBV7-8	TRBJ2-1
TGTGCCACCAGTGAGCGTCAGAAGGTCTTTCCTAATGAAAAACTGTTTTTT	CATSERQKVFPNEKLFF	TRBV24-1	TRBJ1-4
TGTGCCAGCAGCGTAGCTATCCCCGGGGGGTGGAGCTATGGCTACACCTTC	CASSVAIPGGWSYGYTF	TRBV9	TRBJ1-2
TGCGCCAGCAGCTTCGCTCTGACGGATGAGCAGTTCTTC	CASSFALTDEQFF	TRBV5-1	TRBJ2-1
TGTGCCAGCATTCTTATAGGACAAGAGACCCAGTACTTC	CASILIGQETQYF	TRBV6-1	TRBJ2-5
TGCGCCAGCGGCCCTAGCGGGGCCTACGAGCAGTACTTC	CASGPSGAYEQYF	TRBV10-1	TRBJ2-7
TGTGCCAGTAGTATGGACAGGGGAGGGTTCTATGGCTACACCTTC	CASSMDRGGFYGYTF	TRBV19	TRBJ1-2
TGCAGCGTTGGGAGACTAGCGGGGACCTACGAGCAGTACTTC	CSVGRLAGTYEQYF	TRBV29-1	TRBJ2-7
TGTGCCAGCAGCTTGCTTCTGGGGCCGGGGGAGAATGAAAAACTGTTTTTT	CASSLLLGPGENEKLFF	TRBV5-6	TRBJ1-4
TGTGCCCCCGGGGGAGAGCACAGAAAGCAGTTCTTC	CAPGGEHRKQFF	TRBV10-3	TRBJ2-1
TGCGCCAGCAGGATGGGGGGCGGTGGGGGGGGGGTGAACTCCTACAATGAGCAGTTCTTC	CASRMGGGGGGVNSYNEQFF	TRBV5-1	TRBJ2-1
TGCGCCAGCAGCCAAGGAGCTAAAAGGGGCGCACGCTACGAGCAGTACTTC	CASSQGAKRGARYEQYF	TRBV4-1	TRBJ2-7
TGTGCCAGCAGTCGAGCCGGGACAGCCGTGGGAAGGAAGATGAACACTGAAGCTTTCTTT	CASSRAGTAVGRKMNTEAFF	TRBV27	TRBJ1-1
TGTGGGGGTGGGGCTCAAGCCGGGGAGCTGTTTTTT	CGGGAQAGELFF	TRBV12-3	TRBJ2-2
TGTGCCAGAGTTCGACAGGGCTCCCCCTACGAGCAGTACTTC	CARVRQGSPYEQYF	TRBV25-1	TRBJ2-7
TGCAGTGCTAGACCGCCACTAGATAGATTGCCTGAGCAGTTCTTC	CSARPPLDRLPEQFF	TRBV20-1	TRBJ2-1
TGCGCCAGCAGCCAAGATGGGACAGGCTATGGCTACACCTTC	CASSQDGTGYGYTF	TRBV4-3	TRBJ1-2
TGTGCTAGTGGTTCCAGAAGGCCTTACAGGGGAGAACAAGAGACCCAGTACTTC	CASGSRRPYRGEQETQYF	TRBV12-5	TRBJ2-5
TGTGCCAGCAATTCACTAGATGACGGGGAGCTGTTTTTT	CASNSLDDGELFF	TRBV2	TRBJ2-2
TGCGCCAGCAGCAGGCAGGGGGGGCCAGACGAGCAGTACTTC	CASSRQGGPDEQYF	TRBV5-1	TRBJ2-7
TGTGCCAGCAGCCACCTAGCCCGGGGACTAGCGGGGGTACCCTACAATGAGCAGTTCTTC	CASSHLARGLAGVPYNEQFF	TRBV3-1	TRBJ2-1
TGCAGTGCTAGAGTAAGGGAGCTAGCGGAGCAGTTCTTC	CSARVRELAEQFF	TRBV20-1	TRBJ2-1
TGTGCCAGTAGTTTGTCTAGCGGGGGCTGCCACTCCTACGAGCAGTACTTC	CASSLSSGGCHSYEQYF	TRBV19	TRBJ2-7
TGTGCCTGGAGTGTAAGGGGACATTGCGAGCAGTACTTC	CAWSVRGHCEQYF	TRBV30	TRBJ2-7
TGTGCCAGCAGCGTCAAACATCAGGCTAGCACAGATACGCAGTATTTT	CASSVKHQASTDTQYF	TRBV9	TRBJ2-3
TGTGCCAGCAGCGGGGGGGAGGTAGCTTTCTTT	CASSGGEVAFF	TRBV7-9	TRBJ1-1
TGTGCCACTATCAGAGGCTACACCTTC	CATIRGYTF	TRBV24-1	TRBJ1-2
TGTGCCAGCAGCCCCCTTAATTCAAATTCACCCCTCCACTTT	CASSPLNSNSPLHF	TRBV7-3	TRBJ1-6
TGTGCCAGCAGAGGGGTAAGAGGCTACGAGCAGTACTTC	CASRGVRGYEQYF	TRBV2	TRBJ2-7
TGTGCCAGCAGTTGTTTTTCGCGGGAGCGAGAGCAGTACTTC	CASSCFSREREQYF	TRBV6-5	TRBJ2-7
TGTGCCATCAGTGAGCCGGGGGGGGGACGGGAGACCCAGTACTTC	CAISEPGGGRETQYF	TRBV10-3	TRBJ2-5
TGTGCCAGCAAAAAGGATAACTATGGCTACACCTTC	CASKKDNYGYTF	TRBV5-6	TRBJ1-2
TGCAGTGCTAGAGATCCCCACAGGGAGCTAGCTTTCTTT	CSARDPHRELAFF	TRBV20-1	TRBJ1-1
TGTGCCACCCACCAGGATAATGAGCAGTTCTTC	CATHQDNEQFF	TRBV24-1	TRBJ2-1
TGCAGTGCTCGGAGCCAGAGGGGCCCGACAGTCTTCTCCTACAATGAGCAGTTCTTC	CSARSQRGPTVFSYNEQFF	TRBV20-1	TRBJ2-1
TGTGCCAGCAGTGGAAGACAGGGCGATCATAATTCACCCCTCCACTTT	CASSGRQGDHNSPLHF	TRBV6-4	TRBJ1-6
TGTGCCAGCATATGGGGACACCACTCTGGAAACACCATATATTTT	CASIWGHHSGNTIYF	TRBV6-2	TRBJ1-3
TGCAGTGCTAGAGATCCTAGACCCTACGAGCAGTACTTC	CSARDPRPYEQYF	TRBV20-1	TRBJ2-7
TGTGCCAGCAGAGAGGCGAAATCGGGGGGCTACACCTTC	CASREAKSGGYTF	TRBV12-3	TRBJ1-2
TGCGCCAGCAGCCAAGAGGGACAGGTAAAAGGCTCCTATAATTCACCCCTCCACTTT	CASSQEGQVKGSYNSPLHF	TRBV4-1	TRBJ1-6
TGCGCCAGCCGGCGGGGTTTAATATATAGCAATCAGCCCCAGCATTTT	CASRRGLIYSNQPQHF	TRBV5-1	TRBJ1-5
TGTGCCAGCCCGTTTGACCGGGAGACCTGTGGCTACACCTTC	CASPFDRETCGYTF	TRBV9	TRBJ1-2
TGTGCCACCAGGTATCGGGACAGGCTCTCCTACGAGCAGTACTTC	CATRYRDRLSYEQYF	TRBV24-1	TRBJ2-7
TGCGCCAGCAGTTGCAGGGGTATTCAGGACAACACTGAAGCTTTCTTT	CASSCRGIQDNTEAFF	TRBV10-1	TRBJ1-1
TGTGCCAGCAGTTACAAAACAGCGAGGAACACTGAAGCTTTCTTT	CASSYKTARNTEAFF	TRBV6-5	TRBJ1-1
TGTGCCCGACCCTCCCCCGCGGGAGCTATGTATGGCTACACCTTC	CARPSPAGAMYGYTF	TRBV25-1	TRBJ1-2
TGCGCCAGCAGCCTTAAGCGGGAGTTCGAGCAGTACTTC	CASSLKREFEQYF	TRBV5-1	TRBJ2-7
TGCAGTGCTAGTAAAGGGGGGCTACCAACTGTCGTCCCCCACGAGCAGTACTTC	CSASKGGLPTVVPHEQYF	TRBV20-1	TRBJ2-7
TGCAGCGTTGCAAGCGGAAAAGGGGGCCACGCTAACTATGGCTACACCTTC	CSVASGKGGHANYGYTF	TRBV29-1	TRBJ1-2
TGTGCCAGCATTGGCGGGGGGTGGCCCCAAGAGACCCAGTACTTC	CASIGGGWPQETQYF	TRBV28	TRBJ2-5
TGTGCCAGCAGTTTCCCGGCCGGGCCTATGGCGGGGGGGGAGACCCAGTACTTC	CASSFPAGPMAGGETQYF	TRBV28	TRBJ2-5
TGTGCCAGCAGTCACAGGGGATTGGAAGAGACCCAGTACTTC	CASSHRGLEETQYF	TRBV3-1	TRBJ2-5
TGTGCCAGCAGCCCCCCTAATTGGACGGAAACATCCTACGAGCAGTACTTC	CASSPPNWTETSYEQYF	TRBV14	TRBJ2-7
TGTGCCAGCAGTGAGGCGACGGGAGACTCCTACGAGCAGTACTTC	CASSEATGDSYEQYF	TRBV6-4	TRBJ2-7
TGTGCCAGCAGCCGCGGGGCGGAGGTACTGTTGATGGCGGGGCTGAACGCAGATACGCAGTATTTT	CASSRGAEVLLMAGLNADTQYF	TRBV14	TRBJ2-3
TGTGCCAGCATGGGGAGGAGGGTGGGTCTCAACGCTTACAATGAGCAGTTCTTC	CASMGRRVGLNAYNEQFF	TRBV6-4	TRBJ2-1
TGTGCCAGCAGTGACAACAAAGGACATACAGCAGAGACCCAGTACTTC	CASSDNKGHTAETQYF	TRBV6-4	TRBJ2-5
TGTGCCAGCAGTTTATTTTCGGTACTAGCGGGCGAAAACAGGTCCTACGAGCAGTACTTC	CASSLFSVLAGENRSYEQYF	TRBV12-4	TRBJ2-7
TGTGCCAGCAGCTTAGCCCGGGGGGGATTCCTGTCCTACAATGAGCAGTTCTTC	CASSLARGGFLSYNEQFF	TRBV7-6	TRBJ2-1
TGTGCCAGCAGCCCGGGGCTGGTGCAAGAGACCCAGTACTTC	CASSPGLVQETQYF	TRBV5-8	TRBJ2-5
TGCGCCAGCAGTGATCGTGCCCTTGGGACCTCCTACGAGCAGTACTTC	CASSDRALGTSYEQYF	TRBV10-1	TRBJ2-7
TGTGCCATCCAGGACCCGGTCTATGGCTACACCTTC	CAIQDPVYGYTF	TRBV19	TRBJ1-2
TGTGCCAGCAGCTTAATGATCCTAAAAACAGATACGCAGTATTTT	CASSLMILKTDTQYF	TRBV11-2	TRBJ2-3
TGTGCCAGCAGCATTTTCAGAAATCAGCCCCAGCATTTT	CASSIFRNQPQHF	TRBV13	TRBJ1-5
TGTGCCAGCAGTCGCAGTACGACTCCTAATGAGCAGTTCTTC	CASSRSTTPNEQFF	TRBV27	TRBJ2-1
TGTGCCACCAGTGAATCCGTTTATGGAGCTTTCTTT	CATSESVYGAFF	TRBV24-1	TRBJ1-1
TGTGCCAGCAGTGACGATGGGACAGTGGGCTACACCTTC	CASSDDGTVGYTF	TRBV6-4	TRBJ1-2
TGTGCCATCAGTGTCGGGGTGAACGATAGCAATCAGCCCCAGCATTTT	CAISVGVNDSNQPQHF	TRBV10-3	TRBJ1-5
TGTGCCACCATGAAAAGCGGGTGGGGGGGAGCCAAAAACATTCAGTACTTC	CATMKSGWGGAKNIQYF	TRBV24-1	TRBJ2-4
TGTGCCAGCAGGCGCCAGGAATGCTCCTACGAGCAGTACTTC	CASRRQECSYEQYF	TRBV27	TRBJ2-7
TGTGCCAGCAGCTGGCGGTCTGCTCCCGAGTACGAGCAGTACTTC	CASSWRSAPEYEQYF	TRBV7-3	TRBJ2-7
TGTGCCAGCAGATTTGAACAAGCTGAAGCTTTCTTT	CASRFEQAEAFF	TRBV2	TRBJ1-1
TGTGCCAGCAGCTGGATAGTTAGACAGGGGGGGTACGAGCAGTACTTC	CASSWIVRQGGYEQYF	TRBV7-9	TRBJ2-7
TGTGCCAGCAGCCAAGATAAAGTGCAAACAGATACGCAGTATTTT	CASSQDKVQTDTQYF	TRBV14	TRBJ2-3
TGTGCCAGCAGCTTAGCTCGGCGACACTCTTCCTACGAGCAGTACTTC	CASSLARRHSSYEQYF	TRBV7-2	TRBJ2-7
TGCGCCTCCGACAAAATTGGAAACACCATATATTTT	CASDKIGNTIYF	TRBV10-1	TRBJ1-3
TGTGCCAGCAGTTACTCGACCAGCGGGAATTATACCTACAATGAGCAGTTCTTC	CASSYSTSGNYTYNEQFF	TRBV6-5	TRBJ2-1
TGTGCCAGCAGCGGGGACAGGGGTAGATGTAATTCACCCCTCCACTTT	CASSGDRGRCNSPLHF	TRBV6-1	TRBJ1-6
TGCGCCAGCAGCCAAGGGGCTAAGTCCTACGAGCAGTACTTC	CASSQGAKSYEQYF	TRBV4-1	TRBJ2-7
TGTGCCAGCAGTCCTCAAACAGGGAATCATGAAAAACTGTTTTTT	CASSPQTGNHEKLFF	TRBV6-1	TRBJ1-4
TGTGCCAGCAGTTATTGCGGGACAGAGTACGAGCAGTACTTC	CASSYCGTEYEQYF	TRBV6-5	TRBJ2-7
TGTGCCAGCAGCCGAGGACCCCTGGGGGGGGCAGAGGGAAGCTCCTACAATGAGCAGTTCTTC	CASSRGPLGGAEGSSYNEQFF	TRBV7-9	TRBJ2-1
TGTGCCAGCAGTCCGAGATTTTCCAGCCAGGAGATCAACACTGAAGCTTTCTTT	CASSPRFSSQEINTEAFF	TRBV27	TRBJ1-1
TGTGCATACCGGGGGGGTGGTAACTATGGCTACACCTTC	CAYRGGGNYGYTF	TRBV6-2	TRBJ1-2
TGTGCCAGCAGCCCACCGACGGCTTCCCTTACCGGGGAGCTGTTTTTT	CASSPPTASLTGELFF	TRBV13	TRBJ2-2
TGTGCCAGCAGTTTGGGTTCCACTAGCGGCCCTAAGTCCTACAATGAGCAGTTCTTC	CASSLGSTSGPKSYNEQFF	TRBV27	TRBJ2-1
TGTGCCAGCAGCTTACATAAACTCAACTACGAGCAGTACTTC	CASSLHKLNYEQYF	TRBV11-1	TRBJ2-7
TGCAGGAGATGTTCTTACTATGGCTACACCTTC	CRRCSYYGYTF	TRBV20-1	TRBJ1-2
TGTGCTAGTGGTTCCCGTGGGACTAGGTACAATGAGCAGTTCTTC	CASGSRGTRYNEQFF	TRBV12-5	TRBJ2-1
TGTGCCAGCAGTTACCCCCAGGGACAGGCTGAAGCTTTCTTT	CASSYPQGQAEAFF	TRBV6-3	TRBJ1-1
TGTGCCAGTAGTGAAACAGGGACTTACTTT	CASSETGTYF	TRBV19	TRBJ1-1
TGCGCCAGCAGCTTGAGGTGCCCCAGTGTACGTTCCGGGACTAGCGGGAGACTAGATACGCAGTATTTT	CASSLRCPSVRSGTSGRLDTQYF	TRBV5-1	TRBJ2-3
TGTGCCAGCAGACGGACAGACACTGAAGCTTTCTTT	CASRRTDTEAFF	TRBV7-9	TRBJ1-1
TGTGCCAGCAGCCTTTGGGGGGGTATGACAGATACGCAGTATTTT	CASSLWGGMTDTQYF	TRBV7-3	TRBJ2-3
TGTGCTAGTGGTTTGGTGAGAAGACCGACAGTAAATCAGCCCCAGCATTTT	CASGLVRRPTVNQPQHF	TRBV12-5	TRBJ1-5
TGCAGTGCTTGTGGAGGGAAGCAGAATGAGCAGTTCTTC	CSACGGKQNEQFF	TRBV20-1	TRBJ2-1
TGCAGTGCTGTTTACAGGGGAAGCAATCAGCCCCAGCATTTT	CSAVYRGSNQPQHF	TRBV20-1	TRBJ1-5
TGTGCCACCAGACGGGGGCCCAATCAGCCCCAGCATTTT	CATRRGPNQPQHF	TRBV24-1	TRBJ1-5
TGCAGCGTTGAAACTAGGGGGGTCCCTGAGCAGTACTTC	CSVETRGVPEQYF	TRBV29-1	TRBJ2-7
TGTGCCAGCAGTTATGGGACAGGGGCTGTGAACACTGAAGCTTTCTTT	CASSYGTGAVNTEAFF	TRBV27	TRBJ1-1
TGTGCCACCTTGGGGGGGTTAGGGTTCCCTGAAGCTTTCTTT	CATLGGLGFPEAFF	TRBV10-3	TRBJ1-1
TGTGCCAGCATCAGGAGGGAGAAGACAGGTGTGTCCTACGAGCAGTACTTC	CASIRREKTGVSYEQYF	TRBV6-8	TRBJ2-7
TGCGCCAGCAGCTTGTTTTTAAGGGACTCACCCCTCCACTTT	CASSLFLRDSPLHF	TRBV5-1	TRBJ1-6
TGTGCCAGCACGGCTAGAGGCGGAGGCCGAATGGAGCAGTTCTTC	CASTARGGGRMEQFF	TRBV27	TRBJ2-1
TGTGCCAGCAGTGAAGGCGGGACAGGGATAATCTCTGGGGCCAACGTCCTGACTTTC	CASSEGGTGIISGANVLTF	TRBV25-1	TRBJ2-6
TGCAGCCAAAAACCGGGGGCCCCCAGCTCTGGGGCCAACGTCCTGACTTTC	CSQKPGAPSSGANVLTF	TRBV29-1	TRBJ2-6
TGTGCCAGCAGAGACTTGTATAGACAGAGTTTTACGCAGTATTTT	CASRDLYRQSFTQYF	TRBV7-9	TRBJ2-3
TGTGCCAGCAGCCAAGGGGGTCCGTCCGAGCAGTACTTC	CASSQGGPSEQYF	TRBV7-3	TRBJ2-7
TGTGCCAGCAGCGGCCGGGAAAATGAGACCCAGTACTTC	CASSGRENETQYF	TRBV6-1	TRBJ2-5
TGTGCCAGCAGCTTTCCAGCCGACCGCCGGGAGCTTAGCTCTGGAAACACCATATATTTT	CASSFPADRRELSSGNTIYF	TRBV7-2	TRBJ1-3
TGCGCCAGCAGCCGGGGTGGATATGAGCAGTTCTTC	CASSRGGYEQFF	TRBV5-1	TRBJ2-1
TGTGCCAGGGTTCACAGGGATACTTACAATGAGCAGTTCTTC	CARVHRDTYNEQFF	TRBV13	TRBJ2-1
TGTGCCAGCAGCTTACCCCCCAGGGAGACCTACGAGCAGTACTTC	CASSLPPRETYEQYF	TRBV11-1	TRBJ2-7
TGTGCCAGTAACCGCGGGGGGGTCAATGAGCAGTTCTTC	CASNRGGVNEQFF	TRBV7-3	TRBJ2-1
TGTGCCAGCAGCACGGGGGGAATAGATACGCAGTATTTT	CASSTGGIDTQYF	TRBV7-9	TRBJ2-3
TGTGCCAGCAGATACAAAGGGGAATGGAGTCCCTCTGGAAACACCATATATTTT	CASRYKGEWSPSGNTIYF	TRBV27	TRBJ1-3
TGTGCCAGTAGTATTCCCTCTGATCCGTATGGCTACACCTTC	CASSIPSDPYGYTF	TRBV19	TRBJ1-2
TGCAGTGCTAGAGGACAGGGGGGGGTCTCCTCTGGGGCCAACGTCCTGACTTTC	CSARGQGGVSSGANVLTF	TRBV20-1	TRBJ2-6
TGTGCCAGCAGTTATCAACTGCAGGGCGGCTACGAGCAGTACTTC	CASSYQLQGGYEQYF	TRBV6-2	TRBJ2-7
TGTGCCAGCAGCCCGGGACAGAATCAGCCCCAGCATTTT	CASSPGQNQPQHF	TRBV12-3	TRBJ1-5
TGTGCCAGCAGGTCTCGCTGGAACTCTGGAAACACCATATATTTT	CASRSRWNSGNTIYF	TRBV6-5	TRBJ1-3
TGTGCCAGCAGCTTGACTGCGGACGGCGGGTCGAACACCGGGGAGCTGTTTTTT	CASSLTADGGSNTGELFF	TRBV7-8	TRBJ2-2
TGCAGTGCCGACCCCTCCCCCTCGGGGGGAGGGGGGTCGGGGTACTACGAGCAGTACTTC	CSADPSPSGGGGSGYYEQYF	TRBV20-1	TRBJ2-7
TGTGCCAGCAGTTTCCGGGGGGGGTTGAACACCGGGGAGCTGTTTTTT	CASSFRGGLNTGELFF	TRBV27	TRBJ2-2
TGCGCCAGCAGCCCAAACATAGGGGGCGACTGGTACAATGAGCAGTTCTTC	CASSPNIGGDWYNEQFF	TRBV4-1	TRBJ2-1
TGTGCCAGCAGAACCAACAGGGCGGAATGCACAGATACGCAGTATTTT	CASRTNRAECTDTQYF	TRBV7-4	TRBJ2-3
TGCGCCAGCAAGGGCCCGGGGGGGCCTAATTGCACAGATACGCAGTATTTT	CASKGPGGPNCTDTQYF	TRBV10-1	TRBJ2-3
TGTGCCAGCAGTTCATCTTCCGACGAGCAGTACTTC	CASSSSSDEQYF	TRBV6-9	TRBJ2-7
TGCGGGGCACCCCCGAATCAGCCCCAGCATTTT	CGAPPNQPQHF	TRBV19	TRBJ1-5
TGTGCCACCGCCAGCCCCCCTGGAAACACCATATATTTT	CATASPPGNTIYF	TRBV24-1	TRBJ1-3
TGTGCCAGCTCACCACCCCTTCCACTTGGGAGGGAGCAGTTCTTC	CASSPPLPLGREQFF	TRBV18	TRBJ2-1
TGCAGTGCTAGTCTTGGGTGCGGATCCGGGGAGCTGTTTTTT	CSASLGCGSGELFF	TRBV20-1	TRBJ2-2
TGCAGTGCTAGACAGATATTTGGACAGGGTAGAGCTTTCTTT	CSARQIFGQGRAFF	TRBV20-1	TRBJ1-1
TGTGCCAGCAGTTGGCGACTAGTAGTGGTTGGGAACAATGAGCAGTTCTTC	CASSWRLVVVGNNEQFF	TRBV12-4	TRBJ2-1
TGTGCCAGCAGTAGAGGGGATATCTATGGCTACACCTTC	CASSRGDIYGYTF	TRBV6-3	TRBJ1-2
TGTGCCAGCAGTGGGGGGGGGGGGGGGTACGAGCAGTACTTC	CASSGGGGGYEQYF	TRBV6-5	TRBJ2-7
TGCGCCAGCAGTGAGTCGGGGAAGGGCATTCAGTACTTC	CASSESGKGIQYF	TRBV10-1	TRBJ2-4
TGTGCCAGCAGTCGCAGGGGAGCTGAAGCTTTCTTT	CASSRRGAEAFF	TRBV6-2	TRBJ1-1
TGTGCCATCACCCGGGACAGGGGCGCTAACTATGGCTACACCTTC	CAITRDRGANYGYTF	TRBV10-3	TRBJ1-2
TGTGCCAGTAGCCGGGGACTAGCGGGGAACACAGATACGCAGTATTTT	CASSRGLAGNTDTQYF	TRBV19	TRBJ2-3
TGTGCCAGCAGACTAAGAGCCAAAAACATTCAGTACTTC	CASRLRAKNIQYF	TRBV28	TRBJ2-4
TGCGCCAGCAGCCACTACCAAAAAGGGGGCGCGGAAAATAACTCTGGAAACACCATATATTTT	CASSHYQKGGAENNSGNTIYF	TRBV4-1	TRBJ1-3
TGTGCTAGTGGTTTGACCTACCAGCTTCCCGAGTGGGAAAAACTGTTTTTT	CASGLTYQLPEWEKLFF	TRBV12-5	TRBJ1-4
TGTGCCAGCAGTTGGGAAGTACAAGAGACCCAGTACTTC	CASSWEVQETQYF	TRBV27	TRBJ2-5
TGTGACATGATGGAAAAGAGCGCAACTAATGAAAAACTGTTTTTT	CDMMEKSATNEKLFF	TRBV12-3	TRBJ1-4
TGTGCCAGCAGCCACCGGACAGGGGAAAGAAACACCATATATTTT	CASSHRTGERNTIYF	TRBV7-2	TRBJ1-3
TGCGCCAGCAGCTTGGAGAAGACGGGTGTGTACACCGGGGAGCTGTTTTTT	CASSLEKTGVYTGELFF	TRBV5-1	TRBJ2-2
TGTGCCAGCAGTTCGGGGGTGAGGACAGGGGGCTGTAGGGTGACAAATCAGCCCCAGCATTTT	CASSSGVRTGGCRVTNQPQHF	TRBV6-1	TRBJ1-5
TGTGCCAGCAGCCAAGACCCAGGGCAGGGGGGTTCAGAAAAACTGTTTTTT	CASSQDPGQGGSEKLFF	TRBV14	TRBJ1-4
TGTGCCAGCAGGGGACAGGGTATGGCGTCACCCCTCCACTTT	CASRGQGMASPLHF	TRBV12-4	TRBJ1-6
TGTGCCACCAGTGATTTGCGGGACGCGGGAGAACTCACAGATACGCAGTATTTT	CATSDLRDAGELTDTQYF	TRBV24-1	TRBJ2-3
TGTGCCAATTGGCAGGTCTACGAGCAGTACTTC	CANWQVYEQYF	TRBV6-3	TRBJ2-7
TGCGCCAGCAGCCAAGAGATGACAGGCTCCTACGAGCAGTACTTC	CASSQEMTGSYEQYF	TRBV4-3	TRBJ2-7
TGTGCCAGCCTAGCGGGGGTGGACCGATGCGCCAAAAACATTCAGTACTTC	CASLAGVDRCAKNIQYF	TRBV12-4	TRBJ2-4
TGTGCCAGCAGCTTAGGACTAGCGGCCTACGAGCAGTACTTC	CASSLGLAAYEQYF	TRBV7-2	TRBJ2-7
TGTGCCAGCAGTGTTTCTAGCGGGGGGGAGGAGACCCAGTACTTC	CASSVSSGGEETQYF	TRBV6-2	TRBJ2-5
TGTGCCAGCAGCCACCAAGGGGGAAATCAGCCCCAGCATTTT	CASSHQGGNQPQHF	TRBV14	TRBJ1-5
TGTGCCAGCAGTGAAACGGTCCTCTATGGCTACACCTTC	CASSETVLYGYTF	TRBV6-4	TRBJ1-2
TGTGCCAGCAGCCTATTCGGGACAGGGCCGTTTGAGCAGTACTTC	CASSLFGTGPFEQYF	TRBV9	TRBJ2-7
TGTGCCAGCAGTTTGGGATACAATGAGCAGTTCTTC	CASSLGYNEQFF	TRBV7-3	TRBJ2-1
TGCGCCAGCAGCTTCAGCGGGAACATTCAGTACTTC	CASSFSGNIQYF	TRBV5-1	TRBJ2-4
TGTGCCAGCAGCGAAAACCAGGAATGGACCGGCAATCAGCCCCAGCATTTT	CASSENQEWTGNQPQHF	TRBV7-2	TRBJ1-5
TGTGCCAGCAGGAACGGACAGGGGCACGAGCAGTACTTC	CASRNGQGHEQYF	TRBV7-3	TRBJ2-7
TGTGCCAGCAGTCCCCGAAAAAATGAGCAGTTCTTC	CASSPRKNEQFF	TRBV27	TRBJ2-1
TGCAGCGAGAACGGACAGGGAGGGAACACCGGGGAGCTGTTTTTT	CSENGQGGNTGELFF	TRBV29-1	TRBJ2-2
TGTGCCAGCGGGCAGGGGGGTTCACCCCTCCACTTT	CASGQGGSPLHF	TRBV2	TRBJ1-6
TGTGCCAGCACCCCCGGGGGGCTATACTATGGCTACACCTTC	CASTPGGLYYGYTF	TRBV6-5	TRBJ1-2
TGCGCCAGCAGCCAATTAGTAGGGGCCCTCCACGAGCAGTACTTC	CASSQLVGALHEQYF	TRBV4-1	TRBJ2-7
TGCGCCAGCAGTGAGCAAGTACAGGGGCGCGGTAACTATGGCTACACCTTC	CASSEQVQGRGNYGYTF	TRBV10-1	TRBJ1-2
TGTGCCAGCAGCTTAGTAGCCTTAGTCTACTACGAGCAGTACTTC	CASSLVALVYYEQYF	TRBV11-3	TRBJ2-7
TGCAGTGCTAGCCGGGGACAGGGAGCCGAGCAGTACTTC	CSASRGQGAEQYF	TRBV20-1	TRBJ2-7
TGTGCCAGCAGCTTAGCGGGCCAAGGACTAGAGGATACGCAGTATTTT	CASSLAGQGLEDTQYF	TRBV7-9	TRBJ2-3
TGTGCCTCCCCGGGACTAGCGGGAGAGCCCTACGAGCAGTACTTC	CASPGLAGEPYEQYF	TRBV10-3	TRBJ2-7
TGTGCCAGAGGATGGGGGGGGCGATACAATGAGCAGTTCTTC	CARGWGGRYNEQFF	TRBV19	TRBJ2-1
TGTGCCAGCGAGAACGGGAGACAGCCCCAGCATTTT	CASENGRQPQHF	TRBV6-1	TRBJ1-5
TGTGCCAGCAGCTGGGTACCTTTGCGACAGGGGTTCCAGCCCCAGCATTTT	CASSWVPLRQGFQPQHF	TRBV5-6	TRBJ1-5
TGCAAGACTAGCGGAGACGAGACCCAGTACTTC	CKTSGDETQYF	TRBV20-1	TRBJ2-5
TGTGCCAGCAGCTCCTTTCGGGACAGGGATGGCTACACCTTC	CASSSFRDRDGYTF	TRBV6-3	TRBJ1-2
TGCGCCAGCAAATCAGATCGGGTTAGCGTCTACGAGCAGTACTTC	CASKSDRVSVYEQYF	TRBV10-1	TRBJ2-7
TGTGCCAGCAGCCGGGGAGGGGTATATGACGAGCAGTACTTC	CASSRGGVYDEQYF	TRBV9	TRBJ2-7
TGTGCCAGCAGTCTTATGTGGGAGACCGGTGAAAAACTGTTTTTT	CASSLMWETGEKLFF	TRBV27	TRBJ1-4
TGTGCCAGGCCAGGAAAAGCTTTCTTT	CARPGKAFF	TRBV6-1	TRBJ1-1
TGTGCCAGCAGCACCCTACTAGCGGGAGGGTCCTACGAGCAGTACTTC	CASSTLLAGGSYEQYF	TRBV7-2	TRBJ2-7
TGTGCCAGCAGCCTGAGAGGGTCCTCTGGAAACACCATATATTTT	CASSLRGSSGNTIYF	TRBV4-2	TRBJ1-3
TGTGCCAGCAGAAAAGGGAGCTCTGAAGCTTTCTTT	CASRKGSSEAFF	TRBV28	TRBJ1-1
TGTGCCTGGAGGGTTGTCCTGCCGGGACAGTATAGGAGGGCGAACACTGAAGCTTTCTTT	CAWRVVLPGQYRRANTEAFF	TRBV30	TRBJ1-1
TGCGCCAGCAGCTTGGACTGGGGAACAACTACCCTCAGAGTGGACTACGAGCAGTACTTC	CASSLDWGTTTLRVDYEQYF	TRBV5-1	TRBJ2-7
TGTGCCTGGACACCCACAGGGGGCATGGCTGGAAACACCATATATTTT	CAWTPTGGMAGNTIYF	TRBV30	TRBJ1-3
TGCGCCAGCAGCTCAAGCCCCAGGGGAATATACGGAGTTGGCTACAATGAGCAGTTCTTC	CASSSSPRGIYGVGYNEQFF	TRBV5-1	TRBJ2-1
TGTGCCAGCTTAGCGGGTTGGGACACCTACGAGCAGTACTTC	CASLAGWDTYEQYF	TRBV6-1	TRBJ2-7
TGTGCCAGCAGTGAAGCGCTTCCAATCGTGGACCGCGCAACTAATGAAAAACTGTTTTTT	CASSEALPIVDRATNEKLFF	TRBV2	TRBJ1-4
TGTGCCAGCAGAAAAGACAGGGGGCTGGTGGTCTCCTATAATTCACCCCTCCACTTT	CASRKDRGLVVSYNSPLHF	TRBV11-2	TRBJ1-6
TGCGCCAGCAGCCAAGACGAAGGGGGGGTCACAGATACGCAGTATTTT	CASSQDEGGVTDTQYF	TRBV4-1	TRBJ2-3
TGTGCCAGCCACCTCTCCTACGAGCAGTACTTC	CASHLSYEQYF	TRBV6-4	TRBJ2-7
TGTGCCAGCAGCCGGGATACAGTTACGGATACGCAGTATTTT	CASSRDTVTDTQYF	TRBV2	TRBJ2-3
TGTGCCAGCAGGAGGGGACCGGGACAGGGACCGTGTGAAGCTTTCTTT	CASRRGPGQGPCEAFF	TRBV27	TRBJ1-1
TGTGCCAGTAGTAAGGGGGAGGTCGAGCAGTACTTC	CASSKGEVEQYF	TRBV19	TRBJ2-7
TGTGCCAGCAGCAGAAGACAGGGACAGGCCTACGAGCAGTACTTC	CASSRRQGQAYEQYF	TRBV7-3	TRBJ2-7
TGTGCCAGCAGCGTCACAGGGGTGTGTGCGGAGACCCAGTACTTC	CASSVTGVCAETQYF	TRBV9	TRBJ2-5
TGCAGCGTTACCCTGGGAAACGATTCAGCCGGTGCCGACTCTGGAAACACCATATATTTT	CSVTLGNDSAGADSGNTIYF	TRBV29-1	TRBJ1-3
TGTGCCAGCAAAGGGATCACTTTTAGCGGGGTTTACGAGAGCGAGCAGTACTTC	CASKGITFSGVYESEQYF	TRBV5-6	TRBJ2-7
TGCAGTCGCCTACCCGTGGACAGGGAGCAGTACTTC	CSRLPVDREQYF	TRBV20-1	TRBJ2-7
TGTGCCAGCAGACCTCCCGGGGGCGTCTTGACTGAAGCTTTCTTT	CASRPPGGVLTEAFF	TRBV27	TRBJ1-1
TGCGCCAGCAGCACCAGGGAAGAGACCCAGTACTTC	CASSTREETQYF	TRBV5-1	TRBJ2-5
TGTGCCAGCAGTTTACTTGGGGAGCTGGCCTATGGCTACACCTTC	CASSLLGELAYGYTF	TRBV27	TRBJ1-2
TGCAGTGCTAGTCGTCGGACAGAGACCCAGTACTTC	CSASRRTETQYF	TRBV20-1	TRBJ2-5
TGTGCCAGCAGCTTAAAAAAAACATCGGGAGGTCTACTCCGATATACCGGGGAGCTGTTTTTT	CASSLKKTSGGLLRYTGELFF	TRBV14	TRBJ2-2
TGCAGTGCTTTACTAGCGGGGTCCTACGAGCAGTACTTC	CSALLAGSYEQYF	TRBV20-1	TRBJ2-7
TGTGCCAGCAGCGTAGTCCAGTCCGAGCCCCAGCATTTT	CASSVVQSEPQHF	TRBV9	TRBJ1-5
TGCGCCAGCAGCCCCGGCCGGGACAGGACGAGGGGCTACACCTTC	CASSPGRDRTRGYTF	TRBV4-3	TRBJ1-2
TGCATTGAAGGACAGTATAAGGATACCAAACTGTTTTTT	CIEGQYKDTKLFF	TRBV20-1	TRBJ1-4
TGTGCCAGCAGCCTCTGGGGCAATCAGCCCCAGCATTTT	CASSLWGNQPQHF	TRBV25-1	TRBJ1-5
TGTGCCAGCAGGGGTGTCGGCTACACCTTC	CASRGVGYTF	TRBV28	TRBJ1-2
TGTGCCAGCAGCTCTAAACCCCGGGACAGGGGGTGTAGGAACACTGAAGCTTTCTTT	CASSSKPRDRGCRNTEAFF	TRBV5-4	TRBJ1-1
TGTGCCAGCAGTTACGAACAAGGGGGCCTCTCCTATAATTCACCCCTCCACTTT	CASSYEQGGLSYNSPLHF	TRBV6-2	TRBJ1-6
TGCGTTATTGGAGCGGGGGCCATACCGAACACTGAAGCTTTCTTT	CVIGAGAIPNTEAFF	TRBV20-1	TRBJ1-1
TGTGCCAGCAGTGAAGGGACCCGACAGCCTCAGATTGTTGAAGCTTTCTTT	CASSEGTRQPQIVEAFF	TRBV2	TRBJ1-1
TGCGCCAGCAGCTACCACAGGATGAGGGGGGACACTGAAGCTTTCTTT	CASSYHRMRGDTEAFF	TRBV5-1	TRBJ1-1
TGTGCCAGATGGGGACTTTGGTCCTACGAGCAGTACTTC	CARWGLWSYEQYF	TRBV27	TRBJ2-7
TGTGCCAGCAGCCCTTCGACAGGGGACCGCACTGAAGCTTTCTTT	CASSPSTGDRTEAFF	TRBV7-9	TRBJ1-1
TGCAGTGCTAGTAAACACTACGAGCAGTACTTC	CSASKHYEQYF	TRBV20-1	TRBJ2-7
TGTGCCAGCAGCTTGCAGCAATTTGAGGCTAGCACAGCGACACGGGATACGCAGTATTTT	CASSLQQFEASTATRDTQYF	TRBV5-4	TRBJ2-3
TGTGCCAGCAGCCCGGCCACAGCCAGGGGCGAGAACACTGAAGCTTTCTTT	CASSPATARGENTEAFF	TRBV14	TRBJ1-1
TGTGCCAGCACCGTAATCGCTGGAAACACCATATATTTT	CASTVIAGNTIYF	TRBV27	TRBJ1-3
TGCGCCAGCAGCCTTACTGGGTTTGGGACAGGGGGGGGCTCTGGAAACACCATATATTTT	CASSLTGFGTGGGSGNTIYF	TRBV5-1	TRBJ1-3
TGCAGTGCTGAAACGAGACAGGGGTTTAAAGGCAATCAGCCCCAGCATTTT	CSAETRQGFKGNQPQHF	TRBV20-1	TRBJ1-5
TGCGCCAGCAGCTTCCTAGCGGTGGTAGACTACAATGAGCAGTTCTTC	CASSFLAVVDYNEQFF	TRBV5-1	TRBJ2-1
TGTGCCAGCTCACCACTACAGACAGGTACCCCCGATAGCAATCAGCCCCAGCATTTT	CASSPLQTGTPDSNQPQHF	TRBV18	TRBJ1-5
TGTGCCAGCAGTGACGTCCGACTGGGACAGTATCAGCCCCAGCATTTT	CASSDVRLGQYQPQHF	TRBV6-1	TRBJ1-5
TGTGCCAGCAGTTTGGTTGACAGGGGGAGCCAGCCCCAGCATTTT	CASSLVDRGSQPQHF	TRBV27	TRBJ1-5
TGTGCCACCAGTGACTGCGGGGTCATGGGTGGGGCTACCACTGAAGCTTTCTTT	CATSDCGVMGGATTEAFF	TRBV24-1	TRBJ1-1
TGTGCCAGCAGTGATCTCCCACAAGCAGACACTGAAGCTTTCTTT	CASSDLPQADTEAFF	TRBV6-5	TRBJ1-1
TGTGCCACCAGTGAGGACAGGGTCCATAATGGAGTCAATCAGCCCCAGCATTTT	CATSEDRVHNGVNQPQHF	TRBV24-1	TRBJ1-5
TGCAGGGAACCAGGGGGCCCCGCCTACAATGAGCAGTTCTTC	CREPGGPAYNEQFF	TRBV20-1	TRBJ2-1
TGTGCCATGGGGACTTTTGGCAATCAGCCCCAGCATTTT	CAMGTFGNQPQHF	TRBV11-2	TRBJ1-5
TGTGCCAGCAGCTTGTCCCCTAGTACTGAAGCTTTCTTT	CASSLSPSTEAFF	TRBV5-4	TRBJ1-1
TGTGCCAGCAGCCTGGCACGGGACGGTACCAGAAATGAGCAGTTCTTC	CASSLARDGTRNEQFF	TRBV7-2	TRBJ2-1
TGTGCCATCAATGCCGCGGGAGGATGGGATACGCAGTATTTT	CAINAAGGWDTQYF	TRBV6-2	TRBJ2-3
TGTGCCAGCAGCCCTATAGGGCATGGCTACACCTTC	CASSPIGHGYTF	TRBV7-2	TRBJ1-2
TGTGCCAGCAGTTTACTCGTCCAGGATGCAACTAATGAAAAACTGTTTTTT	CASSLLVQDATNEKLFF	TRBV27	TRBJ1-4
TGTGCCAGCAGCGTCCTAGACAATGAGCAGTTCTTC	CASSVLDNEQFF	TRBV11-2	TRBJ2-1
TGCGCCAGCAGGGCCCCAGAAAGGCTCAATCAGCCCCAGCATTTT	CASRAPERLNQPQHF	TRBV5-1	TRBJ1-5
TGTGCCAGCAGCGAGGGCGTGAACACTGAAGCTTTCTTT	CASSEGVNTEAFF	TRBV7-3	TRBJ1-1
TGTGCCTGGAGTCACCTGCCCTACGAGCAGTACTTC	CAWSHLPYEQYF	TRBV30	TRBJ2-7
TGTGCCAGCAGTGGGTGCCCGGCCGGGCCCCTAGCCAAAAACATTCAGTACTTC	CASSGCPAGPLAKNIQYF	TRBV25-1	TRBJ2-4
TGTGCCAGCATAAGGGACAGCGGTTGGACCCGCTATAATTCACCCCTCCACTTT	CASIRDSGWTRYNSPLHF	TRBV7-6	TRBJ1-6
TGTGCCAGCAGCGGCGGGAGGGGGTACAATGAGCAGTTCTTC	CASSGGRGYNEQFF	TRBV7-2	TRBJ2-1
TGCGCCAGCAGTCCCCGGGACGAAGTGGTACTGCCCCAAGAGACCCAGTACTTC	CASSPRDEVVLPQETQYF	TRBV10-2	TRBJ2-5
TGTGCCAGCAGCTCAGAGAGTGACAGGGTCACTGAAGCTTTCTTT	CASSSESDRVTEAFF	TRBV7-3	TRBJ1-1
TGTGCCAACCAGGGACAGGTTAGCAATCAGCCCCAGCATTTT	CANQGQVSNQPQHF	TRBV6-5	TRBJ1-5
TGCAGCGGGACAGTCTACAATGAGCAGTTCTTC	CSGTVYNEQFF	TRBV29-1	TRBJ2-1
TGTGCCAGCAGCTTCGTCCCTAGAACCTACGAGCAGTACTTC	CASSFVPRTYEQYF	TRBV5-6	TRBJ2-7
TGTGCCAGCAAGAGGGAGGGTACCCAGTACTTC	CASKREGTQYF	TRBV6-1	TRBJ2-5
TGTGCCAGCAGTGAAGCGCACTGCATCGGCTGCACAGATACGCAGTATTTT	CASSEAHCIGCTDTQYF	TRBV2	TRBJ2-3
TGTGCCAGCAGCTTGTCGGCAGACACTGAAGCTTTCTTT	CASSLSADTEAFF	TRBV5-5	TRBJ1-1
TGTGCCAGCAGTTACTCGAAGAGGGACGGTAATGAAAAACTGTTTTTT	CASSYSKRDGNEKLFF	TRBV6-5	TRBJ1-4
TGTGCTAGTGGTCGCCTAGTGGGGAACACCGGGGAGCTGTTTTTT	CASGRLVGNTGELFF	TRBV12-5	TRBJ2-2
TGCGCCAGCAGCTCAGACAGGGTAGATCAGTATTTT	CASSSDRVDQYF	TRBV5-1	TRBJ2-3
TGCGCCAGCAGTGAGTCCGGACGGTACTACGAGCAGTACTTC	CASSESGRYYEQYF	TRBV10-1	TRBJ2-7
TGTGCCAGCAGCCACCGCGGGGCAGAGACCCAGTACTTC	CASSHRGAETQYF	TRBV3-1	TRBJ2-5
TGCGCCAGCAGCCACAGGGAGGCCCGGTTAGCCTCTGGGGCCAACGTCCTGACTTTC	CASSHREARLASGANVLTF	TRBV4-1	TRBJ2-6
TGCGCCAGCAGTGAGCCTATTCCTAACTCTGGGGCCAACGTCCTGACTTTC	CASSEPIPNSGANVLTF	TRBV10-1	TRBJ2-6
TGCGCCAGCAGCCTCGGCAGGACTGGGGGAAACACCATATATTTT	CASSLGRTGGNTIYF	TRBV5-1	TRBJ1-3
TGTGCCAGCTCACCACAACGGAGGACCTGGGGGCAGGACTCTGGAAACACCATATATTTT	CASSPQRRTWGQDSGNTIYF	TRBV18	TRBJ1-3
TGCGCCAGCAGCGGGGAAAGAGTAAATTCACCCCTCCACTTT	CASSGERVNSPLHF	TRBV5-1	TRBJ1-6
TGCGCCAGGTATTACAATGAGCAGTTCTTC	CARYYNEQFF	TRBV10-1	TRBJ2-1
TGCGCCGGTCTAAAATCGGATAGCAATCAGCCCCAGCATTTT	CAGLKSDSNQPQHF	TRBV5-1	TRBJ1-5
TGTGCCAGCAGCTTAACACGGGCGTTTAGGAACTATGGCTACACCTTC	CASSLTRAFRNYGYTF	TRBV7-3	TRBJ1-2
TGCGCCAGCAGCGCGGCGGTCGGACTAGCGGGGCACTCCTACGAGCAGTACTTC	CASSAAVGLAGHSYEQYF	TRBV5-1	TRBJ2-7
TGTGCCAGCAGCCAAGATCCTGAAAAGCCCAGCAATCAGCCCCAGCATTTT	CASSQDPEKPSNQPQHF	TRBV3-1	TRBJ1-5
TGTGCCACCCGGGGGCAAGTCTCTGGGGCCAACGTCCTGACTTTC	CATRGQVSGANVLTF	TRBV19	TRBJ2-6
TGTGCCAGCAGCTTCGTAACTAGCGGGAGTGAGGGCTACGAGCAGTACTTC	CASSFVTSGSEGYEQYF	TRBV5-6	TRBJ2-7
TGTGCCAGCAGCTTAAATGGGGAAGCTTTCTTT	CASSLNGEAFF	TRBV7-4	TRBJ1-1
TGTGCCAGCAGTCCCGTCAGGACCCGCAATCAGCCCCAGCATTTT	CASSPVRTRNQPQHF	TRBV28	TRBJ1-5
TGTGCCAGCACCCAGGGGTGCGGCTACACCTTC	CASTQGCGYTF	TRBV7-8	TRBJ1-2
TGCGCCAGCAGCCAGTGGGGCAATCAGCCCCAGCATTTT	CASSQWGNQPQHF	TRBV4-1	TRBJ1-5
TGCGCCAGCAGCTTGGAGAAAACAATTAACAGGGGTTACACCTTC	CASSLEKTINRGYTF	TRBV5-1	TRBJ1-2
TGTGCCAGCAGCTTGGCTCCCATCTCTGGGGCCAACGTCCTGACTTTC	CASSLAPISGANVLTF	TRBV5-6	TRBJ2-6
TGTGCCAGCAGGGACATCAGTGTAGAGACCCAGTACTTC	CASRDISVETQYF	TRBV5-4	TRBJ2-5
TGTGCCAGCAGCGGGAGGTTGGACCGGGGGAGGTGTAACTATGGCTACACCTTC	CASSGRLDRGRCNYGYTF	TRBV5-5	TRBJ1-2
TGCGCCAGCAGCCAGCCGCGGGCGATTTTCTCCTACAATGAGCAGTTCTTC	CASSQPRAIFSYNEQFF	TRBV4-3	TRBJ2-1
TGTGCCAGACACGGCGCGGTCGGGTATAGCAATCAGCCCCAGCATTTT	CARHGAVGYSNQPQHF	TRBV6-4	TRBJ1-5
TGCAGTGCTGCCTACAGGGGGCGCATCCTCAATCAGCCCCAGCATTTT	CSAAYRGRILNQPQHF	TRBV20-1	TRBJ1-5
TGCGCCAGCAGCCATGCAGCGAACACTGAAGCTTTCTTT	CASSHAANTEAFF	TRBV4-1	TRBJ1-1
TGCGCCAGCAGTGGCACTAGCGGGCAAGAGACCCAGTACTTC	CASSGTSGQETQYF	TRBV10-1	TRBJ2-5
TGTGCCAGCAGCCAAGATCCAACAGACCTCGAGCAGTACTTC	CASSQDPTDLEQYF	TRBV14	TRBJ2-7
TGTGCCAGCAGCCAAGATCCGACAGGGGAGGGGATGAACACTGAAGCTTTCTTT	CASSQDPTGEGMNTEAFF	TRBV3-1	TRBJ1-1
TGTGCCAGCAGCCCTACGCGCGAGCAGTACTTC	CASSPTREQYF	TRBV5-5	TRBJ2-7
TGTGCCAGCAGCGTAGAGGAACAAAGCGGGGCCGGATGCCATGAGCAGTTCTTC	CASSVEEQSGAGCHEQFF	TRBV9	TRBJ2-1
TGTGCCAGCAGCCCTAGCGAGGTCCGTTTGAACACCGGGGAGCTGTTTTTT	CASSPSEVRLNTGELFF	TRBV7-3	TRBJ2-2
TGTGCCAGCAGCCTTGACGTCGCCAGGTCCTACGAGCAGTACTTC	CASSLDVARSYEQYF	TRBV7-3	TRBJ2-7
TGTGCCAGCCAGGACAGGGGCAATGAGCAGTTCTTC	CASQDRGNEQFF	TRBV6-1	TRBJ2-1
TGTGCTAGTGGTGAACGTCCCGGACAGGGGGCCACTGAAGCTTTCTTT	CASGERPGQGATEAFF	TRBV12-5	TRBJ1-1
TGTGCCAGCAGTGGGGAGGGGACCAGCTATGGCTACACCTTC	CASSGEGTSYGYTF	TRBV27	TRBJ1-2
TGTGCCAGCAAAAGATTAGGGGATATCGAGCAGTACTTC	CASKRLGDIEQYF	TRBV6-4	TRBJ2-7
TGTGCCACCAGCAGCGACCGGGACAACAATCAGCCCCAGCATTTT	CATSSDRDNNQPQHF	TRBV15	TRBJ1-5
TGTGCCAGCAGCGTGAAGGCCTTTGGGACAGCACTAACGAATGGCTACACCTTC	CASSVKAFGTALTNGYTF	TRBV9	TRBJ1-2
TGTGCCAGCTCACCCTTCCCCTCCCTCTCCTCCTACGAGCAGTACTTC	CASSPFPSLSSYEQYF	TRBV18	TRBJ2-7
TGTGCCAGCAGTTACGGCGAGGTCTCTGGAAACACCATATATTTT	CASSYGEVSGNTIYF	TRBV6-5	TRBJ1-3
TGTGCCAGCAGCGAAGAGGGCCGGGACAGGCTAGGAAATCAGCCCCAGCATTTT	CASSEEGRDRLGNQPQHF	TRBV13	TRBJ1-5
TGTGCCAGCAGCGTTGCACTAGCGGGAGGAAGCGACTACGAGCAGTACTTC	CASSVALAGGSDYEQYF	TRBV11-2	TRBJ2-7
TGTGCCAGCGCGGACAGACATGGCTACACCTTC	CASADRHGYTF	TRBV9	TRBJ1-2
TGTGCCAGCAGCCGCTATCTAACCGACGGAAATGAAAAACTGTTTTTT	CASSRYLTDGNEKLFF	TRBV7-9	TRBJ1-4
TGCGCCAGCAGTGTGCCAGTCAGGGACAGGACTAACACTGAAGCTTTCTTT	CASSVPVRDRTNTEAFF	TRBV10-1	TRBJ1-1
TGTGCCAGCAGTCGGACAGGATGCGGGGAGGGGGCCTACGAGCAGTACTTC	CASSRTGCGEGAYEQYF	TRBV6-5	TRBJ2-7
TGTGCCAGCAGTCTTGGGGCCCTTATCTATGGCTACACCTTC	CASSLGALIYGYTF	TRBV6-3	TRBJ1-2
TGTGCCATTACCTTGTTTCCTAGCGGCGGGGCCTACGAGCAGTACTTC	CAITLFPSGGAYEQYF	TRBV6-5	TRBJ2-7
TGCGCCAGCAGCCCCAGACAGTTGACCGACTATGGCTACACCTTC	CASSPRQLTDYGYTF	TRBV4-1	TRBJ1-2
