TGCGCCAGCAGCCAAGAAACCCGGGGTGATCAGCCCCAGCATTTT	CASSQETRGDQPQHF	TRBV4-1	TRBJ1-5
TGTGCCAGCAGTTACTGCGGGAGCGAGACCCAGTACTTC	CASSYCGSETQYF	TRBV6-5	TRBJ2-5
TGTGCCAGCAGCTTACCCGGGTCCTACGAGCAGTACTTC	CASSLPGSYEQYF	TRBV7-9	TRBJ2-7
TGTGCCAGCAGTGAGCGGGAGAAGCGGGAGTACTTC	CASSEREKREYF	TRBV6-4	TRBJ2-7
TGCAGCGACGACAAGGGCTATAATTCACCCCTCCACTTT	CSDDKGYNSPLHF	TRBV29-1	TRBJ1-6
TGTGCCAGCAGCTTGGACAGCCTTGCTTTCTTT	CASSLDSLAFF	TRBV5-4	TRBJ1-1
TGTGCCAGCAGTCGGTCTAAGCCGGCAGATACGCAGTATTTT	CASSRSKPADTQYF	TRBV28	TRBJ2-3
TGTGCCAGCAGTACCACCTTC	CASSTTF	TRBV6-5	TRBJ1-2
TGTGCCAGCAGTTTCGCACATTCGGAAAAACTGTTTTTT	CASSFAHSEKLFF	TRBV12-3	TRBJ1-4
TGTGCCAGGAGGACAGGGAATCAAAACATTCAGTACTTC	CARRTGNQNIQYF	TRBV28	TRBJ2-4
TGTGCCAGTAGTATTAGTCTATCAGTTTGGCGTGGCTATCAGCCCCAGCATTTT	CASSISLSVWRGYQPQHF	TRBV19	TRBJ1-5
TGTGCCAGCAGCGCCGGGAGGGACAGGGCCGGCTCCTACGAGCAGTACTTC	CASSAGRDRAGSYEQYF	TRBV13	TRBJ2-7
TGTGCCAGCAGTCACCCATCCTATAATTCACCCCTCCACTTT	CASSHPSYNSPLHF	TRBV6-2	TRBJ1-6
TGTGCCAGCAGCCCCGGACAGGGGAACACTGAAGCTTTCTTT	CASSPGQGNTEAFF	TRBV7-3	TRBJ1-1
TGCGCCAGCAGCTTGAATAAACGGGGGGTGAAAGGAGCTACAGATACGCAGTATTTT	CASSLNKRGVKGATDTQYF	TRBV5-1	TRBJ2-3
TGTGCCAGCAGCCAACGACAGGGTCAATTTAAGTCGGTCTATGGCTACACCTTC	CASSQRQGQFKSVYGYTF	TRBV14	TRBJ1-2
TGCAGCGTTTACGGGACAGGGCGACTGGGCCTGGGGGCCAACGTCCTGACTTTC	CSVYGTGRLGLGANVLTF	TRBV29-1	TRBJ2-6
TGTGCCAGCAGTGCCCCCAGGGTTTACGAGCAGTACTTC	CASSAPRVYEQYF	TRBV6-1	TRBJ2-7
TGTGCGGCCCCCTTAGGTGGCCCGAACACCGGGGAGCTGTTTTTT	CAAPLGGPNTGELFF	TRBV27	TRBJ2-2
TGTGCCAGCAAGATCGGAGGACAGGGCTCCTACGAGCAGTACTTC	CASKIGGQGSYEQYF	TRBV14	TRBJ2-7
TGCGCCAGCGGGGCAACACAGGGCGGGACAGATACGCAGTATTTT	CASGATQGGTDTQYF	TRBV10-1	TRBJ2-3
TGCAGCGTTGAGCGGCTACCGAATGAGCAGTTCTTC	CSVERLPNEQFF	TRBV29-1	TRBJ2-1
TGTGCCTGGATCCCCGAAAAGGGGGCTACCGTCCTGTGGAATGAGCAGTTCTTC	CAWIPEKGATVLWNEQFF	TRBV30	TRBJ2-1
TGTGCCAGCAGCACTGCGGGGGAGATCCAAGAGACCCAGTACTTC	CASSTAGEIQETQYF	TRBV14	TRBJ2-5
TGTGCCAGCTCACCAGGGGGGACTAGCGGGGATGAGCAGTTCTTC	CASSPGGTSGDEQFF	TRBV18	TRBJ2-1
TGTGCCAGTATCGGCAAGTACTACGAGCAGTACTTC	CASIGKYYEQYF	TRBV19	TRBJ2-7
TGTGCCAGCAGATGTAGCGGGACCTATGGCTACACCTTC	CASRCSGTYGYTF	TRBV6-5	TRBJ1-2
TGTGCCAGCAGTGGAGATCACAGGGGTTCGATGAACACTGAAGCTTTCTTT	CASSGDHRGSMNTEAFF	TRBV6-8	TRBJ1-1
TGTGCCAGCAGTTTAGGACGTCAACAGCATGGATGTCCTAGCGAGCAGTACTTC	CASSLGRQQHGCPSEQYF	TRBV12-3	TRBJ2-7
TGCAGTGCACGCGGGAGTGTCCAAGAGACCCAGTACTTC	CSARGSVQETQYF	TRBV20-1	TRBJ2-5
TGTGCCAGCAGCCAATGCGGGGCACCCTATGGCTACACCTTC	CASSQCGAPYGYTF	TRBV3-1	TRBJ1-2
TGTGCCAGCAGCCCCTACGGGTCGAACACCGGGGAGCTGTTTTTT	CASSPYGSNTGELFF	TRBV13	TRBJ2-2
TGTGCCAGCAGTTTATTTGGTACGGACGCCGAGCAGTACTTC	CASSLFGTDAEQYF	TRBV27	TRBJ2-7
TGTGCCTGGAGTTCGCGGACAGGGAGGGAAAAACTGTTTTTT	CAWSSRTGREKLFF	TRBV30	TRBJ1-4
TGCGCCATAGGGGGGCGCATCCTCTCCTACGAGCAGTACTTC	CAIGGRILSYEQYF	TRBV10-2	TRBJ2-7
TGTGCCAGCAGCCAAGGGGGGACAGGGGGCGACTATGGCTACACCTTC	CASSQGGTGGDYGYTF	TRBV3-1	TRBJ1-2
TGTGCCAGCAGTTTATGGGACTTCCGAAACACCATATATTTT	CASSLWDFRNTIYF	TRBV27	TRBJ1-3
TGCGCCAGCAGCTTAACATATAGCACCGGGGAGCTGTTTTTT	CASSLTYSTGELFF	TRBV5-1	TRBJ2-2
TGTGCCAGCAAAAAGCCTCGCCGGGGTTCATACAATGAGCAGTTCTTC	CASKKPRRGSYNEQFF	TRBV12-4	TRBJ2-1
TGTGCCAGCAGCCACCTAGACACCGGGGAGCTGTTTTTT	CASSHLDTGELFF	TRBV11-2	TRBJ2-2
TGTGCCACCGGACAGGGGAAAAGAGCTTCCTACGAGCAGTACTTC	CATGQGKRASYEQYF	TRBV24-1	TRBJ2-7
TGTGCCAGCAGTTACTTGCCGCGGGGGGCGGTCTCTAAAAACATTCAGTACTTC	CASSYLPRGAVSKNIQYF	TRBV6-3	TRBJ2-4
TGTGCCAGCAGCAGTCCCGTTAGCGGGAAGACAGCAACTAATGAAAAACTGTTTTTT	CASSSPVSGKTATNEKLFF	TRBV5-4	TRBJ1-4
TGTGCCACTCCCCGACAGGGGGCGACTGAAGCTTTCTTT	CATPRQGATEAFF	TRBV24-1	TRBJ1-1
TGTGCCAGTACCCAGAAACAGACCCAGTACTTC	CASTQKQTQYF	TRBV19	TRBJ2-5
TGCGCCAGCAGCTTGGGGAAAGGGCGAGTGGGAGATGGCTACACCTTC	CASSLGKGRVGDGYTF	TRBV5-1	TRBJ1-2
TGTGCCAGCAGTGAGGGGGGTGAAGCTTTCTTT	CASSEGGEAFF	TRBV2	TRBJ1-1
TGTGCCAGCAGTGACGGTTACTCCCAAGAATCCCCGGCCCATCAGCCCCAGCATTTT	CASSDGYSQESPAHQPQHF	TRBV6-4	TRBJ1-5
TGTGCCAGCAGCCAAGAGTCGCAGGAGGCGCAGTACTTC	CASSQESQEAQYF	TRBV14	TRBJ2-7
TGCACTTGGGGGCACTGGAACACTGAAGCTTTCTTT	CTWGHWNTEAFF	TRBV20-1	TRBJ1-1
TGCGCCATCTCGCCCCAGGGAGGATGGTTGCGACAAGAGACCCAGTACTTC	CAISPQGGWLRQETQYF	TRBV4-1	TRBJ2-5
TGTGCCAGCACCTGGTGGGGGGCCAATTTCAATGAGCAGTTCTTC	CASTWWGANFNEQFF	TRBV12-3	TRBJ2-1
TGCAGTGCACCCGGGACAGTGAGCAATCAGCCCCAGCATTTT	CSAPGTVSNQPQHF	TRBV20-1	TRBJ1-5
TGTGCCACCAGTGATGGGGGCGCGGAGACCCAGTACTTC	CATSDGGAETQYF	TRBV24-1	TRBJ2-5
TGTGCCACCAGTGATCCGTCGGGTTCCCCAAAGACTAGCGGGGTTGAGCAGTTCTTC	CATSDPSGSPKTSGVEQFF	TRBV24-1	TRBJ2-1
TGCAGTGCTAGCGGGACAGTCACGAACACTGAAGCTTTCTTT	CSASGTVTNTEAFF	TRBV20-1	TRBJ1-1
TGTGCCAGCAAGTTAGTGGGACTAGCGGGGATCAACAATGAGCAGTTCTTC	CASKLVGLAGINNEQFF	TRBV6-4	TRBJ2-1
TGTGCCAGCCGAGGACAGGGCCCTCAGCCCCAGCATTTT	CASRGQGPQPQHF	TRBV18	TRBJ1-5
TGTGCCAGGGACACTAGCGGGAGACCCGCCACAGCAGACGAGCAGTACTTC	CARDTSGRPATADEQYF	TRBV6-2	TRBJ2-7
TGCGCCAGCAGCTTGGTCCCCCTGACGGACAATGAGCAGTTCTTC	CASSLVPLTDNEQFF	TRBV5-1	TRBJ2-1
TGCGCCAGCAGTGACCTAAAAGACTCCTCACCCCTCCACTTT	CASSDLKDSSPLHF	TRBV10-1	TRBJ1-6
TGTGCCAGCAGTGAAGCGAAGGAGGTTCTAGCCAAAAACATTCAGTACTTC	CASSEAKEVLAKNIQYF	TRBV6-1	TRBJ2-4
TGTGCCAGCAGTGAAGGGACAGGGGAGACCCAGTACTTC	CASSEGTGETQYF	TRBV6-1	TRBJ2-5
TGTGCCAGCCGACAGGGGGCCACAGATACGCAGTATTTT	CASRQGATDTQYF	TRBV11-1	TRBJ2-3
TGTGCCAGCAGCCTGAAAGAATCCTACGAGCAGTACTTC	CASSLKESYEQYF	TRBV11-3	TRBJ2-7
TGCGAACAGGGGTCCAGGGAGACCCAGTACTTC	CEQGSRETQYF	TRBV20-1	TRBJ2-5
TGTGCCAGCAGCTTAGGTCCCACAGGGCGTTACACCGGGGAGCTGTTTTTT	CASSLGPTGRYTGELFF	TRBV11-1	TRBJ2-2
TGCGCTAGAAATTCACCCCTCCACTTT	CARNSPLHF	TRBV10-1	TRBJ1-6
TGTGCCAGCAGCCACTCCAATGGACCGGACGAACCGGGACAGGGGTTCTACGAGCAGTACTTC	CASSHSNGPDEPGQGFYEQYF	TRBV14	TRBJ2-7
TGTGCCACCAGTGACCTTTTGGCGGAAATGAACACCGGGGAGCTGTTTTTT	CATSDLLAEMNTGELFF	TRBV24-1	TRBJ2-2
TGTGCCAAGATGGACAGTCAGGCAGGAAACACCATATATTTT	CAKMDSQAGNTIYF	TRBV27	TRBJ1-3
TGTGCCAGCAGTTTGGCTGAGTCGCACTACGAGCAGTACTTC	CASSLAESHYEQYF	TRBV27	TRBJ2-7
TGTGCCAGCAGTTACGAAGCAGGATATGAGCAGTTCTTC	CASSYEAGYEQFF	TRBV6-2	TRBJ2-1
TGCGCCAGCAGCTTCCGCAGAGCCTACGAGCAGTACTTC	CASSFRRAYEQYF	TRBV5-1	TRBJ2-7
TGTGCCAGCAGAACGCCACCCCGGGTGCTCCAGTCAGGGAGGAATGAAAAACTGTTTTTT	CASRTPPRVLQSGRNEKLFF	TRBV6-5	TRBJ1-4
TGTGCCAGCAGCGGATTGACGACAGGCTACACCTTC	CASSGLTTGYTF	TRBV7-4	TRBJ1-2
TGCGCCAGCAGCCCTCAGGCTGAGTACCAAGAGACCCAGTACTTC	CASSPQAEYQETQYF	TRBV5-1	TRBJ2-5
TGTGCCAGCAGCTTTACGGAAGAGACCCAGTACTTC	CASSFTEETQYF	TRBV5-4	TRBJ2-5
TGTGCCACCGGGGCCCTCGGGACAGGGGAGAAGGGCTGGGATCAGCCCCAGCATTTT	CATGALGTGEKGWDQPQHF	TRBV25-1	TRBJ1-5
TGTGCCAGGGGGGGGGGAGAGACCCAGTACTTC	CARGGGETQYF	TRBV6-4	TRBJ2-5
TGTGCCAGAACCTTTTGGGGAAGTTTAAGGGTTACCCTCTACGAGCAGTACTTC	CARTFWGSLRVTLYEQYF	TRBV27	TRBJ2-7
TGTGCCAGCAGCGCTAGCGGGCTTCGCACAGATACGCAGTATTTT	CASSASGLRTDTQYF	TRBV6-5	TRBJ2-3
TGCAGTGCTAGAGATCCCCAGCCGGGGACTGCTAGGGCAACTAATGAAAAACTGTTTTTT	CSARDPQPGTARATNEKLFF	TRBV20-1	TRBJ1-4
TGTGCCAGCAGCCCCGATGGGGGCAAAGTGAACACTGAAGCTTTCTTT	CASSPDGGKVNTEAFF	TRBV6-5	TRBJ1-1
TGTGCCAGCAGGTGGAGGGAACTAGCGGGAGAGGCCTACAATGAGCAGTTCTTC	CASRWRELAGEAYNEQFF	TRBV6-1	TRBJ2-1
TGTGCCAGCAGTTTGACTGGACAGGGGTGTTGGAGCAATCAGCCCCAGCATTTT	CASSLTGQGCWSNQPQHF	TRBV6-2	TRBJ1-5
TGCGCCAGCAGTGGACAGCCGGCTCCTTCCTACGAGCAGTACTTC	CASSGQPAPSYEQYF	TRBV10-1	TRBJ2-7
TGTGCCAGCAGTCAGACAGGGGAATCGTACGAGCAGTACTTC	CASSQTGESYEQYF	TRBV6-5	TRBJ2-7
TGTGCCAGCAGCTTACGGGGGAGGAAAGAGACCCAGTACTTC	CASSLRGRKETQYF	TRBV7-7	TRBJ2-5
TGCGCCAGCAGCTTCGGGGGTTACCTTAGCTCCTACAATGAGCAGTTCTTC	CASSFGGYLSSYNEQFF	TRBV5-1	TRBJ2-1
TGCAGCGTTGAAAACAAGGGCGGGGGCTATGGCTACACCTTC	CSVENKGGGYGYTF	TRBV29-1	TRBJ1-2
TGTGCCAGCAGTTGCCGGAGGTTCTACGAGCAGTACTTC	CASSCRRFYEQYF	TRBV12-4	TRBJ2-7
TGTGCCAGAGGTTGTTCGACAGGTGGAGCTACGGACAATCAGCCCCAGCATTTT	CARGCSTGGATDNQPQHF	TRBV10-3	TRBJ1-5
TGTGCCAGCAGCCGCAGCGCCTATGGCTACACCTTC	CASSRSAYGYTF	TRBV3-1	TRBJ1-2
TGTGCCAGCAGCCTCGGGGACTATGGCTACACCTTC	CASSLGDYGYTF	TRBV9	TRBJ1-2
TGTGCCAGCAGCCCAGGGGGCAGCCTGGTGTATGGCTACACCTTC	CASSPGGSLVYGYTF	TRBV11-2	TRBJ1-2
TGTGCCAGTAGTATAGCTCGTTGGGGATCGGAAAGGGAGACCCAGTACTTC	CASSIARWGSERETQYF	TRBV19	TRBJ2-5
TGCGCCAGCAGCTTCCCGCGCTACGAGCAGTACTTC	CASSFPRYEQYF	TRBV5-1	TRBJ2-7
TGTGCCAGCAGTTTCCACAGTCGATATGGCTACACCTTC	CASSFHSRYGYTF	TRBV6-2	TRBJ1-2
TGCAGTGCTTCGACTAGGTTGGTCGGCTACACCTTC	CSASTRLVGYTF	TRBV20-1	TRBJ1-2
TGTGCCAGCATCACAGGGCCCAACGAGCAGTACTTC	CASITGPNEQYF	TRBV27	TRBJ2-7
TGTGCCAGCAGCGTAGAAATCGACAGGGTCCCTGACGAGCAGTACTTC	CASSVEIDRVPDEQYF	TRBV9	TRBJ2-7
TGTGCCCTAACAGGGGGCCTTGGAAGTGGGGCCAACGTCCTGACTTTC	CALTGGLGSGANVLTF	TRBV12-3	TRBJ2-6
TGTGCCAGCAGCGGGACACCCGAGACCCAGTACTTC	CASSGTPETQYF	TRBV13	TRBJ2-5
TGTGCCAGCGAGGACGTAGAAATAACAGATACGCAGTATTTT	CASEDVEITDTQYF	TRBV28	TRBJ2-3
TGTGCCAGCAGCTTAGGGGCGGCCAGGTACGAGCAGTACTTC	CASSLGAARYEQYF	TRBV11-2	TRBJ2-7
TGTGCCACCCCATGTCAATCGTTGAACACCGGGGAGCTGTTTTTT	CATPCQSLNTGELFF	TRBV24-1	TRBJ2-2
TGTGCCAGCATTACGACAGGGTTTTGCACTGAAGCTTTCTTT	CASITTGFCTEAFF	TRBV7-9	TRBJ1-1
TGTGCCAGCAGCAGCAGGGGGGGAGGGAACGGGCACAATCAGCCCCAGCATTTT	CASSSRGGGNGHNQPQHF	TRBV13	TRBJ1-5
TGTGCCAGCAGCTTCATAGCACAGGGGAATCAGCCCCAGCATTTT	CASSFIAQGNQPQHF	TRBV6-2	TRBJ1-5
TGTGCCCCCAGGGGAGGCAGGGGGGGTAACTATGGCTACACCTTC	CAPRGGRGGNYGYTF	TRBV7-9	TRBJ1-2
TGTGCCAGCCTCGACAGGGGGTATCCCACGAGGCAGCCCCAGCATTTT	CASLDRGYPTRQPQHF	TRBV6-4	TRBJ1-5
TGTGCCAGCAGTGTTTCACCACAGCGGGAAATATACGAGCAGTACTTC	CASSVSPQREIYEQYF	TRBV6-4	TRBJ2-7
TGCGCCAGCAGCGGCAGTAGGGGACCATGTTCACCCCTCCACTTT	CASSGSRGPCSPLHF	TRBV5-1	TRBJ1-6
TGTGCTAGTACCAAAGATGGGTACAATGAGCAGTTCTTC	CASTKDGYNEQFF	TRBV12-5	TRBJ2-1
TGTGCCAGCAAAGTGACAGGGCTAAGAGGGGGAAAATCTCTCTTATTCTCTGGAAACACCATATATTTT	CASKVTGLRGGKSLLFSGNTIYF	TRBV6-2	TRBJ1-3
TGTGCCAGCAGTATCCGGGACAGGGATGGCTACACCTTC	CASSIRDRDGYTF	TRBV6-5	TRBJ1-2
TGTGCCAGTAGTATGTCCTACAGGGGGGCCTACGAGCAGTACTTC	CASSMSYRGAYEQYF	TRBV19	TRBJ2-7
TGCAGTGCTAGGCCCGGACCGATCAGGGGGGAGAACTGGGAGCAGTACTTC	CSARPGPIRGENWEQYF	TRBV20-1	TRBJ2-7
TGTGCCAGCAGTCCGGGGGGAAATGAGCAGTTCTTC	CASSPGGNEQFF	TRBV6-3	TRBJ2-1
TGTGCCAGCAGTTTATTATCGGCGATTGGCTACACCTTC	CASSLLSAIGYTF	TRBV12-3	TRBJ1-2
TGTGCCAGCAGTGAAGTCAATAGGAAACAGGGGAACACCGGGGAGCTGTTTTTT	CASSEVNRKQGNTGELFF	TRBV6-1	TRBJ2-2
TGTGCCAGCAGCCGAAAGGAGGGCAACGAGCAGTACTTC	CASSRKEGNEQYF	TRBV9	TRBJ2-7
TGTGCCAGCAGCCATCTTAGCCAGACTAGCGGGAGGGACTTGGTATTACGCCAAGAGACCCAGTACTTC	CASSHLSQTSGRDLVLRQETQYF	TRBV3-1	TRBJ2-5
TGTGCCAGCAGCTTAGCCCACAGGCACTATGGCTACACCTTC	CASSLAHRHYGYTF	TRBV11-3	TRBJ1-2
TGTGCCAGCAGCCAAGATTACAGGTCTGGCTACACCTTC	CASSQDYRSGYTF	TRBV14	TRBJ1-2
TGTGCCACCAGTGTTACGTACAGGGTGAGGGACGAGCAGTACTTC	CATSVTYRVRDEQYF	TRBV24-1	TRBJ2-7
TGTGCCAGCAGCCGACGGTATTGGCAGCCCCAGCATTTT	CASSRRYWQPQHF	TRBV9	TRBJ1-5
TGTGCCAGCAGCCCGCAACTATTCGGGGGCGGGGGGGTTTTCTCTGAAGCTTTCTTT	CASSPQLFGGGGVFSEAFF	TRBV7-4	TRBJ1-1
TGTGCCAGCAGCCACACGGAAGAGACCCAGTACTTC	CASSHTEETQYF	TRBV11-3	TRBJ2-5
TGCAGTGCTAGATCCGGGACTAGCCCCCCCTACGAGCAGTACTTC	CSARSGTSPPYEQYF	TRBV20-1	TRBJ2-7
TGTGCCAGCAGTTTTGGTACCGGGACAGTTTTCTACGAGCAGTACTTC	CASSFGTGTVFYEQYF	TRBV27	TRBJ2-7
TGTGCCAGCATCGGCGGACGCTCCTACAATGAGCAGTTCTTC	CASIGGRSYNEQFF	TRBV27	TRBJ2-1
TGCGCCAGCAGCTTGGGTCCGGGGGGGCCGGATTACGAGCAGTACTTC	CASSLGPGGPDYEQYF	TRBV5-1	TRBJ2-7
TGTGCCAGCAGCGGTTTCTTGACAGGGGGCGCTGAAAAACTGTTTTTT	CASSGFLTGGAEKLFF	TRBV7-7	TRBJ1-4
TGTGCCAGCAGCGTCCAGGACAGGGCCTATGGCTACACCTTC	CASSVQDRAYGYTF	TRBV9	TRBJ1-2
TGTGCCAGCACCCGGTTCTGGGGATTTTACACAAATGAGCAGTTCTTC	CASTRFWGFYTNEQFF	TRBV12-4	TRBJ2-1
TGCAGTGCTTCCATAACCACAGATACGCAGTATTTT	CSASITTDTQYF	TRBV20-1	TRBJ2-3
TGTGCCAGCAGTCCCGAGGGGCCTGGGACCGGGGAGCTGTTTTTT	CASSPEGPGTGELFF	TRBV12-3	TRBJ2-2
TGTGCCAGCAGCCAAGAGCGGGGTTACTATGAGCAGTTCTTC	CASSQERGYYEQFF	TRBV3-1	TRBJ2-1
TGTGCCAGCAGCTCTCGGAAAACCAGGGACAGGTGGCCCTACGAGCAGTACTTC	CASSSRKTRDRWPYEQYF	TRBV7-2	TRBJ2-7
TGTGCCAGCAGCAAACGGAGCCCCAAAAACATTCAGTACTTC	CASSKRSPKNIQYF	TRBV7-9	TRBJ2-4
TGTGCCAGCAGCCTGGCGCTAGCGGGGGAGCAGTACTTC	CASSLALAGEQYF	TRBV27	TRBJ2-7
TGTGCCAGCTCCGCATTTCGGGGGGGCTTCAAAAACATTCAGTACTTC	CASSAFRGGFKNIQYF	TRBV6-1	TRBJ2-4
TGCAGTGCTAGAAACGGAATACGTGAGCGGGCGCCCCAGCATTTT	CSARNGIRERAPQHF	TRBV20-1	TRBJ1-5
TGTGCCAGCTCACCAGGGCAGGCTTTCTTT	CASSPGQAFF	TRBV18	TRBJ1-1
TGTGCCAGCAGCAGCCTGGGCTTTGCAGAGGGGGAGCTGTTTTTT	CASSSLGFAEGELFF	TRBV13	TRBJ2-2
TGCAGTGCTAGGAGACGCGCTAGAGAGGCCTACGAGCAGTACTTC	CSARRRAREAYEQYF	TRBV20-1	TRBJ2-7
TGTGCCAGCAGCGACTCGGGGCGCTGGTTTCTTGAAGCTTTCTTT	CASSDSGRWFLEAFF	TRBV9	TRBJ1-1
TGTGCCAGCAGGGGGGTCCAGGGTGGGTATGGCTACACCTTC	CASRGVQGGYGYTF	TRBV6-3	TRBJ1-2
TGCGCCAGCAGCAGCGCTTATTTACTTGAGCAGCAGTTCTTC	CASSSAYLLEQQFF	TRBV5-1	TRBJ2-1
TGCGCCAGCAGCCTGGAGAGCCGGACAGAAGACATCGACACTGAAGCTTTCTTT	CASSLESRTEDIDTEAFF	TRBV4-1	TRBJ1-1
TGCGCCAGCAGCTGGTGCCCGGGACAGGGGACCTGGAGCTACGAGCAGTACTTC	CASSWCPGQGTWSYEQYF	TRBV5-1	TRBJ2-7
TGTGCCAGCACCCAGACCGGGGGCTCCCAAGAGACCCAGTACTTC	CASTQTGGSQETQYF	TRBV7-9	TRBJ2-5
TGTGCCAGCAGTGAAAGCAATCAGCCCCAGCATTTT	CASSESNQPQHF	TRBV12-4	TRBJ1-5
TGTGCCAGCAGCTTAGCAGGGATCAGCGGAGGCTACACCTTC	CASSLAGISGGYTF	TRBV5-4	TRBJ1-2
TGTGCCAGCAGCAGGGGGGGGGGCCCCTCCTACGAGCAGTACTTC	CASSRGGGPSYEQYF	TRBV7-3	TRBJ2-7
TGCGCCAGCAGCCAAGATTCGGAAGAACAGAGCAATGGCTACACCTTC	CASSQDSEEQSNGYTF	TRBV4-3	TRBJ1-2
TGTGCCAGCAGCTTACCCTCTGGTGTTCGGGGGGTAGTAGAGGACCAAGAGACCCAGTACTTC	CASSLPSGVRGVVEDQETQYF	TRBV7-3	TRBJ2-5
TGTGCCAGCAGCTTACCAGGGACAGGTAACACTGAAGCTTTCTTT	CASSLPGTGNTEAFF	TRBV11-3	TRBJ1-1
TGTGCCAGCAGCTTAAATGGTGGCACTGAAGCTTTCTTT	CASSLNGGTEAFF	TRBV7-6	TRBJ1-1
TGCAGTGCGACAGGGGCCAACTATGGCTACACCTTC	CSATGANYGYTF	TRBV20-1	TRBJ1-2
TGTGCCAGCGCACCAGTCCCACCACTCTCAGGGAGTACGCAGTATTTT	CASAPVPPLSGSTQYF	TRBV6-1	TRBJ2-3
TGTGCCTGGAGTAGACTAGCGGGGCAGAATGAGCAGTTCTTC	CAWSRLAGQNEQFF	TRBV30	TRBJ2-1
TGCGCCAGCAGTGATAACGGGGATCTAAGGGTCGAGCAGTACTTC	CASSDNGDLRVEQYF	TRBV10-1	TRBJ2-7
TGTGCCAGCAGCTTACCTGCCGGGACAGGGGTTCGCCAAGAGACCCAGTACTTC	CASSLPAGTGVRQETQYF	TRBV11-3	TRBJ2-5
TGTGCCAGCATTAATGAGGGGACCCAAAATTCACCCCTCCACTTT	CASINEGTQNSPLHF	TRBV2	TRBJ1-6
TGTGCCAGCAGTTGGACAGGCCTGCACACAGATACGCAGTATTTT	CASSWTGLHTDTQYF	TRBV6-4	TRBJ2-3
TGTGCCAGCAGCCGGTGGGGCCGGGGTCTGGACGAGCAGTACTTC	CASSRWGRGLDEQYF	TRBV7-3	TRBJ2-7
TGCGCCAGCAGTAACAGAAAGGGAGATTACGCCAAAAACATTCAGTACTTC	CASSNRKGDYAKNIQYF	TRBV5-1	TRBJ2-4
TGCGCCAGCAGCCGGACGGGAATCCTTGGCACAGATACGCAGTATTTT	CASSRTGILGTDTQYF	TRBV4-1	TRBJ2-3
TGTGCCAGCAGAACCCTGGGGAACCGGAACACTGAAGCTTTCTTT	CASRTLGNRNTEAFF	TRBV6-3	TRBJ1-1
TGTGCCAGCAGCGTAGGTAGGGCAGGGAACACTGAAGCTTTCTTT	CASSVGRAGNTEAFF	TRBV9	TRBJ1-1
TGTGCCAGCAGCAAAGGACTAGTAAGGTTGGGGCACAATGAGCAGTTCTTC	CASSKGLVRLGHNEQFF	TRBV9	TRBJ2-1
TGCGCCAGCAGTGAGTCCCTTCCGGGACAGGCGACTGGGGCCAACGTCCTGACTTTC	CASSESLPGQATGANVLTF	TRBV10-2	TRBJ2-6
TGTGCCACCGTAACCCTACGGGACAGGGGGATAACCAGAGCTAACTATGGCTACACCTTC	CATVTLRDRGITRANYGYTF	TRBV24-1	TRBJ1-2
TGTGCCAGCAGCGGGGGGGCGGTTAATCAGCCCCAGCATTTT	CASSGGAVNQPQHF	TRBV5-5	TRBJ1-5
TGTGCTAGTGGCTCGACAGGGGATGGCTACACCTTC	CASGSTGDGYTF	TRBV12-5	TRBJ1-2
TGCGCCAGCAGGGCCCGTAGTCCAGCGAGGGCATCTGGAAACACCATATATTTT	CASRARSPARASGNTIYF	TRBV4-1	TRBJ1-3
TGTGCCAGTAGTGGGGGGGGGGCGAATGAGCAGTTCTTC	CASSGGGANEQFF	TRBV19	TRBJ2-1
TGTGCCAGCAGTGAATCTACACCCGGGACAGGGGATCAGCCCCAGCATTTT	CASSESTPGTGDQPQHF	TRBV25-1	TRBJ1-5
TGCGCCAGCAGCCCCGGCCCCAATGAGACCCAGTACTTC	CASSPGPNETQYF	TRBV5-1	TRBJ2-5
TGTGCCAGCAGCCGCCCCCGCGGGAGGTCGTACGAGCAGTACTTC	CASSRPRGRSYEQYF	TRBV11-2	TRBJ2-7
TGTGCCAGCAGCGAAGGGGGGGGCTACACCTTC	CASSEGGGYTF	TRBV7-3	TRBJ1-2
TGTGCCTGGAGTTGGGGACTAGCGGGCAGAACCTACGAGCAGTACTTC	CAWSWGLAGRTYEQYF	TRBV30	TRBJ2-7
TGTGCCACCAGGGACGGGGCGCCGAACACTGAAGCTTTCTTT	CATRDGAPNTEAFF	TRBV24-1	TRBJ1-1
TGTGCCAGCTCACCCTTGGACGGGAGTTCCCTATTCGCCTACGAGCAGTACTTC	CASSPLDGSSLFAYEQYF	TRBV18	TRBJ2-7
TGTGCCAGCAGCTTAAGACGCGATGAAAAACTGTTTTTT	CASSLRRDEKLFF	TRBV11-3	TRBJ1-4
TGTGCCAGCAGCTTGGAGGACTTACCAGGGGACTATGGCTACACCTTC	CASSLEDLPGDYGYTF	TRBV5-5	TRBJ1-2
TGTGCCAGCCGTACTCGGACAATCTATGGCTACACCTTC	CASRTRTIYGYTF	TRBV7-9	TRBJ1-2
TGTGCCAGCAGTTTAGGGGAACTCATTGATCAGCCCCAGCATTTT	CASSLGELIDQPQHF	TRBV12-4	TRBJ1-5
TGTGCCAGCAGCGACAGGCGGGGGCTTGATGAGCAGTTCTTC	CASSDRRGLDEQFF	TRBV13	TRBJ2-1
TGTGCCAGCAGCATGGGACTAGCGGGTGGGAACGAATTCGAGACCCAGTACTTC	CASSMGLAGGNEFETQYF	TRBV7-4	TRBJ2-5
TGTGCCGGGACAGGGCGCACAGATACGCAGTATTTT	CAGTGRTDTQYF	TRBV30	TRBJ2-3
TGTGCCAGCAGTCACCCCGGGACAGTAGCCTATACCGGGGAGCTGTTTTTT	CASSHPGTVAYTGELFF	TRBV27	TRBJ2-2
TGTGCCAGCAAGCCGGGACACACCGGGGAGCTGTTTTTT	CASKPGHTGELFF	TRBV7-6	TRBJ2-2
TGTGCCAGCAGTGACTCTCCCCACTCCCGCCCGGGACAGGGAGCTTGGGACGAGCAGTACTTC	CASSDSPHSRPGQGAWDEQYF	TRBV6-4	TRBJ2-7
TGTGCCAGCAGTTACCGGCTGCCGGACAGGGCTTACTACAATGAGCAGTTCTTC	CASSYRLPDRAYYNEQFF	TRBV6-5	TRBJ2-1
TGTGCCAGCAGGTGTGTGGGATGCAACACCGGGGAGCTGTTTTTT	CASRCVGCNTGELFF	TRBV6-1	TRBJ2-2
TGTGCCAGTAGGACTAGGGGCAATCAGCCCCAGCATTTT	CASRTRGNQPQHF	TRBV3-1	TRBJ1-5
TGCAGTGCAGGACACAGGGGATCGAGCTCTGGAAACACCATATATTTT	CSAGHRGSSSGNTIYF	TRBV20-1	TRBJ1-3
TGTGCCAGCAGTGACTCGATTCCAGGGACAGCGCGGATAAACATTCAGTACTTC	CASSDSIPGTARINIQYF	TRBV6-4	TRBJ2-4
TGTGCCAGCAGCGTAGTACCAGGGGGTTTATACGAGCAGTACTTC	CASSVVPGGLYEQYF	TRBV9	TRBJ2-7
TGCAGCGTCAGGGGACGGGCCTCAGATACGCAGTATTTT	CSVRGRASDTQYF	TRBV29-1	TRBJ2-3
TGTGCCAGCAGCTTAAAATACTTCACTAGCGGGAGCTCCTACAATGAGCAGTTCTTC	CASSLKYFTSGSSYNEQFF	TRBV7-2	TRBJ2-1
TGTGTTTCTGCCTACGACAACGTTAAGGGCTACACCTTC	CVSAYDNVKGYTF	TRBV7-3	TRBJ1-2
TGTGCCACCCGGCCAGGGGCGAGGTGGGAGCTGTTTTTT	CATRPGARWELFF	TRBV12-4	TRBJ2-2
TGTGCCAGCAGTGCAAAACGCCCGAATGGCTACACCTTC	CASSAKRPNGYTF	TRBV2	TRBJ1-2
TGTGCCAGCAGCCAGGGGACATATAGCAATCAGCCCCAGCATTTT	CASSQGTYSNQPQHF	TRBV7-4	TRBJ1-5
TGTGCCACGAGAAGGGGGGCCCCGACCGGGGAGCTGTTTTTT	CATRRGAPTGELFF	TRBV19	TRBJ2-2
TGTGCCAGCAGCGGGAGGATAAAGCAGCCCCAGCATTTT	CASSGRIKQPQHF	TRBV7-9	TRBJ1-5
TGTGCCAGTAACCAGGCTAGGACCGAGTACGAGCAGTACTTC	CASNQARTEYEQYF	TRBV12-4	TRBJ2-7
TGTGCCAGCAGCCCCGCAGGGGGGAGTCAGCCCCAGCATTTT	CASSPAGGSQPQHF	TRBV5-5	TRBJ1-5
TGTGCCAGCAGCATATGGAGGGAGGGCTACGAGCAGTACTTC	CASSIWREGYEQYF	TRBV7-4	TRBJ2-7
TGTGCCAGCAGTTTAGAAGGTACGGGGGGGCCGTCAAACAATGAGCAGTTCTTC	CASSLEGTGGPSNNEQFF	TRBV27	TRBJ2-1
TGTGCCAGCAGTTGCCTCCCTCCCGGCTACACCTTC	CASSCLPPGYTF	TRBV28	TRBJ1-2
TGTGCCAGCAGTCCAAACAGGGGGGGATACGAGCAGTACTTC	CASSPNRGGYEQYF	TRBV25-1	TRBJ2-7
TGTGCCAGCAGCTTGAACTTCAAGGGCGTATCGGCCAACGTCCTGACTTTC	CASSLNFKGVSANVLTF	TRBV5-6	TRBJ2-6
TGTGCCAGCAGCTTAGGAAGGGGAGTGGGACTTATAAGAGGAAATAGCAATCAGCCCCAGCATTTT	CASSLGRGVGLIRGNSNQPQHF	TRBV7-2	TRBJ1-5
TGTGCCAGCAGCAGACAGCAGTATTTT	CASSRQQYF	TRBV5-4	TRBJ2-3
TGTGCCAGCAGTTGGGAAGAGACCCAGTACTTC	CASSWEETQYF	TRBV25-1	TRBJ2-5
TGCGCCAGCAGCTTGATAGGGACGTGGCTCGGGGAGCTGTTTTTT	CASSLIGTWLGELFF	TRBV5-1	TRBJ2-2
TGCGCCAGCTTCGAGCCGGACAGCCCGGGGTCAGTGGATGGCTACACCTTC	CASFEPDSPGSVDGYTF	TRBV10-1	TRBJ1-2
TGTGCCAGCAGCTTAGCGCCCCGACAGGGCTACAATGAGCAGTTCTTC	CASSLAPRQGYNEQFF	TRBV7-9	TRBJ2-1
TGTGCCAGCAGCATTTCGATTCCCGGGACTAGCGGGAGTAGTGAGACCCAGTACTTC	CASSISIPGTSGSSETQYF	TRBV13	TRBJ2-5
TGTGCCAGCAGCTTCTTAGGCCCGAACACCGGGGAGCTGTTTTTT	CASSFLGPNTGELFF	TRBV7-3	TRBJ2-2
TGTGCCCAGGGTCCCAAAAACATTCAGTACTTC	CAQGPKNIQYF	TRBV7-3	TRBJ2-4
TGTGCTAGTGTTCGGGGACTAGCGGGAGAGAGCTCCTACAATGAGCAGTTCTTC	CASVRGLAGESSYNEQFF	TRBV12-5	TRBJ2-1
TGTGCCAGCAGCCCAAAGTTCAGGGACGAGCAGTACTTC	CASSPKFRDEQYF	TRBV14	TRBJ2-7
TGTGCCAGCAGTTTGGTTTCGACAGGTACTGAAGCTTTCTTT	CASSLVSTGTEAFF	TRBV12-3	TRBJ1-1
TGTGCCAGTAGTGAACGCGGACAGGGGATTCGGGAGCTGTTTTTT	CASSERGQGIRELFF	TRBV19	TRBJ2-2
TGTGCCAGCAGGGGAGGTAGTTCCGCCGGGACTAAGACCCACGAAAAACTGTTTTTT	CASRGGSSAGTKTHEKLFF	TRBV7-8	TRBJ1-4
TGTGCCAGCAGTGGACAGGGGGCGGTCGTGAACACCGGGGAGCTGTTTTTT	CASSGQGAVVNTGELFF	TRBV6-4	TRBJ2-2
TGTGCCAGCCTTTTATTACCAGATACGCAGTATTTT	CASLLLPDTQYF	TRBV6-4	TRBJ2-3
TGTGCCAGCATGCCGGGACAGGGCTTCCGGGGCACAGATACGCAGTATTTT	CASMPGQGFRGTDTQYF	TRBV12-3	TRBJ2-3
TGTGCCAGCAGTGAATGTAGAGGACAGGGCACAGATACGCAGTATTTT	CASSECRGQGTDTQYF	TRBV6-1	TRBJ2-3
TGTGCCAGCAGTGACAAGCCGTTCCTTAGGGGACAGCTTAGGAACACTGAAGCTTTCTTT	CASSDKPFLRGQLRNTEAFF	TRBV6-4	TRBJ1-1
TGTGCCAGTAGTGGACTAGCGGTTCCCTACGAGCAGTACTTC	CASSGLAVPYEQYF	TRBV19	TRBJ2-7
TGTGCTAGCATGGGACAGAACTATGGCTACACCTTC	CASMGQNYGYTF	TRBV12-5	TRBJ1-2
TGTGCCAGCAGCTTAGTCGGACCACGGGGGTATAGATGCTCTGGAAACACCATATATTTT	CASSLVGPRGYRCSGNTIYF	TRBV11-3	TRBJ1-3
TGTGCCAGCAGCCAAGAAAGACGGAATTTTCCCGAGCAGTACTTC	CASSQERRNFPEQYF	TRBV14	TRBJ2-7
TGCGCCAGCGTTGCCCGACAGGGATGTGATCAGCCCCAGCATTTT	CASVARQGCDQPQHF	TRBV10-1	TRBJ1-5
TGCGCCAGCAGCCGAGGTGATCCGGCCTTGGCTGGAAACACCATATATTTT	CASSRGDPALAGNTIYF	TRBV4-1	TRBJ1-3
TGTGCCAGCAGCAGGGGGGGCTGGCGGCGCACAGATACGCAGTATTTT	CASSRGGWRRTDTQYF	TRBV6-4	TRBJ2-3
TGTGCCAGCAGCGGAAGGACTTATCAGCCCCAGCATTTT	CASSGRTYQPQHF	TRBV13	TRBJ1-5
TGTGCCACCGTTCAGTGCAGGGGTGAGCAGTACTTC	CATVQCRGEQYF	TRBV24-1	TRBJ2-7
TGTGCCAGCCCGGGGACAACAAGCTCCTACGAGCAGTACTTC	CASPGTTSSYEQYF	TRBV3-1	TRBJ2-7
TGCTATGGCACTAGGGGGGAGCTGTTTTTT	CYGTRGELFF	TRBV20-1	TRBJ2-2
TGTGCCAGCAGCCGAAAAAAGGGTTGTTGCTCCTACAATGAGCAGTTCTTC	CASSRKKGCCSYNEQFF	TRBV11-3	TRBJ2-1
TGTGCCACGAAAGAGGGGGAAAACACCATATATTTT	CATKEGENTIYF	TRBV10-3	TRBJ1-3
TGTGCCAGCATCCCGGGACAGGGGCTTCAGCCCCAGCATTTT	CASIPGQGLQPQHF	TRBV12-4	TRBJ1-5
TGTGCCACTTTGGGTCCCCGGACTAGCGGGCGCTACGAGCAGTACTTC	CATLGPRTSGRYEQYF	TRBV24-1	TRBJ2-7
TGCGCCAGCAGTGAGGGAACCGCGACAGGGAGGAGACCTAACTATGGCTACACCTTC	CASSEGTATGRRPNYGYTF	TRBV10-1	TRBJ1-2
TGTGCCAGCAGCCCCCCTATAGTCCCTCAGGGGGGTGAAGCTTTCTTT	CASSPPIVPQGGEAFF	TRBV7-9	TRBJ1-1
TGTGCCAGCAGCGCCTCTTCGGGACTAGCGCTGGAGCTGTTTTTT	CASSASSGLALELFF	TRBV7-8	TRBJ2-2
TGTGCCAGCCCCAAGCTTTACAGGGAGCAGTTCTTC	CASPKLYREQFF	TRBV6-4	TRBJ2-1
TGTGCCAGCAGAAAAGGGGACAGGGACGAGCAGTACTTC	CASRKGDRDEQYF	TRBV7-4	TRBJ2-7
TGTGCCAGTACCCCGCGGGAGTCCTATGGCTACACCTTC	CASTPRESYGYTF	TRBV19	TRBJ1-2
TGCAGTGCTCACAAATTGGACCCCCGCTGGCGTCTATGGGTGAACACTGAAGCTTTCTTT	CSAHKLDPRWRLWVNTEAFF	TRBV20-1	TRBJ1-1
TGTGCCAAGGGCGGCGAGCAGTACTTC	CAKGGEQYF	TRBV30	TRBJ2-7
TGTGCCAGCAGCTTAAAGGGGCCCCCCTACAATGAGCAGTTCTTC	CASSLKGPPYNEQFF	TRBV5-6	TRBJ2-1
TGTGCCAGCAGCCCTCGGGACTTCCCCTACGAGCAGTACTTC	CASSPRDFPYEQYF	TRBV5-6	TRBJ2-7
TGTGCCAGCAGCCAAGAGTTATGGTTCCGGTGCACAGATACGCAGTATTTT	CASSQELWFRCTDTQYF	TRBV4-2	TRBJ2-3
TGTGCTAGCAGCTTAGCGGGTACCTACGAGCAGTACTTC	CASSLAGTYEQYF	TRBV7-7	TRBJ2-7
TGCAGTGCTAGAGGCCAATCCAGGGGCTGGGCCCGGAGCATCGGAAACACCATATATTTT	CSARGQSRGWARSIGNTIYF	TRBV20-1	TRBJ1-3
TGTGCCAGCAGCTTAATCGGTGGAGATGAGTTGGGAAGCGGGGAGCTGTTTTTT	CASSLIGGDELGSGELFF	TRBV7-2	TRBJ2-2
TGTGCCAGCAGTTTCCCATCGGGACAGGGGGCGTATCAGCCCCAGCATTTT	CASSFPSGQGAYQPQHF	TRBV12-4	TRBJ1-5
TGTGCCACCAGTGTCCTTCAGCCGCCGACTAGCGGGCACAATGAGCAGTTCTTC	CATSVLQPPTSGHNEQFF	TRBV24-1	TRBJ2-1
TGTGCCAGCAGTTTTCTAGATACGCAGTATTTT	CASSFLDTQYF	TRBV12-3	TRBJ2-3
TGCAGTGCTAGAGTCCACCAGTGTATCACTGAAGCTTTCTTT	CSARVHQCITEAFF	TRBV20-1	TRBJ1-1
TGTGCCAGCACGCCACAGGGGGCCGCCGACGCTTTCTTT	CASTPQGAADAFF	TRBV6-4	TRBJ1-1
TGTGCCAGCGGGGGACTAGCGGGGCCGGGGGAGACCCAGTACTTC	CASGGLAGPGETQYF	TRBV27	TRBJ2-5
TGTGCCAATCACAGGGTAGACACTGAAGCTTTCTTT	CANHRVDTEAFF	TRBV28	TRBJ1-1
TGTGCCAGCATGGGGAGGATGAACACTGAAGCTTTCTTT	CASMGRMNTEAFF	TRBV27	TRBJ1-1
TGTGCCAGCAGGGGGGCAACTAATGAAAAACTGTTTTTT	CASRGATNEKLFF	TRBV11-2	TRBJ1-4
TGTGCCAGCAGCCAAGACAAGGTGGAAGCGAAGCTCGTTAGCAATCAGCCCCAGCATTTT	CASSQDKVEAKLVSNQPQHF	TRBV4-2	TRBJ1-5
TGTGCCAGCAGCAACAGGGATCAGCCCCAGCATTTT	CASSNRDQPQHF	TRBV7-3	TRBJ1-5
TGCGCCAGCAGCTTGGTCGCTGCTAGTGGGGTTAGGAACACTGAAGCTTTCTTT	CASSLVAASGVRNTEAFF	TRBV5-1	TRBJ1-1
TGCGCCAGCAGCTTTTTGAAGGGCGGGAGAGGAAACACCATATATTTT	CASSFLKGGRGNTIYF	TRBV5-1	TRBJ1-3
TGTGCCAGCAGCCAATGTCCCGGGACTAGCGGGCGCCATGAGCAGTTCTTC	CASSQCPGTSGRHEQFF	TRBV14	TRBJ2-1
TGTGCCAGCAGCTCTAGGCAAGAAGAGACCCAGTACTTC	CASSSRQEETQYF	TRBV5-4	TRBJ2-5
TGTGCCAGCAGCGGAACCGGGAACCTAGCGGGGAATCCTTTCGGGCGGGAGACCCAGTACTTC	CASSGTGNLAGNPFGRETQYF	TRBV7-6	TRBJ2-5
TGCAGTGCAAGGGGGCTCGAGACCCAGTACTTC	CSARGLETQYF	TRBV20-1	TRBJ2-5
TGTGCCACCAGTGATAGGGGACAGGGTGCAAATGAAAAACTGTTTTTT	CATSDRGQGANEKLFF	TRBV24-1	TRBJ1-4
TGTGCCAGCAGCTTGGGATACAGAGAACCCGGGGAGCTGTTTTTT	CASSLGYREPGELFF	TRBV5-8	TRBJ2-2
TGTGCCACCAGCACCCCAGGGGGCGGCTACACCTTC	CATSTPGGGYTF	TRBV15	TRBJ1-2
TGTGCCAGCAGCTTAAAACGACAGACCAAGGCTTTCTTT	CASSLKRQTKAFF	TRBV7-2	TRBJ1-1
TGCGCCAGCAGCCCCCAGGGGGAATTGAACACTGAAGCTTTCTTT	CASSPQGELNTEAFF	TRBV5-1	TRBJ1-1
TGCAGTGCTAGAGATAACCTCCGATCTGACCGACAGGGTTTCACCATATATTTT	CSARDNLRSDRQGFTIYF	TRBV20-1	TRBJ1-3
TGCAGTGCTAGAGATTGTCAATGGGGTTACTTTTCCTACGAGCAGTACTTC	CSARDCQWGYFSYEQYF	TRBV20-1	TRBJ2-7
TGTGCCAGCAGCTTTTGGGATGGGGATGATACGCAGTATTTT	CASSFWDGDDTQYF	TRBV7-9	TRBJ2-3
TGCAGTGCTATCACTGGAAGTGGGGCCAACGTCCTGACTTTC	CSAITGSGANVLTF	TRBV20-1	TRBJ2-6
TGTGCCAGCAGCGTCTCTCAGGGCCACAATACCGGGGAGCTGTTTTTT	CASSVSQGHNTGELFF	TRBV6-4	TRBJ2-2
TGTGCCAGCAGCTCTCTCCGGAAGGGTGGACAGGGAGGTAGGTGGACCGGGGAGCTGTTTTTT	CASSSLRKGGQGGRWTGELFF	TRBV7-3	TRBJ2-2
TGTGCCAGTAAACAGGGGGCCCACACTGAAGCTTTCTTT	CASKQGAHTEAFF	TRBV6-6	TRBJ1-1
TGTGCCAGCAGCCTGGACAGGGGACCCCTCCACTTT	CASSLDRGPLHF	TRBV13	TRBJ1-6
TGTGCCAGCAGCGTAGGGGGCAGGCGGGCCTACGAGCAGTACTTC	CASSVGGRRAYEQYF	TRBV9	TRBJ2-7
TGCAGTGCCGGGGGGAGAGATCCCTACGAGCAGTACTTC	CSAGGRDPYEQYF	TRBV20-1	TRBJ2-7
TGTGCCAGCAGCTACCGTCGCACCGGGGAGCTGTTTTTT	CASSYRRTGELFF	TRBV7-9	TRBJ2-2
TGTGCCAGCAGCGAGTCACAAGAGACCCAGTACTTC	CASSESQETQYF	TRBV9	TRBJ2-5
TGCAGTGCTAGGGGACAGGGGGGGTCCTCCGGGGAGCTGTTTTTT	CSARGQGGSSGELFF	TRBV20-1	TRBJ2-2
TGTGCCACCAGTGACCACTGGGGCTCAGATACGCAGTATTTT	CATSDHWGSDTQYF	TRBV24-1	TRBJ2-3
TGCGCCAGCATGACAGGGGGCCCTCGTGATACGAACACCGGGGAGCTGTTTTTT	CASMTGGPRDTNTGELFF	TRBV5-1	TRBJ2-2
TGCAGCGTTGAAGATCTACTAGGGGGCTCCAACTATGGCTACACCTTC	CSVEDLLGGSNYGYTF	TRBV29-1	TRBJ1-2
TGTGCCAGCATAGCGGGGGCCTACGAGCAGTACTTC	CASIAGAYEQYF	TRBV6-8	TRBJ2-7
TGTGCCAGCAGTTTAAAAGCTAGCGGGACTTACAATGAGCAGTTCTTC	CASSLKASGTYNEQFF	TRBV28	TRBJ2-1
TGTGCCAGCAGTTGGCTTAGGACTAGCGGGTTCAATGAGCAGTTCTTC	CASSWLRTSGFNEQFF	TRBV6-2	TRBJ2-1
TGCGCCAGCAGCCCAGAGCGGGAGAAAATTAACACTGAAGCTTTCTTT	CASSPEREKINTEAFF	TRBV4-1	TRBJ1-1
TGCGCCAGCAGCCAAAATAGAAATACTAGCGGGCACTACGAGCAGTACTTC	CASSQNRNTSGHYEQYF	TRBV4-3	TRBJ2-7
TGTGCCAGCAGCGCTAGACTAGCGGGCACAGATACGCAGTATTTT	CASSARLAGTDTQYF	TRBV7-9	TRBJ2-3
TGTGCCAGCACAACAGTGGACAGGGCTGGGGCCAACGTCCTGACTTTC	CASTTVDRAGANVLTF	TRBV12-4	TRBJ2-6
TGTGCCAGCAGTTACCAGGGGGCGCGGGGTTACTATGGCTACACCTTC	CASSYQGARGYYGYTF	TRBV6-2	TRBJ1-2
TGTGCCGACCGGGACGGGGTCTATGGCTACACCTTC	CADRDGVYGYTF	TRBV10-3	TRBJ1-2
TGTGCCAAACCTGGGGGCACAGATACGCAGTATTTT	CAKPGGTDTQYF	TRBV19	TRBJ2-3
TGCGCCAGCAGCCGACCCGAACATTGGGTAGCGGGGAACGCCTCCTACGAGCAGTACTTC	CASSRPEHWVAGNASYEQYF	TRBV4-3	TRBJ2-7
TGTGCCAGCAGATCGGCCGGGACGAGTACGGGTGGCACAGATACGCAGTATTTT	CASRSAGTSTGGTDTQYF	TRBV6-5	TRBJ2-3
TGTGCCAGCAGCTTAGAACAGGGGCCGGCGGGGCTCGAGACCCAGTACTTC	CASSLEQGPAGLETQYF	TRBV7-8	TRBJ2-5
TGCGCCAGCAGGGTTACGAAAGACAATGAGCAGTTCTTC	CASRVTKDNEQFF	TRBV10-2	TRBJ2-1
TGTGCCAGCAGCTCCGGACTAGCGGTGAATAGCACAGATACGCAGTATTTT	CASSSGLAVNSTDTQYF	TRBV7-3	TRBJ2-3
TGCAGCGGTGGGTTAGGCGGGAGGCATAACCGAAGTAATAGTAGGTGCTCTGAAAAACTGTTTTTT	CSGGLGGRHNRSNSRCSEKLFF	TRBV29-1	TRBJ1-4
TGTGCCAGCAGCTTAGTTCTATCCCCGGCAAGGGGAGGGGGACCTGCCTACGAGCAGTACTTC	CASSLVLSPARGGGPAYEQYF	TRBV7-7	TRBJ2-7
TGTGCCAGCAGCTCCAGGGCTCGACCCGACTATGGCTACACCTTC	CASSSRARPDYGYTF	TRBV9	TRBJ1-2
TGTGCCAGCAACGGACGATCGACAGATACGCAGTATTTT	CASNGRSTDTQYF	TRBV27	TRBJ2-3
TGTGCCAGCAGCTTGGGGGGCCAGCGGGAAAGCAATGAGCAGTTCTTC	CASSLGGQRESNEQFF	TRBV5-4	TRBJ2-1
TGCGCCAGCAGCCCACTAAATGAAAAACTGTTTTTT	CASSPLNEKLFF	TRBV4-1	TRBJ1-4
TGTGCCAGCAGCCACCTGACCTACGAGCAGTACTTC	CASSHLTYEQYF	TRBV6-4	TRBJ2-7
TGTGCCAGCAGTTTACCCCCTAGCGGGAGGCGGTCCTACGAGCAGTACTTC	CASSLPPSGRRSYEQYF	TRBV12-4	TRBJ2-7
TGTGCCAGCAGCTTCAGCGGAGAGGGGGCGGACTATGGCTACACCTTC	CASSFSGEGADYGYTF	TRBV7-6	TRBJ1-2
TGCGCCAGCAGCTTGATACCCAGGGGGCGCACCCCCATGAACACTGAAGCTTTCTTT	CASSLIPRGRTPMNTEAFF	TRBV5-1	TRBJ1-1
TGTGCCAGCACCCCCTCGACGACGGACCCGATTTACGAGCAGTACTTC	CASTPSTTDPIYEQYF	TRBV6-5	TRBJ2-7
TGCAGTGCTAGTCTGGACGGACATGGGGGGGAAGAACGTACGTACAATGAGCAGTTCTTC	CSASLDGHGGEERTYNEQFF	TRBV20-1	TRBJ2-1
TGCAGTGCGCCACGCCGCTACGAGCAGTACTTC	CSAPRRYEQYF	TRBV20-1	TRBJ2-7
TGTGCCAGCAGGGACGGGACAGGGAGTGGATTCTACGAGCAGTACTTC	CASRDGTGSGFYEQYF	TRBV2	TRBJ2-7
TGTGCCTGGAGTGAGCCCGAGGAGACCCAGTACTTC	CAWSEPEETQYF	TRBV30	TRBJ2-5
TGTGCCAGCAGACCGCGCACGGCCCGAGCCCAGCAGTACTTC	CASRPRTARAQQYF	TRBV11-2	TRBJ2-7
TGCGCCAGCAGTGAGTCCAGGACAGGGTTTCTCTTGGGCGGTAGCTCTGGAAACACCATATATTTT	CASSESRTGFLLGGSSGNTIYF	TRBV10-1	TRBJ1-3
TGTGCCAGCAGCTTAGCCGGGACAGGTTTGAGCGCCAAAAACATTCAGTACTTC	CASSLAGTGLSAKNIQYF	TRBV13	TRBJ2-4
TGCGCCAGGATCCCCACAGGGGGGAAAAACATTCAGTACTTC	CARIPTGGKNIQYF	TRBV5-1	TRBJ2-4
TGTGCCAGCAGCACCCCCTTCGGGGGGGGTTCACCCCTCCACTTT	CASSTPFGGGSPLHF	TRBV9	TRBJ1-6
TGCGCCAGCAGTCAAGACAGGGGAAACACCATATATTTT	CASSQDRGNTIYF	TRBV10-1	TRBJ1-3
TGTGCCAGCAGCTTATACCAAAGCTACGAACCGACCATTGGCTTAGATACGCAGTATTTT	CASSLYQSYEPTIGLDTQYF	TRBV7-9	TRBJ2-3
TGTGCCAGCAGTGAGAACCTCCTCCGGGACAGGACTGTCCGGAATTCACCCCTCCACTTT	CASSENLLRDRTVRNSPLHF	TRBV6-1	TRBJ1-6
TGTGCCAGCAGTCCCCCTTCAGAACGCCCCAGGGAGGAGACCCAGTACTTC	CASSPPSERPREETQYF	TRBV6-2	TRBJ2-5
TGTGCCAGCAGTCCTAACGTGGAGACCCAGTACTTC	CASSPNVETQYF	TRBV6-1	TRBJ2-5
TGTGCCAGCAGCTTGGGTAGGGTTGGCTACACCTTC	CASSLGRVGYTF	TRBV5-6	TRBJ1-2
TGTGCCAGCAGCGTCCTTGGACAGGGAAGCTATGGCTACACCTTC	CASSVLGQGSYGYTF	TRBV9	TRBJ1-2
TGTGCCAGCAGCCTTATCCCTGGAAGTTCAGATACGCAGTATTTT	CASSLIPGSSDTQYF	TRBV9	TRBJ2-3
TGCAGCGTTGCCCGGGAAAAACTGTTTTTT	CSVAREKLFF	TRBV29-1	TRBJ1-4
TGTGCCAGTAGTATTTCCCCCGTTTCGGGACACGACGAGGGGGCTTTCTTT	CASSISPVSGHDEGAFF	TRBV19	TRBJ1-1
TGTGCCAGCAGAGGACAGGGCTATGGCTACACCTTC	CASRGQGYGYTF	TRBV27	TRBJ1-2
TGTGCCAGCAGTTTGGACAGGGGGGCCTACGAGCAGTACTTC	CASSLDRGAYEQYF	TRBV28	TRBJ2-7
TGCGCCAGCGGCCGTTACGACTCCTACGAGCAGTACTTC	CASGRYDSYEQYF	TRBV10-1	TRBJ2-7
TGTGCCAGCAGCTGGCTCCCCAGTTTCCCGGGGCATATACCCAACATTCAGTACTTC	CASSWLPSFPGHIPNIQYF	TRBV7-9	TRBJ2-4
TGTGCCATCAGTGAGCAGGCTAAAATTCAGCCCCAGCATTTT	CAISEQAKIQPQHF	TRBV10-3	TRBJ1-5
TGTGCCAGCAGGCCGGGGGGGCCCCTTTCGATGGAGACCCAGTACTTC	CASRPGGPLSMETQYF	TRBV7-9	TRBJ2-5
TGTGCCAGTACTGGTCAGGCAATTTATGGCTACACCTTC	CASTGQAIYGYTF	TRBV19	TRBJ1-2
TGCGCCAGCAGTGCCTGGGGTAGCGAAAAACTGTTTTTT	CASSAWGSEKLFF	TRBV10-2	TRBJ1-4
TGTGCCAGCAGCGACCGCCAGGGGGCTGAGGGGAATACTGAAGCTTTCTTT	CASSDRQGAEGNTEAFF	TRBV5-6	TRBJ1-1
TGTGCCAGCGTTGGGACGCCAGGCTATAATTCACCCCTCCACTTT	CASVGTPGYNSPLHF	TRBV27	TRBJ1-6
TGTGCCAGCAGTTTAGCTCCCGGGACTAGCGGGAGCGATGATGAGCAGTTCTTC	CASSLAPGTSGSDDEQFF	TRBV28	TRBJ2-1
TGTGCCAGCAGATTAAGTCACCTTGAGCAGTTCTTC	CASRLSHLEQFF	TRBV5-6	TRBJ2-1
TGTGCCTGGAGTGTAGATAAGAGGACAACCGGGGCTGCAACTAATGAAAAACTGTTTTTT	CAWSVDKRTTGAATNEKLFF	TRBV30	TRBJ1-4
TGTGCCATTGGAGGGAGGTATTCACCCCTCCACTTT	CAIGGRYSPLHF	TRBV12-4	TRBJ1-6
TGCGCCAGCAGAATGTGTTCTCCAGGGGCCACCGGGGAGCTGTTTTTT	CASRMCSPGATGELFF	TRBV10-2	TRBJ2-2
TGTGCCAGCGGTTGGACAGGGGGCAGAGTGCCCCAGCATTTT	CASGWTGGRVPQHF	TRBV6-1	TRBJ1-5
TGTGCCAGCAGCAAGCGGGGGGTGAACACTGAAGCTTTCTTT	CASSKRGVNTEAFF	TRBV14	TRBJ1-1
TGTGCCAGTAGTATTCCCGATCTAGACAGGGGGAGGAACACTGAAGCTTTCTTT	CASSIPDLDRGRNTEAFF	TRBV19	TRBJ1-1
TGTGCCAGCAGCGTAGCGGAGGGGGGGTACGAGCAGTACTTC	CASSVAEGGYEQYF	TRBV7-9	TRBJ2-7
TGCAGCGTCAAGGGGGGCTACGAGCAGTACTTC	CSVKGGYEQYF	TRBV29-1	TRBJ2-7
TGCAGTGCTACAAATCCGCTCCAGGTTGTAGCTTTCTTT	CSATNPLQVVAFF	TRBV20-1	TRBJ1-1
TGTGCCAGTAAGGTAACCTTCGTACCAGGGGATAGCAATCAGCCCCAGCATTTT	CASKVTFVPGDSNQPQHF	TRBV19	TRBJ1-5
TGTGCCAGCAAGCAGACGTGCTACGAGCAGTACTTC	CASKQTCYEQYF	TRBV6-1	TRBJ2-7
TGCGCCACGGTTGACAGGGCTTCCTACGAGCAGTACTTC	CATVDRASYEQYF	TRBV5-1	TRBJ2-7
TGTGCCAGCAGCGGAGCCCGGGAATCAATCAACACCGGGGAGCTGTTTTTT	CASSGARESINTGELFF	TRBV7-3	TRBJ2-2
TGTGCCAGCACAGGCACAGATACGCAGTATTTT	CASTGTDTQYF	TRBV18	TRBJ2-3
TGTGCCAGCAGCCAGAGGGGGGCAAATGAAAAACTGTTTTTT	CASSQRGANEKLFF	TRBV4-2	TRBJ1-4
TGCAGTGCTAGCGCAAAACTACACAGGAGTTACAATGAGCAGTTCTTC	CSASAKLHRSYNEQFF	TRBV20-1	TRBJ2-1
TGTGCCAGCTCTCTCTACACCGGGGAGCTGTTTTTT	CASSLYTGELFF	TRBV11-3	TRBJ2-2
TGTGCCAGCAGCTTGGAGGTAAGGGAGGAGCCCATGAACACTGAAGCTTTCTTT	CASSLEVREEPMNTEAFF	TRBV5-6	TRBJ1-1
TGTGCCAGCAGCGTAGCACATAGGCCTAATGAAAAACTGTTTTTT	CASSVAHRPNEKLFF	TRBV9	TRBJ1-4
TGTGCCAGCAGCTCTAGCGGGTTGGGGGGCACAGATACGCAGTATTTT	CASSSSGLGGTDTQYF	TRBV13	TRBJ2-3
TGCAGTGCGGTGGGCGTCTACGAGCAGTACTTC	CSAVGVYEQYF	TRBV20-1	TRBJ2-7
TGTGCCAGCAGTTGGGAAACCTTACAGGGACGCTCTGAAGCTTTCTTT	CASSWETLQGRSEAFF	TRBV9	TRBJ1-1
TGTGCCAGCAGCTTAGCAGGATGGGGTGAGGGGACCGGGGAGCTGTTTTTT	CASSLAGWGEGTGELFF	TRBV7-6	TRBJ2-2
TGTGCCAGCAGGGGTCTAGTCGGGATGAGCTCCTACAATGAGCAGTTCTTC	CASRGLVGMSSYNEQFF	TRBV27	TRBJ2-1
TGCGCCAGCAGCCTGCCGGCCTCTTACAATGAGCAGTTCTTC	CASSLPASYNEQFF	TRBV4-1	TRBJ2-1
TGCAGTCTCCAGCGAAAAGATACGCAGTATTTT	CSLQRKDTQYF	TRBV20-1	TRBJ2-3
TGTGCCAGCAGCCCCAGAATGGGGAGACAGCAGTTCTTC	CASSPRMGRQQFF	TRBV11-1	TRBJ2-1
TGTGCCAGCAGCGAGGGACGGGCTCACTACGAGCAGTACTTC	CASSEGRAHYEQYF	TRBV7-8	TRBJ2-7
TGTGCCAGCAGCCTCAATACTCTAGGACTAGCGGGCTACGAGCAGTACTTC	CASSLNTLGLAGYEQYF	TRBV5-4	TRBJ2-7
TGTGCCAGCAGTTACTGGGGATCGACGCGATACAATGAGCAGTTCTTC	CASSYWGSTRYNEQFF	TRBV6-6	TRBJ2-1
TGTGCCAGTAGTATCCGGGGAAGGTATAATTCACCCCTCCACTTT	CASSIRGRYNSPLHF	TRBV19	TRBJ1-6
TGCGCCAGACCCCAGAGACAGGGGGAAGCTGATTCTCTGAACACTGAAGCTTTCTTT	CARPQRQGEADSLNTEAFF	TRBV10-1	TRBJ1-1
TGTGCCAGCAGCCAAGTATGGGCCCGAAAGCAGTTCTTC	CASSQVWARKQFF	TRBV4-2	TRBJ2-1
TGTGCCAGCAGGCGGGGGGGTCGTAGTAGGACAGATACGCAGTATTTT	CASRRGGRSRTDTQYF	TRBV6-4	TRBJ2-3
TGTGCCAGCAGTGACGTCGGGACAGGGTACAATGAGCAGTTCTTC	CASSDVGTGYNEQFF	TRBV6-4	TRBJ2-1
TGTGCCAGCAGGTGCACGGGCGGGCGTTCGAACACTGAAGCTTTCTTT	CASRCTGGRSNTEAFF	TRBV6-5	TRBJ1-1
TGTGCCAGTAGGGGGGGGCCTTCGGACGAGCAGTACTTC	CASRGGPSDEQYF	TRBV19	TRBJ2-7
TGTGCCAGCAGCTGCCCATCCCTAGCGGGGGCGACAGTCGAGCAGTACTTC	CASSCPSLAGATVEQYF	TRBV5-6	TRBJ2-7
TGTGCCAGCAGACCCCTCCGCCGGGACAGGGATTTGGACAATGAGCAGTTCTTC	CASRPLRRDRDLDNEQFF	TRBV13	TRBJ2-1
TGTGCCAGCAGCCAGGGGGAAATACGCACAGATACGCAGTATTTT	CASSQGEIRTDTQYF	TRBV3-1	TRBJ2-3
TGTGCCAGCAGCTTTAGAGCTAATAGCAATCAGCCCCAGCATTTT	CASSFRANSNQPQHF	TRBV7-3	TRBJ1-5
TGTGCCAGCAGCGTCTCAGGGGGCAATCAGCCCCAGCATTTT	CASSVSGGNQPQHF	TRBV9	TRBJ1-5
TGCGCCAGCACAGGGCGGGTCTCCTACGAGCAGTACTTC	CASTGRVSYEQYF	TRBV10-2	TRBJ2-7
TGCAGTGCTAGAGCACTAGCTCGTACTAGCGCTAGCACCGGGGAGCTGTTTTTT	CSARALARTSASTGELFF	TRBV20-1	TRBJ2-2
TGTGCCAGTAGTCAATCTCAAGTCTACAATGAGCAGTTCTTC	CASSQSQVYNEQFF	TRBV19	TRBJ2-1
TGCAGTGCTAGAAAAAAAGTAGCGGGAGGGACTAGCACCGGGGAGCTGTTTTTT	CSARKKVAGGTSTGELFF	TRBV20-1	TRBJ2-2
TGTGCCAGCAGTTTATCTAGCGGGGCAATCGAGCAGTACTTC	CASSLSSGAIEQYF	TRBV12-3	TRBJ2-7
TGTGCCAGCACCACCGACAGGCTGGATGAGCAGTACTTC	CASTTDRLDEQYF	TRBV6-4	TRBJ2-7
TGCGCCAGCAGCTTGGCAGGGGGCCCTGAAGAGACCCAGTACTTC	CASSLAGGPEETQYF	TRBV5-1	TRBJ2-5
TGTGCCAGCAGGAGCAGGGTGGGATACTATGGCTACACCTTC	CASRSRVGYYGYTF	TRBV6-1	TRBJ1-2
TGCGCCAGCGTTCCCGGGACAGGCGAAAAGGTAGGCTACACCTTC	CASVPGTGEKVGYTF	TRBV5-1	TRBJ1-2
TGCGCCAGCAGCCCAACAGGGACGAGGGATCAGCCCCAGCATTTT	CASSPTGTRDQPQHF	TRBV4-3	TRBJ1-5
TGTGCCAGCAGCATTGTACTGGTTCGGAATACGCAGTATTTT	CASSIVLVRNTQYF	TRBV7-3	TRBJ2-3
TGCGCCAGCAGCTTGGGAATTTACAGGGCCTTTGGGTCCTATGGCTACACCTTC	CASSLGIYRAFGSYGYTF	TRBV5-1	TRBJ1-2
TGTGCCAGCAGGGCCTCGTGGGGTGAAGCTTTCTTT	CASRASWGEAFF	TRBV2	TRBJ1-1
TGTGCCAGCAGACCCATAGGGGAGAACACTGAAGCTTTCTTT	CASRPIGENTEAFF	TRBV12-3	TRBJ1-1
TGTGCCACCAGAGGGGGCCTAGCACGGACTGGGGCCAACGTCCTGACTTTC	CATRGGLARTGANVLTF	TRBV24-1	TRBJ2-6
TGTGCCAGCAGCCAAGTGCATCGAATGGGGCTTAGCAATCAGCCCCAGCATTTT	CASSQVHRMGLSNQPQHF	TRBV14	TRBJ1-5
TGTGCCAGCAGTGAGGAACGGAGCTCCTACGAGCAGTACTTC	CASSEERSSYEQYF	TRBV6-4	TRBJ2-7
TGTGCCAGCAGCAAGCAACCGGAGCAGTACTTC	CASSKQPEQYF	TRBV11-1	TRBJ2-7
TGTGCCACCAGTGAGTTGGCGGGACAGGGATTCGTTAATCAGCCCCAGCATTTT	CATSELAGQGFVNQPQHF	TRBV24-1	TRBJ1-5
TGTGCCAGCAGTTTATCTAGCGGGGCAGATACGCAGTATTTT	CASSLSSGADTQYF	TRBV12-4	TRBJ2-3
TGTGCCAGCAGCCTAACCCCGGGACTAAGGGGCGATCCGGGCTACGAGCAGTACTTC	CASSLTPGLRGDPGYEQYF	TRBV13	TRBJ2-7
TGTGCCTGGAGTGTAGGCTCGGGACAAACCCTGAAAGTTCCCTACGAGCAGTACTTC	CAWSVGSGQTLKVPYEQYF	TRBV30	TRBJ2-7
TGTGCCAGTAGTATAGCAGGGGGCAACACCGGGGAGCTGTTTTTT	CASSIAGGNTGELFF	TRBV19	TRBJ2-2
TGTGCCAGCAAACGGAGTCGGAGGTCAGATACGCAGTATTTT	CASKRSRRSDTQYF	TRBV6-3	TRBJ2-3
TGTGCCAGCAGAAAGGGACAGGGAGGCTATGGCTACACCTTC	CASRKGQGGYGYTF	TRBV6-6	TRBJ1-2
TGTGCCAGCAGTAAGAATCGGGGGGTAAGGACCCAGTACTTC	CASSKNRGVRTQYF	TRBV27	TRBJ2-5
TGTGCCAGTAGTATAGTCCTGGACAGGGCCCAATCCTACGAGCAGTACTTC	CASSIVLDRAQSYEQYF	TRBV19	TRBJ2-7
TGTGCCACCAGCCCCATTTCCGGGACAGGGGACGCGTATAGCAATCAGCCCCAGCATTTT	CATSPISGTGDAYSNQPQHF	TRBV15	TRBJ1-5
TGTGCCAGCAGCGGGGACAGGGGTAGGGGGAACACTGAAGCTTTCTTT	CASSGDRGRGNTEAFF	TRBV7-6	TRBJ1-1
TGCAGCGTCCATCCACAGGGGTACGAGCAGTACTTC	CSVHPQGYEQYF	TRBV29-1	TRBJ2-7
TGTGCCAGCAGCAGGGGGGACAGCACAGATACGCAGTATTTT	CASSRGDSTDTQYF	TRBV7-9	TRBJ2-3
TGTGCTAGTGGTTTGTTAACCCGGGGGGCCCTCGAGACCCAGTACTTC	CASGLLTRGALETQYF	TRBV12-5	TRBJ2-5
TGCGCCAGCACTCCGAGGGATAATTCACCCCTCCACTTT	CASTPRDNSPLHF	TRBV10-1	TRBJ1-6
TGTGCCAGCAGCAGAGTAAGGGGACACTCGACTGATCAGCCCCAGCATTTT	CASSRVRGHSTDQPQHF	TRBV13	TRBJ1-5
TGTGCCACCAGTGATTCCTGGGGTCACACCGGGGAGCTGTTTTTT	CATSDSWGHTGELFF	TRBV24-1	TRBJ2-2
TGTGCCAGCTTCCTCCAAAGGCAGACCACTGAAGCTTTCTTT	CASFLQRQTTEAFF	TRBV27	TRBJ1-1
TGTGCCAGCAGCCACCTCCGACTAGCCACCGGGGAGCTGTTTTTT	CASSHLRLATGELFF	TRBV14	TRBJ2-2
TGTGCCAGCAGTTCGGGACAGGGGGCCGAAGGAACGCAGTACTTC	CASSSGQGAEGTQYF	TRBV12-3	TRBJ2-7
TGTGCCAGCAGCAGTCCCCCGGCCGATACGCAGTATTTT	CASSSPPADTQYF	TRBV5-4	TRBJ2-3
TGTGCCAGCAGGAAGGGGGGGGTCTGCTATGGCTACACCTTC	CASRKGGVCYGYTF	TRBV6-1	TRBJ1-2
TGTGCCAGCAGTGACTCGACCGTGTTGTCTCCGGAGACCCAGTACTTC	CASSDSTVLSPETQYF	TRBV6-4	TRBJ2-5
TGCAGTGCAGGGGGCCCCTATCAGTACTCCCTGAACGAGCAGTACTTC	CSAGGPYQYSLNEQYF	TRBV20-1	TRBJ2-7
TGTGCCAGCATGTCACTAGCGGGAGTTTACATTTCTACAGATACGCAGTATTTT	CASMSLAGVYISTDTQYF	TRBV6-4	TRBJ2-3
TGTGCCAGCAGAAACCGCAGACCGGACAGGGACTGTCGTAATCAGCCCCAGCATTTT	CASRNRRPDRDCRNQPQHF	TRBV13	TRBJ1-5
TGTGCCAGCAGCCCGCCCCTTCAGCAAGAGACCCAGTACTTC	CASSPPLQQETQYF	TRBV13	TRBJ2-5
TGTGCCAGCAGTTCAGGGACAGTGGGCTCTGGAAACACCATATATTTT	CASSSGTVGSGNTIYF	TRBV27	TRBJ1-3
TGTGCCAGCAGGAAGAGGGGCGTAAAACTGTTTTTT	CASRKRGVKLFF	TRBV6-5	TRBJ1-4
TGTGCCAGCAGCGGACAGGGTAATCAGCCCCAGCATTTT	CASSGQGNQPQHF	TRBV7-3	TRBJ1-5
TGTGCCAGCATAACCCCGCGGACAGGTCGGGATGAAAAACTGTTTTTT	CASITPRTGRDEKLFF	TRBV6-4	TRBJ1-4
TGCAGTGCTAGGCGGTTGGACGGGACCCGCTCCTACAATGAGCAGTTCTTC	CSARRLDGTRSYNEQFF	TRBV20-1	TRBJ2-1
TGTGCCAGCATGGGCGGGGGACCAGAACAGCCCCAGCATTTT	CASMGGGPEQPQHF	TRBV5-4	TRBJ1-5
TGTGCCAGCAGCTGTGAGAACTACGAGCAGTACTTC	CASSCENYEQYF	TRBV5-4	TRBJ2-7
TGCGCCAGCATCAGGGGTAAGAGGAATTCACCCCTCCACTTT	CASIRGKRNSPLHF	TRBV10-1	TRBJ1-6
TGTGCCACCAGCAGTGGTGCTAGCAAAGAGCAGTTCTTC	CATSSGASKEQFF	TRBV15	TRBJ2-1
TGTGCCATCAGTGAGGGAGAAGGGGCTCGGGATTGTCAGACCCAGTACTTC	CAISEGEGARDCQTQYF	TRBV10-3	TRBJ2-5
TGTGCCAGCAGGCCTGCGGACTCCTCCTCCTACGAGCAGTACTTC	CASRPADSSSYEQYF	TRBV6-5	TRBJ2-7
TGTGCCAGTAGTACTCCCCACAGGGGGCTGGTCCACCATCAGCCCCAGCATTTT	CASSTPHRGLVHHQPQHF	TRBV19	TRBJ1-5
TGCGCCAGCAGCCATATTCAGAATAAGGACAGTGGAGTGGGCAATCAGCCCCAGCATTTT	CASSHIQNKDSGVGNQPQHF	TRBV4-1	TRBJ1-5
TGTGCCAGCAGCCCAGGTCCGGACTTC	CASSPGPDF	TRBV6-2	TRBJ2-7
TGTGCCACCAGTCACCGACTAGCGGGAGGTAGCAATCAGCCCCAGCATTTT	CATSHRLAGGSNQPQHF	TRBV24-1	TRBJ1-5
TGTGCCAGCAGCCAAGATTGGGACAGGGGGGTCTCTGGAAACACCATATATTTT	CASSQDWDRGVSGNTIYF	TRBV3-1	TRBJ1-3
TGCAGTGCTAGACTTGGACAGGGCCGCCGCTACGAGCAGTACTTC	CSARLGQGRRYEQYF	TRBV20-1	TRBJ2-7
TGCGCCAGCAGCCAAGATCAACCCGGGACCTCCTACAATGAGCAGTTCTTC	CASSQDQPGTSYNEQFF	TRBV4-1	TRBJ2-1
TGTGCCAGCAGCGTAGGGGGGGGCCGACACAATGAGCAGTTCTTC	CASSVGGGRHNEQFF	TRBV7-2	TRBJ2-1
TGCAGCGTTGAGGGCGCGACAGGAGCTGAGCCGAACACCGGGGAGCTGTTTTTT	CSVEGATGAEPNTGELFF	TRBV29-1	TRBJ2-2
TGCAGTGCTAGACGGGGGGGCCATTCCTCCTGGCAGTTCTTC	CSARRGGHSSWQFF	TRBV20-1	TRBJ2-1
TGTGCCAGCAGCTTACAGACTCGGAATAGCAATCAGCCCCAGCATTTT	CASSLQTRNSNQPQHF	TRBV5-5	TRBJ1-5
TGTGCCAGCAGCCGGACTGAAGCTTTCTTT	CASSRTEAFF	TRBV3-1	TRBJ1-1
TGCACGACTAGCGGCACTCATGAGCAGTTCTTC	CTTSGTHEQFF	TRBV20-1	TRBJ2-1
TGCAGTGCTAGAGCCGATAGACTCAGGGGGTATGAAAAACTGTTTTTT	CSARADRLRGYEKLFF	TRBV20-1	TRBJ1-4
TGTGCCAGCAGCTTAGCGGGCATCGGAACCATAGACACCGGGGAGCTGTTTTTT	CASSLAGIGTIDTGELFF	TRBV7-2	TRBJ2-2
TGCACCGCGGGAGGACTAAGTTACACCATATATTTT	CTAGGLSYTIYF	TRBV20-1	TRBJ1-3
TGCGCCAGCAGTCCCGACAGGGGGGGCAGCTACGAGCAGTACTTC	CASSPDRGGSYEQYF	TRBV10-1	TRBJ2-7
TGTGCCAGCGTATCGTCGAACACTGAAGCTTTCTTT	CASVSSNTEAFF	TRBV28	TRBJ1-1
TGTGCCAGCAGCAGCACCAATCAGCCCCAGCATTTT	CASSSTNQPQHF	TRBV6-5	TRBJ1-5
TGTGCCAGCAGCTTGGGGGAGGTCGACGACCACTCCTACGAGCAGTACTTC	CASSLGEVDDHSYEQYF	TRBV11-3	TRBJ2-7
TGTGCCAGCAGTCCCTCCCACGAAACAGGGAAGGGGGGTCATCTGAACACTGAAGCTTTCTTT	CASSPSHETGKGGHLNTEAFF	TRBV27	TRBJ1-1
TGCAGTGCTAGAGATCCGGGACAGATCTACTCCTACGAGCAGTACTTC	CSARDPGQIYSYEQYF	TRBV20-1	TRBJ2-7
TGCGCCAGCAGTCTAATATGGGGGAGGGTTAACACCGGGGAGCTGTTTTTT	CASSLIWGRVNTGELFF	TRBV10-1	TRBJ2-2
TGTGCTAGTGGGACAGGAGATCAGCCCCAGCATTTT	CASGTGDQPQHF	TRBV12-5	TRBJ1-5
TGTGCCAGCAGTTTAGACGGACGTTCATATGTCCGGCCCGGGACAGGGGAAGCTGAAGCTTTCTTT	CASSLDGRSYVRPGTGEAEAFF	TRBV27	TRBJ1-1
TGTGCCAGCAGTGATGTGGTGGGGGTCCAGGAGTATGGCTACACCTTC	CASSDVVGVQEYGYTF	TRBV2	TRBJ1-2
TGCGCCAGTCCCCAAAGCGGGAGTGAGACCCAGTACTTC	CASPQSGSETQYF	TRBV4-1	TRBJ2-5
TGTGCCAGCAGCTTAGATCGAAGGGTGGGGGGTGAGACCCAGTACTTC	CASSLDRRVGGETQYF	TRBV11-2	TRBJ2-5
TGTGCCGAGCGTAGCGGGGGAGATGAGCAGTTCTTC	CAERSGGDEQFF	TRBV6-6	TRBJ2-1
TGTGCCAGCAGTGAATCCAGGGGAAGAACTAGGAGCTATGGCTACACCTTC	CASSESRGRTRSYGYTF	TRBV25-1	TRBJ1-2
TGCAGTGCTAGATTCGGGACAGGGCTCTTTACTAATGAAAAACTGTTTTTT	CSARFGTGLFTNEKLFF	TRBV20-1	TRBJ1-4
TGTGCCAGTAGTAGACAGCCCTACGAGCAGTACTTC	CASSRQPYEQYF	TRBV19	TRBJ2-7
TGTGCCAGCAGCCTTCTCGGACAGGGCCAGGGGTCTAAGAACACTGAAGCTTTCTTT	CASSLLGQGQGSKNTEAFF	TRBV7-3	TRBJ1-1
TGTGCCAGCAGCTTAGCGGAGTCCTACAATGAGCAGTTCTTC	CASSLAESYNEQFF	TRBV7-9	TRBJ2-1
TGTGCCAGCAGTTTAGACCCTAGCGGGGGGGCCAACGTCCTGACTTTC	CASSLDPSGGANVLTF	TRBV27	TRBJ2-6
TGTGCCAGCATTAGGGGCAGGTACGAGCAGTACTTC	CASIRGRYEQYF	TRBV9	TRBJ2-7
TGCGCCAGCAGCCGGAAGCTAGGCGGGTGGAACGGCAATCAGCCCCAGCATTTT	CASSRKLGGWNGNQPQHF	TRBV4-3	TRBJ1-5
TGTGCCAGCACCGCGGGAGCCCAGTACTTC	CASTAGAQYF	TRBV7-9	TRBJ2-5
TGCGCCAGCAGCCAAGACCTGGGACCTCCAAACACTGAAGCTTTCTTT	CASSQDLGPPNTEAFF	TRBV4-3	TRBJ1-1
TGTGCCAGCAGCCAAGAGTTTCTGAGGGGAGTTGAGACCCAGTACTTC	CASSQEFLRGVETQYF	TRBV3-1	TRBJ2-5
TGTGCCAGCAGTGAGAGCTATACGCAGTATTTT	CASSESYTQYF	TRBV6-4	TRBJ2-3
TGTGCCAGCAGTGAATCTGACGGTGACTTC	CASSESDGDF	TRBV6-1	TRBJ2-7
TGCAGTGCTAGCGAAGAGGAGGGCTACGAGCAGTACTTC	CSASEEEGYEQYF	TRBV20-1	TRBJ2-7
TGTGCCAGCAGTTACCCTAGCGGAGCAGATACGCAGTATTTT	CASSYPSGADTQYF	TRBV6-5	TRBJ2-3
TGTGCCAGCAGGGGTAGCAGGGCTGGGTTGAACACTGAAGCTTTCTTT	CASRGSRAGLNTEAFF	TRBV25-1	TRBJ1-1
TGCGCCAGCAGCATCCGTCCACGACAGGGCCCCTACGAGCAGTACTTC	CASSIRPRQGPYEQYF	TRBV5-1	TRBJ2-7
TGTGCCACCAGCAGCAGGTGGGATTTATCTGAAGCTTTCTTT	CATSSRWDLSEAFF	TRBV15	TRBJ1-1
TGTGCCAGCAGCGTGACGGACAGAATTTATAGCAATCAGCCCCAGCATTTT	CASSVTDRIYSNQPQHF	TRBV7-4	TRBJ1-5
TGTGCCAGCAAAGGGGGCAGAAAACTGTTTTTT	CASKGGRKLFF	TRBV9	TRBJ1-4
TGTGCCATCAGTGCCGGCTATACCTACGAGCAGTACTTC	CAISAGYTYEQYF	TRBV10-3	TRBJ2-7
TGTGCCAGCAGTGCCTTAAGCGGCCTATCAGATACGCAGTATTTT	CASSALSGLSDTQYF	TRBV6-4	TRBJ2-3
TGCAGTGCATTTGAGCCAGAGGATCAGCCCCAGCATTTT	CSAFEPEDQPQHF	TRBV20-1	TRBJ1-5
TGTGCCAGCAGTTACTCTTGCAAGGGGTCCTACAATGAGCAGTTCTTC	CASSYSCKGSYNEQFF	TRBV6-5	TRBJ2-1
TGCGCCAGCAGTGATTGGCGTGGTGACACTGAAGCTTTCTTT	CASSDWRGDTEAFF	TRBV10-1	TRBJ1-1
TGCAGTGCGCTGGGAGGGACAGGACGTTCGAAAGAGACCCAGTACTTC	CSALGGTGRSKETQYF	TRBV20-1	TRBJ2-5
TGCGCCAGCAGCTTAGTCCCCGGGACTAGCGGGGAGATGCCCAATGAGCAGTTCTTC	CASSLVPGTSGEMPNEQFF	TRBV5-1	TRBJ2-1
TGCAGTGCTAGAGGGTGGACAGGGGTGGGGGCCAACGTCCTGACTTTC	CSARGWTGVGANVLTF	TRBV20-1	TRBJ2-6
TGTGCTAGTGGTTTGGTACCACAGAGGTCAAATGAGCAGTTCTTC	CASGLVPQRSNEQFF	TRBV12-5	TRBJ2-1
TGTGCCAGCAGTGACCCTCGGACTCACGAGCAGTACTTC	CASSDPRTHEQYF	TRBV2	TRBJ2-7
TGCGCCAGCAGCTTGAAATGCGCCGGGGTGTGGGACAACACCGGGGAGCTGTTTTTT	CASSLKCAGVWDNTGELFF	TRBV5-1	TRBJ2-2
TGTGCTAGTGGTTTGGTAAGGCGAAGGTTGGTCTACGAGCAGTACTTC	CASGLVRRRLVYEQYF	TRBV12-5	TRBJ2-7
TGTGCCAGCAGTTATCCACCGGGACAGGGGCAGAGTAAGGGGAACACTGAAGCTTTCTTT	CASSYPPGQGQSKGNTEAFF	TRBV6-2	TRBJ1-1
TGCGCCAGCAGCCAAGATTCGCTACCTTGGACAGGGCGGGAATACGAGCAGTACTTC	CASSQDSLPWTGREYEQYF	TRBV4-3	TRBJ2-7
TGTGCCAGCAGTGACGGACAGGCCTTTCAGATTGACAATGAGCAGTTCTTC	CASSDGQAFQIDNEQFF	TRBV6-4	TRBJ2-1
TGCGCCAGCAGCATGGGGGGCAGGTTCCACTACGAGCAGTACTTC	CASSMGGRFHYEQYF	TRBV10-1	TRBJ2-7
TGCGCCAGCAGCTTGGTAACGAACACCGGGGAGCTGTTTTTT	CASSLVTNTGELFF	TRBV5-1	TRBJ2-2
TGTGCCAGCAGTGCAGACAGGGGGCATGGCTACGAGCAGTACTTC	CASSADRGHGYEQYF	TRBV25-1	TRBJ2-7
TGTGCCAGCAGCAAGGACAGGGGGCAGCCCCAGCATTTT	CASSKDRGQPQHF	TRBV7-2	TRBJ1-5
TGTGCCACCAGTGATCAAGGGTCCTTGGAAAAACTGTTTTTT	CATSDQGSLEKLFF	TRBV24-1	TRBJ1-4
TGTGCCAGCAGCCAAGATGGCCCAAGACAGGGGCTTACTAATGAAAAACTGTTTTTT	CASSQDGPRQGLTNEKLFF	TRBV4-2	TRBJ1-4
TGTGCCAGCAGCCGAAGTCTTAAACTAGCGGGGGGGCCCGGGTCACAAGGGGCCTACAATGAGCAGTTCTTC	CASSRSLKLAGGPGSQGAYNEQFF	TRBV7-9	TRBJ2-1
TGCGCCAGCACGCTCCCGGGGGGGAACACTGAAGCTTTCTTT	CASTLPGGNTEAFF	TRBV5-1	TRBJ1-1
TGTGCCAGCATTCCCCGTACCCCTAGCGGCGACTACGAGCAGTACTTC	CASIPRTPSGDYEQYF	TRBV6-5	TRBJ2-7
TGTGCCAGCAGCCTAGCGGAGCAGTACTTC	CASSLAEQYF	TRBV3-1	TRBJ2-7
TGCAGCGTACCAGACGACCGGACCAAGCAGTACGAGCAGTACTTC	CSVPDDRTKQYEQYF	TRBV29-1	TRBJ2-7
TGCGCCACTCCCGAGGGACTTCCGACTGAAGCTTTCTTT	CATPEGLPTEAFF	TRBV5-1	TRBJ1-1
TGCAGTGCACAGGGGCGTATCGATAATCAGCCCCAGCATTTT	CSAQGRIDNQPQHF	TRBV20-1	TRBJ1-5
TGTGCCAGCAGCTTAGGGAATGCCCATTACGAGCAGTACTTC	CASSLGNAHYEQYF	TRBV11-3	TRBJ2-7
TGTGCTGAGGTCGAAAAACTGTTTTTT	CAEVEKLFF	TRBV7-6	TRBJ1-4
TGTGCCAGCAGTGACAGTCCCACAGATACGCAGTATTTT	CASSDSPTDTQYF	TRBV27	TRBJ2-3
TGTGCCAGCAGCGTAACAGGGCCGGGTCCGAACACCGGGGAGCTGTTTTTT	CASSVTGPGPNTGELFF	TRBV9	TRBJ2-2
TGTGCCAGCAGCTTGCTAAGGGACAACAACAGCAATGAGCAGTTCTTC	CASSLLRDNNSNEQFF	TRBV5-6	TRBJ2-1
TGTGCCAGCAGCGTAGTCCAGACCGGGGAGCTGTTTTTT	CASSVVQTGELFF	TRBV9	TRBJ2-2
TGTGCCAGCAGCTTAGCCGACAAGGGGGAGCAGTACTTC	CASSLADKGEQYF	TRBV11-3	TRBJ2-7
TGTGCCAGGGGCCAGCCGGGCCCGTTCACAGATACGCAGTATTTT	CARGQPGPFTDTQYF	TRBV19	TRBJ2-3
TGTGCCACCAGCGGACCCAAAGCAGGGGCCTACGAGCAGTACTTC	CATSGPKAGAYEQYF	TRBV24-1	TRBJ2-7
TGTGCCAGCAGCGAAGAGGGTCAGACGCAGTATTTT	CASSEEGQTQYF	TRBV5-4	TRBJ2-3
TGTGCCAGCAGTTTAGCAGGCATTGAGCAGTTCTTC	CASSLAGIEQFF	TRBV27	TRBJ2-1
TGTGCCAGCAGTTCCACCTCCTACGAGCAGTACTTC	CASSSTSYEQYF	TRBV6-1	TRBJ2-7
TGTGCCAGCGACAGCCCATATGGCTACACCTTC	CASDSPYGYTF	TRBV12-4	TRBJ1-2
TGTGCCAGCAGCGGGGAGTCGTACGAGCAGTACTTC	CASSGESYEQYF	TRBV13	TRBJ2-7
TGTGCCAGCAGGACTTGTAAAGTAACTTACAATGAGCAGTTCTTC	CASRTCKVTYNEQFF	TRBV12-3	TRBJ2-1
TGCGCCAGCAGCTTGGAAACGCAGGGGCCGGGCAATCAGCCCCAGCATTTT	CASSLETQGPGNQPQHF	TRBV5-1	TRBJ1-5
TGTGCCAGTAGTCTGGGTGTCACAGGCCGACCGGCCCCCCTCGCCAAAAACATTCAGTACTTC	CASSLGVTGRPAPLAKNIQYF	TRBV19	TRBJ2-4
TGTGCCAGCAGCAGAGATAATTGGGATAATCAGCCCCAGCATTTT	CASSRDNWDNQPQHF	TRBV13	TRBJ1-5
TGTGCCAGTAGTAAGGCCCGAGCACACAGGGGAGCTTTCTTT	CASSKARAHRGAFF	TRBV19	TRBJ1-1
TGTGCCAGCAGTGTGCTGGGACTAGCGGGAGGGTTGGACTCCTACAATGAGCAGTTCTTC	CASSVLGLAGGLDSYNEQFF	TRBV6-1	TRBJ2-1
TGCGCCAGCACAGCCCGCTACGAGCAGTACTTC	CASTARYEQYF	TRBV5-1	TRBJ2-7
TGTGCCAGCAGCCCCAGGGAATGCACCGGGGAGCTGTTTTTT	CASSPRECTGELFF	TRBV7-4	TRBJ2-2
TGCGCCAGCAGCCAAGGGCACAATCAGCCCCAGCATTTT	CASSQGHNQPQHF	TRBV4-1	TRBJ1-5
TGTGCCAGCAGCTGTCCCCGACAGGGAGCCCGGGGGGCTAATGAAAAACTGTTTTTT	CASSCPRQGARGANEKLFF	TRBV11-1	TRBJ1-4
TGTGCCAGCAGCGGGCCTCGCTCGGGGGGGCCGGAAGAGACCCAGTACTTC	CASSGPRSGGPEETQYF	TRBV5-4	TRBJ2-5
TGTGCCAGCAGTTTATGCACTAGCGGGCGTTTTTTCTACAATGAGCAGTTCTTC	CASSLCTSGRFFYNEQFF	TRBV27	TRBJ2-1
TGTGCCAGCAGTTTAATAACAGAGGACAGCGGGGCCGGGGAGCTGTTTTTT	CASSLITEDSGAGELFF	TRBV6-4	TRBJ2-2
TGTGCCAGCAGCTTAGATATCCTCCCGGGGGGTAAAGGTACGCAGTATTTT	CASSLDILPGGKGTQYF	TRBV11-3	TRBJ2-3
TGCGCCAGCAGCCAAGATCCCCCCGGGGGAATCTCTAGCACAGATACGCAGTATTTT	CASSQDPPGGISSTDTQYF	TRBV4-1	TRBJ2-3
TGTGCCAGCAGCTTAGCGACTCTCCAGGGCCCAATCTTC	CASSLATLQGPIF	TRBV11-2	TRBJ2-1
TGCAGTGCTAGACCCGTCGGGGATCAGCCCCAGCATTTT	CSARPVGDQPQHF	TRBV20-1	TRBJ1-5
TGTGCCTGGAGAGTGACAGGGCCCTACGAGCAGTACTTC	CAWRVTGPYEQYF	TRBV30	TRBJ2-7
TGTGCCAGCAGCGCGAAGAGGGTCTCTGGGGCCAACGTCCTGACTTTC	CASSAKRVSGANVLTF	TRBV7-2	TRBJ2-6
TGTGCCAGCAGCCCTGGAGTGGGACAGATTGACCAAGAGCAGTTCTTC	CASSPGVGQIDQEQFF	TRBV2	TRBJ2-1
TGTGCCAGCAGCTTAGCGCGACGCGGACAGGAGCAGCGCTATGGCTACACCTTC	CASSLARRGQEQRYGYTF	TRBV7-2	TRBJ1-2
TGTGCCAGCAGGTTGGGACAGGGGGTTTTTTCCTCTGGGGCCAACGTCCTGACTTTC	CASRLGQGVFSSGANVLTF	TRBV6-2	TRBJ2-6
TGCAGCGGTATTACAACAGCGAACACTGAAGCTTTCTTT	CSGITTANTEAFF	TRBV29-1	TRBJ1-1
TGTGCCAGCAGTCCAGTCGACATTCCTACCTCCTACAATGAGCAGTTCTTC	CASSPVDIPTSYNEQFF	TRBV2	TRBJ2-1
TGTGCCACCAGCGCGTGCGGCGCCGGGGATGAAAAACTGTTTTTT	CATSACGAGDEKLFF	TRBV15	TRBJ1-4
TGTGCCAGCAGCTTAACAACAGGGGGGGATCAGCCCCAGCATTTT	CASSLTTGGDQPQHF	TRBV13	TRBJ1-5
TGTGCCAAGGGGTCAGGGGGCTTGAACACTGAAGCTTTCTTT	CAKGSGGLNTEAFF	TRBV6-2	TRBJ1-1
TGTGCCAGCAGCGGAAAGGAGATATTCTATGGCTACACCTTC	CASSGKEIFYGYTF	TRBV7-3	TRBJ1-2
TGCAGCGGAATAAGGGGTCCTCACTACGAGCAGTACTTC	CSGIRGPHYEQYF	TRBV29-1	TRBJ2-7
TGTGCCAGCAGTTATCCTGGCGAAAGGGTAAATCAGCCCCAGCATTTT	CASSYPGERVNQPQHF	TRBV6-6	TRBJ1-5
TGTGCCAGCATAGGGACTAGCGGGCCCGTCAACTGGAATGAGCAGTTCTTC	CASIGTSGPVNWNEQFF	TRBV25-1	TRBJ2-1
TGTGCCAGCAGTCGACAGGCCTCCTCGCGGACCGGCGCTGAAGCTTTCTTT	CASSRQASSRTGAEAFF	TRBV6-1	TRBJ1-1
TGTGCCAGCAGAGGCAAAGGACAGGGGGAGACCCAGTACTTC	CASRGKGQGETQYF	TRBV27	TRBJ2-5
TGTGCCAGCAGTTGCTCCGGGGGCATGAACACTGAAGCTTTCTTT	CASSCSGGMNTEAFF	TRBV28	TRBJ1-1
TGTGCCAGCAGTTTAGAACCGGGACAGCTTAGTGCAACTAATGAAAAACTGTTTTTT	CASSLEPGQLSATNEKLFF	TRBV27	TRBJ1-4
TGCAGTGCTAGGCCAGGCCCAAAAAGGAGAGACACTGAAGCTTTCTTT	CSARPGPKRRDTEAFF	TRBV20-1	TRBJ1-1
TGTGCCAGCAGCGGGCGTCCTAGCGGAGTTGAGCAGTTCTTC	CASSGRPSGVEQFF	TRBV7-3	TRBJ2-1
TGTGCCAGCAGTTTAATTTGGGACAGGGACAATGAGCAGTTCTTC	CASSLIWDRDNEQFF	TRBV12-4	TRBJ2-1
TGCAGTGCAATGACAGGAGGGCCCAATCAGCCCCAGCATTTT	CSAMTGGPNQPQHF	TRBV20-1	TRBJ1-5
TGTGCCAGCCGGTCCTGGGGACAGGGGCGAAACTACGAGCAGTACTTC	CASRSWGQGRNYEQYF	TRBV6-6	TRBJ2-7
TGTGCCAGCCGACGACAGCCATTGGGCGGGGCTGAAAAACTGTTTTTT	CASRRQPLGGAEKLFF	TRBV2	TRBJ1-4
TGTGCCAGTAGTATGGGGGAGGATGAAAAACTGTTTTTT	CASSMGEDEKLFF	TRBV19	TRBJ1-4
TGTGCCAGCAGAGGAACGACAGGGGTTTCCGGGGAGCTGTTTTTT	CASRGTTGVSGELFF	TRBV12-4	TRBJ2-2
TGTGCCAGCAAAGGCGGGCTACACCACATTCAGTACTTC	CASKGGLHHIQYF	TRBV27	TRBJ2-4
TGTGCCAGCAGCTTGCCCGGGGGCGAGCAGTACTTC	CASSLPGGEQYF	TRBV5-6	TRBJ2-7
TGTGCCAGCAGCCTGAGTGATTCTAGCACAGATACGCAGTATTTT	CASSLSDSSTDTQYF	TRBV14	TRBJ2-3
TGCAGTGCGTTCCCGAACAATGAGCAGTTCTTC	CSAFPNNEQFF	TRBV20-1	TRBJ2-1
TGTGCCAGCGACGACAGGCCGGGCTACGAGCAGTACTTC	CASDDRPGYEQYF	TRBV12-3	TRBJ2-7
TGTGCCAGCAGCCACGCTTACGCCGAAGCTTTCTTT	CASSHAYAEAFF	TRBV14	TRBJ1-1
TGTGCCAGCAGCGTAGTGAGCGGAGGAAATGAGCAGTTCTTC	CASSVVSGGNEQFF	TRBV9	TRBJ2-1
TGTGCCAGCAGCCTGGCAGGGGGGGCCTGGAGCAATCAGCCCCAGCATTTT	CASSLAGGAWSNQPQHF	TRBV7-6	TRBJ1-5
TGTGCCAGCATGGTCAGGGCTCGCACAGATACGCAGTATTTT	CASMVRARTDTQYF	TRBV27	TRBJ2-3
TGTGCCAGCAGCTTAGCCCGCCCGGTTAGGGTCCCCGAGACCCAGTACTTC	CASSLARPVRVPETQYF	TRBV7-9	TRBJ2-5
TGTGCCAGCAGCCCCTTCGGGGGCTATGGCTACACCTTC	CASSPFGGYGYTF	TRBV11-3	TRBJ1-2
TGTGCCATCAGTAGAAGGGGAACCGGGGGGACTGAAGCTTTCTTT	CAISRRGTGGTEAFF	TRBV10-3	TRBJ1-1
TGTGCCAGCTCACCAAGGGTGAACACTGAAGCTTTCTTT	CASSPRVNTEAFF	TRBV18	TRBJ1-1
TGTGCCACCAACCAAGTGGGGGAGAACACTGAAGCTTTCTTT	CATNQVGENTEAFF	TRBV24-1	TRBJ1-1
TGTGCCTGGAGCGCTTGGGGGGGCCTGGATGAAAAACTGTTTTTT	CAWSAWGGLDEKLFF	TRBV30	TRBJ1-4
TGTGCCAGCTCACGATGGGGATTGATCGACACCGGGGAGCTGTTTTTT	CASSRWGLIDTGELFF	TRBV18	TRBJ2-2
TGTGCCAGCTCGCGGAGACAGAAAAACACAGATACGCAGTATTTT	CASSRRQKNTDTQYF	TRBV18	TRBJ2-3
TGTGCCAGCAGCTTGACCCTAGCGGGCCCGGCACAAGAGACCCAGTACTTC	CASSLTLAGPAQETQYF	TRBV5-5	TRBJ2-5
TGTGCCAGCAGTCGGGCGCCTAATGAGCAGTTCTTC	CASSRAPNEQFF	TRBV7-7	TRBJ2-1
TGTGCCAGCAGCTTATCGGGACTTGTTTATGAGCAGTTCTTC	CASSLSGLVYEQFF	TRBV7-6	TRBJ2-1
TGCGCCAGCAGCTTCGACCGGGCGGGAATTGCGAACACCGGGGAGCTGTTTTTT	CASSFDRAGIANTGELFF	TRBV5-1	TRBJ2-2
TGTGCCAGCAGCTTAGATCAGGTCGAGACCCAGTACTTC	CASSLDQVETQYF	TRBV11-3	TRBJ2-5
TGTGCCAGCAGCCCCAAGGAGAGGGGCAGTCTCGACACTGAAGCTTTCTTT	CASSPKERGSLDTEAFF	TRBV27	TRBJ1-1
TGCGCCAGACGGGACAGGAGCGCGAATTGCTCCTACGAGCAGTACTTC	CARRDRSANCSYEQYF	TRBV10-1	TRBJ2-7
TGCAGTGCTGTTACTTGGCTCGGGGATCAGCCCCAGCATTTT	CSAVTWLGDQPQHF	TRBV20-1	TRBJ1-5
TGTGCCAGCAGCTTAGCGGACCAGAGCCGGGGACTGTTAGATCAGCCCCAGCATTTT	CASSLADQSRGLLDQPQHF	TRBV7-9	TRBJ1-5
TGTGCCAGCAGTCTACCACAGGAGGATAGCACAGATACGCAGTATTTT	CASSLPQEDSTDTQYF	TRBV6-3	TRBJ2-3
TGTGCCAGCAGTGACTCGACAGCATGGTGGGGGCAGCCCCAGCATTTT	CASSDSTAWWGQPQHF	TRBV6-4	TRBJ1-5
TGTGCCATCAGTGAGTCGATTTACCGGGGGGGCTTCTCTGGAAACACCATATATTTT	CAISESIYRGGFSGNTIYF	TRBV10-3	TRBJ1-3
TGTGCCAGCTCACCGGAGCGGGACAGGGGTACTCGGACCCAGTACTTC	CASSPERDRGTRTQYF	TRBV18	TRBJ2-5
TGTGCCAGCAGCCGACCCCGCGAGCGGACAACTGTGTATAATTCACCCCTCCACTTT	CASSRPRERTTVYNSPLHF	TRBV7-9	TRBJ1-6
TGTGCCAGCAGTTTGGGGGACAGCACTGAAGCTTTCTTT	CASSLGDSTEAFF	TRBV6-8	TRBJ1-1
TGTGCCACCAGTGGGGCCAGGGAGGTCTACGAGCAGTACTTC	CATSGAREVYEQYF	TRBV24-1	TRBJ2-7
TGTGCCAGCAGTTTCCTCCGCGGGACTAGCGTATTAGATACGCAGTATTTT	CASSFLRGTSVLDTQYF	TRBV12-4	TRBJ2-3
TGTGCCAGCAGCAGGGGGACAGTTTGGAGTTACGAGCAGTACTTC	CASSRGTVWSYEQYF	TRBV7-6	TRBJ2-7
TGCGCCAGCAGACCTCGGGTTGTAGAGACCCAGTACTTC	CASRPRVVETQYF	TRBV10-1	TRBJ2-5
TGTGCTAGTGGTCGGGACGCTTTTATATACGAGCAGTACTTC	CASGRDAFIYEQYF	TRBV12-5	TRBJ2-7
TGTGCCAGCAGCATGGCTGTAGCCTATGGCTACACCTTC	CASSMAVAYGYTF	TRBV11-3	TRBJ1-2
TGTGCCAGCAGGGCCTCGACTAGCGGGAGGGCTAGGGAGCAGTTCTTC	CASRASTSGRAREQFF	TRBV6-4	TRBJ2-1
TGTGCCAGCAGTAGGGGGGGAAACAATGAGCAGTTCTTC	CASSRGGNNEQFF	TRBV27	TRBJ2-1
TGTGCCAGCAGTTTATGGTCTTTCCCCGCCGTGACGGTTAGCTCCTACAATGAGCAGTTCTTC	CASSLWSFPAVTVSSYNEQFF	TRBV27	TRBJ2-1
TGTGCCAGCAGCCTGTTCGGGGGACAGGGGAAGGGTGGCTACACCTTC	CASSLFGGQGKGGYTF	TRBV5-6	TRBJ1-2
TGTGCCAGCAGCCCGCCAGGACAGGCGTATGGCTACACCTTC	CASSPPGQAYGYTF	TRBV7-3	TRBJ1-2
TGTGCCAGCAGCCAAGACACCGGGACGGAGTCGGGACAGGGGAGGCAGGACACCGGGGAGCTGTTTTTT	CASSQDTGTESGQGRQDTGELFF	TRBV3-1	TRBJ2-2
TGTGCCAGCTCATGCGGGAAGGACAGGCCAGCAGATACGCAGTATTTT	CASSCGKDRPADTQYF	TRBV18	TRBJ2-3
TGTGCCAGCCCGAGGAGGGGGGACAATGAGCAGTTCTTC	CASPRRGDNEQFF	TRBV25-1	TRBJ2-1
TGCGCCAGCAGCTTGAGGGACAGTCCCCAGTGCATGAACACTGAAGCTTTCTTT	CASSLRDSPQCMNTEAFF	TRBV5-1	TRBJ1-1
TGTGCCAGTAGTAAGACAGGGGGCGTACCCTATAGCAATCAGCCCCAGCATTTT	CASSKTGGVPYSNQPQHF	TRBV19	TRBJ1-5
TGCGCCAGCAGCCAAGAGCTCCCAGGGGGAGCCAAAAACATTCAGTACTTC	CASSQELPGGAKNIQYF	TRBV4-1	TRBJ2-4
TGCGCCAGCAGCACTGGCCCGGGCGTCATGAACACTGAAGCTTTCTTT	CASSTGPGVMNTEAFF	TRBV5-1	TRBJ1-1
TGTGCCAGCAGTGAAGCAAGTATGAACACCGGGGAGCTGTTTTTT	CASSEASMNTGELFF	TRBV6-1	TRBJ2-2
TGTGCCAGCAGCCAAGTTTTAAATCTTACAGGTCTCAGGGCAGGTGGCGAAGGGGTAAACACAGATACGCAGTATTTT	CASSQVLNLTGLRAGGEGVNTDTQYF	TRBV4-2	TRBJ2-3
TGCAGCGTTGAAGCCCAGGGGGGGTGGACGAACACCGGGGAGCTGTTTTTT	CSVEAQGGWTNTGELFF	TRBV29-1	TRBJ2-2
TGTGCCAGCAGTTTTGGGGGACGCGCCAAAAACATTCAGTACTTC	CASSFGGRAKNIQYF	TRBV12-4	TRBJ2-4
TGTGCCAGCAGCTGGAAGGGGACTAGCGGGGATGCTAGCACAGATACGCAGTATTTT	CASSWKGTSGDASTDTQYF	TRBV7-9	TRBJ2-3
TGTGCCAGCAGCCAAGTTGTACTACAGGGTTCTAGCAATCAGCCCCAGCATTTT	CASSQVVLQGSSNQPQHF	TRBV3-1	TRBJ1-5
TGTGCCAGCAGTGAAGGCTGTCGGGACAGGAGGTGGCAATGTTATGAGCAGTTCTTC	CASSEGCRDRRWQCYEQFF	TRBV2	TRBJ2-1
TGTGCCAGCAGCGGGATTGAGAAAAAGACAGTCGGATACTATGGCTACACCTTC	CASSGIEKKTVGYYGYTF	TRBV13	TRBJ1-2
TGCAGTGCTAGAGATTGGGGACAAGGGGAAACCTATGGCTACACCTTC	CSARDWGQGETYGYTF	TRBV20-1	TRBJ1-2
TGTGCCAGCAGCGTAGCCCATAACCCTACCTACGAGCAGTACTTC	CASSVAHNPTYEQYF	TRBV9	TRBJ2-7
TGTGCCAGCACCGGGGACGATAGGGAGCCCCAGCATTTT	CASTGDDREPQHF	TRBV12-3	TRBJ1-5
TGTGCCACCAGTGCAGGGGCCAACTATGGCTACACCTTC	CATSAGANYGYTF	TRBV24-1	TRBJ1-2
TGTGCCACCAGTGAGACAGACGACATTGAGGGGGAGCTGTTTTTT	CATSETDDIEGELFF	TRBV24-1	TRBJ2-2
TGCAGTGCTGCGGAGACTAAAGCTATCTGTGCCTACGAGCAGTACTTC	CSAAETKAICAYEQYF	TRBV20-1	TRBJ2-7
TGTGCCAGCAAGGAAGGGACACGGCTCTCTGGGGCCAACGTCCTGACTTTC	CASKEGTRLSGANVLTF	TRBV7-7	TRBJ2-6
TGTGCCAGCAGCTTCCTCGGTCACGGGGGTGCCTCTCGGGATAACTATGGCTACACCTTC	CASSFLGHGGASRDNYGYTF	TRBV7-4	TRBJ1-2
TGTGCCAGCACCTCGGGGGGGGCCAGTTGCGAGCAGTACTTC	CASTSGGASCEQYF	TRBV6-5	TRBJ2-7
TGCGCCAGCCGGTGGGGCTCATTCTCCTACAATGAGCAGTTCTTC	CASRWGSFSYNEQFF	TRBV10-1	TRBJ2-1
TGCAGTGCCCGTAGACAGGGGTTACTCACCGGGGAGCTGTTTTTT	CSARRQGLLTGELFF	TRBV20-1	TRBJ2-2
TGTGCCACCAGTGACCCCGGGGTATCCTACAATGAGCAGTTCTTC	CATSDPGVSYNEQFF	TRBV24-1	TRBJ2-1
TGTGCCAGCAGTAAACGCCTCTGGCGGAGGGACGCTGAGCAGTTCTTC	CASSKRLWRRDAEQFF	TRBV27	TRBJ2-1
TGTGCCAGCAGTGGGGGGACAGGTGTCCGTGAGTGTAAAGAGACCCAGTACTTC	CASSGGTGVRECKETQYF	TRBV2	TRBJ2-5
TGCGCCAGCAAGGAAGACAGGCCACCCACCACTGAAGCTTTCTTT	CASKEDRPPTTEAFF	TRBV5-1	TRBJ1-1
TGTGCCAGCAGCACGAAACCGGGCTACGAGCAGTACTTC	CASSTKPGYEQYF	TRBV13	TRBJ2-7
TGTGCCAGCGGAGATATCCGCCGGAGCACCGGGGAGCTGTTTTTT	CASGDIRRSTGELFF	TRBV2	TRBJ2-2
TGTGCCAGCAGCCCACTGTGGACTGGTGGGGTCACTGAAGCTTTCTTT	CASSPLWTGGVTEAFF	TRBV9	TRBJ1-1
TGTGCCAGCAGTTTGCCCAGGGTGAACTATCAGCCCCAGCATTTT	CASSLPRVNYQPQHF	TRBV28	TRBJ1-5
TGCAGTGCTAGTGCGACAGGGGAGCTCTATGGCTACACCTTC	CSASATGELYGYTF	TRBV20-1	TRBJ1-2
TGTGCCAGCCACCAGGGCATCGAGGAGCTGTTTTTT	CASHQGIEELFF	TRBV27	TRBJ2-2
TGTGCCAGCAGCTTAGGGGGGGGCAGGGGGGTGTACTATGGCTACACCTTC	CASSLGGGRGVYYGYTF	TRBV7-8	TRBJ1-2
TGTGCCAGCAGCCAAGTACCAGCATTACAAATGGACAAAAACATTCAGTACTTC	CASSQVPALQMDKNIQYF	TRBV3-1	TRBJ2-4
TGTGCCAGCAGTTTATTTGTGGGGGCGCGGTACGAGCAGTACTTC	CASSLFVGARYEQYF	TRBV27	TRBJ2-7
TGCATTAGCGGGCGTAATGAGCAGTTCTTC	CISGRNEQFF	TRBV6-1	TRBJ2-1
TGCAGCGTTGGGGGGGAGTCCGGCTCCTACGAGCAGTACTTC	CSVGGESGSYEQYF	TRBV29-1	TRBJ2-7
TGCGCCAGCAGCTTGGCAGGGCAGGGGGAGTTGAACACTGAAGCTTTCTTT	CASSLAGQGELNTEAFF	TRBV5-1	TRBJ1-1
TGTGCCACTGTTCATCAGCCCCAGCATTTT	CATVHQPQHF	TRBV24-1	TRBJ1-5
TGTGCCAGCAGGACAGGGTTCTATAACTATGGCTACACCTTC	CASRTGFYNYGYTF	TRBV7-9	TRBJ1-2
TGTGCCAGCAGTTTGTCCCAAAGAAGACTCCGGGACGATCGTTCTTCTAATGAAAAACTGTTTTTT	CASSLSQRRLRDDRSSNEKLFF	TRBV12-3	TRBJ1-4
TGTGCCAGCAGCCAAGATAGGGCCCGCCACCTACTAGCGGGAGGGGCCTACGAGCAGTACTTC	CASSQDRARHLLAGGAYEQYF	TRBV3-1	TRBJ2-7
TGTGCCAGCAGTTTTGGTATAGGGGGGCGACGTGGCCACGAGCAGTACTTC	CASSFGIGGRRGHEQYF	TRBV28	TRBJ2-7
TGTGCCAGCACCCCGACAGTGCCCGACTATGGCTACACCTTC	CASTPTVPDYGYTF	TRBV5-6	TRBJ1-2
TGTGCCATCAGATGGAGTCCCCCAACCTACGAGCAGTACTTC	CAIRWSPPTYEQYF	TRBV10-3	TRBJ2-7
TGTGCCAGCAGGGGGGCTTGGAGCTCCTACAATGAGCAGTTCTTC	CASRGAWSSYNEQFF	TRBV25-1	TRBJ2-1
TGTGCCAGCAGCGTCAGGGGTGGGGACGAGGGGAGGCCCCAGCATTTT	CASSVRGGDEGRPQHF	TRBV9	TRBJ1-5
TGTGCCAGCAGCTTACTCACGCGCAATGAGCAGTTCTTC	CASSLLTRNEQFF	TRBV7-8	TRBJ2-1
TGTGCCAGCACCCGGGACAGCGCTTATGGCTACACCTTC	CASTRDSAYGYTF	TRBV7-3	TRBJ1-2
TGTGCCAGCAGTAGGGGGACAGGGCCTAGCAATCAGCCCCAGCATTTT	CASSRGTGPSNQPQHF	TRBV6-1	TRBJ1-5
TGTGCCAGCAGGGCCCGGGACAGTGGCTACACCTTC	CASRARDSGYTF	TRBV2	TRBJ1-2
TGTGCCAGCAGCGGGACAGGGGTCTTATACAGCTCCTATAATTCACCCCTCCACTTT	CASSGTGVLYSSYNSPLHF	TRBV9	TRBJ1-6
TGTGCCAGCAGCGACCTAAATCTAGGGTCGACAGTGGGGGATCAGCCCCAGCATTTT	CASSDLNLGSTVGDQPQHF	TRBV9	TRBJ1-5
TGTGCCAGCGTAAACATATACGGGGAAAAGCAAGAGACCCAGTACTTC	CASVNIYGEKQETQYF	TRBV27	TRBJ2-5
TGTGCCAGCAGCAAGCCGACAGGGAACACTGAAGCTTTCTTT	CASSKPTGNTEAFF	TRBV11-2	TRBJ1-1
TGTGCCAGCCCTGATGTAGCGGGTCTGCCTACTGAGACCCAGTACTTC	CASPDVAGLPTETQYF	TRBV11-3	TRBJ2-5
TGTGCCAGCAGCCACTGGACAGGGGACAACACTGAAGCTTTCTTT	CASSHWTGDNTEAFF	TRBV4-2	TRBJ1-1
TGTGCCAGCAGCGACGGGGGCGAACTCGAGCAGTACTTC	CASSDGGELEQYF	TRBV7-3	TRBJ2-7
TGTGCCAGCAGCGGGCCCGAGGGACAGGGAGGAGAGCAGTACTTC	CASSGPEGQGGEQYF	TRBV7-3	TRBJ2-7
TGTGCCAGCTTACCGGGACAGGGCCCCTATGGCTACACCTTC	CASLPGQGPYGYTF	TRBV6-4	TRBJ1-2
TGTGCCACTAGCGAGAACACAGATACGCAGTATTTT	CATSENTDTQYF	TRBV28	TRBJ2-3
TGTGCCATCTCGGGGTCGGGCAACGTACGCACTGAAGCTTTCTTT	CAISGSGNVRTEAFF	TRBV10-3	TRBJ1-1
TGTGCCAGCAGCGTAGCTCGTTACAGGGGCTACGAGCAGTACTTC	CASSVARYRGYEQYF	TRBV9	TRBJ2-7
TGTGCCAGCAGGAGTGGGGAGGAGAATCAGCCCCAGCATTTT	CASRSGEENQPQHF	TRBV6-2	TRBJ1-5
TGTGCCAGCAGCCAACCCCCGGGGGGGGGGTACGAGCAGTACTTC	CASSQPPGGGYEQYF	TRBV14	TRBJ2-7
TGCGCCAGCAGCTTAAAGGACAGGGGCTATCCCCCTGAAGCTTTCTTT	CASSLKDRGYPPEAFF	TRBV5-1	TRBJ1-1
TGTGCCAGCAGCTTAGCCAAACGCCGGTTTTTCAGCGCATGCACAGATACGCAGTATTTT	CASSLAKRRFFSACTDTQYF	TRBV7-9	TRBJ2-3
TGTGCCAGCAGTTTATCCGTTCTAGCGGGGGCAGATACGCAGTATTTT	CASSLSVLAGADTQYF	TRBV27	TRBJ2-3
TGTGCCATCAGTGAGTCGACTTACCCCTACGAGCAGTACTTC	CAISESTYPYEQYF	TRBV10-3	TRBJ2-7
TGTGCCAGCAGCTTGGTACAGGGTCGCAATCAGCCCCAGCATTTT	CASSLVQGRNQPQHF	TRBV5-4	TRBJ1-5
TGTGCCAGCAGCTTGGCCGGGGGGGCTGAGACCCAGTACTTC	CASSLAGGAETQYF	TRBV5-5	TRBJ2-5
TGTGCCAGCAGTCTAATGGTTAGGTATTTT	CASSLMVRYF	TRBV6-1	TRBJ2-3
TGTGCCAGCAGCTTAGGCCGACAGGTGAACACTGAAGCTTTCTTT	CASSLGRQVNTEAFF	TRBV7-8	TRBJ1-1
TGTGCCAGCAGCCAACCCGGGGAGGGTTCACCCCTCCACTTT	CASSQPGEGSPLHF	TRBV9	TRBJ1-6
TGTGCCAGTACCAAGGACAGGGGGGGCTCCTACGAGCAGTACTTC	CASTKDRGGSYEQYF	TRBV27	TRBJ2-7
TGCAGTGCTAGAAATAGCGGGCCCCAGCATTTT	CSARNSGPQHF	TRBV20-1	TRBJ1-5
TGCAGTGCTAGCCGACGACTAGCGCGGGACGAGCAGTACTTC	CSASRRLARDEQYF	TRBV20-1	TRBJ2-7
TGCGCCAGCAGCTTGGACTTACCGCGCCGGGACAGGGACGCTTCGATGTATGGCTACACCTTC	CASSLDLPRRDRDASMYGYTF	TRBV5-1	TRBJ1-2
TGTGCCAGCATCGGACAGGGTTCCCACGAGCAGTACTTC	CASIGQGSHEQYF	TRBV9	TRBJ2-7
TGTGCTAGTGGACAGGGGTCACAGCCCCAGCATTTT	CASGQGSQPQHF	TRBV12-5	TRBJ1-5
TGTGCCAGCAGCGTCAGGGGGCCCCTGGGAAACACCATATATTTT	CASSVRGPLGNTIYF	TRBV9	TRBJ1-3
TGTGACCAGGCGGCGGTGGGGGAAGCGCAGTATTTT	CDQAAVGEAQYF	TRBV7-9	TRBJ2-3
TGTGACAAGCCGGGCCGGGTAGAGACCCAGTACTTC	CDKPGRVETQYF	TRBV25-1	TRBJ2-5
TGTGCCAGCAGCATGGGGGGGCCGTGTTGGGTATTTTCGGAATACGAGCAGTACTTC	CASSMGGPCWVFSEYEQYF	TRBV13	TRBJ2-7
TGCGCCAGCGGTTACCTCCAGGGAGGGGTATTACCAAACATTCAGTACTTC	CASGYLQGGVLPNIQYF	TRBV10-1	TRBJ2-4
TGCAGCGTACTCCAATCGCGAGGGTACAATGAGCAGTTCTTC	CSVLQSRGYNEQFF	TRBV29-1	TRBJ2-1
TGTGCCAGCTCACACGGGACTGTCCCGCCCTCTGGGGCCAACGTCCTGACTTTC	CASSHGTVPPSGANVLTF	TRBV18	TRBJ2-6
TGTGCCATCCGTTCCCCGAAGGCAGAGACCCAGTACTTC	CAIRSPKAETQYF	TRBV10-3	TRBJ2-5
TGTGCCAGCAGTGACCTATCGACTAGCGGCCATCGGAATGAGCAGTTCTTC	CASSDLSTSGHRNEQFF	TRBV6-4	TRBJ2-1
TGTGCCAGCAGTGGACAGAAGGAACTTAGCTCCTATAATTCACCCCTCCACTTT	CASSGQKELSSYNSPLHF	TRBV12-3	TRBJ1-6
TGTGCCAGCAGCCACTCAGCTAACTATGGCTACACCTTC	CASSHSANYGYTF	TRBV13	TRBJ1-2
TGTGCCAGCAGCCAAGCCGGGTGGGGCAGAACCGGGGAGCTGTTTTTT	CASSQAGWGRTGELFF	TRBV14	TRBJ2-2
TGTGCCAGCAGTCGTATGGGACAGGCGGAGGGGGCCAACGTCCTGACTTTC	CASSRMGQAEGANVLTF	TRBV7-8	TRBJ2-6
TGCAGTGCTAGAGTCCTTGGACTAGCGGGTGGAGAGCCCTACAATGAGCAGTTCTTC	CSARVLGLAGGEPYNEQFF	TRBV20-1	TRBJ2-1
TGTGCCAGGTTGCCCGGCTATTCACCCCTCCACTTT	CARLPGYSPLHF	TRBV27	TRBJ1-6
TGTGCCAGCAGTGGACAGGGGACTGAAGCTTTCTTT	CASSGQGTEAFF	TRBV28	TRBJ1-1
TGTGCCACCGGGACACGTTATAGCAATCAGCCCCAGCATTTT	CATGTRYSNQPQHF	TRBV6-4	TRBJ1-5
TGTGCCAGCAGCCCAGGAACAGGGAATCAGCCCCAGCATTTT	CASSPGTGNQPQHF	TRBV11-3	TRBJ1-5
TGTGCCAGCAGGAAGGACCGGGGTCAAACCTATAATTCACCCCTCCACTTT	CASRKDRGQTYNSPLHF	TRBV13	TRBJ1-6
TGTGCCAGCAGCCAAGGCCCCGACAGGGGGCTCACAGATACGCAGTATTTT	CASSQGPDRGLTDTQYF	TRBV12-4	TRBJ2-3
TGTGCCAGCCTACCAACAGGGCCCTCCCTGAATCAGCCCCAGCATTTT	CASLPTGPSLNQPQHF	TRBV9	TRBJ1-5
TGTGCCAGCAGTTTTAAGGGGGCTTTTAGACATGGCTACACCTTC	CASSFKGAFRHGYTF	TRBV27	TRBJ1-2
TGTGCCAGCAGTGAAGCGGGAGGGGAAGATGAGAGGGGCACCGGGGAGCTGTTTTTT	CASSEAGGEDERGTGELFF	TRBV2	TRBJ2-2
TGCGCCAGCAGCCCCTCAGGGGCTGAGCTTACTGAAGCTTTCTTT	CASSPSGAELTEAFF	TRBV5-1	TRBJ1-1
TGTGCCACCCAAAAGCCAATCCGGTACGGAAACACCATATATTTT	CATQKPIRYGNTIYF	TRBV7-3	TRBJ1-3
TGTGCCAGCAGCTTAGTCCCCGACGTGACCTACAATGAGCAGTTCTTC	CASSLVPDVTYNEQFF	TRBV7-6	TRBJ2-1
TGTGCCAGCAGCGGGGACTTTTGCGGAGAGACCCAGTACTTC	CASSGDFCGETQYF	TRBV13	TRBJ2-5
TGTGCCAGCAGTTGCCCAAAGGTTGGGGTGCGCTATGGCTACACCTTC	CASSCPKVGVRYGYTF	TRBV6-9	TRBJ1-2
TGCGCCAGCAGGACAGGGAAAGGCAATCAGCCCCAGCATTTT	CASRTGKGNQPQHF	TRBV10-2	TRBJ1-5
TGTGCCAGCAGCTTAGAGGGGGTTCCGAGCTCCTACGAGCAGTACTTC	CASSLEGVPSSYEQYF	TRBV5-4	TRBJ2-7
TGCAGTGCTTTACTAGCGGGCGTCTACGAGCAGTACTTC	CSALLAGVYEQYF	TRBV20-1	TRBJ2-7
TGTGCCAGCAGCGGGCGGTTAAGGGGATCTCGACCCTACGAGCAGTACTTC	CASSGRLRGSRPYEQYF	TRBV13	TRBJ2-7
TGTGCCAGCCCACTAGCGGGGGGGATTCGGGAGACCCAGTACTTC	CASPLAGGIRETQYF	TRBV6-5	TRBJ2-5
TGTGCCAGCCGGGAGCAGGGGGGCTATGGCTACACCTTC	CASREQGGYGYTF	TRBV7-9	TRBJ1-2
TGTGCCAGCAGCCAAAGTTTACAGGGTAAGGGCAATCAGCCCCAGCATTTT	CASSQSLQGKGNQPQHF	TRBV14	TRBJ1-5
TGTGCCAGAACAAATCCCGCTACGACTAGCGGGGTCAACTCCTACAATGAGCAGTTCTTC	CARTNPATTSGVNSYNEQFF	TRBV19	TRBJ2-1
TGTGCCAGCAGCTTAGGGAGTAAGCGGGACCCAGGATACAATGAGCAGTTCTTC	CASSLGSKRDPGYNEQFF	TRBV7-2	TRBJ2-1
TGCGCCAGCAGACTTGACAGGAGCTCCTACGAGCAGTACTTC	CASRLDRSSYEQYF	TRBV10-1	TRBJ2-7
TGCGCCAGCAGTGACATGAAACTACTAGCGGGAGCTAGCTCCTACAATGAGCAGTTCTTC	CASSDMKLLAGASSYNEQFF	TRBV10-1	TRBJ2-1
TGTGCCAGCAGCTCTGTCTTC	CASSSVF	TRBV11-2	TRBJ1-2
TGTGCCAGCAGCCAACCCCTAGATCGGAGAGAGACCCAGTACTTC	CASSQPLDRRETQYF	TRBV14	TRBJ2-5
TGTGCCAGCAGCAAAGCTGAGGGCAGAGATGGCTACACCTTC	CASSKAEGRDGYTF	TRBV3-1	TRBJ1-2
TGCGCCAGCAGCCCGGGGCAAGAGACCCAGTACTTC	CASSPGQETQYF	TRBV4-3	TRBJ2-5
TGTGCCAGCAGTCTAGCGGGCTCCTACGAGCAGTACTTC	CASSLAGSYEQYF	TRBV11-2	TRBJ2-7
TGTTTTGACAGGGGCCGCCTTAAGAGCTCCTACGAGCAGTACTTC	CFDRGRLKSSYEQYF	TRBV7-9	TRBJ2-7
TGTGCCACCCCGGGGGGGGGAACCAGCCGGACCTACGAGCAGTACTTC	CATPGGGTSRTYEQYF	TRBV24-1	TRBJ2-7
TGTGCCAGCAGTGACTCGAAAAAAACTCGTCCCGACAGGTTGGAGAATTCACCCCTCCACTTT	CASSDSKKTRPDRLENSPLHF	TRBV6-4	TRBJ1-6
TGTGCCAGCAGAAAACTAGCGGGAGTTCGTCACAATGAGCAGTTCTTC	CASRKLAGVRHNEQFF	TRBV6-4	TRBJ2-1
TGCGCCAGCAGCCAGTTCCTACTAGCGGGAGGAGAAAAACTGTTTTTT	CASSQFLLAGGEKLFF	TRBV4-1	TRBJ1-4
TGCAGCGTTGACCAACAACAGGGTACAGTAGGCTACACCTTC	CSVDQQQGTVGYTF	TRBV29-1	TRBJ1-2
TGTGCCAGCAGGGGTCCCAGTAGGACTAGCGGGGCAGCCTACAATGAGCAGTTCTTC	CASRGPSRTSGAAYNEQFF	TRBV28	TRBJ2-1
TGTGCCAGCTCACCATATATTTCCGACAGGTTTAATTCACCCCTCCACTTT	CASSPYISDRFNSPLHF	TRBV18	TRBJ1-6
TGTGCCAGCAGCCCGTCCTTGGGGGAGACCCAGTACTTC	CASSPSLGETQYF	TRBV11-1	TRBJ2-5
TGCGCCAGCAGCCAAGCGGAGGACAGGACCACTGAAGCTTTCTTT	CASSQAEDRTTEAFF	TRBV4-1	TRBJ1-1
TGCAGTGCTAGAGATCCCCACGGGGCTGGGACGGGTGGCTACACCTTC	CSARDPHGAGTGGYTF	TRBV20-1	TRBJ1-2
TGTGCCACCAGTGATTTCCTGTTGGGACGAGCTGGGTTGGAAAAACTGTTTTTT	CATSDFLLGRAGLEKLFF	TRBV24-1	TRBJ1-4
TGTGCCAGCAGCGGTATCATTCGGACAACTGTGTACGAGCAGTACTTC	CASSGIIRTTVYEQYF	TRBV7-2	TRBJ2-7
TGTGCCAGCAGTGAATGTTCGGTGGGACAGGGGGGTGAAGCTTTCTTT	CASSECSVGQGGEAFF	TRBV6-1	TRBJ1-1
TGTGCCAGCAGCTTAACAGGGGGCGGGGGGAAAAACACTGAAGCTTTCTTT	CASSLTGGGGKNTEAFF	TRBV5-6	TRBJ1-1
TGTGCCAGCAGTGGGGGGGGCTTTCAGCCCCAGCATTTT	CASSGGGFQPQHF	TRBV27	TRBJ1-5
TGCGCCAGCAGCCCCTTTTACGTCCATACGCAGTATTTT	CASSPFYVHTQYF	TRBV5-1	TRBJ2-3
TGTGCCATCACAAACACTGAAGCTTTCTTT	CAITNTEAFF	TRBV10-3	TRBJ1-1
TGTGCCAGCAGCCTCCGGGGTAGACAGCCCCCTAATTCACCCCTCCACTTT	CASSLRGRQPPNSPLHF	TRBV6-1	TRBJ1-6
TGCAGTGCTAGAAAAAGGTTCGAGACCTCCTACGAGCAGTACTTC	CSARKRFETSYEQYF	TRBV20-1	TRBJ2-7
TGTGCCAGCAGCCATCCCCGCGGGGACCACGAGCAGTACTTC	CASSHPRGDHEQYF	TRBV27	TRBJ2-7
TGTGCCAGCAGTGCGGGGGGGCCCTACGAGCAGTACTTC	CASSAGGPYEQYF	TRBV25-1	TRBJ2-7
TGCAGTGCGGGGGCTGAGTCCGCTAATGAAAAACTGTTTTTT	CSAGAESANEKLFF	TRBV20-1	TRBJ1-4
TGTGCCAGCAGCCGCCCGAGTCACACCATGAACACTGAAGCTTTCTTT	CASSRPSHTMNTEAFF	TRBV4-2	TRBJ1-1
TGTGCCAGCAGCTCAGAGGAGATTTCGAGCTCCTACGAGCAGTACTTC	CASSSEEISSSYEQYF	TRBV7-2	TRBJ2-7
TGTGCCAGCAGCCAATCTAGCGGGACTAGAGACGAGCAGTACTTC	CASSQSSGTRDEQYF	TRBV13	TRBJ2-7
TGTGCCAGTAGTATACCCGAACAGCTAAATCAGCCCCAGCATTTT	CASSIPEQLNQPQHF	TRBV19	TRBJ1-5
TGTGCCAGTAGTATAAAATCAGCAGGATACACAGATACGCAGTATTTT	CASSIKSAGYTDTQYF	TRBV19	TRBJ2-3
TGTGCCAGCAGCTTAGCCGACAGGGGGCTTGGCTACACCTTC	CASSLADRGLGYTF	TRBV7-2	TRBJ1-2
TGCGCCAGCAGCCAAGATGTCCGGGGCGAAAGGGCCAAAAACATTCAGTACTTC	CASSQDVRGERAKNIQYF	TRBV4-3	TRBJ2-4
TGTGCCAGCAGATTGGTCAGGGACAACACTGAAGCTTTCTTT	CASRLVRDNTEAFF	TRBV7-9	TRBJ1-1
TGTGCCTGGAGCGACCGACTAGCGGGTATTTCTCTCGAGCAGTACTTC	CAWSDRLAGISLEQYF	TRBV30	TRBJ2-7
TGTGCTCAGCTAGGGCGGGAGCTCACTTCCTACGAGCAGTACTTC	CAQLGRELTSYEQYF	TRBV24-1	TRBJ2-7
TGCAGTGCTTTTGATGGTGGTGGGGTACCCTACGAGCAGTACTTC	CSAFDGGGVPYEQYF	TRBV20-1	TRBJ2-7
TGTGCCAGCAGGGGGGCTTTCTTT	CASRGAFF	TRBV6-5	TRBJ1-1
TGTGCCAGCAGCCCAAACAAAACGGGGCAGCCCCAGCATTTT	CASSPNKTGQPQHF	TRBV7-9	TRBJ1-5
TGTGCTAGCAGCTTAGGCTTCTCGGGCGGACAGGACAATCAGCCCCAGCATTTT	CASSLGFSGGQDNQPQHF	TRBV7-7	TRBJ1-5
TGCAGTGCTAGAGAGGGAAACAGGGTGAACACTGAAGCTTTCTTT	CSAREGNRVNTEAFF	TRBV20-1	TRBJ1-1
TGCGCCAGCAGCTTATACCGGAGCGACAGGGAGCCCCCGCCGTACAGTTCCGAGCAGTACTTC	CASSLYRSDREPPPYSSEQYF	TRBV5-1	TRBJ2-7
TGTGCCACCAGCAGAGATCCGGACAGGGTCAACGAGCAGTTCTTC	CATSRDPDRVNEQFF	TRBV15	TRBJ2-1
TGTGCCAGCACACGGGGGAATCAGCCCCAGCATTTT	CASTRGNQPQHF	TRBV27	TRBJ1-5
TGTGCCAGCAGCGCGGGGGGGCCCTGTAATTCACCCCTCCACTTT	CASSAGGPCNSPLHF	TRBV3-1	TRBJ1-6
TGTGCCAGCAGCCTAGGTGAGGGGGGGAAGCACACTGAAGCTTTCTTT	CASSLGEGGKHTEAFF	TRBV7-6	TRBJ1-1
TGTGCCACCCAAAGTGTGAACGAGGGACCGGCTGAAGCTTTCTTT	CATQSVNEGPAEAFF	TRBV24-1	TRBJ1-1
TGTGCCAGCATCCCGTCCGACTATCTAAGCTACGAGCAGTACTTC	CASIPSDYLSYEQYF	TRBV6-1	TRBJ2-7
TGCGCCAGCAGCCAAGATCTGGCCAGGGGCGGGGCCACAGATACGCAGTATTTT	CASSQDLARGGATDTQYF	TRBV4-3	TRBJ2-3
TGTGCCAGGCCCGGGGGATCCTACGAGCAGTACTTC	CARPGGSYEQYF	TRBV11-2	TRBJ2-7
TGTGCCAGCAGCTCGATGTATCCCTGGACTAGCGGGCAGACCTACGAGCAGTACTTC	CASSSMYPWTSGQTYEQYF	TRBV7-2	TRBJ2-7
TGTGCCAGCAGTGGGGATGGACTAGCGGGAGATACGCAGTATTTT	CASSGDGLAGDTQYF	TRBV6-5	TRBJ2-3
TGTGCCAGCAGCCTACCGGGGGAGCAGTACTTC	CASSLPGEQYF	TRBV14	TRBJ2-7
TGTGCCAGCGGACCGCAAGGGGCAACGAGGAATGAAAAACTGTTTTTT	CASGPQGATRNEKLFF	TRBV7-9	TRBJ1-4
TGCGCCAGCAGTGATCAACCGGGCGTCTCCTACAATGAGCAGTTCTTC	CASSDQPGVSYNEQFF	TRBV10-1	TRBJ2-1
TGTGCCAGCAGCCAAGATGTCTCCGGGACAGGGAGCGAGCAGTACTTC	CASSQDVSGTGSEQYF	TRBV4-2	TRBJ2-7
TGTGCCAGCAGTTTAGAGGACTATCGGCCTTCATGGACGCAGCCCCAGCATTTT	CASSLEDYRPSWTQPQHF	TRBV27	TRBJ1-5
TGTGCCAGCAGTAACAACAGGGTATGCTACGAGCAGTACTTC	CASSNNRVCYEQYF	TRBV28	TRBJ2-7
TGTGCCAGCAGCTTTTGCAGGGGGCTGAGAGGGAGTAACTATGGCTACACCTTC	CASSFCRGLRGSNYGYTF	TRBV7-8	TRBJ1-2
TGTGCCATGGAGGGGCCTAGAATTTTCATGAACACTGAAGCTTTCTTT	CAMEGPRIFMNTEAFF	TRBV10-3	TRBJ1-1
TGTGCCACCAGTTGTCCTAGGGCCTACAATGAGCAGTTCTTC	CATSCPRAYNEQFF	TRBV24-1	TRBJ2-1
TGTGCCAGCAGCTTAGGGAGAGGAAGGGAAAAACTGTTTTTT	CASSLGRGREKLFF	TRBV7-2	TRBJ1-4
TGTGCCAGCAGCTTGGCCATACTAATTCAGCCCCAGCATTTT	CASSLAILIQPQHF	TRBV5-6	TRBJ1-5
TGTGCCAGCAGCCACTTTGGACAGACCGGGGAGCTGTTTTTT	CASSHFGQTGELFF	TRBV5-8	TRBJ2-2
TGCGCCAGCAGCTTGGCCGCTAGGCCAGGCTACACCTTC	CASSLAARPGYTF	TRBV5-1	TRBJ1-2
TGTGCCAGCAGCCAAGATTCTAAGGACATAAAAGAGACCCAGTACTTC	CASSQDSKDIKETQYF	TRBV3-1	TRBJ2-5
TGTGCCAGCGGTTCTCCAGGGGACACGAGCCGGGGCTACACCTTC	CASGSPGDTSRGYTF	TRBV7-3	TRBJ1-2
TGTGCCAGCAGTTACGGGTCAATCGGGGACAAACTCGTACCTGGAAACACCATATATTTT	CASSYGSIGDKLVPGNTIYF	TRBV6-5	TRBJ1-3
TGTGCCAGCAGCCAAGATGTAACTTCGACAGGAGCTTTCTTT	CASSQDVTSTGAFF	TRBV3-1	TRBJ1-1
TGCAGCGTTAGGGCCAGGTCAAAGGATCCTAGGGGCGGTAACTATGGCTACACCTTC	CSVRARSKDPRGGNYGYTF	TRBV29-1	TRBJ1-2
TGCGCCAGCAGCCAAGATGGGGGGGGGGACAATGAGCAGTTCTTC	CASSQDGGGDNEQFF	TRBV4-1	TRBJ2-1
TGTGCCAGCAGTTTGGGCGGGTACGAGCAGTACTTC	CASSLGGYEQYF	TRBV27	TRBJ2-7
TGCAGTGCTAGAGCGGGGGGCCAGCGGCGCACTGAAGCTTTCTTT	CSARAGGQRRTEAFF	TRBV20-1	TRBJ1-1
TGTGCCAGCACTTCCGCCCCTACTAGCGGGAGGGGGCTTGAGACCCAGTACTTC	CASTSAPTSGRGLETQYF	TRBV6-4	TRBJ2-5
TGCAGCGTTGCTCGGGAAGGGGGTCGTGGCTACACCTTC	CSVAREGGRGYTF	TRBV29-1	TRBJ1-2
TGCGCCAGCAAAAAAGGGCGGCCCAACCGGACTGGGGAGACCCAGTACTTC	CASKKGRPNRTGETQYF	TRBV10-1	TRBJ2-5
TGCAGTGCTAGAGATTTCAAGGAGGGTTATGTTAACACTGAAGCTTTCTTT	CSARDFKEGYVNTEAFF	TRBV20-1	TRBJ1-1
TGTGCCATTCCTCGGGGACGGCCAACTGAAGCTTTCTTT	CAIPRGRPTEAFF	TRBV2	TRBJ1-1
TGTGCCAGCAGCCGAGGGGGGGGGGGGGTTTCCTACGAGCAGTACTTC	CASSRGGGGVSYEQYF	TRBV5-4	TRBJ2-7
TGTGCCTGGAGTGTAGGAGTAATCCGGGCCAATGAGCAGTTCTTC	CAWSVGVIRANEQFF	TRBV30	TRBJ2-1
TGTGCCAGCAGTGACTCAGGGACAGGTAGTAATTCACCCCTCCACTTT	CASSDSGTGSNSPLHF	TRBV6-4	TRBJ1-6
TGTGCCAGCCCCTGGAATATCTGCTATGGCTACACCTTC	CASPWNICYGYTF	TRBV2	TRBJ1-2
TGTGCCTGGAGTGAGGGATTCGCTTCCTTTCAGCCCCAGCATTTT	CAWSEGFASFQPQHF	TRBV30	TRBJ1-5
TGTGCCAGCATGGGGACAGGTGTTTCGAACACTGAAGCTTTCTTT	CASMGTGVSNTEAFF	TRBV6-4	TRBJ1-1
TGTGCCAGTCATCCGGGACAGGACAATGGCTACACCTTC	CASHPGQDNGYTF	TRBV19	TRBJ1-2
TGTGCCAGCAGCTCCAGGGGGACAGCCAAAAACATTCAGTACTTC	CASSSRGTAKNIQYF	TRBV5-4	TRBJ2-4
TGTGCCAGCAGTTTCTGGAGAAATGAGCAGTTCTTC	CASSFWRNEQFF	TRBV28	TRBJ2-1
TGTGCCAGCAGCTCTCCCATTCAGGGGGCTAAGGAGACTAATGAAAAACTGTTTTTT	CASSSPIQGAKETNEKLFF	TRBV7-6	TRBJ1-4
TGTGCCAGCAGTCGGCGGCCGGACAGCTCCTACGAGCAGTACTTC	CASSRRPDSSYEQYF	TRBV6-5	TRBJ2-7
TGTGCCAGCAGCTTGGAGGGCCCGGGGGTATCCTACGAGCAGTACTTC	CASSLEGPGVSYEQYF	TRBV5-6	TRBJ2-7
TGTGCCAGCAGAAAGACAGGGCGACGGGTCGGCAGCTCCTACGAGCAGTACTTC	CASRKTGRRVGSSYEQYF	TRBV12-4	TRBJ2-7
TGTGCCAGCAGGTATTCCTCGAATGAAGCTTTCTTT	CASRYSSNEAFF	TRBV6-5	TRBJ1-1
TGTGCCAGCGTGGGGACAGGGCCCAGAGTCGCGAAGAGCTCCTACGAGCAGTACTTC	CASVGTGPRVAKSSYEQYF	TRBV27	TRBJ2-7
TGCGCCAGCCAAGACAGGCCCAATCAGCCCCAGCATTTT	CASQDRPNQPQHF	TRBV4-3	TRBJ1-5
TGTGCCAGTCGGGGGGTAGGTACGCAGTATTTT	CASRGVGTQYF	TRBV19	TRBJ2-3
TGTGCCAGCCATCAGGGGCGCAGCTACGAGCAGTACTTC	CASHQGRSYEQYF	TRBV7-3	TRBJ2-7
TGCGCCAGCAGCTTGATGGACAGTCGTGGAGTGGCTTTCTTT	CASSLMDSRGVAFF	TRBV5-1	TRBJ1-1
TGCACCTTACAGGGGGCAAGAATTGCCGAGCAGTACTTC	CTLQGARIAEQYF	TRBV20-1	TRBJ2-7
TGTGCCAGCAGTTTAGATTGTAGGGGGGGCTCCTACGAGCAGTACTTC	CASSLDCRGGSYEQYF	TRBV12-4	TRBJ2-7
TGTGCCAGCAGACCTTCAGACAGGTTGAAGGATGAGCAGTTCTTC	CASRPSDRLKDEQFF	TRBV2	TRBJ2-1
TGCAGTGCTATATCACGCAGGACGCCCTACGAGCAGTACTTC	CSAISRRTPYEQYF	TRBV20-1	TRBJ2-7
TGTGCCAGCAGCAAAGGGACTAGGGGGTACGAGCAGTACTTC	CASSKGTRGYEQYF	TRBV5-6	TRBJ2-7
TGTGCCAGCAGTGAAGAGTACCGGGACTCGACGGCCTACAATGAGCAGTTCTTC	CASSEEYRDSTAYNEQFF	TRBV6-1	TRBJ2-1
TGTGCCAGGGAATGCTGGGGACCTAGTTCACCCCTCCACTTT	CARECWGPSSPLHF	TRBV6-3	TRBJ1-6
TGTGCCAGCAGAAGCGGGAGGTCTCACTTGGCCTACGAGCAGTACTTC	CASRSGRSHLAYEQYF	TRBV6-2	TRBJ2-7
TGTGCCAGCAGCAGACTAGCGGGGGCGAACACCGGGGAGCTGTTTTTT	CASSRLAGANTGELFF	TRBV9	TRBJ2-2
TGTGCCAGCCAATACATTTACACTGAAGCTTTCTTT	CASQYIYTEAFF	TRBV6-5	TRBJ1-1
TGTGCCAGCAGTAGGCCTGGGAAGGGACTAGCGGGGGGGCCCCGTTACGAGCAGTACTTC	CASSRPGKGLAGGPRYEQYF	TRBV27	TRBJ2-7
TGTGCCAGCAGCCCCGCCGCCAGGGCCTACGAGCAGTACTTC	CASSPAARAYEQYF	TRBV7-3	TRBJ2-7
TGTGCCAGCAGCCTGGACAGCCGGAACACTGAAGCTTTCTTT	CASSLDSRNTEAFF	TRBV6-5	TRBJ1-1
TGTGCCACCAGGGAGGGCGGTAACACCGGGGAGCTGTTTTTT	CATREGGNTGELFF	TRBV24-1	TRBJ2-2
TGTGCCAGCAGCATTCCGAAGTACGAGCAGTACTTC	CASSIPKYEQYF	TRBV9	TRBJ2-7
TGTGCCAGCACTCTCGGCCCCTATGGCTACACCTTC	CASTLGPYGYTF	TRBV9	TRBJ1-2
TGCGCCAGCAGCCAAGATACCCCCGACTCCCGGGCCAAAAACATTCAGTACTTC	CASSQDTPDSRAKNIQYF	TRBV4-3	TRBJ2-4
TGTGCCAGCGCAGGGGGGTATGGCTACACCTTC	CASAGGYGYTF	TRBV5-6	TRBJ1-2
TGCGCCACTCTCGCGGGAGTCAAGTTGTTAGATACGCAGTATTTT	CATLAGVKLLDTQYF	TRBV10-1	TRBJ2-3
TGTGCCAGCAGCTTAGGAATAGGGGGACTAGCGGGTACGCCCGCTAGCACAGATACGCAGTATTTT	CASSLGIGGLAGTPASTDTQYF	TRBV7-6	TRBJ2-3
TGTGCCACCAGTGAACCCCGGGGGGGCCCCGAGCAGTACTTC	CATSEPRGGPEQYF	TRBV24-1	TRBJ2-7
TGTGCCAGCAGTGAAAGCGACAGGGGAGAAGAGACCCAGTACTTC	CASSESDRGEETQYF	TRBV6-1	TRBJ2-5
TGTGCCAGCAGCCAAGTTTGGCAGGAACACGAGCAGTACTTC	CASSQVWQEHEQYF	TRBV3-1	TRBJ2-7
TGTGCCAGCAGTCCTAGCGGGGGGCCAGATACGCAGTATTTT	CASSPSGGPDTQYF	TRBV28	TRBJ2-3
TGTGCCAGCAGCCGCCGGGACAGGGGGCGCTTACTGACTAACTATGGCTACACCTTC	CASSRRDRGRLLTNYGYTF	TRBV12-3	TRBJ1-2
TGTGCCAGCAGCACGACAGGGAGGCCTGGGGATACGCAGTATTTT	CASSTTGRPGDTQYF	TRBV9	TRBJ2-3
TGTGCCAGCAAGGGTCCGGGACAGGGCATCGAGCAGTACTTC	CASKGPGQGIEQYF	TRBV9	TRBJ2-7
TGCAGTGCTAGAACCTCTGGACTAGCGGGACTCAATGAGCAGTTCTTC	CSARTSGLAGLNEQFF	TRBV20-1	TRBJ2-1
TGTGCCATCAAGCCAATCGGGCAGAACACTGAAGCTTTCTTT	CAIKPIGQNTEAFF	TRBV10-3	TRBJ1-1
TGTGCCAGCAGTGATAGACGGATCTCCTACGAGCAGTACTTC	CASSDRRISYEQYF	TRBV6-4	TRBJ2-7
TGTGCCAGCACGACCGGGACATCGGTTGAAAAACTGTTTTTT	CASTTGTSVEKLFF	TRBV6-5	TRBJ1-4
TGTGCCAGCCATGGACAGGGGGCATTTAGAGGCAATCAGCCCCAGCATTTT	CASHGQGAFRGNQPQHF	TRBV7-4	TRBJ1-5
TGTGCCAGCAGTTTTACTAGGCACACCGGGGAGCTGTTTTTT	CASSFTRHTGELFF	TRBV6-9	TRBJ2-2
TGTGTCGACAGGATAGAGCAGTACTTC	CVDRIEQYF	TRBV25-1	TRBJ2-7
TGTGCCAGCAGCTTAAGCCCCCGGGGCGGGCTTGAGCAGTTCTTC	CASSLSPRGGLEQFF	TRBV7-9	TRBJ2-1
TGTGAGGGGGGGTATATAGATACGCAGTATTTT	CEGGYIDTQYF	TRBV7-9	TRBJ2-3
TGTGCCAGCAGGTGGGACATTGAAAAACTGTTTTTT	CASRWDIEKLFF	TRBV2	TRBJ1-4
TGTGCCAGCAGTGAATACCCCGGTTTGGACAGGGTAGAGACCCAGTACTTC	CASSEYPGLDRVETQYF	TRBV6-1	TRBJ2-5
TGCAGTGCTAGAGATCTTGGAGGTCCCGGGACAGGGGGCTGCTTTAGACACTATGGCTACACCTTC	CSARDLGGPGTGGCFRHYGYTF	TRBV20-1	TRBJ1-2
TGTGCTAGTGGTTTGGTACCCATGGGGTTGTTACAGTATTTT	CASGLVPMGLLQYF	TRBV12-5	TRBJ2-3
TGCAGCGTTGAGAAGCTTGGGACTAGCGGAGGGAATGAGCAGTTCTTC	CSVEKLGTSGGNEQFF	TRBV29-1	TRBJ2-1
TGTGCCACGTCTTGCACAGATACGCAGTATTTT	CATSCTDTQYF	TRBV13	TRBJ2-3
TGTGCCAGCAGCCAAGATCACCCGGCCGGGACAGCGGAGAGTCGTGGCTACACCTTC	CASSQDHPAGTAESRGYTF	TRBV3-1	TRBJ1-2
TGCGCCAGCAGCTTGCACCCCGACAGGGTACGGACCCCCGAGCAGTACTTC	CASSLHPDRVRTPEQYF	TRBV5-1	TRBJ2-7
TGCAGTGCTGACAGGGGGGCCGAACAGCCCCAGCATTTT	CSADRGAEQPQHF	TRBV20-1	TRBJ1-5
TGTGCCACAGGTTTCACAGATACGCAGTATTTT	CATGFTDTQYF	TRBV6-5	TRBJ2-3
TGTGCCAGCAGTTACCGGTCGGGACGTTATGGCTACACCTTC	CASSYRSGRYGYTF	TRBV6-6	TRBJ1-2
TGCAGTGCTAGTAGTGGCGGGGGCCCATCCAAATCTGGGGCCAACGTCCTGACTTTC	CSASSGGGPSKSGANVLTF	TRBV20-1	TRBJ2-6
TGTGCCAGCAGTTTTCTCCGGACAGATCCGTTTAACACCGGGGAGCTGTTTTTT	CASSFLRTDPFNTGELFF	TRBV27	TRBJ2-2
TGTGCTAGTGGTTTGTTTGGGGGGTGCTGGCGCTCCTACGAGCAGTACTTC	CASGLFGGCWRSYEQYF	TRBV12-5	TRBJ2-7
TGTGCCAGCAGTTTGCCAACAGGGACAAAGCCCCAGCATTTT	CASSLPTGTKPQHF	TRBV6-5	TRBJ1-5
TGTGCCAGCCCTGAGGGCCAAAACATTCAGTACTTC	CASPEGQNIQYF	TRBV9	TRBJ2-4
TGTGCCAGTAAACAGGTCGGAGGGCAAGCGTACCAAGAGACCCAGTACTTC	CASKQVGGQAYQETQYF	TRBV19	TRBJ2-5
TGTGCCACCAGACGTAGGGGACAGGATGAAAAACTGTTTTTT	CATRRRGQDEKLFF	TRBV15	TRBJ1-4
TGTGCCAGCAGTCCTACAAGTATGTCTATTGAAGCTTTCTTT	CASSPTSMSIEAFF	TRBV12-3	TRBJ1-1
TGTGCCAGCAGTCAGATACTAGCGGGAGCTAATGAGCAGTTCTTC	CASSQILAGANEQFF	TRBV7-9	TRBJ2-1
TGTGCCAGCAGTTTATCGACAATGAGGGCGATTAATGAGCAGTTCTTC	CASSLSTMRAINEQFF	TRBV28	TRBJ2-1
TGTGCCAGCAGCTTAGGTAGCGGGCATGGCTACGAGCAGTACTTC	CASSLGSGHGYEQYF	TRBV7-2	TRBJ2-7
TGTGCCAGCAGCATGCGGGGAAATCTGGACACCGGGGAGCTGTTTTTT	CASSMRGNLDTGELFF	TRBV7-3	TRBJ2-2
TGTGCCAGCAGCGCCGTATCTTCTAGGGGCCCGGGACAGCTTGTGCAGCCCCAGCATTTT	CASSAVSSRGPGQLVQPQHF	TRBV7-3	TRBJ1-5
TGTGCCAGCAGCGCCACTAGCGGGAGGTTACCACAGCCTAATCAGCCCCAGCATTTT	CASSATSGRLPQPNQPQHF	TRBV13	TRBJ1-5
TGTGCCAGCAGCTTGAAACTAGCGGGTGAGCAGTTCTTC	CASSLKLAGEQFF	TRBV7-6	TRBJ2-1
TGTGCCAGCATTCCGGGACAGGGGGCCCCCTCCTACGAGCAGTACTTC	CASIPGQGAPSYEQYF	TRBV6-1	TRBJ2-7
TGTGCCAGCAGTGAAGGACAATTATGGCCCGCTAGAGGGTCGGATGAAGCTTTCTTT	CASSEGQLWPARGSDEAFF	TRBV6-1	TRBJ1-1
TGTGCCAGCAGTGCCGCCGCAGGGGGCGCGGATTGGCAGCCCCAGCATTTT	CASSAAAGGADWQPQHF	TRBV6-1	TRBJ1-5
TGTGCCAGCAGCGACAGGTGGGTGGTCTCCTACGAGCAGTACTTC	CASSDRWVVSYEQYF	TRBV5-4	TRBJ2-7
TGTGCCAGCAGTTTACGAGGCGGACTAGCGGGAGGGCGGAGAGGATTATGGGAGCCCCAGCATTTT	CASSLRGGLAGGRRGLWEPQHF	TRBV12-4	TRBJ1-5
TGCAGTGCTAGACGAGTAGCGGGGAAAAGCCCAGATACGCAGTATTTT	CSARRVAGKSPDTQYF	TRBV20-1	TRBJ2-3
TGCGCCAGCAGTGAGGAACCAAAATTGGCACTAGCGGGAGCCTACGAGCAGTACTTC	CASSEEPKLALAGAYEQYF	TRBV10-2	TRBJ2-7
TGTGCCACCAGGACCCGGGACAGGGGGGTAAGCTCCTACGAGCAGTACTTC	CATRTRDRGVSSYEQYF	TRBV24-1	TRBJ2-7
TGCAGTGCTAGAGTGGGGATGGACTATGGCTACACCTTC	CSARVGMDYGYTF	TRBV20-1	TRBJ1-2
TGTGCCAGCAGCTTAGTCCGAGGAGGGACAGGGTTGGGAAACACCATATATTTT	CASSLVRGGTGLGNTIYF	TRBV13	TRBJ1-3
TGCGCCAGCAGCCAAGCTGTTTTGGAGCCAACAGGGCCACTAGGCTACACCTTC	CASSQAVLEPTGPLGYTF	TRBV4-1	TRBJ1-2
TGCGCCAGCAGCGCGGGAGTCGACTGTGAAAAACTGTTTTTT	CASSAGVDCEKLFF	TRBV5-1	TRBJ1-4
TGTGCCAGCAGTTTATACAGGGGTACGTCCTACAATGAGCAGTTCTTC	CASSLYRGTSYNEQFF	TRBV27	TRBJ2-1
TGTGCCAGCAGACAGGCAACCGGGGAGCTGTTTTTT	CASRQATGELFF	TRBV28	TRBJ2-2
TGTGCCAGCAGCCAGCGACAGGAAAGCGGGTATTTT	CASSQRQESGYF	TRBV7-9	TRBJ2-3
TGTGCCAGCCGGGGGACAGATCGCAATCAGCCCCAGCATTTT	CASRGTDRNQPQHF	TRBV27	TRBJ1-5
TGTGCCAGCAGCTCCTTCATACCTAGCGGGGTCCCTAGCAATCAGCCCCAGCATTTT	CASSSFIPSGVPSNQPQHF	TRBV7-3	TRBJ1-5
TGTGCCAGCAGCCCCGCGGGACTAGCGTCCGAGCAGTACTTC	CASSPAGLASEQYF	TRBV7-3	TRBJ2-7
TGTGCCATCAAGCCCCGTGCTCTTCCCAGGGGAATTATGGCCGGGGAGCTGTTTTTT	CAIKPRALPRGIMAGELFF	TRBV11-2	TRBJ2-2
TGTGCCTGGAGTCCCCCGACAGGAATTGGGGAAGAATACGAGCAGTACTTC	CAWSPPTGIGEEYEQYF	TRBV30	TRBJ2-7
TGTGCCAGCAGCGGGAGGACTTTTGGCTACACCTTC	CASSGRTFGYTF	TRBV6-5	TRBJ1-2
TGTGCCAGCAGCACGAAGCCCCGGGGAGGGATGGCCTACAATGAGCAGTTCTTC	CASSTKPRGGMAYNEQFF	TRBV13	TRBJ2-1
TGTGCCAGCAGCTTAACCAGGCGTAGGGGCAACACCATATATTTT	CASSLTRRRGNTIYF	TRBV11-2	TRBJ1-3
TGTGCCAGTAGTATAGATACGGGATACAATGAGCAGTTCTTC	CASSIDTGYNEQFF	TRBV19	TRBJ2-1
TGTGCTAGTTGCGCGGCCGACAATGAGCAGTTCTTC	CASCAADNEQFF	TRBV12-5	TRBJ2-1
TGTGCCAGCAGGGGGGCCGGGACAGGGGCACCTAACTATGGCTACACCTTC	CASRGAGTGAPNYGYTF	TRBV2	TRBJ1-2
TGTGCCAGTAGTTATGGGACAGGGGCCTACGAGCAGTACTTC	CASSYGTGAYEQYF	TRBV19	TRBJ2-7
TGTGCCAGCAGCTTCCGTAGGGGAGGGAACACTGAAGCTTTCTTT	CASSFRRGGNTEAFF	TRBV7-9	TRBJ1-1
TGTGCCAGCAGTTACACTTTTCACCAGGGGGCAGTTGGCTACACCTTC	CASSYTFHQGAVGYTF	TRBV6-5	TRBJ1-2
TGCGCCAGCAGACTACCACAGAAGAATAACTATGGCTACACCTTC	CASRLPQKNNYGYTF	TRBV5-1	TRBJ1-2
TGTGCCAGCAGCTTGGAGGGCTACCCCGGGACAAGGGAGGGACCACCCCTCCACTTT	CASSLEGYPGTREGPPLHF	TRBV5-4	TRBJ1-6
TGTGCCAGCAGGAGGGCCCATGAAAAACTGTTTTTT	CASRRAHEKLFF	TRBV6-4	TRBJ1-4
TGCGCCAGCAGCAGCAGGGTAGAAGAGACCCAGTACTTC	CASSSRVEETQYF	TRBV5-1	TRBJ2-5
TGCGCCAGCAGCTTGGAGACGACAAGCTCCTACAATGAGCAGTTCTTC	CASSLETTSSYNEQFF	TRBV5-1	TRBJ2-1
TGTGCCAGCAGTTGTAGCTGGGGTGGGACAGTAAGCTCCTACGAGCAGTACTTC	CASSCSWGGTVSSYEQYF	TRBV6-4	TRBJ2-7
TGTGCCAGCAGCGAAGGGGGGTTGGGGAATGGCTACACCTTC	CASSEGGLGNGYTF	TRBV7-3	TRBJ1-2
TGTGCCAGCAGCCGGGGAGATACGCAGTATTTT	CASSRGDTQYF	TRBV13	TRBJ2-3
TGTGCCCATAGGCGCGTGTCCTACGAGCAGTACTTC	CAHRRVSYEQYF	TRBV5-6	TRBJ2-7
TGTGCCAGCAGAAGTCGCGGGAGTCAAGAGACCCAGTACTTC	CASRSRGSQETQYF	TRBV7-4	TRBJ2-5
TGCGCCAGCAGCTTGGGACGTCATTCGGCCTACGAGCAGTACTTC	CASSLGRHSAYEQYF	TRBV5-1	TRBJ2-7
TGCAGTGCTAGGGCATACGAGCAGTACTTC	CSARAYEQYF	TRBV20-1	TRBJ2-7
TGTGCCAGCACATACCCACCGGACAGGGGGCGTTTTAAGCATGGCTACACCTTC	CASTYPPDRGRFKHGYTF	TRBV6-2	TRBJ1-2
TGTGCCAGTAGTATTAACTCGATGTCATACGACGAGGGCTCCTACAATGAGCAGTTCTTC	CASSINSMSYDEGSYNEQFF	TRBV19	TRBJ2-1
TGTGCCAGCAGCCAAAAACGGGGACAGGCAAAACAGTACTTC	CASSQKRGQAKQYF	TRBV14	TRBJ2-7
TGCAGTTTGACAGGGCCGAATGAAAAACTGTTTTTT	CSLTGPNEKLFF	TRBV20-1	TRBJ1-4
TGTGCCAGCAGCGTAGCACGTTTGCAGGGGCAGGGGCCCCAGCATTTT	CASSVARLQGQGPQHF	TRBV9	TRBJ1-5
TGTGCCAGCAGCGTCGGGTACCTTCAGAACACTGAAGCTTTCTTT	CASSVGYLQNTEAFF	TRBV9	TRBJ1-1
TGTGTAGGACCATCCTTCTTGGCCGGGGAGCTGTTTTTT	CVGPSFLAGELFF	TRBV6-4	TRBJ2-2
TGTGCCAGCAGCTTGGTTCGGGGCTGGCGAGCGTCTGAAGCTTTCTTT	CASSLVRGWRASEAFF	TRBV5-4	TRBJ1-1
TGTGCCAGCAGTGGGGGAACTTTTAATGAAAAACTGTTTTTT	CASSGGTFNEKLFF	TRBV12-3	TRBJ1-4
TGTGCCAGTAGTATTCCGAGCGGGATGTTGTCAGTTAGCAATCAGCCCCAGCATTTT	CASSIPSGMLSVSNQPQHF	TRBV19	TRBJ1-5
TGTGCCAGCAGCAAGTCGGGGGTTATGAACACTGAAGCTTTCTTT	CASSKSGVMNTEAFF	TRBV7-3	TRBJ1-1
TGCAGTGCTAGAGAAGCGACAGGGCACGACTATAATTCACCCCTCCACTTT	CSAREATGHDYNSPLHF	TRBV20-1	TRBJ1-6
TGTGCCAGTAGTATAGATCTAGACAGGGGTCGGGACGAAAAACTGTTTTTT	CASSIDLDRGRDEKLFF	TRBV19	TRBJ1-4
TGCGCCAGCAGCCACCGGGACAGGGTGCCCCAGCATTTT	CASSHRDRVPQHF	TRBV5-1	TRBJ1-5
TGTGCCAGCAGCACTGGGGGAGTAAGCAATCAGCCCCAGCATTTT	CASSTGGVSNQPQHF	TRBV9	TRBJ1-5
TGTGCCAGCAGTTCACGGGGACAGGGGGAGGGGAACACTGAAGCTTTCTTT	CASSSRGQGEGNTEAFF	TRBV25-1	TRBJ1-1
TGCAGTGGGATTCCGGGGTACAATGAGCAGTTCTTC	CSGIPGYNEQFF	TRBV20-1	TRBJ2-1
TGTGCCACCAGTGATTTTGGTCAGCGGGAGGAAAACACCGGGGAGCTGTTTTTT	CATSDFGQREENTGELFF	TRBV24-1	TRBJ2-2
TGTGCCAGCATAACCCAGGGGAATGAGCAGTTCTTC	CASITQGNEQFF	TRBV6-2	TRBJ2-1
TGTGCCAGCTCTGGGGTTGTTGGGAGCAACAATGAGCAGTTCTTC	CASSGVVGSNNEQFF	TRBV18	TRBJ2-1
TGTGCCACCCGATCCCGACAAGAAGCTTTCTTT	CATRSRQEAFF	TRBV19	TRBJ1-1
TGTGCCACCAGTGAGGGACAAGGGCTCGGGAGAGCTTTCTTT	CATSEGQGLGRAFF	TRBV24-1	TRBJ1-1
TGTGCCAGCTCACGTCCGAAACACACAGAGGGACGGAGCAATCAGCCCCAGCATTTT	CASSRPKHTEGRSNQPQHF	TRBV18	TRBJ1-5
TGTGCCAGCAGCTTAGGGACAGGTATAACGTACTTC	CASSLGTGITYF	TRBV7-9	TRBJ2-7
TGTGCCAGCAGCTTAGGGTACAGGGGTGATTCACCCCTCCACTTT	CASSLGYRGDSPLHF	TRBV7-4	TRBJ1-6
TGTGCCAGCAGCCGGGGGGGTGTGGATGAGCAGTTCTTC	CASSRGGVDEQFF	TRBV4-2	TRBJ2-1
TGTGCCAGCAGCCATATAAGTACGGATACGTTAACATCCTACAATGAGCAGTTCTTC	CASSHISTDTLTSYNEQFF	TRBV13	TRBJ2-1
TGTGCCAGCAGCTTAGAGGGGAACGAAAAGGGGGGGGGGTTTGAGACCCAGTACTTC	CASSLEGNEKGGGFETQYF	TRBV11-2	TRBJ2-5
TGTGCCAGCAGCCAAGGTGGGGGCGCCGAGCAGTACTTC	CASSQGGGAEQYF	TRBV14	TRBJ2-7
TGCGCCAGCACCGCGGGAGCGCATTGGGGTGGGAGTGGCTACACCTTC	CASTAGAHWGGSGYTF	TRBV10-1	TRBJ1-2
TGTGCCAGAGCGACGACCTACGAGCAGTACTTC	CARATTYEQYF	TRBV5-4	TRBJ2-7
TGTGCCAGCATCGGGGGACTAGCGGGGGAGGAGCAGTACTTC	CASIGGLAGEEQYF	TRBV6-6	TRBJ2-7
TGTGCCAGCAGTCGGACAAAACTGGGGAGGAATTCACCCCTCCACTTT	CASSRTKLGRNSPLHF	TRBV6-3	TRBJ1-6
TGCAGTGCCTTTCACAGGGTCTGCTACAATGAGCAGTTCTTC	CSAFHRVCYNEQFF	TRBV20-1	TRBJ2-1
TGTGCCAGCTCACCGGAACCGGTAGACTACAATCAGCCCCAGCATTTT	CASSPEPVDYNQPQHF	TRBV18	TRBJ1-5
TGTGCCAGCAGCCGACAGGGGCCGCCGAACACCGGGGAGCTGTTTTTT	CASSRQGPPNTGELFF	TRBV27	TRBJ2-2
TGTGCCAGCGCTAGGGTCCCTTCGGACACCGGGGAGCTGTTTTTT	CASARVPSDTGELFF	TRBV2	TRBJ2-2
TGTGCCAGCCACTGGGGACTTAGCACAGATACGCAGTATTTT	CASHWGLSTDTQYF	TRBV5-8	TRBJ2-3
TGTGCCAGCAGCTTAAACCGGGACTTAGATCCAGGCTACGAGCAGTACTTC	CASSLNRDLDPGYEQYF	TRBV7-3	TRBJ2-7
