TGTGCCAGCAGCCAAGAATTGGGGCCTGCACACACAGATACGCAGTATTTT	CASSQELGPAHTDTQYF	TRBV14	TRBJ2-3
TGCAGTGCTAGAGGGGGGCCAAGGGGGCCCTACGAGCAGTACTTC	CSARGGPRGPYEQYF	TRBV20-1	TRBJ2-7
TGCAGTGCGCCAGCGGGATCGGACGAGCAGTACTTC	CSAPAGSDEQYF	TRBV20-1	TRBJ2-7
TGTGCCAGCAGGGTTAGCACAGGGGAGAGGGGTAACAATGAAAAACTGTTTTTT	CASRVSTGERGNNEKLFF	TRBV2	TRBJ1-4
TGTGCCAGCAGCTGCAGCGGGAGCCAAGATACGCAGTATTTT	CASSCSGSQDTQYF	TRBV11-2	TRBJ2-3
TGTGCCAGCAGTTACGTAGGGCCGGACAGGGGATATCTGGGGTATAGCAATCAGCCCCAGCATTTT	CASSYVGPDRGYLGYSNQPQHF	TRBV6-5	TRBJ1-5
TGCAGTGCTAGATCAGTAGGGAAGAGAGGCTACACCTTC	CSARSVGKRGYTF	TRBV20-1	TRBJ1-2
TGTGCCAGCAGCTTAGACGGCTATGGCTACACCTTC	CASSLDGYGYTF	TRBV7-6	TRBJ1-2
TGTGCCAGCAGGGACCAGGTTTGCGAGACCCAGTACTTC	CASRDQVCETQYF	TRBV10-3	TRBJ2-5
TGTGCCAGCAGTTATTGTTGTAGGGTTGCTCACAATGAGCAGTTCTTC	CASSYCCRVAHNEQFF	TRBV6-9	TRBJ2-1
TGTGCCAGCAGTTACAAGCGGACCAACACTGAAGCTTTCTTT	CASSYKRTNTEAFF	TRBV6-2	TRBJ1-1
TGTGCCAGCAGTTGGGCGGGAGGAGGTTTGACTGAAGCTTTCTTT	CASSWAGGGLTEAFF	TRBV6-5	TRBJ1-1
TGCAGCGTTGATCTGGATAGTTACGAGCAGTACTTC	CSVDLDSYEQYF	TRBV29-1	TRBJ2-7
TGTGCCAGCAGCTTAGAAGATGCCGGGACAGTGTCGGACACCATATATTTT	CASSLEDAGTVSDTIYF	TRBV11-3	TRBJ1-3
TGTGCCAGCAGCCCTTTCCCGGCGAAGGTTCAACCCCTCCACTTT	CASSPFPAKVQPLHF	TRBV28	TRBJ1-6
TGTGCCAGCAGTGAAGTAGACTCAGACACCGGGGAGCTGTTTTTT	CASSEVDSDTGELFF	TRBV2	TRBJ2-2
TGTGCCAGCAGCCAAGACAAACCCGCAACCGCGGGGGGGGAGACCCAGTACTTC	CASSQDKPATAGGETQYF	TRBV3-1	TRBJ2-5
TGTGCCAGCTCACCACCGACGCATGGCTACACCTTC	CASSPPTHGYTF	TRBV18	TRBJ1-2
TGTGCCAGCAGTTTAGTTGCCTTTTGGACGCTCATACCCTTC	CASSLVAFWTLIPF	TRBV12-3	TRBJ1-2
TGCGCCAGCAGCTTTCACAGGGGGGGGTACAATGAGCAGTTCTTC	CASSFHRGGYNEQFF	TRBV5-1	TRBJ2-1
TGTGCCAGCAGTTACGGGCTCAGGGGGGAAACCCGGAACGAGCAGTACTTC	CASSYGLRGETRNEQYF	TRBV6-2	TRBJ2-7
TGTGCCAGCTCACGGGATAAGAAGTACAATGAGCAGTTCTTC	CASSRDKKYNEQFF	TRBV6-2	TRBJ2-1
TGCGCCAGCAGCTATCTGATGGGGGGAGATGAGCAGTTCTTC	CASSYLMGGDEQFF	TRBV5-1	TRBJ2-1
TGTGCCAGCTCACCTTCTCCGGGACTAGCGGGGAGGAATGAGCAGTTCTTC	CASSPSPGLAGRNEQFF	TRBV18	TRBJ2-1
TGTGCCAGCAGACCCGACTATGGCTACACCTTC	CASRPDYGYTF	TRBV7-2	TRBJ1-2
TGTACCCCCGGTGTTGAAAAACTGTTTTTT	CTPGVEKLFF	TRBV6-1	TRBJ1-4
TGCGCCAGCAGCTCTAAGACTAGCGACATCGAGCAGTACTTC	CASSSKTSDIEQYF	TRBV5-1	TRBJ2-7
TGTGCCAGCAGTTTGGGGGCCCCCGAGCAGTACTTC	CASSLGAPEQYF	TRBV6-5	TRBJ2-7
TGTGCCAGCAGTGCGGGGGTCACTGAAGCTTTCTTT	CASSAGVTEAFF	TRBV6-4	TRBJ1-1
TGCGCCAGCAGCCGGAAAAGGACTACGGACAGTTACGAGCAGTACTTC	CASSRKRTTDSYEQYF	TRBV5-1	TRBJ2-7
TGCAGCGCGGGGGGGGCCGGCGACAATGAGCAGTTCTTC	CSAGGAGDNEQFF	TRBV29-1	TRBJ2-1
TGTGCCAGCACCAGGAGCCTATGGTACAATGAGCAGTTCTTC	CASTRSLWYNEQFF	TRBV6-6	TRBJ2-1
TGTGCCTCTCGGGGGGGTGGGCATTCTAACTATGGCTACACCTTC	CASRGGGHSNYGYTF	TRBV7-7	TRBJ1-2
TGTGCCAGCAGCGGGCAAGAGACCCAGTACTTC	CASSGQETQYF	TRBV27	TRBJ2-5
TGTGCCAGCAAGTCCCATAGTCATGGGGGTGAAGCTTTCTTT	CASKSHSHGGEAFF	TRBV6-4	TRBJ1-1
TGTGCCAGCAGGATGCCCGGGACTAGTGAGCAGTACTTC	CASRMPGTSEQYF	TRBV7-9	TRBJ2-7
TGTGCCAGCATAAAGGGGGGATTTCATAGCAATCAGCCCCAGCATTTT	CASIKGGFHSNQPQHF	TRBV6-4	TRBJ1-5
TGTGCCACCAGTCGGGAGGCCGATCAGCCCCAGCATTTT	CATSREADQPQHF	TRBV24-1	TRBJ1-5
TGTGCCAGCAGTCTAGCGGGCTACGAGCAGTACTTC	CASSLAGYEQYF	TRBV27	TRBJ2-7
TGTGCCAGCAGCCCATGCAGGAACGGAGGCACAGATACGCAGTATTTT	CASSPCRNGGTDTQYF	TRBV7-4	TRBJ2-3
TGCGCCAGCAGCTTCTTGACCCCGCGGTTGGTAATCACCGGGGAGCTGTTTTTT	CASSFLTPRLVITGELFF	TRBV5-1	TRBJ2-2
TGTGCCAGCAGCCGACTAGCGGGAGGGCTAGGGGGCTACACCTTC	CASSRLAGGLGGYTF	TRBV5-4	TRBJ1-2
TGTGCCAGCATGTTGATGGGCTGGGGGATTTTAGATGGCTACACCTTC	CASMLMGWGILDGYTF	TRBV6-5	TRBJ1-2
TGCGCCAGCCGGTATTTACTCTCCCGTGAGACCCAGTACTTC	CASRYLLSRETQYF	TRBV4-3	TRBJ2-5
TGCGCCAGCAGCAGGCTTCACCGTAGCGGGCTTGGATCCTACGAGCAGTACTTC	CASSRLHRSGLGSYEQYF	TRBV4-1	TRBJ2-7
TGTGCCAGGAAGGGAGGACAGGGGACCTACGAGCAGTACTTC	CARKGGQGTYEQYF	TRBV6-6	TRBJ2-7
TGTGCCAGCAGCGGGGGGCTTAGTAATCAGCCCCAGCATTTT	CASSGGLSNQPQHF	TRBV9	TRBJ1-5
TGTGCCAGCAGTGTCCGACGCAATGAGCAGTTCTTC	CASSVRRNEQFF	TRBV2	TRBJ2-1
TGCGCCAGCGAGCAGAACTATGGCTACACCTTC	CASEQNYGYTF	TRBV5-1	TRBJ1-2
TGTGCCAGCAGCTTAGGGATTGGGCGGGATGAGCAGTTCTTC	CASSLGIGRDEQFF	TRBV5-5	TRBJ2-1
TGTGCCAGCAGCCAAGAGAACTCTCGGAACACTGAAGCTTTCTTT	CASSQENSRNTEAFF	TRBV14	TRBJ1-1
TGTGCCAGCACCGGGACAGGGCACATCCAAGAGACCCAGTACTTC	CASTGTGHIQETQYF	TRBV6-3	TRBJ2-5
TGTGCCAGCAGCTTAGCGGGAAAGGACTACTCCTACGAGCAGTACTTC	CASSLAGKDYSYEQYF	TRBV7-2	TRBJ2-7
TGTGCCAGCAGTTTATACCGACAGCAGGCTAACTCTGGAAACACCATATATTTT	CASSLYRQQANSGNTIYF	TRBV28	TRBJ1-3
TGTGCCAGCAGCCCAGCGGGAGGCTACGAGCAGTACTTC	CASSPAGGYEQYF	TRBV7-2	TRBJ2-7
TGTGCCAGCAGCGTAGATCGACTCCCCTACAATGAGCAGTTCTTC	CASSVDRLPYNEQFF	TRBV9	TRBJ2-1
TGTGCCAGCAGCCAACTGATAGTCTATACAAAAGAGACCCAGTACTTC	CASSQLIVYTKETQYF	TRBV3-1	TRBJ2-5
TGTGCCAGCATGGGGGGGGATTCACCCCTCCACTTT	CASMGGDSPLHF	TRBV6-8	TRBJ1-6
TGTGCCAGCAGGAACCCCCAACCCGGCAGGGGGCGCCATGAAAAACTGTTTTTT	CASRNPQPGRGRHEKLFF	TRBV28	TRBJ1-4
TGTGCCAGCAGCTTAGGAAATGACGCTCGTTGGGTCTCCTACAATGAGCAGTTCTTC	CASSLGNDARWVSYNEQFF	TRBV11-3	TRBJ2-1
TGTGCCAGCAGCGTAGACAGGGCCACAACGCCGCAGTTCTTC	CASSVDRATTPQFF	TRBV9	TRBJ2-1
TGTGCCTGGAGTGTGACAGGACACACTGAAGCTTTCTTT	CAWSVTGHTEAFF	TRBV30	TRBJ1-1
TGCGCCAGCAGGGACTCCTACGAGCAGTACTTC	CASRDSYEQYF	TRBV5-1	TRBJ2-7
TGCGCCAGCATCCAGGGGGCTGCACCCCTCCACTTT	CASIQGAAPLHF	TRBV10-1	TRBJ1-6
TGTGCCAGCAGCTATACCGAGTTCGTGCGCTACAATGAGCAGTTCTTC	CASSYTEFVRYNEQFF	TRBV13	TRBJ2-1
TGTGCCAGCAGCTTAGTATCAGGGTATGAAGCTTTCTTT	CASSLVSGYEAFF	TRBV13	TRBJ1-1
TGCAGTGCTAGAGATCCCACGGCAGATGCCAGCTCCTACAATGAGCAGTTCTTC	CSARDPTADASSYNEQFF	TRBV20-1	TRBJ2-1
TGCAGCGTTGCTACAGGGGGCCCTCTGAACACTGAAGCTTTCTTT	CSVATGGPLNTEAFF	TRBV29-1	TRBJ1-1
TGTGCCAGCAGTGAAGCGGCTCCTATAGGGGCGGTCCTTGGCTACACCTTC	CASSEAAPIGAVLGYTF	TRBV6-1	TRBJ1-2
TGTGCCAGCAGCTTGGGGAGACTAGCGGGAGGGCGGAAGAACGAGCAGTACTTC	CASSLGRLAGGRKNEQYF	TRBV5-4	TRBJ2-7
TGCAGTGCTGTAGCGGGAGTCAATGAGCAGTTCTTC	CSAVAGVNEQFF	TRBV20-1	TRBJ2-1
TGTGCCAGTAGTAGCACGACTAGCGGGGGGGAAGAGACCCAGTACTTC	CASSSTTSGGEETQYF	TRBV19	TRBJ2-5
TGTGCCAGCAGCGAACCACTAGCGGGAGGAGGTGAAGCTTTCTTT	CASSEPLAGGGEAFF	TRBV13	TRBJ1-1
TGCGCCAGCAGCTTGCCGGACAGGCGGTCTTATGGCTACACCTTC	CASSLPDRRSYGYTF	TRBV5-1	TRBJ1-2
TGCAGCGACGGGGTGACCAATGAAAAACTGTTTTTT	CSDGVTNEKLFF	TRBV29-1	TRBJ1-4
TGTGCCAGCAGCGGCCCCGGTTGGAGGCGTCGCAATCAGCCCCAGCATTTT	CASSGPGWRRRNQPQHF	TRBV13	TRBJ1-5
TGTGCCAGCAGCCAAGAACCCGGGACGGATAGCAATCAGCCCCAGCATTTT	CASSQEPGTDSNQPQHF	TRBV3-1	TRBJ1-5
TGCGCCAGCGGTGAAACAGGGGGCTTCCGGATTAATGAAAAACTGTTTTTT	CASGETGGFRINEKLFF	TRBV4-1	TRBJ1-4
TGTGCCACCAGTGTATCCCCCGGGACAGTTAGACTTCAGCCCCAGCATTTT	CATSVSPGTVRLQPQHF	TRBV24-1	TRBJ1-5
TGTGCCAGCTCACCACAAGATGACTATCAATGGGGCTATGGCTACACCTTC	CASSPQDDYQWGYGYTF	TRBV18	TRBJ1-2
TGTGCCAGCAGCTTTTCCGGGGACAGGGAGAAGATCTCTGGGGCCAACGTCCTGACTTTC	CASSFSGDREKISGANVLTF	TRBV7-3	TRBJ2-6
TGTGCCTGGAGAGTCGACAGTCCTGGAAACACCATATATTTT	CAWRVDSPGNTIYF	TRBV30	TRBJ1-3
TGTGCCAGCAGCCAAGAGGGGGGGGGGGGCTACGAGCAGTACTTC	CASSQEGGGGYEQYF	TRBV3-1	TRBJ2-7
TGTGCCAGCAGCCGGCTGGAATATAGCAATCAGCCCCAGCATTTT	CASSRLEYSNQPQHF	TRBV3-1	TRBJ1-5
TGCGCCAGCAGCTTGGCCAGGTCAAGGGGGGAGACCCAGTACTTC	CASSLARSRGETQYF	TRBV5-1	TRBJ2-5
TGTGCCAGCAGTGAGACGGACAGAATGAACACTGAAGCTTTCTTT	CASSETDRMNTEAFF	TRBV6-4	TRBJ1-1
TGTGCCAGCAGCTCGGCCCTACTTGGGGGGGCGGACAGAGCTTTCTTT	CASSSALLGGADRAFF	TRBV13	TRBJ1-1
TGTGCCAGCAGTGAGACTAGCGGACACTCGTTCACAGATACGCAGTATTTT	CASSETSGHSFTDTQYF	TRBV6-5	TRBJ2-3
TGTGCCAGCAGCCCCCGGGGCCGGGCCTACGAGCAGTACTTC	CASSPRGRAYEQYF	TRBV13	TRBJ2-7
TGCGCCAGCAGCCCCCCCGAGTCTAGGGGGCACTACAATGAGCAGTTCTTC	CASSPPESRGHYNEQFF	TRBV5-1	TRBJ2-1
TGTGCCAGCAGGGTCCTAGAAGAGACCCAGTACTTC	CASRVLEETQYF	TRBV5-4	TRBJ2-5
TGTGCCAGCAGGCTCGGTTCCCGGGGGTCCTACGAGCAGTACTTC	CASRLGSRGSYEQYF	TRBV25-1	TRBJ2-7
TGTGCCCCAGCGGGAAGGAACACTGAAGCTTTCTTT	CAPAGRNTEAFF	TRBV7-9	TRBJ1-1
TGCGCCAGCAGTGTAAACACGGGGGCGACTTCCTACGAGCAGTACTTC	CASSVNTGATSYEQYF	TRBV10-1	TRBJ2-7
TGCAGCGTTGAAGTTCTGACAGGCCGGGATTATAGCAATCAGCCCCAGCATTTT	CSVEVLTGRDYSNQPQHF	TRBV29-1	TRBJ1-5
TGTGCCAGCAGCCCGGTACGTACCTTCTTT	CASSPVRTFF	TRBV28	TRBJ1-1
TGCAGCGTCCTACTAGGGGACAATGAGCAGTTCTTC	CSVLLGDNEQFF	TRBV29-1	TRBJ2-1
TGTGCCAGCAGGAACAGGGACCGGAATGAAAAACTGTTTTTT	CASRNRDRNEKLFF	TRBV6-4	TRBJ1-4
TGTGCCAGCAGGGACAGCTACGAGCAGTACTTC	CASRDSYEQYF	TRBV6-4	TRBJ2-7
TGTGCCAGCAGCTCTGACAGGGGGCTAGAACATGGCTACACCTTC	CASSSDRGLEHGYTF	TRBV7-3	TRBJ1-2
TGTGCCAGCAGTGGGAGGGTTGCCTATAGCAATCAGCCCCAGCATTTT	CASSGRVAYSNQPQHF	TRBV6-4	TRBJ1-5
TGTGCCAGCAGCTTTCGGCTCCTATCGGTCTTC	CASSFRLLSVF	TRBV11-3	TRBJ2-1
TGTGCCAGCAGCGGGGCAGGGACCGGGGAGCTGTTTTTT	CASSGAGTGELFF	TRBV7-3	TRBJ2-2
TGCGCCAGCAGTGAGTCGAAGGGGGGCACCGAAGAGCAGTTCTTC	CASSESKGGTEEQFF	TRBV10-2	TRBJ2-1
TGTGCCAGCAGCGTGACAGGTGCGAATACGCAGTATTTT	CASSVTGANTQYF	TRBV7-2	TRBJ2-3
TGTGCCAGCAGTGAATATATGGGGGGGAGGCCGGACACCGGGGAGCTGTTTTTT	CASSEYMGGRPDTGELFF	TRBV25-1	TRBJ2-2
TGTGCCAGCAGTGAATACCCAGGGGATACGCAGTATTTT	CASSEYPGDTQYF	TRBV25-1	TRBJ2-3
TGCGCCAGCACGGGGGGGGCCGCAGCCACAGATACGCAGTATTTT	CASTGGAAATDTQYF	TRBV10-1	TRBJ2-3
TGCAGCGTTGAACCTAAGCGGGGGGATTGGAACACCGGGGAGCTGTTTTTT	CSVEPKRGDWNTGELFF	TRBV29-1	TRBJ2-2
TGCGCCAGCAGCCAGCAGGGCTACGAGCAGTACTTC	CASSQQGYEQYF	TRBV4-1	TRBJ2-7
TGTGCATTCGTGCCGGACAGGGCTCGCAATCAGCCCCAGCATTTT	CAFVPDRARNQPQHF	TRBV9	TRBJ1-5
TGCAGCGTTAGGACAGTTTCAAATGAAAAACTGTTTTTT	CSVRTVSNEKLFF	TRBV29-1	TRBJ1-4
TGTGCCAGCAGTTCCCGGGAGAAGGGCACAGATACGCAGTATTTT	CASSSREKGTDTQYF	TRBV6-2	TRBJ2-3
TGTGCCAGCAGCCCCGGGGCACCCTACTACGAGCAGTACTTC	CASSPGAPYYEQYF	TRBV5-5	TRBJ2-7
TGCGCCAGCAGCTGGACTAGCGGGGGAACGCACACCGGGGAGCTGTTTTTT	CASSWTSGGTHTGELFF	TRBV10-1	TRBJ2-2
TGTGCCAGCAGGACAGCTGGTCAGCCCCAGCATTTT	CASRTAGQPQHF	TRBV6-5	TRBJ1-5
TGTGCCAGCAGGGTTCTAGCGCCAGGATACGAGCAGTACTTC	CASRVLAPGYEQYF	TRBV5-4	TRBJ2-7
TGTGCCAGCACCTTGAGCAGGAGCGAGCAGTACTTC	CASTLSRSEQYF	TRBV5-6	TRBJ2-7
TGTGCCAGCAGGCTTCACAGGGCCTGCCCTGACACAGATACGCAGTATTTT	CASRLHRACPDTDTQYF	TRBV12-3	TRBJ2-3
TGTGCCAGCAGCCAACTAGCGAAAAGGGCTAGCACAGATACGCAGTATTTT	CASSQLAKRASTDTQYF	TRBV14	TRBJ2-3
TGTGCCAGCAGCTTGGAAGCATGTCCCTGCGACAGCCAGTTCACCGGGGAGCTGTTTTTT	CASSLEACPCDSQFTGELFF	TRBV11-2	TRBJ2-2
TGCAGTGCTAGAGGGGCGAATGCAACTAATGAAAAACTGTTTTTT	CSARGANATNEKLFF	TRBV20-1	TRBJ1-4
TGTGCCAGCAGCACGGGACAGGCAATGGAGCCCCAGCATTTT	CASSTGQAMEPQHF	TRBV7-9	TRBJ1-5
TGTGCCAGGTACGCCACCTATGGCTACACCTTC	CARYATYGYTF	TRBV28	TRBJ1-2
TGTGCCAGCAGCTATCGGGAGGTAGGACGCTCTGGAAACACCATATATTTT	CASSYREVGRSGNTIYF	TRBV6-2	TRBJ1-3
TGCAGTGCGCGGGATGGCTACACCTTC	CSARDGYTF	TRBV20-1	TRBJ1-2
TGTGCCAGCAGCGCGGGGGGCCGTCGCTCCTACAATGAGCAGTTCTTC	CASSAGGRRSYNEQFF	TRBV5-6	TRBJ2-1
TGTGCCAGCAGCCCGGTCGTTTGCAGCTACGAGCAGTACTTC	CASSPVVCSYEQYF	TRBV13	TRBJ2-7
TGTGCCATTACTAGGGGGGGCTATGGCTACACCTTC	CAITRGGYGYTF	TRBV10-3	TRBJ1-2
TGCGCCAGCAGTAGAAGGGAGGCTAGTTGTAGCTACGAGCAGTACTTC	CASSRREASCSYEQYF	TRBV10-1	TRBJ2-7
TGTGCCAGCTCAGGGGGCAACTATGGCTACACCTTC	CASSGGNYGYTF	TRBV18	TRBJ1-2
TGTGCCAGACAGGGCTCCCTCAGCAATCAGCCCCAGCATTTT	CARQGSLSNQPQHF	TRBV6-4	TRBJ1-5
TGTGCCAGCAGTGACGACGACAGAGCGAAAAACATTCAGTACTTC	CASSDDDRAKNIQYF	TRBV25-1	TRBJ2-4
TGTGCCAGCAGGTATTTGTGGGACAGCGTTTCCCAGCCCCAGCATTTT	CASRYLWDSVSQPQHF	TRBV6-3	TRBJ1-5
TGCGCCAGCAGTGTCGACGCAGGGGTGAATAATTCACCCCTCCACTTT	CASSVDAGVNNSPLHF	TRBV10-1	TRBJ1-6
TGTGCCACCCACGAAAAGGGCACAGATACGCAGTATTTT	CATHEKGTDTQYF	TRBV19	TRBJ2-3
TGTGCCAGCAGTGAATGGGAAAGGGGGGACACCTTC	CASSEWERGDTF	TRBV25-1	TRBJ1-2
TGTGCCAGCAGTTACTCGGAGCGGGAGCTAAGGACTCGCTCTGGAAACACCATATATTTT	CASSYSERELRTRSGNTIYF	TRBV6-5	TRBJ1-3
TGCGCCAGCACAGGGGGCTCACCCCTCCACTTT	CASTGGSPLHF	TRBV10-2	TRBJ1-6
TGTGCCAGTATTTTGGGGGGGGGGGCGGGGCACACCGGGGAGCTGTTTTTT	CASILGGGAGHTGELFF	TRBV19	TRBJ2-2
TGTGCCAGCAGCCGATCGGTGCTGGGGAACTATGGCTACACCTTC	CASSRSVLGNYGYTF	TRBV7-2	TRBJ1-2
TGCAGTGCTCGACCCGGGTTTAAAACGCATTTT	CSARPGFKTHF	TRBV20-1	TRBJ1-5
TGCGCCAGCTCACAGTACGAGCAGTACTTC	CASSQYEQYF	TRBV5-1	TRBJ2-7
TGTGCCAGCATCAGGGTTTACGGTTACGAGCAGTACTTC	CASIRVYGYEQYF	TRBV6-5	TRBJ2-7
TGTGCCAGCAGCCCCCCATCGTGGGCTAGCTACAATGAGCAGTTCTTC	CASSPPSWASYNEQFF	TRBV7-6	TRBJ2-1
TGCAGTGCTAGAGATAAGGGCTCAGGACCCCAAGAGACCCAGTACTTC	CSARDKGSGPQETQYF	TRBV20-1	TRBJ2-5
TGTGCCAGCAGTCTGGGCCTCTTCCCGGGGGAGCTGTTTTTT	CASSLGLFPGELFF	TRBV27	TRBJ2-2
TGTGCCAGCAGCTTAGTCCATGTTTTTGGCACAGATACGCAGTATTTT	CASSLVHVFGTDTQYF	TRBV11-3	TRBJ2-3
TGTGCCAGCAGCCCCCATACAAATTCAGGGGGCAAAATATACTATGGCTACACCTTC	CASSPHTNSGGKIYYGYTF	TRBV4-2	TRBJ1-2
TGTGCCAGCCGTCCACCGACCCATACAGGGGGCCGCTGGCGGCCTGAAGCTTTCTTT	CASRPPTHTGGRWRPEAFF	TRBV6-1	TRBJ1-1
TGTGCGGGGCTCATGAACACTGAAGCTTTCTTT	CAGLMNTEAFF	TRBV30	TRBJ1-1
TGTGCCAGCAAGCCGGGGGGGGGTAACGAGACCCAGTACTTC	CASKPGGGNETQYF	TRBV6-4	TRBJ2-5
TGTGCCGGAACTGCCTACGAGCAGTACTTC	CAGTAYEQYF	TRBV9	TRBJ2-7
TGTGCCAGCAGCTGCCCGCAGGGGGCTCCGGCGAACACTGAAGCTTTCTTT	CASSCPQGAPANTEAFF	TRBV7-9	TRBJ1-1
TGTGCCAGGGCTGGTCCAGGGAACGAGCCCCAGCATTTT	CARAGPGNEPQHF	TRBV2	TRBJ1-5
TGTGCCAGCAGTAAGGGACAGGACAATGAGCAGTTCTTC	CASSKGQDNEQFF	TRBV27	TRBJ2-1
TGTGCCAGCATAGGGGACACCCGAACGAGGGGGAACACTGAAGCTTTCTTT	CASIGDTRTRGNTEAFF	TRBV28	TRBJ1-1
TGCGCCAGCAGTGAGTCTAAACCGGGGTTGACGGTCAATGAGCAGTTCTTC	CASSESKPGLTVNEQFF	TRBV10-1	TRBJ2-1
TGTGCCAGCAGTTTATTGACAGGGATGAGCACAGATACGCAGTATTTT	CASSLLTGMSTDTQYF	TRBV28	TRBJ2-3
TGTGCCAGCAGCCCCAGGGTTTACTACAATGAGCAGTTCTTC	CASSPRVYYNEQFF	TRBV7-6	TRBJ2-1
TGTGCCAGCAGAGGCTACGAGCAGTACTTC	CASRGYEQYF	TRBV14	TRBJ2-7
TGTGCCTGGAGTGGTTGCGGAGTGAGCACAGATACGCAGTATTTT	CAWSGCGVSTDTQYF	TRBV30	TRBJ2-3
TGTGCCAGTAGGCTCCGGACAGGGGAGTCCCTGAATAGCAATCAGCCCCAGCATTTT	CASRLRTGESLNSNQPQHF	TRBV19	TRBJ1-5
TGTGCCAGCAAAGGACAATGCCCGGGACAGGGGGCTTGGAGCTATGGCTACACCTTC	CASKGQCPGQGAWSYGYTF	TRBV2	TRBJ1-2
TGTGCCAGCAGCCAACTCCTACGCACAGATACGCAGTATTTT	CASSQLLRTDTQYF	TRBV14	TRBJ2-3
TGTGCCAGCAGTTACGTACCCGGACTAGCGGGAGGGGGACTTCAGCCCCAGCATTTT	CASSYVPGLAGGGLQPQHF	TRBV6-3	TRBJ1-5
TGTGCCAGCAGTGTCGACCAGGTGCATAGCAATCAGCCCCAGCATTTT	CASSVDQVHSNQPQHF	TRBV6-1	TRBJ1-5
TGTGCCAGCAGCTTCGGGAGTTGGGACCGTTCCTACGAGCAGTACTTC	CASSFGSWDRSYEQYF	TRBV5-8	TRBJ2-7
TGTGCCACCAGTGATTTCGACGCCTTAGGGTATTCACCCCTCCACTTT	CATSDFDALGYSPLHF	TRBV24-1	TRBJ1-6
TGCGCCAGCAGCTTGGGGCTTTTGCCCCAGCATTTT	CASSLGLLPQHF	TRBV5-1	TRBJ1-5
TGCAGCGTTGAAATCATTAAGGAATGGACAGGGCTCGGCTACACCTTC	CSVEIIKEWTGLGYTF	TRBV29-1	TRBJ1-2
TGCCCCGTTTCAGCAGAAGAGCAGTACTTC	CPVSAEEQYF	TRBV20-1	TRBJ2-7
TGTGCCAGCAGTGATAGGGACAGGGGACGCAACGCACTTGAGCCCCAGCATTTT	CASSDRDRGRNALEPQHF	TRBV6-2	TRBJ1-5
TGCGCCAGCAGCCCAGACAGGGAAGGGGACACTGAAGCTTTCTTT	CASSPDREGDTEAFF	TRBV10-2	TRBJ1-1
TGTGCCAGCCTACGAGGGAGGGTGAACACTGAAGCTTTCTTT	CASLRGRVNTEAFF	TRBV5-6	TRBJ1-1
TGTGCCAGCAGCTTAGACTTCCGGGGGGGGAAAGAGACCCAGTACTTC	CASSLDFRGGKETQYF	TRBV7-9	TRBJ2-5
TGTGCCAGCAGCGTAGCTCCCAGGGAGACTAACTATGGCTACACCTTC	CASSVAPRETNYGYTF	TRBV9	TRBJ1-2
TGTGCCAGCAGTTATCCCCTAGCCTACAATGAGCAGTTCTTC	CASSYPLAYNEQFF	TRBV12-4	TRBJ2-1
TGTGCTATCTCACAGGGATATTATCAGCCCCAGCATTTT	CAISQGYYQPQHF	TRBV12-5	TRBJ1-5
TGCGCCAGCAGCCATCCCAGTAGTAGCGGGAAAGCCTACGAGCAGTACTTC	CASSHPSSSGKAYEQYF	TRBV4-1	TRBJ2-7
TGTGCCAGCAGAAACAGGGCACCGGGCATGAACACTGAAGCTTTCTTT	CASRNRAPGMNTEAFF	TRBV7-9	TRBJ1-1
TGCAGCGTTCACGGCTACACCTTC	CSVHGYTF	TRBV29-1	TRBJ1-2
TGCGCCAGCAGCTTGGCAGTCCCCCGGGACGTGCTCTCTGGGGCCAACGTCCTGACTTTC	CASSLAVPRDVLSGANVLTF	TRBV5-1	TRBJ2-6
TGTGCCAGCAGCCGAAAGGTTGGCTACGAGCAGTACTTC	CASSRKVGYEQYF	TRBV5-4	TRBJ2-7
TGTGCCAGCAGTTTGTGGGGACGGCAGGGAAGATACACCTTC	CASSLWGRQGRYTF	TRBV28	TRBJ1-2
TGCAGCGTCAACCCACAGGGTCCGGCCCAGTACTTC	CSVNPQGPAQYF	TRBV29-1	TRBJ2-5
TGCGCCAGCAGTGGGGACAGGGACGAGTATAGCAATCAGCCCCAGCATTTT	CASSGDRDEYSNQPQHF	TRBV10-1	TRBJ1-5
TGCAGTGCTAGTACGGACGAAGGGGGAGCTTTCTTT	CSASTDEGGAFF	TRBV20-1	TRBJ1-1
TGTGCCACCAGTGATTTGAGCCGTCCGTATTCCAGGGTGGGATCCGATACGCAGTATTTT	CATSDLSRPYSRVGSDTQYF	TRBV24-1	TRBJ2-3
TGCAGTGCCCATAGCCAGGGGCATGGCTACACCTTC	CSAHSQGHGYTF	TRBV20-1	TRBJ1-2
TGTGCCAGCAGCCGCGGGACAGGGATGGGGGCCAACGTCCTGACTTTC	CASSRGTGMGANVLTF	TRBV13	TRBJ2-6
TGTGCCAGCAGCTTAGGTCAGCCGGGACCGGACACTGAAGCTTTCTTT	CASSLGQPGPDTEAFF	TRBV11-2	TRBJ1-1
TGTGCGGGACTAGAGCAGACCCAGTACTTC	CAGLEQTQYF	TRBV30	TRBJ2-5
TGTGCCAGCATTGGTGGAAGGCAGGGAATAAGGATGGCAACTAATGAAAAACTGTTTTTT	CASIGGRQGIRMATNEKLFF	TRBV2	TRBJ1-4
TGTGCCAGCAGTGCCCGGACTAGCGGTCCTCGGGCCTACAATGAGCAGTTCTTC	CASSARTSGPRAYNEQFF	TRBV6-5	TRBJ2-1
TGTGCCAGCAGCGGCGAGCCACGTCAGGAATCTGAAGCTTTCTTT	CASSGEPRQESEAFF	TRBV13	TRBJ1-1
TGTGCCAGCAGTTACTCGGTACGCCTTAGGGATCCTTCACCCCTCCACTTT	CASSYSVRLRDPSPLHF	TRBV6-2	TRBJ1-6
TGTGCCACCAGTGATCCCCCGGGACAGGGAACCAAAAACATTCAGTACTTC	CATSDPPGQGTKNIQYF	TRBV24-1	TRBJ2-4
TGTGCCAGCAGGGCTCGTAGGACGAGCAATCAGCCCCAGCATTTT	CASRARRTSNQPQHF	TRBV14	TRBJ1-5
TGTGCCAGCAGTTACTCGGGTGGGACAGGACGATCCCTCAATCAGCCCCAGCATTTT	CASSYSGGTGRSLNQPQHF	TRBV6-5	TRBJ1-5
TGTGCCAGCAGTTTCGGCCGGTATCCTGAAGCTTTCTTT	CASSFGRYPEAFF	TRBV27	TRBJ1-1
TGCGCCAGCAGTACAGGGCAAGAGACCCAGTACTTC	CASSTGQETQYF	TRBV10-1	TRBJ2-5
TGCGCCAGCAGTTGCCACAAGGACCCCAAAGATACGCAGTATTTT	CASSCHKDPKDTQYF	TRBV10-2	TRBJ2-3
TGTGCCAGCAGTGGTGAAAAAGACAGTGAAGAGACCCAGTACTTC	CASSGEKDSEETQYF	TRBV6-4	TRBJ2-5
TGCAGTGCTAGCGACGATGGGGGGGGAGGCGCAACTAATGAAAAACTGTTTTTT	CSASDDGGGGATNEKLFF	TRBV20-1	TRBJ1-4
TGTGCCAGCAGCGGCTCCGGCCTTACAGGGGAGGGGTATGGCTACACCTTC	CASSGSGLTGEGYGYTF	TRBV5-5	TRBJ1-2
TGTGCCAGCAGCAACCGGGGGAGGTCAGGGAAAGCAGGAAATCAGCCCCAGCATTTT	CASSNRGRSGKAGNQPQHF	TRBV13	TRBJ1-5
TGCGCCAGCTCCTTGGGACAGGGGGGGGGGATCACTGAAGCTTTCTTT	CASSLGQGGGITEAFF	TRBV10-1	TRBJ1-1
TGTGCCAAGGAGCCGGGACTAGCGGGAGAGGCGAACGAGCAGTACTTC	CAKEPGLAGEANEQYF	TRBV9	TRBJ2-7
TGTGCCAGCAGCCAAGAAAGGGGGCCTGGGGTCGTAGAGACCCAGTACTTC	CASSQERGPGVVETQYF	TRBV3-1	TRBJ2-5
TGCAGTGCTAGAGTCCTAGCCCCAGGGGGCGGGAACACTGAAGCTTTCTTT	CSARVLAPGGGNTEAFF	TRBV20-1	TRBJ1-1
TGTGCCAGCAGTTACTTTCTCCGGGACAAGGCAGATACGCAGTATTTT	CASSYFLRDKADTQYF	TRBV6-5	TRBJ2-3
TGTGCCATCAGCATACCCAGGGGTGGCTTTTCCTACGAGCAGTACTTC	CAISIPRGGFSYEQYF	TRBV10-3	TRBJ2-7
TGTGCCAGGGGCGGGAGATCTGACGAAGACACTGAAGCTTTCTTT	CARGGRSDEDTEAFF	TRBV6-1	TRBJ1-1
TGTGCCAGCAGTAGGGGGGGATGGGACGAGCAGTACTTC	CASSRGGWDEQYF	TRBV6-5	TRBJ2-7
TGTGCCAGCACGGGGGGGCCGTACAATGAGCAGTTCTTC	CASTGGPYNEQFF	TRBV6-6	TRBJ2-1
TGTGCCAGCAGCTTGGGAGCGGCAGACTACGAGCAGTACTTC	CASSLGAADYEQYF	TRBV5-4	TRBJ2-7
TGCGCCAGCCCCCCACCCGGGACAGGGGATTACACCGGGGAGCTGTTTTTT	CASPPPGTGDYTGELFF	TRBV5-1	TRBJ2-2
TGTGCCAGCAACACGACAGGGAACAGCAATCAGCCCCAGCATTTT	CASNTTGNSNQPQHF	TRBV5-4	TRBJ1-5
TGCGCCAGCAGCTTGTCCGCGGGAGTCACAGCGGAGCAGTACTTC	CASSLSAGVTAEQYF	TRBV5-1	TRBJ2-7
TGTGCCACATTCACTCAGAAGACCTACGAGCAGTACTTC	CATFTQKTYEQYF	TRBV24-1	TRBJ2-7
TGCGCCAGCAGCCGGGGGGGGCGGGAGCAGTTCTTC	CASSRGGREQFF	TRBV4-1	TRBJ2-1
TGCGCCAGCAGTGATAACAGGGGGCGGTTATTCCCCTTCGATGGCTACACCTTC	CASSDNRGRLFPFDGYTF	TRBV10-1	TRBJ1-2
TGTGCCAGCAGAGGTGGGAGGTTAAAGGATGAGCAGTTCTTC	CASRGGRLKDEQFF	TRBV6-3	TRBJ2-1
TGTGCCAGCAGCTCCCTCCAGACTAGAGAGACCCAGTACTTC	CASSSLQTRETQYF	TRBV11-2	TRBJ2-5
TGTGCCAGCAGTTTAACCCCCAGGGGTGCCTACGAGCAGTACTTC	CASSLTPRGAYEQYF	TRBV12-4	TRBJ2-7
TGTGCTAGTGCACCGGGACTAGCGGGTTTTTATTTCTTC	CASAPGLAGFYFF	TRBV12-5	TRBJ2-1
TGCAGTGCTTCCGATGAACGGTATAGCAATCAGCCCCAGCATTTT	CSASDERYSNQPQHF	TRBV20-1	TRBJ1-5
TGTGCCAGTGGGACTAGACTAGAGACCCAGTACTTC	CASGTRLETQYF	TRBV19	TRBJ2-5
TGCAGCCACAGAGCGGGTTTTCCCGCTTTCTTT	CSHRAGFPAFF	TRBV29-1	TRBJ1-1
TGCAGTGCTAGATTTCCAAGGGGACAGGGGGCGCCAGAAGCTTTCTTT	CSARFPRGQGAPEAFF	TRBV20-1	TRBJ1-1
TGTGCCAGCATTGGACTGACCAGACTTCGAGGGTCCTATAATTCACCCCTCCACTTT	CASIGLTRLRGSYNSPLHF	TRBV5-5	TRBJ1-6
TGTGCCAGCAGCTTAGATACGACAGGTCAGCCCCAGCATTTT	CASSLDTTGQPQHF	TRBV7-8	TRBJ1-5
TGTGCCAGCAGCTTACCCACTCCCGGGCTTGCCTACGAGCAGTACTTC	CASSLPTPGLAYEQYF	TRBV7-3	TRBJ2-7
TGCAGTGCTAGAGCTCCCTCGGGGTACTCTGGAAACACCATATATTTT	CSARAPSGYSGNTIYF	TRBV20-1	TRBJ1-3
TGTGCCAGCAGCGTCAGACAGGGGTCTCTGCAAGCTTTCTTT	CASSVRQGSLQAFF	TRBV7-2	TRBJ1-1
TGTGCCAGCAGCACCCCTCACAGGGGGCAGATCCGGGTAAGCTCCTACGAGCAGTACTTC	CASSTPHRGQIRVSSYEQYF	TRBV11-3	TRBJ2-7
TGCAGTGCTAGAGAATCTGGGATTAGGGCTAGCGGCGGGGAGACCCAGTACTTC	CSARESGIRASGGETQYF	TRBV20-1	TRBJ2-5
TGTGCCAGCCCCACCGGGGGAAACACCATATATTTT	CASPTGGNTIYF	TRBV6-4	TRBJ1-3
TGTGCCAGCAGCGTGTCTGGTGAGCAGTTCTTC	CASSVSGEQFF	TRBV13	TRBJ2-1
TGTGCCAGCAGCCCTTCGGGAGCGCGCACCTACAATGAGCAGTTCTTC	CASSPSGARTYNEQFF	TRBV14	TRBJ2-1
TGTGCCAGCAGAACTGGGGGACTAGCGGGAGATCGGGAGCTGTTTTTT	CASRTGGLAGDRELFF	TRBV9	TRBJ2-2
TGTGCCAGCAGCCGCAGGGACGGGGCCTGGGAGCAGTACTTC	CASSRRDGAWEQYF	TRBV7-3	TRBJ2-7
TGCAGTGCCCTCGAGGGGTGGAGACGGGCAGATACGCAGTATTTT	CSALEGWRRADTQYF	TRBV20-1	TRBJ2-3
TGTGCCAGTAACTGTATGGGACGGGATTCACCCCTCCACTTT	CASNCMGRDSPLHF	TRBV19	TRBJ1-6
TGTGCCAGCAGCGAGTCCTCTATCCGGGACGGGGACGAGCAGTACTTC	CASSESSIRDGDEQYF	TRBV5-4	TRBJ2-7
TGTGCCAGCAGGGACCTCGGGGGCTACACCTTC	CASRDLGGYTF	TRBV6-2	TRBJ1-2
TGTGCCAGCAGCTTCCCGTCAGGGCAAGAGACCCAGTACTTC	CASSFPSGQETQYF	TRBV5-4	TRBJ2-5
TGTGCCAGCAGCCAAGCGCCGGGACAGGGGGCTAGGCGGAGAACAACTAATGAAAAACTGTTTTTT	CASSQAPGQGARRRTTNEKLFF	TRBV3-1	TRBJ1-4
TGCGCCAGCAGCCAAGCCGGGTCATTGTACGAGCAGTACTTC	CASSQAGSLYEQYF	TRBV4-1	TRBJ2-7
TGTGCCAGCAGTGACCACGCAGGGGGGCAGCCCCAGCATTTT	CASSDHAGGQPQHF	TRBV6-4	TRBJ1-5
TGTGCCAGCAGCCAAGACACTAGCGGGGGGGCCGGGAACTACGAGCAGTACTTC	CASSQDTSGGAGNYEQYF	TRBV3-1	TRBJ2-7
TGTGCCAGCTCACTAGACTGGGGAAACACCATATATTTT	CASSLDWGNTIYF	TRBV18	TRBJ1-3
TGTGCCTGGAGTGTTCCTTATGTATATGGCTACACCTTC	CAWSVPYVYGYTF	TRBV30	TRBJ1-2
TGTGCCAGCAGCAGGCAGTCTGGCTACACCTTC	CASSRQSGYTF	TRBV11-3	TRBJ1-2
TGTGCCAGCAGCGCCCGACAGGTAAATCAGCCCCAGCATTTT	CASSARQVNQPQHF	TRBV7-9	TRBJ1-5
TGTGCCAGCAGCGTACCCGCCGGGACAGGGGCTGGCTATGGCTACACCTTC	CASSVPAGTGAGYGYTF	TRBV9	TRBJ1-2
TGTGCCCAAGGGAGGGCGGACTACGAGCAGTACTTC	CAQGRADYEQYF	TRBV5-4	TRBJ2-7
TGTGCCAGCAGTGAGGCGGGGGGGGTCCGGACAGATACGCAGTATTTT	CASSEAGGVRTDTQYF	TRBV6-4	TRBJ2-3
TGTGCCAGCAGAAGGCCTAGGTACAATGAGCAGTTCTTC	CASRRPRYNEQFF	TRBV11-2	TRBJ2-1
TGCAGTGCCAAGCCTCGGAAGGCGACAGGGTCCGGCTACGAGCAGTACTTC	CSAKPRKATGSGYEQYF	TRBV20-1	TRBJ2-7
TGCGCCAGCAGCCAAGAGGTGCGGGAGCGTCCTAATTCACCCCTCCACTTT	CASSQEVRERPNSPLHF	TRBV4-1	TRBJ1-6
TGCGCCAGCAGCCAAGATTTCCCCGGGACTAGCGACGATAACAATGAGCAGTTCTTC	CASSQDFPGTSDDNNEQFF	TRBV4-3	TRBJ2-1
TGTGCCAGCAGCCAAGATGACCGGGACAGGCTCAGGACCGGGGAGCTGTTTTTT	CASSQDDRDRLRTGELFF	TRBV3-1	TRBJ2-2
TGTGCCACCAAGTCCTGGCAGCCACGCTCCTACAATGAGCAGTTCTTC	CATKSWQPRSYNEQFF	TRBV24-1	TRBJ2-1
TGTGCCAGGACCCTCGGCTACACCTTC	CARTLGYTF	TRBV3-1	TRBJ1-2
TGTGCCACCGGACAGGGGGCTTCGTATAGCAATCAGCCCCAGCATTTT	CATGQGASYSNQPQHF	TRBV24-1	TRBJ1-5
TGTGCCAGCAGCCGGGGGGGGAACACTGAAGCTTTCTTT	CASSRGGNTEAFF	TRBV7-3	TRBJ1-1
TGCAGCGTTGCCCGGCGCCGAGACAACACTGAAGCTTTCTTT	CSVARRRDNTEAFF	TRBV29-1	TRBJ1-1
TGCAGTGCTAGAGTTCGGACAGGGAATGAAAAACTGTTTTTT	CSARVRTGNEKLFF	TRBV20-1	TRBJ1-4
TGTGCCAGCAGGGATCCAGACAGAAGTAAAACTGAAGCTTTCTTT	CASRDPDRSKTEAFF	TRBV18	TRBJ1-1
TGTGCCAGCAGTTCGCCCCCCCCAGGGACTTCTGGGGCCAACGTCCTGACTTTC	CASSSPPPGTSGANVLTF	TRBV6-8	TRBJ2-6
TGTGCCAGCAGCATGAGCAGACAGGGCCTTACCTACGAGCAGTACTTC	CASSMSRQGLTYEQYF	TRBV11-3	TRBJ2-7
TGTGCCAGCAGTTACCTTCCACTAGCGGGAGCCTGTTGCTATGGCTACACCTTC	CASSYLPLAGACCYGYTF	TRBV6-6	TRBJ1-2
TGCGCCAGCAGCTGGATTCTCAACCCATCGCATGAGCAGTTCTTC	CASSWILNPSHEQFF	TRBV5-1	TRBJ2-1
TGTGCCAGCAGCAACAGGGTGAACACTGAAGCTTTCTTT	CASSNRVNTEAFF	TRBV7-4	TRBJ1-1
TGTGCTAGCAGCTTAGGCGGCAAAGAAACAGGGTACCTTCAGGAGACCCAGTACTTC	CASSLGGKETGYLQETQYF	TRBV7-7	TRBJ2-5
TGTGCCAGCAGCTTATTCCCACCTCCCAGGGAGGGGGCAGAACTGTTTTTT	CASSLFPPPREGAELFF	TRBV7-2	TRBJ1-4
TGCGCCAGCAGCCCCCACTCGGCAGGGGAGACCCAGTACTTC	CASSPHSAGETQYF	TRBV4-1	TRBJ2-5
TGTGCCAGCAGGGACCTTAGAGGACTCCTCTATGGCTACACCTTC	CASRDLRGLLYGYTF	TRBV6-8	TRBJ1-2
TGTGCCAGCAGCGGGGGGGAGAATATTCAGGGGGAAGCTTATGAAGCTTTCTTT	CASSGGENIQGEAYEAFF	TRBV11-3	TRBJ1-1
TGTGCCAGCTCACCAAAGGAATTCCTAGCCTACAATGAGCAGTTCTTC	CASSPKEFLAYNEQFF	TRBV18	TRBJ2-1
TGTGCCAGTAGTATTTTTCGGCCTCCACACACAGATACGCAGTATTTT	CASSIFRPPHTDTQYF	TRBV19	TRBJ2-3
TGTGCCAGCATGAGTCCGGGAGACTGCGACAACTACGAGCAGTACTTC	CASMSPGDCDNYEQYF	TRBV6-4	TRBJ2-7
TGTGCCAGCAGCCAAGATGGGTATACCCCTCTAAGCGGGAGGTTACTCCTCAGTAATGAAAAACTGTTTTTT	CASSQDGYTPLSGRLLLSNEKLFF	TRBV4-2	TRBJ1-4
TGTGCCAGCAGCCACCGGCGGACGGCCGAGCAGTACTTC	CASSHRRTAEQYF	TRBV7-3	TRBJ2-7
TGTGCCAGCAGACTGGGGGGTCAGCCCCAGCATTTT	CASRLGGQPQHF	TRBV28	TRBJ1-5
TGTGCCAGCAGCTTTCCCCAGACAGGGTTCCAAGAGACCCAGTACTTC	CASSFPQTGFQETQYF	TRBV5-6	TRBJ2-5
TGTGCCAGCAGCCTGGAGTCACACCGGGGGAATGGCTACACCTTC	CASSLESHRGNGYTF	TRBV7-6	TRBJ1-2
TGCAGTGCTAGAGATCAGTATGAAGCTTTCTTT	CSARDQYEAFF	TRBV20-1	TRBJ1-1
TGTGCCAGCAGCCCCCTAACGACAGCCATACTTCGCAATCAGCCCCAGCATTTT	CASSPLTTAILRNQPQHF	TRBV13	TRBJ1-5
TGCGCCAGCAGTGAGCTAGATCCTAGTCAGGCCGAGCAGTACTTC	CASSELDPSQAEQYF	TRBV10-2	TRBJ2-7
TGTGCCAGCCGACAGGGCGAGCAGTACTTC	CASRQGEQYF	TRBV7-6	TRBJ2-7
TGTGCCACCAGGAAAAAACATGACGCGACAAATGAAAAACTGTTTTTT	CATRKKHDATNEKLFF	TRBV6-1	TRBJ1-4
TGTGCCAGCAGTGCGCACGGGGGTCCTAACTATGGCTACACCTTC	CASSAHGGPNYGYTF	TRBV6-1	TRBJ1-2
TGTGCCAGCAGCAAACTGGAGATAGGGAACACTGAAGCTTTCTTT	CASSKLEIGNTEAFF	TRBV16	TRBJ1-1
TGCAGTGCTAGCGAACCTATATACACCGGGGAGCTGTTTTTT	CSASEPIYTGELFF	TRBV20-1	TRBJ2-2
TGTGCCAGCAGCGTTCTGGGTTCACCGGGACAGGGCACCGGGGCGGATCACTCCTACAATGAGCAGTTCTTC	CASSVLGSPGQGTGADHSYNEQFF	TRBV9	TRBJ2-1
TGTGCCAGCAGCAACATTCATGAGGAGGAGGGGGAGCAGTTCTTC	CASSNIHEEEGEQFF	TRBV5-6	TRBJ2-1
TGTGCCAGCAGCTTGGGCTTTCTAGCGGGGTACAATGAGCAGTTCTTC	CASSLGFLAGYNEQFF	TRBV5-6	TRBJ2-1
TGTGCCAGCAGCAGGAAAGCCTACGAGCAGTACTTC	CASSRKAYEQYF	TRBV12-4	TRBJ2-7
TGTGCCAGCAGTACCGGGACCGCCAATGAAAAACTGTTTTTT	CASSTGTANEKLFF	TRBV6-5	TRBJ1-4
TGTGCCAGCAGCTTCCTTGATAAAGCGGGACCTGACGAGGGGGGCTACGAGCAGTACTTC	CASSFLDKAGPDEGGYEQYF	TRBV11-2	TRBJ2-7
TGTGCCAGCTCTATGGACAGGGGGAATCATCAGCCCCAGCATTTT	CASSMDRGNHQPQHF	TRBV2	TRBJ1-5
TGTGCCAAATCAGGGGAAGCTAACTATGGCTACACCTTC	CAKSGEANYGYTF	TRBV6-1	TRBJ1-2
TGTGCCAGCAGCTTCATATCGGACCCAGGGGCCCCCTTCTCCTACAATGAGCAGTTCTTC	CASSFISDPGAPFSYNEQFF	TRBV11-2	TRBJ2-1
TGTGCCAGCAGTTTAGGACAGCAGCCCCAGCATTTT	CASSLGQQPQHF	TRBV6-2	TRBJ1-5
TGTGCCAGCAGTAGACCCTCCCGTGGGGGCGGGGACTACGAGCAGTACTTC	CASSRPSRGGGDYEQYF	TRBV2	TRBJ2-7
TGTGCCAGCAGGCAATATGAGCAGTTCTTC	CASRQYEQFF	TRBV6-2	TRBJ2-1
TGTGCCAGCAGCTGGGGGTGGGACTACAATGAGCAGTTCTTC	CASSWGWDYNEQFF	TRBV7-6	TRBJ2-1
TGTGCCAGCAGTTACTCTGCCCCAAATCAGGACGGGAATTCACCCCTCCACTTT	CASSYSAPNQDGNSPLHF	TRBV6-3	TRBJ1-6
TGCGCCAGCAGCTTGGGAGCCCAGGGGAGATCAGGAAATTCACCCCTCCACTTT	CASSLGAQGRSGNSPLHF	TRBV5-1	TRBJ1-6
TGTGCCAGTAGGAGCTCGCTGTGGGACAATGAGCAGTTCTTC	CASRSSLWDNEQFF	TRBV19	TRBJ2-1
TGCGCCAGCAGAGTTCGGCCCCCTAGCCCTACCACCGGGGAGCTGTTTTTT	CASRVRPPSPTTGELFF	TRBV10-1	TRBJ2-2
TGTGCCTGGCAGAAATCCGGGACATCCGCGGGAGATACGCAGTATTTT	CAWQKSGTSAGDTQYF	TRBV30	TRBJ2-3
TGCAGTGCTAGACGCGGTTGGGATCAGCCCCAGCATTTT	CSARRGWDQPQHF	TRBV20-1	TRBJ1-5
TGTGCCAGTAGTATAGGGGGGGGGCCCCTAGGGGAGCTGTTTTTT	CASSIGGGPLGELFF	TRBV19	TRBJ2-2
TGTGCCTGGAGGCCGGGAGGCTACGAGCAGTACTTC	CAWRPGGYEQYF	TRBV30	TRBJ2-7
TGTGCCTGGAGTGTAACCGACAGTTCAGAGACCCAGTACTTC	CAWSVTDSSETQYF	TRBV30	TRBJ2-5
TGTGCCAGCAGTGACGACAGGGGGGGGGGTACCGGGGAGCTGTTTTTT	CASSDDRGGGTGELFF	TRBV6-4	TRBJ2-2
TGTGCCAGCAGCTACACCTTTGGTCGGGGGGATAGCAATCAGCCCCAGCATTTT	CASSYTFGRGDSNQPQHF	TRBV7-8	TRBJ1-5
TGTGCCAGCAGCCCTAAGGGGGATACGCAGTATTTT	CASSPKGDTQYF	TRBV6-4	TRBJ2-3
TGTGCCAGCAGCCGCACGATTGAACAGGACTCTGGAAACACCATATATTTT	CASSRTIEQDSGNTIYF	TRBV6-4	TRBJ1-3
TGCAGTGCGGGGGACAGGGGATCCTACGAGCAGTACTTC	CSAGDRGSYEQYF	TRBV20-1	TRBJ2-7
TGCAGTGCTAGAACTACATGCAGGCGGGGAAGCTCCTACGAGCAGTACTTC	CSARTTCRRGSSYEQYF	TRBV20-1	TRBJ2-7
TGTGCCAGCAGCGGACTGTATGCCGGGGAGCTGTTTTTT	CASSGLYAGELFF	TRBV7-9	TRBJ2-2
TGTGCCAGCAGCGGCAATCTAGCGGGTGAGCAGTTCTTC	CASSGNLAGEQFF	TRBV2	TRBJ2-1
TGTGCCAGCAGCAGAGCGCGGAGCCGGAGGGGCTATGGCTACACCTTC	CASSRARSRRGYGYTF	TRBV3-1	TRBJ1-2
TGCGCCAGCAGCCGGCTAACTCTCGACAAGTCCTACGAGCAGTACTTC	CASSRLTLDKSYEQYF	TRBV4-1	TRBJ2-7
TGTGCCAGCAGCTTTCCCGGGCCCCGCCATGAGCAGTTCTTC	CASSFPGPRHEQFF	TRBV5-8	TRBJ2-1
TGTGCCACCAGTGATTTGCTAAACCAACAGGGCCCCTTTTATAGCAATCAGCCCCAGCATTTT	CATSDLLNQQGPFYSNQPQHF	TRBV24-1	TRBJ1-5
TGTGCCACAGAAACCCCGGGACAGGGGGGAGCCGGGGAGCTGTTTTTT	CATETPGQGGAGELFF	TRBV24-1	TRBJ2-2
TGTGCCAGCAGGACAGGCTCTGGAAACACCATATATTTT	CASRTGSGNTIYF	TRBV14	TRBJ1-3
TGTGCCAGTCTAATCGGTAGCTTTGAGCAGTTCTTC	CASLIGSFEQFF	TRBV6-6	TRBJ2-1
TGCGCCAGCCAAGGCGGGAGAGACGCCTACGAGCAGTACTTC	CASQGGRDAYEQYF	TRBV10-1	TRBJ2-7
TGTGCCAGCAGCTTATCACACCTACAGGGGCTCTACGAGCAGTACTTC	CASSLSHLQGLYEQYF	TRBV7-9	TRBJ2-7
TGCAGCGTTGAAAGACAGGATAGCAATCAGCCCCAGCATTTT	CSVERQDSNQPQHF	TRBV29-1	TRBJ1-5
TGTGCCAGTAGTCACGAGGGGTTTGCAGTCATGAACACTGAAGCTTTCTTT	CASSHEGFAVMNTEAFF	TRBV19	TRBJ1-1
TGTGCCAGCAGCTTAGTATCACCCCCCCGTTGGTATGCCCTGGGGGCAAGGAAAAACATTCAGTACTTC	CASSLVSPPRWYALGARKNIQYF	TRBV11-2	TRBJ2-4
TGTGCCACCAGTGATAGCCGGGACAGTCCAGACCAAGAGACCCAGTACTTC	CATSDSRDSPDQETQYF	TRBV24-1	TRBJ2-5
TGTGCCAGCAGTTCGTCCCCTGATCAGGTTGCCTCTGGGGCCAACGTCCTGACTTTC	CASSSSPDQVASGANVLTF	TRBV6-5	TRBJ2-6
TGTGCCAGCAGCGAGGTAGCCGGACAGAGGATACCGGCTAACTATGGCTACACCTTC	CASSEVAGQRIPANYGYTF	TRBV9	TRBJ1-2
TGTGCCAGCAGCTTAAAGGGAATCGCGGACGAGCAGTACTTC	CASSLKGIADEQYF	TRBV11-2	TRBJ2-7
TGTGCCAGCAGCCTTTGCGGGAGGCTCAATCAGCCCCAGCATTTT	CASSLCGRLNQPQHF	TRBV3-1	TRBJ1-5
TGCAGTGCTAGTGGCCAAGCAAGGGGGGGGTACGAGCAGTACTTC	CSASGQARGGYEQYF	TRBV20-1	TRBJ2-7
TGCGCCAGCAGGACTAGCGGGGGGGCCTACAATGAGCAGTTCTTC	CASRTSGGAYNEQFF	TRBV10-1	TRBJ2-1
TGTGCCAGCAGGGGGTGTTGCTACACCTTC	CASRGCCYTF	TRBV25-1	TRBJ1-2
TGTGCCAGCAGCCCAAGGGCAGGGACTAGCGGGCTTTCCACAGATACGCAGTATTTT	CASSPRAGTSGLSTDTQYF	TRBV14	TRBJ2-3
TGTGCCAGCAGCCAATCGGGACAGTCTAGCTACGAGCAGTACTTC	CASSQSGQSSYEQYF	TRBV3-1	TRBJ2-7
TGTGCCAGCAGCGAACCGACGGTTAAAAACTATGGCTACACCTTC	CASSEPTVKNYGYTF	TRBV4-2	TRBJ1-2
TGTGCCAGCAATCGGGACAAACCCGATTACGAGCAGTACTTC	CASNRDKPDYEQYF	TRBV6-1	TRBJ2-7
TGTGCCAGCTCACCTCCCCTATGTCAGCCCCAGCATTTT	CASSPPLCQPQHF	TRBV18	TRBJ1-5
TGTGCCAGCAGTCCCCAACCTAGGGAGGATGAGCAGTTCTTC	CASSPQPREDEQFF	TRBV6-1	TRBJ2-1
TGTGCCAGCAGCCAAGAGATCCCCTATGGGCAGTTTTACTTC	CASSQEIPYGQFYF	TRBV3-1	TRBJ2-4
TGTGCCAGCAGCCAAGAGTGGGACAGAGGGAACACCGGGGAGCTGTTTTTT	CASSQEWDRGNTGELFF	TRBV14	TRBJ2-2
TGTGCCAGCAGCTTAAGGAAAGGACAGGGGACTGGAAACACCATATATTTT	CASSLRKGQGTGNTIYF	TRBV11-2	TRBJ1-3
TGCAGTGCTCCTACGCGGCCACGCGAAGAGACCCAGTACTTC	CSAPTRPREETQYF	TRBV20-1	TRBJ2-5
TGTGCCACCTCCCAAGACAGGGGGCCTAATGAAAAACTGTTTTTT	CATSQDRGPNEKLFF	TRBV24-1	TRBJ1-4
TGTGCCAGCAGCATCCACAGGGAGAAAGTAAGCTCCTACGAGCAGTACTTC	CASSIHREKVSSYEQYF	TRBV11-2	TRBJ2-7
TGCAGTGCTAGAGATCCCGACAGGCGACGCTCTGGGGCCAACGTCCTGACTTTC	CSARDPDRRRSGANVLTF	TRBV20-1	TRBJ2-6
TGTGCCAGCTCACTTATGTCCGGGACTAGCGGGGGCCCGAATGAGCAGTTCTTC	CASSLMSGTSGGPNEQFF	TRBV18	TRBJ2-1
TGTGCCAGCAGTATATCCTACGGGGTCTCTGGGGCCAACGTCCTGACTTTC	CASSISYGVSGANVLTF	TRBV27	TRBJ2-6
TGTGCCAGCAGCCAAGACAAACCAGGGACAGGTTATGGCTACACCTTC	CASSQDKPGTGYGYTF	TRBV14	TRBJ1-2
TGTGCCAGCTCAGTGAGGGGTACAATGTACTACAATGAGCAGTTCTTC	CASSVRGTMYYNEQFF	TRBV18	TRBJ2-1
TGTGCCAGCAGAATCCTCCGGACAGGGACCAATGAGCAGTTCTTC	CASRILRTGTNEQFF	TRBV27	TRBJ2-1
TGTGCCAGCAGTGACTCTAAGAGGGGAATGCCGGTTCAGCCCCAGCATTTT	CASSDSKRGMPVQPQHF	TRBV6-4	TRBJ1-5
TGTGCCAGCAGCCAACACAGGAAAGAGTACTTC	CASSQHRKEYF	TRBV4-2	TRBJ2-7
TGTGCCACCAGCAGAGAAACCAGGGTCCGGGGATTCTTAGGGGAAAAACTGTTTTTT	CATSRETRVRGFLGEKLFF	TRBV15	TRBJ1-4
TGTGCCATCACTGAAGCCAGCCGGCCCCAGCATTTT	CAITEASRPQHF	TRBV10-3	TRBJ1-5
TGTGCCTGGACGTCCGGGACAGGGGGGTACAATGAGCAGTTCTTC	CAWTSGTGGYNEQFF	TRBV30	TRBJ2-1
TGTGCCAGCAGGAGGCGGATTACGGAGCTGTTTTTT	CASRRRITELFF	TRBV7-3	TRBJ2-2
TGTGCCAGCTCACAGAGTCAGCCTCCCTCTGAAGCTTTCTTT	CASSQSQPPSEAFF	TRBV18	TRBJ1-1
TGTGCCAGCAGCTTCCTCACCAAACAGGGGGGGGACCCCTGCAATCAGCCCCAGCATTTT	CASSFLTKQGGDPCNQPQHF	TRBV7-8	TRBJ1-5
TGTGCCAGCAGTCCTCCGGGACAGGGACATCAGCCCCAGCATTTT	CASSPPGQGHQPQHF	TRBV6-1	TRBJ1-5
TGCAGTCTATCCCCAGGACGTACCGTTTTGTGCTCGGTCCAAGAGACCCAGTACTTC	CSLSPGRTVLCSVQETQYF	TRBV20-1	TRBJ2-5
TGTGCCAGCAGCCCCCACTGGGGCTATGGCTACACCTTC	CASSPHWGYGYTF	TRBV7-2	TRBJ1-2
TGCGCCAGCCCGGGGGGCGCCTACGAGCAGTACTTC	CASPGGAYEQYF	TRBV10-1	TRBJ2-7
TGTGCCAGCAGTGCAAGGGGAGTTAATCAGCCCCAGCATTTT	CASSARGVNQPQHF	TRBV28	TRBJ1-5
TGTGCCAGCAGCCTAACAATTGAGCAGTTCTTC	CASSLTIEQFF	TRBV6-5	TRBJ2-1
TGTGCCACCAGTGAGTACGACGGGAGTCTCTACGAGCAGTACTTC	CATSEYDGSLYEQYF	TRBV24-1	TRBJ2-7
TGTGCCAGCAGCTTGGGACAGCCGAGCTCTGGAAACACCATATATTTT	CASSLGQPSSGNTIYF	TRBV7-9	TRBJ1-3
TGCAGTGCGGTGAGGTTTTACACCGGGGAGCTGTTTTTT	CSAVRFYTGELFF	TRBV20-1	TRBJ2-2
TGTGCCACCAGTGTGGGGGCTGTAAACAATGAGCAGTTCTTC	CATSVGAVNNEQFF	TRBV24-1	TRBJ2-1
TGTGCCAGCAGCTGTACAGGGGAGACTGAAGCTTTCTTT	CASSCTGETEAFF	TRBV7-3	TRBJ1-1
TGTGCCAGCAGTTCTTCCGGGAGGACAGGTGGCTACACCTTC	CASSSSGRTGGYTF	TRBV6-9	TRBJ1-2
TGTGCCAGCAGCCACAACTTTGACAGGGTGCTTCAGACTGAAGCTTTCTTT	CASSHNFDRVLQTEAFF	TRBV4-2	TRBJ1-1
TGTGCCAGCAGCCATACTGGTAGGATGAACACTGAAGCTTTCTTT	CASSHTGRMNTEAFF	TRBV3-1	TRBJ1-1
TGTGCCAGCAGCCATCTCAAAAACATTCAGTACTTC	CASSHLKNIQYF	TRBV3-1	TRBJ2-4
TGTGCCAGCAGTCGCAGCGTGGGGCAAGAGACCCAGTACTTC	CASSRSVGQETQYF	TRBV27	TRBJ2-5
TGCAGCGTTGATCCTTGGGGGGAGGGGGCCAACGTCCTGACTTTC	CSVDPWGEGANVLTF	TRBV29-1	TRBJ2-6
TGTGCCAGCCCGTGTCGACAGGGGAATGAGACCCAGTACTTC	CASPCRQGNETQYF	TRBV6-6	TRBJ2-5
TGTGCCAGCAGAGGTTCGCACCGGGAGGCTTTTAAGAACACTGAAGCTTTCTTT	CASRGSHREAFKNTEAFF	TRBV6-6	TRBJ1-1
TGTGCCAGCAGGGGCCCAGGAGGAGAGACCCAGTACTTC	CASRGPGGETQYF	TRBV6-4	TRBJ2-5
TGTGCCAGCAGCCGGTCACAGGGACCGTCCTACGAGCAGTACTTC	CASSRSQGPSYEQYF	TRBV13	TRBJ2-7
TGTGCCAGCAGCTTGGACCTAGCGGGGGACGAGCAGTACTTC	CASSLDLAGDEQYF	TRBV7-6	TRBJ2-7
TGTGCCTGGTGGGGGCGCTCACCCCTCCACTTT	CAWWGRSPLHF	TRBV30	TRBJ1-6
TGCAGTGCTAGAGCCACAGGGCTAAATCAGCCCCAGCATTTT	CSARATGLNQPQHF	TRBV20-1	TRBJ1-5
TGTGCCAGCAGCGGTGGCAGGGAGTGTCGAGGGAACAATCAGCCCCAGCATTTT	CASSGGRECRGNNQPQHF	TRBV7-6	TRBJ1-5
TGTGCCAGTAGTATTGGACGGAGCGGGTCTAACTATGGCTACACCTTC	CASSIGRSGSNYGYTF	TRBV19	TRBJ1-2
TGTGCCAGCAGCGAGGCAGGGACCGGGGAGCTGTTTTTT	CASSEAGTGELFF	TRBV14	TRBJ2-2
TGTGCCAGCAGCCAACTCGGGGAATCGAGAGGCTATGGCTACACCTTC	CASSQLGESRGYGYTF	TRBV4-2	TRBJ1-2
TGCAGTGCTAGCGGACCGGGACCCCCTGAAGCTTTCTTT	CSASGPGPPEAFF	TRBV20-1	TRBJ1-1
TGTGCCAGCAGTTTATTCAAGGGGTCGGGCTACACCTTC	CASSLFKGSGYTF	TRBV27	TRBJ1-2
TGTGCCAGCAGCTTAGGACAGCTCGAGCAGTACTTC	CASSLGQLEQYF	TRBV11-3	TRBJ2-7
TGCAGTGCTAGAGTTGGGAACCCGCGCGGGAGGGGCAATGAAAAACTGTTTTTT	CSARVGNPRGRGNEKLFF	TRBV20-1	TRBJ1-4
TGTGCCAGCAGAGTGCCCGACCGGGTTTCGAACACCGGGGAGCTGTTTTTT	CASRVPDRVSNTGELFF	TRBV7-6	TRBJ2-2
TGTGCCACGCTAGGACCCCCAGGACAGGGGCGGGAGCAGTTCTTC	CATLGPPGQGREQFF	TRBV6-2	TRBJ2-1
TGTGCCAGCAGCAGGCAACTAGCGGGAGTTAACATTCAGTACTTC	CASSRQLAGVNIQYF	TRBV7-6	TRBJ2-4
TGTGCCAGCAGTGACTATTTAGGACAGGGCCCCGAGGGGAGGTACGAGCAGTACTTC	CASSDYLGQGPEGRYEQYF	TRBV6-4	TRBJ2-7
TGTGCCAGCAGTTGGGCCGGGAGGAGATACAATGAGCAGTTCTTC	CASSWAGRRYNEQFF	TRBV6-5	TRBJ2-1
TGTGCCAGCAGTTACTCGAGAAGCCGGACAGGCACAGATACGCAGTATTTT	CASSYSRSRTGTDTQYF	TRBV6-6	TRBJ2-3
TGTGCCAGCAGAATGGGGTTACAGGAGCCAAACCCCTACGAGCAGTACTTC	CASRMGLQEPNPYEQYF	TRBV6-5	TRBJ2-7
TGTGCCAGCAGCCTTGTACTAGCGGGAGGTGGGTACAATGAGCAGTTCTTC	CASSLVLAGGGYNEQFF	TRBV3-1	TRBJ2-1
TGTGCCAGCAGCGGGACAGGGTATCTCTGTACCCAGAACACTGAAGCTTTCTTT	CASSGTGYLCTQNTEAFF	TRBV7-4	TRBJ1-1
TGTGCCAGCAGTACCCCGGTAGGGGGCGCGGGATGTTACGAGCAGTACTTC	CASSTPVGGAGCYEQYF	TRBV12-3	TRBJ2-7
TGTGCCAAGACGACAGGGGGCGACTACGAGCAGTACTTC	CAKTTGGDYEQYF	TRBV7-9	TRBJ2-7
TGTGCCACCAGCAGAGATCCGGGGGGGAACTATGGCTACACCTTC	CATSRDPGGNYGYTF	TRBV15	TRBJ1-2
TGTGCCAGCAGGGTCTCCGATAGCGGGCGACTGGGGAACCTACATGAGCAGTTCTTC	CASRVSDSGRLGNLHEQFF	TRBV2	TRBJ2-1
TGCGCCACGAGGGCGGGAAAAGCTTTCTTT	CATRAGKAFF	TRBV10-1	TRBJ1-1
TGCAGTGCTAGGGAAGATCCCGAGGGAAGCCCTGAGCAGTTCTTC	CSAREDPEGSPEQFF	TRBV20-1	TRBJ2-1
TGCGCCAGCAGCCAAACAGATGAGCAGTTCTTC	CASSQTDEQFF	TRBV4-3	TRBJ2-1
TGCAGTGCTAGAAGAACCGGGGCGGCCGGGAACACTGAAGCTTTCTTT	CSARRTGAAGNTEAFF	TRBV20-1	TRBJ1-1
TGTGCCAGCAGCTTAAGGCCTAGACGCTACGAGCAGTACTTC	CASSLRPRRYEQYF	TRBV7-2	TRBJ2-7
TGTGCCAGCAGTTTATCACTAGCGGGGATGGGTAGGGAGACCCAGTACTTC	CASSLSLAGMGRETQYF	TRBV27	TRBJ2-5
TGTGCCAGTAGTATAGAAAACTCAAGGGCCTTGGTCCGTCTAGGCGTCTACGAGCAGTACTTC	CASSIENSRALVRLGVYEQYF	TRBV19	TRBJ2-7
TGTGCCTGGAATGTCGGATCCCGGAGCAATCAGCCCCAGCATTTT	CAWNVGSRSNQPQHF	TRBV30	TRBJ1-5
TGCAGTGCTTTCACTCCAGGGTTAGACACAGATACGCAGTATTTT	CSAFTPGLDTDTQYF	TRBV20-1	TRBJ2-3
TGTGCCAGCAGTTTTCCCGCGGGAGGATCTAGCAATCAGCCCCAGCATTTT	CASSFPAGGSSNQPQHF	TRBV12-3	TRBJ1-5
TGTGCCAGCAGTCCGTTGGGAACCTGTGACAGGGGGGCAAACATTCAGTACTTC	CASSPLGTCDRGANIQYF	TRBV6-5	TRBJ2-4
TGCAGTGCTAGGGGGTATGGCTACACCTTC	CSARGYGYTF	TRBV20-1	TRBJ1-2
TGTGCCAGCAGTTGGCGGAAGCCCCAGCATTTT	CASSWRKPQHF	TRBV27	TRBJ1-5
TGTGCCAGCAGGACTGATCGGGGCTACTACAATGAGCAGTTCTTC	CASRTDRGYYNEQFF	TRBV7-4	TRBJ2-1
TGCGCCAGCAGCCGCGTCCACAGGGTTTTCCCTAGCACAGATACGCAGTATTTT	CASSRVHRVFPSTDTQYF	TRBV5-1	TRBJ2-3
TGTGCCAGCAGCTCGCGAGGGTCAGATACGCAGTATTTT	CASSSRGSDTQYF	TRBV11-1	TRBJ2-3
TGTGCCAGTAGTATGGGAGGGAAGAAAGGCAATGAGCAGTTCTTC	CASSMGGKKGNEQFF	TRBV19	TRBJ2-1
TGTGCCAGCACGGACAGGGCTTCCGAGCAGTACTTC	CASTDRASEQYF	TRBV12-3	TRBJ2-7
TGTGCCAGCAGCACGGGGGGGGACTACAATGAGCAGTTCTTC	CASSTGGDYNEQFF	TRBV13	TRBJ2-1
TGTGCCAGCACCGAGACTAGCGGGAGCGGGGAGCTGTTTTTT	CASTETSGSGELFF	TRBV6-4	TRBJ2-2
TGTGCCAGCAGCTTGGGTCTAACTAGCGGGAGCCGGAGGCGAAGACGAGAGACCCAGTACTTC	CASSLGLTSGSRRRRRETQYF	TRBV5-5	TRBJ2-5
TGTGCCCTACGCTATTCACCAGCTGGGGGGTCCGGGGAGCTGTTTTTT	CALRYSPAGGSGELFF	TRBV15	TRBJ2-2
TGTGCCAGCAGCTTGGCCGGGGCTGCCAGGTGCAATCAGCCCCAGCATTTT	CASSLAGAARCNQPQHF	TRBV5-6	TRBJ1-5
TGTGCCAGCAGCCACTGGGGATCCAGCGAGCAGTACTTC	CASSHWGSSEQYF	TRBV3-1	TRBJ2-7
TGTGCCAGCAGCGTAGAACTAATACAGGGTGATACGCAGTATTTT	CASSVELIQGDTQYF	TRBV9	TRBJ2-3
TGTGCCAGCAGCCCCCCCAGGGGAGCTACTGAAGCTTTCTTT	CASSPPRGATEAFF	TRBV7-8	TRBJ1-1
TGTGCCAGTAGTATGGGGACGGATCAGCCCCAGCATTTT	CASSMGTDQPQHF	TRBV19	TRBJ1-5
TGTGCCAGCATCCCCACCGTCTGGTGGGGCCCGACATGGAACACTGAAGCTTTCTTT	CASIPTVWWGPTWNTEAFF	TRBV5-4	TRBJ1-1
TGTGCCAGCAGCGGAAGGGACCGTGGTTTAAACATTCAGTACTTC	CASSGRDRGLNIQYF	TRBV7-2	TRBJ2-4
TGTGCCACCAGTGAGTCAGGGGCGGGGTGCGAGCAGTACTTC	CATSESGAGCEQYF	TRBV24-1	TRBJ2-7
TGTGCCAGCAAAGGGGGCGGAAACACTGAAGCTTTCTTT	CASKGGGNTEAFF	TRBV28	TRBJ1-1
TGTGCCAGCAGCACTCGACTGGAAGCAGGGGCTGAGCATTTT	CASSTRLEAGAEHF	TRBV7-3	TRBJ1-5
TGTGCCAGCAGTGGGGCCTTGAACACTGAAGCTTTCTTT	CASSGALNTEAFF	TRBV6-1	TRBJ1-1
TGTGCCAGCAGCTTTTTCCCTCTGGGGAATCAGCCCCAGCATTTT	CASSFFPLGNQPQHF	TRBV7-6	TRBJ1-5
TGTGCCAGTAGGCTAGAGGCTGAGGGGAAGACGAACACTGAAGCTTTCTTT	CASRLEAEGKTNTEAFF	TRBV19	TRBJ1-1
TGCGCCAGCAGCCTACAGCGGGAAGGTCAAGAGACCCAGTACTTC	CASSLQREGQETQYF	TRBV5-1	TRBJ2-5
TGCGCCAGCAGCCAACCTAGCTACAATGAGCAGTTCTTC	CASSQPSYNEQFF	TRBV4-1	TRBJ2-1
TGCGCCAGCAGCACAATCAGACAGCGTGGCTACACCTTC	CASSTIRQRGYTF	TRBV5-1	TRBJ1-2
TGTGCCAGCAGCGGCCAGTCGGACTACTATGGCTACACCTTC	CASSGQSDYYGYTF	TRBV12-4	TRBJ1-2
TGTGCTAGTGGTTTGTCGCTCAGGGGGCAGAATGAGCAGTTCTTC	CASGLSLRGQNEQFF	TRBV12-5	TRBJ2-1
TGTGCCAGCAGTGAACGGCGGGGCTATGGCTACACCTTC	CASSERRGYGYTF	TRBV25-1	TRBJ1-2
TGTGCCAGCAGTGAAGCGCTCATTTCCTCGGCCAACTATGGCTACACCTTC	CASSEALISSANYGYTF	TRBV2	TRBJ1-2
TGTGCCAGCTCGAAACTAGCGGGAGAAGATTCACCCCTCCACTTT	CASSKLAGEDSPLHF	TRBV13	TRBJ1-6
TGTGCCAGCAGCAACCCGGGACAGGTCCACTACGAGCAGTACTTC	CASSNPGQVHYEQYF	TRBV5-4	TRBJ2-7
TGTGCTAGCAGCAGAAACCGGGTTAGAGTCGGCCAAGAGACCCAGTACTTC	CASSRNRVRVGQETQYF	TRBV7-7	TRBJ2-5
TGTGCTAGTGGTTTCTCACCTTGGTACCCGGGACAGGCCCCTGGCTACACCTTC	CASGFSPWYPGQAPGYTF	TRBV12-5	TRBJ1-2
TGTGCCAGTAGTATAGGAGGACAGCGGATGAACACTGAAGCTTTCTTT	CASSIGGQRMNTEAFF	TRBV19	TRBJ1-1
TGTGCCAGCAGCAACACTAGCGGGTACTACAATGAGCAGTTCTTC	CASSNTSGYYNEQFF	TRBV9	TRBJ2-1
TGTGCCAGCACTATAGTTACAGATACGCAGTATTTT	CASTIVTDTQYF	TRBV6-4	TRBJ2-3
TGTGCCAGCAGTGACAGGGACTATGGCTACACCTTC	CASSDRDYGYTF	TRBV25-1	TRBJ1-2
TGTGCCAGCACCCGGAATAAGCCCGGGGAGCTGTTTTTT	CASTRNKPGELFF	TRBV5-4	TRBJ2-2
TGTGCCAGCAGCCAAAGGGGCCACCAAGAGACCCAGTACTTC	CASSQRGHQETQYF	TRBV3-1	TRBJ2-5
TGTGCCAGCAGTTACAGGCCAGGGGAAAAACTGTTTTTT	CASSYRPGEKLFF	TRBV6-5	TRBJ1-4
TGTGCCAGCAGCCAAGCGTGGGCCCCCTCGGACGAGCAGTACTTC	CASSQAWAPSDEQYF	TRBV3-1	TRBJ2-7
TGTGCCAGCAGCTTGCTGCCGGGACTAGATTGTGAGGAAGCGTATTTT	CASSLLPGLDCEEAYF	TRBV5-5	TRBJ2-3
TGTGACTATGGCTACACCTTC	CDYGYTF	TRBV19	TRBJ1-2
TGCGCCAGCAGCTTGGCAGCAGGGGAGCACTATGGCTACACCTTC	CASSLAAGEHYGYTF	TRBV5-1	TRBJ1-2
TGCGCCAGCAGCCTCCCGGGGACAGGGAAGGACCAACTAAGGAGCAATCAGCCCCAGCATTTT	CASSLPGTGKDQLRSNQPQHF	TRBV10-2	TRBJ1-5
TGTGCCAGCAGCGTCACGGGCACCGGACAGGCAAGGGAGCAGTACTTC	CASSVTGTGQAREQYF	TRBV7-3	TRBJ2-7
TGTGCCACCAGTGATTTGCACGGACAGCCCGGGGAGCTGTTTTTT	CATSDLHGQPGELFF	TRBV24-1	TRBJ2-2
TGTGCCAGCAGCCTTACCCGACACGAGCAGTACTTC	CASSLTRHEQYF	TRBV7-6	TRBJ2-7
TGTGCCAGCAGCTTGGAAAAAGAGGTTGTAGAGGACAGGGGGAATGGCTACACCTTC	CASSLEKEVVEDRGNGYTF	TRBV5-8	TRBJ1-2
TGCAGTGCTAGAGCAGGGACAGGGTTAAATCAGCCCCAGCATTTT	CSARAGTGLNQPQHF	TRBV20-1	TRBJ1-5
TGTGCCAGCTCCGGGGGGAAGAATTCACCCCTCCACTTT	CASSGGKNSPLHF	TRBV12-3	TRBJ1-6
TGCGCCAGCAAAAGCTGCAATGAAAAACTGTTTTTT	CASKSCNEKLFF	TRBV10-1	TRBJ1-4
TGTGCCAGCAGCGTAGCTACGTCCGGCCAAGAGACCCAGTACTTC	CASSVATSGQETQYF	TRBV9	TRBJ2-5
TGTGCCAGTAGTAACGCGCGGCTCCTTGATACGCAGTATTTT	CASSNARLLDTQYF	TRBV19	TRBJ2-3
TGTGCCAGCAGCCAAGTGGACAGGGACAGGGCGAGAAATCAGCCCCAGCATTTT	CASSQVDRDRARNQPQHF	TRBV3-1	TRBJ1-5
TGTGCCAGCAGTTACTCCTCGATTGAGACCCAGTACTTC	CASSYSSIETQYF	TRBV6-5	TRBJ2-5
TGTGCCAGCAGCCAAGATCCTGCAGGGATGTCTGAAGCTTTCTTT	CASSQDPAGMSEAFF	TRBV14	TRBJ1-1
TGTGCCAGCAGTTGGAGCAACAGGGGAACCTACGAGCAGTACTTC	CASSWSNRGTYEQYF	TRBV6-3	TRBJ2-7
TGTGCCAGCAGTTTCCCTGGGACTAGCGGCCGGGGAAGCAATGAGCAGTTCTTC	CASSFPGTSGRGSNEQFF	TRBV27	TRBJ2-1
TGTGCCAGCAGGGGCAGGGGACTGACTGAAGCTTTCTTT	CASRGRGLTEAFF	TRBV7-4	TRBJ1-1
TGCGCCAGCAGCTTGCCGGAGTCCGGGGCGGGGGGTGCCAAAAACATTCAGTACTTC	CASSLPESGAGGAKNIQYF	TRBV5-1	TRBJ2-4
TGTGCCAGCTCACCATTCAGGGGGGACAGCCAGTTCGTGGGCTACACCTTC	CASSPFRGDSQFVGYTF	TRBV18	TRBJ1-2
TGCGCCAGCAGCCACGAGAGTCTCGAGCAGTACTTC	CASSHESLEQYF	TRBV4-1	TRBJ2-7
TGTGTTGACAGGGAGACCGGGGAGCTGTTTTTT	CVDRETGELFF	TRBV11-2	TRBJ2-2
TGTGCCAGCAGTTTACTGTCCAGGGCGGCCTATGGCTACACCTTC	CASSLLSRAAYGYTF	TRBV28	TRBJ1-2
TGTGCCAGCAGTTACTCACCGGGGGGGGCCTACGAGCAGTACTTC	CASSYSPGGAYEQYF	TRBV6-3	TRBJ2-7
TGTGCCACAGACCAGAGTCAGCCCCAGCATTTT	CATDQSQPQHF	TRBV24-1	TRBJ1-5
TGTGCCAGACGGGGAGGTTTGCAACATGAAAAACTGTTTTTT	CARRGGLQHEKLFF	TRBV6-4	TRBJ1-4
TGTGCCAGCAGCGCCCTCGGCTCCAACACCGGGGAGCTGTTTTTT	CASSALGSNTGELFF	TRBV5-4	TRBJ2-2
TGTGCCAGCACTTCGGGAAGGGACAGTAGTGGGGAGACCCAGTACTTC	CASTSGRDSSGETQYF	TRBV27	TRBJ2-5
TGCAGCGTTGAAGATCCCCCCGGTCCGGGACTACCGGGCCCCGAGACCCAGTACTTC	CSVEDPPGPGLPGPETQYF	TRBV29-1	TRBJ2-5
TGTGCCAGCACCAGGACAGATACGCAGTATTTT	CASTRTDTQYF	TRBV7-3	TRBJ2-3
TGTGCCAGCAGCCTTGGACAGGGGCGGCGAAACTATGGCTACACCTTC	CASSLGQGRRNYGYTF	TRBV7-9	TRBJ1-2
TGTGCCAGCAGGTCCAACCCCGCAGGGGTGAACACTGAAGCTTTCTTT	CASRSNPAGVNTEAFF	TRBV6-3	TRBJ1-1
TGTGCCAGCAGCTTCTCCAGAGGCGACGACGAGCAGTACTTC	CASSFSRGDDEQYF	TRBV11-1	TRBJ2-7
TGCGCCAGCAGGGCGCAGAATAGCTCCTATAATTCACCCCTCCACTTT	CASRAQNSSYNSPLHF	TRBV5-1	TRBJ1-6
TGTGCCAGCAGTGAGAGAAGGGTGGACAGGAACCAGTACTTC	CASSERRVDRNQYF	TRBV6-4	TRBJ2-5
TGTGCCAGCAGCCATCCGGGAGTTGCGAACACCGGGGAGCTGTTTTTT	CASSHPGVANTGELFF	TRBV7-7	TRBJ2-2
TGCGCCAGCAGCCTATACGGCACCGGGGAGCTGTTTTTT	CASSLYGTGELFF	TRBV4-3	TRBJ2-2
TGTGCCAGCAGCAAGATTCGGCGGGTAGATGGCTACACCTTC	CASSKIRRVDGYTF	TRBV5-5	TRBJ1-2
TGTGCCAGCTGCGGGAGTTATAGCAATCAGCCCCAGCATTTT	CASCGSYSNQPQHF	TRBV2	TRBJ1-5
TGCGCCAGCAGCTCAGGCCCGGGGGCCTACGAGCAGTACTTC	CASSSGPGAYEQYF	TRBV5-1	TRBJ2-7
TGTGCCAGCAGTGAAGCGCATCCTCTTCTCTCCGGCTCCTATGGCTACACCTTC	CASSEAHPLLSGSYGYTF	TRBV2	TRBJ1-2
TGTGCCAGCAGCTTAGAAACGGAACAAGGACTAGCGAATGAGCAGTTCTTC	CASSLETEQGLANEQFF	TRBV13	TRBJ2-1
TGTGCCTGGAGAGGCGGTGACAGTTTTTCAGCTTTCTTT	CAWRGGDSFSAFF	TRBV30	TRBJ1-1
TGTGCCAGCAGCAAAGTCAGGGGGCCCCGTATTAACACAGATACGCAGTATTTT	CASSKVRGPRINTDTQYF	TRBV13	TRBJ2-3
TGTGCCAGCAGTCGGTACAGGGGACGGGGAGCCAAAAACATTCAGTACTTC	CASSRYRGRGAKNIQYF	TRBV27	TRBJ2-4
TGCGCCAGCAGCCGTAGCGGGGGGCAGTTCTTC	CASSRSGGQFF	TRBV5-1	TRBJ2-1
TGTGCCAGCAGCTTATTCCAAGGGGGACAGGATAATAATGAAAAACTGTTTTTT	CASSLFQGGQDNNEKLFF	TRBV7-3	TRBJ1-4
TGTGCCACCAGTGACCCCGAGGGTTGGCGCGAGCAGTACTTC	CATSDPEGWREQYF	TRBV24-1	TRBJ2-7
TGTGCCAGCCCCCCTTCGGGGACTGAAGCTTTCTTT	CASPPSGTEAFF	TRBV28	TRBJ1-1
TGCGCCAGCAGCGGTCTCGGGACTAGCGGGCCATTGTCAGATACGCAGTATTTT	CASSGLGTSGPLSDTQYF	TRBV5-1	TRBJ2-3
TGTGCCAGCAGCGGACAGGGATCTACGCCCTATGGCTACACCTTC	CASSGQGSTPYGYTF	TRBV7-9	TRBJ1-2
TGTGCCAGCAGCGGAGACTACTATGGCTACACCTTC	CASSGDYYGYTF	TRBV7-9	TRBJ1-2
TGTGCCAGCAGCGGGCTTCACCGGGACAGCCCTCGAGCCAATGAAAAACTGTTTTTT	CASSGLHRDSPRANEKLFF	TRBV13	TRBJ1-4
TGCGCCAGCAGCTTGCTGGCCACCGGGGAGCTGTTTTTT	CASSLLATGELFF	TRBV5-1	TRBJ2-2
TGTGCCAGCCCCACGAACACTGAAGCTTTCTTT	CASPTNTEAFF	TRBV27	TRBJ1-1
TGTGCCAGCAGTGCAGATAGTGGGACAGGGGTATTGCGCAATCAGCCCCAGCATTTT	CASSADSGTGVLRNQPQHF	TRBV25-1	TRBJ1-5
TGTGCCAGCAGTTTGGACGGGACATATTGGGGAAATTCACCCCTCCACTTT	CASSLDGTYWGNSPLHF	TRBV12-4	TRBJ1-6
TGTGCCAGCAGCTCACGGGACAGGGGAGGGGGTAACTATGGCTACACCTTC	CASSSRDRGGGNYGYTF	TRBV13	TRBJ1-2
TGTGCCACCAGTGATACGAAGGACAGGGGGCGGAAATGTTCCTACGAGCAGTACTTC	CATSDTKDRGRKCSYEQYF	TRBV24-1	TRBJ2-7
TGTGCCAGCAGTGCTAGAAAACCGGGACATTTCTCCTACGAGCAGTACTTC	CASSARKPGHFSYEQYF	TRBV6-4	TRBJ2-7
TGTGCAGTAGCGGGGGCCTATGAGCAGTTCTTC	CAVAGAYEQFF	TRBV6-2	TRBJ2-1
TGTGCCAGCAGCGGTATAGGGCTCACCTCTGGAAACACCATATATTTT	CASSGIGLTSGNTIYF	TRBV5-6	TRBJ1-3
TGTGCCAGCAGCTTTAGGCGGAATGAGCAGTTCTTC	CASSFRRNEQFF	TRBV11-1	TRBJ2-1
TGTGCCAGCAGCTTAAAAGGGCCGGGGCCTGGGAACACCGGGGAGCTGTTTTTT	CASSLKGPGPGNTGELFF	TRBV7-9	TRBJ2-2
TGTGCCAGCAGCAACCCTCCCCAAGGGACGGGAAACATTCAGTACTTC	CASSNPPQGTGNIQYF	TRBV13	TRBJ2-4
TGTGCATCAGACACCCAAGAGACCCAGTACTTC	CASDTQETQYF	TRBV7-2	TRBJ2-5
TGTGCCAGCAGCGGGGGGTTCTACGAGCAGTACTTC	CASSGGFYEQYF	TRBV7-9	TRBJ2-7
TGCAGTGCTAGAGAATCTCATCGGGGGCTGTTTTTT	CSARESHRGLFF	TRBV20-1	TRBJ1-4
TGTGCCAGCTATCCAACCCCAAGAAGCTATGAAGACTATGGCTACACCTTC	CASYPTPRSYEDYGYTF	TRBV27	TRBJ1-2
TGTGCCACCAGCTCCCAGGAACGCTCCAAAAACATTCAGTACTTC	CATSSQERSKNIQYF	TRBV15	TRBJ2-4
TGTGATGTTGGGGGGGGGGAGCCCTACAATGAGCAGTTCTTC	CDVGGGEPYNEQFF	TRBV6-2	TRBJ2-1
TGCGCCAGCAGCTTGCCGGCTAGGCATACGATCGAGCAGTACTTC	CASSLPARHTIEQYF	TRBV5-1	TRBJ2-7
TGCGCCAGCACTATAGCGGTCTACAATGAGCAGTTCTTC	CASTIAVYNEQFF	TRBV10-1	TRBJ2-1
TGCGCCGGCCACGTGGGACAGGGAAGGAACTCAGATGGCTACACCTTC	CAGHVGQGRNSDGYTF	TRBV10-1	TRBJ1-2
TGTGCCAGCAGCCGCCCCACAGGGAAAGACTATGGCTACACCTTC	CASSRPTGKDYGYTF	TRBV7-9	TRBJ1-2
TGTGCCTGGAGTGTCCACATGGCAGGCCCACCCTATAATTCACCCCTCCACTTT	CAWSVHMAGPPYNSPLHF	TRBV30	TRBJ1-6
TGCGCCAGCAGCTTCGAAGGGGGGAGAACGAATTCACCCCTCCACTTT	CASSFEGGRTNSPLHF	TRBV5-1	TRBJ1-6
TGTGCCAGCAGCCATAGGACCCCCGGACAGGGGAGTGCTAACTATGGCTACACCTTC	CASSHRTPGQGSANYGYTF	TRBV14	TRBJ1-2
TGTGCCAGCAGCTTTCGGTTAGAGACCGGGACTAGCGGGAGGAACAATGAGCAGTTCTTC	CASSFRLETGTSGRNNEQFF	TRBV5-6	TRBJ2-1
TGCGCCAGCAGTAAAGCCCGGGAGGTCCTTATCACTGAAGCTTTCTTT	CASSKAREVLITEAFF	TRBV5-1	TRBJ1-1
TGTGCCTATCCCCCGTGGACAGGCCCGGAATCATATGCAACTAATGAAAAACTGTTTTTT	CAYPPWTGPESYATNEKLFF	TRBV19	TRBJ1-4
TGTGCCAGCAGCTCCGGGGTTAGGGGCAATCAGCCCCAGCATTTT	CASSSGVRGNQPQHF	TRBV5-6	TRBJ1-5
TGTGCCAGCAGCGCCCTAAGTACTAACAGAAGAGTTTCACCCCTCCACTTT	CASSALSTNRRVSPLHF	TRBV5-8	TRBJ1-6
TGTGCCTGGAGTGTCACTGGGGGGAATCCGAACACTGAAGCTTTCTTT	CAWSVTGGNPNTEAFF	TRBV30	TRBJ1-1
TGTGCCATCACCAGGCGGCCTGGAAACACCATATATTTT	CAITRRPGNTIYF	TRBV10-3	TRBJ1-3
TGTGCCATCAGTGAGGCGAAGGAAGGCGAAAAGGAAAAACTGTTTTTT	CAISEAKEGEKEKLFF	TRBV10-3	TRBJ1-4
TGTGCCAGCATCGGGGAAGTCCAGCCCCAGCATTTT	CASIGEVQPQHF	TRBV6-8	TRBJ1-5
TGTGCCAGCAGCCAAAAAATACGGGCCCGGGGGCCTTCTTTCTTT	CASSQKIRARGPSFF	TRBV4-2	TRBJ1-1
TGTGCCAGCAGTTTATTTGACAGGGGGTTCCGGAGATCTGGCTACACCTTC	CASSLFDRGFRRSGYTF	TRBV27	TRBJ1-2
TGTGCCAGCACCTCCCAGAAAAATAGCACAGATACGCAGTATTTT	CASTSQKNSTDTQYF	TRBV6-4	TRBJ2-3
TGTGCCAGCAGCTTACGGGACAGGGTGCTGACCCAGTACTTC	CASSLRDRVLTQYF	TRBV7-6	TRBJ2-5
TGTGCCAGCAGCCGAGCAAAACGGGACAGCCGTAATCAGCCCCAGCATTTT	CASSRAKRDSRNQPQHF	TRBV11-3	TRBJ1-5
TGTGCCAGCAGTTTACACGGGGGCTGCGAGCAGTACTTC	CASSLHGGCEQYF	TRBV27	TRBJ2-7
TGTGCCAGCAGCTTGCCCGGGGGGACGGTATGCAATCAGCCCCAGCATTTT	CASSLPGGTVCNQPQHF	TRBV5-5	TRBJ1-5
TGTGCCAGTACAGATCTACAGTCTGGTGCCCACGAGCAGTACTTC	CASTDLQSGAHEQYF	TRBV19	TRBJ2-7
TGCAGCGTTGAAGCCGGCGGTCCGGGACGAGCCTACGAGCAGTACTTC	CSVEAGGPGRAYEQYF	TRBV29-1	TRBJ2-7
TGCGCCAGCAGCTATGGAAGGGCCGAGCAGTACTTC	CASSYGRAEQYF	TRBV5-1	TRBJ2-7
TGCGCCAGCATCCGCGTGGGGCGCACTGAAGCTTTCTTT	CASIRVGRTEAFF	TRBV10-1	TRBJ1-1
TGTGCCAGCAGCCCACTGAGGACGTACAATGAGCAGTTCTTC	CASSPLRTYNEQFF	TRBV6-4	TRBJ2-1
TGTGCTAGTGGTTTGGCCTATAAGCCCAGGACTAGACGCCTTTGGTGTTACAATGAGCAGTTCTTC	CASGLAYKPRTRRLWCYNEQFF	TRBV12-5	TRBJ2-1
TGCAGTGCTATAGCGGGAGGTGCTGACTACGAGCAGTACTTC	CSAIAGGADYEQYF	TRBV20-1	TRBJ2-7
TGTGCCTGGAGGCCGGGTTCAGACAGGCGACTAGCCAAAAACATTCAGTACTTC	CAWRPGSDRRLAKNIQYF	TRBV30	TRBJ2-4
TGTGCCAGCAGCCATGCTCAACCGGGACAGACTAATAGCAATCAGCCCCAGCATTTT	CASSHAQPGQTNSNQPQHF	TRBV7-2	TRBJ1-5
TGCAGTGCTAGAGATCCGAGACTAGCGGGAGGGCCCAGCGAGTCCTACGAGCAGTACTTC	CSARDPRLAGGPSESYEQYF	TRBV20-1	TRBJ2-7
TGTGCCAGCAGTGATTGTTCCTGCAGGTTGGAGGCTGAAGCTTTCTTT	CASSDCSCRLEAEAFF	TRBV25-1	TRBJ1-1
TGTGCCAGCAGTTTATGGGCGTACCAGCGGGATAGCGGGGAGCTGTTTTTT	CASSLWAYQRDSGELFF	TRBV28	TRBJ2-2
TGTGCCAGCAGAGTGGGTGGTGGGCAGGGCCACCAAGAGACCCAGTACTTC	CASRVGGGQGHQETQYF	TRBV6-4	TRBJ2-5
TGTGCTAGTGGTCCCTCGGGGGCGGGCTATCAGCCCCAGCATTTT	CASGPSGAGYQPQHF	TRBV12-5	TRBJ1-5
TGCAGTGCTGGTGGGGGGATGGATGAAAAACTGTTTTTT	CSAGGGMDEKLFF	TRBV20-1	TRBJ1-4
TGTGCCAGATCGGGACGGACCTATGGCTACACCTTC	CARSGRTYGYTF	TRBV6-5	TRBJ1-2
TGTGCCAGCAGTTTAAACCCTAGTCGCGGGAGACTAGTGAGCACAGATACGCAGTATTTT	CASSLNPSRGRLVSTDTQYF	TRBV12-4	TRBJ2-3
TGCGCCAGCAGCCATTCCCCAATAGGGGAGATGAACACTGAAGCTTTCTTT	CASSHSPIGEMNTEAFF	TRBV4-3	TRBJ1-1
TGTGCCAGTCACCCTAGCGGGCCAGAGACCCAGTACTTC	CASHPSGPETQYF	TRBV19	TRBJ2-5
TGTGCCAGCAGCTTGGCTCGAACGCAGGGCAATCAGCCCCAGCATTTT	CASSLARTQGNQPQHF	TRBV5-4	TRBJ1-5
TGCAGCGTTGAAGGGGAGTATAATTCACCCCTCCACTTT	CSVEGEYNSPLHF	TRBV29-1	TRBJ1-6
TGTGCCAGCAGCACCCATGGCGGACTAGCGGGGGGGATTGGGTCATACGAGCAGTACTTC	CASSTHGGLAGGIGSYEQYF	TRBV5-4	TRBJ2-7
TGTGCCAGCAGCCAAGATGTGGCAGGGTGGGCCTACTTCCGCACTGAAGCTTTCTTT	CASSQDVAGWAYFRTEAFF	TRBV14	TRBJ1-1
TGTGCCAGCAGTTTATGTGCGGATTCACAGGGGGGGAGGACCCAGTACTTC	CASSLCADSQGGRTQYF	TRBV28	TRBJ2-5
TGTGCCATCAGTGAGGGACAGGCCCTGAATCAGCCCCAGCATTTT	CAISEGQALNQPQHF	TRBV10-3	TRBJ1-5
TGTGCCAGCAGTGAAGAGGTAGCGGGGGCGACTTACAATGAGCAGTTCTTC	CASSEEVAGATYNEQFF	TRBV2	TRBJ2-1
TGCGCCAGCACAAGAGGGCAGGCCTACGAGCAGTACTTC	CASTRGQAYEQYF	TRBV10-1	TRBJ2-7
TGTGCCAGCAGCGGAAAGGGAGATACGCAGTATTTT	CASSGKGDTQYF	TRBV7-3	TRBJ2-3
TGTGCCAGCAAACCAATGAGAGTGACTCGTCAATCCTACGAGCAGTACTTC	CASKPMRVTRQSYEQYF	TRBV5-4	TRBJ2-7
TGTGCCAGCAGGGGGGGGACCCCTGAGCAGTACTTC	CASRGGTPEQYF	TRBV12-4	TRBJ2-7
TGTGCCAGCAGCAAGCTCGCTTTCTTT	CASSKLAFF	TRBV12-3	TRBJ1-1
TGCAGTGCAAAAAGGGGACAGGGGGGGGGCAATCAGCCCCAGCATTTT	CSAKRGQGGGNQPQHF	TRBV20-1	TRBJ1-5
TGTGCCAGCAGTGACCCCCCCCGGGGCCCTCAGCCCCAGCATTTT	CASSDPPRGPQPQHF	TRBV6-4	TRBJ1-5
TGTGCCACCAGTGATTTGCCTCCCCCCGACAGGGGGCGCGCCTACGAGCAGTACTTC	CATSDLPPPDRGRAYEQYF	TRBV24-1	TRBJ2-7
TGTGCCAGCAGCTGGGCGGGAGGTTGCACTGAAGCTTTCTTT	CASSWAGGCTEAFF	TRBV7-8	TRBJ1-1
TGCAGTGCTCCCATCGGGACACCCTTCGTGTCAGCAACTAATGAAAAACTGTTTTTT	CSAPIGTPFVSATNEKLFF	TRBV20-1	TRBJ1-4
TGTGCCACCAGTGACCCCGGGGGGGCCTCCTACGAGCAGTACTTC	CATSDPGGASYEQYF	TRBV24-1	TRBJ2-7
TGTGCCAGCAGCGCGACAGGCCTGGCTGGCTACACCTTC	CASSATGLAGYTF	TRBV9	TRBJ1-2
TGCGCCAGCAGCTCTCCCCGGGACTTTTTTAAAACTTCCCCTGGGGCCAACGTCCTGACTTTC	CASSSPRDFFKTSPGANVLTF	TRBV5-1	TRBJ2-6
TGTGCCAGCAGCGGACATGGTTTCCAACGCAATCAGCCCCAGCATTTT	CASSGHGFQRNQPQHF	TRBV6-6	TRBJ1-5
TGTGCCACCAGTGATGTACAGGGGGAGACCCAGTACTTC	CATSDVQGETQYF	TRBV24-1	TRBJ2-5
TGTGCCCCACGACTAGCGGGGGGAGAGGAGGCCTACGAGCAGTACTTC	CAPRLAGGEEAYEQYF	TRBV19	TRBJ2-7
TGTGCCAGCAGCTTGAGACCCGGGGGTCTTTTCCCGAGCAATCAGCCCCAGCATTTT	CASSLRPGGLFPSNQPQHF	TRBV7-7	TRBJ1-5
TGTGTCCCCGCCGGGCACGGCCACAATGAGCAGTTCTTC	CVPAGHGHNEQFF	TRBV7-9	TRBJ2-1
TGTGCCAGCAGCTTAATAGGGCCCCAGCATTTT	CASSLIGPQHF	TRBV7-8	TRBJ1-5
TGTGCCTGGAGTGTTCGAACGGGGGGGGGTTCCTATAATTCACCCCTCCACTTT	CAWSVRTGGGSYNSPLHF	TRBV30	TRBJ1-6
TGTGCCAGCAGTCCCGTAGGGGGTAGCCGGGACTGGAACAATGAGCAGTTCTTC	CASSPVGGSRDWNNEQFF	TRBV5-8	TRBJ2-1
TGTGCCAGCTCACGTATAATAAAAGAGACCCAGTACTTC	CASSRIIKETQYF	TRBV18	TRBJ2-5
TGTGCTAGTGGTTACGGGATGAACACTGAAGCTTTCTTT	CASGYGMNTEAFF	TRBV12-5	TRBJ1-1
TGTGCCAGCAGATCCGGGACAGGGGCCTCTGGGGCCAACGTCCTGACTTTC	CASRSGTGASGANVLTF	TRBV6-4	TRBJ2-6
TGTGCCAGCAGGGCGATTGAGTCGGACGGTACGGCTGAAGCTTTCTTT	CASRAIESDGTAEAFF	TRBV5-6	TRBJ1-1
TGTGCCAGCAGCGGAACGGGCATCTACGAGCAGTACTTC	CASSGTGIYEQYF	TRBV5-6	TRBJ2-7
TGTGCCACCAGCAGAGATCGCGGGAGCTACGAGCAGTACTTC	CATSRDRGSYEQYF	TRBV15	TRBJ2-7
TGTGCCAGCAGTTCGCGTCACGGTAGCTCCTACAATGAGCAGTTCTTC	CASSSRHGSSYNEQFF	TRBV6-6	TRBJ2-1
TGTGCCAGGTTTGAAGCGGGAAAACTCACGAACACTGAAGCTTTCTTT	CARFEAGKLTNTEAFF	TRBV27	TRBJ1-1
TGTGCCAGCCCGGGGCGAGACTCCCCCTTGCCCCTAGATACGCAGTATTTT	CASPGRDSPLPLDTQYF	TRBV4-2	TRBJ2-3
TGTGCCAGGGCCCGGATCTCCTACAATGAGCAGTTCTTC	CARARISYNEQFF	TRBV6-2	TRBJ2-1
TGCAAGATAGGAGGTGGGGCCCTAACCTACGAGCAGTACTTC	CKIGGGALTYEQYF	TRBV20-1	TRBJ2-7
TGCGCCAGCAGCGGGGGAACAGAGGGACAGTATACGCAGTATTTT	CASSGGTEGQYTQYF	TRBV5-1	TRBJ2-3
TGCAGCGTCGTACTAGCGGGAGGAAGGATTGAAAAACTGTTTTTT	CSVVLAGGRIEKLFF	TRBV29-1	TRBJ1-4
TGTGCCAGCAGTTTAGTGACTTACAATGAGCAGTTCTTC	CASSLVTYNEQFF	TRBV28	TRBJ2-1
TGTGCCAGCAGCATCCAGGGTTTAGCCGAGCAGTACTTC	CASSIQGLAEQYF	TRBV7-9	TRBJ2-7
TGCGCCAGCAGCTTGTTTCAAGACGGCGAGCAGTACTTC	CASSLFQDGEQYF	TRBV5-1	TRBJ2-7
TGCAGTGCTAGAGTGAGAGTGAACCGGAGCTCCTACAATGAGCAGTTCTTC	CSARVRVNRSSYNEQFF	TRBV20-1	TRBJ2-1
TGTGCCTGTATGGGGGGGTATGAGCAGTTCTTC	CACMGGYEQFF	TRBV30	TRBJ2-1
TGTGCCAGCATGGGGATGGAGGGAAGTGGGAGCGGGGAGCTGTTTTTT	CASMGMEGSGSGELFF	TRBV12-3	TRBJ2-2
TGTGCCAGCAGCTTAAACGCCTTGCAGGAACACTTGACGGGAGAGCAGTACTTC	CASSLNALQEHLTGEQYF	TRBV7-3	TRBJ2-7
TGCAGTGCAACAGGGGCTACTGAAGCTTTCTTT	CSATGATEAFF	TRBV20-1	TRBJ1-1
TGTGCCAGCAGCGGGCCACCGGGACTAGGTCAAGAGACCCAGTACTTC	CASSGPPGLGQETQYF	TRBV9	TRBJ2-5
TGTGCCAGCAGCCAACCGTGGGATCTAAGTGAAAAACTGTTTTTT	CASSQPWDLSEKLFF	TRBV3-1	TRBJ1-4
TGTGCCAGCAGCTTAGACCGGGGCCGGGAGCGGGCGAATCAGCCCCAGCATTTT	CASSLDRGRERANQPQHF	TRBV7-2	TRBJ1-5
TGTGCCAGTAGTATGGTCGGGGGACCCCTCTTC	CASSMVGGPLF	TRBV19	TRBJ2-1
TGTGCCACCAGCAGAGAAAACCATAGAGGAGGTTACTTC	CATSRENHRGGYF	TRBV15	TRBJ2-7
TGTGCCAGCAGGAGGTTCAGCGGCATCTATGGCTACACCTTC	CASRRFSGIYGYTF	TRBV6-1	TRBJ1-2
TGTGCCAGTAGTATGAAGAGCGGGATGGCCGGTCAAGAGACCCAGTACTTC	CASSMKSGMAGQETQYF	TRBV19	TRBJ2-5
TGTGCCAGCAGCCCTGCGAATCCGGTCGGGGCTCCAAAAACTGAAGCTTTCTTT	CASSPANPVGAPKTEAFF	TRBV13	TRBJ1-1
TGTGCCTGGAGTTCTAAGGGGACTAGCAGCATTCAGTACTTC	CAWSSKGTSSIQYF	TRBV30	TRBJ2-4
TGTGCCAGCAGCTTACAGGGAGATCCCTACGAGCAGTACTTC	CASSLQGDPYEQYF	TRBV13	TRBJ2-7
TGCGCCAGCAGCTTGGTTGAGGACAGGTACGAGCAGTACTTC	CASSLVEDRYEQYF	TRBV5-1	TRBJ2-7
TGTGCCAGCAGCTTATTTTACTCCCTCCACTTT	CASSLFYSLHF	TRBV7-2	TRBJ1-6
TGTGCCAGCAGCGCCTGCCGCCCCAAAGATACGCAGTATTTT	CASSACRPKDTQYF	TRBV13	TRBJ2-3
TGTGCCAGCAGTGGTCTAGTGCTAGCCAAAAACATTCAGTACTTC	CASSGLVLAKNIQYF	TRBV6-2	TRBJ2-4
TGTGCCAGTAGTAAAGGATACAGGGTTATTCACGAGCAGTACTTC	CASSKGYRVIHEQYF	TRBV19	TRBJ2-7
TGTGCCAGCAGCGCTCCGGGGAACTATGGCTACACCTTC	CASSAPGNYGYTF	TRBV9	TRBJ1-2
TGTGCCAGCAGCTTAACCTCAGGGGGGAATTCACCCCTCCACTTT	CASSLTSGGNSPLHF	TRBV7-3	TRBJ1-6
TGTGCCAGCAGCTTAGTCAGCGGGAATGGGAACACTGAAGCTTTCTTT	CASSLVSGNGNTEAFF	TRBV7-9	TRBJ1-1
TGCGCCAGCAGCCACCGGGGGGGACATACGCAGTATTTT	CASSHRGGHTQYF	TRBV4-1	TRBJ2-3
TGCGCCAGCAGTCCCCCTCCTGGAAAAACGAACACCCCTCGGGGGACCCAGTACTTC	CASSPPPGKTNTPRGTQYF	TRBV10-1	TRBJ2-5
TGCGCCAGCAGTCTAGGACCCTCCTACGAGCAGTACTTC	CASSLGPSYEQYF	TRBV10-1	TRBJ2-7
TGTGCCAGCAGTTTGACCGGGAATAGCACAGATACGCAGTATTTT	CASSLTGNSTDTQYF	TRBV27	TRBJ2-3
TGTGCCAGCAGTGAATCCACCAGAAGTTTACAAGCTTTCTTT	CASSESTRSLQAFF	TRBV25-1	TRBJ1-1
TGTGCCAGCAGCTCCCCGGGACAGGGGAAATTCAATGAGCAGTTCTTC	CASSSPGQGKFNEQFF	TRBV7-2	TRBJ2-1
TGTGCCAGCAGCGTAAATGGGGTGAAGGGAGAGACCCAGTACTTC	CASSVNGVKGETQYF	TRBV9	TRBJ2-5
TGTGCCAGCAGCGGTTACACGAATTCACCCCTCCACTTT	CASSGYTNSPLHF	TRBV9	TRBJ1-6
TGTGCCAGCAGTTTACGGCCAGACAGGGACTGGGAAGAGACCCAGTACTTC	CASSLRPDRDWEETQYF	TRBV28	TRBJ2-5
TGTGCCATTAAGACAGTCGGCTACACCTTC	CAIKTVGYTF	TRBV19	TRBJ1-2
TGTGCCAGCAGCTGCTCTATCCCCGAGACCCAGTACTTC	CASSCSIPETQYF	TRBV5-6	TRBJ2-5
TGTGCCAGCGGGCCGGGACAGCTATGTAGCTCCTACGAGCAGTACTTC	CASGPGQLCSSYEQYF	TRBV6-4	TRBJ2-7
TGTGCCACCCCACAGGGATTCAACTACGAGCAGTACTTC	CATPQGFNYEQYF	TRBV28	TRBJ2-7
TGCGCCAGCAGCCAAGATAAGACACAGGGGGGGCAAGAGACCCAGTACTTC	CASSQDKTQGGQETQYF	TRBV4-1	TRBJ2-5
TGTGCCAGCAGCAGGAATAGCACAGATACGCAGTATTTT	CASSRNSTDTQYF	TRBV9	TRBJ2-3
TGTGCCAGCAGCCAAGAGACGCAGTCCCCAGACTACGAGCAGTACTTC	CASSQETQSPDYEQYF	TRBV14	TRBJ2-7
TGTGCCAGCAGGGAGCGGGAGACCCAGTACTTC	CASRERETQYF	TRBV27	TRBJ2-5
TGTGCCAGTAGTATCAAAGGGAGGGGGCCTAACTATGGCTACACCTTC	CASSIKGRGPNYGYTF	TRBV19	TRBJ1-2
TGTGCCAGCAGTTCAGGGGGACTAAGGAACTATGGCTACACCTTC	CASSSGGLRNYGYTF	TRBV27	TRBJ1-2
TGTGCCAGCAGGGTCCGAGAAAACACCGGGGAGCTGTTTTTT	CASRVRENTGELFF	TRBV27	TRBJ2-2
TGCGCCAGCAGCTTGGTCCCGGGACAGGGGAAATACTCCCCCTATGGCTACACCTTC	CASSLVPGQGKYSPYGYTF	TRBV5-1	TRBJ1-2
TGTGCCAGCAGCGTGAAGGATGCTACCTCCTACGAGCAGTACTTC	CASSVKDATSYEQYF	TRBV9	TRBJ2-7
TGTGCCAGCAGTGCGGCCAATCAGCCCCAGCATTTT	CASSAANQPQHF	TRBV27	TRBJ1-5
TGTGCCCCCCAACTAGCGGGTGGGCTTGGCTCCTACGAGCAGTACTTC	CAPQLAGGLGSYEQYF	TRBV10-3	TRBJ2-7
TGTGCCAGCAGCAAGTCCGACGGAGAGGCTAACGAGCAGTACTTC	CASSKSDGEANEQYF	TRBV11-3	TRBJ2-7
TGTGCCAGCAGTTTAACCACGGGGCCCCAGACAGATACGCAGTATTTT	CASSLTTGPQTDTQYF	TRBV12-4	TRBJ2-3
TGTGCCAGCAGCTTAGTTCCTCTCCGGGACAAAAAGCACACTGAAGCTTTCTTT	CASSLVPLRDKKHTEAFF	TRBV11-3	TRBJ1-1
TGCGCCAGCAGCTTCGAATACCCGAGGGCAGCTCCTAATGAAAAACTGTTTTTT	CASSFEYPRAAPNEKLFF	TRBV5-1	TRBJ1-4
TGTGCCAGCAGTGACAGAGGAAATCCCCATGAGCAGTTCTTC	CASSDRGNPHEQFF	TRBV6-4	TRBJ2-1
TGCGCCAGCAGCCAACACGGGGAAGAGACCCAGTACTTC	CASSQHGEETQYF	TRBV4-3	TRBJ2-5
TGCGCCAGCAGCCAAGAGCCTTCTCGGGGAGCGAAATCCTACGAGCAGTACTTC	CASSQEPSRGAKSYEQYF	TRBV4-3	TRBJ2-7
TGTGCCAGTAGACTAAATGAGCAGTTCTTC	CASRLNEQFF	TRBV19	TRBJ2-1
TGTGCCAGCAGGGACAGGGGGCGGATGATCTTATATGGCTACACCTTC	CASRDRGRMILYGYTF	TRBV6-5	TRBJ1-2
TGTGCCAGCAGAGTAATCAGGGGGCGGGAGCAAGAGACCCAGTACTTC	CASRVIRGREQETQYF	TRBV27	TRBJ2-5
TGCAGTGCCTCCCCGACTAGCGGTTTGAATGAGCAGTTCTTC	CSASPTSGLNEQFF	TRBV20-1	TRBJ2-1
TGTGCCAGCGCGTGTTGGACTAGCGTCGATACGCAGTATTTT	CASACWTSVDTQYF	TRBV6-4	TRBJ2-3
TGCGCCAGCAGCCAAGAACGGGGCAGAGGTAACGAGCAGTACTTC	CASSQERGRGNEQYF	TRBV4-1	TRBJ2-7
TGTGCCAGCAGCCTCGCCGGACAGGGGGGGGGCGAGCAGTACTTC	CASSLAGQGGGEQYF	TRBV13	TRBJ2-7
TGTGCCAGCAGTGAAGCGCGGGACGGCGAGCAGTACTTC	CASSEARDGEQYF	TRBV6-1	TRBJ2-7
TGTGCCAGCAGCTTTGTGGCTAGCGGGGGCACAGATACGCAGTATTTT	CASSFVASGGTDTQYF	TRBV13	TRBJ2-3
TGTGCCAGCAGCTTAGGTGGACCGGGCGAGGGAGGGTTCTCCCTAGGGGGGGCAGATACGCAGTATTTT	CASSLGGPGEGGFSLGGADTQYF	TRBV7-9	TRBJ2-3
TGTGCCAGCAGCCGAGATCTAGGGACAGGGGGCAATCATTCCTACGAGCAGTACTTC	CASSRDLGTGGNHSYEQYF	TRBV14	TRBJ2-7
TGTGCCAGCAGCTCGGTAACTTCTCGCCCCAACACTGAAGCTTTCTTT	CASSSVTSRPNTEAFF	TRBV7-2	TRBJ1-1
TGTGCTAGTGGTTTGTTCGGTCTCAGGGGACAGGAGGCCCGCTACGAGCAGTACTTC	CASGLFGLRGQEARYEQYF	TRBV12-5	TRBJ2-7
TGTGCCACTCCGGGGGCTCGGAATGAAAAACTGTTTTTT	CATPGARNEKLFF	TRBV6-6	TRBJ1-4
TGTGCCTGGAGACCCCACCTGAAGACTAGGACCAATGAGCAGTTCTTC	CAWRPHLKTRTNEQFF	TRBV30	TRBJ2-1
TGTGCCAGCAGCTATACGGAAGGACCCACTGAAGCTTTCTTT	CASSYTEGPTEAFF	TRBV6-4	TRBJ1-1
TGTGCCAGCAGTTACATCTGGGACAGGGCCTACAATGAGCAGTTCTTC	CASSYIWDRAYNEQFF	TRBV6-3	TRBJ2-1
TGCGCCAGCAGCTTTTCTTCAACGAGCTACGAGCAGTACTTC	CASSFSSTSYEQYF	TRBV5-1	TRBJ2-7
TGTGCCAGCAGTCCAGGACAGGGGGCGGGTTATGGCTACACCTTC	CASSPGQGAGYGYTF	TRBV6-1	TRBJ1-2
TGTGCCACCCCCGGGACAGGGGGCGCCAAAAACATTCAGTACTTC	CATPGTGGAKNIQYF	TRBV24-1	TRBJ2-4
TGTGCTAGTGGTTTGGACGTGGAAACAGCCTACGAGCAGTACTTC	CASGLDVETAYEQYF	TRBV12-5	TRBJ2-7
TGTGCCAGCAGTATAGAAGGCACCGGGGAGCTGTTTTTT	CASSIEGTGELFF	TRBV12-3	TRBJ2-2
TGTGCCAGCAGTCAAAGGGGGAATGAGCAGTTCTTC	CASSQRGNEQFF	TRBV28	TRBJ2-1
TGTGCCAGCAGCTGGGGCGAGGGGGATAGGTCACCCCTCCACTTT	CASSWGEGDRSPLHF	TRBV5-4	TRBJ1-6
TGTGCCACCAGTGATGCACCTCGACTAGCGGGCTATTTCACAGATACGCAGTATTTT	CATSDAPRLAGYFTDTQYF	TRBV24-1	TRBJ2-3
TGTGCCAGCAGCTTAGACTCCCTGGGGGGCGGAAATGAAAAACTGTTTTTT	CASSLDSLGGGNEKLFF	TRBV7-4	TRBJ1-4
TGCGCCAGCGGGCCCAGGAGAGAGACCCAGTACTTC	CASGPRRETQYF	TRBV10-1	TRBJ2-5
TGCGCCAGCAGTGCGTTGACGAGGGTTGGGTGCAATGAGCAGTTCTTC	CASSALTRVGCNEQFF	TRBV10-2	TRBJ2-1
TGTGCCAGCAGTCCCACCAGGGGGGATGCGACTAATGAAAAACTGTTTTTT	CASSPTRGDATNEKLFF	TRBV6-6	TRBJ1-4
TGCGCCAGCAGTGAGCCGAAAGGGACAGGGCGTTATAGCAATCAGCCCCAGCATTTT	CASSEPKGTGRYSNQPQHF	TRBV10-1	TRBJ1-5
TGTGCCAGCAGTTTGGGAAGCTCCTACGAGCAGTACTTC	CASSLGSSYEQYF	TRBV27	TRBJ2-7
TGTGCCAGCAGCTTAGACAAGGGACGAGGAAAGGAGACCCAGTACTTC	CASSLDKGRGKETQYF	TRBV7-9	TRBJ2-5
TGTGCCAGCAGTGGCTGGACAAGCAATCAGCCCCAGCATTTT	CASSGWTSNQPQHF	TRBV7-2	TRBJ1-5
TGTGCCACAGAGGTCACCGGGGAGCTGTTTTTT	CATEVTGELFF	TRBV6-1	TRBJ2-2
TGCGCCACGGGGGCAAGTTTAACTGAGACCCAGTACTTC	CATGASLTETQYF	TRBV10-1	TRBJ2-5
TGTGCCAGCAGAATTCCCACTAGCGGGAGTAACAATGAGCAGTTCTTC	CASRIPTSGSNNEQFF	TRBV11-3	TRBJ2-1
TGTGCCAGCAGCTTACCGAAGTGGAAAGGGGGGCCGATCTATGGCTACACCTTC	CASSLPKWKGGPIYGYTF	TRBV7-9	TRBJ1-2
TGCGCCAGCAGTGACACACTACTAGCGGGCGGGCCGGACAATGAGCAGTTCTTC	CASSDTLLAGGPDNEQFF	TRBV10-1	TRBJ2-1
TGTGCCAGTAGTGGCGGGGGGGGGGGGCTCGAGCAGTACTTC	CASSGGGGGLEQYF	TRBV19	TRBJ2-7
TGTGCCAGCAGCTTAACCGTCGGACGGGAGCAGTACTTC	CASSLTVGREQYF	TRBV11-2	TRBJ2-7
TGCGCCAGCCGTGCGACAGGTAGCCCTCCCAATCAGCCCCAGCATTTT	CASRATGSPPNQPQHF	TRBV10-1	TRBJ1-5
TGTGCCAGCAGTTTGGGCCGGGACAGACCGGGCCAGACAGATACGCAGTATTTT	CASSLGRDRPGQTDTQYF	TRBV27	TRBJ2-3
TGTGCCAGCAGCCCAGGGGTAAGCTCTGGAAACACCATATATTTT	CASSPGVSSGNTIYF	TRBV13	TRBJ1-3
TGTGCCAGCAGCCACAACGGACAGGACTCGGAAAAACTGTTTTTT	CASSHNGQDSEKLFF	TRBV3-1	TRBJ1-4
TGTGCCAGCAGCTTGCGAATGGGGCCCGACTACGAGCAGTACTTC	CASSLRMGPDYEQYF	TRBV7-6	TRBJ2-7
TGTGCCAGCAGTGAAGCACGGGACTGTACGTCCCATGAGCAGTTCTTC	CASSEARDCTSHEQFF	TRBV2	TRBJ2-1
TGTGCCAGCAGCTTGCCCCTAGCGAAGATGACCCAGTACTTC	CASSLPLAKMTQYF	TRBV5-6	TRBJ2-5
TGTGCCAGCAGTACACCCTTGTTTAAGCAGGGCTCTGGAAACACCATATATTTT	CASSTPLFKQGSGNTIYF	TRBV12-3	TRBJ1-3
TGTGCCAGCCCTTGGGGTAAGAAAGCTTTCTTT	CASPWGKKAFF	TRBV6-1	TRBJ1-1
TGTGCCAGCAGCGACAGGGCTGGAAACACCATATATTTT	CASSDRAGNTIYF	TRBV7-3	TRBJ1-3
TGTGCCACCAGCAGGTTAGGGAGCAATGAGCAGTTCTTC	CATSRLGSNEQFF	TRBV15	TRBJ2-1
TGTGCCAGCAGTTGGCGTCTCACAGATACGCAGTATTTT	CASSWRLTDTQYF	TRBV28	TRBJ2-3
TGTGCCAGCAGGGCTTGTCAACAGGGGGGAAGGACTGAAGCTTTCTTT	CASRACQQGGRTEAFF	TRBV27	TRBJ1-1
TGTGCCAGCAGAAGACAGTTTCAGCCCCAGCATTTT	CASRRQFQPQHF	TRBV14	TRBJ1-5
TGTGCCTGGAACCAGAAGTCCGATAGACCCGAAGAGACCCAGTACTTC	CAWNQKSDRPEETQYF	TRBV30	TRBJ2-5
TGTGCCAGCAGCCCAACGACGGCAGATACGCAGTATTTT	CASSPTTADTQYF	TRBV7-8	TRBJ2-3
TGCAGTGCCACATGCGAGGCTGACACTGAAGCTTTCTTT	CSATCEADTEAFF	TRBV20-1	TRBJ1-1
TGTGCCAGCAGAGGGCCCCAAATGAACACTGAAGCTTTCTTT	CASRGPQMNTEAFF	TRBV9	TRBJ1-1
TGTGCCAGCAGCCACAGGGGACCGATCCTTGGAACTAACTATGGCTACACCTTC	CASSHRGPILGTNYGYTF	TRBV13	TRBJ1-2
TGTGCCAGCAGCCGGAGCCTGCGTGGCAATCAGCCCCAGCATTTT	CASSRSLRGNQPQHF	TRBV13	TRBJ1-5
TGTGCTAGCAGCTTAAGGGGAACGGACAGGGGGGAAACTGAAGCTTTCTTT	CASSLRGTDRGETEAFF	TRBV7-7	TRBJ1-1
TGCAGCGTTGAGCCCGGGACACAGCTAGATAGCAATCAGCCCCAGCATTTT	CSVEPGTQLDSNQPQHF	TRBV29-1	TRBJ1-5
TGTGCCAGCAGCCGGACAGGGGGGGAAGAGACCCAGTACTTC	CASSRTGGEETQYF	TRBV6-1	TRBJ2-5
TGTGCCAGCAGCTTAGAGCGAAGCCATGAGCAGTTCTTC	CASSLERSHEQFF	TRBV7-2	TRBJ2-1
TGTGCCAGTAGTCAATCGGCGTTTCCGAACACCGGGGAGCTGTTTTTT	CASSQSAFPNTGELFF	TRBV19	TRBJ2-2
TGTGCCAGCCTCACAAGAAACCACCGTGGGGCCAACGTCCTGACTTTC	CASLTRNHRGANVLTF	TRBV6-6	TRBJ2-6
TGTGCCAGCAAAACAGGCTCCTACGAGCAGTACTTC	CASKTGSYEQYF	TRBV5-4	TRBJ2-7
TGTGCCAGCAGGGGGCCGGTCGAGACGCCAGACGCGGGCCTTTTCACCGGGGAGCTGTTTTTT	CASRGPVETPDAGLFTGELFF	TRBV27	TRBJ2-2
TGTGCCATCCTTTACAGGGTGGCTAATGAAAAACTGTTTTTT	CAILYRVANEKLFF	TRBV6-2	TRBJ1-4
TGCAGCGTAACTGGGACAGGGGGCGCTAACGAAAAACTGTTTTTT	CSVTGTGGANEKLFF	TRBV29-1	TRBJ1-4
TGTGCCAGCAGCCCCCCCGGGACAGGGGGTGGAAACACCATATATTTT	CASSPPGTGGGNTIYF	TRBV13	TRBJ1-3
TGCGCCAGCAGCTCCCGACGTTTTTATTACGAGCAGTACTTC	CASSSRRFYYEQYF	TRBV5-1	TRBJ2-7
TGTGCCAGCAGCAGATTCAGGTCGGACGGACTATCCAATGAGCAGTTCTTC	CASSRFRSDGLSNEQFF	TRBV7-9	TRBJ2-1
TGTGCTCCGGCGTACAATGAGCAGTTCTTC	CAPAYNEQFF	TRBV28	TRBJ2-1
TGTGCCAGCAGTTTTTCCCAGCCCAGCTCCTACGAGCAGTACTTC	CASSFSQPSSYEQYF	TRBV28	TRBJ2-7
TGTGCCACCATCCGACAGGGAATGGACGAGCAGTACTTC	CATIRQGMDEQYF	TRBV24-1	TRBJ2-7
TGCGCCAGCAGTGTTGGGGGACAGCCCCAGCATTTT	CASSVGGQPQHF	TRBV10-1	TRBJ1-5
TGTGCCACCAGCAGGGGGGGGGATGAAAAACTGTTTTTT	CATSRGGDEKLFF	TRBV15	TRBJ1-4
TGTGCCAGGGCGGGACTAGGCTACGAGCAGTACTTC	CARAGLGYEQYF	TRBV27	TRBJ2-7
TGTGCCAGCAGCTTAGAGAGACCGGGGCGGGAGGGGGGTGCCCAGGAGACCCAGTACTTC	CASSLERPGREGGAQETQYF	TRBV7-2	TRBJ2-5
TGCGCCAGCCAATACGCCTACGAGCAGTACTTC	CASQYAYEQYF	TRBV5-1	TRBJ2-7
TGTGCCAGCATTACCCGGTCAGTACACGAGCAGTACTTC	CASITRSVHEQYF	TRBV2	TRBJ2-7
TGTGCCAGCAGGACCTGGGGAGGGAGACACTATGGCTACACCTTC	CASRTWGGRHYGYTF	TRBV12-3	TRBJ1-2
TGTGCCAGCAGTGACTCAGACAGGGGGCGGGCCTATGGCTACACCTTC	CASSDSDRGRAYGYTF	TRBV6-4	TRBJ1-2
TGTGCCAGCAGCCAGGAAGAGGGGACTGAAGCTTTCTTT	CASSQEEGTEAFF	TRBV7-8	TRBJ1-1
TGTGCCAGCAGCATCCCGGGACTAGCGGGAGCGGGGGCCAACGTCCTGACTTTC	CASSIPGLAGAGANVLTF	TRBV13	TRBJ2-6
TGTGCCAGCAGTCTGAAAAGAGGCGGCTCTGGAAACACCATATATTTT	CASSLKRGGSGNTIYF	TRBV27	TRBJ1-3
TGTGCCAGCAGCCAGGCCAGGGGAATCGAGCAGTACTTC	CASSQARGIEQYF	TRBV3-1	TRBJ2-7
TGTGCCAGCAGTATAGGCATGATAAGACAGGGACAGTTTAGCAATCAGCCCCAGCATTTT	CASSIGMIRQGQFSNQPQHF	TRBV6-4	TRBJ1-5
TGCGCCAGCAGCTTGCTTAGCGGGAAGGAAAAACCTGTCCATTTATCGCAGTATTTT	CASSLLSGKEKPVHLSQYF	TRBV5-1	TRBJ2-3
TGTGCCAGCAGCTTAGATTCGTGGGCCCGGGGGCAGAACACTGAAGCTTTCTTT	CASSLDSWARGQNTEAFF	TRBV9	TRBJ1-1
TGTGCCAGCTTTCGCAGGGTCGGTAGTCCCGTAAACACTGAAGCTTTCTTT	CASFRRVGSPVNTEAFF	TRBV11-3	TRBJ1-1
TGTGCTAGCAGCTTAAGTAAAGGTGAAGGGGAGCTGTTTTTT	CASSLSKGEGELFF	TRBV7-7	TRBJ2-2
TGTGCCAGCAGCCAGATGACAGGGGGCCGGTATGGCTACACCTTC	CASSQMTGGRYGYTF	TRBV14	TRBJ1-2
TGTGCCAGCAGTTTATCCGGGGGGCCATTCAATGAGCAGTTCTTC	CASSLSGGPFNEQFF	TRBV27	TRBJ2-1
TGCGCCAGCAGTGCCGGGGGTTATGATCAGCCCCAGCATTTT	CASSAGGYDQPQHF	TRBV10-1	TRBJ1-5
TGTGCCAGCCCAGGAACGAGTCAGGGGGAGGGATGCACAGATACGCAGTATTTT	CASPGTSQGEGCTDTQYF	TRBV6-4	TRBJ2-3
TGTGCCAGCAGCTTAGCTACATATGAGCTACGCACCGGGGAGCTGTTTTTT	CASSLATYELRTGELFF	TRBV7-8	TRBJ2-2
TGTGCCAGTAGTGGGACGGGCACAGATACGCAGTATTTT	CASSGTGTDTQYF	TRBV19	TRBJ2-3
TGTGCCAGCAGCATCGGGCAGGTAGAGCAGTTCTTC	CASSIGQVEQFF	TRBV7-9	TRBJ2-1
TGTGCCAGCAGCCAGCGCCCCCGTCAGAACTATGGCTACACCTTC	CASSQRPRQNYGYTF	TRBV4-2	TRBJ1-2
TGTGCCAGCTCACCACGTAAGGGGAAGGGAGTTCGCTCGTCTGGCTACACCTTC	CASSPRKGKGVRSSGYTF	TRBV18	TRBJ1-2
TGTGCCAGCAGTAGCACAAGGATTGCTTACTACGAGCAGTACTTC	CASSSTRIAYYEQYF	TRBV6-5	TRBJ2-7
TGTGCCAGCAGCTGCCGAGGACAGGAGTACAAATTAGCCAAAAACATTCAGTACTTC	CASSCRGQEYKLAKNIQYF	TRBV13	TRBJ2-4
TGTGCCTACCCGAAGAGGGACAGGGCTGAAGCTTTCTTT	CAYPKRDRAEAFF	TRBV27	TRBJ1-1
TGCGCCAGCAGCCAAGATCCCCTAGGTAATCGGGGGCTCACAGATACGCAGTATTTT	CASSQDPLGNRGLTDTQYF	TRBV4-1	TRBJ2-3
TGTGCCAGCAGCTTAGACATCGGCTACGAGCAGTACTTC	CASSLDIGYEQYF	TRBV7-3	TRBJ2-7
TGTGCCAGCTCACCATCACTACGGGACAGGGGGCGCCCGCATTCACTCTCACAGAAGGGGAATACACGCACAGATACGCAGTATTTT	CASSPSLRDRGRPHSLSQKGNTRTDTQYF	TRBV18	TRBJ2-3
TGTGCCAGCAGTCAATATAGCAATCAGCCCCAGCATTTT	CASSQYSNQPQHF	TRBV6-6	TRBJ1-5
TGTGCCAGATCCGACAGGGAAGAAGGCGATAGCAATCAGCCCCAGCATTTT	CARSDREEGDSNQPQHF	TRBV6-5	TRBJ1-5
TGTGCCAGCAGAAAGCCCTCTAGGGAGGATCAGCCCCAGCATTTT	CASRKPSREDQPQHF	TRBV27	TRBJ1-5
TGTGCCACCAGCTTGGGGGTTTGCGAGCAGTACTTC	CATSLGVCEQYF	TRBV15	TRBJ2-7
TGCAGTGCCCTAATCTGCCGGGACAGGGGATCCCAAGAGACCCAGTACTTC	CSALICRDRGSQETQYF	TRBV20-1	TRBJ2-5
TGTGCCAAGCCTCATCCTGGGGGTGACAATCAGCCCCAGCATTTT	CAKPHPGGDNQPQHF	TRBV10-3	TRBJ1-5
TGTGCCAGCAGCCAAGAGCCTAGCGGGAAGGACAATGAGCAGTTCTTC	CASSQEPSGKDNEQFF	TRBV14	TRBJ2-1
TGTGCCAGCAGAAGCGGAGACGAGCAGTACTTC	CASRSGDEQYF	TRBV27	TRBJ2-7
TGTGCCAGATCAGATGGGGCTGATACGCAGTATTTT	CARSDGADTQYF	TRBV5-4	TRBJ2-3
TGTGCCAGCAGTGGCTCGAGGGTAGGTAAAGCTTTCTTT	CASSGSRVGKAFF	TRBV6-3	TRBJ1-1
TGTGCCAGTAGTATTAGGGAGGTCATCACCGGGGAGCTGTTTTTT	CASSIREVITGELFF	TRBV19	TRBJ2-2
TGTGCCAGCAGTCCCCTAGCGGGGGGGAGCACAGATACGCAGTATTTT	CASSPLAGGSTDTQYF	TRBV27	TRBJ2-3
TGCAGTGCTTGGAGGGGGTACGAGCAGTACTTC	CSAWRGYEQYF	TRBV20-1	TRBJ2-7
TGTGCCAACCCTGCAGGGCCCCAGCATTTT	CANPAGPQHF	TRBV9	TRBJ1-5
TGTGCCAGCAGCACTAGACAGTCTGGGTACGAGCAGTACTTC	CASSTRQSGYEQYF	TRBV7-3	TRBJ2-7
TGTGCCAGCAGGGACAGGGGGCAGAGTGGTTCCGAGCAGTACTTC	CASRDRGQSGSEQYF	TRBV6-5	TRBJ2-7
TGTGCCAGCAGCTTATGTAGAGGGCATGAGCAGTTCTTC	CASSLCRGHEQFF	TRBV7-2	TRBJ2-1
TGCGCCAGCAGCTGGGGGGACAGTATTGCTGAAGCTTTCTTT	CASSWGDSIAEAFF	TRBV5-1	TRBJ1-1
TGTGCCAGCAGACGCGGAGGGGACGAGCAGTACTTC	CASRRGGDEQYF	TRBV7-6	TRBJ2-7
TGTGCCAGCAGTGCCGGGACAGTACCTGAAGCTTTCTTT	CASSAGTVPEAFF	TRBV6-4	TRBJ1-1
TGCAGTAAGTGGATGGGACAGCAGGAGCAGTTCTTC	CSKWMGQQEQFF	TRBV20-1	TRBJ2-1
TGTGCCAGCAGGGACGCACAGGGCGCTTACGAGCAGTACTTC	CASRDAQGAYEQYF	TRBV27	TRBJ2-7
TGTGCCAGCAGTGGGAGGAACACTGAAGCTTTCTTT	CASSGRNTEAFF	TRBV6-1	TRBJ1-1
TGTGCTAGCAGCGGGGACAGGGGGCCCCCCAATCAGCCCCAGCATTTT	CASSGDRGPPNQPQHF	TRBV7-7	TRBJ1-5
TGTGTATTCCGGGACAGGGGAGTCTACGAGCAGTACTTC	CVFRDRGVYEQYF	TRBV4-2	TRBJ2-7
TGTGCCAGCAGCCACCCGGGACCGAGGTCCGAAAAACTGTTTTTT	CASSHPGPRSEKLFF	TRBV11-2	TRBJ1-4
TGTGCCAGCAGCCCCCGTGGTAGACTTAAAGAGACCCAGTACTTC	CASSPRGRLKETQYF	TRBV14	TRBJ2-5
TGTGCCAGCAGAGTAGGTGGGACAGGAGGCGAGCAGTACTTC	CASRVGGTGGEQYF	TRBV14	TRBJ2-7
TGTGCCAGCAGCTTAGCGAGGACAGCTTCAAACACTGAAGCTTTCTTT	CASSLARTASNTEAFF	TRBV7-9	TRBJ1-1
TGTGCCAGCAGCTATTGGGACGTTGAAGCTTTCTTT	CASSYWDVEAFF	TRBV5-4	TRBJ1-1
TGTGCCAGCAGTCTCTGGCCTCTCTATGGCTACACCTTC	CASSLWPLYGYTF	TRBV6-4	TRBJ1-2
TGCGCCAGCAGTGCGGGTACTAGCGGGAGGCCGAACTACGAGCAGTACTTC	CASSAGTSGRPNYEQYF	TRBV10-1	TRBJ2-7
TGTGCCAGCAGCAGGCATCAGATAAACATTCAGTACTTC	CASSRHQINIQYF	TRBV5-6	TRBJ2-4
TGTGCCAGCAGTTTATTGGGGGCGCCAGATAATTCACCCCTCCACTTT	CASSLLGAPDNSPLHF	TRBV6-5	TRBJ1-6
TGTGCCAGCAGCTTAGCGGGCTGCTCCTACGAGCAGTACTTC	CASSLAGCSYEQYF	TRBV7-2	TRBJ2-7
TGTGCCAGCAGCTTGGAACCGGGGGGGGGGAACTACAATGAGCAGTTCTTC	CASSLEPGGGNYNEQFF	TRBV5-6	TRBJ2-1
TGTGCCAGCAGCCAAGATGAGAGGGGGCTCCCCAATGAGCAGTTCTTC	CASSQDERGLPNEQFF	TRBV3-1	TRBJ2-1
TGCAGTGCCAGCGGGAGGCGGTCCAATCAGCCCCAGCATTTT	CSASGRRSNQPQHF	TRBV20-1	TRBJ1-5
TGTGCCACCCACCGTTTAACTAGCGGGGCATCCACCGGGGAGCTGTTTTTT	CATHRLTSGASTGELFF	TRBV24-1	TRBJ2-2
TGTGCCAGCAATACTCCACGGCTATATGGCTACACCTTC	CASNTPRLYGYTF	TRBV6-4	TRBJ1-2
TGTGCCATCACCCGGCTGAGACTCATGAACACTGAAGCTTTCTTT	CAITRLRLMNTEAFF	TRBV10-3	TRBJ1-1
TGTGGGAGTACAGCCGAGTCTGGGGCCAACGTCCTGACTTTC	CGSTAESGANVLTF	TRBV6-4	TRBJ2-6
TGTGGTACGACGGAAGCCGGGGAGCTGTTTTTT	CGTTEAGELFF	TRBV27	TRBJ2-2
TGTGCCAGCAGTGAAGGTCCACAGAGGTGGGAGAACACTGAAGCTTTCTTT	CASSEGPQRWENTEAFF	TRBV6-1	TRBJ1-1
TGTGCCAGCAGTGGCAGTGGGAGGGGTAACACTGAAGCTTTCTTT	CASSGSGRGNTEAFF	TRBV28	TRBJ1-1
TGTGCCAGCAGCCAAGCCATAGGACATAGGTGGGAAAGCAATCAGCCCCAGCATTTT	CASSQAIGHRWESNQPQHF	TRBV3-1	TRBJ1-5
TGTGCCAGTAGTATTACTCCGACAGGGGTGAACACTGAAGCTTTCTTT	CASSITPTGVNTEAFF	TRBV19	TRBJ1-1
TGTGCCACCAGCAGGAACCGACGCTGCTACGAGCAGTACTTC	CATSRNRRCYEQYF	TRBV15	TRBJ2-7
TGTGCCAGCAGCGAAGGTGTACAGGTCGGGGAGGTAGAGACCCAGTACTTC	CASSEGVQVGEVETQYF	TRBV7-3	TRBJ2-5
TGTGCCAGCAGACAGGACAGGGTCTGGACTGAAGCTTTCTTT	CASRQDRVWTEAFF	TRBV5-4	TRBJ1-1
TGTGCCAGCAGTGAAGTCCCTTTCGGGACAGGAGACACCATATATTTT	CASSEVPFGTGDTIYF	TRBV2	TRBJ1-3
TGTGCCAGCAGCGAAAGCCGCGGGGGGAGTAGGAGCTCCTACAATGAGCAGTTCTTC	CASSESRGGSRSSYNEQFF	TRBV7-2	TRBJ2-1
TGTGCCAGCAGTGGCTATAAGGGATATCAGCCCCAGCATTTT	CASSGYKGYQPQHF	TRBV28	TRBJ1-5
TGTGCCAGCAGTTCCATCCAGAGGTTAACCTACGAGCAGTACTTC	CASSSIQRLTYEQYF	TRBV27	TRBJ2-7
TGTGCCAGCAGTGAGGGGGGGCAAGAGACCCAGTACTTC	CASSEGGQETQYF	TRBV7-9	TRBJ2-5
TGTGCCAGCAGTGGCGGGAGTCTAGGACTAGCGGGGGGTTTGGCTCGAGGTTTTGATACGCAGTATTTT	CASSGGSLGLAGGLARGFDTQYF	TRBV6-1	TRBJ2-3
TGTGCCAGCAGTTACTCCGGGGCCCGGACAGGGAACACCGGGGAGCTGTTTTTT	CASSYSGARTGNTGELFF	TRBV6-2	TRBJ2-2
TGCGCCAGCCGGACCATCACAGGGTCGATCAATGAGCAGTTCTTC	CASRTITGSINEQFF	TRBV4-1	TRBJ2-1
TGCAGTGCTGATCGGAGGGACTTC	CSADRRDF	TRBV20-1	TRBJ2-7
TGTGCCAGCAGCGTAGGCCACCCGCCGAGGATCTTAAAGAGCTCCTACAATGAGCAGTTCTTC	CASSVGHPPRILKSSYNEQFF	TRBV9	TRBJ2-1
TGCGCCAGCAGACCAGGGGCCGGTGAAAAACTGTTTTTT	CASRPGAGEKLFF	TRBV10-1	TRBJ1-4
TGCGCCAACCCAAGGACAGACGTCACTGAAGCTTTCTTT	CANPRTDVTEAFF	TRBV10-2	TRBJ1-1
TGCAGTGCTAGAATCAGGTACCCCAGGAGGGGGAGCTCCTACAATGAGCAGTTCTTC	CSARIRYPRRGSSYNEQFF	TRBV20-1	TRBJ2-1
TGTGCCAGCAGTTTCTACAGGGTATTAAACATTCAGTACTTC	CASSFYRVLNIQYF	TRBV28	TRBJ2-4
TGTGCCAGCAGCCGGCAAGGGGCCCAAGAGACCCAGTACTTC	CASSRQGAQETQYF	TRBV7-3	TRBJ2-5
TGTGCCACCAGGAGTCCTGATAAGTCAAGAGAGACCCAGTACTTC	CATRSPDKSRETQYF	TRBV24-1	TRBJ2-5
TGTGCCAGCAGCGATTCAATGTCCGTCACGGGGGATGACAATTCACCCCTCCACTTT	CASSDSMSVTGDDNSPLHF	TRBV7-9	TRBJ1-6
TGTGCCAGCAGCGCGACAGGGAACTCCTACGAGCAGTACTTC	CASSATGNSYEQYF	TRBV6-4	TRBJ2-7
TGTGCCAGCAGCTGGCAGCAGGAACCTAGAACCTATGGCTACACCTTC	CASSWQQEPRTYGYTF	TRBV11-2	TRBJ1-2
TGTGCCAGCATTCCCCCGAGCGGGAGAGTCTATGGCTACACCTTC	CASIPPSGRVYGYTF	TRBV9	TRBJ1-2
TGTGCCAGCAGCCAGGACAGAGCGGAGGCCCTCCACTTT	CASSQDRAEALHF	TRBV5-6	TRBJ1-6
TGTGCCAGCAGCTTGCCGAGACAGCCCCAGCATTTT	CASSLPRQPQHF	TRBV5-6	TRBJ1-5
TGTGCCAGCAGCCGGGGCAGGGGGGCTTGCAGCTCCTACGAGCAGTACTTC	CASSRGRGACSSYEQYF	TRBV7-4	TRBJ2-7
TGTGCCAGCAACGTAGACCTGACACCTGGAAACACCATATATTTT	CASNVDLTPGNTIYF	TRBV27	TRBJ1-3
TGCGCCAGCAGCTTGGAGAAGACAGGGGGCACAGATACGCAGTATTTT	CASSLEKTGGTDTQYF	TRBV5-1	TRBJ2-3
TGCAGTGCTAGGGGAGGAAGCCCGGACAGGGAGGTGTCCTACGAGCAGTACTTC	CSARGGSPDREVSYEQYF	TRBV20-1	TRBJ2-7
TGTGCCAGCAGTGAAACCCGGGACAGTCAGTTCACTGAAGCTTTCTTT	CASSETRDSQFTEAFF	TRBV6-1	TRBJ1-1
TGCCCTGCCCCCGGCCCGGAGACCGGGGAGCTGTTTTTT	CPAPGPETGELFF	TRBV5-1	TRBJ2-2
TGTGCCAGCAGCACGCAGGGGGCATATTCTCGTGGCCCTAGCACAGATACGCAGTATTTT	CASSTQGAYSRGPSTDTQYF	TRBV5-4	TRBJ2-3
TGTGCCAGCTCACCACCCGCAGGGGGGGGGGGCTCCTACAATGAGCAGTTCTTC	CASSPPAGGGGSYNEQFF	TRBV18	TRBJ2-1
TGTGCCAGCAGCCGGAGGGGGGGAGGAGCTTTCTTT	CASSRRGGGAFF	TRBV4-2	TRBJ1-1
TGTGCCAGCAGCTACAGTAACGGACAGGGTTCTAACTATGGCTACACCTTC	CASSYSNGQGSNYGYTF	TRBV7-3	TRBJ1-2
TGTGCCAGCAGCCAAGGCTCAGGGATCAATGGAGAAAAACTGTTTTTT	CASSQGSGINGEKLFF	TRBV3-1	TRBJ1-4
TGTGCCATCACTAGTGGGGATGAGCAGTTCTTC	CAITSGDEQFF	TRBV7-8	TRBJ2-1
TGTGCCAGCAGCGCAAGCGGGATAAGTTCCGGGGAGCTGTTTTTT	CASSASGISSGELFF	TRBV7-4	TRBJ2-2
TGTGCCAGCAGCGTCTCTGGGGAGAGAGGTCAGCCCCAGCATTTT	CASSVSGERGQPQHF	TRBV7-3	TRBJ1-5
TGTGCCAGCAGCCAAGATAATCCGGGACTAGGGGATACGCAGTATTTT	CASSQDNPGLGDTQYF	TRBV3-1	TRBJ2-3
TGTGCCTGGGCACGACAATTGGGCTACACCTTC	CAWARQLGYTF	TRBV30	TRBJ1-2
TGTGCCAGCAGCTCCCAGCGCAAAAAACCTAGGCTCACAGATACGCAGTATTTT	CASSSQRKKPRLTDTQYF	TRBV5-8	TRBJ2-3
TGCGCCAGCAGCTTAGGCGGGAGTGATTTACGCTCCTACGAGCAGTACTTC	CASSLGGSDLRSYEQYF	TRBV5-1	TRBJ2-7
TGTGCCACCAGGCTGGGCGCAGATACGCAGTATTTT	CATRLGADTQYF	TRBV6-2	TRBJ2-3
TGTGCTAGTGGTTCCCCCGGACAGGGGGTGGAGGGGAATACGCAGTATTTT	CASGSPGQGVEGNTQYF	TRBV12-5	TRBJ2-3
TGTGCCTGGAAGCTCTGTCTCCGCACTGAAGCTTTCTTT	CAWKLCLRTEAFF	TRBV30	TRBJ1-1
TGTGCCAGCAGCCCTAGCCCGGGAGGCTGTGAGCAGTACTTC	CASSPSPGGCEQYF	TRBV3-1	TRBJ2-7
TGTGCCAGCAGTGACAACTGGGGGGGTTCTGAAGCTTTCTTT	CASSDNWGGSEAFF	TRBV6-1	TRBJ1-1
TGTGCCAGCAGTGAATTTCGGACCGGGGAGCTGTTTTTT	CASSEFRTGELFF	TRBV2	TRBJ2-2
TGTGCCAGCAGTTTCCCGGGGTCCTATGGCTACACCTTC	CASSFPGSYGYTF	TRBV27	TRBJ1-2
TGTGCCATCAGAGAAGGCAGCGGCTTGACGACTGAAGCTTTCTTT	CAIREGSGLTTEAFF	TRBV10-3	TRBJ1-1
TGTGCCAGCAGCTTAGACAGGATGCCTGGTGAGCAGTTCTTC	CASSLDRMPGEQFF	TRBV7-8	TRBJ2-1
TGTGCCAGCAGCTTAGGTGCAGGTTACTATGGCTACACCTTC	CASSLGAGYYGYTF	TRBV7-7	TRBJ1-2
TGTGCCAGCTCTAGCGGGAAATCCAGCTCTGGGGCCAACGTCCTGACTTTC	CASSSGKSSSGANVLTF	TRBV7-4	TRBJ2-6
TGTGCCAGCAGCCAATTCCGGACAGGCCGGGGGCTACTTAACACTGAAGCTTTCTTT	CASSQFRTGRGLLNTEAFF	TRBV14	TRBJ1-1
TGTGCCAGCAGCCAAGAGGGGCGCGCTTTCTTT	CASSQEGRAFF	TRBV14	TRBJ1-1
TGTGCCAGCAGTGGGGGTTTTGAGCAGTACTTC	CASSGGFEQYF	TRBV6-1	TRBJ2-7
TGTGCCAGCAGCCTAACAAGTGATAGCAATCAGCCCCAGCATTTT	CASSLTSDSNQPQHF	TRBV5-4	TRBJ1-5
TGTGCCAGCAGCTTGCCCTGGGAGGGCATCGACCAGTACTTC	CASSLPWEGIDQYF	TRBV5-6	TRBJ2-5
TGTGGCTTGGCTCCTCGGCCTACAGGGACGCTCACTGAAGCTTTCTTT	CGLAPRPTGTLTEAFF	TRBV7-9	TRBJ1-1
TGTGCCGACAGGGTTTCACCCCTCCACTTT	CADRVSPLHF	TRBV28	TRBJ1-6
TGCAGTGTTGGACAGGGGGGTGCTTTCTTT	CSVGQGGAFF	TRBV20-1	TRBJ1-1
TGTGCTAGTGGTTATGGAAATAAATACGAGCAGTACTTC	CASGYGNKYEQYF	TRBV12-5	TRBJ2-7
TGTGCTAGCAGCTTATCCCGTCCCAGGGCCCCTAGAAGCACAGATACGCAGTATTTT	CASSLSRPRAPRSTDTQYF	TRBV7-7	TRBJ2-3
TGCAGCGTTGGGTCCTTACTAGCGGGAGTTAGGGCCAAAAACATTCAGTACTTC	CSVGSLLAGVRAKNIQYF	TRBV29-1	TRBJ2-4
TGTGCCAGCAGGGTAGGGCAGTACTTC	CASRVGQYF	TRBV6-8	TRBJ2-7
TGTGCCAGCTCACCACCAGGGTTCTATGGCTACACCTTC	CASSPPGFYGYTF	TRBV18	TRBJ1-2
TGTGCCAGCAAATACCCGGGACCGTTAGAACAAGAGACCCAGTACTTC	CASKYPGPLEQETQYF	TRBV6-1	TRBJ2-5
TGTGCCAGCAGTTTAGGGGGCTGGAACGTGGGATATGGCTACACCTTC	CASSLGGWNVGYGYTF	TRBV6-1	TRBJ1-2
TGTGCCAGCAGCCAGGCAGACAAAAACATTCAGTACTTC	CASSQADKNIQYF	TRBV14	TRBJ2-4
TGCAGCGTTGAAAGGCAGGGCAGGGACACTGAAGCTTTCTTT	CSVERQGRDTEAFF	TRBV29-1	TRBJ1-1
TGTGCCAGCAGCGAGGGCGGGACAGGGCCGGAAGAGACCCAGTACTTC	CASSEGGTGPEETQYF	TRBV7-3	TRBJ2-5
TGTGCCACCAGTGATTCATGGGCGTTAAGACAGGGTTGTAGGGTGGGGAGTCATCAGCCCCAGCATTTT	CATSDSWALRQGCRVGSHQPQHF	TRBV24-1	TRBJ1-5
TGCGCCAGCAGTGGTACACAGGGGGGAAATTCACCCCTCCACTTT	CASSGTQGGNSPLHF	TRBV10-1	TRBJ1-6
TGTGCCAGCTCACCATTCCTAAGTTACGGTCCATATACCTCCTACGAGCAGTACTTC	CASSPFLSYGPYTSYEQYF	TRBV18	TRBJ2-7
TGTGCCATCAGGAACGGGAGGGCTTACGAGCAGTACTTC	CAIRNGRAYEQYF	TRBV10-3	TRBJ2-7
TGTGCCAGCAGCGTAGCCGTCCAAAATCAGCCCCAGCATTTT	CASSVAVQNQPQHF	TRBV9	TRBJ1-5
TGCGCCAGCAGCCAAGACCCTAGCGGTGCTGGTGAGCAGTTCTTC	CASSQDPSGAGEQFF	TRBV4-1	TRBJ2-1
TGTGCCAGCAGCGCCGTGTCGGGACAGCAGGGGAACACTGAAGCTTTCTTT	CASSAVSGQQGNTEAFF	TRBV7-3	TRBJ1-1
TGTGCCAGCAGTGATGGCCTTAGGCCCGGGGAGCTGTTTTTT	CASSDGLRPGELFF	TRBV6-4	TRBJ2-2
TGCAGTGCTAGAGATACATTCCGGGACAGGGTCTCTGGGGCCAACGTCCTGACTTTC	CSARDTFRDRVSGANVLTF	TRBV20-1	TRBJ2-6
TGTGCCAGCAGTCCCTGGGACAGGGGGGTACAGCAGCCCCAGCATTTT	CASSPWDRGVQQPQHF	TRBV12-3	TRBJ1-5
TGTGCCAGCAGTGCTCTCCCTGGACAGCCGGGCTACGAGCAGTACTTC	CASSALPGQPGYEQYF	TRBV6-4	TRBJ2-7
TGCAGTGCTCGACTCCATAGAACTTACGAGCAGTACTTC	CSARLHRTYEQYF	TRBV20-1	TRBJ2-7
TGCAGTGCTACCCTCCCGGGGGGGCAGCGATCCTACGAGCAGTACTTC	CSATLPGGQRSYEQYF	TRBV20-1	TRBJ2-7
TGTGCCAGCAGTTACCGGCTCCTTCCGGGACTAGCGGGAGTGGGAGTAGAGACCCAGTACTTC	CASSYRLLPGLAGVGVETQYF	TRBV6-3	TRBJ2-5
TGTGCCAGCAGAACCTCGGACCCCCACTCCTCTGGGGCCAACGTCCTGACTTTC	CASRTSDPHSSGANVLTF	TRBV9	TRBJ2-6
TGCGCCAGCAAGCGGATTAGATACGAGCAGTACTTC	CASKRIRYEQYF	TRBV10-2	TRBJ2-7
TGTGCCAGCAGCGGAGAGCCGAATGAGCAGTTCTTC	CASSGEPNEQFF	TRBV7-3	TRBJ2-1
TGCAGTGCTAGATTTAATCCGATGGACAGGGGAGAGCAGTACTTC	CSARFNPMDRGEQYF	TRBV20-1	TRBJ2-7
TGTGCCAGCAGCCAAGATAAAGTACAGTCTGGGGCCAACGTCCTGACTTTC	CASSQDKVQSGANVLTF	TRBV3-1	TRBJ2-6
TGTGCCAGCATAGGGGGGTTAACGAACACCGGGGAGCTGTTTTTT	CASIGGLTNTGELFF	TRBV9	TRBJ2-2
TGTGCCAGCAGCGGTAGAACCTCCAGCTCCTACAATGAGCAGTTCTTC	CASSGRTSSSYNEQFF	TRBV11-1	TRBJ2-1
TGCGCCAGCAGCCAAGATTTGGCGACAGGGGGCCCTGGGGACCTCTGCTCTGGGGCCAACGTCCTGACTTTC	CASSQDLATGGPGDLCSGANVLTF	TRBV4-1	TRBJ2-6
TGTGCCAGCAGCACCCTCCCGCTCGTTACAGGGATATTCTTCGGCTACACCTTC	CASSTLPLVTGIFFGYTF	TRBV13	TRBJ1-2
TGTGCCAGCAGCTTATCCGGGGGCCCTCCCGATACGCAGTATTTT	CASSLSGGPPDTQYF	TRBV7-6	TRBJ2-3
TGTGCCAGCAGTGAATTAAAAGACCGGCCGGACGGGGATGGCTACACCTTC	CASSELKDRPDGDGYTF	TRBV25-1	TRBJ1-2
TGTGCCGGGAGGAACACTGAAGCTTTCTTT	CAGRNTEAFF	TRBV15	TRBJ1-1
TGTGCCAGCAGCTTGGGAAACAGGGGGGCTTGTCCCATAGGCTACGAGCAGTACTTC	CASSLGNRGACPIGYEQYF	TRBV5-4	TRBJ2-7
TGTGCCAGCAGCATTAGGGGAAGTGTCGACAGGGCCTGGGGCTACGAGCAGTACTTC	CASSIRGSVDRAWGYEQYF	TRBV13	TRBJ2-7
TGTGCCACGAGGGGACTAGGGGGGGGGGATGAGCAGTTCTTC	CATRGLGGGDEQFF	TRBV24-1	TRBJ2-1
TGTGCCAGCAGCCAAGAGGGGACAGGCTACACCTTC	CASSQEGTGYTF	TRBV14	TRBJ1-2
TGTGCCAGCACCATTGGAAACCGGGACAGGGGAACAGATACGCAGTATTTT	CASTIGNRDRGTDTQYF	TRBV4-2	TRBJ2-3
TGCGCCAGCATGACTAGCGGGCCGTACCAAGAGACCCAGTACTTC	CASMTSGPYQETQYF	TRBV10-2	TRBJ2-5
TGTGCCAGCAGCTCTCAGGGCCTAGGTCAGGGGGTCCACTATGGCTACACCTTC	CASSSQGLGQGVHYGYTF	TRBV7-9	TRBJ1-2
TGTGCCAGCAGGCGTAGCACAGATACGCAGTATTTT	CASRRSTDTQYF	TRBV7-2	TRBJ2-3
TGTGCCAGCAGCTCCCCACAGGGTTCAAACTACGAGCAGTACTTC	CASSSPQGSNYEQYF	TRBV13	TRBJ2-7
TGTGCCAGCAAGGGGTTGGGACAGGGGCCCTTTCAGCCCCAGCATTTT	CASKGLGQGPFQPQHF	TRBV2	TRBJ1-5
TGTGCCAGCAGGCTTGCTGGGCTCTATGGCTACACCTTC	CASRLAGLYGYTF	TRBV6-2	TRBJ1-2
TGTGCCAGTAGTGCAAACAGGGATGAGCAGTTCTTC	CASSANRDEQFF	TRBV19	TRBJ2-1
TGTGCCAGCCAAAAAACACATACCCCGCGGGCCAAAAACATTCAGTACTTC	CASQKTHTPRAKNIQYF	TRBV6-4	TRBJ2-4
TGCAGCCCCGGGACAGTCCTTGCAAACACTGAAGCTTTCTTT	CSPGTVLANTEAFF	TRBV29-1	TRBJ1-1
TGTGCCAGCAGTTACACAGGGGGCAATCAGCCCCAGCATTTT	CASSYTGGNQPQHF	TRBV6-5	TRBJ1-5
TGTGCCAGTAGTATAGAGAGCGGGAGGAGAATCTACAATGAGCAGTTCTTC	CASSIESGRRIYNEQFF	TRBV19	TRBJ2-1
TGTGCCAGCAGCCAAGGCGGCCCCCTGGGCCAGGAGCAGTACTTC	CASSQGGPLGQEQYF	TRBV4-2	TRBJ2-7
TGTGCCAGCAGCAACAAGGCGGCTGACGGAGTGAACACTGAAGCTTTCTTT	CASSNKAADGVNTEAFF	TRBV14	TRBJ1-1
TGTGCCAGCAGTTGTTTTTTTGAAATCTTC	CASSCFFEIF	TRBV6-1	TRBJ2-7
TGTGCCAGCAGCTACCAGACCCTCGAAGGGTTTAACTATGGCTACACCTTC	CASSYQTLEGFNYGYTF	TRBV7-3	TRBJ1-2
TGTGCCAGCAGCGGCCCGCCCCGAGGCACCAACATTCAGTACTTC	CASSGPPRGTNIQYF	TRBV7-9	TRBJ2-4
TGTGCCAGCAGTAAAGCCTCTGGGGCCAACGTCCTGACTTTC	CASSKASGANVLTF	TRBV28	TRBJ2-6
TGTGCCTGGAGAGTTATGACGGTAGCCTACGAGCAGTACTTC	CAWRVMTVAYEQYF	TRBV30	TRBJ2-7
TGTGCCAGTCCGCCGGGACCTCGGACTGGAAACACCATATATTTT	CASPPGPRTGNTIYF	TRBV19	TRBJ1-3
TGTGCCAGCAGGTCAGGTGGGGGGTTAAGGTACGAGCAGTACTTC	CASRSGGGLRYEQYF	TRBV7-3	TRBJ2-7
TGTGCCAGCAGCCAAGATGCTCAGGGTGAGCAGTTCTTC	CASSQDAQGEQFF	TRBV4-2	TRBJ2-1
TGTGCCAGCAGCCGTCACAGGGAAATTCCCGGAAACACCATATATTTT	CASSRHREIPGNTIYF	TRBV3-1	TRBJ1-3
TGTGCCAGTAGTACCAGGGGAGAGAATAGCAATCAGCCCCAGCATTTT	CASSTRGENSNQPQHF	TRBV19	TRBJ1-5
TGCGCCAGCAGCCACCCTGCAGCCGGGGTAGGGGTGGAAAAACTGTTTTTT	CASSHPAAGVGVEKLFF	TRBV4-1	TRBJ1-4
TGCGCCAGCAGGAGAGTACTTTCTTGGGGGCTCCCTTCTGGGGGACTGGGCAATCAGCCCCAGCATTTT	CASRRVLSWGLPSGGLGNQPQHF	TRBV10-1	TRBJ1-5
TGCGCCAGCAGCTTCATCCCAAGGGGGTACAATGAGCAGTTCTTC	CASSFIPRGYNEQFF	TRBV5-1	TRBJ2-1
TGTGCCAGCACCCCTGGGGGGCCCCACTACAATGAGCAGTTCTTC	CASTPGGPHYNEQFF	TRBV25-1	TRBJ2-1
TGTGCCAGCAGCTTAGAGGGGGGAGCCTACGAGCAGTACTTC	CASSLEGGAYEQYF	TRBV7-3	TRBJ2-7
TGTGCCATCAGCGGTTCTTTCACCGGGACAGTCGCTTACACTGAAGCTTTCTTT	CAISGSFTGTVAYTEAFF	TRBV10-3	TRBJ1-1
TGCGCCCCTAACTCCGACGACACCGGGGAGCTGTTTTTT	CAPNSDDTGELFF	TRBV5-1	TRBJ2-2
TGTGCCAGCAGCCGAGGGACAGGCCGATACAATGAGCAGTTCTTC	CASSRGTGRYNEQFF	TRBV11-1	TRBJ2-1
TGTGCCAGCATCCCGACAGCCCCTGGAAACACCATATATTTT	CASIPTAPGNTIYF	TRBV27	TRBJ1-3
TGTGCCAGCAGTTACTCGGCTTCCTCCTCGCGGGGCGGCTACGAGCAGTACTTC	CASSYSASSSRGGYEQYF	TRBV6-3	TRBJ2-7
TGTGCCAGCAGCCCTACAAGAGGGGGGGACACTGAAGCTTTCTTT	CASSPTRGGDTEAFF	TRBV6-5	TRBJ1-1
TGCGCCAGCAGCGGTAGAAAGGGTGGAAATGAGCAGTACTTC	CASSGRKGGNEQYF	TRBV5-1	TRBJ2-7
TGTGCCAGCAGACGGGGCCAGTTAGCCTACGAGCAGTACTTC	CASRRGQLAYEQYF	TRBV6-1	TRBJ2-7
TGTGCCAGCACCAGGGACCACAACCAGTACTTC	CASTRDHNQYF	TRBV2	TRBJ2-5
TGTGCCAACAGCGGCGAGCAGTACTTC	CANSGEQYF	TRBV27	TRBJ2-7
TGTGCCACCATACCCCGGGACAGGGGTGGTGCCTACGAGCAGTACTTC	CATIPRDRGGAYEQYF	TRBV24-1	TRBJ2-7
TGTGCCAGCAGGGCTCGGGGGAGTTATGAAAAACTGTTTTTT	CASRARGSYEKLFF	TRBV6-4	TRBJ1-4
TGTGCCTGGACCGGGACAGGAAGCGATCAGCCCCAGCATTTT	CAWTGTGSDQPQHF	TRBV30	TRBJ1-5
TGCGCCAGCAGCACGAGGGGGGGTCTGAACACTGAAGCTTTCTTT	CASSTRGGLNTEAFF	TRBV5-1	TRBJ1-1
TGTGCCAGCACAACAGGGGAAGCTTTCTTT	CASTTGEAFF	TRBV25-1	TRBJ1-1
TGTGCCACCCGCCTTAGAGGGAACAATGAGCAGTTCTTC	CATRLRGNNEQFF	TRBV4-2	TRBJ2-1
TGTGCTAATCTCACCGGGACTATATATGAGCAGTTCTTC	CANLTGTIYEQFF	TRBV12-5	TRBJ2-1
TGTGCCAGCAGTTTTCCCAACCTTTTGGCCCGGCCATACGAGCAGTACTTC	CASSFPNLLARPYEQYF	TRBV27	TRBJ2-7
TGTGCCAGCAGTGTAGGATGGAGGGGGAGTCTCTCCTACGAGCAGTACTTC	CASSVGWRGSLSYEQYF	TRBV2	TRBJ2-7
TGTGCCAGCACTCACTTAACTAGCGGGGGGGGGGTAGATACGCAGTATTTT	CASTHLTSGGGVDTQYF	TRBV6-5	TRBJ2-3
TGTGCCAGCAGCCAACCGCAGTTAGGTAAAGAGACCCAGTACTTC	CASSQPQLGKETQYF	TRBV14	TRBJ2-5
TGCGCCAGCAGCCTGGTAGGCGGGAGGGCCTTTTACGAGCAGTACTTC	CASSLVGGRAFYEQYF	TRBV4-1	TRBJ2-7
TGTGCCACCAGTGATTTGCCAATTACTGGGGGGGTTTTGTCCAGCTCCTACAATGAGCAGTTCTTC	CATSDLPITGGVLSSSYNEQFF	TRBV24-1	TRBJ2-1
TGCGCCAGCAGCCTTCAGGGGAACACTGAAGCTTTCTTT	CASSLQGNTEAFF	TRBV5-1	TRBJ1-1
TGTGCCAGCAGTTACTCCGAGGGTTGGGAAGCGGCCGGGACAGGGGAGGGTAGCAATCAGCCCCAGCATTTT	CASSYSEGWEAAGTGEGSNQPQHF	TRBV6-2	TRBJ1-5
TGTGCCAGCAGTGGGCTGGGACAGGGTGGGAGTAGCAATCAGCCCCAGCATTTT	CASSGLGQGGSSNQPQHF	TRBV6-4	TRBJ1-5
TGTGCCAGCAGTTTATGCACCCCAGGGGATAGCAATCAGCCCCAGCATTTT	CASSLCTPGDSNQPQHF	TRBV27	TRBJ1-5
TGTGCCAGCGAAAAGGGACAGTTACCCCTCTACGAGCAGTACTTC	CASEKGQLPLYEQYF	TRBV6-1	TRBJ2-7
TGTGCCAGCAGCCAAGAACACAATCAGCCCCAGCATTTT	CASSQEHNQPQHF	TRBV14	TRBJ1-5
TGTGCCAGCAGCTTAACAACCATTAGAACTAATGAAAAACTGTTTTTT	CASSLTTIRTNEKLFF	TRBV7-7	TRBJ1-4
