TGTGCCAGCAAGACACGGGGAGGGAAAGAGGAGCAGTACTTC	CASKTRGGKEEQYF	TRBV6-4	TRBJ2-7
TGTGCCAGCAGTAGGAGGGGGTCCTATGGCTACACCTTC	CASSRRGSYGYTF	TRBV27	TRBJ1-2
TGTGCCAGCAGCAACGGCTCTTCACAGGGGGGTCCCGAGCAGTACTTC	CASSNGSSQGGPEQYF	TRBV27	TRBJ2-7
TGCAGTGCTAGACAGAGGGTGGGGGGGTGGGGGGGCCTTAAGCAGTTCTTC	CSARQRVGGWGGLKQFF	TRBV20-1	TRBJ2-1
TGTGCCAGCAGCGTGGGGTTAGGTACAACTAATGAAAAACTGTTTTTT	CASSVGLGTTNEKLFF	TRBV6-5	TRBJ1-4
TGTGCCAGCCTCTACGAGCAGTACTTC	CASLYEQYF	TRBV5-8	TRBJ2-7
TGTGCCAGCCTGGGACAGGGGCTGCAGCCCCAGCATTTT	CASLGQGLQPQHF	TRBV6-3	TRBJ1-5
TGTGCCAGCAGTGCTATTTATAGGAGTGAAAAACTGTTTTTT	CASSAIYRSEKLFF	TRBV2	TRBJ1-4
TGTGCCAGCAGCCAAGAGATTAGAAGGGGGGGGTTAGACCAAGAGACCCAGTACTTC	CASSQEIRRGGLDQETQYF	TRBV14	TRBJ2-5
TGTGCCAGCAGGCCTCCGGGACAGGGGCGAGGAAACACCATATATTTT	CASRPPGQGRGNTIYF	TRBV6-5	TRBJ1-3
TGTGCCAGCAGCTCCGGGAATGAAAAACTGTTTTTT	CASSSGNEKLFF	TRBV7-7	TRBJ1-4
TGCAGCGTTCGGGCCTACAATGAGCAGTTCTTC	CSVRAYNEQFF	TRBV29-1	TRBJ2-1
TGTGCCAGCAGTTTATTTTTAAAGCGGGAGAGAGGTACCTACGAGCAGTACTTC	CASSLFLKRERGTYEQYF	TRBV27	TRBJ2-7
TGTGCCAGCAGCTCACAGACAGAGCAGTACTTC	CASSSQTEQYF	TRBV14	TRBJ2-7
TGCGCCAGCAGAGACGACAGGGCCCTCTACGAGCAGTACTTC	CASRDDRALYEQYF	TRBV10-1	TRBJ2-7
TGTGCCAGCAATAGGAAAACTCCCGTAACCCAAGAGACCCAGTACTTC	CASNRKTPVTQETQYF	TRBV6-4	TRBJ2-5
TGTGCCAGCAGCACCGACGAGGGACTAGCGGGAGGCGAGACCCAGTACTTC	CASSTDEGLAGGETQYF	TRBV7-4	TRBJ2-5
TGTGCCAGCAGATTGGACCCCACCGGGGCCAAAAACATTCAGTACTTC	CASRLDPTGAKNIQYF	TRBV7-9	TRBJ2-4
TGTGCCAGTAGTATTACCCGGGGCCCGGGGAACTTGAATCAGCCCCAGCATTTT	CASSITRGPGNLNQPQHF	TRBV19	TRBJ1-5
TGTGCCAGCAGCTACTGTTCCCTCCGGGGAAGATACGAGCAGTACTTC	CASSYCSLRGRYEQYF	TRBV11-3	TRBJ2-7
TGCGCCAGCAGCTTGGCCAGTGGGGGGCTTGACCCAGAGACCCAGTACTTC	CASSLASGGLDPETQYF	TRBV5-1	TRBJ2-5
TGTGCCAGCAGCCGTACGGGGGGGACCGGGGAGCTGTTTTTT	CASSRTGGTGELFF	TRBV14	TRBJ2-2
TGTGCCAGTAGTATTCCCATCCGGGACAGGGGCCCCCTCCACTTT	CASSIPIRDRGPLHF	TRBV19	TRBJ1-6
TGCAGTGCTAGCAAAAGTTATCGGCGACGGAGGGTCGTAAAATATGGCTACACCTTC	CSASKSYRRRRVVKYGYTF	TRBV20-1	TRBJ1-2
TGTGCCAGCAGCACGGCAGCTAGCAATCAGCCCCAGCATTTT	CASSTAASNQPQHF	TRBV7-9	TRBJ1-5
TGTGCCACCAGTGGGCCCCCAGGGAGGAGCTCCTACGAGCAGTACTTC	CATSGPPGRSSYEQYF	TRBV24-1	TRBJ2-7
TGTGCCAGCAGCAGGAGGGGTCCGGGACTAGACCCAGTTACCGAGCAGTACTTC	CASSRRGPGLDPVTEQYF	TRBV5-4	TRBJ2-7
TGTGCCAGCAGCTATCGAAAACAGGGGGGATCTAACTATGGCTACACCTTC	CASSYRKQGGSNYGYTF	TRBV7-9	TRBJ1-2
TGTGCCAGCAGCCGATCCGGGACTAGCGGTGACTCCTACAATGAGCAGTTCTTC	CASSRSGTSGDSYNEQFF	TRBV3-1	TRBJ2-1
TGTGCCAGCAGCGTAGGTGGGAAACAGTCAGGGGGGCACGGCTACACCTTC	CASSVGGKQSGGHGYTF	TRBV9	TRBJ1-2
TGTACGCCAAGGAACACTGAAGCTTTCTTT	CTPRNTEAFF	TRBV10-3	TRBJ1-1
TGTGCCAGCAGCTGGGTAGGGGGCGTACCCCAGCATTTT	CASSWVGGVPQHF	TRBV5-6	TRBJ1-5
TGTGCCAGCAGCCAAGAGGGAAAAGGGCGGGGCTATGGCTACACCTTC	CASSQEGKGRGYGYTF	TRBV14	TRBJ1-2
TGTGCCAGCAGTGCTTCGGACAGGGCCCGATGCAATCAGCCCCAGCATTTT	CASSASDRARCNQPQHF	TRBV6-1	TRBJ1-5
TGTGCTAGCAGCTTACCCCAGAGGACCAATTCACCCCTCCACTTT	CASSLPQRTNSPLHF	TRBV7-7	TRBJ1-6
TGCAGCGTTGGGGGACTAGCGGGGGGGCCGAACACCGGGGAGCTGTTTTTT	CSVGGLAGGPNTGELFF	TRBV29-1	TRBJ2-2
TGCAGTGCGCGACAGCGTCGTCAGCCCCAGCATTTT	CSARQRRQPQHF	TRBV20-1	TRBJ1-5
TGCAGTGCTTCAAGGCTCCCGGGACAGGGAAGGCGCTATGGCTACACCTTC	CSASRLPGQGRRYGYTF	TRBV20-1	TRBJ1-2
TGTGCCAGCAGGGTCAGTCGAAAAGAGACCCAGTACTTC	CASRVSRKETQYF	TRBV2	TRBJ2-5
TGTGCCAGCTCATCACCCGCACACTGCTACGAGCAGTACTTC	CASSSPAHCYEQYF	TRBV18	TRBJ2-7
TGTGCCAGCAGTTCCGGGACTAGCGGCCAGGATACGCAGTATTTT	CASSSGTSGQDTQYF	TRBV6-5	TRBJ2-3
TGTGCCAGCAGCTTAGTAAAACCAGCCGTGGGAGAAAAACTGTTTTTT	CASSLVKPAVGEKLFF	TRBV7-6	TRBJ1-4
TGTGCCAGCAGTGGCCCACAGTACACTGAAGCTTTCTTT	CASSGPQYTEAFF	TRBV12-3	TRBJ1-1
TGTGCCAGCAGTGAAGCGCTTTACAGGGTCGGTGGCTACACCTTC	CASSEALYRVGGYTF	TRBV6-1	TRBJ1-2
TGTGCCAGCAGTTTCCCAACGGGACAGGGCCTGGAAAAGGCTAACTATGGCTACACCTTC	CASSFPTGQGLEKANYGYTF	TRBV28	TRBJ1-2
TGTGCCAGACCCCAGGGCGGGGTGTCTCCGGCCCAGGTGAACACTGAAGCTTTCTTT	CARPQGGVSPAQVNTEAFF	TRBV10-3	TRBJ1-1
TGTGCCAGCAAACCCGGGGCCCCTCTTAGCACAGATACGCAGTATTTT	CASKPGAPLSTDTQYF	TRBV6-4	TRBJ2-3
TGCGCCAGCAGCCATAGATCGGGGGGGCGGGCCTACGAGCAGTACTTC	CASSHRSGGRAYEQYF	TRBV4-1	TRBJ2-7
TGTGCCAGCAGGAGGGACAGGGGTTTGCACAATGAGCAGTTCTTC	CASRRDRGLHNEQFF	TRBV5-6	TRBJ2-1
TGTGCCAGCAGCTTAGATGAGACAGTACGTCATCAGCCCCAGCATTTT	CASSLDETVRHQPQHF	TRBV7-2	TRBJ1-5
TGTGCCATCAGTGTTACTGGTCGGGACAGCGGACCCTACGAGCAGTACTTC	CAISVTGRDSGPYEQYF	TRBV10-3	TRBJ2-7
TGTGCCTGGAGAAATGACGGGGGTAGGGCGAACACCGGGGAGCTGTTTTTT	CAWRNDGGRANTGELFF	TRBV30	TRBJ2-2
TGTGCCAGCAGCGACTCCGTACCGGAGTCAGATACGCAGTATTTT	CASSDSVPESDTQYF	TRBV11-3	TRBJ2-3
TGCGCCAGCAGCTTGACCAGGAGAACTGGCTCCTATAATTCACCCCTCCACTTT	CASSLTRRTGSYNSPLHF	TRBV5-1	TRBJ1-6
TGTGCCAGCAGTTACGTACCCCCTTCGGGAATGTTCGAGCAGTACTTC	CASSYVPPSGMFEQYF	TRBV6-5	TRBJ2-7
TGTGCCAGCAGTTTCGCCCCGGGACCTCAAGAGACCCAGTACTTC	CASSFAPGPQETQYF	TRBV27	TRBJ2-5
TGTGCCAGCAGCAGAGGGACAGGGCTGGACACCGGGGAGCTGTTTTTT	CASSRGTGLDTGELFF	TRBV5-6	TRBJ2-2
TGTGCCAGTATGGCGGGGACCCCGAGGGCTGGCTACACCTTC	CASMAGTPRAGYTF	TRBV9	TRBJ1-2
TGCAGTGCTAGAGATACAGACAGGGGTAAATATGAGCAGTTCTTC	CSARDTDRGKYEQFF	TRBV20-1	TRBJ2-1
TGCGCCAGCAGCAGCAGGGAAGCAACTAATGAAAAACTGTTTTTT	CASSSREATNEKLFF	TRBV5-1	TRBJ1-4
TGTGCCAGCAGCGACCACTCGGACGAGGGAGTCATGAACACTGAAGCTTTCTTT	CASSDHSDEGVMNTEAFF	TRBV7-3	TRBJ1-1
TGTGCCAGCGACGGGGGACAGGGGACAAACAATGAGCAGTTCTTC	CASDGGQGTNNEQFF	TRBV27	TRBJ2-1
TGTGCCACCATCCTCTCGGCCGGAGAGGAGGGCTACACCTTC	CATILSAGEEGYTF	TRBV24-1	TRBJ1-2
TGCAGTGCTAGAGACCAGTTCTCCTACGAGCAGTACTTC	CSARDQFSYEQYF	TRBV20-1	TRBJ2-7
TGTGCCACCGGCCTCCTCTGTGAGGACTATGGCTACACCTTC	CATGLLCEDYGYTF	TRBV24-1	TRBJ1-2
TGCGCCAGCAGCAGAGTTCATGAGGGGAATGAGCAGTTCTTC	CASSRVHEGNEQFF	TRBV5-1	TRBJ2-1
TGTGCCAGCAGCCGAGCAAGAAGGGACAATAGCAATCAGCCCCAGCATTTT	CASSRARRDNSNQPQHF	TRBV9	TRBJ1-5
TGTGCCAGCAGACAGGGGGGGTTGGTGAACACCGGGGAGCTGTTTTTT	CASRQGGLVNTGELFF	TRBV6-5	TRBJ2-2
TGTGCCAGCAGCCGGTGGACCGGGCGGCCTCTTCGCTCCTACGAGCAGTACTTC	CASSRWTGRPLRSYEQYF	TRBV14	TRBJ2-7
TGCAGTGCTAGAGTCCAGAGGTTGACTAGCTTTAGGCCAGATACGCAGTATTTT	CSARVQRLTSFRPDTQYF	TRBV20-1	TRBJ2-3
TGTGCCAGCAGCGTAGTCAATTCCACCATGACTAGCGGGGGGGATACGCAGTATTTT	CASSVVNSTMTSGGDTQYF	TRBV9	TRBJ2-3
TGCGCCAGCAGCGCACTGAAAGCTAATGAAAAACTGTTTTTT	CASSALKANEKLFF	TRBV5-1	TRBJ1-4
TGCGCCAGCAGTGAGCCGGACCCGGGACAGGGGAAAGCTAACTATGGCTACACCTTC	CASSEPDPGQGKANYGYTF	TRBV10-1	TRBJ1-2
TGTGCCAGCAGCCTCTTAACAGGGGTTTATAGCAATCAGCCCCAGCATTTT	CASSLLTGVYSNQPQHF	TRBV3-1	TRBJ1-5
TGTGCCAGCAGCCAAGAAAGGGTAGATGGCTACACCTTC	CASSQERVDGYTF	TRBV14	TRBJ1-2
TGTGCCAGCAGCGTAGGACCAGGGAAGATAAACCGGGCTTTCTTT	CASSVGPGKINRAFF	TRBV9	TRBJ1-1
TGTGCCAGCAGCTCCCGAGACAGACACAATCAGCCCCAGCATTTT	CASSSRDRHNQPQHF	TRBV7-9	TRBJ1-5
TGTGCCAGCCCAGGGGCTTTTCAAGCTTTCTTT	CASPGAFQAFF	TRBV6-1	TRBJ1-1
TGTGCCAGCAGCTTGCCGAGCGGGACAGGAGCGAGTCAGCCCCAGCATTTT	CASSLPSGTGASQPQHF	TRBV5-4	TRBJ1-5
TGTGCCAGCAGTGAAAGCCATCGGGGAAGGAGCTCTGGAAACACCATATATTTT	CASSESHRGRSSGNTIYF	TRBV6-1	TRBJ1-3
TGTGCCATCAGTGAGTCGTGGACAGGTCGCTATGGCTACACCTTC	CAISESWTGRYGYTF	TRBV10-3	TRBJ1-2
TGTGCCAGCAGTACGGGGGGCGGGGACACCGGGGAGCTGTTTTTT	CASSTGGGDTGELFF	TRBV27	TRBJ2-2
TGTGCCAGCAGACAGGAACACAATGAGCAGTTCTTC	CASRQEHNEQFF	TRBV2	TRBJ2-1
TGCGCCAGCAGTGAGCTGGACTCGATTACGGAGCAGTACTTC	CASSELDSITEQYF	TRBV10-2	TRBJ2-7
TGTGCCAGCAGTTCCGCCCTCGGGGGGCCCCATAGGAACAGCTCCTACGAGCAGTACTTC	CASSSALGGPHRNSSYEQYF	TRBV6-2	TRBJ2-7
TGTGCCAGCAGCCAAAGGGTAGATCAAGAGCCAGACACCGGGGAGCTGTTTTTT	CASSQRVDQEPDTGELFF	TRBV7-4	TRBJ2-2
TGTGCCAGCAGCATCCGGAGCCCGGTCTATGGCTACACCTTC	CASSIRSPVYGYTF	TRBV5-6	TRBJ1-2
TGTGCCACCAGCACTGGGGGCATCCGGGTCTCTGGGGCCAACGTCCTGACTTTC	CATSTGGIRVSGANVLTF	TRBV15	TRBJ2-6
TGTGCCAGCAGCTTAGCGGAGGCCGGGACGGGCAGCTATGGCTACACCTTC	CASSLAEAGTGSYGYTF	TRBV7-2	TRBJ1-2
TGTGCCAGCAGCTACCGGGACAGGGTAAAGATGGATAGCAATCAGCCCCAGCATTTT	CASSYRDRVKMDSNQPQHF	TRBV5-6	TRBJ1-5
TGTGCCTGGAGAGCCCGGGACATGCATCAGCCCCAGCATTTT	CAWRARDMHQPQHF	TRBV30	TRBJ1-5
TGTGCCAGCAGCTTAGAGAGCCGATGGCCAATCCTAGCGGGGGACGAGCAGTACTTC	CASSLESRWPILAGDEQYF	TRBV7-3	TRBJ2-7
TGTGCCGTACGGGAGACTAGCGAGTTATACAATGAGCAGTTCTTC	CAVRETSELYNEQFF	TRBV7-2	TRBJ2-1
TGTGCCGTCAAGTCTAGAGAGACCCAGTACTTC	CAVKSRETQYF	TRBV7-6	TRBJ2-5
TGTGCCAGTGGTACTCTTAAACCCTACGAGCAGTACTTC	CASGTLKPYEQYF	TRBV6-4	TRBJ2-7
TGTGCCAGCAGCGAAATCACTAGCCACAATGAGCAGTTCTTC	CASSEITSHNEQFF	TRBV13	TRBJ2-1
TGCAGTGCTAGAGGAAGGACAGTGGCTTGCAATCAGCCCCAGCATTTT	CSARGRTVACNQPQHF	TRBV20-1	TRBJ1-5
TGCAGTGCTAGTAGTCTAGAAACTAGCTACTGGGGCTACGAGCAGTACTTC	CSASSLETSYWGYEQYF	TRBV20-1	TRBJ2-7
TGTGCTAGCAGCTTAGGGAGGGGGGGCTACACCTTC	CASSLGRGGYTF	TRBV7-7	TRBJ1-2
TGTGCCAGCAGCCCGGGACATACCTCACCCCTCCACTTT	CASSPGHTSPLHF	TRBV13	TRBJ1-6
TGCAGCGTGGATAGCTTACAGGGAAGTGAAGCTTTCTTT	CSVDSLQGSEAFF	TRBV29-1	TRBJ1-1
TGTGCCAGCAGCGCGGACAGGGGCTACACCTTC	CASSADRGYTF	TRBV13	TRBJ1-2
TGCAGCGTTGCTAGCCGACACAGGGCCACTGAAGCTTTCTTT	CSVASRHRATEAFF	TRBV29-1	TRBJ1-1
TGTGCCAGCAGACCTAAGACAGAAACTAGTACCCTCACCGGGGAGCTGTTTTTT	CASRPKTETSTLTGELFF	TRBV12-3	TRBJ2-2
TGTGCCAGCAGTTGCTTCCTTTGCGGGAGGGCTGAGCAGTACTTC	CASSCFLCGRAEQYF	TRBV6-8	TRBJ2-7
TGTGCCAGCAGTAGATTCCCAGGGAAGGCCTGCTCCTATAATTCACCCCTCCACTTT	CASSRFPGKACSYNSPLHF	TRBV27	TRBJ1-6
TGTGCCAGTAGTATAGTACTGGGGTCTAACTCACCCCTCCACTTT	CASSIVLGSNSPLHF	TRBV19	TRBJ1-6
TGTGCCAGCAGTTACATGAGGGCTAGCACTGAAGCTTTCTTT	CASSYMRASTEAFF	TRBV6-3	TRBJ1-1
TGCGCCGGCCCAGGCAATCAGCCCCAGCATTTT	CAGPGNQPQHF	TRBV5-1	TRBJ1-5
TGTGCCCGAACGGAATGGGAAACTAGCGGGAGTGACAGCAGTTTGCAGTTCTTC	CARTEWETSGSDSSLQFF	TRBV12-3	TRBJ2-1
TGTGCCAGCAGTTTAGGACAGGGCCCGGGGGGTGGCTACACCTTC	CASSLGQGPGGGYTF	TRBV27	TRBJ1-2
TGTGCCAGCTTAAACCCGGCACCGGGCACTGAAGCTTTCTTT	CASLNPAPGTEAFF	TRBV19	TRBJ1-1
TGTGCCAGCAGCTTACCAGAGGGGTATAGCAATCAGCCCCAGCATTTT	CASSLPEGYSNQPQHF	TRBV5-8	TRBJ1-5
TGTGCCATCGGAGACCTTGCTTTCTTT	CAIGDLAFF	TRBV27	TRBJ1-1
TGCGCCAGCTCCCATATAGTTTCCTACGAGCAGTACTTC	CASSHIVSYEQYF	TRBV5-1	TRBJ2-7
TGTGCCACCAGTGCACCCAGTTGGCCTATAAGGAGCAATCAGCCCCAGCATTTT	CATSAPSWPIRSNQPQHF	TRBV24-1	TRBJ1-5
TGCGCCAGCAGCCAAGACGCGAACAAACGACAGGCTGACACTGAAGCTTTCTTT	CASSQDANKRQADTEAFF	TRBV4-3	TRBJ1-1
TGCAGTGCAAACAGTCTTTACGAGCAGTACTTC	CSANSLYEQYF	TRBV20-1	TRBJ2-7
TGTGCCAGCACAGCAGGGGCCGAAGCCAAAAACATTCAGTACTTC	CASTAGAEAKNIQYF	TRBV6-4	TRBJ2-4
TGTGCCAGCAGCCAAGAACCCTGGAGTGCTCGGGGGAGGGTCAACATTCAGTACTTC	CASSQEPWSARGRVNIQYF	TRBV3-1	TRBJ2-4
TGTGCCAGCAGAGAATTTCGCACTGAAGCTTTCTTT	CASREFRTEAFF	TRBV28	TRBJ1-1
TGTGCCAGCAGTTACGTGGGGCCCCAGGCTCAGCCCCAGCATTTT	CASSYVGPQAQPQHF	TRBV6-5	TRBJ1-5
TGTGCCAGCAGCTTTTTGAGGTCGGGACTAGCTTTCTTT	CASSFLRSGLAFF	TRBV7-2	TRBJ1-1
TGTGCCAGCAGCCAAGAGACAGGGGGAAATCAGCCCCAGCATTTT	CASSQETGGNQPQHF	TRBV3-1	TRBJ1-5
TGTGCCAGCACGAAGGATGAGCAGTTCTTC	CASTKDEQFF	TRBV7-9	TRBJ2-1
TGTGCCAGCAGCAGATGGATCGAACCAGCTAGGGAGACCCAGTACTTC	CASSRWIEPARETQYF	TRBV7-3	TRBJ2-5
TGTGCCCTAAGTGACGTCTATGAGCAGTTCTTC	CALSDVYEQFF	TRBV9	TRBJ2-1
TGCGCCAGCAGCACCCGGGGCGAGATAAGCTCCTACGAGCAGTACTTC	CASSTRGEISSYEQYF	TRBV4-1	TRBJ2-7
TGTGCCAGCAGTGACTCGAGGGACAGGGGCGGGAATGAGACCCAGTACTTC	CASSDSRDRGGNETQYF	TRBV6-4	TRBJ2-5
TGTGCCCGGGGGGGTAGCTCCTACAATGAGCAGTTCTTC	CARGGSSYNEQFF	TRBV6-6	TRBJ2-1
TGTAGCTACCCCTCTATGGAAGATACCGGGGAGCTGTTTTTT	CSYPSMEDTGELFF	TRBV11-2	TRBJ2-2
TGTGCCAGCAGTCCCAAGGACAGGGCTCGGTCCTACGAGCAGTACTTC	CASSPKDRARSYEQYF	TRBV25-1	TRBJ2-7
TGCAGTGCACGCCCATACGGCTACACCTTC	CSARPYGYTF	TRBV20-1	TRBJ1-2
TGTGCCAGCAGCTTAGATTGCCCAGGGGACCGAGTCGACATTCAGTACTTC	CASSLDCPGDRVDIQYF	TRBV11-2	TRBJ2-4
TGTGCCAGCTCTCGGGACGATAGCAATCAGCCCCAGCATTTT	CASSRDDSNQPQHF	TRBV6-4	TRBJ1-5
TGCGCCAGCAGCCACCCCGGGACAGGGACGAAAACTAACTATGGCTACACCTTC	CASSHPGTGTKTNYGYTF	TRBV4-1	TRBJ1-2
TGTGCCAGCAGCCCCACCCGGCAACTCACAGATACGCAGTATTTT	CASSPTRQLTDTQYF	TRBV13	TRBJ2-3
TGTGCCAGCAGCATCGGGCCGGTAGGGGCGACCTACGAGCAGTACTTC	CASSIGPVGATYEQYF	TRBV7-3	TRBJ2-7
TGCGCCAGCAGCTCCCGGGCCGCCGGTTATGGGGCTGGAAACACCATATATTTT	CASSSRAAGYGAGNTIYF	TRBV5-1	TRBJ1-3
TGCAGTGCTAGAGGACCGGGACAGGGCAATCAGCCCCAGCATTTT	CSARGPGQGNQPQHF	TRBV20-1	TRBJ1-5
TGTGCCAGCAGTGACGTTTGGAGTAGGAAGGCTAACTATGGCTACACCTTC	CASSDVWSRKANYGYTF	TRBV6-4	TRBJ1-2
TGCAGCGTTTCCCTAAGTGACAGGGAGTTCCACGCAAACTATGGCTACACCTTC	CSVSLSDREFHANYGYTF	TRBV29-1	TRBJ1-2
TGTGCCAGCAGCCAACCCCACTGGGTTGAGACCCAGTACTTC	CASSQPHWVETQYF	TRBV4-2	TRBJ2-5
TGTGCCAGCAGTGTTCCGGGACAGTCGTGCAAGACCGGGGAGCTGTTTTTT	CASSVPGQSCKTGELFF	TRBV6-5	TRBJ2-2
TGTGCCAGCAGCTTAGGGCGGGACCGGCCGAACACTGAAGCTTTCTTT	CASSLGRDRPNTEAFF	TRBV7-3	TRBJ1-1
TGTGCCACCCGCCCCTATTCCGGGACAGGGACACAAGAGACCCAGTACTTC	CATRPYSGTGTQETQYF	TRBV15	TRBJ2-5
TGTGCCAGCAGCGGGCCGGGCCGTTTATACACTGAAGCTTTCTTT	CASSGPGRLYTEAFF	TRBV6-5	TRBJ1-1
TGTGCCAGCAGTTCCCGGGGGGGGGATTGGACCTACAATGAGCAGTTCTTC	CASSSRGGDWTYNEQFF	TRBV6-6	TRBJ2-1
TGTAGGGGCAAATGCTCCTATAATTCACCCCTCCACTTT	CRGKCSYNSPLHF	TRBV10-3	TRBJ1-6
TGTGCCAGCCTGGACTTATTAGCTTTCTTT	CASLDLLAFF	TRBV28	TRBJ1-1
TGTGCCAGCAGCCGGGGTCCCAGCAATCAGCCCCAGCATTTT	CASSRGPSNQPQHF	TRBV7-2	TRBJ1-5
TGTGCCAGCAGCTGGTCCGGTAGCCCGGGGGCGAGGAATCAGCCCCAGCATTTT	CASSWSGSPGARNQPQHF	TRBV5-4	TRBJ1-5
TGTGCCAGCAGCAACAGACCCTACGAGCAGTACTTC	CASSNRPYEQYF	TRBV13	TRBJ2-7
TGTGCCAGCAGCTTTTTTGAACGGGCAGATACGCAGTATTTT	CASSFFERADTQYF	TRBV11-3	TRBJ2-3
TGTGCCAGCAGCGATCTTGGGGGGGGCACGGGTGTAGCCAAAAACATTCAGTACTTC	CASSDLGGGTGVAKNIQYF	TRBV5-4	TRBJ2-4
TGTGCCAGCAGGACAGGACCTACAGATACGCAGTATTTT	CASRTGPTDTQYF	TRBV6-4	TRBJ2-3
TGTGCCATCATCTCCTCTCCGGGGGACGAGCAGTACTTC	CAIISSPGDEQYF	TRBV10-3	TRBJ2-7
TGTGCCAGCAGTTACGAGCTAGCGCGGGACCCTGACGAGCAGTACTTC	CASSYELARDPDEQYF	TRBV6-2	TRBJ2-7
TGCGCCAGCAGTGAGTCTCAATACGCGTACGAGCAGTACTTC	CASSESQYAYEQYF	TRBV10-1	TRBJ2-7
TGTGCCAGCAGCCAACCCTGCGTGTCTCAAGTCGGGGGGGAGACCCAGTACTTC	CASSQPCVSQVGGETQYF	TRBV14	TRBJ2-5
TGCAGTGCTCTGGAAGGGGGGGGTGGGACCACCGGGGAGCTGTTTTTT	CSALEGGGGTTGELFF	TRBV20-1	TRBJ2-2
TGTGCCAGTAGTTCATGGAAAACAGGAATCTCCTACAATGAGCAGTTCTTC	CASSSWKTGISYNEQFF	TRBV19	TRBJ2-1
TGTGCCAGCAGCTCGCCTCGATTCTGGTACGAGCAGTACTTC	CASSSPRFWYEQYF	TRBV7-8	TRBJ2-7
TGCAGTGCTAGAGGCTTTAAACCGCGACCCACGGCGCATTTT	CSARGFKPRPTAHF	TRBV20-1	TRBJ1-5
TGTGCCCCCAGGGGGGGCCATGACACAGATACGCAGTATTTT	CAPRGGHDTDTQYF	TRBV6-1	TRBJ2-3
TGCGCCAGCAGAGAGACGAACACCGGGGAGCTGTTTTTT	CASRETNTGELFF	TRBV4-1	TRBJ2-2
TGTGCCAGAAATTTACAGGGGACTACACCTGGATCGCCCTACGAGCAGTACTTC	CARNLQGTTPGSPYEQYF	TRBV6-6	TRBJ2-7
TGTGCCACCAGTGCGGGGGAAGCTTTCTTT	CATSAGEAFF	TRBV24-1	TRBJ1-1
TGTGCCAGCAGTGACTTCGAAGGCGGGAGGGGGGCCTACGAGCAGTACTTC	CASSDFEGGRGAYEQYF	TRBV6-4	TRBJ2-7
TGTGCCAGCAGAAAGAGTCCATGGGGAGTTAACGAGCAGTACTTC	CASRKSPWGVNEQYF	TRBV27	TRBJ2-7
TGTGCCAGCAGGTCCACGTACAGGGAGACCCAGTACTTC	CASRSTYRETQYF	TRBV25-1	TRBJ2-5
TGTGCCAGCAGTGAAGTGGGTCTCGGGACTAGCGTGGAAGCCTACGAGCAGTACTTC	CASSEVGLGTSVEAYEQYF	TRBV6-1	TRBJ2-7
TGTGCCAGCAGCAGTCTAGCGGCTTCCTACGAGCAGTACTTC	CASSSLAASYEQYF	TRBV5-6	TRBJ2-7
TGTGCCAGCAGCCAAGGACCTCATGAGGCGGGAGTGTGCGAGCAGTACTTC	CASSQGPHEAGVCEQYF	TRBV4-2	TRBJ2-7
TGTGCCAGCAGCCTCCCCCGGGACAGGGACTGCGTAAACACTGAAGCTTTCTTT	CASSLPRDRDCVNTEAFF	TRBV3-1	TRBJ1-1
TGCAGTGCGGTAGGCCCCCTCAGAGGGGGCTATAATTCACCCCTCCACTTT	CSAVGPLRGGYNSPLHF	TRBV20-1	TRBJ1-6
TGTGCCAGCGACAGGATCAATCAGCCCCAGCATTTT	CASDRINQPQHF	TRBV5-6	TRBJ1-5
TGTGCCAGCAGCTACTACGAGCAGTACTTC	CASSYYEQYF	TRBV3-1	TRBJ2-7
TGTGCCAGCAGTGACAGACCGTCGTGTAGCAATCAGCCCCAGCATTTT	CASSDRPSCSNQPQHF	TRBV6-4	TRBJ1-5
TGTGCCAGCAGCCAAGACAGGGGACTCCACTTT	CASSQDRGLHF	TRBV3-1	TRBJ1-6
TGCGCCAACGGGACAGGCCCTGAGCAGTACTTC	CANGTGPEQYF	TRBV10-1	TRBJ2-7
TGTGCCAGCACGAAACAGGGGTCCATAGTCTCCTACGAGCAGTACTTC	CASTKQGSIVSYEQYF	TRBV27	TRBJ2-7
TGCAGTGCTGACAACGGGAACTCTGGGGCCAACGTCCTGACTTTC	CSADNGNSGANVLTF	TRBV20-1	TRBJ2-6
TGTGCCAGTAGTATCGTCACCACACTGAGGGATTCACCCCTCCACTTT	CASSIVTTLRDSPLHF	TRBV19	TRBJ1-6
TGTGCCACCAGTGAATGCAGCAGGGACGAGCAGTACTTC	CATSECSRDEQYF	TRBV24-1	TRBJ2-7
TGTGCCAGCAGCCCCAGAGGCCACAGGGAGGGCGGTAACTATGGCTACACCTTC	CASSPRGHREGGNYGYTF	TRBV13	TRBJ1-2
TGCGCCAGCACGCAGATTAACGAGCAGTACTTC	CASTQINEQYF	TRBV5-1	TRBJ2-7
TGCGCCAGCCCGAGGGGAAATCACACTGAAGCTTTCTTT	CASPRGNHTEAFF	TRBV5-1	TRBJ1-1
TGTGCCAGCAGTGAATGCCCAGAGGGGGCAGGAGAACTGGAGATGCAGTACTTC	CASSECPEGAGELEMQYF	TRBV25-1	TRBJ2-7
TGTGCCAGCAGCCTCCCAGAATGCGGTTCTGGAGATGAGCAGTTCTTC	CASSLPECGSGDEQFF	TRBV3-1	TRBJ2-1
TGTGCCAGCAACCAACAGGGGGGGTTCATGAACACTGAAGCTTTCTTT	CASNQQGGFMNTEAFF	TRBV6-3	TRBJ1-1
TGTGCCAGCAGCATAGCAGGGCGGAGGTACGAGCAGTACTTC	CASSIAGRRYEQYF	TRBV7-6	TRBJ2-7
TGTGCCAGCAGCCAAGACCTTGGGACAGTCGGACCTCCCGAGCAGTACTTC	CASSQDLGTVGPPEQYF	TRBV3-1	TRBJ2-7
TGTGCCAGCAGCGCGACTGGGTATGGCTACACCTTC	CASSATGYGYTF	TRBV13	TRBJ1-2
TGTGCCAGCACCCCCAGGGGGCCTTTGAACACTGAAGCTTTCTTT	CASTPRGPLNTEAFF	TRBV7-9	TRBJ1-1
TGTGCCAGCAGACCCCTATTCAATGAGCAGTTCTTC	CASRPLFNEQFF	TRBV27	TRBJ2-1
TGTGCCAGCAGCTTAGACTCTCCGCACTATGGCTACACCTTC	CASSLDSPHYGYTF	TRBV11-3	TRBJ1-2
TGTGCCAGCAGCACCGGAGGGGGGCAGCCCCAGCATTTT	CASSTGGGQPQHF	TRBV13	TRBJ1-5
TGTGCCAGCATCCCCAGTGCGGGCCCTTTTAATGAGCAGTTCTTC	CASIPSAGPFNEQFF	TRBV27	TRBJ2-1
TGCGCCAGCAGTGAGTCGACCCCCTTAGGACAGGAGATGGGAGCCGGGGAGCTGTTTTTT	CASSESTPLGQEMGAGELFF	TRBV10-1	TRBJ2-2
TGCGCCAGCAGGTTAACTACACCGGGGATGAATGAGCAGTTCTTC	CASRLTTPGMNEQFF	TRBV10-1	TRBJ2-1
TGTGCCAGCAGCTTGGACCGAGGGCTCGGCTACACCTTC	CASSLDRGLGYTF	TRBV5-6	TRBJ1-2
TGTGCCAGCAGCTCGCACCGGGGACACACTGAAGCTTTCTTT	CASSSHRGHTEAFF	TRBV7-2	TRBJ1-1
TGTGCCAGCAGTGTCAGTAACGGCTTGAACACTGAAGCTTTCTTT	CASSVSNGLNTEAFF	TRBV6-1	TRBJ1-1
TGTGCCAGTAGTCGCCGCCGGGACAGGGGGACGAACGGCTACACCTTC	CASSRRRDRGTNGYTF	TRBV19	TRBJ1-2
TGCACACTCGAGGGGGGAGCTACTGAAGCTTTCTTT	CTLEGGATEAFF	TRBV29-1	TRBJ1-1
TGTGCCAGCAGTGGGGGGGCTGTACTATTTCAGCCCCAGCATTTT	CASSGGAVLFQPQHF	TRBV6-5	TRBJ1-5
TGTGCCACCAGTGATTGGCCCCTGGGACGTGAAGCTTTCTTT	CATSDWPLGREAFF	TRBV24-1	TRBJ1-1
TGCGCCAGCAGTGAGCAGGGCGGACCTACTAGAGGTGAATACGAGCAGTACTTC	CASSEQGGPTRGEYEQYF	TRBV10-1	TRBJ2-7
TGTGCCAGCAGCCAAGAGTACAGGGTAAAGAATCATGAAAAACTGTTTTTT	CASSQEYRVKNHEKLFF	TRBV3-1	TRBJ1-4
TGTGCCACCAGAAGACAGGAGAGTACCTACGAGCAGTACTTC	CATRRQESTYEQYF	TRBV15	TRBJ2-7
TGTGCCAGCAGTTACTTGCCGGGACAGGGCGGTAACTATGGCTACACCTTC	CASSYLPGQGGNYGYTF	TRBV6-5	TRBJ1-2
TGTGCCAGCAGCCAGAGACAGGGTGAAGCTTTCTTT	CASSQRQGEAFF	TRBV13	TRBJ1-1
TGTGCCAGCAGCCGGGACAGAGGCGAGCAGTACTTC	CASSRDRGEQYF	TRBV7-7	TRBJ2-7
TGTGCCACCAGTGATGACAGGGGCTATGGCTACACCTTC	CATSDDRGYGYTF	TRBV24-1	TRBJ1-2
TGCGCCAGCTGGCGCCGCAATCAGCCCCAGCATTTT	CASWRRNQPQHF	TRBV10-1	TRBJ1-5
TGTGCCAGCAGGAGGGACTTAGGTGTAGAGACCCAGTACTTC	CASRRDLGVETQYF	TRBV28	TRBJ2-5
TGCAGTGCTAGAAAAACCGAGGGAGGGGCCTACGAGCAGTACTTC	CSARKTEGGAYEQYF	TRBV20-1	TRBJ2-7
TGTGCCAGCGGGGAACCCCGCGGGACCCCAACTAGCCCCTACAATGAGCAGTTCTTC	CASGEPRGTPTSPYNEQFF	TRBV5-6	TRBJ2-1
TGTGCCAGCAGCCCAACTAGCGGGAGGGCCTTTGAGTCCTATAATTCACCCCTCCACTTT	CASSPTSGRAFESYNSPLHF	TRBV7-2	TRBJ1-6
TGTGCCAGCAGTGAACTTCGCAAGGGGGATGGCTACACCTTC	CASSELRKGDGYTF	TRBV6-1	TRBJ1-2
TGCGCCAGCAGCTGCAACACTAGCGGGAGGGCGGGCGAGCAGTACTTC	CASSCNTSGRAGEQYF	TRBV5-1	TRBJ2-7
TGTGCCAGCAGTTACTTCTTGGGGGGCTACACCTTC	CASSYFLGGYTF	TRBV2	TRBJ1-2
TGTGCCAGCAGCTCGCGACGTGGGGTCCGAGATGAGCAGTTCTTC	CASSSRRGVRDEQFF	TRBV11-1	TRBJ2-1
TGTGCCATCAGTGAGCGTGGGGGGGTAGTTTACGAGCAGTACTTC	CAISERGGVVYEQYF	TRBV10-3	TRBJ2-7
TGTGCCAGCAGGTTCGGGGTTGACTACGAGCAGTACTTC	CASRFGVDYEQYF	TRBV12-4	TRBJ2-7
TGCAGTGCTAGAGAAATGGGACAGGGGGACTATGGCTACACCTTC	CSAREMGQGDYGYTF	TRBV20-1	TRBJ1-2
TGCGCCAGCAGCTTGACGCCCCAGCGGGAGGGGGGTCAGCCCCAGCATTTT	CASSLTPQREGGQPQHF	TRBV5-1	TRBJ1-5
TGTGCCAGCACCCCCATGTCTTACTCCCCAGGGGGCTTTTTTGACTATGGCTACACCTTC	CASTPMSYSPGGFFDYGYTF	TRBV6-2	TRBJ1-2
TGCAGTGCTCCGACGGGACAGGGTGAAGCTTTCTTT	CSAPTGQGEAFF	TRBV20-1	TRBJ1-1
TGTGCCAGCAGTCCCAGGGAAGATGAAAAACTGTTTTTT	CASSPREDEKLFF	TRBV27	TRBJ1-4
TGTGCCAGCTCACCGGTACCAAGGGCGTACGAGCAGTACTTC	CASSPVPRAYEQYF	TRBV18	TRBJ2-7
TGTGCCAGCAGCTTAGAGCGGCGGCCTGGCTACACCTTC	CASSLERRPGYTF	TRBV11-1	TRBJ1-2
TGTGCCAGCAAGCGACAGGCCGCCTACGAGCAGTACTTC	CASKRQAAYEQYF	TRBV2	TRBJ2-7
TGCGCCAGCGCCGCCCCGGGACCCAAAAACATTCAGTACTTC	CASAAPGPKNIQYF	TRBV4-3	TRBJ2-4
TGTGCCAGCAGCCGGGATGAGATCATGGCAGGAGACGAGCAGTACTTC	CASSRDEIMAGDEQYF	TRBV13	TRBJ2-7
TGTGCCATTCGGCTACCTTACAATGAGCAGTTCTTC	CAIRLPYNEQFF	TRBV7-2	TRBJ2-1
TGTGCCAGCAGCTCCTCCCGTTGGCAGGGATCAGGGCACTATGGCTACACCTTC	CASSSSRWQGSGHYGYTF	TRBV11-2	TRBJ1-2
TGCGCCAGCAGCACCGACAGGTGGAGGAACACTGAAGCTTTCTTT	CASSTDRWRNTEAFF	TRBV5-1	TRBJ1-1
TGTGCCAGCAGTGTTACTCTATGGGGGCTCAGCAATCAGCCCCAGCATTTT	CASSVTLWGLSNQPQHF	TRBV25-1	TRBJ1-5
TGTGCCAGCACGACCCGCAAGGGACAGGGGACTTACAATGAGCAGTTCTTC	CASTTRKGQGTYNEQFF	TRBV27	TRBJ2-1
TGTGCCAGCAGCGGGGGGGGGCAAAACGCCTACGAGCAGTACTTC	CASSGGGQNAYEQYF	TRBV11-3	TRBJ2-7
TGCGCCAGCAGGCGGGGAGATAATTCACCCCTCCACTTT	CASRRGDNSPLHF	TRBV5-1	TRBJ1-6
TGTGCCAGCAGCGAGCAGAGGGGGGGGGACCAGAGAAACGAGCAGTACTTC	CASSEQRGGDQRNEQYF	TRBV5-8	TRBJ2-7
TGTGCCAGCTCACCATTTAGGGAAACGGGGGGAAAAGCGCCCCAGTACTTC	CASSPFRETGGKAPQYF	TRBV18	TRBJ2-5
TGTGCCAGCAGTGAATATTTACCGGACTACACAGATACGCAGTATTTT	CASSEYLPDYTDTQYF	TRBV25-1	TRBJ2-3
TGTGCCAGCAGTTACTCGACCCCCTGGGGCCCCGGGCCGGACGAGCAGTACTTC	CASSYSTPWGPGPDEQYF	TRBV6-5	TRBJ2-7
TGCGCCAGCAGCTTGGGTTGGAGGGGTAATGAGCAGTTCTTC	CASSLGWRGNEQFF	TRBV5-1	TRBJ2-1
TGTGCCACCCCAGGGGCGACCATGAACACTGAAGCTTTCTTT	CATPGATMNTEAFF	TRBV7-9	TRBJ1-1
TGTGCCAGCAGCTTGGCGTTAACTAGCGGGGCCTACGAGCAGTACTTC	CASSLALTSGAYEQYF	TRBV5-5	TRBJ2-7
TGTGCCAGCAGGCAAGGGAGTTGTACTGAAGCTTTCTTT	CASRQGSCTEAFF	TRBV28	TRBJ1-1
TGCGCCAGCAGCCAAGATGCTATTAAAAGACAGTTGCTCAATCAGCCCCAGCATTTT	CASSQDAIKRQLLNQPQHF	TRBV4-1	TRBJ1-5
TGTGCCAGCATAGGCCGCAAAAACATTCAGTACTTC	CASIGRKNIQYF	TRBV27	TRBJ2-4
TGCAGTGCTAGAGATGGCCCCTCTGGACAGATGCAGGAGCAGTACTTC	CSARDGPSGQMQEQYF	TRBV20-1	TRBJ2-7
TGTGCCAGCAAGGACCTTAGTGCGGGCTACGAGCAGTACTTC	CASKDLSAGYEQYF	TRBV9	TRBJ2-7
TGCGCCAGCAGCCCCCGAAACAGGGCCGGTGGCTACACCTTC	CASSPRNRAGGYTF	TRBV5-1	TRBJ1-2
TGTGCCAGCAGTTACGGGGGTCTAGCGGGATCTGAGCAGTTCTTC	CASSYGGLAGSEQFF	TRBV6-5	TRBJ2-1
TGTGCCAGCAGCTTAAAAGGGACAGATGGCTACACCTTC	CASSLKGTDGYTF	TRBV7-3	TRBJ1-2
TGTACCGTCAGGGGAGTCTCTGGGGCCAACGTCCTGACTTTC	CTVRGVSGANVLTF	TRBV7-9	TRBJ2-6
TGCGCCAGCAGCTTCGGGACTAGCGGGACCGATACGCAGTATTTT	CASSFGTSGTDTQYF	TRBV5-1	TRBJ2-3
TGTGCCACCAGTGATAAGGAGAGTCCTTACGAGCAGTACTTC	CATSDKESPYEQYF	TRBV24-1	TRBJ2-7
TGCGCCAGCAGCCAGGCAGCGGGATTCGCTACCTACGAGCAGTACTTC	CASSQAAGFATYEQYF	TRBV4-1	TRBJ2-7
TGTGCCAGCAGTGGTAAGAGATTAGTAACTAGCGGGGGGGCCGTCCAAGAGACCCAGTACTTC	CASSGKRLVTSGGAVQETQYF	TRBV12-4	TRBJ2-5
TGTGCCAGCAGTTGCGGGAGGACCACAGCTTTCTTT	CASSCGRTTAFF	TRBV27	TRBJ1-1
TGTGCCAGCAGCCCTTGCTACGCGTTGGAGCTGTTTTTT	CASSPCYALELFF	TRBV7-9	TRBJ2-2
TGCAGTGCTAGAGATTTGAGGGGAGGGAATGAGCAGTTCTTC	CSARDLRGGNEQFF	TRBV20-1	TRBJ2-1
TGCCCGGGGGGAGACGAGCAGTACTTC	CPGGDEQYF	TRBV5-1	TRBJ2-7
TGCAGTGCTAGAGCCCCCTGGACAGGGCGGAGCGAGGGACGGGGAAGCAATCAGCCCCAGCATTTT	CSARAPWTGRSEGRGSNQPQHF	TRBV20-1	TRBJ1-5
TGTGCCAGCAGTTACTCGAACAATCGAGTGGGGCATACTGGGGCCAACGTCCTGACTTTC	CASSYSNNRVGHTGANVLTF	TRBV27	TRBJ2-6
TGTGCCAGCAGCCAGGCATTCTCGACCAGCAATCAGCCCCAGCATTTT	CASSQAFSTSNQPQHF	TRBV5-6	TRBJ1-5
TGTGCCAGCAGTTTATTCTCACGATTCCCAGAAAGGGACAGGGGGGGCTACGAGCAGTACTTC	CASSLFSRFPERDRGGYEQYF	TRBV27	TRBJ2-7
TGTGCCAGCAGCGAAGGGACCGGGGGGGAGCCCACAGATACGCAGTATTTT	CASSEGTGGEPTDTQYF	TRBV7-8	TRBJ2-3
TGTGCCAGCAGGAGGGGGGGAACCCGCACGAATGAGCAGTTCTTC	CASRRGGTRTNEQFF	TRBV6-1	TRBJ2-1
TGTGCCATCAGTGAGGACGGGGGAACCCGGGATTCACCCCTCCACTTT	CAISEDGGTRDSPLHF	TRBV10-3	TRBJ1-6
TGTGCCAGCAGCTGCGGGACAGGGATTCCCGGGGAGCTGTTTTTT	CASSCGTGIPGELFF	TRBV7-2	TRBJ2-2
TGTGCCACCAGCAGAGCGGTAGACAGGCCAGGAAAAGCCAAAAACATTCAGTACTTC	CATSRAVDRPGKAKNIQYF	TRBV15	TRBJ2-4
TGCGCCAGTCTCCATAGACTAGCGGGAGGAATAGGCAATGAGCAGTTCTTC	CASLHRLAGGIGNEQFF	TRBV10-2	TRBJ2-1
TGTGCCAGCAGCGGTCCTTGGGGGGGTTCGTTGGACAATGAGCAGTTCTTC	CASSGPWGGSLDNEQFF	TRBV7-3	TRBJ2-1
TGTGCCAGCAGCGAAAGGCGCCGCACCGGGGAGCTGTTTTTT	CASSERRRTGELFF	TRBV6-3	TRBJ2-2
TGCAGTGCTGCCGCGGGGACTAGCGGGGGATACAATGAGCAGTTCTTC	CSAAAGTSGGYNEQFF	TRBV20-1	TRBJ2-1
TGTGCCAGGGGGAACAGGGGGCGCAGGGAGGGTTCACCCCTCCACTTT	CARGNRGRREGSPLHF	TRBV6-4	TRBJ1-6
TGTGCCAGCAGCCCGCTAGCCACCCCTCTAGCCGGTAGGGAGGCCAAAAACATTCAGTACTTC	CASSPLATPLAGREAKNIQYF	TRBV3-1	TRBJ2-4
TGTGCCAGCAGTGAATGGACGGGACAGGGACCCAAAAACACCATATATTTT	CASSEWTGQGPKNTIYF	TRBV2	TRBJ1-3
TGTGCCAGCAGCGGCCGGGACAGAGACTACGAGCAGTACTTC	CASSGRDRDYEQYF	TRBV13	TRBJ2-7
TGCGCCAGCAGCTTGGGATATCCAACTAATGAAAAACTGTTTTTT	CASSLGYPTNEKLFF	TRBV5-1	TRBJ1-4
TGCGCCAGCAGCCCTAGGGCGACTGAAGCTTTCTTT	CASSPRATEAFF	TRBV5-1	TRBJ1-1
TGTGCCAGCAGTGAAGCCGGGACAGGGGGGGGCCCCGTGAACACTGAAGCTTTCTTT	CASSEAGTGGGPVNTEAFF	TRBV2	TRBJ1-1
TGTGCCAGCAGCGTAGATTCCATCAGGGCGGAAGGGGGAATCTGCTCCTACGAGCAGTACTTC	CASSVDSIRAEGGICSYEQYF	TRBV9	TRBJ2-7
TGTGCCAGCAGCCAGAGCAGGGGGCTTTCGAACACTGAAGCTTTCTTT	CASSQSRGLSNTEAFF	TRBV4-2	TRBJ1-1
TGTGGAAGACAGGCCTACGAGCAGTACTTC	CGRQAYEQYF	TRBV6-5	TRBJ2-7
TGTGCCAGCAGCCCCTACAGGGGGCGCACCGGGGAGCTGTTTTTT	CASSPYRGRTGELFF	TRBV12-3	TRBJ2-2
TGTGCCAGCAGCTTAGCGGTAGCTCCATTTAACACTGAAGCTTTCTTT	CASSLAVAPFNTEAFF	TRBV7-2	TRBJ1-1
TGTGCCAGCAGCCAGGGGTCCAAGACCGGGGAGCTGTTTTTT	CASSQGSKTGELFF	TRBV3-1	TRBJ2-2
TGTGCCAGCAGGGACAGGGGGACTAACTATGGCTACACCTTC	CASRDRGTNYGYTF	TRBV5-6	TRBJ1-2
TGTGCCACCGATCGGGACTCCGACGAGCAGTACTTC	CATDRDSDEQYF	TRBV15	TRBJ2-7
TGTGCCAGCAGCGCTGGACACGAGCAGTACTTC	CASSAGHEQYF	TRBV7-9	TRBJ2-7
TGTGCCAGCAGTTTACCCCGGACTAAAGGTCGTTCTGAGCAGTACTTC	CASSLPRTKGRSEQYF	TRBV27	TRBJ2-7
TGCAGTGCTCCCTTCCGACAGGGAAGGGTGCTCCATCAGCCCCAGCATTTT	CSAPFRQGRVLHQPQHF	TRBV20-1	TRBJ1-5
TGTGCCAGCAGTTATGGGGGGACTTATGTTGGCTCTGGAAACACCATATATTTT	CASSYGGTYVGSGNTIYF	TRBV6-9	TRBJ1-3
TGTGCCAGCAGTGGCTGGGACAGACTATATGGCTACACCTTC	CASSGWDRLYGYTF	TRBV25-1	TRBJ1-2
TGTGCCAGCAGGCCCTACCGGGTGTCACCCCTCCACTTT	CASRPYRVSPLHF	TRBV7-9	TRBJ1-6
TGTGCCAGCAGCTTGCAGGGACACATGAACACTGAAGCTTTCTTT	CASSLQGHMNTEAFF	TRBV5-5	TRBJ1-1
TGTGTTTCGACTAGGGGGGAGACCCAGTACTTC	CVSTRGETQYF	TRBV6-2	TRBJ2-5
TGTGCCAGCAGCCACCAGGGGGGGCCTACCCTAGATACGCAGTATTTT	CASSHQGGPTLDTQYF	TRBV3-1	TRBJ2-3
TGTGCCATCAGGGCCAGGTCTAACTATGGCTACACCTTC	CAIRARSNYGYTF	TRBV10-3	TRBJ1-2
TGTGCCAGCAGTTCCAAAGAGGGGAACGAGCAGTACTTC	CASSSKEGNEQYF	TRBV6-1	TRBJ2-7
TGCGCCAGCAGTGTGCAGGACATGCGGTCTGGAAACACCATATATTTT	CASSVQDMRSGNTIYF	TRBV10-2	TRBJ1-3
TGTGCCAGCAGTGATCGACAGGGTAATGAAAAACTGTTTTTT	CASSDRQGNEKLFF	TRBV6-1	TRBJ1-4
TGTGCCAGCAGTTACTCAGGGGTCGGAGCTGAAGCTTTCTTT	CASSYSGVGAEAFF	TRBV6-3	TRBJ1-1
TGTGCCAGCAGCAACTGCCAGCCTGTTGCCGCTTTCTTT	CASSNCQPVAAFF	TRBV7-3	TRBJ1-1
TGTGCCAGCAGTTTTGGGACAGCCATGCAAGAGACCCAGTACTTC	CASSFGTAMQETQYF	TRBV27	TRBJ2-5
TGTGCCAGCAGTGAGCGAATTCGACTAGGAAGCTCCTACAATGAGCAGTTCTTC	CASSERIRLGSSYNEQFF	TRBV2	TRBJ2-1
TGTGCCTGGAGTCGGCTAGCGGGGAGGTGGGTTAGCAAAAACATTCAGTACTTC	CAWSRLAGRWVSKNIQYF	TRBV30	TRBJ2-4
TGTGCCAGGAATAGGGGGCCCCTGACCACTGAAGCTTTCTTT	CARNRGPLTTEAFF	TRBV5-6	TRBJ1-1
TGTGCCAGCAGTTACGGACCACTCAGTCGAGACGAGCAGTACTTC	CASSYGPLSRDEQYF	TRBV6-5	TRBJ2-7
TGTGCCAGCCTGGGGGACTATGGCTACACCTTC	CASLGDYGYTF	TRBV7-2	TRBJ1-2
TGTGCCAGCAGCCCACCCTTCTCCCGGGAGGGACCCGAGACCCAGTACTTC	CASSPPFSREGPETQYF	TRBV13	TRBJ2-5
TGCAGTGCACGTACCGGGACCTACGAGCAGTACTTC	CSARTGTYEQYF	TRBV20-1	TRBJ2-7
TGTGCCACCAGCAGAGTTCGACAGGGAAACATTCAGTACTTC	CATSRVRQGNIQYF	TRBV15	TRBJ2-4
TGCAGTGCTAGAGATGCAGGGCAGGACAGGAAAGGAAATGAAAAACTGTTTTTT	CSARDAGQDRKGNEKLFF	TRBV20-1	TRBJ1-4
TGTGCCAGCAGCTTGACTTCGGGTTCCTACGAGCAGTACTTC	CASSLTSGSYEQYF	TRBV5-4	TRBJ2-7
TGCAGCGTTGATCCTACAGGGTGGGCGGGCAATCAGCCCCAGCATTTT	CSVDPTGWAGNQPQHF	TRBV29-1	TRBJ1-5
TGTGCCAGCAGTGTCCGTACAGGGGAAAAACTGTTTTTT	CASSVRTGEKLFF	TRBV6-4	TRBJ1-4
TGTGCCAGCAGTGAATCTAGGAGGGTCTACGAGCAGTACTTC	CASSESRRVYEQYF	TRBV25-1	TRBJ2-7
TGTGCCTGGAGCCCCCAGGGTTCTAACTATGGCTACACCTTC	CAWSPQGSNYGYTF	TRBV30	TRBJ1-2
TGTGCCAGCAGCTATGCGGACAGACTAGGAATCTCCTACAATGAGCAGTTCTTC	CASSYADRLGISYNEQFF	TRBV9	TRBJ2-1
TGTGCCAGCAGCTTGCCCGCCGGGACAGGGGGCGCTTGCGACGACTATGGCTACACCTTC	CASSLPAGTGGACDDYGYTF	TRBV5-5	TRBJ1-2
TGTGCCAGCCCTACAGGCAGGGTGAACACTGAAGCTTTCTTT	CASPTGRVNTEAFF	TRBV6-5	TRBJ1-1
TGTGCCAGCTCACGACTGCCCTACGAGCAGTACTTC	CASSRLPYEQYF	TRBV18	TRBJ2-7
TGTGCCAGCAGTAATGGAGCAGGGGCTTACAATGAGCAGTTCTTC	CASSNGAGAYNEQFF	TRBV28	TRBJ2-1
TGTGCCAGCAGTTTTACTACACGGGCAGGGGAACGTAATGATACGCAGTATTTT	CASSFTTRAGERNDTQYF	TRBV12-3	TRBJ2-3
TGTGCCAGCAGAACCGGGAAGCACAATCAGCCCCAGCATTTT	CASRTGKHNQPQHF	TRBV6-5	TRBJ1-5
TGTGCCCGAGCGGGAGGTTCCGAGACCCAGTACTTC	CARAGGSETQYF	TRBV28	TRBJ2-5
TGTGCCAGCAGCGCCCCACCTACAGGGGACTACGAGCAGTACTTC	CASSAPPTGDYEQYF	TRBV5-6	TRBJ2-7
TGTGCCAGCAGGGGGGGCTCGGGGGGCCAAGAGACCCAGTACTTC	CASRGGSGGQETQYF	TRBV4-2	TRBJ2-5
TGCAGTGCTAGACGGGGGCGGGCGCATCATAATTCACCCCTCCACTTT	CSARRGRAHHNSPLHF	TRBV20-1	TRBJ1-6
TGCAGTGCTAGAGGAGGAGGGCCGGGTGAGACCCAGTACTTC	CSARGGGPGETQYF	TRBV20-1	TRBJ2-5
TGCAGCGGCTTCTGGACCGGGACAGCTGAGACCCAGTACTTC	CSGFWTGTAETQYF	TRBV29-1	TRBJ2-5
TGCAGTGCGCTCGGGACATGGGGAAACACCATATATTTT	CSALGTWGNTIYF	TRBV20-1	TRBJ1-3
TGTGCCAGCAGCCATTGGGGGGCCCTCATGAACACTGAAGCTTTCTTT	CASSHWGALMNTEAFF	TRBV7-3	TRBJ1-1
TGTGCCAGCAGCCATGCGGGAGCTGGTTTAACAGATACGCAGTATTTT	CASSHAGAGLTDTQYF	TRBV7-4	TRBJ2-3
TGTGCCAGCGGCGGACGGGGGACAGGGTCTGGGTATAGCAATCAGCCCCAGCATTTT	CASGGRGTGSGYSNQPQHF	TRBV6-5	TRBJ1-5
TGTGCCAGCAGTGACTCGACCTGTCCCACGGACAAAGGTACTGAAGCTTTCTTT	CASSDSTCPTDKGTEAFF	TRBV6-4	TRBJ1-1
TGCGCCAGCAGAACAGGGACCCCGGATGAGCAGTTCTTC	CASRTGTPDEQFF	TRBV5-1	TRBJ2-1
TGTGCCAGCATCATGACAGGGGCGCCTGGGGCCAACGTCCTGACTTTC	CASIMTGAPGANVLTF	TRBV27	TRBJ2-6
TGTGCCAGCAGCCTCATCCCTATGCGGGAGGGCAGGGGTAGCACAGATACGCAGTATTTT	CASSLIPMREGRGSTDTQYF	TRBV3-1	TRBJ2-3
TGTGCCAGCAGTTACTTCTCCTACGAGCAGTACTTC	CASSYFSYEQYF	TRBV6-2	TRBJ2-7
TGCGCCAGCAGTGAGTCGCCTACTCCCAGGAACACTGAAGCTTTCTTT	CASSESPTPRNTEAFF	TRBV10-2	TRBJ1-1
TGTGCCAGCAGCCCGCGGTATCTGGAAGAGACCCAGTACTTC	CASSPRYLEETQYF	TRBV12-3	TRBJ2-5
TGTGCCAGCAGCGGAAGGGGAGAAACGACAGGGTCGAGGATCTCCTACGAGCAGTACTTC	CASSGRGETTGSRISYEQYF	TRBV5-6	TRBJ2-7
TGTGCCTGGATCGACGACCTGGGGACCCGGGACGATACGCAGTATTTT	CAWIDDLGTRDDTQYF	TRBV30	TRBJ2-3
TGTGCCAGCAGCTCCTCTTTCACGGGCGCTGGAAACACCATATATTTT	CASSSSFTGAGNTIYF	TRBV7-2	TRBJ1-3
TGTGCCAGCAGCTTAGCGAGGGGACAGGGGGTCGAGCAGTACTTC	CASSLARGQGVEQYF	TRBV7-2	TRBJ2-7
TGTGCCAGCAGCTGGGGCTACACCTTC	CASSWGYTF	TRBV7-8	TRBJ1-2
TGTGCCAGTAGTCGAAGGGTGGACAGAGACGAGCAGTACTTC	CASSRRVDRDEQYF	TRBV19	TRBJ2-7
TGTGCCAGCAGTAATCCGGGACAGGGCACGTCTGGAAACACCATATATTTT	CASSNPGQGTSGNTIYF	TRBV27	TRBJ1-3
TGCGCCAGCAAGAGACACAGGTCCTACGAGCAGTACTTC	CASKRHRSYEQYF	TRBV10-1	TRBJ2-7
TGTGCCAGCAGACAGCTGAATCAGCCCCAGCATTTT	CASRQLNQPQHF	TRBV6-1	TRBJ1-5
TGTGCCAGGCGTGGACAGGGTATTAGGCGGGCAAGCTCCTACGAGCAGTACTTC	CARRGQGIRRASSYEQYF	TRBV6-5	TRBJ2-7
TGTGCCAGCAGCTACCGGGGTTCTGGGACTAACTATGGCTACACCTTC	CASSYRGSGTNYGYTF	TRBV7-9	TRBJ1-2
TGTGCCAGCAGTTTACCAGGGGGCGTAGATGAGCAGTTCTTC	CASSLPGGVDEQFF	TRBV12-4	TRBJ2-1
TGTGCCAGCAGCCGCATGAGCGTAGGACAGGGGAGGCCCACCTTC	CASSRMSVGQGRPTF	TRBV7-2	TRBJ1-2
TGTGGGGCCGCGAACACTGAAGCTTTCTTT	CGAANTEAFF	TRBV30	TRBJ1-1
TGTGCCAGCAGTTTGGAGGGGGAGAACAATGAGCAGTTCTTC	CASSLEGENNEQFF	TRBV12-4	TRBJ2-1
TGTGCCAGCAGCTTTACCAATAGCTGTTTCGACAGGATGGGCTACACCTTC	CASSFTNSCFDRMGYTF	TRBV11-2	TRBJ1-2
TGTGCCAGCAGGCTGCCCAGGGGAGAGACCCAGTACTTC	CASRLPRGETQYF	TRBV6-2	TRBJ2-5
TGTGCCACCAGTGACTCGAGAGCAGGGATCGTATCCGGGGAGCTGTTTTTT	CATSDSRAGIVSGELFF	TRBV24-1	TRBJ2-2
TGTGCCAGCAGCTTTTATACCACAGGGGTCGATCGCTACAATGAGCAGTTCTTC	CASSFYTTGVDRYNEQFF	TRBV9	TRBJ2-1
TGTGCCAGCAACCTATCTTCCTACGAGCAGTACTTC	CASNLSSYEQYF	TRBV5-4	TRBJ2-7
TGTGCCAGCTTCCGCCGGCGCCTTGAAGGCGAGCAGTACTTC	CASFRRRLEGEQYF	TRBV25-1	TRBJ2-7
TGTGCCAGCAGCCAAGATTATTCGGGAGGAGCCTACAATGAGCAGTTCTTC	CASSQDYSGGAYNEQFF	TRBV3-1	TRBJ2-1
TGTGCCAGGGGGAGTGGGGGACAGGGGCTAGCCAAAAACATTCAGTACTTC	CARGSGGQGLAKNIQYF	TRBV6-5	TRBJ2-4
TGTGCCATCAGCTCGATTACTACGGGGGGGACTGTGGACACTGAAGCTTTCTTT	CAISSITTGGTVDTEAFF	TRBV10-3	TRBJ1-1
TGTGCCCATCGGGGGAAATATGGCTACACCTTC	CAHRGKYGYTF	TRBV10-3	TRBJ1-2
TGTGCCAGCAGCACCCCACGACGAAGCCTGGGACAGGGAAGTACTGAAGCTTTCTTT	CASSTPRRSLGQGSTEAFF	TRBV13	TRBJ1-1
TGTGCCAGCATGAAGGGGGTCCTAGGCTACACCTTC	CASMKGVLGYTF	TRBV25-1	TRBJ1-2
TGTGCCAGCAGTCGGGGACTAGAGACCCAGTACTTC	CASSRGLETQYF	TRBV2	TRBJ2-5
TGTGCCAGCAGCTCGGACAGGGGCTTCCATGGCTACACCTTC	CASSSDRGFHGYTF	TRBV7-2	TRBJ1-2
TGTGCCAGCAGCGCGGGGCCCTGCGCTAATGAAAAACTGTTTTTT	CASSAGPCANEKLFF	TRBV13	TRBJ1-4
TGCAGTGCCCATGGGAATTACGAGCAGTACTTC	CSAHGNYEQYF	TRBV20-1	TRBJ2-7
TGTGCCAGCTCACGGGGGAGCACAGATACGCAGTATTTT	CASSRGSTDTQYF	TRBV18	TRBJ2-3
TGTGCCACGGAGGGGGCTAACACTGAAGCTTTCTTT	CATEGANTEAFF	TRBV7-9	TRBJ1-1
TGTGCCAAACTTTCTGGCTCAGATACGCAGTATTTT	CAKLSGSDTQYF	TRBV10-3	TRBJ2-3
TGTGCTAGTGGTTTGGGCCCTAGGCTACTACCCTCTGGGGCCAACGTCCTGACTTTC	CASGLGPRLLPSGANVLTF	TRBV12-5	TRBJ2-6
TGTGCCAGCAGCTTATGGGCCCCAGCTTTCTTT	CASSLWAPAFF	TRBV11-2	TRBJ1-1
TGTGCCAGCAGCCAAGATAGAGGTATTAGTGATACGCAGTATTTT	CASSQDRGISDTQYF	TRBV4-2	TRBJ2-3
TGTGCCAGCAGTCCAGGGCTTCACTATGGCTACACCTTC	CASSPGLHYGYTF	TRBV7-2	TRBJ1-2
TGCGCCAGCAGCAGATGTGCAGGGGGGAATGAAAAACTGTTTTTT	CASSRCAGGNEKLFF	TRBV5-1	TRBJ1-4
TGTGCCAGCAGTTTACCGGGGGACACTTCCAATCAGCCCCAGCATTTT	CASSLPGDTSNQPQHF	TRBV12-4	TRBJ1-5
TGTGCCAGCAGCCCCCGGGGTTATGGCTACACCTTC	CASSPRGYGYTF	TRBV7-9	TRBJ1-2
TGTGCCAGCAGCGATGACAGCGAGACCTACGAGCAGTACTTC	CASSDDSETYEQYF	TRBV7-4	TRBJ2-7
TGTGCCAGCAGCGTAACCAACTTGGGGCCTAATGAAAAACTGTTTTTT	CASSVTNLGPNEKLFF	TRBV9	TRBJ1-4
TGTGCCAGCAGTTACGAACGTCGGGGCTTTGAGCAGTTCTTC	CASSYERRGFEQFF	TRBV6-5	TRBJ2-1
TGCAGTGCGAGAACGGGGACTAGCGGGAGTCCGGCAGATACGCAGTATTTT	CSARTGTSGSPADTQYF	TRBV20-1	TRBJ2-3
TGTGCCAGCAGCTTAGGCACGGGGGGGCTCCACAATGAGCAGTTCTTC	CASSLGTGGLHNEQFF	TRBV11-3	TRBJ2-1
TGTGCCAGCAGCTTAGATATAAACGGTTTCGAGCAGTACTTC	CASSLDINGFEQYF	TRBV11-3	TRBJ2-7
TGTGCCAGCAACAGGGGCCTCAGGAATGCTTTCTTT	CASNRGLRNAFF	TRBV27	TRBJ1-1
TGTGCCAGCAGCGTAGCGCGACCTCAACAAGGGAAATATAATTCACCCCTCCACTTT	CASSVARPQQGKYNSPLHF	TRBV9	TRBJ1-6
TGTGCCAGCAGCCCGAGAGACACTGGAAACACCATATATTTT	CASSPRDTGNTIYF	TRBV13	TRBJ1-3
TGTGCCACCATCCGGCGCCTATTAGGCACCGGGGAGCTGTTTTTT	CATIRRLLGTGELFF	TRBV24-1	TRBJ2-2
TGCGCCCCCGAGGGGGGACAGGGGCGTCCGAACACCGGGGAGCTGTTTTTT	CAPEGGQGRPNTGELFF	TRBV10-1	TRBJ2-2
TGTGCCAGTAGGACCGAAGCGGCGCAGTACTTC	CASRTEAAQYF	TRBV19	TRBJ2-7
TGTGCCAGTAGTATAACCCGGTTCTGCGAGCAGTACTTC	CASSITRFCEQYF	TRBV19	TRBJ2-7
TGCGCCAGCAGCTTGGCAGACAGGGCTCCACATGAGCAGTTCTTC	CASSLADRAPHEQFF	TRBV5-1	TRBJ2-1
TGTGCCAGCGGCCCGGGACGCGGGTTTGAGCAGTTCTTC	CASGPGRGFEQFF	TRBV2	TRBJ2-1
TGTGCCAGCAGCCCGGGGCCCAGGGGGGCTAATGGCTACACCTTC	CASSPGPRGANGYTF	TRBV13	TRBJ1-2
TGTGCCAGCAGTGACTCCCTTGACAGGTGTACATACGAGCAGTACTTC	CASSDSLDRCTYEQYF	TRBV6-4	TRBJ2-7
TGTGCCAAGTGGGGGACAGTACGAGAGACCCAGTACTTC	CAKWGTVRETQYF	TRBV12-4	TRBJ2-5
TGTGCCAGCAGATGGGCGGCGGCCTACGAGCAGTACTTC	CASRWAAAYEQYF	TRBV28	TRBJ2-7
TGTGCCAGCAGTACCACGGGGGCCAGCTCCTACAATGAGCAGTTCTTC	CASSTTGASSYNEQFF	TRBV25-1	TRBJ2-1
TGTGCCAGCAGTGAGAAGGTTGGAACAGGGGTGTCTTACTTC	CASSEKVGTGVSYF	TRBV27	TRBJ2-4
TGCAGTGCTGACAGGGCGGAGGACTATGGCTACACCTTC	CSADRAEDYGYTF	TRBV20-1	TRBJ1-2
TGTGCCCCCCTAGTAAACTATAGCAATCAGCCCCAGCATTTT	CAPLVNYSNQPQHF	TRBV9	TRBJ1-5
TGTGCCAGCAGTAAAATGGAGGGACAGAACACTGAAGCTTTCTTT	CASSKMEGQNTEAFF	TRBV27	TRBJ1-1
TGTGCCAGCAGCGTATATGACAGGGCCCAGGACACTGAAGCTTTCTTT	CASSVYDRAQDTEAFF	TRBV9	TRBJ1-1
TGTGCCAGCAGCTGGAGGACAGGGATGAACACTGAAGCTTTCTTT	CASSWRTGMNTEAFF	TRBV7-4	TRBJ1-1
TGTGCCAGCAGCTGCGGGAGGGAGATACGGCACGAGCAGTACTTC	CASSCGREIRHEQYF	TRBV7-6	TRBJ2-7
TGTGCCACCAGGACAGCTCGTCAGCCCCAGCATTTT	CATRTARQPQHF	TRBV24-1	TRBJ1-5
TGTGCCAGCAGCCAAGACGGACTAGCGGGGGGGGCGCAAGAGACCCAGTACTTC	CASSQDGLAGGAQETQYF	TRBV14	TRBJ2-5
TGTGCCAGCAGCTTGGTGGACTGGAGGCAGTATTTT	CASSLVDWRQYF	TRBV7-2	TRBJ2-3
TGTGCCACCAGTGATCCTCGAAAGCGGGCCAGGGAACGGAACGAGCAGTACTTC	CATSDPRKRARERNEQYF	TRBV24-1	TRBJ2-7
TGTGCCAGCAGCTCCTTCCCCAGGACCTCTGGGGCCAACGTCCTGACTTTC	CASSSFPRTSGANVLTF	TRBV7-2	TRBJ2-6
TGTGCCAGCAGCTGGGTACAGACCCAGTACTTC	CASSWVQTQYF	TRBV27	TRBJ2-5
TGTGCCTGGAGGTGGGGGACGGAGGAGTATGGTGGGGCTTTCTTT	CAWRWGTEEYGGAFF	TRBV30	TRBJ1-1
TGTGCCAGCAGTATAAGGAAATTGGGACAGGGGTATAGCAATCAGCCCCAGCATTTT	CASSIRKLGQGYSNQPQHF	TRBV6-1	TRBJ1-5
TGCGCCAGCAGCGGGACACTTTGGCAGCCCCAGCATTTT	CASSGTLWQPQHF	TRBV5-1	TRBJ1-5
TGCAGTGCTAGAGATCGAACCGACCGGGACAGCTACACTGAAGCTTTCTTT	CSARDRTDRDSYTEAFF	TRBV20-1	TRBJ1-1
TGTGCCAGCAGTGTGGGGGAAGGGACAGAGGTGGTAGGCTACACCTTC	CASSVGEGTEVVGYTF	TRBV2	TRBJ1-2
TGTGCCAGCAGTGACACCCGACAGGGCTCCGGGGACGAGCAGTACTTC	CASSDTRQGSGDEQYF	TRBV6-4	TRBJ2-7
TGTGCCAGCAGCGTTCTCAGGGGTGAGCCCCAGCATTTT	CASSVLRGEPQHF	TRBV11-3	TRBJ1-5
TGTGCCAGCAGGACGGGGAGAGAGCTTAGCAATCAGCCCCAGCATTTT	CASRTGRELSNQPQHF	TRBV28	TRBJ1-5
TGTGCCAGCAGCTTCGGGGACAGCGAGGTCTACACCTTC	CASSFGDSEVYTF	TRBV5-5	TRBJ1-2
TGTGCCAGCAGCCCGGACAGGGCTGAAGCTTTCTTT	CASSPDRAEAFF	TRBV3-1	TRBJ1-1
TGTGCCATCAGTGAAGGCAACGAGCAGTACTTC	CAISEGNEQYF	TRBV10-3	TRBJ2-7
TGCGCCAGCAGGGGGGTGGGGGACACTCCGTACGAGCAGTACTTC	CASRGVGDTPYEQYF	TRBV10-1	TRBJ2-7
TGTGCCAGCAGCCAAGAGTCACAGGTGTACGAGCAGTACTTC	CASSQESQVYEQYF	TRBV14	TRBJ2-7
TGTGCCAGCAGCTTGGCGGGGAATTTTCCGCCCAGGGGATCCTCACCCCTCCACTTT	CASSLAGNFPPRGSSPLHF	TRBV5-6	TRBJ1-6
TGTGCCAGCTCACCGGATGTAAGGGATCAGAAAGCTTTCTTT	CASSPDVRDQKAFF	TRBV18	TRBJ1-1
TGCGCCAGCGTCGCAGGGGGCACCGTCATGTATGGCTACACCTTC	CASVAGGTVMYGYTF	TRBV5-1	TRBJ1-2
TGCGCCAGCAGCTTGGCTCCCACGAAAGACTCCTACGAGCAGTACTTC	CASSLAPTKDSYEQYF	TRBV5-1	TRBJ2-7
TGCAGTGCCCCAATGGACACAGGTAACTCACCCCTCCACTTT	CSAPMDTGNSPLHF	TRBV20-1	TRBJ1-6
TGTGCCACCAGCATAGTGCTTTCGACAGGGGAGACAAACTACGAGCAGTACTTC	CATSIVLSTGETNYEQYF	TRBV15	TRBJ2-7
TGTGCCAGTCGGTCCCTAGCGGGTGAGCAGTTCTTC	CASRSLAGEQFF	TRBV19	TRBJ2-1
TGTGCCAGCAGCACGTTGACTAGCGGGAGGGCGGATACGCAGTATTTT	CASSTLTSGRADTQYF	TRBV7-9	TRBJ2-3
TGTGCCAGCAGCTTCGAAAAGGGACGGGCAGATACGCAGTATTTT	CASSFEKGRADTQYF	TRBV13	TRBJ2-3
TGTGCCAGCAGCAATAGAACCTCGGCAGGTATGACGTCCGTGTCCTACAATGAGCAGTTCTTC	CASSNRTSAGMTSVSYNEQFF	TRBV7-4	TRBJ2-1
TGTGCCAGCAGAGGCAGGGCCTATGGCTACACCTTC	CASRGRAYGYTF	TRBV28	TRBJ1-2
TGTGCCAGCAGCTGCGTAGTAACAGGGGAGAACACTGAAGCTTTCTTT	CASSCVVTGENTEAFF	TRBV11-1	TRBJ1-1
TGTGCCAGTCCGGAAGGACTCTCCTATAATTCACCCCTCCACTTT	CASPEGLSYNSPLHF	TRBV25-1	TRBJ1-6
TGTGCCAGCAGCCTTTCAGGGGCCGCCCAGTACTTC	CASSLSGAAQYF	TRBV13	TRBJ2-5
TGCAGCGGAAAGGGGGCCGACGAGCAGTACTTC	CSGKGADEQYF	TRBV29-1	TRBJ2-7
TGCGCCAGCAGCCGACTGGAGCGAGGCACGAATTCACCCCTCCACTTT	CASSRLERGTNSPLHF	TRBV4-1	TRBJ1-6
TGTGCCACCAGTCTTTCCCTACTTTACCTCACGAACACTGAAGCTTTCTTT	CATSLSLLYLTNTEAFF	TRBV24-1	TRBJ1-1
TGCAGTGCTAGAGGAACAACCGGGGGACTACGGACAGGTGGGGCTTTCTTT	CSARGTTGGLRTGGAFF	TRBV20-1	TRBJ1-1
TGTGCCAGAACAAACAGGGGGGGAAGGGGCTTGGAGACCCAGTACTTC	CARTNRGGRGLETQYF	TRBV9	TRBJ2-5
TGTGCCAGCAGCCGGGGGACAGGGGGGCATGGCTACACCTTC	CASSRGTGGHGYTF	TRBV6-2	TRBJ1-2
TGTGCCAGCAGCGAAGGGGGGTCACAGCCCCAGCATTTT	CASSEGGSQPQHF	TRBV5-6	TRBJ1-5
TGCGCCAGCAGTGCCGACAGGGGGAAGCACACCATATATTTT	CASSADRGKHTIYF	TRBV10-1	TRBJ1-3
TGTGCCAGCAGCCAACACCCCACAGTGGTTCGGAGGTCTGGAAACACCATATATTTT	CASSQHPTVVRRSGNTIYF	TRBV3-1	TRBJ1-3
TGTGCCAGCTCCCCAGGACAGGGTTCCTACGAGCAGTACTTC	CASSPGQGSYEQYF	TRBV18	TRBJ2-7
TGTGCCAGCACCCCGGTAGCGGGACTTTCCTACGAGCAGTACTTC	CASTPVAGLSYEQYF	TRBV6-5	TRBJ2-7
TGTGCCAGCAGTCCCGGGACGAGCTACGAGCAGTACTTC	CASSPGTSYEQYF	TRBV7-2	TRBJ2-7
TGTGCCAGCAGCTTAGGCCCGCGGGAGAGACCCAGGGACTACAATGAGCAGTTCTTC	CASSLGPRERPRDYNEQFF	TRBV7-6	TRBJ2-1
TGTGCCAGCAGCTTAGGGTCCCCCTGCGGGAGGGGGACGTACGAGCAGTACTTC	CASSLGSPCGRGTYEQYF	TRBV11-3	TRBJ2-7
TGTGCCACCAGTGATTATGAGGGAGGCTACAATGAGCAGTTCTTC	CATSDYEGGYNEQFF	TRBV24-1	TRBJ2-1
TGCGCCAGCAGTGGTCCCACTAGCGGGAGGTACCACAGGTACAATGAGCAGTTCTTC	CASSGPTSGRYHRYNEQFF	TRBV10-1	TRBJ2-1
TGTGCCAGCAGCTCCGGTCAGGGGCCGGTGAACACTGAAGCTTTCTTT	CASSSGQGPVNTEAFF	TRBV11-2	TRBJ1-1
TGTGCCAGTAGGGTGACTAGTGTGGTGACGTTGGCCTACGAGCAGTACTTC	CASRVTSVVTLAYEQYF	TRBV19	TRBJ2-7
TGTGCCAGCAGCTTGGAGAAGTCCGTCAAGAGTCAGACTGCCGGGGAGCTGTTTTTT	CASSLEKSVKSQTAGELFF	TRBV5-6	TRBJ2-2
TGCGCCAGCAGCTTGACCAGAAGGGCGCCGAGCAATCAGCCCCAGCATTTT	CASSLTRRAPSNQPQHF	TRBV5-1	TRBJ1-5
TGTGCCTGGAGCAGGGTGAATGGGGCCAACGTCCTGACTTTC	CAWSRVNGANVLTF	TRBV30	TRBJ2-6
TGTGCCAGCAGCCCCCGGACAGGGAAACAGAACACTGAAGCTTTCTTT	CASSPRTGKQNTEAFF	TRBV5-6	TRBJ1-1
TGTGCCACCAGTGATTTGATCAAAAGAGGCTATGGCTACACCTTC	CATSDLIKRGYGYTF	TRBV24-1	TRBJ1-2
TGTGCCATCAGTGGACAGGAGAGCTCCTATAATTCACCCCTCCACTTT	CAISGQESSYNSPLHF	TRBV10-3	TRBJ1-6
TGTGCCACCGGGGACTCCAATGAGCAGTTCTTC	CATGDSNEQFF	TRBV15	TRBJ2-1
TGTGCCAGCAGTGAGACAGGAATAAACCTAGCTGAGCAGTACTTC	CASSETGINLAEQYF	TRBV25-1	TRBJ2-7
TGTGCCAGTAGTAGAGTTTACCCAGGGAGGGGGGGCAATCAGCCCCAGCATTTT	CASSRVYPGRGGNQPQHF	TRBV19	TRBJ1-5
TGCGCCAGCAGGGATCCCGGAGGGGCGCGGGTACAGGACTACAATGAGCAGTTCTTC	CASRDPGGARVQDYNEQFF	TRBV5-1	TRBJ2-1
TGCGCCAGCAGCTGTAGCGGCAATCAGCCCCAGCATTTT	CASSCSGNQPQHF	TRBV5-1	TRBJ1-5
TGTGCCAGCAGCCAAGTGGCCATCAGGGCCAACGTCCTGACTTTC	CASSQVAIRANVLTF	TRBV3-1	TRBJ2-6
TGTGCCAGCTACCAGAGGGTGCCTCCGAACACCGGGGAGCTGTTTTTT	CASYQRVPPNTGELFF	TRBV12-4	TRBJ2-2
TGTGCCAGCAGTGATTTCCCCCGGTCTATTGAGACCCAGTACTTC	CASSDFPRSIETQYF	TRBV6-1	TRBJ2-5
TGCAGTGCTAGAGGCACCGCCAAGGGGGCCCGAAAGACAACTAATGAAAAACTGTTTTTT	CSARGTAKGARKTTNEKLFF	TRBV20-1	TRBJ1-4
TGTGCCAGCAGCAAAATCTACCGGGACGGCTCCTACGAGCAGTACTTC	CASSKIYRDGSYEQYF	TRBV7-2	TRBJ2-7
TGTGCCAGCTCGGCTCCTTCGCTATGGGACAGTAATAATTCACCCCTCCACTTT	CASSAPSLWDSNNSPLHF	TRBV27	TRBJ1-6
TGTGCCAGCAGCAAATCGACAGGCACCACAGATACGCAGTATTTT	CASSKSTGTTDTQYF	TRBV13	TRBJ2-3
TGTGCCAGCAGCTTGAGGCTCCCTCAGCCCCAGCATTTT	CASSLRLPQPQHF	TRBV5-6	TRBJ1-5
TGTGCCAGTACCCAGACAGGGTTTCGGGGTGGAAACACCATATATTTT	CASTQTGFRGGNTIYF	TRBV19	TRBJ1-3
TGTGCCAGCAGTTACCGCATTCGGAGAGCAACAGATACGCAGTATTTT	CASSYRIRRATDTQYF	TRBV6-5	TRBJ2-3
TGTGCCAGCAGCCCGACGACTAGAGGAGGGGGGGAGCTGTTTTTT	CASSPTTRGGGELFF	TRBV7-3	TRBJ2-2
TGTGCCAGCCCGGGACTAGACAATGAGCAGTTCTTC	CASPGLDNEQFF	TRBV27	TRBJ2-1
TGTGCCACCAGTGATTTCATGAGAGCTAACTATGGCTACACCTTC	CATSDFMRANYGYTF	TRBV24-1	TRBJ1-2
TGTGCCAGCAGTTCATTCACTGGGACAGGGAGGTCGCAGTATTTT	CASSSFTGTGRSQYF	TRBV6-5	TRBJ2-3
TGTGCCAGCGTCGGGGGGAGCAATCAGCCCCAGCATTTT	CASVGGSNQPQHF	TRBV6-3	TRBJ1-5
TGTGCCAGCAGCGCGGCAGGGAATGAGCAGTTCTTC	CASSAAGNEQFF	TRBV7-3	TRBJ2-1
TGTGCCAGCAGAATGGGGGCCAATTGCTACGAGCAGTACTTC	CASRMGANCYEQYF	TRBV12-4	TRBJ2-7
TGCAGTGCTAGAGGGGCTCCCGCCGGGGAGCTGTTTTTT	CSARGAPAGELFF	TRBV20-1	TRBJ2-2
TGTGCCAGCAGCCCTGCTGCCGGGGAACCTGGAAACACCATATATTTT	CASSPAAGEPGNTIYF	TRBV5-6	TRBJ1-3
TGTGCCAGCACCGGGACGTTAGACGGCGAGCAGTACTTC	CASTGTLDGEQYF	TRBV28	TRBJ2-7
TGTGCCAGCCGGTTGGGCCGGGTGGGGCGGGGCTGGCCCTACGAGCAGTACTTC	CASRLGRVGRGWPYEQYF	TRBV6-4	TRBJ2-7
TGCGCCAGCAATATGAGCTCCTACGAGCAGTACTTC	CASNMSSYEQYF	TRBV5-1	TRBJ2-7
TGTGCCAGCAGCCTTGGTTCTCCTTCGGGAAACACCATATATTTT	CASSLGSPSGNTIYF	TRBV3-1	TRBJ1-3
TGTGCCAGTAGTATCAGGGCTAGCGGACTTGAGCAGTTCTTC	CASSIRASGLEQFF	TRBV19	TRBJ2-1
TGTGCCAGCAGCGGCGGGACCTGGGAGAACTACAATGAGCAGTTCTTC	CASSGGTWENYNEQFF	TRBV11-3	TRBJ2-1
TGCGCCAGCAAGGTTACCGGGGGCCATTCGCCCCAGCATTTT	CASKVTGGHSPQHF	TRBV4-3	TRBJ1-5
TGTGCCAGCACCTTAACTAGCGGGAGAGCAAACTATGGCTACACCTTC	CASTLTSGRANYGYTF	TRBV6-4	TRBJ1-2
TGTGCCAGCAGTTTCAAGGACAGAAGTGGCTACACCTTC	CASSFKDRSGYTF	TRBV12-3	TRBJ1-2
TGTGCCAGCAGCGGGACAGGGTACAATGAGCAGTTCTTC	CASSGTGYNEQFF	TRBV7-3	TRBJ2-1
TGTGCCAGCTCACCACCGGGGGCACTACTTGCTTTCTTT	CASSPPGALLAFF	TRBV18	TRBJ1-1
TGTGCCAGCAGCGTAGAGAATTCCGGACGGGACAGACCGGGCGGAAACACCATATATTTT	CASSVENSGRDRPGGNTIYF	TRBV9	TRBJ1-3
TGCAGCGTCGTAACCAGGGTACCTGCAACTAATGAAAAACTGTTTTTT	CSVVTRVPATNEKLFF	TRBV29-1	TRBJ1-4
TGCGCCAGCAGCAGGGGGGGACCCTACGAGCAGTACTTC	CASSRGGPYEQYF	TRBV4-1	TRBJ2-7
TGTGCCAGCAGCGACAGGGCCCGGAACTATGGCTACACCTTC	CASSDRARNYGYTF	TRBV5-6	TRBJ1-2
TGTGCCATCAGTGAAGGGGTAATGCGCAGCACAGATACGCAGTATTTT	CAISEGVMRSTDTQYF	TRBV10-3	TRBJ2-3
TGCGCCAGCAGCCAAGAGACCAGAAGGGACAGGGGAACCTACGAGCAGTACTTC	CASSQETRRDRGTYEQYF	TRBV4-1	TRBJ2-7
TGTGCCAGCAGTGACTCGACAGGGGCGATTTCCGGGGAGCTGTTTTTT	CASSDSTGAISGELFF	TRBV6-4	TRBJ2-2
TGTGCCAGCCAGGGCCCCTCTTTTACCCCGACAAAAATGGAGGGGTACGGGGAGCTGTTTTTT	CASQGPSFTPTKMEGYGELFF	TRBV9	TRBJ2-2
TGTGCCAGCAGCTTAGGGGTTGACGCATCACTTACAGGGATTGAAAAACTGTTTTTT	CASSLGVDASLTGIEKLFF	TRBV7-9	TRBJ1-4
TGTGCCAGCAGCTGGGGGGGTGCGGGGGGCTCTGGAAACACCATATATTTT	CASSWGGAGGSGNTIYF	TRBV11-3	TRBJ1-3
TGTGCCAGCTCACCATCCGACGGCCAAGAGACCCAGTACTTC	CASSPSDGQETQYF	TRBV18	TRBJ2-5
TGTGCCAGCAGAGACGAGGGGGCCTATAGCAATCAGCCCCAGCATTTT	CASRDEGAYSNQPQHF	TRBV28	TRBJ1-5
TGTGCCAGCAGTTACTCGCCTAGCGGGAATGAGCAGTTCTTC	CASSYSPSGNEQFF	TRBV6-6	TRBJ2-1
TGTGCCAGCAGCAAGTGGATGGGACACAATAGCAATCAGCCCCAGCATTTT	CASSKWMGHNSNQPQHF	TRBV5-8	TRBJ1-5
TGTGCCAGCAGTGACCCTGCCCCCGGCGACACTGAAGCTTTCTTT	CASSDPAPGDTEAFF	TRBV6-4	TRBJ1-1
TGTGCCAGCAGTTACTCGACCCCTGGTCCCCTAGCGGGGGGGCCTGTCGTCTCCTACGAGCAGTACTTC	CASSYSTPGPLAGGPVVSYEQYF	TRBV6-5	TRBJ2-7
TGTGCCAGCAGCATTAGGAAGCAGTACTTC	CASSIRKQYF	TRBV13	TRBJ2-7
TGTGCCAGCAGTTTATCTGTAATCCCAGACCAGTATGGCTACACCTTC	CASSLSVIPDQYGYTF	TRBV27	TRBJ1-2
TGTGCCAGCAGCTTAGACTGGGACAGGGGGATCTCTGGGGCCAACGTCCTGACTTTC	CASSLDWDRGISGANVLTF	TRBV7-9	TRBJ2-6
TGCAGTGCGTCTGGCACCGGGGCTTGGAAGGGATGCGTGCGACCCCTCCACTTT	CSASGTGAWKGCVRPLHF	TRBV20-1	TRBJ1-6
TGTGCCAGCAAATCCCTCCTCACAGATACGCAGTATTTT	CASKSLLTDTQYF	TRBV27	TRBJ2-3
TGTGCCACCAGACGGGCGTTCGAGACCCAGTACTTC	CATRRAFETQYF	TRBV24-1	TRBJ2-5
TGTGCCAGTATTCAGGGACAGGGACCTAGGAACACTGAAGCTTTCTTT	CASIQGQGPRNTEAFF	TRBV19	TRBJ1-1
TGTGCCAGCAGCCGAGGTAGGACCCACCGGGGTAACACCGGGGAGCTGTTTTTT	CASSRGRTHRGNTGELFF	TRBV7-2	TRBJ2-2
TGTGCCAGCAGCTCGGGACTAGGAAAGAACGAGCAGTACTTC	CASSSGLGKNEQYF	TRBV7-2	TRBJ2-7
TGTGCCAGCAGCAAGGTTGGGGCAACTAACTATGGCTACACCTTC	CASSKVGATNYGYTF	TRBV5-6	TRBJ1-2
TGCAGTGCGGATAACAGGTTGGTAGCGAGGCACGAGCAGTACTTC	CSADNRLVARHEQYF	TRBV20-1	TRBJ2-7
TGCGCCAGCAAACCTACAGGGTCAGGTGAAGCTTTCTTT	CASKPTGSGEAFF	TRBV5-1	TRBJ1-1
TGTGCCAGCAGGGGCGGGGTCCGGGAGACCCAGTACTTC	CASRGGVRETQYF	TRBV7-6	TRBJ2-5
TGTGCCAGCAGCCCAGCGGGCTGGGGGGGCCGGACCGGGGAGCTGTTTTTT	CASSPAGWGGRTGELFF	TRBV13	TRBJ2-2
TGCAGCGTTGAAGATAGTCCGCAGGGGCCCAGGAGCACAGATACGCAGTATTTT	CSVEDSPQGPRSTDTQYF	TRBV29-1	TRBJ2-3
TGCAGTGCCAACCGCCGGACAGGGAGATCCGGAAACACCATATATTTT	CSANRRTGRSGNTIYF	TRBV20-1	TRBJ1-3
TGCGCCAGCAGCTGGGACAGCTACTATGGCTACACCTTC	CASSWDSYYGYTF	TRBV5-1	TRBJ1-2
TGTGCCAGCAGTGTCTGTCAAGGGAGGGTCCTCAAAAACATTCAGTACTTC	CASSVCQGRVLKNIQYF	TRBV6-4	TRBJ2-4
TGTGCCAGCAGAGACAGACCCCCCTACGAGCAGTACTTC	CASRDRPPYEQYF	TRBV12-4	TRBJ2-7
TGTGCCAGCAGCGTACTCCGGGGGGGGAGGAAGTATAACTATGGCTACACCTTC	CASSVLRGGRKYNYGYTF	TRBV28	TRBJ1-2
TGTGCCAGCAACAAAAGGACTAGCAGAGGCTACGAGCAGTACTTC	CASNKRTSRGYEQYF	TRBV6-5	TRBJ2-7
TGTGCCAGCAGTTTAAATCGTGTCCGGCTGGAGTATCCTAGGTTTAGCTCCTACAATGAGCAGTTCTTC	CASSLNRVRLEYPRFSSYNEQFF	TRBV28	TRBJ2-1
TGCGCCAGCAGCCAAGGCGGGCCACAGAAGGATACGCAGTATTTT	CASSQGGPQKDTQYF	TRBV4-1	TRBJ2-3
TGTGCCAGTAGTTTACGACCGGAATTAGTTAAGGATGAAAAACTGTTTTTT	CASSLRPELVKDEKLFF	TRBV19	TRBJ1-4
TGTGCCAGTACTAGCGGGAAATTTGAGCAGTTCTTC	CASTSGKFEQFF	TRBV19	TRBJ2-1
TGTGCCAGCAGCTTAGACGGGGCGCAGTACTTC	CASSLDGAQYF	TRBV7-9	TRBJ2-7
TGTGCCAGCACCGTACTGGGGCCCCGTGGCGGGCAGTTCTTC	CASTVLGPRGGQFF	TRBV9	TRBJ2-1
TGTGCCAGGAGGGGGCGCCGGAGCTATGGCTACACCTTC	CARRGRRSYGYTF	TRBV6-4	TRBJ1-2
TGCGCCAGCCGGCGAGAGGGGGACTCTGGAAACACCATATATTTT	CASRREGDSGNTIYF	TRBV10-1	TRBJ1-3
TGTGCCAGCAGCTGCCCTAACAGAGGGGCCTACGAGCAGTACTTC	CASSCPNRGAYEQYF	TRBV11-1	TRBJ2-7
TGTGCCAGCAGTGACTCGATAGGGATAACGGGCTACGAGCAGTACTTC	CASSDSIGITGYEQYF	TRBV6-4	TRBJ2-7
TGTGCCAGCAGTTTAAAGACAAGGGGGTGCATTCAGTACTTC	CASSLKTRGCIQYF	TRBV27	TRBJ2-4
TGCGCCAGCAGCCAAGCAAGGTCGGGGGGAAGCAATCAGCCCCAGCATTTT	CASSQARSGGSNQPQHF	TRBV4-3	TRBJ1-5
TGTGCCAGCAGCGTAGCGGAGTGTGGACAGCACGCGAACACTGAAGCTTTCTTT	CASSVAECGQHANTEAFF	TRBV9	TRBJ1-1
TGTGCCAGTAGTATTTCGAAAGGACAGGGGGGGGACTATGGCTACACCTTC	CASSISKGQGGDYGYTF	TRBV19	TRBJ1-2
TGCGCCAGCAGCCTGAGGGGAATCTCCTACAATGAGCAGTTCTTC	CASSLRGISYNEQFF	TRBV5-1	TRBJ2-1
TGTGCCAGCAGCCGGAGGACAGATAGCAATCAGCCCCAGCATTTT	CASSRRTDSNQPQHF	TRBV11-3	TRBJ1-5
TGTGCGTGGGGCTCTAAATGCGAGCAGTACTTC	CAWGSKCEQYF	TRBV6-2	TRBJ2-7
TGTGCCAGCAGGAACCCAGAGAGAAACAGCAATCAGCCCCAGCATTTT	CASRNPERNSNQPQHF	TRBV12-4	TRBJ1-5
TGTGCCAAACGAGGGTGGGCTCAAGAGACCCAGTACTTC	CAKRGWAQETQYF	TRBV4-2	TRBJ2-5
TGTGCCAGCAGTTTAAACAGGGGAAACGAGCAGTACTTC	CASSLNRGNEQYF	TRBV6-1	TRBJ2-7
TGTGCCAGCAGCTTGGCCCCACGGGGGACGTCTGGGGCCAACGTCCTGACTTTC	CASSLAPRGTSGANVLTF	TRBV5-8	TRBJ2-6
TGTGCCACCAGTGTGCCTTTGGGGACAGGTTCGACGGAAAAACTGTTTTTT	CATSVPLGTGSTEKLFF	TRBV24-1	TRBJ1-4
TGTGCCAAGGGACAATTTAACAATCAGCCCCAGCATTTT	CAKGQFNNQPQHF	TRBV6-4	TRBJ1-5
TGCGCCATAGGGGGGCTATGTAACGAGCAGTACTTC	CAIGGLCNEQYF	TRBV10-2	TRBJ2-7
TGTGCCAGCAGCGTAGCAGGCCAATTTGGGGGAAAGGTTAACTATGGCTACACCTTC	CASSVAGQFGGKVNYGYTF	TRBV9	TRBJ1-2
TGTGCCAGCAGAGGCAATGGGGGGGCATTTGGCTACACCTTC	CASRGNGGAFGYTF	TRBV12-3	TRBJ1-2
TGCAGTGCGGAAGGGATAGCCTACGAGCAGTACTTC	CSAEGIAYEQYF	TRBV20-1	TRBJ2-7
TGTGCCAGCAGAGTGTGGAAGAACACTGAAGCTTTCTTT	CASRVWKNTEAFF	TRBV2	TRBJ1-1
TGTGCCAGCAGCCACTCACCCGGGACAAGGGTATGGGGTTCGTACGAGCAGTACTTC	CASSHSPGTRVWGSYEQYF	TRBV13	TRBJ2-7
TGTGCCAGCAGCCCTGAAGCGGGAGGGGGAGGGGGGGGCACAGATACGCAGTATTTT	CASSPEAGGGGGGTDTQYF	TRBV11-3	TRBJ2-3
TGTGCCAGCAGTTTAGCGCGGAACCTCAAGACCGAAAAACTGTTTTTT	CASSLARNLKTEKLFF	TRBV12-3	TRBJ1-4
TGTGCCAGCAGCTTAGATGAAAAGACCTTCGAGCAGTACTTC	CASSLDEKTFEQYF	TRBV11-3	TRBJ2-7
TGTGCCAGCAGGCCGGTTGGGACAGAACCTGAAGCTTTCTTT	CASRPVGTEPEAFF	TRBV7-9	TRBJ1-1
TGTGCCAGCAGTTTAGGGGGGGCCTTAGGCGGGGCCAACGTCCTGACTTTC	CASSLGGALGGANVLTF	TRBV2	TRBJ2-6
TGTGCCAGCAGCGAGGACAGGCCTTCCGGGTGCACAGATACGCAGTATTTT	CASSEDRPSGCTDTQYF	TRBV7-3	TRBJ2-3
TGTGCCAGCGTCCCCCTTGGGACATATCCCTACGAGCAGTACTTC	CASVPLGTYPYEQYF	TRBV6-1	TRBJ2-7
TGTGCCAGCAGCCAAGATAGGGGACACAGATATGAAAAACTGTTTTTT	CASSQDRGHRYEKLFF	TRBV14	TRBJ1-4
TGTGCCAGCAGGCTACAACAGGGTCCAGGTACCTACGAGCAGTACTTC	CASRLQQGPGTYEQYF	TRBV12-3	TRBJ2-7
TGTGCCTGGACGAGGACAGTTCATGCCAAAAACATTCAGTACTTC	CAWTRTVHAKNIQYF	TRBV30	TRBJ2-4
TGCGCCAGCGGGCGGGGGTCCAGAGTATCAGACTCTGGAAACACCATATATTTT	CASGRGSRVSDSGNTIYF	TRBV10-1	TRBJ1-3
TGTGCCAGCAGCCAAGATTTGGGACGTCATGAAAAACTGTTTTTT	CASSQDLGRHEKLFF	TRBV3-1	TRBJ1-4
TGCGCCAGCAGCTTAGGAACCGGGGAGCTGTTTTTT	CASSLGTGELFF	TRBV5-1	TRBJ2-2
TGTGCCAGCAGGGCAGCGGGAGGCTACAATGAGCAGTTCTTC	CASRAAGGYNEQFF	TRBV25-1	TRBJ2-1
TGTGCCAGTCTCTATGGGGCGGCGCCGTTTTGGGGGAACACCGGGGAGCTGTTTTTT	CASLYGAAPFWGNTGELFF	TRBV19	TRBJ2-2
TGTGCCAGCAGTTCACTAACCCCTCGGACTAGCCCTCTATCCGATAGCACAGATACGCAGTATTTT	CASSSLTPRTSPLSDSTDTQYF	TRBV27	TRBJ2-3
TGTGCCAGCAGCGGTGTGGGAGGGAACACTGAAGCTTTCTTT	CASSGVGGNTEAFF	TRBV9	TRBJ1-1
TGTGCCAGCCGGGACCCCTACGAGCAGTACTTC	CASRDPYEQYF	TRBV27	TRBJ2-7
TGTGCCAGCAGCTTTCGGGGGGATCGGTACGACACTGAAGCTTTCTTT	CASSFRGDRYDTEAFF	TRBV7-9	TRBJ1-1
TGTGCCAGCAGTGAACTAGCGGGAAGCAATCAGCCCCAGCATTTT	CASSELAGSNQPQHF	TRBV25-1	TRBJ1-5
TGTGCCAGCAGTTCCCCGGGACAGGGTAGACTCAATCAGCCCCAGCATTTT	CASSSPGQGRLNQPQHF	TRBV6-1	TRBJ1-5
TGTGCTAGTGGATCTGGGACAGAAGGTGCCTACGAGCAGTACTTC	CASGSGTEGAYEQYF	TRBV12-5	TRBJ2-7
TGTGCCACCAGCAGAGATAGGACAGTCTCACCCCTCCACTTT	CATSRDRTVSPLHF	TRBV15	TRBJ1-6
TGTGCCAGCAGTTTATGGGCCCACATTCAGTACTTC	CASSLWAHIQYF	TRBV27	TRBJ2-4
TGCGCCAGCAGTAGGGATAATGAGCAGTTCTTC	CASSRDNEQFF	TRBV10-1	TRBJ2-1
TGTGCCAGCAGTTTATCGGTCTGGAAGGGGAATCAGCCCCAGCATTTT	CASSLSVWKGNQPQHF	TRBV27	TRBJ1-5
TGTGCCAGCATGGTGGAGAGATCCGGGAGCGGCGAGCAGTACTTC	CASMVERSGSGEQYF	TRBV6-6	TRBJ2-7
TGTGCCACCTCCACAGGTGGCTACACCTTC	CATSTGGYTF	TRBV13	TRBJ1-2
TGTGCCAGCAGTTGTGAACAGGGTAAGTATACGCAGTATTTT	CASSCEQGKYTQYF	TRBV12-4	TRBJ2-3
TGTGCCAGCAGCTATAGAGGACTTAATGGCTACACCTTC	CASSYRGLNGYTF	TRBV5-6	TRBJ1-2
TGTGCCAGCACCCCGGGGGGCCGAAACGAGCAGTACTTC	CASTPGGRNEQYF	TRBV7-6	TRBJ2-7
TGCGCCAGCAGCTGCGGGTTCAATCAGCCCCAGCATTTT	CASSCGFNQPQHF	TRBV5-1	TRBJ1-5
TGTGCCAGCAGACCGGGTTTAGCGGGACTGGGCTACGAGCAGTACTTC	CASRPGLAGLGYEQYF	TRBV7-9	TRBJ2-7
TGTGCCAGCAGCTTATCAGGGTACAAGGGTTCGTCCTACAATGAGCAGTTCTTC	CASSLSGYKGSSYNEQFF	TRBV11-3	TRBJ2-1
TGTGCCAGCAGCGATCACAGGGCTTGTTGCTTCAACACCATATATTTT	CASSDHRACCFNTIYF	TRBV9	TRBJ1-3
TGTGCCAGCAGTTACGAGATTCTAGACCAAGAGACCCAGTACTTC	CASSYEILDQETQYF	TRBV6-5	TRBJ2-5
TGTGCTAGTGGGCGTGGACAGCTTAAACTAGAGACCCAGTACTTC	CASGRGQLKLETQYF	TRBV12-5	TRBJ2-5
TGCGCCAGCAGAACGGCGGGGCACACCTTC	CASRTAGHTF	TRBV10-1	TRBJ1-2
TGTGCCAGCAGCTTATCCGGGCCCAAGTTAATTAATCAGCCCCAGCATTTT	CASSLSGPKLINQPQHF	TRBV7-3	TRBJ1-5
TGTGCCACCAGTGATCCTATAACCGGGGAGCTGTTTTTT	CATSDPITGELFF	TRBV24-1	TRBJ2-2
TGTGCCAGCAGCCAAAGGGTGAACACCGGGGAGCTGTTTTTT	CASSQRVNTGELFF	TRBV5-6	TRBJ2-2
TGTGCCAGCAGCCACCTCAGGCTGGGGTACGAGCAGTACTTC	CASSHLRLGYEQYF	TRBV27	TRBJ2-7
TGTGCCAGCGTGAGGGGAAACACTGAAGCTTTCTTT	CASVRGNTEAFF	TRBV27	TRBJ1-1
TGTGCCAGCAGCTTAGAAGGGTTCAAAAATTCACCCCTCCACTTT	CASSLEGFKNSPLHF	TRBV7-6	TRBJ1-6
TGTGCCAGCAGCACAGCTGACAGCAAGCGGACCCAGTACTTC	CASSTADSKRTQYF	TRBV13	TRBJ2-5
TGCAGTGCTAGCCCGGGACAGTTTTCCTACGAGCAGTACTTC	CSASPGQFSYEQYF	TRBV20-1	TRBJ2-7
TGTGCCAGCAGCTTGGCAGGAAATAACTATGGCTACACCTTC	CASSLAGNNYGYTF	TRBV5-4	TRBJ1-2
TGTGCGGGGGATCAGGTACAGCCCCAGCATTTT	CAGDQVQPQHF	TRBV6-4	TRBJ1-5
TGTGCCAGCAGTGAAAAATTTGGCAGGGGGCCCGTTGCTTGGGCCAACGTCCTGACTTTC	CASSEKFGRGPVAWANVLTF	TRBV6-4	TRBJ2-6
TGCGCCAGCAGCGCCAGGGGACCAGAAGAGACCCAGTACTTC	CASSARGPEETQYF	TRBV5-1	TRBJ2-5
TGTGCCAGCAGTTTAGGAAGTAGCGGGTCAGCAGGGGGCAGCTCCTACGAGCAGTACTTC	CASSLGSSGSAGGSSYEQYF	TRBV12-4	TRBJ2-7
TGTGCCAGCAGTTACTCTTTTGCGGCACAGGGCCGTAGCAATCAGCCCCAGCATTTT	CASSYSFAAQGRSNQPQHF	TRBV6-3	TRBJ1-5
TGTGCCAGCACCCCGGGACTTAGAATGAACACTGAAGCTTTCTTT	CASTPGLRMNTEAFF	TRBV6-4	TRBJ1-1
TGTGCCAGCAGTTGCCAGGGCCGGGACCACTCTGGAAACACCATATATTTT	CASSCQGRDHSGNTIYF	TRBV12-3	TRBJ1-3
TGTGCCAGCTCACGTTTGGCTGCAGACACTGAAGCTTTCTTT	CASSRLAADTEAFF	TRBV18	TRBJ1-1
TGTGCCACCACCCCGACCTATAATTCACCCCTCCACTTT	CATTPTYNSPLHF	TRBV24-1	TRBJ1-6
TGTGCCAGTAGTGGGCAGGGTTGCTACGAGCAGTACTTC	CASSGQGCYEQYF	TRBV19	TRBJ2-7
TGTGCCAGCAGCCGAAGGGGGGGGCATCCCGGCGTACAGGCCTACGAGCAGTACTTC	CASSRRGGHPGVQAYEQYF	TRBV7-3	TRBJ2-7
TGTGCCAGCAGTGGAGTTCGGTCACCCCTCCACTTT	CASSGVRSPLHF	TRBV2	TRBJ1-6
TGTGCCAGTATAAAAGTTGGGCGGCCCGGGGAGCTGTTTTTT	CASIKVGRPGELFF	TRBV19	TRBJ2-2
TGTGCTAGTGGTTTGAGAAGCAGGACGAATTATGAGCAGTTCTTC	CASGLRSRTNYEQFF	TRBV12-5	TRBJ2-1
TGCGCCAGCAGCAATCAGGGGGATGACTACGAGCAGTACTTC	CASSNQGDDYEQYF	TRBV5-1	TRBJ2-7
TGTGCCAGCAGTTTATCCAGTAGAACGACCTACAGGGTTACAGATACGCAGTATTTT	CASSLSSRTTYRVTDTQYF	TRBV27	TRBJ2-3
TGTGCCAGCAATGGCGGTGCCAAAAACATTCAGTACTTC	CASNGGAKNIQYF	TRBV27	TRBJ2-4
TGTGCCAGCAGCTTACATGGGGCGAACGAGCAGTACTTC	CASSLHGANEQYF	TRBV5-6	TRBJ2-7
TGTGCCAGCAGTTTATTGCCCAAAGAACAGGGAGCTGGATATTCACCCCTCCACTTT	CASSLLPKEQGAGYSPLHF	TRBV27	TRBJ1-6
TGTGCCAGCAGCCAAGACTTGCGGGGTAAGGGCTGGAGGTTGGACCAAGTGAGCCCGGCAACTAATGAAAAACTGTTTTTT	CASSQDLRGKGWRLDQVSPATNEKLFF	TRBV3-1	TRBJ1-4
TGCGCCAGCACTTCAAGGGGAGGTACCGGGGAGCTGTTTTTT	CASTSRGGTGELFF	TRBV10-2	TRBJ2-2
TGTGCCAGCAGGACAATCGGGACAGAAGCTAGGCCCTACGAGCAGTACTTC	CASRTIGTEARPYEQYF	TRBV6-5	TRBJ2-7
TGCGCCAGCAGCTTGCAAAAAGGGGCGGGTAACTCCTACGAGCAGTACTTC	CASSLQKGAGNSYEQYF	TRBV5-1	TRBJ2-7
TGTGCCAGTCCGTCCAGTTCCAATGGCTACACCTTC	CASPSSSNGYTF	TRBV6-1	TRBJ1-2
TGTGCCAGCAGCATCCTCAGGGAGACTCAGCCCCAGCATTTT	CASSILRETQPQHF	TRBV11-3	TRBJ1-5
TGTGCCAGCATCCCTCCCTTGCAGGGATGGGGAGGCTACACCTTC	CASIPPLQGWGGYTF	TRBV27	TRBJ1-2
TGTGCCAGCAGTGTCCGGCCCTCTTATGCGCAGTATTTT	CASSVRPSYAQYF	TRBV27	TRBJ2-3
TGTGCCAACGGACAGGGGGGTTATAGCAATCAGCCCCAGCATTTT	CANGQGGYSNQPQHF	TRBV6-8	TRBJ1-5
TGTGCCAGCAGTTACGGTAATCTCGGTTTTGAGAACACTGAAGCTTTCTTT	CASSYGNLGFENTEAFF	TRBV6-5	TRBJ1-1
TGTGCCAGTAGTCCGCCACCCCGGGGGCGCGGCAAGGGGGAAGCTTTCTTT	CASSPPPRGRGKGEAFF	TRBV19	TRBJ1-1
TGTGCCAGCAGTTACGGACTAGCTCAGGGCACAGATACGCAGTATTTT	CASSYGLAQGTDTQYF	TRBV6-5	TRBJ2-3
TGTGCCAGCAGTGACGAACGTGCGTTAGGGGAGTTGTACGAGCAGTACTTC	CASSDERALGELYEQYF	TRBV6-4	TRBJ2-7
TGTGCCAGCAGCGGAAGCCCCGACAGATTACTAGCCAAAAACATTCAGTACTTC	CASSGSPDRLLAKNIQYF	TRBV7-2	TRBJ2-4
TGTGTCCTTCAGGGGGCGCGATCCGGTGAGAATCAGCCCCAGCATTTT	CVLQGARSGENQPQHF	TRBV9	TRBJ1-5
TGTGCCAGCAGCTTAGCGTGGAAGCTCTATAAAAGTTTCTACAATGAGCAGTTCTTC	CASSLAWKLYKSFYNEQFF	TRBV7-6	TRBJ2-1
TGTGCCACCAGTGACGAGGGGCCGATGAACACTGAAGCTTTCTTT	CATSDEGPMNTEAFF	TRBV24-1	TRBJ1-1
TGTGCGGTTGCCGGGACGGGAAAACTGTTTTTT	CAVAGTGKLFF	TRBV27	TRBJ1-4
TGCAGTGCTAGAGATCTAGGGGGGAAACCTTATACGCAGTATTTT	CSARDLGGKPYTQYF	TRBV20-1	TRBJ2-3
TGTGCTAGTGGAGTGGGGGGGATTGAACCAGAGACCCAGTACTTC	CASGVGGIEPETQYF	TRBV12-5	TRBJ2-5
TGTGCCAGCAGTTACGGCCCCCACAGGGCCGAAAAACTGTTTTTT	CASSYGPHRAEKLFF	TRBV6-3	TRBJ1-4
TGTGCCAGCAGTTATCCGGGGCGCTGGAAGAGGGTTAAATACAATGAGCAGTTCTTC	CASSYPGRWKRVKYNEQFF	TRBV6-3	TRBJ2-1
TGTGCCAGCAAACCCCCCGGGGGGGGGGCCTACGAGCAGTACTTC	CASKPPGGGAYEQYF	TRBV6-2	TRBJ2-7
TGTGCCAGCAGTGGGTCGGGGACAGGGGGGCACACCTTC	CASSGSGTGGHTF	TRBV2	TRBJ1-2
TGTGCCACCCGGGACACGAACACCGGGGAGCTGTTTTTT	CATRDTNTGELFF	TRBV24-1	TRBJ2-2
TGTGCCAGATCGACCGGGACAGGGGAAAGGCCCGAGCAGTACTTC	CARSTGTGERPEQYF	TRBV6-1	TRBJ2-7
TGTGCCAGCAGCAGTTCCCTGGACGAAGGGACCCAGTACTTC	CASSSSLDEGTQYF	TRBV3-1	TRBJ2-5
TGTGCCTACACAGGGGGCGATGGCTACACCTTC	CAYTGGDGYTF	TRBV10-3	TRBJ1-2
TGTGCCACGAGACAGATAACTCTAGAGACCCAGTACTTC	CATRQITLETQYF	TRBV6-5	TRBJ2-5
TGTGCCACCCCCTTGGGGGGGGCTCAGCCCCAGCATTTT	CATPLGGAQPQHF	TRBV19	TRBJ1-5
TGTGCCAGCACTTCAAGGACTGAAGCTTTCTTT	CASTSRTEAFF	TRBV9	TRBJ1-1
TGCGCCAGCAGTGAGTCGGGGGGGGCGATGCCGGGCGAGCAGTACTTC	CASSESGGAMPGEQYF	TRBV10-1	TRBJ2-7
TGTGCCAGTAGTATGACGGCAGAACAGGGAGGGGGTACCTTCGGAAACACCATATATTTT	CASSMTAEQGGGTFGNTIYF	TRBV19	TRBJ1-3
TGCGCCAGCAGCCAAGGCTTGCCGTGTAATACTGGGGCCAACGTCCTGACTTTC	CASSQGLPCNTGANVLTF	TRBV4-1	TRBJ2-6
TGTGCCAGCTCCGGTCCCGGGGGGCCCACCGGGGAGCTGTTTTTT	CASSGPGGPTGELFF	TRBV18	TRBJ2-2
TGTGCTAGTGGTTTCGGCACAGGGGACCAAGGCCAAGAGACCCAGTACTTC	CASGFGTGDQGQETQYF	TRBV12-5	TRBJ2-5
TGTGCCAGCACTTGGGGGGGCCGGCGCTACACAGATACGCAGTATTTT	CASTWGGRRYTDTQYF	TRBV2	TRBJ2-3
TGTGCCAGCAGCCAAGTGATCCATCCGGGACTAGCGGGAGAGTCGCAGTACTTC	CASSQVIHPGLAGESQYF	TRBV4-2	TRBJ2-7
TGCGCCAGCAGTGAGTCGAGCTCGGGGATCAGCGGAGTCTCCTACGAGCAGTACTTC	CASSESSSGISGVSYEQYF	TRBV10-1	TRBJ2-7
TGTGCCAGCAAACTGGGGGGAGAAGAGACCCAGTACTTC	CASKLGGEETQYF	TRBV25-1	TRBJ2-5
TGTGCCAGCAGAGGCCGGGACAGGGTTCGACGCGACTATGGCTACACCTTC	CASRGRDRVRRDYGYTF	TRBV6-1	TRBJ1-2
TGTGCTAGTGGTTTTGTGGACGACCCGTACAATGAGCAGTTCTTC	CASGFVDDPYNEQFF	TRBV12-5	TRBJ2-1
TGTGCCAGCAGTTCCACTAACCTCGGGGAACTGAACACTGAAGCTTTCTTT	CASSSTNLGELNTEAFF	TRBV28	TRBJ1-1
TGTGCCAACCGACAGCCCCAGCATTTT	CANRQPQHF	TRBV7-8	TRBJ1-5
TGTGCCAGCAGTTTATGCCCGAGGGGGGGCTGTACGCAGTATTTT	CASSLCPRGGCTQYF	TRBV27	TRBJ2-3
TGTGCCAGCAGTGAATGCGGGACAGGGGATAGCGGGAACACTGAAGCTTTCTTT	CASSECGTGDSGNTEAFF	TRBV25-1	TRBJ1-1
TGTGCCAGCAGCTACTGGGACTCCTACGAGCAGTACTTC	CASSYWDSYEQYF	TRBV5-5	TRBJ2-7
TGTGCCTGGAGTGTATCGATCTTAGGGGGGTCCTTGTTCAATGAGCAGTTCTTC	CAWSVSILGGSLFNEQFF	TRBV30	TRBJ2-1
TGCAGCGTTGACGACCGCCGGGACAGGGTTGAAGCTTTCTTT	CSVDDRRDRVEAFF	TRBV29-1	TRBJ1-1
TGTGCCAGCAGTCAGGGCAACCTCGGAACCGGGGAGCTGTTTTTT	CASSQGNLGTGELFF	TRBV27	TRBJ2-2
TGCGCCAGCAGTAAAGCGGGAGATAATGAGCAGTTCTTC	CASSKAGDNEQFF	TRBV10-2	TRBJ2-1
TGTGCCAGTAGTAGACCGTCATGGACGGTCGCCCTCCACTTT	CASSRPSWTVALHF	TRBV19	TRBJ1-6
TGCGCCAGCAGCCAAGAGGGAGGGGGGGCTACCTCTGGGGCCAACGTCCTGACTTTC	CASSQEGGGATSGANVLTF	TRBV4-3	TRBJ2-6
TGTGCCAGCAATCCGGGACTAGCGGAACCTCACTGTGAGCAGTTCTTC	CASNPGLAEPHCEQFF	TRBV2	TRBJ2-1
TGTGCCAGCAGCTTAGCGGGTGGGTCCTACGAGCAGTACTTC	CASSLAGGSYEQYF	TRBV5-6	TRBJ2-7
TGCAGTGCTAGAGACTCGCCTCGGGACAGGGAAATGAGCAATCAGCCCCAGCATTTT	CSARDSPRDREMSNQPQHF	TRBV20-1	TRBJ1-5
TGTGCCAGCAGCCGGGCGGGGCCGAGAGATACGCAGTATTTT	CASSRAGPRDTQYF	TRBV7-3	TRBJ2-3
TGTGCCAGCACGGGGGGGGCAGAGAATCAGCCCCAGCATTTT	CASTGGAENQPQHF	TRBV6-5	TRBJ1-5
TGTGCCAGCAGCGCGGTACATACGATACGGAATGTGCGCACTGAAGCTTTCTTT	CASSAVHTIRNVRTEAFF	TRBV7-3	TRBJ1-1
TGCGCCAGCACAGTGGACGGGGAGCAGTTCTTC	CASTVDGEQFF	TRBV10-1	TRBJ2-1
TGCAGTGCTATGACGGGACTAGCGGGCGGGAGCTGCTCCTACGAGCAGTACTTC	CSAMTGLAGGSCSYEQYF	TRBV20-1	TRBJ2-7
TGTGCCAGCAGCTTGCCCATCTTTAGGGAGTTTAATGAAAAACTGTTTTTT	CASSLPIFREFNEKLFF	TRBV5-6	TRBJ1-4
TGCGCCAGCAGCTCCGGGCCGGGACTTTTTATTTATGAGCAGTTCTTC	CASSSGPGLFIYEQFF	TRBV5-1	TRBJ2-1
TGTGCCAGCAGTTACCAAAGGAGACAGGGAGCCTACGAGCAGTACTTC	CASSYQRRQGAYEQYF	TRBV6-3	TRBJ2-7
TGCGCCAGCAGCGGAGGGGGGCGGCGGACAGATACGCAGTATTTT	CASSGGGRRTDTQYF	TRBV5-1	TRBJ2-3
TGTGCCAGCAGGTCCCCAATACAGGGGGTCCTCGACACAGATACGCAGTATTTT	CASRSPIQGVLDTDTQYF	TRBV6-3	TRBJ2-3
TGCGCCAGCAGCTGGGACAGACGAGATACGCAGTATTTT	CASSWDRRDTQYF	TRBV5-1	TRBJ2-3
TGTGCCTGGAGTGGTGACAGGCGAAACTACGAGCAGTACTTC	CAWSGDRRNYEQYF	TRBV30	TRBJ2-7
TGTGCCAGCACATCCTGCGGAGCTAGTAGCAATCAGCCCCAGCATTTT	CASTSCGASSNQPQHF	TRBV12-3	TRBJ1-5
TGCAGTGCGGCGGCTTTTAACTATGGCTACACCTTC	CSAAAFNYGYTF	TRBV20-1	TRBJ1-2
TGTGCCAGCAGAGGGAGAGGGCTTAGCTCCTATAATTCACCCCTCCACTTT	CASRGRGLSSYNSPLHF	TRBV6-4	TRBJ1-6
TGTGCCAGCAGCCAAGAGTCCATACTAGCACCTCCGTCTAGAAGCTCCTACAATGAGCAGTTCTTC	CASSQESILAPPSRSSYNEQFF	TRBV4-2	TRBJ2-1
TGTGCCAGCAGTAGGGCACCAGGGGAGGATGACACCGGGGAGCTGTTTTTT	CASSRAPGEDDTGELFF	TRBV6-5	TRBJ2-2
TGTGCCACAGCCCTTCAGGGGGGTAGCAATCAGCCCCAGCATTTT	CATALQGGSNQPQHF	TRBV15	TRBJ1-5
TGTGCCAGCAGCGTTAACACAGGGGCAGAGACCCAGTACTTC	CASSVNTGAETQYF	TRBV7-3	TRBJ2-5
TGTGCCTGGAGTGTAGCGCAGACAGGGAGCTATGGCTACACCTTC	CAWSVAQTGSYGYTF	TRBV30	TRBJ1-2
TGTGCCACCAGCAGGGCTAGCGGGTCAGCGGCCGGGGTAACACTATACGAGCAGTACTTC	CATSRASGSAAGVTLYEQYF	TRBV15	TRBJ2-7
TGCAGCGTTGTTCTGCCAACCCAGGGCTCCGTCTACGAGCAGTACTTC	CSVVLPTQGSVYEQYF	TRBV29-1	TRBJ2-7
TGTGCCATCAGAGGGGGGGTCGACACAGATACGCAGTATTTT	CAIRGGVDTDTQYF	TRBV10-3	TRBJ2-3
TGTGCCATCGCCCGGGACAGTAGTACCGGGGAGCTGTTTTTT	CAIARDSSTGELFF	TRBV10-3	TRBJ2-2
TGCGCCAGCAGCTTGGGGCCCGGCTTAAGCATCGAGACCCAGTACTTC	CASSLGPGLSIETQYF	TRBV5-1	TRBJ2-5
TGTGCCAGTAGTAAGCCCCGAGGGCGGATCGAGCAGTACTTC	CASSKPRGRIEQYF	TRBV19	TRBJ2-7
TGTGCCAGCAGCCCCAACTCTGGAAACACCATATATTTT	CASSPNSGNTIYF	TRBV7-9	TRBJ1-3
TGTGCCAGCAGCTTATCGGGCCGGAACTACGAGCAGTACTTC	CASSLSGRNYEQYF	TRBV7-6	TRBJ2-7
TGTGCCAGCAGCGCACTAGCGGGCTCGCACTATGAGCAGTTCTTC	CASSALAGSHYEQFF	TRBV7-7	TRBJ2-1
TGTGCCAGCAGGGCGGGCGGGATCTACGAGCAGTACTTC	CASRAGGIYEQYF	TRBV6-8	TRBJ2-7
TGTGCCAGCAGCAGGCCGGACAGTTGGAGTTCCTACGAGCAGTACTTC	CASSRPDSWSSYEQYF	TRBV7-6	TRBJ2-7
TGTGCCAGCAGCGTAGTCGATGGTCAGGGGGGGAGCTCTGGGGCCAACGTCCTGACTTTC	CASSVVDGQGGSSGANVLTF	TRBV9	TRBJ2-6
TGTGCCACGGGACGTGGAGGTCGGACCCAGTACTTC	CATGRGGRTQYF	TRBV24-1	TRBJ2-5
TGTGCCAGCCTTTCCTCTAGCGGGGGTATATCCTACAATGAGCAGTTCTTC	CASLSSSGGISYNEQFF	TRBV12-4	TRBJ2-1
TGTGCCAGCGTTCAACCCTTGGGATACAACATCCTTATTTCACCCCTCCACTTT	CASVQPLGYNILISPLHF	TRBV6-4	TRBJ1-6
TGCAGCTCACAGGGGAATTCACCCCTCCACTTT	CSSQGNSPLHF	TRBV29-1	TRBJ1-6
TGCGCCAGCAGCCAAGCTCCTAATCAGGCACAAGGAGAGACCCAGTACTTC	CASSQAPNQAQGETQYF	TRBV4-1	TRBJ2-5
TGTGCTAGTGGTTTTAGGGAGACCCAGTACTTC	CASGFRETQYF	TRBV12-5	TRBJ2-5
TGCGCCAGCAGCCAACCGAGGGAACTCCAAGAGACCCAGTACTTC	CASSQPRELQETQYF	TRBV4-1	TRBJ2-5
TGCGCCAGCAGCTTAAGAAGTAGGAGCTCCTATAATTCACCCCTCCACTTT	CASSLRSRSSYNSPLHF	TRBV5-1	TRBJ1-6
TGTGCCAGCAGTTTCTTGGCAAAGGATGACAGGGCCGATGGCTACACCTTC	CASSFLAKDDRADGYTF	TRBV27	TRBJ1-2
TGTGCCAGCAGCTTAACCCCCGGATTTGGGGCAGATACGCAGTATTTT	CASSLTPGFGADTQYF	TRBV7-3	TRBJ2-3
TGTGCCAGCAGCACAGGACCGAGTGGCTACACCTTC	CASSTGPSGYTF	TRBV7-9	TRBJ1-2
TGCACACTAGCGGGAGGAAGCTCCTACGAGCAGTACTTC	CTLAGGSSYEQYF	TRBV20-1	TRBJ2-7
TGTGCCTGGAGTTCTAGATGCGGGAGAGAGTACATTCCGGAAGCTTTCTTT	CAWSSRCGREYIPEAFF	TRBV30	TRBJ1-1
TGTGCCAGCAGTTTCCCCCAGATGGCCTACGAGCAGTACTTC	CASSFPQMAYEQYF	TRBV6-9	TRBJ2-7
TGTGCCAGCCTACTAGGGGTCTACGAGCAGTACTTC	CASLLGVYEQYF	TRBV11-2	TRBJ2-7
TGTGCCACCAGCAGAGTTGGGGACTCACCCCTCCACTTT	CATSRVGDSPLHF	TRBV15	TRBJ1-6
TGTGCCAGCAGCAAGGGCTTGAGGGTCACAGATACGCAGTATTTT	CASSKGLRVTDTQYF	TRBV5-4	TRBJ2-3
TGTGCCGCACCAAGACAGGTCCACCCTGGCTACACCTTC	CAAPRQVHPGYTF	TRBV28	TRBJ1-2
TGTGCCAGCAGCATAATTGGGGGGGCCATCCTATTCGGGGCCCAGTACTTC	CASSIIGGAILFGAQYF	TRBV7-9	TRBJ2-5
TGTGCCAGCATTCAGCAGGGCGGTGCCTATGGCTACACCTTC	CASIQQGGAYGYTF	TRBV28	TRBJ1-2
TGCGCCAGCAGCCAAGACGCGGCCTCTGGAAACACCATATATTTT	CASSQDAASGNTIYF	TRBV4-1	TRBJ1-3
TGCGCCAGCAGCCCCAGGTCAAGAACCAGGGTATCCTACGAGCAGTACTTC	CASSPRSRTRVSYEQYF	TRBV5-1	TRBJ2-7
TGTGCCAGCAGCCCCAGCGTTCACGAGCAGTACTTC	CASSPSVHEQYF	TRBV5-4	TRBJ2-7
TGTGCCAGCAGACCGGGACTCCGATATGAAAAACTGTTTTTT	CASRPGLRYEKLFF	TRBV6-4	TRBJ1-4
TGCGCCAGCAGCTTGAGGGCAGGGGCCAAAAACATTCAGTACTTC	CASSLRAGAKNIQYF	TRBV5-1	TRBJ2-4
TGTGCCAGCAGTGAAGTCGGGTCGGTGCTAGAAAAACTGTTTTTT	CASSEVGSVLEKLFF	TRBV12-3	TRBJ1-4
TGTGCCATCAGTTGTCGGGACAGGGTCAATCAGCCCCAGCATTTT	CAISCRDRVNQPQHF	TRBV10-3	TRBJ1-5
TGTGCCAGCAGCTGGCAGGACAGCAATGAGCAGTTCTTC	CASSWQDSNEQFF	TRBV11-3	TRBJ2-1
TGTGCCAGTAGTAGGGGGGGGACCGAGCAGTACTTC	CASSRGGTEQYF	TRBV19	TRBJ2-7
TGTGCCAGCAGTACTGACAGGGACATCAGCTATGGCTACACCTTC	CASSTDRDISYGYTF	TRBV27	TRBJ1-2
TGTGCCAGCAGAGAAAGACAGGGGGCTGAAGCTTTCTTT	CASRERQGAEAFF	TRBV6-3	TRBJ1-1
TGTGCCAGCAGCCCGGAGGGGGCCCTCCACTTT	CASSPEGALHF	TRBV12-3	TRBJ1-6
TGTGCCAGCAACCTAGGGGGGCCTAAAGATACGCAGTATTTT	CASNLGGPKDTQYF	TRBV6-4	TRBJ2-3
TGTGCCAGCAGTTACTGGTCCTCCCACGGACAGGGGGTAGTGGGCACTGAAGCTTTCTTT	CASSYWSSHGQGVVGTEAFF	TRBV6-5	TRBJ1-1
TGTGCCAGCAGCCAAGATGGGGGGGCCACGGAAGGCTACAATGAGCAGTTCTTC	CASSQDGGATEGYNEQFF	TRBV4-2	TRBJ2-1
TGTGCCAGCAGCTCTCGTGGACAGAAACGGGGGTATTCAAAAAATCAGCCCCAGCATTTT	CASSSRGQKRGYSKNQPQHF	TRBV7-3	TRBJ1-5
TGTGCCAGCTCACGTGTGGGCCATCACAACAATGAGCAGTTCTTC	CASSRVGHHNNEQFF	TRBV18	TRBJ2-1
TGTGCCAGCAGTGACTCCGCGGGGGAGGAGACCCAGTACTTC	CASSDSAGEETQYF	TRBV6-4	TRBJ2-5
TGCGCCAGCAGTGAACATCAACAGCCCCAGCATTTT	CASSEHQQPQHF	TRBV10-1	TRBJ1-5
TGTGCCAGCAGCATTGGACAGTGTTCTGGGGCCAACGTCCTGACTTTC	CASSIGQCSGANVLTF	TRBV7-8	TRBJ2-6
TGTGCCAGCAGCTGGACAGGGGTGGTCCCGGCGCAGTACTTC	CASSWTGVVPAQYF	TRBV5-6	TRBJ2-7
TGTGCCAGCAGTTTATGGCCCTCCAATCAGCCCCAGCATTTT	CASSLWPSNQPQHF	TRBV27	TRBJ1-5
TGTGCCAGCAGCTTTCGGACAGAGTTGAGGGATTACTATGGCTACACCTTC	CASSFRTELRDYYGYTF	TRBV7-4	TRBJ1-2
TGTGCTAGTGGACCGTCAGCCTCCCAGGGGGGTTCTTTCTTT	CASGPSASQGGSFF	TRBV12-5	TRBJ1-1
TGTGCCAGCAGCTTCAGAAAGACGCAGAACGAGCAGTACTTC	CASSFRKTQNEQYF	TRBV7-9	TRBJ2-7
TGCAGCGTTGATTTGTTGACTAGCGGGAGGGCCCCAAGCTACAATGAGCAGTTCTTC	CSVDLLTSGRAPSYNEQFF	TRBV29-1	TRBJ2-1
TGTGCCACCCACTACAGGGCACACTCTGGGGCCAACGTCCTGACTTTC	CATHYRAHSGANVLTF	TRBV7-9	TRBJ2-6
TGTGCCAGTAGTATCCAGCAGTGGTTGTACACTGAAGCTTTCTTT	CASSIQQWLYTEAFF	TRBV19	TRBJ1-1
TGTGCCAGCACCAAAAAGGACAGGGCAGACAATGAGCAGTTCTTC	CASTKKDRADNEQFF	TRBV27	TRBJ2-1
TGTGCCAGCAGTTCGGGGGGTGTCTCCGAGACCCAGTACTTC	CASSSGGVSETQYF	TRBV13	TRBJ2-5
TGTGCCAGCAGCTTCCCAGTGGAGACCCAGTACTTC	CASSFPVETQYF	TRBV7-8	TRBJ2-5
TGCAGCGTTGACGGTGGACTAGACTATGGCTACACCTTC	CSVDGGLDYGYTF	TRBV29-1	TRBJ1-2
TGCAGCGTTGAAACGAGGAACCGGGACGGCGTCACAGATACGCAGTATTTT	CSVETRNRDGVTDTQYF	TRBV29-1	TRBJ2-3
TGTGCCAGCACAGGGGATCGTGAAAAACTGTTTTTT	CASTGDREKLFF	TRBV25-1	TRBJ1-4
TGTGCCAGCGGGGCCCGGGCCCGGGCCCGTTCACCCCTCCACTTT	CASGARARARSPLHF	TRBV6-4	TRBJ1-6
TGTGCCAGCAAGGGCAGCGACTATGGCTACACCTTC	CASKGSDYGYTF	TRBV27	TRBJ1-2
TGTGCCACCAGGTGGAACCCAAAGGGGGACAGGGTGGGCTCTGGAAACACCATATATTTT	CATRWNPKGDRVGSGNTIYF	TRBV24-1	TRBJ1-3
TGTGCCAGCAGTTTATTGCAGGGGATCTCTGGAAACACCATATATTTT	CASSLLQGISGNTIYF	TRBV28	TRBJ1-3
TGTGCCAGCAGCTTTCAGGGTTTCTACGAGCAGTACTTC	CASSFQGFYEQYF	TRBV7-9	TRBJ2-7
TGTGCCAGCAGCTTAGCAGGGAGGGGAAGAGCCTACGAGCAGTACTTC	CASSLAGRGRAYEQYF	TRBV7-2	TRBJ2-7
TGTGCCAGCAGCTTAGGGAACAGGGGGGGGTCTAGCGGCTACACCTTC	CASSLGNRGGSSGYTF	TRBV11-2	TRBJ1-2
TGCAGTGCTAGAGAACCAGGCTCCTACGAGCAGTACTTC	CSAREPGSYEQYF	TRBV20-1	TRBJ2-7
TGCAGTGCTAGAGAACGTACTAAGGAGACCCAGTACTTC	CSARERTKETQYF	TRBV20-1	TRBJ2-5
TGCGCCAGCAGCAGGCAGAGAAGCGTGCCCCAGCATTTT	CASSRQRSVPQHF	TRBV5-1	TRBJ1-5
TGTGCCAGCATCCTAGTCCTCGAAACGCAGTATTTT	CASILVLETQYF	TRBV12-3	TRBJ2-3
TGCAGTGAATCACAGAGGTACAATGAGCAGTTCTTC	CSESQRYNEQFF	TRBV20-1	TRBJ2-1
TGCAGTGCTAGCCCTGGGACTAGCGGTCCTGAGACCCAGTACTTC	CSASPGTSGPETQYF	TRBV20-1	TRBJ2-5
TGTGCCAGCTCCGGACATGGGGGCAGATATCCTGAGCAGTACTTC	CASSGHGGRYPEQYF	TRBV25-1	TRBJ2-7
TGTGCCAGCAGCAAACCCGGCACAGCTAACTATGGCTACACCTTC	CASSKPGTANYGYTF	TRBV5-5	TRBJ1-2
TGTGCCAGCAGTTTACGCCTTAGTGGGGGCCGGCCGTCCTACGAGCAGTACTTC	CASSLRLSGGRPSYEQYF	TRBV12-4	TRBJ2-7
TGTGCCAGCAGTAGTTCCCCCGGACAGGAGTACAACATTCAGTACTTC	CASSSSPGQEYNIQYF	TRBV27	TRBJ2-4
TGTGCCAGCCGTGTGGAAGAGACCCAGTACTTC	CASRVEETQYF	TRBV5-4	TRBJ2-5
TGCAGTGCTAGACTCCCGGGACAGGGCGAGACCCAGTACTTC	CSARLPGQGETQYF	TRBV20-1	TRBJ2-5
TGCGCCAGCAGCCAAGTAGGTGGGCGGCAGTACTTC	CASSQVGGRQYF	TRBV4-1	TRBJ2-5
TGTGCCAGCAGCTTAGCTGAGCAGTTCTTC	CASSLAEQFF	TRBV5-4	TRBJ2-1
TGTGCCAGCAGTCCGACAGGGCGGGAACACACTGAAGCTTTCTTT	CASSPTGREHTEAFF	TRBV12-4	TRBJ1-1
TGTGCCACCAGTGATTTGTCTCAGGGCGAAGAGACCCAGTACTTC	CATSDLSQGEETQYF	TRBV24-1	TRBJ2-5
TGTGCCAGCAGTGCCGGAACAGGGGACCGCAATCAGCCCCAGCATTTT	CASSAGTGDRNQPQHF	TRBV27	TRBJ1-5
TGTGGACAGCTTGTGTCCTACGAGCAGTACTTC	CGQLVSYEQYF	TRBV12-3	TRBJ2-7
TGTGCCACTACCAGGTACTTACAAGATTCCAATGAGCAGTTCTTC	CATTRYLQDSNEQFF	TRBV6-4	TRBJ2-1
TGTGCCAGCAGCATGACAGGGTTAGAACAAGAGACCCAGTACTTC	CASSMTGLEQETQYF	TRBV7-4	TRBJ2-5
TGTGCCAGGACCAGCTACATTGAGTACTTC	CARTSYIEYF	TRBV7-9	TRBJ2-7
TGTGCCAGCAGTCAAATGGCGGGACAGGGTTTCCACCGGGGGGTGGACGAGCAGTACTTC	CASSQMAGQGFHRGVDEQYF	TRBV6-2	TRBJ2-7
TGTGCCAGCAGCTTAGGGGTAGACAACTTTCAGGAGACCCAGTACTTC	CASSLGVDNFQETQYF	TRBV11-2	TRBJ2-5
TGTGCCAGCAGTCGGGGCGGGACAGGGAACGAGCAGTTCTTC	CASSRGGTGNEQFF	TRBV13	TRBJ2-1
TGCAGTGCTAGAGATAGGGACAGGGAGCAGTACTTC	CSARDRDREQYF	TRBV20-1	TRBJ2-7
TGTGCCAGCAGCTTAGTCCTAGGAAACACCATATATTTT	CASSLVLGNTIYF	TRBV11-3	TRBJ1-3
TGTGCCAGCAGTATAAATGGGGGGGACACTAGCACAGATACGCAGTATTTT	CASSINGGDTSTDTQYF	TRBV28	TRBJ2-3
TGTGCCAGCAGCTTACAGGGCGAGCAGTACTTC	CASSLQGEQYF	TRBV11-3	TRBJ2-7
TGTGCCAGCAAAGTGGGGTTCATGAACACTGAAGCTTTCTTT	CASKVGFMNTEAFF	TRBV7-9	TRBJ1-1
TGTGCCAGCAGCTTACTCGGGATCAACTACGAGCAGTACTTC	CASSLLGINYEQYF	TRBV7-9	TRBJ2-7
TGTGCCACCATCAGGGGGCTTCTCACTAACACTGAAGCTTTCTTT	CATIRGLLTNTEAFF	TRBV24-1	TRBJ1-1
TGTGCCAGCAAAGTGACCAGCGACGAGCAGTACTTC	CASKVTSDEQYF	TRBV6-2	TRBJ2-7
TGTGCCATCAGTGAGTGCTCCTTCAACCCCAATGAGCAGTTCTTC	CAISECSFNPNEQFF	TRBV10-3	TRBJ2-1
TGTGCCAGCAGCGCTACTAGCGGGGAATTCACAGATACGCAGTATTTT	CASSATSGEFTDTQYF	TRBV7-2	TRBJ2-3
TGTGCCAGCAGGTCCGTAGAGGACTTTTACAATGAGCAGTTCTTC	CASRSVEDFYNEQFF	TRBV12-3	TRBJ2-1
TGTGCCAGCATGAAGGCCCCCCAGCAGTTCTTC	CASMKAPQQFF	TRBV27	TRBJ2-1
TGTGCCAGCAGCGTAGCCCTAAGGCCCCAGCATTTT	CASSVALRPQHF	TRBV9	TRBJ1-5
TGTGCCAGCAGAGGGACGCATGACACCGGGGAGCTGTTTTTT	CASRGTHDTGELFF	TRBV7-6	TRBJ2-2
TGTGCCCCGCAGCGAGCCCCGAGCTCCTACGAGCAGTACTTC	CAPQRAPSSYEQYF	TRBV10-3	TRBJ2-7
TGTGCCTGGAGGTCAAGGGGGTCTGGGCAAGAGACCCAGTACTTC	CAWRSRGSGQETQYF	TRBV30	TRBJ2-5
TGCAGCGGGGAGGGGCTCGAGCAGTACTTC	CSGEGLEQYF	TRBV29-1	TRBJ2-7
TGTGCCAGTACCGAGGGTAGCAATGAGCAGTTCTTC	CASTEGSNEQFF	TRBV19	TRBJ2-1
TGTGCCTGGCCTAGTTGGTCAGAGCAGTACTTC	CAWPSWSEQYF	TRBV30	TRBJ2-7
TGTGCCAGCAGCTTAGTCCCACGGAACACTGAAGCTTTCTTT	CASSLVPRNTEAFF	TRBV7-6	TRBJ1-1
TGTGCCAGCAGTGGGACAGGGGAGCAGTTCTTC	CASSGTGEQFF	TRBV6-2	TRBJ2-1
TGTGCCAGCAGTCGCAGACAGGGTAAGGCCCAGGAGCAGTACTTC	CASSRRQGKAQEQYF	TRBV12-3	TRBJ2-7
TGTGCCAGCAGCTTAGCCGACAGGGCAGTTTATGGCTACACCTTC	CASSLADRAVYGYTF	TRBV7-9	TRBJ1-2
TGTGCCAGCAGCACTAAGGACGCGAGGAGGTCTGGAAACACCATATATTTT	CASSTKDARRSGNTIYF	TRBV7-9	TRBJ1-3
TGTGCAACCGCAACAGGCCCCGGAAACACCATATATTTT	CATATGPGNTIYF	TRBV9	TRBJ1-3
TGTGCCAGCAGTGGGGTCACAGGGGTATGCCAAGCAGGGGATAATTCACCCCTCCACTTT	CASSGVTGVCQAGDNSPLHF	TRBV6-4	TRBJ1-6
TGTGCCAGCTGTGGGCCGGGACAGGGGTGCAATCAGCCCCAGCATTTT	CASCGPGQGCNQPQHF	TRBV5-5	TRBJ1-5
TGTGCTAGCAGTCTCAGGGACCGAAAAGGAAACACCATATATTTT	CASSLRDRKGNTIYF	TRBV7-7	TRBJ1-3
TGTGCCAGAATACTATTGGGAGGGGGGTTTCAGCCCCAGCATTTT	CARILLGGGFQPQHF	TRBV2	TRBJ1-5
TGTGCCAGCTATTGCCACTACGAGCAGTACTTC	CASYCHYEQYF	TRBV6-4	TRBJ2-7
TGCGCCAGCAGCCAAGATCCGGGGAAGCGCCGGGACGTTATAATTACCGGGGAGCTGTTTTTT	CASSQDPGKRRDVIITGELFF	TRBV4-1	TRBJ2-2
TGTGCCAGCAGCCTAGAGCCAGGGAGCCGTCCAACTGAAGCTTTCTTT	CASSLEPGSRPTEAFF	TRBV5-6	TRBJ1-1
TGTGCCAGTAGTATAGATGTTTCTAATGGGAGTACGCAGTATTTT	CASSIDVSNGSTQYF	TRBV19	TRBJ2-3
TGCGCCAGCAGCTTTCTTGCGACAGGGGATGAGCAGTTCTTC	CASSFLATGDEQFF	TRBV5-1	TRBJ2-1
TGTGCCAGCAGCCAAGGGCGATCGGAGCAGTACTTC	CASSQGRSEQYF	TRBV14	TRBJ2-7
TGTGCCAGCCGAAGAGGGGAAGGGCAGTTCTTC	CASRRGEGQFF	TRBV27	TRBJ2-1
TGTGCCAGCAGTTTATTTTTAAGGGTAGGGGAGCAGTACTTC	CASSLFLRVGEQYF	TRBV27	TRBJ2-7
TGTGCCAGCAGCTACCCTACGGCTTTCTATAATTCACCCCTCCACTTT	CASSYPTAFYNSPLHF	TRBV6-6	TRBJ1-6
TGTGCCAGCAGCACGCCAGGGCCTATACTTGGGGAGCAGTACTTC	CASSTPGPILGEQYF	TRBV7-4	TRBJ2-7
TGTGCCAGCAGTGACGGGGGATATTTCAACGAGCAGTACTTC	CASSDGGYFNEQYF	TRBV9	TRBJ2-7
TGTGCAGGGGAGGCAGAGACCCAGTACTTC	CAGEAETQYF	TRBV7-2	TRBJ2-5
TGTGCCAGCAGCAGATCATGGAGCTCCTACGAGCAGTACTTC	CASSRSWSSYEQYF	TRBV25-1	TRBJ2-7
TGTGCCTGGAGCGGGACCTATCTTAGAAACATTCAGTACTTC	CAWSGTYLRNIQYF	TRBV30	TRBJ2-4
TGCAGCGTTGCATGGGACTGCGACACCGGGGAGCTGTTTTTT	CSVAWDCDTGELFF	TRBV29-1	TRBJ2-2
TGTGCCAGCAGCTGGGGGGAGCAGTACTTC	CASSWGEQYF	TRBV28	TRBJ2-7
TGCAGTGCTCCCCAGGGAGGAAGCAATCAGCCCCAGCATTTT	CSAPQGGSNQPQHF	TRBV20-1	TRBJ1-5
TGTGCCACCCGTGGGCGCACGGGTCGGGCAGATACGCAGTATTTT	CATRGRTGRADTQYF	TRBV24-1	TRBJ2-3
TGTGCCAGCAGCCTCCCTCACGGGACAGGGGCCGGAAACACCATATATTTT	CASSLPHGTGAGNTIYF	TRBV13	TRBJ1-3
TGTGCCAGCAGTGAATGGGGGCTTCCTAAAGACACCGGGGAGCTGTTTTTT	CASSEWGLPKDTGELFF	TRBV6-4	TRBJ2-2
TGTGCCAGCAGCGTAGAAGGGGGCGGAAACACCATATATTTT	CASSVEGGGNTIYF	TRBV9	TRBJ1-3
TGTGCCAGGCTCCTCAGACAGGGTCGGGCCTACGAGCAGTACTTC	CARLLRQGRAYEQYF	TRBV27	TRBJ2-7
TGCAGTGCAATGCTTTCGCCCCGTTGGTACGAGCAGTACTTC	CSAMLSPRWYEQYF	TRBV20-1	TRBJ2-7
TGTGCCAGCAGTTTCCTGGGACTCTCTTACTACGAGCAGTACTTC	CASSFLGLSYYEQYF	TRBV28	TRBJ2-7
TGTGCCAGCAGTTACTCGACAGGACAGTACATGAACACTGAAGCTTTCTTT	CASSYSTGQYMNTEAFF	TRBV6-6	TRBJ1-1
TGCGCCAGCAGCCCCCTCTATGAAAAACTGTTTTTT	CASSPLYEKLFF	TRBV5-1	TRBJ1-4
TGTGCCAAAAGGGGGGGGGGGCCGAGCTCCTACGAGCAGTACTTC	CAKRGGGPSSYEQYF	TRBV2	TRBJ2-7
TGTGCCAGTAGTACCGAAACCTTTCCCGGGACAGGTTACTCCTATAATTCACCCCTCCACTTT	CASSTETFPGTGYSYNSPLHF	TRBV19	TRBJ1-6
TGTGCCAGCAGCCAAGATACGACGCGCGTCTTCCTAGACAGTACGAATGAGCAGTTCTTC	CASSQDTTRVFLDSTNEQFF	TRBV3-1	TRBJ2-1
TGCAGTGCTAGAGTGGAGAGGAAAGAGACCCAGTACTTC	CSARVERKETQYF	TRBV20-1	TRBJ2-5
TGTGCCAGCAGTAATGATAGACGGGGCTACACCTTC	CASSNDRRGYTF	TRBV6-1	TRBJ1-2
TGTGCCAGCAGCACGAACAGGGATGGACGTAGCAATCAGCCCCAGCATTTT	CASSTNRDGRSNQPQHF	TRBV7-2	TRBJ1-5
TGTGCCAGCAGTTTAGAGGCAGCCGAAGCTTTCTTT	CASSLEAAEAFF	TRBV12-3	TRBJ1-1
TGCGCCAGCAGGTTAACTGGGGAGGCCAGAAGCAATCAGCCCCAGCATTTT	CASRLTGEARSNQPQHF	TRBV10-2	TRBJ1-5
TGTGCCAGCAGTGGCCGGGACAGGGGTGACTTC	CASSGRDRGDF	TRBV6-1	TRBJ2-7
TGTGCCACCAGCAGGCCTCGAGACAGGGGGCCCGCCTACGAGCAGTACTTC	CATSRPRDRGPAYEQYF	TRBV15	TRBJ2-7
TGTGCCAGCAGTTACCTCCACAGGCAGCTAACAGATACGCAGTATTTT	CASSYLHRQLTDTQYF	TRBV6-5	TRBJ2-3
TGTGCCAGCAGCGGGGCGACCCGACAGGCTCAGCCCCAGCATTTT	CASSGATRQAQPQHF	TRBV11-2	TRBJ1-5
TGCGCCAGCAGCCAAGATGGAACGACAGGGCCCAATCAGCCCCAGCATTTT	CASSQDGTTGPNQPQHF	TRBV4-3	TRBJ1-5
TGCAGTGCAGGGCAGAACACTGAAGCTTTCTTT	CSAGQNTEAFF	TRBV20-1	TRBJ1-1
TGTGCCAGCAGCTCGGGACTAGACGAGCAGTACTTC	CASSSGLDEQYF	TRBV7-2	TRBJ2-7
TGTGCCAGTAAACCGGGGGGGCTACGGTGCACAGATACGCAGTATTTT	CASKPGGLRCTDTQYF	TRBV19	TRBJ2-3
TGTGCCAGCACCTATGGGGCCCGGATCTCTGGAAACACCATATATTTT	CASTYGARISGNTIYF	TRBV12-3	TRBJ1-3
TGTGCCACCAGTGATTTAGGTCTGGGACAGGGCCTCCCCGTGCGGCAGCCCCAGCATTTT	CATSDLGLGQGLPVRQPQHF	TRBV24-1	TRBJ1-5
TGTGCCAGCAGCCGGGAACCCCGGGGACTAGCGGGTGCGGAGAATGAGCAGTTCTTC	CASSREPRGLAGAENEQFF	TRBV7-4	TRBJ2-1
TGTGCCAACTTTGGCTACACAGATACGCAGTATTTT	CANFGYTDTQYF	TRBV27	TRBJ2-3
TGTGCCAGCAGCTTCCCTAAGGCGCTAGCGGGACTGGCCTACGAGCAGTACTTC	CASSFPKALAGLAYEQYF	TRBV11-3	TRBJ2-7
TGCGCCAGCAGAGACGGGGCCAATGAGCAGTTCTTC	CASRDGANEQFF	TRBV4-3	TRBJ2-1
TGCGCCAGCAGCCATTCAATCAATTTCCCGGGACAGGGGGCTAGCTCCTACAATGAGCAGTTCTTC	CASSHSINFPGQGASSYNEQFF	TRBV4-3	TRBJ2-1
TGTGCCACCAGTGATTTGCCGGAACAGGGCCTGCGCCCCTTTAGCAATCAGCCCCAGCATTTT	CATSDLPEQGLRPFSNQPQHF	TRBV24-1	TRBJ1-5
TGTGCCAGCAGCTTACAGAGGCCGGCCTACGAGCAGTACTTC	CASSLQRPAYEQYF	TRBV7-9	TRBJ2-7
TGCAGTGCTAGAACTAGACACAATGAGCAGTTCTTC	CSARTRHNEQFF	TRBV20-1	TRBJ2-1
TGTGCCAGCAGTTTATGGCGGGAGCTTAGCTCCTACGAGCAGTACTTC	CASSLWRELSSYEQYF	TRBV12-3	TRBJ2-7
TGTGCCAGCAGTGCCCCCCTAGAAGGGACAGGGGGCACCACCTACGAGCAGTACTTC	CASSAPLEGTGGTTYEQYF	TRBV2	TRBJ2-7
TGTGCCAGTAGTCTAATAGCGGGACCAAAGGTCTCCTACGAGCAGTACTTC	CASSLIAGPKVSYEQYF	TRBV19	TRBJ2-7
TGCGCCAGCAGCAGGTTCTCTAGCGTCGAGCAGTACTTC	CASSRFSSVEQYF	TRBV5-1	TRBJ2-7
TGTGCCAGCAGCGGGGACCCTAGCGGGAGGCCGGATACGCAGTATTTT	CASSGDPSGRPDTQYF	TRBV3-1	TRBJ2-3
TGCAGTGCCTGGGAGCCCAAAAACATTCAGTACTTC	CSAWEPKNIQYF	TRBV20-1	TRBJ2-4
TGTGCCAGTAGTATAGATCTCATAAAACCACAGGGAACTGAAGCTTTCTTT	CASSIDLIKPQGTEAFF	TRBV19	TRBJ1-1
TGTGCCACCAGTGATAGTGCGGCATCCAGCAATCAGCCCCAGCATTTT	CATSDSAASSNQPQHF	TRBV24-1	TRBJ1-5
TGTGCCAGCATCCGGCGGGGACAGGGTAATTATCAGCCCCAGCATTTT	CASIRRGQGNYQPQHF	TRBV6-4	TRBJ1-5
TGTGCCAGCTCACATTCCCCGGGACTAGCGGGAGAAAACATTCAGTACTTC	CASSHSPGLAGENIQYF	TRBV18	TRBJ2-4
TGTGCCAGTAGATGGGACAGTTACGCCGGTTTGAACACTGAAGCTTTCTTT	CASRWDSYAGLNTEAFF	TRBV19	TRBJ1-1
TGTGCCAGCAGCAAACTCAGCCGCACAGATACGCAGTATTTT	CASSKLSRTDTQYF	TRBV9	TRBJ2-3
TGTGCCAGTGTTCCAGGGGGGTCACCCCTCCACTTT	CASVPGGSPLHF	TRBV19	TRBJ1-6
TGTGCCAGCAGCAGGATTAATACAGCGGGAACATCAGGTGGGCAAGAGACCCAGTACTTC	CASSRINTAGTSGGQETQYF	TRBV5-5	TRBJ2-5
TGTGCCAGCAAGGGAGAAACTGGAAACACCATATATTTT	CASKGETGNTIYF	TRBV7-8	TRBJ1-3
TGTGCCAGCAGCCGTGCAGGATATAGCAATCAGCCCCAGCATTTT	CASSRAGYSNQPQHF	TRBV13	TRBJ1-5
TGTGCCAGCAGCTGGCCCAATAGCGGGAACATTCAGTACTTC	CASSWPNSGNIQYF	TRBV11-3	TRBJ2-4
TGTGCCAGCCCTCGACAGGCGAACACCGGGGAGCTGTTTTTT	CASPRQANTGELFF	TRBV14	TRBJ2-2
TGTGCCAGCAGCTTGACAGGGTGGGGTACGAACACCGGGGAGCTGTTTTTT	CASSLTGWGTNTGELFF	TRBV7-9	TRBJ2-2
TGTGCCAGCAGTTTAAGCGGGGGGGCTATCTCCAATGAGCAGTTCTTC	CASSLSGGAISNEQFF	TRBV12-4	TRBJ2-1
TGTGCCAGCAGCTTACCAGGGCCTCAGCGATCTACTGAAGCTTTCTTT	CASSLPGPQRSTEAFF	TRBV7-9	TRBJ1-1
TGTGCCAGCAGTTTAGACTCCCCAAAGATGGGACTAGACACCGGGGAGCTGTTTTTT	CASSLDSPKMGLDTGELFF	TRBV27	TRBJ2-2
TGTGCCAGCAGCTTACGGCAGGGCTCCCGTAATGGCTACACCTTC	CASSLRQGSRNGYTF	TRBV7-3	TRBJ1-2
TGTGCCAGCAGCGCTCGGAATTTGTACGAGCAGTACTTC	CASSARNLYEQYF	TRBV11-3	TRBJ2-7
TGTGCCCCCGCCGGGGTCTGTGAAGCTTTCTTT	CAPAGVCEAFF	TRBV19	TRBJ1-1
TGTGCCAGCTACGGGGGGTCCTACAATGAGCAGTTCTTC	CASYGGSYNEQFF	TRBV2	TRBJ2-1
TGTGCCAGCAGCAAATACAGGGCCTGGACTGGAAACACCATATATTTT	CASSKYRAWTGNTIYF	TRBV11-3	TRBJ1-3
TGTGCCAGCAGACGAGGACCGCAGACCGGGTCCTACGAGCAGTACTTC	CASRRGPQTGSYEQYF	TRBV28	TRBJ2-7
TGCGCCAGCAGCCCAAGAAAAAATGGGACAGCATTAGAGGCCGGAAAACTGTTTTTT	CASSPRKNGTALEAGKLFF	TRBV10-1	TRBJ1-4
TGTGCCTGGCGGGACAGGGGGCAAACCACTGCCCGGAGAAATGAGCAGTTCTTC	CAWRDRGQTTARRNEQFF	TRBV30	TRBJ2-1
TGTGCCAGCAGCAAAGGAAGGACCAGAAGATCGGATAATGAAAAACTGTTTTTT	CASSKGRTRRSDNEKLFF	TRBV7-8	TRBJ1-4
TGTGCCAGCAGCGGGACAGGGCTCTATGGCTACACCTTC	CASSGTGLYGYTF	TRBV7-3	TRBJ1-2
TGTGCCAGCAGCCTCCCGTTGATCGGACTAGCGGGATGGAGCTCCTACGAGCAGTACTTC	CASSLPLIGLAGWSSYEQYF	TRBV7-4	TRBJ2-7
TGTGCCAGCAGCTTAGGAGGAATTGGGACAGGGGAAGGTGGCTACACCTTC	CASSLGGIGTGEGGYTF	TRBV7-2	TRBJ1-2
TGTGCCAGCAGTTGGACCTACGAGCAGTACTTC	CASSWTYEQYF	TRBV6-5	TRBJ2-7
TGTGCCAGTGTGAGGGGGGCCCCCGAGACCCAGTACTTC	CASVRGAPETQYF	TRBV6-1	TRBJ2-5
TGTGCCAGCAGCTTGAGGACGACCACCGGGGAGCTGTTTTTT	CASSLRTTTGELFF	TRBV5-6	TRBJ2-2
TGCAGCGTTGACAATGCAAGAACGGGTGGCTCCTACGAGCAGTACTTC	CSVDNARTGGSYEQYF	TRBV29-1	TRBJ2-7
TGTGCCACCAGCAGAGTCCAGGGGTATGGCTACACCTTC	CATSRVQGYGYTF	TRBV15	TRBJ1-2
TGTGCCAGCAGTTTACCACCCGGGAGGGGTACCTACGAGCAGTACTTC	CASSLPPGRGTYEQYF	TRBV27	TRBJ2-7
TGTGCCAGCATACTCCTGGGGGGGCAGTACTTC	CASILLGGQYF	TRBV2	TRBJ2-5
TGTGCCAGCAGCGGAAGGCCCCTAAATTCCTACGAGCAGTACTTC	CASSGRPLNSYEQYF	TRBV7-9	TRBJ2-7
TGTGCCAGGCAGTGTAAGCTAGGACTGGAGCAGTTCTTC	CARQCKLGLEQFF	TRBV2	TRBJ2-1
TGCAGTGCGGGACAGCCTTCGTCGAACACTGAAGCTTTCTTT	CSAGQPSSNTEAFF	TRBV20-1	TRBJ1-1
TGTGCCAGCAGTTTATCCGGGGGGGGCTGTGAAAAACTGTTTTTT	CASSLSGGGCEKLFF	TRBV28	TRBJ1-4
TGTGCCAGCAGTGACTCTTTGGGCCTGGACTTTGGGGAGCTGTTTTTT	CASSDSLGLDFGELFF	TRBV6-4	TRBJ2-2
TGTGCCAGCTCTGTCCCCTGCGAGCGGGAGGGGGAATCGAACACCGGGGAGCTGTTTTTT	CASSVPCEREGESNTGELFF	TRBV18	TRBJ2-2
TGTGCCAGCAGCTTGTCATTAGGACTTAGCAATCAGCCCCAGCATTTT	CASSLSLGLSNQPQHF	TRBV5-6	TRBJ1-5
TGTGCCAGCAGTTTTGGACAGGGGGCTAGTCGGAGCAATCAGCCCCAGCATTTT	CASSFGQGASRSNQPQHF	TRBV12-3	TRBJ1-5
TGTGCCAGCCGAGCTCTCTACAATGAGCAGTTCTTC	CASRALYNEQFF	TRBV7-4	TRBJ2-1
TGTGCCAGCAGTTACCTTGAGGGACTTTCAGAGACCCAGTACTTC	CASSYLEGLSETQYF	TRBV12-4	TRBJ2-5
TGTGCCAGCAGCCCCCTAGGGTCCTACGAGCAGTACTTC	CASSPLGSYEQYF	TRBV3-1	TRBJ2-7
TGCAGCGTGAAATTTATAGCGGGACGGGACGACGAGCAGTACTTC	CSVKFIAGRDDEQYF	TRBV29-1	TRBJ2-7
TGTGCCACCCATGTCCTTTCAACCCAGGGTTCCCTGTTAGGGCAAGAGACCCAGTACTTC	CATHVLSTQGSLLGQETQYF	TRBV24-1	TRBJ2-5
TGTGCCAGCAGCCAAATAAGGACTAGCGGGGAAGACACAGATACGCAGTATTTT	CASSQIRTSGEDTDTQYF	TRBV3-1	TRBJ2-3
TGCGCCAGCAGCTTGGCTAGATTGGTTGGCCGCGAGCAGTACTTC	CASSLARLVGREQYF	TRBV5-1	TRBJ2-7
TGTGCCAGCAGCTGGGCTGGCACAGATACGCAGTATTTT	CASSWAGTDTQYF	TRBV6-4	TRBJ2-3
TGTGCCAGCAGCTCTAGGGGGGGAGAGAACACTGAAGCTTTCTTT	CASSSRGGENTEAFF	TRBV5-6	TRBJ1-1
TGCAGTGCTAGCGGGAGCCCAGGGTTTACCTCCTACGAGCAGTACTTC	CSASGSPGFTSYEQYF	TRBV20-1	TRBJ2-7
TGCGCCAGCAGCTTAGTACATAAACGGGACGGAGCTTTCTTT	CASSLVHKRDGAFF	TRBV5-1	TRBJ1-1
TGTGCCAGCAGACTAGCGGGAGGGCGAGCCTCCTACAATGAGCAGTTCTTC	CASRLAGGRASYNEQFF	TRBV6-3	TRBJ2-1
TGTGCCAGCGAGGGGTGCGGGAGCCAGGAGGGGGGCAATTCACCCCTCCACTTT	CASEGCGSQEGGNSPLHF	TRBV6-3	TRBJ1-6
TGCGCCAGCGTAACTAGCGGGAGCCCAGATACGCAGTATTTT	CASVTSGSPDTQYF	TRBV5-1	TRBJ2-3
TGCAGTGCATGGGGGCTCTTCGCTCGATCCGACAGGGTGAACACCGGGGAGCTGTTTTTT	CSAWGLFARSDRVNTGELFF	TRBV20-1	TRBJ2-2
TGTGCCAGCAGGAGACAGGGAAAGGATGAAAAACTGTTTTTT	CASRRQGKDEKLFF	TRBV6-4	TRBJ1-4
TGTGCCAGCAGTTATGGCTTTAACGGGGGACTCGAGACCCAGTACTTC	CASSYGFNGGLETQYF	TRBV6-3	TRBJ2-5
TGTGCCATATCAGGGTTGGATCGCTTCTCCTACGAGCAGTACTTC	CAISGLDRFSYEQYF	TRBV10-3	TRBJ2-7
TGCAGTGCTAGGAACTGGGGCCGTTACGTAAATACTTCACCCCTCCACTTT	CSARNWGRYVNTSPLHF	TRBV20-1	TRBJ1-6
TGTGCCAGCAGTGACTTAGCGGGCGCTTCGGCGTACAATGAGCAGTTCTTC	CASSDLAGASAYNEQFF	TRBV28	TRBJ2-1
TGTGCCAGCAGCCAAGTGAGTCCTCCGGGGGCAAGGGGCCCCTATGGCTACACCTTC	CASSQVSPPGARGPYGYTF	TRBV3-1	TRBJ1-2
TGTGCCAGCAGTTACAGGGGGACGGACAGGCTTAATTCACCCCTCCACTTT	CASSYRGTDRLNSPLHF	TRBV6-2	TRBJ1-6
TGTGCCATAACGACTAGCGGGCCAACAGATACGCAGTATTTT	CAITTSGPTDTQYF	TRBV6-1	TRBJ2-3
TGTGCCTGGATAGATCAGGGCCCCCGAACTAATGAAAAACTGTTTTTT	CAWIDQGPRTNEKLFF	TRBV30	TRBJ1-4
TGTGCCAGCAGCTGGAGAACAACCTACGAGCAGTACTTC	CASSWRTTYEQYF	TRBV7-2	TRBJ2-7
TGTGCCAGCAGCTTACACGTGCGGGGAAGTGAGCAGTTCTTC	CASSLHVRGSEQFF	TRBV7-4	TRBJ2-1
TGTGCCAGCATCCCCCCATCGAGGGCCGGGCACTATGGCTACACCTTC	CASIPPSRAGHYGYTF	TRBV5-5	TRBJ1-2
TGTGCCAGCAGCAAGGTATGGGGCGCATGCTACAATGAGCAGTTCTTC	CASSKVWGACYNEQFF	TRBV13	TRBJ2-1
TGTGCCATCCCACCCAGTCGGGACAGGGTTAGGGTAGCCAAAAACATTCAGTACTTC	CAIPPSRDRVRVAKNIQYF	TRBV10-3	TRBJ2-4
TGTGCCAGCTCACCATCTCAGTACCACAGGGCGGCGAACACTGAAGCTTTCTTT	CASSPSQYHRAANTEAFF	TRBV18	TRBJ1-1
TGTGCCAGCAGCTCTACAGGGGCTCAGCCCCAGCATTTT	CASSSTGAQPQHF	TRBV13	TRBJ1-5
TGTGCCAGGCCCGGGACAGGATTTAGCTCCTACAATGAGCAGTTCTTC	CARPGTGFSSYNEQFF	TRBV6-5	TRBJ2-1
TGTGCCAGCAGTGAATACTACCAAGAGACCCAGTACTTC	CASSEYYQETQYF	TRBV6-4	TRBJ2-5
TGCGCCAGCAGTGAGTCCAGAGAAGGGGTCGAGCAGTACTTC	CASSESREGVEQYF	TRBV10-1	TRBJ2-7
TGTGCCAGCAGCCCAGGACAGGGGAAAGAAACCACTGAAGCTTTCTTT	CASSPGQGKETTEAFF	TRBV6-8	TRBJ1-1
TGTGCCAGCAGTCCAACAGGACAGCTACGGGAAAAACTGTTTTTT	CASSPTGQLREKLFF	TRBV6-1	TRBJ1-4
TGTGCCAGTAGAACTGGGGGGGCAGTGTATTTT	CASRTGGAVYF	TRBV19	TRBJ2-3
TGTGCCAGCAGCACGCTCAGGGGGCGGCCCGAGACCCAGTACTTC	CASSTLRGRPETQYF	TRBV13	TRBJ2-5
TGTGCCAGCAGCGGGGGGAGAGATACGCAGTATTTT	CASSGGRDTQYF	TRBV7-9	TRBJ2-3
TGTGCCAGCTCACCACAGGACCTGACAGGGTCCTACGAGCAGTACTTC	CASSPQDLTGSYEQYF	TRBV18	TRBJ2-7
TGTGCCAGCAGCTTAGCGCCCCGGGACGTAGACAATGAGCAGTTCTTC	CASSLAPRDVDNEQFF	TRBV7-2	TRBJ2-1
TGTGCCAGCAGCTCCCGAGGACAGGGTATGAACACTGAAGCTTTCTTT	CASSSRGQGMNTEAFF	TRBV13	TRBJ1-1
TGCAGTGCTGACAGGTGTAGTAGGTCGACCCAGTACTTC	CSADRCSRSTQYF	TRBV20-1	TRBJ2-5
TGTGCCAGCAGCCGAAATCAGATGGATTACAATGAGCAGTTCTTC	CASSRNQMDYNEQFF	TRBV4-2	TRBJ2-1
TGTGCCAGCAGCTTACAACTGCTAACTAGCGGGAGGCCGAATGAGCAGTTCTTC	CASSLQLLTSGRPNEQFF	TRBV13	TRBJ2-1
TGTGCCAGGGGAAAAAAGGGCGGGCCCTACGAGCAGTACTTC	CARGKKGGPYEQYF	TRBV6-5	TRBJ2-7
TGTGCCAGCAGCTTGAATTCAGGGTTGAACACTGAAGCTTTCTTT	CASSLNSGLNTEAFF	TRBV5-5	TRBJ1-1
TGTGCCAGCAGTTTTGACCCCGGGACCGACTATAGCAATCAGCCCCAGCATTTT	CASSFDPGTDYSNQPQHF	TRBV27	TRBJ1-5
TGTGCCAGCAGCGGGAGAGCGGATTCTAATGAGCAGTTCTTC	CASSGRADSNEQFF	TRBV9	TRBJ2-1
TGCAGTGCGGGACAGGGGGAAGAGACCCAGTACTTC	CSAGQGEETQYF	TRBV20-1	TRBJ2-5
TGTGCCAGTCGGGGGGGGGCCGATGCAGATACGCAGTATTTT	CASRGGADADTQYF	TRBV19	TRBJ2-3
TGTGCCAGCAGCTTAGATGCCCGGGACAGTGGGACCACTGAAGCTTTCTTT	CASSLDARDSGTTEAFF	TRBV7-6	TRBJ1-1
TGTGCCAGCAGCTTGATGTCAGGGCTACACGAGCAGTACTTC	CASSLMSGLHEQYF	TRBV5-4	TRBJ2-7
TGTGCCAGCAGCCGGAGCCAGGGGGGGAACTACGAGCAGTACTTC	CASSRSQGGNYEQYF	TRBV13	TRBJ2-7
TGTGCCAGCGGTGCCGGACTAGCGGGCGAGACCCAGTACTTC	CASGAGLAGETQYF	TRBV6-5	TRBJ2-5
TGTGCCAGCAGTTATCGGACTAGCGGGAAAGGTGAGACCCAGTACTTC	CASSYRTSGKGETQYF	TRBV12-4	TRBJ2-5
