TGCGCCAGCAAGGTCAGGGGCGAAGAGCAGTACTTC	CASKVRGEEQYF	TRBV10-1	TRBJ2-7
TGTGCCAGCAGCTATCCATTAGGCTCAAGGAATTCACCCCTCCACTTT	CASSYPLGSRNSPLHF	TRBV11-3	TRBJ1-6
TGTGCCAGCAGGGACAGGGGGAAACGTGCTTTCTTT	CASRDRGKRAFF	TRBV12-3	TRBJ1-1
TGTGCCAGCAGTTTATCGGCTCCTCTGGACAGGAGGAATGCCTACGAGCAGTACTTC	CASSLSAPLDRRNAYEQYF	TRBV27	TRBJ2-7
TGTGCCAGTAGCAGGGGGAAAAAGGGCTACAATGAGCAGTTCTTC	CASSRGKKGYNEQFF	TRBV19	TRBJ2-1
TGTGCCAGCAGTGGCCCTGGAGGGCGGGAGCAGTACTTC	CASSGPGGREQYF	TRBV6-1	TRBJ2-7
TGTGCCAGCAGGAAGTCTACAGGGGTCACTGAAGCTTTCTTT	CASRKSTGVTEAFF	TRBV12-4	TRBJ1-1
TGTGCCAGTAGAAGAGAAGCGACTAGCGGGGGGCCCACAGATACGCAGTATTTT	CASRREATSGGPTDTQYF	TRBV19	TRBJ2-3
TGTGCCAGCAGTTATTACCGGGACAGGGGGGAACCTTATGAAGCTTTCTTT	CASSYYRDRGEPYEAFF	TRBV6-6	TRBJ1-1
TGTGCCAGCAGCCAGGGTGTCGGGGAACGATATGGCTACACCTTC	CASSQGVGERYGYTF	TRBV13	TRBJ1-2
TGTGCCAGCAGCTGGGCCCTCGACAGCAGGACCCATGAGCAGTTCTTC	CASSWALDSRTHEQFF	TRBV7-3	TRBJ2-1
TGTGCCAGCAGTCCGTCATCCAATATGGACACCGGGGAGCTGTTTTTT	CASSPSSNMDTGELFF	TRBV6-5	TRBJ2-2
TGTGCCAGCAGTTATTCTGGTCCGGGACTAGCGGGAGAATATGGCTACACCTTC	CASSYSGPGLAGEYGYTF	TRBV27	TRBJ1-2
TGTGCCATCAGGGAGGCCGGGAGCTACGAGCAGTACTTC	CAIREAGSYEQYF	TRBV10-3	TRBJ2-7
TGTGCCAGTCTCCGGGGCTACGAGCAGTACTTC	CASLRGYEQYF	TRBV5-4	TRBJ2-7
TGTGCCAAACCTAGCGATAATGAGCAGTTCTTC	CAKPSDNEQFF	TRBV27	TRBJ2-1
TGTGCCAGCAGGGTGGGGGACGGCGAAAGCACAGATACGCAGTATTTT	CASRVGDGESTDTQYF	TRBV5-4	TRBJ2-3
TGTGCCAGCAGCGTCGAACGGGGACAGGGCTGCCCAGATACGCAGTATTTT	CASSVERGQGCPDTQYF	TRBV7-3	TRBJ2-3
TGCGCCAGCAGCAGGCCCCGAGGGGAAGTGATAGATAGCACAGATACGCAGTATTTT	CASSRPRGEVIDSTDTQYF	TRBV4-1	TRBJ2-3
TGCGCCAGCAGTGTCCCCAACAGGGATGAAAAACTGTTTTTT	CASSVPNRDEKLFF	TRBV10-1	TRBJ1-4
TGTGCCAGCAGTTTAGGACAGGGGGCGCGAGGACGAAAACTGTTTTTT	CASSLGQGARGRKLFF	TRBV12-4	TRBJ1-4
TGCAGCGCCCAGATTGGAGAACCTAATGAAAAACTGTTTTTT	CSAQIGEPNEKLFF	TRBV29-1	TRBJ1-4
TGTGCCAGCTACCAGGGTCCCTCTGGAAACACCATATATTTT	CASYQGPSGNTIYF	TRBV6-4	TRBJ1-3
TGTGCCAGCAGCCGGACTTCCCCAAGCTACGAGCAGTACTTC	CASSRTSPSYEQYF	TRBV13	TRBJ2-7
TGTGCCACCAGTGAGAATACTCGGGAGGGCTCCCCCCAGTACTTC	CATSENTREGSPQYF	TRBV24-1	TRBJ2-5
TGCGCCAGCAGCCAATCCTCACAGGCACCCCCCAACATTCAGTACTTC	CASSQSSQAPPNIQYF	TRBV4-3	TRBJ2-4
TGTGCCAGCAGCCAATCTTCTGAAATTACGGGACAGGTACCCCCCGTTTATGGCTACACCTTC	CASSQSSEITGQVPPVYGYTF	TRBV14	TRBJ1-2
TGTGCCACAAACTATGGCTACACCTTC	CATNYGYTF	TRBV10-3	TRBJ1-2
TGTGCCAGTAAAGGGGGGAGCTCCTACGAGCAGTACTTC	CASKGGSSYEQYF	TRBV19	TRBJ2-7
TGTGCCAGCAGAGCGATAAGCGGGGTCGGACCCTACGAGCAGTACTTC	CASRAISGVGPYEQYF	TRBV6-3	TRBJ2-7
TGTGCCAGCAGTACAAAGGCTAGCGGGCAGACCCTTGCCTACAATGAGCAGTTCTTC	CASSTKASGQTLAYNEQFF	TRBV6-5	TRBJ2-1
TGTGCCTGGAAAGCGTGGAGCTGGGAACAAGAGACCCAGTACTTC	CAWKAWSWEQETQYF	TRBV30	TRBJ2-5
TGCGCCAGCAGCTTGAGCGGTCCGGCAGCCAAAAACATTCAGTACTTC	CASSLSGPAAKNIQYF	TRBV5-1	TRBJ2-4
TGTGCCAGCAGTTACGACCAGCGGGATACTAATGAAAAACTGTTTTTT	CASSYDQRDTNEKLFF	TRBV6-5	TRBJ1-4
TGTGCCACCAGTAAGCCGCTAGTCAGCAATGAGCAGTTCTTC	CATSKPLVSNEQFF	TRBV24-1	TRBJ2-1
TGTGCCAGCAGCTATGTCAAAGAGGGGGGCCCAAGCAATCAGCCCCAGCATTTT	CASSYVKEGGPSNQPQHF	TRBV5-6	TRBJ1-5
TGTGCCAGCATTCCCATCACTAGCGGGGGGGCGTTGCAAGAGACCCAGTACTTC	CASIPITSGGALQETQYF	TRBV6-1	TRBJ2-5
TGTGCCAGCAGCTTAAACCAGGAAAAACTGTTTTTT	CASSLNQEKLFF	TRBV7-3	TRBJ1-4
TGTGCCAGTACGCGGGAGCTAGGGGAGACCCAGTACTTC	CASTRELGETQYF	TRBV19	TRBJ2-5
TGCGCTATGGGAGTCTCTGGAAACACCATATATTTT	CAMGVSGNTIYF	TRBV10-1	TRBJ1-3
TGTGCCAGCAGCCAAGAAGACGGGACTAGCGAACTGGGCGGGGAGCTGTTTTTT	CASSQEDGTSELGGELFF	TRBV14	TRBJ2-2
TGCGGGGGGCGGAGGACCTACGAGCAGTACTTC	CGGRRTYEQYF	TRBV5-1	TRBJ2-7
TGTGCCAGCAGCCAAGTGCCAGGGACTACTAATCCCGGGCATAGGAACACTGAAGCTTTCTTT	CASSQVPGTTNPGHRNTEAFF	TRBV3-1	TRBJ1-1
TGTGCCAGCAGCTTGGCGGACAGGGACGGGGTCAATCAGCCCCAGCATTTT	CASSLADRDGVNQPQHF	TRBV5-6	TRBJ1-5
TGTGCCAGCAGCCGAGGTACCCGGGGGCGGGGAGACCTCTATGGCTACACCTTC	CASSRGTRGRGDLYGYTF	TRBV13	TRBJ1-2
TGCGCCAGCAGTGTACGACAGGGGAATGGCTACACCTTC	CASSVRQGNGYTF	TRBV10-1	TRBJ1-2
TGTGCCAGCAGCGCAGCCGACAGTTCCACCGGGGAGCTGTTTTTT	CASSAADSSTGELFF	TRBV7-2	TRBJ2-2
TGTGCCAGGCCGAAAGACCAGTACTTC	CARPKDQYF	TRBV6-3	TRBJ2-5
TGTGCCATAGGAGCGGGAGCGATCATTCAGTACTTC	CAIGAGAIIQYF	TRBV13	TRBJ2-4
TGTGCCAGCAGCTTAGTAGAGGGGGGATGCCAAGAGACCCAGTACTTC	CASSLVEGGCQETQYF	TRBV7-3	TRBJ2-5
TGTGCCATCAGTGATGAATGTGTCGGTACCTGGGACACCGTGCAGCCCCAGCATTTT	CAISDECVGTWDTVQPQHF	TRBV10-3	TRBJ1-5
TGCAGTGCTAGAGGCCCTCATGACAGGTGCGTTTCTCTGAGTGGAAACACCATATATTTT	CSARGPHDRCVSLSGNTIYF	TRBV20-1	TRBJ1-3
TGTGCCAGCAGCAGACAGAAAGGAGGAGAAAAACTGTTTTTT	CASSRQKGGEKLFF	TRBV12-3	TRBJ1-4
TGCAGTGCTAGAGACCTAGGTGTACGGGGGGCAACCTTCTACGAGCAGTACTTC	CSARDLGVRGATFYEQYF	TRBV20-1	TRBJ2-7
TGTGCCAGCAGGGACAGGACAGAGGGGTCGAATCAGCCCCAGCATTTT	CASRDRTEGSNQPQHF	TRBV12-3	TRBJ1-5
TGTGCCAGCAGTGACTACCTGGATTTCTACGAGCAGTACTTC	CASSDYLDFYEQYF	TRBV6-4	TRBJ2-7
TGTGCCAGCAGTGTAAGGCACAGGGGGTATAGCTCCTACAATGAGCAGTTCTTC	CASSVRHRGYSSYNEQFF	TRBV27	TRBJ2-1
TGTGCTAGCAGCTCCACTGACGTTCGCACCGGGGAGCTGTTTTTT	CASSSTDVRTGELFF	TRBV7-7	TRBJ2-2
TGTGCCAGCAGCTTTGTGGGTGGGGCCTACGAGCAGTACTTC	CASSFVGGAYEQYF	TRBV7-3	TRBJ2-7
TGTGCCAGCAGTGAATTGAGGGGAAATTCACCCCTCCACTTT	CASSELRGNSPLHF	TRBV2	TRBJ1-6
TGTGCCAGCAAGCGACAGGGCTATTACGAGCAGTACTTC	CASKRQGYYEQYF	TRBV27	TRBJ2-7
TGTGCCAGTACCCGGGGGGAGACCTACGAGCAGTACTTC	CASTRGETYEQYF	TRBV19	TRBJ2-7
TGCAGTGCTAGTTTGGGGGGAGGAGAGGGTGCCTACGAGCAGTACTTC	CSASLGGGEGAYEQYF	TRBV20-1	TRBJ2-7
TGTGCCAGCAGCCAAGGACAGTATTCCGGGGAGCTGTTTTTT	CASSQGQYSGELFF	TRBV3-1	TRBJ2-2
TGTGCCAGCAGCATTCCCACACCGGGGGGTCATTGCCACACTGAAGCTTTCTTT	CASSIPTPGGHCHTEAFF	TRBV7-2	TRBJ1-1
TGTGCCAGCAGTTTAAATCCCGGGACAGGGGGCGCTTGTCAGCCCCAGCATTTT	CASSLNPGTGGACQPQHF	TRBV28	TRBJ1-5
TGTGCCAGCAGCTTCCAGGGCTATGGCTACACCTTC	CASSFQGYGYTF	TRBV11-3	TRBJ1-2
TGTGCCAGCGGCGGGGGGGAGGAGGCCTACAATGAGCAGTTCTTC	CASGGGEEAYNEQFF	TRBV27	TRBJ2-1
TGTGCCACCAGTGATTATCGGGGTAATTGTATTTGGGGGTATCAGCCCCAGCATTTT	CATSDYRGNCIWGYQPQHF	TRBV24-1	TRBJ1-5
TGTGCCAGCAGCTTAACCCCCTGGACTAGCGATCGCGAGCAGTACTTC	CASSLTPWTSDREQYF	TRBV7-3	TRBJ2-7
TGTGAATCTGGGTGTCACTACAGGGAAGACACTGAAGCTTTCTTT	CESGCHYREDTEAFF	TRBV4-2	TRBJ1-1
TGCGCCAGCAGTGAGTTATGCTTAGGAGGGAGGGGCACAGATACGCAGTATTTT	CASSELCLGGRGTDTQYF	TRBV10-2	TRBJ2-3
TGTGCCGTGGGGGGACTAGATTTGGAGGGCAATGAGCAGTTCTTC	CAVGGLDLEGNEQFF	TRBV6-1	TRBJ2-1
TGTGCCAGCAGTGCCGGACAGGCTGGGGCCAACGTCCTGACTTTC	CASSAGQAGANVLTF	TRBV6-1	TRBJ2-6
TGCAGTGCTAGAGATTTTCCGCAGACCCCCATGGCCTACAATGAGCAGTTCTTC	CSARDFPQTPMAYNEQFF	TRBV20-1	TRBJ2-1
TGTGCCAGCAGCCAATCGAGACAGGGGCGGGGCTCTGGAAACACCATATATTTT	CASSQSRQGRGSGNTIYF	TRBV14	TRBJ1-3
TGTGCCAGCACCTGTTTTGGGGTCGCTTTTCCCGGGGCGATCCCTGTGCACACCGGGGAGCTGTTTTTT	CASTCFGVAFPGAIPVHTGELFF	TRBV3-1	TRBJ2-2
TGTGCCATGAAAGGGAACTGGTCGACAGGGTGTACTGAAGCTTTCTTT	CAMKGNWSTGCTEAFF	TRBV3-1	TRBJ1-1
TGTGCCTGGATGAGAGGAGGTCCGAACACCGGGGAGCTGTTTTTT	CAWMRGGPNTGELFF	TRBV30	TRBJ2-2
TGTGCCAGCAGGGGGGGGACCTCTCAGGATGGCTACACCTTC	CASRGGTSQDGYTF	TRBV28	TRBJ1-2
TGTGCCAGCAGTGAAGGCGTACCGGCGGCCGCCCCGGGACTAGCGGGATTGGTCCGAGACGGCAGGGGAAGCACAGATACGCAGTATTTT	CASSEGVPAAAPGLAGLVRDGRGSTDTQYF	TRBV2	TRBJ2-3
TGTGCCAGCAGTTACCAGCCCAGGACTAGCGGGGGGGACTCCTACGAGCAGTACTTC	CASSYQPRTSGGDSYEQYF	TRBV6-2	TRBJ2-7
TGTGCCACCAAAGGGGGAGCGGACTCCTACAATGAGCAGTTCTTC	CATKGGADSYNEQFF	TRBV24-1	TRBJ2-1
TGTGCCATCAGTGATCCACCCAGAGAGACCCAGTACTTC	CAISDPPRETQYF	TRBV10-3	TRBJ2-5
TGCGCCAGCAGCTCCCCGGGACAGTGGTACTATGGCTACACCTTC	CASSSPGQWYYGYTF	TRBV5-1	TRBJ1-2
TGCAGCGTTGAAGCGGCGGAGCACACAGATACGCAGTATTTT	CSVEAAEHTDTQYF	TRBV29-1	TRBJ2-3
TGTGCCAGCAGCGGTAGGGGACAAGAGACCCAGTACTTC	CASSGRGQETQYF	TRBV6-3	TRBJ2-5
TGTGCCAGCAGTGACGGGCTTCTAGAGTCCTACGAGCAGTACTTC	CASSDGLLESYEQYF	TRBV2	TRBJ2-7
TGTGCCGGAGACAGGGGACGGTCCTACGAGCAGTACTTC	CAGDRGRSYEQYF	TRBV2	TRBJ2-7
TGTGCCAGCAGGTCGACAGGAGAGGCTGTCCGGAAGGGTGAGCAGTTCTTC	CASRSTGEAVRKGEQFF	TRBV6-6	TRBJ2-1
TGCGCCAGCAGCGGAGAGGGGGCAGGCCCAAAATACAATGAGCAGTTCTTC	CASSGEGAGPKYNEQFF	TRBV5-1	TRBJ2-1
TGCAGTGCACCAGCTCCATGGGGCGTCGAGCAGTACTTC	CSAPAPWGVEQYF	TRBV20-1	TRBJ2-7
TGCGCCAGCAGCATCGAAAACGGACTAGAAACCCAAGAGACCCAGTACTTC	CASSIENGLETQETQYF	TRBV5-1	TRBJ2-5
TGCGCCAGCAGCCAAGAGGTTAGGGGTGAAAAACTGTTTTTT	CASSQEVRGEKLFF	TRBV4-1	TRBJ1-4
TGTGCTAGTGGCATTACCGGCGCCCCGGAGCCCCAGCATTTT	CASGITGAPEPQHF	TRBV12-5	TRBJ1-5
TGTGCACACCGTCCAGGGGGTATAGCCCGCAATCAGCCCCAGCATTTT	CAHRPGGIARNQPQHF	TRBV11-3	TRBJ1-5
TGTGCCAGCAGCCCAAGGGGGAATCCCCGGGTGCTCCGTTGCTCGAACACCGGGGAGCTGTTTTTT	CASSPRGNPRVLRCSNTGELFF	TRBV7-3	TRBJ2-2
TGTGCCAGCAGCCCGGGGGGAGAGACCCAGTACTTC	CASSPGGETQYF	TRBV13	TRBJ2-5
TGTGCCAGCACGCCTGGTACAGGGGGGTGGGGAGGCTACGAGCAGTACTTC	CASTPGTGGWGGYEQYF	TRBV7-3	TRBJ2-7
TGTGCCAGCAGCTTAACGGAAGTAGCCGATACGCAGTATTTT	CASSLTEVADTQYF	TRBV5-6	TRBJ2-3
TGCAGCGGCGGGGGGGGACGCGAGCAGTACTTC	CSGGGGREQYF	TRBV29-1	TRBJ2-7
TGTGCCACCGTGGGGGGGCATAAAGATAGCTACAATGAGCAGTTCTTC	CATVGGHKDSYNEQFF	TRBV28	TRBJ2-1
TGTGCCAGCAGCATAAAACCGCGGAGGACAGGGTCCGGGGCCTACGAGCAGTACTTC	CASSIKPRRTGSGAYEQYF	TRBV6-5	TRBJ2-7
TGTGCCAGCAGTTATGGAATCGAGGCAACCCAAGAGGGGCGGCCACAGCCCCAGCATTTT	CASSYGIEATQEGRPQPQHF	TRBV6-5	TRBJ1-5
TGCGCCAGCAGGGTAGATTTAAGGACAGGGGCCTATGGCTACACCTTC	CASRVDLRTGAYGYTF	TRBV10-1	TRBJ1-2
TGTGCCAGCAGTCCGTCGAACTACGAGCAGTACTTC	CASSPSNYEQYF	TRBV12-3	TRBJ2-7
TGTGCCAGCAGGCGAATAGAAGCTGAAGCTTTCTTT	CASRRIEAEAFF	TRBV12-4	TRBJ1-1
TGTGCCAGCAGTCCCCACAGGTCCTTTTCGGTATGCGAGCAGTACTTC	CASSPHRSFSVCEQYF	TRBV12-3	TRBJ2-7
TGCGCCAGCAGCTTAAGGGACACTGGGACAGATACGCAGTATTTT	CASSLRDTGTDTQYF	TRBV5-1	TRBJ2-3
TGTGCCAGCAGCTGCGGACCTAGCGGGAGGGGAAACAATGAGCAGTTCTTC	CASSCGPSGRGNNEQFF	TRBV7-2	TRBJ2-1
TGTGCCGGGCCCGGGGGGGGAAGATACGAGCAGTACTTC	CAGPGGGRYEQYF	TRBV24-1	TRBJ2-7
TGTGCCACGCTCTCTAGCTGGGAGACCCAGTACTTC	CATLSSWETQYF	TRBV19	TRBJ2-5
TGTGCCAGCAGCAGGGACAGGGGGAAGATGCATAACTATGGCTACACCTTC	CASSRDRGKMHNYGYTF	TRBV3-1	TRBJ1-2
TGTGCCAGCAGCCCGGGACAGAAAAACACTGAAGCTTTCTTT	CASSPGQKNTEAFF	TRBV9	TRBJ1-1
TGTGCCAGCCTGGCAGGGACCTGGACTGAAGCTTTCTTT	CASLAGTWTEAFF	TRBV6-4	TRBJ1-1
TGTGCCAGCAGCGGTCAGGGACTTAATGAAAAACTGTTTTTT	CASSGQGLNEKLFF	TRBV7-9	TRBJ1-4
TGTGCCAGCAGCTTACGTGCGGTGTTTTACACAGATACGCAGTATTTT	CASSLRAVFYTDTQYF	TRBV11-3	TRBJ2-3
TGTGCCAGCAGCGGCGTCCGCGTTGGACAGCTACATTCCTACGAGCAGTACTTC	CASSGVRVGQLHSYEQYF	TRBV7-2	TRBJ2-7
TGCAGTCTTACTCAGTACTTC	CSLTQYF	TRBV20-1	TRBJ2-5
TGTGCCAGCACCGGGACAGGGTATAGCAATCAGCCCCAGCATTTT	CASTGTGYSNQPQHF	TRBV6-6	TRBJ1-5
TGTGCCTGGAGTTTTCCCCCCAGCACCTACGAGCAGTACTTC	CAWSFPPSTYEQYF	TRBV30	TRBJ2-7
TGTGCCAGCAGCTATACCGGGACAGTGAATGGCTATGGCTACACCTTC	CASSYTGTVNGYGYTF	TRBV7-2	TRBJ1-2
TGCAGTGGGGACAGAAGGAAAAACATTCAGTACTTC	CSGDRRKNIQYF	TRBV20-1	TRBJ2-4
TGTGCCAGCAGCCCTACTAGCGGGAGCTCCGACACTGAAGCTTTCTTT	CASSPTSGSSDTEAFF	TRBV7-6	TRBJ1-1
TGTGCCAGCAGCGTCGGGGATGAGCAGTTCTTC	CASSVGDEQFF	TRBV3-1	TRBJ2-1
TGCGCCAGCAGCCATGTGAAGCGGACGGAAAAAGGCAATGGCTACACCTTC	CASSHVKRTEKGNGYTF	TRBV4-1	TRBJ1-2
TGTGCCAGCAGTTTAACCGGGCCGTTCTACGAGCAGTACTTC	CASSLTGPFYEQYF	TRBV27	TRBJ2-7
TGTGCCAGCAGCTCCGGGAGGGGTAGCAATCAGCCCCAGCATTTT	CASSSGRGSNQPQHF	TRBV11-3	TRBJ1-5
TGTGCTAGTGGTGAAAGGGGGGACTTCAATCAGCCCCAGCATTTT	CASGERGDFNQPQHF	TRBV12-5	TRBJ1-5
TGTGCCAGCAGCCAAGGCTTACATACTAGGACAGTTAGGCCCGGGGAGCTGTTTTTT	CASSQGLHTRTVRPGELFF	TRBV14	TRBJ2-2
TGTGCCAGCACTCAGGGATCCTACGAGCAGTACTTC	CASTQGSYEQYF	TRBV27	TRBJ2-7
TGTGCCAGCACGGAGGGGTCCAATCAGCCCCAGCATTTT	CASTEGSNQPQHF	TRBV6-6	TRBJ1-5
TGCGCCAGCAGCGCGTCATCACTAAACATTCAGTACTTC	CASSASSLNIQYF	TRBV5-1	TRBJ2-4
TGTGCCAGCAGTTTAGGTTACCATTTTCAAAATGGCTACACCTTC	CASSLGYHFQNGYTF	TRBV12-4	TRBJ1-2
TGTGCCAGCAGCTTTTCGTTTGCTTTCTTT	CASSFSFAFF	TRBV5-4	TRBJ1-1
TGTGCCAGCAGTCCTCCGGGCATTGAGATCAACACCATATATTTT	CASSPPGIEINTIYF	TRBV6-1	TRBJ1-3
TGCAGTGCTGGCGCCGGGACGAACACCGGGGAGCTGTTTTTT	CSAGAGTNTGELFF	TRBV20-1	TRBJ2-2
TGCAGTGCTAGACGGGAACCCGGACCAAGGAAACCCGAGCAGTACTTC	CSARREPGPRKPEQYF	TRBV20-1	TRBJ2-7
TGTGCCAGCAGCCAAGTCCCAGGGTATGGCTACACCTTC	CASSQVPGYGYTF	TRBV4-2	TRBJ1-2
TGTGCCAGCACTCCCCAACGGACTAGGAGATCCGGTGGCTACACCTTC	CASTPQRTRRSGGYTF	TRBV6-1	TRBJ1-2
TGTGCCAGCAGCTTAGCCACACTCCAAGCGGGTCCGGTCGAGCAGTACTTC	CASSLATLQAGPVEQYF	TRBV7-3	TRBJ2-7
TGTGCCAGCAGCTTAGCAGCTCCCCGGGACAGGGGTAATGGCTACACCTTC	CASSLAAPRDRGNGYTF	TRBV7-4	TRBJ1-2
TGCAGTGCGCCCAGGGACGGGGCCAACGTCCTGACTTTC	CSAPRDGANVLTF	TRBV20-1	TRBJ2-6
TGTGCCAGCAGCCAAGTGCAACGAGGTCTCCGCAATCAGCCCCAGCATTTT	CASSQVQRGLRNQPQHF	TRBV7-3	TRBJ1-5
TGCGCCAGCAGCCCCCAGGGGCTACTGGTTGGCTACACCTTC	CASSPQGLLVGYTF	TRBV5-1	TRBJ1-2
TGTGCCAGTAGTATCGAGAGGGACACTGAAGCTTTCTTT	CASSIERDTEAFF	TRBV19	TRBJ1-1
TGTGCCAGCAGCCAATCGGTTGGCCGATTCATGAACACTGAAGCTTTCTTT	CASSQSVGRFMNTEAFF	TRBV4-2	TRBJ1-1
TGTGCCAGCAGCCTGGCTGGCCTTGGGACAGGGAATGAAAAACTGTTTTTT	CASSLAGLGTGNEKLFF	TRBV11-3	TRBJ1-4
TGTGCCAGTAGTATAGCCAGGCTAGGACAGGGAGCTTTCTTT	CASSIARLGQGAFF	TRBV19	TRBJ1-1
TGCGCCAGCAGCTTGCGCCCAGAATTGCATTCCTACGAGCAGTACTTC	CASSLRPELHSYEQYF	TRBV5-1	TRBJ2-7
TGTGCCAGCAGCCAAGAAACGCGCGGGACAGGGGAGTATGGCTACACCTTC	CASSQETRGTGEYGYTF	TRBV14	TRBJ1-2
TGTGCCAGCAGAGTACCGGGACGGGGGTCCTACGAGCAGTACTTC	CASRVPGRGSYEQYF	TRBV11-3	TRBJ2-7
TGTGCCAGCAGCCGGGGGGAGAGCTCCTACAATGAGCAGTTCTTC	CASSRGESSYNEQFF	TRBV14	TRBJ2-1
TGTGCCAGCAGCATTCCGGGGAGCCCGCAGTTCTTC	CASSIPGSPQFF	TRBV7-2	TRBJ2-1
TGTGCCAGCAGCGCTGGACAGCTTTACGAGCAGTACTTC	CASSAGQLYEQYF	TRBV7-2	TRBJ2-7
TGTGCCAGCAGAGAGGGAGGGCATCAAGAGACCCAGTACTTC	CASREGGHQETQYF	TRBV6-5	TRBJ2-5
TGTGCCAGCAGTTACATTAAGCACTCACAGGTTTGCCACAGCACAGATACGCAGTATTTT	CASSYIKHSQVCHSTDTQYF	TRBV6-2	TRBJ2-3
TGTGCCAGCAGCTGTTTAGGCAACCTCGGGAGGGGGGTAAGCACAGATACGCAGTATTTT	CASSCLGNLGRGVSTDTQYF	TRBV5-4	TRBJ2-3
TGTGCCAGCAGTGAGTCTTGGGACAGGAATGGAAGCGAGCAGTACTTC	CASSESWDRNGSEQYF	TRBV6-1	TRBJ2-7
TGTGCCAGCAGCGCCGACAGACACACCGGGGAGCTGTTTTTT	CASSADRHTGELFF	TRBV7-9	TRBJ2-2
TGTGCCAGCAGCGTCATACTCCCTTTAAGCTCCTACAATGAGCAGTTCTTC	CASSVILPLSSYNEQFF	TRBV5-8	TRBJ2-1
TGCGCCAGCAGCTTTCGCGGACTAGCGGGGCAGTTCTTC	CASSFRGLAGQFF	TRBV5-1	TRBJ2-1
TGTGCCAGCAGTTGGGGCTGGACTAGCAATCAGCCCCAGCATTTT	CASSWGWTSNQPQHF	TRBV12-3	TRBJ1-5
TGTGCGCTCACCCCTCGGGACAGGGAGGCCTCTGGGGCCAACGTCCTGACTTTC	CALTPRDREASGANVLTF	TRBV12-5	TRBJ2-6
TGCAGTGCTGGGGGCCGGGGTTATGGCTACACCTTC	CSAGGRGYGYTF	TRBV20-1	TRBJ1-2
TGTGCCAGCAGTTTAAGTCTGGATTATTACAATGAGCAGTTCTTC	CASSLSLDYYNEQFF	TRBV28	TRBJ2-1
TGCGCCAGCAGTAGGACAGGTATAATCACTGAAGCTTTCTTT	CASSRTGIITEAFF	TRBV10-1	TRBJ1-1
TGCAGCGTTGAACCGTACAACGGAGGTCAGCCCCAGCATTTT	CSVEPYNGGQPQHF	TRBV29-1	TRBJ1-5
TGTGCCAGCAGAAGAACAGGCAACAATCAGCCCCAGCATTTT	CASRRTGNNQPQHF	TRBV6-4	TRBJ1-5
TGCGCCAGCAGTCCGGGACCTTCACCCCTCCACTTT	CASSPGPSPLHF	TRBV5-1	TRBJ1-6
TGTGCCAGCACCAGGGGGGGGCTGAAAGAGACCCAGTACTTC	CASTRGGLKETQYF	TRBV27	TRBJ2-5
TGTGCCAGCAGCCGACAGGAGAATATCGGCTATAATTCACCCCTCCACTTT	CASSRQENIGYNSPLHF	TRBV27	TRBJ1-6
TGTGCCAGCTCAGGAAGGGGTAACACCATATATTTT	CASSGRGNTIYF	TRBV18	TRBJ1-3
TGTGCCAGCAGTGAATGGTCCCCGGGACTGTGGTTAGATACGCAGTATTTT	CASSEWSPGLWLDTQYF	TRBV25-1	TRBJ2-3
TGTGCCAGCAGTTGTCTGGGACAGGGTTGGGATTACACCGGGGAGCTGTTTTTT	CASSCLGQGWDYTGELFF	TRBV28	TRBJ2-2
TGTGCCAGCAGCTTAGTCGGGGATTGGTTTCCATTAGGACTAGCAGGGGACAATGAGCAGTTCTTC	CASSLVGDWFPLGLAGDNEQFF	TRBV7-2	TRBJ2-1
TGTGCCAGCAGTTACGGAGTAGGCGGTAAGACCCAGTACTTC	CASSYGVGGKTQYF	TRBV6-6	TRBJ2-5
TGTGCCAGCAGCCTCAGGGACGATAACACTGAAGCTTTCTTT	CASSLRDDNTEAFF	TRBV7-3	TRBJ1-1
TGTGCCAGCAGCTTACCGCCCAGGAGGGGCGGGGAGCTGTTTTTT	CASSLPPRRGGELFF	TRBV7-9	TRBJ2-2
TGTGCCAGCAGTAAGGACAGGGATCTCACAGATACGCAGTATTTT	CASSKDRDLTDTQYF	TRBV6-1	TRBJ2-3
TGTGCCTGGAGTGGGGGAATGGGGCTTAACTATGGCTACACCTTC	CAWSGGMGLNYGYTF	TRBV30	TRBJ1-2
TGTGCCAGTAGTATGACGGGACAGGGGACGGTGTCCACAGATACGCAGTATTTT	CASSMTGQGTVSTDTQYF	TRBV19	TRBJ2-3
TGTGCCAGCAGTGAGACTAGCGGGGGGGCACCCTACAATGAGCAGTTCTTC	CASSETSGGAPYNEQFF	TRBV6-1	TRBJ2-1
TGCGCCAGACGGCTTGGCTACACCTTC	CARRLGYTF	TRBV10-1	TRBJ1-2
TGTGCCAGTCTAGCCAGGGGCTTTATGCCCCTCCGCACAGATACGCAGTATTTT	CASLARGFMPLRTDTQYF	TRBV9	TRBJ2-3
TGCGCCAGCAGCTTGGGGGGGGGGGATACGCAGTATTTT	CASSLGGGDTQYF	TRBV5-1	TRBJ2-3
TGTGCCAACGGACAGGCGAGGGGAAGCTCCTACGAGCAGTACTTC	CANGQARGSSYEQYF	TRBV7-9	TRBJ2-7
TGTGCCAGCAGCACTGAGGGAATCTACGAGCAGTACTTC	CASSTEGIYEQYF	TRBV13	TRBJ2-7
TGTGCCAGCAGCCAAGGAGGCAGACACGAGCAGTACTTC	CASSQGGRHEQYF	TRBV3-1	TRBJ2-7
TGTGCCAGCTCCCACATAGAGGACCGTTGTAATCAGCCCCAGCATTTT	CASSHIEDRCNQPQHF	TRBV27	TRBJ1-5
TGTGCCATTTTCCATTCTGGGACCAACACTGAAGCTTTCTTT	CAIFHSGTNTEAFF	TRBV3-1	TRBJ1-1
TGTGCCAGCAGGAACCCCGGGACAGGGCCCTCGAACACTGAAGCTTTCTTT	CASRNPGTGPSNTEAFF	TRBV7-9	TRBJ1-1
TGTGCTAGCCCGCGACCCGTCGGTTGCTCCTACGAGCAGTACTTC	CASPRPVGCSYEQYF	TRBV7-7	TRBJ2-7
TGTGCCAGCAGGGCCGGGACTTCCGCTAATGAAAAACTGTTTTTT	CASRAGTSANEKLFF	TRBV6-2	TRBJ1-4
TGTGCCAGCAGCTTTCTTCGGACAGGGAGTTTGAACACTGAAGCTTTCTTT	CASSFLRTGSLNTEAFF	TRBV7-4	TRBJ1-1
TGTGCCAGCAGCTTCGAACCGGGACAGGAAACTAATCAGCCCCAGCATTTT	CASSFEPGQETNQPQHF	TRBV7-7	TRBJ1-5
TGTGCCAGCAGCCACAGTACGGGGGACCGCTACGAGCAGTACTTC	CASSHSTGDRYEQYF	TRBV7-7	TRBJ2-7
TGCGCCAGCAGCTTGGAGTGGGGCTCGTCTACGCAGTATTTT	CASSLEWGSSTQYF	TRBV5-1	TRBJ2-3
TGTGCCAGCAGCCTCGCAGGGGGCAGGATTTGGTCCTACGAGCAGTACTTC	CASSLAGGRIWSYEQYF	TRBV7-9	TRBJ2-7
TGTGCCAGCAGCCAAAACGACGCATCCTACGAGCAGTACTTC	CASSQNDASYEQYF	TRBV7-2	TRBJ2-7
TGTGCCAGCAGTGACCCTTCGCATCCCGGCTACACCTTC	CASSDPSHPGYTF	TRBV28	TRBJ1-2
TGTGCCAGCAGCACGCTAGACGGAAGTAATGGCTACACCTTC	CASSTLDGSNGYTF	TRBV9	TRBJ1-2
TGTAGGAGCGAAGCTTTCTTT	CRSEAFF	TRBV19	TRBJ1-1
TGTGCCAGCAGCGTGTCATTAACTGGGGGCAATCACTTC	CASSVSLTGGNHF	TRBV7-4	TRBJ2-7
TGTGCCAGCAGCCCACTCCGGGACAGGGGGTCGTGTCGACGGGATGAAGCTTTCTTT	CASSPLRDRGSCRRDEAFF	TRBV6-5	TRBJ1-1
TGCAGTGCAGGGGGGGGACCGAGGTCCTACGAGCAGTACTTC	CSAGGGPRSYEQYF	TRBV20-1	TRBJ2-7
TGCGCCAGCAGCTACTGGGACCCTGGACTATGCTACGAGCAGTACTTC	CASSYWDPGLCYEQYF	TRBV5-1	TRBJ2-7
TGTGCCTGGGGCCCCCCGACAGGGCTCCTAAGCTATAATTCACCCCTCCACTTT	CAWGPPTGLLSYNSPLHF	TRBV30	TRBJ1-6
TGTGCCAGCAGTTACCGCCCGGCAACTAATGAAAAACTGTTTTTT	CASSYRPATNEKLFF	TRBV6-5	TRBJ1-4
TGTGCCAGCAGTGTGGGTGGCGGGAGGGGGGGCTATGGCTACACCTTC	CASSVGGGRGGYGYTF	TRBV14	TRBJ1-2
TGTGCCAGCAGCTGGTCGCTAGTGCCCTCAGTGGAGACCCAGTACTTC	CASSWSLVPSVETQYF	TRBV7-9	TRBJ2-5
TGCGCCAGCAGCCAAGGGTTTAGGGCAAACTACGAGCAGTACTTC	CASSQGFRANYEQYF	TRBV4-1	TRBJ2-7
TGCGCCAGCGGAGACAGCCATTCACCCCTCCACTTT	CASGDSHSPLHF	TRBV5-1	TRBJ1-6
TGTGCCAGCAGTTATCCCCAGGCCTACTTAAATTGGAACACTGAAGCTTTCTTT	CASSYPQAYLNWNTEAFF	TRBV6-2	TRBJ1-1
TGCGCCAGCATCATCGGGACAGGGTACGAGCAGTACTTC	CASIIGTGYEQYF	TRBV10-2	TRBJ2-7
TGTGCCAGCCGGTCCCGGGACAGAGTCATTCAGTACTTC	CASRSRDRVIQYF	TRBV14	TRBJ2-4
TGTGCCAGCAGTGAGCGAACGACAGGAAGGGTGGATGAAAAACTGTTTTTT	CASSERTTGRVDEKLFF	TRBV6-4	TRBJ1-4
TGCAGTGCTAGAGTTCGGGACAGGGGGTGCAATCAGCCCCAGCATTTT	CSARVRDRGCNQPQHF	TRBV20-1	TRBJ1-5
TGTGCCAGCAGCGGACAGGGGGCCCTCTACGAGCAGTACTTC	CASSGQGALYEQYF	TRBV11-2	TRBJ2-7
TGTGCCAGCAGCTGTCTGGAGGAAGCGGAGGTTAGGGGGAACACTGAAGCTTTCTTT	CASSCLEEAEVRGNTEAFF	TRBV7-3	TRBJ1-1
TGTGCCAGCAGTTTAGAATGCATAGGGGGAGACACCGGGGAGCTGTTTTTT	CASSLECIGGDTGELFF	TRBV12-4	TRBJ2-2
TGTGCCAGCAGCCAGGGTGAGAGAGGGTATAGCAATCAGCCCCAGCATTTT	CASSQGERGYSNQPQHF	TRBV6-3	TRBJ1-5
TGTGCCAGCAGCAGGGGGACAGGGTTAGGCTACACCTTC	CASSRGTGLGYTF	TRBV13	TRBJ1-2
TGTGCCAGCAAAGGGGGGGGGTCCCAGCATTTT	CASKGGGSQHF	TRBV13	TRBJ1-5
TGCAGCGTTGAAGATCGTGTCCCGGGACAGGGGGAGAACACTGAAGCTTTCTTT	CSVEDRVPGQGENTEAFF	TRBV29-1	TRBJ1-1
TGTGCCAGCAGCGTAGACAAGCTGGGACTAGCGGACGATACGCAGTATTTT	CASSVDKLGLADDTQYF	TRBV9	TRBJ2-3
TGCGCCAGCAGCCAAGATAAGCAGGAAAAACACACCTTC	CASSQDKQEKHTF	TRBV4-1	TRBJ1-2
TGCGCCAGCAGTGAAACGGGGGGAAAGGCCTACGAGCAGTACTTC	CASSETGGKAYEQYF	TRBV10-1	TRBJ2-7
TGCAGTGCTAGAGATCGCGGGTCACAAGAGGTTAATCAGCCCCAGCATTTT	CSARDRGSQEVNQPQHF	TRBV20-1	TRBJ1-5
TGTGCCAGCAGCCACGAGGGACAGGGCTACGAGCAGTACTTC	CASSHEGQGYEQYF	TRBV7-6	TRBJ2-7
TGTGCCTGGAGAGACAGGGCACCCCTTGGGCTGTCACCCCTCCACTTT	CAWRDRAPLGLSPLHF	TRBV30	TRBJ1-6
TGCGCCAGCAGCTGTTTACAGGGAGAGCGATGTAGCAATCAGCCCCAGCATTTT	CASSCLQGERCSNQPQHF	TRBV5-1	TRBJ1-5
TGCGCCAGAGCGGGAAGCTCCTACGAGCAGTACTTC	CARAGSSYEQYF	TRBV10-1	TRBJ2-7
TGTGCCAGCAGCTTAGCTGCAAGCAAGGGGACTAGCGAGCTAACCGGGGAGCTGTTTTTT	CASSLAASKGTSELTGELFF	TRBV7-2	TRBJ2-2
TGTGCCAGCAGTGACCTGATTGGCACTGAAGCTTTCTTT	CASSDLIGTEAFF	TRBV12-4	TRBJ1-1
TGTGCCAGTAGTATTCAGTCGGACGAGCAGTACTTC	CASSIQSDEQYF	TRBV19	TRBJ2-7
TGTGCTAGTGGTTTGGTCGCCCCGGGGGCCGCGTCTGGGGCCAACGTCCTGACTTTC	CASGLVAPGAASGANVLTF	TRBV12-5	TRBJ2-6
TGTGCCAGCAGGGTCCTTGAAGAGACCCAGTACTTC	CASRVLEETQYF	TRBV12-3	TRBJ2-5
TGCGCCAGCAGCGCCCCGGGACCGGGGAATGAAAAACTGTTTTTT	CASSAPGPGNEKLFF	TRBV4-3	TRBJ1-4
TGTGCCAGCAGTTACCCCAGGGGGCTCCCGATGAACACTGAAGCTTTCTTT	CASSYPRGLPMNTEAFF	TRBV6-6	TRBJ1-1
TGTGCCACCTGGGGGCTCACAGATACGCAGTATTTT	CATWGLTDTQYF	TRBV24-1	TRBJ2-3
TGCGCCAGCAGCCGGAGCTACCGCACTGAAGCTTTCTTT	CASSRSYRTEAFF	TRBV5-1	TRBJ1-1
TGCAGTGCCCCCCTTTTGCCCCGCACAGATACGCAGTATTTT	CSAPLLPRTDTQYF	TRBV20-1	TRBJ2-3
TGTGCCAGCAGCCGAGCCTACGAGCAGTACTTC	CASSRAYEQYF	TRBV11-2	TRBJ2-7
TGTGCCAGCAGCTTGCCGACCGGGACAGGGATAAAAGGGAGGAGCGGTAGGGAAAAACTGTTTTTT	CASSLPTGTGIKGRSGREKLFF	TRBV5-4	TRBJ1-4
TGTGCCAGCAGCCCAGCTTCGAGGGAGGACCTTGAGCAGTACTTC	CASSPASREDLEQYF	TRBV5-4	TRBJ2-7
TGCAGCGATTGGGGGCGAGGGTACAATCAGCCCCAGCATTTT	CSDWGRGYNQPQHF	TRBV29-1	TRBJ1-5
TGTGCCAGCAGTCTGGGGGACCCCACTGAAGCTTTCTTT	CASSLGDPTEAFF	TRBV6-1	TRBJ1-1
TGTGCCAGCAGTGAAAAGGGGGCTTCGGACAACCCCCTCCACTTT	CASSEKGASDNPLHF	TRBV25-1	TRBJ1-6
TGTGCCCCTCTTGACAGCTCTGGAAACACCATATATTTT	CAPLDSSGNTIYF	TRBV10-3	TRBJ1-3
TGTGCCAGCAGCTTAGTAAGGGGGCCTGGCTACACCTTC	CASSLVRGPGYTF	TRBV7-6	TRBJ1-2
TGTGCCAGCAGTAGGGGCGGGTTTTCACCCCTCCACTTT	CASSRGGFSPLHF	TRBV7-3	TRBJ1-6
TGTGCCAGCAGTGACTCGATTCTAATACAGGGGGGAGAGCAGTACTTC	CASSDSILIQGGEQYF	TRBV6-4	TRBJ2-7
TGCGCCAGCAGCAAAGGGGGGACAGGGGAGGAATTGGTACAGCGCAATCAGCCCCAGCATTTT	CASSKGGTGEELVQRNQPQHF	TRBV10-1	TRBJ1-5
TGTGCCAGCAGCTTAGGGGGGTACGAGCAGTACTTC	CASSLGGYEQYF	TRBV7-7	TRBJ2-7
TGTGCCAGCAGTGACTCAGACCGACTCCCCTACGAGCAGTACTTC	CASSDSDRLPYEQYF	TRBV2	TRBJ2-7
TGTGCCAGCAGCAACCCCCCGGGTGAAAAACTGTTTTTT	CASSNPPGEKLFF	TRBV9	TRBJ1-4
TGTGCCACCTCGTCCGGGACAGGGCGAATGAACACTGAAGCTTTCTTT	CATSSGTGRMNTEAFF	TRBV24-1	TRBJ1-1
TGTGCCAGCAGCACAAGGATGGACAGCCGGACGGCCTACGAGCAGTACTTC	CASSTRMDSRTAYEQYF	TRBV11-3	TRBJ2-7
TGTGCCAGCAGGACCGAGGAGAGCTCTGGAAACACCATATATTTT	CASRTEESSGNTIYF	TRBV7-3	TRBJ1-3
TGTGCCAGCAGTGACTGTAAGATGGGGATGTACGAGCAGTACTTC	CASSDCKMGMYEQYF	TRBV6-4	TRBJ2-7
TGTGCCAGCAGCCAAGGCCCCCGGGACAGGGCCACATGTCTTTGGGATCAGCCCCAGCATTTT	CASSQGPRDRATCLWDQPQHF	TRBV14	TRBJ1-5
TGTGCCAGCAGCCTAGGGCTGGGGAACACCGGGGAGCTGTTTTTT	CASSLGLGNTGELFF	TRBV13	TRBJ2-2
TGTGCCAGCAGTGAAGCAAATGCAGCCCGCTCTGGGGCCAACGTCCTGACTTTC	CASSEANAARSGANVLTF	TRBV6-1	TRBJ2-6
TGTGCCAGCAGCCAAGATTCGCAGGGAGAGAATCAGCCCCAGCATTTT	CASSQDSQGENQPQHF	TRBV14	TRBJ1-5
TGCGCCAGCAGCCAGTTGGGCGTTAATAGAGAGACCCAGTACTTC	CASSQLGVNRETQYF	TRBV4-1	TRBJ2-5
TGTGCCAGCAGTAAACCAGAGGCTTGGCAGTTCTTC	CASSKPEAWQFF	TRBV6-5	TRBJ2-1
TGTGCCAGCAGTGGGGCAACAGTTTATAGCAATCAGCCCCAGCATTTT	CASSGATVYSNQPQHF	TRBV12-4	TRBJ1-5
TGCGCCAGCAGCTCTAGCGGGAGCACAGATACGCAGTATTTT	CASSSSGSTDTQYF	TRBV10-1	TRBJ2-3
TGTGCCAGCAGTTACCCCCCAGGGGGCGTGGAAGTTAGGATTGCTAATGAAAAACTGTTTTTT	CASSYPPGGVEVRIANEKLFF	TRBV6-5	TRBJ1-4
TGTGCCAGGGACAGTGAAAAACTGTTTTTT	CARDSEKLFF	TRBV19	TRBJ1-4
TGTGCCAGCAGTTTATGGGACAGGCTCCCGGAGACCCAGTACTTC	CASSLWDRLPETQYF	TRBV27	TRBJ2-5
TGTGCCAGCAGCCTCGGGGACATCTCTGGAAACACCATATATTTT	CASSLGDISGNTIYF	TRBV7-4	TRBJ1-3
TGCGCCAGAGTAGGAGGCCTCATCGGTGCCAAAAACATTCAGTACTTC	CARVGGLIGAKNIQYF	TRBV5-1	TRBJ2-4
TGTGCCAGCAGCATGGACCGGGACAAGATCGAGCAGTACTTC	CASSMDRDKIEQYF	TRBV11-3	TRBJ2-7
TGTGCCAGCAGCTTGCCGGCGGCCGGGACGGGCACTGAAGCTTTCTTT	CASSLPAAGTGTEAFF	TRBV5-4	TRBJ1-1
TGCAGCGTTGAGCAGATACGGGGGCGTAAACGCAGGTCACCCCTCCACTTT	CSVEQIRGRKRRSPLHF	TRBV29-1	TRBJ1-6
TGTGCCAGCAGCTTGGAAAGGGGGACCGAGCAGTACTTC	CASSLERGTEQYF	TRBV5-4	TRBJ2-7
TGCGCCAGCAGCAAGGGGACCTGGAACACCGGGGAGCTGTTTTTT	CASSKGTWNTGELFF	TRBV5-1	TRBJ2-2
TGCGCCAGAAACAGATGCTCCTACGAGCAGTACTTC	CARNRCSYEQYF	TRBV5-1	TRBJ2-7
TGTGCCAGCAGTCAAACCGGGGACAGGGGGGTTGCGAGAACCTCCTACGAGCAGTACTTC	CASSQTGDRGVARTSYEQYF	TRBV6-4	TRBJ2-7
TGTGCCAGCAGTTGGCCGGGTCCCTACTCCAGTGGGAACACTGAAGCTTTCTTT	CASSWPGPYSSGNTEAFF	TRBV12-3	TRBJ1-1
TGCGCCAGCAGCCAAGCCGCGGGGGCTTATGAAGCTTTCTTT	CASSQAAGAYEAFF	TRBV4-3	TRBJ1-1
TGTGCCAGCAGCCTGGGGGGCAGCCCACTATCTGAGCAGTTCTTC	CASSLGGSPLSEQFF	TRBV9	TRBJ2-1
TGTGCCTCCCAACATCGACTCACGTACCCGGGGCAAGGAAACACCATATATTTT	CASQHRLTYPGQGNTIYF	TRBV25-1	TRBJ1-3
TGTGCTAGTGGTTGTAACGGGGGGGGAAGGCGGGGCTCCTACGAGCAGTACTTC	CASGCNGGGRRGSYEQYF	TRBV12-5	TRBJ2-7
TGCGCCAGCAGAGAAAGGGGGGGATCGGGGCGGCCCGGGGAGCTGTTTTTT	CASRERGGSGRPGELFF	TRBV5-1	TRBJ2-2
TGTTCCTACAGGGGGCGCGCCGCTTTCTTT	CSYRGRAAFF	TRBV6-1	TRBJ1-1
TGTGCCACCAGTGCCAGGAGGGTGTATAGCAATCAGCCCCAGCATTTT	CATSARRVYSNQPQHF	TRBV24-1	TRBJ1-5
TGTGCCAGCTTCCGAGTTAGGGGCTACACCTTC	CASFRVRGYTF	TRBV27	TRBJ1-2
TGCAGTGCCTACCCTAAGGGGCCCGGTGAAAAACTGTTTTTT	CSAYPKGPGEKLFF	TRBV20-1	TRBJ1-4
TGTGCCAGCAGTGACTTCCGAAAAGTATCCCGGGGGTCGAACACCGGGGAGCTGTTTTTT	CASSDFRKVSRGSNTGELFF	TRBV6-4	TRBJ2-2
TGTGCCAGCTCACCACACGCCCGGGATCAGCCCCAGCATTTT	CASSPHARDQPQHF	TRBV18	TRBJ1-5
TGCGCCAGCAGCGGCTACTGGGACAGGGAGGAGACCCAGTACTTC	CASSGYWDREETQYF	TRBV5-1	TRBJ2-5
TGTGCCAGCAGTGTAATGCACAAGGGCACAGATACGCAGTATTTT	CASSVMHKGTDTQYF	TRBV25-1	TRBJ2-3
TGTGCCAGCAGTTTTGGACAGGGGGCTTGGAGCAATGAGCAGTTCTTC	CASSFGQGAWSNEQFF	TRBV12-3	TRBJ2-1
TGCGCCAGCCCCCCGGGACAGGGGGGTAGGAACATTCAGTACTTC	CASPPGQGGRNIQYF	TRBV10-1	TRBJ2-4
TGTGCCAGCAGTTTGACCTGGGGAGAGCAGTACTTC	CASSLTWGEQYF	TRBV27	TRBJ2-7
TGTGCCACCCCAAACTCCGGGACAGGGGACGGCAATCAGCCCCAGCATTTT	CATPNSGTGDGNQPQHF	TRBV28	TRBJ1-5
TGCGCCAGCAGCCAAGATCCTTTCCTATTAGTTCCAGGAGGAATGGGAGTGACAGATACGCAGTATTTT	CASSQDPFLLVPGGMGVTDTQYF	TRBV4-1	TRBJ2-3
TGTGCCACGGTCGGGTCCCCAACCTACGAGCAGTACTTC	CATVGSPTYEQYF	TRBV10-3	TRBJ2-7
TGTGCCAGTAGTATGTCGCACTATGGCTACACCTTC	CASSMSHYGYTF	TRBV19	TRBJ1-2
TGTGCCAGCAGCTACAGGGATGCTGCGAGATCACCCCTCCACTTT	CASSYRDAARSPLHF	TRBV25-1	TRBJ1-6
TGTGCCAGCAGCTTCTCGAACAGAGGTTGTGGCTACACCTTC	CASSFSNRGCGYTF	TRBV11-2	TRBJ1-2
TGTGCCAGCAGCGATTCAGGGAAAAGGGGAGCTTTCTTT	CASSDSGKRGAFF	TRBV13	TRBJ1-1
TGCGCCAGCAGCTTGGAAGTCATGGACAGGGGCGGCAAAAACATTCAGTACTTC	CASSLEVMDRGGKNIQYF	TRBV5-1	TRBJ2-4
TGTGCCAGCAGCTTACTGGAGGCGGACAGTAATGAGCAGTTCTTC	CASSLLEADSNEQFF	TRBV7-3	TRBJ2-1
TGTGCCAGCAGCACTAATTTCCTAGGCGGACAGGACGTCTTCTTC	CASSTNFLGGQDVFF	TRBV13	TRBJ2-1
TGTGCCACCAGTGAGGATACCCTTGGGGATTGCCAAGAGACCCAGTACTTC	CATSEDTLGDCQETQYF	TRBV24-1	TRBJ2-5
TGTGCCAGCAGGTACAGGGGGCGTGCTGAAGCTTTCTTT	CASRYRGRAEAFF	TRBV7-9	TRBJ1-1
TGTGCCAGCAGTTTCAGCGTCCGGGAAAATTCACCCCTCCACTTT	CASSFSVRENSPLHF	TRBV27	TRBJ1-6
TGTGCCAGCAGCTCAAACAGGGCCTTCTACGAGCAGTACTTC	CASSSNRAFYEQYF	TRBV11-3	TRBJ2-7
TGTGCCAGCAGCTTAGCGCAGGGAAATTCACCCCTCCACTTT	CASSLAQGNSPLHF	TRBV7-8	TRBJ1-6
TGCAGTGCTAGGCAGGGGTATTTT	CSARQGYF	TRBV20-1	TRBJ1-3
TGTGCCAGCAGCGAGCGGGAACACTACGAGCAGTACTTC	CASSEREHYEQYF	TRBV6-4	TRBJ2-7
TGTGCCAGCACCAAGGGGACAGGGCCGAGGGACACTGAAGCTTTCTTT	CASTKGTGPRDTEAFF	TRBV27	TRBJ1-1
TGTGCCAGCTCACCAGCTATAACCCGGGGGCGTTCGAAACAGAGCTCTGGGGCCAACGTCCTGACTTTC	CASSPAITRGRSKQSSGANVLTF	TRBV18	TRBJ2-6
TGTGCCAGCAGCTCGGGAGGGGGCCCGAATCAGCCCCAGCATTTT	CASSSGGGPNQPQHF	TRBV7-3	TRBJ1-5
TGCGCCAGCAGCCCCGGGGGGCACGGAGCCAAAAACATTCAGTACTTC	CASSPGGHGAKNIQYF	TRBV4-1	TRBJ2-4
TGTGCCAGCATATTAGAGGGGCAGACGAACACTGAAGCTTTCTTT	CASILEGQTNTEAFF	TRBV11-2	TRBJ1-1
TGTGCCAGCAGTTTAGAGAATTTGATGGCGGGGAGGGGAATGAACACTGAAGCTTTCTTT	CASSLENLMAGRGMNTEAFF	TRBV27	TRBJ1-1
TGTGCCCCTACCCAGGACGCTCAGCCCCAGCATTTT	CAPTQDAQPQHF	TRBV19	TRBJ1-5
TGTGCCAGCAGGGTCAAGGCGCCCTCTGGAAACACCATATATTTT	CASRVKAPSGNTIYF	TRBV6-1	TRBJ1-3
TGTGCCAGCAGTGGAAGCCCACCGTGTTGTTTAAAATCCTACGAGCAGTACTTC	CASSGSPPCCLKSYEQYF	TRBV27	TRBJ2-7
TGTGCCAGCAGCTGGGGAGCTGCACACACCGGGGAGCTGTTTTTT	CASSWGAAHTGELFF	TRBV7-9	TRBJ2-2
TGTGCCAGCAGCTTGTCCCCGGCCCCCCGAGTTCCAGAAGAGACCCAGTACTTC	CASSLSPAPRVPEETQYF	TRBV5-6	TRBJ2-5
TGCGCCAGCAGTGAGTCGACCAGCGGTAGCACAGATACGCAGTATTTT	CASSESTSGSTDTQYF	TRBV10-2	TRBJ2-3
TGTGCCAGCTCACCAGCTAGGGGGCCACAAGAGACCCAGTACTTC	CASSPARGPQETQYF	TRBV18	TRBJ2-5
TGTGCCAGCAGCTTACAGAGCGACGGCCGCTCCTACGAGCAGTACTTC	CASSLQSDGRSYEQYF	TRBV7-3	TRBJ2-7
TGCAGTGCTAGAGACCTCACAGGGGAGATACGATCCTACGAGCAGTACTTC	CSARDLTGEIRSYEQYF	TRBV20-1	TRBJ2-7
TGTGCCAGCAGCAAAGGGGACTGCAGCAATCAGCCCCAGCATTTT	CASSKGDCSNQPQHF	TRBV2	TRBJ1-5
TGTGCCAGCTCACCACTGAGCTCTCAGGGCCCCCATAGCAATCAGCCCCAGCATTTT	CASSPLSSQGPHSNQPQHF	TRBV18	TRBJ1-5
TGCGCCAGCAGCCTCCTACGATTAGACGAGCAGTACTTC	CASSLLRLDEQYF	TRBV4-1	TRBJ2-7
TGTGCCAGCAGTTTAGCCATGTTCGTGGGATCAGATACGCAGTATTTT	CASSLAMFVGSDTQYF	TRBV12-4	TRBJ2-3
TGTGCCAGCAGCAGGGGGTACTGCGGAGGGTGCTACGAGCAGTACTTC	CASSRGYCGGCYEQYF	TRBV5-6	TRBJ2-7
TGCGCCAGCAGTGCGAAGGGCCCCATACTGTGCTACGAGCAGTACTTC	CASSAKGPILCYEQYF	TRBV10-1	TRBJ2-7
TGTGCCAGCAGTGAGTCTGAAGCTTTCTTT	CASSESEAFF	TRBV6-1	TRBJ1-1
TGCGCCAGCAGCGGGCTTAACGGTGAGGAAAAACTGTTTTTT	CASSGLNGEEKLFF	TRBV5-1	TRBJ1-4
TGTGCCAGCAGCCAGCGGCCGGATGGAAACACCATATATTTT	CASSQRPDGNTIYF	TRBV14	TRBJ1-3
TGTGCCAGCAAATATCGATTAAATCTGGGACGGGACACTGAAGCTTTCTTT	CASKYRLNLGRDTEAFF	TRBV6-4	TRBJ1-1
TGCGCCAGCAGCGTGGACCATAGCAATCAGCCCCAGCATTTT	CASSVDHSNQPQHF	TRBV5-1	TRBJ1-5
TGTGCCAGCAGCGACAGGGCCGGGGAGCCCCAGCATTTT	CASSDRAGEPQHF	TRBV13	TRBJ1-5
TGCGCCAGCAGCTTCATCCCATCTAGGGATGAGGATTGCAACACCGGGGAGCTGTTTTTT	CASSFIPSRDEDCNTGELFF	TRBV5-1	TRBJ2-2
TGTGCCAGCAGCAACAGCGGGACAGCAGATACGCAGTATTTT	CASSNSGTADTQYF	TRBV7-3	TRBJ2-3
TGTGCCAGCAGTCGGGGCCTCATACAGCCCCAGCATTTT	CASSRGLIQPQHF	TRBV6-4	TRBJ1-5
TGTGCCAGCAGTGAATCTTTAAGCAATAAGGGACAGGGAGGAGATACCGATAGCAATCAGCCCCAGCATTTT	CASSESLSNKGQGGDTDSNQPQHF	TRBV25-1	TRBJ1-5
TGTGCCACCTGGCGTGTCGAGCAGTACTTC	CATWRVEQYF	TRBV24-1	TRBJ2-7
TGTGCCAGCATGGGTGGGACAGGGAACACCGGGGAGCTGTTTTTT	CASMGGTGNTGELFF	TRBV7-9	TRBJ2-2
TGTGCCAGCAGTTACTCACGGACAGGAGGGGAGACCCAGTACTTC	CASSYSRTGGETQYF	TRBV6-6	TRBJ2-5
TGTGCCAGCAGCAGACCAGATACGCAGTATTTT	CASSRPDTQYF	TRBV7-6	TRBJ2-3
TGTGCCAGCAGCGGACAGGGGTACTTC	CASSGQGYF	TRBV7-9	TRBJ2-7
TGTGCCAGCGAGAAAGGTAAACCCTACGAGCAGTACTTC	CASEKGKPYEQYF	TRBV19	TRBJ2-7
TGCAGCGTTGAAGATACGCGGATCGCGGGACCGGGCACAGATACGCAGTATTTT	CSVEDTRIAGPGTDTQYF	TRBV29-1	TRBJ2-3
TGTGCCAGCAGTGACGCAGGGGGGCCCTCACTTGGTGCCAAAAACATTCAGTACTTC	CASSDAGGPSLGAKNIQYF	TRBV6-4	TRBJ2-4
TGTGCCAGCAGTTTATACTCCTACGAGCAGTACTTC	CASSLYSYEQYF	TRBV6-1	TRBJ2-7
TGTGCCACCAGTGATTCCCTGACCGGGACAGGGGGCGCGGTTAACGAGCAGTACTTC	CATSDSLTGTGGAVNEQYF	TRBV24-1	TRBJ2-7
TGCAGCCAGGGGGTGAAATCTAATGAAAAACTGTTTTTT	CSQGVKSNEKLFF	TRBV29-1	TRBJ1-4
TGTGCCAGCATGGCTATGGGACAAAAATCACCCCTCCACTTT	CASMAMGQKSPLHF	TRBV6-6	TRBJ1-6
TGTGCCAGCAGCGTACGGGACTCGAACACTGAAGCTTTCTTT	CASSVRDSNTEAFF	TRBV7-3	TRBJ1-1
TGTGCCATCAGCCAAGGACAGGGGACAACTAATGAAAAACTGTTTTTT	CAISQGQGTTNEKLFF	TRBV10-3	TRBJ1-4
TGCGCCAGCAGAACTTCCCCGTGGGGGCAACAAAAACTGTTTTTT	CASRTSPWGQQKLFF	TRBV10-1	TRBJ1-4
TGTGCCAGCAGTTACTCCCAAAAGGGGGGAGCTAACACTGAAGCTTTCTTT	CASSYSQKGGANTEAFF	TRBV6-5	TRBJ1-1
TGCAACTTATCCGGGACAGGCATGTCGAGCCATAGCAATCAGCCCCAGCATTTT	CNLSGTGMSSHSNQPQHF	TRBV20-1	TRBJ1-5
TGTGCCAGCAGAAGCCAGCCCCAGCATTTT	CASRSQPQHF	TRBV2	TRBJ1-5
TGTGCCAGCATCTGGGACAATGAGCAGTTCTTC	CASIWDNEQFF	TRBV12-4	TRBJ2-1
TGTGCCACCAGTGAGTCGGGGGAGCGACAGGGTGGCTTGGATCAGCCCCAGCATTTT	CATSESGERQGGLDQPQHF	TRBV24-1	TRBJ1-5
TGTGCCAGCAGCTTAGGGGGCCCCTTACTAGCGGGAGCTGAAGCTTTCTTT	CASSLGGPLLAGAEAFF	TRBV7-6	TRBJ1-1
TGTGCCAGCAAACCGGGACAGGGGGGTGATACGCAGTATTTT	CASKPGQGGDTQYF	TRBV6-4	TRBJ2-3
TGTGCCAGCAGCGGTCCAGCGGAGACAGGGAGCTACGAGCAGTACTTC	CASSGPAETGSYEQYF	TRBV7-9	TRBJ2-7
TGTGCCAGCAGTTTACAGGGGAGACTCAGTGTTGAAGCTTTCTTT	CASSLQGRLSVEAFF	TRBV28	TRBJ1-1
TGTGCCAGCAGTGACTCGGAAAGGGGGCAGGGGGGAGTCAATAATTCACCCCTCCACTTT	CASSDSERGQGGVNNSPLHF	TRBV6-4	TRBJ1-6
TGTGCCAACAACCAAGTGGTCAATCAGCCCCAGCATTTT	CANNQVVNQPQHF	TRBV11-3	TRBJ1-5
TGTGCCAGATGGGGTAGAGCTTTCTTT	CARWGRAFF	TRBV12-3	TRBJ1-1
TGTGCCACCATGTCGACCCGCATCTCCTACAATGAGCAGTTCTTC	CATMSTRISYNEQFF	TRBV24-1	TRBJ2-1
TGTGCCAGCAGCGGCGAGCGAGGCCAGCCCCAGCATTTT	CASSGERGQPQHF	TRBV9	TRBJ1-5
TGCGCCAGCAGCTTGGAGCCTATAAGGTTTTACTACGAGCAGTACTTC	CASSLEPIRFYYEQYF	TRBV5-1	TRBJ2-7
TGCAGTGCTTTCGAGCCGTACGAGCAGTACTTC	CSAFEPYEQYF	TRBV20-1	TRBJ2-7
TGTGCCAGCAGCCAACGGGGTAATTCACCCCTCCACTTT	CASSQRGNSPLHF	TRBV3-1	TRBJ1-6
TGTGCCAGCAGCCGGGTCCTGGCGCCGGGACAGGGGAGCTCCTACAATGAGCAGTTCTTC	CASSRVLAPGQGSSYNEQFF	TRBV6-4	TRBJ2-1
TGTGCCAGCAGCCAAGACCATTGGTCCGAGCAGTACTTC	CASSQDHWSEQYF	TRBV3-1	TRBJ2-7
TGTGCCAGCAGCTTAGATACCGGGTGCCGTTCCTACAATGAGCAGTTCTTC	CASSLDTGCRSYNEQFF	TRBV11-3	TRBJ2-1
TGTGCCAGCAGCCAACCCCCGTGGGACAGGGATGGCTACGAGCAGTACTTC	CASSQPPWDRDGYEQYF	TRBV13	TRBJ2-7
TGCGCCAGCAGCGGGCGGGATGAGCAGTTCTTC	CASSGRDEQFF	TRBV5-1	TRBJ2-1
TGTGCCAGCAGGTGCTGCACTAGTTCCTGTAATGAGCAGTTCTTC	CASRCCTSSCNEQFF	TRBV28	TRBJ2-1
TGCAATCGGCCAGATACGCAGTATTTT	CNRPDTQYF	TRBV20-1	TRBJ2-3
TGCAGTGCTAGAGATTCCAAGGGCCGGGACAGAAGTACTGAAGCTTTCTTT	CSARDSKGRDRSTEAFF	TRBV20-1	TRBJ1-1
TGTGCCAGCAGCTTGAATTCTAGCGGGGAGACCCAGTACTTC	CASSLNSSGETQYF	TRBV5-8	TRBJ2-5
TGTGCCAGCAGCTCGATTTGCCCCAGGGATAACAAGGGGACCCAGTACTTC	CASSSICPRDNKGTQYF	TRBV7-9	TRBJ2-5
TGCGCCAGCCAACCCCCTGGGGCTCTAGGTAATCAGCCCCAGCATTTT	CASQPPGALGNQPQHF	TRBV4-1	TRBJ1-5
TGTGCCAGCAGCAGCAGGGACCTGCCTCGACTAGCCAAAAACATTCAGTACTTC	CASSSRDLPRLAKNIQYF	TRBV27	TRBJ2-4
TGTGCCAGCAGCGCCCGTGCCCCCGGGAATGAGCAGTTCTTC	CASSARAPGNEQFF	TRBV9	TRBJ2-1
TGTGCCGCCGAGCGGAGAGAGACCCAGTACTTC	CAAERRETQYF	TRBV19	TRBJ2-5
TGCAGTGCTATCGGGACAGAGGCGGCCTACAATGAGCAGTTCTTC	CSAIGTEAAYNEQFF	TRBV20-1	TRBJ2-1
TGTGCCAGCGACAGGGTGGTTCAGCCCCAGCATTTT	CASDRVVQPQHF	TRBV6-2	TRBJ1-5
TGTGACTCTAGGGGCACATACAATGAGCAGTTCTTC	CDSRGTYNEQFF	TRBV6-5	TRBJ2-1
TGTGCCTGGACCACGTCCAGTAACAATGAGCAGTTCTTC	CAWTTSSNNEQFF	TRBV30	TRBJ2-1
TGTGCCAGCAGGGGCTACGAGCAGTACTTC	CASRGYEQYF	TRBV13	TRBJ2-7
TGTGCCATCAACCCCAGGAAGATCGTAAATCAGCCCCAGCATTTT	CAINPRKIVNQPQHF	TRBV10-3	TRBJ1-5
TGTGCCAGCAGCCGCCAGCCAGGGATAGACTGCACAGATACGCAGTATTTT	CASSRQPGIDCTDTQYF	TRBV7-8	TRBJ2-3
TGTGCCAGCAGTCTAACGGCCCTATTCGGCTACACCTTC	CASSLTALFGYTF	TRBV6-4	TRBJ1-2
TGCGCCAGCAGCCGAGGGAAAAGTGGATGGATGGTGACAGATACGCAGTATTTT	CASSRGKSGWMVTDTQYF	TRBV4-1	TRBJ2-3
TGTGCCAGCAGTGACGACAATGAGCAGTTCTTC	CASSDDNEQFF	TRBV6-4	TRBJ2-1
TGCGCCAGCAGCTTGACTCCAGGTGGACAGGTAGGTCAGCCCCAGCATTTT	CASSLTPGGQVGQPQHF	TRBV5-1	TRBJ1-5
TGCAGTCCCACTACTAGATACGAGCAGTACTTC	CSPTTRYEQYF	TRBV20-1	TRBJ2-7
TGTGCCAGCAGCCAAGATCTACGGGGCCGGCCCTGCAATCAGCCCCAGCATTTT	CASSQDLRGRPCNQPQHF	TRBV3-1	TRBJ1-5
TGCGCCAGCCACCCGCCCCTGAACACTGAAGCTTTCTTT	CASHPPLNTEAFF	TRBV10-1	TRBJ1-1
TGTGCCAGCAGTTCCAGAGGACAGGGCAATCAGCCCCAGCATTTT	CASSSRGQGNQPQHF	TRBV6-5	TRBJ1-5
TGTGCCAGCAGCTTTCCGATAGGACAGCCCTACGAGCAGTACTTC	CASSFPIGQPYEQYF	TRBV7-2	TRBJ2-7
TGTGCCTACGGAAAGGGGACTAGCGGGATGAAAAAACTGTACCAAGAGACCCAGTACTTC	CAYGKGTSGMKKLYQETQYF	TRBV19	TRBJ2-5
TGTGCCATCAGAGCCCGACAGGGGTTACTCCAATGCAATCAGCCCCAGCATTTT	CAIRARQGLLQCNQPQHF	TRBV10-3	TRBJ1-5
TGCGCCAGCAGCTTGGCCCAGGGACAGGGAACTAATGAAAAACTGTTTTTT	CASSLAQGQGTNEKLFF	TRBV5-1	TRBJ1-4
TGCGCCAGCAGCTTGGTCCCCGGGACAGGGGGCGAAGAGACCCAGTACTTC	CASSLVPGTGGEETQYF	TRBV5-1	TRBJ2-5
TGTGCCAGCAGTGCGGGGACTAGTATGTACAATGAGCAGTTCTTC	CASSAGTSMYNEQFF	TRBV25-1	TRBJ2-1
TGTGCCAGCAGCGGCCGGGCCCGACAGGGGGGGCCCGGTTGGTTGAACACTGAAGCTTTCTTT	CASSGRARQGGPGWLNTEAFF	TRBV5-6	TRBJ1-1
TGTGCCAGCAGCCCCATTCCGCTAGCAGATACGCAGTATTTT	CASSPIPLADTQYF	TRBV6-2	TRBJ2-3
TGTGCCAGCAGTTATCCCCCCGGGACAGGGGGCACCGGGGAGCTGTTTTTT	CASSYPPGTGGTGELFF	TRBV6-5	TRBJ2-2
TGCAACCGGGAAGATGAGCAGTTCTTC	CNREDEQFF	TRBV10-2	TRBJ2-1
TGTGCCACCAGTGACCTGGGACTAGCGGGTCCCTACGAGCAGTACTTC	CATSDLGLAGPYEQYF	TRBV24-1	TRBJ2-7
TGTGCCAAGCCACCCCCGGGGGGCTATGGCTACACCTTC	CAKPPPGGYGYTF	TRBV19	TRBJ1-2
TGTGCCAGCATCAGGACGACCCAGTACTTC	CASIRTTQYF	TRBV5-6	TRBJ2-5
TGTGCCTGGAGTTCCAGGCCCCAGCATTTT	CAWSSRPQHF	TRBV30	TRBJ1-5
TGTGCCAGCAGCATTGGGGGCGGGAGCCGTTACGAGCAGTACTTC	CASSIGGGSRYEQYF	TRBV13	TRBJ2-7
TGTGCCAGCAGCGACAGCCACTATGGCTACACCTTC	CASSDSHYGYTF	TRBV5-6	TRBJ1-2
TGTGCCAGCAGATGCGGGAGAGGCTCCTACGAGCAGTACTTC	CASRCGRGSYEQYF	TRBV12-4	TRBJ2-7
TGTGCCAGCAGTAAGCCATTTAGCTACGAAGATACGCAGTATTTT	CASSKPFSYEDTQYF	TRBV6-6	TRBJ2-3
TGTGCCAGCAGCTGGGCTGGGGATACGCAGTATTTT	CASSWAGDTQYF	TRBV7-9	TRBJ2-3
TGTGCCACCAGTCTTGCCAGGGTGTACATCGAGCAGTACTTC	CATSLARVYIEQYF	TRBV24-1	TRBJ2-7
TGTGCCAGCAGCCTTTTCTTGGATGACAGCACCAAAAACATTCAGTACTTC	CASSLFLDDSTKNIQYF	TRBV6-4	TRBJ2-4
TGTGCCAGCAGTTACTCGAATAACATCGCGTGGACTAGCGGGGGTAATGAGCAGTTCTTC	CASSYSNNIAWTSGGNEQFF	TRBV6-3	TRBJ2-1
TGTGCCTGTGCACGCGAGGCGAACACCGGGGAGCTGTTTTTT	CACAREANTGELFF	TRBV30	TRBJ2-2
TGTGCCAGCCCAAGTTGGTTTAAGGGGGGACAGGTCTTTCTGTCACCCCTCCACTTT	CASPSWFKGGQVFLSPLHF	TRBV7-9	TRBJ1-6
TGTGCCAGTAGGGGAGGGAGCGAGCCCCAGCATTTT	CASRGGSEPQHF	TRBV19	TRBJ1-5
TGTGCCAGCATGATACGGGACGAGACTAATGAAAAACTGTTTTTT	CASMIRDETNEKLFF	TRBV18	TRBJ1-4
TGTGCCTGGAGTGTAGGAGAGGGGGCCACAGATACGCAGTATTTT	CAWSVGEGATDTQYF	TRBV30	TRBJ2-3
TGTGCCAGCAGCCAAGGACAGGGAAGGACCCAGTACTTC	CASSQGQGRTQYF	TRBV4-2	TRBJ2-5
TGTGCCAGCAGTGAACCCCCTAGCGGGTTCAATGAGCAGTTCTTC	CASSEPPSGFNEQFF	TRBV6-4	TRBJ2-1
TGTGCCAGCAGCCCGAGGGCCCAAGAGACCCAGTACTTC	CASSPRAQETQYF	TRBV7-3	TRBJ2-5
TGTGCCAGCAGTCGGGGCCAGTGGGGGGTCCTAGCCAAAAACATTCAGTACTTC	CASSRGQWGVLAKNIQYF	TRBV6-2	TRBJ2-4
TGTGCCACCAGTGACGAGCCTAGCGGGGGGGACAATGAGCAGTTCTTC	CATSDEPSGGDNEQFF	TRBV24-1	TRBJ2-1
TGTGCCAGCGTCCCCAGCAGGGGCAATCAGCCCCAGCATTTT	CASVPSRGNQPQHF	TRBV6-4	TRBJ1-5
TGCGCCAGCAGTAGGAGCGGGGGTTACAATGAGCAGTTCTTC	CASSRSGGYNEQFF	TRBV10-1	TRBJ2-1
TGTGCCAGCAGTCGGGGTCCCCGGCACCAACCGGTGACCCAGTACTTC	CASSRGPRHQPVTQYF	TRBV28	TRBJ2-5
TGTGCCAGCATGGGACCTACTGAAGCTTTCTTT	CASMGPTEAFF	TRBV2	TRBJ1-1
TGTGCCAGCAGGCCAAAGTCCGGGACTAGCGGGTGGCTGATAGGGTGCTCCTACAATGAGCAGTTCTTC	CASRPKSGTSGWLIGCSYNEQFF	TRBV6-5	TRBJ2-1
TGTGCCAGCAGTGCGGGGAGGTGCGAGACCCAGTACTTC	CASSAGRCETQYF	TRBV6-5	TRBJ2-5
TGTGCCAGCTCACCTTCCCCTATTGAACTCACAGATACGCAGTATTTT	CASSPSPIELTDTQYF	TRBV18	TRBJ2-3
TGTGCCACCAGTGATGGCAGAGGTGAAGCTTTCTTT	CATSDGRGEAFF	TRBV24-1	TRBJ1-1
TGTGCTAGTGGTTACACGGGGGGCGGCGACTACAATGAGCAGTTCTTC	CASGYTGGGDYNEQFF	TRBV12-5	TRBJ2-1
TGTGCTAGTGGTTTGGTACGGAAAGTCAGCGAAGGGAGCACCGGGGAGCTGTTTTTT	CASGLVRKVSEGSTGELFF	TRBV12-5	TRBJ2-2
TGTGCCAGCAGAAATACAGGGGGCGCAGGAAACACCATATATTTT	CASRNTGGAGNTIYF	TRBV7-3	TRBJ1-3
TGTGCCAGCAGCTTAGATGAGCCCCACACAGGGCGCGAGCAGTACTTC	CASSLDEPHTGREQYF	TRBV11-2	TRBJ2-7
TGTGCCATCAGTGTCGGGAGGGTTAGAGGCAATCAGCCCCAGCATTTT	CAISVGRVRGNQPQHF	TRBV10-3	TRBJ1-5
TGTGCCAGTCAATGTGGAAACACCATATATTTT	CASQCGNTIYF	TRBV19	TRBJ1-3
TGTGCCAGCAGTTTTGGCAGACAGGGGGCTCGGGGGGCCAACGTCCTGACTTTC	CASSFGRQGARGANVLTF	TRBV6-5	TRBJ2-6
TGCGCCAGCGCCGCGGGATTCTACGAGCAGTACTTC	CASAAGFYEQYF	TRBV5-1	TRBJ2-7
TGCAGTGCTAGAACGACAGGGTTAGGGTACGAGCAGTACTTC	CSARTTGLGYEQYF	TRBV20-1	TRBJ2-7
TGTGCCAGCAACCCCTCCGAAGGGGGAGCTGGAAACACCATATATTTT	CASNPSEGGAGNTIYF	TRBV6-8	TRBJ1-3
TGTGCCAGGCGGGGTGGAAACACCATATATTTT	CARRGGNTIYF	TRBV28	TRBJ1-3
TGTGCCCCCCCCTCCCCGATGTGCGGCGATCCAGATACGCAGTATTTT	CAPPSPMCGDPDTQYF	TRBV7-9	TRBJ2-3
TGTGCCAGCACGGCAGGAGGCTCTGGAAACACCATATATTTT	CASTAGGSGNTIYF	TRBV9	TRBJ1-3
TGCAGTGCTAGACTGAACCAGGACAGCCTAAGTAATGAAAAACTGTTTTTT	CSARLNQDSLSNEKLFF	TRBV20-1	TRBJ1-4
TGTGCCAGCTTTCCCAGGGGGGCTTTCTTT	CASFPRGAFF	TRBV6-5	TRBJ1-1
TGTGCCAGCCTGTTAGGCGGCATGTACACCGGGGAGCTGTTTTTT	CASLLGGMYTGELFF	TRBV7-9	TRBJ2-2
TGTGCCAGCAGACAGACGGTAGAAACATTGGAGCTGTTTTTT	CASRQTVETLELFF	TRBV3-1	TRBJ2-2
TGTGCCAGCAGCCCAGTGGGGGGGGGCGAGCAGTACTTC	CASSPVGGGEQYF	TRBV7-9	TRBJ2-7
TGTGCCAGCAGCCAAGATTTGGTCGGACCCACCTATGGCTACACCTTC	CASSQDLVGPTYGYTF	TRBV14	TRBJ1-2
TGTGCCAGTCAGCCGGGGGGGAACACTGAAGCTTTCTTT	CASQPGGNTEAFF	TRBV27	TRBJ1-1
TGTGCCAGCAGCAGGACAAAGCCCCAGCATTTT	CASSRTKPQHF	TRBV7-8	TRBJ1-5
TGTGCCAGCAGCTTAGGGCGGGAAGAAAAACTGTTTTTT	CASSLGREEKLFF	TRBV7-6	TRBJ1-4
TGTGCCAGCAGCTCCCTCAGTAGCACTGAAGCTTTCTTT	CASSSLSSTEAFF	TRBV6-4	TRBJ1-1
TGTGCCAGCTCCGCCAGGAGGCCCCCCCTAGAGCAGTACTTC	CASSARRPPLEQYF	TRBV18	TRBJ2-7
TGTGCCAGCAGCTTAAAAGGTGGACGGGAAAGACGGGGTGATGGCTACACCTTC	CASSLKGGRERRGDGYTF	TRBV11-2	TRBJ1-2
TGTGCCAGCAATGGCCCAGCCGGACAGGGTAGGAACGAGCAGTACTTC	CASNGPAGQGRNEQYF	TRBV6-4	TRBJ2-7
TGTGCCAGCTACCGGCGTACCGGGACAGCCGATACGCAGTATTTT	CASYRRTGTADTQYF	TRBV6-4	TRBJ2-3
TGTGCCAGCAGCACCACTTGGACTAGGGGCCCAGATACGCAGTATTTT	CASSTTWTRGPDTQYF	TRBV7-3	TRBJ2-3
TGTGCCAGCAGCTTAGAATTTACGCCGTACGAGCAGTACTTC	CASSLEFTPYEQYF	TRBV7-2	TRBJ2-7
TGTGCCAGCAGCTTAGCGTTTTGCGCAGTCGAGCAGTACTTC	CASSLAFCAVEQYF	TRBV7-9	TRBJ2-7
TGTGCCAGCAGCAGTGAGGGCCCGCTGAACACTGAAGCTTTCTTT	CASSSEGPLNTEAFF	TRBV7-4	TRBJ1-1
TGTGCCAGCTCACCAGCCTCGACCTGGGGGAGAAGCACAGATACGCAGTATTTT	CASSPASTWGRSTDTQYF	TRBV18	TRBJ2-3
TGTGCCAGCAGTTTTCGGTTCCCGGGCGGACGGCACGAGCAGTACTTC	CASSFRFPGGRHEQYF	TRBV28	TRBJ2-7
TGTGCCAGTAGTGGACGCGGACAGTGCTGCACTGAAGCTTTCTTT	CASSGRGQCCTEAFF	TRBV19	TRBJ1-1
TGTGCCAGCTCACCACAAGGGGATCGCCCCTACGAGCAGTACTTC	CASSPQGDRPYEQYF	TRBV18	TRBJ2-7
TGTGCCAGCAGACCCAGGCTTAGTGAAAAACTGTTTTTT	CASRPRLSEKLFF	TRBV27	TRBJ1-4
TGTGCCAGCAGCTTGCATTCTAGCTGGAACTACGAGCAGTACTTC	CASSLHSSWNYEQYF	TRBV5-6	TRBJ2-7
TGTGCCAGCTCACCGCAGGGATCCTACGAGCAGTACTTC	CASSPQGSYEQYF	TRBV18	TRBJ2-7
TGTGCCAGCAGCGCCGAGGCTGTATACAATCAGCCCCAGCATTTT	CASSAEAVYNQPQHF	TRBV3-1	TRBJ1-5
TGTGCCAGCAGCGGGGCTAGGGGGAATGAGCAGTTCTTC	CASSGARGNEQFF	TRBV3-1	TRBJ2-1
TGTGCCAGCAGCCGAGGGCACACTGAAGCTTTCTTT	CASSRGHTEAFF	TRBV5-6	TRBJ1-1
TGCGCCAGCAGCGGCCGTGGGGGGCCCCAGCAGTTCTTC	CASSGRGGPQQFF	TRBV5-1	TRBJ2-1
TGTGCCAGCAGCGCGAGCGGGAGGAACGAGCAGTACTTC	CASSASGRNEQYF	TRBV7-9	TRBJ2-7
TGTGCCAGGAACGAGACCCAGTACTTC	CARNETQYF	TRBV6-1	TRBJ2-5
TGCGCCAGGCTTCACCGCCCCGAGACCCAGTACTTC	CARLHRPETQYF	TRBV4-1	TRBJ2-5
TGTGCCAGCAGCAAAGGGGGGCCCTGGTACCTAGGAGAGACCCAGTACTTC	CASSKGGPWYLGETQYF	TRBV7-9	TRBJ2-5
TGTGGACTAGCGGGCTTATACGAGCAGTACTTC	CGLAGLYEQYF	TRBV19	TRBJ2-7
TGCGCCAGCAGTGGTAGCAGGAACAGATTCTATGGCTACACCTTC	CASSGSRNRFYGYTF	TRBV10-1	TRBJ1-2
TGCGCCAGCAAAAGGATCCCGAGGGGTCCCTACAATGAGCAGTTCTTC	CASKRIPRGPYNEQFF	TRBV10-1	TRBJ2-1
TGCGCCAGCAGCTTCTTGGGGGAACGGGGTGGAAATGGCTACACCTTC	CASSFLGERGGNGYTF	TRBV5-1	TRBJ1-2
TGTGCCACCAGCCGGGCGAAAATCAATGAGCAGTTCTTC	CATSRAKINEQFF	TRBV15	TRBJ2-1
TGTGCCAGCAGGGGAAGACGTGACTACGAGCAGTACTTC	CASRGRRDYEQYF	TRBV7-9	TRBJ2-7
TGTGCCAGCCAGGACGGGAACAACAATTCACCCCTCCACTTT	CASQDGNNNSPLHF	TRBV13	TRBJ1-6
TGTGCCAGCAGGAACGTACGCTACGAGCAGTACTTC	CASRNVRYEQYF	TRBV28	TRBJ2-7
TGTGCCAGCATTCGGACAAATCAGCCCCAGCATTTT	CASIRTNQPQHF	TRBV11-2	TRBJ1-5
TGTGCCAGCACCCCTCTTCCGGAGGGAACCGGGGGCAACACTGAAGCTTTCTTT	CASTPLPEGTGGNTEAFF	TRBV6-4	TRBJ1-1
TGTGCCAGCAGCTACCCCCCACTTCCAAGGGAGGACTATGGCTACACCTTC	CASSYPPLPREDYGYTF	TRBV7-3	TRBJ1-2
TGTGCCAGCAGCTTCCGGGGAGAGGAACACTCCTATAATTCACCCCTCCACTTT	CASSFRGEEHSYNSPLHF	TRBV7-2	TRBJ1-6
TGCACGTCTGCCACTACTTCCTACGAGCAGTACTTC	CTSATTSYEQYF	TRBV20-1	TRBJ2-7
TGTGCCAGCAGCCAAGAGACCCCACTAGCGGGAGCCGGCACAGATACGCAGTATTTT	CASSQETPLAGAGTDTQYF	TRBV3-1	TRBJ2-3
TGCGCCAGCAGCTATACAGTTGTCAGCGAGTACTTC	CASSYTVVSEYF	TRBV5-1	TRBJ2-4
TGTGCCAGCAGCTGGACGGAGTCCTCTGGGGCCAACGTCCTGACTTTC	CASSWTESSGANVLTF	TRBV7-2	TRBJ2-6
TGTGCCAGCAGTGCGATAGCGGGAATTAGGGCGAACACCGGGGAGCTGTTTTTT	CASSAIAGIRANTGELFF	TRBV27	TRBJ2-2
TGTGCCAGTAGTTTTAGTGGCCAGACCCAGCCCCAGCATTTT	CASSFSGQTQPQHF	TRBV19	TRBJ1-5
TGTGCCATCAGTCCCCCAGGGAACACCGGGGAGCTGTTTTTT	CAISPPGNTGELFF	TRBV10-3	TRBJ2-2
TGTGCCAGCTGTAGCGGGCCGGTCTTC	CASCSGPVF	TRBV6-1	TRBJ2-1
TGTGCCAGCAGTGAAGCCTTCGGCGGAATTTCTAGCGGGAAAACAGATACGCAGTATTTT	CASSEAFGGISSGKTDTQYF	TRBV6-1	TRBJ2-3
TGTGCCAGCAGCTTACAGAGCTTCCTAGGGGCCAACGTCCTGACTTTC	CASSLQSFLGANVLTF	TRBV7-9	TRBJ2-6
TGTGCCAGCAGTTCCCGAAACAGGGGAAATCAGCCCCAGCATTTT	CASSSRNRGNQPQHF	TRBV27	TRBJ1-5
TGTGCCAGCTCTCGGGACGGCGGGACCGCTAGCACAGATACGCAGTATTTT	CASSRDGGTASTDTQYF	TRBV18	TRBJ2-3
TGTGCCGGGGGAGGGGCGGGGTCTGCAGATACGCAGTATTTT	CAGGGAGSADTQYF	TRBV7-2	TRBJ2-3
TGTGCCAGCAGTTTCGAGGGGAGGGGCCTGCATCAGCCCCAGCATTTT	CASSFEGRGLHQPQHF	TRBV27	TRBJ1-5
TGTGCCATCATTTACATCTATAGCAATCAGCCCCAGCATTTT	CAIIYIYSNQPQHF	TRBV10-3	TRBJ1-5
TGTGCCAGCAACCCCTCAGGGGGCACTAACTATGGCTACACCTTC	CASNPSGGTNYGYTF	TRBV6-5	TRBJ1-2
TGCAGTGATGTACAGGGGGATTGCGAAAAACTGTTTTTT	CSDVQGDCEKLFF	TRBV20-1	TRBJ1-4
TGTGCCAGCAATCCCCTCCGGGACAGGGTCCTGAGGAACGAGCAGTACTTC	CASNPLRDRVLRNEQYF	TRBV12-4	TRBJ2-7
TGTGCCAGCAGCTACCCGGGGTGGACGAACACCGGGGAGCTGTTTTTT	CASSYPGWTNTGELFF	TRBV11-3	TRBJ2-2
TGTGCCAGCAGTTCCGCGAGGACAGATGGCTACACCTTC	CASSSARTDGYTF	TRBV28	TRBJ1-2
TGTGCCAGCAGTTCACCGTCCGACAGGGAAGCTGAGCAGTTCTTC	CASSSPSDREAEQFF	TRBV27	TRBJ2-1
TGTGCCTGGAGTGTACGATGGAGGTTTGGGGGGAATCAGCCCCAGCATTTT	CAWSVRWRFGGNQPQHF	TRBV30	TRBJ1-5
TGTGCCACCAGTGATTGGCGGGGACTAGTCCCTGCCTACGAGCAGTACTTC	CATSDWRGLVPAYEQYF	TRBV24-1	TRBJ2-7
TGCAGTGCGGAGATAGCGGGTCCAGTTCGCTATGAGCAGTTCTTC	CSAEIAGPVRYEQFF	TRBV20-1	TRBJ2-1
TGTGCCACCAGTGGGGGGAACACCGGGGAGCTGTTTTTT	CATSGGNTGELFF	TRBV24-1	TRBJ2-2
TGTGCCAGCAGTGAAGTTTCTCTAGCGGCCGCCTACAATGAGCAGTTCTTC	CASSEVSLAAAYNEQFF	TRBV6-1	TRBJ2-1
TGTGCCAGCTCACGCACCCAGCATTTT	CASSRTQHF	TRBV18	TRBJ1-5
TGTGCCAGCATTTCCAGGGAGGTCCCCGAGCAGTACTTC	CASISREVPEQYF	TRBV6-3	TRBJ2-7
TGTGCCAGCAGTTACAGGCAGCCCCAGCATTTT	CASSYRQPQHF	TRBV6-3	TRBJ1-5
TGTGCCAGCAGCCAAGACTGGACCTACTACGAGCAGTACTTC	CASSQDWTYYEQYF	TRBV14	TRBJ2-7
TGTGCCAGCAGCTCGGACAGGGGGGTTGCGAGGAACGAGCAGTACTTC	CASSSDRGVARNEQYF	TRBV7-4	TRBJ2-7
TGTGCCAGTAGTATCCCCCTTCACAGAGGGGGCCGCCAAGATACGCAGTATTTT	CASSIPLHRGGRQDTQYF	TRBV19	TRBJ2-3
TGTGCCAGCAGTTTAGACGGGACAGGGGGGGGGCTGGGCAAAAACATTCAGTACTTC	CASSLDGTGGGLGKNIQYF	TRBV28	TRBJ2-4
TGTGCCAGCAGTTACAGTAAGGAGGACAGTATGAACACTGAAGCTTTCTTT	CASSYSKEDSMNTEAFF	TRBV6-5	TRBJ1-1
TGTGCCAGCAGGCTGGGACGCCCAACTAATGAAAAACTGTTTTTT	CASRLGRPTNEKLFF	TRBV6-5	TRBJ1-4
TGTGCCAGTAGTAAAAGAAGCGGGCCGGGGCTGCAGTATTTT	CASSKRSGPGLQYF	TRBV19	TRBJ2-3
TGTGCCACCAGTGAGGGACGGACAGGGTATAATCAGCCCCAGCATTTT	CATSEGRTGYNQPQHF	TRBV24-1	TRBJ1-5
TGTGCCAGCAGTTACTCGATTCGGGTCATCTACGAGCAGTACTTC	CASSYSIRVIYEQYF	TRBV6-5	TRBJ2-7
TGCGCCAGCCCCCTAGTACTCTCTGGGGCCAACGTCCTGACTTTC	CASPLVLSGANVLTF	TRBV4-3	TRBJ2-6
TGCGCCAGCAGCCAAGATAAACAGGGCAGGCTTGAAGCTTTCTTT	CASSQDKQGRLEAFF	TRBV4-3	TRBJ1-1
TGTGCCAGCAGTGATACTCCGGGCGCAGCAACTAATGAAAAACTGTTTTTT	CASSDTPGAATNEKLFF	TRBV6-5	TRBJ1-4
TGTGCCAGCAGTGCCACGCCCAGGGGGGTTAACGAGCAGTACTTC	CASSATPRGVNEQYF	TRBV27	TRBJ2-7
TGTGCCAGCAGTGAGGGGGTCTCCTACGAGCAGTACTTC	CASSEGVSYEQYF	TRBV28	TRBJ2-7
TGTGCCAGCCCCGCAGGGGGGCCCGAATCTGAAGCTTTCTTT	CASPAGGPESEAFF	TRBV14	TRBJ1-1
TGCAGCGTTCGGGCTCGCGGAGCCGACAGGGTTCGGACACCCCTCCACTTT	CSVRARGADRVRTPLHF	TRBV29-1	TRBJ1-6
TGTGCCATCACTCTCTTGGGCGAATACGATGAAAAACTGTTTTTT	CAITLLGEYDEKLFF	TRBV10-3	TRBJ1-4
TGTGCCACCAGGAAGGCTAGTTCACTAGCGGGAGGGCGAAGACTAATGGAAGAGACCCAGTACTTC	CATRKASSLAGGRRLMEETQYF	TRBV24-1	TRBJ2-5
TGTGCCAGCAGCTCCCAGCAAGGGTCTAACTATGGCTACACCTTC	CASSSQQGSNYGYTF	TRBV7-2	TRBJ1-2
TGCAGTGCCTTTGAGGGCTCCTACAATGAGCAGTTCTTC	CSAFEGSYNEQFF	TRBV20-1	TRBJ2-1
TGTGCCAGCAACCGGGACGCTCGTACGGAAAAACTGTTTTTT	CASNRDARTEKLFF	TRBV6-5	TRBJ1-4
TGCAGTGCTAGGGGGTCCGGAAACACCATATATTTT	CSARGSGNTIYF	TRBV20-1	TRBJ1-3
TGTGCCAGCAGCCACTTTTACAATGAGCAGTTCTTC	CASSHFYNEQFF	TRBV5-5	TRBJ2-1
TGTGCCAGCAGTTACCAATCCTACGAGCAGTACTTC	CASSYQSYEQYF	TRBV6-5	TRBJ2-7
TGTGCCAGCACCCAGGGGTGGATCTACGAGCAGTACTTC	CASTQGWIYEQYF	TRBV6-6	TRBJ2-7
TGTGCCAGCAGCGGGCCGACATCCAATCAGCCCCAGCATTTT	CASSGPTSNQPQHF	TRBV11-2	TRBJ1-5
TGTGCCAGCAGCCAAGATGACACAGGGTGGAATCAGCCCCAGCATTTT	CASSQDDTGWNQPQHF	TRBV3-1	TRBJ1-5
TGTGCCAGCAGTTTAGAGTTGCCGGGGGGGCGCATGCCGACCGGGGAGCTGTTTTTT	CASSLELPGGRMPTGELFF	TRBV27	TRBJ2-2
TGTGCCAGCAGTGCGGTACCAGGGACAGGGGGCAGGGTGAGGCTAGCCAAAAACATTCAGTACTTC	CASSAVPGTGGRVRLAKNIQYF	TRBV6-4	TRBJ2-4
TGCGCCAGCAGCGCCTCCGGGACCTGCTACGAGCAGTACTTC	CASSASGTCYEQYF	TRBV5-1	TRBJ2-7
TGTGCCAGCAGTTTGGCAGGGTGCACAGATACGCAGTATTTT	CASSLAGCTDTQYF	TRBV28	TRBJ2-3
TGTGCCAGCAGCTATAGACGGAACACTTCGGAGCCCCAGCATTTT	CASSYRRNTSEPQHF	TRBV13	TRBJ1-5
TGTGCCAGCAGCACAGAGGGCCACTCCTACGAGCAGTACTTC	CASSTEGHSYEQYF	TRBV13	TRBJ2-7
TGTGCCAGCAGCCCGGGACGGGCCTCCTACGAGCAGTACTTC	CASSPGRASYEQYF	TRBV28	TRBJ2-7
TGTGCCAGCAGTACAGTTCGTGAGCAGTACTTC	CASSTVREQYF	TRBV28	TRBJ2-7
TGTGCCAGCAAGGCGGGGAATAGCTCCTACAATGAGCAGTTCTTC	CASKAGNSSYNEQFF	TRBV5-5	TRBJ2-1
TGTGCCAGCAGTTTGTTCCGGGGGGGCCACTTC	CASSLFRGGHF	TRBV28	TRBJ2-7
TGTGCCACCGTAACGACAGGGATCGGTAAAGATACGCAGTATTTT	CATVTTGIGKDTQYF	TRBV24-1	TRBJ2-3
TGCAGCGAACAGGACACTGAAGCTTTCTTT	CSEQDTEAFF	TRBV29-1	TRBJ1-1
TGTGCCAGCAGCTGGACCAATGTACCGACGTCAGGCTCCTACGAGCAGTACTTC	CASSWTNVPTSGSYEQYF	TRBV7-9	TRBJ2-7
TGTGCCAGCAGAGGGGGGGCGGATGAAAAACTGTTTTTT	CASRGGADEKLFF	TRBV6-4	TRBJ1-4
TGCGCCAGCAGTCGGGGGGGCGTAAGGTTTAATGAGCAGTTCTTC	CASSRGGVRFNEQFF	TRBV10-1	TRBJ2-1
TGTGCCAGCAGCTTGCCTGGGAGGGGGGGCCGCCGGGCCTACGAGCAGTACTTC	CASSLPGRGGRRAYEQYF	TRBV7-9	TRBJ2-7
TGCGCCAGGAGGTTCGATAGACTGACCCATCAGCCCCAGCATTTT	CARRFDRLTHQPQHF	TRBV10-1	TRBJ1-5
TGTGCCGGCCGGGACAGGGGGCACTGGTCCTATAATTCACCCCTCCACTTT	CAGRDRGHWSYNSPLHF	TRBV7-8	TRBJ1-6
TGTGCCACCATCCCTCCGGGGACTACAGATACGCAGTATTTT	CATIPPGTTDTQYF	TRBV24-1	TRBJ2-3
TGTGCCAGCAGCGCCTTCCCCCCGGGACAGGGCGGGGAGCTGTTTTTT	CASSAFPPGQGGELFF	TRBV9	TRBJ2-2
TGTGCCAGCAGCTCCTTGACGCTGCGCACAGATACGCAGTATTTT	CASSSLTLRTDTQYF	TRBV9	TRBJ2-3
TGTGCCAGCAGCTGGACAGGGGGTGCAACTAATGAAAAACTGTTTTTT	CASSWTGGATNEKLFF	TRBV7-3	TRBJ1-4
TGTGCCAGACGCCGTGAAACGGGCAAGCGGCAGACTAATGAAAAACTGTTTTTT	CARRRETGKRQTNEKLFF	TRBV19	TRBJ1-4
TGTGCCAGCAGTCTGGCTTACGAGCAGTACTTC	CASSLAYEQYF	TRBV6-1	TRBJ2-7
TGCAGCGCCCAGGGTAGGCGCCAAGAGACCCAGTACTTC	CSAQGRRQETQYF	TRBV29-1	TRBJ2-5
TGTGCCAGCAGTGACCGGGGCTGGAGTGGCTCCTACAATGAGCAGTTCTTC	CASSDRGWSGSYNEQFF	TRBV6-4	TRBJ2-1
TGTGCCAGCAGCTCAGGGGGACGCTACGAGCAGTACTTC	CASSSGGRYEQYF	TRBV5-6	TRBJ2-7
TGTGCCAGCAGCTTAGGGCCGGGTACCGCTTTCTTT	CASSLGPGTAFF	TRBV7-2	TRBJ1-1
TGTGCCAGCAGTTACAGCTCAATGAGGACAGGGTGCAACACTGAAGCTTTCTTT	CASSYSSMRTGCNTEAFF	TRBV6-3	TRBJ1-1
TGTGCCAGCAGCCACCCCCGCGACAGGGGTCGGTATTTT	CASSHPRDRGRYF	TRBV7-8	TRBJ1-3
TGTGCCACCAAGCGGATATCGGGACGCATTCAGTACTTC	CATKRISGRIQYF	TRBV24-1	TRBJ2-4
TGTGCCAGCAGCTCCGGTCAGGATCCTACCTCTGGGGCCAACGTCCTGACTTTC	CASSSGQDPTSGANVLTF	TRBV11-2	TRBJ2-6
TGTGCCAGCAGTTATCCTCGTGCGGGAGTCGTCTTC	CASSYPRAGVVF	TRBV6-6	TRBJ2-1
TGTGCCAGCTCACCCCCGGGACTAGCGGTTCCCTCCTACAATGAGCAGTTCTTC	CASSPPGLAVPSYNEQFF	TRBV18	TRBJ2-1
TGTGCCAGCAGCTTAATGGGGGGGAGCACAGATACGCAGTATTTT	CASSLMGGSTDTQYF	TRBV11-3	TRBJ2-3
TGTGCCAGCATTCCCGGGACGAACCCCCAGTACTTC	CASIPGTNPQYF	TRBV7-9	TRBJ2-5
TGCGCCAGCAGCTTGCCAGCGGGACCGTTAGACACTGAAGCTTTCTTT	CASSLPAGPLDTEAFF	TRBV5-1	TRBJ1-1
TGTGCCACCAGTGAGCAGTGGGACAGGGACCAAGCTTTCTTT	CATSEQWDRDQAFF	TRBV24-1	TRBJ1-1
TGTGCCAGCAGCGACATGACTAGCGACACCGGGGAGCTGTTTTTT	CASSDMTSDTGELFF	TRBV7-2	TRBJ2-2
TGTGCCAGACACGGGACAGGGGGCTCCTACGAGCAGTACTTC	CARHGTGGSYEQYF	TRBV5-4	TRBJ2-7
TGTGCCACCAGTGATTTGGTCCGGACTAGCGGGGGGGCCGAAAAGCAGTTCTTC	CATSDLVRTSGGAEKQFF	TRBV24-1	TRBJ2-1
TGTGCCAGACGGGGGGTGTGGGGTACAGATACGCAGTATTTT	CARRGVWGTDTQYF	TRBV5-4	TRBJ2-3
TGTGCCAGCAGCTTGGCACTACAGGGCGGGGGTAGTGAGCAGTTCTTC	CASSLALQGGGSEQFF	TRBV5-6	TRBJ2-1
TGTGCCTGGAGGGGGGCGGGAGGTTCAGATACGCAGTATTTT	CAWRGAGGSDTQYF	TRBV30	TRBJ2-3
TGCAGTGCTCGAGGGGGCCCCAAAGATACGCAGTATTTT	CSARGGPKDTQYF	TRBV20-1	TRBJ2-3
TGCAGTGCTAGAGATGGTGAGACGGGGCCGGACCCCGGACTACGCCTAGATACGCAGTATTTT	CSARDGETGPDPGLRLDTQYF	TRBV20-1	TRBJ2-3
TGTGCCTGGAGTGTAGTCCCTTTACAGGGCGATAGCAATCAGCCCCAGCATTTT	CAWSVVPLQGDSNQPQHF	TRBV30	TRBJ1-5
TGTGCCAGCAGCAGGGCGCGGACAGACACTGAAGCTTTCTTT	CASSRARTDTEAFF	TRBV7-3	TRBJ1-1
TGTGCCAGCAGCCGAAAGCCAGGGGTCAATCAGCCCCAGCATTTT	CASSRKPGVNQPQHF	TRBV3-1	TRBJ1-5
TGTGCCAGCAGCCAATATCACCGAGCTGGCACAGATACGCAGTATTTT	CASSQYHRAGTDTQYF	TRBV4-2	TRBJ2-3
TGTGCCAGCAGCGCAGACGTTCAGGGTGGAGAGAGAAATTCACCCCTCCACTTT	CASSADVQGGERNSPLHF	TRBV5-5	TRBJ1-6
TGTGCCAGCAGCAAGGGGGTGGAGAAGCCGCCCACAGATACGCAGTATTTT	CASSKGVEKPPTDTQYF	TRBV7-9	TRBJ2-3
TGTGCCAGCAGCAACCTAGTATGCTCCTACGAGCAGTACTTC	CASSNLVCSYEQYF	TRBV7-9	TRBJ2-7
TGTGCCAGCAGTTTAAAGCGGGCACTCCGCTCACACACTGAAGCTTTCTTT	CASSLKRALRSHTEAFF	TRBV28	TRBJ1-1
TGCAGCGTTGCGGGACAGGGGTATGGCTACACCTTC	CSVAGQGYGYTF	TRBV29-1	TRBJ1-2
TGTGCTAGCAGCGATCGCACTGGGGGACAGACACAACAGCCCCAGCATTTT	CASSDRTGGQTQQPQHF	TRBV7-7	TRBJ1-5
TGTGCCAGCAGCCAACAGGAAAAACTGTTTTTT	CASSQQEKLFF	TRBV14	TRBJ1-4
TGTGCCAGCAGTACTGAAAAAAGCCACGAGCAGTACTTC	CASSTEKSHEQYF	TRBV6-5	TRBJ2-7
TGTGCCAGCAGTTACGGTCCGGGACTAGCGGGAGAAAAGTGGGAGACCCAGTACTTC	CASSYGPGLAGEKWETQYF	TRBV6-5	TRBJ2-5
TGTGCCAGCAGCTTGACAGACAGGAATCAGCCCCAGCATTTT	CASSLTDRNQPQHF	TRBV7-9	TRBJ1-5
TGTGCCACCAGTGTGGAGGTGACAGGTCCGGGTGCGGAAGATAACTATGGCTACACCTTC	CATSVEVTGPGAEDNYGYTF	TRBV24-1	TRBJ1-2
TGTGCCAGCAGCCAAGAGCCTCCGGAGGACACTGAAGCTTTCTTT	CASSQEPPEDTEAFF	TRBV14	TRBJ1-1
TGCGCCAGCAGTGGACAGGGGCGCTATGGCTACACCTTC	CASSGQGRYGYTF	TRBV10-1	TRBJ1-2
TGTGCCAGCAGCTTGACAATGGACAGGGAAAGCTACGAGCAGTACTTC	CASSLTMDRESYEQYF	TRBV5-4	TRBJ2-7
TGCAGTGCTTCCACAGGGTGCGGAATTGAAAAACTGTTTTTT	CSASTGCGIEKLFF	TRBV20-1	TRBJ1-4
TGCAGTGCTAGACTTCCGACAGTCTATGGCTACACCTTC	CSARLPTVYGYTF	TRBV20-1	TRBJ1-2
TGTGCCAGCAGCGGGGGGGGGATTAACACTGAAGCTTTCTTT	CASSGGGINTEAFF	TRBV11-2	TRBJ1-1
TGTGCCAGCAGTGAACTACTAGCGGGGGTATACGAGCAGTACTTC	CASSELLAGVYEQYF	TRBV2	TRBJ2-7
TGTGCTAGCAGCTTACGATCTAGCGGGAGTGTAGCCAAAAACATTCAGTACTTC	CASSLRSSGSVAKNIQYF	TRBV7-7	TRBJ2-4
TGTGCCACATTGACAGGGGGCAGTAATTCACCCCTCCACTTT	CATLTGGSNSPLHF	TRBV24-1	TRBJ1-6
TGCGCCAGCAGCGCCGGGACATGGGCAATCTACGAGCAGTACTTC	CASSAGTWAIYEQYF	TRBV10-1	TRBJ2-7
TGTGCCACCAGTAATATGGACTGCCATGAGCAGTTCTTC	CATSNMDCHEQFF	TRBV24-1	TRBJ2-1
TGTGCCAGCAGTGCGGGGGGTGTTTGGTACAATGAGCAGTTCTTC	CASSAGGVWYNEQFF	TRBV6-1	TRBJ2-1
TGTGCCAGCAGGGATCCCCCCCCGGGGGTCGGAAACACCATATATTTT	CASRDPPPGVGNTIYF	TRBV7-4	TRBJ1-3
TGCAGTGCAAGGAGTAGGGGAGAATACGAGCAGTACTTC	CSARSRGEYEQYF	TRBV20-1	TRBJ2-7
TGTGCCAGCACCGCCCCCACAGATACGCAGTATTTT	CASTAPTDTQYF	TRBV27	TRBJ2-3
TGTGCCAGCAGCGTGGGGAGGGCCTTCAATGAGCAGTTCTTC	CASSVGRAFNEQFF	TRBV7-6	TRBJ2-1
TGTGCCAGCAGCGACCCTGGCTGGGACAGTAACTATGGCTACACCTTC	CASSDPGWDSNYGYTF	TRBV9	TRBJ1-2
TGTGCCAGCAGTTACCCAACAGGGAGTATGAACACTGAAGCTTTCTTT	CASSYPTGSMNTEAFF	TRBV6-8	TRBJ1-1
TGTGCCAGCAGCCTAGTGGTTAAGCAAAGGCTGGGTAAAGATACGCAGTATTTT	CASSLVVKQRLGKDTQYF	TRBV11-2	TRBJ2-3
TGTGCCAGCATGGGGGGGGGATCAGATACGCAGTATTTT	CASMGGGSDTQYF	TRBV5-6	TRBJ2-3
TGCATTGAGTGGAACACTGAAGCTTTCTTT	CIEWNTEAFF	TRBV29-1	TRBJ1-1
TGTGCCAGCAGGGGCACAGAAGCGGGTGAAGAGACCCAGTACTTC	CASRGTEAGEETQYF	TRBV27	TRBJ2-5
TGTGCCAGCAGCTTAGGGGGATTGGAGGAAGGAGAACGTGGGGGCTACACCTTC	CASSLGGLEEGERGGYTF	TRBV7-9	TRBJ1-2
TGTGCCAGCAGCGAGAGGGGGGAGGTGACAGATACGCAGTATTTT	CASSERGEVTDTQYF	TRBV28	TRBJ2-3
TGTGCCAGCAGCTTAGCGGACCCAGGTGCAACTAATGAAAAACTGTTTTTT	CASSLADPGATNEKLFF	TRBV7-6	TRBJ1-4
TGCGCCAGCAGCTCAGGAGGACTACTAGCGGGCCGGACCCAGTACTTC	CASSSGGLLAGRTQYF	TRBV5-1	TRBJ2-5
TGTGCCAGCAGCCAAGAAATGGTCCCTGAGTTCCAAAGGTTGTCCTGTATTCCGTTCTCTGGGGCCAACGTCCTGACTTTC	CASSQEMVPEFQRLSCIPFSGANVLTF	TRBV3-1	TRBJ2-6
TGTGCTGCACGGGACAGGGGAGAGGTCAGCTCCTATAATTCACCCCTCCACTTT	CAARDRGEVSSYNSPLHF	TRBV7-3	TRBJ1-6
TGTGCCAGCAGTGACAGGGCCATAGGATACGAGCAGTACTTC	CASSDRAIGYEQYF	TRBV6-2	TRBJ2-7
TGTGCCAGCAGCTGCCGTCTAGCCGGAGAGTACGAGCAGTACTTC	CASSCRLAGEYEQYF	TRBV5-6	TRBJ2-7
TGTGCCAGCAGCGGGACTTACTGCACGGGACAGAAGGACGAGACCCAGTACTTC	CASSGTYCTGQKDETQYF	TRBV9	TRBJ2-5
TGCAGCGCCGGTCAGGGGGCCTCAAGGGCCTACGAGCAGTACTTC	CSAGQGASRAYEQYF	TRBV29-1	TRBJ2-7
TGTGCCAGCAGCCTGGTCCGCCTGGTCCCCTATGGCTACACCTTC	CASSLVRLVPYGYTF	TRBV13	TRBJ1-2
TGTGCCAGCAGCTTAAGAGGGAGGATTCCTAATGAAAAACTGTTTTTT	CASSLRGRIPNEKLFF	TRBV11-1	TRBJ1-4
TGTGCCAGCAGTCCCAGGGGGCGACCTTCCTACGAGCAGTACTTC	CASSPRGRPSYEQYF	TRBV27	TRBJ2-7
TGCAGTGCTAGATGGACGGGAGCGGGAGCTTTCTTT	CSARWTGAGAFF	TRBV20-1	TRBJ1-1
TGTGCTAGTGGTTTGCCTCCACAGGGACCTGAGCCCTGGGGCTACGAGCAGTACTTC	CASGLPPQGPEPWGYEQYF	TRBV12-5	TRBJ2-7
TGTGCCAGCAGTGGACTAGCGACAGATACGCAGTATTTT	CASSGLATDTQYF	TRBV6-1	TRBJ2-3
TGTGCCATCAGTGAGCCGGACAGGGACATTTCAGGGGGCGGATTCTTT	CAISEPDRDISGGGFF	TRBV10-3	TRBJ1-1
TGTGCCAGCAGTGGGCTCCGGGGGCCTTACGACCCCTACGAGCAGTACTTC	CASSGLRGPYDPYEQYF	TRBV25-1	TRBJ2-7
TGTGCCGTACAGGGGGCGCAACGCACTGAAGCTTTCTTT	CAVQGAQRTEAFF	TRBV14	TRBJ1-1
TGCAGTGCTAGCAGGTCAGGGGACGACTACGAGCAGTACTTC	CSASRSGDDYEQYF	TRBV20-1	TRBJ2-7
TGTGCCAGCAGTTATCAGGGACAGGGGTCGCCTGAAAAACTGTTTTTT	CASSYQGQGSPEKLFF	TRBV6-5	TRBJ1-4
TGTGCCAGCAGGTGGACAGGGTTTAGACAATATGGCTACACCTTC	CASRWTGFRQYGYTF	TRBV6-1	TRBJ1-2
TGTGCCAGCAGCATTACAGGGGCCTACGAGCAGTACTTC	CASSITGAYEQYF	TRBV9	TRBJ2-7
TGCGCCAGCAGGACTCCGCAGAGATCTGAAGCTTTCTTT	CASRTPQRSEAFF	TRBV10-1	TRBJ1-1
TGTGCCAGCAGCCAAGATATTCAATGGCATAATCTTTACTCTGGGGCCAACGTCCTGACTTTC	CASSQDIQWHNLYSGANVLTF	TRBV3-1	TRBJ2-6
TGTGCCAGCAGTTACCAGGGGGCAGACCGTTTCGGGGGCTACAATGAGCAGTTCTTC	CASSYQGADRFGGYNEQFF	TRBV6-4	TRBJ2-1
TGTGCCAGCAGCCCTTGGGCAACAACAGGGATCAGCTACACCTTC	CASSPWATTGISYTF	TRBV11-3	TRBJ1-2
TGTGCCACCAGTGATCTTGACGGAGGCCCTTGTGAGCAGTTCTTC	CATSDLDGGPCEQFF	TRBV24-1	TRBJ2-1
TGTGCCAGCTCGAGTCCAAATGAGCAGTTCTTC	CASSSPNEQFF	TRBV7-3	TRBJ2-1
TGTGCGACAGGGGGGTTCGTGAACACTGAAGCTTTCTTT	CATGGFVNTEAFF	TRBV27	TRBJ1-1
TGCAGTGCCCGCGGGACAGCGGCCTACGAGCAGTACTTC	CSARGTAAYEQYF	TRBV20-1	TRBJ2-7
TGTGCCAGCAGTGTCCGGGACGAGCCGGTTCGTAACTATGGCTACACCTTC	CASSVRDEPVRNYGYTF	TRBV6-1	TRBJ1-2
TGTGCCAGCAGCGCCCAGGGCTGGCCGGCCCGCAGCAATCAGCCCCAGCATTTT	CASSAQGWPARSNQPQHF	TRBV3-1	TRBJ1-5
TGCGCCAGCAGCACCCGGGACACTGAAGCTTTCTTT	CASSTRDTEAFF	TRBV5-1	TRBJ1-1
TGTGCCATCAGCCCCAGCCTGGACTTGCAGCCCCAGCATTTT	CAISPSLDLQPQHF	TRBV10-3	TRBJ1-5
TGTGCCAGCAGACCCCGGGACAGGGATAACTATTACGAGCAGTACTTC	CASRPRDRDNYYEQYF	TRBV27	TRBJ2-7
TGTGCCAGCAGCTCCGGGACAGACCGACTTACAGATACGCAGTATTTT	CASSSGTDRLTDTQYF	TRBV9	TRBJ2-3
TGTGCCAGTCCGGGTACAGGGGGGAAGCACTACGAGCAGTACTTC	CASPGTGGKHYEQYF	TRBV6-5	TRBJ2-7
TGTGCCAGCAGCACTAGGGGGACCAACTACAATGAGCAGTTCTTC	CASSTRGTNYNEQFF	TRBV7-8	TRBJ2-1
TGTGCCAGCGGCCCCAGGGGGGGCCAAAGGTATGAGCAGTTCTTC	CASGPRGGQRYEQFF	TRBV11-3	TRBJ2-1
TGTGCCAGCAGCCATGGAGTAGCCTACGAGCAGTACTTC	CASSHGVAYEQYF	TRBV13	TRBJ2-7
TGTGCCAGGAGAGGGGGCAGGAGGGGTCAAGAGACCCAGTACTTC	CARRGGRRGQETQYF	TRBV27	TRBJ2-5
TGTGCCACCAGTGGCTGTGGGCTGGGTGACCTGGAGACCCAGTACTTC	CATSGCGLGDLETQYF	TRBV24-1	TRBJ2-5
TGTGCTAGTGGGGGGTCGATGGGGGGGGGACAGTATTTT	CASGGSMGGGQYF	TRBV12-5	TRBJ2-3
TGTGCCAGCCACCCCCATATGGGCACCCCCTCCTCTGACACTGAAGCTTTCTTT	CASHPHMGTPSSDTEAFF	TRBV25-1	TRBJ1-1
TGTGCCAGCAGAGCCGGGGACAGATGGGATGGCTACACCTTC	CASRAGDRWDGYTF	TRBV11-3	TRBJ1-2
TGTGCCAGCAGCGTAGACGCCCAACGGACAGGGGGGACTGGGTTACAGCCCCAGCATTTT	CASSVDAQRTGGTGLQPQHF	TRBV9	TRBJ1-5
TGTGCCACCAGTGATTTGCCACCCCGACCGGGACAGCTCTATGGCTACACCTTC	CATSDLPPRPGQLYGYTF	TRBV24-1	TRBJ1-2
TGCGCCACCAAAAAGTCTCCCACAGCCCTAGCCAAAAACATTCAGTACTTC	CATKKSPTALAKNIQYF	TRBV5-1	TRBJ2-4
TGTGCCAGCAGCGACCTAGTTGAGACCCAGTACTTC	CASSDLVETQYF	TRBV9	TRBJ2-5
TGTGCCAGCAGTTACTCTTGGGGTCCCTATGGCTACACCTTC	CASSYSWGPYGYTF	TRBV6-5	TRBJ1-2
TGTGCCAGCAGCCAAGGGAGGGAACTGTTTTTT	CASSQGRELFF	TRBV14	TRBJ1-4
TGTGCCAGCAGGGGGGTAGGGGCCTACGAGCAGTACTTC	CASRGVGAYEQYF	TRBV6-4	TRBJ2-7
TGTGCCAGCAGCCCTGACCGGGATCTTAAACATGAGCAGTTCTTC	CASSPDRDLKHEQFF	TRBV14	TRBJ2-1
TGTGCCAGCAGCGCGGGCAATGAGCAGTTCTTC	CASSAGNEQFF	TRBV9	TRBJ2-1
TGTGCCAGCAGTGGGGGACTAGCGGGAACCTTTACCTACGAGCAGTACTTC	CASSGGLAGTFTYEQYF	TRBV27	TRBJ2-7
TGTGCCAGCAGCTCGGACAGGAAGTGCACTCGGCAGCCCCAGCATTTT	CASSSDRKCTRQPQHF	TRBV13	TRBJ1-5
TGCAGTGCTGGTTTGGGACAGGGGAGTAACTATGGCTACACCTTC	CSAGLGQGSNYGYTF	TRBV20-1	TRBJ1-2
TGCAGTGCTACCGTGAAACCGGAGGGCTACACCTTC	CSATVKPEGYTF	TRBV20-1	TRBJ1-2
TGCAGTGCTAGGGCCAAGGGGGCAACTAATGAAAAACTGTTTTTT	CSARAKGATNEKLFF	TRBV20-1	TRBJ1-4
TGCAGCGGATCGGGGCGGTGTCGAGATACGCAGTATTTT	CSGSGRCRDTQYF	TRBV29-1	TRBJ2-3
TGTGCCACCAGTTCGGACAGGTGGAACTATGGCTACACCTTC	CATSSDRWNYGYTF	TRBV24-1	TRBJ1-2
TGCGCCAGCAGCCAAGACGGCCCAGGGGGCAGTCTAGGAAGCTCCTACGAGCAGTACTTC	CASSQDGPGGSLGSSYEQYF	TRBV4-1	TRBJ2-7
TGTGCCAGCATGAAGAGGGACAGGGGTTGGTCTAACTATGGCTACACCTTC	CASMKRDRGWSNYGYTF	TRBV6-6	TRBJ1-2
TGTGCCTTCGGCCGGGACTCAGAGACCCAGTACTTC	CAFGRDSETQYF	TRBV30	TRBJ2-5
TGTGCCAGCAGCTTGGGGCCGGGAGGGTGGACCTTAGGGGCTGAAGCTTTCTTT	CASSLGPGGWTLGAEAFF	TRBV5-6	TRBJ1-1
TGCGCCAGCAGCTTGGGGGGACGGATCTACGAGCAGTACTTC	CASSLGGRIYEQYF	TRBV5-1	TRBJ2-7
TGCAGTGCTTCCTGCGGAGGGATGTATGATGAGCAGTTCTTC	CSASCGGMYDEQFF	TRBV20-1	TRBJ2-1
TGCAGTGCTAGGGGGACAGGGCATAATCAGCCCCAGCATTTT	CSARGTGHNQPQHF	TRBV20-1	TRBJ1-5
TGTGCCAGCAGCTTAGGGCACCCCATCGCCGGGGAGCTGTTTTTT	CASSLGHPIAGELFF	TRBV7-2	TRBJ2-2
TGTGCCAGCAGCGGAGGGGGCAATGAGGGAGGTGAGACCCAGTACTTC	CASSGGGNEGGETQYF	TRBV11-3	TRBJ2-5
TGTGCCAGCAGTGCAGCCCAGGTCGACAGGACGGGCTACACCTTC	CASSAAQVDRTGYTF	TRBV6-5	TRBJ1-2
TGTGCCAGCAGCGCCTTAAATGGGCGGGGTCGCACAGATACGCAGTATTTT	CASSALNGRGRTDTQYF	TRBV7-6	TRBJ2-3
TGCGCCAGCAGCCTAGCCGGCGCCAATGAGCAGTTCTTC	CASSLAGANEQFF	TRBV4-1	TRBJ2-1
TGTGCCAGCAGCTTAGCTGGGGGGGAATACACTGAAGCTTTCTTT	CASSLAGGEYTEAFF	TRBV7-9	TRBJ1-1
TGTGCCAGTAGATTCCGTTCTCAGGCTCAGCCCCAGCATTTT	CASRFRSQAQPQHF	TRBV19	TRBJ1-5
TGTGCCAGCAGTTTAGAGTCTTGGGCGGCTGAAGCTTTCTTT	CASSLESWAAEAFF	TRBV28	TRBJ1-1
TGTGCCAGCAGCTTATACGCGACAGAAGGGGTTTGGAACTACGAGCAGTACTTC	CASSLYATEGVWNYEQYF	TRBV7-9	TRBJ2-7
TGTGCCACCAGCATGCCGGGACAGGGCACCTACAATGAGCAGTTCTTC	CATSMPGQGTYNEQFF	TRBV24-1	TRBJ2-1
TGTGCCAGTTCCCTTAGGACGGGGGAGCGGAACGAGCAGTACTTC	CASSLRTGERNEQYF	TRBV6-8	TRBJ2-7
TGTGCCAGCAGAGTCCGGGACAGTTCCACAGATACGCAGTATTTT	CASRVRDSSTDTQYF	TRBV7-3	TRBJ2-3
TGCAGTGCTGTCAATAAAGGGGACCAAATAGAGCAGTTCTTC	CSAVNKGDQIEQFF	TRBV20-1	TRBJ2-1
TGTGCCAGCAGACTGGGACAGGAGCAGTACTTC	CASRLGQEQYF	TRBV6-6	TRBJ2-7
TGCAGTGCCTCAGGGTGCAATCAGCCCCAGCATTTT	CSASGCNQPQHF	TRBV20-1	TRBJ1-5
TGTGCCAGCAGTGGGGACCCTCGACTAGTTCGGGATCCAAGCTCCTACAATGAGCAGTTCTTC	CASSGDPRLVRDPSSYNEQFF	TRBV6-4	TRBJ2-1
TGTGCCAGCAGCCAAAATATTGGGCAGTCCTACGAGCAGTACTTC	CASSQNIGQSYEQYF	TRBV3-1	TRBJ2-7
TGTGCCACTCCGGGACAGCGGGGTTTTAATTACTACGAGCAGTACTTC	CATPGQRGFNYYEQYF	TRBV19	TRBJ2-7
TGTGCCAGCTGCCCGAACGGGGGTGGCTACACCTTC	CASCPNGGGYTF	TRBV27	TRBJ1-2
TGTGCCAGCAGTGAAACGTTAGGGACTAGCGGGGAGTACTACAATGAGCAGTTCTTC	CASSETLGTSGEYYNEQFF	TRBV12-4	TRBJ2-1
TGTGCCAGCAGCAGCGACGGGACTTGGTCCTATGGCTACACCTTC	CASSSDGTWSYGYTF	TRBV5-6	TRBJ1-2
TGTGCCAAGCCAGATTGGGGGGCCCACCGCCAAGAGACCCAGTACTTC	CAKPDWGAHRQETQYF	TRBV6-6	TRBJ2-5
TGTGCCAGCAGCCAAGATCCCCACAGCGGGGCCGCCCAAAACATTCAGTACTTC	CASSQDPHSGAAQNIQYF	TRBV14	TRBJ2-4
TGCGCCAGCAGCTTGGCGGGACTACCGGTGAACACTGAAGCTTTCTTT	CASSLAGLPVNTEAFF	TRBV5-1	TRBJ1-1
TGTGCCACCAGCCCCCGTAGCTTTCGCACAGATACGCAGTATTTT	CATSPRSFRTDTQYF	TRBV24-1	TRBJ2-3
TGTGCCAGCAGCGGGACAGGGGTAAAAGAGACCCAGTACTTC	CASSGTGVKETQYF	TRBV11-1	TRBJ2-5
TGCAGTGCTAAGGTTATGGCCCATGAAAAACTGTTTTTT	CSAKVMAHEKLFF	TRBV20-1	TRBJ1-4
TGTGCCAGCTACTCTGGAAACACCATATATTTT	CASYSGNTIYF	TRBV11-3	TRBJ1-3
TGTGCCAGCAGTGGGCCGGGACAGGGCACTGAAGCTTTCTTT	CASSGPGQGTEAFF	TRBV27	TRBJ1-1
TGTGCCAGCACGTCTGGACAGGGAATAGTACAAGATCAGATGAACACTGAAGCTTTCTTT	CASTSGQGIVQDQMNTEAFF	TRBV28	TRBJ1-1
TGTGCCTGGAGTGAGGACAGGGGGCACCTAGATGAGCAGTTCTTC	CAWSEDRGHLDEQFF	TRBV30	TRBJ2-1
TGTGCCAGGGTCGAGAAAGAGACCCAGTACTTC	CARVEKETQYF	TRBV2	TRBJ2-5
TGTGCCAGCTTGACCATGAACACTGAAGCTTTCTTT	CASLTMNTEAFF	TRBV12-4	TRBJ1-1
TGTGCCAGTAGTATACCAAACCAGCCCCAGCATTTT	CASSIPNQPQHF	TRBV19	TRBJ1-5
TGTGCCAGTAGTATAGAGAGACAGGGAACGTATGGCTACACCTTC	CASSIERQGTYGYTF	TRBV19	TRBJ1-2
TGCAGTGCCAGGGCGTCAACCGGTGTTTCAGCCAAAAACATTCAGTACTTC	CSARASTGVSAKNIQYF	TRBV20-1	TRBJ2-4
TGTGCCAGCAGTCAGCAGACAGGGGGCTCCGAGCAGTACTTC	CASSQQTGGSEQYF	TRBV28	TRBJ2-7
TGCAGTGCCCCGACAGGGGTTCCTGGGGCCAACGTCCTGACTTTC	CSAPTGVPGANVLTF	TRBV20-1	TRBJ2-6
TGTGCCAGCAGCTTGGCCGGACACACCTCCTACGAGCAGTACTTC	CASSLAGHTSYEQYF	TRBV5-5	TRBJ2-7
TGTGCTAGTGGTCCAGCGGGACTCTTGGTCACAGATACGCAGTATTTT	CASGPAGLLVTDTQYF	TRBV12-5	TRBJ2-3
TGTGCCAAAACCTTAATTGACAATGAGCAGTTCTTC	CAKTLIDNEQFF	TRBV19	TRBJ2-1
TGCGCCAGCAGCCAGGCAGGCGGGACAGGTTTTGGACGCAATCAGCCCCAGCATTTT	CASSQAGGTGFGRNQPQHF	TRBV4-1	TRBJ1-5
TGTGCCAGCAGCTCAGCACTCTCCTACGAGCAGTACTTC	CASSSALSYEQYF	TRBV7-9	TRBJ2-7
TGTGCCAGCAGCTTGGGGCCCCTGGTCAGGTTCACTGAAGCTTTCTTT	CASSLGPLVRFTEAFF	TRBV5-6	TRBJ1-1
TGTGCCAGCAGGCAGCGGGATGGCGAGCAGTACTTC	CASRQRDGEQYF	TRBV12-4	TRBJ2-7
TGCAGTGCTCCACCCCGACAGGGGCAGGGTGGCTACGAGCAGTACTTC	CSAPPRQGQGGYEQYF	TRBV20-1	TRBJ2-7
TGTGCCAGCGTCTGGACAGTCCCTAACGAGCAGTACTTC	CASVWTVPNEQYF	TRBV28	TRBJ2-7
TGTGCCAGCAGCTTACGGAATGAGCAGTTCTTC	CASSLRNEQFF	TRBV7-9	TRBJ2-1
TGTGCCAGCAGCTTAGTTCCAAAGGACGGTCATGGAGCAGATGGCTACACCTTC	CASSLVPKDGHGADGYTF	TRBV5-8	TRBJ1-2
TGTGCCAGCAGCTCCCACAGGGGGCGATTAATCACAGATACGCAGTATTTT	CASSSHRGRLITDTQYF	TRBV7-9	TRBJ2-3
TGTGCCAGCTCACCTGTATGGAACACTGAAGCTTTCTTT	CASSPVWNTEAFF	TRBV18	TRBJ1-1
TGTGCCAGCAGCTCCGTCAATCTGGACAGGGGCACAGATACGCAGTATTTT	CASSSVNLDRGTDTQYF	TRBV7-3	TRBJ2-3
TGCGCCAGCAGCGTAGCATTCCCGGGTCTTGAATTAGAAAGCAGCACAGATACGCAGTATTTT	CASSVAFPGLELESSTDTQYF	TRBV4-1	TRBJ2-3
TGTGCCACCAGCAGAGGAAACCTCCCTTGGGCCTCGCAGTTCTTC	CATSRGNLPWASQFF	TRBV15	TRBJ2-1
TGTGCCAGCATAGTTGCCCGGGACAGGGGAGCTCCCTACGAGCAGTACTTC	CASIVARDRGAPYEQYF	TRBV7-9	TRBJ2-7
TGTGCCAGCAGTTTAGGACTAGATTGGGAAGAGAGCACAGATACGCAGTATTTT	CASSLGLDWEESTDTQYF	TRBV27	TRBJ2-3
TGTGCCAGCAGCAAACGAGGGGAGACCCACCATTCACCCCTCCACTTT	CASSKRGETHHSPLHF	TRBV13	TRBJ1-6
TGTGCCAGCAGTGAACCCAGGGGACCGGCTGAAGCTTTCTTT	CASSEPRGPAEAFF	TRBV2	TRBJ1-1
TGCAGTGCTAGAGATCCCCGGACCGAGCAGTACTTC	CSARDPRTEQYF	TRBV20-1	TRBJ2-7
TGCAGTGCTAGTGTTTTCCTGGGGATCCCCACAGATACGCAGTATTTT	CSASVFLGIPTDTQYF	TRBV20-1	TRBJ2-3
TGTGCTAGTGGTTTGGGGGGATGGGGCTCTGAAGCTTTCTTT	CASGLGGWGSEAFF	TRBV12-5	TRBJ1-1
TGCAGTGCTAGAAAAACCGATGAGCAGTTCTTC	CSARKTDEQFF	TRBV20-1	TRBJ2-1
TGTGCCAGCAGATTCAAGGGACTAGGTCATGAGCAGTTCTTC	CASRFKGLGHEQFF	TRBV2	TRBJ2-1
TGTAACCTGCGGGAGGTTCGCTGCACAGATACGCAGTATTTT	CNLREVRCTDTQYF	TRBV27	TRBJ2-3
TGTGCCAGCACCTCAGCTAGCACAGATACGCAGTATTTT	CASTSASTDTQYF	TRBV12-3	TRBJ2-3
TGCAGCGTCCCTGCGGGGGGGCGTCACGAGACCCAGTACTTC	CSVPAGGRHETQYF	TRBV29-1	TRBJ2-5
TGTGCCAGTAGTGGGACTAGTTCCGCGAACACCGGGGAGCTGTTTTTT	CASSGTSSANTGELFF	TRBV19	TRBJ2-2
TGTGCCAGCAGTTTAAATTGCCCGACAGGGGTCCATGGCTACACCTTC	CASSLNCPTGVHGYTF	TRBV12-3	TRBJ1-2
TGCGCCAGCAGGAAGGACCCCCAGTACCGGGGTTCCTACGAGCAGTACTTC	CASRKDPQYRGSYEQYF	TRBV5-1	TRBJ2-7
TGTGCCAGCATCGTTAGACAGGGCAACACTGAAGCTTTCTTT	CASIVRQGNTEAFF	TRBV27	TRBJ1-1
TGTGCCAGCAGCAGAAAGACAGGGCGGATGGCCCAGCATTTT	CASSRKTGRMAQHF	TRBV6-5	TRBJ1-5
TGTGCCACCAGTGATTTTAATGGCACATATGGGAACTATGGCTACACCTTC	CATSDFNGTYGNYGYTF	TRBV24-1	TRBJ1-2
TGTGCCAGCAGCCAAGCAGGGTATACTCAAGAGACCCAGTACTTC	CASSQAGYTQETQYF	TRBV14	TRBJ2-5
TGTGCCAGCAGCGGACGAATGTTAGCTAACTATGGCTACACCTTC	CASSGRMLANYGYTF	TRBV13	TRBJ1-2
TGTGCCAGCAGTTTATGGGGAACAGGGGGGTACAATGAGCAGTTCTTC	CASSLWGTGGYNEQFF	TRBV12-4	TRBJ2-1
TGTGCCAGCAGCTTAGCCAGTCGTTGCCGGGACGGATCTCAGCCCCAGCATTTT	CASSLASRCRDGSQPQHF	TRBV11-3	TRBJ1-5
TGTGCCAGCAGCTTAGGCAACGCCTCGCAGGGGCGCTCTGGGGCCAACGTCCTGACTTTC	CASSLGNASQGRSGANVLTF	TRBV7-2	TRBJ2-6
TGTGCCACCAGTGATTTAATAAGTACAGGGTCTGGGGCCAACGTCCTGACTTTC	CATSDLISTGSGANVLTF	TRBV24-1	TRBJ2-6
TGCAGTGCTAGAGATGGACAGATCGAGCAGTACTTC	CSARDGQIEQYF	TRBV20-1	TRBJ2-7
TGCGCCAAGCGGGGCCCCACAGATACGCAGTATTTT	CAKRGPTDTQYF	TRBV10-1	TRBJ2-3
TGTGCCAGCAGTAGGGGTCCAACCTACGAGCAGTACTTC	CASSRGPTYEQYF	TRBV6-1	TRBJ2-7
TGTGCCAGTAGTATCCGGACAGGTGGAAACGAGCAGTACTTC	CASSIRTGGNEQYF	TRBV19	TRBJ2-7
TGTGCCACCAGTGATTCGCGGCTTTGGGAAGGTTCACCCCTCCACTTT	CATSDSRLWEGSPLHF	TRBV24-1	TRBJ1-6
TGCGCCAGCAGCCGACTTGGACAGGGGCTTAAGGGCTACACCTTC	CASSRLGQGLKGYTF	TRBV10-2	TRBJ1-2
TGTGCCAGTAGTTCACTAGCGGGCTCCTACGAGCAGTACTTC	CASSSLAGSYEQYF	TRBV19	TRBJ2-7
TGTGCCAGCAGCTGGCCCGGGCCCTACTCCTCCTACGAGCAGTACTTC	CASSWPGPYSSYEQYF	TRBV5-4	TRBJ2-7
TGTGCCAGCAGGTCGGGGGGTGAGCAGTTCTTC	CASRSGGEQFF	TRBV28	TRBJ2-1
TGTGCCAGCAACACGGGAGGGGACTATGGCTACACCTTC	CASNTGGDYGYTF	TRBV6-1	TRBJ1-2
TGTGCCAGCAGCAGGGGACGGGACGATGGCTACACCTTC	CASSRGRDDGYTF	TRBV7-3	TRBJ1-2
TGTGCCAGCAGTCCCCCCGAGGGCCTGGACACTGAAGCTTTCTTT	CASSPPEGLDTEAFF	TRBV6-4	TRBJ1-1
TGCAGTGCTCAAAAACAGGGGTCCCGAGCCGGGGAGCTGTTTTTT	CSAQKQGSRAGELFF	TRBV20-1	TRBJ2-2
TGTGCCACCCGGGAGGGCGATGGCTACACCTTC	CATREGDGYTF	TRBV13	TRBJ1-2
TGTGCCAGCAGTGTCCAATCGTTGGGGACGAACATTCAGTACTTC	CASSVQSLGTNIQYF	TRBV6-4	TRBJ2-4
TGTGCCAGCAGCCCCTGCACCCTGCAGAATCAGCCCCAGCATTTT	CASSPCTLQNQPQHF	TRBV7-4	TRBJ1-5
TGTGCCAGCACCCGACAGGGTAGCACAGATACGCAGTATTTT	CASTRQGSTDTQYF	TRBV6-1	TRBJ2-3
TGTGCCAGCAGCGTAGCTTTCCCTGACATTGATACGCAGTATTTT	CASSVAFPDIDTQYF	TRBV9	TRBJ2-3
TGTGCCAGCAGGGTAACTCGGGAAGCTTTCTTT	CASRVTREAFF	TRBV6-1	TRBJ1-1
TGTGCCAGCAGCCGGAATCCCGGGACAGTAGGGGGCGGGGAGCTGTTTTTT	CASSRNPGTVGGGELFF	TRBV11-3	TRBJ2-2
TGTGCCAGCCAAGAGCCGGGACAGCGGACCGGTGAAAAACTGTTTTTT	CASQEPGQRTGEKLFF	TRBV5-4	TRBJ1-4
TGTGCCAGCAGCTTGGGACGGGAAGGCCGACTGCCGAAGGTACGCTCTGGAAACACCATATATTTT	CASSLGREGRLPKVRSGNTIYF	TRBV5-4	TRBJ1-3
TGTGCCAGCAGCGACGCCGGGACGGACAATGAGCAGTTCTTC	CASSDAGTDNEQFF	TRBV13	TRBJ2-1
TGTGCCAGCAGTCGGGCCTTAGGGGGCCCCCAGCATTTT	CASSRALGGPQHF	TRBV12-4	TRBJ1-5
TGTGCCAGCAGCGGACAGGGGGGCTATAATTCACCCCTCCACTTT	CASSGQGGYNSPLHF	TRBV4-2	TRBJ1-6
TGTGCCAGCAGACACCTAGCGGGGAGAAAAAACATTCAGTACTTC	CASRHLAGRKNIQYF	TRBV11-2	TRBJ2-4
TGCAGTGCTATTCCCATGGTGAGGAGGGGAGAGCAGTACTTC	CSAIPMVRRGEQYF	TRBV20-1	TRBJ2-7
TGTGCCAGCAGCTTATCCCGGGCGGAAGCTTTCTTT	CASSLSRAEAFF	TRBV5-6	TRBJ1-1
TGTGCCAGCAGCCAAGTACGACTCGGGAGCTCTGGAAACACCATATATTTT	CASSQVRLGSSGNTIYF	TRBV3-1	TRBJ1-3
TGTGTAGGGGCCTACAATGAGCAGTTCTTC	CVGAYNEQFF	TRBV6-1	TRBJ2-1
TGTGCCAGCAGGACTCTCCCAAAGTGGGGGATCGAGCAGTACTTC	CASRTLPKWGIEQYF	TRBV7-9	TRBJ2-7
TGTGCCCGGGGGTTGAGGCTCAATCAGCCCCAGCATTTT	CARGLRLNQPQHF	TRBV24-1	TRBJ1-5
TGCGCCAGCAGCTTTTCGGAAGAACATGAGCAGTTCTTC	CASSFSEEHEQFF	TRBV10-1	TRBJ2-1
TGTGCCAGCAGTTTAGGGGCGTTCTACAGGGGAGACCCAATCACAGATACGCAGTATTTT	CASSLGAFYRGDPITDTQYF	TRBV28	TRBJ2-3
TGTGCCAGCAGCGGACTAGCGGGTAGTGAGCAGTTCTTC	CASSGLAGSEQFF	TRBV9	TRBJ2-1
TGCAGTGCTAGAGAAAATCCTAAACTCCCCGTGGTGGGGCACTATGGCTACACCTTC	CSARENPKLPVVGHYGYTF	TRBV20-1	TRBJ1-2
TGTGCCAGCAGCCTTCAGGGGGCCGAGCAGTACTTC	CASSLQGAEQYF	TRBV14	TRBJ2-7
TGTGCCAGGGGGGGCCGTGAGCAGTTCTTC	CARGGREQFF	TRBV6-3	TRBJ2-1
TGTGCCAGCAGCGTCCCAATTAATCCCGACGGGGGAGCCGGGGAGCTGTTTTTT	CASSVPINPDGGAGELFF	TRBV7-3	TRBJ2-2
TGTGCCAGCAGCGGCGAGATCAACGGACATCATTACGAGCAGTACTTC	CASSGEINGHHYEQYF	TRBV7-9	TRBJ2-7
TGCGCCAGCAGCTCTCGAGCCCAAGAAAAACTGTTTTTT	CASSSRAQEKLFF	TRBV10-1	TRBJ1-4
TGTGCCAGCAGTTACACCCTAGCGGGAGATGGGGGCTCCTACGAGCAGTACTTC	CASSYTLAGDGGSYEQYF	TRBV6-5	TRBJ2-7
TGCGCCAGCAGCCAGAGACAGGGTGGAAGTTCTGGGGCCAACGTCCTGACTTTC	CASSQRQGGSSGANVLTF	TRBV4-1	TRBJ2-6
TGTGCCTGGAGTGTAGAATGTGGGGCACAGGGGGACAATGAGCAGTTCTTC	CAWSVECGAQGDNEQFF	TRBV30	TRBJ2-1
TGTGCCAGCAGCGGTAGCCCCCTGAGGACAGGGGGCAATCAGCCCCAGCATTTT	CASSGSPLRTGGNQPQHF	TRBV13	TRBJ1-5
TGTGCCAGCAGCTTAGGGACAGTAATTAAATCCTACGAGCAGTACTTC	CASSLGTVIKSYEQYF	TRBV11-2	TRBJ2-7
TGTGCCAGCAGTTACTCACCTACACATCTCATGACAGAAAATCAGCCCCAGCATTTT	CASSYSPTHLMTENQPQHF	TRBV6-2	TRBJ1-5
TGTGCCAGCAGTTCTCAGGGGAACACTGAAGCTTTCTTT	CASSSQGNTEAFF	TRBV27	TRBJ1-1
TGCGCCAGCAGCCTAGCGGGGGAGACCCAGTACTTC	CASSLAGETQYF	TRBV10-1	TRBJ2-5
TGCGCCAGCATTACGACAGGGCGGGGCACAGATACGCAGTATTTT	CASITTGRGTDTQYF	TRBV5-1	TRBJ2-3
TGTGCCAGCAGTTTTGAGGTCCATGAGCAGTTCTTC	CASSFEVHEQFF	TRBV12-3	TRBJ2-1
TGTGCCACCACGGTCGGGGCCCTTTGTGGAGAGACCCAGTACTTC	CATTVGALCGETQYF	TRBV11-2	TRBJ2-5
TGTGCCAGCAGTGAATTCCCCCACCCAACGACGGGCGGGGAGCTGTTTTTT	CASSEFPHPTTGGELFF	TRBV25-1	TRBJ2-2
TGCAGTGCTCCCCGGTGGAGTGCCCAAGAGACCCAGTACTTC	CSAPRWSAQETQYF	TRBV20-1	TRBJ2-5
TGTGCCAGCAGACGGTGGGGGGAGCAGTTCTTC	CASRRWGEQFF	TRBV6-2	TRBJ2-1
TGCGCCAGCAGCTTGCACGGTACAGGGGAGACCCAGTACTTC	CASSLHGTGETQYF	TRBV5-1	TRBJ2-5
TGTGCCATTCCATTCCCTCGGACAGGGACGAAAGGGGCCTACGAGCAGTACTTC	CAIPFPRTGTKGAYEQYF	TRBV10-3	TRBJ2-7
TGTGCAATCTCCCTTGCCGGGGGTAGAAACACCATATATTTT	CAISLAGGRNTIYF	TRBV11-3	TRBJ1-3
TGTGCCAGCAGTTACCGGGAAGGCACAGATACGCAGTATTTT	CASSYREGTDTQYF	TRBV6-2	TRBJ2-3
TGCGCCAGCAGCTTAGATGACGGGGACCAAGAGACCCAGTACTTC	CASSLDDGDQETQYF	TRBV5-1	TRBJ2-5
TGCAGCTTCCGCGGGGTCGATGAGCAGTTCTTC	CSFRGVDEQFF	TRBV29-1	TRBJ2-1
TGTGCCAGCAGCGATCGAGGGACTAGCGGGGGGCACAATGAGCAGTTCTTC	CASSDRGTSGGHNEQFF	TRBV7-4	TRBJ2-1
TGTGCCAGTAGTTCCTCGGGGGATGGGGGACGAGCTTTCTTT	CASSSSGDGGRAFF	TRBV19	TRBJ1-1
TGCAGCGGGAGAAACCCCGAAGGACGTGGACACACCGGGGAGCTGTTTTTT	CSGRNPEGRGHTGELFF	TRBV29-1	TRBJ2-2
TGTGCCAGCAGTGACAGGGGTTCGGCGATAGGGGCCAACGTCCTGACTTTC	CASSDRGSAIGANVLTF	TRBV12-3	TRBJ2-6
TGTGCCAGCAGTTGGGGACAGCTTGGAGACGAGCAGTACTTC	CASSWGQLGDEQYF	TRBV6-2	TRBJ2-7
TGTGCCAGCAGTGTAACCCCGGGGGTGTACAATGAGCAGTTCTTC	CASSVTPGVYNEQFF	TRBV28	TRBJ2-1
TGCGCCAGCAGCTTGGAATCCAGGGGGGGCGGGAGGCGGGACACCGGGGAGCTGTTTTTT	CASSLESRGGGRRDTGELFF	TRBV5-1	TRBJ2-2
TGTGCCAGCACATATCCCGGGACAGGGTACACTGAAGCTTTCTTT	CASTYPGTGYTEAFF	TRBV12-3	TRBJ1-1
TGTGCCAGCCTAGACAGGGAGGGAATGAACACTGAAGCTTTCTTT	CASLDREGMNTEAFF	TRBV9	TRBJ1-1
TGTGCCAGCAGCCCCGGACCCACAGGGGGGCGGTACGAGCAGTACTTC	CASSPGPTGGRYEQYF	TRBV4-2	TRBJ2-7
TGTGCCACCAGCAGCTTCCTAGCATATTGCCAAGAGACCCAGTACTTC	CATSSFLAYCQETQYF	TRBV15	TRBJ2-5
TGTGCCAGCAGTGACCGAGCGGGATCTTACAATGAGCAGTTCTTC	CASSDRAGSYNEQFF	TRBV6-1	TRBJ2-1
TGTGCCAGCGTCCCCAACATGGACACTGAAGCTTTCTTT	CASVPNMDTEAFF	TRBV6-4	TRBJ1-1
TGTGCCAGCAGTTTTGTCAGGGACAGGGGTCCATACGAGCAGTACTTC	CASSFVRDRGPYEQYF	TRBV12-3	TRBJ2-7
TGTGCCAGCAGCTTGCTTTCCCACGGGGCCAGAAGAGGCTCTGGGGCCAACGTCCTGACTTTC	CASSLLSHGARRGSGANVLTF	TRBV5-4	TRBJ2-6
TGCGCCAGCAGCCAAGCGGGACTAGACACTGGTGATACGCAGTATTTT	CASSQAGLDTGDTQYF	TRBV4-3	TRBJ2-3
TGTGCCAGCAGCCGGACGGTGGACTCCTACGAGCAGTACTTC	CASSRTVDSYEQYF	TRBV7-3	TRBJ2-7
TGTGCCAGCAGTGAAGCTGGACTAGCGGGGTTAAAAATACACCAAGAGACCCAGTACTTC	CASSEAGLAGLKIHQETQYF	TRBV6-1	TRBJ2-5
TGCACTGGAAAAAAGCGGGAGCCCTCCTACGAGCAGTACTTC	CTGKKREPSYEQYF	TRBV20-1	TRBJ2-7
TGTGCCAGCAGCGCCACTAGCGGGATGACCGCCTACGAGCAGTACTTC	CASSATSGMTAYEQYF	TRBV11-3	TRBJ2-7
TGCGCCAGCAGTGAGTCGGAGACAGGGGAAGGCGAAGGAAACACCATATATTTT	CASSESETGEGEGNTIYF	TRBV10-2	TRBJ1-3
TGCGCCAGCCCTCGCGGGGGCCCTAATAGCACAGATACGCAGTATTTT	CASPRGGPNSTDTQYF	TRBV5-1	TRBJ2-3
TGTGCCAGCAGCTTAGCCCTCCTACCCAGGACAGGGGGCTATAGCAATCAGCCCCAGCATTTT	CASSLALLPRTGGYSNQPQHF	TRBV7-8	TRBJ1-5
TGCGCCAGCAGCCAAAAGGGGCCCACCGGGGAGCTGTTTTTT	CASSQKGPTGELFF	TRBV4-1	TRBJ2-2
TGTGCCACGAGCGGGACCCCTGTGAACACTGAAGCTTTCTTT	CATSGTPVNTEAFF	TRBV6-5	TRBJ1-1
TGTGCCACCAGTATAGCTATGAACACTGAAGCTTTCTTT	CATSIAMNTEAFF	TRBV24-1	TRBJ1-1
TGTGCCAGCAGCAGGGGTGGCCCTGCAACTAATGAAAAACTGTTTTTT	CASSRGGPATNEKLFF	TRBV13	TRBJ1-4
TGTGCCAGCAGTGACAATTGGGACAGGTCACAGCCCCAGCATTTT	CASSDNWDRSQPQHF	TRBV6-4	TRBJ1-5
TGTGCCAGCAGCCCCTACAAACCGACGGGCCAGCCCCAGCATTTT	CASSPYKPTGQPQHF	TRBV6-2	TRBJ1-5
TGTGCCAGCCCTTTTGACAGGAACCCGGGACCCCGTACCTACGAGCAGTACTTC	CASPFDRNPGPRTYEQYF	TRBV5-4	TRBJ2-7
TGTGCCAGCAGCTACTCAGGGGGTTTCCGAGATATTTATAGCAATCAGCCCCAGCATTTT	CASSYSGGFRDIYSNQPQHF	TRBV7-9	TRBJ1-5
TGTGCCACCAGTGATTGGAAAAGGACAGGTAGGGTCTACGAGCAGTACTTC	CATSDWKRTGRVYEQYF	TRBV24-1	TRBJ2-7
TGTGCCAGCAGTTTGGGGGCTCAATATCAGCCCCAGCATTTT	CASSLGAQYQPQHF	TRBV27	TRBJ1-5
TGTGCCACCAGTGATTACGGCAGGTATAAGGCGGAGAGCTCTGGAAACACCATATATTTT	CATSDYGRYKAESSGNTIYF	TRBV24-1	TRBJ1-3
TGTGCCAGCAGCTTTCAGGAAGGGGAGGGTGGCTACACCTTC	CASSFQEGEGGYTF	TRBV5-4	TRBJ1-2
TGTGCCAGCAGCCAAGAACAGGGGGGGCGTCTGACCCAGTACTTC	CASSQEQGGRLTQYF	TRBV14	TRBJ2-5
TGTGCCAGCAGTGACTGGGGCTTCTTCTCCTATAATTCACCCCTCCACTTT	CASSDWGFFSYNSPLHF	TRBV2	TRBJ1-6
TGTGCCAGCAGTGAAGGGACTAGACTCTTTCGCCCAAAGAACACTGAAGCTTTCTTT	CASSEGTRLFRPKNTEAFF	TRBV25-1	TRBJ1-1
TGTGCCAGCAGTGAAGTCGGGGTTCAGGGGGGACCTAACACCGGGGAGCTGTTTTTT	CASSEVGVQGGPNTGELFF	TRBV6-1	TRBJ2-2
TGCAGTGCGATGGACAATCACACAGATACGCAGTATTTT	CSAMDNHTDTQYF	TRBV20-1	TRBJ2-3
TGTGCCAGTAGTATGCCCAGGGGTTTGAACACTGAAGCTTTCTTT	CASSMPRGLNTEAFF	TRBV19	TRBJ1-1
TGTGCCAGCAGACCGAGCCCGACGCACCACACTGAAGCTTTCTTT	CASRPSPTHHTEAFF	TRBV6-6	TRBJ1-1
TGTGCCACCCCCCGGGGGGGGGGGAGCTCCTACAATGAGCAGTTCTTC	CATPRGGGSSYNEQFF	TRBV24-1	TRBJ2-1
TGCGCCAGCAGCCAAAGTAGGACAAACACCGGGGAGCTGTTTTTT	CASSQSRTNTGELFF	TRBV4-3	TRBJ2-2
TGTGCCAGCAGCCAAGATAGCCGGGACAGGGTATGGTACGAGCAGTACTTC	CASSQDSRDRVWYEQYF	TRBV3-1	TRBJ2-7
TGCGCCAGCAGCCAAGACATGAGGGGAGAGCAGTACTTC	CASSQDMRGEQYF	TRBV4-1	TRBJ2-7
TGCGCCAGCAGCCAAGAGGCCGGACGACTAGTTGAGCAGTTCTTC	CASSQEAGRLVEQFF	TRBV4-1	TRBJ2-1
TGTGCCAGCAGCTTAGTCCTTAAGGACAGGGGAAACGAGCAGTACTTC	CASSLVLKDRGNEQYF	TRBV7-2	TRBJ2-7
TGTGCCAGCAGTGAACCCGGGACAGGGCTGGCCAATAACTATGGCTACACCTTC	CASSEPGTGLANNYGYTF	TRBV2	TRBJ1-2
TGCGCCAGCAGCTACCCGAAACCGGGACTTTTTGCCCCCACAGATACGCAGTATTTT	CASSYPKPGLFAPTDTQYF	TRBV5-1	TRBJ2-3
TGTGCCAGCAGCCAAAAAGGGACAAGCACCGGGGAGCTGTTTTTT	CASSQKGTSTGELFF	TRBV14	TRBJ2-2
TGTGCCAGCAGTATAGGCCGGGACCGTCGTGAGACCCAGTACTTC	CASSIGRDRRETQYF	TRBV6-4	TRBJ2-5
TGTGCCAGCAGGGGGACCGAGGTGGGACAGGTCCCCTACGAGCAGTACTTC	CASRGTEVGQVPYEQYF	TRBV7-2	TRBJ2-7
TGTGCCACCAGTGTCTCCAGAACCTACGAGCAGTACTTC	CATSVSRTYEQYF	TRBV24-1	TRBJ2-7
TGTGCCATAATACAGGGTCCCCCGGACTCTGGAAACACCATATATTTT	CAIIQGPPDSGNTIYF	TRBV2	TRBJ1-3
TGTGCCAGCAGTGAAGCGGGTCGGGACAGATTTTCCTCTGGAAACACCATATATTTT	CASSEAGRDRFSSGNTIYF	TRBV6-1	TRBJ1-3
TGTGCCAGCAGTGAAGAGAAGGTGGGGGCCTACGAGCAGTACTTC	CASSEEKVGAYEQYF	TRBV6-1	TRBJ2-7
TGCAGTGCTAGACCCACACTTCCTGGGACTCCGCGGCTCTACGAGCAGTACTTC	CSARPTLPGTPRLYEQYF	TRBV20-1	TRBJ2-7
TGTGCCAGCCATAACCGACAGGGGACGCCCCACTCCCTCCACTTT	CASHNRQGTPHSLHF	TRBV25-1	TRBJ1-6
TGTGCCAGCTCACCAGTACTAGCGGGAGGATCCTACGAGCAGTACTTC	CASSPVLAGGSYEQYF	TRBV18	TRBJ2-7
TGTGCCAGCAGCGCTGTGAGCTCTAGCGGGAGTGAGCAGTTCTTC	CASSAVSSSGSEQFF	TRBV12-4	TRBJ2-1
TGTGCCAGCAGTAGGACAGGGTCCTCTAATGAAAAACTGTTTTTT	CASSRTGSSNEKLFF	TRBV27	TRBJ1-4
TGTGCCAGCAGCTTAGGACGAAACAGGGACCGGAACTATGGCTACACCTTC	CASSLGRNRDRNYGYTF	TRBV11-2	TRBJ1-2
TGTGCCAGCAGTGATTTTTTAACCCACAGGGACTATGGCTACACCTTC	CASSDFLTHRDYGYTF	TRBV6-4	TRBJ1-2
TGTGCCAGCCGGTCCCGTGGCCCGGGCGGCACAGATACGCAGTATTTT	CASRSRGPGGTDTQYF	TRBV9	TRBJ2-3
TGCGCCAGCAGCGGAATTTCTCTAGGGGTGAACACCGGGGAGCTGTTTTTT	CASSGISLGVNTGELFF	TRBV5-1	TRBJ2-2
TGTGCCAGCAGCTCGACAGGGTGGGGCAGGCCCTACGAGCAGTACTTC	CASSSTGWGRPYEQYF	TRBV13	TRBJ2-7
TGTGCCAGCTCACAGGGCGGCTACGAGCAGTACTTC	CASSQGGYEQYF	TRBV11-3	TRBJ2-7
TGTGCCAGCAGCGTGGGCCGCCGGGGGCTGACTAATTCACCCCTCCACTTT	CASSVGRRGLTNSPLHF	TRBV7-3	TRBJ1-6
TGTGCCAGCAGTTTTGGGGGCGTATCCTATGGCTACACCTTC	CASSFGGVSYGYTF	TRBV12-3	TRBJ1-2
TGTGCCAGCAGCTACAGGGCTAATGAAAAACTGTTTTTT	CASSYRANEKLFF	TRBV7-3	TRBJ1-4
TGTGCCAGCAGCGGATCCGGGACAACGGGTAATCAGCCCCAGCATTTT	CASSGSGTTGNQPQHF	TRBV7-2	TRBJ1-5
TGTGCCAGCAGTGATCGGGACAGGGTGTCGGGGCAGTACTTC	CASSDRDRVSGQYF	TRBV6-1	TRBJ2-7
TGCGCCAGCAGCCGTAGGGGGATCTATGGCTACACCTTC	CASSRRGIYGYTF	TRBV5-1	TRBJ1-2
TGCAGTGCAATCGAGGGGGATGCTGGTGAGACCCAGTACTTC	CSAIEGDAGETQYF	TRBV20-1	TRBJ2-5
TGTGCCAGCAGCGACGACAAGAGGCTACGGGAGGGGTGCTATGGCTACACCTTC	CASSDDKRLREGCYGYTF	TRBV9	TRBJ1-2
TGTGCCAGCAGCCCGGCATACTCCTACAATGAGCAGTTCTTC	CASSPAYSYNEQFF	TRBV9	TRBJ2-1
TGTGCTAGTGGTCCCCGGTTCTGTCCATTCCAGGGCTATGGCTACACCTTC	CASGPRFCPFQGYGYTF	TRBV12-5	TRBJ1-2
TGTGCCAGTAGTCCGGGGAGCTCTGGAAACACCATATATTTT	CASSPGSSGNTIYF	TRBV19	TRBJ1-3
TGCAGTGCTAGCATACCCAAGATGCAGTTCTTC	CSASIPKMQFF	TRBV20-1	TRBJ2-1
TGTGCCAGCGTCGGAGTCCCAGACTCTGGAAACACCATATATTTT	CASVGVPDSGNTIYF	TRBV28	TRBJ1-3
TGTGCCAGCAGCCAAGATCGGACAGGTCGGGTAGCTGGAAACACCATATATTTT	CASSQDRTGRVAGNTIYF	TRBV4-2	TRBJ1-3
TGTGCCAGCAGCTTACCAGGGAAAGGCCCCCGGAATGAAAAACTGTTTTTT	CASSLPGKGPRNEKLFF	TRBV7-9	TRBJ1-4
TGCGCCAGCAGCTGCCCACAGGGGGGAAACTATGGCTACACCTTC	CASSCPQGGNYGYTF	TRBV5-1	TRBJ1-2
TGTGCCAGCTCAAAGGGCAAGCCTGAAGCTTTCTTT	CASSKGKPEAFF	TRBV2	TRBJ1-1
TGTGCCTGGCAGGGTAATCGCTACGAGCAGTACTTC	CAWQGNRYEQYF	TRBV30	TRBJ2-7
TGTGCCAGCAGACGAACCGATCTAGCGGGGAACAATGAGCAGTTCTTC	CASRRTDLAGNNEQFF	TRBV6-4	TRBJ2-1
TGTGCACGTACAGGGGGGACCGGGGAGCTGTTTTTT	CARTGGTGELFF	TRBV12-5	TRBJ2-2
TGTGCCAGCTCACCAACACTAGCGGGAGGGGCCACTGAAGCTTTCTTT	CASSPTLAGGATEAFF	TRBV18	TRBJ1-1
TGTGCCAGCTGGTGGGGGCAGACTAACTATGGCTACACCTTC	CASWWGQTNYGYTF	TRBV28	TRBJ1-2
TGTGCCAGCCTCGGTCAGCAGTTCTTC	CASLGQQFF	TRBV11-2	TRBJ2-1
TGCAGTGCTAGAGCCCGGGGTCGGACAGGGGGTTATGGCTACACCTTC	CSARARGRTGGYGYTF	TRBV20-1	TRBJ1-2
TGCGCCAGCAGCGTCACAGGTAACAGGGGTGGGGAAGGGTGCACTGAAGCTTTCTTT	CASSVTGNRGGEGCTEAFF	TRBV5-1	TRBJ1-1
TGTGCGTTGCAGGGGGCGGCCGGCAATGAGCAGTTCTTC	CALQGAAGNEQFF	TRBV9	TRBJ2-1
TGTGCCACCAGTGATTCGTCAAACCCTACAGGGGGGGACTATGGCTACACCTTC	CATSDSSNPTGGDYGYTF	TRBV24-1	TRBJ1-2
TGCGCCAGCAGCCCTCAGAATAGCAATCAGCCCCAGCATTTT	CASSPQNSNQPQHF	TRBV4-3	TRBJ1-5
TGTGCCAGCAGTTTTCGTCCAGCGAGGGAGGAGCAGTTCTTC	CASSFRPAREEQFF	TRBV28	TRBJ2-1
TGCAGTGCTAGCCCGGAACCAACTCGGCCCAGGGGGCCCAGGGACACTGAAGCTTTCTTT	CSASPEPTRPRGPRDTEAFF	TRBV20-1	TRBJ1-1
TGTGCCATTAAAGGGGTCCAGAACACTGAAGCTTTCTTT	CAIKGVQNTEAFF	TRBV2	TRBJ1-1
TGTGCCATGGGCACCGACAATGAGCAGTTCTTC	CAMGTDNEQFF	TRBV10-3	TRBJ2-1
TGTGCCAATGGGGGGGAGGGAACTAATGAAAAACTGTTTTTT	CANGGEGTNEKLFF	TRBV6-5	TRBJ1-4
TGTGCCAGTACACGGCTTCTATTACCCGGGACAGGCTTTGAAGCTTTCTTT	CASTRLLLPGTGFEAFF	TRBV19	TRBJ1-1
TGTGCCAGCAGCCCAAGGAAGCTTGAGCAGTACTTC	CASSPRKLEQYF	TRBV7-3	TRBJ2-7
TGTGCCAGCAGTTTACGGGAGGGCCCTGAAGAGACCCAGTACTTC	CASSLREGPEETQYF	TRBV12-4	TRBJ2-5
TGTGCCAGCAGTGGGGTTGCGGCCAAAAAACTGTTTTTT	CASSGVAAKKLFF	TRBV6-5	TRBJ1-4
TGTGCCAGCAGCCCCAGGGGGGTTCACGAGCAGTACTTC	CASSPRGVHEQYF	TRBV5-6	TRBJ2-7
TGTGCCAGCAGCTTAGCCCTGCGGGAGCATTCCAACATTCAGTACTTC	CASSLALREHSNIQYF	TRBV7-4	TRBJ2-4
TGTGCCAGCAGCCCCGGTGGGGTGACAGATACGCAGTATTTT	CASSPGGVTDTQYF	TRBV7-4	TRBJ2-3
TGTGCCAGTAGTATGTTGACGGCGGAAGGGAATTCACCCCTCCACTTT	CASSMLTAEGNSPLHF	TRBV19	TRBJ1-6
TGTGCCAGCAGCTTTCTACTAGGTGAGCAGTTCTTC	CASSFLLGEQFF	TRBV7-3	TRBJ2-1
TGTGCCAGCAGCTTAGACAAACAGGGGGGGGCCTACGAGCAGTACTTC	CASSLDKQGGAYEQYF	TRBV7-4	TRBJ2-7
TGTGCCAGCAGCACTAGGGGGGAGCAGTTCTTC	CASSTRGEQFF	TRBV11-3	TRBJ2-1
TGTGCCACCAGTGATAAGGGGGCAACAGATACGCAGTATTTT	CATSDKGATDTQYF	TRBV24-1	TRBJ2-3
TGTGCCAGCGTAGACCGTGGGGGGGTTTGCAATCAGCCCCAGCATTTT	CASVDRGGVCNQPQHF	TRBV12-3	TRBJ1-5
TGTGCCAGCATCCAGGGATATGAAAAACTGTTTTTT	CASIQGYEKLFF	TRBV6-5	TRBJ1-4
TGCGCCAGCAGCCACTCGAACGGCCCTGAACCCGAGCAGTACTTC	CASSHSNGPEPEQYF	TRBV4-3	TRBJ2-7
TGTGCCGGGGACAGCGCGGGGAGAGCCTACAATGAGCAGTTCTTC	CAGDSAGRAYNEQFF	TRBV27	TRBJ2-1
TGTGCCAGCAGCTTGTCTAGCGGGGAGGGAACCTACAATGAGCAGTTCTTC	CASSLSSGEGTYNEQFF	TRBV11-2	TRBJ2-1
TGTGCCAGCGGGACAGGATATAGCAATCAGCCCCAGCATTTT	CASGTGYSNQPQHF	TRBV6-5	TRBJ1-5
TGTGCCAGCAGCGGGGTAGGGGAAAAATCCTACGAGCAGTACTTC	CASSGVGEKSYEQYF	TRBV7-2	TRBJ2-7
TGTGCCAGCAGCGAGTTGTGGACAGGGTATGGCTACACCTTC	CASSELWTGYGYTF	TRBV9	TRBJ1-2
TGTGCCATCAGTGAGGGACAGGGAGAGGCGGTAGGTAGCTCCTACAATGAGCAGTTCTTC	CAISEGQGEAVGSSYNEQFF	TRBV10-3	TRBJ2-1
TGTGCCAGCAGCTTATTACGCCTTCGTCAAGAGAAAGCTTTCTTT	CASSLLRLRQEKAFF	TRBV5-4	TRBJ1-1
TGTGCCAGCAGTTTGGTAAAGGACAGGGACACTGAAGCTTTCTTT	CASSLVKDRDTEAFF	TRBV12-3	TRBJ1-1
TGTGCCACCAGTGATCTTTATACTAGGGGACGGGGAAACACCATATATTTT	CATSDLYTRGRGNTIYF	TRBV24-1	TRBJ1-3
TGCAGTGCTTCAGGTGACTTTTGGGACAATGAGCAGTTCTTC	CSASGDFWDNEQFF	TRBV20-1	TRBJ2-1
TGTGCCAGCAGCCCGTCCCCGCTACTAGCCGGGGATACGCAGTATTTT	CASSPSPLLAGDTQYF	TRBV3-1	TRBJ2-3
TGTGCCAGCAGTGAAGCAGTGGGGAGAGATACGCAGTATTTT	CASSEAVGRDTQYF	TRBV6-1	TRBJ2-3
TGTGCCAGCAGTCTCCAGGCGGGACTAGCGCTACCCTACGAGCAGTACTTC	CASSLQAGLALPYEQYF	TRBV6-1	TRBJ2-7
TGTGCCAGCAGCGTAGAAACTAGCGGGAGCCCGCAAGAGACCCAGTACTTC	CASSVETSGSPQETQYF	TRBV9	TRBJ2-5
TGTGCCATCAGTGGGGGGGGGGAGACCCAGTACTTC	CAISGGGETQYF	TRBV10-3	TRBJ2-5
TGCGCCAGCAGCTTGCCCGGGACAGGGCCGGTGGGGGGCTCCTACGAGCAGTACTTC	CASSLPGTGPVGGSYEQYF	TRBV5-1	TRBJ2-7
TGCGCCAGCAGTGAGTCAGGGGGAGGTGAAAAACTGTTTTTT	CASSESGGGEKLFF	TRBV10-1	TRBJ1-4
TGTGCCAGCAGCTTATTCCAGGGGGGGGGTTTAGCTCTGAACAATGAGCAGTTCTTC	CASSLFQGGGLALNNEQFF	TRBV7-2	TRBJ2-1
TGTGCCAGCAGTTACCCACTAGCGGACACAGATACGCAGTATTTT	CASSYPLADTDTQYF	TRBV6-3	TRBJ2-3
TGTGCCAGCAGTTACTCTGGGGTTAAAGCAGAGACCCAGTACTTC	CASSYSGVKAETQYF	TRBV6-2	TRBJ2-5
TGTGCCAGCAGTGCGGACAGGGAGCAGTACTTC	CASSADREQYF	TRBV6-1	TRBJ2-7
TGTGCCAGCGGTCTCCCTGAACAGGGCTTAAGGGCATATGCAGATACGCAGTATTTT	CASGLPEQGLRAYADTQYF	TRBV6-4	TRBJ2-3
TGTGCCAGCAGTGAGCGGGGACAATCTTCCTACGAGCAGTACTTC	CASSERGQSSYEQYF	TRBV27	TRBJ2-7
TGCGCCAGCGCCTTTTTAAAAGAAGACGACAATGAGCAGTTCTTC	CASAFLKEDDNEQFF	TRBV10-1	TRBJ2-1
TGTGCCAGCAGTGAATTACAGAACGAGCAGTACTTC	CASSELQNEQYF	TRBV6-1	TRBJ2-7
TGTGCCAGCAGCCAGGACAGGGGAGGGATGACGGATCAGCCCCAGCATTTT	CASSQDRGGMTDQPQHF	TRBV5-8	TRBJ1-5
TGTGCCAGCAGGGTAGCGGGAATTAATGAGCAGTTCTTC	CASRVAGINEQFF	TRBV6-1	TRBJ2-1
TGCGCCTGGCCCGGGGGGGAGCTGTTTTTT	CAWPGGELFF	TRBV10-1	TRBJ2-2
TGTGCCAGCAGCGTATGGCCACCAAATGAGCAGTTCTTC	CASSVWPPNEQFF	TRBV9	TRBJ2-1
TGTGCCAGCACACCGCATTGGACAGGGGGTGGATCCCAGGGATCTAACTATGGCTACACCTTC	CASTPHWTGGGSQGSNYGYTF	TRBV2	TRBJ1-2
TGCGCCAGCAGCCCCCAGCACAGGGGGCGCCGATATGGCTACACCTTC	CASSPQHRGRRYGYTF	TRBV5-1	TRBJ1-2
TGTGCCAGCAGTCCGCCGGGACAGAACACTGAAGCTTTCTTT	CASSPPGQNTEAFF	TRBV6-1	TRBJ1-1
