TGTGCCATCAAGGAAACCACCAGGGCTTTCTTT	CAIKETTRAFF	TRBV10-3	TRBJ1-1
TGTGCCAGCAGCTTAGCGGGACACGGGCGACCACCAAGCGTGGCCTACGAGCAGTACTTC	CASSLAGHGRPPSVAYEQYF	TRBV11-2	TRBJ2-7
TGTGCCAGCAGTTTTTACAGGGGGCGCCACCGAACTAACTATGGCTACACCTTC	CASSFYRGRHRTNYGYTF	TRBV28	TRBJ1-2
TGTGCCAGCAGCGATCGGCCGCCCTACAATGAGCAGTTCTTC	CASSDRPPYNEQFF	TRBV2	TRBJ2-1
TGTGCCAGCAGCCATCCTCTGAGGGGCTATAATTCACCCCTCCACTTT	CASSHPLRGYNSPLHF	TRBV3-1	TRBJ1-6
TGTGCCAGCAGTTTAATTTGGCCACTAGCTGGGAGCTCCTACGAGCAGTACTTC	CASSLIWPLAGSSYEQYF	TRBV27	TRBJ2-7
TGTGCCAGCACACAGGGATGGTACGAGCAGTACTTC	CASTQGWYEQYF	TRBV6-6	TRBJ2-7
TGTGCCAGCAGCCAAAGCGGGATCGATGAGCAGTTCTTC	CASSQSGIDEQFF	TRBV7-2	TRBJ2-1
TGTGCCAGCAGCAAGGTTCGTCGCTACGAGCAGTACTTC	CASSKVRRYEQYF	TRBV13	TRBJ2-7
TGTGCCTGGAGGGGTTCTACAGGAACGGGCTACGAGCAGTACTTC	CAWRGSTGTGYEQYF	TRBV30	TRBJ2-7
TGTGCCAGCAGCCCCGACATATACGAGCAGTACTTC	CASSPDIYEQYF	TRBV5-5	TRBJ2-7
TGCAGTGCTAGTACCGGGACAGGGGCCCCCTACGAGCAGTACTTC	CSASTGTGAPYEQYF	TRBV20-1	TRBJ2-7
TGTGCCAGCATCGGCGGGACAGGCCACTATGGCTACACCTTC	CASIGGTGHYGYTF	TRBV7-9	TRBJ1-2
TGTGCCAGCACGACGGACAGGGGAAAAAACATTCAGTACTTC	CASTTDRGKNIQYF	TRBV28	TRBJ2-4
TGTGCCAGCAGCTTAGCTCCTTCGCCGGGACTAGCCATGAACACCGGGGAGCTGTTTTTT	CASSLAPSPGLAMNTGELFF	TRBV7-4	TRBJ2-2
TGTGCCAGTACAAGGGACAGGGCCGGATCCACTGAAGCTTTCTTT	CASTRDRAGSTEAFF	TRBV19	TRBJ1-1
TGTGCCTGGAGTAGGAGTTCCCCATACAGCCGGTTAAGGTTATCTGGAAACACCATATATTTT	CAWSRSSPYSRLRLSGNTIYF	TRBV30	TRBJ1-3
TGCAGTGCTACCGGGACTAGGGAATTTCAATACGAGCAGTACTTC	CSATGTREFQYEQYF	TRBV20-1	TRBJ2-7
TGTGCCACCAGTGATAGGCCCCACAGGCCTAGGCATCAGCCCCAGCATTTT	CATSDRPHRPRHQPQHF	TRBV24-1	TRBJ1-5
TGTGCCAGCAGTCACCTGCAACCACAGGATGAGCAGTTCTTC	CASSHLQPQDEQFF	TRBV12-3	TRBJ2-1
TGTGCCAGCAGCTCCGACGGCCGGTCGGGGGGGCAGCCCCAGCATTTT	CASSSDGRSGGQPQHF	TRBV7-9	TRBJ1-5
TGTGCCAGCAGTTACTCGGTTTACCAGGTATACTCGAGCAATCAGCCCCAGCATTTT	CASSYSVYQVYSSNQPQHF	TRBV6-2	TRBJ1-5
TGTGCCAGCAGCCACTTAGGCAATCAGCCCCAGCATTTT	CASSHLGNQPQHF	TRBV14	TRBJ1-5
TGTGCTAGTGGTTTGGCCTCGGGACAGGGGTCTAGCACAGATACGCAGTATTTT	CASGLASGQGSSTDTQYF	TRBV12-5	TRBJ2-3
TGTGCCAGCATAGGTCAAGGACAGGGGCAATCGGTATCCTACGAGCAGTACTTC	CASIGQGQGQSVSYEQYF	TRBV27	TRBJ2-7
TGTGCCAGCAGTTTATCTCGGGATATAGAGGAGACCCAGTACTTC	CASSLSRDIEETQYF	TRBV27	TRBJ2-5
TGTGCCAGCAGCGGGGTGTTCGAAGGAGAGCCCCAGCATTTT	CASSGVFEGEPQHF	TRBV6-3	TRBJ1-5
TGTGCCAGCAGAATCCCGGGACAGCATGGGCAGAAGGTTGAAAAACTGTTTTTT	CASRIPGQHGQKVEKLFF	TRBV6-4	TRBJ1-4
TGCAGCGTTGAAGCTGAATTCAGGGGATTATACGAGCAGTACTTC	CSVEAEFRGLYEQYF	TRBV29-1	TRBJ2-7
TGCAGTTTATCCATCGGGGGCGCCGCTGACTATGGCTACACCTTC	CSLSIGGAADYGYTF	TRBV20-1	TRBJ1-2
TGTGCCAGCAGCGAAATGGGGCGTCGGCATGGCTACACCTTC	CASSEMGRRHGYTF	TRBV5-8	TRBJ1-2
TGTGCCAGCAGCTTACAACGGGGGAATCGATCTGGAAACACCATATATTTT	CASSLQRGNRSGNTIYF	TRBV7-2	TRBJ1-3
TGTGCCAGCAGCGAAGAAATGAACACTGAAGCTTTCTTT	CASSEEMNTEAFF	TRBV6-1	TRBJ1-1
TGTGCCCTGATAGGGCGTAGGGGGGACACCGGGGAGCTGTTTTTT	CALIGRRGDTGELFF	TRBV7-8	TRBJ2-2
TGCAGCGTTGCGGAAACCGGGGAGCTGTTTTTT	CSVAETGELFF	TRBV29-1	TRBJ2-2
TGTGCCAGCAGAGGGAACTATGGCTACACCTTC	CASRGNYGYTF	TRBV11-2	TRBJ1-2
TGCGCCAGCAGCTTGGTACGTTTTAATCAGCCCCAGCATTTT	CASSLVRFNQPQHF	TRBV5-1	TRBJ1-5
TGTGCCAGCAGCTCCCCTGGGACAGGGCGTTACACTGAAGCTTTCTTT	CASSSPGTGRYTEAFF	TRBV13	TRBJ1-1
TGTGCTGGGGCGCCGACCTACTATGGCTACACCTTC	CAGAPTYYGYTF	TRBV30	TRBJ1-2
TGTGCCAGCAGTGAATTGCATGGACAGGGGACCAGTAACACTGAAGCTTTCTTT	CASSELHGQGTSNTEAFF	TRBV25-1	TRBJ1-1
TGCGCCAGCAGCTTATGCATTACCAGGGATTCTGAAGCTTTCTTT	CASSLCITRDSEAFF	TRBV5-1	TRBJ1-1
TGTGCCAGCAGCCCTCGTGCCGAGCGGCAGGGGCAGTACTTC	CASSPRAERQGQYF	TRBV3-1	TRBJ2-7
TGTGCCAGCACCCCACGGCGTGAGAATGAGCAGTTCTTC	CASTPRRENEQFF	TRBV11-2	TRBJ2-1
TGTGCCAGCAGCCGTCATGGGACCACCGGGGAGCTGTTTTTT	CASSRHGTTGELFF	TRBV14	TRBJ2-2
TGTGCCAGCAGCGAGTACTCGGGTGGGTACGAGCAGTACTTC	CASSEYSGGYEQYF	TRBV7-9	TRBJ2-7
TGTGCCAGCAGTTTGTATCGGGGCTACGAGCAGTACTTC	CASSLYRGYEQYF	TRBV28	TRBJ2-7
TGTGCCAGCAGTTACTCGTCTAGGGACAGGGATACTGAAGCTTTCTTT	CASSYSSRDRDTEAFF	TRBV6-5	TRBJ1-1
TGCAGTGCTAGAGATGTGGGGGGGGCCCAGGAGTCGTATGAGCAGTTCTTC	CSARDVGGAQESYEQFF	TRBV20-1	TRBJ2-1
TGTGCCAGCAGTCCCCTATCAAGGGTGGCTGGGGCCAACGTCCTGACTTTC	CASSPLSRVAGANVLTF	TRBV27	TRBJ2-6
TGTGCCACCAGTAACCAGGCGACTCACTATGGCTACACCTTC	CATSNQATHYGYTF	TRBV24-1	TRBJ1-2
TGTGCCAGCAGTTCAACAACCCGGACAGGACAGCGCACAGATACGCAGTATTTT	CASSSTTRTGQRTDTQYF	TRBV25-1	TRBJ2-3
TGTGCCAGCAGCGCCAGTACGTACCAAGAGACCCAGTACTTC	CASSASTYQETQYF	TRBV9	TRBJ2-5
TGTGCCAGCTCACCACCACAGGGGAACACTGAAGCTTTCTTT	CASSPPQGNTEAFF	TRBV18	TRBJ1-1
TGCGCCAGCAGCCAACTAAGGGCGCAGTCACCGGGCTACGAGCAGTACTTC	CASSQLRAQSPGYEQYF	TRBV4-1	TRBJ2-7
TGCGCCAGCAGTGCCGGACTACCAGGTCCAGATACGCAGTATTTT	CASSAGLPGPDTQYF	TRBV10-1	TRBJ2-3
TGTGCCAGCGTAGCGGAGGGACAGGGGGGGAACACTGAAGCTTTCTTT	CASVAEGQGGNTEAFF	TRBV7-2	TRBJ1-1
TGTGCCAGCCCCTCAGGCAGGGTCATGAACACTGAAGCTTTCTTT	CASPSGRVMNTEAFF	TRBV27	TRBJ1-1
TGTGCCAGCAGCGGACAGGGCTCAACGGAAGAGACCCAGTACTTC	CASSGQGSTEETQYF	TRBV13	TRBJ2-5
TGTGCCAGCAGTACGATGCAGTATTTT	CASSTMQYF	TRBV7-7	TRBJ2-3
TGCGCCGGGCGACAGAATATGATCTACGAGCAGTACTTC	CAGRQNMIYEQYF	TRBV5-1	TRBJ2-7
TGTGCCTGGAGCTCGGGGGTCGGGGCTGCCTGCGTTCCAGTTGCCAACACTGAAGCTTTCTTT	CAWSSGVGAACVPVANTEAFF	TRBV30	TRBJ1-1
TGTGCCAGCAGAGATCCGGGACAGGGGCCACCCCCAGGCTACACCTTC	CASRDPGQGPPPGYTF	TRBV28	TRBJ1-2
TGTGCCAGCAGTTACCTCCTTACATTTAGTAAGATTGGCTACACCTTC	CASSYLLTFSKIGYTF	TRBV6-6	TRBJ1-2
TGTGCCAGCAGCTTACCAAGAGCCCTCGAGCAGTACTTC	CASSLPRALEQYF	TRBV11-3	TRBJ2-7
TGTGCCACCCCAATTACGATCCTTCAGCCCCAGCATTTT	CATPITILQPQHF	TRBV24-1	TRBJ1-5
TGCGCCAGCAGCTTGGAGCAGGGCGGAAAAGTCTACAATGAGCAGTTCTTC	CASSLEQGGKVYNEQFF	TRBV5-1	TRBJ2-1
TGTGCCAGCAGTTACCAAACAGGCCGCCCTGGAAACACCATATATTTT	CASSYQTGRPGNTIYF	TRBV6-5	TRBJ1-3
TGCGCCAGCAGCTTCCCCCGGGTTCTAGCGGGCTCGGATGAGCAGTTCTTC	CASSFPRVLAGSDEQFF	TRBV5-1	TRBJ2-1
TGCGCCAGCATATTCCCGCTCGGTGCCGGCTATGGCTACACCTTC	CASIFPLGAGYGYTF	TRBV5-1	TRBJ1-2
TGCAGTGCTAGAGAACGCGTAGGGCGTACAGAAGGGAATTCACCCCTCCACTTT	CSARERVGRTEGNSPLHF	TRBV20-1	TRBJ1-6
TGTGCCAGCAGCTGGACCCAGCATTTT	CASSWTQHF	TRBV7-2	TRBJ1-5
TGTGCCATTGCCGACTCGCTCGCTAATCAGCCCCAGCATTTT	CAIADSLANQPQHF	TRBV19	TRBJ1-5
TGCGCCAGCAGTGAGACTAGCGGGGAGACCCAGTACTTC	CASSETSGETQYF	TRBV10-2	TRBJ2-5
TGTGCCAGCAGCGAAGAGGATTCACCAGCTTTCTTT	CASSEEDSPAFF	TRBV11-1	TRBJ1-1
TGTGCCAGCAGCTTACGTGCTAGCGGGAGGTACAATGAGCAGTTCTTC	CASSLRASGRYNEQFF	TRBV7-6	TRBJ2-1
TGTGCCACCAGTGATTTCCACAGGGCGTTACAAGAGACCCAGTACTTC	CATSDFHRALQETQYF	TRBV24-1	TRBJ2-5
TGTGCCAGCAGTGAAAAGGGACCCGCCTCAGCTTTCTTT	CASSEKGPASAFF	TRBV27	TRBJ1-1
TGTGCCACCAGCCCACTCTTCGGACAGGGTGTACCATACAATGAGCAGTTCTTC	CATSPLFGQGVPYNEQFF	TRBV15	TRBJ2-1
TGTGCCAGTAGTACTACGGGAGGATACCCCGGGAACACCGGGGAGCTGTTTTTT	CASSTTGGYPGNTGELFF	TRBV19	TRBJ2-2
TGTGCCAGCAGCTTGGTCACTCCAGACACTGAAGCTTTCTTT	CASSLVTPDTEAFF	TRBV5-6	TRBJ1-1
TGTGCCAGCAGTTACGACATTTTCTCTGGGGCCAACGTCCTGACTTTC	CASSYDIFSGANVLTF	TRBV6-5	TRBJ2-6
TGTGCCACAGAACTGTCGGGCCCACGACACTCTGGAAACACCATATATTTT	CATELSGPRHSGNTIYF	TRBV24-1	TRBJ1-3
TGTGCCAGCAGCTTCGTGGTCCAGACTTCTGGTACTACCAAAAACATTCAGTACTTC	CASSFVVQTSGTTKNIQYF	TRBV11-2	TRBJ2-4
TGCGCCAGCAGCCAAGAAGGTCGCCGCGGATCAGTCTACAATGAGCAGTTCTTC	CASSQEGRRGSVYNEQFF	TRBV4-1	TRBJ2-1
TGTGCCAGCAGTTACTCGACCCTACATTCGGAGCAGTACTTC	CASSYSTLHSEQYF	TRBV6-5	TRBJ2-4
TGTGCCAGAAGGGGAGGGCAGCCCCAGCATTTT	CARRGGQPQHF	TRBV10-3	TRBJ1-5
TGTGCCAGCAGTGTTCAAGGGGGGCGGGGGGGAGGGAGACCGAACACCGGGGAGCTGTTTTTT	CASSVQGGRGGGRPNTGELFF	TRBV2	TRBJ2-2
TGTGCCAGCAGTGGCTCTAGCGGGACCCTCCGCAATGAGCAGTTCTTC	CASSGSSGTLRNEQFF	TRBV27	TRBJ2-1
TGCAGCGGTCACCCAGGGGTCCAAGAGACCCAGTACTTC	CSGHPGVQETQYF	TRBV29-1	TRBJ2-5
TGTGCCAGCAGCCCCCTAAGGGGACAGCCCCAGCATTTT	CASSPLRGQPQHF	TRBV13	TRBJ1-5
TGCGCCAGCAGCCAGGGCCGACAGGACAGCGAGCAGTACTTC	CASSQGRQDSEQYF	TRBV4-3	TRBJ2-7
TGCGCCAGCAGCTTGGTGGGGGGGTTATTTGGACTATCACAGCTGTTTTTT	CASSLVGGLFGLSQLFF	TRBV5-1	TRBJ2-2
TGTGCCAGCATAACGGACAGGGAGGTGGAGACCCAGTACTTC	CASITDREVETQYF	TRBV6-4	TRBJ2-5
TGTGCCTGGAGTGTATCCTTTTCAAGTTCGGAAGGCTACACCTTC	CAWSVSFSSSEGYTF	TRBV30	TRBJ1-2
TGTGCCATCAGACACGGGACAGGGGATGGACAGCCCCAGCATTTT	CAIRHGTGDGQPQHF	TRBV10-3	TRBJ1-5
TGTGCCAGCAGCTTAAGAGGACGGAGGCAGTCCTACGAGCAGTACTTC	CASSLRGRRQSYEQYF	TRBV7-3	TRBJ2-7
TGTGCCAGCAGCCCGGGGGGAACTGAAGCTTTCTTT	CASSPGGTEAFF	TRBV7-9	TRBJ1-1
TGCAGTGCTAGGGATAGGGCCTACGAGCAGTACTTC	CSARDRAYEQYF	TRBV20-1	TRBJ2-7
TGTGCCACAACCCCCAGCGTACAGGGGGCTTTCTTT	CATTPSVQGAFF	TRBV15	TRBJ1-1
TGTGCCAGCACCGCCCGGGACAAGACCTACGAGCAGTACTTC	CASTARDKTYEQYF	TRBV6-4	TRBJ2-7
TGCAGTGCTAGGCCCGGTGGAGGACTAGCCAGGTTCCCCAACAATGAGCAGTTCTTC	CSARPGGGLARFPNNEQFF	TRBV20-1	TRBJ2-1
TGTGCCAGCAGTGACCAACCAGGGACGGCTTACGAGCAGTACTTC	CASSDQPGTAYEQYF	TRBV25-1	TRBJ2-7
TGCAGTGCGGGATCGGGTGGCTACACCTTC	CSAGSGGYTF	TRBV20-1	TRBJ1-2
TGTGCCAGCAGCTTAGAAGACAGGGGCGACCAGAACACTGAAGCTTTCTTT	CASSLEDRGDQNTEAFF	TRBV11-3	TRBJ1-1
TGTGCCAGCACCCGTACTCATAACTATGGCTACACCTTC	CASTRTHNYGYTF	TRBV28	TRBJ1-2
TGCAGTGCTAGAGAATTACCGCGGGTTTGCTCTGGAAACACCATATATTTT	CSARELPRVCSGNTIYF	TRBV20-1	TRBJ1-3
TGTGCCAGCAGCTCTGAGGACAGGGGATTCACTGAAGCTTTCTTT	CASSSEDRGFTEAFF	TRBV5-4	TRBJ1-1
TGTGCCAGCAGCTTAGTACAAGGAGACCTAAGGGAAGCTTTCTTT	CASSLVQGDLREAFF	TRBV7-7	TRBJ1-1
TGTGCCACCAGTGTCGAGGGCTTCCGGGGCCCTAGCAATCAGCCCCAGCATTTT	CATSVEGFRGPSNQPQHF	TRBV24-1	TRBJ1-5
TGTGCCAGCTCACCATCGACCGGCCTGTACGAGCAGTACTTC	CASSPSTGLYEQYF	TRBV18	TRBJ2-7
TGTGCCAGCAGCCAAGGCTTAAAGGGGGAATACCCGGGGGCAGGTCCTAACTATGGCTACACCTTC	CASSQGLKGEYPGAGPNYGYTF	TRBV3-1	TRBJ1-2
TGTGCCAGCAGTCCTGGGACAGAGGAGACCCAGTACTTC	CASSPGTEETQYF	TRBV28	TRBJ2-5
TGCGCCAGCAGCAAAGGCGAGGACAGGGGAGGGTGCGACATATATGAGCAGTTCTTC	CASSKGEDRGGCDIYEQFF	TRBV5-1	TRBJ2-1
TGTGCCAGCAGCCTTACTAGCGGTCTTGCGAACCTAGGCTACGAGCAGTACTTC	CASSLTSGLANLGYEQYF	TRBV7-6	TRBJ2-7
TGTGCCAGCAGTTACCCAACAGGCCCCTATAATTCACCCCTCCACTTT	CASSYPTGPYNSPLHF	TRBV6-2	TRBJ1-6
TGTGCCAGCAGTGCGGACGACTCCTGTGGACAGGGGAGTAGCTCCTACGAGCAGTACTTC	CASSADDSCGQGSSSYEQYF	TRBV6-1	TRBJ2-7
TGTGCCCGGAAGCTGATAGAGGGTGGAAACACCATATATTTT	CARKLIEGGNTIYF	TRBV27	TRBJ1-3
TGTGCCAGCAGCGGGCCAGAGACCCAGTACTTC	CASSGPETQYF	TRBV9	TRBJ2-5
TGTGCCAGCAGCCTTGAGGTCCGCGGGGGCGGTACCTACGAGCAGTACTTC	CASSLEVRGGGTYEQYF	TRBV7-3	TRBJ2-7
TGTGCCAGTATTCGACGAAGAGAGTTTCAGCCCCAGCATTTT	CASIRRREFQPQHF	TRBV19	TRBJ1-5
TGTGCCAGCAGGGAAGCGCCCGGGATAGAGCAGTTCTTC	CASREAPGIEQFF	TRBV6-1	TRBJ2-1
TGTGCCAGCAGTGTTGGGACAGTCAATCAATTCTGCCCCTACGAGCAGTACTTC	CASSVGTVNQFCPYEQYF	TRBV6-1	TRBJ2-7
TGTGCCAGCAGCCAAAGGGGGACTAGGCCCTACGAGCAGTACTTC	CASSQRGTRPYEQYF	TRBV14	TRBJ2-7
TGTGCCAGCAGCCGTTCCGGGACAGGGGGTGGCTACACCTTC	CASSRSGTGGGYTF	TRBV3-1	TRBJ1-2
TGTGCCAGCAGCAACATCCTCCACTCCCAGCCCCAGCATTTT	CASSNILHSQPQHF	TRBV11-3	TRBJ1-5
TGTGCCAGCAGTTCTACAGGAAAAGAGACCCAGTACTTC	CASSSTGKETQYF	TRBV6-5	TRBJ2-5
TGCGCCAGCAGCTTGGGCGGGGGGGACGAGCAGTACTTC	CASSLGGGDEQYF	TRBV5-1	TRBJ2-7
TGTGCCAGCAGCTTAGCCGGGACAGGGGGAGACAACACTGAAGCTTTCTTT	CASSLAGTGGDNTEAFF	TRBV7-8	TRBJ1-1
TGCGCCAGCAGCCAATCACTAGCGTTACACGCCTACGAGCAGTACTTC	CASSQSLALHAYEQYF	TRBV4-1	TRBJ2-7
TGTGCCAGCAGTTATTCTGACTTATCTGGAAACACCATATATTTT	CASSYSDLSGNTIYF	TRBV6-3	TRBJ1-3
TGTGCCAGCAGCTTAGGGGGCAGGAAACTGTTTTTT	CASSLGGRKLFF	TRBV7-3	TRBJ1-4
TGTGCCAGCAGCCAAGAACACGTCGGGGTCGGGGGCTATGGCTACACCTTC	CASSQEHVGVGGYGYTF	TRBV4-2	TRBJ1-2
TGTGCCAGCAGCCGGAGACCACCCTTAACCGGTAGTCCCAGTCCGGGACAGAGCAATCAGCCCCAGCATTTT	CASSRRPPLTGSPSPGQSNQPQHF	TRBV7-2	TRBJ1-5
TGTGCCAGCATAGCCCCCCCCGGGGACCCGGAGGATATGAACACTGAAGCTTTCTTT	CASIAPPGDPEDMNTEAFF	TRBV28	TRBJ1-1
TGTGCCACCAGTGCCGGGACTAGCGACCAAGAGACCCAGTACTTC	CATSAGTSDQETQYF	TRBV24-1	TRBJ2-5
TGTGCCAGCTCACCACCCAACTTGCTCCAGGGAACTACATACGAGCAGTACTTC	CASSPPNLLQGTTYEQYF	TRBV18	TRBJ2-7
TGTGCCTGGACCCGGCGAGCACTCGAGCAGTACTTC	CAWTRRALEQYF	TRBV30	TRBJ2-7
TGTGCCAGCAGCTTAGCGACGAGGGGAGGGCGGGGCAATCAGCCCCAGCATTTT	CASSLATRGGRGNQPQHF	TRBV7-9	TRBJ1-5
TGTGCCAGCAGCGATGTGACAGGGGCCTACGAGCAGTACTTC	CASSDVTGAYEQYF	TRBV9	TRBJ2-7
TGCAGTGCTAACGCAGCCAGGTACTATGGCTACACCTTC	CSANAARYYGYTF	TRBV20-1	TRBJ1-2
TGTGCCAGCAGTTTTTCCTCGGGGGTAAGCTACGAGCAGTACTTC	CASSFSSGVSYEQYF	TRBV27	TRBJ2-7
TGTGCCAGCAGTGAGGTGGAGGGGGTATACAGGGGCAGGGTAGATACGCAGTATTTT	CASSEVEGVYRGRVDTQYF	TRBV6-4	TRBJ2-3
TGTGCCAGCAGACCGCTCATCTCGGGGTGGTCGGACCGGACTAATGAAAAACTGTTTTTT	CASRPLISGWSDRTNEKLFF	TRBV11-2	TRBJ1-4
TGTGCCACAGGGGCCCCCTACTACGAGCAGTACTTC	CATGAPYYEQYF	TRBV19	TRBJ2-7
TGTGCCAGTAACTTAGGTGACGCTATCGAGCAGTACTTC	CASNLGDAIEQYF	TRBV6-4	TRBJ2-7
TGTGCCAGCAGTTTCCTTCCGCCCGGGACAGAATTGCAGTTCTTC	CASSFLPPGTELQFF	TRBV6-9	TRBJ2-1
TGTGCCAGCAGCTTAAGCCTCGGCCGTCGGGGCGCGAACACCGGGGAGCTGTTTTTT	CASSLSLGRRGANTGELFF	TRBV7-9	TRBJ2-2
TGTGCCAGCAGTTCGGGGGCTAAATCACACAATCAGCCCCAGCATTTT	CASSSGAKSHNQPQHF	TRBV6-3	TRBJ1-5
TGCAGTGCTAGAGAGATATCTGGTGGGGGACGGCAGGGGAGACAAGAGACCCAGTACTTC	CSAREISGGGRQGRQETQYF	TRBV20-1	TRBJ2-5
TGTGCCAGCAGTATAGAACGCCCCTACAATGAGCAGTTCTTC	CASSIERPYNEQFF	TRBV27	TRBJ2-1
TGTGCCAGCTCGGGGTTAAGTGCTTTCTTT	CASSGLSAFF	TRBV7-2	TRBJ1-1
TGCGCCAGCACCCGGGACAGGGATCAGCCCCAGCATTTT	CASTRDRDQPQHF	TRBV10-1	TRBJ1-5
TGTGCCAGCAGTGAACTATCCTTCAAAGAGACCCAGTACTTC	CASSELSFKETQYF	TRBV6-6	TRBJ2-5
TGTGCCAGCAGTTGGAAGGACGAAAATCAGCCCCAGCATTTT	CASSWKDENQPQHF	TRBV12-4	TRBJ1-5
TGCAGTGCTAGTACGGGGTTAGGGGGCCTGTTTTTT	CSASTGLGGLFF	TRBV20-1	TRBJ1-4
TGCGCCAGCAGCTTGACAATAAAGGGGGGCAATGGTTATACGCAGTATTTT	CASSLTIKGGNGYTQYF	TRBV5-1	TRBJ2-3
TGCAGTGCTGTAATTCTAGCGGGGCGTGAGGGAGATACGCAGTATTTT	CSAVILAGREGDTQYF	TRBV20-1	TRBJ2-3
TGCGCCAGCGTAAGGGGCGCACCCAATGAGCAGTTCTTC	CASVRGAPNEQFF	TRBV5-1	TRBJ2-1
TGTGCCAGCAGCGTCCATACTAGCGGGAGTACTAGCTCCTACAATGAGCAGTTCTTC	CASSVHTSGSTSSYNEQFF	TRBV7-4	TRBJ2-1
TGCAGTGCTAGGCCACAATCCCTCCACTTT	CSARPQSLHF	TRBV20-1	TRBJ1-6
TGCGCCAGCATAATCAAACATTTTACTGGGGCCAACGTCCTGACTTTC	CASIIKHFTGANVLTF	TRBV10-1	TRBJ2-6
TGTGCCAGCAGCTTAGGAAGGTCTAGAGGGCACCACACTGAAGCTTTCTTT	CASSLGRSRGHHTEAFF	TRBV7-9	TRBJ1-1
TGTGCCAGCAGTTTTGGAGGGGCCGTGAACTATGGCTACACCTTC	CASSFGGAVNYGYTF	TRBV28	TRBJ1-2
TGTGCCAGCAGCGTGAAGTCTAGCGGGGGGTCGGGTGATGAGCAGTTCTTC	CASSVKSSGGSGDEQFF	TRBV13	TRBJ2-1
TGCGCCAGCAGACAGGGATACTACGGTGAAAAACTGTTTTTT	CASRQGYYGEKLFF	TRBV10-1	TRBJ1-4
TGCGCCAGCAGCCAAGCAAAAAGACAGGGGAATAACACTGAAGCTTTCTTT	CASSQAKRQGNNTEAFF	TRBV4-3	TRBJ1-1
TGTGCCACCAGCACAGGGGCCTACAATGAGCAGTTCTTC	CATSTGAYNEQFF	TRBV15	TRBJ2-1
TGCGCCAGCAGCGTGGACAGGGATACACTCAATGAGCAGTTCTTC	CASSVDRDTLNEQFF	TRBV5-1	TRBJ2-1
TGCAGTGCTAGGGGACAGGGGGCCTGGTTTTATAGCAATCAGCCCCAGCATTTT	CSARGQGAWFYSNQPQHF	TRBV20-1	TRBJ1-5
TGTGCCAGCTCACTCATCAAGAGGCACAATGAGCAGTTCTTC	CASSLIKRHNEQFF	TRBV18	TRBJ2-1
TGTGCCAGCAGCCCTTGCCGGGACAGGAACGAGCAGTACTTC	CASSPCRDRNEQYF	TRBV7-9	TRBJ2-7
TGTGCCAGCAGGCAAGAGGGACAGGGGGGCACTGAAGCTTTCTTT	CASRQEGQGGTEAFF	TRBV6-2	TRBJ1-1
TGTGCCAGCAGCTCCCGACAGGGTTCTACTGAAGCTTTCTTT	CASSSRQGSTEAFF	TRBV6-4	TRBJ1-1
TGTGCCATCAGTGACCCATTTGGGACTAGCGGGGTCCAAGAGACCCAGTACTTC	CAISDPFGTSGVQETQYF	TRBV10-3	TRBJ2-5
TGCGCCAGCAGACAGGCCCCCGGAACTAGCGGGAACTGGATTTCGAACACCGGGGAGCTGTTTTTT	CASRQAPGTSGNWISNTGELFF	TRBV5-1	TRBJ2-2
TGTGCCAGCAGCGATCATCCGGGGCCCCCTTACGAGCAGTACTTC	CASSDHPGPPYEQYF	TRBV3-1	TRBJ2-7
TGTGCCAGCAGCCAAGAAGACGTGGAGGGCGAAGAGACCCAGTACTTC	CASSQEDVEGEETQYF	TRBV14	TRBJ2-5
TGTGCCAGCAGCATTCACCCGAATTTGTACGAGCAGTACTTC	CASSIHPNLYEQYF	TRBV7-6	TRBJ2-7
TGTGCCCTCTCCCCCGGGACAGGGACTAATGAAAAACTGTTTTTT	CALSPGTGTNEKLFF	TRBV11-3	TRBJ1-4
TGTGCCAGCAGCTTGCCGGCAGGGGACAAGGGCGAGCAGTACTTC	CASSLPAGDKGEQYF	TRBV5-6	TRBJ2-7
TGCAGTGCTAGACCGGGACAGGGGTCCTCCTACGAGCAGTACTTC	CSARPGQGSSYEQYF	TRBV20-1	TRBJ2-7
TGCAGTGCTAGACAAAGGACTAGCGGGGGGCTTACCGGGGAGCTGTTTTTT	CSARQRTSGGLTGELFF	TRBV20-1	TRBJ2-2
TGTGCCACCACCGAAACGAGCTCCTACAATGAGCAGTTCTTC	CATTETSSYNEQFF	TRBV24-1	TRBJ2-1
TGTGCCAGCAGTTACGGGACAGGGGGCAATCAGCCCCAGCATTTT	CASSYGTGGNQPQHF	TRBV6-2	TRBJ1-5
TGTGCCAGCAGGGGTACTACTGGGGCCAACGTCCTGACTTTC	CASRGTTGANVLTF	TRBV9	TRBJ2-6
TGTGCCAGCAGCACCTACGGGAACTACGAGCAGTACTTC	CASSTYGNYEQYF	TRBV5-6	TRBJ2-7
TGTGCCACCAGCAGAGATGGACGGCTTAATGTTAACTATGGCTACACCTTC	CATSRDGRLNVNYGYTF	TRBV15	TRBJ1-2
TGTGCCACCAGTGATTTGGGACCGGGAACCTATGGCTACACCTTC	CATSDLGPGTYGYTF	TRBV24-1	TRBJ1-2
TGTGCCAGCTCACGGACAGAGAAGAATGGCTACACCTTC	CASSRTEKNGYTF	TRBV18	TRBJ1-2
TGCGCCAGCAGCTGTGGGTCGCACCGGGACAGGGGTTTTTACTATGGCTACACCTTC	CASSCGSHRDRGFYYGYTF	TRBV4-1	TRBJ1-2
TGTGCCAGCAGCCAAGAGCCTCAGTTACACCCGAAGGGGTTCATGCATTCTGAAGCTTTCTTT	CASSQEPQLHPKGFMHSEAFF	TRBV3-1	TRBJ1-1
TGCGCCAGCATTTCGGGGGAAATGAACACTGAAGCTTTCTTT	CASISGEMNTEAFF	TRBV10-1	TRBJ1-1
TGTGCCTGGGGGGAGGGAAAAACTTGTGAGCAGTTCTTC	CAWGEGKTCEQFF	TRBV30	TRBJ2-1
TGTGCCAGCAGTTTTTACAGGTTTGGGATGAACACTGAAGCTTTCTTT	CASSFYRFGMNTEAFF	TRBV28	TRBJ1-1
TGTGCCAGCAGCGTAGCCTGGGGAGCTGAACCTAGCGGGCAAGCCTCCTACGAGCAGTACTTC	CASSVAWGAEPSGQASYEQYF	TRBV9	TRBJ2-7
TGTGCCAGCGGTCTGGGGGACGGGGCCTACGAGCAGTACTTC	CASGLGDGAYEQYF	TRBV6-1	TRBJ2-7
TGTGCCAGCAGCCTAGCGGGACTAGTCCCTGAGCAGTTCTTC	CASSLAGLVPEQFF	TRBV7-7	TRBJ2-1
TGTGCCAGCAGAGGAAGCCGGGACAGGGAAAAGTGGGGCGAGCAGTACTTC	CASRGSRDREKWGEQYF	TRBV6-5	TRBJ2-7
TGTGCCAGACCCCGAAGGCTAACGGACAATGAGCAGTTCTTC	CARPRRLTDNEQFF	TRBV6-2	TRBJ2-1
TGTGCCAGCAGCTTAGCGATGACCCTAGCGGGCTACGAGCAGTACTTC	CASSLAMTLAGYEQYF	TRBV7-9	TRBJ2-7
TGTGTAGAAACCAGGGAGCAAGAGACCCAGTACTTC	CVETREQETQYF	TRBV9	TRBJ2-5
TGCGCCAGCGGGCGAGACACTGAAGCTTTCTTT	CASGRDTEAFF	TRBV5-1	TRBJ1-1
TGTGCCAGCAGCTTGGTGGGACCCTACGAGCAGTACTTC	CASSLVGPYEQYF	TRBV5-8	TRBJ2-7
TGTGCCAGTAGTATAAACACGGGACTAGCGGGGAAGTACGAGCAGTACTTC	CASSINTGLAGKYEQYF	TRBV19	TRBJ2-7
TGTGCCAGCAGCCGGCGACAGGGGGCAGGAGAGACCCAGTACTTC	CASSRRQGAGETQYF	TRBV9	TRBJ2-5
TGTGCCAGCAGTGCCGAGCGGACTTATGGCTACACCTTC	CASSAERTYGYTF	TRBV12-4	TRBJ1-2
TGTGCCAGCCCGGGGACGGTAAGGCACTCCTACGAGCAGTACTTC	CASPGTVRHSYEQYF	TRBV5-6	TRBJ2-7
TGTGCCAGCAGCGTCCCCGACATATCAACTAATGAAAAACTGTTTTTT	CASSVPDISTNEKLFF	TRBV5-6	TRBJ1-4
TGCAGTGCTAGGTCCTTCGGAGACAACACCGGGGAGCTGTTTTTT	CSARSFGDNTGELFF	TRBV20-1	TRBJ2-2
TGTGCCAGCAGCTCATCTAGACGAACCGACTACGAGCAGTACTTC	CASSSSRRTDYEQYF	TRBV11-2	TRBJ2-7
TGTGCCAGCAGCGCGCCCGGAGCAAGAGGTTGGCACTTTATGGCCTACGAGCAGTACTTC	CASSAPGARGWHFMAYEQYF	TRBV4-2	TRBJ2-7
TGCAGTGCTAGAGATCGTATCGGGACTAGTAATGAGCAGTTCTTC	CSARDRIGTSNEQFF	TRBV20-1	TRBJ2-1
TGCGCCAGCAGTGACCAGATCAGGGCGGGTACACCCTACGAGCAGTACTTC	CASSDQIRAGTPYEQYF	TRBV10-1	TRBJ2-7
TGCGCCAGCCACCTCTACCGCTCCTACAATGAGCAGTTCTTC	CASHLYRSYNEQFF	TRBV5-1	TRBJ2-1
TGTGCCAGCAGCTGTCCATGCTCGGGACAGGTCGAGACCCAGTACTTC	CASSCPCSGQVETQYF	TRBV5-6	TRBJ2-5
TGCGCCAGCAGAAACAATGGGACAGGCTTGGCAATGTACCAAGAGACCCAGTACTTC	CASRNNGTGLAMYQETQYF	TRBV4-1	TRBJ2-5
TGTGCCAGCAGCATTGTAAAACTAGCGGGGTCCTACGAGCAGTACTTC	CASSIVKLAGSYEQYF	TRBV13	TRBJ2-7
TGTGCCAGCAGTTATGGACAGGGCAATCAGCCCCAGCATTTT	CASSYGQGNQPQHF	TRBV6-5	TRBJ1-5
TGTGCCAGCAGCCAGGGAAGGCGCATGATCATCCATCAGCCCCAGCATTTT	CASSQGRRMIIHQPQHF	TRBV3-1	TRBJ1-5
TGCAGTGCTAGAGAAGGGGGGGGGCAGTCCGCCAATGAGCAGTTCTTC	CSAREGGGQSANEQFF	TRBV20-1	TRBJ2-1
TGTGCCAGCAGCGGACCCGACAGGGGGGAAGAGACCCAGTACTTC	CASSGPDRGEETQYF	TRBV9	TRBJ2-5
TGCGCCAGCAGCCAAGATTTAAGCGTTTTTCCCCACCGGGCTTCTTACACTGAAGCTTTCTTT	CASSQDLSVFPHRASYTEAFF	TRBV4-1	TRBJ1-1
TGTGCCAGCAGCACCGAGTCCTACACCTTC	CASSTESYTF	TRBV13	TRBJ1-2
TGTGCCACCAGTGAGGCTGCGACTGAAGCTTTCTTT	CATSEAATEAFF	TRBV24-1	TRBJ1-1
TGTGCCAGCAGGGTGGGGAACTATGGCTACACCTTC	CASRVGNYGYTF	TRBV27	TRBJ1-2
TGTGCCAGCAGCGGTCGCGGACAGGGCACTGAAGCTTTCTTT	CASSGRGQGTEAFF	TRBV7-2	TRBJ1-1
TGCAACCGCTCATGGAGAAGGCCCCAAGAGACCCAGTACTTC	CNRSWRRPQETQYF	TRBV5-1	TRBJ2-5
TGTGCCACCGGTGGCGGGAGTCCCACCGGGGAGCTGTTTTTT	CATGGGSPTGELFF	TRBV24-1	TRBJ2-2
TGTGCCAGCAGAGGGACAGCCTTAGCTTTGACTGAAGCTTTCTTT	CASRGTALALTEAFF	TRBV5-6	TRBJ1-1
TGTGCCAGCAGCTTGGGAGGCAGGGTTTTCCACGAGCAGTACTTC	CASSLGGRVFHEQYF	TRBV5-4	TRBJ2-7
TGTGCCAGGCGATGGACCGGGGAGCTGTTTTTT	CARRWTGELFF	TRBV19	TRBJ2-2
TGTGCCAGCAGTTTCGCATCCACTGGGACTAGTGCCTACAATGAGCAGTTCTTC	CASSFASTGTSAYNEQFF	TRBV12-4	TRBJ2-1
TGCGCCAGCAGCCAAGATTGGTTCCCAGGGGGCGGCCGCAATCAGCCCCAGCATTTT	CASSQDWFPGGGRNQPQHF	TRBV4-1	TRBJ1-5
TGCGCCAGCAGCCAAGAGCCGACGGGCGGGACAGGGGGGCCCAGGCCTGGGGCCAACGTCCTGACTTTC	CASSQEPTGGTGGPRPGANVLTF	TRBV4-1	TRBJ2-6
TGTGCCAGCAGCCGGAGAACGGGGATACCTCATAGCAATCAGCCCCAGCATTTT	CASSRRTGIPHSNQPQHF	TRBV7-3	TRBJ1-5
TGTGCCAGCAGTGTCCCCGCTTTGTGGGCGGAGCTGTATAGCAATCAGCCCCAGCATTTT	CASSVPALWAELYSNQPQHF	TRBV6-4	TRBJ1-5
TGTGCCAGCAGCATAGGAGGGGCAGAGACCCAGTACTTC	CASSIGGAETQYF	TRBV7-6	TRBJ2-5
TGTGCCAGCAGTTTAGGGAGCCTTTGGGAGACCCAGTACTTC	CASSLGSLWETQYF	TRBV28	TRBJ2-5
TGTGCCAGCAGCCCCGGCAACCCGGGACTAGCGGGCCATCAAGAGACCCAGTACTTC	CASSPGNPGLAGHQETQYF	TRBV13	TRBJ2-5
TGTGCCAGCAGTGCCAAACTGAACGCCAAAAACATTCAGTACTTC	CASSAKLNAKNIQYF	TRBV6-1	TRBJ2-4
TGTGCCAGCAGCGGATCCGGGGGGGACGAGCAGTACTTC	CASSGSGGDEQYF	TRBV13	TRBJ2-7
TGTGCCAGCAGTAGTGTGCCCTCGACGAACATCACTGAAGCTTTCTTT	CASSSVPSTNITEAFF	TRBV6-3	TRBJ1-1
TGTGCTAGTGGTGCCGTTTGGGGTAGGGAAAAACTGTTTTTT	CASGAVWGREKLFF	TRBV12-5	TRBJ1-4
TGTGCCAGCAGTTCACCACTAGCGGGAGAGGACACAGATACGCAGTATTTT	CASSSPLAGEDTDTQYF	TRBV6-6	TRBJ2-3
TGTGCCAGCAAGCCTCTAGCGGGGAATCCTACCGGGGAGCTGTTTTTT	CASKPLAGNPTGELFF	TRBV6-1	TRBJ2-2
TGTGCCAGCCCCGGGGGGGCGGATGAGCAGTTCTTC	CASPGGADEQFF	TRBV28	TRBJ2-1
TGTGCCACTCTTCAGATCTATCACTATGGCTACACCTTC	CATLQIYHYGYTF	TRBV28	TRBJ1-2
TGCAGTGCTAGGGCGCTAAGCCTTTATTCTAGATGGGCAGGGGAGCAGTACTTC	CSARALSLYSRWAGEQYF	TRBV20-1	TRBJ2-7
TGTGCCAGCAGGGGGATAGCCCTAGCGGTCGAGACCCAGTACTTC	CASRGIALAVETQYF	TRBV6-5	TRBJ2-5
TGTGCCAGCCCCGGGACAGGGGTACAGACCCTCCACTTT	CASPGTGVQTLHF	TRBV7-3	TRBJ1-6
TGTGCTGCGGAGACAGGGGGCGGGGGGAATGGCTACACCTTC	CAAETGGGGNGYTF	TRBV30	TRBJ1-2
TGCGCCAGCAGCCAAGACATGGGACAGGTTCGGATCACTGAAGCTTTCTTT	CASSQDMGQVRITEAFF	TRBV4-3	TRBJ1-1
TGTGCCATCAACGCGAAAGAGACCCAGTACTTC	CAINAKETQYF	TRBV10-3	TRBJ2-5
TGTGCCAGCAGCACTCACAGGGAGACCCTCCACTTT	CASSTHRETLHF	TRBV13	TRBJ1-6
TGTGCCAGCAGCGTAGAACTACGACTAGGAAAAACGGCCAGACAGGGGGGGGTAGCGGATAGCAATCAGCCCCAGCATTTT	CASSVELRLGKTARQGGVADSNQPQHF	TRBV9	TRBJ1-5
TGTGCCAGCAGTTTGAACGCCAGGTGCTCCTACGAGCAGTACTTC	CASSLNARCSYEQYF	TRBV27	TRBJ2-7
TGTGCCACACTCAAGGGATTAAATCAGCCCCAGCATTTT	CATLKGLNQPQHF	TRBV24-1	TRBJ1-5
TGCAGTGCTAGAAAGGAGGGGACGTATAGCAATCAGCCCCAGCATTTT	CSARKEGTYSNQPQHF	TRBV20-1	TRBJ1-5
TGTGCCAGCAGCTTGGGGACAGGGGTAGCCCAAGAGACCCAGTACTTC	CASSLGTGVAQETQYF	TRBV13	TRBJ2-5
TGCGCCAAGCGGGACCGCTATGGCTACACCTTC	CAKRDRYGYTF	TRBV10-1	TRBJ1-2
TGTGCCAGCAGTTTTAGGCTAGCGGGTGCCAATGAGCAGTACTTC	CASSFRLAGANEQYF	TRBV27	TRBJ2-7
TGTGCCAGCAGCCAAGACGGGTATGGCTACACCTTC	CASSQDGYGYTF	TRBV3-1	TRBJ1-2
TGCAGTGCTAGAGAGGGTCAGAACACTGAAGCTTTCTTT	CSAREGQNTEAFF	TRBV20-1	TRBJ1-1
TGTGCCAGCAGCTTGGAAGGGAGGCCCAGTCGCCGGGGGTACTTC	CASSLEGRPSRRGYF	TRBV11-2	TRBJ2-5
TGCGCCAGGTCGCCACGTGTACTAGCGGGAGGGCCCTACGAGCAGTACTTC	CARSPRVLAGGPYEQYF	TRBV10-1	TRBJ2-7
TGTGCCTGGAAAGGGGGTGGCTACACCTTC	CAWKGGGYTF	TRBV30	TRBJ1-2
TGTGCCAGGAGACTAGCGAGGGGTGAGCAGTTCTTC	CARRLARGEQFF	TRBV19	TRBJ2-1
TGTGCCAGCAGCTTGGAGACAGGGCGGGTCTACGAGCAGTACTTC	CASSLETGRVYEQYF	TRBV5-6	TRBJ2-7
TGTGCCAGCACTCAAATCGGGGGGTTGTTTGACTACGAGCAGTACTTC	CASTQIGGLFDYEQYF	TRBV27	TRBJ2-7
TGTGCCAGCAGTTTCACCCCCAGGGGTCGGGAGCAGTACTTC	CASSFTPRGREQYF	TRBV27	TRBJ2-7
TGTGCCAGCAGTAGGGGTTGTCCCAACTATGGCTACACCTTC	CASSRGCPNYGYTF	TRBV28	TRBJ1-2
TGCGCCAGCAGCTTGCAGGGGGCAACTAATGAAAAACTGTTTTTT	CASSLQGATNEKLFF	TRBV5-1	TRBJ1-4
TGTGCCAGCAGCTTCTACGAAGTTCTACGGGCCCACACCGGGGAGCTGTTTTTT	CASSFYEVLRAHTGELFF	TRBV5-4	TRBJ2-2
TGTGCCAGCAGCTATCCCGGGACTAGTTTAGTATACGGGGAGCTGTTTTTT	CASSYPGTSLVYGELFF	TRBV9	TRBJ2-2
TGTGCCAGCAGCCAGGCCGGTAATTTGCTAGCGGGGGGCCTGCCCTACAATGAGCAGTTCTTC	CASSQAGNLLAGGLPYNEQFF	TRBV3-1	TRBJ2-1
TGTGCCAGTAGTATAGTTGTGGGGAACCGGGCTTTTCTCGAGAACACTGAAGCTTTCTTT	CASSIVVGNRAFLENTEAFF	TRBV19	TRBJ1-1
TGTGCCACCGACAACTTCGGGACAGGGGGTTTAGAGACCCAGTACTTC	CATDNFGTGGLETQYF	TRBV15	TRBJ2-5
TGTGCCAGCAGTTATGATCAGCCACCCTACGAGCAGTACTTC	CASSYDQPPYEQYF	TRBV6-5	TRBJ2-7
TGTGCCAGCAGTGTACTTGCGGGACAGGGAGACTCTGGGGCCAACGTCCTGACTTTC	CASSVLAGQGDSGANVLTF	TRBV25-1	TRBJ2-6
TGCAGTGCTAGCCCTGGGAGGGACAGGATTACTAGCACCGGGGAGCTGTTTTTT	CSASPGRDRITSTGELFF	TRBV20-1	TRBJ2-2
TGCAGTGCTAGAGTTAGACAGGGGGCTGGGGCCAACGTCCTGACTTTC	CSARVRQGAGANVLTF	TRBV20-1	TRBJ2-6
TGTGCCAGCAGCCTTCCCCCGACAGGGAATTCACCCCTCCACTTT	CASSLPPTGNSPLHF	TRBV14	TRBJ1-6
TGCAGGGGTTCGGGGGGATACGAGCAGTACTTC	CRGSGGYEQYF	TRBV20-1	TRBJ2-7
TGCAGTGCGAAGGGACTAGCGGGGGGGTATGGCACAGATACGCAGTATTTT	CSAKGLAGGYGTDTQYF	TRBV20-1	TRBJ2-3
TGTGCCACCAGCAGAGCCCGGTACAGGGGGCACTCGGTACCCTACGAGCAGTACTTC	CATSRARYRGHSVPYEQYF	TRBV15	TRBJ2-7
TGCGCCAGCAGTGAGTTGGCGCGGGAGGACGAGCAGTACTTC	CASSELAREDEQYF	TRBV10-1	TRBJ2-7
TGCAGTGCTGGACACCCAGGGGGCTTGCGGAGGCTCAGGGGAGAGACCCAGTACTTC	CSAGHPGGLRRLRGETQYF	TRBV20-1	TRBJ2-5
TGTGCCAGCAGCATCCCGCGGGGGAACACCGGGGAGCTGTTTTTT	CASSIPRGNTGELFF	TRBV13	TRBJ2-2
TGTGCCAGCAGTTTACTTCCTCAGGGGTCTCGGGTTGCAACTAATGAAAAACTGTTTTTT	CASSLLPQGSRVATNEKLFF	TRBV27	TRBJ1-4
TGCAGTGCGAAGTCAGGGGGGGGGGCCTACGAGCAGTACTTC	CSAKSGGGAYEQYF	TRBV20-1	TRBJ2-7
TGTGCCAGCAGCTGCACAGGGAGCCAAGAGACCCAGTACTTC	CASSCTGSQETQYF	TRBV7-2	TRBJ2-5
TGTGCCAGCAGCCAGACTATCACGAGGCCCTACGAGCAGTACTTC	CASSQTITRPYEQYF	TRBV3-1	TRBJ2-7
TGTGCCAGCAGCTGGACAGGGGACAATCGGAAGACCCAGTACTTC	CASSWTGDNRKTQYF	TRBV7-3	TRBJ2-5
TGCAGTGCTAGAGCACCCCTGGCAGTCGGGGAGGCTTTCTTT	CSARAPLAVGEAFF	TRBV20-1	TRBJ1-1
TGTGCCACCAGCCACGCCCTACGGACAGGGGGCAATCAGCCCCAGCATTTT	CATSHALRTGGNQPQHF	TRBV15	TRBJ1-5
TGCGCCAGCAGCCAAGAATGGGGGGTGAGGACCCCTCTGTACGAGCAGTACTTC	CASSQEWGVRTPLYEQYF	TRBV4-1	TRBJ2-7
TGTGCCAGCAGCTTAGCAGCGTGGAACTATGGCTACACCTTC	CASSLAAWNYGYTF	TRBV11-2	TRBJ1-2
TGCAGTGCTAAGGGGAGCTTGGATATTCGATACGAGCAGTACTTC	CSAKGSLDIRYEQYF	TRBV20-1	TRBJ2-7
TGCGCCAGCAGCTTGGCCTACAGGGGGCGGTTGACTAACTATGGCTACACCTTC	CASSLAYRGRLTNYGYTF	TRBV5-1	TRBJ1-2
TGTGCCAGCAGCTTCCGCTCTACCAATCAGCCCCAGCATTTT	CASSFRSTNQPQHF	TRBV11-2	TRBJ1-5
TGCAGCGTTGGGGGGGGGGGGGGGAACACCGGGGAGCTGTTTTTT	CSVGGGGGNTGELFF	TRBV29-1	TRBJ2-2
TGTGCCAGCAGTAGCGGGACTAGCCCCTACGAGCAGTACTTC	CASSSGTSPYEQYF	TRBV6-4	TRBJ2-7
TGTGCCACCAGATCTTGTTCGGCGGGGATCGAGGGAAACACCATATATTTT	CATRSCSAGIEGNTIYF	TRBV24-1	TRBJ1-3
TGTGCCAGCGGAACAGGGATTTGCCGAGGCTACACCTTC	CASGTGICRGYTF	TRBV12-4	TRBJ1-2
TGTGCCAGCTCACCACAGGACAGTAGACTCTGTTATGGCTACACCTTC	CASSPQDSRLCYGYTF	TRBV18	TRBJ1-2
TGTGCCAGCAGTTTCCGGACGAGGGGCAATGAAAAACTGTTTTTT	CASSFRTRGNEKLFF	TRBV6-5	TRBJ1-4
TGTGCTAGTGGTTCTTCCAGATCGGGGAGTTCCCAAGAGACCCAGTACTTC	CASGSSRSGSSQETQYF	TRBV12-5	TRBJ2-5
TGTGCCAGCAGTGAGCGGGAGGTATCTAGCTCCTACAATGAGCAGTTCTTC	CASSEREVSSSYNEQFF	TRBV6-4	TRBJ2-1
TGTGCCAGCAAACTGGATGGGGCCAACGTCCTGACTTTC	CASKLDGANVLTF	TRBV6-1	TRBJ2-6
TGTGCCAGCAGCTTGGCCGCCGGGGGAGCTTTCTTT	CASSLAAGGAFF	TRBV5-5	TRBJ1-1
TGCGCCAGCAGCTTGACCCAGGGGAGCAATGAGCAGTTCTTC	CASSLTQGSNEQFF	TRBV5-1	TRBJ2-1
TGTGCCTGGCCGTCGACGTCGGCCGTCTACGAGCAGTACTTC	CAWPSTSAVYEQYF	TRBV30	TRBJ2-7
TGTGCCAGCAGTTTGCTGGACAGGGGTCGCCCTGAAGCTTTCTTT	CASSLLDRGRPEAFF	TRBV12-3	TRBJ1-1
TGTGCCACCAGCAGAGATAAGGAGGGAGTCCCGGTCGCTTTCTTT	CATSRDKEGVPVAFF	TRBV15	TRBJ1-1
TGTGCCAGCAGGGGGGAGACCCATGAGCAGTTCTTC	CASRGETHEQFF	TRBV6-3	TRBJ2-1
TGTGCCAGCAGCTATGGGACAGGGATACCCGAGACCCAGTACTTC	CASSYGTGIPETQYF	TRBV7-4	TRBJ2-5
TGTGCCACCATCGGTAGGGCCAGGGAGCAGTACTTC	CATIGRAREQYF	TRBV24-1	TRBJ2-7
TGCAGTGCTAATCAGGGGTTAGCCAAAAACATTCAGTACTTC	CSANQGLAKNIQYF	TRBV20-1	TRBJ2-4
TGTGCCACCAGAACAGGGATCTATGGCTACACCTTC	CATRTGIYGYTF	TRBV24-1	TRBJ1-2
TGCGCCAGCAGTAAAACGGGGGGGTGGACAGATACGCAGTATTTT	CASSKTGGWTDTQYF	TRBV4-1	TRBJ2-3
TGTGCCAGCAGTTTATGGGTCGTACTAGCGGGAGCAGGGAACACTGAAGCTTTCTTT	CASSLWVVLAGAGNTEAFF	TRBV28	TRBJ1-1
TGTGCCAGCAGTTGCACCGGCTACGTCAACGTCGGGAACACTGAAGCTTTCTTT	CASSCTGYVNVGNTEAFF	TRBV12-4	TRBJ1-1
TGCGCCAGCACCCGGGGCTCGGGTCGCTCCAATTCACCCCTCCACTTT	CASTRGSGRSNSPLHF	TRBV5-1	TRBJ1-6
TGTGCCAGCAGCCCCGGTCGGGTAATTGAGCAGTTCTTC	CASSPGRVIEQFF	TRBV13	TRBJ2-1
TGTGCCACCAGCATCCACGGTCAGCGGGACCGGTTGGCCTACGAGCAGTACTTC	CATSIHGQRDRLAYEQYF	TRBV15	TRBJ2-7
TGTGCCAGCGAATCCTCCTACGAGCAGTACTTC	CASESSYEQYF	TRBV9	TRBJ2-7
TGTGCCATCAGATCAAGACAGAAATTTCTCGGGTATAATTCACCCCTCCACTTT	CAIRSRQKFLGYNSPLHF	TRBV10-3	TRBJ1-6
TGTGCCAGCCGAGGGCGCTACGAGCAGTACTTC	CASRGRYEQYF	TRBV6-1	TRBJ2-7
TGTGCCAGCAGTGAGCGAACTAGCGGGGGGCCCCAAGAGACCCAGTACTTC	CASSERTSGGPQETQYF	TRBV6-1	TRBJ2-5
TGTGCCAGCAGTTATCTGGACGAACACTACGAGCAGTACTTC	CASSYLDEHYEQYF	TRBV6-2	TRBJ2-7
TGTGCCAGCAGGGGGCAGAGCCGATCCTACGAGCAGTACTTC	CASRGQSRSYEQYF	TRBV6-4	TRBJ2-7
TGTGCCAACCCAACGACAAACTACGAGCAGTACTTC	CANPTTNYEQYF	TRBV5-5	TRBJ2-7
TGTGCCAGCAGTTTGGGCTCGCCCTCCTACGAGCAGTACTTC	CASSLGSPSYEQYF	TRBV12-4	TRBJ2-7
TGTGCCAGGGGGCATATAGATACAGGCTATGGCTACACCTTC	CARGHIDTGYGYTF	TRBV6-5	TRBJ1-2
TGCAGTGCTAGTCCCTCAGGGGTTAAGCTCACAGATACGCAGTATTTT	CSASPSGVKLTDTQYF	TRBV20-1	TRBJ2-3
TGTGCCAGCAGCACCCGGCCGGGACAGGGGTTCAGGTACTCCTATAATTCACCCCTCCACTTT	CASSTRPGQGFRYSYNSPLHF	TRBV7-3	TRBJ1-6
TGTGCCAGCAGCTGGACAGAGACCCAGTACTTC	CASSWTETQYF	TRBV7-3	TRBJ2-5
TGTGCCAGCAGCCAGGGGGCTACTAGCTCCTATAATTCACCCCTCCACTTT	CASSQGATSSYNSPLHF	TRBV3-1	TRBJ1-6
TGTGCCAGCAGTTACGAGACACAGGGCCGCTACGAGCAGTACTTC	CASSYETQGRYEQYF	TRBV6-5	TRBJ2-7
TGTGCCAGCAGGTTAAGCTCCTATAATTCACCCCTCCACTTT	CASRLSSYNSPLHF	TRBV7-4	TRBJ1-6
TGTGCCAGCAGCAGACACCCGATTGGACAGGGGAGCATGAACACTGAAGCTTTCTTT	CASSRHPIGQGSMNTEAFF	TRBV6-1	TRBJ1-1
TGCAGTGTTCACCATGTAGGACTAGCTCTAAATGAGCAGTTCTTC	CSVHHVGLALNEQFF	TRBV20-1	TRBJ2-1
TGTGCCAGCAGCATACCCATCTACGAGCAGTACTTC	CASSIPIYEQYF	TRBV6-5	TRBJ2-7
TGCGCCAGCTGTGCTAGCGGCACAGATACGCAGTATTTT	CASCASGTDTQYF	TRBV5-1	TRBJ2-3
TGTGCCGGGGGGGCACGTCGGGACCAGCCCCAGCATTTT	CAGGARRDQPQHF	TRBV7-9	TRBJ1-5
TGTGCCAGTCTTAACAGCGTGCCTGGGAAGACCCAGTACTTC	CASLNSVPGKTQYF	TRBV19	TRBJ2-5
TGTGCCAGCAGATCCCAGGCAAGCTACGAGCAGTACTTC	CASRSQASYEQYF	TRBV27	TRBJ2-7
TGTGCCAGCAGCCACCCCCGATGGGGGGGAAACACCATATATTTT	CASSHPRWGGNTIYF	TRBV14	TRBJ1-3
TGTGCCAGCAGCGGTGGGACGGTCGCTTTCTTT	CASSGGTVAFF	TRBV13	TRBJ1-1
TGTGCCAGCAGGTACCTGGGACAGGGGGCAAAATACGAGCAGTACTTC	CASRYLGQGAKYEQYF	TRBV6-4	TRBJ2-7
TGTGCCAGCAGGGTCCGGCTCGCCAGGACCGGGGAGCTGTTTTTT	CASRVRLARTGELFF	TRBV25-1	TRBJ2-2
TGCAGTGCTGGCCCCCGGGACAGTACCAATGAGCAGTTCTTC	CSAGPRDSTNEQFF	TRBV20-1	TRBJ2-1
TGTGCCAGCAGCCATGCCGGGACTAGGGATCATGAGCAGTTCTTC	CASSHAGTRDHEQFF	TRBV27	TRBJ2-1
TGTGCCAGCAGCTTAGGGACAGGGCCAGCGGGTGAAGCTTTCTTT	CASSLGTGPAGEAFF	TRBV13	TRBJ1-1
TGTGCCAGCAGTTACAAACAGGGAGGACCCCCTGAAAAACTGTTTTTT	CASSYKQGGPPEKLFF	TRBV6-2	TRBJ1-4
TGCAGTGCTGATAGACAGCGAGTACAACAGCCCCAGCATTTT	CSADRQRVQQPQHF	TRBV20-1	TRBJ1-5
TGTGCTAGTGTCAAAAAGATATGGACAGGTTTCTGCAATCAGCCCCAGCATTTT	CASVKKIWTGFCNQPQHF	TRBV12-5	TRBJ1-5
TGTGCCAGCAGCCGCCCGGGCGGGGCCTACAATGAGCAGTTCTTC	CASSRPGGAYNEQFF	TRBV11-2	TRBJ2-1
TGTGCCAGCAGCTCGGGGACAGGGCCCGGACGATGGAAGTACTTC	CASSSGTGPGRWKYF	TRBV11-2	TRBJ2-7
TGTGCCAGCAGCCTCCGGGACAGGGTGGATGAAGTTTCCTACGAGCAGTACTTC	CASSLRDRVDEVSYEQYF	TRBV13	TRBJ2-7
TGCAGTGCTACTAGACAGGGTCACTATGGCTACACCTTC	CSATRQGHYGYTF	TRBV20-1	TRBJ1-2
TGTGGTCGACAGGGGGCCGCACCTGAAGCTTTCTTT	CGRQGAAPEAFF	TRBV12-3	TRBJ1-1
TGCGCCAGCAGCCAGCAACGGACTAGCGGGGACAATGAGCAGTTCTTC	CASSQQRTSGDNEQFF	TRBV4-1	TRBJ2-1
TGTGCCAGCAGGAGAGCCTACGAGCAGTACTTC	CASRRAYEQYF	TRBV2	TRBJ2-7
TGTGCCAGCGCTGGCGGGAGGGAGACCCAGTACTTC	CASAGGRETQYF	TRBV5-8	TRBJ2-5
TGTGCCAGCAATCCCCCCCGGCGGTTCTACACCGGGGAGCTGTTTTTT	CASNPPRRFYTGELFF	TRBV13	TRBJ2-2
TGCAGTGCTAGACCATTTGGGGCTATTAACACTGAAGCTTTCTTT	CSARPFGAINTEAFF	TRBV20-1	TRBJ1-1
TGTGCCAGCAGTGACTCGACGGAGGAGAGGGGAAGTGGAAACACCATATATTTT	CASSDSTEERGSGNTIYF	TRBV6-4	TRBJ1-3
TGTGCCAGCAGTTACGCCCAGCGGGATAGGAGGAATGAGCAGTTCTTC	CASSYAQRDRRNEQFF	TRBV6-6	TRBJ2-1
TGTGCCAGCTCACCCCCCGGGACAGGGGGAGAAAAACTGTTTTTT	CASSPPGTGGEKLFF	TRBV18	TRBJ1-4
TGTGCCAGCAGCCGTGTAATAGAGCCAAAGAACACCGGGGAGCTGTTTTTT	CASSRVIEPKNTGELFF	TRBV7-6	TRBJ2-2
TGTGCCAGCAGCCCCGTACTAGCGGTAAAAGGGTACAATGAGCAGTTCTTC	CASSPVLAVKGYNEQFF	TRBV11-2	TRBJ2-1
TGTGCCAGCAGCCCGGGGGGCGGGAGGACAGATACGCAGTATTTT	CASSPGGGRTDTQYF	TRBV5-4	TRBJ2-3
TGTGCCAGCAGCGTGACCGTTGGGGGACAGAATGAGCAGTTCTTC	CASSVTVGGQNEQFF	TRBV9	TRBJ2-1
TGCGCCAGCAGTGACCACCGGGACAGCAGTAATGCAACTAATGAAAAACTGTTTTTT	CASSDHRDSSNATNEKLFF	TRBV10-1	TRBJ1-4
TGTGCCAGCAGCCAGCGAGGACTGTTTTTCTTAGCGGGATTCTATAGTCAGCCCCAGCATTTT	CASSQRGLFFLAGFYSQPQHF	TRBV14	TRBJ1-5
TGTGCCAGCAGCTTAGTTGCGTATATCCAATGCTACACCTTC	CASSLVAYIQCYTF	TRBV11-2	TRBJ1-2
TGTGCCAGCAGTGAGACTCGGGAGGACGGCTACGAGCAGTACTTC	CASSETREDGYEQYF	TRBV6-4	TRBJ2-7
TGCGCCAGCACAGGGAGGGGCTACGAGCAGTACTTC	CASTGRGYEQYF	TRBV10-1	TRBJ2-7
TGTGCCACCAGCTTACAACAGGGTCAGCCCCAGCATTTT	CATSLQQGQPQHF	TRBV15	TRBJ1-5
TGTGCCAGCAGTGACAACATGAACCGGAGTCAGCCCCAGCATTTT	CASSDNMNRSQPQHF	TRBV6-1	TRBJ1-5
TGCGCCCCAGGCAGGCCCGGTTCCAAAAACATTCAGTACTTC	CAPGRPGSKNIQYF	TRBV5-1	TRBJ2-4
TGCGCCAGCAGCCAAGATCCTCCAACGGGGAAACCTTCACCCCTCCACTTT	CASSQDPPTGKPSPLHF	TRBV4-3	TRBJ1-6
TGTGCCAGCAGCTTTGGGGGCAGGGATGAGCAGTTCTTC	CASSFGGRDEQFF	TRBV7-8	TRBJ2-1
TGTTGGACTACAGGAAACTATGGCTACACCTTC	CWTTGNYGYTF	TRBV11-1	TRBJ1-2
TGCGCCAGCAGCTTGCATGAGGGTAACACTGAAGCTTTCTTT	CASSLHEGNTEAFF	TRBV5-1	TRBJ1-1
TGTGCCACCAGTCGTCCCGTGGCGGGAGGGCCAAATTCACCCCTCCACTTT	CATSRPVAGGPNSPLHF	TRBV24-1	TRBJ1-6
TGTGCCACCAGCAGACAGACAGTCGGCGAACGGAACACCTTC	CATSRQTVGERNTF	TRBV15	TRBJ1-2
TGTGCCAGCAGTTCCTCGGGACAGGGGGGAGAATGTGGCTACACCTTC	CASSSSGQGGECGYTF	TRBV12-3	TRBJ1-2
TGTGCCAGGGTGAAGGACTCCTACAATGAGCAGTTCTTC	CARVKDSYNEQFF	TRBV19	TRBJ2-1
TGTGCCAGCAGGGAACCTCCGGGACAGGGGAATCAGCATCAGCCCCAGCATTTT	CASREPPGQGNQHQPQHF	TRBV6-5	TRBJ1-5
TGTGCCAGCAGCTTTTACGGGTGCTCCTACGAGCAGTACTTC	CASSFYGCSYEQYF	TRBV11-3	TRBJ2-7
TGCGCCAGCAGTGGTGACAATGAGCAGTTCTTC	CASSGDNEQFF	TRBV10-1	TRBJ2-1
TGTGCCAGCAGCCAAGGTGACAGGGGGAACTATGGCTACACCTTC	CASSQGDRGNYGYTF	TRBV3-1	TRBJ1-2
TGTGCCAGCAGCTTGAAGAAAGGGGCCACCTACAATGAGCAGTTCTTC	CASSLKKGATYNEQFF	TRBV5-4	TRBJ2-1
TGTGCCAGCAGCCGGGAACCGGGACAGGGGATTCAGCCCCAGCATTTT	CASSREPGQGIQPQHF	TRBV7-9	TRBJ1-5
TGTGCCAGCAGCTCCCAGCGGGACGAGCAGTTCTTC	CASSSQRDEQFF	TRBV11-2	TRBJ2-1
TGTGCCATCAGTGAGCTGGCAGGGGCCGGATATGAGCAGTTCTTC	CAISELAGAGYEQFF	TRBV10-3	TRBJ2-1
TGTGCCAGCAGAGAACCGGGAGGCCGCTCTGGAAACACCATATATTTT	CASREPGGRSGNTIYF	TRBV6-5	TRBJ1-3
TGTGCCAGCAGTTTACCCGGACGCTATGGCTACACCTTC	CASSLPGRYGYTF	TRBV27	TRBJ1-2
TGTGCCAGCAGTTCGCTAACTTTAAGGTACTACGAGCAGTACTTC	CASSSLTLRYYEQYF	TRBV6-9	TRBJ2-7
TGCGCCAGCTCTCCCCGTTCAAGCATGCCCCAGCATTTT	CASSPRSSMPQHF	TRBV10-1	TRBJ1-5
TGTGCTAGGGAGTATAGTTTCCAGCCCCAGCATTTT	CAREYSFQPQHF	TRBV12-5	TRBJ1-5
TGTGCCAGCCCCGGGACTAGCGGGGCGCAGTATTTT	CASPGTSGAQYF	TRBV27	TRBJ2-3
TGTGCCAGCAGTAGGGACAGGGCCCCTGGCTACACCTTC	CASSRDRAPGYTF	TRBV6-4	TRBJ1-2
TGCGCCAGCAGCCAGAGAGGGGGCAACAATGAGCAGTTCTTC	CASSQRGGNNEQFF	TRBV4-1	TRBJ2-1
TGTGCCACCAAGGGACTAGTTCACAATGAGCAGTTCTTC	CATKGLVHNEQFF	TRBV24-1	TRBJ2-1
TGCAGTGCTGTCGGACAGGGAGTGGGTTCTTGTTCGTACACCGGGGAGCTGTTTTTT	CSAVGQGVGSCSYTGELFF	TRBV20-1	TRBJ2-2
TGTGCCAGCAGGGGCTGGCCCCAGCATTTT	CASRGWPQHF	TRBV2	TRBJ1-5
TGTGCCAGCAGTGAACCTTGGACAGGGAACACCATATATTTT	CASSEPWTGNTIYF	TRBV6-1	TRBJ1-3
TGTGCCAGCAGCGTATCTAAAGGGGTTGGCCCTTTGCCCCAGCATTTT	CASSVSKGVGPLPQHF	TRBV9	TRBJ1-5
TGTGCCAGCAGCGGATGTTGGAGGGATGAGCAGTTCTTC	CASSGCWRDEQFF	TRBV5-6	TRBJ2-1
TGTGCCATCTACGGACTAGGTCGCACAGATACGCAGTATTTT	CAIYGLGRTDTQYF	TRBV19	TRBJ2-3
TGCAGCGGAAACAAATCAGAGCTAGAGTGCTACGAGCAGTACTTC	CSGNKSELECYEQYF	TRBV29-1	TRBJ2-7
TGCAGTGCAGCGAGGTCCTATGATACGCAGTATTTT	CSAARSYDTQYF	TRBV20-1	TRBJ2-3
TGCAGCGAATACGGCGAGGGGCGCACTGAAGCTTTCTTT	CSEYGEGRTEAFF	TRBV29-1	TRBJ1-1
TGTGCCATCAGTGGCGGGGGGGCGCTGTACGAGCAGTACTTC	CAISGGGALYEQYF	TRBV10-3	TRBJ2-7
TGTGCCTGGAGAGCCGCCAACGCCGGGACAGGGGACGAAGCTTTCTTT	CAWRAANAGTGDEAFF	TRBV30	TRBJ1-1
TGTGCCATCAGTCCAAGAGGGGTTGTCTACGAGCAGTACTTC	CAISPRGVVYEQYF	TRBV10-3	TRBJ2-7
TGCAGTGCTAGAGCGAGCCAGGGGGGTAATCAGCCCCAGCATTTT	CSARASQGGNQPQHF	TRBV20-1	TRBJ1-5
TGTGCCAGCTCTGAGGGGGGTAGGGACCGCACAGATACGCAGTATTTT	CASSEGGRDRTDTQYF	TRBV27	TRBJ2-3
TGCAGTGCTGTAGGAACCGGGGGGGAAAGCTACACCTTC	CSAVGTGGESYTF	TRBV20-1	TRBJ1-2
TGCAGCCGGGGACCGCTACGCACCGGGGAGCTGTTTTTT	CSRGPLRTGELFF	TRBV29-1	TRBJ2-2
TGTGCCTGGAGGAGGACAGGGGGTCAGCCCCAGCATTTT	CAWRRTGGQPQHF	TRBV30	TRBJ1-5
TGTGCCAGCAGACCCGCAAGGTGGAACACAGATACGCAGTATTTT	CASRPARWNTDTQYF	TRBV12-3	TRBJ2-3
TGCAGTGCTGTGACAGGGCTACACACTGAAGCTTTCTTT	CSAVTGLHTEAFF	TRBV20-1	TRBJ1-1
TGTGCCAGCAGCGTATGGGGCGCAGGAGGAAACGAGCAGTACTTC	CASSVWGAGGNEQYF	TRBV9	TRBJ2-7
TGTGCCAGCAGTTCCACTTTCGCCCAAGTGCAGGGGGACTCCTACGAGCAGTACTTC	CASSSTFAQVQGDSYEQYF	TRBV6-5	TRBJ2-7
TGTGCCAGCTCACCCTCGGGACAGACAAGACGTGAAGCTTTCTTT	CASSPSGQTRREAFF	TRBV18	TRBJ1-1
TGTGCCAGCAGTAATGACGTGGGTCAGCCCCAGCATTTT	CASSNDVGQPQHF	TRBV5-6	TRBJ1-5
TGCAGTGCTAAGACTAGCGGGGGGGCCGGCCCAAGCTCCTACGAGCAGTACTTC	CSAKTSGGAGPSSYEQYF	TRBV20-1	TRBJ2-7
TGTGCCAGCAGCCCAGGGAGACGAGTCTTT	CASSPGRRVF	TRBV7-9	TRBJ1-1
TGCAGTGCAAGACTGGACAGGTGGGGACATTTCTCTGGAAACACCATATATTTT	CSARLDRWGHFSGNTIYF	TRBV20-1	TRBJ1-3
TGCAGTGCTAGAGCCCCCCGAGGACTAGCGGCGGCCTACGAGCAGTACTTC	CSARAPRGLAAAYEQYF	TRBV20-1	TRBJ2-7
TGTGCCAGCAGTGAAGAAACAGGCTGCACAGATACGCAGTATTTT	CASSEETGCTDTQYF	TRBV6-1	TRBJ2-3
TGTGCCAGCAGCAAATGTACCTCTGGAAACACCATATATTTT	CASSKCTSGNTIYF	TRBV5-6	TRBJ1-3
TGTGCCTGGAGTGTCCCCGAGGGCTATAATTCACCCCTCCACTTT	CAWSVPEGYNSPLHF	TRBV30	TRBJ1-6
TGTGCCAGCAGCTTAGCAGGACAGGGGGCGGTCCAAGCTTTCTTT	CASSLAGQGAVQAFF	TRBV7-6	TRBJ1-1
TGTGCCAGCAGCCCACTAGCGGGGGCAAGAGATACGCAGTATTTT	CASSPLAGARDTQYF	TRBV11-3	TRBJ2-3
TGCAGCCCCCGCTCAACAGGTAAAAGGTCACCCCTCCACTTT	CSPRSTGKRSPLHF	TRBV29-1	TRBJ1-6
TGTGCCAGACTGACGGGAGCCAAAAACATTCAGTACTTC	CARLTGAKNIQYF	TRBV27	TRBJ2-4
TGTGCCAGCAGCAACCGACTAGCGGGAGCGGTGGGTCCTAACTATGGCTACACCTTC	CASSNRLAGAVGPNYGYTF	TRBV11-3	TRBJ1-2
TGTGCCAGCAGCGAGTTACAGGGTGTACCGAGGAAGCAGTGCGAGCAGTACTTC	CASSELQGVPRKQCEQYF	TRBV5-4	TRBJ2-7
TGTGCCAGCAGGGGAAGGCGGGCCTACGAGCAGTACTTC	CASRGRRAYEQYF	TRBV27	TRBJ2-7
TGTGCCAGCAGCCAAGATCGGAGATGGGGGCGCTACGAGCAGTACTTC	CASSQDRRWGRYEQYF	TRBV3-1	TRBJ2-7
TGTGCCAGCAGCTGCGGGTCGCTAGCGGGTAAAATACTCTACGAGCAGTACTTC	CASSCGSLAGKILYEQYF	TRBV5-6	TRBJ2-7
TGTGCCAGCAGCTCCAGGGGGTCTCGGGCCAACGTCCTGACTTTC	CASSSRGSRANVLTF	TRBV13	TRBJ2-6
TGCGCCAGCAGCTTGCGCCAGAGCGGTGAGCAGTTCTTC	CASSLRQSGEQFF	TRBV5-1	TRBJ2-1
TGTGCCAGCAGCACAAGCGGAGTCCTCAATGAAAAACTGTTTTTT	CASSTSGVLNEKLFF	TRBV9	TRBJ1-4
TGTGCTAGTGGTCCTAGGGTCGAGACCCAGTACTTC	CASGPRVETQYF	TRBV12-5	TRBJ2-5
TGTGCCAGCAGTAAAGATCTCCAAAGGACCGGGTCCTACGAGCAGTACTTC	CASSKDLQRTGSYEQYF	TRBV6-5	TRBJ2-7
TGCGGCCAGGGTGATCAGCCCCAGCATTTT	CGQGDQPQHF	TRBV20-1	TRBJ1-5
TGCGCCAGCAGCTTGGCTACAATGGGTAATTCACCCCTCCACTTT	CASSLATMGNSPLHF	TRBV5-1	TRBJ1-6
TGTGCCAGCAGCCCCCATATAAGACAGAAGAACACTGAAGCTTTCTTT	CASSPHIRQKNTEAFF	TRBV6-4	TRBJ1-1
TGTGCCAGCAGGGTCCGGACAGGCACTGGCTACACCTTC	CASRVRTGTGYTF	TRBV6-2	TRBJ1-2
TGTGCCAGCAGCCCACGAGGGGGGGTTATGGCCGAGCAGTACTTC	CASSPRGGVMAEQYF	TRBV9	TRBJ2-7
TGTGCCAGCAGAAGAGGGATAGACTCCTACAATGAGCAGTTCTTC	CASRRGIDSYNEQFF	TRBV5-6	TRBJ2-1
TGTGCCAGCAGCCCGTCCAGGGGGCAAGCTTTCTTT	CASSPSRGQAFF	TRBV13	TRBJ1-1
TGTGCCAGCAGCTCCCGTGTACTAGCGGGAGACCCGAGCTCTGGAAACACCATATATTTT	CASSSRVLAGDPSSGNTIYF	TRBV7-2	TRBJ1-3
TGCAGTGCTAGGGACGATCCCCGGAGCAACTACGAGCAGTACTTC	CSARDDPRSNYEQYF	TRBV20-1	TRBJ2-7
TGTGCCAGCAGCCGCCAGACAGGTCAAAATTCACCCCTCCACTTT	CASSRQTGQNSPLHF	TRBV7-9	TRBJ1-6
TGTGCCAGCAGTTTATCGAGGCAGGGACGCAATCAGCCCCAGCATTTT	CASSLSRQGRNQPQHF	TRBV27	TRBJ1-5
TGTGCCACGGAGACAGACTGTCAGCCCCAGCATTTT	CATETDCQPQHF	TRBV6-5	TRBJ1-5
TGTGCCAGCAGCATCTGGGGGGGCGGCTATTACAATGAGCAGTTCTTC	CASSIWGGGYYNEQFF	TRBV9	TRBJ2-1
TGTGCCACAAAGGGACTAGCGGGTAGGACCAATGAGCAGTTCTTC	CATKGLAGRTNEQFF	TRBV27	TRBJ2-1
TGTGCCAGCAGCTTTTGGGGGACAGGGCTAATCAGGGCGGTGAACACTGAAGCTTTCTTT	CASSFWGTGLIRAVNTEAFF	TRBV7-7	TRBJ1-1
TGTGCCAGCCGGGACAGGACTGAGACCCAGTACTTC	CASRDRTETQYF	TRBV9	TRBJ2-5
TGTGCCAGCAGCAACGGAGGGGACTATGGCTACACCTTC	CASSNGGDYGYTF	TRBV7-4	TRBJ1-2
TGTGCCTGGAGTGTACCCGCCCCTGGTAGGGGGGGGCACGTCCAGCCCCAGCATTTT	CAWSVPAPGRGGHVQPQHF	TRBV30	TRBJ1-5
TGTGCCAGCAGCAAACGGCCTAACTATCAGCCCCAGCATTTT	CASSKRPNYQPQHF	TRBV13	TRBJ1-5
TGTGCCAGCAGTAAAACCGGGACAGGGGGGTGCTACGAGCAGTACTTC	CASSKTGTGGCYEQYF	TRBV28	TRBJ2-7
TGCAGTGCTAGACGAAGACTCTCAGAAAGCACAGATACGCAGTATTTT	CSARRRLSESTDTQYF	TRBV20-1	TRBJ2-3
TGTGCCAGCAGTTCGAAAATCACCGCCTATGGCTACACCTTC	CASSSKITAYGYTF	TRBV6-5	TRBJ1-2
TGTGCCACCGTAGAGGACAGTATATGCAATGAGCAGTTCTTC	CATVEDSICNEQFF	TRBV24-1	TRBJ2-1
TGCGCCAGCAGCAGTAATCGGACTAGCGGGAGATACAATGAGCAGTTCTTC	CASSSNRTSGRYNEQFF	TRBV5-1	TRBJ2-1
TGTGCCAGCAGCGTAGGACAGGGAGTGAGGGACACTGAAGCTTTCTTT	CASSVGQGVRDTEAFF	TRBV9	TRBJ1-1
TGTGCTAGTGGTCCATCACGGCGGGTTGGAAACACCATATATTTT	CASGPSRRVGNTIYF	TRBV12-5	TRBJ1-3
TGCAGTGCTAGCCGACCGCGGGAGATCGAGACCCAGTACTTC	CSASRPREIETQYF	TRBV20-1	TRBJ2-5
TGTGCCAGCAGCCGTAGGAGGCGTAGCACAGATACGCAGTATTTT	CASSRRRRSTDTQYF	TRBV7-3	TRBJ2-3
TGTGCCAGCAGCTTCAGGGGTCACGACACTGAAGCTTTCTTT	CASSFRGHDTEAFF	TRBV7-9	TRBJ1-1
TGTGCCAGCAGCACAGAGACAGGGAATTACATAGAGACCCAGTACTTC	CASSTETGNYIETQYF	TRBV13	TRBJ2-5
TGCGCCCCCGCGGGACAGGGAGTCTTC	CAPAGQGVF	TRBV10-2	TRBJ2-1
TGTGCCAGCAGCCACCCCACGGCGAACACTGAAGCTTTCTTT	CASSHPTANTEAFF	TRBV7-9	TRBJ1-1
TGTGCCAGCAGCGGGAGGGATGGGAACTATGGCTACACCTTC	CASSGRDGNYGYTF	TRBV3-1	TRBJ1-2
TGTGCCATCACGGTCCGAGGGGGAGGCTACACCTTC	CAITVRGGGYTF	TRBV10-3	TRBJ1-2
TGTGCCAGCATTTCCCAACTAGAAGGCCAGTACTTC	CASISQLEGQYF	TRBV27	TRBJ2-5
TGTGCCAGCAGCCCGCCCCCCGGACTAGTTCAAGAGACCCAGTACTTC	CASSPPPGLVQETQYF	TRBV13	TRBJ2-5
TGTGCCAGCAGTTACCTGGACAGGGAGGGGGAGCTGTTTTTT	CASSYLDREGELFF	TRBV6-2	TRBJ2-2
TGTGCCAGCAGCTCTACAGACTCGGGCAACAATGAGCAGTTCTTC	CASSSTDSGNNEQFF	TRBV9	TRBJ2-1
TGTGCCAGCAGCTTCAAACACGGAATTAGCAATCAGCCCCAGCATTTT	CASSFKHGISNQPQHF	TRBV7-6	TRBJ1-5
TGCGCCAGCAGCCCTGACAGCCGCCCTGGGGCCAACGTCCTGACTTTC	CASSPDSRPGANVLTF	TRBV4-3	TRBJ2-6
TGTGCCAGTAGTATGCCGGGGGACGAGCAGTACTTC	CASSMPGDEQYF	TRBV19	TRBJ2-7
TGCAGTGCCACTTCCCCGGGGGGCTTCCTCGAGCAGTACTTC	CSATSPGGFLEQYF	TRBV20-1	TRBJ2-7
TGTGCCAGCAGCCGGACGGGCCCCTCCTACAATGAGCAGTTCTTC	CASSRTGPSYNEQFF	TRBV27	TRBJ2-1
TGCAGTGCTGGACCTCGCACAGACTATGGCTACACCTTC	CSAGPRTDYGYTF	TRBV20-1	TRBJ1-2
TGTGCCAGCTCACCAGGGGCGGTGGCTAACTATGGCTACACCTTC	CASSPGAVANYGYTF	TRBV18	TRBJ1-2
TGTGCCAGCAGCCTCCTAGCGGGGGGGCACAATGAGCAGTTCTTC	CASSLLAGGHNEQFF	TRBV7-4	TRBJ2-1
TGTGCCAGCAGCTCCCATTTGTATCTTTTCGAGCAGTACTTC	CASSSHLYLFEQYF	TRBV7-9	TRBJ2-7
TGTGCCAGTAGTATACCGGACCGGGACAGAAGGCTAAATCAGCCCCAGCATTTT	CASSIPDRDRRLNQPQHF	TRBV19	TRBJ1-5
TGTGCTAGTGGTTTGGTTCGGCACGGAAACACCATATATTTT	CASGLVRHGNTIYF	TRBV12-5	TRBJ1-3
TGCGCCAGCAGCCTGGGGACAGGGACCAATCAGCCCCAGCATTTT	CASSLGTGTNQPQHF	TRBV4-3	TRBJ1-5
TGTGCCGAAGGCGGTATGATGCCCGACTACAATGAGCAGTTCTTC	CAEGGMMPDYNEQFF	TRBV6-5	TRBJ2-1
TGTGCCAGCAGCAGTTGTCACCCGCGACCACGAGTGTGCAATCAGCCCCAGCATTTT	CASSSCHPRPRVCNQPQHF	TRBV9	TRBJ1-5
TGTGCCAGTAGTTCGGGGGACATCGAGACCCAGTACTTC	CASSSGDIETQYF	TRBV19	TRBJ2-5
TGTGCCAGCAGTGACTCTGAGGGGCCATCGCAGGGGTCCCGGCGGGACAATGAGCAGTTCTTC	CASSDSEGPSQGSRRDNEQFF	TRBV6-4	TRBJ2-1
TGTGCCAGCAGTTATTCGGCTATGGGGGGGGCTGAGACCCAGTACTTC	CASSYSAMGGAETQYF	TRBV6-8	TRBJ2-5
TGCGCCAGCAGCAAACCTGAAATGGGCTATGGCTACACCTTC	CASSKPEMGYGYTF	TRBV5-1	TRBJ1-2
TGCGCCAGCAGTGTCCCGGACACCCCGGCTAATGAAAAACTGTTTTTT	CASSVPDTPANEKLFF	TRBV10-1	TRBJ1-4
TGTGCCAGCAGCCCCTCCCCTATGGCGACAGGGTGGGGATTGAGATATAGCAATCAGCCCCAGCATTTT	CASSPSPMATGWGLRYSNQPQHF	TRBV9	TRBJ1-5
TGTGCCAGCAGTGAGCGGGACGGGACCCAGTACTTC	CASSERDGTQYF	TRBV27	TRBJ2-5
TGTGCCAGCAGCTCCCCCCGACAGGGGAACCAATCGGGCTACACCTTC	CASSSPRQGNQSGYTF	TRBV11-3	TRBJ1-2
TGTGCCAGCAGAACGGGGGGCAATGAGCAGTTCTTC	CASRTGGNEQFF	TRBV5-6	TRBJ2-1
TGTGCCAGCAGTTATCGCGAGGGGGGCAATGAGCAGTTCTTC	CASSYREGGNEQFF	TRBV6-5	TRBJ2-1
TGTGCCTGGAGTGTACGGCAAGTGCCCGGGACTAGTGGGTCAGATACGCAGTATTTT	CAWSVRQVPGTSGSDTQYF	TRBV30	TRBJ2-3
TGTGCCAGCGAAATAGCGAACACTGAAGCTTTCTTT	CASEIANTEAFF	TRBV6-1	TRBJ1-1
TGTGCCAGCAACGGTAAGGGTCAGCCCCAGCATTTT	CASNGKGQPQHF	TRBV27	TRBJ1-5
TGTGCCAGCAGCCCCATCGATCGGGGGACCTACGAGCAGTACTTC	CASSPIDRGTYEQYF	TRBV14	TRBJ2-7
TGTGCCAGCAGTTTGGGGACTAGCGGGAAGCGCTCCTACGAGCAGTACTTC	CASSLGTSGKRSYEQYF	TRBV12-4	TRBJ2-7
TGTGCCAGCAGTGACTCCCCCCCCGGGGGCGGGGATCAGCCCCAGCATTTT	CASSDSPPGGGDQPQHF	TRBV6-4	TRBJ1-5
TGTGCCAGCAGTTGGAGGCGTACAGTAGCCAAAAACATTCAGTACTTC	CASSWRRTVAKNIQYF	TRBV6-6	TRBJ2-4
TGTGCCAGCAGTTACCAATCCTTCCCTTTGTCTGAAGCTTTCTTT	CASSYQSFPLSEAFF	TRBV6-5	TRBJ1-1
TGTGCCAGTAGTATAAGGGACAGGGGGCTCCGCTATGGCTACACCTTC	CASSIRDRGLRYGYTF	TRBV19	TRBJ1-2
TGTGCCAGCAGCAACCCCCAAGTAAAGACGATTTTCTCTGGAAACACCATATATTTT	CASSNPQVKTIFSGNTIYF	TRBV13	TRBJ1-3
TGTGCCATCACTGCGGGAGGCAATGAAAAACTGTTTTTT	CAITAGGNEKLFF	TRBV10-3	TRBJ1-4
TGCGCCAACGACAGGAATTACGGGGAGCTGTTTTTT	CANDRNYGELFF	TRBV10-1	TRBJ2-2
TGTGCCAGCAGCCCCCCAGGGCATCAGCCCCAGCATTTT	CASSPPGHQPQHF	TRBV11-1	TRBJ1-5
TGCGCCAGCAGCTTCTCACACAGGGCTTTAACTGAAGCTTTCTTT	CASSFSHRALTEAFF	TRBV5-1	TRBJ1-1
TGTGCCAGCAGTTACCGTATACAGGCCGTTGATAATTCACCCCTCCACTTT	CASSYRIQAVDNSPLHF	TRBV6-5	TRBJ1-6
TGCAGCGTTTACGGCGGTCAAGAGACCCAGTACTTC	CSVYGGQETQYF	TRBV29-1	TRBJ2-5
TGCAGTGCTCAAGGGGTATCAGTAGCCTATGGCTACACCTTC	CSAQGVSVAYGYTF	TRBV20-1	TRBJ1-2
TGCGCCAGCAGCTCTGGGCAGGAGGGGTTATCTGGAAACACCATATATTTT	CASSSGQEGLSGNTIYF	TRBV5-1	TRBJ1-3
TGTGCCAGCAGTTTCGCGCCCTACGAGCAGTACTTC	CASSFAPYEQYF	TRBV27	TRBJ2-7
TGTGCCAGCAGATACCAGGGCTGGAACTACGAGCAGTACTTC	CASRYQGWNYEQYF	TRBV27	TRBJ2-7
TGTGCCAGCAGCTTAGGCAACAGATGGCCGGGACAGGGAAACACTGAAGCTTTCTTT	CASSLGNRWPGQGNTEAFF	TRBV7-9	TRBJ1-1
TGCGCCAGCGGGGGGACCCGCTATGGCTACACCTTC	CASGGTRYGYTF	TRBV5-1	TRBJ1-2
TGTGCCAGCAGCTTACCCCGTAACCCCTGGGACGGTCACTATGGCTACACCTTC	CASSLPRNPWDGHYGYTF	TRBV7-9	TRBJ1-2
TGTGCCAGCCGCCAAGAATGTGGAAACACCATATATTTT	CASRQECGNTIYF	TRBV7-9	TRBJ1-3
TGCGCCAGCAGTCTGTCGTCAGACACCTTC	CASSLSSDTF	TRBV10-1	TRBJ1-2
TGTGCCAGCAGCGTTACTAGCGGGAGGGCGCCTGGGAGTGGAAACACCATATATTTT	CASSVTSGRAPGSGNTIYF	TRBV5-4	TRBJ1-3
TGTGCCAGCAGCCGGGACAGGCCCTACGAGCAGTACTTC	CASSRDRPYEQYF	TRBV13	TRBJ2-7
TGCAGTGCCCCAGGGTCTCCCACAGATACGCAGTATTTT	CSAPGSPTDTQYF	TRBV20-1	TRBJ2-3
TGCAGCAAGGGACTAAGCACAGATACGCAGTATTTT	CSKGLSTDTQYF	TRBV29-1	TRBJ2-3
TGTGCCAGTAGTATAGCAATACTCGGGATGGGTCAGAGGGGAGAGACCCAGTACTTC	CASSIAILGMGQRGETQYF	TRBV19	TRBJ2-5
TGTGCCAGCAGCCCGGGGGGACCTACAGATACGCAGTATTTT	CASSPGGPTDTQYF	TRBV5-4	TRBJ2-3
TGTGCCAGCAGCTTAGCCGGGGACCCACGCTATAGCAATCAGCCCCAGCATTTT	CASSLAGDPRYSNQPQHF	TRBV11-3	TRBJ1-5
TGTGCCAGCAGCTCGATTTTATCCAACAAGGCGAACACCGGGGAGCTGTTTTTT	CASSSILSNKANTGELFF	TRBV7-2	TRBJ2-2
TGTGCCAGCAGCCTGACTAGCGGGGGTCATGAGCAGTTCTTC	CASSLTSGGHEQFF	TRBV13	TRBJ2-1
TGTGCCAGCAGCAAAGGCCGGGACAGAGATGGCTACACCTTC	CASSKGRDRDGYTF	TRBV11-3	TRBJ1-2
TGCGCCAGCAGCCAAGAGAAGAAACAGACGTTTAATGGCTACACCTTC	CASSQEKKQTFNGYTF	TRBV4-3	TRBJ1-2
TGTGCCAGCAGCAGCCAGCCAAGCCGGTACAATGAGCAGTTCTTC	CASSSQPSRYNEQFF	TRBV13	TRBJ2-1
TGTGCCAGGGTTGGTACTATGGCCTACAATGAGCAGTTCTTC	CARVGTMAYNEQFF	TRBV6-4	TRBJ2-1
TGTGCCAGCAGCGGAGAGGACCGCGGCAGGGATACGCAGTATTTT	CASSGEDRGRDTQYF	TRBV5-6	TRBJ2-3
TGTGCCAGCAGCTCAAAGCGAGAGTACTACAATGAGCAGTTCTTC	CASSSKREYYNEQFF	TRBV7-3	TRBJ2-1
TGTGCCAGCATTGGAAGTGGTAATGAAAAACTGTTTTTT	CASIGSGNEKLFF	TRBV6-2	TRBJ1-4
TGTGCCAGCAGCTCTATTCGGGGTCTAACGAGTAAAGGGCTAGACTATGGCTACACCTTC	CASSSIRGLTSKGLDYGYTF	TRBV5-6	TRBJ1-2
TGCGCCAGCACCGGGACTAGAACGGCCGGGGAGCTGTTTTTT	CASTGTRTAGELFF	TRBV10-2	TRBJ2-2
TGTGCCAGCAGACCTTCAACAGGCAGGGGGAAGAGCAATCAGCCCCAGCATTTT	CASRPSTGRGKSNQPQHF	TRBV12-4	TRBJ1-5
TGTGCCACCACCAAATCCCTGGACAGGCAAGAGACCCAGTACTTC	CATTKSLDRQETQYF	TRBV24-1	TRBJ2-5
TGTGCCAGCAGGATACCGGGACTAGCCCCTACTCCCGGGCCAGATACGCAGTATTTT	CASRIPGLAPTPGPDTQYF	TRBV6-4	TRBJ2-3
TGTGCCAGCAGTCCCCCCCCGGGACAGGGGGCCTATGGCTACACCTTC	CASSPPPGQGAYGYTF	TRBV6-3	TRBJ1-2
TGTGCCAGCAGCTGTACGGGAATTCGAGAGCAGTACTTC	CASSCTGIREQYF	TRBV5-6	TRBJ2-7
TGTGCCAGCAGCTTAGATTTAGAACAGGGGAATGAGCAGTTCTTC	CASSLDLEQGNEQFF	TRBV11-2	TRBJ2-1
TGTGCCAGCAGCCAACGCGAGCGGGGGCCTGGGGCCAACGTCCTGACTTTC	CASSQRERGPGANVLTF	TRBV4-2	TRBJ2-6
TGCAGTGCCGGGACAGGCGGCTACACCTTC	CSAGTGGYTF	TRBV20-1	TRBJ1-2
TGCGCCAGCAGCCAAGAGGGGGTCTATCAGCCCCAGCATTTT	CASSQEGVYQPQHF	TRBV4-3	TRBJ1-5
TGTGCCAGCAGCTTAAGGACAGTCGGAGGCGGCACAGATACGCAGTATTTT	CASSLRTVGGGTDTQYF	TRBV7-3	TRBJ2-3
TGTGCCACCAGCGGGGGAACGAAGGGCCTTTCCTCTGGAAACACCATATATTTT	CATSGGTKGLSSGNTIYF	TRBV15	TRBJ1-3
TGCGCCAGCAGCTTGTACCCCCCCCGGGACATAGCCAGTAGCGCCAAAAACATTCAGTACTTC	CASSLYPPRDIASSAKNIQYF	TRBV5-1	TRBJ2-4
TGTGCCAGCAGGGGCCGGTGGACAGGGGTCGAGCAGTACTTC	CASRGRWTGVEQYF	TRBV7-3	TRBJ2-7
TGTGCCAGCAGCGTAGTCCCTGGGATTTGGGGGGGCCCCAGGGCTGGGGTGGTCAAAAACATTCAGTACTTC	CASSVVPGIWGGPRAGVVKNIQYF	TRBV9	TRBJ2-4
TGTGCCAGCAGTTTACTAGCGGGAGTTACTGCAGCTTTCTTT	CASSLLAGVTAAFF	TRBV12-4	TRBJ1-1
TGTGCCAGCTCCCATTTCGGGGGTGAAGATACGCAGTATTTT	CASSHFGGEDTQYF	TRBV18	TRBJ2-3
TGTGCCAGCAGCTTAGATTTCAGACCCGAGCTAGTCGAGCAGTACTTC	CASSLDFRPELVEQYF	TRBV11-3	TRBJ2-7
TGCAGTGCTGTCAGGCGCTCAGAGACCCAGTACTTC	CSAVRRSETQYF	TRBV20-1	TRBJ2-5
TGTGCCAGCAGTTTAGTGGTTTTTCGCGAGCAAACGGGACAGGGGAAGTATAGCAATCAGCCCCAGCATTTT	CASSLVVFREQTGQGKYSNQPQHF	TRBV12-3	TRBJ1-5
TGCAGCGTTTCCCACCCATCCTACGAGCAGTACTTC	CSVSHPSYEQYF	TRBV29-1	TRBJ2-7
TGTGCCAGCAGTTTATTCTTTGGGACTCAGGGCTACAATGAGCAGTTCTTC	CASSLFFGTQGYNEQFF	TRBV28	TRBJ2-1
TGTGCCAGCAGCAGGGGGCGCCGGGACACTGAAGCTTTCTTT	CASSRGRRDTEAFF	TRBV7-2	TRBJ1-1
TGTGCCAATCGAAGTCAATTGATCTCTGGGGCCAACGTCCTGACTTTC	CANRSQLISGANVLTF	TRBV6-5	TRBJ2-6
TGTGCCAGCAGCTTGATAAGACCGCAGGATCAGCCCCAGCATTTT	CASSLIRPQDQPQHF	TRBV5-4	TRBJ1-5
TGTGCCAGCAGCCTGGACAGGGGGAGGGTACTCTACGAGCAGTACTTC	CASSLDRGRVLYEQYF	TRBV2	TRBJ2-7
TGTGCCAGCAGTGAGGACACAGGGAATACCGTGGGCTACACCTTC	CASSEDTGNTVGYTF	TRBV6-1	TRBJ1-2
TGTGCCAGCAGCTGGGGGGGACAGGCTTACGAGCAGTACTTC	CASSWGGQAYEQYF	TRBV7-9	TRBJ2-7
TGTGCCACGGGGGGCGCGCCAAACACCATATATTTT	CATGGAPNTIYF	TRBV24-1	TRBJ1-3
TGTGCCAGCACGCGGGACAGGAAGGAAAAACTGTTTTTT	CASTRDRKEKLFF	TRBV5-6	TRBJ1-4
TGTGCCAGCAGCCCTACCTTCAGGGTAGCGGGCTACGAGCAGTACTTC	CASSPTFRVAGYEQYF	TRBV7-3	TRBJ2-7
TGTGCCAGCAGCGTCCCAAGACAGGGGGGAAGGGGCGGCTACACCTTC	CASSVPRQGGRGGYTF	TRBV7-4	TRBJ1-2
TGCGCCAGCAGCCAAGCTCCTCTAGCGGGCCCAGGTTCCTACGAGCAGTACTTC	CASSQAPLAGPGSYEQYF	TRBV4-1	TRBJ2-7
TGCGCCAGCTTAAAGAGACTGTCTGCAGATACGCAGTATTTT	CASLKRLSADTQYF	TRBV10-1	TRBJ2-3
TGTGCCACCAGGCCAGGGACAGGCAAGGGCGATTCACCCCTCCACTTT	CATRPGTGKGDSPLHF	TRBV7-9	TRBJ1-6
TGTGCCAGTACCAAGGGGGGTCAGCCCCAGCATTTT	CASTKGGQPQHF	TRBV19	TRBJ1-5
TGCAGCGTTGGGGGGCGGCTCGCGCGAGCCAAAAACATTCAGTACTTC	CSVGGRLARAKNIQYF	TRBV29-1	TRBJ2-4
TGTGCCATCGGGGGGCGTAAACTCCGGTGGAATTCACCCCTCCACTTT	CAIGGRKLRWNSPLHF	TRBV10-3	TRBJ1-6
TGCAGCACCCGTTGCTGGGACTTATTGAATGAGCAGTTCTTC	CSTRCWDLLNEQFF	TRBV29-1	TRBJ2-1
TGTGCCAGCAGTTATTGGGGGGCCGGAGGGTATTACAATGAGCAGTTCTTC	CASSYWGAGGYYNEQFF	TRBV6-3	TRBJ2-1
TGTGCCACCTCCGGGGGACCGTCACCCGAGCAGTACTTC	CATSGGPSPEQYF	TRBV12-3	TRBJ2-7
TGTGCCAGCAGTCATAGCAGGGAGTCCTACGAGCAGTACTTC	CASSHSRESYEQYF	TRBV28	TRBJ2-7
TGTGCCAGCAGGGGTGACAAGGGGGACAGGGCAAACGAGAATAGTCCAGAGACCCAGTACTTC	CASRGDKGDRANENSPETQYF	TRBV7-3	TRBJ2-5
TGTGCCAGCGCGGGTTCCTACAATGAGCAGTTCTTC	CASAGSYNEQFF	TRBV6-2	TRBJ2-1
TGTGCCAGTAGTATGTACAGGGGAGGCTACACCTTC	CASSMYRGGYTF	TRBV19	TRBJ1-2
TGTGCCAGCAGTGAACGCGGTAACAATGAGCAGTTCTTC	CASSERGNNEQFF	TRBV6-1	TRBJ2-1
TGTGCCAAATACCCCCAGCGCAACACTGAAGCTTTCTTT	CAKYPQRNTEAFF	TRBV6-1	TRBJ1-1
TGTGCCAGCAGTTCCTGGGGGGGGATGTACAATGAGCAGTTCTTC	CASSSWGGMYNEQFF	TRBV27	TRBJ2-1
TGTGCCAGCAGCTTACACAGGGGGCCTGGCTACGAGCAGTACTTC	CASSLHRGPGYEQYF	TRBV7-9	TRBJ2-7
TGTGCCAGCAGTTTAGATCGGGGCAGCACAGATACGCAGTATTTT	CASSLDRGSTDTQYF	TRBV28	TRBJ2-3
TGCGCCAGCAGCCAAGTCTTAACGTCAAACACCATATATTTT	CASSQVLTSNTIYF	TRBV4-1	TRBJ1-3
TGTGCCAGCAGTTTATCGGGGGGGCCAGATGAGCAGTTCTTC	CASSLSGGPDEQFF	TRBV27	TRBJ2-1
TGTGCCAGCAGCCCGTCTAGGACTAGCGGAAAAGAGCAGTACTTC	CASSPSRTSGKEQYF	TRBV6-6	TRBJ2-7
TGCAGTGCTAGAGCAGTTAGCGGCACGGCAATTGAGCAGTTCTTC	CSARAVSGTAIEQFF	TRBV20-1	TRBJ2-1
TGTGCCACCAGTGATGGGGGAACCGACGAGCAGTACTTC	CATSDGGTDEQYF	TRBV24-1	TRBJ2-7
TGTGCCTGGATTCAACTCCCGGGGCCCCCTAACTATGGCTACACCTTC	CAWIQLPGPPNYGYTF	TRBV30	TRBJ1-2
TGTGCCAGCAGCTTACTACAGGGGAATCAGCCCCAGCATTTT	CASSLLQGNQPQHF	TRBV7-6	TRBJ1-5
TGTGCCAGCAGTGACTCGAGGGAACCCACCTCTAGGCGGAACAATGAGCAGTTCTTC	CASSDSREPTSRRNNEQFF	TRBV6-4	TRBJ2-1
TGTGCCAGCAGCACGGGCAGGGATTCCACAGATACGCAGTATTTT	CASSTGRDSTDTQYF	TRBV7-4	TRBJ2-3
TGTGCCAGCAGTTTTCCGGGACAGAATAATTCACCCCTCCACTTT	CASSFPGQNNSPLHF	TRBV27	TRBJ1-6
TGCGCCAGCAGCCAAGATCAGGCCGGGACACTAAACACCATATATTTT	CASSQDQAGTLNTIYF	TRBV4-1	TRBJ1-3
TGCAGTGCTAGGGGACAGGGGGCGGCCTACGAGCAGTACTTC	CSARGQGAAYEQYF	TRBV20-1	TRBJ2-7
TGTGCCAGCGGTAGGCCGAAGGTATCTGGAAACACCATATATTTT	CASGRPKVSGNTIYF	TRBV27	TRBJ1-3
TGTGCCAGTAGTATAGACTCAACTGGCATGGAATCGAACACCGGGGAGCTGTTTTTT	CASSIDSTGMESNTGELFF	TRBV19	TRBJ2-2
TGTGCCAGCAGCCAAGATCCTTGGGGACCTGTTCACACTGAAGCTTTCTTT	CASSQDPWGPVHTEAFF	TRBV14	TRBJ1-1
TGCGCCAGCAGCGGGCGGCCCTCTGGGGCCAACGTCCTGACTTTC	CASSGRPSGANVLTF	TRBV5-1	TRBJ2-6
TGTGCCGCGGGCCCGGGGGGATCCTACGAGCAGTACTTC	CAAGPGGSYEQYF	TRBV7-2	TRBJ2-7
TGTGCCACAGTCCCTCCTACCTCCAAAAACATTCAGTACTTC	CATVPPTSKNIQYF	TRBV24-1	TRBJ2-4
TGTGCCAGCAGTAAAATCCGGGACAGGGAGACCCAGTACTTC	CASSKIRDRETQYF	TRBV27	TRBJ2-5
TGTGCCAGCAGTGAATACCATCAGAGGTTCTTC	CASSEYHQRFF	TRBV25-1	TRBJ1-2
TGTGCCAGCATTCTTAAGGCGGTGCCCTCTGGAAACACCATATATTTT	CASILKAVPSGNTIYF	TRBV11-2	TRBJ1-3
TGTGCCAGCAGCTTAAAGACAGTTGGGGAAAACATTCAGTACTTC	CASSLKTVGENIQYF	TRBV11-2	TRBJ2-4
TGTGCCAGCAGCGACTCCCACACAAATCAGCCCCAGCATTTT	CASSDSHTNQPQHF	TRBV11-3	TRBJ1-5
TGCGCCAGCAGTGAGTCGTTAAGGGGGCTAGAGGAGCAGTTCTTC	CASSESLRGLEEQFF	TRBV10-2	TRBJ2-1
TGTGCCGGCGGGGGGAACACTGAAGCTTTCTTT	CAGGGNTEAFF	TRBV30	TRBJ1-1
TGTGCCAGCAGCCAGGGCCACGGATGTTCCAACAATCAGCCCCAGCATTTT	CASSQGHGCSNNQPQHF	TRBV13	TRBJ1-5
TGCGCCAGCAGCTGGCCGACAGGGACGGGCACTGAAGCTTTCTTT	CASSWPTGTGTEAFF	TRBV5-1	TRBJ1-1
TGCGCCAGCAGTTCGGGGGCCATGGGAAACACCATATATTTT	CASSSGAMGNTIYF	TRBV10-2	TRBJ1-3
TGTGCCAGCAGCATGGGGACAGGGACTGCCGGGGAGCTGTTTTTT	CASSMGTGTAGELFF	TRBV6-5	TRBJ2-2
TGTGCCAGCAGTGATCCCACTAGCGGGGGGGGCACAGATACGCAGTATTTT	CASSDPTSGGGTDTQYF	TRBV2	TRBJ2-3
TGTGCCAGCAGCAGTGGGCAGACAGGGTCCGCAACTAATGAAAAACTGTTTTTT	CASSSGQTGSATNEKLFF	TRBV9	TRBJ1-4
TGTGCCAGCAGCGGAAAACACAGACCCCCTCAAGGCAATGAGCAGTTCTTC	CASSGKHRPPQGNEQFF	TRBV7-9	TRBJ2-1
TGTGCCAGCAGCTCGGGGGCGGCCTCGAACACTGAAGCTTTCTTT	CASSSGAASNTEAFF	TRBV13	TRBJ1-1
TGTGCCAGCAGCCACCTGGCGGGGGATAGCAATCAGCCCCAGCATTTT	CASSHLAGDSNQPQHF	TRBV4-2	TRBJ1-5
TGTGCCAGCAAGGGGGACGGCACTGGCTGGATCTCCTTTAGCAATCAGCCCCAGCATTTT	CASKGDGTGWISFSNQPQHF	TRBV6-5	TRBJ1-5
TGCAGCCGCCACAGCGGGACTCAAAATGAGCAGTTCTTC	CSRHSGTQNEQFF	TRBV29-1	TRBJ2-1
TGTGCCAGCAGTGTACAGCGGGTTGAATCTGTAGGAAACACCATATATTTT	CASSVQRVESVGNTIYF	TRBV27	TRBJ1-3
TGTGCCAGGGACAGTCTAGCCAAAAACATTCAGTACTTC	CARDSLAKNIQYF	TRBV6-2	TRBJ2-4
TGTGCCAGCAGACTCGAGCAGTACTTC	CASRLEQYF	TRBV27	TRBJ2-7
TGTGCCAGCAGCCGATCTCTTCAGGGATCAACTAATGAAAAACTGTTTTTT	CASSRSLQGSTNEKLFF	TRBV14	TRBJ1-4
TGTGCCAGCAGCTTAGAAAGAGGCTCGAAATACGAGCAGTACTTC	CASSLERGSKYEQYF	TRBV7-9	TRBJ2-7
TGTGCCAGCCGAAGGGACTTTTCGAACACCGGGGAGCTGTTTTTT	CASRRDFSNTGELFF	TRBV6-5	TRBJ2-2
TGTGCCAGCATATGGAGGGCGTACGAGCAGTACTTC	CASIWRAYEQYF	TRBV6-1	TRBJ2-7
TGTGCCAGCAGCTACCGGGACAGTGTTGAAGCTTTCTTT	CASSYRDSVEAFF	TRBV5-6	TRBJ1-1
TGTGCCAGCAGTTTAGACCTAGCGGGTCAGGATGAGCAGTTCTTC	CASSLDLAGQDEQFF	TRBV27	TRBJ2-1
TGTGCTAGTCTCATGACAGGGAGCGAGAACCCGAAGGGGATGAGCTATGGCTACACCTTC	CASLMTGSENPKGMSYGYTF	TRBV12-5	TRBJ1-2
TGTGCTAGTGGTTTCCCCCGGGGGGTCAACACCGGGGAGCTGTTTTTT	CASGFPRGVNTGELFF	TRBV12-5	TRBJ2-2
TGTGCCACCAGTGACGACTACGGTGTTGCGAATGAAAAACTGTTTTTT	CATSDDYGVANEKLFF	TRBV24-1	TRBJ1-4
TGTGCCAGCAGTGCCCCCGGCAATGAAAAACTGTTTTTT	CASSAPGNEKLFF	TRBV6-1	TRBJ1-4
TGTGCCAGCAGTTACGCCCCCCCTACTACGGACGGGGACGACTCTGGAAACACCATATATTTT	CASSYAPPTTDGDDSGNTIYF	TRBV6-6	TRBJ1-3
TGTGCCTGGAGTGTAAACGAAAGATATAGCAATCAGCCCCAGCATTTT	CAWSVNERYSNQPQHF	TRBV30	TRBJ1-5
TGCGCCAGCAGCTGTATCCTGCAGGGGAATCAGCCCCAGCATTTT	CASSCILQGNQPQHF	TRBV5-1	TRBJ1-5
TGTGCCAGCAGTTACGGGGCTGGGGGGGGGGTTGGGGAGACCCAGTACTTC	CASSYGAGGGVGETQYF	TRBV6-5	TRBJ2-5
TGTGCCAGCAGCTCCCCTGATTACGGGGGAGCCTCTGGAAACACCATATATTTT	CASSSPDYGGASGNTIYF	TRBV7-2	TRBJ1-3
TGTGCCAGCAGCAACCCAAATCGGGGCGCAGAGCAGTACTTC	CASSNPNRGAEQYF	TRBV7-3	TRBJ2-7
TGTCCAGGGAATGAAAAACTGTTTTTT	CPGNEKLFF	TRBV6-5	TRBJ1-4
TGCAGTGCGACCGGTGAAAAACTGTTTTTT	CSATGEKLFF	TRBV20-1	TRBJ1-4
TGTGCCAGTAGTATCAGCCGGGGGCCCTATGGCTACACCTTC	CASSISRGPYGYTF	TRBV19	TRBJ1-2
TGTGCCAGCAGAAGATGGACAGTTGAACAGAGCTCCTATAATTCACCCCTCCACTTT	CASRRWTVEQSSYNSPLHF	TRBV2	TRBJ1-6
TGCAGTGCTCCGGGGGCCGAGAACAATGAGCAGTTCTTC	CSAPGAENNEQFF	TRBV20-1	TRBJ2-1
TGTGCTAGTGGTGGGGGACGAGTCGGATCCTACGAGCAGTACTTC	CASGGGRVGSYEQYF	TRBV12-5	TRBJ2-7
TGTGCCAGCATGCGCGGCTATGGCTACACCTTC	CASMRGYGYTF	TRBV27	TRBJ1-2
TGTGCCAGCAGTTACCCGGGACTAGCGGGAGGACCACCCGAGCAGTTCTTC	CASSYPGLAGGPPEQFF	TRBV28	TRBJ2-1
TGTGCCAGCAGTTACGGATTAATAGACGGAGAGGATGGCTACACCTTC	CASSYGLIDGEDGYTF	TRBV6-3	TRBJ1-2
TGTGCCAGCAGCTCCCCACCGTGCCTCAGTGATTCACCCCTCCACTTT	CASSSPPCLSDSPLHF	TRBV5-6	TRBJ1-6
TGCAGTTCGGACGGTGGGGCAGATACGCAGTATTTT	CSSDGGADTQYF	TRBV20-1	TRBJ2-3
TGCAGCGTTCCAGGCCTTTATGAAAAACTGTTTTTT	CSVPGLYEKLFF	TRBV29-1	TRBJ1-4
TGTGCCAGCAGTTTAAAAAACAGGGGGATGAACACTGAAGCTTTCTTT	CASSLKNRGMNTEAFF	TRBV12-4	TRBJ1-1
TGTGCCAGCAGTTTTAAGCGGGATCCCCAGTACTTC	CASSFKRDPQYF	TRBV27	TRBJ2-5
TGCGCCGGCGCCGGAGAAGGCACCGGGGAGCTGTTTTTT	CAGAGEGTGELFF	TRBV4-1	TRBJ2-2
TGTGCCAGCAATTACAGCGTTAGCAATCAGCCCCAGCATTTT	CASNYSVSNQPQHF	TRBV7-9	TRBJ1-5
TGTGCCAGCAGTGACCCCTCAGGGGGCGATCAGCCCCAGCATTTT	CASSDPSGGDQPQHF	TRBV6-4	TRBJ1-5
TGTGCCAGCAGTTATTTTGTCGCCGGGACAGGGGGCAAAAACATTCAGTACTTC	CASSYFVAGTGGKNIQYF	TRBV6-2	TRBJ2-4
TGTGCCACTGGTGGGGGGTATGGGTTCTACGAGCAGTACTTC	CATGGGYGFYEQYF	TRBV19	TRBJ2-7
TGCGCCAGCAGCACACCCACCCTACACAGGAAGGGACGTGGCTACACCTTC	CASSTPTLHRKGRGYTF	TRBV5-1	TRBJ1-2
TGTGCCAGCAGTTCCGGGACTAGCGGTGCACCATACAATGAGCAGTTCTTC	CASSSGTSGAPYNEQFF	TRBV6-1	TRBJ2-1
TGCGCCAGCAGCCGCCCGGTGACGGGAAGGGGGTACGAGCAGTACTTC	CASSRPVTGRGYEQYF	TRBV5-1	TRBJ2-7
TGCGCCAGCAGTGGACGGATGAACCGACTAGCTGTTTCGAGTAGCACAGATACGCAGTATTTT	CASSGRMNRLAVSSSTDTQYF	TRBV10-1	TRBJ2-3
TGTGCCAGCAGCTTTCAACCGGGGAGGGGAGACTACGAGCAGTACTTC	CASSFQPGRGDYEQYF	TRBV7-9	TRBJ2-7
TGTGCCAGCAGTTACCGACAGGGGACAAACTATGGCTACACCTTC	CASSYRQGTNYGYTF	TRBV6-6	TRBJ1-2
TGTGCCACCAGTGAATACCTGCAGCATAGTCCTGAAGCTTTCTTT	CATSEYLQHSPEAFF	TRBV24-1	TRBJ1-1
TGTGCCAGCAGCTACGTTGCGGTCTGGAGCTACGAGCAGTACTTC	CASSYVAVWSYEQYF	TRBV7-9	TRBJ2-7
TGTGTTCCTCGGGGGCAGGCTATGGAAAAACTGTTTTTT	CVPRGQAMEKLFF	TRBV7-9	TRBJ1-4
TGTGCCATACAAGATGAGCAGTTCTTC	CAIQDEQFF	TRBV25-1	TRBJ2-1
TGTGCCAGCAGTGAATGGGGGGGAGATGGCTACACCTTC	CASSEWGGDGYTF	TRBV2	TRBJ1-2
TGTGCCTTCCGGGGACAGGGGGAGTCCAACACCGGGGAGCTGTTTTTT	CAFRGQGESNTGELFF	TRBV30	TRBJ2-2
TGTGCCAGCAGCCTCGGGAACTACGAGCAGTACTTC	CASSLGNYEQYF	TRBV9	TRBJ2-7
TGTGCCAGCAGCCGGAAAATTTCCAGATGGGTCTCCTACGAGCAGTACTTC	CASSRKISRWVSYEQYF	TRBV13	TRBJ2-7
TGTGCCAGCCAGACAGGGGGGGATAATCAGCCCCAGCATTTT	CASQTGGDNQPQHF	TRBV18	TRBJ1-5
TGTGCCACCACTACCCGGGACAGGACTGAAGCTTTCTTT	CATTTRDRTEAFF	TRBV24-1	TRBJ1-1
TGTGCCTGGAGTCCCGACTATGGCTACACCTTC	CAWSPDYGYTF	TRBV30	TRBJ1-2
TGTGCCAGCAGCTGGGGACTAGCAGAGACCCAGTACTTC	CASSWGLAETQYF	TRBV7-3	TRBJ2-5
TGTGCCAGCAGCTCGAGTAGCGAGACTAGTCGCGAAGCAGATACGCAGTATTTT	CASSSSSETSREADTQYF	TRBV7-3	TRBJ2-3
TGTGCCAGCAGTTACGGAGGGACGCGGATGAGGGATACGCAGTATTTT	CASSYGGTRMRDTQYF	TRBV6-6	TRBJ2-3
TGTGCCATCACGGGATCTCTCGCTGTTGGCTACACCTTC	CAITGSLAVGYTF	TRBV10-3	TRBJ1-2
TGTGCCAGCAGCCAATCGAGACAGGGGAGTCATGAGCAGTTCTTC	CASSQSRQGSHEQFF	TRBV16	TRBJ2-1
TGTGCCAGCAGTGGGGTCGCGACTAGCGGGTCGGGAGAAGCTAGCACAGATACGCAGTATTTT	CASSGVATSGSGEASTDTQYF	TRBV6-5	TRBJ2-3
TGTGCCATCTCCGAGTTACGAAGGAACTATGGCTACACCTTC	CAISELRRNYGYTF	TRBV10-3	TRBJ1-2
TGCAGTGCTAGAGCCGTTCAATCAGGGCCCAACGAGCAGTACTTC	CSARAVQSGPNEQYF	TRBV20-1	TRBJ2-7
TGTGCTAGTGAAGCAGGGAGGCTAGCGGAAAGCACAGATACGCAGTATTTT	CASEAGRLAESTDTQYF	TRBV12-5	TRBJ2-3
TGTGCCAGCAGTTACGAAAGGACAGGGGTCGATAATTCACCCCTCCACTTT	CASSYERTGVDNSPLHF	TRBV6-5	TRBJ1-6
TGTGCCACTCACAGGGCGGAGCAGTACTTC	CATHRAEQYF	TRBV24-1	TRBJ2-7
TGCGCCCAGGTCTACGATACGCAGTATTTT	CAQVYDTQYF	TRBV5-1	TRBJ2-3
TGTGCCAGCAGCTTAATACCGTGGGGAGGGCACCCGTACCAAGAGACCCAGTACTTC	CASSLIPWGGHPYQETQYF	TRBV7-9	TRBJ2-5
TGTGCCAGCAGCCAAGGGACGGGTAGCTCCTACGAGCAGTACTTC	CASSQGTGSSYEQYF	TRBV13	TRBJ2-7
TGTGCCAGCAGTTTTTGGACAGGGCTGACCATCTGGTACAATGAGCAGTTCTTC	CASSFWTGLTIWYNEQFF	TRBV12-3	TRBJ2-1
TGTGCCAGCAGCTTAAATTTTGGGGTCGGGTATAATTCACCCCTCCACTTT	CASSLNFGVGYNSPLHF	TRBV7-9	TRBJ1-6
TGTGCCAGCAGCTTAGGGGGGAATCAGCCCCAGCATTTT	CASSLGGNQPQHF	TRBV7-3	TRBJ1-5
TGTGCCAGCAGTTATAATTGGGACAGCACCGAGCAGTACTTC	CASSYNWDSTEQYF	TRBV27	TRBJ2-7
TGTGCCAGCAGTTTATCGCTATTTAAGCCGGGAAACACCATATATTTT	CASSLSLFKPGNTIYF	TRBV27	TRBJ1-3
TGTGCCAGCAGCCGGGACAGGGAGAGCTCTGGAAACACCATATATTTT	CASSRDRESSGNTIYF	TRBV9	TRBJ1-3
TGTGCCAGCAGTCCCCGGGACAGGTGGACTGAAGCTTTCTTT	CASSPRDRWTEAFF	TRBV11-2	TRBJ1-1
TGTGCCCCGGGAAAGCCGGAAACCAGGGTCGTGGGCTTTTGCTATGGCTACACCTTC	CAPGKPETRVVGFCYGYTF	TRBV27	TRBJ1-2
TGTGCCAGTAGTATACCCAGGGGCTTAGCTTTCTTT	CASSIPRGLAFF	TRBV19	TRBJ1-1
TGCGCCAGCAGCCAAGACCAACAAAGGCCCAATCAGCCCCAGCATTTT	CASSQDQQRPNQPQHF	TRBV4-1	TRBJ1-5
TGTGACACACTCCCTAAGACAGCGGCTGAAGCTTTCTTT	CDTLPKTAAEAFF	TRBV7-9	TRBJ1-1
TGTGCCAGCATGTCATGCGGACAGGGAGGTAATGAAAAACTGTTTTTT	CASMSCGQGGNEKLFF	TRBV6-1	TRBJ1-4
TGCGCCAGCAGCCACGGAGGCGGGGGTGGGGGCTACACCTTC	CASSHGGGGGGYTF	TRBV4-1	TRBJ1-2
TGTGCCCCATCCCGGGACCGAGGGAGGGCTGGAAACACCATATATTTT	CAPSRDRGRAGNTIYF	TRBV6-4	TRBJ1-3
TGTGCCACTTCGGACCAGGAGACCCAGTACTTC	CATSDQETQYF	TRBV12-3	TRBJ2-5
TGCAGGACTAGCGGGGTTAATGAGCAGTTCTTC	CRTSGVNEQFF	TRBV20-1	TRBJ2-1
TGTGCCAGCAGCTTACTGGGGGAAAAATTACAGGGATACACTGAAGCTTTCTTT	CASSLLGEKLQGYTEAFF	TRBV7-3	TRBJ1-1
TGTGCCAGCAGCCCGATCGACAGTCCAGTACACACTGAAGCTTTCTTT	CASSPIDSPVHTEAFF	TRBV27	TRBJ1-1
TGTGCCAGCAGCAAACCGAGTCACAATGAGCAGTTCTTC	CASSKPSHNEQFF	TRBV13	TRBJ2-1
TGTGCCAGCAGCTTGACAGTATACTCTGGAAACACCATATATTTT	CASSLTVYSGNTIYF	TRBV7-3	TRBJ1-3
TGTGCCAGCAGCCGTATAGAAGGCCTATCCTACGAGCAGTACTTC	CASSRIEGLSYEQYF	TRBV7-3	TRBJ2-7
TGCGCCAGCAGTGGGGGATGGTTTGGACAGGGAGGGACGAGGGGAAACACCATATATTTT	CASSGGWFGQGGTRGNTIYF	TRBV10-1	TRBJ1-3
TGTGCCAGCAGCGGTATCGGCATCACGTTCTTCTATGGCTACACCTTC	CASSGIGITFFYGYTF	TRBV9	TRBJ1-2
TGTGCCATAGGGACAGGGGGGGCGATTAACACCGGGGAGCTGTTTTTT	CAIGTGGAINTGELFF	TRBV24-1	TRBJ2-2
TGTGCCAGCAGCTTAAACCTAGCGGGAAGGGCCGGGGAGCTGTTTTTT	CASSLNLAGRAGELFF	TRBV11-3	TRBJ2-2
TGTGCCAGTAGTCCCCCGGGGGGGTACTACGAGCAGTACTTC	CASSPPGGYYEQYF	TRBV19	TRBJ2-7
TGCGCCAGCAGTGAGTCGCCAGTTCCCATCTGGACAGGTAGCACCGGGGAGCTGTTTTTT	CASSESPVPIWTGSTGELFF	TRBV10-2	TRBJ2-2
TGTGCCAGCAGCTTAGAACCACAGGGGAGGGACTATGGCTACACCTTC	CASSLEPQGRDYGYTF	TRBV9	TRBJ1-2
TGCGCCAGCAGCCGGGAGGGCCGAGACTATGGCTACACCTTC	CASSREGRDYGYTF	TRBV5-1	TRBJ1-2
TGTGCCAGCAGCACTAGATGGGACAATCAGCCCCAGCATTTT	CASSTRWDNQPQHF	TRBV5-4	TRBJ1-5
TGTGCCACCAGGACCTCTTCTTTCGGTAGCAATCAGCCCCAGCATTTT	CATRTSSFGSNQPQHF	TRBV24-1	TRBJ1-5
TGTGCCACTTCTCATAATGGTTGCAATCAGCCCCAGCATTTT	CATSHNGCNQPQHF	TRBV24-1	TRBJ1-5
TGTGCCAGTGGGCCCTTTACCGGGGAGCTGTTTTTT	CASGPFTGELFF	TRBV19	TRBJ2-2
TGCGCCAGCAGCTGGGGACAGGGCCCCTCCAAAAACATTCAGTACTTC	CASSWGQGPSKNIQYF	TRBV5-1	TRBJ2-4
TGTGCCAGCAGTTTGAAAACTAGCGGGGGGGCCAAGGTCTACGAGCAGTACTTC	CASSLKTSGGAKVYEQYF	TRBV28	TRBJ2-7
TGCGCCAGCAGCCGTCAGTGCCGGACCTACGAGCAGTACTTC	CASSRQCRTYEQYF	TRBV4-1	TRBJ2-7
TGTGCCAGTAGAGCAATAAGGCATAGGGGGACTGCGACTAGCACAGATACGCAGTATTTT	CASRAIRHRGTATSTDTQYF	TRBV19	TRBJ2-3
TGTGCCAGCAGTGAAATAAGACAGGGGGCAAACGAGCAGTACTTC	CASSEIRQGANEQYF	TRBV6-4	TRBJ2-7
TGTGCCAGCGGAAAGCCGGGACAGGGGGAAGAAGCTTTCTTT	CASGKPGQGEEAFF	TRBV28	TRBJ1-1
TGTGCCAGCAGTACCCGGGGGAAAAAGTTCTACGAGCAGTACTTC	CASSTRGKKFYEQYF	TRBV27	TRBJ2-7
TGTGCCAGCAGTGCACTGGACTTTAATGGCTACACCTTC	CASSALDFNGYTF	TRBV2	TRBJ1-2
TGTGCCAGCAGTTTATCACGTGGTCGTTCCTACGAGCAGTACTTC	CASSLSRGRSYEQYF	TRBV6-9	TRBJ2-7
TGCAGTGCTAGAGATCGCGGAGAGACCCAGTACTTC	CSARDRGETQYF	TRBV20-1	TRBJ2-5
TGTGCCAGCAGCCAAGACATCTCGAGGACCCCCAACTATGGCTACACCTTC	CASSQDISRTPNYGYTF	TRBV3-1	TRBJ1-2
TGTGCCAGCAGCGCCAACTTTGCTACCGAGCAGTACTTC	CASSANFATEQYF	TRBV7-3	TRBJ2-7
TGCATGAAGCAGGGGGCGCGCGGGGAGCTGTTTTTT	CMKQGARGELFF	TRBV20-1	TRBJ2-2
TGTGCCAGCAGTTCAGCAGGGCCGCAAGTTTGGTACGAGCAGTACTTC	CASSSAGPQVWYEQYF	TRBV6-5	TRBJ2-7
TGTGCCGTCAGGTTTGAGCAGTACTTC	CAVRFEQYF	TRBV5-6	TRBJ2-7
TGCGCCAGCAGCTCCTCCAGGGGCCTTTACGAGCAGTACTTC	CASSSSRGLYEQYF	TRBV4-1	TRBJ2-7
TGTGCCAGCAGTGCCCGCAGGGGGTATAGCAATCAGCCCCAGCATTTT	CASSARRGYSNQPQHF	TRBV6-1	TRBJ1-5
TGTGCCACCGCGACTAGCGGGCCCGGCGAGCAGTACTTC	CATATSGPGEQYF	TRBV24-1	TRBJ2-7
TGTGCCAGCAGTTTAGCCCCCGAGGTACATTCACCCCTCCACTTT	CASSLAPEVHSPLHF	TRBV12-4	TRBJ1-6
TGTGCCAGCTCACCCTGTGGTCGACAGGTGAGCTCCTACAATGAGCAGTTCTTC	CASSPCGRQVSSYNEQFF	TRBV18	TRBJ2-1
TGTGCCAGCAGTTCCTCCGGTCTTGGGAAGACCCAGTACTTC	CASSSSGLGKTQYF	TRBV28	TRBJ2-5
TGTGCCAGCAGCGCCGCGACGATTCGTCAGCCCCAGCATTTT	CASSAATIRQPQHF	TRBV9	TRBJ1-5
TGTGCCAGCAGCTTAGCGCTTCCCCCTCCGGGACACTTATCTCGGACAGAACAAGAGACCCAGTACTTC	CASSLALPPPGHLSRTEQETQYF	TRBV7-9	TRBJ2-5
TGTGCCAGCAGCTTAGTGAGAGTGGGCGGGGAGGGGCGTAGCACCGGGGAGCTGTTTTTT	CASSLVRVGGEGRSTGELFF	TRBV7-2	TRBJ2-2
TGTGCCAGCGGGGGGAGTGCTGCCGAGCAGTACTTC	CASGGSAAEQYF	TRBV12-3	TRBJ2-7
TGTGCCAAGGGATTCATTAAGGTATGCACAGGGGGCGGCAATCAGCCCCAGCATTTT	CAKGFIKVCTGGGNQPQHF	TRBV27	TRBJ1-5
TGTGCCAGCAGCTTCCGGTCCGGGGGATTGAACTATGGCTACACCTTC	CASSFRSGGLNYGYTF	TRBV7-4	TRBJ1-2
TGCGCCAGCAGCAGGGAAGGGGAGACCCAGTACTTC	CASSREGETQYF	TRBV5-1	TRBJ2-5
TGTGCCTGGAGTGTACGGGTCGCGAGCGAACCGGGACAGCTAGGTACTGAAGCTTTCTTT	CAWSVRVASEPGQLGTEAFF	TRBV30	TRBJ1-1
TGCAGTGCTAGAGATAACCCGGGACAGTGTACTGAAGCTTTCTTT	CSARDNPGQCTEAFF	TRBV20-1	TRBJ1-1
TGTGCCAGCAGTCCGGGTCGCGGATCCCAGTACTTC	CASSPGRGSQYF	TRBV6-1	TRBJ2-5
TGCGCCAGCAGTTTCTACCTGGCCAAAAACATTCAGTACTTC	CASSFYLAKNIQYF	TRBV10-1	TRBJ2-4
TGTGCCAGCATACATGAGAGGGAGGAAAGCACAGATACGCAGTATTTT	CASIHEREESTDTQYF	TRBV7-2	TRBJ2-3
TGTGCCACTTCGTACAATGAGCAGTTCTTC	CATSYNEQFF	TRBV15	TRBJ2-1
TGCGCCAGCACCCCTCTCCTAAATTACACCGGGGAGCTGTTTTTT	CASTPLLNYTGELFF	TRBV10-1	TRBJ2-2
TGTGCCAGCAGCTCTCGTCTAGAGGCCTACGAGCAGTACTTC	CASSSRLEAYEQYF	TRBV13	TRBJ2-7
TGCGCCAGCAGCATCCTCCGGGACAGGGGAGTGGGCCCTAACACTGAAGCTTTCTTT	CASSILRDRGVGPNTEAFF	TRBV5-1	TRBJ1-1
TGTGCCAGCAGCGTAGTACCAACCGGACTAGCGGGTCTAGACTCCTACAATGAGCAGTTCTTC	CASSVVPTGLAGLDSYNEQFF	TRBV9	TRBJ2-1
TGTGCCAGCAGTAGTCATGGTATGGGACACGGCGCTTTCTTT	CASSSHGMGHGAFF	TRBV6-5	TRBJ1-1
TGTGCCAGCAGTTTCTTTTCAGCGATAGGGTTAAACTATGGCTACACCTTC	CASSFFSAIGLNYGYTF	TRBV27	TRBJ1-2
TGTGCCAGCAGGACCAGGCCAGCTGGCTACACCTTC	CASRTRPAGYTF	TRBV11-3	TRBJ1-2
TGCGCCAGCACGGCGGACGCCGAGGGCTACGAGCAGTACTTC	CASTADAEGYEQYF	TRBV5-1	TRBJ2-7
TGTGCCAGCAGCTCCGGGACTAGAGTACCCGAGACCCAGTACTTC	CASSSGTRVPETQYF	TRBV13	TRBJ2-5
TGTGCCAGCAGCTTCCCTAACACCATATATTTT	CASSFPNTIYF	TRBV5-6	TRBJ1-3
TGTGCCAGCAGTGCCGGGACGAGGAACACTGAAGCTTTCTTT	CASSAGTRNTEAFF	TRBV6-1	TRBJ1-1
TGTGCCAGCAGCGTAGTAGTTAAGGGACAGGGCACTCAGCCCCAGCATTTT	CASSVVVKGQGTQPQHF	TRBV9	TRBJ1-5
TGTGCCAGGGTGGGGCAGCCCGGAACTGAAGCTTTCTTT	CARVGQPGTEAFF	TRBV27	TRBJ1-1
TGCGCCAGCAGAGATGCGGGGAGGGACAATGAGCAGTTCTTC	CASRDAGRDNEQFF	TRBV10-1	TRBJ2-1
TGTGCCAGCGGCGGTGAAGCTTTCTTT	CASGGEAFF	TRBV6-4	TRBJ1-1
TGTGCCAGCTCACCACGAAATAACAGGGGGCGCCCCGACACTGAAGCTTTCTTT	CASSPRNNRGRPDTEAFF	TRBV18	TRBJ1-1
TGTGCCAGCAGCTTGCCCGAGCCGGGACAGGGGGACAATGAAAAACTGTTTTTT	CASSLPEPGQGDNEKLFF	TRBV5-5	TRBJ1-4
TGTGCCAGCAGTTTAACCCCTAGCGGGAGCGGGGGGTATTTT	CASSLTPSGSGGYF	TRBV28	TRBJ2-3
TGTGCCAGGGGACTAGCGGGGGTGTCCTACGAGCAGTACTTC	CARGLAGVSYEQYF	TRBV7-9	TRBJ2-7
TGCAGCGTAGACCCGGGACAGGGGACTGAAGCTTTCTTT	CSVDPGQGTEAFF	TRBV29-1	TRBJ1-1
TGTGCCATGTTGGAGGGGAGCTCTGGAAACACCATATATTTT	CAMLEGSSGNTIYF	TRBV11-3	TRBJ1-3
TGTGCCAGCAGCCAAGTTGGACAGATGGAGGGGGCGGCCAAAAACATTCAGTACTTC	CASSQVGQMEGAAKNIQYF	TRBV6-5	TRBJ2-4
TGTGCCAGACCGGACAGCTGGGGTGAGCAGTTCTTC	CARPDSWGEQFF	TRBV24-1	TRBJ2-1
TGCAGCGTTGAATCCCCAGAGGTCAGGGCTGGCTACACCTTC	CSVESPEVRAGYTF	TRBV29-1	TRBJ1-2
TGTGCCAGCAGCCAAACCGGGGGGGCCAGCACCGGGGAGCTGTTTTTT	CASSQTGGASTGELFF	TRBV3-1	TRBJ2-2
TGTGCCAGCAGTTACTGTCGGGACTATGAGCAGTTCTTC	CASSYCRDYEQFF	TRBV6-5	TRBJ2-1
TGTGCCAGCAGTGACTCTAAACCGCTAAATGACATTCAGTACTTC	CASSDSKPLNDIQYF	TRBV6-4	TRBJ2-4
TGTGCCAGCAGTTACAAAGGACCGGGCGGAGCCAAAAACATTCAGTACTTC	CASSYKGPGGAKNIQYF	TRBV6-5	TRBJ2-4
TGTGCCAGCAGCTTAGTCCCAGGTGGGACGGGCTCCGAGCAGTACTTC	CASSLVPGGTGSEQYF	TRBV7-2	TRBJ2-7
TGTGCCACCAGTGATTTGCCAAAGGGACAGTCTGGGGCCAACGTCCTGACTTTC	CATSDLPKGQSGANVLTF	TRBV24-1	TRBJ2-6
TGCAGTGCTAGAGATCGGAGCGGGAGTGCCGTCCTGACTTTC	CSARDRSGSAVLTF	TRBV20-1	TRBJ2-6
TGCAGTGCTAGAGATCTTCGCCTTCCGGGGGGAATCGAGCAGTACTTC	CSARDLRLPGGIEQYF	TRBV20-1	TRBJ2-7
TGTGCCAGCAGTTATAGGGGCACAAAGACCCAGTACTTC	CASSYRGTKTQYF	TRBV28	TRBJ2-5
TGTGCCAGCAGCAAGACGCGGGCAGCAGATACGCAGTATTTT	CASSKTRAADTQYF	TRBV13	TRBJ2-3
TGTGCCAGTAGAGTTACTCCCGATCAGCCCCAGCATTTT	CASRVTPDQPQHF	TRBV19	TRBJ1-5
TGTGCCAGCAGACCGCCTAGCGGGCCCCACAATGAGCAGTTCTTC	CASRPPSGPHNEQFF	TRBV6-5	TRBJ2-1
TGTGCCAGTAGTATAATTCCGGGACAGGGGTCGAGCAATCAGCCCCAGCATTTT	CASSIIPGQGSSNQPQHF	TRBV19	TRBJ1-5
TGCAGTGCTCCGGGACGGGACTACGAGCAGTACTTC	CSAPGRDYEQYF	TRBV20-1	TRBJ2-7
TGTGCCAGCAGTGAAGCGCCCGGCCACTTCCACACTGAAGCTTTCTTT	CASSEAPGHFHTEAFF	TRBV6-1	TRBJ1-1
TGTGCCAGTAGTATAGCGGGTGACCCCCCATGGTTCAATCAGCCCCAGCATTTT	CASSIAGDPPWFNQPQHF	TRBV19	TRBJ1-5
TGTGCCAGCAGCTATCCCGGGGGGAGCTATGAGCAGTTCTTC	CASSYPGGSYEQFF	TRBV5-8	TRBJ2-1
TGTGCCACCAGCAGGGATTCTAAGGGTTGCTATGGCTACACCTTC	CATSRDSKGCYGYTF	TRBV15	TRBJ1-2
TGTGCCAGCAGCCAACCGGGACAGACTCGTTACCAAGAGACCCAGTACTTC	CASSQPGQTRYQETQYF	TRBV3-1	TRBJ2-5
TGTGCCAGCAGCAGGCGCGGACAGGGTGAAAAACTGTTTTTT	CASSRRGQGEKLFF	TRBV7-4	TRBJ1-4
TGCGCCAGCAGCGGAGCAAGGTACGAGCAGTACTTC	CASSGARYEQYF	TRBV5-1	TRBJ2-7
TGTGCCACCAGTGCGGAGTGCTTACAAACAACCGGGGAGCTGTTTTTT	CATSAECLQTTGELFF	TRBV24-1	TRBJ2-2
TGCAGCGAGCGGAAAGGACAAGAGACCCAGTACTTC	CSERKGQETQYF	TRBV29-1	TRBJ2-5
TGTGCCAGCAGCTTAGAAAGGACAGGACCACAAGAGACCCAGTACTTC	CASSLERTGPQETQYF	TRBV7-9	TRBJ2-5
TGTGCCAGCAGGCCCCGGGTAGCGGGATCTTCCTACGAGCAGTACTTC	CASRPRVAGSSYEQYF	TRBV7-2	TRBJ2-7
TGTGCCAGCACAGAGATGGCCCCGGATAATGAAAAACTGTTTTTT	CASTEMAPDNEKLFF	TRBV6-1	TRBJ1-4
TGTGCCAGCAGCTTAGGACAGCGGAAAGGGTCGGCAGCCAAAAACATTCAGTACTTC	CASSLGQRKGSAAKNIQYF	TRBV11-3	TRBJ2-4
TGTGCCACCATGAGGAGCTACGAGCAGTACTTC	CATMRSYEQYF	TRBV24-1	TRBJ2-7
TGTGCCAGCTCACCAGATCAGGGGGGGACAGGGCTTGGGAGCTCCTACGAGCAGTACTTC	CASSPDQGGTGLGSSYEQYF	TRBV18	TRBJ2-7
TGTGCCAGCGGGGTGGATCAAGGGCCCTACGGGGAGCTGTTTTTT	CASGVDQGPYGELFF	TRBV7-3	TRBJ2-2
TGTGCCAGCAGCTTCATGGTCCCGGGACAGTACACTAATGAAAAACTGTTTTTT	CASSFMVPGQYTNEKLFF	TRBV7-3	TRBJ1-4
TGCGCCAGCATTAGTCCAATAGACAGGGGGGACGAGACCCAGTACTTC	CASISPIDRGDETQYF	TRBV5-1	TRBJ2-5
TGTGCCTGGGGATCTCAGGGAGCTTTCTTT	CAWGSQGAFF	TRBV30	TRBJ1-1
TGTGCCAGCAGCTTCCGTCCGGGTCCTAGGGGGAGTGGTAACTATGGCTACACCTTC	CASSFRPGPRGSGNYGYTF	TRBV7-2	TRBJ1-2
TGCGCCAGCAATGAAGTCTCTGGAAACACCATATATTTT	CASNEVSGNTIYF	TRBV5-1	TRBJ1-3
TGTGCCACCAGTAAGCTCCCTCCAGACTACTATAGCAATCAGCCCCAGCATTTT	CATSKLPPDYYSNQPQHF	TRBV24-1	TRBJ1-5
TGCGCCAGCAGCTTGAGCGGGAGCCCAGATACGCAGTATTTT	CASSLSGSPDTQYF	TRBV5-1	TRBJ2-3
TGTGCCAGCAGCGTAGTCGGTCCTGGTGCCCTCAGGGGGAAAGCTTTCTTT	CASSVVGPGALRGKAFF	TRBV9	TRBJ1-1
TGTGCCAGCAGCCAAGATGAGGGCGAGGTGGCGGGCTACACCTTC	CASSQDEGEVAGYTF	TRBV14	TRBJ1-2
TGTGCCAGCAGCGGTGGATGGGGAGAGAGGATCATAAATGGCTACACCTTC	CASSGGWGERIINGYTF	TRBV9	TRBJ1-2
TGTGCCACCAGTGATGTCAAGGTGGAGTACTTC	CATSDVKVEYF	TRBV24-1	TRBJ2-5
TGTGCCAGCAGCTTGTTTGGGACAGGGGGCGCTACCCTCGATAGCTCCTACGAGCAGTACTTC	CASSLFGTGGATLDSSYEQYF	TRBV5-8	TRBJ2-7
TGTGCCAGCAGCTTGGCTGAGGGGGGGCAGTACTTC	CASSLAEGGQYF	TRBV5-4	TRBJ2-7
TGTGCCAGCAGTGACTCATGGGACAATCCGCACCAAGAGACCCAGTACTTC	CASSDSWDNPHQETQYF	TRBV6-4	TRBJ2-5
TGTGCCAGCAGCCAAGGAGTTCAGGGGGGGGATCAAGAGACCCAGTACTTC	CASSQGVQGGDQETQYF	TRBV5-4	TRBJ2-5
TGTGCCAGCAGTCCCAACCTCTACAGGCTGATTTCAACTAATGAAAAACTGTTTTTT	CASSPNLYRLISTNEKLFF	TRBV28	TRBJ1-4
TGTGCCACCAGTGATTTCGGAAACAATGAGCAGTTCTTC	CATSDFGNNEQFF	TRBV24-1	TRBJ2-1
TGCGCCAGCAGCCAAGATCGGAGTAGGGGGAAAAGGGTCATGAACACTGAAGCTTTCTTT	CASSQDRSRGKRVMNTEAFF	TRBV4-1	TRBJ1-1
TGTGCCACAGAGTACCCCGGGGAGCTGTTTTTT	CATEYPGELFF	TRBV24-1	TRBJ2-2
TGTGCCAGTAGTATAGCCCGGACGAAATATGGCTACACCTTC	CASSIARTKYGYTF	TRBV19	TRBJ1-2
TGTGCCAGCAGCTTAAGCGCGGACCAGTCGCACAATGAGCAGTTCTTC	CASSLSADQSHNEQFF	TRBV7-4	TRBJ2-1
TGTGCCATCAGCCTGAGGCTGGATTGCAATCAGCCCCAGCATTTT	CAISLRLDCNQPQHF	TRBV10-3	TRBJ1-5
TGCGCCAGCAGTGCTTACCACCAGGGGGGCCCTTATGGCTACACCTTC	CASSAYHQGGPYGYTF	TRBV10-1	TRBJ1-2
TGTGCCAGCAGCGGGGGGTGCGAGCAGTACTTC	CASSGGCEQYF	TRBV6-3	TRBJ2-7
TGTGCCAGCAGCATGAGGGTGGCGAACACTGAAGCTTTCTTT	CASSMRVANTEAFF	TRBV13	TRBJ1-1
TGTGCCAGCAGTGGAAAGGGGGGGGAGTGGACTAACTATGGCTACACCTTC	CASSGKGGEWTNYGYTF	TRBV2	TRBJ1-2
TGTGCCAGCAGTAAGTCCGTTCGAGCGGCCGTTCAGAATTCACCCCTCCACTTT	CASSKSVRAAVQNSPLHF	TRBV27	TRBJ1-6
TGTGGCGGGGCTGAAAAACTGTTTTTT	CGGAEKLFF	TRBV9	TRBJ1-4
TGCAGTGCTAGTGGGGAAGAGAGAGAGTATGGCTACACCTTC	CSASGEEREYGYTF	TRBV20-1	TRBJ1-2
TGTGCCAGCAGCCCGACCTCGAATGAGCAGTTCTTC	CASSPTSNEQFF	TRBV14	TRBJ2-1
TGCGCCAGCAGCTATTTCCCGTGGACTAGCGGGAAGTGCTCCTACAATGAGCAGTTCTTC	CASSYFPWTSGKCSYNEQFF	TRBV5-1	TRBJ2-1
TGTGCCAGCAGTGAGAGACCCACCAAAAACATTCAGTACTTC	CASSERPTKNIQYF	TRBV6-4	TRBJ2-4
TGTGCCAGCAGCCCCGGACACTATGGCTACACCTTC	CASSPGHYGYTF	TRBV6-6	TRBJ1-2
TGCGCCAGAGCCGGGGCTGGAGCTCAAACCCAGTACTTC	CARAGAGAQTQYF	TRBV10-2	TRBJ2-5
TGCAGTGCTCACGACAGGTCCCTATATGGCTACACCTTC	CSAHDRSLYGYTF	TRBV20-1	TRBJ1-2
TGTGCCAGCAGCTTGTCCAGCGAGCAGTACTTC	CASSLSSEQYF	TRBV11-3	TRBJ2-7
TGCGCCAGCAGCCAAGGCGGACAGGGAGAGACCCAGTACTTC	CASSQGGQGETQYF	TRBV4-3	TRBJ2-5
TGCAGTGCTAGTGACGGACTAAACAAGGGGGGGGGGCCCACCGGGGAGCTGTTTTTT	CSASDGLNKGGGPTGELFF	TRBV20-1	TRBJ2-2
TGTGCCACCAGTGATTACGGGGGCGATACTAATGAAAAACTGTTTTTT	CATSDYGGDTNEKLFF	TRBV24-1	TRBJ1-4
TGTGCCAGCAGTTTATTTACGTACAATGAGCAGTTCTTC	CASSLFTYNEQFF	TRBV27	TRBJ2-1
TGTGCCAGCAGTCCCCTAGCTGAGACCCAGTACTTC	CASSPLAETQYF	TRBV6-4	TRBJ2-5
TGTGCCAGCAGTTACTCGAAGAAGGGGACTAGCGCCTCCTACGAGCAGTACTTC	CASSYSKKGTSASYEQYF	TRBV6-5	TRBJ2-7
TGTGCCAGCAGCCGGCCACTAGCGGGGGGCTACGAGCAGTACTTC	CASSRPLAGGYEQYF	TRBV3-1	TRBJ2-7
TGCGCCAGCAGCCAAGATTTGGGGGTACTCTCCTACGAGCAGTACTTC	CASSQDLGVLSYEQYF	TRBV4-1	TRBJ2-7
TGTGCCAGCAGACTAGCGACAGATAATTCCTACGAGCAGTACTTC	CASRLATDNSYEQYF	TRBV6-4	TRBJ2-7
TGTGCCAGCAGTTCTAAGGGGGAAGAGACCCAGTACTTC	CASSSKGEETQYF	TRBV6-2	TRBJ2-5
TGTGCCAGCACTAGGCGGGGGTCTTTCCGTCCGGGGAATGAGCAGTTCTTC	CASTRRGSFRPGNEQFF	TRBV6-2	TRBJ2-1
TGTGCCAGCAGTTTCCAGAGGGACGACAGACGTAACTATGGCTACACCTTC	CASSFQRDDRRNYGYTF	TRBV12-4	TRBJ1-2
TGTGCCTGGAGTGTACATCCCACCCGGCACAGGGGGCGGGCAGAACCCCGCTACGAGCAGTACTTC	CAWSVHPTRHRGRAEPRYEQYF	TRBV30	TRBJ2-7
TGTGCCAGCAGCCAACCCGAATCGGGGGGGCTGGGCTCCTACGAGCAGTACTTC	CASSQPESGGLGSYEQYF	TRBV14	TRBJ2-7
TGTGCCAGCAGTGGGGGGAGGAGTACCGAAGAGACCCAGTACTTC	CASSGGRSTEETQYF	TRBV27	TRBJ2-5
TGTGCCAGCAGCGGGTTACGGGTTGGCCAAGATGAAAAACTGTTTTTT	CASSGLRVGQDEKLFF	TRBV7-3	TRBJ1-4
TGTGCCAGCAGCGCACCCGGGACAGGGGACTGCTTC	CASSAPGTGDCF	TRBV13	TRBJ1-2
TGTGCCAGGGATTACAGGGCAGATACGCAGTATTTT	CARDYRADTQYF	TRBV6-4	TRBJ2-3
TGCGCCAGCAGCCAAGATAAGGTGACAGGCACTGAAGCTTTCTTT	CASSQDKVTGTEAFF	TRBV4-1	TRBJ1-1
TGTGCCAGCAGCGCCTGGGGGAGTATAATTGGTCGGCCAGATACGCAGTATTTT	CASSAWGSIIGRPDTQYF	TRBV6-1	TRBJ2-3
TGTGCCAGCGGGGGGAACCATCAGCCCCAGCATTTT	CASGGNHQPQHF	TRBV6-4	TRBJ1-5
TGCGCCAGCAGTGAGCTGGGGATAAAGACCAGCGGGGTTGGTGAAGACAATGAGCAGTTCTTC	CASSELGIKTSGVGEDNEQFF	TRBV10-2	TRBJ2-1
TGTGCCACCAGTGGATCAACTTCGGTTGTCAATCAGCCCCAGCATTTT	CATSGSTSVVNQPQHF	TRBV24-1	TRBJ1-5
TGCAGCGTTGAGGTCGGTTTCTCCGAGGGATACGAGCAGTACTTC	CSVEVGFSEGYEQYF	TRBV29-1	TRBJ2-7
TGTGCCTGGAGTGTATCTCCCGGCTTCGTGACCCAGTACTTC	CAWSVSPGFVTQYF	TRBV30	TRBJ2-5
TGTGCCAGCAGTTTCCTCTTGCCGGGACTAGCGGAGCAGCGCACAGATACGCAGTATTTT	CASSFLLPGLAEQRTDTQYF	TRBV12-4	TRBJ2-3
TGTGCCAGCAGTATGATAGGGACAGCAGTTTCGCGAAGCTCTGGGGCCAACGTCCTGACTTTC	CASSMIGTAVSRSSGANVLTF	TRBV14	TRBJ2-6
TGCAGTGCTATGGGGGGGTCGCATTTT	CSAMGGSHF	TRBV20-1	TRBJ1-5
TGCAGTGCTAGCCCGGAGGGTTACACTGAAGCTTTCTTT	CSASPEGYTEAFF	TRBV20-1	TRBJ1-1
TGTGCCAGCAGCGGTGAAACAGGACTAGCGGGGGGCATTAACTCCTACAATGAGCAGTTCTTC	CASSGETGLAGGINSYNEQFF	TRBV11-2	TRBJ2-1
TGTGCCAGCAGCTTAGCCAGAAAAAGTAGCAATCAGCCCCAGCATTTT	CASSLARKSSNQPQHF	TRBV7-9	TRBJ1-5
TGTGCCATCATATGGGGCCATTTCTATGGCTACACCTTC	CAIIWGHFYGYTF	TRBV10-3	TRBJ1-2
TGTGCCAGCAGCGGACTTACGGGCCTTAGCGGGAGTGCCTACAATGAGCAGTTCTTC	CASSGLTGLSGSAYNEQFF	TRBV13	TRBJ2-1
TGTGCCAGCAGTGGGGGACAGGGAGTTGAGCAGTTCTTC	CASSGGQGVEQFF	TRBV6-5	TRBJ2-1
TGCAGTGCTCGAGGGGTGCCCGATACCGGGGAGCTGTTTTTT	CSARGVPDTGELFF	TRBV20-1	TRBJ2-2
TGTGCCAGCAGTGGGGGGACAGGCCGCCAAGAGACCCAGTACTTC	CASSGGTGRQETQYF	TRBV2	TRBJ2-5
TGTGCCAGCAGCATCGGACAGGAGATAATGGAGCAGTACTTC	CASSIGQEIMEQYF	TRBV11-2	TRBJ2-7
TGTGCCAGCAGTTACGATAGGGGGCCAAACACCATATATTTT	CASSYDRGPNTIYF	TRBV6-5	TRBJ1-3
TGTGCCAGCAGCCATCTAGCGGGAGCCTACGAGCAGTACTTC	CASSHLAGAYEQYF	TRBV5-5	TRBJ2-7
TGTGCCAGCAGTGACCTTAGCGCCGTTAGCTCCTACAATGAGCAGTTCTTC	CASSDLSAVSSYNEQFF	TRBV6-4	TRBJ2-1
TGTGCCAGCAGACCTGCTTGTGGACACCGAGAGCAGTACTTC	CASRPACGHREQYF	TRBV6-5	TRBJ2-7
TGTGCCAGCAAGCCGGGACAGCGCTATGGCTACACCTTC	CASKPGQRYGYTF	TRBV6-2	TRBJ1-2
TGTGCCAGTACCCTTGACACGGGCCGGGACGAGCAGTACTTC	CASTLDTGRDEQYF	TRBV19	TRBJ2-7
TGTGCCAGCAGCGTTCGGGGAAATCAGCCCCAGCATTTT	CASSVRGNQPQHF	TRBV7-3	TRBJ1-5
TGTGCCAGCAGCCCCTTAAGAAAAGCCTACGAGCAGTACTTC	CASSPLRKAYEQYF	TRBV14	TRBJ2-7
TGTGCCAGCACTAAAAAGTACAATGAGCAGTTCTTC	CASTKKYNEQFF	TRBV7-9	TRBJ2-1
TGCAGGGGAGGACACTTC	CRGGHF	TRBV20-1	TRBJ2-7
TGTGCCACCAGTGAGTGGCCGGGACTAGCTAGCTACGAGCAGTACTTC	CATSEWPGLASYEQYF	TRBV24-1	TRBJ2-7
TGTGCCAGCAGTGACAGGGAAGCTAACTATGGCTACACCTTC	CASSDREANYGYTF	TRBV6-4	TRBJ1-2
TGCGCCAGCAGCCTAGTGGACGCGGGCACTGAAGCTTTCTTT	CASSLVDAGTEAFF	TRBV4-3	TRBJ1-1
TGCAGTGGGACAGGGGGCCGGAGAACTGAAGCTTTCTTT	CSGTGGRRTEAFF	TRBV20-1	TRBJ1-1
TGTGCCAGCTCACCACACCCGAGGGTAGGAAACACCATATATTTT	CASSPHPRVGNTIYF	TRBV18	TRBJ1-3
TGTGCCATAACAGGGCTCACAGATACGCAGTATTTT	CAITGLTDTQYF	TRBV6-2	TRBJ2-3
TGTGCCAGCAGCTATACCCACCTTGAGACCCAGTACTTC	CASSYTHLETQYF	TRBV11-3	TRBJ2-5
TGTGCCAGCAGTCGTTTCCCCGGTGGTCCAGGTGGCTACACCTTC	CASSRFPGGPGGYTF	TRBV28	TRBJ1-2
TGTGCCAGCAGTTGGACAGGGCAGGAAATTGAAAAACTGTTTTTT	CASSWTGQEIEKLFF	TRBV12-3	TRBJ1-4
TGTGCCAGCAGACACTCTAGCTACGAGCAGTACTTC	CASRHSSYEQYF	TRBV25-1	TRBJ2-7
TGCAGTGCTAGAGATAGGTGCGGACTGTGGCTTGACCTCTACGAGCAGTACTTC	CSARDRCGLWLDLYEQYF	TRBV20-1	TRBJ2-7
TGTGCCAGCAGTTGGGGGACTGGAAACACCATATATTTT	CASSWGTGNTIYF	TRBV28	TRBJ1-3
TGTGCCAGCAGAGTCCCGGGACAGGGTAGCCACTATGGCTACACCTTC	CASRVPGQGSHYGYTF	TRBV6-2	TRBJ1-2
TGTGCCACAATCCCCAAATTCTTC	CATIPKFF	TRBV6-5	TRBJ2-1
TGTGCCAGCAGCAGGACCATTAGTGGCTACACCTTC	CASSRTISGYTF	TRBV9	TRBJ1-2
TGTGCCAGCAGCTTGCAGGGCCCGCAGTATTTT	CASSLQGPQYF	TRBV13	TRBJ2-3
TGTGCCAGCAGCGTTGACGAGAGGGATTCACCCCTCCACTTT	CASSVDERDSPLHF	TRBV6-4	TRBJ1-6
TGTGCCAGCAGTAAAAGACAGGTCGTCCGTCGATGGAGCTCTGGAAACACCATATATTTT	CASSKRQVVRRWSSGNTIYF	TRBV28	TRBJ1-3
TGCAGTGCTAGAGATCCCCGTCCCGGGACAGGCGATAGCAATCAGCCCCAGCATTTT	CSARDPRPGTGDSNQPQHF	TRBV20-1	TRBJ1-5
TGCGCCAGCAGCCCTACGTCTACAGGGCCTATCGATACGCAGTATTTT	CASSPTSTGPIDTQYF	TRBV4-1	TRBJ2-3
TGTGCCAGCACCACAGGCAGGGGGGAGCATTTT	CASTTGRGEHF	TRBV6-1	TRBJ1-5
TGTGCCAGCAGGATTTCCAGATGCGAGCTGAACACTGAAGCTTTCTTT	CASRISRCELNTEAFF	TRBV7-9	TRBJ1-1
TGTGCCAGCAGCTTCCGACGGCCTGGCTACACCTTC	CASSFRRPGYTF	TRBV7-3	TRBJ1-2
TGTGCCAGCCTACAGGAGGCTAGCGGAACGACAGATACGCAGTATTTT	CASLQEASGTTDTQYF	TRBV6-1	TRBJ2-3
TGTGCCAGCAGCTTAGACGCGTCCTACGAGCAGTACTTC	CASSLDASYEQYF	TRBV7-9	TRBJ2-7
TGTGCCAGCAGTTTACACCCAAACAATAGCGCCTACGAGCAGTACTTC	CASSLHPNNSAYEQYF	TRBV28	TRBJ2-7
TGTGCCAGCAGCTTAGGGACAGCCCGGAACACTGAAGCTTTCTTT	CASSLGTARNTEAFF	TRBV7-9	TRBJ1-1
TGTGCCAGCAGCTTGGGGGGATGGTTTAACGGCCACACCGGGGAGCTGTTTTTT	CASSLGGWFNGHTGELFF	TRBV5-6	TRBJ2-2
TGTGCCACAACGGGACAGGGGGACAATGAGCAGTTCTTC	CATTGQGDNEQFF	TRBV4-2	TRBJ2-1
TGCAGCGTTGCAGCAAGCGGGGGCGCGAGTGAAAAACTGTTTTTT	CSVAASGGASEKLFF	TRBV29-1	TRBJ1-4
TGTGCCAGCATATGCCTCAAGGACGTCTATGGCTACACCTTC	CASICLKDVYGYTF	TRBV2	TRBJ1-2
TGTGCTAGTGGGGCCGGCAGGGGCCCCTCTGGAAACACCATATATTTT	CASGAGRGPSGNTIYF	TRBV12-5	TRBJ1-3
TGTGCCAGCAGCGTCACAAGGGAACAGGGAGATAGAGACACCATATATTTT	CASSVTREQGDRDTIYF	TRBV11-3	TRBJ1-3
TGTGCCAGCAGCCAGGGGGCAGGCTACGAGCAGTACTTC	CASSQGAGYEQYF	TRBV7-3	TRBJ2-7
TGCGCCAGCAGTGTTGCATTACGGGGTAAATGGTACGAGCAGTACTTC	CASSVALRGKWYEQYF	TRBV10-1	TRBJ2-7
TGTGCCAGCAGCTGGGGTATCCGCAATCAGCCCCAGCATTTT	CASSWGIRNQPQHF	TRBV7-2	TRBJ1-5
TGTGCCAGCACCGGGGGGATCGCCAATCCGATGGAACAGTACTTC	CASTGGIANPMEQYF	TRBV28	TRBJ2-5
TGTGCCAGCAGTTTGCACGTAACGGGGGGTTTTTGCAATCAGCCCCAGCATTTT	CASSLHVTGGFCNQPQHF	TRBV27	TRBJ1-5
TGCGCCAGCAGTGAGATCGGGAGAGAGACCCAGTACTTC	CASSEIGRETQYF	TRBV10-2	TRBJ2-5
TGTGCCAGCAGCCAGAAAGGGGAGCAGCCCCAGCATTTT	CASSQKGEQPQHF	TRBV4-2	TRBJ1-5
TGTGCCAGCAGCTTCCTAAGCCAGGGACAGTTACTTGGCTACACCTTC	CASSFLSQGQLLGYTF	TRBV7-4	TRBJ1-2
TGTGCCAGCAGTTTCGATCCCGACAATGAGCAGTTCTTC	CASSFDPDNEQFF	TRBV27	TRBJ2-1
TGTGCCAGCAGCCGCGGACAGGCCCCTGAAGCTTTCTTT	CASSRGQAPEAFF	TRBV7-9	TRBJ1-1
TGCGCCAGCAGCCAAGTGGGGTCCCCTGGACCACCGCTGGGCTCTGGGGCCAACGTCCTGACTTTC	CASSQVGSPGPPLGSGANVLTF	TRBV4-1	TRBJ2-6
TGTGCCAGCAGCCAAGATAAAAGAATGACATTTCCTGGGGCCAACGTCCTGACTTTC	CASSQDKRMTFPGANVLTF	TRBV3-1	TRBJ2-6
TGTGCCAGCAGTTCCCCGAGGCTTTGCCCCTTGGAAGCTTTCTTT	CASSSPRLCPLEAFF	TRBV6-9	TRBJ1-1
TGCGCCAGCAGCCAAGATCCCGCTTGGACTAGGGGGCGATCAGATACGCAGTATTTT	CASSQDPAWTRGRSDTQYF	TRBV4-1	TRBJ2-3
TGTGCCACCATGGGCCCGGGACGGAACCAAGAGACCCAGTACTTC	CATMGPGRNQETQYF	TRBV24-1	TRBJ2-5
TGTGCCAGCAGCTCCGCTTTCGCGGAGGATCAGCCCCAGCATTTT	CASSSAFAEDQPQHF	TRBV2	TRBJ1-5
TGTGCCAGTAGCCAGGGATCCAGGGATCTTGGGGCCAACGTCCTGACTTTC	CASSQGSRDLGANVLTF	TRBV19	TRBJ2-6
TGCAGTGCTAGAGATATTACGAGCGCGAACACCGGGGAGCTGTTTTTT	CSARDITSANTGELFF	TRBV20-1	TRBJ2-2
TGTGCCAGCCTGGATAGACCCGCAACTAATGAAAAACTGTTTTTT	CASLDRPATNEKLFF	TRBV6-2	TRBJ1-4
TGCCCCAAATGCGGGAGCGCCTACGAGCAGTACTTC	CPKCGSAYEQYF	TRBV20-1	TRBJ2-7
TGTGCCAGCAGCGGATTCGTTAGCGGCAGGAACACCGGGGAGCTGTTTTTT	CASSGFVSGRNTGELFF	TRBV7-2	TRBJ2-2
TGTGCCAGCAGTTACCGGACGGTACCTCAAGAGACCCAGTACTTC	CASSYRTVPQETQYF	TRBV6-3	TRBJ2-5
TGTGCCAGCAGCTTGTTCGTAACGGCGAGGGGGGCTGGAAACACCATATATTTT	CASSLFVTARGAGNTIYF	TRBV7-8	TRBJ1-3
TGTGCCAGCAGTACGGGGAGAGAGAACTATGGCTACACCTTC	CASSTGRENYGYTF	TRBV12-3	TRBJ1-2
TGTGCCAGCAGCCAAGAGGCGCGACAGGCGCCGCCGAGCTATGGCTACACCTTC	CASSQEARQAPPSYGYTF	TRBV14	TRBJ1-2
TGTGCCAGTAGTTTCGAACCGGGACGAGAGACCCAGTACTTC	CASSFEPGRETQYF	TRBV19	TRBJ2-5
TGTGCCAGCACCGGACTAGCGGGGGGTAGGAGCTGGTACAATGAGCAGTTCTTC	CASTGLAGGRSWYNEQFF	TRBV9	TRBJ2-1
TGCGCCAGCAGCCATCCACAGGGGTTTAGGAACACTGAAGCTTTCTTT	CASSHPQGFRNTEAFF	TRBV5-1	TRBJ1-1
TGCGCCAGCAGCGATCGGAGAGACACTGAAGCTTTCTTT	CASSDRRDTEAFF	TRBV5-1	TRBJ1-1
TGTGCCAGCGGAGATCAGCCCCAGCATTTT	CASGDQPQHF	TRBV2	TRBJ1-5
TGTGCCAGCAGCTGGGAGGGTTATTGCACAGATACGCAGTATTTT	CASSWEGYCTDTQYF	TRBV7-9	TRBJ2-3
TGTGCCACCAGTGGAGACCGCTATCAAAATCAGCCCCAGCATTTT	CATSGDRYQNQPQHF	TRBV24-1	TRBJ1-5
TGTGCCTGGAGTCCCGGGGGACAGGGCCTAACAGATACGCAGTATTTT	CAWSPGGQGLTDTQYF	TRBV30	TRBJ2-3
TGTGCCAGCAGCTTAGCGGGGGCTGGGGCCAACGTCCTGACTTTC	CASSLAGAGANVLTF	TRBV7-2	TRBJ2-6
TGTGCCAGCAGCCCCCACGTGGGGCGGCGTCCCACCGGGGAGCTGTTTTTT	CASSPHVGRRPTGELFF	TRBV12-3	TRBJ2-2
TGTGCCATACGGTTTAGCGGGGGGACCCAGTACTTC	CAIRFSGGTQYF	TRBV7-9	TRBJ2-5
TGTGCCAGTAGTATAGGGGGGGGTAATAGCAATCAGCCCCAGCATTTT	CASSIGGGNSNQPQHF	TRBV19	TRBJ1-5
TGTGCCAGTACTCCTGGTTCGGGAGATACGCAGTATTTT	CASTPGSGDTQYF	TRBV19	TRBJ2-3
TGTGCCAGCAGCTTAATAAGGAATTGGCTAACAGGTAAAAGTAATTCACCCCTCCACTTT	CASSLIRNWLTGKSNSPLHF	TRBV7-9	TRBJ1-6
TGTGCTAGTGGTAAGCCGTGTAAGGGGGTGAACAATAGCAATCAGCCCCAGCATTTT	CASGKPCKGVNNSNQPQHF	TRBV12-5	TRBJ1-5
TGTGCCAGCAGTGAGCCACTTCATACGCAGTATTTT	CASSEPLHTQYF	TRBV6-1	TRBJ2-3
TGTGCCAGCTGGCTATGGGAAGTTAACTATGGCTACACCTTC	CASWLWEVNYGYTF	TRBV9	TRBJ1-2
TGTGCCAGCAGTTACTCGCCAGGAGCGGCACAAGTCACAGATACGCAGTATTTT	CASSYSPGAAQVTDTQYF	TRBV6-6	TRBJ2-3
TGTCTCCCAACAATCGTAGGGACACCCGACCAAGAGACCCAGTACTTC	CLPTIVGTPDQETQYF	TRBV7-9	TRBJ2-5
TGCGCCAGCAGTGGTCTTTACAGGGGGCGAGGGGAGCTGTTTTTT	CASSGLYRGRGELFF	TRBV10-1	TRBJ2-2
TGCGCCAGCAGTGAGGTTCTAGTCCACAATGAGCAGTTCTTC	CASSEVLVHNEQFF	TRBV10-1	TRBJ2-1
TGTGCCAGCAGCCAAGGAAGCTCCTACGAGCAGTACTTC	CASSQGSSYEQYF	TRBV3-1	TRBJ2-7
TGTGCCAGCAGCAAAATCGCGGGAAGGGCTGAAGCTTTCTTT	CASSKIAGRAEAFF	TRBV3-1	TRBJ1-1
TGTGCCAGCAGTATTGACCTCGAGCGACAGATGAGCTCTAATGAAAAACTGTTTTTT	CASSIDLERQMSSNEKLFF	TRBV6-1	TRBJ1-4
TGTGCCAGCAGCTTAGAGAAAGGAGTTAGCGGGGAGCTGTTTTTT	CASSLEKGVSGELFF	TRBV7-9	TRBJ2-2
TGTGCCAGCAGTGAAGCAGGCCTCGCGAGGCAGGGGATACAGTACGAGCAGTACTTC	CASSEAGLARQGIQYEQYF	TRBV2	TRBJ2-7
TGCGCCAGCAGCCACCGCATGGAGCCATTAGAGCAGTTCTTC	CASSHRMEPLEQFF	TRBV4-3	TRBJ2-1
TGTGCCAGCAGTTACTGGACATACGAGCAGTACTTC	CASSYWTYEQYF	TRBV6-6	TRBJ2-7
