TGTGCCAGCAGTTTACGTTCATGGGATGGCTACACCTTC	CASSLRSWDGYTF	TRBV27	TRBJ1-2
TGTGCCAGCAGGACAGGGCTTCACACCGGGGAGCTGTTTTTT	CASRTGLHTGELFF	TRBV6-2	TRBJ2-2
TGTGCCAGCAGTTTGGCCGCGCAAGAGACCCAGTACTTC	CASSLAAQETQYF	TRBV27	TRBJ2-5
TGCAGTGCTAGGGGGGGGTACAATGAGCAGTTCTTC	CSARGGYNEQFF	TRBV20-1	TRBJ2-1
TGCAGTGGATATGACTGGATAAGTTATGAAAAACTGTTTTTT	CSGYDWISYEKLFF	TRBV20-1	TRBJ1-4
TGTGCCACCAGTGATAAGGCTAGCGGGCACAAAGAGACCCAGTACTTC	CATSDKASGHKETQYF	TRBV24-1	TRBJ2-5
TGCGCCAGCAGCTGGCCGAGGCCCCTCTATGGCTACACCTTC	CASSWPRPLYGYTF	TRBV5-1	TRBJ1-2
TGTGCCAGCAGCGGGACACACCGTCACGAGCAGTACTTC	CASSGTHRHEQYF	TRBV7-2	TRBJ2-7
TGTGCCAGCTCACAGCTAGCGGGGACCACAGATACGCAGTATTTT	CASSQLAGTTDTQYF	TRBV18	TRBJ2-3
TGTGCCAGGTGGGAAAGCCTGGGCAAAAACATTCAGTACTTC	CARWESLGKNIQYF	TRBV19	TRBJ2-4
TGTGCCAGCAGCCAAGATGCGTGCCGGGACAGGGTGCAGAGTCGGTACACTGAAGCTTTCTTT	CASSQDACRDRVQSRYTEAFF	TRBV14	TRBJ1-1
TGTGCCAGCAGCCATCGGGGTTGCACAGATACGCAGTATTTT	CASSHRGCTDTQYF	TRBV14	TRBJ2-3
TGTGCCAGCAGTGAAGCGGGAGAGGTACCGAATTCACCCCTCCACTTT	CASSEAGEVPNSPLHF	TRBV6-4	TRBJ1-6
TGTGCCAGCAGCCTGACCCTTCCGAACACTGAAGCTTTCTTT	CASSLTLPNTEAFF	TRBV3-1	TRBJ1-1
TGTGCCAGCAGCCATGGGACAGACGTTGTGGTTGGATGGAACACACCCCTCCACTTT	CASSHGTDVVVGWNTPLHF	TRBV11-2	TRBJ1-6
TGTGCCAGCAGTAAATCGAGCGGGAGGTTAGGGGGCATGAACACTGAAGCTTTCTTT	CASSKSSGRLGGMNTEAFF	TRBV28	TRBJ1-1
TGTGCCAGCAGAATCAGGTCCTCCTACGAGCAGTACTTC	CASRIRSSYEQYF	TRBV27	TRBJ2-7
TGTGCCAGCCCGAGGGATGGGGAGGGAGAGACCCAGTACTTC	CASPRDGEGETQYF	TRBV7-4	TRBJ2-5
TGTGCCAGCAGTTTACGGGGAAATAGTCCTATCCCGAGCTACGAGCAGTACTTC	CASSLRGNSPIPSYEQYF	TRBV28	TRBJ2-7
TGTGCCAGCAGCTTAGCTGGTTCGCCGATGCCTTCACCCCTCCACTTT	CASSLAGSPMPSPLHF	TRBV7-9	TRBJ1-6
TGTGCCAGCAGTGAGGGAATTGCGAACACTGAAGCTTTCTTT	CASSEGIANTEAFF	TRBV3-1	TRBJ1-1
TGTGCCGAGGGAGGGGGTCGGAGAATCTCTGGAAACACCATATATTTT	CAEGGGRRISGNTIYF	TRBV2	TRBJ1-3
TGCAGCGTTGAGGGTAAAAAAACAGGGTATCATGTGAACACTGAAGCTTTCTTT	CSVEGKKTGYHVNTEAFF	TRBV29-1	TRBJ1-1
TGCGCCAGCAGCTTGGACCCGGGACTAGATGTCAGGTACTACGAGCAGTACTTC	CASSLDPGLDVRYYEQYF	TRBV5-1	TRBJ2-7
TGCAGTGCTAAGGATACCACCCCCACTAGCGGGAGGGCCGGACACCCCTACGAGCAGTACTTC	CSAKDTTPTSGRAGHPYEQYF	TRBV20-1	TRBJ2-7
TGCAGTGCTAGAGATCTGCCGGAGAACGAGCAGTACTTC	CSARDLPENEQYF	TRBV20-1	TRBJ2-7
TGTGCCAGCAGTCCCGGACTAGCGGCTCATACGCAGTATTTT	CASSPGLAAHTQYF	TRBV3-1	TRBJ2-3
TGTGCCAGCAGCCGACAGGGGGCCGTCTTAATGAACACTGAAGCTTTCTTT	CASSRQGAVLMNTEAFF	TRBV3-1	TRBJ1-1
TGTGCCAGGTGGGCAGTAGCTTTCTTT	CARWAVAFF	TRBV28	TRBJ1-1
TGTGCCAGCACCGGACCCTCCCTGAACACTGAAGCTTTCTTT	CASTGPSLNTEAFF	TRBV12-4	TRBJ1-1
TGTGCCAGCAGCGGCGTTGTGACAGTCAGCACAGATACGCAGTATTTT	CASSGVVTVSTDTQYF	TRBV7-2	TRBJ2-3
TGTGCCAGCAGCCAAGGGAAAAAGTATAATTCACCCCTCCACTTT	CASSQGKKYNSPLHF	TRBV7-3	TRBJ1-6
TGTGCTAGTGGTTCCAGGGACAGCTCTGGAAACACCATATATTTT	CASGSRDSSGNTIYF	TRBV12-5	TRBJ1-3
TGTGCCGTTTCTAGACCCACCAATGAGCAGTTCTTC	CAVSRPTNEQFF	TRBV30	TRBJ2-1
TGTGCCAGCAGTCCGGGACGTCGCTACAATGAGCAGTTCTTC	CASSPGRRYNEQFF	TRBV6-6	TRBJ2-1
TGTGCCAGCAGCTTAGAGACCCAGTACTTC	CASSLETQYF	TRBV11-3	TRBJ2-5
TGTGCCACCAGTGATTCCGGATTTAAACAGGGTGAGAGGAGATCCTACGAGCAGTACTTC	CATSDSGFKQGERRSYEQYF	TRBV24-1	TRBJ2-7
TGTGCCAGCAGTAATCCGGGCATAGAGACCTACGAGCAGTACTTC	CASSNPGIETYEQYF	TRBV28	TRBJ2-7
TGCGCCAGCAGCCAAGACGGGTACCCCACCGGGGAGCTGTTTTTT	CASSQDGYPTGELFF	TRBV4-3	TRBJ2-2
TGTGCCAGCAGCTTGGCCTTAAGGTTCCATAGCAATCAGCCCCAGCATTTT	CASSLALRFHSNQPQHF	TRBV5-6	TRBJ1-5
TGTGCCAGCAGCCGGGGAAAAAGCTCCTACGAGCAGTACTTC	CASSRGKSSYEQYF	TRBV7-2	TRBJ2-7
TGTGGGTCGCGGGAGATGGAAGAGACCCAGTACTTC	CGSREMEETQYF	TRBV6-4	TRBJ2-5
TGCAGTGCTAGCGAGAACCAGACCCAGTACTTC	CSASENQTQYF	TRBV20-1	TRBJ2-5
TGTGCCAGCCGGAGGTCATTTCGTCAGCCCCAGCATTTT	CASRRSFRQPQHF	TRBV6-1	TRBJ1-5
TGTGCCAGCAGCGCACCGGGACATCTGTGTCAGCCCCAGCATTTT	CASSAPGHLCQPQHF	TRBV11-2	TRBJ1-5
TGTGCCAGCAGCTTGGCCCCTTGGACCGGGAAGCCCTACGAGCAGTACTTC	CASSLAPWTGKPYEQYF	TRBV5-6	TRBJ2-7
TGTGCCAGCAGCTGGATGGAAGAAGGGACTACCTACAATGAGCAGTTCTTC	CASSWMEEGTTYNEQFF	TRBV5-6	TRBJ2-1
TGTGCCAGCAGCGTAGGCATACAGGGGGGGGCCGGGGAGCTGTTTTTT	CASSVGIQGGAGELFF	TRBV9	TRBJ2-2
TGTGCCAGCAGTGACTCGATAGAGAGGGACAGGGTCAATCAGCCCCAGCATTTT	CASSDSIERDRVNQPQHF	TRBV6-4	TRBJ1-5
TGCGCCAGCAGCCTAGTTAGCGGGACGAAAGACGTCCTGACTTTC	CASSLVSGTKDVLTF	TRBV4-3	TRBJ2-6
TGTGCTAGTGGTTTGGTAATTAATAATTATACGCAGTATTTT	CASGLVINNYTQYF	TRBV12-5	TRBJ2-3
TGTGCCAGCAGCTTGGTTAGGGACAGGGGACAGGGCACTGAAGCTTTCTTT	CASSLVRDRGQGTEAFF	TRBV5-6	TRBJ1-1
TGTGCCACCAGCAGAGATGTGCGGGAGCCCCGCTACGAGCAGTACTTC	CATSRDVREPRYEQYF	TRBV15	TRBJ2-7
TGTGCCAGCAGCTTTAAACCCCGGAGTAACGAGCAGTACTTC	CASSFKPRSNEQYF	TRBV5-6	TRBJ2-7
TGTGCCATCCTAGCGGCCAAAAGTCGCAAAAACATTCAGTACTTC	CAILAAKSRKNIQYF	TRBV2	TRBJ2-4
TGCAGTGCTAGAAGGGGGTTGCCGGCTGAAAAACTGTTTTTT	CSARRGLPAEKLFF	TRBV20-1	TRBJ1-4
TGTGCCACCGGGAGGGGAGCCTACGAGCAGTACTTC	CATGRGAYEQYF	TRBV6-5	TRBJ2-7
TGTGCTAGTGGTTTTGCCGGGGAGGGGGCTATAGGCTACACCTTC	CASGFAGEGAIGYTF	TRBV12-5	TRBJ1-2
TGTGCCAGTAGTATGAGTGTTCGGTCCCCTGAAGCTTTCTTT	CASSMSVRSPEAFF	TRBV19	TRBJ1-1
TGTGCCTTTCCAACAGACGGAAACACTGAAGCTTTCTTT	CAFPTDGNTEAFF	TRBV6-6	TRBJ1-1
TGTGCCAGCAGTTACTCGGTCCGACAGGGTAGGTTACTCCACTTT	CASSYSVRQGRLLHF	TRBV6-5	TRBJ1-6
TGTGCCTGGAGAGGGACTAGCCTAGAGACCCAGTACTTC	CAWRGTSLETQYF	TRBV30	TRBJ2-5
TGTGCCAGCAGCTTGCTGTCACTCATATTAAATGAAAAACTGTTTTTT	CASSLLSLILNEKLFF	TRBV5-4	TRBJ1-4
TGTGCCAGCAGCTTAGGTGGGTTAGGAACTGAAGCTTTCTTT	CASSLGGLGTEAFF	TRBV7-7	TRBJ1-1
TGTGCCAGCTCACCCGGGTGGCAGCTAGGAAAGAGCTCCTACAATGAGCAGTTCTTC	CASSPGWQLGKSSYNEQFF	TRBV18	TRBJ2-1
TGCGCCAGCAGTGGGGACAGGGAGGACGAGCAGTACTTC	CASSGDREDEQYF	TRBV10-1	TRBJ2-7
TGTGCCAGCAGTTTAGCCTCAGGAGGGACTAAGAACACTGAAGCTTTCTTT	CASSLASGGTKNTEAFF	TRBV12-4	TRBJ1-1
TGCGCCAGCAGCCAAGAAAAGCAGGGGTATGGCTACACCTTC	CASSQEKQGYGYTF	TRBV4-1	TRBJ1-2
TGTGCCAGCATGCGGACAGAACTCTCTGGAAACACCATATATTTT	CASMRTELSGNTIYF	TRBV28	TRBJ1-3
TGTGCCAGCAGCCCTCCCCGAAGCGACAGTGGGGAAAACATTCAGTACTTC	CASSPPRSDSGENIQYF	TRBV7-4	TRBJ2-4
TGTGCCAGCAGCTTCAAAGAGGGCTCTTTCTACGAGCAGTACTTC	CASSFKEGSFYEQYF	TRBV7-7	TRBJ2-7
TGTGCCAGCAGCTCCGCCGGGACAGGGGGCGCTAACTATGGCTACACCTTC	CASSSAGTGGANYGYTF	TRBV5-6	TRBJ1-2
TGTGCCAGCAGTTTCTCTCCCGGGAGGCTTTCACCCCTCCACTTT	CASSFSPGRLSPLHF	TRBV12-3	TRBJ1-6
TGTGCCAGCACCCGACTAGCGGGCCACCAGAATGAGCAGTTCTTC	CASTRLAGHQNEQFF	TRBV7-2	TRBJ2-1
TGTGCCAGCAGCTTAGATCAGGGCGAAGGACGTGGAAACTCTGGGGCCAACGTCCTGACTTTC	CASSLDQGEGRGNSGANVLTF	TRBV11-2	TRBJ2-6
TGTGCCAGCAGTTGTGCTAGGTGGAGTGAGACCCAGTACTTC	CASSCARWSETQYF	TRBV6-3	TRBJ2-5
TGTGCCACCAGTGATAATCGACAGGGGGCGCTTACGTATCATCAGCCCCAGCATTTT	CATSDNRQGALTYHQPQHF	TRBV24-1	TRBJ1-5
TGCGCCAGCAGTCCACCGGTAAAGAAAACACAATGCCCGTTCAATCAGCCCCAGCATTTT	CASSPPVKKTQCPFNQPQHF	TRBV5-1	TRBJ1-5
TGTGCCAGCAGCTCGCCGGCGACTTTGAACACTGAAGCTTTCTTT	CASSSPATLNTEAFF	TRBV11-2	TRBJ1-1
TGTGCCAGCAGCTCCGGGCAGGATCAGCCCCAGCATTTT	CASSSGQDQPQHF	TRBV7-3	TRBJ1-5
TGCACCACCCCAAAGGGGGGCTCCTACGAGCAGTACTTC	CTTPKGGSYEQYF	TRBV20-1	TRBJ2-7
TGTGCCAGCAGCCAACAGGGTGCCTATAATTCACCCCTCCACTTT	CASSQQGAYNSPLHF	TRBV7-2	TRBJ1-6
TGTGCCAGCAGTTTCAGCACGGGACAGGGCGCTTTCTTT	CASSFSTGQGAFF	TRBV28	TRBJ1-1
TGTGCCAGCAGCACAGTGGGACTAGCGGGCATCACCACAGATACGCAGTATTTT	CASSTVGLAGITTDTQYF	TRBV7-8	TRBJ2-3
TGTGCCAGCAGCCAACCCCGGGACTTGTGTCCTCGCACAGATACGCAGTATTTT	CASSQPRDLCPRTDTQYF	TRBV4-2	TRBJ2-3
TGTGCCAGCAGTTTGGGCGCCACTAGCGGGAGACCAAACATTCAGTACTTC	CASSLGATSGRPNIQYF	TRBV12-4	TRBJ2-4
TGTGCCAGCAGCGCTACGGGGGGGGGCACCTACGAGCAGTACTTC	CASSATGGGTYEQYF	TRBV7-4	TRBJ2-7
TGTGCCAGCAGCTTTGGGGCATCCGGTCCCTACGAGCAGTACTTC	CASSFGASGPYEQYF	TRBV7-9	TRBJ2-7
TGTGCCAGCAGTTATTCCGGGGGGGGGAGAGGTGAAGCTTTCTTT	CASSYSGGGRGEAFF	TRBV6-9	TRBJ1-1
TGTGCCAGCAGACACCCATGCAGGGCGGAATACGAGCAGTACTTC	CASRHPCRAEYEQYF	TRBV6-5	TRBJ2-7
TGTGCCAGCAGGGGGGGCGGCTACGAGCAGTACTTC	CASRGGGYEQYF	TRBV3-1	TRBJ2-7
TGTGCCACCCTCGGACGGGGCCTTAATCAGCCCCAGCATTTT	CATLGRGLNQPQHF	TRBV24-1	TRBJ1-5
TGTGCCAGCAGCTTAGATCGGACTAGCGGGATTTGGGAAATTAACACCGGGGAGCTGTTTTTT	CASSLDRTSGIWEINTGELFF	TRBV7-6	TRBJ2-2
TGTGCCAGCAGCACCTTGCCGGGGCCCAATCAGCCCCAGCATTTT	CASSTLPGPNQPQHF	TRBV7-4	TRBJ1-5
TGTGCCAGCAGCGTAGTAAGGGCCTTAGACGAGCAGTACTTC	CASSVVRALDEQYF	TRBV9	TRBJ2-7
TGCAGTGCTAGAGGAAGACAGGAGCGGAGCTCCTACGAGCAGTACTTC	CSARGRQERSSYEQYF	TRBV20-1	TRBJ2-7
TGTGCCAGCACTCTCAAATACCCAGATACGCAGTATTTT	CASTLKYPDTQYF	TRBV2	TRBJ2-3
TGCGCCAGCAGCTTGACTAGGAGACTAGTCTACAATGAGCAGTTCTTC	CASSLTRRLVYNEQFF	TRBV5-1	TRBJ2-1
TGTGCCAGCTCACCACGATGTGGGGGTGGAATGGGAAATGAGCAGTTCTTC	CASSPRCGGGMGNEQFF	TRBV18	TRBJ2-1
TGTGTAACAGGGGAGACCTGCAATCAGCCCCAGCATTTT	CVTGETCNQPQHF	TRBV28	TRBJ1-5
TGTGCCAGCAGCCACAGCATCCTTAGGCGCACTGAAGCTTTCTTT	CASSHSILRRTEAFF	TRBV7-9	TRBJ1-1
TGTGCCAGCAGCGGCGACAGGGAAGAGCAGTACTTC	CASSGDREEQYF	TRBV13	TRBJ2-7
TGTGCCAGCAGCAAACCGGGACTTTGGGATGGCTACACCTTC	CASSKPGLWDGYTF	TRBV7-2	TRBJ1-2
TGTGCCAGCAGTGCCAGGGGCGAGCAGTACTTC	CASSARGEQYF	TRBV2	TRBJ2-7
TGTGCCACTTACTGGGGGGGAGGGAATGAAAAACTGTTTTTT	CATYWGGGNEKLFF	TRBV11-3	TRBJ1-4
TGTGCCACCAGGGAGACTGGGGCCTCGGACCACAATGAGCAGTTCTTC	CATRETGASDHNEQFF	TRBV24-1	TRBJ2-1
TGCGCCAGCAGCTTGACTGGAACAGTCCATAACGAAAGATACGAGCAGTACTTC	CASSLTGTVHNERYEQYF	TRBV5-1	TRBJ2-7
TGTGCCAGCAGTTACTCAATCGGACAGGGCCCCCTTGCAACTAATGAAAAACTGTTTTTT	CASSYSIGQGPLATNEKLFF	TRBV6-3	TRBJ1-4
TGTGCCACCACTGGACAGAGCGAAAAACTGTTTTTT	CATTGQSEKLFF	TRBV24-1	TRBJ1-4
TGTGCCAGCAGGTTAAAAAGGACTAGTGAGCAGTACTTC	CASRLKRTSEQYF	TRBV6-5	TRBJ2-7
TGTGCCAGCAGCTTAGCGCCTCTGCGAAGGGGGGGCAGCAAGCAAGAGACCCAGTACTTC	CASSLAPLRRGGSKQETQYF	TRBV7-9	TRBJ2-5
TGTGCCAGCAGCTTAGCAACAACTCCACCCCTTGGGCCCTACGAGCAGTACTTC	CASSLATTPPLGPYEQYF	TRBV7-9	TRBJ2-7
TGTGCCAGCAGCTCACAGGGGCCTGATCAAGAGACCCAGTACTTC	CASSSQGPDQETQYF	TRBV13	TRBJ2-5
TGTGCCGTGTCCCGACCGAACTATAATTCACCCCTCCACTTT	CAVSRPNYNSPLHF	TRBV5-6	TRBJ1-6
TGTGCCAGCATTACTAGCGGCCTGCACGAGCAGTACTTC	CASITSGLHEQYF	TRBV27	TRBJ2-7
TGTGCCAGCAGTGACAAACAGGCCCCCGATGGCTACACCTTC	CASSDKQAPDGYTF	TRBV6-4	TRBJ1-2
TGCAGTGCTAGGTTATTTGACGAGCAGTACTTC	CSARLFDEQYF	TRBV20-1	TRBJ2-7
TGTGCCAGTAGTAGCGGGAGGGTATTCAAGGCAACTAATGAAAAACTGTTTTTT	CASSSGRVFKATNEKLFF	TRBV19	TRBJ1-4
TGTGCCAGCAGCCACCAGGGGGCGCAAGGGACTTCCTACGAGCAGTACTTC	CASSHQGAQGTSYEQYF	TRBV13	TRBJ2-7
TGTGCCAGCAGTGGCCCGACGAGCTCCTACGAGCAGTACTTC	CASSGPTSSYEQYF	TRBV6-5	TRBJ2-7
TGTGCCAGCAGCTTAGAGCCGGGACAGGGAGTAGGCTACGAGCAGTACTTC	CASSLEPGQGVGYEQYF	TRBV7-2	TRBJ2-7
TGTGCCAGCTCACCTCCCCGGGGTATCGGCCTTGACTACGAGCAGTACTTC	CASSPPRGIGLDYEQYF	TRBV18	TRBJ2-7
TGTGGTGCCGGGACTAGCGGGGGTAATGAGCAGTTCTTC	CGAGTSGGNEQFF	TRBV11-3	TRBJ2-1
TGTGCCTGGAGTACCGCCAGGGGGCTCCCCAATCAGCCCCAGCATTTT	CAWSTARGLPNQPQHF	TRBV30	TRBJ1-5
TGTGCCTGGAGTGGGGGGGCCAATGAGCAGTTCTTC	CAWSGGANEQFF	TRBV30	TRBJ2-1
TGTGCCAGTAGTATACCGAGGGTAACGGGGGGGCCTTCTACGCAGTATTTT	CASSIPRVTGGPSTQYF	TRBV19	TRBJ2-3
TGTGCCAGCCCCGGGGGGCCCAGGGACTACGAGCAGTACTTC	CASPGGPRDYEQYF	TRBV7-3	TRBJ2-7
TGTGCCAGCAGCCAATATACCATAAGGGCCCTGACGGACTTC	CASSQYTIRALTDF	TRBV3-1	TRBJ2-7
TGTGCCAGCAGCCGGGGCGCTGAAGCTTTCTTT	CASSRGAEAFF	TRBV7-3	TRBJ1-1
TGCAGTGCTAGAAACCGGGGCAGCGGAGGGGACAATGAGCAGTTCTTC	CSARNRGSGGDNEQFF	TRBV20-1	TRBJ2-1
TGTGCCAGCAGCCTTTCTTTTCAAGCGGGATGGGTGACAGCTTTCTTT	CASSLSFQAGWVTAFF	TRBV7-2	TRBJ1-1
TGTGCCAGCAGCCAGGGGACAGGCGGACAGCCCCAGCATTTT	CASSQGTGGQPQHF	TRBV3-1	TRBJ1-5
TGTGCCTGGAGTGGGGCAGGGGAACATAGCGGGGCCAACGTCCTGACTTTC	CAWSGAGEHSGANVLTF	TRBV30	TRBJ2-6
TGTGCCAGCAGCGCCTCCATTAAGGGAGGGCTCAATGAGCAGTTCTTC	CASSASIKGGLNEQFF	TRBV5-6	TRBJ2-1
TGTGCCAGCAGTTTGCCTCGGCGGGGGGGGGAGGACACCGGGGAGCTGTTTTTT	CASSLPRRGGEDTGELFF	TRBV28	TRBJ2-2
TGTGCCAGCAGCTGCCCCAAACTAGCGGGAGGGCCAGGGTTCTCCTACGAGCAGTACTTC	CASSCPKLAGGPGFSYEQYF	TRBV7-3	TRBJ2-7
TGTGCCAGGGTTACGGACTACGAGCAGTACTTC	CARVTDYEQYF	TRBV6-1	TRBJ2-7
TGTGCCAGCCCTAGAGTACAGTTTGTGCACAATCAGCCCCAGCATTTT	CASPRVQFVHNQPQHF	TRBV28	TRBJ1-5
TGCGCCAGCAGCAGGGAAGTGGGGCGCGAGCAGTACTTC	CASSREVGREQYF	TRBV10-1	TRBJ2-7
TGCGCCAGCAGTGAGCACCCGAACTACGAGCAGTACTTC	CASSEHPNYEQYF	TRBV10-1	TRBJ2-7
TGTGCCAGCAGTTTGGTCTCCATGCGTAGCAATCAGCCCCAGCATTTT	CASSLVSMRSNQPQHF	TRBV6-5	TRBJ1-5
TGTGCCACCAGTGATTTTATCCTGAAGGACAGGGCCTCCTACAATGAGCAGTTCTTC	CATSDFILKDRASYNEQFF	TRBV24-1	TRBJ2-1
TGCAGCGATCATAGAAAGGACTCTGGAAACACCATATATTTT	CSDHRKDSGNTIYF	TRBV29-1	TRBJ1-3
TGTGCCAGCAGCCAAGAACCGGGGCTATTGCAAGAGACCCAGTACTTC	CASSQEPGLLQETQYF	TRBV14	TRBJ2-5
TGCGCCAGCAGCTTTCTGTGGGGGCCCGGTGGCAACACCATATATTTT	CASSFLWGPGGNTIYF	TRBV5-1	TRBJ1-3
TGTGCCTGGAGTCGGGGAAAGTCGGCTAATGAAAAACTGTTTTTT	CAWSRGKSANEKLFF	TRBV30	TRBJ1-4
TGCGCCAGCATTGGCTGGAGGGAAATCCGAGGCTACACCTTC	CASIGWREIRGYTF	TRBV10-1	TRBJ1-2
TGTGCCAGCAGTGAGTCCCGGGGGGCCTACAATGAGCAGTTCTTC	CASSESRGAYNEQFF	TRBV27	TRBJ2-1
TGTGCCAGCAGCGGTAAAAGCGGGATTCCCTACAATGAGCAGTTCTTC	CASSGKSGIPYNEQFF	TRBV7-3	TRBJ2-1
TGTGCCAGCAGTTACCTCCGAGACAGCCCGCCCTATGAGCAGTTCTTC	CASSYLRDSPPYEQFF	TRBV6-5	TRBJ2-1
TGTGCCAGCAGTTACGGACTAGCGGGAGGGCAGTTATCCAAAAACATTCAGTACTTC	CASSYGLAGGQLSKNIQYF	TRBV6-5	TRBJ2-4
TGTGCCAGCAGTGACTCGCAGGGGACAGGGTACTATCCAGATACGCAGTATTTT	CASSDSQGTGYYPDTQYF	TRBV6-4	TRBJ2-3
TGTGCCAGCAGCGAGGGACAGGAGCAGTACTTC	CASSEGQEQYF	TRBV9	TRBJ2-7
TGTGCCAGCAGCTTAGCGGCCCCCGCGGTGCCACTTCGGCGACATAGCTCCTATAATTCACCCCTCCACTTT	CASSLAAPAVPLRRHSSYNSPLHF	TRBV11-1	TRBJ1-6
TGTGCCAGCATGGACGAGGGCCCGAAAAAGACTGAAAAACTGTTTTTT	CASMDEGPKKTEKLFF	TRBV27	TRBJ1-4
TGCAGTGCTCGGAGGTCTCCAGGGGGGAATGAGCAGTTCTTC	CSARRSPGGNEQFF	TRBV20-1	TRBJ2-1
TGTGCCAGCAGCTTCCTGGAGACTAGCGGCGGCACAGATACGCAGTATTTT	CASSFLETSGGTDTQYF	TRBV11-2	TRBJ2-3
TGTGCCAGCATCAATTCGACCTCGGACGCGCCCCAGCATTTT	CASINSTSDAPQHF	TRBV27	TRBJ1-5
TGTGCCAGCAGCTTATGTCGGAGGGGATTTTCCGGGGAGCTGTTTTTT	CASSLCRRGFSGELFF	TRBV11-3	TRBJ2-2
TGTGCCAGCAGCTGTGGGGCCGTCCCTCAAGAGACCCAGTACTTC	CASSCGAVPQETQYF	TRBV13	TRBJ2-5
TGTGCCAGCAGTTTCCAACGGGACATTTTCGAAGCTTTCTTT	CASSFQRDIFEAFF	TRBV28	TRBJ1-1
TGTGCCAGCAGTTTTCTAGCGGGAGATTCCAGTACAGATACGCAGTATTTT	CASSFLAGDSSTDTQYF	TRBV6-6	TRBJ2-3
TGCAGTGCTAGACGTTTGACTAGCCAAGAGACCCAGTACTTC	CSARRLTSQETQYF	TRBV20-1	TRBJ2-5
TGTGCCAGCAGCTTATCCGATACGCTTGAGCAGTACTTC	CASSLSDTLEQYF	TRBV7-4	TRBJ2-7
TGTGCCAGCAGTTTATTTCCCAGACTAGGGGAGACCCAGTACTTC	CASSLFPRLGETQYF	TRBV27	TRBJ2-5
TGTGCCAGCAGCCAAGGTGTCGGGCCGGCCTATAATTCACCCCTCCACTTT	CASSQGVGPAYNSPLHF	TRBV3-1	TRBJ1-6
TGTGCTAGTGGCGGGGGACAGGGGGCAAAAGGCTCCGAGCACACTGAAGCTTTCTTT	CASGGGQGAKGSEHTEAFF	TRBV12-5	TRBJ1-1
TGTGCCAGCAGATTTAGGGGAGGGGATCCAAACATTCAGTACTTC	CASRFRGGDPNIQYF	TRBV6-4	TRBJ2-4
TGCGCCAGCACGCCGGCACGGCCAAGTTATAATTCACCCCTCCACTTT	CASTPARPSYNSPLHF	TRBV10-1	TRBJ1-6
TGTGCCAGCTCACCACCCGGGACAGGGACAGATACGCAGTATTTT	CASSPPGTGTDTQYF	TRBV18	TRBJ2-3
TGCAGCGCTGACTCCAGGGTCCGACCCTATAGCAATCAGCCCCAGCATTTT	CSADSRVRPYSNQPQHF	TRBV29-1	TRBJ1-5
TGTGCCAGCTCACGGGGGACTGCGTCCATGGGCTTGACCCAGTACTTC	CASSRGTASMGLTQYF	TRBV28	TRBJ2-5
TGCGCCAGCATTCCACTCTTCTCTGGGGCCAACGTCCTGACTTTC	CASIPLFSGANVLTF	TRBV10-1	TRBJ2-6
TGTGCCAGCAGCCAAGATGGACAGCAGACCCAGTACTTC	CASSQDGQQTQYF	TRBV14	TRBJ2-5
TGTGCCAGTAATGGGACAGGGGGTACGCAGTATTTT	CASNGTGGTQYF	TRBV19	TRBJ2-3
TGTGCCACCAGTACGGGGGGCTTAAGAGGAAAATCCTACGAGCAGTACTTC	CATSTGGLRGKSYEQYF	TRBV24-1	TRBJ2-7
TGTGCCAGCAGCGCCAAGTCACCCCTCCACTTT	CASSAKSPLHF	TRBV7-8	TRBJ1-6
TGTGCCAGCAGCGGCCAGAACTTCCTGAACACTGAAGCTTTCTTT	CASSGQNFLNTEAFF	TRBV11-2	TRBJ1-1
TGTGCCAGCAGGACAGGGCAGAACTATGGCTACACCTTC	CASRTGQNYGYTF	TRBV7-9	TRBJ1-2
TGTGCCAGCAGCTTGGGGGCCTCCCAGGCCCACACTGAAGCTTTCTTT	CASSLGASQAHTEAFF	TRBV5-8	TRBJ1-1
TGTGCCAAGAACAGGGGTGTTATGGAACTAGCCAAAAACATTCAGTACTTC	CAKNRGVMELAKNIQYF	TRBV7-6	TRBJ2-4
TGCGCCAGCAGTGCTTGTTGGGGTTCGGGGCCTGGAAACACCATATATTTT	CASSACWGSGPGNTIYF	TRBV10-1	TRBJ1-3
TGCAGTGCTAGAGAGCGTAACTATGGCTACACCTTC	CSARERNYGYTF	TRBV20-1	TRBJ1-2
TGTGCCAGTAGTATAGATTCCCCCCGTTGGGGAGTGCAGTACTTC	CASSIDSPRWGVQYF	TRBV19	TRBJ2-4
TGTGCCAGCAGCAGGGGGAGCGTACGCGAGCAGTACTTC	CASSRGSVREQYF	TRBV13	TRBJ2-7
TGTGCCTGGACCCAGACGGGAACACATGAAAAACTGTTTTTT	CAWTQTGTHEKLFF	TRBV30	TRBJ1-4
TGTGCCACCAGCTCTCTTGGAGATGAGACCCAGTACTTC	CATSSLGDETQYF	TRBV24-1	TRBJ2-5
TGTGCCAGCAGCCCGAGGGAAACCACCGGGGAGCTGTTTTTT	CASSPRETTGELFF	TRBV9	TRBJ2-2
TGTGCCAGCAGCTTGACGGGGGGGCCTGCCTACGAGCAGTACTTC	CASSLTGGPAYEQYF	TRBV5-8	TRBJ2-7
TGTGCCAGCAAAGGACCCCGAGCTGCAACTAATGAAAAACTGTTTTTT	CASKGPRAATNEKLFF	TRBV6-4	TRBJ1-4
TGTGCCAGCAGCCCCCCTCTATTCGGACTAGCGGGAATGGAGGGACGGGGGGCCTACAATGAGCAGTTCTTC	CASSPPLFGLAGMEGRGAYNEQFF	TRBV7-2	TRBJ2-1
TGTGCCAGCAGTATGCTGGGGGTAAATAATTCACCCCTCCACTTT	CASSMLGVNNSPLHF	TRBV6-4	TRBJ1-6
TGTGCCAGCAGGAGCTACGAGCAGTACTTC	CASRSYEQYF	TRBV6-4	TRBJ2-7
TGTGCCAGCAGTGGCCGGGACAGGGTTGGACCTGCTGGAAACACCATATATTTT	CASSGRDRVGPAGNTIYF	TRBV6-3	TRBJ1-3
TGTGCCAGCAGCCCTGGAGGGCGTCAGGGGGCCCTCTTGAGGGCTGGGGAGCTGTTTTTT	CASSPGGRQGALLRAGELFF	TRBV9	TRBJ2-2
TGTGCCACCCATAGGGGGGGGGCCTGTCCTAGCACAGATACGCAGTATTTT	CATHRGGACPSTDTQYF	TRBV15	TRBJ2-3
TGCGCCAGCAGCTGTCAGGGGGCCCGGGAGTACTACGAGCAGTACTTC	CASSCQGAREYYEQYF	TRBV5-1	TRBJ2-7
TGTGCCAGCAGTGACTCGGCTCCGGGACAGGGGGCGAACACTGAAGCTTTCTTT	CASSDSAPGQGANTEAFF	TRBV6-4	TRBJ1-1
TGTGCCAGCAGTCCTAAGAGGGGCACCACAGATACGCAGTATTTT	CASSPKRGTTDTQYF	TRBV27	TRBJ2-3
TGTGCCAGCAGACCTCACCAACAGGGGGATTCCTCCTACGAGCAGTACTTC	CASRPHQQGDSSYEQYF	TRBV6-4	TRBJ2-7
TGTGCCAGCAGGGGGGTTCCGAAGGGCTACGAGCAGTACTTC	CASRGVPKGYEQYF	TRBV6-6	TRBJ2-7
TGCAGCGGGTCTAGCTTCACTGAAGCTTTCTTT	CSGSSFTEAFF	TRBV29-1	TRBJ1-1
TGTGCCAGCAGCGGGGGCAGAGCGAATGAAAAACTGTTTTTT	CASSGGRANEKLFF	TRBV14	TRBJ1-4
TGTGCCAGCAGACGGCCAATGCATCTAGCGGATCTGAACACCGGGGAGCTGTTTTTT	CASRRPMHLADLNTGELFF	TRBV12-3	TRBJ2-2
TGTGAAGAAGTACGGGGGGGAACCGAAGTCCTCGGCAATGAGCAGTTCTTC	CEEVRGGTEVLGNEQFF	TRBV12-3	TRBJ2-1
TGTGCCAGCAGCTACATTTTGGCGCCGTCCTACAATGAGCAGTTCTTC	CASSYILAPSYNEQFF	TRBV5-6	TRBJ2-1
TGCGCCAGCAGTGAGGGTTTCGAGAAGGGAGTTGATTGTAGTGGCTACACCTTC	CASSEGFEKGVDCSGYTF	TRBV10-1	TRBJ1-2
TGTGCCAGTAGTATAACAGGGGCTACGAACACCGGGGAGCTGTTTTTT	CASSITGATNTGELFF	TRBV19	TRBJ2-2
TGCGCCAGCAGCGCCGGGGGACACGGGACGGCGACCAAAAACATTCAGTACTTC	CASSAGGHGTATKNIQYF	TRBV5-1	TRBJ2-4
TGTGCCAGCAGGGGACAAAAACTGTTTTTT	CASRGQKLFF	TRBV6-5	TRBJ1-4
TGCGCCAGCAGGGGAAGGGGTGCCTACGAGCAGTACTTC	CASRGRGAYEQYF	TRBV10-1	TRBJ2-7
TGTGCCAGCAGCCCTGACAGGGGGTGGGTTGAAGCTTTCTTT	CASSPDRGWVEAFF	TRBV13	TRBJ1-1
TGTGCCACCAGTGAGAACCGAGAGGTGAACACTGAAGCTTTCTTT	CATSENREVNTEAFF	TRBV24-1	TRBJ1-1
TGTGCCACCAGCAGAGATACCAGGGACAGGTGGGATGAGCAGTACTTC	CATSRDTRDRWDEQYF	TRBV15	TRBJ2-7
TGCAGTGCTCCGAAAGGGACTAGCGGGAATTACAATGAGCAGTTCTTC	CSAPKGTSGNYNEQFF	TRBV20-1	TRBJ2-1
TGTGCCAGCAGCGACAGGGCGACTGAAGCTTTCTTT	CASSDRATEAFF	TRBV9	TRBJ1-1
TGCGCCAGCAGCTTGTTGAGGACAGGGGGCTGGGCTAAAGCTTTCTTT	CASSLLRTGGWAKAFF	TRBV5-1	TRBJ1-1
TGTGCCAGCAAAGAGGGGGTCGGGAAGTTACTAGCCAAAAACATTCAGTACTTC	CASKEGVGKLLAKNIQYF	TRBV5-4	TRBJ2-4
TGTGCCTGGACAACCCTTGACCGAACTAACTATGGCTACACCTTC	CAWTTLDRTNYGYTF	TRBV30	TRBJ1-2
TGCAGCGTTGAGACGGGGACAGATACGCAGTATTTT	CSVETGTDTQYF	TRBV29-1	TRBJ2-3
TGCAGTGCTATCCGAAGGGGGGGGCCAAACGAGCAGTACTTC	CSAIRRGGPNEQYF	TRBV20-1	TRBJ2-7
TGTGCCATCAGAATGCAGGGCCTCCAGGATGGGGTCTATGGCTACACCTTC	CAIRMQGLQDGVYGYTF	TRBV10-3	TRBJ1-2
TGCAGTGCTAGCCCGATTTTTGAAACCTCCTACGAGCAGTACTTC	CSASPIFETSYEQYF	TRBV20-1	TRBJ2-7
TGTCCTTCAAATTTTACCGGGACTAGATACGAGCAGTACTTC	CPSNFTGTRYEQYF	TRBV7-9	TRBJ2-7
TGCAGTGCTAGAGTGTTAGGGCCCGCCAAAAACATTCAGTACTTC	CSARVLGPAKNIQYF	TRBV20-1	TRBJ2-4
TGTGCTAGTGGCCTAGGACTATTGCACAATGAGCAGTTCTTC	CASGLGLLHNEQFF	TRBV12-5	TRBJ2-1
TGTGCCTGGAGTATCAGGGGGGCATTGGCGGGCTCTGGGGCCAACGTCCTGACTTTC	CAWSIRGALAGSGANVLTF	TRBV30	TRBJ2-6
TGCAGTGCTAGAGCGTTGGGAAGCAGCGGCTCAGATACGCAGTATTTT	CSARALGSSGSDTQYF	TRBV20-1	TRBJ2-3
TGTGCCAGCAGCCGAAGGGGAACTCAGCCCCAGCATTTT	CASSRRGTQPQHF	TRBV3-1	TRBJ1-5
TGTGCCAGGGGGAGGGAGACCCAGTACTTC	CARGRETQYF	TRBV6-4	TRBJ2-5
TGTGCCAGCAGAAAAGTAGCCCCGGGACAGGGGAGGGCTTTCTTT	CASRKVAPGQGRAFF	TRBV28	TRBJ1-1
TGTGCCAGCAGACTCCTCCTAGCGGGTTCCCCGGTCTTC	CASRLLLAGSPVF	TRBV28	TRBJ2-1
TGTGCCAGTAGTAACGGCAGGGGGCTTAGGGACTTGTATAGCAATCAGCCCCAGCATTTT	CASSNGRGLRDLYSNQPQHF	TRBV19	TRBJ1-5
TGTGCCAGCAGCTTGGGGGGCAGTGACAGGGCCCAGCATTTT	CASSLGGSDRAQHF	TRBV5-4	TRBJ1-5
TGCAGTGCGATCCCGTGGGCCGGTTTTTCCGAGTGGACTAATGAAAAACTGTTTTTT	CSAIPWAGFSEWTNEKLFF	TRBV20-1	TRBJ1-4
TGTGCCAGCAGTGCCCCAGGGCCAGGCTACGAGCAGTACTTC	CASSAPGPGYEQYF	TRBV25-1	TRBJ2-7
TGCGCCAGCAGCGTAGGGAGAGGAAGCACAGATACGCAGTATTTT	CASSVGRGSTDTQYF	TRBV5-1	TRBJ2-3
TGTGCCAGCAACCGGCACAGAAACTATGGCTACACCTTC	CASNRHRNYGYTF	TRBV14	TRBJ1-2
TGCAGTGCTAGCAGTACTAACTATGGCTACACCTTC	CSASSTNYGYTF	TRBV20-1	TRBJ1-2
TGCGCCACATCAGGGACCTACGAGCAGTACTTC	CATSGTYEQYF	TRBV4-3	TRBJ2-7
TGTGCCAGCAGCGGCCTGGACATGAACACTGAAGCTTTCTTT	CASSGLDMNTEAFF	TRBV13	TRBJ1-1
TGTGCCAGCCCAGGTAACACAGGGGTTGAAGCTTTCTTT	CASPGNTGVEAFF	TRBV12-4	TRBJ1-1
TGTGCCTGGACCGGGGGGGCGGGAGAGACCCAGTACTTC	CAWTGGAGETQYF	TRBV30	TRBJ2-5
TGTGCCAGCAGCGTAGCGAAGGGGAAAAGCAATCAGCCCCAGCATTTT	CASSVAKGKSNQPQHF	TRBV9	TRBJ1-5
TGTGCCAGTAGTATGCCTACAGGGCGTGGCTACACCTTC	CASSMPTGRGYTF	TRBV19	TRBJ1-2
TGTGCCAGCTCACCACGGCCCCAAAAGACAGGGTACAGAGGAGGCTACGAGCAGTACTTC	CASSPRPQKTGYRGGYEQYF	TRBV18	TRBJ2-7
TGCGCCAGCAGTCCGCACACGCACACTGAAGCTTTCTTT	CASSPHTHTEAFF	TRBV5-1	TRBJ1-1
TGTGCCAGCAGTCTTTGCCTTGGGAACACTGAAGCTTTCTTT	CASSLCLGNTEAFF	TRBV6-3	TRBJ1-1
TGCACAAGAATAACAGGGAGACAGCAAGAGACCCAGTACTTC	CTRITGRQQETQYF	TRBV20-1	TRBJ2-5
TGCGCCACGACTAGCGGGGGGAGGGACGAGCAGTACTTC	CATTSGGRDEQYF	TRBV10-1	TRBJ2-7
TGCGCCAGCCAAGACAGGGGCACCGGGGAGCTGTTTTTT	CASQDRGTGELFF	TRBV5-1	TRBJ2-2
TGCAGTGCTAGACAGGGGCTAAATCAGCCCCAGCATTTT	CSARQGLNQPQHF	TRBV20-1	TRBJ1-5
TGTGCCAGCAGCCACTGGGGGGCAGATACGCAGTATTTT	CASSHWGADTQYF	TRBV4-2	TRBJ2-3
TGTGCCAGCAGCGTACGGTCAGCGGGAGGGCCTAACTATGGCTACACCTTC	CASSVRSAGGPNYGYTF	TRBV9	TRBJ1-2
TGTGCCAGCGGGAGGGACAGCTACGAGCAGTACTTC	CASGRDSYEQYF	TRBV6-1	TRBJ2-7
TGCGCCAGCAGTGCACTCTACGAGCAGTACTTC	CASSALYEQYF	TRBV10-1	TRBJ2-7
TGTGCCAGCAGCTTAAGGTGGCCCTGTAGCAATCAGCCCCAGCATTTT	CASSLRWPCSNQPQHF	TRBV7-3	TRBJ1-5
TGTGCCAGCAGCGTAGGAGGCCGGGACAGGGAGTACGGAAACGTGAACACTGAAGCTTTCTTT	CASSVGGRDREYGNVNTEAFF	TRBV9	TRBJ1-1
TGTGCCACCAGTGAACTAATAGGGAATCCTGAAGCTTTCTTT	CATSELIGNPEAFF	TRBV24-1	TRBJ1-1
TGCAGCGTCACAGTCGGAGACGGGTTGGAGCAGTACTTC	CSVTVGDGLEQYF	TRBV29-1	TRBJ2-7
TGCAGTGCTAGAGTCCGGGACGCAGATACGCAGTATTTT	CSARVRDADTQYF	TRBV20-1	TRBJ2-3
TGTGCCACCAGCTCCCCGGGACTAGCGACCGGGGAGCTGTTTTTT	CATSSPGLATGELFF	TRBV15	TRBJ2-2
TGTGCCAGCAGCAGGGATTGGAGGCCGAACACCGGGGAGCTGTTTTTT	CASSRDWRPNTGELFF	TRBV11-3	TRBJ2-2
TGTGCCAGCAGCCCGTCTAAGTACTACGAGCAGTACTTC	CASSPSKYYEQYF	TRBV7-9	TRBJ2-7
TGTGCCAGCAGTTTAACCTGGGGCCCTGGAAACACCATATATTTT	CASSLTWGPGNTIYF	TRBV27	TRBJ1-3
TGCGCCAGCAGTGACGCGGACAGGGCTGCCTACGAGCAGTACTTC	CASSDADRAAYEQYF	TRBV10-1	TRBJ2-7
TGTGCCAGCAGTCCGACAGAAGGAGGCCGGGAGACCCAGTACTTC	CASSPTEGGRETQYF	TRBV27	TRBJ2-5
TGTGCCAGCAGCGTCAATACAAGCGGGTGGACTGAAGCTTTCTTT	CASSVNTSGWTEAFF	TRBV7-4	TRBJ1-1
TGTGCCAGCAGCCCGGGACCGCAGTATTTT	CASSPGPQYF	TRBV5-6	TRBJ2-3
TGTGCCAGCAGTTACGCACCAAAAGGGGGACTGTGGAATCAGCCCCAGCATTTT	CASSYAPKGGLWNQPQHF	TRBV6-2	TRBJ1-5
TGTGCCAGCAGTTACTCTTGGGGGGGCCAAGAGACCCAGTACTTC	CASSYSWGGQETQYF	TRBV6-5	TRBJ2-5
TGTGCCTGGAGGGTCGGCTCGGACTACGAGCAGTACTTC	CAWRVGSDYEQYF	TRBV30	TRBJ2-7
TGTGCCAGCAGTTGTTGGGGGGAAGAGACCCAGTACTTC	CASSCWGEETQYF	TRBV27	TRBJ2-5
TGCGCCAGCACTAACGGGGGGAGTTGCTACGAGCAGTACTTC	CASTNGGSCYEQYF	TRBV10-2	TRBJ2-7
TGCGCCAGCAGCTTGCTTCGGGTAATCCTGGAGGGCTACGAGCAGTACTTC	CASSLLRVILEGYEQYF	TRBV5-1	TRBJ2-7
TGTGCCAGCGGGGGGGACGATGGCTACACCTTC	CASGGDDGYTF	TRBV6-4	TRBJ1-2
TGCGCCAGCAGCGGACGCGGCTACACCTTC	CASSGRGYTF	TRBV5-1	TRBJ1-2
TGTGCCAGCAGCTTAGGCTCGCCGAATAGGTACGAGCAGTACTTC	CASSLGSPNRYEQYF	TRBV11-2	TRBJ2-7
TGCAGTGCTAGAGCTGGCCAGGTTCTTCCGAGTCGAAGCTACGAGCAGTACTTC	CSARAGQVLPSRSYEQYF	TRBV20-1	TRBJ2-7
TGTGCCAGCAGCGGCTCCCCCCCGGACTTAAGGGAGCTGTTTTTT	CASSGSPPDLRELFF	TRBV9	TRBJ2-2
TGTGCCAGCGTATGGGGGGGGAGGGTAAATAACGAGCAGTACTTC	CASVWGGRVNNEQYF	TRBV25-1	TRBJ2-7
TGTGCCGTTTCGGGGGGCACAGATACGCAGTATTTT	CAVSGGTDTQYF	TRBV10-3	TRBJ2-3
TGTGCCAGCGTACGGCGAAGGTCCCCGCTTTATGAAAAACTGTTTTTT	CASVRRRSPLYEKLFF	TRBV19	TRBJ1-4
TGCGCCAGCAGCCATCCGCGGGACAGGTACAATGAGCAGTTCTTC	CASSHPRDRYNEQFF	TRBV4-3	TRBJ2-1
TGCGCCAGCAGCTTGGGGAGCAGGCCAGGGAACACTGAAGCTTTCTTT	CASSLGSRPGNTEAFF	TRBV5-1	TRBJ1-1
TGTGCCAGCAGTGACGAAGGCTTCTGGACAGGGGGGGGGAACACTGAAGCTTTCTTT	CASSDEGFWTGGGNTEAFF	TRBV6-4	TRBJ1-1
TGTGCCACCATTATTACAGGGGGGGTTAGTTACAATGAGCAGTTCTTC	CATIITGGVSYNEQFF	TRBV24-1	TRBJ2-1
TGTGCCATCGGTAACCCAGGCCCCGACTATGGCTACACCTTC	CAIGNPGPDYGYTF	TRBV10-3	TRBJ1-2
TGTGCCACGTTGACAGGGAACCCTAACTATGGCTACACCTTC	CATLTGNPNYGYTF	TRBV3-1	TRBJ1-2
TGCAGTGCTAGACCCCAGGGTTATGAGCAGTTCTTC	CSARPQGYEQFF	TRBV20-1	TRBJ2-1
TGCGCCAGCAGCCAAGATGGACAGGGCGGCTACACCTTC	CASSQDGQGGYTF	TRBV4-1	TRBJ1-2
TGTGCCAGCAGTTACTCGAGCCAGATGGTTGGCTCCTACGAGCAGTACTTC	CASSYSSQMVGSYEQYF	TRBV6-5	TRBJ2-7
TGTGCCAGCAGTTACCAACCCGGGACAGGGGAGACCCAGTACTTC	CASSYQPGTGETQYF	TRBV6-2	TRBJ2-5
TGCAGTGCTGGGACCCGCGGGAGATCATTCTCCTACAATGAGCAGTTCTTC	CSAGTRGRSFSYNEQFF	TRBV20-1	TRBJ2-1
TGTGCCAGCAGTTCAAAGCCCTACGAGCAGTACTTC	CASSSKPYEQYF	TRBV27	TRBJ2-7
TGTGCCAGCAGTTTTTCGGGGGGTCGGGGTGACAATGAGCAGTTCTTC	CASSFSGGRGDNEQFF	TRBV6-9	TRBJ2-1
TGCGCCAGCCATAGAGCGGGTCCACCTTGGGCGAACACTGAAGCTTTCTTT	CASHRAGPPWANTEAFF	TRBV10-1	TRBJ1-1
TGTGCCAGCAGCGGGGGGCGGGACGAAGAGACCCAGTACTTC	CASSGGRDEETQYF	TRBV11-3	TRBJ2-5
TGTGCCAGCACCCGGGACAGGGGCCTTCAGCCCCAGCATTTT	CASTRDRGLQPQHF	TRBV6-3	TRBJ1-5
TGTGCCAGCAGTTTAGATGAGATTGGCCTTCTTAACTATGGCTACACCTTC	CASSLDEIGLLNYGYTF	TRBV27	TRBJ1-2
TGTGCCAGCAGTGAACACGGACTAGCGCACTTGTGCACAGATACGCAGTATTTT	CASSEHGLAHLCTDTQYF	TRBV2	TRBJ2-3
TGTGCCACCAGTGATTGGGACCAGGCGGGAAGTGACTTTTTCTACACCTTC	CATSDWDQAGSDFFYTF	TRBV24-1	TRBJ1-2
TGTGCCAGCAGCTTGACGGTGGGAGGCTCTGGAAACACCATATATTTT	CASSLTVGGSGNTIYF	TRBV28	TRBJ1-3
TGTGCTAGTGCCCTCTCACAGGGGAGGGGCTCCTACGAGCAGTACTTC	CASALSQGRGSYEQYF	TRBV12-5	TRBJ2-7
TGTGCCAGCAGCGAAACCCAAAACCCGGCCAAAAACATTCAGTACTTC	CASSETQNPAKNIQYF	TRBV13	TRBJ2-4
TGCGCCAGCAGCAACAGAAGGGGTGGCTACACCTTC	CASSNRRGGYTF	TRBV5-1	TRBJ1-2
TGCGCCAGCAGCTTGAGTGGGGTCGTTTCTAACTATGGCTACACCTTC	CASSLSGVVSNYGYTF	TRBV5-1	TRBJ1-2
TGTGCCAGCAGCTTGCCAGACGGACAGGGGGCAACAGATACGCAGTATTTT	CASSLPDGQGATDTQYF	TRBV7-4	TRBJ2-3
TGTGCCAGCAGACGGGACACCGGGGAGCTGTTTTTT	CASRRDTGELFF	TRBV6-4	TRBJ2-2
TGTGCCAGCACGGGGGGGGCCAGGTATGAGCAGTTCTTC	CASTGGARYEQFF	TRBV6-2	TRBJ2-1
TGTGCCAGCAGCAGGGGGGGCGAGCAGTACTTC	CASSRGGEQYF	TRBV11-3	TRBJ2-7
TGTGCCAGCAGCGGGACAGGTCAGCCCCAGCATTTT	CASSGTGQPQHF	TRBV7-9	TRBJ1-5
TGTGCCAGCAGCCCACGAGTCAGGGGGCTATACGAGCAGTACTTC	CASSPRVRGLYEQYF	TRBV4-2	TRBJ2-7
TGTGCCAGCAACCCCCCGGGACAGGGGCACACCGGGGAGCTGTTTTTT	CASNPPGQGHTGELFF	TRBV11-3	TRBJ2-2
TGTGCCACCAGTGATTTCGCCGGGACAACACCTAGCTACGAGCAGTACTTC	CATSDFAGTTPSYEQYF	TRBV24-1	TRBJ2-7
TGTGCCAGCAGTTACACTTACAGGCATAATGCTGAAGCTTTCTTT	CASSYTYRHNAEAFF	TRBV12-3	TRBJ1-1
TGTGCCAGCCCGGGAAATCAGGGCTATGGCTACACCTTC	CASPGNQGYGYTF	TRBV7-9	TRBJ1-2
TGTGCCAGCAGCTTACAGGGGAGATTCACTGAAGCTTTCTTT	CASSLQGRFTEAFF	TRBV7-9	TRBJ1-1
TGCGCCAGCAGCTTGGGAGGGCTAAGTACCCCGAACACCGGGGAGCTGTTTTTT	CASSLGGLSTPNTGELFF	TRBV5-1	TRBJ2-2
TGTGCCAGCAGCTTATCCCGACAGGGCTTTGTGTACTTC	CASSLSRQGFVYF	TRBV7-6	TRBJ2-7
TGCGCCAGCAGCCAAGATGCACCTTCCAGGGGCTGGCACAACAACCACACTGAAGCTTTCTTT	CASSQDAPSRGWHNNHTEAFF	TRBV4-3	TRBJ1-1
TGCAGTGCTAGGAGGACAGGGGGGAGCTCCTACAATGAGCAGTTCTTC	CSARRTGGSSYNEQFF	TRBV20-1	TRBJ2-1
TGTGCCAGCAGCCAACCCGGGTACAGGGCTAACTATGGCTACACCTTC	CASSQPGYRANYGYTF	TRBV3-1	TRBJ1-2
TGTGCCAGCAGCTTGCAGGGGGCCACCGGGGAGCTGTTTTTT	CASSLQGATGELFF	TRBV9	TRBJ2-2
TGTGCCAGCAGCTTAGGACAGGAGAGGGACACCGGGGAGCTGTTTTTT	CASSLGQERDTGELFF	TRBV7-2	TRBJ2-2
TGTGCCAGCAGCCAAGGTCGTCCTAGCGGGGGGGCCTCAGGGTTTGGCTACAATGAGCAGTTCTTC	CASSQGRPSGGASGFGYNEQFF	TRBV4-2	TRBJ2-1
TGTGCCAGCAGCGTAGCTGGAGCGGAGGACTCCTACGAGCAGTACTTC	CASSVAGAEDSYEQYF	TRBV9	TRBJ2-7
TGTGCCAGCAGCACCCGGAGGGAGCAGGGATTTAATCAGCCCCAGCATTTT	CASSTRREQGFNQPQHF	TRBV7-3	TRBJ1-5
TGTGCCTGGAGTTACAGGGGGCGCTTCACTGAAGCTTTCTTT	CAWSYRGRFTEAFF	TRBV30	TRBJ1-1
TGTGCCAGCAGCTCGCAAGAGACCCAGTACTTC	CASSSQETQYF	TRBV9	TRBJ2-5
TGTGCCACCAGTGATTTACAGGGCGAGACTAACTATGGCTACACCTTC	CATSDLQGETNYGYTF	TRBV24-1	TRBJ1-2
TGCGCCAGCAGGAGTCCGGGGGGGCTCAATGAGCAGTTCTTC	CASRSPGGLNEQFF	TRBV10-1	TRBJ2-1
TGTGCCAGCAGCTTAGTCTCCCTCTGGGACAGGGGGCACCCACCGCACAATGAGCAGTTCTTC	CASSLVSLWDRGHPPHNEQFF	TRBV11-2	TRBJ2-1
TGTGCCAGCAGCCAGTTGGGGCTCGGCTACGAGCAGTACTTC	CASSQLGLGYEQYF	TRBV2	TRBJ2-7
TGTGCCAGCAGCGGTCCTAACGGGAAACGAGAGACCCAGTACTTC	CASSGPNGKRETQYF	TRBV7-9	TRBJ2-5
TGCGCCAGCACCCCGGGGCACTATGGCTACACCTTC	CASTPGHYGYTF	TRBV4-3	TRBJ1-2
TGCGCCAGCAGAGTCGGACTAGCTGAGGTTATACGGAACACCGGGGAGCTGTTTTTT	CASRVGLAEVIRNTGELFF	TRBV10-1	TRBJ2-2
TGTGCCAGCAGCGCCGGGGGAAACAATGAGCAGTTCTTC	CASSAGGNNEQFF	TRBV7-3	TRBJ2-1
TGTGCCAGCTCACCAAGAGGGATAAGCTCCTATAATTCACCCCTCCACTTT	CASSPRGISSYNSPLHF	TRBV18	TRBJ1-6
TGTGCCAGCAGCTGCAGGGAGGCCTCCTACGAGCAGTACTTC	CASSCREASYEQYF	TRBV7-4	TRBJ2-7
TGCAGTGCTAGAATACCCGGAAGTCGCTACGAGCAGTACTTC	CSARIPGSRYEQYF	TRBV20-1	TRBJ2-7
TGCAGTGCTAGATGGTGGATAGCCGGTTCCTACGAGCAGTACTTC	CSARWWIAGSYEQYF	TRBV20-1	TRBJ2-7
TGTGCCAGCGGGGACTACAATGAGCAGTTCTTC	CASGDYNEQFF	TRBV9	TRBJ2-1
TGTGCCAGCAGCCGGGATCGGCCAGGGGGGGAAGGCTGGACCCCCTACGAGCAGTACTTC	CASSRDRPGGEGWTPYEQYF	TRBV27	TRBJ2-7
TGCGCCAGCAGCTCCGGGGACAGGGGGGATGAGACCCAGTACTTC	CASSSGDRGDETQYF	TRBV5-1	TRBJ2-5
TGTGCCAGCAGCCCGGGACAGGGCTACACCTTC	CASSPGQGYTF	TRBV13	TRBJ1-2
TGTGCCAGCAGCTCCGGGAGGGCCGAGCAGTACTTC	CASSSGRAEQYF	TRBV5-6	TRBJ2-7
TGTGCCAGCAGAGGGTTGAGCAATCAGCCCCAGCATTTT	CASRGLSNQPQHF	TRBV6-5	TRBJ1-5
TGCGCCAGCAGCCAAGTCTCGTTAGCCGGGACAGGGGGTAGCCCCGCCGGGGAGCTGTTTTTT	CASSQVSLAGTGGSPAGELFF	TRBV4-1	TRBJ2-2
TGTGCCAGCAGTTCTTGCCGACCAATCAGGACAGGGGGCCAGCCCCAGCATTTT	CASSSCRPIRTGGQPQHF	TRBV6-5	TRBJ1-5
TGCAGTGCTAGAGCGACAGGGGAGGTTAGGGGAGCAAGGCCGGCAACTAATGAAAAACTGTTTTTT	CSARATGEVRGARPATNEKLFF	TRBV20-1	TRBJ1-4
TGTGCCAGCAATGTACCCTACGAGCAGTACTTC	CASNVPYEQYF	TRBV9	TRBJ2-7
TGCGCCAGCGAGTTGGGGGCGTTCTACGAGCAGTACTTC	CASELGAFYEQYF	TRBV10-1	TRBJ2-7
TGTGCCATCAGTGAGTCGCATCCTAGGGGGGACACCGGGGAGCTGTTTTTT	CAISESHPRGDTGELFF	TRBV10-3	TRBJ2-2
TGTGCCAGCAGTAGGGGACTCACCGGGGAGCTGTTTTTT	CASSRGLTGELFF	TRBV11-2	TRBJ2-2
TGTGCCAGCAGTGAATGTTTGGCTACAGAGAAGGCTACAGCTAACTATGGCTACACCTTC	CASSECLATEKATANYGYTF	TRBV25-1	TRBJ1-2
TGTGCCAGCACGAAAGCCTTCTTCTACGAGCAGTACTTC	CASTKAFFYEQYF	TRBV27	TRBJ2-7
TGTGCCAGCAGGACAGGGGGTGGACAAGAGACCCAGTACTTC	CASRTGGGQETQYF	TRBV12-3	TRBJ2-5
TGTGCCACCAGTGCCAGGGGGCTTCATGAGCAGTTCTTC	CATSARGLHEQFF	TRBV24-1	TRBJ2-1
TGTGCCACCAGCAGAGATATGTCGTATCGGAACACTGAAGCTTTCTTT	CATSRDMSYRNTEAFF	TRBV15	TRBJ1-1
TGTGCCAGCAAACCTTTAGGGGGACAGAAGAGAGCCAAAAACATTCAGTACTTC	CASKPLGGQKRAKNIQYF	TRBV2	TRBJ2-4
TGCGCCAGCAGCCCTCCAGCGGGGGACTACGAGCAGTACTTC	CASSPPAGDYEQYF	TRBV4-1	TRBJ2-7
TGTGCCAGCAGCTTTTGGAGAATTAATTCACCCCTCCACTTT	CASSFWRINSPLHF	TRBV5-4	TRBJ1-6
TGCGCCAGCAGCCAAGATACCCCCTGGGAGGGGGGGGTCACCGGGGAGCTGTTTTTT	CASSQDTPWEGGVTGELFF	TRBV4-1	TRBJ2-2
TGCGCCAGCAGCCAGGGGGCGTGCTGGGGTGAGACCCAGTACTTC	CASSQGACWGETQYF	TRBV5-1	TRBJ2-5
TGCAGTGCTAGGGGGCGGGAGTTTGACAACACTGAAGCTTTCTTT	CSARGREFDNTEAFF	TRBV20-1	TRBJ1-1
TGTGCCAGCAGTGTTAATTCACCCGGATCAGGGTCCGGTATGAACACTGAAGCTTTCTTT	CASSVNSPGSGSGMNTEAFF	TRBV2	TRBJ1-1
TGTGCCAGCAGCGACGGGACAGGGGTGGGGGGAAACACCATATATTTT	CASSDGTGVGGNTIYF	TRBV7-9	TRBJ1-3
TGTGCCAGCAGCCCTCATCGGGGCAACTATGGCTACACCTTC	CASSPHRGNYGYTF	TRBV6-8	TRBJ1-2
TGTGCCAGCAGGGGTGAGGGGACTAGCGGGGGGGCACCCCCCACAGATACGCAGTATTTT	CASRGEGTSGGAPPTDTQYF	TRBV27	TRBJ2-3
TGTGCCAGCAGCTTAGATAGAGGGGGTGCTAGGAGAAGCTCCTATAATTCACCCCTCCACTTT	CASSLDRGGARRSSYNSPLHF	TRBV7-9	TRBJ1-6
TGCGCCAGCAGCCAAGATCCACCCCGCGGGAGCACTGAAGCTTTCTTT	CASSQDPPRGSTEAFF	TRBV4-3	TRBJ1-1
TGTGCCAGCAGGGCTCTTGGGGGGGCTCCCAGGGGATACAATGAGCAGTTCTTC	CASRALGGAPRGYNEQFF	TRBV6-5	TRBJ2-1
TGTGCCAGCAGGACTCCTTATTCACCCCTCCACTTT	CASRTPYSPLHF	TRBV6-5	TRBJ1-6
TGTGCCAGCAGCAACGACAGGGCCAGGCGGGGGCATTCTTATAGCAATCAGCCCCAGCATTTT	CASSNDRARRGHSYSNQPQHF	TRBV7-3	TRBJ1-5
TGTGCCAGCAGCTTAAAGCACCCGGGAGTCTATAACCCGGAGGAGACCCAGTACTTC	CASSLKHPGVYNPEETQYF	TRBV7-3	TRBJ2-5
TGTGCCAGCAGCAGCCGGGAGAATGAGGGTAGAGATACGCAGTATTTT	CASSSRENEGRDTQYF	TRBV9	TRBJ2-3
TGTGCCAGCAGCTTCCTCGACATTACGACAGGGCCCCAGGGGGGTCCCGCTGAAGCTTTCTTT	CASSFLDITTGPQGGPAEAFF	TRBV7-9	TRBJ1-1
TGTGCCAGTAGTATTCATTCCAACCCGACAGCTTTCTTT	CASSIHSNPTAFF	TRBV19	TRBJ1-1
TGTGTAAGGGTAATCCAAGAGACCCAGTACTTC	CVRVIQETQYF	TRBV12-3	TRBJ2-5
TGTGCCAGCAGCCAAGCCCGGACAGAAAGGAGCAATCAGCCCCAGCATTTT	CASSQARTERSNQPQHF	TRBV3-1	TRBJ1-5
TGTGCCAGCAGCTTACGTTCCGGGACGAGCGAGCAGTACTTC	CASSLRSGTSEQYF	TRBV11-2	TRBJ2-7
TGTGCCAGCAGCTTAGAGGGTAGCCAAGAGACCCAGTACTTC	CASSLEGSQETQYF	TRBV7-9	TRBJ2-5
TGTGCCAGTAGTAACAGGGGGCTAAATGAAAAACTGTTTTTT	CASSNRGLNEKLFF	TRBV19	TRBJ1-4
TGCAGTGCCTTGGGGGGGAGACGTCCCTACGAGCAGTACTTC	CSALGGRRPYEQYF	TRBV20-1	TRBJ2-7
TGTGCCAGCAGTGAAGGGACCCTTGGCAGAGAGACCCAGTACTTC	CASSEGTLGRETQYF	TRBV6-1	TRBJ2-5
TGCAGCGGTGGAGGGGGGCCTTCCTCCTACGAGCAGTACTTC	CSGGGGPSSYEQYF	TRBV29-1	TRBJ2-7
TGTGCCAGCAGTGAAGGAAGCCTAGGGGGCATCACCGGGGAGCTGTTTTTT	CASSEGSLGGITGELFF	TRBV6-4	TRBJ2-2
TGTGCCAGCAGCTCCCAGCCAGATGGAAACACCATATATTTT	CASSSQPDGNTIYF	TRBV13	TRBJ1-3
TGTGCTAGTGGTATAGGAGTAAGGGGGGGCCCGGAGTACAATGAGCAGTTCTTC	CASGIGVRGGPEYNEQFF	TRBV12-5	TRBJ2-1
TGTGCCAGCAGTCCTTTTAAGGGGAAAGGAAACACCATATATTTT	CASSPFKGKGNTIYF	TRBV27	TRBJ1-3
TGTGCCAGCAGCTCAAGAGACACTGAAGCTTTCTTT	CASSSRDTEAFF	TRBV11-2	TRBJ1-1
TGTGCCAGCAAGGGGGCACAAGGCCACTACGAGCAGTACTTC	CASKGAQGHYEQYF	TRBV9	TRBJ2-7
TGTGCCAGCAGTGGTTGGGGACAAGAGACCCAGTACTTC	CASSGWGQETQYF	TRBV27	TRBJ2-5
TGTGCCTGCCCGGGACAGGGTGGGAGGATCTCTAGCAATCAGCCCCAGCATTTT	CACPGQGGRISSNQPQHF	TRBV2	TRBJ1-5
TGTGCCAGCAGCCAAGGGGGGGGCGGCTTC	CASSQGGGGF	TRBV14	TRBJ2-5
TGTGCCAGCATACCACAAGTTAGGGAGAGCTATGGCTACACCTTC	CASIPQVRESYGYTF	TRBV28	TRBJ1-2
TGTGCCACCAGTGATGTGGTTCAGCAGGTTCTCAGCAATCAGCCCCAGCATTTT	CATSDVVQQVLSNQPQHF	TRBV24-1	TRBJ1-5
TGCGCCAGCAGGGAGGCGAGGGGTAGGGAGCTGTTTTTT	CASREARGRELFF	TRBV10-1	TRBJ2-2
TGTGCCAGCAGTGAATACCGGGACACGGAAGAGACCCAGTACTTC	CASSEYRDTEETQYF	TRBV25-1	TRBJ2-5
TGTGCCACCAGCCATCGTTCCCGGGGGCGCGGTACTGAAGCTTTCTTT	CATSHRSRGRGTEAFF	TRBV15	TRBJ1-1
TGCGCCAGCAGCTTGGGAACAAGTCCCATCTATTTTTGCTCCTACGAGCAGTACTTC	CASSLGTSPIYFCSYEQYF	TRBV5-1	TRBJ2-7
TGCGCCAGCTGTGGCAGACAAAGTTCCTACGAGCAGTACTTC	CASCGRQSSYEQYF	TRBV10-1	TRBJ2-7
TGTGCCAGCAGCCAAAGCAGGGGTCGACGTTGGGTTGAGGGCACAGATACGCAGTATTTT	CASSQSRGRRWVEGTDTQYF	TRBV14	TRBJ2-3
TGTGCCAGCAGCCTGAAACGGGGGAGCTCCTACAATGAGCAGTTCTTC	CASSLKRGSSYNEQFF	TRBV13	TRBJ2-1
TGCAGTGCTAGAGCCCTCAACTCCAGGAGGGTTGAGGACACTGAAGCTTTCTTT	CSARALNSRRVEDTEAFF	TRBV20-1	TRBJ1-1
TGTGCCAGCTCACAACCACGGGCGTACTTC	CASSQPRAYF	TRBV18	TRBJ2-4
TGTGCCGGGGGATGGGAAGAGACCCAGTACTTC	CAGGWEETQYF	TRBV19	TRBJ2-5
TGTGCCAGCAGTTTTACCCGGACAGCCTACGAGCAGTACTTC	CASSFTRTAYEQYF	TRBV28	TRBJ2-7
TGTGCCAGCAGCTTAGGGACACCGACTAGCGGGGTCCGAAATGAGCAGTTCTTC	CASSLGTPTSGVRNEQFF	TRBV11-2	TRBJ2-1
TGTGCCAGCAGTCTGCCAGAGAACGAGCAGTACTTC	CASSLPENEQYF	TRBV28	TRBJ2-7
TGTGCCAGCAGCGACAGGGGGGAGACCCAGTACTTC	CASSDRGETQYF	TRBV11-3	TRBJ2-5
TGTGCCAGCAGTTTGTGCGGACAGTGTCAGCCCCAGCATTTT	CASSLCGQCQPQHF	TRBV12-4	TRBJ1-5
TGTGCCAGCAGCTTAACGGAGAGCACAGGGGTGGAGGACCAGAACACTGAAGCTTTCTTT	CASSLTESTGVEDQNTEAFF	TRBV7-9	TRBJ1-1
TGTGCCAGCAGTGAACTCCGGTCGACTAGTATCCATGAGCAGTTCTTC	CASSELRSTSIHEQFF	TRBV6-1	TRBJ2-1
TGTGCCAGCATAGCGGTCGATCAGCCCCAGCATTTT	CASIAVDQPQHF	TRBV7-3	TRBJ1-5
TGTGCCAGCAGCATGGGGGGCACAGCTTCCTACGAGCAGTACTTC	CASSMGGTASYEQYF	TRBV12-4	TRBJ2-7
TGCGCCAGCAGCTGCGGACAGGGTTGTATCGCTTTCTTT	CASSCGQGCIAFF	TRBV5-1	TRBJ1-1
TGCGCCAGCAGCGGACTAGCGAGATATTCCTACGAGCAGTACTTC	CASSGLARYSYEQYF	TRBV5-1	TRBJ2-7
TGTGCCAGCAGGAAGAAGACAGGGGAAGTCTCTAATTCACCCCTCCACTTT	CASRKKTGEVSNSPLHF	TRBV6-1	TRBJ1-6
TGTGCCAGCAGTGTCAAGGGCAGGGCCAGCGGGAGGAACACTGAAGCTTTCTTT	CASSVKGRASGRNTEAFF	TRBV25-1	TRBJ1-1
TGTGCCAGCAGCTGCCGCCTCCCCCCTAGCTACGAGCAGTACTTC	CASSCRLPPSYEQYF	TRBV7-2	TRBJ2-7
TGTGCCACCAACAGGGAATGGGGGTCGGACGAGCAGTACTTC	CATNREWGSDEQYF	TRBV24-1	TRBJ2-7
TGTGCCAGCAGTCCTCAGGGAAAGGGCTACACCTTC	CASSPQGKGYTF	TRBV6-1	TRBJ1-2
TGTGCCAGCAGCTTAGCGCTGTTCCTCAGAAGCACAGATACGCAGTATTTT	CASSLALFLRSTDTQYF	TRBV7-9	TRBJ2-3
TGTGCCAGTGATTTCCAAACAGGGGGCGTTCGAGATGAGCAGTTCTTC	CASDFQTGGVRDEQFF	TRBV28	TRBJ2-1
TGTGCCAGCATCCCACATAGGGAGACCCAGGGAGTGTGCACAGATACGCAGTATTTT	CASIPHRETQGVCTDTQYF	TRBV12-4	TRBJ2-3
TGTGCCAGCAGCGTAGTGGAGGCACTAGCCTCCTACGAGCAGTACTTC	CASSVVEALASYEQYF	TRBV9	TRBJ2-7
TGCAGTGCTAGTCGGGCAGAGGATGTCTCCTACGAGCAGTACTTC	CSASRAEDVSYEQYF	TRBV20-1	TRBJ2-7
TGTGCCAGCAGTTACCATTCCAGGACAGGGTCACCCCTCCACTTT	CASSYHSRTGSPLHF	TRBV6-5	TRBJ1-6
TGCAGTGCTAGATTCCGCCCGCAGGGCCGAAAAGATACGCAGTATTTT	CSARFRPQGRKDTQYF	TRBV20-1	TRBJ2-3
TGCGCCAGCAGATTGACCGCAGTCAACACTGAAGCTTTCTTT	CASRLTAVNTEAFF	TRBV10-1	TRBJ1-1
TGTGCCACCAGCAGAGGGTCCCACGGGACTGGGTACCGGTTCGGGGAGCTGTTTTTT	CATSRGSHGTGYRFGELFF	TRBV15	TRBJ2-2
TGTGCCAGCAGCTTGGCGGGACTCACAGATACGCAGTATTTT	CASSLAGLTDTQYF	TRBV7-9	TRBJ2-3
TGTGCCAGCAGTTACGGTGTCCCCTATAATGAAAAACTGTTTTTT	CASSYGVPYNEKLFF	TRBV6-5	TRBJ1-4
TGCAGTGCTAGAGATTCTGAGGGGACTCTGGAGACCCAGTACTTC	CSARDSEGTLETQYF	TRBV20-1	TRBJ2-5
TGTGCCAGCAGCTTCCGTGAACGGGTGGGCTATAATTCACCCCTCCACTTT	CASSFRERVGYNSPLHF	TRBV11-2	TRBJ1-6
TGTGCCAGCAGCAAAAGGCGGGACACGAATCAGCCCCAGCATTTT	CASSKRRDTNQPQHF	TRBV13	TRBJ1-5
TGTGCCAGCAGTTCTCACTCAGAGGGCTCCTATAATTCACCCCTCCACTTT	CASSSHSEGSYNSPLHF	TRBV6-5	TRBJ1-6
TGCGCCAGCAGCTACCCCCGGGGTTCGAGAGGAAAACTGTTTTTT	CASSYPRGSRGKLFF	TRBV5-1	TRBJ1-4
TGCGCCAGCAGCTTGCCCCCTTTATCTAGGGAAGATGAGCAGTTCTTC	CASSLPPLSREDEQFF	TRBV5-1	TRBJ2-1
TGTGCCACCCCGAACTCCAACATGGACAGGGGAATAGCAAACACCGGGGAGCTGTTTTTT	CATPNSNMDRGIANTGELFF	TRBV15	TRBJ2-2
TGTGCCAGCAGCCTGACAGGGGTGGGTTCACCCCTCCACTTT	CASSLTGVGSPLHF	TRBV6-6	TRBJ1-6
TGTGCCAGCAGTGGGCAAGGGGGAAGTTACGAGCAGTACTTC	CASSGQGGSYEQYF	TRBV28	TRBJ2-7
TGTGCCAGTAGTATAGATCCAACAGCCAGGGGCTACACCTTC	CASSIDPTARGYTF	TRBV19	TRBJ1-2
TGCGCCAGCATTCCAAGGGACAGGTCCTATGGCTACACCTTC	CASIPRDRSYGYTF	TRBV10-2	TRBJ1-2
TGTGCCAGCAGCCTAGTAGACAGGGATAATAGCAATCAGCCCCAGCATTTT	CASSLVDRDNSNQPQHF	TRBV7-9	TRBJ1-5
TGTGCCAGCAGCGGCAGGGGGGCACGTTATGGCTACACCTTC	CASSGRGARYGYTF	TRBV7-3	TRBJ1-2
TGTGCCACTACCCGAACCGGACAGGGCTATAGCAATCAGCCCCAGCATTTT	CATTRTGQGYSNQPQHF	TRBV10-3	TRBJ1-5
TGTGCCAGCAGCTCGGGCCGAACATCGCCCTCCTACGAGCAGTACTTC	CASSSGRTSPSYEQYF	TRBV11-3	TRBJ2-7
TGTGCCAGCAGCTTAGAGCCGGGACTAGCGGGTTCCTACGAGCAGTACTTC	CASSLEPGLAGSYEQYF	TRBV7-8	TRBJ2-7
TGTGCCACCAGCAGAGATGTGCAGCCCCCGGGGGATACGCAGTATTTT	CATSRDVQPPGDTQYF	TRBV15	TRBJ2-3
TGTGCCAGTAATCGGCTAGCGGGGCAGACCCAGTACTTC	CASNRLAGQTQYF	TRBV19	TRBJ2-5
TGTGCCAGCAGCCGAAGAAGGGGGCTGCCCCAGCATTTT	CASSRRRGLPQHF	TRBV5-4	TRBJ1-5
TGTGCCAGCAGTTACCCTTTCCAGGGGGCTTTCTTT	CASSYPFQGAFF	TRBV6-2	TRBJ1-1
TGTGCCAGTAGTATACAGGGGTGGGGGGTGAACACTGAAGCTTTCTTT	CASSIQGWGVNTEAFF	TRBV19	TRBJ1-1
TGCAGCGTTGGACGACTAGCCAGTCCGAACACCGGGGAGCTGTTTTTT	CSVGRLASPNTGELFF	TRBV29-1	TRBJ2-2
TGTGCCAGCAGTGTAGCTCAGCCCCAGCATTTT	CASSVAQPQHF	TRBV6-4	TRBJ1-5
TGTGCTAGTGGGGAAGACAAGGAGGATAGCAATCAGCCCCAGCATTTT	CASGEDKEDSNQPQHF	TRBV12-5	TRBJ1-5
TGCGCCAGCAGCTTGGCCCAGGGACGAGGGGGGAGAGGCACAGATACGCAGTATTTT	CASSLAQGRGGRGTDTQYF	TRBV5-1	TRBJ2-3
TGTGCCAGATGGCAAGAAGAGACCCAGTACTTC	CARWQEETQYF	TRBV25-1	TRBJ2-5
TGTGCCATCAGTAAGCGGGAGAATTTAAACTTC	CAISKRENLNF	TRBV10-3	TRBJ2-7
TGTGCCAGCAGTTGGGACCCTAACTATGGCTACACCTTC	CASSWDPNYGYTF	TRBV28	TRBJ1-2
TGTGCCAGCAGCCGTTCGGGACTAGCGGGTCACCCCGGGGTAGTCTGGGTGTGTAGCACAGATACGCAGTATTTT	CASSRSGLAGHPGVVWVCSTDTQYF	TRBV7-9	TRBJ2-3
TGCGCCAGCAGCTTGACTCGAGCTTCGGACGAGCAGTACTTC	CASSLTRASDEQYF	TRBV5-1	TRBJ2-7
TGTGCCAGCAGCCAGGGGGAAACAGGACGTGAAAAACTGTTTTTT	CASSQGETGREKLFF	TRBV5-6	TRBJ1-4
TGCGCCAGCAGTGAAAAGGGCCAAGGCGAAGCTTTCTTT	CASSEKGQGEAFF	TRBV10-1	TRBJ1-1
TGTGCCAGCAGCGCCTGGTTGACAGTATTAGGCAATCAGCCCCAGCATTTT	CASSAWLTVLGNQPQHF	TRBV7-2	TRBJ1-5
TGTGCCACCAGGTCACAGGAACAATTCTACGAGCAGTACTTC	CATRSQEQFYEQYF	TRBV15	TRBJ2-7
TGTGCCAGCAGCCGTCCCAGGGGGGGTGGGAGTGCTTTCTTT	CASSRPRGGGSAFF	TRBV5-5	TRBJ1-1
TGTGCCAGCAGCGGAAGCAGGGGGAAAGGAAGAGGACGGACCTACGAGCAGTACTTC	CASSGSRGKGRGRTYEQYF	TRBV13	TRBJ2-7
TGTGCCAGCAGCGATTGGAACGGTCTTAGGCCTCGCGAGCAGTACTTC	CASSDWNGLRPREQYF	TRBV25-1	TRBJ2-7
TGCAGTGCCGACTGCAGGGCCGAGACCCAGTACTTC	CSADCRAETQYF	TRBV20-1	TRBJ2-5
TGTGCCAGCAGCACCACCAACTCACCCGGGACAGGAGGGCCCTACGAGCAGTACTTC	CASSTTNSPGTGGPYEQYF	TRBV5-6	TRBJ2-7
TGTGCCAGCAGCCTGCAGGGCGGGGCTATGGGACCCGGGGAGCTGTTTTTT	CASSLQGGAMGPGELFF	TRBV3-1	TRBJ2-2
TGTGCCAGCAGCCGCATAAAGACCCACGAGCAGTACTTC	CASSRIKTHEQYF	TRBV7-3	TRBJ2-7
TGTGCCAGCAGTGAACCCGGACTAGCGGGTCGGACAGATACGCAGTATTTT	CASSEPGLAGRTDTQYF	TRBV25-1	TRBJ2-3
TGTGCCAGCAGCTTAACGCCTTCAGGGCGACGAAGGGGCTACGAGCAGTACTTC	CASSLTPSGRRRGYEQYF	TRBV7-3	TRBJ2-7
TGTGCCACCAGTGATTTGGGTACCGAGGGGGAATCTGGGGCCAACGTCCTGACTTTC	CATSDLGTEGESGANVLTF	TRBV24-1	TRBJ2-6
TGCAGTGCTCGCTGGGAGGACCGTGAGAGCTCTGGAAACACCATATATTTT	CSARWEDRESSGNTIYF	TRBV20-1	TRBJ1-3
TGTGCCAGCAGATGGGGGGAGGTAAATGAGCAGTTCTTC	CASRWGEVNEQFF	TRBV6-8	TRBJ2-1
TGTGCCAGCAGCTGGATGCTTCCGAGCGCCTACGAGCAGTACTTC	CASSWMLPSAYEQYF	TRBV5-5	TRBJ2-7
TGCGCCAGCACCCTCAGGGCGGGGCACATGAACACTGAAGCTTTCTTT	CASTLRAGHMNTEAFF	TRBV5-1	TRBJ1-1
TGTGCCACCAGTGATCCCAGAGCCGGGACAGGGGGATTTCAGCCCCAGCATTTT	CATSDPRAGTGGFQPQHF	TRBV24-1	TRBJ1-5
TGTGCCAGCAGTTACCAGGACAGGGGGATGGTCCGGTCGTCTAGCACAGATACGCAGTATTTT	CASSYQDRGMVRSSSTDTQYF	TRBV6-5	TRBJ2-3
TGTGCCAGCAGCCCTACAGGGAAAAGATCTTTGAGATCCTACGAGCAGTACTTC	CASSPTGKRSLRSYEQYF	TRBV7-3	TRBJ2-7
TGTGCCAGCAGCCAAACAGGGCTCTTAGTTTCACCCCTCCACTTT	CASSQTGLLVSPLHF	TRBV4-2	TRBJ1-6
TGTGCCAGCAGGACAGGGATGAACACTGAAGCTTTCTTT	CASRTGMNTEAFF	TRBV6-1	TRBJ1-1
TGTGCCAGCAGCTTGCTAAGGGGGCGCGGGAATGATAGGGGGTTGACTGGAAACACCATATATTTT	CASSLLRGRGNDRGLTGNTIYF	TRBV5-4	TRBJ1-3
TGTGCCAGCAGCCTCCCATTGACATCTAATGGCTACACCTTC	CASSLPLTSNGYTF	TRBV9	TRBJ1-2
TGTGCCACCAGCAGGGCTTACAGGGGCTACGAGCAGTACTTC	CATSRAYRGYEQYF	TRBV15	TRBJ2-7
TGTGCCACACAGGACCGTAGCCCTTCACCCCTCCACTTT	CATQDRSPSPLHF	TRBV6-5	TRBJ1-6
TGTGCCAGCAGCGCCGGGACAGGGAAAAGCAACTATGGCTACACCTTC	CASSAGTGKSNYGYTF	TRBV13	TRBJ1-2
TGCAGTGCTAGATTCTTCTCCTACGAGCAGTACTTC	CSARFFSYEQYF	TRBV20-1	TRBJ2-7
TGTGCCACCAGTGATTTCCGCCGGGGATGGAGTCCGGTCGGCACAGATACGCAGTATTTT	CATSDFRRGWSPVGTDTQYF	TRBV24-1	TRBJ2-3
TGTGCCAGCAGCCATAAAGAGACCCAGTACTTC	CASSHKETQYF	TRBV13	TRBJ2-5
TGTGCCAGCAGCCAAGATATACAACTAGGCTACACCTTC	CASSQDIQLGYTF	TRBV3-1	TRBJ1-2
TGTGCCAGCAGTCCGGACAGGGGCGTCTCAGAGACCCAGTACTTC	CASSPDRGVSETQYF	TRBV6-3	TRBJ2-5
TGTGCCAGCAGCTCTATTGAGGAGAGAGGGGAGCACGAGCAGTACTTC	CASSSIEERGEHEQYF	TRBV5-4	TRBJ2-7
TGTGCCATCAGACTAGCGGGGGCTTTTGAGACCCAGTACTTC	CAIRLAGAFETQYF	TRBV10-3	TRBJ2-5
TGTGCCAGCACCGTACAGGTATGGAATGAGCAGTTCTTC	CASTVQVWNEQFF	TRBV12-3	TRBJ2-1
TGTGCCACCAGTGATAGTGGGACAGGGTACAATGAGCAGTTCTTC	CATSDSGTGYNEQFF	TRBV24-1	TRBJ2-1
TGTGCCAGCAAAGCCAAACCCTTAGGGAGGGGCTGCAATCAGCCCCAGCATTTT	CASKAKPLGRGCNQPQHF	TRBV25-1	TRBJ1-5
TGTGCCACCAGTGACCGGCCTTTGGGAGGGCAAGCCCAGAACGAGCAGTACTTC	CATSDRPLGGQAQNEQYF	TRBV24-1	TRBJ2-7
TGTGCCCCCGGACTAGGCGGTAAAGAGACCCAGTACTTC	CAPGLGGKETQYF	TRBV10-3	TRBJ2-5
TGTGCCAGCAGTGAAGCTACCCCCTCCGGGACTAGCGGAAAGACCCAGTACTTC	CASSEATPSGTSGKTQYF	TRBV6-1	TRBJ2-5
TGCAGCGTTGCCGCTGGATATAGCAAATGGGGGACAGGGGGAGCTTTCTTT	CSVAAGYSKWGTGGAFF	TRBV29-1	TRBJ1-1
TGTGCCAGCAGCTTGTTTCGGACACTCCAGCCCCAGCATTTT	CASSLFRTLQPQHF	TRBV5-4	TRBJ1-5
TGCAGCGTTGAAACGACAGGGGGCCACGCCTACGAGCAGTACTTC	CSVETTGGHAYEQYF	TRBV29-1	TRBJ2-7
TGTGCCAGCAGTTTTGCTAGCGGGGGGGCCTCTAAGGATAACACCGGGGAGCTGTTTTTT	CASSFASGGASKDNTGELFF	TRBV6-3	TRBJ2-2
TGTGCCAGCTCACCGGGACATTCCTACGAGCAGTACTTC	CASSPGHSYEQYF	TRBV18	TRBJ2-7
TGTGCCAGCAGCTGTCCAAATAGAGTGACTAGCGGGAGGGCCCACACTGAAGCTTTCTTT	CASSCPNRVTSGRAHTEAFF	TRBV13	TRBJ1-1
TGCAGTGCTAGGACTTTCCGGACAGGGGGGCGTAATCAGCCCCAGCATTTT	CSARTFRTGGRNQPQHF	TRBV20-1	TRBJ1-5
TGTGCCAGCAGCTTAAAGTCCAGGACAGGACAGGGCAATTGGAGAGCCTACGAGCAGTACTTC	CASSLKSRTGQGNWRAYEQYF	TRBV7-3	TRBJ2-7
TGTGCCAGCAGCTTGATTAGGGAGGGGTACACCTTC	CASSLIREGYTF	TRBV5-6	TRBJ1-2
TGCGCCAGCAGCTTCCACTCGGGACAGGGGGCCGCGACTAACTATGGCTACACCTTC	CASSFHSGQGAATNYGYTF	TRBV5-1	TRBJ1-2
TGCGCCAGCAGCTTGGGTCCCAGGGGGCGATTGAACACTGAAGCTTTCTTT	CASSLGPRGRLNTEAFF	TRBV5-1	TRBJ1-1
TGTGCCAGCAGCCAGGGAAACACCATATATTTT	CASSQGNTIYF	TRBV5-6	TRBJ1-3
TGCGCCAGCAGCTTGGGTCAAGGGCCGCTCATGAACACTGAAGCTTTCTTT	CASSLGQGPLMNTEAFF	TRBV5-1	TRBJ1-1
TGTGCCAGCAACAAGGGGGGGTGTGGATATGAGCAGTTCTTC	CASNKGGCGYEQFF	TRBV6-8	TRBJ2-1
TGTGCCACCCATAAGGGACCCGTAAACAATGAGCAGTTCTTC	CATHKGPVNNEQFF	TRBV6-1	TRBJ2-1
TGTGCCAGCAGCTTTGACCCAGGAACCTACGAGCAGTACTTC	CASSFDPGTYEQYF	TRBV7-9	TRBJ2-7
TGTGCCGATTGGGCCCACACCTACGAGCAGTACTTC	CADWAHTYEQYF	TRBV7-9	TRBJ2-7
TGTGCCAGCAGCAGGCAGGAGGCCTGGCGCACAGATACGCAGTATTTT	CASSRQEAWRTDTQYF	TRBV7-6	TRBJ2-3
TGTGCCAGTCCGACTCACTCTGGGGCCAACGTCCTGACTTTC	CASPTHSGANVLTF	TRBV9	TRBJ2-6
TGTGCCAGCAGTGATGCTAGCGGGACGGGGAACACCGGGGAGCTGTTTTTT	CASSDASGTGNTGELFF	TRBV25-1	TRBJ2-2
TGTGCCAGCAGCTTAGCCGACAAAGTGAACACTGAAGCTTTCTTT	CASSLADKVNTEAFF	TRBV11-3	TRBJ1-1
TGTGCCAGGCGCCGACAGGCGTACCAAGAGACCCAGTACTTC	CARRRQAYQETQYF	TRBV27	TRBJ2-5
TGTGCCAGTAGTATGGACGGCTATGGCTACACCTTC	CASSMDGYGYTF	TRBV19	TRBJ1-2
TGCGCCAGCAGCTTGGCCCGGGTCCGCGGGAATGAGCAGTTCTTC	CASSLARVRGNEQFF	TRBV5-1	TRBJ2-1
TGTGCCAGCAGTTACCGGGACGGCTACACAGATACGCAGTATTTT	CASSYRDGYTDTQYF	TRBV13	TRBJ2-3
TGTGCCAGCGGGGGTACGTCCTACGAGCAGTACTTC	CASGGTSYEQYF	TRBV12-3	TRBJ2-7
TGTGCCACCAGCCCGGGACATACGCAGTATTTT	CATSPGHTQYF	TRBV15	TRBJ2-3
TGTGCCAGCAGTTTCACCAGCTCAGGGCCCCTGCCCCAGCATTTT	CASSFTSSGPLPQHF	TRBV6-5	TRBJ1-5
TGCAGTGCTAGAGATCGAATAGCGCAAGAGACCCAGTACTTC	CSARDRIAQETQYF	TRBV20-1	TRBJ2-5
TGTGCCAGCAGCACTCGCGGTAGCTGGGAGGCTGACGAGCAGTACTTC	CASSTRGSWEADEQYF	TRBV7-9	TRBJ2-7
TGCGCCAGCAGTGATCCAGCGGTCTCCGGGGTTTGGGAGACCCAGTACTTC	CASSDPAVSGVWETQYF	TRBV10-1	TRBJ2-5
TGTGCCAGCAGCCAAGAAGTCCGGCGGGCTAGCACAGATACGCAGTATTTT	CASSQEVRRASTDTQYF	TRBV3-1	TRBJ2-3
TGTGCCAAATCAAAGAGAGGGAGCTGGGGCGGAACAGAGGCGGATAGCAATCAGCCCCAGCATTTT	CAKSKRGSWGGTEADSNQPQHF	TRBV6-4	TRBJ1-5
TGCGCCAGCAGTGAGCATTCCCGCTCCAGAGAAACATCACCCCTCCACTTT	CASSEHSRSRETSPLHF	TRBV10-2	TRBJ1-6
TGTGCCAGCTCAGATGAGGGGGCCCGGCCCCACACCGGGGAGCTGTTTTTT	CASSDEGARPHTGELFF	TRBV18	TRBJ2-2
TGTGCCAGCAGGCGACTGGGACAGGGGAGGCCCTCCTACGAGCAGTACTTC	CASRRLGQGRPSYEQYF	TRBV6-1	TRBJ2-7
TGTGCCACCAGAGAACCGGGGGGGGATGAGGAGACCCAGTACTTC	CATREPGGDEETQYF	TRBV24-1	TRBJ2-5
TGCGCCAGCAGCCCCCCGGGAGAGATAGTCTTC	CASSPPGEIVF	TRBV5-1	TRBJ2-1
TGTGCCAGCAGTTACAACACGGGGGGGCGGGTCCAAGAGACCCAGTACTTC	CASSYNTGGRVQETQYF	TRBV6-2	TRBJ2-5
TGTGCCAGCACTGGGAGGGGCCTAAGTAATGAAAAACTGTTTTTT	CASTGRGLSNEKLFF	TRBV6-4	TRBJ1-4
TGTGCCAGCAGCCAAGTTCAGGTCGGGCCGGGCTACAATGAGCAGTTCTTC	CASSQVQVGPGYNEQFF	TRBV14	TRBJ2-1
TGTGCCTGGAGTGTAAGACCGGGACTAGCGGGAGATTGGAAAACTGAAGCTTTCTTT	CAWSVRPGLAGDWKTEAFF	TRBV30	TRBJ1-1
TGTGCCAGCAGCGGCGGCGGACGGGTCTACGAGCAGTACTTC	CASSGGGRVYEQYF	TRBV7-4	TRBJ2-7
TGTGCCAGCAGTTCCATCTCCTACGAGCAGTACTTC	CASSSISYEQYF	TRBV28	TRBJ2-7
TGCAGTGCTACCGGGAGGCGGGATCTACACACTGAAGCTTTCTTT	CSATGRRDLHTEAFF	TRBV20-1	TRBJ1-1
TGTGCCACCAGCAGAGAGAGGCCCCCTCGAAAGCCCTACGAGCAGTACTTC	CATSRERPPRKPYEQYF	TRBV15	TRBJ2-7
TGTGCCAGCACCCCTAGTTTAGATACGCAGTATTTT	CASTPSLDTQYF	TRBV6-4	TRBJ2-3
TGTGCCAGGCCGGGACAGGGTCTCTTC	CARPGQGLF	TRBV5-6	TRBJ2-1
TGTGCCAGCATAGCGGACATTCCAGCTGTCCAAGAGACCCAGTACTTC	CASIADIPAVQETQYF	TRBV6-5	TRBJ2-5
TGCGCCAGCAGCCAAGAAGGAGGGGATTTGAACACTGAAGCTTTCTTT	CASSQEGGDLNTEAFF	TRBV4-1	TRBJ1-1
TGTGCCAGCAGCTTAGTAGGACACCCCGACGAGCAGTACTTC	CASSLVGHPDEQYF	TRBV5-6	TRBJ2-7
TGTGCCAGCAGCAGACACAGTCCCCGCGGGGGGGGGGAGCCAACTAATGAAAAACTGTTTTTT	CASSRHSPRGGGEPTNEKLFF	TRBV11-2	TRBJ1-4
TGTGCCAGCAGTCGGGACGGATACGAGCAGTACTTC	CASSRDGYEQYF	TRBV6-1	TRBJ2-7
TGTGCCAGCAGTGAACTCCCGGACACTGAAGCTTTCTTT	CASSELPDTEAFF	TRBV2	TRBJ1-1
TGTGCCAGCAGCTCCGAAAACCTGAGCGGGATCCCTGAAGCTTTCTTT	CASSSENLSGIPEAFF	TRBV7-7	TRBJ1-1
TGCGCCAGCAGCCGGTTTAGAAGCGGGAGAGGCGAACAGCCCCAGCATTTT	CASSRFRSGRGEQPQHF	TRBV5-1	TRBJ1-5
TGCGCCAGCAGCTTGGAAACGGGTAATGAGCAGTTCTTC	CASSLETGNEQFF	TRBV5-1	TRBJ2-1
TGTGCCTGGAAAGGGGGGCCGAGAAGGGATACGCAGTATTTT	CAWKGGPRRDTQYF	TRBV30	TRBJ2-3
TGTGCCAGCAGGAACCCCGAGTCGGCCGGCTACACCTTC	CASRNPESAGYTF	TRBV6-5	TRBJ1-2
TGCGCCAGCAGAGGTCTGGGCACTGAAGCTTTCTTT	CASRGLGTEAFF	TRBV10-1	TRBJ1-1
TGTGCCAGCAGCTGGGGGGGCGCATCAGTTAGAGATGAGCAGTTCTTC	CASSWGGASVRDEQFF	TRBV5-6	TRBJ2-1
TGTGCCAGCAGTTACCTTTTCACCAGAGAGACCCAGTACTTC	CASSYLFTRETQYF	TRBV6-5	TRBJ2-5
TGCGCCAGCAGCTTAACCCTCTCGGTAATAAACTATGGCTACACCTTC	CASSLTLSVINYGYTF	TRBV5-1	TRBJ1-2
TGTGCCAGCAGTGACTCCATTGGCCAACGGACTGAAGCTTTCTTT	CASSDSIGQRTEAFF	TRBV6-4	TRBJ1-1
TGTGCCTGGAGTGCGACTCAGACCCAAGATGAGCAGTTCTTC	CAWSATQTQDEQFF	TRBV30	TRBJ2-1
TGTGCCACCAGCAGAGATACTAGTTGGAGGGCAAGGAGCTGGACCCAGAGATCCTACGAGCAGTACTTC	CATSRDTSWRARSWTQRSYEQYF	TRBV15	TRBJ2-7
TGTGCCAGCAGCTGGAGGGGTGCCAAAAACATTCAGTACTTC	CASSWRGAKNIQYF	TRBV7-2	TRBJ2-4
TGTGCCAGCAGCTTAGTCCAATGGACGTGGGGGGGTATGCCTGGGTACGAGCAGTACTTC	CASSLVQWTWGGMPGYEQYF	TRBV11-2	TRBJ2-7
TGCGCCAGCAGTGAGTCCCTGTGGAGCCGACCAGGGGAACGGAATAATGAAAAACTGTTTTTT	CASSESLWSRPGERNNEKLFF	TRBV10-1	TRBJ1-4
TGTGCCAGCAGCTTTTGCTTCATTTCACCCCTCCACTTT	CASSFCFISPLHF	TRBV5-4	TRBJ1-6
TGTGCCAGCAGCGTCTGGGACGGTTGGGGGGCGAACACCGGGGAGCTGTTTTTT	CASSVWDGWGANTGELFF	TRBV13	TRBJ2-2
TGTGCCAGCAGTGCGCCCCCGTTAGTCAGGGAAGTGTCTTCGGCCTCTGGGGCCAACGTCCTGACTTTC	CASSAPPLVREVSSASGANVLTF	TRBV6-2	TRBJ2-6
TGTGCCAGCAGCGATAGGAACACTGAAGCTTTCTTT	CASSDRNTEAFF	TRBV13	TRBJ1-1
TGTGCCAGCAGCTTGATCTACGAGCAGTACTTC	CASSLIYEQYF	TRBV13	TRBJ2-7
TGTGCCAGCAGCACAACGGCACGACAGGCTAAAAAGAGGGACACCGGGGAGCTGTTTTTT	CASSTTARQAKKRDTGELFF	TRBV11-2	TRBJ2-2
TGTGCCAGCAGACGGACGGGAGAGACCCAGTACTTC	CASRRTGETQYF	TRBV6-2	TRBJ2-5
TGTGCTCGGCCGAGAGGTCAGCCCCAGCATTTT	CARPRGQPQHF	TRBV7-2	TRBJ1-5
TGTGCCACTAGCGGGTGTCGGCCGGAATCCAATGAGCAGTTCTTC	CATSGCRPESNEQFF	TRBV5-4	TRBJ2-1
TGTGCCAGCAGCTTAGCGAGGACAGGACCGGGCCTTATGAACACTGAAGCTTTCTTT	CASSLARTGPGLMNTEAFF	TRBV7-9	TRBJ1-1
TGTGCCAGCAGCGTGGGGCGGTACGATCAGCCCCAGCATTTT	CASSVGRYDQPQHF	TRBV9	TRBJ1-5
TGTGCCAGCAGCGGGTCACGGGACAGGGCCCGTAGCAATCAGCCCCAGCATTTT	CASSGSRDRARSNQPQHF	TRBV6-5	TRBJ1-5
TGTGCCAGCATATACGGAGTCGCCGGCTCCTACGAGCAGTACTTC	CASIYGVAGSYEQYF	TRBV7-3	TRBJ2-7
TGTGCCAGCAGTTCGAAAAGAACACACTGGGAGACCCAGTACTTC	CASSSKRTHWETQYF	TRBV2	TRBJ2-5
TGTGCCAGCATCCGGCGTACCTACGAGCAGTACTTC	CASIRRTYEQYF	TRBV7-9	TRBJ2-7
TGTGCCAGCAGCAACTCCGTTCGTGGGACTAGCGGGAGGGCAGATAACGAGCAGTACTTC	CASSNSVRGTSGRADNEQYF	TRBV7-3	TRBJ2-7
TGTGCCAGCAGTTTAAGAGGGGGGGACTTTCCTTGGGAGACCCAGTACTTC	CASSLRGGDFPWETQYF	TRBV27	TRBJ2-5
TGTGCCATTCAAACGGGCAGGGGGAACGAGCAGTACTTC	CAIQTGRGNEQYF	TRBV6-5	TRBJ2-7
TGTGCCAGCAGCGCCCGGGACAGGGGCAGACTAGCCAAAAACATTCAGTACTTC	CASSARDRGRLAKNIQYF	TRBV13	TRBJ2-4
TGTGCCAGCAGCGAGCAACCCTTGGAGGGACAGGGAAGCAATCAGCCCCAGCATTTT	CASSEQPLEGQGSNQPQHF	TRBV5-8	TRBJ1-5
TGTGCCAGCAGCCAAGGTCCCCCCCCGAGGGTTGACTCTGGAAACACCATATATTTT	CASSQGPPPRVDSGNTIYF	TRBV4-2	TRBJ1-3
TGTGCCAGCAGTTACTCGAGCGAGGGGTGGGTGACAGATACGCAGTATTTT	CASSYSSEGWVTDTQYF	TRBV6-6	TRBJ2-3
TGCGCCAGCACTCGGTACATTCGGACTAGATTGGCTTACAATGAGCAGTTCTTC	CASTRYIRTRLAYNEQFF	TRBV5-1	TRBJ2-1
TGTGCCAGCAGCCTGAGGACGGTCGAGGTTGAGCAGTTCTTC	CASSLRTVEVEQFF	TRBV4-2	TRBJ2-1
TGTGCCAGCAGCCCCTGGACAGGGGGCTTGACGAACACTGAAGCTTTCTTT	CASSPWTGGLTNTEAFF	TRBV9	TRBJ1-1
TGTGCCAGCAGCTTAGCCCAAGGGTCGGCCGAAAAACTGTTTTTT	CASSLAQGSAEKLFF	TRBV7-8	TRBJ1-4
TGTGCCAGCAGCACAGGGGGCTACGAGCAGTACTTC	CASSTGGYEQYF	TRBV7-6	TRBJ2-7
TGTGCCACAGACGATAAGCAGAAATATCATTATGGCTACACCTTC	CATDDKQKYHYGYTF	TRBV24-1	TRBJ1-2
TGCGCCATCCCAGAAAGAAACACCATATATTTT	CAIPERNTIYF	TRBV10-1	TRBJ1-3
TGTGCCACCAGTGATTCGAGAGAGTATGGCTACACCTTC	CATSDSREYGYTF	TRBV24-1	TRBJ1-2
TGTGCCACCAGTAACCGGGAGGGGGGGTACTCCTACGAGCAGTACTTC	CATSNREGGYSYEQYF	TRBV24-1	TRBJ2-7
TGTGCCAGCAGCGTCTTACTAGCGGGAGTTAGGGGGTACGAGCAGTACTTC	CASSVLLAGVRGYEQYF	TRBV9	TRBJ2-7
TGTGCCACCAAATATAGGCCGGGACACTATGGCAACACCATATATTTT	CATKYRPGHYGNTIYF	TRBV24-1	TRBJ1-3
TGTGCCATCATCCCAACAGGGCGTAGCAATCAGCCCCAGCATTTT	CAIIPTGRSNQPQHF	TRBV10-3	TRBJ1-5
TGCAGTGCTCAATTCAGGGGAAAACCAACTAATGAAAAACTGTTTTTT	CSAQFRGKPTNEKLFF	TRBV20-1	TRBJ1-4
TGCGCCGGGCCGGGACAGGGAACTGAAGCTTTCTTT	CAGPGQGTEAFF	TRBV10-1	TRBJ1-1
TGTGCCAGCAGACAAGGGGTGTCCTACGAGCAGTACTTC	CASRQGVSYEQYF	TRBV2	TRBJ2-7
TGTGCCACCAGTGACCCAATAGCGGGCGGGACAGATACGCAGTATTTT	CATSDPIAGGTDTQYF	TRBV24-1	TRBJ2-3
TGTGCCAGCACGCCGGGACAGGGGGCACGGGCCAACGTCCTGACTTTC	CASTPGQGARANVLTF	TRBV6-4	TRBJ2-6
TGTGCCAGCAGTGGTCCCGTGGCTGAAGCTTTCTTT	CASSGPVAEAFF	TRBV25-1	TRBJ1-1
TGTGCCAGCAGTTTGGGTTCCCATGGGGCCAACGTCCTGACTTTC	CASSLGSHGANVLTF	TRBV28	TRBJ2-6
TGTGCCAGCAGCCATTCCGACAGGGGGCCCCGAATCACTGAAGCTTTCTTT	CASSHSDRGPRITEAFF	TRBV3-1	TRBJ1-1
TGCGCCAGCAGTGGAAACAGGGATAAGTATGGCTACACCTTC	CASSGNRDKYGYTF	TRBV10-1	TRBJ1-2
TGTGCTAGTGGCCAACGCTCTACCTACGAGCAGTACTTC	CASGQRSTYEQYF	TRBV12-5	TRBJ2-7
TGCGCCAGCAGCTTCGACCCTAGCGGGACAACCGACATCGAGCAGTACTTC	CASSFDPSGTTDIEQYF	TRBV5-1	TRBJ2-7
TGTGCCAGCAGTTTAACCAGCCGGGGGCTTACTGGGGCCAACGTCCTGACTTTC	CASSLTSRGLTGANVLTF	TRBV28	TRBJ2-6
TGTGCCAGCAGCGTTGTCGTCATAGGAAACACAGATACGCAGTATTTT	CASSVVVIGNTDTQYF	TRBV9	TRBJ2-3
TGTGCCAGCAGCCGGGACAGGGTCGCAACTAATGAAAAACTGTTTTTT	CASSRDRVATNEKLFF	TRBV6-5	TRBJ1-4
TGTGCCAGCAGCCCTTTACAGGGGAAAAGCGATAACGAAAAACTGTTTTTT	CASSPLQGKSDNEKLFF	TRBV5-6	TRBJ1-4
TGTGCCAGCAGCTTGGTGGTAGGGGGCGGGCACACTGAAGCTTTCTTT	CASSLVVGGGHTEAFF	TRBV5-5	TRBJ1-1
TGTGCCAGCAGCTGCCCGGGACAAGAGTCCGGGGAGCTGTTTTTT	CASSCPGQESGELFF	TRBV7-3	TRBJ2-2
TGTGCCAGCAGCCAAGAGCACCCCGGGGAGCTGTTTTTT	CASSQEHPGELFF	TRBV14	TRBJ2-2
TGTGCCAGCAGTGAATGGACAGGGGGACCGGCCTTC	CASSEWTGGPAF	TRBV6-5	TRBJ1-2
TGTGCCAGCAGTTTATCGCCGACCTCAGGGGACCATGAAAAACTGTTTTTT	CASSLSPTSGDHEKLFF	TRBV27	TRBJ1-4
TGTGCCAGCAGTTCTACGGAATCGAACACTGAAGCTTTCTTT	CASSSTESNTEAFF	TRBV6-9	TRBJ1-1
TGTGCCACCAGTGTACCCGGACGGATACTAAACAATGAGCAGTTCTTC	CATSVPGRILNNEQFF	TRBV24-1	TRBJ2-1
TGTGCCAGGCGGGAGGGGGAGACCCAGTACTTC	CARREGETQYF	TRBV19	TRBJ2-5
TGCGCCAGCAGTCGGGTGGACCTCCACGAGCAGTACTTC	CASSRVDLHEQYF	TRBV10-1	TRBJ2-7
TGTGCCAGCATGCTAACAGGTTGCATCACTGAAGCTTTCTTT	CASMLTGCITEAFF	TRBV6-2	TRBJ1-1
TGCGCCAGCAGTGAACCTAAGGGCGGGGAGCTGTTTTTT	CASSEPKGGELFF	TRBV10-1	TRBJ2-2
TGCAGTGCTAGAGGTGGAGGGGGGCGTGGTACCGGGAGGAGCGAGCAGTTCTTC	CSARGGGGRGTGRSEQFF	TRBV20-1	TRBJ2-1
TGCAGTCAACGCCCCGGGACAGAAAAACTGTTTTTT	CSQRPGTEKLFF	TRBV20-1	TRBJ1-4
TGTGCCACCAGTGATTTGCCCCGTAAAGAGACCCAGTACTTC	CATSDLPRKETQYF	TRBV24-1	TRBJ2-5
TGTGCCAGCAGCGGGAGGGATCAGCCCCAGCATTTT	CASSGRDQPQHF	TRBV7-3	TRBJ1-5
TGTGCCAGCAGCACCACACGGAATGAAAAACTGTTTTTT	CASSTTRNEKLFF	TRBV7-3	TRBJ1-4
TGCGCCAGCAGCCAAGATTCAAGGGGGGGCCCCTTTCGGCGCTACAATGAGCAGTTCTTC	CASSQDSRGGPFRRYNEQFF	TRBV4-1	TRBJ2-1
TGTGCCAGAACATTTTCACCCCTCCACTTT	CARTFSPLHF	TRBV2	TRBJ1-6
TGTGCCAGCAGCCGACAGGGGAACACTGAAGCTTTCTTT	CASSRQGNTEAFF	TRBV11-2	TRBJ1-1
TGTGCCAGCAGCCCGAGCGGGGACAGGGAGGGGCCCTACGAGCAGTACTTC	CASSPSGDREGPYEQYF	TRBV7-3	TRBJ2-7
TGTGCCAGCAGGGGGAAAAGCTACGAGCAGTACTTC	CASRGKSYEQYF	TRBV27	TRBJ2-7
TGTGCCACCAGTGATTTCCAGGGGCGGAATGAGCAGTTCTTC	CATSDFQGRNEQFF	TRBV24-1	TRBJ2-1
TGTGCCACCCGAGGGCCCAGCTCCTATAATTCACCCCTCCACTTT	CATRGPSSYNSPLHF	TRBV24-1	TRBJ1-6
TGTGCCCCGAAAGGGGTACAGCCCCAGCATTTT	CAPKGVQPQHF	TRBV28	TRBJ1-5
TGTGCTAGTGGTTTCGCGAGGCGAAATGAGCAGTTCTTC	CASGFARRNEQFF	TRBV12-5	TRBJ2-1
TGTGCCAGCAGCGGCCACCTAAACACAGATACGCAGTATTTT	CASSGHLNTDTQYF	TRBV7-3	TRBJ2-3
TGTGCCAGCAGCTTAGGATTTACAGGTGAAGCTTTCTTT	CASSLGFTGEAFF	TRBV11-3	TRBJ1-1
TGCAGTGCTAGAGGGAGGCAGCCCCAGCATTTT	CSARGRQPQHF	TRBV20-1	TRBJ1-5
TGTGCCAGCAGCCGACTAGAGGAAGCCAAAAACATTCAGTACTTC	CASSRLEEAKNIQYF	TRBV7-3	TRBJ2-4
TGCGCCAGCAGCTTGATACAGGGGTCCGACTATGGCTACACCTTC	CASSLIQGSDYGYTF	TRBV5-1	TRBJ1-2
TGCAGCGCCCTCAAAGAGGAATATAGCAATCAGCCCCAGCATTTT	CSALKEEYSNQPQHF	TRBV29-1	TRBJ1-5
TGCGCCAGCAGTGAACCAGGGCTGAATGAGCAGTTCTTC	CASSEPGLNEQFF	TRBV10-1	TRBJ2-1
TGCGCCAGCAGCTTGGCGGGACAGGGGGGACATGAAAAACTGTTTTTT	CASSLAGQGGHEKLFF	TRBV5-1	TRBJ1-4
TGTGCCAGCAGCGGACTAGCGGCCTTGGTTGAGCAGTTCTTC	CASSGLAALVEQFF	TRBV9	TRBJ2-1
TGTGCCAGCTCACACCGGGACAGGGATAACACTCGGGTCTACGAGCAGTACTTC	CASSHRDRDNTRVYEQYF	TRBV18	TRBJ2-7
TGCGCCAGCAGCCAAGGGGGGTCCGGGGGGTCGGGGCAAGAGACCCAGTACTTC	CASSQGGSGGSGQETQYF	TRBV4-3	TRBJ2-5
TGTGCCAGCAGCTTAGCGGGTCTACAGGCGGGGGGAAACACCATATATTTT	CASSLAGLQAGGNTIYF	TRBV7-4	TRBJ1-3
TGTGCCAGCAGCAGACAACTAGCGGGAGCGGCAGATACGCAGTATTTT	CASSRQLAGAADTQYF	TRBV7-2	TRBJ2-3
TGTGCCAGCAGTAGGACTGAAGCTTTCTTT	CASSRTEAFF	TRBV6-5	TRBJ1-1
TGCAGTGCCCGGAGGCGTGGGCAGTACTTC	CSARRRGQYF	TRBV20-1	TRBJ2-4
TGTGCCAGCAGTTCCCTGCAGCCCCAGCATTTT	CASSSLQPQHF	TRBV28	TRBJ1-5
TGCAGCGTTGACAGGGGGCCCCTTAGAAATTCACCCCTCCACTTT	CSVDRGPLRNSPLHF	TRBV29-1	TRBJ1-6
TGTGCCAGCAGCTTAGCAGGACAGGGGGGGCCTTCCAGCAATCAGCCCCAGCATTTT	CASSLAGQGGPSSNQPQHF	TRBV7-9	TRBJ1-5
TGTGCCAGCAGCCAAGATGGACAGGTGGTCTACGAGCAGTACTTC	CASSQDGQVVYEQYF	TRBV14	TRBJ2-7
TGTGCCAGCAGTACCAGAGGGGGCACTGAAGCTTTCTTT	CASSTRGGTEAFF	TRBV28	TRBJ1-1
TGTGCCAGCAGCAAGGGGCCTTGGCATGGCTACACCTTC	CASSKGPWHGYTF	TRBV5-4	TRBJ1-2
TGCGCCAGCAGCTCGAGGCCGTACCAAGAGACCCAGTACTTC	CASSSRPYQETQYF	TRBV5-1	TRBJ2-5
TGTGCCAGCAGTGACCCCCAGCAGGGGGGTAGCAATCAGCCCCAGCATTTT	CASSDPQQGGSNQPQHF	TRBV6-4	TRBJ1-5
TGCGCCAGCAGCGAAGCGAGAGCGGGTACCATCTACGAGCAGTACTTC	CASSEARAGTIYEQYF	TRBV10-1	TRBJ2-7
TGTGCCAGCACCCCACAGGGGTACGGGGACACTGAAGCTTTCTTT	CASTPQGYGDTEAFF	TRBV12-3	TRBJ1-1
TGTGCCTGTTCCTATACGGGGAGAAGGATCCTCTATGGCTACACCTTC	CACSYTGRRILYGYTF	TRBV30	TRBJ1-2
TGTGCCAGCAGTTTACCTTTTAGCGGGAATGAGCAGTTCTTC	CASSLPFSGNEQFF	TRBV12-3	TRBJ2-1
TGCGCCAGCACCCAAAGGGGGCTGGCTGGAAACACCATATATTTT	CASTQRGLAGNTIYF	TRBV10-2	TRBJ1-3
TGCGCCAGCAGCCAGCGACAGGACCCCAACACTGAAGCTTTCTTT	CASSQRQDPNTEAFF	TRBV4-1	TRBJ1-1
TGTGCCAGCAGCTCGTTCTACAGGGGGAAATTGAACACTGAAGCTTTCTTT	CASSSFYRGKLNTEAFF	TRBV9	TRBJ1-1
TGTGCCAGCAGCGTAGTCCGTTTAACGATTACAAGCTCCTACGAGCAGTACTTC	CASSVVRLTITSSYEQYF	TRBV9	TRBJ2-7
TGTGCCAGCAGTCACGGCTCGCGTGACATAGTGGAGAACACTGAAGCTTTCTTT	CASSHGSRDIVENTEAFF	TRBV28	TRBJ1-1
TGTGCCAGCCATAGGAGCCCCCGGGGGGGACAGGGGGATGAGCAGTTCTTC	CASHRSPRGGQGDEQFF	TRBV14	TRBJ2-1
TGTGCCAGCAGCGGGGGTCCCGCCGGGGAGCTGTTTTTT	CASSGGPAGELFF	TRBV13	TRBJ2-2
TGCGCCCATCCCCCAGCAGGGCAGCCCCAGCATTTT	CAHPPAGQPQHF	TRBV5-1	TRBJ1-5
TGTGCCAGCAGCCCTCGGGGGGGAGGGTCCTACGAGCAGTACTTC	CASSPRGGGSYEQYF	TRBV7-3	TRBJ2-7
TGTGCCAGCAGCAGTAACCCGTCCGGGACTTCCTACGAGCAGTACTTC	CASSSNPSGTSYEQYF	TRBV5-8	TRBJ2-7
TGTGCCAGCAGTGGTAGCGGGAGACCCAGGGATCAGCCCCAGCATTTT	CASSGSGRPRDQPQHF	TRBV25-1	TRBJ1-5
TGTGCCAGCAGCGGACACGCCGGGACGGGCGAGCAGTACTTC	CASSGHAGTGEQYF	TRBV7-3	TRBJ2-7
TGCAGTGCTAGTCCGACTAGCGGGAGGAAGGATTTCTGTTATAGCAATCAGCCCCAGCATTTT	CSASPTSGRKDFCYSNQPQHF	TRBV20-1	TRBJ1-5
TGTGCCACCATGCGACCCTTAATCGCAAACACAGATACGCAGTATTTT	CATMRPLIANTDTQYF	TRBV24-1	TRBJ2-3
TGCAGCGTTGAGCGCAGCCTTGGGAGGTGCGAGCAGTACTTC	CSVERSLGRCEQYF	TRBV29-1	TRBJ2-7
TGTGCCAGCATCGGCGGCACTGAAGCTTTCTTT	CASIGGTEAFF	TRBV6-1	TRBJ1-1
TGCGCCAGCAGCTCCGGAGGGACAGACACTGAAGCTTTCTTT	CASSSGGTDTEAFF	TRBV5-1	TRBJ1-1
TGTGCCAGCAGCCCGGGGAGGGGCTACACCTTC	CASSPGRGYTF	TRBV7-7	TRBJ1-2
TGTGCCAGCAGTTACTACGGGGGGCTAGGGGACACAGATACGCAGTATTTT	CASSYYGGLGDTDTQYF	TRBV6-5	TRBJ2-3
TGTGCCAGCAGCGAAGCGGTTCCTGGCTACACCTTC	CASSEAVPGYTF	TRBV7-3	TRBJ1-2
TGTGCCATCAGCTTCGGAGGGGTAGCCAAAAACATTCAGTACTTC	CAISFGGVAKNIQYF	TRBV10-3	TRBJ2-4
TGTGCCATCACATTCGAAACCTTTGTTTCAGACCTAGTAGCCAAAAACATTCAGTACTTC	CAITFETFVSDLVAKNIQYF	TRBV10-3	TRBJ2-4
TGTGCCAGCAGTTTCGACAGGACCCTTAACTATGGCTACACCTTC	CASSFDRTLNYGYTF	TRBV6-4	TRBJ1-2
TGTGCCAGCAGTTACAAGGGGGGGCAACGGTACGAGCAGTACTTC	CASSYKGGQRYEQYF	TRBV6-6	TRBJ2-7
TGCAGTGCTATTAGGGCCCTTGGGGGTGAAAAACTGTTTTTT	CSAIRALGGEKLFF	TRBV20-1	TRBJ1-4
TGTGCCAGCACCGGCTTCAGGAGCGCGTACAATGAGCAGTTCTTC	CASTGFRSAYNEQFF	TRBV14	TRBJ2-1
TGTGCCAGCTCACGCACTCAGGGACTAGGCAATGAGCAGTTCTTC	CASSRTQGLGNEQFF	TRBV6-4	TRBJ2-1
TGTGCCAGCAGCTTAGGTGCTGGTGAAAAACTGTTTTTT	CASSLGAGEKLFF	TRBV11-2	TRBJ1-4
TGTGCCAGCGGTCCCCGGGATGACTACCCGAACAATGAGCAGTTCTTC	CASGPRDDYPNNEQFF	TRBV27	TRBJ2-1
TGTGCCAGCAGTGAACCCCTGGGGGGGCCCTACAATGAGCAGTTCTTC	CASSEPLGGPYNEQFF	TRBV2	TRBJ2-1
TGTGCCAGCAGTTATCCCCAAAGGGGACTAGCGCCCTCAAATGAGCAGTTCTTC	CASSYPQRGLAPSNEQFF	TRBV6-5	TRBJ2-1
TGTGCCAGCAGTTACTCGACATTGGGACAGGGCTGGGTAGCTTTCTTT	CASSYSTLGQGWVAFF	TRBV6-5	TRBJ1-1
TGTGCCAGCATGGAGGGAAACGAGCAGTACTTC	CASMEGNEQYF	TRBV12-4	TRBJ2-7
TGTGCCACCAGTGATTTGAGACGATGCAGGGGTTCTCTTACTAACTATGGCTACACCTTC	CATSDLRRCRGSLTNYGYTF	TRBV24-1	TRBJ1-2
TGTGCCAGCAGCTGGGGGACTAGCGGGAATGAGCAGTTCTTC	CASSWGTSGNEQFF	TRBV7-9	TRBJ2-1
TGTGCTAGCAGCTTAGGTACAGGTTTACGCGAGACCCAGTACTTC	CASSLGTGLRETQYF	TRBV7-7	TRBJ2-5
TGTGCCAGCAGCTTCAGGCCTGAAAAACTGTTTTTT	CASSFRPEKLFF	TRBV7-8	TRBJ1-4
TGTGCCAGCAGCATAGTACAGGGGCCCTTAGAGACCCAGTACTTC	CASSIVQGPLETQYF	TRBV13	TRBJ2-5
TGTGCCAGCAGCGGAATTGGGGGGGGGGTACTGGCCTCCAATGAGCAGTTCTTC	CASSGIGGGVLASNEQFF	TRBV13	TRBJ2-1
TGCAGCGTTCAGATGAGGCAGGGCCGAATCGAGCAGTACTTC	CSVQMRQGRIEQYF	TRBV29-1	TRBJ2-7
TGTGCCTGGAGTGTACTAGCGGGAGTACTAACCGGGGAGCTGTTTTTT	CAWSVLAGVLTGELFF	TRBV30	TRBJ2-2
TGTGCCAGCAGCCAAGACAAGGCTACTGAAGCTTTCTTT	CASSQDKATEAFF	TRBV3-1	TRBJ1-1
TGTGCCAGCAGTGTAACCTCCAGCGATACCGGCTACACCTTC	CASSVTSSDTGYTF	TRBV6-1	TRBJ1-2
TGCGCCAGCAGCCAAGATGGCCAGGCCGGGATTAACTCTGGAAACACCATATATTTT	CASSQDGQAGINSGNTIYF	TRBV4-3	TRBJ1-3
TGTGCCAGCAGGAATAACCCCGTTAAGGCTGAAGCTTTCTTT	CASRNNPVKAEAFF	TRBV7-9	TRBJ1-1
TGCAGCGTTAGCATCTCGGGGCGAAGGTTCTACGAGCAGTACTTC	CSVSISGRRFYEQYF	TRBV29-1	TRBJ2-7
TGTGCCACCAGAAGGAGGACAGGGCCGACTGAAGCTTTCTTT	CATRRRTGPTEAFF	TRBV24-1	TRBJ1-1
TGTGCCAGCAGACGGGGGCGTGTAGATACGCAGTATTTT	CASRRGRVDTQYF	TRBV6-5	TRBJ2-3
TGTGCCAGCAGCGGGATCGACAGGGGGGGGCGCCTCCATGAAAAACTGTTTTTT	CASSGIDRGGRLHEKLFF	TRBV7-8	TRBJ1-4
TGTGCCAGTAGGGAGTCCCAGCATTTT	CASRESQHF	TRBV19	TRBJ1-5
TGTGCCACCAGTGATCCGAAGCCGGCGATTTTCCGCAATCAGCCCCAGCATTTT	CATSDPKPAIFRNQPQHF	TRBV24-1	TRBJ1-5
TGTGCCTGTCGGGTTTCGGACAGGTATGGCTACACCTTC	CACRVSDRYGYTF	TRBV30	TRBJ1-2
TGTGCCATCAGTGACTCCCAGGGGGCCATCCCTTTCCTCTACGAGCAGTACTTC	CAISDSQGAIPFLYEQYF	TRBV10-3	TRBJ2-7
TGCAGTGCTAGACTTTCGGATAGAACTGAAGCTTTCTTT	CSARLSDRTEAFF	TRBV20-1	TRBJ1-1
TGTGCCAGCAGTGAATCCTTTAGCTACGAGCAGTACTTC	CASSESFSYEQYF	TRBV25-1	TRBJ2-7
TGCGCCAGCAGCTTTAGTTTTACGGGAGGCACAGATACGCAGTATTTT	CASSFSFTGGTDTQYF	TRBV5-1	TRBJ2-3
TGTGCCAGCGCTCTGGGGGGGGGCCGGGAAAAACTGTTTTTT	CASALGGGREKLFF	TRBV25-1	TRBJ1-4
TGTGCCAGCAGCCAGACAGTAATCTACGAGCAGTACTTC	CASSQTVIYEQYF	TRBV9	TRBJ2-7
TGTGCCAGCAGCCCCATCTCCAACGAGCAGTACTTC	CASSPISNEQYF	TRBV5-4	TRBJ2-7
TGCGCCAGCAGCAGTCTCTCCCGATACCGAAGCACAGATACGCAGTATTTT	CASSSLSRYRSTDTQYF	TRBV5-1	TRBJ2-3
TGTGCCAGCAGCCTGGTACACAGTTGCAATGAAAAACTGTTTTTT	CASSLVHSCNEKLFF	TRBV7-9	TRBJ1-4
TGTGCCAGCATACCAACCCTGACGATAAGCAATCAGCCCCAGCATTTT	CASIPTLTISNQPQHF	TRBV6-1	TRBJ1-5
TGTGCCAGCAGCGAGTCGATCCTTTACTATGGCTACACCTTC	CASSESILYYGYTF	TRBV7-2	TRBJ1-2
TGTGCCAGCAGTGATCGACACGGGTACGAGCAGTACTTC	CASSDRHGYEQYF	TRBV6-1	TRBJ2-7
TGTGCCAGCAGCCTCAGAAAAAACGGGTACGAGCAGTACTTC	CASSLRKNGYEQYF	TRBV3-1	TRBJ2-7
TGTGCCAGCAGCCAAGATAGCGTATTTACGCGGGGGGCTCTGGGGCAGCCCCAGCATTTT	CASSQDSVFTRGALGQPQHF	TRBV14	TRBJ1-5
TGTGCCAGCAGCACCGTGAAGACCGGGGAGCTGTTTTTT	CASSTVKTGELFF	TRBV13	TRBJ2-2
TGCGCCAGCAGCCAAGATATCTTCGGGACAGGAACTCTATACAATCAGCCCCAGCATTTT	CASSQDIFGTGTLYNQPQHF	TRBV4-1	TRBJ1-5
TGTGCCAGCAGCCGAAATGTTGGACAGGCGGAAAAACTGTTTTTT	CASSRNVGQAEKLFF	TRBV4-2	TRBJ1-4
TGCGCCAGCAGCTTTAGGAGGGGAAACACCGGGGAGCTGTTTTTT	CASSFRRGNTGELFF	TRBV4-1	TRBJ2-2
TGTGCCAGCAGCTTAGTTTCGGGCAGGGGGCAAGGAAAGAACACTGAAGCTTTCTTT	CASSLVSGRGQGKNTEAFF	TRBV7-2	TRBJ1-1
TGTGCCAGCTCACCATCAGGGCGCACTTTCTTT	CASSPSGRTFF	TRBV18	TRBJ1-1
TGTGCCAGCAGCCCCACGGGCCAGTACGAGCAGTACTTC	CASSPTGQYEQYF	TRBV5-4	TRBJ2-7
TGTGCCAGCAGCACCCCAAGGGTTTTTCGCTCTGGAAACACCATATATTTT	CASSTPRVFRSGNTIYF	TRBV7-3	TRBJ1-3
TGTGCCAGCAGCGGCGGGGGACAGGTTTTAGCTTTCTTT	CASSGGGQVLAFF	TRBV7-4	TRBJ1-1
TGTGCCAAACTTACTAGGGGGGCAAGCACCGGGGAGCTGTTTTTT	CAKLTRGASTGELFF	TRBV6-8	TRBJ2-2
TGTGCCAGCAGTTTCAACCGGGACCTACTGTACTTC	CASSFNRDLLYF	TRBV27	TRBJ2-5
TGTGCCAGCATTCCCGCTCTCGGGCACGAGCAGTACTTC	CASIPALGHEQYF	TRBV6-2	TRBJ2-7
TGTGCCAGCATTCGGTCTGGCTACACCTTC	CASIRSGYTF	TRBV25-1	TRBJ1-2
TGTGCCAGCAGTTTCTTCCTATTTCGGGACAGGGGGTATGGCTACACCTTC	CASSFFLFRDRGYGYTF	TRBV28	TRBJ1-2
TGTGCCAGCAGCGTAGCGCCGGGTCTGAACACTGAAGCTTTCTTT	CASSVAPGLNTEAFF	TRBV9	TRBJ1-1
TGTGCCAGCAGATCCCCTCAGATCACCGGGGAGCTGTTTTTT	CASRSPQITGELFF	TRBV12-3	TRBJ2-2
TGTGCCAGCAGAGCCGGGACTGGGTGGTCTGAAAAACTGTTTTTT	CASRAGTGWSEKLFF	TRBV2	TRBJ1-4
TGTGCCAGCAGCTTATGTCATCAGAGGGACAGCGCCTACAATGAGCAGTTCTTC	CASSLCHQRDSAYNEQFF	TRBV11-3	TRBJ2-1
TGCGCCAGCAGTGAGATAAGGGGTAGTGGCTACACCTTC	CASSEIRGSGYTF	TRBV10-1	TRBJ1-2
TGTGCCAGCAGTTACAGTCTGTGGGGGGGAGATACGCAGTATTTT	CASSYSLWGGDTQYF	TRBV6-5	TRBJ2-3
TGTGCCAGCAGCTTTACCGTGCGACAGGGGCTAGCTAACTATGGCTACACCTTC	CASSFTVRQGLANYGYTF	TRBV5-6	TRBJ1-2
TGTGCCAGCAGCCCGTTCCCTGGGGAGTCCTCCTACGAGCAGTACTTC	CASSPFPGESSYEQYF	TRBV6-5	TRBJ2-7
TGCGCCAGCAGCCCCCGGGACAGGGGGAATCAGCCCCAGCATTTT	CASSPRDRGNQPQHF	TRBV5-1	TRBJ1-5
TGTGCCAGCCGGCGGGGGGAAGATGAGCAGTACTTC	CASRRGEDEQYF	TRBV7-7	TRBJ2-7
TGTGCCAGACTAGCGGGCTTGGGGTACAATGAGCAGTTCTTC	CARLAGLGYNEQFF	TRBV19	TRBJ2-1
TGTGCCAGCAGACAAATCGCGGGAGTACCTACTGAGCAGTTCTTC	CASRQIAGVPTEQFF	TRBV9	TRBJ2-1
TGTGCCAGCAGCGTGAGAGGGAGTCTTGCTGAAAAACTGTTTTTT	CASSVRGSLAEKLFF	TRBV13	TRBJ1-4
TGTGCCAGCAGCTTAGAACCCACGCGGGACATAAGAGTAAATGAAGCTTTCTTT	CASSLEPTRDIRVNEAFF	TRBV7-9	TRBJ1-1
TGTGCCAGCAGACCCGGGACAGGGGAGGATGAAGCTTTCTTT	CASRPGTGEDEAFF	TRBV6-8	TRBJ1-1
TGTGCCTGGAGTGTACACCAGGGTGGAAGATACGAGCAGTACTTC	CAWSVHQGGRYEQYF	TRBV30	TRBJ2-7
TGTGCCACCGCTGTCAACGCGGGACATCAGGCGGCAGATACGCAGTATTTT	CATAVNAGHQAADTQYF	TRBV15	TRBJ2-3
TGTGCCAGCGCCGGGGAAAAGGAGGTTCATGGCTACACCTTC	CASAGEKEVHGYTF	TRBV28	TRBJ1-2
TGCGCCAGCAGCTTCCCGAACAGGGCTCTTGAGCAGTTCTTC	CASSFPNRALEQFF	TRBV5-1	TRBJ2-1
TGTGCCAGCAGTTCACCACCGCCCCAAGAGACCCAGTACTTC	CASSSPPPQETQYF	TRBV12-4	TRBJ2-5
TGTGCCAGCAAGCGACTGCGCACTGAAGCTTTCTTT	CASKRLRTEAFF	TRBV9	TRBJ1-1
TGTGCCAGCTCCGGACAGTGGCGGAGCAATCAGCCCCAGCATTTT	CASSGQWRSNQPQHF	TRBV18	TRBJ1-5
TGTGCCAGCAGTTTAAAAACCCACAGGGAAGGGAGCAATCAGCCCCAGCATTTT	CASSLKTHREGSNQPQHF	TRBV28	TRBJ1-5
TGTGCCAGCAGAGGAACGAGGCAGCCCCAGCATTTT	CASRGTRQPQHF	TRBV6-1	TRBJ1-5
TGTGCCAGATCCCACGCCCCGGGACTAGCGTCCCGGGGGTCCACAGATACGCAGTATTTT	CARSHAPGLASRGSTDTQYF	TRBV6-4	TRBJ2-3
TGTGCCAGCAGCGTAGGAAGGAGGGGCTGTACTTTTCCCGGGGAGCTGTTTTTT	CASSVGRRGCTFPGELFF	TRBV9	TRBJ2-2
TGTGCCAGCATCCCGGGACGGGGGAGCAGCTCCTATAATTCACCCCTCCACTTT	CASIPGRGSSSYNSPLHF	TRBV7-4	TRBJ1-6
TGTGCCAGCAGTCCCAACGGGACAGGGGAAAACACTGAAGCTTTCTTT	CASSPNGTGENTEAFF	TRBV28	TRBJ1-1
TGCAGTAAGCGACAGGTGAACACTGAAGCTTTCTTT	CSKRQVNTEAFF	TRBV20-1	TRBJ1-1
TGCAGCGTTGAGAGGAAGGACAGGGGGCCCAATTCACCCCTCCACTTT	CSVERKDRGPNSPLHF	TRBV29-1	TRBJ1-6
TGCAGTGCCGCACCAGGCACTGAGCAGTTCTTC	CSAAPGTEQFF	TRBV20-1	TRBJ2-1
TGTGCCAGCAGCTCTGGAACCCCTTACCAAGAGACCCAGTACTTC	CASSSGTPYQETQYF	TRBV7-9	TRBJ2-5
TGTGCCAGCAGTTTAACCGGGACAGGGCGTTGGAACACTGAAGCTTTCTTT	CASSLTGTGRWNTEAFF	TRBV28	TRBJ1-1
TGTGCCAGCTCTAAAGGTCTGGGGGGCCGACTGGGATGGAGCTCCTACAATGAGCAGTTCTTC	CASSKGLGGRLGWSSYNEQFF	TRBV18	TRBJ2-1
TGCGCCAGCAGCTTCGCCGAGACCCAGTACTTC	CASSFAETQYF	TRBV5-1	TRBJ2-5
TGTGCCAGCAGTTTACGCCTGGGTGCGGACTATGGCTACACCTTC	CASSLRLGADYGYTF	TRBV27	TRBJ1-2
TGTGCCTGGAGTGGTCAAACGACTTTGACGTACGAGCAGTACTTC	CAWSGQTTLTYEQYF	TRBV30	TRBJ2-7
TGTGCCAGCAGGCTAAGGGGGAGCAGCAATCAGCCCCAGCATTTT	CASRLRGSSNQPQHF	TRBV7-2	TRBJ1-5
TGTGCCAGCAGCTCAGACAGGGGGCAAATCAGGGGCTACGAGCAGTACTTC	CASSSDRGQIRGYEQYF	TRBV7-3	TRBJ2-7
TGTGCCAGCAGCACAAGGGACTCGGGAGAGACCCAGTACTTC	CASSTRDSGETQYF	TRBV13	TRBJ2-5
TGTGCCAGCAGCTTAAGGAGGCAGGGGGTTAAGAACACTGAAGCTTTCTTT	CASSLRRQGVKNTEAFF	TRBV7-3	TRBJ1-1
TGTGCCAGCAGTGACCGCCGGGAGTACTTC	CASSDRREYF	TRBV6-4	TRBJ2-4
TGTGCCAGCAGTCTGACAGGGGAGCAGTACTTC	CASSLTGEQYF	TRBV27	TRBJ2-7
TGTGCCAGCAGCGTGACAGGGGGCTACATGAACACTGAAGCTTTCTTT	CASSVTGGYMNTEAFF	TRBV7-3	TRBJ1-1
TGTGCCAGCAGATGGAAGGGACAGGGGAGTAACATTCAGTACTTC	CASRWKGQGSNIQYF	TRBV6-5	TRBJ2-4
TGCGCCAGCTCAGGTCGGGACAGGGAAGTCTCTGGGGCCAACGTCCTGACTTTC	CASSGRDREVSGANVLTF	TRBV10-1	TRBJ2-6
TGTGCCAGCAGCTTAGGGAGCGGTCTAGCGGAGCAGCGGGGGACCTACGAGCAGTACTTC	CASSLGSGLAEQRGTYEQYF	TRBV11-2	TRBJ2-7
TGTGCCAGTAGTCCACGACGGACCTATGGCTACACCTTC	CASSPRRTYGYTF	TRBV19	TRBJ1-2
TGCGCCAGCAGCTCCTTGGTTTCCGGGAGCCACTCCTACGAGCAGTACTTC	CASSSLVSGSHSYEQYF	TRBV5-1	TRBJ2-7
TGCAGCGTTGAGAAGGGACAGATGTGGTCCTACGAGCAGTACTTC	CSVEKGQMWSYEQYF	TRBV29-1	TRBJ2-7
TGTGCCAGCAGCTTAACAGGGGTTTCTGAAAAACTGTTTTTT	CASSLTGVSEKLFF	TRBV7-9	TRBJ1-4
TGCAGTGCTAGAGATGCGGGAGGGGAGACACCTTACGAGCAGTACTTC	CSARDAGGETPYEQYF	TRBV20-1	TRBJ2-7
TGCAGCGCCCAGGTCGGACAGGGGGCCTACTACGAGCAGTACTTC	CSAQVGQGAYYEQYF	TRBV29-1	TRBJ2-7
TGTGCCAGCAGCCAGGGGACTGATCTTAGGGGGTACAGAATGGAATCCAATGAGCAGTTCTTC	CASSQGTDLRGYRMESNEQFF	TRBV3-1	TRBJ2-1
TGTGCCAGTGGGGGGGGGGATTACGAGCAGTACTTC	CASGGGDYEQYF	TRBV19	TRBJ2-7
TGTGCCAGCAGCGTATTAAGGGGACAGGGTTCTGGAAACACCATATATTTT	CASSVLRGQGSGNTIYF	TRBV9	TRBJ1-3
TGTGCCTGGAGTCCACCGGGACAGGGAGCTTATGGCTACACCTTC	CAWSPPGQGAYGYTF	TRBV30	TRBJ1-2
TGTGCCAGCAGCTTAGAGGACACCGGACTAGCCCCAATAGAGGCTGGGGCCAACGTCCTGACTTTC	CASSLEDTGLAPIEAGANVLTF	TRBV7-9	TRBJ2-6
TGTGCCAGCCCCGGGAGTAATCCGATGAACACTGAAGCTTTCTTT	CASPGSNPMNTEAFF	TRBV25-1	TRBJ1-1
TGCAGTGCTCGGGACAGGGAGCAGTACTTC	CSARDREQYF	TRBV20-1	TRBJ2-7
TGTGCCAGCAGCTTGTGGCTAGCGGGGAAGTACTTC	CASSLWLAGKYF	TRBV11-2	TRBJ2-7
TGTGCCAGCAGCAACCGGGACAGACAGCAGCCCCAGCATTTT	CASSNRDRQQPQHF	TRBV13	TRBJ1-5
TGTGCCAGCAGTTATTCCGCGGGACCAGAGACCCAGTACTTC	CASSYSAGPETQYF	TRBV6-5	TRBJ2-5
TGTGCCAGCAGTTATGCTAACGGTCAGCCCCAGCATTTT	CASSYANGQPQHF	TRBV6-3	TRBJ1-5
TGTGCCAGCGGAGCCAGGGGTAGTCCAAGGTCCGGGGAGCTGTTTTTT	CASGARGSPRSGELFF	TRBV27	TRBJ2-2
TGTGCCAGCCCCAACGGGGCCCTCGAGCAGTACTTC	CASPNGALEQYF	TRBV5-8	TRBJ2-7
TGTGCCAGCAGTGCCTTAATCCAGGGGGGTAATTCACCCCTCCACTTT	CASSALIQGGNSPLHF	TRBV6-4	TRBJ1-6
TGTGCCACCGACATCTTACGGTCATTTAATGAAAAACTGTTTTTT	CATDILRSFNEKLFF	TRBV24-1	TRBJ1-4
TGTGCCAGCAGCTTGGGCGCCGGACAGGGCGCCGAGCATTTT	CASSLGAGQGAEHF	TRBV5-4	TRBJ1-5
TGTGCCAGCAGCCCTATGCGGGGGGCCGTTGAGCAGTTCTTC	CASSPMRGAVEQFF	TRBV3-1	TRBJ2-1
TGCGCCAGCTGGCCTGGGCGAAGCAATCAGCCCCAGCATTTT	CASWPGRSNQPQHF	TRBV5-1	TRBJ1-5
TGTGCCAGCCCGTCAGACAGGAGTAATCTCTCCTACGAGCAGTACTTC	CASPSDRSNLSYEQYF	TRBV9	TRBJ2-7
TGTGCCACCAGAAGGGGTCTTCGTCTCGGGCCTAAGCCCCAGCATTTT	CATRRGLRLGPKPQHF	TRBV24-1	TRBJ1-5
TGTGCCAGACCGTGTCTCCTGGGGGGGGTGAGCACAGATACGCAGTATTTT	CARPCLLGGVSTDTQYF	TRBV15	TRBJ2-3
TGTGCCAGCAGCGTGGAAGGGGGGGGGGATACGCAGTATTTT	CASSVEGGGDTQYF	TRBV11-3	TRBJ2-3
TGTGCCAGCAGTGATGTCGGGGAGGGGACGGACCAAGAGACCCAGTACTTC	CASSDVGEGTDQETQYF	TRBV6-4	TRBJ2-5
TGTGCCAGCAGGGCTTCGAACACTGAAGCTTTCTTT	CASRASNTEAFF	TRBV7-9	TRBJ1-1
TGCAGCGTTGCTGTCATTGGCACCTACGAGCAGTACTTC	CSVAVIGTYEQYF	TRBV29-1	TRBJ2-7
TGTGCCAGCAGCCTAATAGCAGCGGGCAATCAGCCCCAGCATTTT	CASSLIAAGNQPQHF	TRBV7-8	TRBJ1-5
TGCAGTGCTAGAGATATCCATCCCCCCTACTATGGCTACACCTTC	CSARDIHPPYYGYTF	TRBV20-1	TRBJ1-2
TGTGCCAGCAGCCAAGAGGCCGGGACAGGGCAGCCCCAGCATTTT	CASSQEAGTGQPQHF	TRBV3-1	TRBJ1-5
TGTGCCTCCCGCCATCGACTTGGTCAAGCTTTCTTT	CASRHRLGQAFF	TRBV28	TRBJ1-1
TGCAGTGCTGGCCCCCTAACAGGGGGCGAAGACACTGAAGCTTTCTTT	CSAGPLTGGEDTEAFF	TRBV20-1	TRBJ1-1
TGTGCCAGCAGCCTCCATGGGTATGGCTACACCTTC	CASSLHGYGYTF	TRBV11-2	TRBJ1-2
TGTGCCAGCAGTTTCGTCGCGATCGAGACCCAGTACTTC	CASSFVAIETQYF	TRBV12-3	TRBJ2-5
TGCGCCAGCAGCCATTGGCTCGAGCAGTACTTC	CASSHWLEQYF	TRBV4-1	TRBJ2-7
TGTGCCAGTTGTCCAGGGAGGGAAGACACCGGGGAGCTGTTTTTT	CASCPGREDTGELFF	TRBV19	TRBJ2-2
TGTGCCAGCAAAAGGACATGGCCCCTCCACTTT	CASKRTWPLHF	TRBV11-3	TRBJ1-6
TGTGCCAAGGCATTACCTGAAGCTTTCTTT	CAKALPEAFF	TRBV6-6	TRBJ1-1
TGTGCCATCAGTGCCAGCGGGACCCCGGGGTTGGGCAATCAGCCCCAGCATTTT	CAISASGTPGLGNQPQHF	TRBV10-3	TRBJ1-5
TGTGCCAGCAGCTTGCCCCAGAATACCCCCGGCAGGGCATACGAGCAGTACTTC	CASSLPQNTPGRAYEQYF	TRBV5-6	TRBJ2-7
TGTGCCAGCTCACCACCTAGGTCAGGGACGGTAAACTCCTACGAGCAGTACTTC	CASSPPRSGTVNSYEQYF	TRBV18	TRBJ2-7
TGTGCCAGCAGCCAAGAATGGGACAGGGTCATAGACTACGAGCAGTACTTC	CASSQEWDRVIDYEQYF	TRBV14	TRBJ2-7
TGTGCCAGCAGTTTCGGACAGGGAAGGAGAGTGAACACTGAAGCTTTCTTT	CASSFGQGRRVNTEAFF	TRBV27	TRBJ1-1
TGTGCCAGTAGTACCGCATCGGCTAACGGGGCTTTCTTT	CASSTASANGAFF	TRBV19	TRBJ1-1
TGCGCCAGCAGCCCGGAGGGGGCGAAGTACTTC	CASSPEGAKYF	TRBV5-1	TRBJ2-4
TGTGCCAGCAGCCGTCCCACGGCCTGGGGAACTAATTCACCCCTCCACTTT	CASSRPTAWGTNSPLHF	TRBV3-1	TRBJ1-6
TGTGCCAGCAGCGACAGGGATGGGGGCAATCAGCCCCAGCATTTT	CASSDRDGGNQPQHF	TRBV5-6	TRBJ1-5
TGTGCCAGCAGCGGGACAGAGCCGGGATACGAGCAGTACTTC	CASSGTEPGYEQYF	TRBV7-3	TRBJ2-7
TGTGCCAGCCGCGGGTCACAGGGGGGGTCCGAGCAGTACTTC	CASRGSQGGSEQYF	TRBV28	TRBJ2-7
TGTGCCAGCAGTGTGATCTACCCCATCGTCAGGGAGACCCAGTACTTC	CASSVIYPIVRETQYF	TRBV2	TRBJ2-5
TGCAGTGCTAGAGAGGTTCTCGCCCCGGACCCGAGGGTTCAGCCCCAGCATTTT	CSAREVLAPDPRVQPQHF	TRBV20-1	TRBJ1-5
TGTGCCAGGAACCCACGTCTAGGGGGCAATCAGCCCCAGCATTTT	CARNPRLGGNQPQHF	TRBV27	TRBJ1-5
TGTGCCAGCTGGACAGGGGTAAGCAATCAGCCCCAGCATTTT	CASWTGVSNQPQHF	TRBV19	TRBJ1-5
TGTGCCAGCAGCTTGGCTTCCATTCAGGGTGGAGACACTGAAGCTTTCTTT	CASSLASIQGGDTEAFF	TRBV5-5	TRBJ1-1
TGTGCCACGAATAATCGGCCACAGGGTGAGCAGTTCTTC	CATNNRPQGEQFF	TRBV24-1	TRBJ2-1
TGTGCCAGCAGCTTAAGAGAGTGGCGGAAGAATGCCTACAATGAGCAGTTCTTC	CASSLREWRKNAYNEQFF	TRBV7-3	TRBJ2-1
TGTGCCAGCAGCAAGGACAGGGATCCCCTGATGAACACTGAAGCTTTCTTT	CASSKDRDPLMNTEAFF	TRBV7-4	TRBJ1-1
TGTGCCACCGTGGGGTGGGGGGGGTGCTATTTT	CATVGWGGCYF	TRBV24-1	TRBJ2-3
TGCAGTGCCAGGGTAGACTTACGGGTGAACACTGAAGCTTTCTTT	CSARVDLRVNTEAFF	TRBV20-1	TRBJ1-1
TGTGCCAGCATAGGGGGTTTGAAGGATCCTTTGAACACTGAAGCTTTCTTT	CASIGGLKDPLNTEAFF	TRBV6-3	TRBJ1-1
TGTGCCACCAGTGATTTGCTCCCCCGAGGGGATAGCAATCAGCCCCAGCATTTT	CATSDLLPRGDSNQPQHF	TRBV24-1	TRBJ1-5
TGTGCCAGCTCAGGACCCCCACAGGAACCAACTAATGAAAAACTGTTTTTT	CASSGPPQEPTNEKLFF	TRBV18	TRBJ1-4
TGTGCCAGCAGCTTACGTATTGTATTGGGGAGATCGGAAAACATTCAGTACTTC	CASSLRIVLGRSENIQYF	TRBV7-4	TRBJ2-4
TGTGCCAGCAGCTCGGACAGGGGGGGTCGGAGAAAACTGTTTTTT	CASSSDRGGRRKLFF	TRBV13	TRBJ1-4
TGTGCCAGCAGCTTGGCTGGGACAGTTGCAGATACGCAGTATTTT	CASSLAGTVADTQYF	TRBV5-6	TRBJ2-3
TGTGCCAGCAGTTACAGGGACGCAAATCAGCCCCAGCATTTT	CASSYRDANQPQHF	TRBV6-6	TRBJ1-5
TGTGCCACCATCGCACAGATGTACACAGGCCCATACAATGAGCAGTTCTTC	CATIAQMYTGPYNEQFF	TRBV24-1	TRBJ2-1
TGTGCCACCAGTGATTTGAGCCGGCAGGAAAAAAGCTCCTACGAGCAGTACTTC	CATSDLSRQEKSSYEQYF	TRBV24-1	TRBJ2-7
TGTGCCAGCAGCTCTGCTCAGACGGAGTATAGCAATCAGCCCCAGCATTTT	CASSSAQTEYSNQPQHF	TRBV7-2	TRBJ1-5
TGTGCCAGCAGTCGCCCAGGTAGGCCCTACGAGCAGTACTTC	CASSRPGRPYEQYF	TRBV6-1	TRBJ2-7
TGTGCCAGCAGTTATCGACAGGGAGAGACCCAGTACTTC	CASSYRQGETQYF	TRBV6-9	TRBJ2-5
TGCAAGGGGGAGGGGGGGCGTCCCTACAATGAGCAGTTCTTC	CKGEGGRPYNEQFF	TRBV20-1	TRBJ2-1
TGTGCCAGCAGCCCTGGGGGCGAGCAGTACTTC	CASSPGGEQYF	TRBV3-1	TRBJ2-7
TGTGCCAGCAGCTTAGGAGGGTGTAGCGGAAGGGAAGAGACCCAGTACTTC	CASSLGGCSGREETQYF	TRBV7-6	TRBJ2-5
TGTGCCCCGGGACAGGTGGAGACCCAGTACTTC	CAPGQVETQYF	TRBV7-8	TRBJ2-5
TGCGCCAGCAGCTCCCAGGGTGGGAATCAGCCCCAGCATTTT	CASSSQGGNQPQHF	TRBV5-1	TRBJ1-5
TGCAGCTACCGGGCTCCGGGACTGGTGGGGTCCTACGAGCAGTACTTC	CSYRAPGLVGSYEQYF	TRBV29-1	TRBJ2-7
TGTGCCAGCAGTCACTCGACAGACAGCTATGGCTACACCTTC	CASSHSTDSYGYTF	TRBV28	TRBJ1-2
TGTGCCAGTAGTATAGGAACGGGACAACACGACCAGCTCCTGAACACTGAAGCTTTCTTT	CASSIGTGQHDQLLNTEAFF	TRBV19	TRBJ1-1
TGTGCCAGCAGTGCGGACAGGGAACAAAACGAGCAGTACTTC	CASSADREQNEQYF	TRBV25-1	TRBJ2-7
TGTGCCAGCAGCTTGGGGAAGGACAGGGTAAACGAGCAGTACTTC	CASSLGKDRVNEQYF	TRBV5-6	TRBJ2-7
TGTGCCAGCAGGGACGAGGGACCAACTAATGAAAAACTGTTTTTT	CASRDEGPTNEKLFF	TRBV27	TRBJ1-4
TGTGCCAGCAGCCAAGATCTGGGACAGGGGTGCGTGGGCTACACCTTC	CASSQDLGQGCVGYTF	TRBV4-2	TRBJ1-2
TGTGCCAGGAAGGGGCCCACCTACGAGCAGTACTTC	CARKGPTYEQYF	TRBV3-1	TRBJ2-7
TGTGCCAGCAGTTTGAGGGCCGGGACTAGCGGGAGGCGGTATGAGCAGTTCTTC	CASSLRAGTSGRRYEQFF	TRBV27	TRBJ2-1
TGCGCCAGCAGCGTAGGACTAGCGGGAGGCTCCTACGAGCAGTACTTC	CASSVGLAGGSYEQYF	TRBV5-1	TRBJ2-7
TGTGCCAGCGATGCCCCTAGCGGGGGGCCCAAATCTGCCCCCACCCAGTACTTC	CASDAPSGGPKSAPTQYF	TRBV6-1	TRBJ2-5
TGTGCCAGCAGTTTCTTTCACAGGGCCGGCTACGAGCAGTACTTC	CASSFFHRAGYEQYF	TRBV27	TRBJ2-7
TGCGCCAGCAGTGAGTCTGGTCATGAACAGGGGAAGGGGGCTAGTAGCTCCTACAATGAGCAGTTCTTC	CASSESGHEQGKGASSSYNEQFF	TRBV10-2	TRBJ2-1
TGTGCCAGCAGCCAAGATGACACCGAAGCTTTCTTT	CASSQDDTEAFF	TRBV14	TRBJ1-1
TGTGCCAGCATCCGTCAACAGGATTGGGAAGCTTTCTTT	CASIRQQDWEAFF	TRBV9	TRBJ1-1
TGTGCCAGCACAAACAGGGGTGAAGCTTTCTTT	CASTNRGEAFF	TRBV6-5	TRBJ1-1
TGTGCCAGCGGGTGGACAGGGCCCGGGCCACATTCAGACTACGAGCAGTACTTC	CASGWTGPGPHSDYEQYF	TRBV6-4	TRBJ2-7
TGTGCCAGCAGTGCCCCCCAACGACAGCCGGACGAGCAGTACTTC	CASSAPQRQPDEQYF	TRBV6-4	TRBJ2-7
TGTGCTAGCAGCTTAGCCTTGAGACAGGGGAATTCACCCCTCCACTTT	CASSLALRQGNSPLHF	TRBV7-7	TRBJ1-6
TGTGCCAGCAGTCGCACTGAAGCTTTCTTT	CASSRTEAFF	TRBV6-3	TRBJ1-1
TGTGCCAGCAGCCCGGGACTAGCGGGAGAAACCGGGGAGCTGTTTTTT	CASSPGLAGETGELFF	TRBV13	TRBJ2-2
TGTGCCAGCAGCGTAGGCAGGTTCTTTCCTGGTGGGACTTCCCCCTACGAGCAGTACTTC	CASSVGRFFPGGTSPYEQYF	TRBV9	TRBJ2-7
TGCAGCGTTGGAAATGGGGGGGCTGGTGGGTATGAGCAGTTCTTC	CSVGNGGAGGYEQFF	TRBV29-1	TRBJ2-1
TGCGCCAGCAGCCATTTGCTCCGCTCCTACAATGAGCAGTTCTTC	CASSHLLRSYNEQFF	TRBV4-1	TRBJ2-1
TGTGCTAGTGGTTTTCCCAGTTGGGGGGGGAAAGTGCCAGCGGCCAAAAACATTCAGTACTTC	CASGFPSWGGKVPAAKNIQYF	TRBV12-5	TRBJ2-4
TGTGCCAGCAGCTTTGCCGGTCCTTATCAGCCCCAGCATTTT	CASSFAGPYQPQHF	TRBV7-3	TRBJ1-5
TGTGCCAGCAGCATGGTGACAGGGACTAATGAAAAACTGTTTTTT	CASSMVTGTNEKLFF	TRBV5-6	TRBJ1-4
TGTGCCAGCATTTCCGTAGGATCTACTTACACCATATATTTT	CASISVGSTYTIYF	TRBV6-5	TRBJ1-3
TGTGCCAGCAGTTACTCGAGGGCGTCAAGAAAAATAGGGGATCCCACCTACGAGCAGTACTTC	CASSYSRASRKIGDPTYEQYF	TRBV6-5	TRBJ2-7
TGTGCCAGCAGCTTCCGAGCTATCGAGCAGTACTTC	CASSFRAIEQYF	TRBV4-2	TRBJ2-7
TGTGCCTGGCCCGCCTGGGGATCTAATCAGCCCCAGCATTTT	CAWPAWGSNQPQHF	TRBV30	TRBJ1-5
TGTGCCAGCAGTCGTTCGGCTGGGGCCAACGTCCTGACTTTC	CASSRSAGANVLTF	TRBV6-5	TRBJ2-6
TGCAGTGCTAGAGATGAAGGGAGGGTTGAAGCTTTCTTT	CSARDEGRVEAFF	TRBV20-1	TRBJ1-1
TGTGCCACCAGTGATACGCCCCCTTATCGAATTCCGGGACAGGGAGGACTTGAAGCTTTCTTT	CATSDTPPYRIPGQGGLEAFF	TRBV24-1	TRBJ1-1
TGTGCCAGCAAAATAGCCAGAGGGACGGGACCATACTACGAGCAGTACTTC	CASKIARGTGPYYEQYF	TRBV6-4	TRBJ2-7
TGTGCCAGTAGTATAGCCCAGCGACTAGCGGCCACAGATACGCAGTATTTT	CASSIAQRLAATDTQYF	TRBV19	TRBJ2-3
TGTGCCCACCGAGCCCGGGGTCTCAGCAATCAGCCCCAGCATTTT	CAHRARGLSNQPQHF	TRBV12-5	TRBJ1-5
TGTGCCAGCAGTGAAAGGGACAGCCGGACTAATGAAAAACTGTTTTTT	CASSERDSRTNEKLFF	TRBV2	TRBJ1-4
TGTGCCAGCAGCTTAGAAGCGACGGCCTACGAGCAGTACTTC	CASSLEATAYEQYF	TRBV7-9	TRBJ2-7
TGTGCCAGCAGTTTGTTAAAGGGGGCGAGTCACGAGCAGTACTTC	CASSLLKGASHEQYF	TRBV12-3	TRBJ2-7
TGTGCCAGCAGTAGAGGACAGGGGCGGTGCAATCAGCCCCAGCATTTT	CASSRGQGRCNQPQHF	TRBV7-6	TRBJ1-5
TGTGCCAGCCCGGTTCTGGACAGGGGACTGAACACTGAAGCTTTCTTT	CASPVLDRGLNTEAFF	TRBV6-5	TRBJ1-1
TGTGCCAGCAGTTTATTGGGGGACGAAAACTACGAGCAGTACTTC	CASSLLGDENYEQYF	TRBV27	TRBJ2-7
TGTGCCTCCGGGGGGGAAGCCTACAATGAGCAGTTCTTC	CASGGEAYNEQFF	TRBV2	TRBJ2-1
TGTGCCAGCAGTGACTCGAAAGGGGGGGGGTATCATCCTTTCTACGAGCAGTACTTC	CASSDSKGGGYHPFYEQYF	TRBV6-4	TRBJ2-7
TGTGCCAGCTCACGGGGCAGTGAGTTTCAGCCCCAGCATTTT	CASSRGSEFQPQHF	TRBV27	TRBJ1-5
TGCGCCAGCAGCCCAGTTGGTCAAGGGGTAGGCTACGAGCAGTACTTC	CASSPVGQGVGYEQYF	TRBV4-1	TRBJ2-7
TGTGCCAGCAGTTTATCGTTAGCGGGGAGCACAGATACGCAGTATTTT	CASSLSLAGSTDTQYF	TRBV27	TRBJ2-3
TGCGCCAGCAGCCAAGGTACTTATGAGATGGCGGACACTGAAGCTTTCTTT	CASSQGTYEMADTEAFF	TRBV4-3	TRBJ1-1
TGTGCCAGCAGAGCTAGCCCTGATGACCAAGAGACCCAGTACTTC	CASRASPDDQETQYF	TRBV27	TRBJ2-5
TGCAGTGCTAGGTGTCCCCCAGCTGGTCAAAACTATGGCTACACCTTC	CSARCPPAGQNYGYTF	TRBV20-1	TRBJ1-2
TGTGCCAGCAGCCGCTTTTTGGGGGCGCCTACTGAAGCTTTCTTT	CASSRFLGAPTEAFF	TRBV7-9	TRBJ1-1
TGTGCCAGCAGCTTCGGTACGAGTAGTTACGAGCAGTACTTC	CASSFGTSSYEQYF	TRBV5-8	TRBJ2-7
TGTGCCAGCAGCTTGGGATCCCCCGACAGGGGGCGGGACGAGCAGTACTTC	CASSLGSPDRGRDEQYF	TRBV3-1	TRBJ2-7
TGTGCCAGCAGCCACTCCCGGGAAGGGACTCATCAGCCCCAGCATTTT	CASSHSREGTHQPQHF	TRBV3-1	TRBJ1-5
TGTGCCAGCAGTCCTGAGCACAAGGAGACCCAGTACTTC	CASSPEHKETQYF	TRBV6-2	TRBJ2-5
TGTGCCAGCAGAAAGGCTCAGCGAGCCGGGGGACGCGGACGTGAAGCTTTCTTT	CASRKAQRAGGRGREAFF	TRBV28	TRBJ1-1
TGTGCCAGCAGTTACATGGTCGGACTAGCGGGGGGGCCGAAGGGGGTCAATGAGCAGTTCTTC	CASSYMVGLAGGPKGVNEQFF	TRBV6-2	TRBJ2-1
TGCAGTGCTCTACTTACAGGTAGGAACTATGGCTACACCTTC	CSALLTGRNYGYTF	TRBV20-1	TRBJ1-2
TGTGCCACCAGTGCTCCTGGACAGGGTATTACTGAAGCTTTCTTT	CATSAPGQGITEAFF	TRBV24-1	TRBJ1-1
TGTGCGGGGGTGGAGCTGTTTTTT	CAGVELFF	TRBV30	TRBJ2-2
TGTGCCAGCAGTGAGGGTCGGGCGGGCACAGATACGCAGTATTTT	CASSEGRAGTDTQYF	TRBV6-1	TRBJ2-3
TGTGCCAGTAGTATAGACAGGGAACCGGCCAGAGGAGCCTACGAGCAGTACTTC	CASSIDREPARGAYEQYF	TRBV19	TRBJ2-7
TGTGCCAGCAGCCTCTCCTCCTACAATGAGCAGTTCTTC	CASSLSSYNEQFF	TRBV14	TRBJ2-1
TGTGCCAGCTCACCACCCGTTCGATTCAGGGCTGGTGAAAAACTGTTTTTT	CASSPPVRFRAGEKLFF	TRBV18	TRBJ1-4
TGTGCCAGCAGTCCGGGACTAGCGGGAGCGGGAAAGGGAACAACAGATACGCAGTATTTT	CASSPGLAGAGKGTTDTQYF	TRBV7-3	TRBJ2-3
TGTGCCAGCAGCTTGGTGTCGAGACTAGGGTTTTCCTACGAGCAGTACTTC	CASSLVSRLGFSYEQYF	TRBV5-6	TRBJ2-7
TGCAGCGGCCGAACCCAGGGAGTAATGAGTTCACCCCTCCACTTT	CSGRTQGVMSSPLHF	TRBV29-1	TRBJ1-6
TGTGCCAGACTAGCGGTCACCTACGAGCAGTACTTC	CARLAVTYEQYF	TRBV19	TRBJ2-7
TGTGCCAGCAGGACAGGGGGCAATCAGCCCCAGCATTTT	CASRTGGNQPQHF	TRBV6-5	TRBJ1-5
TGTGCCACCGCGGCCCGCCCACCCCTCCACTTT	CATAARPPLHF	TRBV7-9	TRBJ1-6
TGTGCCAGTAACTCCCTGCTAGCGGGTTGGTACGAGCAGTACTTC	CASNSLLAGWYEQYF	TRBV19	TRBJ2-7
TGTGCCACCAGTGATCAGAGATCAAACAGGGAAAGGCACTATGGCTACACCTTC	CATSDQRSNRERHYGYTF	TRBV24-1	TRBJ1-2
TGTGCCAGCAGCTCTCTCCGGGACAGGGCTCCCAGCTCCTATAATTCACCCCTCCACTTT	CASSSLRDRAPSSYNSPLHF	TRBV5-6	TRBJ1-6
TGTGCCAGAAGGGCTGACTACACCGGGGAGCTGTTTTTT	CARRADYTGELFF	TRBV6-5	TRBJ2-2
TGTGCCAGCAGCTCAACAGGGACACTGAACACTGAAGCTTTCTTT	CASSSTGTLNTEAFF	TRBV7-9	TRBJ1-1
TGCAGTGCTAGACAGGACGGTGAAGCTTTCTTT	CSARQDGEAFF	TRBV20-1	TRBJ1-1
TGTGCCAGCCTTCGGAGCTCCTACAATGAGCAGTTCTTC	CASLRSSYNEQFF	TRBV5-4	TRBJ2-1
TGCAGCGTTAGCAGGGACATGAACACTGAAGCTTTCTTT	CSVSRDMNTEAFF	TRBV29-1	TRBJ1-1
TGTGCCAGGAGGGGGACGGGGGGGGGCAATGAGCAGTTCTTC	CARRGTGGGNEQFF	TRBV19	TRBJ2-1
TGCGCCAGCAGCCAAAGGAGGACCCGGAATGAAAAACTGTTTTTT	CASSQRRTRNEKLFF	TRBV4-1	TRBJ1-4
TGCGCCAGCAGCAGGTGCGCTAGCACAGATACGCAGTATTTT	CASSRCASTDTQYF	TRBV5-1	TRBJ2-3
TGCGCCAGCAGACGGGTCGAGCTGACCTACGAGCAGTACTTC	CASRRVELTYEQYF	TRBV5-1	TRBJ2-7
TGTGCCAGCAGCGAACCCTTAGGGCCGGGGGATGAGCAGTTCTTC	CASSEPLGPGDEQFF	TRBV13	TRBJ2-1
TGCAGTGCTAGAGATGGACAGGGCTACGAGCAGTACTTC	CSARDGQGYEQYF	TRBV20-1	TRBJ2-7
TGCACCCCTCCCATTGCTGACAATGAGCAGTTCTTC	CTPPIADNEQFF	TRBV20-1	TRBJ2-1
TGTGCCAGCAGCCAGGGGGACGCGACGGAGACCCAGTACTTC	CASSQGDATETQYF	TRBV7-7	TRBJ2-5
TGCGCCAGCAAAAAACGAGCGCCCCGGGACAGGGGGGCTGAAGCTTTCTTT	CASKKRAPRDRGAEAFF	TRBV10-2	TRBJ1-1
TGTGCCAGCAGTTACCCGGCGGATGAGCAGTTCTTC	CASSYPADEQFF	TRBV6-5	TRBJ2-1
TGTGCCTGGAGTGTAGGCAGAGCATGGGGTTGCCCTCACAGCAATCAGCCCCAGCATTTT	CAWSVGRAWGCPHSNQPQHF	TRBV30	TRBJ1-5
TGTGCCAGCAGCTTAGATCTTTCTTGGGGACAGCTTGGGAACACCGGGGAGCTGTTTTTT	CASSLDLSWGQLGNTGELFF	TRBV11-2	TRBJ2-2
TGTGCCAGCAGCCCATCTTGCGGGGGGGCCACAGATACGCAGTATTTT	CASSPSCGGATDTQYF	TRBV13	TRBJ2-3
TGTGCCAGCAGCGGGTTCGGCAGGGTAGGGGAGACCTCACCCCTCCACTTT	CASSGFGRVGETSPLHF	TRBV13	TRBJ1-6
TGTGCCAGCAGTGTACCGGGCCCGGGGAGCACTGAAGCTTTCTTT	CASSVPGPGSTEAFF	TRBV6-4	TRBJ1-1
TGTGCCCTAGGGAATTACGAGCAGTACTTC	CALGNYEQYF	TRBV6-5	TRBJ2-7
TGTGCCAGCAGTTTAGGACAGGGCCTCGACCAAGAGACCCAGTACTTC	CASSLGQGLDQETQYF	TRBV27	TRBJ2-5
TGCGCCAGCGTAGGGCCGAGAGCTAACTATGGCTACACCTTC	CASVGPRANYGYTF	TRBV5-1	TRBJ1-2
TGCGCCAGCAGTGCCACTGTGTGGGGGGAGACCCTGCCAGATACGCAGTATTTT	CASSATVWGETLPDTQYF	TRBV10-1	TRBJ2-3
TGTGCCAGCAGCCACGATACCAACAGGGGGCGGACTAACTATGGCTACACCTTC	CASSHDTNRGRTNYGYTF	TRBV28	TRBJ1-2
TGTGCCAGCAGCGGGTCCTGGGGGGACACCGGGGAGCTGTTTTTT	CASSGSWGDTGELFF	TRBV7-4	TRBJ2-2
TGTGCCAGCAGCCAAGATGCTGGGACCGGGGAGCTGTTTTTT	CASSQDAGTGELFF	TRBV3-1	TRBJ2-2
TGTGCCACCGACAGGGTGTCGGGCTATGGCTACACCTTC	CATDRVSGYGYTF	TRBV14	TRBJ1-2
TGTGCCACCGCCGGGACAGATCAAGAGACCCAGTACTTC	CATAGTDQETQYF	TRBV24-1	TRBJ2-5
TGTGCCAGTAGTATGGGGGGCCGGGGGGAAGCTATCTACGAGCAGTACTTC	CASSMGGRGEAIYEQYF	TRBV19	TRBJ2-7
TGTGCCACCAGCAGGGTACAAGGTGAGAACACTGAAGCTTTCTTT	CATSRVQGENTEAFF	TRBV15	TRBJ1-1
TGTGCCTGGATGCCACAGGGGGGCTACACCTTC	CAWMPQGGYTF	TRBV30	TRBJ1-2
TGCAAGGGACAATCTGGAAACACCATATATTTT	CKGQSGNTIYF	TRBV20-1	TRBJ1-3
TGTGCCAGCAGCTTTGTTCGGACAGGTTGGCCTCCAACTGAAGCTTTCTTT	CASSFVRTGWPPTEAFF	TRBV5-5	TRBJ1-1
TGTGCCAGCAGTATAGCTAGGCTGAAGGGCACAGATACGCAGTATTTT	CASSIARLKGTDTQYF	TRBV9	TRBJ2-3
TGTGCCAGCAGTTATGCTACGCTGCGGACAGGTTCCTTCTACGAGCAGTACTTC	CASSYATLRTGSFYEQYF	TRBV28	TRBJ2-7
TGTGCCAGCAGTGGAAACCCGGGACAAGAAGAGACCCAGTACTTC	CASSGNPGQEETQYF	TRBV27	TRBJ2-5
TGTGCCAGCACAACCCGGGACAGGGGCTCTGGGGCCAACGTCCTGACTTTC	CASTTRDRGSGANVLTF	TRBV6-5	TRBJ2-6
TGCAGTGCTAGCCTAGGACGGGGGGGAGGTAGCTCCTACAATGAGCAGTTCTTC	CSASLGRGGGSSYNEQFF	TRBV20-1	TRBJ2-1
TGTGCCACCATCAGTCCGGGCGCTTTCTTT	CATISPGAFF	TRBV24-1	TRBJ1-1
TGTGCCAGCAGTTACTCGACGAGGGGCTCCGACACTGAAGCTTTCTTT	CASSYSTRGSDTEAFF	TRBV6-2	TRBJ1-1
TGTGCCAGCAGTCGGGGACTACATGAAAAACTGTTTTTT	CASSRGLHEKLFF	TRBV6-5	TRBJ1-4
TGTGCCACCAGCGAAGTCACAGGGGGAACTGAAGCTTTCTTT	CATSEVTGGTEAFF	TRBV15	TRBJ1-1
