TGTGCCAGCAGCCCCAGGGGGGCTTTCACCGGGGAGCTGTTTTTT	CASSPRGAFTGELFF	TRBV14	TRBJ2-2
TGCGCCAGCAGCTTGCTTGGGGGGACTAACGAGCAGTACTTC	CASSLLGGTNEQYF	TRBV5-1	TRBJ2-7
TGTGCCAGCAGCTTTAATGGACAGGAAGGCTATGGCTACACCTTC	CASSFNGQEGYGYTF	TRBV5-5	TRBJ1-2
TGCAGCGTTAGGACGTCTGGGGCCAACGTCCTGACTTTC	CSVRTSGANVLTF	TRBV29-1	TRBJ2-6
TGCGCCAGCAGCCACTTTGCGGGAGATAACTATGGCTACACCTTC	CASSHFAGDNYGYTF	TRBV4-3	TRBJ1-2
TGTGCCAGCAGCTCCCCGTGGGGTTTCTCTGGGGCCAACGTCCTGACTTTC	CASSSPWGFSGANVLTF	TRBV7-9	TRBJ2-6
TGTGCCAGCAGCGTAGCGACAGGGAGCAATCAGCCCCAGCATTTT	CASSVATGSNQPQHF	TRBV9	TRBJ1-5
TGTGCCAGCAGTTCGTCAATGGGCCCAGAAAACACCGGGGAGCTGTTTTTT	CASSSSMGPENTGELFF	TRBV6-5	TRBJ2-2
TGTGCCAGCAGTGACTCGACCTTTATCACCGGACAGATCAATCAGCCCCAGCATTTT	CASSDSTFITGQINQPQHF	TRBV6-4	TRBJ1-5
TGTAGCAGGGGGCGAAGGAAGACCCAGTACTTC	CSRGRRKTQYF	TRBV10-3	TRBJ2-5
TGTGCCAGCTCACCAAGGGGGGACTCTGGAAACACCATATATTTT	CASSPRGDSGNTIYF	TRBV18	TRBJ1-3
TGTGCCAGCAAGATAGTCCGCGAAAGGATGAACACTGAAGCTTTCTTT	CASKIVRERMNTEAFF	TRBV27	TRBJ1-1
TGTGCCAGTAGTGGCTCTGCGGGACAGCTGGGTACTGGGGCCAACGTCCTGACTTTC	CASSGSAGQLGTGANVLTF	TRBV19	TRBJ2-6
TGTGCCAGCACCAGGGGGGTTAGCTCTGGGGCCAACGTCCTGACTTTC	CASTRGVSSGANVLTF	TRBV6-1	TRBJ2-6
TGTGCCAGCAGTGCAGGGGTACACTACGAGCAGTACTTC	CASSAGVHYEQYF	TRBV12-4	TRBJ2-7
TGTGCCAGCAGTTTTTGGGGACTGGAAGGGCACACCGGGGAGCTGTTTTTT	CASSFWGLEGHTGELFF	TRBV6-1	TRBJ2-2
TGTGCCAGCAGCCAAAGGGGGGGGGAGACTTTCGAGCAGTACTTC	CASSQRGGETFEQYF	TRBV11-2	TRBJ2-7
TGTGCCACCAACCATAAGGTCAGGGAGAATAGCAATCAGCCCCAGCATTTT	CATNHKVRENSNQPQHF	TRBV15	TRBJ1-5
TGTGCCAGCAGTTCCTCTGAAGGGGGGGGGTCCTACGAGCAGTACTTC	CASSSSEGGGSYEQYF	TRBV28	TRBJ2-7
TGTGCCACCAGTGATAACCCGGCAGGTTCGGCTTTCTTT	CATSDNPAGSAFF	TRBV24-1	TRBJ1-1
TGTGCCACCAGTGACGGCAGGGTCGATGAAGCTTTCTTT	CATSDGRVDEAFF	TRBV24-1	TRBJ1-1
TGTGCCAGCAGTTCGGACTCGTACGAGCAGTACTTC	CASSSDSYEQYF	TRBV6-6	TRBJ2-7
TGTGCCAGCAGTTTGACTCTCGACAGGGGGTGGAAAGAGACCCAGTACTTC	CASSLTLDRGWKETQYF	TRBV28	TRBJ2-5
TGCAGCGGGTGCACAGGGGGCTACACCTTC	CSGCTGGYTF	TRBV29-1	TRBJ1-2
TGTGCCAGCTCACTTACTTCGGGGGGCCCCCACCCCTACAATGAGCAGTTCTTC	CASSLTSGGPHPYNEQFF	TRBV18	TRBJ2-1
TGTGCCAGCAGCCCACCCGGGACACCTATAGAGACCCAGTACTTC	CASSPPGTPIETQYF	TRBV14	TRBJ2-5
TGTGCCAGCTCAGATCCGTTGACCCAGTACTTC	CASSDPLTQYF	TRBV13	TRBJ2-5
TGTGCCACCAGCCCCCGGGACACGTGTGAAGCTTTCTTT	CATSPRDTCEAFF	TRBV24-1	TRBJ1-1
TGTGCCAGCAGCTTAACAAAGCGGGAGAGATCCGGGGAGCTGTTTTTT	CASSLTKRERSGELFF	TRBV7-3	TRBJ2-2
TGTGCTAGCAGCTTAGCGGGACCTATCTTTAAAACCTACGAGCAGTACTTC	CASSLAGPIFKTYEQYF	TRBV7-7	TRBJ2-7
TGTGCCAGCGCCAGTCCCGGGGGCACGGGTGGCTACACCTTC	CASASPGGTGGYTF	TRBV2	TRBJ1-2
TGTGCCAGCAGTGGTCCTTGCGGATATCAGCCCCAGCATTTT	CASSGPCGYQPQHF	TRBV6-1	TRBJ1-5
TGTGCCAGCAGCCAAGATGGTCTGACAGCAGATACGCAGTATTTT	CASSQDGLTADTQYF	TRBV3-1	TRBJ2-3
TGTGCCACCAGTGACAGGTTTATTCGCGCCTACGAGCAGTACTTC	CATSDRFIRAYEQYF	TRBV24-1	TRBJ2-7
TGTGCCAGCAGCTGCGGGAAAACCAATGAAAAACTGTTTTTT	CASSCGKTNEKLFF	TRBV7-3	TRBJ1-4
TGTGCCAGCAGGCCTAGGGCTCAGCCCCAGCATTTT	CASRPRAQPQHF	TRBV7-8	TRBJ1-5
TGTGCCAGCAGTGAATTTCATTTGCGCTACACCTTC	CASSEFHLRYTF	TRBV25-1	TRBJ1-2
TGTGCCAGCAGAAACGATACGCAGTATTTT	CASRNDTQYF	TRBV27	TRBJ2-3
TGTGCCAGCAGGACAGGGGTGAGCAATCAGCCCCAGCATTTT	CASRTGVSNQPQHF	TRBV12-3	TRBJ1-5
TGTGCCAGCAGCTTGGGGATCGCCAACTTGGCCACAGATACGCAGTATTTT	CASSLGIANLATDTQYF	TRBV5-6	TRBJ2-3
TGTGCTAGTGGTTTGGTCTACAGGGGGCTAGCGTGTAATGAAAAACTGTTTTTT	CASGLVYRGLACNEKLFF	TRBV12-5	TRBJ1-4
TGTGCCAGCGGACGTGGGGGGGGGGCCACAGATACGCAGTATTTT	CASGRGGGATDTQYF	TRBV9	TRBJ2-3
TGTGCCAGCAGGGGACTAGCGGGAGGCTACGAGCAGTACTTC	CASRGLAGGYEQYF	TRBV11-3	TRBJ2-7
TGTGCCAGCAGCCAGCAGGGTCCAGGTGAAAAACTGTTTTTT	CASSQQGPGEKLFF	TRBV2	TRBJ1-4
TGTGCCAGCAGCCCGGGCCGCCTCTCGGGACAGGGGTGTACGCAGTATTTT	CASSPGRLSGQGCTQYF	TRBV16	TRBJ2-3
TGTGCCAGCAGCCAAGGTTGGCTCATAGCTTTCTTT	CASSQGWLIAFF	TRBV3-1	TRBJ1-1
TGCGCCAGCAGCCAAGATCTAGACTCAGGGGGCTATAGCAATCAGCCCCAGCATTTT	CASSQDLDSGGYSNQPQHF	TRBV4-1	TRBJ1-5
TGTGCCAGCAGTTCTCAGAAGACAAAGTACACTGAAGCTTTCTTT	CASSSQKTKYTEAFF	TRBV27	TRBJ1-1
TGCGCCAGCAGCTCGGGGGGGTACGAGCAGTACTTC	CASSSGGYEQYF	TRBV5-1	TRBJ2-7
TGTGCCAGCAGCCAAGATGCATTCCGCGGGACAGGCTACGAGCAGTACTTC	CASSQDAFRGTGYEQYF	TRBV3-1	TRBJ2-7
TGCGCCAGCAGCGGATTTGTCAGGGGGGGCGCTGAAGCTTTCTTT	CASSGFVRGGAEAFF	TRBV5-1	TRBJ1-1
TGTGCCAGCAGCTGGGGGGAGGCTACCGGGGAGCTGTTTTTT	CASSWGEATGELFF	TRBV5-4	TRBJ2-2
TGCAGTGCACCGGGACAAATACAAGAGACCCAGTACTTC	CSAPGQIQETQYF	TRBV20-1	TRBJ2-5
TGTGCCAGCAGCGGGACAGGAACCCGCTATGGCTACACCTTC	CASSGTGTRYGYTF	TRBV13	TRBJ1-2
TGTGCCAGTAGCGAGAACACTGAAGCTTTCTTT	CASSENTEAFF	TRBV19	TRBJ1-1
TGTGCCAGCAGCGGAGGGGGGGAGCTGTTTTTT	CASSGGGELFF	TRBV2	TRBJ2-2
TGTGCCAGCAGCGGGAGTCCAATAAGGACTATTGTCGAGACCCAGTACTTC	CASSGSPIRTIVETQYF	TRBV7-3	TRBJ2-5
TGTGCCAGCAGCTTTTCCCTCAGGCTATACACTGAAGCTTTCTTT	CASSFSLRLYTEAFF	TRBV11-3	TRBJ1-1
TGTGCCAGCAGCTGGTCTGGGGGACGGAATGTCTACGAGCAGTACTTC	CASSWSGGRNVYEQYF	TRBV5-6	TRBJ2-7
TGTGCCAGCAGTTCCGGGGGCGAAGAGACCCAGTACTTC	CASSSGGEETQYF	TRBV27	TRBJ2-5
TGTGCCAGCTCGCTTCGGACAGGGGTCTTCCCTGGAAACACCATATATTTT	CASSLRTGVFPGNTIYF	TRBV18	TRBJ1-3
TGTGCCAGCATCGGGACAGGGCGGGATACCGGGGAGCTGTTTTTT	CASIGTGRDTGELFF	TRBV6-3	TRBJ2-2
TGCGCCAGCAGCCCATTTCCAGGGGTTTTGGATAGCAATCAGCCCCAGCATTTT	CASSPFPGVLDSNQPQHF	TRBV5-1	TRBJ1-5
TGTGCCACCAGCAGAGCTCCCTATGGCTACACCTTC	CATSRAPYGYTF	TRBV15	TRBJ1-2
TGTGCCACCGTCCCGGGGGGGCCGGAGATCAATGAGCAGTTCTTC	CATVPGGPEINEQFF	TRBV24-1	TRBJ2-1
TGTGCCAGCAGTTGGACGGGTAACTACGAGCAGTACTTC	CASSWTGNYEQYF	TRBV2	TRBJ2-7
TGCGCCAGCAGTGAACAAACAGCCTCCTACGAGCAGTACTTC	CASSEQTASYEQYF	TRBV10-1	TRBJ2-7
TGTGCCAGCAGTTACTCCCCCTCCCAGATTGGCAACCGGACAGGTACGAGCAATCAGCCCCAGCATTTT	CASSYSPSQIGNRTGTSNQPQHF	TRBV6-2	TRBJ1-5
TGCGCCAGCAGCCTAACCAGCGGGACTAGGGGGGGTTACCAAGAGACCCAGTACTTC	CASSLTSGTRGGYQETQYF	TRBV4-3	TRBJ2-5
TGTGCCAGCATCCAATCTGGGGAGTTTGCCAAGAACTATGGCTACACCTTC	CASIQSGEFAKNYGYTF	TRBV9	TRBJ1-2
TGCAGCGTTGCCGGTGTTGCACAGGGGGGCAGCTCCTACGAGCAGTACTTC	CSVAGVAQGGSSYEQYF	TRBV29-1	TRBJ2-7
TGTGCCCGTCCCGGGACTAGCGGGAGTGAGCAGTTCTTC	CARPGTSGSEQFF	TRBV10-3	TRBJ2-1
TGTGCCAACCTCGACAGGGGAGTACACTATGGCTACACCTTC	CANLDRGVHYGYTF	TRBV11-2	TRBJ1-2
TGTGCCAGCAGCTACGGGCCTACGACAAAGGGTAACTATGGCTACACCTTC	CASSYGPTTKGNYGYTF	TRBV7-4	TRBJ1-2
TGCAGTGCTATACTGACTCCAGGCTACACCTTC	CSAILTPGYTF	TRBV20-1	TRBJ1-2
TGTGCCAGCAGCTTGTGGGACAGGGATAGCAATCAGCCCCAGCATTTT	CASSLWDRDSNQPQHF	TRBV5-8	TRBJ1-5
TGTGCCAGCAGTGTTTACGGGACTGGCTCCTACAATGAGCAGTTCTTC	CASSVYGTGSYNEQFF	TRBV12-3	TRBJ2-1
TGCGCCAGCAGCTTGGAACATCAAGAGGACAGGGATCGCGCCTACGAGCAGTACTTC	CASSLEHQEDRDRAYEQYF	TRBV5-1	TRBJ2-7
TGTGCCAGAGGGGCAGAGACCCAGTACTTC	CARGAETQYF	TRBV28	TRBJ2-5
TGTGCCAGCAGCTGGGACAGGTCCTACGAGCAGTACTTC	CASSWDRSYEQYF	TRBV7-9	TRBJ2-7
TGTGCCAGCAGCCAAGACGGCCCTAATACCGGGGAGCTGTTTTTT	CASSQDGPNTGELFF	TRBV3-1	TRBJ2-2
TGCGCCAGCAGCTTATGTACATACAGTGGGATATCTAGCGGGTCCGATAGCTACGAGCAGTACTTC	CASSLCTYSGISSGSDSYEQYF	TRBV5-1	TRBJ2-7
TGTGCCAGCACACTTGGGAGGTACTTCGTGAACACTGAAGCTTTCTTT	CASTLGRYFVNTEAFF	TRBV6-4	TRBJ1-1
TGTGCCAGAGGACTTCGGGACAGATCCCGGTCACCCCTCCACTTT	CARGLRDRSRSPLHF	TRBV19	TRBJ1-6
TGCAGTGCTAGTGTTTCGGGGGGACAGGTTGCAACTAATGAAAAACTGTTTTTT	CSASVSGGQVATNEKLFF	TRBV20-1	TRBJ1-4
TGTGCCAGCAGCACGTGCGGGAGGGACTCCGGAAACACCATATATTTT	CASSTCGRDSGNTIYF	TRBV13	TRBJ1-3
TGCGCCAGCATAAAGCACAGGGGGTACTGTAACACTGAAGCTTTCTTT	CASIKHRGYCNTEAFF	TRBV10-2	TRBJ1-1
TGCAGCGTTGATGGCGAGGGACAGGGCCGCGATGGCTACACCTTC	CSVDGEGQGRDGYTF	TRBV29-1	TRBJ1-2
TGTGCCAGCAGATACCCTAGCGGGGCCCACAATGAGCAGTTCTTC	CASRYPSGAHNEQFF	TRBV9	TRBJ2-1
TGTGCCAGCAGCGTGCGGGAAAAGAGGTACAATGAGCAGTTCTTC	CASSVREKRYNEQFF	TRBV7-3	TRBJ2-1
TGTGCCAGCAGTTTACCCCATCCGGGACTAGCGGGGGGTCTCACCGGGGAGCTGTTTTTT	CASSLPHPGLAGGLTGELFF	TRBV28	TRBJ2-2
TGCCCGGGCGTGAACAGCACTGAAGCTTTCTTT	CPGVNSTEAFF	TRBV18	TRBJ1-1
TGTGCCAGCAACGACCGGGCCAGTCACATGAATGAGCAGTTCTTC	CASNDRASHMNEQFF	TRBV25-1	TRBJ2-1
TGTGCCAGCACCGCGGGAGGGCCCTACGAGCAGTACTTC	CASTAGGPYEQYF	TRBV2	TRBJ2-7
TGTGCCAGCAGTTTAATGTATCGGATTCCTGGGGCCAACGTCCTGACTTTC	CASSLMYRIPGANVLTF	TRBV27	TRBJ2-6
TGTGCCAGCAGCCCCCCGTTCCCGGGCCGGGGAGACAAGGGTTCACCCCTCCACTTT	CASSPPFPGRGDKGSPLHF	TRBV6-4	TRBJ1-6
TGCAGTGGAAGAAGGGGGGGAAGCTACAATGAGCAGTTCTTC	CSGRRGGSYNEQFF	TRBV20-1	TRBJ2-1
TGCGCCAGCAGCAAACAGGGAGCCGCTTTCTTT	CASSKQGAAFF	TRBV5-1	TRBJ1-1
TGCGCCAGCAGCGAGAGGGACAGGGGTTACTACGAGCAGTACTTC	CASSERDRGYYEQYF	TRBV5-1	TRBJ2-7
TGTGCCAGCAGCAACAGGGTGGGACAGTCCTACGAGCAGTACTTC	CASSNRVGQSYEQYF	TRBV6-4	TRBJ2-7
TGTGCCAGCAGCGAGACAGGTAGGAGCTACGAGCAGTACTTC	CASSETGRSYEQYF	TRBV7-9	TRBJ2-7
TGTGCCAGCAGATTCGGGGCGGGGAACCCCTCCTACGAGCAGTACTTC	CASRFGAGNPSYEQYF	TRBV6-4	TRBJ2-7
TGTGCCAGACGACCGGCGACCTACGAGCAGTACTTC	CARRPATYEQYF	TRBV6-1	TRBJ2-7
TGTGCCAGCAGCTCAGATAACTATGGCTACACCTTC	CASSSDNYGYTF	TRBV5-6	TRBJ1-2
TGCAGTGCTACCGCCTACCACAAGGGGAGGCTCTACGAGCAGTACTTC	CSATAYHKGRLYEQYF	TRBV20-1	TRBJ2-7
TGTGCTAGTGGTTTGGTGGACAGGGGCCAGTACTTC	CASGLVDRGQYF	TRBV12-5	TRBJ2-4
TGTGCCAGCAGCTTAAGAGAGATAGGAGACGAGCAGTACTTC	CASSLREIGDEQYF	TRBV11-3	TRBJ2-7
TGTGCCAGCAGCCAGGTCATGAGGGACAGGGTGGACTATGGCTACACCTTC	CASSQVMRDRVDYGYTF	TRBV14	TRBJ1-2
TGTGCCAGCAGCGCCCCCGGGGTATCATACGAGCAGTACTTC	CASSAPGVSYEQYF	TRBV9	TRBJ2-7
TGCGCCAGCAGCTTGGACACGGTGGGACAGGGGAGCCAACGTAAGCAGTTCTTC	CASSLDTVGQGSQRKQFF	TRBV5-1	TRBJ2-1
TGCGCCAGCAGCCACTCTTGGGAAGATTGCTACGAGCAGTACTTC	CASSHSWEDCYEQYF	TRBV4-1	TRBJ2-7
TGTGCCAGCAGCCCTGAGGGCTCTAATGAAAAACTGTTTTTT	CASSPEGSNEKLFF	TRBV13	TRBJ1-4
TGTGCCAGCAGCCGGGAAGAGCTGTTTTTT	CASSREELFF	TRBV3-1	TRBJ2-2
TGTGCTAGTGGTAGACCCGAGGGGAGGGGCTACACCTTC	CASGRPEGRGYTF	TRBV12-5	TRBJ1-2
TGTGCCAGCATCCATACTCTTCGTAATGGCTACACCTTC	CASIHTLRNGYTF	TRBV6-4	TRBJ1-2
TGTGCCAGCAGCCAGGACGAGTATGAGCAGTTCTTC	CASSQDEYEQFF	TRBV13	TRBJ2-1
TGTGCCAGCAGCTCTCGACGGTATAGCAATCAGCCCCAGCATTTT	CASSSRRYSNQPQHF	TRBV5-4	TRBJ1-5
TGCAGCCCCCGGGGGGCCTTAGATACGCAGTATTTT	CSPRGALDTQYF	TRBV29-1	TRBJ2-3
TGCGCCAGCAGCTTGGGATTGAGGGGGATGGGTGAAAAACTGTTTTTT	CASSLGLRGMGEKLFF	TRBV5-1	TRBJ1-4
TGTGCCGCAAGAGCAGGGGAGACCGGGGAGCTGTTTTTT	CAARAGETGELFF	TRBV2	TRBJ2-2
TGTGCCAGCAGCCCCAAGGGCCCTTATTTTGTCAATGAGCAGTTCTTC	CASSPKGPYFVNEQFF	TRBV11-3	TRBJ2-1
TGCGCCAGCAGTGAGGGCCGCGGAGATGGCTACACCTTC	CASSEGRGDGYTF	TRBV10-1	TRBJ1-2
TGTGCCAGCAGCCCGACCGGGCTGTTTTTT	CASSPTGLFF	TRBV13	TRBJ2-2
TGTGCCAGCAGTTATGCAGGGGACCAGGACAGCCGGGAAGCTTTCTTT	CASSYAGDQDSREAFF	TRBV6-5	TRBJ1-1
TGCAGCGTTAGGAAAGTGAAGGGGACTAGCGGGAAGGACAATGAGCAGTTCTTC	CSVRKVKGTSGKDNEQFF	TRBV29-1	TRBJ2-1
TGTGCCAGCTCCTGGTGGACCCAGGCTTACACCTTC	CASSWWTQAYTF	TRBV18	TRBJ1-2
TGTGCCAGCAGCCGGTGGCCAGAGGTTTTTGGGGCCGACACTGAAGCTTTCTTT	CASSRWPEVFGADTEAFF	TRBV7-6	TRBJ1-1
TGCGCCAGCAGCCTCACCACCTCCGGGGAGCTGTTTTTT	CASSLTTSGELFF	TRBV5-1	TRBJ2-2
TGTGCCAGCAGCTTATTGGGGGGGGAGGACAATGAGCAGTTCTTC	CASSLLGGEDNEQFF	TRBV11-1	TRBJ2-1
TGTGCCAGCAGTTTTGGGCTACTTCCCCGGGACACTTGGGTCTGCGGCAATCAGCCCCAGCATTTT	CASSFGLLPRDTWVCGNQPQHF	TRBV12-3	TRBJ1-5
TGTGCCAGCAGTTACTTCGGGTCTGGCTACACCTTC	CASSYFGSGYTF	TRBV6-5	TRBJ1-2
TGTGCCAGCAGCTTGAGAGCTACAGGGCAGCGTTGCACTGAAGCTTTCTTT	CASSLRATGQRCTEAFF	TRBV5-6	TRBJ1-1
TGTGCCAGCAGCCAAGCTAACGAGGGGGCCCGGAATCAGCCCCAGCATTTT	CASSQANEGARNQPQHF	TRBV3-1	TRBJ1-5
TGTGCCAGCAGTGAGGGACAGGCCCTGAATGAAAAACTGTTTTTT	CASSEGQALNEKLFF	TRBV6-4	TRBJ1-4
TGCGCCAGCAGCCAAGATAGGCGCTCCCCGACAGGGACAAACTATGGCTACACCTTC	CASSQDRRSPTGTNYGYTF	TRBV4-3	TRBJ1-2
TGTGCCAGCAGCGCCCGGGGGGGCGGGCCAGTCCCAGAGACCCAGTACTTC	CASSARGGGPVPETQYF	TRBV9	TRBJ2-5
TGCGCCAGCAGCGGCCGCGGGAGTAGGGCGACAGATACGCAGTATTTT	CASSGRGSRATDTQYF	TRBV5-1	TRBJ2-3
TGTGCCAGCAGTTACCCAGTTTCCTACGAGCAGTACTTC	CASSYPVSYEQYF	TRBV6-5	TRBJ2-7
TGTGCCAGCAGCCAAGATGCTCGGGTTTACGTCGGGGAGCTGTTTTTT	CASSQDARVYVGELFF	TRBV3-1	TRBJ2-2
TGTGCCAGCGGGCCTAGCGGGGAGATAGCCAAAAACATTCAGTACTTC	CASGPSGEIAKNIQYF	TRBV7-3	TRBJ2-4
TGTGCCACGGCCCCCCCCCCATGGGGAGGTAACATTCAGTACTTC	CATAPPPWGGNIQYF	TRBV24-1	TRBJ2-4
TGTGCTAGTGGTTTAAGCAGGGGGCTGAGCTCCTACGAGCAGTACTTC	CASGLSRGLSSYEQYF	TRBV12-5	TRBJ2-7
TGCGCCAGCAGCTTGGAGGACAGGAGATGGAATGAAAAACTGTTTTTT	CASSLEDRRWNEKLFF	TRBV5-1	TRBJ1-4
TGTGCCAGCAGCTACTCCTACGAGCAGTACTTC	CASSYSYEQYF	TRBV7-3	TRBJ2-7
TGTGCCAGCAGGAATAGTATAGGTTTCAAAAACATTCAGTACTTC	CASRNSIGFKNIQYF	TRBV6-1	TRBJ2-4
TGCGCCAGCAGCGCAGGGTGGGGGAACACTGAAGCTTTCTTT	CASSAGWGNTEAFF	TRBV4-3	TRBJ1-1
TGCGCCAGCAGCCAAGTAACCCGAGTATTCCCCTCTGGAAACACCATATATTTT	CASSQVTRVFPSGNTIYF	TRBV4-3	TRBJ1-3
TGTGCCAGCCCTGGTAAGGTACCCTCAGGGGTTCAATATAATTCACCCCTCCACTTT	CASPGKVPSGVQYNSPLHF	TRBV6-4	TRBJ1-6
TGTGCCAGTAGTATAGATCCGTTAGGGACAGGGGGTAGCTACGAGCAGTACTTC	CASSIDPLGTGGSYEQYF	TRBV19	TRBJ2-7
TGTGCCAGCAGCGGTAGCGGGAGGAACGAGCAGTACTTC	CASSGSGRNEQYF	TRBV7-8	TRBJ2-7
TGTGCCAGCAGCTTACCTACTGACGTTAGGGAGCTCGATAGCAATCAGCCCCAGCATTTT	CASSLPTDVRELDSNQPQHF	TRBV7-9	TRBJ1-5
TGTGCCACCAGTGATCGTCTTAACTTGAGGGACCAGCTATGGCAGTACTTC	CATSDRLNLRDQLWQYF	TRBV24-1	TRBJ2-7
TGTGCCAGCAGCTTAGCAAAACCGCAGGGTACCTCTGGGGCCAACGTCCTGACTTTC	CASSLAKPQGTSGANVLTF	TRBV7-6	TRBJ2-6
TGTGCCAGCAGCGCCACGGGTGAAGCTTTCTTT	CASSATGEAFF	TRBV13	TRBJ1-1
TGTGCCAGCGAACAGGGGGGACAGCCCCAGCATTTT	CASEQGGQPQHF	TRBV12-3	TRBJ1-5
TGTGCCAGCAGCCGGGGGCAAAGAGAAGAGCAGTACTTC	CASSRGQREEQYF	TRBV9	TRBJ2-7
TGTGCCAGCAGGGAAACTAGCGGGGGGGCCTTTCGCTACAATGAGCAGTTCTTC	CASRETSGGAFRYNEQFF	TRBV6-2	TRBJ2-1
TGCGCCAGCAGCCAAGGTCCCCGGGACAGGAACACCGGGGAGCTGTTTTTT	CASSQGPRDRNTGELFF	TRBV4-1	TRBJ2-2
TGTGCCAGCAGTCCGGTCGGCACCCTATCCCAGAGCAATCAGCCCCAGCATTTT	CASSPVGTLSQSNQPQHF	TRBV6-3	TRBJ1-5
TGTGCCAGCAGCTCGGTAGGCGGTAGGCACGAGCAGTACTTC	CASSSVGGRHEQYF	TRBV5-4	TRBJ2-7
TGTGCCAGCAGTTTATACAGCATGAACACTGAAGCTTTCTTT	CASSLYSMNTEAFF	TRBV27	TRBJ1-1
TGCGCCAGCAGCTTGGGGCTACAGGGGGCGCTCCCCTCAGCAGATACGCAGTATTTT	CASSLGLQGALPSADTQYF	TRBV5-1	TRBJ2-3
TGTGCCAGCCCTAGACAGGGGGAAGAGACCCAGTACTTC	CASPRQGEETQYF	TRBV6-5	TRBJ2-5
TGTGCCAGCAGCATTTTCACCGTTAGAGCGCCGGTGACCTACGAGCAGTACTTC	CASSIFTVRAPVTYEQYF	TRBV7-9	TRBJ2-7
TGTGCCAGCAGCCAAGATGACGAGGGATCCGCACCCCTCCACTTT	CASSQDDEGSAPLHF	TRBV14	TRBJ1-6
TGCAGTGCTGAGCAGGGCCCTTTTCTTAATTCACCCCTCCACTTT	CSAEQGPFLNSPLHF	TRBV20-1	TRBJ1-6
TGTGCCACCAGTGTGGGCGGGGCCTATAATTCACCCCTCCACTTT	CATSVGGAYNSPLHF	TRBV24-1	TRBJ1-6
TGTGCCAGCACTAGCGGGAGCAATGAGCAGTTCTTC	CASTSGSNEQFF	TRBV7-9	TRBJ2-1
TGTGCCACCAGAGTAGGCGAGCAGTACTTC	CATRVGEQYF	TRBV24-1	TRBJ2-7
TGTGCCAGCCCTCACAGGGAGGCCTATGGCTACACCTTC	CASPHREAYGYTF	TRBV14	TRBJ1-2
TGTGCCAGTAGTCCATGGGGGCGGGACGAGCAGTACTTC	CASSPWGRDEQYF	TRBV19	TRBJ2-7
TGTGCCAGCAGCAAGGGGGAGGGCAACTATGGCTACACCTTC	CASSKGEGNYGYTF	TRBV7-3	TRBJ1-2
TGTGCCAGCAGCCAAGATGCGGGAGGGGTCACTGAAGCTTTCTTT	CASSQDAGGVTEAFF	TRBV4-2	TRBJ1-1
TGCGCCAGCACATTAGGGACTAGCGGGGATGGGCGGGCTTATGAGCAGTTCTTC	CASTLGTSGDGRAYEQFF	TRBV10-1	TRBJ2-1
TGTGCCAGCAGCTACTTCGTATGTAGCTCCTATAATTCACCCCTCCACTTT	CASSYFVCSSYNSPLHF	TRBV5-4	TRBJ1-6
TGTGCCAGCAGCTTTTTTAAGGGACAGGGGCCCTACGAGCAGTACTTC	CASSFFKGQGPYEQYF	TRBV5-6	TRBJ2-7
TGTGCCAGCAGCGCTCCCAGAATATACGTAAGCTCCTACGAGCAGTACTTC	CASSAPRIYVSSYEQYF	TRBV7-6	TRBJ2-7
TGTGCCAGCAGCTTAGCGGGACAGGGTTCCAATCAGCCCCAGCATTTT	CASSLAGQGSNQPQHF	TRBV7-2	TRBJ1-5
TGCGCCGGGGAGGGGGGCTACGAGCAGTACTTC	CAGEGGYEQYF	TRBV20-1	TRBJ2-7
TGTGCCCTGACAGGGGGCGCGGAAGATACGCAGTATTTT	CALTGGAEDTQYF	TRBV5-4	TRBJ2-3
TGTGCCAGCAGTTCGTGGACAGTCCGCACTGAAGCTTTCTTT	CASSSWTVRTEAFF	TRBV27	TRBJ1-1
TGTGCCAGCAGCGTCCGACAGGGATACGAGCAGTACTTC	CASSVRQGYEQYF	TRBV9	TRBJ2-7
TGTGCCTGGAGTGTACCCGTGATGGCTACTAGGGACAGGGGGGAGGAGCAGCCCCAGCATTTT	CAWSVPVMATRDRGEEQPQHF	TRBV30	TRBJ1-5
TGTGCCAGCAGCCAGAGGGGGGGGGGCAGAAGGGAGCAGTTCTTC	CASSQRGGGRREQFF	TRBV3-1	TRBJ2-1
TGCGCCAGCAGTGAAGGGATTATCGCCGAGATCGGCCTCCTGAACACTGAAGCTTTCTTT	CASSEGIIAEIGLLNTEAFF	TRBV10-2	TRBJ1-1
TGCGCCAGCAGCTACCAGCCCGTCGAGGATGACAGAAAGCCTGAGCAGTACTTC	CASSYQPVEDDRKPEQYF	TRBV5-1	TRBJ2-7
TGTGCCAGCAGCGGACGGGGGGAGCATCTCCAGACTTCACCCCTCCACTTT	CASSGRGEHLQTSPLHF	TRBV5-6	TRBJ1-6
TGTGCCAGCAGCTTACCCCCATCGCCACGAAGGGGACTCACCTTC	CASSLPPSPRRGLTF	TRBV11-3	TRBJ1-2
TGTGCCAGCAGTTTTGCAGGGGCCTGCTACGAGCAGTACTTC	CASSFAGACYEQYF	TRBV12-4	TRBJ2-7
TGTGCCAGCCGGAGTCCTTGGGGACAGGTTATTACGCCTAACATTCAGTACTTC	CASRSPWGQVITPNIQYF	TRBV5-8	TRBJ2-4
TGTGCCAGCAGTCGAGGTTTTTCGACACAAGGACAGGTCGTAAACACTGAAGCTTTCTTT	CASSRGFSTQGQVVNTEAFF	TRBV28	TRBJ1-1
TGTGCCAGCAGCTATGACGGTACAGATACGCAGTATTTT	CASSYDGTDTQYF	TRBV7-9	TRBJ2-3
TGTGCCAGCAGTGGGGATGGGGGGGGATTCGGTCAAAGAGAGACCCAGTACTTC	CASSGDGGGFGQRETQYF	TRBV6-5	TRBJ2-5
TGCAGCGAAGACAGCTCTTTAGACCTCTGCGGGTTCTATGGCTACACCTTC	CSEDSSLDLCGFYGYTF	TRBV29-1	TRBJ1-2
TGCAGTGCTAAACGCCTCAGCAATCAGCCCCAGCATTTT	CSAKRLSNQPQHF	TRBV20-1	TRBJ1-5
TGTGCCAGCAGCAAGCAGGCCATTTTAGATACGCAGTATTTT	CASSKQAILDTQYF	TRBV5-5	TRBJ2-3
TGTGCCAGCAGCCAAGTGAGGCTGGGGGGGGCCGAAAAACAGGGTAACAATGAGCAGTTCTTC	CASSQVRLGGAEKQGNNEQFF	TRBV3-1	TRBJ2-1
TGTGCCAGCAGTTCTCCGAATCCCGGGACAGGGGCCGGGGAGCTGTTTTTT	CASSSPNPGTGAGELFF	TRBV7-9	TRBJ2-2
TGTGCCAGCAGCCCTTCTAGCCTAAGGGTCTTCAATGAGCAGTTCTTC	CASSPSSLRVFNEQFF	TRBV9	TRBJ2-1
TGTGCCAGCAGCGAGACAGGGTTGTACTCTGGGGCCAACGTCCTGACTTTC	CASSETGLYSGANVLTF	TRBV9	TRBJ2-6
TGTGCCAGCAAGCTCGGGGCAGACACTGAAGCTTTCTTT	CASKLGADTEAFF	TRBV28	TRBJ1-1
TGTGCCAGCAAAAGGGACAGGGAAATTAACACTGAAGCTTTCTTT	CASKRDREINTEAFF	TRBV28	TRBJ1-1
TGTGCCAGCAGCAGACACCGCGGGAGCAACTACGAGCAGTACTTC	CASSRHRGSNYEQYF	TRBV9	TRBJ2-7
TGTGCCAGCAGACATGGGGGAATAAGCACAGATACGCAGTATTTT	CASRHGGISTDTQYF	TRBV6-2	TRBJ2-3
TGCGCCAGCACCTGGGTGGAAGCTTTCTTT	CASTWVEAFF	TRBV10-1	TRBJ1-1
TGTGCCAGCAGTTTAAGCAAAGGTTACGGCCCCGCACCCAATGAGCAGTTCTTC	CASSLSKGYGPAPNEQFF	TRBV28	TRBJ2-1
TGTGCCAGCAGAAGGGGGAGGGAGTTTGCTCTTCCAACTAATGAAAAACTGTTTTTT	CASRRGREFALPTNEKLFF	TRBV6-3	TRBJ1-4
TGTGCCAGCAGCTGGGGGACGTTCACAGATACGCAGTATTTT	CASSWGTFTDTQYF	TRBV9	TRBJ2-3
TGTGCCAGCAGCCAAGTCTTCCGGGACAGATTCCAAGAGACCCAGTACTTC	CASSQVFRDRFQETQYF	TRBV3-1	TRBJ2-5
TGTGCCAGCATAGGGGGGTCCTACGAGCAGTACTTC	CASIGGSYEQYF	TRBV27	TRBJ2-7
TGTGCCAGCAGCCAAGATCAGCGGACAGGGTATAGCAATCAGCCCCAGCATTTT	CASSQDQRTGYSNQPQHF	TRBV3-1	TRBJ1-5
TGTGCCAGCAGTTACATCAACCAACTTGGACAGGGGGCTGAAGCTTTCTTT	CASSYINQLGQGAEAFF	TRBV6-5	TRBJ1-1
TGTGCCAGCAGTTTGACTAGCGTGAGGTACAATGAGCAGTTCTTC	CASSLTSVRYNEQFF	TRBV12-3	TRBJ2-1
TGCGCCAGCAGCTTGATGAGAACCTATGGCTACACCTTC	CASSLMRTYGYTF	TRBV5-1	TRBJ1-2
TGTGCCAGTAGTATAGGGGCAGGGGGGGTCGGGTCTAATGGCTACACCTTC	CASSIGAGGVGSNGYTF	TRBV19	TRBJ1-2
TGCAGTGCTAGGGAAAGACCGGCCGCTTTCTTT	CSARERPAAFF	TRBV20-1	TRBJ1-1
TGTGCCAGCAGTTTAGCCACCGGGAATTCACCCCTCCACTTT	CASSLATGNSPLHF	TRBV27	TRBJ1-6
TGTGCTCTCCCGGGACTAGCGGGAGACGGCTACGAGCAGTACTTC	CALPGLAGDGYEQYF	TRBV3-1	TRBJ2-7
TGCAGTGCTAAAAGAATGAGACCGGGTTTTGGGAGCTCCTACGAGCAGTACTTC	CSAKRMRPGFGSSYEQYF	TRBV20-1	TRBJ2-7
TGTGCCAGCAGCTGGGCCCATCAAACGGCCTACGAGCAGTACTTC	CASSWAHQTAYEQYF	TRBV5-5	TRBJ2-7
TGTGCTAGTGAACAGGGCTCTAGGGGGTTAGCCAAAAACATTCAGTACTTC	CASEQGSRGLAKNIQYF	TRBV12-5	TRBJ2-4
TGTGCCAGCAGCCGCGCCGTCCTTTTTCAGCCCCAGCATTTT	CASSRAVLFQPQHF	TRBV3-1	TRBJ1-5
TGTGCCAGCAGCTTGACTGAGCAGTACTTC	CASSLTEQYF	TRBV28	TRBJ2-7
TGCAGGGGACCGGGACTAGCGGGAAGGAAAGATAGCACAGATACGCAGTATTTT	CRGPGLAGRKDSTDTQYF	TRBV20-1	TRBJ2-3
TGTGCCAGCCGGACAGGGGTTTCGCCCCAGCATTTT	CASRTGVSPQHF	TRBV13	TRBJ1-5
TGCAGTGCTGTCAAGGGCGAGCAGTTCTTC	CSAVKGEQFF	TRBV20-1	TRBJ2-1
TGTGCCAGCAGTGAATGGCCAGAAACTAGCGGGTGCACAGATACGCAGTATTTT	CASSEWPETSGCTDTQYF	TRBV25-1	TRBJ2-3
TGCAGTGCTAGAGACAACATGGGCGGCGTTTGGGACAGGGCCCGTACTGGGGCCAACGTCCTGACTTTC	CSARDNMGGVWDRARTGANVLTF	TRBV20-1	TRBJ2-6
TGTGCCAGCAGCTTGCCGACTTTGGTCAATGAGCAGTTCTTC	CASSLPTLVNEQFF	TRBV5-6	TRBJ2-1
TGTGCCACCATTTCAGGGCCAGATACGCAGTATTTT	CATISGPDTQYF	TRBV24-1	TRBJ2-3
TGTGCCAGCAGCCAGAAGTCGCATTTT	CASSQKSHF	TRBV5-6	TRBJ1-5
TGTGCCAGCAGCGCCAGGGGACTTAACACTGAAGCTTTCTTT	CASSARGLNTEAFF	TRBV2	TRBJ1-1
TGTGCCAGCAGCACCCGGACAGGAGGGGAAGCTTTCTTT	CASSTRTGGEAFF	TRBV13	TRBJ1-1
TGTGCCAGCAGTTACTCGACCTACCGGGACAGGGGTACAAAACTGTTTTTT	CASSYSTYRDRGTKLFF	TRBV6-5	TRBJ1-4
TGTGCCAGCAGCTTGGGGGGGGACAGCGGCTACGAGCAGTACTTC	CASSLGGDSGYEQYF	TRBV5-6	TRBJ2-7
TGCGCCAGCAGCCAAGACGCTCGGGTTGGAGGCTACACCTCCTACGAGCAGTACTTC	CASSQDARVGGYTSYEQYF	TRBV4-1	TRBJ2-7
TGTGCCAGCAGCCCGGGACAACCCACAGATACGCAGTATTTT	CASSPGQPTDTQYF	TRBV7-9	TRBJ2-3
TGTGCCAGCAGTTTATTCTGCAGTTACAGGGTCATAAGCAATCAGCCCCAGCATTTT	CASSLFCSYRVISNQPQHF	TRBV27	TRBJ1-5
TGTGCCACCAGTGATTTGATCAGAGGCGGAGGGGATGCCTACAATGAGCAGTTCTTC	CATSDLIRGGGDAYNEQFF	TRBV24-1	TRBJ2-1
TGTGCCAGCAGCGTGCGGACCTGGGGACTAGCAGATGAGCAGTTCTTC	CASSVRTWGLADEQFF	TRBV9	TRBJ2-1
TGCGCCAGCAGCTCAAAGGGGGCCTTACCCTACGAGCAGTACTTC	CASSSKGALPYEQYF	TRBV5-1	TRBJ2-7
TGTGCTAGTGGTTTGGTTAATCTTTGCGGGAACTACGAGCAGTACTTC	CASGLVNLCGNYEQYF	TRBV12-5	TRBJ2-7
TGTGCCAGCAGCCAGGTTTTCAGAAGGTTAGCTTTCTTT	CASSQVFRRLAFF	TRBV4-2	TRBJ1-1
TGTGCCAGCAGTGACCTAAAGCGGGCAGGCTACGAGCAGTACTTC	CASSDLKRAGYEQYF	TRBV6-4	TRBJ2-7
TGCAGTGCTTCACACTTATCGGAATTAGACAATGAGCAGTTCTTC	CSASHLSELDNEQFF	TRBV20-1	TRBJ2-1
TGTGCCAGCAGCCGTACCGTCAAAGGCGGCTACACCTTC	CASSRTVKGGYTF	TRBV7-9	TRBJ1-2
TGTGCCAGCAGGTGGACAGGACTCACAGATACGCAGTATTTT	CASRWTGLTDTQYF	TRBV6-1	TRBJ2-3
TGTGCCAGCTCCAGGGGGGATAGCAATCAGCCCCAGCATTTT	CASSRGDSNQPQHF	TRBV12-3	TRBJ1-5
TGTGCCCGGACTAGCGGGTTGGACGACTTC	CARTSGLDDF	TRBV27	TRBJ2-7
TGTGCTGACTCGTTTCCCGGGACTAGGAGCTACGAGCAGTACTTC	CADSFPGTRSYEQYF	TRBV12-5	TRBJ2-7
TGCGCCAGCAGGGGGGGCATAGCTCGATACACTGAAGCTTTCTTT	CASRGGIARYTEAFF	TRBV10-1	TRBJ1-1
TGTGCCAGCAGCGAGCAGGGAAAGTCAATCGGGAGCTCCTACGAGCAGTACTTC	CASSEQGKSIGSSYEQYF	TRBV13	TRBJ2-7
TGTGCCAGCAGTGACACTCGGGGGAATGAAAAACTGTTTTTT	CASSDTRGNEKLFF	TRBV6-4	TRBJ1-4
TGTGCCAGCAGCTCCGGCACCACGGGGTATGGCTACACCTTC	CASSSGTTGYGYTF	TRBV7-6	TRBJ1-2
TGTGCCAGCAGCGGGGCGGTTCCGAACTATGGCTACACCTTC	CASSGAVPNYGYTF	TRBV7-3	TRBJ1-2
TGTGCCAGTAACCACAGGGTATTATATGGCTACACCTTC	CASNHRVLYGYTF	TRBV19	TRBJ1-2
TGTGCCAGCAGTTACATCCCCGAAAAACTGTTTTTT	CASSYIPEKLFF	TRBV6-5	TRBJ1-4
TGCAGCGTTGCCAGGGTGGGACAGCCCCAGCATTTT	CSVARVGQPQHF	TRBV29-1	TRBJ1-5
TGTGCCAGCAGTGACCACGGGACTAGCGGGAGGTACGAGCAGTACTTC	CASSDHGTSGRYEQYF	TRBV6-4	TRBJ2-7
TGTGCCGAACGACCATTAAAACTGTTTTTT	CAERPLKLFF	TRBV11-2	TRBJ1-4
TGCGCCAGCAGCCGGTTGGGAGTCCAAGAGACCCAGTACTTC	CASSRLGVQETQYF	TRBV4-3	TRBJ2-5
TGTGCCAGCAGTGTGGGGGGCGGTAGCAATCAGCCCCAGCATTTT	CASSVGGGSNQPQHF	TRBV6-4	TRBJ1-5
TGTGCCAGCAGCTTAGACCGCTGGGGGAACACTGAAGCTTTCTTT	CASSLDRWGNTEAFF	TRBV7-9	TRBJ1-1
TGCGCCAGCAGCTTGGGTGGTCGGGGAGCTTTCTTT	CASSLGGRGAFF	TRBV5-1	TRBJ1-1
TGCGCCAGCAGTGAGTCGGGCCAGGGGACTTCCTACAATGAGCAGTTCTTC	CASSESGQGTSYNEQFF	TRBV10-1	TRBJ2-1
TGTGCCAGCAGCACGCCACGAGAGTGGATCACCGGGGAGCTGTTTTTT	CASSTPREWITGELFF	TRBV13	TRBJ2-2
TGTGCCAGCAGTTATTCAACGACAGGATCTTGTGAAAAACTGTTTTTT	CASSYSTTGSCEKLFF	TRBV6-9	TRBJ1-4
TGTGCCAGCAGCGGGCAGGGCCTTAGGGCTAACTATGGCTACACCTTC	CASSGQGLRANYGYTF	TRBV7-2	TRBJ1-2
TGTGCCAGCAGACTAGTCGTCGAGCAGTTCTTC	CASRLVVEQFF	TRBV27	TRBJ2-1
TGTGCCAGCAGTTCTGCTCCGGGACTAGCGGGCCAAGGTGGGGCCTACAATGAGCAGTTCTTC	CASSSAPGLAGQGGAYNEQFF	TRBV6-4	TRBJ2-1
TGTGCCAGCAGTGACTCCCAGACTAGCGGCCAATACAATGAGCAGTTCTTC	CASSDSQTSGQYNEQFF	TRBV6-4	TRBJ2-1
TGCAGCGTGTTTATTTCGGGACAGGGGGTCTACGAGCAGTACTTC	CSVFISGQGVYEQYF	TRBV29-1	TRBJ2-7
TGTGCCAGCAGCATATTGACAGGGATGGACGAGCAGTACTTC	CASSILTGMDEQYF	TRBV7-4	TRBJ2-7
TGTGAATGGACAGTTCTTAAGGGCTACACCTTC	CEWTVLKGYTF	TRBV6-2	TRBJ1-2
TGCAGCGTGGACTACCGCAGGGACGTTAATTACCCACATTCACCCCTCCACTTT	CSVDYRRDVNYPHSPLHF	TRBV29-1	TRBJ1-6
TGTGCCAGCAGTGACAGGGTCCCCAATGAGCAGTTCTTC	CASSDRVPNEQFF	TRBV27	TRBJ2-1
TGTGCCAGCAGCTCCCTGGGAGGGGGAGTGAACGGGAACACTGAAGCTTTCTTT	CASSSLGGGVNGNTEAFF	TRBV7-2	TRBJ1-1
TGTGCCAGCGCACACCTCCCAGAGACAGGGACCTCTGGGGCCAACGTCCTGACTTTC	CASAHLPETGTSGANVLTF	TRBV5-4	TRBJ2-6
TGCAGTGCGAGCTCAGGGGGAGTCGACGGAGGGAATCAGCCCCAGCATTTT	CSASSGGVDGGNQPQHF	TRBV20-1	TRBJ1-5
TGTGCCAGCAGCTTCCAATCGGGCACAGATACGCAGTATTTT	CASSFQSGTDTQYF	TRBV9	TRBJ2-3
TGTGCCACCAGTGATTTCAGGGAAAAGGCAAAACTGTTTTTT	CATSDFREKAKLFF	TRBV24-1	TRBJ1-4
TGTGCCAGAGGACAGAGCTCTGGAAACACCATATATTTT	CARGQSSGNTIYF	TRBV27	TRBJ1-3
TGTGCCAGCAGCTTACTCGGGGGTTCGACGGGCCCCTCTGGGGCCAACGTCCTGACTTTC	CASSLLGGSTGPSGANVLTF	TRBV7-3	TRBJ2-6
TGTGCCACCAGCAGAGACCCCGGACTAGCGGGGGGGCGGGGAGAGACCCAGTACTTC	CATSRDPGLAGGRGETQYF	TRBV15	TRBJ2-5
TGTGCCAGCAGGGGGTCAGGGAATGAAGCTTTCTTT	CASRGSGNEAFF	TRBV6-3	TRBJ1-1
TGTGCCAGCAGCTTCCGGGGGGGGTATCACACTGAAGCTTTCTTT	CASSFRGGYHTEAFF	TRBV7-3	TRBJ1-1
TGTGCCAGCAGCTTGGCCATAAGGAGGGGAAGCGAGCAGTACTTC	CASSLAIRRGSEQYF	TRBV5-6	TRBJ2-7
TGCGCCAGCAGCTTCAAGGGACAGGGGGCGACGGGTACGTGGAATGGAAACACCATATATTTT	CASSFKGQGATGTWNGNTIYF	TRBV5-1	TRBJ1-3
TGTGCCAGCCGAGGGAGGGACACTAAGGATCAGCCCCAGCATTTT	CASRGRDTKDQPQHF	TRBV5-6	TRBJ1-5
TGTGCCAGCAGCGGGGGGCAAGAGACCCAGTACTTC	CASSGGQETQYF	TRBV11-2	TRBJ2-5
TGTGCCAGCAGAGTTGACAGGGGCGCCGCTTTCTTT	CASRVDRGAAFF	TRBV5-6	TRBJ1-1
TGTGCCAGCCTTGGGAGTAGAGGTAAAGCGAACACCGGGGAGCTGTTTTTT	CASLGSRGKANTGELFF	TRBV9	TRBJ2-2
TGCAGTGCAGGACATAGCTACGAGCAGTACTTC	CSAGHSYEQYF	TRBV20-1	TRBJ2-7
TGTGCCAGCAGTACTTCGCAGGACTATGAGCAGTTCTTC	CASSTSQDYEQFF	TRBV6-1	TRBJ2-1
TGCGCCAAGGGACAGGGGAACACTGAAGCTTTCTTT	CAKGQGNTEAFF	TRBV4-1	TRBJ1-1
TGTGCCAGCAGTGAGGTATCCAGGGCCGGCAATGAGCAGTTCTTC	CASSEVSRAGNEQFF	TRBV6-1	TRBJ2-1
TGTGCCAGCATGGGGACTAGGTCCTACGAGCAGTACTTC	CASMGTRSYEQYF	TRBV6-4	TRBJ2-7
TGTGCCAGCAGTTCGCCTTCCCCGGAATCTTGCAATCAGCCCCAGCATTTT	CASSSPSPESCNQPQHF	TRBV27	TRBJ1-5
TGTGCCAGCACGAACAGATACGAGCAGTACTTC	CASTNRYEQYF	TRBV12-3	TRBJ2-7
TGTGCCAGCACAAGCAGGGTGGTCAATCAGCCCCAGCATTTT	CASTSRVVNQPQHF	TRBV28	TRBJ1-5
TGTGCCAGCTCACCGCGCTCTGGAAACACCATATATTTT	CASSPRSGNTIYF	TRBV18	TRBJ1-3
TGTGCCAACGTAGTAGCTACCTACGAGCAGTACTTC	CANVVATYEQYF	TRBV5-4	TRBJ2-7
TGTGCCAGCAGTGAATTAGGTGCACGGGGGGGGAGTGACACTGAAGCTTTCTTT	CASSELGARGGSDTEAFF	TRBV25-1	TRBJ1-1
TGCAGTGCCCTAACGGTTACTATTGGGAATGAAAAACTGTTTTTT	CSALTVTIGNEKLFF	TRBV20-1	TRBJ1-4
TGTGCCAGCTCACAGGCAGAGAGGAGTTTCACCATATATTTT	CASSQAERSFTIYF	TRBV18	TRBJ1-3
TGCAGTGCTACATGTGAAGGGGGGACAGATACGCAGTATTTT	CSATCEGGTDTQYF	TRBV20-1	TRBJ2-3
TGTGCCAGCAGATACAGGGGGCCACTATGTGATACTGAAGCTTTCTTT	CASRYRGPLCDTEAFF	TRBV6-4	TRBJ1-1
TGTGCCAGCAGCTTAGGCATGCTGGGAGGGGCTACATATAGCAATCAGCCCCAGCATTTT	CASSLGMLGGATYSNQPQHF	TRBV7-9	TRBJ1-5
TGTGCCAGCAGCTTAGATTTTTTACGGGAGGAAAGCACAGATACGCAGTATTTT	CASSLDFLREESTDTQYF	TRBV11-2	TRBJ2-3
TGTGCCAGCAGCCGGGACAGGGGCAATTCACCCCTCCACTTT	CASSRDRGNSPLHF	TRBV11-2	TRBJ1-6
TGTGCCAGCAGTTACTCGAACCGGGACGAGCAGTACTTC	CASSYSNRDEQYF	TRBV6-6	TRBJ2-7
TGCGCCAGCAGCTTGGAGCCTGAGCAGTTCTTC	CASSLEPEQFF	TRBV5-1	TRBJ2-1
TGCAGTGCTAGACGTAAGCAGAGTATACGCTACTATGGCTACACCTTC	CSARRKQSIRYYGYTF	TRBV20-1	TRBJ1-2
TGTGCCACAGGAAAAGTTTCCTACGAGCAGTACTTC	CATGKVSYEQYF	TRBV7-7	TRBJ2-7
TGTGCCTGGAAAGCGGGCTCCTACGAGCAGTACTTC	CAWKAGSYEQYF	TRBV30	TRBJ2-7
TGTGCCAGCATGCACCGGGACAGGGCCAGGTCCGGGGAGCTGTTTTTT	CASMHRDRARSGELFF	TRBV7-9	TRBJ2-2
TGTGCCAGCAGCCGCCAGCTTACTGAAGCTTTCTTT	CASSRQLTEAFF	TRBV5-6	TRBJ1-1
TGTGCCTGGAGGGGGGGCCTATACGAGCAGTACTTC	CAWRGGLYEQYF	TRBV30	TRBJ2-7
TGCAGTGCTAGAGATACGACAGGGCCGATGCCCCAGCATTTT	CSARDTTGPMPQHF	TRBV20-1	TRBJ1-5
TGTGCCAAAGCCGGGGGGGCCTCTGGAAACACCATATATTTT	CAKAGGASGNTIYF	TRBV18	TRBJ1-3
TGTGCCAGTAGTATAAGCAGGTACAATGAGCAGTTCTTC	CASSISRYNEQFF	TRBV19	TRBJ2-1
TGCAGTGCTTGGAGAGGGCCCTCCTACGAGCAGTACTTC	CSAWRGPSYEQYF	TRBV20-1	TRBJ2-7
TGCGCCAGCAGTGAGAGCGGGACAACTATTGGTGAAGCTTTCTTT	CASSESGTTIGEAFF	TRBV10-2	TRBJ1-1
TGTGCCAGCAGCCGCGCAAGGACTACTAACTATGGCTACACCTTC	CASSRARTTNYGYTF	TRBV13	TRBJ1-2
TGTGCCAGCAGCTTCCCCAACAGTGGGAACACTGAAGCTTTCTTT	CASSFPNSGNTEAFF	TRBV7-9	TRBJ1-1
TGTGCTCAGGACGAGCAGTACTTC	CAQDEQYF	TRBV2	TRBJ2-7
TGTGCCTGGAGCCGGGACAGGGGAAGGCAGCCCCAGCATTTT	CAWSRDRGRQPQHF	TRBV30	TRBJ1-5
TGTGCCATCAGTGAGGGGGACGCGAGGTTGAACTCCTACAATGAGCAGTTCTTC	CAISEGDARLNSYNEQFF	TRBV10-3	TRBJ2-1
TGTGCCAGCAGCTTAGCCAGGGTTTCCTACAATGAGCAGTTCTTC	CASSLARVSYNEQFF	TRBV7-9	TRBJ2-1
TGTGCCAGCAGCCTTCTGGGGGTGGCAACTAATGAAAAACTGTTTTTT	CASSLLGVATNEKLFF	TRBV13	TRBJ1-4
TGTGCCAGCAGCCGGGGGTGGTCCTACGAGCAGTACTTC	CASSRGWSYEQYF	TRBV7-2	TRBJ2-7
TGTGCCAGCAGCTTAAGGTTGTCCCCGGGACTAGCGGAGTACAATGAGCAGTTCTTC	CASSLRLSPGLAEYNEQFF	TRBV7-9	TRBJ2-1
TGTGCCAGTAGTATAGGAGTAAATGGCAATGAGCAGTTCTTC	CASSIGVNGNEQFF	TRBV19	TRBJ2-1
TGCAGCGAGTCCGACAGGGGCCGGTGTGAAGCTTTCTTT	CSESDRGRCEAFF	TRBV29-1	TRBJ1-1
TGTGCCAGCAGCCCGTCCTTACTACGCACTGAAGCTTTCTTT	CASSPSLLRTEAFF	TRBV5-6	TRBJ1-1
TGTGCCACCAGTGGCGGGAGAAGGAAAGATACGCAGTATTTT	CATSGGRRKDTQYF	TRBV24-1	TRBJ2-3
TGTGCCAGCAGCGCCAGGATCATTGAGCAGTTCTTC	CASSARIIEQFF	TRBV7-3	TRBJ2-1
TGCGCCAGCAGTCCGGGACAGAAAAGCAATCAGCCCCAGCATTTT	CASSPGQKSNQPQHF	TRBV5-1	TRBJ1-5
TGTGCCAGCAGTAGTAAGAGCGGGATACGTTACGGCTACACCTTC	CASSSKSGIRYGYTF	TRBV12-3	TRBJ1-2
TGTGCCAGCTCAACCTCGGGGGTAGGGCACAATGAGCAGTTCTTC	CASSTSGVGHNEQFF	TRBV6-3	TRBJ2-1
TGTGCCAGCAGCGTAGCGGGGTGGGGAAAACTGTTTTTT	CASSVAGWGKLFF	TRBV9	TRBJ1-4
TGTGCCAGCAGCTTTCGCAGGGGGTGTAATCAGCCCCAGCATTTT	CASSFRRGCNQPQHF	TRBV7-2	TRBJ1-5
TGTGCCAGCAGCTTACTTGACCTCAGGGGGTGGACCGGGGAGCTGTTTTTT	CASSLLDLRGWTGELFF	TRBV7-9	TRBJ2-2
TGTGCCTGGAGTGTGGGGGACCCTTTGAATCAGCCCCAGCATTTT	CAWSVGDPLNQPQHF	TRBV30	TRBJ1-5
TGTGCCAGCAGCTCATATCGGGACAATGAGCAGTTCTTC	CASSSYRDNEQFF	TRBV6-1	TRBJ2-1
TGCATGTCCGGCGGGGATCCTAACTATGGCTACACCTTC	CMSGGDPNYGYTF	TRBV29-1	TRBJ1-2
TGCAGTGCTAAAAGGTCGGGATCCGGATCCTACGAGCAGTACTTC	CSAKRSGSGSYEQYF	TRBV20-1	TRBJ2-7
TGCGCCAGCACTGACCCAAATGAGCAGTTCTTC	CASTDPNEQFF	TRBV4-3	TRBJ2-1
TGCAGTGCTAGCCAGGGGGGGGCCGGGCAGGATTCGTTTCGGCACACCGGGGAGCTGTTTTTT	CSASQGGAGQDSFRHTGELFF	TRBV20-1	TRBJ2-2
TGTGCCAGCAGGTTCTGGCCAGGGGGGGGCTATGGCTACACCTTC	CASRFWPGGGYGYTF	TRBV7-9	TRBJ1-2
TGTGCCACCCGGCCGAAGAGGGCCCATCAGCCCCAGCATTTT	CATRPKRAHQPQHF	TRBV24-1	TRBJ1-5
TGTGCCAGCAGTCCGAAGGGTAACTTAGCCCTCCACTTT	CASSPKGNLALHF	TRBV13	TRBJ1-6
TGTGCCAGCAGTAAGTTACGGGACTCCTACAATGAGCAGTTCTTC	CASSKLRDSYNEQFF	TRBV6-2	TRBJ2-1
TGCGCCAGCAGCTTGGCCCCTCTAGGGTGCGGGGAGCTGTTTTTT	CASSLAPLGCGELFF	TRBV5-1	TRBJ2-2
TGTGCCAGCAGTTACGTCTGTACAGTCATAGGCTCCTACAATGAGCAGTTCTTC	CASSYVCTVIGSYNEQFF	TRBV6-5	TRBJ2-1
TGTGCCATCAGTGAGGACAGTCGCGGGGAGCTGTTTTTT	CAISEDSRGELFF	TRBV10-3	TRBJ2-2
TGTGCCAAGAGCCGGGACAGGGGTAGCTCTGGGGCCAACGTCCTGACTTTC	CAKSRDRGSSGANVLTF	TRBV6-5	TRBJ2-6
TGTGCCAGCAGTGACTCCCGTATCCGGGGCACCGGGGAGCTGTTTTTT	CASSDSRIRGTGELFF	TRBV6-4	TRBJ2-2
TGTGCCAGCTGGGGGCGGCCCGGGGGGAGAACTGAAGCTTTCTTT	CASWGRPGGRTEAFF	TRBV27	TRBJ1-1
TGTGCCAGCAGTGATGGTAGGAGGGGAGATAGCAATGAGCAGTTCTTC	CASSDGRRGDSNEQFF	TRBV6-1	TRBJ2-1
TGTGCCAGCGAGGTTTGTGGGGGCGGGATCTCTCGTTACGAGCAGTACTTC	CASEVCGGGISRYEQYF	TRBV6-2	TRBJ2-7
TGTGCCACCAGTGATTCCCCGTCTTATTTTAATCGCAATCAGCCCCAGCATTTT	CATSDSPSYFNRNQPQHF	TRBV24-1	TRBJ1-5
TGTGCCAGCTCACCACCTAGCCCCCGCGACAGGGTCGGGGGCACAGATACGCAGTATTTT	CASSPPSPRDRVGGTDTQYF	TRBV18	TRBJ2-3
TGTGCCAGCAGCGCAGATAGGGCTCTCTCCGGCTCTGGAAACACCATATATTTT	CASSADRALSGSGNTIYF	TRBV11-2	TRBJ1-3
TGCAGCAAATCCCGAGGCCCCACAGATACGCAGTATTTT	CSKSRGPTDTQYF	TRBV29-1	TRBJ2-3
TGCAGTGCCCGGGCGGAATGTGGAAGCTCCTACGAGCAGTACTTC	CSARAECGSSYEQYF	TRBV20-1	TRBJ2-7
TGTGCCAGCAGCGGGGACAGGGGGCTTGGACGGGGGAACACTGAAGCTTTCTTT	CASSGDRGLGRGNTEAFF	TRBV13	TRBJ1-1
TGCGCCAGCAGCTCCACGCGGAGCTCTGGGGCCAACGTCCTGACTTTC	CASSSTRSSGANVLTF	TRBV5-1	TRBJ2-6
TGCGCCAGCAGCAGCTTC	CASSSF	TRBV10-1	TRBJ2-7
TGCGCCAGCAGCCTTTGGGGTTACCGGACAGGGAGCTCCTACGAGCAGTACTTC	CASSLWGYRTGSSYEQYF	TRBV4-1	TRBJ2-7
TGTGCCAGCAGCTCTCTGGGAGGGAGTAGCACAGATACGCAGTATTTT	CASSSLGGSSTDTQYF	TRBV11-3	TRBJ2-3
TGTGCCAGCAGTCACCTAAAACTAGATCGAAAACGCCCTGCCTACAATGAGCAGTTCTTC	CASSHLKLDRKRPAYNEQFF	TRBV6-2	TRBJ2-1
TGTGCCAGCAAGCGTGACAGTGAGAACACTGAAGCTTTCTTT	CASKRDSENTEAFF	TRBV6-1	TRBJ1-1
TGTGCCAGCAGGTCAAGGGAAAACTATGGCTACACCTTC	CASRSRENYGYTF	TRBV6-8	TRBJ1-2
TGCGCCAGCCGCGGGAGTGGTAGATGCAATCAGCCCCAGCATTTT	CASRGSGRCNQPQHF	TRBV5-1	TRBJ1-5
TGTGCCAGTAAACGGGGGGGGAAACTCTCTGGGGCCAACGTCCTGACTTTC	CASKRGGKLSGANVLTF	TRBV19	TRBJ2-6
TGTGCCAGCAGTTCCCGCCCCCGGGAGTATCATTGTGTTGAGCAGTTCTTC	CASSSRPREYHCVEQFF	TRBV27	TRBJ2-1
TGTGCCAGCTCACTTGTCCAAAGGGGGGGACAGGTTGATTTATTCTATAATTCACCCCTCCACTTT	CASSLVQRGGQVDLFYNSPLHF	TRBV18	TRBJ1-6
TGTGCCAGCAGTTACAAACAGGGTTTATTGAACACTGAAGCTTTCTTT	CASSYKQGLLNTEAFF	TRBV6-6	TRBJ1-1
TGCAGTGCTGAAGAACGGGGGGAGAACACTGAAGCTTTCTTT	CSAEERGENTEAFF	TRBV20-1	TRBJ1-1
TGTGCCAGCAGACTAACTAGACTAGCCACAGATACGCAGTATTTT	CASRLTRLATDTQYF	TRBV7-3	TRBJ2-3
TGTGCCAGCAGCTTGGGGAGGCATTGTGCACTTGACACTGAAGCTTTCTTT	CASSLGRHCALDTEAFF	TRBV5-6	TRBJ1-1
TGTGCCAGCAGCGACGGGCGCCCAGGGGGCGCATTTGCGATCGGGGAGCTGTTTTTT	CASSDGRPGGAFAIGELFF	TRBV7-3	TRBJ2-2
TGTGCCAGCAGTTTCCACTTCGGGGACAGGGGCGAGAACTCCTACAATGAGCAGTTCTTC	CASSFHFGDRGENSYNEQFF	TRBV27	TRBJ2-1
TGTGCCAGCAGCTCTAAAAATGAGCAGTTCTTC	CASSSKNEQFF	TRBV7-2	TRBJ2-1
TGTGCCAGCAGGCGGAGTTTTCGGGGGCTTGTTACTCAGCCCCAGCATTTT	CASRRSFRGLVTQPQHF	TRBV6-5	TRBJ1-5
TGTGCCAGCAGTGCGATTGGGGGGGGGCAGTATTTT	CASSAIGGGQYF	TRBV6-1	TRBJ2-3
TGTGCCAGCAGTTTAGACCGGCAGGGACTCGAGCAGTACTTC	CASSLDRQGLEQYF	TRBV12-4	TRBJ2-7
TGCAGCGCCACCAAGACTAGTGCCGGCACAGATACGCAGTATTTT	CSATKTSAGTDTQYF	TRBV29-1	TRBJ2-3
TGTGCCAGCAGCTTGCGAGCCAGGGGCTCTAGGGGGAAACAGCCCCAGCATTTT	CASSLRARGSRGKQPQHF	TRBV5-5	TRBJ1-5
TGTGCCAGCAGCCAGGCGGGGGCTTCCACTGAAGCTTTCTTT	CASSQAGASTEAFF	TRBV14	TRBJ1-1
TGTGCCAGCAGCGAAACGCGACAGGGGGATGGTACTGGAAACACCATATATTTT	CASSETRQGDGTGNTIYF	TRBV28	TRBJ1-3
TGTGCCCTCAGGTACGAGCAGTACTTC	CALRYEQYF	TRBV6-2	TRBJ2-7
TGTGCCACCAGTGAGTCCCGGGGGGCCTACGAGCAGTACTTC	CATSESRGAYEQYF	TRBV24-1	TRBJ2-7
TGTGCCAGTAGTATATCCGGGGAGGGGACTCTCTACGAGCAGTACTTC	CASSISGEGTLYEQYF	TRBV19	TRBJ2-7
TGTGCCAGCAGCGAAGGGGGGGCCACAAATGGCTACAATGAGCAGTTCTTC	CASSEGGATNGYNEQFF	TRBV7-9	TRBJ2-1
TGCGCCAGCAGCTTGGTGAATAGCAATCAGCCCCAGCATTTT	CASSLVNSNQPQHF	TRBV5-1	TRBJ1-5
TGTGCCAGCAGCTTAAAGTCCGGGACTAGCGGGAGGTGGCAAAACATTCAGTACTTC	CASSLKSGTSGRWQNIQYF	TRBV11-2	TRBJ2-4
TGTGCCAGCAGCTTAGCAGACCCTACTAGAGATAGCAAGGGGAACGGGGAGCTGTTTTTT	CASSLADPTRDSKGNGELFF	TRBV7-2	TRBJ2-2
TGTGCCAGCAGCGTAGCCGGCGGGACTAGCGGTAGGTATGAGCAGTTCTTC	CASSVAGGTSGRYEQFF	TRBV9	TRBJ2-1
TGTGCCAGCAGCAGTCGTGCAGGAGGGTCCTACGAGCAGTACTTC	CASSSRAGGSYEQYF	TRBV7-6	TRBJ2-7
TGTGCTAGTGGTTTGGTACTCGATTCGGACCGAGAGACCCAGTACTTC	CASGLVLDSDRETQYF	TRBV12-5	TRBJ2-5
TGTGCCACCAGCAGAGACAGGGGCTCTGGGGCCAACGTCCTGACTTTC	CATSRDRGSGANVLTF	TRBV15	TRBJ2-6
TGTGCCAGCAGCTTAGGTTTCCCTGAGGGACTTTGGGTGGATGACTACGAGCAGTACTTC	CASSLGFPEGLWVDDYEQYF	TRBV7-9	TRBJ2-7
TGTGCCAGCAAGGGACAGGGCGGTGGCTACACCTTC	CASKGQGGGYTF	TRBV6-4	TRBJ1-2
TGTGCCAGCAGCTTCGGGACAGCGATCAATCAGCCCCAGCATTTT	CASSFGTAINQPQHF	TRBV7-9	TRBJ1-5
TGTGCCAGCAACCGACTAGCGGGAGGCTCCTACGAGCAGTACTTC	CASNRLAGGSYEQYF	TRBV6-4	TRBJ2-7
TGTGCCAGCTCGGACAGGGAAGCGAACACTGAAGCTTTCTTT	CASSDREANTEAFF	TRBV12-3	TRBJ1-1
TGTGCCAGCAGTGATTCGAGATCCGACAATGAGCAGTTCTTC	CASSDSRSDNEQFF	TRBV2	TRBJ2-1
TGTGCCAGCTGGGATGTCCTCAACAGCGAGCTTTACTCCTATAATTCACCCCTCCACTTT	CASWDVLNSELYSYNSPLHF	TRBV6-3	TRBJ1-6
TGTGCCAGCAGTTTAGCTAAGGACAGGGTCGATGGCTACACCTTC	CASSLAKDRVDGYTF	TRBV12-4	TRBJ1-2
TGTGCCAGCAGCGGGACTAGCGGGGGGGCTACAGACTCCTACGAGCAGTACTTC	CASSGTSGGATDSYEQYF	TRBV11-1	TRBJ2-7
TGTGCCAGCAGCAGCCTAGCGGAAGCCTACGAGCAGTACTTC	CASSSLAEAYEQYF	TRBV7-4	TRBJ2-7
TGTGCCAGCAGAACGGGACAGGGGTACGGCGCTAACTATGGCTACACCTTC	CASRTGQGYGANYGYTF	TRBV11-2	TRBJ1-2
TGTGCCAGCAGCAGCTCCTGGACTAGCGCGGAGGGTAGCTCCTACAATGAGCAGTTCTTC	CASSSSWTSAEGSSYNEQFF	TRBV7-3	TRBJ2-1
TGTGCCAGCAGCTTACCGAACATGCTGCAGGGTAGGGTACGGACTGAAGCTTTCTTT	CASSLPNMLQGRVRTEAFF	TRBV7-7	TRBJ1-1
TGCGCCAGCAGCCAAGAGGGGGAGAAGATCGGGGGGGTCTCCTACAATGAGCAGTTCTTC	CASSQEGEKIGGVSYNEQFF	TRBV4-1	TRBJ2-1
TGCAGCGTTGCTCCCCGCGGGATTAGCTCCTACGAGCAGTACTTC	CSVAPRGISSYEQYF	TRBV29-1	TRBJ2-7
TGTGCCAGCCATGACAGTATTCCCTACGAGCAGTACTTC	CASHDSIPYEQYF	TRBV6-2	TRBJ2-7
TGTGCCAGCAGCTTATTCCTCGGTCGAACCGCTGAAAAACTGTTTTTT	CASSLFLGRTAEKLFF	TRBV11-1	TRBJ1-4
TGTGCTAGCGCCATAAACGCAGAGACCCAGTACTTC	CASAINAETQYF	TRBV7-7	TRBJ2-5
TGCAGTGCCCGCACTAGCGGGGAAAGGTGGCTCAAAAACATTCAGTACTTC	CSARTSGERWLKNIQYF	TRBV20-1	TRBJ2-4
TGCAGTGCAAGACAGGGCCGCGGCACTGAAGCTTTCTTT	CSARQGRGTEAFF	TRBV20-1	TRBJ1-1
TGTGCCAGCAGTGATCCCGACATCTGGCTTCAGCCCCAGCATTTT	CASSDPDIWLQPQHF	TRBV6-4	TRBJ1-5
TGTGCTAGCCAGACAGGGGGCAATCAGCCCCAGCATTTT	CASQTGGNQPQHF	TRBV12-5	TRBJ1-5
TGCGCCAGCAGCTTGGAAAGACTAGCGGGCAATGAGCAGTTCTTC	CASSLERLAGNEQFF	TRBV5-1	TRBJ2-1
TGTGCCACCAGTGAGATCGCGGTTACAGGGTCTGACCCAAACTGCAATCAGCCCCAGCATTTT	CATSEIAVTGSDPNCNQPQHF	TRBV24-1	TRBJ1-5
TGTGCCAGTAGTATCTCTATTGTGATTAGCAATCAGCCCCAGCATTTT	CASSISIVISNQPQHF	TRBV19	TRBJ1-5
TGTGCCATCAGTGAGGACAGGCCTGAAGCTTTCTTT	CAISEDRPEAFF	TRBV10-3	TRBJ1-1
TGTGCCACCAGTGTTAGCAGTACGGGGGGCTACGAGCAGTACTTC	CATSVSSTGGYEQYF	TRBV24-1	TRBJ2-7
TGTGCCAGTCACGGACAGGGTTCAGGGTTTGCAACTAATGAAAAACTGTTTTTT	CASHGQGSGFATNEKLFF	TRBV19	TRBJ1-4
TGTGCCAGCAGCCAACGAAGGTGCAATCAGCCCCAGCATTTT	CASSQRRCNQPQHF	TRBV3-1	TRBJ1-5
TGTGCCAGCAGCCCCCCCGGGACAGGGGGGAGGAGTAATGAAAAACTGTTTTTT	CASSPPGTGGRSNEKLFF	TRBV9	TRBJ1-4
TGTGCCAGCCCTCCACGTTTGGTCTCAGGGGCTGAAGCTTTCTTT	CASPPRLVSGAEAFF	TRBV11-3	TRBJ1-1
TGCGCCAATCGGGACAGCTTCTACGAGCAGTACTTC	CANRDSFYEQYF	TRBV10-1	TRBJ2-7
TGTGCCAGCAGCTTACCCCGAGCGGACCACTACGAGCAGTACTTC	CASSLPRADHYEQYF	TRBV7-2	TRBJ2-7
TGTGCCAGCAGCATGAGGGACAGGGCTGACCACGAGCAGTACTTC	CASSMRDRADHEQYF	TRBV7-9	TRBJ2-7
TGTGCCAGCAGCCGCGGGAGGAGGGAGGGTAGGTCCTACAATGAGCAGTTCTTC	CASSRGRREGRSYNEQFF	TRBV7-2	TRBJ2-1
TGCGCCAGCAGTGACTGGGGGGGCCCACACGAGCAGTACTTC	CASSDWGGPHEQYF	TRBV10-1	TRBJ2-7
TGCGCCAGCAGCCCCCCGGGACTAGCGGGAGTTCTACAGTTTCTAAACTATGGCTACACCTTC	CASSPPGLAGVLQFLNYGYTF	TRBV5-1	TRBJ1-2
TGTGCCAGCAGTGCACAGGGCCTAGGCTATGGCTACACCTTC	CASSAQGLGYGYTF	TRBV27	TRBJ1-2
TGTGCTAGCAGCGATTATGTTAATAGTAAACAAGAGGAGCTGTTTTTT	CASSDYVNSKQEELFF	TRBV7-7	TRBJ2-2
TGTGCCAGCAGCTTCCTCCGGACCGATGAGCAGTTCTTC	CASSFLRTDEQFF	TRBV11-2	TRBJ2-1
TGTGCCAGCAGTTACTCGAGGGGGATGTCTGGAAACACCATATATTTT	CASSYSRGMSGNTIYF	TRBV6-6	TRBJ1-3
TGTGCCAGCAGTTTGGGACTCGTAGAAAGGCAGCCCCAGCATTTT	CASSLGLVERQPQHF	TRBV6-3	TRBJ1-5
TGTGCCAGCAGCGACTTGCACCCTAGACAGGCCGTCCAGCACTCAGCCACTGAAGCTTTCTTT	CASSDLHPRQAVQHSATEAFF	TRBV7-4	TRBJ1-1
TGTGCCAGCAGCACACGCCCTAGCGGGGAGACGAACACCGGGGAGCTGTTTTTT	CASSTRPSGETNTGELFF	TRBV13	TRBJ2-2
TGTGCCAGCAGGCTAGGGGACAGGGAGTATTTT	CASRLGDREYF	TRBV27	TRBJ2-3
TGTGCTAGCAGCTTAGCAGAAGGACGGGGAATGAACACTGAAGCTTTCTTT	CASSLAEGRGMNTEAFF	TRBV7-7	TRBJ1-1
TGTGCCAGCAGTTATGGGGGGGCCAGGGATTTCCTGAATGAAAAACTGTTTTTT	CASSYGGARDFLNEKLFF	TRBV6-3	TRBJ1-4
TGTGCCAGCAGTCGTCTCTACACAGATACGCAGTATTTT	CASSRLYTDTQYF	TRBV6-2	TRBJ2-3
TGTGCCAGCAGCCAGGGCGGGAGGGCGACCTACAATGAGCAGTTCTTC	CASSQGGRATYNEQFF	TRBV5-6	TRBJ2-1
TGCGCCAGCAGCCAAGTTGGTAGAACAGAGACCCAGTACTTC	CASSQVGRTETQYF	TRBV4-1	TRBJ2-5
TGTGCCAGCAGCTTAACGGGGACCCGAGATGGCTACACCTTC	CASSLTGTRDGYTF	TRBV7-3	TRBJ1-2
TGTGCCAGCAGTTCCGGACACGAGCAGTACTTC	CASSSGHEQYF	TRBV6-2	TRBJ2-7
TGTGCCAGCAGCCAAGTGAGGGGCGACCGAAACACTGAAGCTTTCTTT	CASSQVRGDRNTEAFF	TRBV14	TRBJ1-1
TGCAGCGTTGAAGCAGAAGGAGTGCATGAGCAGTTCTTC	CSVEAEGVHEQFF	TRBV29-1	TRBJ2-1
TGTGCCAGCAGCCAAGCCGCAGCGCTCCCTGAAGCTTTCTTT	CASSQAAALPEAFF	TRBV3-1	TRBJ1-1
TGTGCCAGCCAGGGACGGGCACGGCTACCCCTGAGCTCCTATAATTCACCCCTCCACTTT	CASQGRARLPLSSYNSPLHF	TRBV7-9	TRBJ1-6
TGTGCCAGCATCGTAGGTCGTGCCTCCTACGAGCAGTACTTC	CASIVGRASYEQYF	TRBV14	TRBJ2-7
TGTGCCAGCAGTGTAGGTTCGGGGAAAACACAGCAGCCCCAGCATTTT	CASSVGSGKTQQPQHF	TRBV28	TRBJ1-5
TGTGCCAGCAACCCGGGACTAGCGGGGGGGCCAGGGAACATTCAGTACTTC	CASNPGLAGGPGNIQYF	TRBV11-1	TRBJ2-4
TGTGCCAGCAGCTTGGAAACCCACGGGATCAATGAGCAGTTCTTC	CASSLETHGINEQFF	TRBV5-5	TRBJ2-1
TGTGCTAGTGGTTTGGTCCCCCGGGACAGACAGGGTCACTCTGGGGCCAACGTCCTGACTTTC	CASGLVPRDRQGHSGANVLTF	TRBV12-5	TRBJ2-6
TGTGCCAGCAGCGTCAGTGGGGGCCTAAGCACAGATACGCAGTATTTT	CASSVSGGLSTDTQYF	TRBV9	TRBJ2-3
TGTGCCAGCAGTATGGGGAATCCCGACGGGGACAGCGAGACCCAGTACTTC	CASSMGNPDGDSETQYF	TRBV12-3	TRBJ2-5
TGTGCCAGCAGTTACATACGGGACAGGGGAGGCACTGAAGCTTTCTTT	CASSYIRDRGGTEAFF	TRBV12-3	TRBJ1-1
TGTGCCAGCAGTTTCAGGACAGGTCCCACCGGGGAGCTGTTTTTT	CASSFRTGPTGELFF	TRBV27	TRBJ2-2
TGTGCCAGCAGCTCCTGCGACCAACTAGCGGGAGGTTTTGACTACAATGAGCAGTTCTTC	CASSSCDQLAGGFDYNEQFF	TRBV7-2	TRBJ2-1
TGTGCCAGCAGCCCCAATGCCACGACTAGCGGGCGCCAAGAGACCCAGTACTTC	CASSPNATTSGRQETQYF	TRBV7-9	TRBJ2-5
TGTGCCACCAGTGACCAGAGGGACAAGCCCCAGCATTTT	CATSDQRDKPQHF	TRBV24-1	TRBJ1-5
TGTGCCACCAGTGATTTGTCCGGGACAGGGCTAGGTGACGAGCAGTACTTC	CATSDLSGTGLGDEQYF	TRBV24-1	TRBJ2-7
TGTGCCAGCAGTTTAGACGCCCATACGCAGTATTTT	CASSLDAHTQYF	TRBV27	TRBJ2-3
TGCGCCAGCAGCTTGAGTGGGGGTGCCACTGAAGCTTTCTTT	CASSLSGGATEAFF	TRBV5-1	TRBJ1-1
TGTGCCTGGAGTGGGAAAGAGTATTGCAAGGGTTGGACAGGGCCTTCCGAGACCCAGTACTTC	CAWSGKEYCKGWTGPSETQYF	TRBV30	TRBJ2-5
TGTGCCTGGCCCGGGACAGCTAGATTGGGGGGGCAAATCAATGAGCAGTTCTTC	CAWPGTARLGGQINEQFF	TRBV6-4	TRBJ2-1
TGCAGTGCGGCAACCGCGTATGGCTACACCTTC	CSAATAYGYTF	TRBV20-1	TRBJ1-2
TGTGCCAGCAGTGAGCCCCCGAGGGGGGGGGCTCGGTTCTACAATGAGCAGTTCTTC	CASSEPPRGGARFYNEQFF	TRBV6-4	TRBJ2-1
TGTGCCAGCAGCTCCGGGACAGGGACTTCTAATGAAAAACTGTTTTTT	CASSSGTGTSNEKLFF	TRBV7-9	TRBJ1-4
TGTGCCAGCAGGTCTAAAGGGACAATAGTGGTCTCTGGAAACACCATATATTTT	CASRSKGTIVVSGNTIYF	TRBV2	TRBJ1-3
TGTGCCAGCAGCACCTCCCACGCCGTATTTCGGGACAGCTCTGGGGCCAACGTCCTGACTTTC	CASSTSHAVFRDSSGANVLTF	TRBV13	TRBJ2-6
TGCGCCAGCAGCCAAGAATTACGGACCCAGTACTTC	CASSQELRTQYF	TRBV4-1	TRBJ2-5
TGCGCCAGCAGCTGCCCACGGGCAGGTGGAAACACCATATATTTT	CASSCPRAGGNTIYF	TRBV5-1	TRBJ1-3
TGTGCCAGCAGGGGCAGGGGGGCGAACACCGGGGAGCTGTTTTTT	CASRGRGANTGELFF	TRBV6-3	TRBJ2-2
TGTGCCTGGAGTGAGGGGGCTCTAAACTCCTACGAGCAGTACTTC	CAWSEGALNSYEQYF	TRBV30	TRBJ2-7
TGTGCCAGCAGCCGACAGGCCATAGGCTGGAACTATGGCTACACCTTC	CASSRQAIGWNYGYTF	TRBV6-8	TRBJ1-2
TGTGCCACCAGTGATAAAACGACAGGGGGCTTCGCTGAGCCCTATGGCTACACCTTC	CATSDKTTGGFAEPYGYTF	TRBV24-1	TRBJ1-2
TGCTTGGAGGGACAGGGGGGGGGCTCCTACAATGAGCAGTTCTTC	CLEGQGGGSYNEQFF	TRBV20-1	TRBJ2-1
TGCAGCGTTGCAGGGAAGGATGACGAGCAGTACTTC	CSVAGKDDEQYF	TRBV29-1	TRBJ2-7
TGTGCCAGCAGCTTGGGGAGGACAGGGGCTCGAGGTGAAAAACTGTTTTTT	CASSLGRTGARGEKLFF	TRBV7-4	TRBJ1-4
TGTGCCAGCAGCGGGGGCCCCTACACCTTC	CASSGGPYTF	TRBV7-3	TRBJ1-2
TGTGCCAGCAGCTTAGGAAACAGAGGGACCCCTTACCAGAGCACAGATACGCAGTATTTT	CASSLGNRGTPYQSTDTQYF	TRBV7-6	TRBJ2-3
TGTGCCAGCAGACAGGGTAATGAGCAGTTCTTC	CASRQGNEQFF	TRBV12-3	TRBJ2-1
TGCGCCAGCAGCTTGGCTCCAAGGACTAGCGGGAGGGCAAGGAGAGCCAAAAACATTCAGTACTTC	CASSLAPRTSGRARRAKNIQYF	TRBV5-1	TRBJ2-4
TGTGCCAGCAGCTTAGACCTTCGGGACAGGGCCGCTTTCTTT	CASSLDLRDRAAFF	TRBV11-2	TRBJ1-1
TGTGCCAGCAGTTACGGGAGCGGGAGACAAGAGACCCAGTACTTC	CASSYGSGRQETQYF	TRBV6-6	TRBJ2-5
TGTGCCAGCAGTTTTCCACGTAGAATCTCTGGAAACACCATATATTTT	CASSFPRRISGNTIYF	TRBV12-3	TRBJ1-3
TGTGCCAGCAGCCAAGATGTACAATCTGGGGCCAACGTCCTGACTTTC	CASSQDVQSGANVLTF	TRBV4-2	TRBJ2-6
TGTGCCACCAGCAGAGATGCCGGGGGGGACAATTACGAGCAGTACTTC	CATSRDAGGDNYEQYF	TRBV15	TRBJ2-7
TGTGCCAGCAGCTTAGTACGGCGACTGACCTACGAGCAGTACTTC	CASSLVRRLTYEQYF	TRBV7-3	TRBJ2-7
TGCAGTGCTAGCAATAAGCCTGGCTACACCTTC	CSASNKPGYTF	TRBV20-1	TRBJ1-2
TGCGCCAGCAGCCAAGAGTCCAGGTATGGCTACACCTTC	CASSQESRYGYTF	TRBV4-1	TRBJ1-2
TGTGCCAGCAGTCCAGGAACTGGACAGTTTCAAAGTCCAGCTTTCTTT	CASSPGTGQFQSPAFF	TRBV7-2	TRBJ1-1
TGTGCCAGCAGTCCGGAAAGTGGGAGATGCATTCAGTACTTC	CASSPESGRCIQYF	TRBV6-1	TRBJ2-4
TGTGCCAGCAGCGTACAGGGGGGACCAGATACGCAGTATTTT	CASSVQGGPDTQYF	TRBV9	TRBJ2-3
TGTGCCAGTACCCCGGGAAGATTCACAGATACGCAGTATTTT	CASTPGRFTDTQYF	TRBV19	TRBJ2-3
TGCGCCAGCATGGCTAGCGGGAAGGGCAATGAGCAGTTCTTC	CASMASGKGNEQFF	TRBV10-1	TRBJ2-1
TGTGCCACCCCGCTAAGGCCAAGCGGGGAGCTGTTTTTT	CATPLRPSGELFF	TRBV7-3	TRBJ2-2
TGTGCCAGCAGCTTGTTTGCCGTGGTGGGGGGACGTAATGAGCAGTTCTTC	CASSLFAVVGGRNEQFF	TRBV5-6	TRBJ2-1
TGCGCCAGCAGCCACGTAACTAGCGGAGAGACCCAGTACTTC	CASSHVTSGETQYF	TRBV4-3	TRBJ2-5
TGTGCCAGCTCACGAGGGTGTCCTAGCGGCCCGCAAGAGACCCAGTACTTC	CASSRGCPSGPQETQYF	TRBV18	TRBJ2-5
TGTGCCCCAAGGTCAGGACAGGGGGACACAGATACGCAGTATTTT	CAPRSGQGDTDTQYF	TRBV11-2	TRBJ2-3
TGCGCCAGCAGCCCAAACGAGCGGGAGAAAATAGAGCAGTACTTC	CASSPNEREKIEQYF	TRBV5-1	TRBJ2-7
TGTGCCAGCAGCCAGTCACACTTAAACACCGGGGAGCTGTTTTTT	CASSQSHLNTGELFF	TRBV3-1	TRBJ2-2
TGTGCCTGTCACAGGTTTGAAAAACTGTTTTTT	CACHRFEKLFF	TRBV9	TRBJ1-4
TGCGCCAGCAGCTTAAGAACCCGACAGGCCAATCAGCCCCAGCATTTT	CASSLRTRQANQPQHF	TRBV5-1	TRBJ1-5
TGTGCCAGCAGTTTTCCTAGCTATTACGAGCAGTACTTC	CASSFPSYYEQYF	TRBV27	TRBJ2-7
TGTGCCAGCAGCCAAGATGAACGGCGTCTGAACACTGAAGCTTTCTTT	CASSQDERRLNTEAFF	TRBV14	TRBJ1-1
TGTGCCAGCAGTTATAATTGGCCAGGGAAAGGGGAAAGCAATGAGCAGTTCTTC	CASSYNWPGKGESNEQFF	TRBV28	TRBJ2-1
TGTGCCAGCAGCTGCGGTCCCCAGTACTTC	CASSCGPQYF	TRBV7-2	TRBJ2-5
TGTGCCAGTAGTCCGGGGACCTACGAGCAGTACTTC	CASSPGTYEQYF	TRBV19	TRBJ2-7
TGCAGTGCCCCCCCCTGGGAGAAGAGCTCCTACGAGCAGTACTTC	CSAPPWEKSSYEQYF	TRBV20-1	TRBJ2-7
TGTGCCAGCAGAATGAGGGAACCCGTGCAGTTCTTC	CASRMREPVQFF	TRBV6-5	TRBJ2-1
TGTGCCCGCGGGGGGACTGGGGCCAACGTCCTGACTTTC	CARGGTGANVLTF	TRBV10-3	TRBJ2-6
TGTGCCAGCAGCGCTGGGGCGGGTCGAACGTGGGCTTTCTTT	CASSAGAGRTWAFF	TRBV11-3	TRBJ1-1
TGTGCCAGCAGTTGTGCGGGGGCTTCCCATTCACCCCTCCACTTT	CASSCAGASHSPLHF	TRBV12-4	TRBJ1-6
TGTGCCAGTACAGGGCGGAAGAACACTGAAGCTTTCTTT	CASTGRKNTEAFF	TRBV19	TRBJ1-1
TGTGCCAGCAGCACGGGGGGGGACAGGGTTGAAGCTTTCTTT	CASSTGGDRVEAFF	TRBV7-9	TRBJ1-1
TGTGCCAGCAGCCGGGACAGGGTCTTTCGGGAGACCCAGTACTTC	CASSRDRVFRETQYF	TRBV7-9	TRBJ2-5
TGTGCCAGCAGTTACGACAGGCGTGCGCAGTTCTTC	CASSYDRRAQFF	TRBV6-6	TRBJ2-1
TGTGCCAGCCCGGGGGGGCAGCTATGGGATACGCAGTATTTT	CASPGGQLWDTQYF	TRBV7-7	TRBJ2-3
TGTGCCAGCAGGTCCCAGGGGGCCTGCGAGCAGTACTTC	CASRSQGACEQYF	TRBV2	TRBJ2-7
TGTGCCAGCAGCCAATTTCCCCGCTTACAGGGGGCAAATGAAAAACTGTTTTTT	CASSQFPRLQGANEKLFF	TRBV4-2	TRBJ1-4
TGTGCCAGCAGTACGGGGACTAGTACCGTCCAAGAGACCCAGTACTTC	CASSTGTSTVQETQYF	TRBV27	TRBJ2-5
TGTGCCAGCAGGGGGTCCTATAATTCACCCCTCCACTTT	CASRGSYNSPLHF	TRBV27	TRBJ1-6
TGTGCCATAACGGGACAGGGGGGTCAGCCCCAGCATTTT	CAITGQGGQPQHF	TRBV12-3	TRBJ1-5
TGTGCCAGCAGCCAAGGCCCCCGATACACTAGCGGGAGTGGGTTAACTAATGAAAAACTGTTTTTT	CASSQGPRYTSGSGLTNEKLFF	TRBV3-1	TRBJ1-4
TGTGCTAGTGGTTTGATCGCTAGCGAATTGTACGAGCAGTACTTC	CASGLIASELYEQYF	TRBV12-5	TRBJ2-7
TGTGCCAGCAGCTTGCCGGACAGATCCTTTGAGACCCAGTACTTC	CASSLPDRSFETQYF	TRBV7-8	TRBJ2-5
TGTGCCAGTAGTATAGTTTCAAGACCCTACGAGCAGTACTTC	CASSIVSRPYEQYF	TRBV19	TRBJ2-7
TGTGCCAGCAGTTACATCGATAGTGAGCAGTTCTTC	CASSYIDSEQFF	TRBV27	TRBJ2-1
TGTGCCATCAGTGAGTCGCTACAGGGGGCTGGCACTGAAGCTTTCTTT	CAISESLQGAGTEAFF	TRBV10-3	TRBJ1-1
TGTGCCAGCAGCCCCCTCTCCTACGAGCAGTACTTC	CASSPLSYEQYF	TRBV7-2	TRBJ2-7
TGTGCCAGCAGCCAACCAGGGAACTATGGCTACACCTTC	CASSQPGNYGYTF	TRBV3-1	TRBJ1-2
TGTGCCCTGGGTCCGAGGGAGGGGGGGAACTACGAGCAGTACTTC	CALGPREGGNYEQYF	TRBV6-2	TRBJ2-7
TGTGCCAGCAGTTTCTCGACAGGGAAGGCTTTCTTT	CASSFSTGKAFF	TRBV28	TRBJ1-1
TGTGCCAGCAGCTTGAGGAAATCCTCAGGGGGCAAAAACTATGGCTACACCTTC	CASSLRKSSGGKNYGYTF	TRBV5-4	TRBJ1-2
TGTGCCAGCATTCCGGCAGATGGTCGCCGTGGCACAGATACGCAGTATTTT	CASIPADGRRGTDTQYF	TRBV6-8	TRBJ2-3
TGTGCCAGTAGTAAGGGGGGACAGGTCTACGAGCAGTACTTC	CASSKGGQVYEQYF	TRBV19	TRBJ2-7
TGTGCCAGCAGCGCCGTACTAGCGGGAGTCCTAGAAAAACTGTTTTTT	CASSAVLAGVLEKLFF	TRBV9	TRBJ1-4
TGCGCCAGCAGCTTGGGATTCAGGGAGCAGTACTTC	CASSLGFREQYF	TRBV5-1	TRBJ2-7
TGTGCCAGCAGTTTATGCTTCCCGACCCTAGCGGGCGGGGGGGGAGTCCTGCCTGAGACCCAGTACTTC	CASSLCFPTLAGGGGVLPETQYF	TRBV28	TRBJ2-5
TGCGCCAGCAGACCAACTCATAGGTCACAGGGGTTAAAAAACATTCAGTACTTC	CASRPTHRSQGLKNIQYF	TRBV10-1	TRBJ2-4
TGCAGTGCGGACGTTATACTAGGGGGGTTAGAGCAGTACTTC	CSADVILGGLEQYF	TRBV20-1	TRBJ2-7
TGTGCCACCAGTGGGGAATTCGGAGACGGCTACACCTTC	CATSGEFGDGYTF	TRBV24-1	TRBJ1-2
TGTGCCAGCAGTGTGGCGGACCCTGCTAGCCAGCCCCAGCATTTT	CASSVADPASQPQHF	TRBV6-1	TRBJ1-5
TGTGCCAGCAGCTTCAACGCAGGGGGCGGCGGAAACACCATATATTTT	CASSFNAGGGGNTIYF	TRBV7-4	TRBJ1-3
TGTGCCTGGGGTTCCGGGACAGGGGGGGAAAAACTGTTTTTT	CAWGSGTGGEKLFF	TRBV30	TRBJ1-4
TGTGCCAGCAGTAGGGTGACTAGTTCTGTCAGGGAGACCCAGTACTTC	CASSRVTSSVRETQYF	TRBV12-3	TRBJ2-5
TGCAGTGCTACAGATCGGGTGTCGCATAGGTTACACAATGAGCAGTTCTTC	CSATDRVSHRLHNEQFF	TRBV20-1	TRBJ2-1
TGTGCCAGCAGTGAATGGGGACAGAATCAGCCCCAGCATTTT	CASSEWGQNQPQHF	TRBV25-1	TRBJ1-5
TGTGCCAGCAGCGGGTTAAGCCGGGACAATGGGGGCGTCAACAATGAGCAGTTCTTC	CASSGLSRDNGGVNNEQFF	TRBV13	TRBJ2-1
TGTGCCACCAGTGAACACGACCGGGACAGGGAGAGGAACACTGAAGCTTTCTTT	CATSEHDRDRERNTEAFF	TRBV24-1	TRBJ1-1
TGCGCCAGACAGGGACAAGTCTACGAGCAGTACTTC	CARQGQVYEQYF	TRBV10-1	TRBJ2-7
TGTGCCAGCAGTGGGGGGCCCCACTCTGGAAACACCATATATTTT	CASSGGPHSGNTIYF	TRBV25-1	TRBJ1-3
TGTGCCAGCAGGGCAAAGGCCACAGATACGCAGTATTTT	CASRAKATDTQYF	TRBV12-3	TRBJ2-3
TGTGCCAGCAGTGCTCAGGGGCTAACCTACGAGCAGTACTTC	CASSAQGLTYEQYF	TRBV6-1	TRBJ2-7
TGTGCCATCAGTGCACGCCGAGTAGGGGGCCTCTGCAACTATGGCTACACCTTC	CAISARRVGGLCNYGYTF	TRBV10-3	TRBJ1-2
TGTGCCAGCTCACCTCAGAGACAGGGCTGGGAAGCTTTCTTT	CASSPQRQGWEAFF	TRBV18	TRBJ1-1
TGTGCCAGCAGCACGGCGAGGGACGAGCAGTACTTC	CASSTARDEQYF	TRBV13	TRBJ2-7
TGTGCCAGGAGGGCGGACTGGCACACTGAAGCTTTCTTT	CARRADWHTEAFF	TRBV6-4	TRBJ1-1
TGTGCCAGCAGCCCGGGACTAGGAAGGTCCTCCTACAATGAGCAGTTCTTC	CASSPGLGRSSYNEQFF	TRBV13	TRBJ2-1
TGTGATGACTCCTACAATGAGCAGTTCTTC	CDDSYNEQFF	TRBV11-3	TRBJ2-1
TGTGCCAGGGGGGGACAGGCAAATGAAAAACTGTTTTTT	CARGGQANEKLFF	TRBV6-4	TRBJ1-4
TGTGCCATGAGGCAAAGCACTGAAGCTTTCTTT	CAMRQSTEAFF	TRBV6-1	TRBJ1-1
TGTGCCAGCGGGGAAACAGGGACCGATCAGCCCCAGCATTTT	CASGETGTDQPQHF	TRBV25-1	TRBJ1-5
TGTGCCAGCTCCAGTTCGTTCCTAGCTGATGGGGGGACAGATACGCAGTATTTT	CASSSSFLADGGTDTQYF	TRBV6-5	TRBJ2-3
TGTGCCAGTAGTCACAGGGACAGAAAGAGCCATCTTAGGAGGACGTATGGCTACACCTTC	CASSHRDRKSHLRRTYGYTF	TRBV19	TRBJ1-2
TGCGCCAGCAGTGGGGACTTCAATCAGCCCCAGCATTTT	CASSGDFNQPQHF	TRBV10-1	TRBJ1-5
TGTGCCAGCAGGTCCGTAAACGCGGACGAGCAGTACTTC	CASRSVNADEQYF	TRBV7-9	TRBJ2-7
TGTGCCAGCAGCTCTCGACGGGAAGCTTTCTTT	CASSSRREAFF	TRBV7-8	TRBJ1-1
TGTGCCAGCAGCGCCCGGCCGGGGACCCAAGAGACCCAGTACTTC	CASSARPGTQETQYF	TRBV7-3	TRBJ2-5
TGCGCCAGCAGCTTGGGGGCGGGAGTAGAAGCCAAGGGGCACACTGAAGCTTTCTTT	CASSLGAGVEAKGHTEAFF	TRBV5-1	TRBJ1-1
TGTGCCACCAGCAGAGATCCTGCAGAGTGGATACCCCTCCACTTT	CATSRDPAEWIPLHF	TRBV15	TRBJ1-6
TGTGCCAGCTCACCAACACCGGGACGTAGGGGCTACGAGCAGTACTTC	CASSPTPGRRGYEQYF	TRBV18	TRBJ2-7
TGTGCCACGACGGGACAGGGTGTTCCAACTAATGAAAAACTGTTTTTT	CATTGQGVPTNEKLFF	TRBV19	TRBJ1-4
TGTGCCAGCAACCCTGCGGCAAACCCGAATCAGCCCCAGCATTTT	CASNPAANPNQPQHF	TRBV7-3	TRBJ1-5
TGTGCCAGCAGGAACAAACCGTCCACCGGGGAGCTGTTTTTT	CASRNKPSTGELFF	TRBV11-3	TRBJ2-2
TGTGCCACCAGTGAGGGTCAGATTGACATTAATGGCTACACCTTC	CATSEGQIDINGYTF	TRBV24-1	TRBJ1-2
TGCGCCAGCAGCGTTCATGTAAACACCGGGGAGCTGTTTTTT	CASSVHVNTGELFF	TRBV4-1	TRBJ2-2
TGTGCCACCAGTCTTATGACTAGCGGGTACAATGAGCAGTTCTTC	CATSLMTSGYNEQFF	TRBV24-1	TRBJ2-1
TGTGCCAGCAGCTACGGGGTTCTAAAACTGTTTTTT	CASSYGVLKLFF	TRBV11-3	TRBJ1-4
TGTGCCAGCAGCAAAGGGCCCAGCCAGCGGACTAGCGGGAAGGAGTTTGAGCAGTTCTTC	CASSKGPSQRTSGKEFEQFF	TRBV7-3	TRBJ2-1
TGCGCCAGCAGTCTTCGGGGTGACACTGAAGCTTTCTTT	CASSLRGDTEAFF	TRBV10-1	TRBJ1-1
TGTGCCAGCAGTGTCCGGAAAAAATCACGGGAGAGGTTCCCCTACGAGCAGTACTTC	CASSVRKKSRERFPYEQYF	TRBV6-1	TRBJ2-7
TGTGCCAGGGGGGACAGGGGGCGGACCCCCAGCAATCAGCCCCAGCATTTT	CARGDRGRTPSNQPQHF	TRBV9	TRBJ1-5
TGTGCCTCCAATATCGGGGAAATCAACTACGAGCAGTACTTC	CASNIGEINYEQYF	TRBV30	TRBJ2-7
TGTGCCAGCAGCAGTCAAACTCGGGGGAGGATTGACTCGCAGTATTTT	CASSSQTRGRIDSQYF	TRBV9	TRBJ2-3
TGTGCCACCACCCCGACAGGGGGATCTTGGCCTGGAAACACCATATATTTT	CATTPTGGSWPGNTIYF	TRBV24-1	TRBJ1-3
TGTGCCAGCAGCTCTAGGGGGGGGCCCCAGTACTTC	CASSSRGGPQYF	TRBV7-2	TRBJ2-5
TGTGCCAGCAGCTTTGATAGCTATAATTCACCCCTCCACTTT	CASSFDSYNSPLHF	TRBV11-2	TRBJ1-6
TGTGCCAGCAGTAGCCACTGGACAGGGGGGGGGAACACTGAAGCTTTCTTT	CASSSHWTGGGNTEAFF	TRBV6-5	TRBJ1-1
TGTGCCAGCAGTTTACTTCAGGGGGCACCAGTCGAGCAGTACTTC	CASSLLQGAPVEQYF	TRBV28	TRBJ2-7
TGCAGTGCTAGAGGACAGGGTTCGAGACGTAATTCACCCCTCCACTTT	CSARGQGSRRNSPLHF	TRBV20-1	TRBJ1-6
TGTGCCAGCAGGACTCGTGGCAAGAGTTACAATGAGCAGTTCTTC	CASRTRGKSYNEQFF	TRBV6-3	TRBJ2-1
TGTGCCAGCACGGGACTATCCGGGGAGCTGTTTTTT	CASTGLSGELFF	TRBV12-3	TRBJ2-2
TGTGCCAGCAGCCACAGGGGGGGCCACAATGAGCAGTTCTTC	CASSHRGGHNEQFF	TRBV14	TRBJ2-1
TGCGCCAGCAGTGAGACGGTTCTTCGCTATGGCTACACCTTC	CASSETVLRYGYTF	TRBV10-1	TRBJ1-2
TGTGCCAGCATTACGGACAGGGGGGGGGATACGCAGTATTTT	CASITDRGGDTQYF	TRBV2	TRBJ2-3
TGTGCCAGCAGTTGGGCCCAGTACGAGCAGTACTTC	CASSWAQYEQYF	TRBV28	TRBJ2-7
TGCGCCAGCAGCTTGGGCCCTAGCGGGGATAAAATCCCGTACAATGAGCAGTTCTTC	CASSLGPSGDKIPYNEQFF	TRBV5-1	TRBJ2-1
TGTGCCAGCAGCTTAGGAGCCCCGTTTAGTAAAAATCAGCCCCAGCATTTT	CASSLGAPFSKNQPQHF	TRBV7-2	TRBJ1-5
TGCAGTGGCGAGGGAGGACCCGATTCACCCCTCCACTTT	CSGEGGPDSPLHF	TRBV20-1	TRBJ1-6
TGTGCCAGCAGCTCGAGATCCCCTAGCGGGTGGGTCCAAGAGACCCAGTACTTC	CASSSRSPSGWVQETQYF	TRBV7-2	TRBJ2-5
TGTGCCACCACTGTCCTGTTTGAACCTGAAGCTTTCTTT	CATTVLFEPEAFF	TRBV24-1	TRBJ1-1
TGCAGTGCTAGACCTAGCGGGGTAACCTACGAGCAGTACTTC	CSARPSGVTYEQYF	TRBV20-1	TRBJ2-7
TGTGCCAGCAGAGGGGGGGGGGACAATGAGCAGTTCTTC	CASRGGGDNEQFF	TRBV12-3	TRBJ2-1
TGTGCCAGCAGTCAGTCGGACCTTTATCAGCCCCAGCATTTT	CASSQSDLYQPQHF	TRBV6-1	TRBJ1-5
TGTGCCAGCAGCTTAACTCGACTAGCAGTAGATTGGTGGCTAGCCAAAAACATTCAGTACTTC	CASSLTRLAVDWWLAKNIQYF	TRBV7-3	TRBJ2-4
TGTGCCTGGAAAACTGACAGGGAGACCGCGGGTCACACTGAAGCTTTCTTT	CAWKTDRETAGHTEAFF	TRBV30	TRBJ1-1
TGTGCCAGCAGCCAAATTCAGGGATTGACAGGATCGAGTGGCTACACCTTC	CASSQIQGLTGSSGYTF	TRBV3-1	TRBJ1-2
TGCGCCAGCAGCTACCCCGGGGCGTGCGCCCAGCCCCAGCATTTT	CASSYPGACAQPQHF	TRBV5-1	TRBJ1-5
TGTGCCAGCGTCTGGCTATACACTGAAGCTTTCTTT	CASVWLYTEAFF	TRBV6-1	TRBJ1-1
TGTGCCAGCAGTTACCCACCCTCCCGGGACAGTTTATACTACGAGCAGTACTTC	CASSYPPSRDSLYYEQYF	TRBV6-5	TRBJ2-7
TGCGCCAGCAGCTTGTATACAGGTTGTGACCCTATTGAGCAGTTCTTC	CASSLYTGCDPIEQFF	TRBV5-1	TRBJ2-1
TGTGCCAGCATCGGCGCACTAGCGGGGCAGTACTTC	CASIGALAGQYF	TRBV6-4	TRBJ2-7
TGTGCCAGCAGCTTACAGCAGACACGCAATCAGCCCCAGCATTTT	CASSLQQTRNQPQHF	TRBV11-2	TRBJ1-5
TGTGCTAGTGGTTGCACAAAGTATCTTCGGGGCGCCTACGAGCAGTACTTC	CASGCTKYLRGAYEQYF	TRBV12-5	TRBJ2-7
TGCGCCAGCAGCCAAGATTCGGGACTACCCGATAATGAGCAGTTCTTC	CASSQDSGLPDNEQFF	TRBV4-3	TRBJ2-1
TGCGCCACCGAACTTAATAACTATGGCTACACCTTC	CATELNNYGYTF	TRBV5-1	TRBJ1-2
TGTGGACCAGGGCACCACAATGAGCAGTTCTTC	CGPGHHNEQFF	TRBV6-2	TRBJ2-1
TGTGCCAGCAGGGACAGGGAAGAAAAACTGTTTTTT	CASRDREEKLFF	TRBV27	TRBJ1-4
TGTGCCAGCAGCCCGGGACAGGATCCAAGGACCTGTCGGGACACTGAAGCTTTCTTT	CASSPGQDPRTCRDTEAFF	TRBV7-9	TRBJ1-1
TGTGCCAGCAGTAAGACCAGGGGGAATAATGAAAAACTGTTTTTT	CASSKTRGNNEKLFF	TRBV27	TRBJ1-4
TGTGCGAAATACAGGGGGCGCCCTGGGGGAGGGGCCAACGTCCTGACTTTC	CAKYRGRPGGGANVLTF	TRBV9	TRBJ2-6
TGTGCCAGCAGCATGGGGCTGGACGGGGGCTACACCTTC	CASSMGLDGGYTF	TRBV7-4	TRBJ1-2
TGTGCCACCAACCCAAGGACAGGGGGCAAGGACGAGCAGTACTTC	CATNPRTGGKDEQYF	TRBV12-3	TRBJ2-7
TGTGCCAGCAGCGTAGGGGACAGGGCAGGTCACTATGGCTACACCTTC	CASSVGDRAGHYGYTF	TRBV7-6	TRBJ1-2
TGTGCCAGCCCTCGACGGGGGATCGAGCAGTACTTC	CASPRRGIEQYF	TRBV12-3	TRBJ2-7
TGTGCCACCAGTGATTGCACAGCTTCCACAGATACGCAGTATTTT	CATSDCTASTDTQYF	TRBV24-1	TRBJ2-3
TGCGCCAGCAGTGAGTCCCAGTGGAGCGGGCCTGAAGCTTTCTTT	CASSESQWSGPEAFF	TRBV10-2	TRBJ1-1
TGTGCCAGCTACACAGGGGACAAACGTGGCAAAAACATTCAGTACTTC	CASYTGDKRGKNIQYF	TRBV13	TRBJ2-4
TGTGCCAGCAGCGTGCAGGTGGACGCCGGGGAGCTGTTTTTT	CASSVQVDAGELFF	TRBV7-3	TRBJ2-2
TGTGCCAGCAGTGACCCAGGGCGAATTAATTCCGGAAACACCATATATTTT	CASSDPGRINSGNTIYF	TRBV6-1	TRBJ1-3
TGTGCCAGCAGCCAAGATAGTCGAGGTTGCCCCATACTCGGGGCAGGGGGCCTCAATTCACCCCTCCACTTT	CASSQDSRGCPILGAGGLNSPLHF	TRBV3-1	TRBJ1-6
TGCAGCGTTGGGAGCGTGACCCGGAACACAGATACGCAGTATTTT	CSVGSVTRNTDTQYF	TRBV29-1	TRBJ2-3
TGTGCCAGCAGACCCCGGATGGTAGCCGACTCTGGAAACACCATATATTTT	CASRPRMVADSGNTIYF	TRBV6-1	TRBJ1-3
TGCAGTGCTCCAAGGGAGGCAGATACGCAGTATTTT	CSAPREADTQYF	TRBV20-1	TRBJ2-3
TGTGCCAGCAGCTTACTTATAGGGGGGACCAAAAACATTCAGTACTTC	CASSLLIGGTKNIQYF	TRBV11-2	TRBJ2-4
TGTGCCAGCAGCCACTGCGGGACAGGGTTTCCGGCTTTCTTT	CASSHCGTGFPAFF	TRBV7-9	TRBJ1-1
TGTGCCAGCACGGGTAGTGCCCGGACTCTGGAACACGAGCAGTACTTC	CASTGSARTLEHEQYF	TRBV12-3	TRBJ2-7
TGTGCCAGCAGTACTTTAAGGAGCGGCAATGAGCAGTTCTTC	CASSTLRSGNEQFF	TRBV28	TRBJ2-1
TGCGCCAGCGTACAGGGGGGGCCCTACGAGCAGTACTTC	CASVQGGPYEQYF	TRBV10-1	TRBJ2-7
TGTGCCAGCAGCCTGGACGGCCCGATCGCCAACACTGAAGCTTTCTTT	CASSLDGPIANTEAFF	TRBV5-6	TRBJ1-1
TGTGCCAGCATACCGCGACAGGGGCCCCCGGCCAAGAACACTGAAGCTTTCTTT	CASIPRQGPPAKNTEAFF	TRBV7-9	TRBJ1-1
TGTGCCAGCAGCCAAGCGGGCCCCACAACCTACGAGCAGTACTTC	CASSQAGPTTYEQYF	TRBV14	TRBJ2-7
TGTGCTAGTGGGGGGCACTCCTACGAGCAGTACTTC	CASGGHSYEQYF	TRBV12-5	TRBJ2-7
TGTGCCATCAGATGGGGGGCAGTTTACGAGCAGTACTTC	CAIRWGAVYEQYF	TRBV10-3	TRBJ2-7
TGTGCCAGCAGCATCCCACCTATGAAGGTGCAGTACTTC	CASSIPPMKVQYF	TRBV7-3	TRBJ2-7
TGTGCCAGCAGCGTGGACAGGGGGGAGTCTATCGGAGCTAACTATGGCTACACCTTC	CASSVDRGESIGANYGYTF	TRBV11-3	TRBJ1-2
TGTGCCACTAACAGGGGGCCGCAGCCCCAGCATTTT	CATNRGPQPQHF	TRBV24-1	TRBJ1-5
TGTGCCAGCAGCTCATGGGCCCGGAAAAACTATGGCTACACCTTC	CASSSWARKNYGYTF	TRBV13	TRBJ1-2
TGTGCCAGCAGCGTAAGATGTCATAATCAGCCCCAGCATTTT	CASSVRCHNQPQHF	TRBV9	TRBJ1-5
TGTGCCACCAGCAGAGATTGCCACTTTATCTCTCAGGGATGCCGCTTC	CATSRDCHFISQGCRF	TRBV15	TRBJ2-5
TGCAGCGTTCGGGGTAAAGGGGGGGGAGCGAGGATGTTGGGCTACGAGCAGTACTTC	CSVRGKGGGARMLGYEQYF	TRBV29-1	TRBJ2-7
TGCGCCAGCAGCCAGGACAGACCCCATGGCTACACCTTC	CASSQDRPHGYTF	TRBV4-1	TRBJ1-2
TGTGCCACCAGCAGGTTTTGCAGGACAGGGGGGGACTTC	CATSRFCRTGGDF	TRBV15	TRBJ2-7
TGTGCCAGCGCGGACAGGGTAAAGCCAGGCACAGATACGCAGTATTTT	CASADRVKPGTDTQYF	TRBV28	TRBJ2-3
TGTGCCAGCAGTTTATACGTTGGGGGAAGAGGCTCTGGAAACACCATATATTTT	CASSLYVGGRGSGNTIYF	TRBV27	TRBJ1-3
TGTGCCAGCAGCTTAAAGAGTGAAGGGGGGCCCGGGACGGACGAGCAGTACTTC	CASSLKSEGGPGTDEQYF	TRBV7-3	TRBJ2-7
TGCAGCGTTGAAGATAGAGGGAGGGTATGTAGCAATCAGCCCCAGCATTTT	CSVEDRGRVCSNQPQHF	TRBV29-1	TRBJ1-5
TGTGCCAGCAGCGTCCCCATTTCCGGTGAAGCTTTCTTT	CASSVPISGEAFF	TRBV5-6	TRBJ1-1
TGTGCCAGCAGCAAGACAGAGATCTATAGCAATCAGCCCCAGCATTTT	CASSKTEIYSNQPQHF	TRBV7-2	TRBJ1-5
TGTGCCAGCAGTTATTACCACGGGGACAAGGAGGGTCCAGTTAATCAGCCCCAGCATTTT	CASSYYHGDKEGPVNQPQHF	TRBV6-5	TRBJ1-5
TGTGCCAGCAGCCCAACTCGTTCACCCCTCCACTTT	CASSPTRSPLHF	TRBV3-1	TRBJ1-6
TGTGCCAGCAGTTACAGACAGTCTGAAAAACTGTTTTTT	CASSYRQSEKLFF	TRBV6-6	TRBJ1-4
TGCAGCGCTCGGGAGTTTGAAGCTTTCTTT	CSAREFEAFF	TRBV29-1	TRBJ1-1
TGTGCCAGCCACTCGGCATTAAATGAAAAACTGTTTTTT	CASHSALNEKLFF	TRBV27	TRBJ1-4
TGTGCCAGCCGGGGACAGGGTGGCTACACCTTC	CASRGQGGYTF	TRBV6-4	TRBJ1-2
TGTGCCAGCAGCTTCCTAGAGACCCAGTACTTC	CASSFLETQYF	TRBV6-8	TRBJ2-5
TGCAGTGCTAGACGACGCGGTGATTATGAGCAGTTCTTC	CSARRRGDYEQFF	TRBV20-1	TRBJ2-1
TGTGCCAGCAGTTACTCGGGGGAAGGGCCCGAAGAGACCCAGTACTTC	CASSYSGEGPEETQYF	TRBV6-6	TRBJ2-5
TGTGCCAGCAGCTTGATGGTGGACGCTAAGGGAAACTATGGCTACACCTTC	CASSLMVDAKGNYGYTF	TRBV5-4	TRBJ1-2
TGTGCCAGCACCCGCCGACTGGAGACCCAGTACTTC	CASTRRLETQYF	TRBV7-9	TRBJ2-5
TGTGCCAGCAGTGACTCGATAGGGACTCATTGGGGAGGCGAAGCTTTCTTT	CASSDSIGTHWGGEAFF	TRBV6-4	TRBJ1-1
TGTGCCAGCTCACCACCCCACCCCGGGGCGACAGCTAAGGTCAACTATGGCTACACCTTC	CASSPPHPGATAKVNYGYTF	TRBV18	TRBJ1-2
TGTGCCACCAGTGAAGGGGGGTACTACGAGCAGTACTTC	CATSEGGYYEQYF	TRBV24-1	TRBJ2-7
TGTGGACCCACGTCGAGGGGGCGGAACTATGGCTACACCTTC	CGPTSRGRNYGYTF	TRBV24-1	TRBJ1-2
TGTGCCAGCAGTGACAAATCTCGGACAGATACGCAGTATTTT	CASSDKSRTDTQYF	TRBV6-1	TRBJ2-3
TGTGCCAGCAGCTTAGCCATGAGTTACGAGCAGTACTTC	CASSLAMSYEQYF	TRBV7-2	TRBJ2-7
TGTGCCAGCAGTTACTCGACTCAGGGGAGCAATCAGCCCCAGCATTTT	CASSYSTQGSNQPQHF	TRBV6-5	TRBJ1-5
TGCGCCAGCAGCTTGACAGCGGGGCCGAACACCGGGGAGCTGTTTTTT	CASSLTAGPNTGELFF	TRBV5-1	TRBJ2-2
TGTGCCAGCAGTTTAGTGAGGCCAGGCCCTAGGGGCACTGAAGCTTTCTTT	CASSLVRPGPRGTEAFF	TRBV27	TRBJ1-1
TGCAGTGCTAGAGATCTCCCCCTAACTAAGGGTAAAGAGACCCAGTACTTC	CSARDLPLTKGKETQYF	TRBV20-1	TRBJ2-5
TGCGCCAGCAGTGAAATCAACGTGCTACTTGACAGGGGACGGGAGCAGTACTTC	CASSEINVLLDRGREQYF	TRBV10-1	TRBJ2-7
TGTGCCAGCAGTGGGGTAAGGGACAGGAAAGGGAGGAGAGGCACATATAGCAATCAGCCCCAGCATTTT	CASSGVRDRKGRRGTYSNQPQHF	TRBV25-1	TRBJ1-5
TGTGCCAGCAGCGTAGTTATAGAGGATCGAAGGGTCTTT	CASSVVIEDRRVF	TRBV9	TRBJ1-1
TGTGCCACCACTGAGGTTCCGACAGGTCCGCCGTCACCCCTCCACTTT	CATTEVPTGPPSPLHF	TRBV24-1	TRBJ1-6
TGTGCCAGCAGCTTAGGTCTTTCTGTTGGGACAGCGCCTAAGAGCTCCTACGAGCAGTACTTC	CASSLGLSVGTAPKSSYEQYF	TRBV7-3	TRBJ2-7
TGTGCCAGCAGTTACTGGCCGTCCGGGACAAAACTCGATACGCAGTATTTT	CASSYWPSGTKLDTQYF	TRBV6-2	TRBJ2-3
TGTGCCAGCAGCAAGTGCCGGGACAGGGGTACTGAAGCTTTCTTT	CASSKCRDRGTEAFF	TRBV7-9	TRBJ1-1
TGTGCCAGCAGCCCCACGACAGGGGGCACCATTCGGTGGGACCAAGAGACCCAGTACTTC	CASSPTTGGTIRWDQETQYF	TRBV14	TRBJ2-5
TGCGCCAGCAGCTTGGTGGGACGCCCCCACTGCACCTACGAGCAGTACTTC	CASSLVGRPHCTYEQYF	TRBV5-1	TRBJ2-7
TGTGCCAGCAGTGACCTGAGCTTCCAAGTCCTCTCCTACAATGAGCAGTTCTTC	CASSDLSFQVLSYNEQFF	TRBV6-4	TRBJ2-1
TGTGCCAGCCAAGCCCATGGAGGGGGCACGAACACCATATATTTT	CASQAHGGGTNTIYF	TRBV2	TRBJ1-3
TGTGCCAGCAGGTATCCCCGTTGGACAGGGGCGAACACCGGGGAGCTGTTTTTT	CASRYPRWTGANTGELFF	TRBV2	TRBJ2-2
TGTGCCAGCAGTGCCGGAACAGGGGTATTCTATAATTCACCCCTCCACTTT	CASSAGTGVFYNSPLHF	TRBV6-4	TRBJ1-6
TGTGCCAGCAGGCTGGACAGGGACATTCAGTACTTC	CASRLDRDIQYF	TRBV6-5	TRBJ2-4
TGTGCCAGCAGCGGACAGGCCACCGGGGAGCTGTTTTTT	CASSGQATGELFF	TRBV11-3	TRBJ2-2
TGCGCCAAGGCGAGAAATACTCCTAACACTGAAGCTTTCTTT	CAKARNTPNTEAFF	TRBV10-2	TRBJ1-1
TGTGCCTATGGGACGGTTAGGGACAAAAACATTCAGTACTTC	CAYGTVRDKNIQYF	TRBV7-7	TRBJ2-4
TGTGCCAGCACAGGGGGCGGGTTAACTGAAGCTTTCTTT	CASTGGGLTEAFF	TRBV14	TRBJ1-1
TGCGCCAGCAGTGCGGACAGGCCCATGAACACTGAAGCTTTCTTT	CASSADRPMNTEAFF	TRBV10-1	TRBJ1-1
TGCGCCAGCAGCCGGGGCAGGTACGAGCAGTACTTC	CASSRGRYEQYF	TRBV4-1	TRBJ2-7
TGTGCCAGCAGGGTCCGCGGGAGGGACACCGGGGAGCTGTTTTTT	CASRVRGRDTGELFF	TRBV6-3	TRBJ2-2
TGTGCCACCAGTGGTGGGGATGGTGAAGCTTTCTTT	CATSGGDGEAFF	TRBV24-1	TRBJ1-1
TGCGCCAGCAGGACAGGGTCCGAGACTGGGTACGAGCAGTACTTC	CASRTGSETGYEQYF	TRBV10-1	TRBJ2-7
TGCGCCAGCAGATACAGGGGGGGCGACACTGAAGCTTTCTTT	CASRYRGGDTEAFF	TRBV10-1	TRBJ1-1
TGTGCCAGCAAACAGACGGACACTGAAGCTTTCTTT	CASKQTDTEAFF	TRBV28	TRBJ1-1
TGTGCCAGCAGCGTAGTGAACAGGGGCGAAAAACTGTTTTTT	CASSVVNRGEKLFF	TRBV9	TRBJ1-4
TGTGCCAGCAGCTGGACTAGCGGGTTGTACAATGAGCAGTTCTTC	CASSWTSGLYNEQFF	TRBV7-2	TRBJ2-1
TGCGCCAGCTATAACAATGAGCAGTTCTTC	CASYNNEQFF	TRBV10-1	TRBJ2-1
TGTGCCAGCAGTTTATCAGGCAATTGGTTTTTAGCGGGAATCAATGAGCAGTTCTTC	CASSLSGNWFLAGINEQFF	TRBV28	TRBJ2-1
TGTGCCACCAGCAGGGACACGTCCTCTGGAAACACCATATATTTT	CATSRDTSSGNTIYF	TRBV15	TRBJ1-3
TGTGCCAGCAGCCCCCGACTAGGGAGTTTCTACGAGCAGTACTTC	CASSPRLGSFYEQYF	TRBV7-3	TRBJ2-7
TGTGCCAGCAGTGAGGGTGGGGGGAATGGGGTCAACTACGAGCAGTACTTC	CASSEGGGNGVNYEQYF	TRBV6-4	TRBJ2-7
TGTGCCAGCAGGCCGGGTGGGACAGGGTATGGCTACACCTTC	CASRPGGTGYGYTF	TRBV12-4	TRBJ1-2
TGTGCCAGCAGCGGCCTACCAGCCCGTCAACCCTACGAGCAGTACTTC	CASSGLPARQPYEQYF	TRBV9	TRBJ2-7
TGTGCCAGCAGTTCCTGTCCACAGGGGGCGCCAAGCAATCAGCCCCAGCATTTT	CASSSCPQGAPSNQPQHF	TRBV12-3	TRBJ1-5
TGTGCCAGCAGCGGTCGAGGCATGGGGGGCCTTTTCCTCCGGGCCTCAGATACGCAGTATTTT	CASSGRGMGGLFLRASDTQYF	TRBV7-3	TRBJ2-3
TGTGCCAGCAGCCGGACAGGGGGCCAGGATCAGCCCCAGCATTTT	CASSRTGGQDQPQHF	TRBV13	TRBJ1-5
TGTGCCAGAGATCAGGGGGCGGGCATGCAAGAGACCCAGTACTTC	CARDQGAGMQETQYF	TRBV14	TRBJ2-5
TGTGCCAGCAGTTTACCCCCAATCGGGGGCATTGGGACCGGGGAGCTGTTTTTT	CASSLPPIGGIGTGELFF	TRBV27	TRBJ2-2
TGTGCCAGCAGTTACTCGAGAGAGGGGGAAGGGACTAGGGGCCGCCAAGAGACCCAGTACTTC	CASSYSREGEGTRGRQETQYF	TRBV6-5	TRBJ2-5
TGTGCCATCAGTGAGTCGTCAGCCAATGAAAAACTGTTTTTT	CAISESSANEKLFF	TRBV10-3	TRBJ1-4
TGTGCGCCCCCAGAAACTCAGCCCCAGCATTTT	CAPPETQPQHF	TRBV11-3	TRBJ1-5
TGCGCCAAATTACCCCGAGACTCGAGCTCCTACAATGAGCAGTTCTTC	CAKLPRDSSSYNEQFF	TRBV10-1	TRBJ2-1
TGTGCCAGCCCGATCGGCAATCAGCCCCAGCATTTT	CASPIGNQPQHF	TRBV28	TRBJ1-5
TGTGCCAGCAGCTGTCAGGACTTCACTTTCTATGGCTACACCTTC	CASSCQDFTFYGYTF	TRBV11-2	TRBJ1-2
TGTGCCAGCAGCTTAGCCGGGACAGACGAGCAGTACTTC	CASSLAGTDEQYF	TRBV7-2	TRBJ2-7
TGCAGCGTTGACCCTCGTTTTTTGGCCAGCAATCAGCCCCAGCATTTT	CSVDPRFLASNQPQHF	TRBV29-1	TRBJ1-5
TGTGCCAGCAGCTTAAACCACCTGGAGTGGACTAGCGGGCGGGTATCCTACGAGCAGTACTTC	CASSLNHLEWTSGRVSYEQYF	TRBV5-4	TRBJ2-7
TGTGCCATCAGACATCTCCGGGACAGGGGTAGGTGGTCCTACGAGCAGTACTTC	CAIRHLRDRGRWSYEQYF	TRBV10-3	TRBJ2-7
TGTGCCAGCAAGCGGCAGAACGTAGGCCAGAGGGAAAAACTGTTTTTT	CASKRQNVGQREKLFF	TRBV27	TRBJ1-4
TGTGCCAGCAGCGTAGTCGGGACAGGGACTGAAGCTTTCTTT	CASSVVGTGTEAFF	TRBV9	TRBJ1-1
TGTGCCAGCTCACCACTCTTTGGCCAGGGACCCCATGGCTACACCTTC	CASSPLFGQGPHGYTF	TRBV18	TRBJ1-2
TGTGCCACTGGTGAGGGACAGCGCGCCATATATTTT	CATGEGQRAIYF	TRBV24-1	TRBJ1-3
TGTGCCAGCAGCCGGGGGTCTTGGAGAGTGGTGTCCTATGGCTACACCTTC	CASSRGSWRVVSYGYTF	TRBV7-9	TRBJ1-2
TGCAGTGCTAGTACGACCTCTGGGGCCAACGTCCTGACTTTC	CSASTTSGANVLTF	TRBV20-1	TRBJ2-6
TGTGCCAGCAGTCAAGGACAGCAATATAGCAATCAGCCCCAGCATTTT	CASSQGQQYSNQPQHF	TRBV6-4	TRBJ1-5
TGTGCCAGCAGCGGCAGGATTAGACGGGTAAAAAGGCATGGCTACACCTTC	CASSGRIRRVKRHGYTF	TRBV13	TRBJ1-2
TGTGCCAGCAGCCAAGATAACCGCTTATCGGGGGTTGAGCAGTACTTC	CASSQDNRLSGVEQYF	TRBV14	TRBJ2-7
TGTGCCAGCAGTACTATACGGACAGCGGGAGATACGCAGTATTTT	CASSTIRTAGDTQYF	TRBV6-4	TRBJ2-3
TGTGCCAGCAGCCCCCGGCGAACCGGGGAGCTGTTTTTT	CASSPRRTGELFF	TRBV3-1	TRBJ2-2
TGCAGCGGACAGGGCTATCAGCCCCAGCATTTT	CSGQGYQPQHF	TRBV29-1	TRBJ1-5
TGTGCCAGCAGCGTAGGCAGGACTAGCGGGACCGTCAACGAGCAGTACTTC	CASSVGRTSGTVNEQYF	TRBV9	TRBJ2-7
TGTGCCAGCAGTCCGATCCGGTCCACTAGCGGGTATCCCAGAAGAAATTCCTCTAGCTTCACAGATACGCAGTATTTT	CASSPIRSTSGYPRRNSSSFTDTQYF	TRBV6-5	TRBJ2-3
TGTGCCAGCAGTTGGCTGCACGACAGGGATAATGGAAACACCATATATTTT	CASSWLHDRDNGNTIYF	TRBV6-3	TRBJ1-3
TGTGCCAGCAAGGGGGGTTTCAATGAGCAGTTCTTC	CASKGGFNEQFF	TRBV6-1	TRBJ2-1
TGTGCTAGTGGTTTGGTACAAGAGTGCTGCTCTGGGGCCAACGTCCTGACTTTC	CASGLVQECCSGANVLTF	TRBV12-5	TRBJ2-6
TGTGCCAGCAGCCCCCCCTGGGTGGACAGGGCGGTAGAGACCCAGTACTTC	CASSPPWVDRAVETQYF	TRBV13	TRBJ2-5
TGCAGTGCTAGCCCTTCCCCTGATGGGTCCTACACCTTC	CSASPSPDGSYTF	TRBV20-1	TRBJ1-2
TGTGCCACCGGAGCGGGACAGAGCAATCAGCCCCAGCATTTT	CATGAGQSNQPQHF	TRBV15	TRBJ1-5
TGTGCCAGCAGCTTAGACCAACAGGACTACCCACCGGTGGACGAGCAGTACTTC	CASSLDQQDYPPVDEQYF	TRBV7-2	TRBJ2-7
TGTGCCAGCGCCCCCCCCCGTCGGGGGGGATCCTACAATGAGCAGTTCTTC	CASAPPRRGGSYNEQFF	TRBV7-4	TRBJ2-1
TGTGCCTGGATACTTTTCGCGCTCACAGATACGCAGTATTTT	CAWILFALTDTQYF	TRBV30	TRBJ2-3
TGTGCCAGCAGATCTAGCGGGACCTACGAGCAGTACTTC	CASRSSGTYEQYF	TRBV27	TRBJ2-7
TGTGCCAGCAGCTGCCCCCAGGGGGCCGGAGACCATGACGAGCAGTACTTC	CASSCPQGAGDHDEQYF	TRBV5-4	TRBJ2-7
TGTGCCAGCCCTACAGGGGGGGTCGCTTTCTTT	CASPTGGVAFF	TRBV7-2	TRBJ1-1
TGCAGTGCTGATGACTTTGAAGCTTTCTTT	CSADDFEAFF	TRBV20-1	TRBJ1-1
TGTGCCAGCAGCTGGTTTTTGTGGACGGGGGCTGAAGCTTTCTTT	CASSWFLWTGAEAFF	TRBV11-2	TRBJ1-1
TGTGCCAGCAGCCAAGAGTCCGGGACAGGGGGGAGTGGCTACACCTTC	CASSQESGTGGSGYTF	TRBV14	TRBJ1-2
TGTGCCAGCAGTGACTCGCCCCTTTTCAAAATTGCCTCTGGGGCCAACGTCCTGACTTTC	CASSDSPLFKIASGANVLTF	TRBV6-4	TRBJ2-6
TGTGCCACCCCTACAGGGGAGGGCAACCAGCCCCAGCATTTT	CATPTGEGNQPQHF	TRBV15	TRBJ1-5
TGTGCCAGCAGTTATAAAATAATACGGCTGGTAATGTCGGCCAACGTCCTGACTTTC	CASSYKIIRLVMSANVLTF	TRBV6-3	TRBJ2-6
TGTGCCAGCACCGTGGGACAGACTAATTTGGGCGGGGATCAGCCCCAGCATTTT	CASTVGQTNLGGDQPQHF	TRBV9	TRBJ1-5
TGTGCCAACCGGAATGACTTCGCTGGCGAGCAGTACTTC	CANRNDFAGEQYF	TRBV11-2	TRBJ2-7
TGCGCCAGCAGCCAAGCAGCAGGTGACTTTCTTTACAATGAGCAGTTCTTC	CASSQAAGDFLYNEQFF	TRBV4-1	TRBJ2-1
TGTGCCAGGACAGGGGGCGGGGTAAATCAGCCCCAGCATTTT	CARTGGGVNQPQHF	TRBV9	TRBJ1-5
TGCAGTGCAGGTCAACCGCAGCACTACGAGCAGTACTTC	CSAGQPQHYEQYF	TRBV20-1	TRBJ2-7
TGTGCCAGCAGCCAAGACCGACAGGGCCGAGGCAATCAGCCCCAGCATTTT	CASSQDRQGRGNQPQHF	TRBV3-1	TRBJ1-5
TGTGCCAGCAGCTTGAAAGGGGGCGGGAGGGGCAATCAGCCCCAGCATTTT	CASSLKGGGRGNQPQHF	TRBV11-2	TRBJ1-5
TGCGCCAGCAGCCCGGGGGGCGGATACAATGAGCAGTTCTTC	CASSPGGGYNEQFF	TRBV5-1	TRBJ2-1
TGTGCCAGCAGCTTAAAGAACAGGGGGGCGCCCGCAGATACGCAGTATTTT	CASSLKNRGAPADTQYF	TRBV7-6	TRBJ2-3
TGCAGTGCAGCTAGCGGGGAACTTCGAGAGGCCTACAATGAGCAGTTCTTC	CSAASGELREAYNEQFF	TRBV20-1	TRBJ2-1
TGCGCCAGCAGTGAGACAAGTAGCGGGGATACGCAGTATTTT	CASSETSSGDTQYF	TRBV10-1	TRBJ2-3
TGTGCCAGCACCCCCAGGGGGCCAATTGTTAGAGAGACCCAGTACTTC	CASTPRGPIVRETQYF	TRBV6-2	TRBJ2-5
TGTGCCAGCAGTTCGGGGACACGTGGTCAGCCCCAGCATTTT	CASSSGTRGQPQHF	TRBV27	TRBJ1-5
TGTGCCAGCACCCAGACAGCTGGCGATGGGTTACCCTACGAGCAGTACTTC	CASTQTAGDGLPYEQYF	TRBV25-1	TRBJ2-7
TGCGCCAGCAGCCAAGATCCGTCCGGCCATCAGCCCCAGCATTTT	CASSQDPSGHQPQHF	TRBV4-1	TRBJ1-5
TGCAGCGTTTACCAGGCCGAAGCTTTCTTT	CSVYQAEAFF	TRBV29-1	TRBJ1-1
TGCGCCAGCAGCTTGGGCCCGATCCAGCGACTGAGCGGCCGAGACTATGGCTACACCTTC	CASSLGPIQRLSGRDYGYTF	TRBV5-1	TRBJ1-2
TGTGCTAGTCAGGACGGCTATGGCTACACCTTC	CASQDGYGYTF	TRBV12-5	TRBJ1-2
TGTGCCAGCAGCCGCGGACAGGGATATAGCAATCAGCCCCAGCATTTT	CASSRGQGYSNQPQHF	TRBV3-1	TRBJ1-5
TGTGCCACAGGGGGCGTAAATCAGCCCCAGCATTTT	CATGGVNQPQHF	TRBV3-1	TRBJ1-5
TGCGCCAGGCCTGGGACAGGGGCGAAAAACATTCAGTACTTC	CARPGTGAKNIQYF	TRBV10-1	TRBJ2-4
TGTGCCAGCAGCATCTGGCATGGGGGGGTATATAGCAATCAGCCCCAGCATTTT	CASSIWHGGVYSNQPQHF	TRBV7-6	TRBJ1-5
TGTGCCAGCAGCGAGACTGGATATGGCTACACCTTC	CASSETGYGYTF	TRBV7-3	TRBJ1-2
TGTGCCAGCAGCTCAAAAGGGTTTCAACTTAGCAATCAGCCCCAGCATTTT	CASSSKGFQLSNQPQHF	TRBV6-1	TRBJ1-5
TGTGCCAGTAGTATAGATAAATATCAGCCCCAGCATTTT	CASSIDKYQPQHF	TRBV19	TRBJ1-5
TGTGCCAGCAGTCAGGGACAGGGCCGCACTGAAGCTTTCTTT	CASSQGQGRTEAFF	TRBV28	TRBJ1-1
TGTGCCACCAGTGTTTCCCCAGCGGGAGAGGTGGCCTACGAGCAGTACTTC	CATSVSPAGEVAYEQYF	TRBV24-1	TRBJ2-7
TGCAGCGTTCCCCAGGGGGAGGTGAACACTGAAGCTTTCTTT	CSVPQGEVNTEAFF	TRBV29-1	TRBJ1-1
TGTGCCAGCTCACCAGGGACAGCGGACAATCAGCCCCAGCATTTT	CASSPGTADNQPQHF	TRBV18	TRBJ1-5
TGTGCCACCAGCTATCCAGCTCGCAATCAGCCCCAGCATTTT	CATSYPARNQPQHF	TRBV24-1	TRBJ1-5
TGCAGCGTAATGAAGAGAGGGCATGGCTCCTACGAGCAGTACTTC	CSVMKRGHGSYEQYF	TRBV29-1	TRBJ2-7
TGTGCCAGCAGCTTAACGAAACAGGGTGCGGATCAGCCCCAGCATTTT	CASSLTKQGADQPQHF	TRBV7-3	TRBJ1-5
TGTGCCAGCAGCTGTGGACAGCCCGTCCTGACTTTC	CASSCGQPVLTF	TRBV11-3	TRBJ2-6
TGTGCCAGCAGTTTAAGGAGGTGGAAGATGAACACTGAAGCTTTCTTT	CASSLRRWKMNTEAFF	TRBV27	TRBJ1-1
TGTGCCAGCGGTCCTCCAGGGTGTACTGAAGCTTTCTTT	CASGPPGCTEAFF	TRBV28	TRBJ1-1
TGTGCCAGCAGCGGAAGGGACAGGGGTGATCAGCCCCAGCATTTT	CASSGRDRGDQPQHF	TRBV13	TRBJ1-5
TGCAGTGCTAGCGACTCACTAGCGGGCTCTGGGGCCAACGTCCTGACTTTC	CSASDSLAGSGANVLTF	TRBV20-1	TRBJ2-6
TGCGCCAGCAGCCATGAGGACCGGTCACCCCTCCACTTT	CASSHEDRSPLHF	TRBV4-1	TRBJ1-6
TGTGCCAGCAGCCACCACCGTCATGCGGGAGATGAGACCCAGTACTTC	CASSHHRHAGDETQYF	TRBV6-2	TRBJ2-5
TGTGCCAGCAAACGGTGCGGGACGGTTAGGAACACTGAAGCTTTCTTT	CASKRCGTVRNTEAFF	TRBV25-1	TRBJ1-1
TGTGCCAGCAGGGCCCTAACCGGGACTAGCAGGTCCTACAATGAGCAGTTCTTC	CASRALTGTSRSYNEQFF	TRBV27	TRBJ2-1
TGTGCCAGCAGTGAAGCAACCCACACTGAAGCTTTCTTT	CASSEATHTEAFF	TRBV2	TRBJ1-1
TGCAGTGCTAGAGACTTTATGGGGTTGGGGAACACTGAAGCTTTCTTT	CSARDFMGLGNTEAFF	TRBV20-1	TRBJ1-1
TGTGCCAGCAGCTTAATACGTGGAAACACCATATATTTT	CASSLIRGNTIYF	TRBV7-9	TRBJ1-3
TGTGCCAGCAGCCCCTTTAGGGGCGATTTATGCTCCTACGAGCAGTACTTC	CASSPFRGDLCSYEQYF	TRBV3-1	TRBJ2-7
TGTGCCAGCAGCTTCGGTGGAGGGCTAGCCAAAAACATTCAGTACTTC	CASSFGGGLAKNIQYF	TRBV11-2	TRBJ2-4
TGCAGTGCTAGAGATATTGGCAGGGGCTCTGGGGCCAACGTCCTGACTTTC	CSARDIGRGSGANVLTF	TRBV20-1	TRBJ2-6
TGTGCCAGCACCCTAAGTCGGAGGGTCTGCGAGCAGTACTTC	CASTLSRRVCEQYF	TRBV27	TRBJ2-7
TGTGCCAGCTCACAACTACAGGCTAGGGCGAACACTGAAGCTTTCTTT	CASSQLQARANTEAFF	TRBV18	TRBJ1-1
TGTGCCAGCAGCCGCAGGGGCCTTTTCAATGAGCAGTTCTTC	CASSRRGLFNEQFF	TRBV7-2	TRBJ2-1
TGCAGTGCTCCCGGCAGCGGGAGGAGTGAGCAGTTCTTC	CSAPGSGRSEQFF	TRBV20-1	TRBJ2-1
TGTGCCACCATAGGAAGGACAGGGTCACCCGGGGAGCTGTTTTTT	CATIGRTGSPGELFF	TRBV24-1	TRBJ2-2
TGTGCCAGCAGTCGGGGGACCGCACGCAAAAACATTCAGTACTTC	CASSRGTARKNIQYF	TRBV27	TRBJ2-4
TGTGCCAGCAGCTATTCCGTAGGGACAGCCTATAGCAATCAGCCCCAGCATTTT	CASSYSVGTAYSNQPQHF	TRBV5-6	TRBJ1-5
TGTGCCAGCAGGGTTACGAACAATGAGCAGTTCTTC	CASRVTNNEQFF	TRBV14	TRBJ2-1
TGTGCCAGCAGTGAGGAGCCCCGAGTTTTGGATGGCTACACCTTC	CASSEEPRVLDGYTF	TRBV6-4	TRBJ1-2
TGTGCCACCAGCGTGGGGACTGTTTGCTCCTACGAGCAGTACTTC	CATSVGTVCSYEQYF	TRBV15	TRBJ2-7
TGTGCCATCAGTGAGCTAAGGACAGGGGACGAGCAGTACTTC	CAISELRTGDEQYF	TRBV10-3	TRBJ2-7
TGCGCCAGCAGCAAAGGTCTAGCGCAAGGTAGCACAGATACGCAGTATTTT	CASSKGLAQGSTDTQYF	TRBV4-3	TRBJ2-3
TGTGCCAGTACTGATATGACCAACTCCTACGAGCAGTACTTC	CASTDMTNSYEQYF	TRBV19	TRBJ2-7
TGCGCCAGCAGTGCTACTAGCGGGCGTGAGCAGTTCTTC	CASSATSGREQFF	TRBV10-1	TRBJ2-1
TGTGACATAGCGCCCAATGAGCAGTTCTTC	CDIAPNEQFF	TRBV2	TRBJ2-1
TGTGCCAGCGACAGATACGAGCAGTACTTC	CASDRYEQYF	TRBV7-3	TRBJ2-7
TGCGCCAGCAGCTATGGGGGAGCCACAGATACGCAGTATTTT	CASSYGGATDTQYF	TRBV5-1	TRBJ2-3
TGCGCCAGCAGCTTGGTACCAGGGAACAATCAGCCCCAGCATTTT	CASSLVPGNNQPQHF	TRBV5-1	TRBJ1-5
TGTGCCAGCAGCTTACGGGGGGGGAGCTCCTACGAGCAGTACTTC	CASSLRGGSSYEQYF	TRBV7-3	TRBJ2-7
TGTGCCAGCAGTGACTCGTTAGCAAGGAAACCGGGACAGGGGGCGTTCTCTGGAAACACCATATATTTT	CASSDSLARKPGQGAFSGNTIYF	TRBV6-4	TRBJ1-3
TGTGCCAGGGGACGGGGCCCTTTTCTATACGAGCAGTACTTC	CARGRGPFLYEQYF	TRBV19	TRBJ2-7
TGCAGTGCTAGCCAGTCGAACACTGAAGCTTTCTTT	CSASQSNTEAFF	TRBV20-1	TRBJ1-1
TGTGCCACCGTGGGGGGTCATGAGCAGTTCTTC	CATVGGHEQFF	TRBV30	TRBJ2-1
TGCGCCAGCAGCCGTAAACCTTTAAAGACTGAAGCTTTCTTT	CASSRKPLKTEAFF	TRBV4-3	TRBJ1-1
TGTGCCAGCAGGGACAGGGGGGAAACTAATGAAAAACTGTTTTTT	CASRDRGETNEKLFF	TRBV11-3	TRBJ1-4
TGTGCCAGCAGCTTACGGCAGGGTCGGAAAACTAACACTGAAGCTTTCTTT	CASSLRQGRKTNTEAFF	TRBV11-3	TRBJ1-1
TGCAGCAAAACAGGGGGCTTTGGATACGAGCAGTACTTC	CSKTGGFGYEQYF	TRBV29-1	TRBJ2-7
TGCGCCAGCAGCTCCAGGGGGCGCCGCCATAGCAATCAGCCCCAGCATTTT	CASSSRGRRHSNQPQHF	TRBV5-1	TRBJ1-5
TGTGCCAGCCTTGGACGAAATCAGCCCCAGCATTTT	CASLGRNQPQHF	TRBV19	TRBJ1-5
TGTGCCAGTAGTAGAGTTTCTTTGGGGCAGTTTGATGGCTACACCTTC	CASSRVSLGQFDGYTF	TRBV19	TRBJ1-2
TGTGCCAGCAGTGACCCGGCTGGATTATACAATGAGCAGTTCTTC	CASSDPAGLYNEQFF	TRBV6-1	TRBJ2-1
TGCGCCAGCAGCCAAGATATGCGACCAGGGAAAACCACTGAAGCTTTCTTT	CASSQDMRPGKTTEAFF	TRBV4-3	TRBJ1-1
TGTGCCAGCTCACCCCTCCCGGGACAGGGGAGTGACGAGCAGTACTTC	CASSPLPGQGSDEQYF	TRBV18	TRBJ2-7
TGCGCCAGCAGCTTGGGGGAGGCCTGGGACAGTCGCCAGCCCCAGCATTTT	CASSLGEAWDSRQPQHF	TRBV5-1	TRBJ1-5
TGTGCCCCTTCCGGGACAGGGGGCGCTTATCAGCCCCAGCATTTT	CAPSGTGGAYQPQHF	TRBV5-4	TRBJ1-5
TGTGCCAGTAGTCCCGGGACTAGCGGGAGAAACGAGCAGTACTTC	CASSPGTSGRNEQYF	TRBV19	TRBJ2-7
TGTGCCGCTTCCGAGGTTTGTTCGGACTTGTCCTACGAGCAGTACTTC	CAASEVCSDLSYEQYF	TRBV3-1	TRBJ2-7
TGTGCCAGCAGCGTAGTCAGGGGGGCACAATGCTACGAGCAGTACTTC	CASSVVRGAQCYEQYF	TRBV9	TRBJ2-7
TGTGCCGCGGGCAGGCCGGGTTATAGCAATCAGCCCCAGCATTTT	CAAGRPGYSNQPQHF	TRBV11-2	TRBJ1-5
TGCAGTGCTAGAGCCGCTTACGGCACCGAGCAGTACTTC	CSARAAYGTEQYF	TRBV20-1	TRBJ2-7
TGTGCCAGCAGGAACTTCGGGGCATACTTC	CASRNFGAYF	TRBV6-4	TRBJ2-7
TGTGCCAGCAGCTGGGAAAAAGGGGGGGAGCTGACGACCTCTGGGGCCAACGTCCTGACTTTC	CASSWEKGGELTTSGANVLTF	TRBV7-4	TRBJ2-6
TGTGCCAGCAGCCCCGGGACTAGCGGGGGGGCCAACGTCCTGACTTTC	CASSPGTSGGANVLTF	TRBV6-3	TRBJ2-6
TGCAGTGCTAGCCTAGTCCGGGACAGGGAAGAGACCCAGTACTTC	CSASLVRDREETQYF	TRBV20-1	TRBJ2-5
TGTGCCAGCATGGTGGGAAGGGACAGGATCACTGAAGCTTTCTTT	CASMVGRDRITEAFF	TRBV5-4	TRBJ1-1
TGCATATCCCCTAATGGGGGAGCTTTCTTT	CISPNGGAFF	TRBV20-1	TRBJ1-1
TGTGCCATCAGTGGAAACCGTCGGACTAGCGGGAGGGGGTCTTCCCGTCACGAGCAGTACTTC	CAISGNRRTSGRGSSRHEQYF	TRBV10-3	TRBJ2-7
TGTGCCAGCAGCCCCCCAGGGGCTGAAGCTTTCTTT	CASSPPGAEAFF	TRBV6-5	TRBJ1-1
TGTGCCAGCAGTTTAACCCCCGGTTGGGACAGGGCCTGTGAAGCTTTCTTT	CASSLTPGWDRACEAFF	TRBV28	TRBJ1-1
TGTGCCAGCAGTTACGAATTCCCGAGACAGGTGGGCTACGAGCAGTACTTC	CASSYEFPRQVGYEQYF	TRBV6-5	TRBJ2-7
TGTGCCTGGAGTGCTTTACTAGCGGGTGAAGATACGCAGTATTTT	CAWSALLAGEDTQYF	TRBV30	TRBJ2-3
TGTGCCAGCAGCAAACTAGCCTACGAGCAGTACTTC	CASSKLAYEQYF	TRBV13	TRBJ2-7
TGCGCCAGCAGCTTGGACCCCGCTAGCTACGAGCAGTACTTC	CASSLDPASYEQYF	TRBV5-1	TRBJ2-7
TGTGCCAGCCCGGGCGGGACTAGGGATGAATCCTACAATGAGCAGTTCTTC	CASPGGTRDESYNEQFF	TRBV11-3	TRBJ2-1
TGTGCCAGCAAACTGACTAGCGGCCCTTCACCCTCAGATACGCAGTATTTT	CASKLTSGPSPSDTQYF	TRBV28	TRBJ2-3
TGCGCCAGCAGCTTGGGCCGGGACTATGAGCAGTTCTTC	CASSLGRDYEQFF	TRBV5-1	TRBJ2-1
TGTGCCAGCAGCAAAGAGACCCAGTCGGATAACTATGGCTACACCTTC	CASSKETQSDNYGYTF	TRBV11-3	TRBJ1-2
TGTGCCACCAGTGATTTGGGAGAGGGACAGGGGCACGACGAGCAGTACTTC	CATSDLGEGQGHDEQYF	TRBV24-1	TRBJ2-7
TGTGCCAGCAGTATAGCGATTGTCCAAGAGACCCAGTACTTC	CASSIAIVQETQYF	TRBV6-2	TRBJ2-5
TGTGCCAGCAGCTTAGCGCTATGGTACTGGACTGTCAGCTCTGGAAACACCATATATTTT	CASSLALWYWTVSSGNTIYF	TRBV7-9	TRBJ1-3
TGTGCCACCCCACCGGGACAGGAAATGGGCTTTTCACCCCTCCACTTT	CATPPGQEMGFSPLHF	TRBV6-4	TRBJ1-6
TGTGCCAGCAGTTACAGGTCCCAGATAGAGACCCAGTACTTC	CASSYRSQIETQYF	TRBV6-6	TRBJ2-5
TGCAGTGCTAGTAGGGGGGCCCCAGATACGCAGTATTTT	CSASRGAPDTQYF	TRBV20-1	TRBJ2-3
TGCAGTGCCAGGAAACGGCATCACACCATATATTTT	CSARKRHHTIYF	TRBV20-1	TRBJ1-3
TGTGCCAGCAGTTTACAAACGCGGGGGGGGAACCCCATTAGCGAGCAGTACTTC	CASSLQTRGGNPISEQYF	TRBV27	TRBJ2-7
TGTGCCACCACCTCTAGCGGGGATACGCAGTATTTT	CATTSSGDTQYF	TRBV24-1	TRBJ2-3
TGCAGTGCACGCGACCGGGACTCCGTCGGACAAGAGACCCAGTACTTC	CSARDRDSVGQETQYF	TRBV20-1	TRBJ2-5
TGTGCTAGTGGACAGCGCTACGAGCAGTACTTC	CASGQRYEQYF	TRBV12-5	TRBJ2-7
TGTGCCAGCAGCTCGGGTTCCCGGACAGAGGACAACGAGCAGTACTTC	CASSSGSRTEDNEQYF	TRBV7-9	TRBJ2-7
TGTGCCAGCAGACCATTGGACAGGGGTACGACCCAGTACTTC	CASRPLDRGTTQYF	TRBV3-1	TRBJ2-5
TGTGCCAGCAGCTTAGCCGGGACCGTCGAGTACACTGAAGCTTTCTTT	CASSLAGTVEYTEAFF	TRBV7-4	TRBJ1-1
TGTGCCAGTAGTATGGGGGGGCCGGGACAAGGCTACACCTTC	CASSMGGPGQGYTF	TRBV19	TRBJ1-2
TGTGCCAGCTCGCTCCCTAGCGGGATCTATTACGAGCAGTACTTC	CASSLPSGIYYEQYF	TRBV9	TRBJ2-7
TGTGCCAGCAGTAAGCCGATTACGGGACAGGGTAATTCACCCCTCCACTTT	CASSKPITGQGNSPLHF	TRBV6-1	TRBJ1-6
TGTGCCAGCAGCGACTGGACTGCCCACGAGCAGTACTTC	CASSDWTAHEQYF	TRBV7-3	TRBJ2-7
TGTGCCAGCAGTTTGCGGGAGGTGGCCGGAAACACCATATATTTT	CASSLREVAGNTIYF	TRBV12-3	TRBJ1-3
TGTGCCAGCAGTTACCTCTTAAATAATGAAAAACTGTTTTTT	CASSYLLNNEKLFF	TRBV6-5	TRBJ1-4
TGTGCCAGCACTCGGGCCCCCCGTAAGCTGACTAGCGGGTTCAAGTACGAGCAGTACTTC	CASTRAPRKLTSGFKYEQYF	TRBV2	TRBJ2-7
TGTGCCAGCAGCCGCGGGCTGGGAGAGCAGAACTACGAGCAGTACTTC	CASSRGLGEQNYEQYF	TRBV3-1	TRBJ2-7
TGTGCCACCAGTGATTTTGGTGGACGCCCTAACTATGGCTACACCTTC	CATSDFGGRPNYGYTF	TRBV24-1	TRBJ1-2
TGTGCCAGCGTGGGGGACAGGGTATCTGTGACCCAGTACTTC	CASVGDRVSVTQYF	TRBV12-4	TRBJ2-5
TGCAGTGCTAGTATGCGGACTGAAGCTTTCTTT	CSASMRTEAFF	TRBV20-1	TRBJ1-1
TGTGCCTGTCCAGGCCCCGGTCAAGAGACCCAGTACTTC	CACPGPGQETQYF	TRBV30	TRBJ2-5
TGCGCCAGCAGCCAAGAACTGGGGGGGGATGGCTACGAGCAGTACTTC	CASSQELGGDGYEQYF	TRBV4-1	TRBJ2-7
TGTCGGGAGGGAGGCACAGATACGCAGTATTTT	CREGGTDTQYF	TRBV10-3	TRBJ2-3
TGTGCCAGCAGCACTGACAGGGGGCCCGCCTACGAGCAGTACTTC	CASSTDRGPAYEQYF	TRBV7-8	TRBJ2-7
TGTGCCAGCAGCGGACCCAGGGTATACAATGAGCAGTTCTTC	CASSGPRVYNEQFF	TRBV7-4	TRBJ2-1
TGTGCCACCAGTGATTTGAAGGGCCTAGCTAGGGGCTCTGGAAACACCATATATTTT	CATSDLKGLARGSGNTIYF	TRBV24-1	TRBJ1-3
TGTGCCAGGGAGCGGATATCTAGGGGCAGAAAGACGGGGGGGCCAGAGCAGTTCTTC	CARERISRGRKTGGPEQFF	TRBV6-6	TRBJ2-1
TGTGCCAGCAGCTTATCCCCCACCTCCGGGACAGCTGAAGCTTTCTTT	CASSLSPTSGTAEAFF	TRBV11-3	TRBJ1-1
TGTGCCAGCAGTAACGATCAAAGGAGGGGGTTAGAGCAGTACTTC	CASSNDQRRGLEQYF	TRBV6-4	TRBJ2-7
TGTGCCAGCAGCCAAACCAATCAGTCCACAGATACGCAGTATTTT	CASSQTNQSTDTQYF	TRBV3-1	TRBJ2-3
TGTGCCATCAGGTGGGGGGGAAGGTACTTC	CAIRWGGRYF	TRBV10-3	TRBJ2-7
TGCGCCAGCAGTGAGTCACGAGGGAGCTCCTACGAGCAGTACTTC	CASSESRGSSYEQYF	TRBV10-1	TRBJ2-7
TGTGCCAGCAGCCCTGCCGGGGGGGGAGAGACCCAGTACTTC	CASSPAGGGETQYF	TRBV6-4	TRBJ2-5
TGTGCCAGCAGTTTGACAGGGGTTAGCCATGAAGCTTTCTTT	CASSLTGVSHEAFF	TRBV12-4	TRBJ1-1
TGTGCCAGCAGTGAAGCTGACAGGGACGAGCAGTACTTC	CASSEADRDEQYF	TRBV6-1	TRBJ2-7
TGTGCCACCGTCGCGGGTGGGGAGGATGTGCAAGCATACGAGCAGTACTTC	CATVAGGEDVQAYEQYF	TRBV6-5	TRBJ2-7
TGCGCCAGCAGCCGACAATACTTGGGGGTCTATGGCTACACCTTC	CASSRQYLGVYGYTF	TRBV4-3	TRBJ1-2
TGTGCCACCAGTGATTTCCGTTGGTTTCGACTTTGGGGGGCCAGAAGCTCCTACGAGCAGTACTTC	CATSDFRWFRLWGARSSYEQYF	TRBV24-1	TRBJ2-7
TGCGCCAGCAGACCCCGGATGTCAGGGAACACCGGGGAGCTGTTTTTT	CASRPRMSGNTGELFF	TRBV5-1	TRBJ2-2
TGTGCTAGGACCGGGACTCAATCCAATCAGCCCCAGCATTTT	CARTGTQSNQPQHF	TRBV12-5	TRBJ1-5
TGTGCCAGCAGAACACAGGGGAAGGGCTACACCTTC	CASRTQGKGYTF	TRBV27	TRBJ1-2
TGTATGAAGGGTCTTGAAGCTTTCTTT	CMKGLEAFF	TRBV10-3	TRBJ1-1
TGTGCAAGGACAGGGACCTCATGTCACCTGAACACTGAAGCTTTCTTT	CARTGTSCHLNTEAFF	TRBV27	TRBJ1-1
TGTGCCAGCAGCCAAGATGGGCTAGCGGGGGGGCCGAACTACTACAATGAGCAGTTCTTC	CASSQDGLAGGPNYYNEQFF	TRBV3-1	TRBJ2-1
TGTGCCAGCAGCTGTCCGGGACAGGGCGCTGTGAGCAATCAGCCCCAGCATTTT	CASSCPGQGAVSNQPQHF	TRBV7-3	TRBJ1-5
TGTGCCAGCAGCTGCGGGTGTCAAGAGACCCAGTACTTC	CASSCGCQETQYF	TRBV11-1	TRBJ2-5
TGTGCCAGCAGCGGCGAGGCCGTATTTCAGCCCCAGCATTTT	CASSGEAVFQPQHF	TRBV13	TRBJ1-5
TGCGCCAGCACAGGGAATGGCTACACCTTC	CASTGNGYTF	TRBV10-1	TRBJ1-2
TGTGCCAGCAGCCTGGGCCTACGAGACTACGAGCAGTACTTC	CASSLGLRDYEQYF	TRBV3-1	TRBJ2-7
TGTGCCAGCTCACCAAACGCCGACAGGGATCTTTATGGCTACACCTTC	CASSPNADRDLYGYTF	TRBV18	TRBJ1-2
TGTGCCAGCAGCTTGTCCGGGACAGAGGCGAACACTGAAGCTTTCTTT	CASSLSGTEANTEAFF	TRBV5-6	TRBJ1-1
TGCGCCAGCAGCAGACAGAGGGGGCGTCCAGCTAACTATGGCTACACCTTC	CASSRQRGRPANYGYTF	TRBV5-1	TRBJ1-2
TGCAGTGCTTTGGGAGGCTACGAGCAGTACTTC	CSALGGYEQYF	TRBV20-1	TRBJ2-7
TGTGCCAGCAGCCTTTTACCGGGACAGAAGGCAGTTACTGAAGCTTTCTTT	CASSLLPGQKAVTEAFF	TRBV14	TRBJ1-1
TGTGCCAGCAGCCAAGAACTCTTAACGGGAAATAGCAATCAGCCCCAGCATTTT	CASSQELLTGNSNQPQHF	TRBV14	TRBJ1-5
TGTGCCAGCTCACCAACTAGGGACTTCAGGAACACTGAAGCTTTCTTT	CASSPTRDFRNTEAFF	TRBV18	TRBJ1-1
TGTGCCAGCAGCGACGGGGTCTCTGGGGCCAACGTCCTGACTTTC	CASSDGVSGANVLTF	TRBV3-1	TRBJ2-6
TGTGCCAGCAGCTTAGGGGCCCAGAACACTGAAGCTTTCTTT	CASSLGAQNTEAFF	TRBV5-6	TRBJ1-1
TGTGCCAGTAGTATCGCTGCGACAGGGGATGTGGATTGCAATCAGCCCCAGCATTTT	CASSIAATGDVDCNQPQHF	TRBV19	TRBJ1-5
TGCGCCAGCAGCTCCGAAGGGGGGGTTTTACTGGTCGAGCAGTACTTC	CASSSEGGVLLVEQYF	TRBV5-1	TRBJ2-7
TGTGCCAGCAGCTTAGAGTTGTTGGACAGGGAGAGGGAGTACGAGCAGTACTTC	CASSLELLDREREYEQYF	TRBV7-6	TRBJ2-7
TGTGCCAGCAGACATGGGGGCGGGGCCTACGAGCAGTACTTC	CASRHGGGAYEQYF	TRBV5-8	TRBJ2-7
TGTGCCAGCAGCGTAGCAGGGACCCTAACTAATGAAAAACTGTTTTTT	CASSVAGTLTNEKLFF	TRBV9	TRBJ1-4
TGTGCCAGCAGCTTAGGACGTTCAGATACGCAGTATTTT	CASSLGRSDTQYF	TRBV11-3	TRBJ2-3
TGTGCCAGCAGCTTAGGCAGGGCTAACACTGAAGCTTTCTTT	CASSLGRANTEAFF	TRBV5-6	TRBJ1-1
TGTGCCAGCGCCCGGGCGGGGGAAAAACTGTTTTTT	CASARAGEKLFF	TRBV7-9	TRBJ1-4
TGTGCCAGCAGCTTAGCGGCTGACAGCACAGATACGCAGTATTTT	CASSLAADSTDTQYF	TRBV7-9	TRBJ2-3
TGTGCCAGCAGTTGGTTTCAAGCGGGACGGACCGGGGAGCTGTTTTTT	CASSWFQAGRTGELFF	TRBV27	TRBJ2-2
TGTGCCAGCAGTTACTCAAGGGAAACGGAATACAATGAGCAGTTCTTC	CASSYSRETEYNEQFF	TRBV6-2	TRBJ2-1
TGTGCCAGCAGTATCGCGGTACAAGACGGACTAGCGGGGGGGCCGGACAATGAGCAGTTCTTC	CASSIAVQDGLAGGPDNEQFF	TRBV28	TRBJ2-1
TGTGCTAGTGGTTTCGAAGGGACAGGGCATGGCTACACCTTC	CASGFEGTGHGYTF	TRBV12-5	TRBJ1-2
TGCGCCAGGGGTGGACAGGGCTACGAGCAGTACTTC	CARGGQGYEQYF	TRBV10-1	TRBJ2-7
TGCGCCAGCAGCCAAGATATAGATCGGCTACCGGGGGGCAAAGTCGATACGCAGTATTTT	CASSQDIDRLPGGKVDTQYF	TRBV4-1	TRBJ2-3
TGTGCCAGCAGCCAAGGAGTTTTGAGCTATGAGCAGTTCTTC	CASSQGVLSYEQFF	TRBV3-1	TRBJ2-1
TGTGCCAGCAGTGAACAAAGCCGGGGATATAGCAATCAGCCCCAGCATTTT	CASSEQSRGYSNQPQHF	TRBV6-1	TRBJ1-5
TGTGCCAGCAGCCCGACCCCCGGGAACTATGGCTACACCTTC	CASSPTPGNYGYTF	TRBV11-2	TRBJ1-2
TGTGCCAGTAGGCACTTGAACTACGAGCAGTACTTC	CASRHLNYEQYF	TRBV19	TRBJ2-7
TGTGCCAGCAGAGGGGGGGGCCAGAGCAATCAGCCCCAGCATTTT	CASRGGGQSNQPQHF	TRBV27	TRBJ1-5
TGTGCCATCTCTGGACTAGCGGGCGGGGGGGAAGAGACCCAGTACTTC	CAISGLAGGGEETQYF	TRBV10-3	TRBJ2-5
TGCAGCGTAGGACAGCGCACGCCAACTAATGAAAAACTGTTTTTT	CSVGQRTPTNEKLFF	TRBV29-1	TRBJ1-4
TGTGCCAGCACTACCCAGCGGAGCACCGGGGAGCTGTTTTTT	CASTTQRSTGELFF	TRBV6-4	TRBJ2-2
TGCAGTGCTAGTGGACCGTTAACCAGACAGGTCCGGACGGAAGACTATGGCTACACCTTC	CSASGPLTRQVRTEDYGYTF	TRBV20-1	TRBJ1-2
TGTGCCAGGCAGAGAAGGATGAACACTGAAGCTTTCTTT	CARQRRMNTEAFF	TRBV19	TRBJ1-1
TGTGCCAGCATAGCTTGGGGGCAAGGCTACACCTTC	CASIAWGQGYTF	TRBV14	TRBJ1-2
TGCAGTGCAGGGTCACACACTGAAGCTTTCTTT	CSAGSHTEAFF	TRBV20-1	TRBJ1-1
TGTGCCACCAGTGGGCTCGGGACTAGCGGGAAACAAGAGACCCAGTACTTC	CATSGLGTSGKQETQYF	TRBV24-1	TRBJ2-5
TGCGCCAGCAGCGGGGGGACAGGGCAAAGCACCGGGGAGCTGTTTTTT	CASSGGTGQSTGELFF	TRBV5-1	TRBJ2-2
TGTGCCAGCAGCCAAGACGGACCAAAGGATGGGGCCAACGTCCTGACTTTC	CASSQDGPKDGANVLTF	TRBV14	TRBJ2-6
TGTGCCAGCAGTTACATTATTGGAGGGGGACTCAATCAGCCCCAGCATTTT	CASSYIIGGGLNQPQHF	TRBV6-5	TRBJ1-5
TGTGCCACCAGTGATTACAACGGTCAACAGGGGGGAAAAGAGCAGTACTTC	CATSDYNGQQGGKEQYF	TRBV24-1	TRBJ2-7
TGTGCCAGCAGCGTTAGGGGGGGGTGTCAGCCCCAGCATTTT	CASSVRGGCQPQHF	TRBV6-1	TRBJ1-5
TGTGCCAGCAGCGGTAGTCCGGAGCAGTTCTTC	CASSGSPEQFF	TRBV7-9	TRBJ2-1
TGTGCCAGCAGCCTCACCGTCACCTCCGGGACTAGCGGGGCCTACGAGCAGTACTTC	CASSLTVTSGTSGAYEQYF	TRBV7-4	TRBJ2-7
TGTGCCAGCAGCTGTGAGAGGAACACCATATATTTT	CASSCERNTIYF	TRBV7-3	TRBJ1-3
TGTGCTGCGGGAGGAACCCCCTACAATGAGCAGTTCTTC	CAAGGTPYNEQFF	TRBV10-3	TRBJ2-1
TGTGCCAGCAGCTTAGCCCCTCCTAAATGCTATGGCTACACCTTC	CASSLAPPKCYGYTF	TRBV7-9	TRBJ1-2
TGTGCCAGCAGTGCCAAGTCTAGTTCCACCCAAGAGACCCAGTACTTC	CASSAKSSSTQETQYF	TRBV6-2	TRBJ2-5
TGTGCCAGCAGCCCCCTCCAACGGGGTTGCGAAAAACTGTTTTTT	CASSPLQRGCEKLFF	TRBV7-3	TRBJ1-4
TGTGCCAGCAATCAGGGGGATCAGCCCCAGCATTTT	CASNQGDQPQHF	TRBV5-6	TRBJ1-5
TGTGCCAGTAGAGGGGCCTCTGGAAACACCATATATTTT	CASRGASGNTIYF	TRBV19	TRBJ1-3
TGTGCCAGCAGCGTTCGAAGCCCCGGGACAGTAAACACCATATATTTT	CASSVRSPGTVNTIYF	TRBV5-8	TRBJ1-3
TGTGCCAGCAGCGAAACCTGGGACAACGAGTCTGGAAACACCATATATTTT	CASSETWDNESGNTIYF	TRBV13	TRBJ1-3
TGTGCCAGCAGCGTAGAGGGTTTTTCACCCCTCCACTTT	CASSVEGFSPLHF	TRBV9	TRBJ1-6
TGTGCCAGCAGCTTGGACGTAGGGAATCAGCCCCAGCATTTT	CASSLDVGNQPQHF	TRBV13	TRBJ1-5
TGTGCCTGGAGTGTACTAGCTACGGGACAGGGGGCCTACGAGCAGTACTTC	CAWSVLATGQGAYEQYF	TRBV30	TRBJ2-7
TGTGCCACCGGGAGAGACAGGAGGCCTGGAAACACCATATATTTT	CATGRDRRPGNTIYF	TRBV24-1	TRBJ1-3
TGCGCCAGCAGCCTGTACAGGAGGGAGGCGGATGGCTACACCTTC	CASSLYRREADGYTF	TRBV4-1	TRBJ1-2
TGTGCCACCAGTGATACCGTGGCGACGCAGTATTTT	CATSDTVATQYF	TRBV24-1	TRBJ2-3
TGCAGTGCTAATAAGGGAGGTCACACTGAAGCTTTCTTT	CSANKGGHTEAFF	TRBV20-1	TRBJ1-1
TGTGCCAGCAGCCACCGAGGGGCAGGGAACACTGAAGCTTTCTTT	CASSHRGAGNTEAFF	TRBV6-5	TRBJ1-1
TGTGCCAGCAGCCCTCCAACTAGCGGGCCGCATTACAATGAGCAGTTCTTC	CASSPPTSGPHYNEQFF	TRBV9	TRBJ2-1
TGTGCCAGCAGCTTAGCGTACAGGGGCTTTGATACGCAGTATTTT	CASSLAYRGFDTQYF	TRBV7-4	TRBJ2-3
TGTGCCAGCAGCCCCTGGACTAATGAAAAACTGTTTTTT	CASSPWTNEKLFF	TRBV5-4	TRBJ1-4
TGTGCCAGCAACGTGAAACTTAATTCACCCCTCCACTTT	CASNVKLNSPLHF	TRBV9	TRBJ1-6
TGTGCCAGCAGTTACTCCCGATATGGCTACACCTTC	CASSYSRYGYTF	TRBV6-5	TRBJ1-2
TGTGCCAGCAGCCGTGAGACAAGGACAGTAAGAGCTCACACTGAAGCTTTCTTT	CASSRETRTVRAHTEAFF	TRBV6-2	TRBJ1-1
