TGTGCCATTCACAATCAGCCCCAGCATTTT	CAIHNQPQHF	TRBV6-1	TRBJ1-5
TGTGCCAGCAGTTACCCGGGGGGGCTTGACGAGCAGTACTTC	CASSYPGGLDEQYF	TRBV6-5	TRBJ2-7
TGTGCCAGCAGCTCCGGACAGGGAAAACTGTTTTTT	CASSSGQGKLFF	TRBV5-4	TRBJ1-4
TGTGCCAGCAGACTACGGGGAGGTGGCAATGAGCAGTTCTTC	CASRLRGGGNEQFF	TRBV25-1	TRBJ2-1
TGTGATTCAGGGGGTAATCAGCCCCAGCATTTT	CDSGGNQPQHF	TRBV29-1	TRBJ1-5
TGTGCCAGCAGTGGTCCCGCCGGGACAGTCAAGAACACTGAAGCTTTCTTT	CASSGPAGTVKNTEAFF	TRBV6-1	TRBJ1-1
TGTGCCAGCGAGGGTCCGGGACAGGGGAACGAGCAGTACTTC	CASEGPGQGNEQYF	TRBV6-5	TRBJ2-7
TGTGCCAGCAGTTTTTTGGGGGGGCCGAGAGAGACCCAGTACTTC	CASSFLGGPRETQYF	TRBV27	TRBJ2-5
TGCGCCAGCCGTCTCCTCTTGCTATGGCGAGGATACGAGCAGTACTTC	CASRLLLLWRGYEQYF	TRBV5-1	TRBJ2-7
TGTGCCACGCGGGACCCCTCCTACGAGCAGTACTTC	CATRDPSYEQYF	TRBV27	TRBJ2-7
TGTGCCAGCAGCGCATCTAGCACCCCAGGGGCGGCCTACGAGCAGTACTTC	CASSASSTPGAAYEQYF	TRBV9	TRBJ2-7
TGTGCCACCAGTGATTTGTCCCATTCCCCCTTTACTGAAGCTTTCTTT	CATSDLSHSPFTEAFF	TRBV24-1	TRBJ1-1
TGTGCCAGCAGCGGCCCTTCGGTAAGGTACGAGCAGTACTTC	CASSGPSVRYEQYF	TRBV9	TRBJ2-7
TGCGCCAGCAGCCGTCCCGGGGGGAACACTGAAGCTTTCTTT	CASSRPGGNTEAFF	TRBV5-1	TRBJ1-1
TGCGCCAGCAGCCAAGGCCAAGGGGAGCTGTTTTTT	CASSQGQGELFF	TRBV4-1	TRBJ2-2
TGTGCCAGCAGCTTGAACGGCCGCAACACCGGGGAGCTGTTTTTT	CASSLNGRNTGELFF	TRBV5-4	TRBJ2-2
TGTGCCAGCAGCTTACGCCTCCGGGAGCAGTTCTTC	CASSLRLREQFF	TRBV7-3	TRBJ2-1
TGTGCCAGCAGCTTGGTCGCGGGACAGTATACTGAAGCTTTCTTT	CASSLVAGQYTEAFF	TRBV5-4	TRBJ1-1
TGTGCCAGCAGTAAGTCTAGCCGGACAGATACGCAGTATTTT	CASSKSSRTDTQYF	TRBV27	TRBJ2-3
TGTGCCAGTAGTATCCGCCGGCAGCCCCAGCATTTT	CASSIRRQPQHF	TRBV19	TRBJ1-5
TGTGCCAGCAGCTTGGAGGGTAATTTCCAAGAGACCCAGTACTTC	CASSLEGNFQETQYF	TRBV5-6	TRBJ2-5
TGTGCCACCAGTGTACAGCCGGGACTAGCTACCTACAATGAGCAGTTCTTC	CATSVQPGLATYNEQFF	TRBV24-1	TRBJ2-1
TGTGCCAGCAGTTATGGGGACGAGCAGTACTTC	CASSYGDEQYF	TRBV27	TRBJ2-7
TGTGCCAGCCTCGGCGGGTTTTACGAGCAGTACTTC	CASLGGFYEQYF	TRBV18	TRBJ2-7
TGCAGTGCTAGATTGTACACCGGGGAGCTGTTTTTT	CSARLYTGELFF	TRBV20-1	TRBJ2-2
TGTGCCAGCAGCTTCGTGACGGAGTACGAGCAGTACTTC	CASSFVTEYEQYF	TRBV5-8	TRBJ2-7
TGTGCCAGCAGCCCAGGGGACAGGGCTCGTCACTACGAGCAGTACTTC	CASSPGDRARHYEQYF	TRBV9	TRBJ2-7
TGTGCCCCGCTAGCGGGTCCCTACGAGCAGTACTTC	CAPLAGPYEQYF	TRBV10-3	TRBJ2-7
TGTGCCAGCAGTTACGAAGGGACAGGACTGGAAGAGACCCAGTACTTC	CASSYEGTGLEETQYF	TRBV6-5	TRBJ2-5
TGTGCCAGCAGCCAAGCATGGCATGGCTACACCTTC	CASSQAWHGYTF	TRBV4-2	TRBJ1-2
TGCAGCAAAAACGGTCATCCGGGGTACGAGCAGTACTTC	CSKNGHPGYEQYF	TRBV29-1	TRBJ2-7
TGTGCCAGCAGTTGTACCCGACCCGGGACTAGCGGGGATTTCGAGACCCAGTACTTC	CASSCTRPGTSGDFETQYF	TRBV6-2	TRBJ2-5
TGTGCCACCAGTGATTTGAAAAGGACGTGGGAAAACATTCAGTACTTC	CATSDLKRTWENIQYF	TRBV24-1	TRBJ2-4
TGCAGTGCTATTTCTGGGGGATCCTACGAGCAGTACTTC	CSAISGGSYEQYF	TRBV20-1	TRBJ2-7
TGCGCCAGCAGCTTGGACGGGGGGGCCTTCACCGGGGAGCTGTTTTTT	CASSLDGGAFTGELFF	TRBV5-1	TRBJ2-2
TGTGCCAGCAGTGAATTTCGTACAGGGGGGGGTTCCCACGAGCAGTACTTC	CASSEFRTGGGSHEQYF	TRBV6-1	TRBJ2-7
TGTGCCATCAGTCCTAGACACTATATTAGCACAGATACGCAGTATTTT	CAISPRHYISTDTQYF	TRBV10-3	TRBJ2-3
TGTGCCAGCAGCAATACGTGGAAGATGGGGCACGAGCAGTACTTC	CASSNTWKMGHEQYF	TRBV7-2	TRBJ2-7
TGTGCCAGCAGTTTAAGGGGCCACGTCAAAAACATTCAGTACTTC	CASSLRGHVKNIQYF	TRBV27	TRBJ2-4
TGTGCCAGCAGTGACTCAAAAGTTCACGACAACGGGACCATATATTTT	CASSDSKVHDNGTIYF	TRBV6-4	TRBJ1-3
TGTGCCAGCAGCGTAGCTAAGTTTATTCCGGGACAGGGGAACTATGGCTACACCTTC	CASSVAKFIPGQGNYGYTF	TRBV9	TRBJ1-2
TGTGCCAGCAGCCAAGGGACAGGCCCAATCTACGAGCAGTACTTC	CASSQGTGPIYEQYF	TRBV4-2	TRBJ2-7
TGTGCCAGCAGCGACCTGGACGGGGGGGCCCAAGAGACCCAGTACTTC	CASSDLDGGAQETQYF	TRBV9	TRBJ2-5
TGTGCCAGCAGTAGTGGGGCTGAGAGTGAGCAGTTCTTC	CASSSGAESEQFF	TRBV6-2	TRBJ2-1
TGTGCCAGCAGTTTAGTAGGGGTTAATCAGCCCCAGCATTTT	CASSLVGVNQPQHF	TRBV28	TRBJ1-5
TGTGCCAGCAGCCTTCCCTACGAGCAGTACTTC	CASSLPYEQYF	TRBV9	TRBJ2-7
TGTGCCAGCAGTGAACCGCCTGGGTCGGGGGACAGGGTCGCCCGGCGGGGCAATCAGCCCCAGCATTTT	CASSEPPGSGDRVARRGNQPQHF	TRBV6-1	TRBJ1-5
TGTGCCAGCAGCGACGACCCAACCGGGGGCGCCTCCTACGAGCAGTACTTC	CASSDDPTGGASYEQYF	TRBV9	TRBJ2-7
TGTGCCAGCAGCGGGGACAGGGAGGCAATAGGGGGCCCCCAAGAGACCCAGTACTTC	CASSGDREAIGGPQETQYF	TRBV6-5	TRBJ2-5
TGTGCCACCGTACCTTCGACAAGACAGGGAGAAGCTTTCTTT	CATVPSTRQGEAFF	TRBV24-1	TRBJ1-1
TGTGCCAGCAAGGACCCGGACCTCTATGGCTACACCTTC	CASKDPDLYGYTF	TRBV6-1	TRBJ1-2
TGTGCCAGTAGCTCTCCGCAAACAGTGTACACCGGGGAGCTGTTTTTT	CASSSPQTVYTGELFF	TRBV19	TRBJ2-2
TGCGCCAGCAGCAGAAGTAGAGCGGGGACTAGCGGGGGGGCCCCTCCGGAGACCCAGTACTTC	CASSRSRAGTSGGAPPETQYF	TRBV5-1	TRBJ2-5
TGTGCCAGCAGTTTAGCCAGACTAGCGGGGGGGCGTGTCGAGCAGTACTTC	CASSLARLAGGRVEQYF	TRBV12-4	TRBJ2-7
TGTGCCATCAGTGCCCCGAGGATGGGCCGGGGGCAAGAGACCCAGTACTTC	CAISAPRMGRGQETQYF	TRBV10-3	TRBJ2-5
TGTGCCAGCAGCTTGACCGCTGATGGGGACGAGCAGTACTTC	CASSLTADGDEQYF	TRBV7-9	TRBJ2-7
TGCGCCAGCAGCCAAGTCTCCTCCGGAGGCAATGCTAGCACAGATACGCAGTATTTT	CASSQVSSGGNASTDTQYF	TRBV4-1	TRBJ2-3
TGTGCTAGCAGCAAGGGACTAGCGCAAGAGACCCAGTACTTC	CASSKGLAQETQYF	TRBV7-7	TRBJ2-5
TGTGCCAGCCCCCACAGGGGCTTCAGCCACCGGGGGAAATTCCATTACACCGGGGAGCTGTTTTTT	CASPHRGFSHRGKFHYTGELFF	TRBV6-2	TRBJ2-2
TGTGCCAGCAGCTATGGGGGGGCTTGCGAGCAGTACTTC	CASSYGGACEQYF	TRBV7-9	TRBJ2-7
TGTGCCAGTAGGGGGGGGGCGTCAGATACGCAGTATTTT	CASRGGASDTQYF	TRBV19	TRBJ2-3
TGCGCCAGCAGCAAAAACCCGACTAGCGGGCGGAGTCCCTACAATGAGCAGTTCTTC	CASSKNPTSGRSPYNEQFF	TRBV5-1	TRBJ2-1
TGTGCCAGCAGCTCCACTAGCGGGAGCCTTTATCAGCCCCAGCATTTT	CASSSTSGSLYQPQHF	TRBV9	TRBJ1-5
TGTGCCAGCAGTTACAGGGCCTGTGGCTACACCTTC	CASSYRACGYTF	TRBV27	TRBJ1-2
TGTGCCAGCAGCGAGGACAGGGGGCTCACCGGGGAGCTGTTTTTT	CASSEDRGLTGELFF	TRBV4-2	TRBJ2-2
TGTGCCAGCTCACCACCTTATCGGGATTCCTACGAGCAGTACTTC	CASSPPYRDSYEQYF	TRBV18	TRBJ2-7
TGTGCCAGCAGTTTGCCAAAGCGGGAGAGGATGAACACTGAAGCTTTCTTT	CASSLPKRERMNTEAFF	TRBV28	TRBJ1-1
TGTGCCAGCAGCGCGAGATCTAGGGACAGGGACGAGCAGTACTTC	CASSARSRDRDEQYF	TRBV13	TRBJ2-7
TGCGCCAGGTTGGGACAAAGGAATGAAAAACTGTTTTTT	CARLGQRNEKLFF	TRBV10-1	TRBJ1-4
TGTGCCAGCAGCTTAGCGCTAGTAGGAAAGTCCTACGAGCAGTACTTC	CASSLALVGKSYEQYF	TRBV7-2	TRBJ2-7
TGCAGTGCCTTAGTTGGGGCCTCCTATGGCTACACCTTC	CSALVGASYGYTF	TRBV20-1	TRBJ1-2
TGTGCCAGCAGCCCTAAGGGGACAGGGTTTCGGGATCAGCCCCAGCATTTT	CASSPKGTGFRDQPQHF	TRBV13	TRBJ1-5
TGCGCCAGCAGTGCTTCCAGCCCACAGGGGGCGCTTGAGCAGTACTTC	CASSASSPQGALEQYF	TRBV10-1	TRBJ2-7
TGTGCCAGCAGCTTGACGGTCAAGTATGCTTTCTTT	CASSLTVKYAFF	TRBV11-2	TRBJ1-1
TGTGCCCAGGGCCGGACAGATACGCAGTATTTT	CAQGRTDTQYF	TRBV6-5	TRBJ2-3
TGTGCCAGCAGCCAATTGACAGGGAAAGACTCCTACGAGCAGTACTTC	CASSQLTGKDSYEQYF	TRBV7-3	TRBJ2-7
TGTGCCAGCAGCGCTAGGGGAGGCAATCAGCCCCAGCATTTT	CASSARGGNQPQHF	TRBV9	TRBJ1-5
TGTGCCAGCAGCTTAGGGGCCGACACTGAAGCTTTCTTT	CASSLGADTEAFF	TRBV11-3	TRBJ1-1
TGTGCCAGCAGCATGATTGTAGATCCCGAGACCCAGTACTTC	CASSMIVDPETQYF	TRBV11-2	TRBJ2-5
TGTGCCAGCAGGACAGGGGGCGACTATGGCTACACCTTC	CASRTGGDYGYTF	TRBV7-3	TRBJ1-2
TGTGCCAGCAGCTTAATACCTCTCAAAGAAGGACAGACCGATCAGCCCCAGCATTTT	CASSLIPLKEGQTDQPQHF	TRBV11-2	TRBJ1-5
TGTGCCAGCAGCTTAGCTAGCGGGGTTCCTGACAATGAGCAGTTCTTC	CASSLASGVPDNEQFF	TRBV7-4	TRBJ2-1
TGTGCCAGCTCACCACCACAGGGAAAGGGGGATTTTTCAACTAATGAAAAACTGTTTTTT	CASSPPQGKGDFSTNEKLFF	TRBV18	TRBJ1-4
TGTGGGGCCAGGGGGCAGCATTTT	CGARGQHF	TRBV7-2	TRBJ1-5
TGTGCCAGCAGCTTGGCCCTGGGAGTCCACGACCATAGCAATCAGCCCCAGCATTTT	CASSLALGVHDHSNQPQHF	TRBV5-4	TRBJ1-5
TGTGCCAGCAGCTTAGTTCGGCGGTACGAGCAGTACTTC	CASSLVRRYEQYF	TRBV7-6	TRBJ2-7
TGTGCCAGCAGCGTTCGGGGAGGACAGGGAGGGGGGGCTAGCACAGATACGCAGTATTTT	CASSVRGGQGGGASTDTQYF	TRBV9	TRBJ2-3
TGTGCCTGGAGTGTACCCCACCACACAGGGGCGTACTATAGCAATCAGCCCCAGCATTTT	CAWSVPHHTGAYYSNQPQHF	TRBV30	TRBJ1-5
TGTGCCAGCTGCTTAATACGAGACAGGAATGGCTACACCTTC	CASCLIRDRNGYTF	TRBV27	TRBJ1-2
TGCAGCGGATACACAGATACGCAGTATTTT	CSGYTDTQYF	TRBV29-1	TRBJ2-3
TGTGCCAGCAGCAGGTGGGCGGGAGACACTGAAGCTTTCTTT	CASSRWAGDTEAFF	TRBV13	TRBJ1-1
TGTGCCAGCAGCTTGGACACGCAATCCTACGAGCAGTACTTC	CASSLDTQSYEQYF	TRBV5-6	TRBJ2-7
TGCGCCAGCAGCTTCCTGGGACAGGGGGTAGGGTATAATTCACCCCTCCACTTT	CASSFLGQGVGYNSPLHF	TRBV5-1	TRBJ1-6
TGTGCCAGCAGCCACAACCTTCGGACTTCCTCCTACAATGAGCAGTTCTTC	CASSHNLRTSSYNEQFF	TRBV4-2	TRBJ2-1
TGTGCCAGCAGCTTAGCCAGAGGACAGGGGGGGATAGCCAAAAACATTCAGTACTTC	CASSLARGQGGIAKNIQYF	TRBV7-9	TRBJ2-4
TGTGCCAGCAGCTTGGCGGACCGGGACAGTGGGCAGTACTTC	CASSLADRDSGQYF	TRBV5-4	TRBJ2-7
TGTGCCAAGTTAGGCTCCACCGGGGAGCTGTTTTTT	CAKLGSTGELFF	TRBV9	TRBJ2-2
TGTGCCACCCGATCCTCAACGGGACAGGGACCAAGCTACACCTTC	CATRSSTGQGPSYTF	TRBV24-1	TRBJ1-2
TGTGCTAGTGGCGTTGCCGGGACTAGCACCAAAGTCTTC	CASGVAGTSTKVF	TRBV12-5	TRBJ2-1
TGTGCCAGCAGCCAAATCGGACGGCGAAATCAGCCCCAGCATTTT	CASSQIGRRNQPQHF	TRBV13	TRBJ1-5
TGTGCCACCAGCAGAAGGCTAGCGGAGACCATACAAGAGACCCAGTACTTC	CATSRRLAETIQETQYF	TRBV15	TRBJ2-5
TGCGCCAGCAGCTTGCCTGGGGGGGCGGATGGCTACACCTTC	CASSLPGGADGYTF	TRBV5-1	TRBJ1-2
TGTGCCAGCTCACCACTAAACCGAGGACAGTTCAATGAGCAGTTCTTC	CASSPLNRGQFNEQFF	TRBV18	TRBJ2-1
TGTGCCTGGAAACTAGCGGGAGAATTCTCCTACGAGCAGTACTTC	CAWKLAGEFSYEQYF	TRBV30	TRBJ2-7
TGTGCCAGTATTCCCCCTTGCAGGGCTAGTGGGGCCAACGTCCTGACTTTC	CASIPPCRASGANVLTF	TRBV19	TRBJ2-6
TGTGCCAGCAGTTTACGGACAACGGACACACTTGAGCAGTACTTC	CASSLRTTDTLEQYF	TRBV27	TRBJ2-7
TGCGCCAGCAGCCCGGTTCAGGTAACGCAGGCTAACTATGGCTACACCTTC	CASSPVQVTQANYGYTF	TRBV5-1	TRBJ1-2
TGTGCCAGCAGCTCCCCCGGGGGACTTAAGAGCACAGATACGCAGTATTTT	CASSSPGGLKSTDTQYF	TRBV11-3	TRBJ2-3
TGTGCCAGCAGCTTAAGGGCCGGGGGCTACACCTTC	CASSLRAGGYTF	TRBV7-3	TRBJ1-2
TGTGCCCTGACTAGCGGGCTCGAGCAGTACTTC	CALTSGLEQYF	TRBV6-5	TRBJ2-7
TGTGCCAGCAGCTCCTATTATGGCTACACCTTC	CASSSYYGYTF	TRBV5-8	TRBJ1-2
TGTGCCAGCAGTGACTCGCCTTGCGGAAAAACTCCCCGGGCCACTACAGATACGCAGTATTTT	CASSDSPCGKTPRATTDTQYF	TRBV6-4	TRBJ2-3
TGTGCCATCATTAAAACTGGAGGACAGGGTGTCGATAGCAATCAGCCCCAGCATTTT	CAIIKTGGQGVDSNQPQHF	TRBV10-3	TRBJ1-5
TGTGCCAGCAGTTTCAGTCAGGGCCCAAAGGAAGGTAGCAATCAGCCCCAGCATTTT	CASSFSQGPKEGSNQPQHF	TRBV12-4	TRBJ1-5
TGTGCCAGCAGTGCAGGTGGCCGAAACTATGGCTACACCTTC	CASSAGGRNYGYTF	TRBV6-1	TRBJ1-2
TGTGCCAGCAGTGACTCGAGGGACAGTGACACTGAAGCTTTCTTT	CASSDSRDSDTEAFF	TRBV6-4	TRBJ1-1
TGTGCCAGTAGTATAGAATCCTGGGGGACAGAGAGGTATAGCAATCAGCCCCAGCATTTT	CASSIESWGTERYSNQPQHF	TRBV19	TRBJ1-5
TGTGCCAGCAGGAGCAGGGGAAAGTACACTGAAGCTTTCTTT	CASRSRGKYTEAFF	TRBV6-2	TRBJ1-1
TGTGCCAGCAGTTCATTTCATGGAGGGGGGCGAGCAAGGTGTAACATTCAGTACTTC	CASSSFHGGGRARCNIQYF	TRBV6-5	TRBJ2-4
TGTGCCAGCAGCTCTAGGACAGGGGCCTCCTACGAGCAGTACTTC	CASSSRTGASYEQYF	TRBV5-4	TRBJ2-7
TGTGCCAGCAGCCCACGTAGGCTGGGGTACAATGAGCAGTTCTTC	CASSPRRLGYNEQFF	TRBV7-3	TRBJ2-1
TGTGCCAGCAGGGGGGGACTAGCGGGACTTGACTCCTACAATGAGCAGTTCTTC	CASRGGLAGLDSYNEQFF	TRBV6-1	TRBJ2-1
TGTGCCAGCAGTCAGGGGCCGTTAGGCTACACCTTC	CASSQGPLGYTF	TRBV6-5	TRBJ1-2
TGTGCCAGCAGCGTTTCGTCGAGCCGCTTTGTTCAAGAGACCCAGTACTTC	CASSVSSSRFVQETQYF	TRBV9	TRBJ2-5
TGTGCCAGCAGCGTAGTACGTCGGGGGGGCCTGGACAATGAGCAGTTCTTC	CASSVVRRGGLDNEQFF	TRBV9	TRBJ2-1
TGTGCCACCACCAGGACGTTCAATCAGCCCCAGCATTTT	CATTRTFNQPQHF	TRBV10-3	TRBJ1-5
TGCAGTGCTAGAGATCCCGCCACGGGGGAGCAGTACTTC	CSARDPATGEQYF	TRBV20-1	TRBJ2-7
TGTGCCAGCAGTTACGGGACTACGGGAGGGAGCCCGCGAAGGAGCAATCAGCCCCAGCATTTT	CASSYGTTGGSPRRSNQPQHF	TRBV12-3	TRBJ1-5
TGTGCCAGCAGTTACGGCAGGGGTCCAGAACCTGAAGCTTTCTTT	CASSYGRGPEPEAFF	TRBV6-3	TRBJ1-1
TGTGCCAGCAGCTTAGCGTCCAGGAACACTGAAGCTTTCTTT	CASSLASRNTEAFF	TRBV7-6	TRBJ1-1
TGCAGCGTTGAAGCCCAAACAGGGGGCTTTAAGGGCGGGGAGCTGTTTTTT	CSVEAQTGGFKGGELFF	TRBV29-1	TRBJ2-2
TGTGCCAGCAGCGGGAGGGGGAAGAGCTCCTACAATGAGCAGTTCTTC	CASSGRGKSSYNEQFF	TRBV28	TRBJ2-1
TGTGCCTTAGACAGGGGGTCTCAGCCCCAGCATTTT	CALDRGSQPQHF	TRBV6-1	TRBJ1-5
TGTGCCAGCAGCTTAGTGGTATGGCAAGATACCGGGGAGCTGTTTTTT	CASSLVVWQDTGELFF	TRBV7-3	TRBJ2-2
TGCGCCAGCAGCCAAAAAGGGGGGACAGACACGGGGAACACTGAAGCTTTCTTT	CASSQKGGTDTGNTEAFF	TRBV4-1	TRBJ1-1
TGTGCCAGCAGCCTAGCGGTCCGAACGAGAGCTAACTATGGCTACACCTTC	CASSLAVRTRANYGYTF	TRBV5-6	TRBJ1-2
TGCGCCAGCAGCCGTTTTGCTCGGGAGGATACGCAGTATTTT	CASSRFAREDTQYF	TRBV4-1	TRBJ2-3
TGTGCCAGCAGGGACGCGGGAGTGCCCTCTGGGGCCAACGTCCTGACTTTC	CASRDAGVPSGANVLTF	TRBV7-9	TRBJ2-6
TGCGCCAGCAGCCAAGGCCCTAAGAGGGGTTCGAACACCGGGGAGCTGTTTTTT	CASSQGPKRGSNTGELFF	TRBV4-1	TRBJ2-2
TGTGCCAGCAGCAAAGAGGGACAGGGCAATCAGCCCCAGCATTTT	CASSKEGQGNQPQHF	TRBV6-5	TRBJ1-5
TGTGCCAGCCTATATGCTAAAGAAGGGAGCTCCTACGAGCAGTACTTC	CASLYAKEGSSYEQYF	TRBV9	TRBJ2-7
TGTGCCAGGATGTTGATCACCGGGGGAGTCAGACAATGGGGGCAGCCCCAGCATTTT	CARMLITGGVRQWGQPQHF	TRBV6-5	TRBJ1-5
TGTGCCAGCAGCGGAAGCATCGGACTTCCCCCGACTGAAGCTTTCTTT	CASSGSIGLPPTEAFF	TRBV7-3	TRBJ1-1
TGCAGTGCTAGCAGGAGCGAACTCTACTATGGCTACACCTTC	CSASRSELYYGYTF	TRBV20-1	TRBJ1-2
TGTGCCAGCAGCTTAGAGCCCCCCGGGACAGCGGGAGTCTACGAGCAGTACTTC	CASSLEPPGTAGVYEQYF	TRBV11-1	TRBJ2-7
TGTGCCAGCAGCCGGGGTTCTCAGCCCCAGCATTTT	CASSRGSQPQHF	TRBV11-2	TRBJ1-5
TGTGCCAGCAGTTATGTAGGTGAGGGGGCGTGGGAATACTCAGGGATGAACACTGAAGCTTTCTTT	CASSYVGEGAWEYSGMNTEAFF	TRBV6-3	TRBJ1-1
TGTGCTAGTGGAAATGGGCCCGGGGCTTTCGGGATCAAGAAGTGCAGCTCCTATAATTCACCCCTCCACTTT	CASGNGPGAFGIKKCSSYNSPLHF	TRBV12-5	TRBJ1-6
TGTGCCAGCAGCCAAGCGGCGACAGATACGCAGTATTTT	CASSQAATDTQYF	TRBV14	TRBJ2-3
TGTGCCAGCAGCGCTCCATTATGGACCCCCTCCTATAATTCACCCCTCCACTTT	CASSAPLWTPSYNSPLHF	TRBV9	TRBJ1-6
TGTGCCAGCAGCGGTAGAGACGGATCCCCAACTAATGAAAAACTGTTTTTT	CASSGRDGSPTNEKLFF	TRBV6-2	TRBJ1-4
TGCAGTGCTGACAGGGAAAACGAGACCCAGTACTTC	CSADRENETQYF	TRBV20-1	TRBJ2-5
TGTGCCCCCGCGGGAGACCATCAGCCCCAGCATTTT	CAPAGDHQPQHF	TRBV30	TRBJ1-5
TGCAGCGTTGAGCGCGGGGGAGTAGGGTACGAGCAGTACTTC	CSVERGGVGYEQYF	TRBV29-1	TRBJ2-7
TGTGCCACCAGTAGGGTCATAGAAGAAGCTAGTTACAATGAGCAGTTCTTC	CATSRVIEEASYNEQFF	TRBV24-1	TRBJ2-1
TGTGCCAGCAGTGAGGGGGGGAGCACCGGGGAGCTGTTTTTT	CASSEGGSTGELFF	TRBV6-1	TRBJ2-2
TGTGCCAGCAGCTTAAGCTTCAGTCAAACGGGCTACACCTTC	CASSLSFSQTGYTF	TRBV7-3	TRBJ1-2
TGTGCCATCAGAAAATTGCCGGGACAGGGGGCAGGGACAGATACGCAGTATTTT	CAIRKLPGQGAGTDTQYF	TRBV10-3	TRBJ2-3
TGTGCCAGCTCACCTGAGGACAGGGTTCCTTTGGATCAGCCCCAGCATTTT	CASSPEDRVPLDQPQHF	TRBV18	TRBJ1-5
TGTGCCAGCAGCCAACCGGGACGAGGGTATGGCTACACCTTC	CASSQPGRGYGYTF	TRBV7-6	TRBJ1-2
TGTGCCAGTAGTAGTTCGGAAGCGGGACAGATGGACTATGGCTACACCTTC	CASSSSEAGQMDYGYTF	TRBV19	TRBJ1-2
TGCGCCAGCAGAGGGACAGGGCAAGATGGGAGCACAGATACGCAGTATTTT	CASRGTGQDGSTDTQYF	TRBV5-1	TRBJ2-3
TGTGCCAGCAGTTCAAGAGAAGCCCAGCCCATTCAGTACTTC	CASSSREAQPIQYF	TRBV28	TRBJ2-4
TGCGCCAGCAGCTTGGGGACAGGGCCCCAGCATTTT	CASSLGTGPQHF	TRBV5-1	TRBJ1-5
TGTGCCAGCAGCTTAACGAATGCGGGAGTGGACCCGCAGTTCTTC	CASSLTNAGVDPQFF	TRBV7-3	TRBJ2-1
TGTGCCACCAGTCGGGGGATTCAAAAGCAGTTCTTC	CATSRGIQKQFF	TRBV24-1	TRBJ2-1
TGTGCCAGCAGGGAACAAGGAAACACCATATATTTT	CASREQGNTIYF	TRBV6-2	TRBJ1-3
TGTGCCAGCAGTGCCTGTCCGGAAATAAAGGGACATGGCTACACCTTC	CASSACPEIKGHGYTF	TRBV6-4	TRBJ1-2
TGTGCCACCAGCAGAGATCCATCGGGAACTAATGAAAAACTGTTTTTT	CATSRDPSGTNEKLFF	TRBV15	TRBJ1-4
TGCGCCATTCGGGGGAGGGGCGACCATGTACTGTATTTT	CAIRGRGDHVLYF	TRBV10-1	TRBJ2-3
TGTGCCAGCAGCTTAGACCGCATTCCGTCGGGACCTACAGATACGCAGTATTTT	CASSLDRIPSGPTDTQYF	TRBV7-3	TRBJ2-3
TGCAGTGCAAGGGGAGGGGGCACTGAAGCTTTCTTT	CSARGGGTEAFF	TRBV20-1	TRBJ1-1
TGTGCCAGCATTGACGATGGAAACACCATATATTTT	CASIDDGNTIYF	TRBV5-4	TRBJ1-3
TGCAGTGCTAGAGCCTGGGGGCTGTGTTGCTACGAGCAGTACTTC	CSARAWGLCCYEQYF	TRBV20-1	TRBJ2-7
TGTGCCAGCAGTAGGACAGGGGGCCCCCCCCTGAACTCAAATTCACCCCTCCACTTT	CASSRTGGPPLNSNSPLHF	TRBV25-1	TRBJ1-6
TGTGCCAGCCGCGTGGGTCGCAATGAGCAGTTCTTC	CASRVGRNEQFF	TRBV11-3	TRBJ2-1
TGTGCCAGCACTTCCACAGTACGGATAAGTGCCCTCCCCGGGGAGCTGTTTTTT	CASTSTVRISALPGELFF	TRBV2	TRBJ2-2
TGTGCCAGCAGTGACTCAGAGGGATGTGGACAGGGGCTCCGCACTGAAGCTTTCTTT	CASSDSEGCGQGLRTEAFF	TRBV6-4	TRBJ1-1
TGTGCCAGCAGCCGGACAGGGGGGGAGTTGGGGGATCAGCCCCAGCATTTT	CASSRTGGELGDQPQHF	TRBV11-2	TRBJ1-5
TGTGCCAGCAGCAGGAATGGCGGGTTTACTGAAGCTTTCTTT	CASSRNGGFTEAFF	TRBV9	TRBJ1-1
TGTGCCAGCAGCTTTTTATTGTCAGGTGGCTACACCTTC	CASSFLLSGGYTF	TRBV7-2	TRBJ1-2
TGTGCCAGCAGCTTACCTACTCAGGGGGAACCTTCAGATGGCTACACCTTC	CASSLPTQGEPSDGYTF	TRBV7-9	TRBJ1-2
TGTGCCAGCAGCCGGGCCGGGTGGTACGAGCAGTACTTC	CASSRAGWYEQYF	TRBV7-9	TRBJ2-7
TGTGCCAGCAGGTCACTAACGACGCAGCCCCAGCATTTT	CASRSLTTQPQHF	TRBV11-3	TRBJ1-5
TGTGCCAGCAGCGGGTGGGACAGGGGGGGAAACACCATATATTTT	CASSGWDRGGNTIYF	TRBV25-1	TRBJ1-3
TGTGCCAGCAGCCAGTACGCGAATAGACAGGGGGCTGTGCAGCCCCAGCATTTT	CASSQYANRQGAVQPQHF	TRBV14	TRBJ1-5
TGTGCCAGCAGCGAAGACCACAGCGGCTCTGGAAACACCATATATTTT	CASSEDHSGSGNTIYF	TRBV9	TRBJ1-3
TGTGCCAGCAGCTTAACAAAGGGGGGGCGCGAGCAGTACTTC	CASSLTKGGREQYF	TRBV7-3	TRBJ2-7
TGTGCCAGCTCACCTGAAACCAAGTGGGGGGGTGGCTCCTACGAGCAGTACTTC	CASSPETKWGGGSYEQYF	TRBV18	TRBJ2-7
TGTGCCAGCAGCCCCTCGGGGGGGCGCTCCTACGAGCAGTACTTC	CASSPSGGRSYEQYF	TRBV11-2	TRBJ2-7
TGTGCCAGCAGTTACTCTCCCACTAGTTTCGAGCAGTACTTC	CASSYSPTSFEQYF	TRBV6-5	TRBJ2-7
TGCGCCAGCAGCCAAGATCAGCCCCAGCATTTT	CASSQDQPQHF	TRBV4-1	TRBJ1-5
TGTGCCAGCAGTTACTGTTGTGGGGGACAGGGTACTGAGCAGTTCTTC	CASSYCCGGQGTEQFF	TRBV6-5	TRBJ2-1
TGTGCCAGCAGCTTGGTGGGGCCGTTCCTGGGCGTAAGAGCTTTCTTT	CASSLVGPFLGVRAFF	TRBV5-6	TRBJ1-1
TGCGCCAGCAGCGGAAAGCTCGGAGGTTCCAGGGCCGGGAACCACTCAACCTACGAGCAGTACTTC	CASSGKLGGSRAGNHSTYEQYF	TRBV5-1	TRBJ2-7
TGTGCCAGCAGCCAAGATAGCGGGGGTCAGTACGAGCAGTACTTC	CASSQDSGGQYEQYF	TRBV14	TRBJ2-7
TGTGCCAGTAGTATAAGGGACAGGGCAGGGGTCTCCTACAATGAGCAGTTCTTC	CASSIRDRAGVSYNEQFF	TRBV19	TRBJ2-1
TGTGCCAGCACCCCCAGCGTGTCCTACAATGAGCAGTTCTTC	CASTPSVSYNEQFF	TRBV5-4	TRBJ2-1
TGTGCCAGCAGCTTAGATCTGGGACAGGGGGTATATCAGCCCCAGCATTTT	CASSLDLGQGVYQPQHF	TRBV11-2	TRBJ1-5
TGTGCCAGCAGCCAATCGGTCAACAATGAGCAGTTCTTC	CASSQSVNNEQFF	TRBV16	TRBJ2-1
TGTGCCAGCAGTTGTCTCTCCTACGAGCAGTACTTC	CASSCLSYEQYF	TRBV12-3	TRBJ2-7
TGCGCCAGCAGCCCTACCGGGACAGGGTTCCACACTGAAGCTTTCTTT	CASSPTGTGFHTEAFF	TRBV10-2	TRBJ1-1
TGCGCCAGCTGTAGTGGGGTTCTACTCCAAGAGACCCAGTACTTC	CASCSGVLLQETQYF	TRBV10-1	TRBJ2-5
TGTGCCAGAACGGGGGAGCAGTACTTC	CARTGEQYF	TRBV18	TRBJ2-7
TGTGCCAGCAGCTTAGAGCCTGCGGGGGGTAGAATCAGCTCCTACAATGAGCAGTTCTTC	CASSLEPAGGRISSYNEQFF	TRBV7-6	TRBJ2-1
TGTGCCAGCAGCCACGGTCGGGACTCGGAACCTTACAATGAGCAGTTCTTC	CASSHGRDSEPYNEQFF	TRBV13	TRBJ2-1
TGTGCCAGCAGCCTAGCGGGCAAGAATGAGCAGTTCTTC	CASSLAGKNEQFF	TRBV9	TRBJ2-1
TGTGCCAGCAGTGGGGTGGACAGGGAGGTTTGCAACGAGACCCAGTACTTC	CASSGVDREVCNETQYF	TRBV28	TRBJ2-5
TGTGCCAGCAGCTACGGGGTGGGGGGGTACTACGAGCAGTACTTC	CASSYGVGGYYEQYF	TRBV13	TRBJ2-7
TGTGCCAGCAGCCGTTCAAGGCACAGGGGGCCTCCGAATCAGCCCCAGCATTTT	CASSRSRHRGPPNQPQHF	TRBV9	TRBJ1-5
TGTGCCAGCAGTGGGGAGGGGAGGAGGGGTCCCTACGAGCAGTACTTC	CASSGEGRRGPYEQYF	TRBV2	TRBJ2-7
TGTGCCAGCAGCAACGGAATAAGACTATATACATACCGGGACACAAGAGCATCTAACTATGGCTACACCTTC	CASSNGIRLYTYRDTRASNYGYTF	TRBV7-7	TRBJ1-2
TGTGCCAGCAGTACAGGGTCTTGTAACTATGGCTACACCTTC	CASSTGSCNYGYTF	TRBV27	TRBJ1-2
TGTGCCAGCAGCCTATTACTAGCGGGAGTGGGGGATCAGCCCCAGCATTTT	CASSLLLAGVGDQPQHF	TRBV3-1	TRBJ1-5
TGTGCCAGCAGCTTGTGGGGGGGGGGGGTACATAGCAATCAGCCCCAGCATTTT	CASSLWGGGVHSNQPQHF	TRBV5-6	TRBJ1-5
TGTGCCAGCAGCCTAGTAGACCCTGGGGGGTACAATGAGCAGTTCTTC	CASSLVDPGGYNEQFF	TRBV5-4	TRBJ2-1
TGTGCCAGCAGGGGGGCTCATTCACCCCTCCACTTT	CASRGAHSPLHF	TRBV6-6	TRBJ1-6
TGTGCCACAGTCCCTTTTTTTCCCCTGGAGGTACCGGACAGGTCCGGGGAGCTGTTTTTT	CATVPFFPLEVPDRSGELFF	TRBV24-1	TRBJ2-2
TGTGCCACCAGTGCGACAGGGCACGGGGAGCTGTTTTTT	CATSATGHGELFF	TRBV24-1	TRBJ2-2
TGTGCCAGCAGCTTAGAATCCGACAGATGGTCCTACGAGCAGTACTTC	CASSLESDRWSYEQYF	TRBV7-9	TRBJ2-7
TGCGCCAGCAGCTTGCCAACGAACGGGGCACCCAGGGGGAACACTGAAGCTTTCTTT	CASSLPTNGAPRGNTEAFF	TRBV5-1	TRBJ1-1
TGCGTCCTACAGGGGTCCTACGAGCAGTACTTC	CVLQGSYEQYF	TRBV10-2	TRBJ2-7
TGTGCCAGCAGTAGGGACAATGAGCAGTTCTTC	CASSRDNEQFF	TRBV12-4	TRBJ2-1
TGCGCCAGCAGCTTAGGAGGTACAGCCTGCTATGGCTACACCTTC	CASSLGGTACYGYTF	TRBV5-1	TRBJ1-2
TGTGCCAGCAGCTCTTTAGTCCAGGACTTTGACCCACTTCTCTACGAGCAGTACTTC	CASSSLVQDFDPLLYEQYF	TRBV7-2	TRBJ2-7
TGTGCCAGCAGTTTACAGGGGCTCTACGAGCAGTACTTC	CASSLQGLYEQYF	TRBV12-3	TRBJ2-7
TGTGCCAGCAACGCCAGTAAGATTAGGGACTATGGCTACACCTTC	CASNASKIRDYGYTF	TRBV25-1	TRBJ1-2
TGTGCCAGCAGCTTACCAGCGGGGAAATACAATGAGCAGTTCTTC	CASSLPAGKYNEQFF	TRBV7-3	TRBJ2-1
TGTGCCAGCAGACCTCTACGACCGACAGCGAACACCGGGGAGCTGTTTTTT	CASRPLRPTANTGELFF	TRBV12-3	TRBJ2-2
TGTGCCAGCAGCCGGCGGGAGACAGATACGCAGTATTTT	CASSRRETDTQYF	TRBV6-1	TRBJ2-3
TGCAGCTTGAGAGAGACCCAGTACTTC	CSLRETQYF	TRBV29-1	TRBJ2-5
TGCAGCGAAATGCGGCCGGGACTAGATAGAATGAGCACCGGGGAGCTGTTTTTT	CSEMRPGLDRMSTGELFF	TRBV29-1	TRBJ2-2
TGTGCCAGCAGCTTGGAGGTAGACAGGGGGCGGGACACTGAAGCTTTCTTT	CASSLEVDRGRDTEAFF	TRBV5-6	TRBJ1-1
TGTGCTCTCCCAGAGGGGCCAGGCTACACCTTC	CALPEGPGYTF	TRBV6-5	TRBJ1-2
TGTGCCAGCATGAGGGGGGACGGTGAAGCTTTCTTT	CASMRGDGEAFF	TRBV28	TRBJ1-1
TGTGCCAGCAGCTTAGCACCTATTTTTTCCGGGGAGCTGTTTTTT	CASSLAPIFSGELFF	TRBV7-8	TRBJ2-2
TGTGCCAGCAGCACCGGGGAGGGTTGTGGCTACACCTTC	CASSTGEGCGYTF	TRBV7-9	TRBJ1-2
TGTGCCAGCAGCCAAGCCCTAGTAGGCTACACCTTC	CASSQALVGYTF	TRBV3-1	TRBJ1-2
TGTGCCAGCAGTTTATTTATGTGCTACGAGCAGTACTTC	CASSLFMCYEQYF	TRBV27	TRBJ2-7
TGTGCCAGCAGGTGGATCAGGGAAAAAGAGCAGTACTTC	CASRWIREKEQYF	TRBV27	TRBJ2-7
TGCAGCGTCTCGAATGGAGCCGACGAGCAGTACTTC	CSVSNGADEQYF	TRBV29-1	TRBJ2-7
TGTGCCAGCAGTTACAAAACTAGCGGGAGGGCGGTAGGGGCTGAAGCTTTCTTT	CASSYKTSGRAVGAEAFF	TRBV6-1	TRBJ1-1
TGTGCCAGCAGCTTCCAGGGGAGCTCCTACGAGCAGTACTTC	CASSFQGSSYEQYF	TRBV13	TRBJ2-7
TGTGCAGAGCTGGTCGCCTGGGTTTTATCAGACGAGCAGTACTTC	CAELVAWVLSDEQYF	TRBV7-9	TRBJ2-7
TGTGTCCCCGGGACAGGGTGGTCGTGCTCACCCCTCCACTTT	CVPGTGWSCSPLHF	TRBV9	TRBJ1-6
TGTGCCAGTAGTAGTAATTGCGGCCCCAGGGAAATTCATGAGCAGTTCTTC	CASSSNCGPREIHEQFF	TRBV19	TRBJ2-1
TGTGCTCGGGCCCAGGGCACAGATACGCAGTATTTT	CARAQGTDTQYF	TRBV3-1	TRBJ2-3
TGTGCCAGCAGGTCAAGGGTCGAGACCCAGTACTTC	CASRSRVETQYF	TRBV25-1	TRBJ2-5
TGTGCCAGCATACGGGGGACCTGCACAGATACGCAGTATTTT	CASIRGTCTDTQYF	TRBV6-1	TRBJ2-3
TGCGCCAGCAGCTTCTGGCACAGAGTGAGTTACACTGAAGCTTTCTTT	CASSFWHRVSYTEAFF	TRBV5-1	TRBJ1-1
TGTGCCTCGATGGGACAGGGGGTCACAGATACGCAGTATTTT	CASMGQGVTDTQYF	TRBV30	TRBJ2-3
TGTGCCAGCAGCCCGACTCTCTACGAGCAGTACTTC	CASSPTLYEQYF	TRBV3-1	TRBJ2-7
TGCGCCAGCAGCTTGGTCAGGCCCTCCTATACCTACGAGCAGTACTTC	CASSLVRPSYTYEQYF	TRBV5-1	TRBJ2-7
TGTGCCAGCAGACGCGGGACAGGGGGTTATAACTATGGCTACACCTTC	CASRRGTGGYNYGYTF	TRBV28	TRBJ1-2
TGCAGCGTTTCGGGGAACACTGAAGCTTTCTTT	CSVSGNTEAFF	TRBV29-1	TRBJ1-1
TGTGCCAGCAGCCGATGGGGGCAGTATTTT	CASSRWGQYF	TRBV7-2	TRBJ2-3
TGCAGTGCTAGGGGACAGCGAGGAGGACCGAAAAAGAGGAGGAACACTGAAGCTTTCTTT	CSARGQRGGPKKRRNTEAFF	TRBV20-1	TRBJ1-1
TGTGCCAGCAGCACACAGGGAGCTCTTTTTAACACTGAAGCTTTCTTT	CASSTQGALFNTEAFF	TRBV7-3	TRBJ1-1
TGTGCCAGCAGCGATACCCCTTGCCGGGGGAGGGAGAGATACAATGAGCAGTTCTTC	CASSDTPCRGRERYNEQFF	TRBV9	TRBJ2-1
TGTGCCAGCAGCCTACAGAGGGGGAACACTGAAGCTTTCTTT	CASSLQRGNTEAFF	TRBV7-3	TRBJ1-1
TGTGCCAGCAGCAGGGGCGGGGCTAACTATGGCTACACCTTC	CASSRGGANYGYTF	TRBV5-6	TRBJ1-2
TGTGCCAGTACGACAGGCGGTCGTTCGTCCTACGAGCAGTACTTC	CASTTGGRSSYEQYF	TRBV19	TRBJ2-7
TGCGCCAGCAGGGGCCGGGACAGCGACGGTGGCTACACCTTC	CASRGRDSDGGYTF	TRBV4-1	TRBJ1-2
TGTGCCAGCCCCAACGGAGAGACCCAGTACTTC	CASPNGETQYF	TRBV6-5	TRBJ2-5
TGTGCCGACGTGGGCTACACCTTC	CADVGYTF	TRBV28	TRBJ1-2
TGTGCCACCAGCCCGGCGTTCGAATACCGGAAAGATACGCAGTATTTT	CATSPAFEYRKDTQYF	TRBV24-1	TRBJ2-3
TGTGCCAGCAGTCGATCCCCTTATTACAATGAGCAGTTCTTC	CASSRSPYYNEQFF	TRBV27	TRBJ2-1
TGCAGTGCTCGGAACGGACTGAGCTCCTACGAGCAGTACTTC	CSARNGLSSYEQYF	TRBV20-1	TRBJ2-7
TGTGCCAGCAGTTTATCCCCAGGGATCACCGGGGAGCTGTTTTTT	CASSLSPGITGELFF	TRBV28	TRBJ2-2
TGTGCCAGCTCACCAGTCCCCCATACTATCCAGGGCTACGAGCAGTACTTC	CASSPVPHTIQGYEQYF	TRBV18	TRBJ2-7
TGCGCCAGCAGCCTGGCAGGGAGAAGGGGTGGCTACACCTTC	CASSLAGRRGGYTF	TRBV5-1	TRBJ1-2
TGTGCCAGCAGCGTTTCCCATAGTCCCGTCCAAGAGACCCAGTACTTC	CASSVSHSPVQETQYF	TRBV7-7	TRBJ2-5
TGTGCCACCTACCCCAGGAGACAGAGAACCGGGGAGCTGTTTTTT	CATYPRRQRTGELFF	TRBV24-1	TRBJ2-2
TGTGCCAGCAGCGACAGGCCCGGGGGTCAGGGGGCGTGCTCCTACGAGCAGTACTTC	CASSDRPGGQGACSYEQYF	TRBV13	TRBJ2-7
TGTGCCGGGGGGGGAGACGAGCAGTACTTC	CAGGGDEQYF	TRBV24-1	TRBJ2-7
TGTGCCAGCAGCTTAGTAAAAAAGCCCAGAACTGAAGCTTTCTTT	CASSLVKKPRTEAFF	TRBV7-8	TRBJ1-1
TGCAGTGCTAGAGAGAAGTGGGGGGTGGGAAGGTCTACTGAAGCTTTCTTT	CSAREKWGVGRSTEAFF	TRBV20-1	TRBJ1-1
TGTGCCAGTAGAGTGACAGGGGTGAACACAGATACGCAGTATTTT	CASRVTGVNTDTQYF	TRBV19	TRBJ2-3
TGTGCCAGCAGCAGAAGGGATGGCTACACCTTC	CASSRRDGYTF	TRBV13	TRBJ1-2
TGTGCCAAAGTCCGGGGGCGGATTTTGGGGGACTATGGCTACACCTTC	CAKVRGRILGDYGYTF	TRBV28	TRBJ1-2
TGTGCCAGCAGCGTGCGGGAGTCCGGGGAGCTGTTTTTT	CASSVRESGELFF	TRBV7-3	TRBJ2-2
TGTGCCAGCAGCACGGGACGCAAGGGGGCTGAAGCTTTCTTT	CASSTGRKGAEAFF	TRBV13	TRBJ1-1
TGTGCCAGCAGCTTAGCGGGGGGGACCCGGAACACTGAAGCTTTCTTT	CASSLAGGTRNTEAFF	TRBV7-2	TRBJ1-1
TGCGCCAGCAGCCAAGTTGGGAATCAGCCCCAGCATTTT	CASSQVGNQPQHF	TRBV4-3	TRBJ1-5
TGTGCCAGCAGACAACAGGGCTATGGCTACACCTTC	CASRQQGYGYTF	TRBV13	TRBJ1-2
TGCGCCAGCAGCCATGACCTACTCACTGAAGCTTTCTTT	CASSHDLLTEAFF	TRBV5-1	TRBJ1-1
TGTGCCAGCAGTCGACTAGCGGGTTTCCAGACCCAGTACTTC	CASSRLAGFQTQYF	TRBV28	TRBJ2-5
TGTGCCAGCAGTTACCCCTTCAGGCCGGGACCGGGGGACAACGAGCAGTACTTC	CASSYPFRPGPGDNEQYF	TRBV6-2	TRBJ2-7
TGTGCCAGCGGGGGAGGGACCCATGGCTACACCTTC	CASGGGTHGYTF	TRBV9	TRBJ1-2
TGTGCCAGCACTTGTCTTGGAGTACAAGAGACCCAGTACTTC	CASTCLGVQETQYF	TRBV6-6	TRBJ2-5
TGTTGGACAGCGGTAGGCTACACCTTC	CWTAVGYTF	TRBV20-1	TRBJ1-2
TGTGCCAGCAGGGGTTGTGAAAAACTGTTTTTT	CASRGCEKLFF	TRBV7-4	TRBJ1-4
TGTGCCAGCAGCCAACACCCGACAGGGAAGGGCCTTTGTTCGATTTATAACTATGGCTACACCTTC	CASSQHPTGKGLCSIYNYGYTF	TRBV14	TRBJ1-2
TGTGCCAGCAGCTTGCCGGACAGGGCCGGTCAGCCCCAGCATTTT	CASSLPDRAGQPQHF	TRBV7-9	TRBJ1-5
TGTGCGCGAAGTAAGCTATTAAAAGAGACCCAGTACTTC	CARSKLLKETQYF	TRBV2	TRBJ2-5
TGTGCCAGCAGCTTATGGATCGCGTGGGGGGATACGCAGTATTTT	CASSLWIAWGDTQYF	TRBV7-9	TRBJ2-3
TGCGCCAGCAGCAAGGAAGGGGAAAGGTACCAAGAGACCCAGTACTTC	CASSKEGERYQETQYF	TRBV5-1	TRBJ2-5
TGTGCCAGCAGCAACAAATCAGGTTACACAGATACGCAGTATTTT	CASSNKSGYTDTQYF	TRBV13	TRBJ2-3
TGTGCCAGCAGCGGCCAACCCGGTTCACCCCTCCACTTT	CASSGQPGSPLHF	TRBV7-4	TRBJ1-6
TGTGCCAGCAGGGACATTCAGCCCCAGCATTTT	CASRDIQPQHF	TRBV28	TRBJ1-5
TGTGCCAGCAGCTTAGCGGGGGGTGAGCAGTTCTTC	CASSLAGGEQFF	TRBV7-2	TRBJ2-1
TGTGCCAGCCGGCAAACTTGGACTAGCGTATCAGATACGCAGTATTTT	CASRQTWTSVSDTQYF	TRBV11-3	TRBJ2-3
TGTGCCAGCAGTCTGGGACTAGCGGACCGCACCGGGGAGCTGTTTTTT	CASSLGLADRTGELFF	TRBV28	TRBJ2-2
TGCAGTGCCAAAGATGCAGGGGGCTCTGGGGCCAACGTCCTGACTTTC	CSAKDAGGSGANVLTF	TRBV20-1	TRBJ2-6
TGTGCCAGCAGCGCCAGGAAAATGAACACTGAAGCTTTCTTT	CASSARKMNTEAFF	TRBV5-6	TRBJ1-1
TGTGCCAGCAGTGGGCCTACTCAAGAGACCCAGTACTTC	CASSGPTQETQYF	TRBV2	TRBJ2-5
TGTGCCAGTAGTATAGCTACCCCGCAGGAACGAGATCTCCGAGTAGAGACCCAGTACTTC	CASSIATPQERDLRVETQYF	TRBV19	TRBJ2-5
TGTGCCAGCAGTGACCTAACCCCCCAAGGGGGAGGGCGACATGAAAAACTGTTTTTT	CASSDLTPQGGGRHEKLFF	TRBV6-4	TRBJ1-4
TGTGCCAGCTCGGGCGTCGGGCGTGGGGGTAGCACAGATACGCAGTATTTT	CASSGVGRGGSTDTQYF	TRBV18	TRBJ2-3
TGCGCCAGCAGCCAAAGGACTAGCGGGGTATTCAATGAGCAGTTCTTC	CASSQRTSGVFNEQFF	TRBV4-1	TRBJ2-1
TGTGCCAGCAGCTTAGATCTAGAAAAACAAGAGACCCAGTACTTC	CASSLDLEKQETQYF	TRBV11-2	TRBJ2-5
TGTGCCTCTCAATTTCTGGACAGGTCAATATTGTTCTTTAGGGGAACGTACGAGCAGTACTTC	CASQFLDRSILFFRGTYEQYF	TRBV30	TRBJ2-7
TGTGCCAGCTCACCCTCCCTAGCGGGACGTAGCACCGGGGAGCTGTTTTTT	CASSPSLAGRSTGELFF	TRBV18	TRBJ2-2
TGCGCCAGCAGCGGCCTGCGGACAGTTGAAGCTTTCTTT	CASSGLRTVEAFF	TRBV5-1	TRBJ1-1
TGCGCCAGCAGCCAAGACCCGAAGACGGCCAATGAGCAGTTCTTC	CASSQDPKTANEQFF	TRBV4-1	TRBJ2-1
TGTGCCAGCAGCGAGACCCCACAGGGGGGCAATGAGCAGTTCTTC	CASSETPQGGNEQFF	TRBV14	TRBJ2-1
TGTGCCAGCAGTGACACGGGGGGGGCCGATACGCAGTATTTT	CASSDTGGADTQYF	TRBV6-4	TRBJ2-3
TGTGCCAGCAGCACAGGGTTTATCTACAATGAGCAGTTCTTC	CASSTGFIYNEQFF	TRBV13	TRBJ2-1
TGCGCCAGCAGCTCTGACCTCACGGAGGGAGAGACCCAGTACTTC	CASSSDLTEGETQYF	TRBV5-1	TRBJ2-5
TGTGCCAGCAGCTTGGGTGGCCCAATAAACACTGAAGCTTTCTTT	CASSLGGPINTEAFF	TRBV5-4	TRBJ1-1
TGCGCCAGCAAAGGTCTAGCGGCAGATACGCAGTATTTT	CASKGLAADTQYF	TRBV10-1	TRBJ2-3
TGTGCCAGCAGTGAGGGGGGCGACAGGAAAGCTGGAAACACCATATATTTT	CASSEGGDRKAGNTIYF	TRBV6-4	TRBJ1-3
TGTGCCAGCAGCGCCTACCAAAACGAGACCCAGTACTTC	CASSAYQNETQYF	TRBV7-3	TRBJ2-5
TGTGCCTGGAGTGTACGCGGACAGGGGCAGCCCCAGCATTTT	CAWSVRGQGQPQHF	TRBV30	TRBJ1-5
TGTGCCACGGGACAGCCCAGGGAGACCCAGTACTTC	CATGQPRETQYF	TRBV25-1	TRBJ2-5
TGTGCCAGCAGTTACTCGACCAAAATCGGGTATAGCAATCAGCCCCAGCATTTT	CASSYSTKIGYSNQPQHF	TRBV6-5	TRBJ1-5
TGTGCCAGCAGGGACCTAGCGGGCCCTAACACCGGGGAGCTGTTTTTT	CASRDLAGPNTGELFF	TRBV6-4	TRBJ2-2
TGCGCCAGCTCGGGGGCCGAAGCTTTCTTT	CASSGAEAFF	TRBV10-2	TRBJ1-1
TGTGCCACCAGCAGAGATTGGAGGGGGGACCTAGCCAAAAACATTCAGTACTTC	CATSRDWRGDLAKNIQYF	TRBV15	TRBJ2-4
TGTGCCACCAGTGATTGGCCGGGACGAACCCATGAGCAGTTCTTC	CATSDWPGRTHEQFF	TRBV24-1	TRBJ2-1
TGTGCCAGCAGTTATTTAAGGAGGAGCGAGCAGTACTTC	CASSYLRRSEQYF	TRBV6-9	TRBJ2-7
TGCGCCAGCAGGATGAGGGCCGACGAGCAGTACTTC	CASRMRADEQYF	TRBV10-1	TRBJ2-7
TGTGCCAGCAGCCAAGAGTTTAGAGAATCCTATAATTCACCCCTCCACTTT	CASSQEFRESYNSPLHF	TRBV3-1	TRBJ1-6
TGTGCCAGCAGCTTAGACTTGTACGCAGGGGTGGAAAAACTGTTTTTT	CASSLDLYAGVEKLFF	TRBV11-3	TRBJ1-4
TGTGCCTGGAGTCCCCCAACACTAGGCACAAGCAATCAGCCCCAGCATTTT	CAWSPPTLGTSNQPQHF	TRBV30	TRBJ1-5
TGTGCCAGCAGCTTAGCGCTCTTACGGGGCTACACCTTC	CASSLALLRGYTF	TRBV7-4	TRBJ1-2
TGCGCCAGCAGCTTGAGCACTAACTATGGCTACACCTTC	CASSLSTNYGYTF	TRBV5-1	TRBJ1-2
TGTGCCAGCAGCGTCGGACAGGGAGCTAGTGGCTACACCTTC	CASSVGQGASGYTF	TRBV9	TRBJ1-2
TGTGCCAGCAGCTGGGACTGGGAGACCCAGTACTTC	CASSWDWETQYF	TRBV11-3	TRBJ2-5
TGTGCCAGCAGGGCTAAAGGGACTAGCGGGATTAGCTCCTACAATGAGCAGTTCTTC	CASRAKGTSGISSYNEQFF	TRBV6-6	TRBJ2-1
TGTGCCAGCAGGTTCGGGGGTACTAACTATGGCTACACCTTC	CASRFGGTNYGYTF	TRBV7-3	TRBJ1-2
TGTGCCAGCAGTTTATGCGGATCGACGGAGTCTGACGAGCAGTACTTC	CASSLCGSTESDEQYF	TRBV27	TRBJ2-7
TGTGCCATAAGTACCATTGGCTCAGGCGACGAGCAGTACTTC	CAISTIGSGDEQYF	TRBV10-3	TRBJ2-7
TGTGCCAGCAGTGAACCCCACGAAAATGAAAAACTGTTTTTT	CASSEPHENEKLFF	TRBV25-1	TRBJ1-4
TGTGCCAGCAGATCGACCGTAAGCACTGAAGCTTTCTTT	CASRSTVSTEAFF	TRBV7-4	TRBJ1-1
TGTGCCAGCAGCTGGGGGAGAAGCTCCTACGAGCAGTACTTC	CASSWGRSSYEQYF	TRBV5-6	TRBJ2-7
TGCGCCAGCAGCTACAATGGGGGAGCGCGGGGGGGGAACACCGGGGAGCTGTTTTTT	CASSYNGGARGGNTGELFF	TRBV5-1	TRBJ2-2
TGTGCCATCAGTAATCAGGGCAACTGCGCCTACGAGCAGTACTTC	CAISNQGNCAYEQYF	TRBV10-3	TRBJ2-7
TGTGCCAGCAGCACTCCGCTTAAGGACCCTTACACTGAAGCTTTCTTT	CASSTPLKDPYTEAFF	TRBV5-4	TRBJ1-1
TGTGCCAGCAGGATTGCGGGAGATTGCGCCGGGGAGCTGTTTTTT	CASRIAGDCAGELFF	TRBV7-3	TRBJ2-2
TGCGCCAGCAGCTTATACTTTCCCTCCTACAATGAGCAGTTCTTC	CASSLYFPSYNEQFF	TRBV5-1	TRBJ2-1
TGTGCCAGATTCCCACCCATGCAGGGGGCCCCCTATGGCTACACCTTC	CARFPPMQGAPYGYTF	TRBV19	TRBJ1-2
TGTGCCAGCAGCCAAGATGCGCCGGGAGGGCCCTGGACGTGCGATTTGAACACTGAAGCTTTCTTT	CASSQDAPGGPWTCDLNTEAFF	TRBV3-1	TRBJ1-1
TGTGCCAGCAGCCTCGAGATCAATGAGCAGTTCTTC	CASSLEINEQFF	TRBV7-3	TRBJ2-1
TGTGCCAGCAGTGTAGGAAGTGGGGACAGGGGGCTGGTTGAGCAGTACTTC	CASSVGSGDRGLVEQYF	TRBV27	TRBJ2-7
TGTGCCAGCAGTTTGAGGGCGCCGGGACAGGGGGGGACTGGAAACACCATATATTTT	CASSLRAPGQGGTGNTIYF	TRBV28	TRBJ1-3
TGTGCCAGCAGCGGAGGCAGAATCGGCTACACCTTC	CASSGGRIGYTF	TRBV5-6	TRBJ1-2
TGTGCCAGCAGGGTGACAGGGAAAGACGAGCAGTACTTC	CASRVTGKDEQYF	TRBV6-5	TRBJ2-7
TGTGCCAGCAGTTTACTTGGGGGGCCTTTGGGCTACAATGAGCAGTTCTTC	CASSLLGGPLGYNEQFF	TRBV27	TRBJ2-1
TGTGCCAGCAGCTTAGGGTGGCCGGACTGTCGATTCTACAATGAGCAGTTCTTC	CASSLGWPDCRFYNEQFF	TRBV7-9	TRBJ2-1
TGTGCCACCAGGGGACAGGGGGAATCTAGCTCCTACGAGCAGTACTTC	CATRGQGESSSYEQYF	TRBV24-1	TRBJ2-7
TGTGCCAGCAGCGGGAACGACGGGGCCAATCAGCCCCAGCATTTT	CASSGNDGANQPQHF	TRBV6-5	TRBJ1-5
TGTGCCAGCAGCGGCACTGCAGTAGCCTACGAGCAGTACTTC	CASSGTAVAYEQYF	TRBV7-9	TRBJ2-7
TGCGCCAGCAGCCCAAGTTGGGGTAACTCCTACGAGCAGTACTTC	CASSPSWGNSYEQYF	TRBV4-1	TRBJ2-7
TGCGCCAGCAGCTTGGTTAGGGGCAAAAGAAACGAGCAGTACTTC	CASSLVRGKRNEQYF	TRBV5-1	TRBJ2-7
TGTGCCAGCGGTTGCACAGATACGCAGTATTTT	CASGCTDTQYF	TRBV19	TRBJ2-3
TGTGCCAGCAGTGACTCGCCGAAGGGACGGGGACAAGAGACCCAGTACTTC	CASSDSPKGRGQETQYF	TRBV6-4	TRBJ2-5
TGTGCCAGCAGCAGAGCCGGGACAAACTATGGCTACACCTTC	CASSRAGTNYGYTF	TRBV3-1	TRBJ1-2
TGTGCCAGCAGCGCGGGAGCGACACTGTTTTTT	CASSAGATLFF	TRBV5-4	TRBJ1-4
TGTGCCAGCAGCCAAGGTCCGAGTGAGCGCGGGAGGCTAAAAGAGACCCAGTACTTC	CASSQGPSERGRLKETQYF	TRBV14	TRBJ2-5
TGTGCCAGCAGTTTATTCCGCGCCCCTCTGCGGGAGGGGGCCAAAAACATTCAGTACTTC	CASSLFRAPLREGAKNIQYF	TRBV28	TRBJ2-4
TGTGCCAGCAGCCGACCGGGACTAGCGGGAGTGGAGCGTAATGAAAAACTGTTTTTT	CASSRPGLAGVERNEKLFF	TRBV14	TRBJ1-4
TGTGCTAGTGGTTTGCGCACCATCCGGGAGGAGGGGGGCTACACCTTC	CASGLRTIREEGGYTF	TRBV12-5	TRBJ1-2
TGTGCCAGCAGTTCGGGACTAGCTAGGTACCAAGAGACCCAGTACTTC	CASSSGLARYQETQYF	TRBV6-9	TRBJ2-5
TGTGCCAGTAGAATGTCCGGGGGGTACAATGAGCAGTTCTTC	CASRMSGGYNEQFF	TRBV19	TRBJ2-1
TGTGCCACCAGTCACAGGGCCAGAGCTGGAAACACCATATATTTT	CATSHRARAGNTIYF	TRBV24-1	TRBJ1-3
TGTGCCAGCAGCGAAGTTTCGGGGACAGGGGGAAGGGGCTACACCTTC	CASSEVSGTGGRGYTF	TRBV9	TRBJ1-2
TGTGCCAGCAGTTACCCGAAGGGGTCTCAGCCCCAGCATTTT	CASSYPKGSQPQHF	TRBV6-5	TRBJ1-5
TGTGCCAGCAGTGAACTACTAGAGATCTCTGGAAACACCATATATTTT	CASSELLEISGNTIYF	TRBV6-1	TRBJ1-3
TGTGCCAGCAGTTACGAGGGGACAGGGGTAAACACTGAAGCTTTCTTT	CASSYEGTGVNTEAFF	TRBV6-6	TRBJ1-1
TGTGCTAGCTCCCGGGGAATCCGGAGGTTCGATGAAAAACTGTTTTTT	CASSRGIRRFDEKLFF	TRBV7-7	TRBJ1-4
TGTGCCAGCAGCAAAGGACAGGGAGGCCAAGAGACCCAGTACTTC	CASSKGQGGQETQYF	TRBV6-4	TRBJ2-5
TGTGCCAGCAGCCAAGACGAACCCGCTGACGAAGAGACCCAGTACTTC	CASSQDEPADEETQYF	TRBV14	TRBJ2-5
TGTGCCAGCAGTGAAGCCATGACGATAGCCTTC	CASSEAMTIAF	TRBV6-1	TRBJ1-2
TGTGCCAGCAGTTCAGGAGGGGGTTGCACTGAAGCTTTCTTT	CASSSGGGCTEAFF	TRBV27	TRBJ1-1
TGTGCCAGCAGCTTAGTTATAGAGGGGGGGGGAAGCAATCAGCCCCAGCATTTT	CASSLVIEGGGSNQPQHF	TRBV7-8	TRBJ1-5
TGTGCCAGCAGCTTCCGACAGGGGCCGCAAGAGACCCAGTACTTC	CASSFRQGPQETQYF	TRBV13	TRBJ2-5
TGTGCCAGCAGTCTGGCTAACAGGGCCCCAGAGACCCAGTACTTC	CASSLANRAPETQYF	TRBV6-3	TRBJ2-5
TGTGCCACCGACAGGGTGATATCAATCATGAACACTGAAGCTTTCTTT	CATDRVISIMNTEAFF	TRBV10-3	TRBJ1-1
TGCGCCAGCAGCTTTCGTGGCGTCGACAGGGCGGGGGGGTGCTATGGCTACACCTTC	CASSFRGVDRAGGCYGYTF	TRBV5-1	TRBJ1-2
TGTGCCAGCAGCCGAGGAGAGCTAGCGGTATTGTTCTCCTACGAGCAGTACTTC	CASSRGELAVLFSYEQYF	TRBV7-3	TRBJ2-7
TGTGCCAGCACCACCCCTTCTAGCGGGAAGGCCGGGGAGCTGTTTTTT	CASTTPSSGKAGELFF	TRBV27	TRBJ2-2
TGTGCCAGCAGCTGGGGGGTATCGGGAAGATACAATGAGCAGTTCTTC	CASSWGVSGRYNEQFF	TRBV11-3	TRBJ2-1
TGTGCCAGCTGGACTAATAGCAATCAGCCCCAGCATTTT	CASWTNSNQPQHF	TRBV7-7	TRBJ1-5
TGCAGCGTTGGCGTGGGGGGCAGGGACACTGAAGCTTTCTTT	CSVGVGGRDTEAFF	TRBV29-1	TRBJ1-1
TGTGCCAGCAGCGCGGCTGGTTACGAGCAGTACTTC	CASSAAGYEQYF	TRBV7-3	TRBJ2-7
TGTGCCAGCTCACAGGGGAGGGAGCGATTATTTTCTGGAAACACCATATATTTT	CASSQGRERLFSGNTIYF	TRBV18	TRBJ1-3
TGTGCTAGTGGTTTCAATAACAGGGATCTCTACGAGCAGTACTTC	CASGFNNRDLYEQYF	TRBV12-5	TRBJ2-7
TGTGCCAGCAGTGACCCCAGGGGACTAGCGGGCCGGAACCGCTGTGGGAACACCGGGGAGCTGTTTTTT	CASSDPRGLAGRNRCGNTGELFF	TRBV6-4	TRBJ2-2
TGTGCCAGCAGTGCACGGCCCAATCAGCCCCAGCATTTT	CASSARPNQPQHF	TRBV2	TRBJ1-5
TGTGCTCAAGGACAGGGGTGCTACGAGCAGTACTTC	CAQGQGCYEQYF	TRBV9	TRBJ2-7
TGTGCCAGCAGTCGGGGGCCAAACATCGATACGCAGTATTTT	CASSRGPNIDTQYF	TRBV25-1	TRBJ2-3
TGTGCCAGCACCGACCAGCGGGACAGGGCTCTATGTGGGCCCAATGGCTACACCTTC	CASTDQRDRALCGPNGYTF	TRBV28	TRBJ1-2
TGTGCCAGCCAAGAACTGCGGGACAGGGGGCGAAGCCCGAACACCGGGGAGCTGTTTTTT	CASQELRDRGRSPNTGELFF	TRBV27	TRBJ2-2
TGCGCCAGCAGCCACCTGGACAGGAGTAGCCAAGAGACCCAGTACTTC	CASSHLDRSSQETQYF	TRBV4-3	TRBJ2-5
TGCGCCAGCAGTGATTTAATGAAGCGGGAGAGAGGATACGAGCAGTACTTC	CASSDLMKRERGYEQYF	TRBV10-1	TRBJ2-7
TGTGCCAGCAGCTTAGCGAACTTCGACAGATGGTCCGAGACCCAGTACTTC	CASSLANFDRWSETQYF	TRBV7-3	TRBJ2-5
TGTGCCAGCAGGACTAGCGGGTCGCGCGGTGCAGATACGCAGTATTTT	CASRTSGSRGADTQYF	TRBV2	TRBJ2-3
TGTGCCAGCGTCTCAATTGGGGCTAATGAAAAACTGTTTTTT	CASVSIGANEKLFF	TRBV14	TRBJ1-4
TGTGTTCGATTGGTCTTCGGGTACGAGCAGTACTTC	CVRLVFGYEQYF	TRBV4-2	TRBJ2-7
TGCGCCAGCAGGGGACCACCCGCGGAAAAACTGTTTTTT	CASRGPPAEKLFF	TRBV10-1	TRBJ1-4
TGTGCTAGTGGGGGACCGGGACTGGGTTGGGGCCCAATATGGGGGTTCAATCAGCCCCAGCATTTT	CASGGPGLGWGPIWGFNQPQHF	TRBV12-5	TRBJ1-5
TGTGCCAGCAATTCGGGAGGTTGGAGCCCCTACGAGCAGTACTTC	CASNSGGWSPYEQYF	TRBV27	TRBJ2-7
TGTGCCAGTTGGAGACAGGCGCAGCCCCAGCATTTT	CASWRQAQPQHF	TRBV6-6	TRBJ1-5
TGTGCCACCAGTGAAGTACCCGGGAAACCTTGCTACAATGAGCAGTTCTTC	CATSEVPGKPCYNEQFF	TRBV24-1	TRBJ2-1
TGTGCCACCAGTGGGGGGATTATAGGAACTGAGCAGTTCTTC	CATSGGIIGTEQFF	TRBV24-1	TRBJ2-1
TGTGCCAGCAGCTACGCCAAACAGGGGGCGGCAGCTAACTATGGCTACACCTTC	CASSYAKQGAAANYGYTF	TRBV7-6	TRBJ1-2
TGTGCCAGCAGGATTACCGGCTACACCTTC	CASRITGYTF	TRBV6-2	TRBJ1-2
TGTGCCAGCAGCCCGCAGAATAATAATTCACCCCTCCACTTT	CASSPQNNNSPLHF	TRBV9	TRBJ1-6
TGTGCCAGCAGCCAAGATCGAGAAGACCGGGACAGGGCGCGGCGAAACACCGGGGAGCTGTTTTTT	CASSQDREDRDRARRNTGELFF	TRBV3-1	TRBJ2-2
TGTGCCAGCACGGGACCTGGACTGTACAATGAGCAGTTCTTC	CASTGPGLYNEQFF	TRBV14	TRBJ2-1
TGTGCCAGCAGCGGGGACAGGGGAAGTGGAGCCAAAAACATTCAGTACTTC	CASSGDRGSGAKNIQYF	TRBV13	TRBJ2-4
TGTGCCAGCAGCCGGGGGGGGGGCACCGGGGAGCTGTTTTTT	CASSRGGGTGELFF	TRBV7-9	TRBJ2-2
TGTGCCAGCAGTGACTCCGTCTTCAAAAGACAGTGCTACCATGGCTACACCTTC	CASSDSVFKRQCYHGYTF	TRBV6-4	TRBJ1-2
TGTGCCAGCAGCTTGTGTCGAGGGACAGGGGGCGGGTCAGTGAACACTGAAGCTTTCTTT	CASSLCRGTGGGSVNTEAFF	TRBV5-6	TRBJ1-1
TGTGCCAGCAGCAACAGGACAGGGGGCCAGGACTATGGCTACACCTTC	CASSNRTGGQDYGYTF	TRBV7-8	TRBJ1-2
TGTGCTAGTGGTAACTTCCTCCTGACAGGGCCTGACTATGGCTACACCTTC	CASGNFLLTGPDYGYTF	TRBV12-5	TRBJ1-2
TGTGCCAGCAGCGGGCCTACTAATGAAAAACTGTTTTTT	CASSGPTNEKLFF	TRBV9	TRBJ1-4
TGCGCCAGCAGCCCCCCCGACCGGGACAGGGGTTGCACTGAAGCTTTCTTT	CASSPPDRDRGCTEAFF	TRBV4-1	TRBJ1-1
TGTGCCAGCAGTGAGGGGACAGGGCTGTCCAATCAGCCCCAGCATTTT	CASSEGTGLSNQPQHF	TRBV25-1	TRBJ1-5
TGTGCCAGCGAGCCCTACAGCGTAGCCTATGCAACTAATGAAAAACTGTTTTTT	CASEPYSVAYATNEKLFF	TRBV6-2	TRBJ1-4
TGTGCCAGCAGCTCACGGAGGGTAGTGGCTGGAAACACCATATATTTT	CASSSRRVVAGNTIYF	TRBV11-3	TRBJ1-3
TGTGCCAGCAGCTTGGCCCCCGCGGACAGGCCTGAGCAGTACTTC	CASSLAPADRPEQYF	TRBV5-8	TRBJ2-7
TGTGCCAGCAGCAATTCACCGGGAAGGCTAGCCAAAAACATTCAGTACTTC	CASSNSPGRLAKNIQYF	TRBV11-3	TRBJ2-4
TGTGCCAGCAGTTACTCGGAGGTGCCTACCAACGAGAACACCGGGGAGCTGTTTTTT	CASSYSEVPTNENTGELFF	TRBV6-6	TRBJ2-2
TGCAGTGCAGCCCTAGGGGATACGCAGTATTTT	CSAALGDTQYF	TRBV20-1	TRBJ2-3
TGTGCCAGTGACAAGATGAGGGCTAATGAGGGAGAAGGAAATGAGCAGTTCTTC	CASDKMRANEGEGNEQFF	TRBV6-5	TRBJ2-1
TGTGCCAGCAGCTTCTCCCTTCCCGGGTCCTCCTATAATTCACCCCTCCACTTT	CASSFSLPGSSYNSPLHF	TRBV7-6	TRBJ1-6
TGCAGTGCTAGACAGTTCGACAGGGGAGGGTGCGAGACCCAGTACTTC	CSARQFDRGGCETQYF	TRBV20-1	TRBJ2-5
TGTGCCAGCAGCGTGGGCCGGGACAGGGATGAGCAGTTCTTC	CASSVGRDRDEQFF	TRBV5-6	TRBJ2-1
TGTGCCAGCAGTTTCCCAGGGACAGCCCGCATACCTCTCACCGGGGAGCTGTTTTTT	CASSFPGTARIPLTGELFF	TRBV12-4	TRBJ2-2
TGTGCCAGCAATGGGACAGAGTGGGCTCCTGAAAAACTGTTTTTT	CASNGTEWAPEKLFF	TRBV12-3	TRBJ1-4
TGCGCCAGCAGCCGACTAGCGGGGAGCTCCTACAATGAGCAGTTCTTC	CASSRLAGSSYNEQFF	TRBV4-1	TRBJ2-1
TGTGCCGCAGGTACCTGGGGGCACGAGCAGTACTTC	CAAGTWGHEQYF	TRBV28	TRBJ2-7
TGTGCCAGCAGCCAAGAGTACGGGAATTTCCTGGGGGGGCGATATGAGCAGTTCTTC	CASSQEYGNFLGGRYEQFF	TRBV4-2	TRBJ2-1
TGTCCCTCTCATAGCGCTAAGAATGAGCAGTTCTTC	CPSHSAKNEQFF	TRBV11-2	TRBJ2-1
TGTGCCAGCAGCTTAGCACGAAGCAATCAGCCCCAGCATTTT	CASSLARSNQPQHF	TRBV11-2	TRBJ1-5
TGTGCCAGCAGCTTTATTAGGGAGACAAGCACAGATACGCAGTATTTT	CASSFIRETSTDTQYF	TRBV7-9	TRBJ2-3
TGTGCCAGCAGCGGTACGCGGGGCCAGGGAAACACCATATATTTT	CASSGTRGQGNTIYF	TRBV7-9	TRBJ1-3
TGTGCCAGCAGGGTCGGTACGCAGTATTTT	CASRVGTQYF	TRBV27	TRBJ2-3
TGCGCCAGCAGCCGACTAGGGCAAGAGACCCAGTACTTC	CASSRLGQETQYF	TRBV5-1	TRBJ2-5
TGTGCCAGCAAAAGGAGGGCCTCCCTCCACTTT	CASKRRASLHF	TRBV12-4	TRBJ1-6
TGTGCCAGCAGCCACTCCGGGACAGGCGAGACCCAGTACTTC	CASSHSGTGETQYF	TRBV13	TRBJ2-5
TGTGCCAGCAGTTGGGACCGGGACAGTCCCACTGAAGCTTTCTTT	CASSWDRDSPTEAFF	TRBV28	TRBJ1-1
TGTGCCAGCAGCCAAGAAATTACAGGGGGGGCCCAAGAGACCCAGTACTTC	CASSQEITGGAQETQYF	TRBV3-1	TRBJ2-5
TGTGCCAGCAGTGACAGGGAAGAGACCCAGTACTTC	CASSDREETQYF	TRBV6-5	TRBJ2-5
TGTGCCAGCAGCTTTCCCCAACCGGGACAGTTCAATCAGCCCCAGCATTTT	CASSFPQPGQFNQPQHF	TRBV5-4	TRBJ1-5
TGCGCCAGCAGCCAAGACGGTGATGTCCCAGAGGGATACTCTGGGGCCAACGTCCTGACTTTC	CASSQDGDVPEGYSGANVLTF	TRBV4-1	TRBJ2-6
TGTGCCAGCAGCCGTGATCGGACAGGTAATGAGCAGTTCTTC	CASSRDRTGNEQFF	TRBV11-2	TRBJ2-1
TGTGCCAGCAGCCTTGAGCGGGAGGGCTACGAGCAGTACTTC	CASSLEREGYEQYF	TRBV7-9	TRBJ2-7
TGTGCTCAAGATTGGACAGGGGACTTCTCCTACGAGCAGTACTTC	CAQDWTGDFSYEQYF	TRBV6-5	TRBJ2-7
TGCAGTGTGATCCCTCGGGATCAGCCCCAGCATTTT	CSVIPRDQPQHF	TRBV20-1	TRBJ1-5
TGCGCCACCCGCATGGGACAGTATAGCAATCAGCCCCAGCATTTT	CATRMGQYSNQPQHF	TRBV5-1	TRBJ1-5
TGTGCCAGCCTCTTGAACCGGCGGGAGCCGCGCTATAATTCACCCCTCCACTTT	CASLLNRREPRYNSPLHF	TRBV12-3	TRBJ1-6
TGTGCCAGCAGTTTCACAGGCACTGAAGCTTTCTTT	CASSFTGTEAFF	TRBV12-3	TRBJ1-1
TGTGCCAGCAGTTTAGGCCGCCCGCGGCAAGATCTAGAGACCCAGTACTTC	CASSLGRPRQDLETQYF	TRBV27	TRBJ2-5
TGTGCCAGCAGCGGTACCCCCAGGACAGAGGGTGGCTACACCTTC	CASSGTPRTEGGYTF	TRBV7-7	TRBJ1-2
TGCGCCAGCAGCCAAGATGCGGACGCCGTTCTTTGCTACTACGAGCAGTACTTC	CASSQDADAVLCYYEQYF	TRBV4-3	TRBJ2-7
TGTGCCACCAGTGGACCCCTGTGGACAGGAGAATATCAGCCCCAGCATTTT	CATSGPLWTGEYQPQHF	TRBV24-1	TRBJ1-5
TGTGCCAGCAGTTACTCAACCGGGACTAGCGGGAGGAAGTACTTC	CASSYSTGTSGRKYF	TRBV28	TRBJ2-7
TGTGCCAGCAGTGACTCGACTAGCGGGACGGGTTATTACGAGCAGTACTTC	CASSDSTSGTGYYEQYF	TRBV6-4	TRBJ2-7
TGTGCCACCAGTGAGGAGAGGGCTTACTTC	CATSEERAYF	TRBV24-1	TRBJ2-7
TGTGCCAGCAGCGATCCAAATCTGCGGGAGAACCGGTTGCATGAGCAGTTCTTC	CASSDPNLRENRLHEQFF	TRBV7-9	TRBJ2-1
TGTGCCAGCAGTCCCGGGCCCATTAAACAGGGGGATGAAGCTTTCTTT	CASSPGPIKQGDEAFF	TRBV12-4	TRBJ1-1
TGCAGTGCTAGTGGGGGCTATCAGCCCCAGCATTTT	CSASGGYQPQHF	TRBV20-1	TRBJ1-5
TGTGCCAGCAGCGGTAGGCCGGGACAGGGATGTAACCATAGCAATCAGCCCCAGCATTTT	CASSGRPGQGCNHSNQPQHF	TRBV7-3	TRBJ1-5
TGTGCCAGCAGCTGGGGGGACAGAAAAAATGAAAAACTGTTTTTT	CASSWGDRKNEKLFF	TRBV5-6	TRBJ1-4
TGTGCCAGCAGCCAAGTCAAGGGGGGGGCTGGGAGAAACAATGAGCAGTTCTTC	CASSQVKGGAGRNNEQFF	TRBV4-2	TRBJ2-1
TGTTCGGGCCCCGACAACGAGCAGTACTTC	CSGPDNEQYF	TRBV27	TRBJ2-7
TGTGCCAGCAGCCCCAGGAAATCCGGGACAGGGGGGTACTACAATGAGCAGTTCTTC	CASSPRKSGTGGYYNEQFF	TRBV13	TRBJ2-1
TGCAGTGCTACTGTCCCCAACTCGGGGGGGCCAACAGATACGCAGTATTTT	CSATVPNSGGPTDTQYF	TRBV20-1	TRBJ2-3
TGTGCCAGCAGTTTATGTCCCTCTAGAGGCAGCTCCTACGAGCAGTACTTC	CASSLCPSRGSSYEQYF	TRBV27	TRBJ2-7
TGTGCCAGGGGGCTGGCGAGCTACGAGCAGTACTTC	CARGLASYEQYF	TRBV7-8	TRBJ2-7
TGTGCCAGCAAAGGGGGGGGGGCCTACGAGCAGTACTTC	CASKGGGAYEQYF	TRBV12-3	TRBJ2-7
TGTGCCAGCAGCCAAAAGTCGGACAGCCATTCCTGGATCACAGATACGCAGTATTTT	CASSQKSDSHSWITDTQYF	TRBV6-1	TRBJ2-3
TGTGCCAGCAGCGACCAGGATCAGCCCCAGCATTTT	CASSDQDQPQHF	TRBV7-3	TRBJ1-5
TGTGCCAGCAGACGACCGGGACGAACTAATGAAAAACTGTTTTTT	CASRRPGRTNEKLFF	TRBV6-1	TRBJ1-4
TGTGCCAGCAGCTTAGTCCGCCGACAGGGGTGTTTTTACGAGCAGTACTTC	CASSLVRRQGCFYEQYF	TRBV7-8	TRBJ2-7
TGTGCCAGCCGTTGCACAGATACGCAGTATTTT	CASRCTDTQYF	TRBV9	TRBJ2-3
TGTGCCAGCAGTGAAAGGACAGGGGCGGGAAACACCATATATTTT	CASSERTGAGNTIYF	TRBV6-1	TRBJ1-3
TGTGCCAGCAGCCAAGATCTAGGGGGGTACACTGAAGCTTTCTTT	CASSQDLGGYTEAFF	TRBV3-1	TRBJ1-1
TGCGCCAGCAGCCAACTCCCGAGGGGGGCCTTC	CASSQLPRGAF	TRBV4-3	TRBJ1-2
TGTGCCAGCAGCCCAAAGGCGGGGCTGACTAGAAATACGCAGTATTTT	CASSPKAGLTRNTQYF	TRBV9	TRBJ2-3
TGTGCCGGGGCATCCGTAGGTTCAGGCACAGATACGCAGTATTTT	CAGASVGSGTDTQYF	TRBV24-1	TRBJ2-3
TGCGCCAGCAGAGGAGAACAGGGGCGGGACAATGAGCAGTTCTTC	CASRGEQGRDNEQFF	TRBV10-1	TRBJ2-1
TGTGCCAGCAGTGAGGCAACACTTGGCTACAATGAGCAGTTCTTC	CASSEATLGYNEQFF	TRBV25-1	TRBJ2-1
TGCGCCAGCAGCTTAATAAACCACAGAGAAGCTTTCTTT	CASSLINHREAFF	TRBV5-1	TRBJ1-1
TGTGCCAGCAGCCCTCCGGGGCCAAAGTACAATGAGCAGTTCTTC	CASSPPGPKYNEQFF	TRBV6-4	TRBJ2-1
TGCGCCAGCAGCGGCCGGGGGGAGCCTTGGCCGAACGGGCGCACAGATACGCAGTATTTT	CASSGRGEPWPNGRTDTQYF	TRBV5-1	TRBJ2-3
TGTGCCAGCAGCCCAGGGTTGGAGGAGGGGTACTCTGGGGCCAACGTCCTGACTTTC	CASSPGLEEGYSGANVLTF	TRBV7-3	TRBJ2-6
TGCGCCAGCAGCTTTGACAGGGGGACCCAAGAGACCCAGTACTTC	CASSFDRGTQETQYF	TRBV5-1	TRBJ2-5
TGTGCCAGCAGCCCCATGATGGCCTGTAAGAACACTGAAGCTTTCTTT	CASSPMMACKNTEAFF	TRBV7-3	TRBJ1-1
TGTGCCAGCCTTACAGGGCGGGACGAGCAGTACTTC	CASLTGRDEQYF	TRBV25-1	TRBJ2-7
TGTGCCAGCAGAGGGGTCCAGCCCCAGCATTTT	CASRGVQPQHF	TRBV7-9	TRBJ1-5
TGTGCCAGCAGCCGCACGAGAAGGGTTTCTGGAAACACCATATATTTT	CASSRTRRVSGNTIYF	TRBV3-1	TRBJ1-3
TGTGCCAGCAGTTCATTAACGGAGACCCAGTACTTC	CASSSLTETQYF	TRBV6-5	TRBJ2-5
TGTGCCAGCAGCGTAGATTCACCGGCCTGGGACACCGGGGAGCTGTTTTTT	CASSVDSPAWDTGELFF	TRBV9	TRBJ2-2
TGTGCCAGCAGCGTCGAGGGGAATAGGGATCGAGATAGCAATCAGCCCCAGCATTTT	CASSVEGNRDRDSNQPQHF	TRBV9	TRBJ1-5
TGCAGTGCTAGACATTGGGGGGAGGTAGCCAAAAACATTCAGTACTTC	CSARHWGEVAKNIQYF	TRBV20-1	TRBJ2-4
TGTGCCACCAGTGATTTGCATAGACAAGTGGGGTGTCCATTCTTC	CATSDLHRQVGCPFF	TRBV24-1	TRBJ1-2
TGCGCCAGCAGCATCGAGGGGGCCAATCAGCCCCAGCATTTT	CASSIEGANQPQHF	TRBV10-1	TRBJ1-5
TGTGCCAGCAGGATAGACCCAGAGACCCAGTACTTC	CASRIDPETQYF	TRBV7-6	TRBJ2-5
TGCAGTGCTCCACTAGCGGGAGAAAGGGACAGGAACACTGAAGCTTTCTTT	CSAPLAGERDRNTEAFF	TRBV20-1	TRBJ1-1
TGTGCCAGCAGCTTGGCGGACGTCGTCGCCGAGCAGTACTTC	CASSLADVVAEQYF	TRBV5-6	TRBJ2-7
TGTGCCAGCAGTGGTCCGGGACAGGCGTCTGACACCGGGGAGCTGTTTTTT	CASSGPGQASDTGELFF	TRBV28	TRBJ2-2
TGTGCCAGCAGCTGCCCACCAGTCCTGAACACTGAAGCTTTCTTT	CASSCPPVLNTEAFF	TRBV5-6	TRBJ1-1
TGTGCCACGTGGCGCCGCAATCAGCCCCAGCATTTT	CATWRRNQPQHF	TRBV6-2	TRBJ1-5
TGTGCCAGCAGCCCCCGATTCGAAGCTTTCTTT	CASSPRFEAFF	TRBV7-3	TRBJ1-1
TGTGCCAGCAGCTTAGTAACCCACGGGGGGGGACATCAGCCCCAGCATTTT	CASSLVTHGGGHQPQHF	TRBV7-9	TRBJ1-5
TGTGCTAGTGGTATAGGTTTGTTTCTTGGGGAGCCCCAGCATTTT	CASGIGLFLGEPQHF	TRBV12-5	TRBJ1-5
TGTGCCAGCAGCAGTTCCCGGAACAGGGTTCGGCCCCCCCCGACTGAAGCTTTCTTT	CASSSSRNRVRPPPTEAFF	TRBV11-2	TRBJ1-1
TGTGCCAGCAGCAGGGTAAATCCGGACAGGGGGTCCAACACCGGGGAGCTGTTTTTT	CASSRVNPDRGSNTGELFF	TRBV7-6	TRBJ2-2
TGCGCCAGCAGCTTGGACAGGAGCTACGAGCAGTACTTC	CASSLDRSYEQYF	TRBV5-1	TRBJ2-7
TGCGCCAGCAGCCAAAATCCGACCGGGATTGCATGTTACACCTTC	CASSQNPTGIACYTF	TRBV4-3	TRBJ1-2
TGTGCCAGTGTTGGGGACAGGGTTTTCTACGAGCAGTACTTC	CASVGDRVFYEQYF	TRBV19	TRBJ2-7
TGTGCCAGCAGTTTATCCTCATACCTTAACGAGCAGTACTTC	CASSLSSYLNEQYF	TRBV28	TRBJ2-7
TGTGCCACCAGCAGAATCGCTCGACTCAGGAAACCCTCCTACAATGAGCAGTTCTTC	CATSRIARLRKPSYNEQFF	TRBV15	TRBJ2-1
TGTGCCAGCAGTGGGGGGACTAGCGGGGGGACGCAAGGAAATGAGCAGTTCTTC	CASSGGTSGGTQGNEQFF	TRBV6-1	TRBJ2-1
TGCAGTGCAACCACAGGCGGGGAGCTGTTTTTT	CSATTGGELFF	TRBV20-1	TRBJ2-2
TGCGCCAGCAGCACTAGCGGGAGGGCCTGGTATTCACCCCTCCACTTT	CASSTSGRAWYSPLHF	TRBV10-1	TRBJ1-6
TGTGCCAGCAGCGGGACTAGCGGTAAAGAGACCCAGTACTTC	CASSGTSGKETQYF	TRBV11-2	TRBJ2-5
TGTGCCAGCAGGAACTGGGGACAGCTACCCCTCCACTTT	CASRNWGQLPLHF	TRBV6-4	TRBJ1-6
TGTGCTAGTGGTTTGGGATCAGCGGGGGTAGTTAATGAAAAACTGTTTTTT	CASGLGSAGVVNEKLFF	TRBV12-5	TRBJ1-4
TGTGCCAGCAGTTTATTGGACGATTTGCCAGATACGCAGTATTTT	CASSLLDDLPDTQYF	TRBV28	TRBJ2-3
TGTGCCACAAAGGGGGCTGTCGAGCAGTACTTC	CATKGAVEQYF	TRBV7-9	TRBJ2-7
TGCAGCGTTGAAGGTCTGATAAGGTACGAGCAGTACTTC	CSVEGLIRYEQYF	TRBV29-1	TRBJ2-7
TGTGCCAGCAGCTTCGGACAGGGCTACGAGCAGTACTTC	CASSFGQGYEQYF	TRBV5-6	TRBJ2-7
TGCAGTGCTATTCCGGACGGCCCCGAGCAGTACTTC	CSAIPDGPEQYF	TRBV20-1	TRBJ2-7
TGTGCCAGCAGCTTGGGTACAAGCCACGAGCAGTACTTC	CASSLGTSHEQYF	TRBV5-4	TRBJ2-7
TGTGCCAGCACGGGATCCAATAATTCCGGGACAGCTAAGAGGGCCTCCTACGAGCAGTACTTC	CASTGSNNSGTAKRASYEQYF	TRBV2	TRBJ2-7
TGCGCCAGCAGCCACAGCCGGGACAGGGAATATAACTATGGCTACACCTTC	CASSHSRDREYNYGYTF	TRBV4-1	TRBJ1-2
TGTGCCAGCATTCTACCCCTATGGACTAGCGGCGTTCATAGCACAGATACGCAGTATTTT	CASILPLWTSGVHSTDTQYF	TRBV28	TRBJ2-3
TGTGCCAGCAGGAAGGTCAGGGTCAAGGGATGGAATCAGCCCCAGCATTTT	CASRKVRVKGWNQPQHF	TRBV27	TRBJ1-5
TGCAGTGCTGACCGGGTGGGGGGGCCATCCGAGCAGTACTTC	CSADRVGGPSEQYF	TRBV20-1	TRBJ2-7
TGTGCCATCTCGGCTTTGGCTAGCGGGGAGCAAGAGACCCAGTACTTC	CAISALASGEQETQYF	TRBV7-9	TRBJ2-5
TGTGCCAGCAGGAAAGGACTAGAAGGGCAGTTCTTC	CASRKGLEGQFF	TRBV6-5	TRBJ2-1
TGTGCCAGCAGTGCCGGGGGGGGCCTGTGGGACAATGAGCAGTTCTTC	CASSAGGGLWDNEQFF	TRBV6-1	TRBJ2-1
TGCGCCAGCAGCCAAGATCCAGGCGATCGACCAGGGAACACTGAAGCTTTCTTT	CASSQDPGDRPGNTEAFF	TRBV4-3	TRBJ1-1
TGTGCCAGCAGCGTAGCCGAGGATAGCAATCAGCCCCAGCATTTT	CASSVAEDSNQPQHF	TRBV9	TRBJ1-5
TGTGCCAGCAGCCAAGCCATTCTGGGTGGTGGAGCTCCGTACGGGGAGCTGTTTTTT	CASSQAILGGGAPYGELFF	TRBV14	TRBJ2-2
TGTGCCAGCAGCGCCGGGACTAGGTACGAGCAGTACTTC	CASSAGTRYEQYF	TRBV13	TRBJ2-7
TGCAGCGTTGATTGGGGGGGCCGCAGGACCCAGTACTTC	CSVDWGGRRTQYF	TRBV29-1	TRBJ2-5
TGCAGCGAACAGGGGAAGTACTCTGGGGCCAACGTCCTGACTTTC	CSEQGKYSGANVLTF	TRBV29-1	TRBJ2-6
TGTGCCAGTAGTATAGGGGGAGGGCCCACTGAAGCTTTCTTT	CASSIGGGPTEAFF	TRBV19	TRBJ1-1
TGTGCCAGCGTCCGGGACAGGGATGGAAGGGGGGAGGGGGATCAGCCCCAGCATTTT	CASVRDRDGRGEGDQPQHF	TRBV27	TRBJ1-5
TGTGCCAGCAGCCGGGGGCCCCTACCAGATACGCAGTATTTT	CASSRGPLPDTQYF	TRBV13	TRBJ2-3
TGTGCCAGCAGCCAACATTCTCGGAACAATTCACCCCTCCACTTT	CASSQHSRNNSPLHF	TRBV3-1	TRBJ1-6
TGCGCCAGCAGACCCAGGGCCGGAGGCTACACCTTC	CASRPRAGGYTF	TRBV10-1	TRBJ1-2
TGCAGTGCTCTAACGTATGCAGGACTAAGCTCCTACGAGCAGTACTTC	CSALTYAGLSSYEQYF	TRBV20-1	TRBJ2-7
TGTGCCAAAGGACAGGGCCGGGGCTACACCTTC	CAKGQGRGYTF	TRBV10-3	TRBJ1-2
TGCAGCGACCACCCGGACGTTGGGAGTGGGGCCAACGTCCTGACTTTC	CSDHPDVGSGANVLTF	TRBV29-1	TRBJ2-6
TGTGCCAGCATCCGCGGGACAAGTGAAGCTTTCTTT	CASIRGTSEAFF	TRBV6-4	TRBJ1-1
TGCGCCAGCAGCCAAGGGGGGGGTGGCTACACCTTC	CASSQGGGGYTF	TRBV4-1	TRBJ1-2
TGCAGTGCTAGAGATCTGGGCCGACTTAGGACTAGGAGAGAGCAGTACTTC	CSARDLGRLRTRREQYF	TRBV20-1	TRBJ2-7
TGTGCCAGCAGCCAAGAGGCGTGGAGCTCTGGGGCCAACGTCCTGACTTTC	CASSQEAWSSGANVLTF	TRBV4-2	TRBJ2-6
TGTGCCAGCAGCGGGGGGTCCGGTCTGAATCAGCCCCAGCATTTT	CASSGGSGLNQPQHF	TRBV5-5	TRBJ1-5
TGTGCCAGCAGTTACCGGGGAGTCAAGCCCCAGCATTTT	CASSYRGVKPQHF	TRBV6-2	TRBJ1-5
TGTGCCAGCAGTGAAGCATGTACAGGGGGAAACTACGAGCAGTACTTC	CASSEACTGGNYEQYF	TRBV6-1	TRBJ2-7
TGTGCTAGTGGTGAGATTCCAGGGACGTTAAGTGCGGGGGAAGCTTTCTTT	CASGEIPGTLSAGEAFF	TRBV12-5	TRBJ1-1
TGCAGTGCTCCTCTCGATCAGCCCCAGCATTTT	CSAPLDQPQHF	TRBV20-1	TRBJ1-5
TGTGCCACCGATCAACAGGGGGCCGAAGCTTTCTTT	CATDQQGAEAFF	TRBV24-1	TRBJ1-1
TGCAGTGCTCCCGGGCTGGGTGGGGACTATGGCTACACCTTC	CSAPGLGGDYGYTF	TRBV20-1	TRBJ1-2
TGTGCCAGCAAAGGTCAGGATCATTACGAGCAGTACTTC	CASKGQDHYEQYF	TRBV2	TRBJ2-7
TGTGCCAGCCCGGGACAGGGTGATTCCTATGGCTACACCTTC	CASPGQGDSYGYTF	TRBV28	TRBJ1-2
TGTGCCAGCAGCTTAACGGTTACTAGCGGGAGAAAAGATCAGCCCCAGCATTTT	CASSLTVTSGRKDQPQHF	TRBV7-9	TRBJ1-5
TGTGCCAGTCGAACGGGGAGCTCCTACAATGAGCAGTTCTTC	CASRTGSSYNEQFF	TRBV27	TRBJ2-1
TGTGCCAGCAGCGACCCGCAGGATTATGAAAAACTGTTTTTT	CASSDPQDYEKLFF	TRBV11-3	TRBJ1-4
TGTGCCAGCAGCAGGGAACACAGGGGGAAGAAACAGCCCCAGCATTTT	CASSREHRGKKQPQHF	TRBV13	TRBJ1-5
TGTGGCGGGACTAGCGGGCCCTCAGATACGCAGTATTTT	CGGTSGPSDTQYF	TRBV25-1	TRBJ2-3
TGTGCCAGCAGCTCTACGACTAGCGGGAGTTTAACGTACAATGAGCAGTTCTTC	CASSSTTSGSLTYNEQFF	TRBV7-9	TRBJ2-1
TGTGCCATGTCCGGGGGCTGGGAGAAACCTTGCACAGATACGCAGTATTTT	CAMSGGWEKPCTDTQYF	TRBV27	TRBJ2-3
TGTGCCAGCAGTTTGGGTGGAGGACTAGCGGGGAGCACAGATACGCAGTATTTT	CASSLGGGLAGSTDTQYF	TRBV12-3	TRBJ2-3
TGTGCCAGCAGCTTCGGTCGTGAGCAGTACTTC	CASSFGREQYF	TRBV7-4	TRBJ2-7
TGTGCCAGCAGTTCCCGGGACATGGATAGCAATCAGCCCCAGCATTTT	CASSSRDMDSNQPQHF	TRBV27	TRBJ1-5
TGTGCCAGCAGCTTATTCCCGGGCCCGGCCCTAGCCAAAAACATTCAGTACTTC	CASSLFPGPALAKNIQYF	TRBV13	TRBJ2-4
TGTGCCACCAGTGATGGGGGACGCTCCTACAATGAGCAGTTCTTC	CATSDGGRSYNEQFF	TRBV24-1	TRBJ2-1
TGTGCCAGACGGGTTCTAGGCGGCACCGGGGAGCTGTTTTTT	CARRVLGGTGELFF	TRBV25-1	TRBJ2-2
TGTGCCAGCATGTGGACACTAGCGGGAGCGGCCTACGAGCAGTACTTC	CASMWTLAGAAYEQYF	TRBV6-5	TRBJ2-7
TGCGCCAGCAGCTCAGGGCTTGGGCATCAGCCCCAGCATTTT	CASSSGLGHQPQHF	TRBV5-1	TRBJ1-5
TGCGCCAGCAATAACACGGGACAGGGATTTAATTCACCCCTCCACTTT	CASNNTGQGFNSPLHF	TRBV10-1	TRBJ1-6
TGCGCCAGCAGCTTGGTGCCGGGGGCCACAGATACGCAGTATTTT	CASSLVPGATDTQYF	TRBV5-1	TRBJ2-3
TGTGCCATCGTACTAGCGGGAGCCACAGATACGCAGTATTTT	CAIVLAGATDTQYF	TRBV10-3	TRBJ2-3
TGCAGTGCTGGGACAGGGGGGGAGACCCAGTACTTC	CSAGTGGETQYF	TRBV20-1	TRBJ2-5
TGTGCCAGCAGCGGTCGCCGGGACAGGGCCGGAGATCAGCCCCAGCATTTT	CASSGRRDRAGDQPQHF	TRBV7-3	TRBJ1-5
TGTGCCAGCAGCATTGAGCCGCCAAGGGGAAGCTACGAGCAGTACTTC	CASSIEPPRGSYEQYF	TRBV13	TRBJ2-7
TGTGCTAGTGGTTTGATGGGCCCAGCTAACTATGGCTACACCTTC	CASGLMGPANYGYTF	TRBV12-5	TRBJ1-2
TGTGCCACCAGTGATTTGCTTCTCCTCACTGCCTTC	CATSDLLLLTAF	TRBV24-1	TRBJ2-5
TGTGCCAGCAGTTTATCCTTGTCCCCTCCAGGCATCCAGCCCCAGCATTTT	CASSLSLSPPGIQPQHF	TRBV27	TRBJ1-5
TGTGCCAGCAGTTTTGGGGGGGGGGCGCAGTATTTT	CASSFGGGAQYF	TRBV12-4	TRBJ2-3
TGTGCCAGCCCACCACTAGCGGGAGCCACTGAAGCTTTCTTT	CASPPLAGATEAFF	TRBV14	TRBJ1-1
TGTGCCAGCAGACCGGGACAGGGAAGGAATTCACCCCTCCACTTT	CASRPGQGRNSPLHF	TRBV6-5	TRBJ1-6
TGTGCCACCAGTGATACGATAGATGAGCAGTTCTTC	CATSDTIDEQFF	TRBV24-1	TRBJ2-1
TGTGCCAGCACGGGTCGACCAGGGGCCAGCTCCTACGAGCAGTACTTC	CASTGRPGASSYEQYF	TRBV27	TRBJ2-7
TGTGCCAGCAGCAAGGGACAAAAATCGAATCAGCCCCAGCATTTT	CASSKGQKSNQPQHF	TRBV7-2	TRBJ1-5
TGTGCCAGCAGCGTATACCTGAGACCGCAGTTCTTC	CASSVYLRPQFF	TRBV7-6	TRBJ2-1
TGTGCCAGCAGCCCTCAGACACCGAACACTGAAGCTTTCTTT	CASSPQTPNTEAFF	TRBV9	TRBJ1-1
TGTGCCACCAGCCTGACTGTTCAGAGCTACGAGCAGTACTTC	CATSLTVQSYEQYF	TRBV24-1	TRBJ2-7
TGTGCCAGCAGCCAAGATCCACAGGGGACAACTAATGAAAAACTGTTTTTT	CASSQDPQGTTNEKLFF	TRBV4-2	TRBJ1-4
TGTGCCAGCAGTTACTCAGGGACTAGCGTAGGACCCAATGAGCAGTTCTTC	CASSYSGTSVGPNEQFF	TRBV6-5	TRBJ2-1
TGCAGTGCGGGACAGGAGGGCGAGCAGTACTTC	CSAGQEGEQYF	TRBV20-1	TRBJ2-7
TGTGCTAGTGGTCACCCTAACCAAGGGGGCTTGGGGGAAGCTTTCTTT	CASGHPNQGGLGEAFF	TRBV12-5	TRBJ1-1
TGTGCCAGCAGTTTGAATGGACAGGAGTATGTGGGAAACACCATATATTTT	CASSLNGQEYVGNTIYF	TRBV28	TRBJ1-3
TGTGCCAGCAGCTTTAAGGACAGATACTATGGCTACACCTTC	CASSFKDRYYGYTF	TRBV7-4	TRBJ1-2
TGCGCCAGCAGAGACATACTAGTACGACAGCCCCAGCATTTT	CASRDILVRQPQHF	TRBV5-1	TRBJ1-5
TGCAGTGCAGTTCGGCTCTCCTTCACAGATACGCAGTATTTT	CSAVRLSFTDTQYF	TRBV20-1	TRBJ2-3
TGTGCCAGTAAACGGGGATACGAGCAGTACTTC	CASKRGYEQYF	TRBV19	TRBJ2-7
TGTGCCAGCAGCTTAAATGAGACAGGGCAGCCCCAGCATTTT	CASSLNETGQPQHF	TRBV7-2	TRBJ1-5
TGCGCCCCAGGAGCATTACTGTACTTC	CAPGALLYF	TRBV4-3	TRBJ2-7
TGTGCCAGCAAAACGACGAATAGCCCACGCTCACAGGGGTTGGAGCAGCCCCAGCATTTT	CASKTTNSPRSQGLEQPQHF	TRBV6-5	TRBJ1-5
TGTGCCAGCAGTAAGAGGACTAGCGGGGGGGGGGAAGAGACCCAGTACTTC	CASSKRTSGGGEETQYF	TRBV28	TRBJ2-5
TGCAGTGCTGACAACTATGGCTACACCTTC	CSADNYGYTF	TRBV20-1	TRBJ1-2
TGTGCCAGCAGCGGTCTGCCAGGGGGGGGGGGCTCCTACAATGAGCAGTTCTTC	CASSGLPGGGGSYNEQFF	TRBV7-2	TRBJ2-1
TGTGCCCCGGGGTTGGGGGGCAATCAGCCCCAGCATTTT	CAPGLGGNQPQHF	TRBV27	TRBJ1-5
TGTGCCAGCAGACGGGGGGGCCCCAGGACAGATACGCAGTATTTT	CASRRGGPRTDTQYF	TRBV6-5	TRBJ2-3
TGTGCCAGCAGCCCGTTCCGACAGGGGTGGGGCGAGGCTGGAAGTGCCCAAGAGACCCAGTACTTC	CASSPFRQGWGEAGSAQETQYF	TRBV27	TRBJ2-5
TGCGCCAGCAGCTTGGGTCTCCCCGGGACTAGCGGGCTCAAATTCTTTAAGAGCTCCTACAATGAGCAGTTCTTC	CASSLGLPGTSGLKFFKSSYNEQFF	TRBV5-1	TRBJ2-1
TGTGCCAGCAGCCAGTCGGTAGGGACAAGTTTTGCAGTTAGCGGTTATTCCTACGAGCAGTACTTC	CASSQSVGTSFAVSGYSYEQYF	TRBV5-8	TRBJ2-7
TGTGCCACCAGTGGGTCGGGGGCTTTCTATGGCTACACCTTC	CATSGSGAFYGYTF	TRBV24-1	TRBJ1-2
TGTGCCAGTAGTATAGCACCGGACAGGAAGAGCCCAGATACGCAGTATTTT	CASSIAPDRKSPDTQYF	TRBV19	TRBJ2-3
TGTGCCAGCAGCGGGGGAACAGGGAGTCAGCATTTT	CASSGGTGSQHF	TRBV11-3	TRBJ1-5
TGTGCCAGCAGCTTCGGCCGAGCTGGGGCCAACGTCCTGACTTTC	CASSFGRAGANVLTF	TRBV5-4	TRBJ2-6
TGCGCCAACGGGACGGGAAACTACGAGCAGTACTTC	CANGTGNYEQYF	TRBV5-1	TRBJ2-7
TGTAGCCAAGAAGTGAACACTGAAGCTTTCTTT	CSQEVNTEAFF	TRBV11-1	TRBJ1-1
TGTGCCAGCAGACTTTATGGTGGGGCTGGAAATTCACCCCTCCACTTT	CASRLYGGAGNSPLHF	TRBV6-4	TRBJ1-6
TGCGCCAGCAGCTTGCCCTCCCGGGGAATCTACGAGCAGTACTTC	CASSLPSRGIYEQYF	TRBV5-1	TRBJ2-7
TGTGCCAGCAGTTACAACCAGATCTCGACAACTAATTCACCCCTCCACTTT	CASSYNQISTTNSPLHF	TRBV6-5	TRBJ1-6
TGCAGTGCTAGAGATAGGTCGACTAGTGAGCAGTTCTTC	CSARDRSTSEQFF	TRBV20-1	TRBJ2-1
TGTGCCAGCAGTTACTTTCCGGGACAGGTGAACACTGAAGCTTTCTTT	CASSYFPGQVNTEAFF	TRBV6-5	TRBJ1-1
TGTGCCCGGGACAGGGAATATCAGCCCCAGCATTTT	CARDREYQPQHF	TRBV6-1	TRBJ1-5
TGTGCCAGCAGTCCCGCCCCGGGGGCGGTCGGCCATAATTCACCCCTCCACTTT	CASSPAPGAVGHNSPLHF	TRBV14	TRBJ1-6
TGCAGTGAAAGACATGAAAAACTGTTTTTT	CSERHEKLFF	TRBV20-1	TRBJ1-4
TGTGCCAGCAGCACCGGGGGGTCGCCCCAGCATTTT	CASSTGGSPQHF	TRBV7-3	TRBJ1-5
TGTGCCAGCGGAAGGGACAGTAGCAATCAGCCCCAGCATTTT	CASGRDSSNQPQHF	TRBV7-9	TRBJ1-5
TGTGCCAGCAGTGACTTCCAGGGCTTCATGAACACTGAAGCTTTCTTT	CASSDFQGFMNTEAFF	TRBV2	TRBJ1-1
TGTGCCATATGTCCCACACAGGGGAACACTGAAGCTTTCTTT	CAICPTQGNTEAFF	TRBV10-3	TRBJ1-1
TGTGCCAGGTCGCCGACTAGCGGGGCCGAGGAGCAGTACTTC	CARSPTSGAEEQYF	TRBV6-3	TRBJ2-7
TGTGCCAGCAGTGGGACAGGCACCGATGGCTACACCTTC	CASSGTGTDGYTF	TRBV6-4	TRBJ1-2
TGCGCCAGCAGAGTGATGGGGGTGTTTAGGTACGAGCAGTACTTC	CASRVMGVFRYEQYF	TRBV4-1	TRBJ2-7
TGTGCCAGCAGCAGAAAAGGGCCGGCACATACTGAAGCTTTCTTT	CASSRKGPAHTEAFF	TRBV7-3	TRBJ1-1
TGTGCCAGCAGACTCGGGACGGTCATCGACACTGAAGCTTTCTTT	CASRLGTVIDTEAFF	TRBV12-3	TRBJ1-1
TGTGCCAGCAGCCGGGTGTGGGGGGGAGGACTTCTCGATAGCAATCAGCCCCAGCATTTT	CASSRVWGGGLLDSNQPQHF	TRBV13	TRBJ1-5
TGTGCCACCAGTGATTTGGTCGAAGGGAGGACCTACGAGCAGTACTTC	CATSDLVEGRTYEQYF	TRBV24-1	TRBJ2-7
TGTGCCAGCAGCGGAGGACTACCGAGTTCACCCCTCCACTTT	CASSGGLPSSPLHF	TRBV13	TRBJ1-6
TGTGCCAGCAGCGCCCCGGGACAGGGGAATGACTCCTACGAGCAGTACTTC	CASSAPGQGNDSYEQYF	TRBV9	TRBJ2-7
TGTGCCAGCAGTGACAGTACGAGTCCGAAGACTGAAGCTTTCTTT	CASSDSTSPKTEAFF	TRBV6-4	TRBJ1-1
TGTGCCAGCAATCTGCCGGGACTAGCAGATACGCAGTATTTT	CASNLPGLADTQYF	TRBV12-3	TRBJ2-3
TGTGCCACCAGTGATTTCCCGGGGAATCAGCCCCAGCATTTT	CATSDFPGNQPQHF	TRBV24-1	TRBJ1-5
TGTGCCAGCAGTACTGCCCCCGCCGGGACAGGGGAGATTCCTCTGCAGTACTTC	CASSTAPAGTGEIPLQYF	TRBV6-1	TRBJ2-7
TGCAGTGCTAGAAATTTTAGGGACTCCTACGAGCAGTACTTC	CSARNFRDSYEQYF	TRBV20-1	TRBJ2-7
TGTGCCAGCAGTCCCAAAATTTACGAGCAGTACTTC	CASSPKIYEQYF	TRBV6-2	TRBJ2-7
TGTGCCAGCAGAATCGTTAGCGGGATGACAGATACGCAGTATTTT	CASRIVSGMTDTQYF	TRBV2	TRBJ2-3
TGTGCCAGCAGCCTCCCGGGACAGGATATCCCAACCTACGAGCAGTACTTC	CASSLPGQDIPTYEQYF	TRBV9	TRBJ2-7
TGTGCCAGCAGTGACCGGTCTTGGGGCACGGGAGACTATGGCTACACCTTC	CASSDRSWGTGDYGYTF	TRBV6-4	TRBJ1-2
TGTGCCATCAGTGAGGAAGGGTCGGGACAGGGGCAGCCCCAGCATTTT	CAISEEGSGQGQPQHF	TRBV10-3	TRBJ1-5
TGCAGTGCTAGGCTCCAGTCTCCCTGTGAAGCTTTCTTT	CSARLQSPCEAFF	TRBV20-1	TRBJ1-1
TGTGCCAGCGTAGGGGAGCAGTTCTTC	CASVGEQFF	TRBV27	TRBJ2-1
TGTGCCAGCAGCTTAACGCCGGCCCGAGATACGCAGTATTTT	CASSLTPARDTQYF	TRBV7-3	TRBJ2-3
TGTGCTAGTGGGAACCCTTGGGACTTGGAGACCCAGTACTTC	CASGNPWDLETQYF	TRBV12-5	TRBJ2-5
TGTGCCAGCTCAACTTCGCAGTCTGCCTCCTACGAGCAGTACTTC	CASSTSQSASYEQYF	TRBV18	TRBJ2-7
TGTGCCAGCAGACCCCCGGGGCTTAACTATGGCTACACCTTC	CASRPPGLNYGYTF	TRBV28	TRBJ1-2
TGCGCCAGCAGCCATCATGCCGCCGGAGGGGTACCTAACTCCTACGAGCAGTACTTC	CASSHHAAGGVPNSYEQYF	TRBV4-1	TRBJ2-7
TGCGCCAGCAGGGACAGGGAGCAGTACTTC	CASRDREQYF	TRBV10-1	TRBJ2-7
TGTGCCAGCAGTTACCGCATCTACAATGAGCAGTTCTTC	CASSYRIYNEQFF	TRBV6-5	TRBJ2-1
TGTGCCACCGACTGGTACTATCCGTACTTC	CATDWYYPYF	TRBV24-1	TRBJ2-5
TGTGCCAGCAGCGGGGACCCCCGGGACAGTTGGAATGAAAAACTGTTTTTT	CASSGDPRDSWNEKLFF	TRBV11-2	TRBJ1-4
TGTGCCAGCAGTTACTCGTCCCCTGAGTTTACCTACGAGCAGTACTTC	CASSYSSPEFTYEQYF	TRBV6-5	TRBJ2-7
TGTGCCAGCAGCAAGAAGGGCGCAGTCTATGGCTACACCTTC	CASSKKGAVYGYTF	TRBV13	TRBJ1-2
TGTGCCACCAGCAGCAAGCGGGAGCCCACTAACTATGGCTACACCTTC	CATSSKREPTNYGYTF	TRBV15	TRBJ1-2
TGCAACCAAACCGGGGAGCTGTTTTTT	CNQTGELFF	TRBV29-1	TRBJ2-2
TGTGCCAGCAGTGACCCAGACAGGGTCCTGGGCTACACCTTC	CASSDPDRVLGYTF	TRBV25-1	TRBJ1-2
TGTGCCAGCAGCTTGACCCTAAAAAGACTTCCCTACGAGCAGTACTTC	CASSLTLKRLPYEQYF	TRBV5-4	TRBJ2-7
TGTGCCAGCAGCTTAGCCCAGCACGGAGGGAGCTCCTACGAGCAGTACTTC	CASSLAQHGGSSYEQYF	TRBV7-2	TRBJ2-7
TGTGCCAGCAGCTTGGAAAGTCGCGGACGGGGCTCCTATAATTCACCCCTCCACTTT	CASSLESRGRGSYNSPLHF	TRBV5-5	TRBJ1-6
TGTGCCACCAGTGATTTGGGGGGTGGGTGTGAAGCTTTCTTT	CATSDLGGGCEAFF	TRBV24-1	TRBJ1-1
TGTGCCACCAGCGCCGGAGCTGCACAGGGGGCAAGAAATGAAAAACTGTTTTTT	CATSAGAAQGARNEKLFF	TRBV15	TRBJ1-4
TGTGCCAGCAGCTGCAGGAGGGGGAGAGAGACCCAGTACTTC	CASSCRRGRETQYF	TRBV7-9	TRBJ2-5
TGTGCCAGCAGCTTAAGGACAGGAAGGGAGCAGTACTTC	CASSLRTGREQYF	TRBV5-5	TRBJ2-7
TGTGCCAGCTCACCTTCCTGTGGGGGATGTCCGAATCAGCCCCAGCATTTT	CASSPSCGGCPNQPQHF	TRBV18	TRBJ1-5
TGCGCCAGCATAAGACAGGTTGGGGTATATAATTCACCCCTCCACTTT	CASIRQVGVYNSPLHF	TRBV10-1	TRBJ1-6
TGCGCCAGCAGCTTGGGTGGGACAGAATCCCCCTACGAGCAGTACTTC	CASSLGGTESPYEQYF	TRBV5-1	TRBJ2-7
TGTGCCAGCAGCTTAGAGGGTCCCGGGGAGCTGTTTTTT	CASSLEGPGELFF	TRBV7-6	TRBJ2-2
TGTGCCAGCAGTTGGGGGATTGGCTACACCTTC	CASSWGIGYTF	TRBV5-5	TRBJ1-2
TGTGCCAGCAATAGAACTATTAGCAATCAGCCCCAGCATTTT	CASNRTISNQPQHF	TRBV19	TRBJ1-5
TGTGCCAGCAGCGAACCCAGACAGGGTCCTAACTATGGCTACACCTTC	CASSEPRQGPNYGYTF	TRBV7-9	TRBJ1-2
TGTGCCAGCAGTTCCCCGCGGACAGGGAGAAAACTGATAGCGCTAAGGGATCAGCCCCAGCATTTT	CASSSPRTGRKLIALRDQPQHF	TRBV27	TRBJ1-5
TGTGCCAGCAGTTTAGACCGGGGCTATGGCTACACCTTC	CASSLDRGYGYTF	TRBV12-3	TRBJ1-2
TGTGCCAGCAGACTGGAATGCGGGAGGGAGACCCAGTACTTC	CASRLECGRETQYF	TRBV6-4	TRBJ2-5
TGTGCCAGCAGCAGGGGCTCTGTATCCCCAGGGGGTCGCACTGAAGCTTTCTTT	CASSRGSVSPGGRTEAFF	TRBV13	TRBJ1-1
TGTGCCAGAAAGGACTACGAGCAGTACTTC	CARKDYEQYF	TRBV28	TRBJ2-7
TGTGCCAGCAGTGAAGGGCTACCCAACTATGGCTACACCTTC	CASSEGLPNYGYTF	TRBV6-4	TRBJ1-2
TGTGCCAGACAGGGTGTACTTGTCGGGGACTATGGCTACACCTTC	CARQGVLVGDYGYTF	TRBV24-1	TRBJ1-2
TGTGCCATCATCCGTTTAGCAGCATACGAGCAGTACTTC	CAIIRLAAYEQYF	TRBV10-3	TRBJ2-7
TGCATCCCCTGGCCAACAGGAGGTTCACCCCTCCACTTT	CIPWPTGGSPLHF	TRBV20-1	TRBJ1-6
TGTGCCAGCAGTTTAAGGACCCTCCCCAGTCAGGTCAATCAGCCCCAGCATTTT	CASSLRTLPSQVNQPQHF	TRBV6-3	TRBJ1-5
TGTGCCACCAGTGATTTCCCGGAGGAAAAGGGGGCTGAAGCTTTCTTT	CATSDFPEEKGAEAFF	TRBV24-1	TRBJ1-1
TGTGCCAGCAGCGTGGCCTCCAGCCTCGCCGCCGGGACAGGGAAGGTTCTTTATGGCTACACCTTC	CASSVASSLAAGTGKVLYGYTF	TRBV9	TRBJ1-2
TGTGCCAGCAAGGAGGGAGTGGTGGAGCAGTACTTC	CASKEGVVEQYF	TRBV7-2	TRBJ2-7
TGTGCCAGCAGACGTCGGAGGGGGGGCTCTGGGGCCAACGTCCTGACTTTC	CASRRRRGGSGANVLTF	TRBV27	TRBJ2-6
TGTGCCAGCATCCGGGGGGAAAAACTGTTTTTT	CASIRGEKLFF	TRBV11-2	TRBJ1-4
TGTGCCAGCAGTGAAAACAGCGGTGAAGCTTTCTTT	CASSENSGEAFF	TRBV6-8	TRBJ1-1
TGTGCCAGCAGTTGGCGCCACCAGCGGGATTGCTACAATGAGCAGTTCTTC	CASSWRHQRDCYNEQFF	TRBV27	TRBJ2-1
TGCGCCAGCAGTGAGCCCCAGAACACCGGGGAGCTGTTTTTT	CASSEPQNTGELFF	TRBV10-1	TRBJ2-2
TGTGCCACCAGCAGAGAAAAGACTAGGAACTCCTACGAGCAGTACTTC	CATSREKTRNSYEQYF	TRBV15	TRBJ2-7
TGTGCCATCAGTGGGAGGGACACCGGGGAGCTGTTTTTT	CAISGRDTGELFF	TRBV10-3	TRBJ2-2
TGCGCCAGCAGCCAGTTCCGGGACAGGCCCTCTGGAAACACCATATATTTT	CASSQFRDRPSGNTIYF	TRBV4-1	TRBJ1-3
TGCAGCCCCGCTCCCTTGGGACTAGCGGGGCGAGCCAAAAACATTCAGTACTTC	CSPAPLGLAGRAKNIQYF	TRBV29-1	TRBJ2-4
TGTGCCAGTTACGCGTCAAGGGCTTGCAATCAGCCCCAGCATTTT	CASYASRACNQPQHF	TRBV27	TRBJ1-5
TGTGCCAGCCTGCAAGCCCAGGAGTATCAGCCCCAGCATTTT	CASLQAQEYQPQHF	TRBV7-4	TRBJ1-5
TGTGCCAGTAGTATTGTCCGGGACGACTCCGAAGAGACCCAGTACTTC	CASSIVRDDSEETQYF	TRBV19	TRBJ2-5
TGCGCCAGCAGCCCCGGGGCCGGGGAGCAGTTCTTC	CASSPGAGEQFF	TRBV5-1	TRBJ2-1
TGTGCCAGCAGTGAGGGGATCTACGAGCAGTACTTC	CASSEGIYEQYF	TRBV27	TRBJ2-7
TGTGCCAGCAGCCAAGGATGGACTAGCACCGTAACCGAGCAGTACTTC	CASSQGWTSTVTEQYF	TRBV3-1	TRBJ2-7
TGTGCCAGCACTCCTCAGGGGGGAGAGACAGATACGCAGTATTTT	CASTPQGGETDTQYF	TRBV28	TRBJ2-3
TGTGCCAGCAGTAAGCCGGGGGCCTATGGCTACACCTTC	CASSKPGAYGYTF	TRBV6-8	TRBJ1-2
TGTGCCAGCAGCGCGGGACAGGGCGAGCAGTACTTC	CASSAGQGEQYF	TRBV9	TRBJ2-7
TGTGCCAGCAGCCAAGGGGATCCTACAGAGGTTGAAAAACTGTTTTTT	CASSQGDPTEVEKLFF	TRBV4-2	TRBJ1-4
TGTGCCAGCAGCTTTCGAACTGGGGGGGCCTACGAGCAGTACTTC	CASSFRTGGAYEQYF	TRBV5-4	TRBJ2-7
TGTGCCACCAGGAACGGACGGGGGAGCTCCTACGAGCAGTACTTC	CATRNGRGSSYEQYF	TRBV24-1	TRBJ2-7
TGCGCCAGCAGCCTGAGCTCTACTCAGTACTTC	CASSLSSTQYF	TRBV5-1	TRBJ2-4
TGCAGTGCTTCGGGAGGGTCCTCTGGAAACACCATATATTTT	CSASGGSSGNTIYF	TRBV20-1	TRBJ1-3
TGTGCCAGCAGCTTACCGGGACCCAGGGGGGTTGGAAACACCATATATTTT	CASSLPGPRGVGNTIYF	TRBV11-3	TRBJ1-3
TGTGCCAGTATCGACCCTTGGGACAATGTGGCGATGGGCTACACCTTC	CASIDPWDNVAMGYTF	TRBV19	TRBJ1-2
TGCAGTGCTAGGAGAATGACGAGTCAGCCCCAGCATTTT	CSARRMTSQPQHF	TRBV20-1	TRBJ1-5
TGCGCCAGCAGCCGGACGACAGGACCCAACTATGGCTACACCTTC	CASSRTTGPNYGYTF	TRBV4-1	TRBJ1-2
TGTGCCAGCAGTACCCCATTGAACCGGGGAAGGACCCAGCATTTT	CASSTPLNRGRTQHF	TRBV6-6	TRBJ1-5
TGCAGCGTTGATGCGGGGGATGAAAAACTGTTTTTT	CSVDAGDEKLFF	TRBV29-1	TRBJ1-4
TGTGCCAGTAGTATGGACAAAGAGACCCAGTACTTC	CASSMDKETQYF	TRBV19	TRBJ2-5
TGTGCCAGCAGTTCGGACTCCCATCAGCCCCAGCATTTT	CASSSDSHQPQHF	TRBV28	TRBJ1-5
TGTGCCAGCAGCCAAGATCAAGGGGTAGTCTTACATAGCAATCAGCCCCAGCATTTT	CASSQDQGVVLHSNQPQHF	TRBV3-1	TRBJ1-5
TGCAGTCACTTAAGGACCACTGAAGCTTTCTTT	CSHLRTTEAFF	TRBV20-1	TRBJ1-1
TGTGCCACCAGTGGTGGACCAGGGACAGGCTTCGATGATGAGCAGTTCTTC	CATSGGPGTGFDDEQFF	TRBV24-1	TRBJ2-1
TGCAGCCCCCTTCGACAGGGGCTGGGGAGCAATCAGCCCCAGCATTTT	CSPLRQGLGSNQPQHF	TRBV29-1	TRBJ1-5
TGTGCCATCAGTGAGTCCAGGGGAGCTTTCTTT	CAISESRGAFF	TRBV10-3	TRBJ1-1
TGTGCCACACAGGGGATGAATCAGCCCCAGCATTTT	CATQGMNQPQHF	TRBV24-1	TRBJ1-5
TGTGCCAGCAGCGGGGGCGGGGGCCACCCATCTGGGGCCAACGTCCTGACTTTC	CASSGGGGHPSGANVLTF	TRBV5-8	TRBJ2-6
TGTGCCAGCAGCCGAGACATTGGGGAAAAACTGTTTTTT	CASSRDIGEKLFF	TRBV4-2	TRBJ1-4
TGTGCCAGCAGCGTAAACCCCCCTGGGGCAAATCAGCCCCAGCATTTT	CASSVNPPGANQPQHF	TRBV11-2	TRBJ1-5
TGTGCCAGCAGTGTGACAGGGGGGAAGAACACTGAAGCTTTCTTT	CASSVTGGKNTEAFF	TRBV5-6	TRBJ1-1
TGTGCCAGCAGCCAACCGCCCACTAGCGGGAGACACGAGCAGTACTTC	CASSQPPTSGRHEQYF	TRBV3-1	TRBJ2-7
TGTGCCAGCAGCAGAGGAGGTATGAACAATCAGCCCCAGCATTTT	CASSRGGMNNQPQHF	TRBV7-3	TRBJ1-5
TGTGCCGTGAGGGGAGGTAATGGCTACACCTTC	CAVRGGNGYTF	TRBV6-5	TRBJ1-2
TGTGCCAGCAGCTTGGCCCAGGGGGGGAGCACAGATACGCAGTATTTT	CASSLAQGGSTDTQYF	TRBV5-4	TRBJ2-3
TGTGCCTGGATAGCCATGCCACAGGGCCGTCAGCCCCAGCATTTT	CAWIAMPQGRQPQHF	TRBV30	TRBJ1-5
TGCAGTGCTAACTTCCCTAGACCGACAGGGGAAGGTTATAGCAATCAGCCCCAGCATTTT	CSANFPRPTGEGYSNQPQHF	TRBV20-1	TRBJ1-5
TGTGCCACCAACCTACCGACAGTTCCAAGTAATTCACCCCTCCACTTT	CATNLPTVPSNSPLHF	TRBV24-1	TRBJ1-6
TGCGCCAGCAGCCCCAATGGACAGGGAGAAGAGCAGTACTTC	CASSPNGQGEEQYF	TRBV4-3	TRBJ2-7
TGCAGTGCTTCAGGACACAACACTGAAGCTTTCTTT	CSASGHNTEAFF	TRBV20-1	TRBJ1-1
TGTGCCAGCAGACCCAACTGTAGTGCCCGCTACGAGCAGTACTTC	CASRPNCSARYEQYF	TRBV5-4	TRBJ2-7
TGCGCCAGCAGCCAAGCCTATAGCTCCTATAATTCACCCCTCCACTTT	CASSQAYSSYNSPLHF	TRBV4-3	TRBJ1-6
TGTGCCACCAGTGATAAACTAGCGGCCCAGTACTTC	CATSDKLAAQYF	TRBV24-1	TRBJ2-5
TGTGCCAGCATAGTAAGGGCGAGCTACGAGCAGTACTTC	CASIVRASYEQYF	TRBV7-2	TRBJ2-7
TGTGCCAGCAGCCCCCCGAAGCCGACGCGACAAGTTCAATGGGCCAAAAACATTCAGTACTTC	CASSPPKPTRQVQWAKNIQYF	TRBV7-3	TRBJ2-4
TGTGCCAGCAGCCAAGATGGGGCGGGGGGGCCCAATGAGCAGTTCTTC	CASSQDGAGGPNEQFF	TRBV14	TRBJ2-1
TGCAGCTTGGGGGGGCAGTACTTC	CSLGGQYF	TRBV29-1	TRBJ2-7
TGTGCCAGCAGCAGAAGCCGGGACAGCTCGAGCTCCTACGAGCAGTACTTC	CASSRSRDSSSSYEQYF	TRBV11-3	TRBJ2-7
TGTGCCAGGGGGGGGAGACCCCATTTCACTGAAGCTTTCTTT	CARGGRPHFTEAFF	TRBV6-3	TRBJ1-1
TGTGCCATCAGTGGCACCCCGGACAGGGGGCAGGACAATCAGCCCCAGCATTTT	CAISGTPDRGQDNQPQHF	TRBV10-3	TRBJ1-5
TGCGCCAGCAGCGCCGACCGTAGCTCCTACGAGCAGTACTTC	CASSADRSSYEQYF	TRBV5-1	TRBJ2-7
TGTGCCTCTAAACAACGACTAGAAGAGACCCAGTACTTC	CASKQRLEETQYF	TRBV9	TRBJ2-5
TGTGCCACCAGTGGTGGGAACTATGGCTACACCTTC	CATSGGNYGYTF	TRBV24-1	TRBJ1-2
TGTGCCAGCAGTTACTCAGGGACTAGCGGGTATAACAATGAGCAGTTCTTC	CASSYSGTSGYNNEQFF	TRBV6-3	TRBJ2-1
TGTGCCAGCAGTTATTACAGGGGTCGTCTATTAAATCAGCCCCAGCATTTT	CASSYYRGRLLNQPQHF	TRBV27	TRBJ1-5
TGTGCCAGCAGCACCGGGCGAAGGCCCCAGCATTTT	CASSTGRRPQHF	TRBV7-9	TRBJ1-5
TGTGCCAGCAGCCTGCCGGGACAGTTAGAGGAAGAGACCCAGTACTTC	CASSLPGQLEEETQYF	TRBV14	TRBJ2-5
TGTGCCAGCAGTTTACGTATATCCAAAGTAACTAGCGGGTACTATGAGCAGTTCTTC	CASSLRISKVTSGYYEQFF	TRBV27	TRBJ2-1
TGTGCCACCAGTGATTTGCGGAGTCCGGGACAGAGAACCTACAATCAGCCCCAGCATTTT	CATSDLRSPGQRTYNQPQHF	TRBV24-1	TRBJ1-5
TGTGCCAAAGGGGGGGAGGGGGTAGCTTTCTTT	CAKGGEGVAFF	TRBV6-3	TRBJ1-1
TGTGCCAGCAGTTTCAACGACAGGGCTTACGAGCAGTACTTC	CASSFNDRAYEQYF	TRBV27	TRBJ2-7
TGTGCCAGCAGTGGACTAGCGGGGCCCGAGCAGTACTTC	CASSGLAGPEQYF	TRBV12-4	TRBJ2-7
TGTCCAAAGGGGGTAGAGACCCAGTACTTC	CPKGVETQYF	TRBV10-3	TRBJ2-5
TGTGCCAGGGTCTCAGATACAGGGGGCTCTGGAAACACCATATATTTT	CARVSDTGGSGNTIYF	TRBV27	TRBJ1-3
TGTGCCAGCAGTGAAGCCCTCGGGCGGCGATTACCAAGACTTAACTATGGCTACACCTTC	CASSEALGRRLPRLNYGYTF	TRBV6-1	TRBJ1-2
TGTGCCACCAGTGACTCTGAGGACAGGGGACAAAGCACCGGGGAGCTGTTTTTT	CATSDSEDRGQSTGELFF	TRBV24-1	TRBJ2-2
TGTGCCAGCAGCTTAGTCCAACTAGAAGCGAATGAGCAGTTCTTC	CASSLVQLEANEQFF	TRBV7-9	TRBJ2-1
TGCAGTGATATCGGGACTAGCGGGGGGAGCTGGAGTGGGGACAATGAGCAGTTCTTC	CSDIGTSGGSWSGDNEQFF	TRBV20-1	TRBJ2-1
TGTGCCAGCAGCCAAGCACAAGGCCTGATGTATGGCTACACCTTC	CASSQAQGLMYGYTF	TRBV3-1	TRBJ1-2
TGTGCCAGCAGCCGTACCCCTGGACCTCAGGGCCGAGCGTATGGCTACACCTTC	CASSRTPGPQGRAYGYTF	TRBV11-3	TRBJ1-2
TGTGCCAGCAGTGATCCGAGCGGGAAAGGGACCTATGAGCAGTTCTTC	CASSDPSGKGTYEQFF	TRBV2	TRBJ2-1
TGCAGTGCTAGAGCCTCCTTTCACAGGGGCCAGTCCTACGAGCAGTACTTC	CSARASFHRGQSYEQYF	TRBV20-1	TRBJ2-7
TGTGCCAGCAGCTCCCCCGGTGTAGTTCCGGGCTACACCTTC	CASSSPGVVPGYTF	TRBV11-2	TRBJ1-2
TGCGCCAGCAGCCAGGGGGGGGGGAAAAGCTCCTACGAGCAGTACTTC	CASSQGGGKSSYEQYF	TRBV4-3	TRBJ2-7
TGTGCCACCAGTGACTACACTGAAGCTTTCTTT	CATSDYTEAFF	TRBV24-1	TRBJ1-1
TGTGCCAGCAGTCAGACCGCCAAAAACATTCAGTACTTC	CASSQTAKNIQYF	TRBV2	TRBJ2-4
TGTGCCAGCAGCTCTAACTTCAACATTCAGTACTTC	CASSSNFNIQYF	TRBV13	TRBJ2-4
TGTGCCAGCAGTGGCCGATGCTTTACTAGCGGGAAAAAATCTCGCGTTGAGCAGTTCTTC	CASSGRCFTSGKKSRVEQFF	TRBV6-4	TRBJ2-1
TGTGCCACCAGTGTAACTTGGGGGACAAGTGGGGCCAACGTCCTGACTTTC	CATSVTWGTSGANVLTF	TRBV24-1	TRBJ2-6
TGTGCCAGCAGCCAAGATTTTAGGGACAGGACTTCTTATGAAGCTTTCTTT	CASSQDFRDRTSYEAFF	TRBV3-1	TRBJ1-1
TGTGCCAGCAGCGGGGCGTTAGGGTACAATGAGCAGTTCTTC	CASSGALGYNEQFF	TRBV13	TRBJ2-1
TGTGCCAGCAGTTTAGTCCCAGTCCAACGCCAGCATTTT	CASSLVPVQRQHF	TRBV12-4	TRBJ1-5
TGTGCCAGCAGCGTAGGTTCTGGGGGAGCGAGCACTGAAGCTTTCTTT	CASSVGSGGASTEAFF	TRBV9	TRBJ1-1
TGTGCCAGCAGGTTCCGGGTGGGACAGGGGGCTCAGCCCCAGCATTTT	CASRFRVGQGAQPQHF	TRBV27	TRBJ1-5
TGTGCCACCGGGGGGGTTATTTATGGCTACACCTTC	CATGGVIYGYTF	TRBV24-1	TRBJ1-2
TGCGCCAGCAGTGAGCCGGTCGGACAGGGGGCGGACAATCAGCCCCAGCATTTT	CASSEPVGQGADNQPQHF	TRBV10-1	TRBJ1-5
TGTGCCAGCTCCGGGAACGGGCGCTACGAGCAGTACTTC	CASSGNGRYEQYF	TRBV18	TRBJ2-7
TGTGCCAGCAGCCAAGAAAGTGTACCGGGGGGGCAGTTCTTC	CASSQESVPGGQFF	TRBV3-1	TRBJ2-1
TGCAGTGCTAAGTGGGGAGTAAAGGTTGAACAGCCCCAGCATTTT	CSAKWGVKVEQPQHF	TRBV20-1	TRBJ1-5
TGTGCCAGCAGCCCCCCCTGGCAGGGCGCCGGTGAGCAGTACTTC	CASSPPWQGAGEQYF	TRBV7-3	TRBJ2-7
TGTGCCACCAGTGACCAGGGGGTGGAGGGGGATTATAGCAATCAGCCCCAGCATTTT	CATSDQGVEGDYSNQPQHF	TRBV24-1	TRBJ1-5
TGTGCCAGCAGCCGAAGGGGACCTTACGGGGAGCTGTTTTTT	CASSRRGPYGELFF	TRBV3-1	TRBJ2-2
TGTGCCAGCAGTTTACCTGGACAGGGTAATGATCGGAGCACAGATACGCAGTATTTT	CASSLPGQGNDRSTDTQYF	TRBV27	TRBJ2-3
TGCGCCAGCAGCCAAGATTCGGGGGTTGACGAGCAGTACTTC	CASSQDSGVDEQYF	TRBV4-1	TRBJ2-7
TGTGCCAGCAGCTTGGGGGTATGTAAGGGGGGCCGGAACACTGAAGCTTTCTTT	CASSLGVCKGGRNTEAFF	TRBV5-6	TRBJ1-1
TGTGCCTGGGGTTCGGGGGGGGGCCCCGGGTCCTACGAGCAGTACTTC	CAWGSGGGPGSYEQYF	TRBV30	TRBJ2-7
TGTGCCAGCAGTGAAGCGGGAGATAAAAACACTGAAGCTTTCTTT	CASSEAGDKNTEAFF	TRBV25-1	TRBJ1-1
TGCAGTGCTCCTATCCGGCAAGCCTACGAGCAGTACTTC	CSAPIRQAYEQYF	TRBV20-1	TRBJ2-7
TGCAGCGTTGAAAGGACCTATGGCTACACCTTC	CSVERTYGYTF	TRBV29-1	TRBJ1-2
TGTGCCAGCAAAGTAAATATTCGAAAGAACTATGGCTACACCTTC	CASKVNIRKNYGYTF	TRBV5-4	TRBJ1-2
TGTGCCAGCAGCACAGGGGACCGAGAGACCCAGTACTTC	CASSTGDRETQYF	TRBV14	TRBJ2-5
TGTGCCACCACAGAAAAACTGTTTTTT	CATTEKLFF	TRBV19	TRBJ1-4
TGCAGTGCTAGATCCTCGGGAGAGGGTAGCTCCTACAATGAGCAGTTCTTC	CSARSSGEGSSYNEQFF	TRBV20-1	TRBJ2-1
TGCAGTGCTAGAGATCAGAACGAGGGGGGGTCTAATGAGCAGTTCTTC	CSARDQNEGGSNEQFF	TRBV20-1	TRBJ2-1
TGTGCCAGCAGCCCCCCTCTCCCCCTGCAAAACTTAAGGACCGGGGAGCTGTTTTTT	CASSPPLPLQNLRTGELFF	TRBV13	TRBJ2-2
TGTGCCAGCAGCCAAGGTGATCCAGGGGACAGGTGGTCGACGGATACGCAGTATTTT	CASSQGDPGDRWSTDTQYF	TRBV3-1	TRBJ2-3
TGCGCCAGCAGCGATCCCCGACGGATCACAGATACGCAGTATTTT	CASSDPRRITDTQYF	TRBV5-1	TRBJ2-3
TGCAGTGCTCGGTGGGGTAACGCCAAAAACATTCAGTACTTC	CSARWGNAKNIQYF	TRBV20-1	TRBJ2-4
TGTGCCAGCAGCCCACCCTCAGGAGTGGGCTCTGGAAACACCATATATTTT	CASSPPSGVGSGNTIYF	TRBV6-4	TRBJ1-3
TGTGCCAGCAGCTTAAGGCAGGGAAGGACTGAAGCTTTCTTT	CASSLRQGRTEAFF	TRBV7-3	TRBJ1-1
TGTGCCACCAGTGGGGAGAATGAGCAGTTCTTC	CATSGENEQFF	TRBV24-1	TRBJ2-1
TGCGCCAGCACACATCGGGGGGGGCAGAACGAGCAGTACTTC	CASTHRGGQNEQYF	TRBV10-1	TRBJ2-7
TGTGCCACCAGTCGGGGGATTCCTTGTTGCACAGATACGCAGTATTTT	CATSRGIPCCTDTQYF	TRBV24-1	TRBJ2-3
TGTGCCAGCAGTTCGTCCGGGGGCAGGACCCGATATAGCAATCAGCCCCAGCATTTT	CASSSSGGRTRYSNQPQHF	TRBV28	TRBJ1-5
TGTGCCAGCAGTTACCAGGGGGCACTACCCTACGAGCAGTACTTC	CASSYQGALPYEQYF	TRBV6-9	TRBJ2-7
TGTGCCAGCCGCAGGACAGGGGAAAAACTGTTTTTT	CASRRTGEKLFF	TRBV6-4	TRBJ1-4
TGTGCCAGCATTCCAGGCTACGAGCAGTACTTC	CASIPGYEQYF	TRBV6-1	TRBJ2-7
TGCGCCAGCAGTGAGTGTTCCCGGGACATGTCCTACGAGCAGTACTTC	CASSECSRDMSYEQYF	TRBV10-1	TRBJ2-7
TGTGCCAGCAGTTATTGGGGACTAGCGTCCGAGCAGTACTTC	CASSYWGLASEQYF	TRBV6-9	TRBJ2-7
TGCGCCAGCAGCGTTGCCACAAAAAGAAGTAACGCTGGGGCCAACGTCCTGACTTTC	CASSVATKRSNAGANVLTF	TRBV5-1	TRBJ2-6
TGTGCCAGCAGCCAAGCGGGGGCGGGAGATCGGAATACTGCTGCAGATACGCAGTATTTT	CASSQAGAGDRNTAADTQYF	TRBV14	TRBJ2-3
TGTGCCAGCAGTTACTCGAAGGGGACAGATACGCAGTATTTT	CASSYSKGTDTQYF	TRBV6-6	TRBJ2-3
TGCGCCAGCAGCTTGGCAGGGACTAGCGGGCTCTGCTACGAGCAGTACTTC	CASSLAGTSGLCYEQYF	TRBV5-1	TRBJ2-7
TGTGCTAGTGGTTTGGTGAGTTATACGGAAAAACGCAATCAGCCCCAGCATTTT	CASGLVSYTEKRNQPQHF	TRBV12-5	TRBJ1-5
TGCAGGCACAACACTGAAGCTTTCTTT	CRHNTEAFF	TRBV20-1	TRBJ1-1
TGTGCCAGCAGCTTCGGCGGACAGGGGGCCCTAGCCAAAAACATTCAGTACTTC	CASSFGGQGALAKNIQYF	TRBV9	TRBJ2-4
TGTGCCAGCAGTCCCCAGACAGGGCATTTGAACACTGAAGCTTTCTTT	CASSPQTGHLNTEAFF	TRBV7-8	TRBJ1-1
TGCGCCAGCAGTGCTGACAGGACTAATGAAAAACTGTTTTTT	CASSADRTNEKLFF	TRBV5-1	TRBJ1-4
TGTGCCACAAGACAGGGGTCCAATCAGCCCCAGCATTTT	CATRQGSNQPQHF	TRBV6-5	TRBJ1-5
TGTGCCAGCGTCCTAGCTTGCCAAGAGACCCAGTACTTC	CASVLACQETQYF	TRBV7-7	TRBJ2-5
TGTGCCTGGAGTGACAGCTACGAGCAGTACTTC	CAWSDSYEQYF	TRBV30	TRBJ2-7
TGTGCCAGCTCACCACCTAAGGACAGAACCTGTAATGAAAAACTGTTTTTT	CASSPPKDRTCNEKLFF	TRBV18	TRBJ1-4
TGTGCCAGCCCTAGCGGGGTTAAATACGAGCAGTACTTC	CASPSGVKYEQYF	TRBV12-3	TRBJ2-7
TGTGCCAGCAGCCCGGGGGGTAATCAGCCCCAGCATTTT	CASSPGGNQPQHF	TRBV13	TRBJ1-5
TGTGCCAGCAGCTTATTAGGGAGGAAGCTAAACGCGGGTGAAGCTTTCTTT	CASSLLGRKLNAGEAFF	TRBV5-4	TRBJ1-1
TGTGCCAGCAGGGACGGTGCCTCCTACGAGCAGTACTTC	CASRDGASYEQYF	TRBV3-1	TRBJ2-7
TGCGCCAGCAGTTTATGGAAACTCGGCGAGAACACTGAAGCTTTCTTT	CASSLWKLGENTEAFF	TRBV10-1	TRBJ1-1
TGTGCCAGTAGTTTGGCAACGCAGTACTTC	CASSLATQYF	TRBV19	TRBJ2-7
TGCGCCAGCAGCCGGACGTTCACCGGGGAGCTGTTTTTT	CASSRTFTGELFF	TRBV5-1	TRBJ2-2
TGTGCCAGCAACAATGTAGCGGCCTACGAGCAGTACTTC	CASNNVAAYEQYF	TRBV6-1	TRBJ2-7
TGCGCCAGCAAACCTAGGGACGGGGGCTACACCTTC	CASKPRDGGYTF	TRBV5-1	TRBJ1-2
TGCGCCAGCAGTGAGAGCGGGAGGAGAAGGGCTAAGGGGGAGGGAGCGGATCAGCCCCAGCATTTT	CASSESGRRRAKGEGADQPQHF	TRBV10-2	TRBJ1-5
TGTGCCATCAGTAGGGGCGGGCCGGCCGAGACCCAGTACTTC	CAISRGGPAETQYF	TRBV10-3	TRBJ2-5
TGTGCCAGCAGTTACCCCGGACAGGGAGGATTACCGCCCACTGAAGCTTTCTTT	CASSYPGQGGLPPTEAFF	TRBV6-5	TRBJ1-1
TGTGCCACCAGAGACCTTGAGCGGGATACGCAGTATTTT	CATRDLERDTQYF	TRBV24-1	TRBJ2-3
TGTGCCAGCAGCTACCCCCAGGGAATGATGGCCTCCTACGAGCAGTACTTC	CASSYPQGMMASYEQYF	TRBV7-9	TRBJ2-7
TGTGCCAGCAGTTTATGTAGGGGGTGTCGCACTGAAGCTTTCTTT	CASSLCRGCRTEAFF	TRBV27	TRBJ1-1
TGTGCCCATTCAAAGGGCGCTTTCTTT	CAHSKGAFF	TRBV10-3	TRBJ1-1
TGTGCCAGCAGCCACGCAGGGGACTATGGCTACACCTTC	CASSHAGDYGYTF	TRBV5-6	TRBJ1-2
TGTGCCAGCAGCTTAGATGGGGCGAACACCGGGGAGCTGTTTTTT	CASSLDGANTGELFF	TRBV7-9	TRBJ2-2
TGTGCCTGGGGCAGGGGGAGCTACGAGCAGTACTTC	CAWGRGSYEQYF	TRBV30	TRBJ2-7
TGTGCCAGCAGTTTATTAGGACTAGCGGGAGCACTCCCCTACGAGCAGTACTTC	CASSLLGLAGALPYEQYF	TRBV27	TRBJ2-7
TGTGCCAGCAGCAAATTCACTAGCGGCCGAGGCACAGATACGCAGTATTTT	CASSKFTSGRGTDTQYF	TRBV11-3	TRBJ2-3
TGTGCCAGCAGTTCACAAGACAGGAGGTACCAAGAGACCCAGTACTTC	CASSSQDRRYQETQYF	TRBV27	TRBJ2-5
TGTGCCACCAGTGATAACGACAGGGGGGAAGAGACCCAGTACTTC	CATSDNDRGEETQYF	TRBV24-1	TRBJ2-5
TGTGCCAGCCAGGGGGCTCTGAACTACGAGCAGTACTTC	CASQGALNYEQYF	TRBV25-1	TRBJ2-7
TGTGCCAGCAGCCCCTCTAGGACAGGTATATTTTTCGGACCCTATGGCTACACCTTC	CASSPSRTGIFFGPYGYTF	TRBV13	TRBJ1-2
TGTGCCAGCGGAGGGAATACTCGCGCCTACGAGCAGTACTTC	CASGGNTRAYEQYF	TRBV6-4	TRBJ2-7
TGTGCCAGCAGTTCTGCTCCGCTCCGGGACAGGGGAGTGGGGGGCTACACCTTC	CASSSAPLRDRGVGGYTF	TRBV12-4	TRBJ1-2
TGTGCCAGCAGCTTGGCCTCCCTCAGGGGGCCTGAGCAGTACTTC	CASSLASLRGPEQYF	TRBV5-6	TRBJ2-7
TGTGCCAGCAGCCCCCATCTCCAGGGGGCAGTCTACGCCTACGAGCAGTACTTC	CASSPHLQGAVYAYEQYF	TRBV9	TRBJ2-7
TGTGCCTCCCTCACGGGGGCTGAGCAGTACTTC	CASLTGAEQYF	TRBV25-1	TRBJ2-7
TGTGCCAGCTCACCACCGAAGGGACAGGGGGAGGTAGGTAATGGCTACACCTTC	CASSPPKGQGEVGNGYTF	TRBV18	TRBJ1-2
TGTGCCAGCAGTGTACTTTTCCCATGGGGGGGTGCAGCAGCCAATGAAAAACTGTTTTTT	CASSVLFPWGGAAANEKLFF	TRBV6-4	TRBJ1-4
TGCGCCAGCATGGCTACCCAGTACTTC	CASMATQYF	TRBV5-1	TRBJ2-7
TGCAGTGCTAGCGGGGGGCCTAACTATGGCTACACCTTC	CSASGGPNYGYTF	TRBV20-1	TRBJ1-2
TGTGCCAGTAGGATCGTTACAACAGGGATTTACGAGCAGTACTTC	CASRIVTTGIYEQYF	TRBV19	TRBJ2-7
TGTGCCAGCAGACCTGAAACAGGGAACACTGAAGCTTTCTTT	CASRPETGNTEAFF	TRBV3-1	TRBJ1-1
TGCGCCAGCAGCCCCCCGCAGGGGGGTGGCACCGGGGAGCTGTTTTTT	CASSPPQGGGTGELFF	TRBV4-1	TRBJ2-2
TGCGCCAGCACGGTTAAAGTCACCGGGACAGCCGGAAACACCATATATTTT	CASTVKVTGTAGNTIYF	TRBV5-1	TRBJ1-3
TGTGCCACGCCATGCGGGAGGCGGGACTCCTACGAGCAGTACTTC	CATPCGRRDSYEQYF	TRBV13	TRBJ2-7
TGTGCCAGCAGCTTAAATCGGACAGCTGCCGTCTGGAAGATCACTGAAGCTTTCTTT	CASSLNRTAAVWKITEAFF	TRBV7-3	TRBJ1-1
TGTGCCAGCAGCTTACCTGGACAGGGGCCTTTCCCGTATGGCTACACCTTC	CASSLPGQGPFPYGYTF	TRBV7-9	TRBJ1-2
TGTGCCAGCAGCGCCCTGAATGATGGCTACACCTTC	CASSALNDGYTF	TRBV7-2	TRBJ1-2
TGCAGTGCTAGAGATCCGGCACGTAAAAAGGCGGTATCACCCCGGGGTGCTTTCTTT	CSARDPARKKAVSPRGAFF	TRBV20-1	TRBJ1-1
TGTGCCAGTAGTAGGGAGAGCGGGAGATCAGATACGCAGTATTTT	CASSRESGRSDTQYF	TRBV19	TRBJ2-3
TGTGCCAGCAGCTTTCAGATTTCCTCTCATGGCTACACCTTC	CASSFQISSHGYTF	TRBV9	TRBJ1-2
TGTGCCAGCATCAACGGCCTCACAGATACGCAGTATTTT	CASINGLTDTQYF	TRBV6-5	TRBJ2-3
TGTGCCTGGAGAGCTCGGGTGGACACGGGGGAGCAGTACTTC	CAWRARVDTGEQYF	TRBV30	TRBJ2-7
TGTGCCAGCAGTGGCTTGCGCGGGTTAACAGATACGCAGTATTTT	CASSGLRGLTDTQYF	TRBV6-1	TRBJ2-3
TGTGCCAGCCTTTTGAGGACGGGCACCGGGGAGCTGTTTTTT	CASLLRTGTGELFF	TRBV6-1	TRBJ2-2
TGTGCCAGCAGCCAAGATAGGGCACCCCGGAAGGTAGGGTTCTCCTACGAGCAGTACTTC	CASSQDRAPRKVGFSYEQYF	TRBV3-1	TRBJ2-7
TGTGCCAGCAGCCCCCGGGGGCTTAATGGTGGCTACACCTTC	CASSPRGLNGGYTF	TRBV7-6	TRBJ1-2
TGTGCCACCAGTGAATGGGTCTTTCAGCCCCAGCATTTT	CATSEWVFQPQHF	TRBV24-1	TRBJ1-5
TGTGCCAGTAGGGGTGGGACAGGGGCTAACTATGGCTACACCTTC	CASRGGTGANYGYTF	TRBV19	TRBJ1-2
TGTGCCAGCAGTTACTCGTGCCTACCCCCGGGACTAGCGGGAGAGCTCAATGAGCAGTTCTTC	CASSYSCLPPGLAGELNEQFF	TRBV6-5	TRBJ2-1
TGCTGGGTCGGGGGGCCGGAGGCCCTCTCCTACGAGCAGTACTTC	CWVGGPEALSYEQYF	TRBV5-1	TRBJ2-7
TGCGCCAGCAGCTTGCCGGGGACCTTTGGGTCTGGGGCCAACGTCCTGACTTTC	CASSLPGTFGSGANVLTF	TRBV5-1	TRBJ2-6
TGTGCCAGCAGAGCCCGTCCCGATAGCCACGAGCAGTACTTC	CASRARPDSHEQYF	TRBV12-3	TRBJ2-7
TGTGCCAGCGGAACCCGATGTTCACCCCTCCACTTT	CASGTRCSPLHF	TRBV5-6	TRBJ1-6
TGCAGCGTTGCTGAAGGGATTCCCGGAACAGATACGCAGTATTTT	CSVAEGIPGTDTQYF	TRBV29-1	TRBJ2-3
TGCGCCAGCAGGGACACAGGGGGCGGGGCCTACGAGCAGTACTTC	CASRDTGGGAYEQYF	TRBV10-1	TRBJ2-7
TGTGCCAGCAGCGACAGGGGCTACCGCAATCAGCCCCAGCATTTT	CASSDRGYRNQPQHF	TRBV11-2	TRBJ1-5
TGTGCCAGCAGCGGACACCATTTCACTGAAGCTTTCTTT	CASSGHHFTEAFF	TRBV7-4	TRBJ1-1
TGTGCCAGCAGCTTATTAAGGAACACAGGGGGCTACACCTTC	CASSLLRNTGGYTF	TRBV11-3	TRBJ1-2
TGTGCCAGCAGCGGTTGCGGGTATCGGGGGCTTGAAGGGTATAACTATGGCTACACCTTC	CASSGCGYRGLEGYNYGYTF	TRBV13	TRBJ1-2
TGTGCCAGCAGTTCCGATCAGCGGGAGATCCGGAACACTGAAGCTTTCTTT	CASSSDQREIRNTEAFF	TRBV12-4	TRBJ1-1
TGCAGTGCTAGACCCCCAAGGCGGGAGTTGGGTTTAGCCTACGAGCAGTACTTC	CSARPPRRELGLAYEQYF	TRBV20-1	TRBJ2-7
TGTGCCAGCAGCACTGGGACAGGCAGAAGGCCTAATACAGATACGCAGTATTTT	CASSTGTGRRPNTDTQYF	TRBV13	TRBJ2-3
TGCGCCAGCAGAATGGGACAGGGAAAACTGTTTTTT	CASRMGQGKLFF	TRBV10-1	TRBJ1-4
TGCAGTGCTATACCGACAGGGACCACTCTGAACACTGAAGCTTTCTTT	CSAIPTGTTLNTEAFF	TRBV20-1	TRBJ1-1
TGCAGTGCTAGAAGGCTGTATAATCAGCCCCAGCATTTT	CSARRLYNQPQHF	TRBV20-1	TRBJ1-5
TGTGCCAGCAGTTACTGGAGGGTCGGGGGCATTTATGGCTACACCTTC	CASSYWRVGGIYGYTF	TRBV6-2	TRBJ1-2
TGTGCTAGTCCGGCTAGCGGGAACGATACGCAGTATTTT	CASPASGNDTQYF	TRBV12-5	TRBJ2-3
TGTGCCAGCAGCACCCATACAGGGAGAGAGTTTTCCTTC	CASSTHTGREFSF	TRBV7-6	TRBJ1-2
TGCGCCAACGTTGAAGGGGGCGGGGATGAAGCTTTCTTT	CANVEGGGDEAFF	TRBV5-1	TRBJ1-1
TGTGCCAGCAGCTGGATCCCGCGGCAAGTGCACTATGGCTACACCTTC	CASSWIPRQVHYGYTF	TRBV11-2	TRBJ1-2
TGCGCCAGCAGTGAGTCTCAGGGGGCCGAAAGCTCCTACGAGCAGTACTTC	CASSESQGAESSYEQYF	TRBV10-1	TRBJ2-7
TGCAGTGCTGATAGCAGGGGCAGGAATGGGGAGTCTGGCTACACCTTC	CSADSRGRNGESGYTF	TRBV20-1	TRBJ1-2
TGCAGTGCTAGGAATAGGGGGTTTATAACAACTAATGAAAAACTGTTTTTT	CSARNRGFITTNEKLFF	TRBV20-1	TRBJ1-4
TGCAGTGCCGCCAGGCTAAACACTGAAGCTTTCTTT	CSAARLNTEAFF	TRBV20-1	TRBJ1-1
TGCAGTGCTAGAGAGAGGTTTTACTATCGAGGAACGGAGCTGTTTTTT	CSARERFYYRGTELFF	TRBV20-1	TRBJ2-2
TGTGCCACCAAGGGAACAGGACTAAAGGTTAACTACGAGCAGTACTTC	CATKGTGLKVNYEQYF	TRBV24-1	TRBJ2-7
TGTGCCACCAGTGATTTGGCTGAAGATCTACTAGCCAAAAACATTCAGTACTTC	CATSDLAEDLLAKNIQYF	TRBV24-1	TRBJ2-4
TGTGCCAGCAGCTTAGGGACAGGTCAGCCCCAGCATTTT	CASSLGTGQPQHF	TRBV7-8	TRBJ1-5
TGTGCCAGCGGGAGGGGCAATGAGCAGTTCTTC	CASGRGNEQFF	TRBV6-1	TRBJ2-1
TGTGCCACCAGTGGAGGGGGGGTTCGATCTGGGGCAGATACGCAGTATTTT	CATSGGGVRSGADTQYF	TRBV24-1	TRBJ2-3
TGTGCCACCAGTGATGCCGGGGGCGGGGACAGCTCCTACGAGCAGTACTTC	CATSDAGGGDSSYEQYF	TRBV24-1	TRBJ2-7
TGTGCCAGCAGCTCCCAGGTGATTGAAAAACTGTTTTTT	CASSSQVIEKLFF	TRBV7-3	TRBJ1-4
TGTGCCACCAGTGACCTTTGGGAGGGTGAGAGCAATCAGCCCCAGCATTTT	CATSDLWEGESNQPQHF	TRBV24-1	TRBJ1-5
TGTGCCAGCAGTGAAGACGGGAATAACTACGAGCAGTACTTC	CASSEDGNNYEQYF	TRBV25-1	TRBJ2-7
TGTGCCACCAGTGAGGCAGGGTCGCACACTGAAGCTTTCTTT	CATSEAGSHTEAFF	TRBV24-1	TRBJ1-1
TGTGCCAGCAGCTTCGGCATGTGGGACAGGGAAATGCCGCAGTATTTT	CASSFGMWDREMPQYF	TRBV5-6	TRBJ2-3
TGTGCCAGCAGCTTCCGTGGGGGGTCCCAGTACTTC	CASSFRGGSQYF	TRBV11-3	TRBJ2-5
TGTGCCAGCAGAAGGGACGACCAAGCTTTCTTT	CASRRDDQAFF	TRBV2	TRBJ1-1
TGTGCTAGTGGTTTCCACCGGGACAGGGAGGAGACCCAGTACTTC	CASGFHRDREETQYF	TRBV12-5	TRBJ2-5
TGTGCCAGCGTCAGGGAGACCTACGAGCAGTACTTC	CASVRETYEQYF	TRBV27	TRBJ2-7
TGTGCCAGCAGCCTTAAACAATATTTCCCTGGGGCCAACGTCCTGACTTTC	CASSLKQYFPGANVLTF	TRBV3-1	TRBJ2-6
TGTGCCAGCAGCGTAAGGTCCCGGTGGGCTGGGAACACCGGGGAGCTGTTTTTT	CASSVRSRWAGNTGELFF	TRBV9	TRBJ2-2
TGTGCCAGCAGTCCGGGGCAGGGAGGGGACACCGGGGAGCTGTTTTTT	CASSPGQGGDTGELFF	TRBV6-5	TRBJ2-2
TGTGCCATCAGTGATCTGGGACAGGGGGCGCCTGACTACGAGCAGTACTTC	CAISDLGQGAPDYEQYF	TRBV10-3	TRBJ2-7
TGTGCCAGTGAACCTACCAGGGGGAGTTCCGCTTTCTTT	CASEPTRGSSAFF	TRBV19	TRBJ1-1
TGTGCCAGCAGCGAGGGACAGGGGGTCCACAATGAGCAGTTCTTC	CASSEGQGVHNEQFF	TRBV13	TRBJ2-1
TGTGCCAGCATCGGACAGGGTGCGGACGATCCCTACGAGCAGTACTTC	CASIGQGADDPYEQYF	TRBV6-1	TRBJ2-7
TGCAGTGCTAGAGGAGCTAGCGGGGACACCGGGGAGCTGTTTTTT	CSARGASGDTGELFF	TRBV20-1	TRBJ2-2
TGTGCCAGCAGCTTAACGAGAGAGGGAATAACCGGGGGCACTGAAGCTTTCTTT	CASSLTREGITGGTEAFF	TRBV7-3	TRBJ1-1
TGCAGCGTTGACAACGGGGATCAGCCCCAGCATTTT	CSVDNGDQPQHF	TRBV29-1	TRBJ1-5
TGTGCCAGCAGCCGGACCGGGATGGGGAGCAATCAGCCCCAGCATTTT	CASSRTGMGSNQPQHF	TRBV14	TRBJ1-5
TGTGCCAGCAGTCCAGAGGTCGAGGCTGCGGATGGCTACACCTTC	CASSPEVEAADGYTF	TRBV12-4	TRBJ1-2
TGTGCCAGCAGTTTACCTAGCGGGTGCAATGAGCAGTTCTTC	CASSLPSGCNEQFF	TRBV28	TRBJ2-1
TGTGCCAGCAGTGATCGGGACGAAGAGACCCAGTACTTC	CASSDRDEETQYF	TRBV2	TRBJ2-5
TGTGCCAGCTTAAGCCTAGCGGGGGCCCGATCCGGGGAGCTGTTTTTT	CASLSLAGARSGELFF	TRBV6-5	TRBJ2-2
TGTTCGAAACGCTGCGGCTACACCTTC	CSKRCGYTF	TRBV6-5	TRBJ1-2
TGTGCCAGCAGCCAAGATAGCTCGGCCGGGACTAGACCGGGCGTCTTC	CASSQDSSAGTRPGVF	TRBV4-2	TRBJ2-1
TGTGCCAGTAGCCTACAGGGGCGGGTACGGACCACTGAAGCTTTCTTT	CASSLQGRVRTTEAFF	TRBV19	TRBJ1-1
TGTGCCACCAGTGATACGGGACAGGAGGGTAATTCACCCCTCCACTTT	CATSDTGQEGNSPLHF	TRBV24-1	TRBJ1-6
TGCAGCGTTTGTGCCCGACGGCAAGAGACCCAGTACTTC	CSVCARRQETQYF	TRBV29-1	TRBJ2-5
TGTGCCAGCAGCTTAGGGCGGGGGACAGATGAGCAGTTCTTC	CASSLGRGTDEQFF	TRBV7-9	TRBJ2-1
TGTGAATGGGACAGGGAATTCTATGGCTACACCTTC	CEWDREFYGYTF	TRBV12-3	TRBJ1-2
TGTGCCAGCAGCTGGGGACTTAATGAGCAGTTCTTC	CASSWGLNEQFF	TRBV5-4	TRBJ2-1
TGTGCCATCAGAGGAGTGCGGAAGAGCGGGAAGTCCGGGGAGCTGTTTTTT	CAIRGVRKSGKSGELFF	TRBV10-3	TRBJ2-2
TGTGCCAAGACTCGTACACAGGGCTCCTACGAGCAGTACTTC	CAKTRTQGSYEQYF	TRBV10-3	TRBJ2-7
TGTGCCAGCAGCCACCCGCCAGGGACGGAGTATGAAGCTTTCTTT	CASSHPPGTEYEAFF	TRBV7-4	TRBJ1-1
TGTGCCAGCAGTTTCTCTCGGGTAACTAGCGGGAGGATAGGGGTTTACGAGCAGTACTTC	CASSFSRVTSGRIGVYEQYF	TRBV27	TRBJ2-7
TGTGCCACCAGCAGCCCTACAGGGGTCTCTGGAAACACCATATATTTT	CATSSPTGVSGNTIYF	TRBV15	TRBJ1-3
TGTGCCAGCAGCACCACCAGTGGCAATCAGCCCCAGCATTTT	CASSTTSGNQPQHF	TRBV5-4	TRBJ1-5
TGTGCCAGTAGTATTAGACTAGCGGAGGAATTCTCCTACGAGCAGTACTTC	CASSIRLAEEFSYEQYF	TRBV19	TRBJ2-7
TGTGCCACCAGTGATGCCGGGCAGGGTGAAGCTTTCTTT	CATSDAGQGEAFF	TRBV24-1	TRBJ1-1
TGTGCCAGCAGCCAAGGGTTTGGACAGAGTCAGCCCCAGCATTTT	CASSQGFGQSQPQHF	TRBV3-1	TRBJ1-5
TGCAGTGCTAATGCAGCCGGGCAGACATATGGCTACACCTTC	CSANAAGQTYGYTF	TRBV20-1	TRBJ1-2
TGTGCCTGCAGAAACCGGGGTTACTGGGGAAAAGAGACCCAGTACTTC	CACRNRGYWGKETQYF	TRBV30	TRBJ2-5
TGTGCCAGCAGTCGGGCAGGGATTGGCTACACCTTC	CASSRAGIGYTF	TRBV27	TRBJ1-2
TGTGCCAGCAGTTTCACCGGGACTAGGGCCGTCGAGCAGTACTTC	CASSFTGTRAVEQYF	TRBV12-4	TRBJ2-7
TGTGCCAGCAGCTTAGGGCAATCCCGGGACAGGAAGTGGCACAATGAGCAGTTCTTC	CASSLGQSRDRKWHNEQFF	TRBV7-2	TRBJ2-1
TGTGCCAGCAGCTTAGACAAGGGGGGGGACCGGATCGGCTACACCTTC	CASSLDKGGDRIGYTF	TRBV11-3	TRBJ1-2
TGTGCCAGCAGCGGACAGGGGCCTAGATTTACCGGGGAGCTGTTTTTT	CASSGQGPRFTGELFF	TRBV7-9	TRBJ2-2
TGTGCTAGTGAGCCTATGGGGCGGTCTAATGAAAAACTGTTTTTT	CASEPMGRSNEKLFF	TRBV12-5	TRBJ1-4
TGTGCCAGCAGCGTAGCGGACCGGGTAGGCAATCAGCCCCAGCATTTT	CASSVADRVGNQPQHF	TRBV9	TRBJ1-5
TGTGCCAGCAGTTTTGTGGACCAGAGCACAGATACGCAGTATTTT	CASSFVDQSTDTQYF	TRBV27	TRBJ2-3
TGCAGTGCTAGAGTATCGGACAGGGGGCAGGCTGGGGCCAACGTCCTGACTTTC	CSARVSDRGQAGANVLTF	TRBV20-1	TRBJ2-6
TGTGCCAGCAGCCCCACACAGGGAGGGGGAGAAGCTTTCTTT	CASSPTQGGGEAFF	TRBV13	TRBJ1-1
TGCGCCAGCAGCTCTCTCAGTACTAGCGGGACTACCTACAATGAGCAGTTCTTC	CASSSLSTSGTTYNEQFF	TRBV5-1	TRBJ2-1
TGTGCCAGCAGCTTGACTCATATAATGAGAACACACACTGAAGCTTTCTTT	CASSLTHIMRTHTEAFF	TRBV5-5	TRBJ1-1
TGCAGCGTTGAGGGCCCCAAGAGGGGGACAGTGAAGGCTGAAGCTTTCTTT	CSVEGPKRGTVKAEAFF	TRBV29-1	TRBJ1-1
TGTGCCAGCAGTCAAGCGGGAGGCTTTGGGGAGCTGTTTTTT	CASSQAGGFGELFF	TRBV6-2	TRBJ2-2
TGTGCCAGCACAGGGTGGGAGGAGACCCAGTACTTC	CASTGWEETQYF	TRBV6-5	TRBJ2-5
TGTGCCAGCAAGTCCTGGATAAGTGGTAACTATGGCTACACCTTC	CASKSWISGNYGYTF	TRBV6-1	TRBJ1-2
TGTGCCAGCAAAGGACTTGTGAATGGCTACACCTTC	CASKGLVNGYTF	TRBV11-3	TRBJ1-2
TGTGCCAGTAGTATAGACCCGTTGAAGGGGCTGAGGTATGGCTACACCTTC	CASSIDPLKGLRYGYTF	TRBV19	TRBJ1-2
TGCAGCGTTGGTAGGCCGTCCAATCAGGGAGATCTATATGGCTACACCTTC	CSVGRPSNQGDLYGYTF	TRBV29-1	TRBJ1-2
TGTGCCAGTTCTCAGGAGACAGTTAACGAGCAGTACTTC	CASSQETVNEQYF	TRBV27	TRBJ2-7
TGTGCCAGCAGCCCCTGGGACTTTTTCTTGGACAATGAGCAGTTCTTC	CASSPWDFFLDNEQFF	TRBV13	TRBJ2-1
TGTGCCAGCAGCTGGGGGCAGTCTCACGAGCAGTACTTC	CASSWGQSHEQYF	TRBV5-4	TRBJ2-7
