TGTGCCTGGCAAAAGGTGCCAACAACAGGACACTACGAGCAGTACTTC	CAWQKVPTTGHYEQYF	TRBV30	TRBJ2-7
TGTGCCAGCAGCTCTCTAGGGGGGGGCGTAGTGTGGGGTTCCTACGAGCAGTACTTC	CASSSLGGGVVWGSYEQYF	TRBV7-7	TRBJ2-7
TGTGCCAGCAGTTGCGGGACTGGAAACACCATATATTTT	CASSCGTGNTIYF	TRBV27	TRBJ1-3
TGTGCCAGCAGATCCCTCCCTAATAGGCAGGTCCGCTACGAGCAGTACTTC	CASRSLPNRQVRYEQYF	TRBV6-4	TRBJ2-7
TGTGCCAGCAAATCCGGGACAGGGTGCAATCAGCCCCAGCATTTT	CASKSGTGCNQPQHF	TRBV6-4	TRBJ1-5
TGTGCCAGCAGCATAACCGGCTCAGGACACTACGAGCAGTACTTC	CASSITGSGHYEQYF	TRBV7-3	TRBJ2-7
TGTGCCACCAGTGATAACTCACCCATTTATGGCTACACCTTC	CATSDNSPIYGYTF	TRBV24-1	TRBJ1-2
TGTGCCATCAGTGAGGACCCCGCGCCCTACAATGAGCAGTTCTTC	CAISEDPAPYNEQFF	TRBV10-3	TRBJ2-1
TGTGCCAGCAGCGCTCGACAGGATGTCAGTGCCACCGGGGAGCTGTTTTTT	CASSARQDVSATGELFF	TRBV13	TRBJ2-2
TGTGCCAGCAGCCGTGGGGCCCGGGGTTTCCTCTATGGCTACACCTTC	CASSRGARGFLYGYTF	TRBV11-3	TRBJ1-2
TGTGCCACCAGAATTGACTCTGGAAACACCATATATTTT	CATRIDSGNTIYF	TRBV24-1	TRBJ1-3
TGTGCCAGCAGCCGGACGGCGGGGGAATATGGCTACACCTTC	CASSRTAGEYGYTF	TRBV13	TRBJ1-2
TGTGCCCCTAGAACGGGCGTGCGACGCCCTAGCAATCAGCCCCAGCATTTT	CAPRTGVRRPSNQPQHF	TRBV6-5	TRBJ1-5
TGTGCCAGCAGCTTGAGGTTTGTCAGACAGGTAGTAGAAGCTTTCTTT	CASSLRFVRQVVEAFF	TRBV7-9	TRBJ1-1
TGTGCCAAAAGCGGGACCCATTCACCCCTCCACTTT	CAKSGTHSPLHF	TRBV25-1	TRBJ1-6
TGTGCCACCAGCAGTATGAGGGAATCCTACAATGAGCAGTTCTTC	CATSSMRESYNEQFF	TRBV15	TRBJ2-1
TGTGCCACCAGTGTTAGGGCGGGCAGCTCCTACGAGCAGTACTTC	CATSVRAGSSYEQYF	TRBV24-1	TRBJ2-7
TGTGCCAGTAGTAGGGACAACAAGAACACTGAAGCTTTCTTT	CASSRDNKNTEAFF	TRBV19	TRBJ1-1
TGTGCCAGCAGTTACCCCAGGGATCAGCCCCAGCATTTT	CASSYPRDQPQHF	TRBV6-2	TRBJ1-5
TGTGCCAGCAGCTTATACAGGGATGGGTCCATGAGCTCCTACGAGCAGTACTTC	CASSLYRDGSMSSYEQYF	TRBV7-9	TRBJ2-7
TGTGCCAGCAGCCGAAGGGGGTCAAATGAGCAGTTCTTC	CASSRRGSNEQFF	TRBV7-7	TRBJ2-1
TGCGCCAGCAGCTTGGGTCCCTCCGTAGGGGCCGGGGAGCTGTTTTTT	CASSLGPSVGAGELFF	TRBV5-1	TRBJ2-2
TGCGCCAGCAGTACAGGGGCCCAAGTCACTGAAGCTTTCTTT	CASSTGAQVTEAFF	TRBV5-1	TRBJ1-1
TGTGCTAGTGGGGCGAGGGTTCACAATGAGCAGTTCTTC	CASGARVHNEQFF	TRBV12-5	TRBJ2-1
TGCAGTGCTAGAGACCTCAGGGCGTCCTACGAGCAGTACTTC	CSARDLRASYEQYF	TRBV20-1	TRBJ2-7
TGTGCCAGCAGTACCGAAGTGGGGGCCCATTCACCCCTCCACTTT	CASSTEVGAHSPLHF	TRBV6-2	TRBJ1-6
TGCGCCAGCCCAAGACAGGGGGCCTCGGTTATCTATGGCTACACCTTC	CASPRQGASVIYGYTF	TRBV5-1	TRBJ1-2
TGCAGTGCTAGTAGGCTCGGACGTAGCGAGCAGTACTTC	CSASRLGRSEQYF	TRBV20-1	TRBJ2-7
TGTGCCAGCGACCAGCGGGAGGAGGAGGTCTATGGCTACACCTTC	CASDQREEEVYGYTF	TRBV6-4	TRBJ1-2
TGTGCCAGCAGTGAAAGGCCTGGGCGGGAGGGTGCGAGCTCCTACAATGAGCAGTTCTTC	CASSERPGREGASSYNEQFF	TRBV27	TRBJ2-1
TGTGCCAGCACGGACGGGGGACTAGCGGACGGGGCCTACGAGCAGTACTTC	CASTDGGLADGAYEQYF	TRBV28	TRBJ2-7
TGTGCCAGCAGCTTAGTGCGGGAGTACCCCCATGAGACCCAGTACTTC	CASSLVREYPHETQYF	TRBV11-3	TRBJ2-5
TGTGCCAGCAGCGTATGCAAGAGGGGGCTGTCCTACAATGAGCAGTTCTTC	CASSVCKRGLSYNEQFF	TRBV7-8	TRBJ2-1
TGTGCCTGGTCCTCGGTGAATGAGCAGTTCTTC	CAWSSVNEQFF	TRBV30	TRBJ2-1
TGTGCCAGCAGCGGGATTTGTAGTATAGATACGCAGTATTTT	CASSGICSIDTQYF	TRBV5-4	TRBJ2-3
TGTGCCAGCAGCGGCCAGCACTATGGCTACACCTTC	CASSGQHYGYTF	TRBV6-5	TRBJ1-2
TGTGCCATCAGTGAGTCGAACCCCGGGACGTATGTGTCCTACGAGCAGTACTTC	CAISESNPGTYVSYEQYF	TRBV10-3	TRBJ2-7
TGTGCCAAGGGAGGGGGCCCTCAGTCCAATCGGAACACTGAAGCTTTCTTT	CAKGGGPQSNRNTEAFF	TRBV28	TRBJ1-1
TGTGCCAGCAGCCAAAGGGCGGCTAGCACCGGGGAGCTGTTTTTT	CASSQRAASTGELFF	TRBV14	TRBJ2-2
TGTGCCAGCAGTTGTGACAGGTGGACAGGGGTGAACACCGGGGAGCTGTTTTTT	CASSCDRWTGVNTGELFF	TRBV28	TRBJ2-2
TGCAGTGCTAGAGGGTCTGGGTACAATGAGCAGTTCTTC	CSARGSGYNEQFF	TRBV20-1	TRBJ2-1
TGTGCCAGCAGTGACTTGGGGGGCTACGAGCAGTACTTC	CASSDLGGYEQYF	TRBV12-3	TRBJ2-7
TGTGCCAGCAGGGCCCAAGCGAAGGCTCGAAAGGGGGCAATTCGCCCCTATGGCTACACCTTC	CASRAQAKARKGAIRPYGYTF	TRBV27	TRBJ1-2
TGTGCCAGCAGTTCCAGGGGCCCTGGGGCCAACGTCCTGACTTTC	CASSSRGPGANVLTF	TRBV2	TRBJ2-6
TGTGCCAGCAGTTACAAGGGGAAAATTCAGTACTTC	CASSYKGKIQYF	TRBV6-5	TRBJ2-4
TGCGCCAGCAGGGACAGAACTTCCACCTTC	CASRDRTSTF	TRBV10-2	TRBJ1-2
TGTGCCAGCAGCTTGCTACTCGGACGTAGGGCGGGCAATGAGCAGTTCTTC	CASSLLLGRRAGNEQFF	TRBV5-6	TRBJ2-1
TGCGCCAGCAGCCATGGTCCCGGGACTGTGTTTTCCGACGGGGAGCTGTTTTTT	CASSHGPGTVFSDGELFF	TRBV4-1	TRBJ2-2
TGTGCCAGCAAGTGGGTTAATTCACCCCTCCACTTT	CASKWVNSPLHF	TRBV6-6	TRBJ1-6
TGTGCCAGCAGTTTAACAGGACAGGGTCTCACTGAAGCTTTCTTT	CASSLTGQGLTEAFF	TRBV28	TRBJ1-1
TGTGCCAGCATCGCTAGCGGGAGGGGGACTAGCACAGATACGCAGTATTTT	CASIASGRGTSTDTQYF	TRBV12-4	TRBJ2-3
TGTGCCAGCAGCCCCGGGACTAGCGGGGGGGCTTCCACCTACGAGCAGTACTTC	CASSPGTSGGASTYEQYF	TRBV5-6	TRBJ2-7
TGTGCCAGCAGCGTACAGGGGGACGGATCCTACAATGAGCAGTTCTTC	CASSVQGDGSYNEQFF	TRBV2	TRBJ2-1
TGCAGTGCTAGAAGGTTACTTAGGACTGAAGCTTTCTTT	CSARRLLRTEAFF	TRBV20-1	TRBJ1-1
TGTGCCAGCAGTTACAGGCAGGGGCAGCTGCTCGAGCAGTACTTC	CASSYRQGQLLEQYF	TRBV6-2	TRBJ2-7
TGTGGGGACGGGTTTACCCCCAATGAGCAGTTCTTC	CGDGFTPNEQFF	TRBV12-3	TRBJ2-1
TGCAGTGCTTCAAGAGTGCGGGAGGAAGTAGCCACTGAAGCTTTCTTT	CSASRVREEVATEAFF	TRBV20-1	TRBJ1-1
TGCGCCAGCAGCCCTTCTCCCACAGATACGCAGTATTTT	CASSPSPTDTQYF	TRBV4-1	TRBJ2-3
TGTGCCAGCAGTGGGAGATACAGGGCCGAGACCCAGTACTTC	CASSGRYRAETQYF	TRBV25-1	TRBJ2-5
TGCGCCAGCAGCTACAGGACAGGGGTAATTTCACCCCTCCACTTT	CASSYRTGVISPLHF	TRBV5-1	TRBJ1-6
TGTGCTAGTGAAAACAGGGGGGGCTATGGCTACACCTTC	CASENRGGYGYTF	TRBV12-5	TRBJ1-2
TGCGCCAGCAGCTTGGCGAAGGGGGGAAGTTACGAGCAGTACTTC	CASSLAKGGSYEQYF	TRBV5-1	TRBJ2-7
TGTGCCAGCTCAGGGGCCAGCTCCTACGAGCAGTACTTC	CASSGASSYEQYF	TRBV18	TRBJ2-7
TGTGCCAGCACCGGGGGGGCAGGGGGGGAGTGGCCGGACACAGATACGCAGTATTTT	CASTGGAGGEWPDTDTQYF	TRBV6-2	TRBJ2-3
TGTGCCAGCAGCTTCCCCCCCACAGGGGGCGGTAATGAAAAACTGTTTTTT	CASSFPPTGGGNEKLFF	TRBV7-9	TRBJ1-4
TGTGCCAGCAGTTTATCAACCGAAGGAACCAAAAACATTCAGTACTTC	CASSLSTEGTKNIQYF	TRBV27	TRBJ2-4
TGTGCCAGCAGCCAAGTACAGGGGGCTGGTGATCTGTATCGGCAATCTTTCCCCTCTGGAAACACCATATATTTT	CASSQVQGAGDLYRQSFPSGNTIYF	TRBV3-1	TRBJ1-3
TGTGCCAGCAGTTGCAGGGGTTTTAGCTCCTACAATGAGCAGTTCTTC	CASSCRGFSSYNEQFF	TRBV27	TRBJ2-1
TGTGCCACCAGCAGACGCGATGATGAGCAGTTCTTC	CATSRRDDEQFF	TRBV15	TRBJ2-1
TGCAGTGACCGACCAAGAGGGACTGTCAATGAGCAGTTCTTC	CSDRPRGTVNEQFF	TRBV20-1	TRBJ2-1
TGTGCCAGCAGCTCTAAACCAGTAGCTTTTGGCAATCAGCCCCAGCATTTT	CASSSKPVAFGNQPQHF	TRBV7-9	TRBJ1-5
TGTGCCACCAGTGTAGACGAAGAGAGCACGCCAGATACGCAGTATTTT	CATSVDEESTPDTQYF	TRBV24-1	TRBJ2-3
TGCAGTGCTAGCCGGTCCGGATCAGCGGATGGGTTTGAAGCTTTCTTT	CSASRSGSADGFEAFF	TRBV20-1	TRBJ1-1
TGTGTGCGGGATTATTTT	CVRDYF	TRBV7-9	TRBJ1-3
TGTGCGGGGGGGGACAGGGCGACCTACGAGCAGTACTTC	CAGGDRATYEQYF	TRBV9	TRBJ2-7
TGTGCCAGCAAAAGCGGACGGAGGGGGCCAGGAAACACCATATATTTT	CASKSGRRGPGNTIYF	TRBV2	TRBJ1-3
TGTGCCAGCAGCGGACAGGGGGAGTCCCATCAGCCCCAGCATTTT	CASSGQGESHQPQHF	TRBV2	TRBJ1-5
TGTGCCACCCCAGGCCCGCCCCAGCATTTT	CATPGPPQHF	TRBV24-1	TRBJ1-5
TGTGCCAGTCAACAGGCCACAGATACGCAGTATTTT	CASQQATDTQYF	TRBV19	TRBJ2-3
TGTGCCAGCAGGATCTGTCCCTGGACAGGGCGCCCGGCCTATAGCAATCAGCCCCAGCATTTT	CASRICPWTGRPAYSNQPQHF	TRBV3-1	TRBJ1-5
TGTGCCATCAGTGGGGGGAAGCAAACCAGGGCCGGAAAGGGAAACACCATATATTTT	CAISGGKQTRAGKGNTIYF	TRBV10-3	TRBJ1-3
TGCGCCAGCAGCTTTTCGCTAAACTATGGCTACACCTTC	CASSFSLNYGYTF	TRBV5-1	TRBJ1-2
TGTGCCAGCATGGAGGGGGCGGAGCAGTACTTC	CASMEGAEQYF	TRBV28	TRBJ2-7
TGTGCCAGCAAAGATGGGGGCGGTGAAGCTTTCTTT	CASKDGGGEAFF	TRBV7-2	TRBJ1-1
TGTGCCAGTAGTATAGTTCTAGCGGACTACGCAGATACGCAGTATTTT	CASSIVLADYADTQYF	TRBV19	TRBJ2-3
TGTGCCAGCTCACCACGGGCGGGACCCTCTGGGGCCAACGTCCTGACTTTC	CASSPRAGPSGANVLTF	TRBV18	TRBJ2-6
TGTGCCAGCAGCTTAGGTGAGGGCCAGAGGGAAAACATTCAGTACTTC	CASSLGEGQRENIQYF	TRBV7-8	TRBJ2-4
TGTGTTTTTGCACTAAAGGGTCGCACTGAAGCTTTCTTT	CVFALKGRTEAFF	TRBV25-1	TRBJ1-1
TGTGCCAGCAGCTTGTACACGGAAGCTTTCTTT	CASSLYTEAFF	TRBV5-8	TRBJ1-1
TGTGCCAGCAGCCTTAGGCCTTCCGGGACAGGGGAAGGTGGAAACACCATATATTTT	CASSLRPSGTGEGGNTIYF	TRBV7-3	TRBJ1-3
TGTGCCAGCAGCTTCGTGTCCTTCAGGCGGTCGGGCGGGGAGCTGTTTTTT	CASSFVSFRRSGGELFF	TRBV7-9	TRBJ2-2
TGTGCCAGCAGTGAGAACAGGGGACGGGGCAATCAGCCCCAGCATTTT	CASSENRGRGNQPQHF	TRBV6-4	TRBJ1-5
TGTGCCAGCAGCAGAACTAGCGGGCTCAATGAGCAGTTCTTC	CASSRTSGLNEQFF	TRBV3-1	TRBJ2-1
TGTGCCATGGAGCCGGGGCAGCCCCAGCATTTT	CAMEPGQPQHF	TRBV10-3	TRBJ1-5
TGTGCCAGCAGCCAAGGGTCCCAGGGGGGAATGGGCTATGGCTACACCTTC	CASSQGSQGGMGYGYTF	TRBV14	TRBJ1-2
TGCGCCAGCAGCCTCCCGGGACAGGGTCGCGATTACACTGAAGCTTTCTTT	CASSLPGQGRDYTEAFF	TRBV10-1	TRBJ1-1
TGTGCCACCAGTGAAATGCGGAGGGAAGATCCTGGTAGTAACGGCTACACCTTC	CATSEMRREDPGSNGYTF	TRBV24-1	TRBJ1-2
TGCGCCAGCAGCGAGGGCCACCGGGACAGGGTGTGGATATACGAGCAGTACTTC	CASSEGHRDRVWIYEQYF	TRBV5-1	TRBJ2-7
TGTGCCAGCAGTGAAACAGGACTAGCGGGGGGGACCTACGAGCAGTACTTC	CASSETGLAGGTYEQYF	TRBV6-1	TRBJ2-7
TGTGCCAGCACCACCCGGACCATTGCCAAAAACATTCAGTACTTC	CASTTRTIAKNIQYF	TRBV7-9	TRBJ2-4
TGTGCCAGCAGCTTTCGGGACAGAAAGAGCCCCTACGAGCAGTACTTC	CASSFRDRKSPYEQYF	TRBV11-3	TRBJ2-7
TGTGCCAGCAGTTACTCGGGGAGGGACAATGAGCAGTTCTTC	CASSYSGRDNEQFF	TRBV6-5	TRBJ2-1
TGTGCCAGCAGCGGGGTGGGACTAGCGGGATCTACTACAGATACGCAGTATTTT	CASSGVGLAGSTTDTQYF	TRBV7-3	TRBJ2-3
TGCGCCAGCAGCTCAGGACATGAGCAGTTCTTC	CASSSGHEQFF	TRBV5-1	TRBJ2-1
TGTGCCAGCAGCTTGGCAAGGGAGGGAGGCGGTGGCTACACCTTC	CASSLAREGGGGYTF	TRBV5-4	TRBJ1-2
TGTGCCAGTAGTGATAGCGACAATGAGCAGTTCTTC	CASSDSDNEQFF	TRBV19	TRBJ2-1
TGTGCCAGCAGAGGGCTACCGAACGAGCAGTACTTC	CASRGLPNEQYF	TRBV6-5	TRBJ2-7
TGTGCCAGCAGTTTATCGAGGACAGCCGACACTAATGAAAAACTGTTTTTT	CASSLSRTADTNEKLFF	TRBV27	TRBJ1-4
TGTGCCAGCAGTGAGCAAGATAACGAATTGGGATACAATGAGCAGTTCTTC	CASSEQDNELGYNEQFF	TRBV6-1	TRBJ2-1
TGTGCCAGCATATTGCGGGAGGGGGAGAGCAATCAGCCCCAGCATTTT	CASILREGESNQPQHF	TRBV6-6	TRBJ1-5
TGCGCCAGCAGCCGGAACAGGGGGAACTATGGCTACACCTTC	CASSRNRGNYGYTF	TRBV4-1	TRBJ1-2
TGTGCCACCAGCAGAACCGGGACAGTGAACTATGGCTACACCTTC	CATSRTGTVNYGYTF	TRBV15	TRBJ1-2
TGTGCCAGCAGCTTAGGACAGAACGGCAATCAGCCCCAGCATTTT	CASSLGQNGNQPQHF	TRBV7-9	TRBJ1-5
TGTGCCAGCATACTCCCCCTGGTGGTCTTC	CASILPLVVF	TRBV9	TRBJ2-1
TGTGCCAGCAGCTTAGGAAAGAGGGGGCGGGGCCAAGAGACCCAGTACTTC	CASSLGKRGRGQETQYF	TRBV11-2	TRBJ2-5
TGTGCCACCAGCAGAGCTCAGGGTTCCTCTGGCTACACCTTC	CATSRAQGSSGYTF	TRBV15	TRBJ1-2
TGCGCCTCCCGGGACAGGGACGGGTCTGAAGCTTTCTTT	CASRDRDGSEAFF	TRBV5-1	TRBJ1-1
TGTGCCAGCAGTGGTAACACGGAGGGGCGGGGCTCTGGGGCCAACGTCCTGACTTTC	CASSGNTEGRGSGANVLTF	TRBV6-1	TRBJ2-6
TGCAGTCAAGGTGGGGGTAACCCGGCCAATGAGCAGTTCTTC	CSQGGGNPANEQFF	TRBV20-1	TRBJ2-1
TGTGCCAGTAGTGCCTGGTGGATTGATTCACCCCTCCACTTT	CASSAWWIDSPLHF	TRBV19	TRBJ1-6
TGCGCCAGCAGCTTGTCGACAGGGGTTAAGGGCTACACCTTC	CASSLSTGVKGYTF	TRBV5-1	TRBJ1-2
TGTGCCAGCCTCAGCCGGCCCCCAGGGTCTGAAGCTTTCTTT	CASLSRPPGSEAFF	TRBV6-5	TRBJ1-1
TGTGCCAGCAACGGGACAGGGTCTTATGGCTACACCTTC	CASNGTGSYGYTF	TRBV6-2	TRBJ1-2
TGTGCCAGCAGTTACTCGCGACGGAGCGGGGGGGCTAGGTCCTCCTACAATGAGCAGTTCTTC	CASSYSRRSGGARSSYNEQFF	TRBV6-5	TRBJ2-1
TGTGCCAGCTCACCAATTCTTGACATTGGATGCTATGGCTACACCTTC	CASSPILDIGCYGYTF	TRBV18	TRBJ1-2
TGTGCCAGCAGCTTCAAAACCTCCTCGGGACGTCGTAATCAGCCCCAGCATTTT	CASSFKTSSGRRNQPQHF	TRBV5-8	TRBJ1-5
TGCGCCAGCAGTGAGGCGACAGTGAGCTATGGCTACACCTTC	CASSEATVSYGYTF	TRBV10-2	TRBJ1-2
TGTGCCAGCACATACCTATGGACCGGGGAGCTGTTTTTT	CASTYLWTGELFF	TRBV6-5	TRBJ2-2
TGTGCCAGCAGCTTGACGGGGGGCGTGACCGGGGAGCTGTTTTTT	CASSLTGGVTGELFF	TRBV7-2	TRBJ2-2
TGTGCCAGCAGCCGAATATCTGCCCGGCAGGACACTGAAGCTTTCTTT	CASSRISARQDTEAFF	TRBV13	TRBJ1-1
TGTGCCTGCGAGGGACAGAATGAAAAACTGTTTTTT	CACEGQNEKLFF	TRBV30	TRBJ1-4
TGTGCCAGCAGCACGTTGGACAGGGAGATCTACGAGCAGTACTTC	CASSTLDREIYEQYF	TRBV13	TRBJ2-7
TGTGCCAGGGGGGCAAGTGAGACCCAGTACTTC	CARGASETQYF	TRBV6-5	TRBJ2-5
TGTGCCAGCACGACATATAGCAATCAGCCCCAGCATTTT	CASTTYSNQPQHF	TRBV14	TRBJ1-5
TGTGCCAGCAGCTTCCGGTCGACTAGAAAGTACAATGAGCAGTTCTTC	CASSFRSTRKYNEQFF	TRBV11-3	TRBJ2-1
TGCGCCAGCAGAGAATGGGGGTTGAACACTGAAGCTTTCTTT	CASREWGLNTEAFF	TRBV10-1	TRBJ1-1
TGTGCCAGCAGTTGGGACAGGAAGCCCTACAATGAGCAGTTCTTC	CASSWDRKPYNEQFF	TRBV27	TRBJ2-1
TGTGCCAGCAGTTATACAGGGGGACCCCTCCACTTT	CASSYTGGPLHF	TRBV6-5	TRBJ1-6
TGTGCCAGTGGAAGCATAGTGAGCTCCTACGAGCAGTACTTC	CASGSIVSSYEQYF	TRBV19	TRBJ2-7
TGTGCCAGCAGCTTCACACCGTGGGGTACCGTATTCTATGGCTACACCTTC	CASSFTPWGTVFYGYTF	TRBV5-6	TRBJ1-2
TGCGCCAGCAGCCGGCTTTGTAAGACAGTAAACTATGGCTACACCTTC	CASSRLCKTVNYGYTF	TRBV5-1	TRBJ1-2
TGTGCCAGCAGCTTCCTACTCACTAGCGGGAGGTACACCGGGGAGCTGTTTTTT	CASSFLLTSGRYTGELFF	TRBV7-3	TRBJ2-2
TGTGCCAGCAGCGCCCTACGTGGCGCGACAGGGGAAGGAAACACCATATATTTT	CASSALRGATGEGNTIYF	TRBV27	TRBJ1-3
TGTGCCAGCAGCGTAGGGGGGTATCAGCCCCAGCATTTT	CASSVGGYQPQHF	TRBV7-4	TRBJ1-5
TGTGCCAGCAGCCAAGGGGACTGCCCGGCCAATGAGCAGTTCTTC	CASSQGDCPANEQFF	TRBV14	TRBJ2-1
TGTGCCACCAGCAGAGCCCTACTCTGTGGGACTGATGAAAAACTGTTTTTT	CATSRALLCGTDEKLFF	TRBV15	TRBJ1-4
TGCGCCAGCAGCTTGGACGTGACAGGGGTCTCCTATAATTCACCCCTCCACTTT	CASSLDVTGVSYNSPLHF	TRBV5-1	TRBJ1-6
TGTGCCAGCAGCTCAGGGGGCTGTGGCTACACCTTC	CASSSGGCGYTF	TRBV7-6	TRBJ1-2
TGTGCCAGCAGCTTAGCGGACAAGAGCGGAGTCCCGTATACGCAGTATTTT	CASSLADKSGVPYTQYF	TRBV7-9	TRBJ2-3
TGTGCCAGCAGTTTGGGACAAGGCTACACCTTC	CASSLGQGYTF	TRBV12-3	TRBJ1-2
TGCGCCAGCAGCCAAGATCGGGGACAGGGGAATGGGAATTCACCCCTCCACTTT	CASSQDRGQGNGNSPLHF	TRBV4-1	TRBJ1-6
TGTGCCAGCAGCACCCTGTGCGGGCTGATGGGGGATAGCAATCAGCCCCAGCATTTT	CASSTLCGLMGDSNQPQHF	TRBV7-4	TRBJ1-5
TGTGCCAGTACACATTTGATGGGCAATCAGCCCCAGCATTTT	CASTHLMGNQPQHF	TRBV19	TRBJ1-5
TGTGCCAGCAGCAGCCGGGCAGGGCAGCCCCAGCATTTT	CASSSRAGQPQHF	TRBV12-4	TRBJ1-5
TGTGCCAGCAGCTTACCTAATGCGACAGGGGGCATTGAAACTGGAAACACCATATATTTT	CASSLPNATGGIETGNTIYF	TRBV7-6	TRBJ1-3
TGTGCCAGCAGCCACCCGACCCGGGACACCCATGAGCAGTTCTTC	CASSHPTRDTHEQFF	TRBV7-3	TRBJ2-1
TGTGCCAGCAGAGGAGCCTGGAGGTTTCCCTACGAGCAGTACTTC	CASRGAWRFPYEQYF	TRBV12-4	TRBJ2-7
TGTGCTAGTGGCCAGGGGGCCAACACTGAAGCTTTCTTT	CASGQGANTEAFF	TRBV12-5	TRBJ1-1
TGTGCCAGCAGCCACCGATTGGGCAAAAACATTCAGTACTTC	CASSHRLGKNIQYF	TRBV14	TRBJ2-4
TGCAGTGCTATACGCGCGGATGAAAAACTGTTTTTT	CSAIRADEKLFF	TRBV20-1	TRBJ1-4
TGTGCCAGCAGTGGACAGGGATACGAGCAGTACTTC	CASSGQGYEQYF	TRBV6-5	TRBJ2-7
TGTGCCAGCAGCAGCAGGGTCGACAGGTTCTGGGGTGGGCCAGTCGAGCAGTACTTC	CASSSRVDRFWGGPVEQYF	TRBV7-3	TRBJ2-7
TGTGCCAGCACCTATATCGGGGCGGGGGCGTCCGGGGAGCTGTTTTTT	CASTYIGAGASGELFF	TRBV9	TRBJ2-2
TGCGCCAGCAGTGAATCGTCAGGGGCCGGAAGGGCCTACGAGCAGTACTTC	CASSESSGAGRAYEQYF	TRBV10-2	TRBJ2-7
TGTGCCTGGACCCCCCACGGACAGAAGAGCAATCAGCCCCAGCATTTT	CAWTPHGQKSNQPQHF	TRBV30	TRBJ1-5
TGTGCCACCGAGGACAGGGGGGGCCTTGGGGTTCAGCCCCAGCATTTT	CATEDRGGLGVQPQHF	TRBV6-2	TRBJ1-5
TGCGCCAGCAAGCAAGGGCGAAGGACTAGCGGGAGGTACTACGAGCAGTACTTC	CASKQGRRTSGRYYEQYF	TRBV10-1	TRBJ2-7
TGTGCCAGCAGCTTTCGGGACAGGGGGGACAATGAAAAACTGTTTTTT	CASSFRDRGDNEKLFF	TRBV5-5	TRBJ1-4
TGTGCCAGCAGCTTGGCCGGGGACCGTTCCGATACGCAGTATTTT	CASSLAGDRSDTQYF	TRBV5-5	TRBJ2-3
TGTGCCACCAGTGAGCCGAAAGGCGGAGCAGCAACTAATGAAAAACTGTTTTTT	CATSEPKGGAATNEKLFF	TRBV24-1	TRBJ1-4
TGTGCCAGCAGTGTCCTGGTATCCTGGCTCTCGTGGGTCTCCCCGAACACCGGGGAGCTGTTTTTT	CASSVLVSWLSWVSPNTGELFF	TRBV3-1	TRBJ2-2
TGTGCCAGCAGCCCCCTGGGACAGGGACCGAACACTGAAGCTTTCTTT	CASSPLGQGPNTEAFF	TRBV13	TRBJ1-1
TGCGCCAGCAGCCAAGGTCGAACCGGGGAGCTGTTTTTT	CASSQGRTGELFF	TRBV4-3	TRBJ2-2
TGTGCCAGAGAGGGAGGGGGACGATACGAGCAGTACTTC	CAREGGGRYEQYF	TRBV28	TRBJ2-7
TGTGCCAGCAGGCGAAAACAACGGGGATCAGCTTTCTTT	CASRRKQRGSAFF	TRBV27	TRBJ1-1
TGTGCCATCCGTAGTGACAGGGCAAATCATGGCTACACCTTC	CAIRSDRANHGYTF	TRBV10-3	TRBJ1-2
TGTGCCAGGTACCCCTTCCCTAGCGGGATCGAGACCCAGTACTTC	CARYPFPSGIETQYF	TRBV19	TRBJ2-5
TGCGCCAGCAGCTTGGCCATAATTCCCCCTTGCGGAGAGACCCAGTACTTC	CASSLAIIPPCGETQYF	TRBV5-1	TRBJ2-5
TGCGCCAGCAGCGGGACTAGTTGCTACGAGCAGTACTTC	CASSGTSCYEQYF	TRBV5-1	TRBJ2-7
TGTGCCATCTCGGGTAGGAGGGGGGCCGGTACCACAGATACGCAGTATTTT	CAISGRRGAGTTDTQYF	TRBV10-3	TRBJ2-3
TGTGCCAGCAGTTACTCGAAAGCGGGAGAGGTAGTAGGCACTGAAGCTTTCTTT	CASSYSKAGEVVGTEAFF	TRBV6-5	TRBJ1-1
TGCGCCAGCAGCGTTACCCTTGGGACAGGGGGGACCCAAGGTAACTCTGGGGCCAACGTCCTGACTTTC	CASSVTLGTGGTQGNSGANVLTF	TRBV4-1	TRBJ2-6
TGTGCCAGCAGCTTAAGGGAGGGAGGGGGCTACACCTTC	CASSLREGGGYTF	TRBV7-9	TRBJ1-2
TGTGCCAGCAGTGACCGCGGGACTAGCGGGGATGGCAATGAGCAGTTCTTC	CASSDRGTSGDGNEQFF	TRBV6-4	TRBJ2-1
TGTGCCAGCAGCGAGACGGCTGGAAACACCATATATTTT	CASSETAGNTIYF	TRBV12-3	TRBJ1-3
TGTGCCAGCAGCCAAGACAGTCAGGGGGAGACCCAGTACTTC	CASSQDSQGETQYF	TRBV4-2	TRBJ2-5
TGCGCCAGCAGCTGGCCGCACACGATTGGCGGCTACACCTTC	CASSWPHTIGGYTF	TRBV5-1	TRBJ1-2
TGTGCCAGCAGCTGTCCCGCGGACAAAGAAGCCTACGAGCAGTACTTC	CASSCPADKEAYEQYF	TRBV7-9	TRBJ2-7
TGTGCCAGCAGCCCAAAGGGGGGCTCCTACGAGCAGTACTTC	CASSPKGGSYEQYF	TRBV13	TRBJ2-7
TGTGCCACCAGTGATCGCGGGGGGAACACTGAAGCTTTCTTT	CATSDRGGNTEAFF	TRBV24-1	TRBJ1-1
TGTGCCAGCAGTCTCCCGGACAGGTTTCACAATGAGCAGTTCTTC	CASSLPDRFHNEQFF	TRBV25-1	TRBJ2-1
TGTGCCAGCAGCTTAACCCTAAAAGGGACAGGGGCCTCGGAGACCCAGTACTTC	CASSLTLKGTGASETQYF	TRBV7-3	TRBJ2-5
TGTGCCAGCAGCCAAGATTTCCGGGGGAGAGAGACCCAGTACTTC	CASSQDFRGRETQYF	TRBV3-1	TRBJ2-5
TGTGCCAGTATAGGCCGAGCGGGGCTCTATGGCTACACCTTC	CASIGRAGLYGYTF	TRBV19	TRBJ1-2
TGTGGGGGGGACAGCCCTCTGGGAGATGAGCCCCAGCATTTT	CGGDSPLGDEPQHF	TRBV5-6	TRBJ1-5
TGTGCCAGTCGAGTTACGAGGGGCTACGAGCAGTACTTC	CASRVTRGYEQYF	TRBV11-2	TRBJ2-7
TGTGCCAAAGGGGGGGGTTGTTACCCCTACGAGCAGTACTTC	CAKGGGCYPYEQYF	TRBV7-9	TRBJ2-7
TGTGCCAGCAGTCTACAACAGTACTATGGCTACACCTTC	CASSLQQYYGYTF	TRBV6-6	TRBJ1-2
TGTGCTAGTGGTTCAGAGGGGGGGCTCACAGATACGCAGTATTTT	CASGSEGGLTDTQYF	TRBV12-5	TRBJ2-3
TGTGCCAGCAGCCCAGGACAGGGGGGAACCCAAGAGACCCAGTACTTC	CASSPGQGGTQETQYF	TRBV7-4	TRBJ2-5
TGCGCCAGCAGCTGCACTTCCGGGACTAGCGGCCCATGCACAGATACGCAGTATTTT	CASSCTSGTSGPCTDTQYF	TRBV5-1	TRBJ2-3
TGTGCCAGCAGCAGTAAAGTTGACGCACAGGATTTCTGTTCCAATCAGCCCCAGCATTTT	CASSSKVDAQDFCSNQPQHF	TRBV7-3	TRBJ1-5
TGTGCCAGGACAGTCTCGGAACCCCTCCACTTT	CARTVSEPLHF	TRBV6-3	TRBJ1-6
TGTGCCAGCAGCTTGTTTGGGGGGGACAATGAGCAGTTCTTC	CASSLFGGDNEQFF	TRBV5-6	TRBJ2-1
TGTGCCAGCAGCGGAACGCCAGTGAACACCGGGGAGCTGTTTTTT	CASSGTPVNTGELFF	TRBV14	TRBJ2-2
TGTGCCAGCAGTACAAAGGGGAAAGGGTCTGGAAACACCATATATTTT	CASSTKGKGSGNTIYF	TRBV6-3	TRBJ1-3
TGTGCCAGCAGCCAAGACTCTCCTCCGGGGCAGCGGGGGAATAGCAATCAGCCCCAGCATTTT	CASSQDSPPGQRGNSNQPQHF	TRBV4-2	TRBJ1-5
TGTGCCAGGGAACGGACCCAAGAGACCCAGTACTTC	CARERTQETQYF	TRBV6-2	TRBJ2-5
TGTGCCAGCAGCAAAGGGCCCGGGACTAGCGGGGGCTACGAGCAGTACTTC	CASSKGPGTSGGYEQYF	TRBV28	TRBJ2-7
TGCAGTGCTAGAGAGATGGTTGGACAGGGGGCTCAATCAGATACGCAGTATTTT	CSAREMVGQGAQSDTQYF	TRBV20-1	TRBJ2-3
TGTGCCAGCAGCGGGGGGGGCCAAGAGACCCAGTACTTC	CASSGGGQETQYF	TRBV7-8	TRBJ2-5
TGTGCCAGCAGCGCAGTCCAAACCGATTGTGGCCGGCGACAGGGCGACATGAACACTGAAGCTTTCTTT	CASSAVQTDCGRRQGDMNTEAFF	TRBV13	TRBJ1-1
TGCAGTGCTAGGCGGAACGGGGTCTATCAAGCCTACGAGCAGTACTTC	CSARRNGVYQAYEQYF	TRBV20-1	TRBJ2-7
TGCAGTGCTGCCAACGGTAGCAGCTCCCTACAGAAGTACGAGCAGTACTTC	CSAANGSSSLQKYEQYF	TRBV20-1	TRBJ2-7
TGTGCCAGCAGCTTAGTATGGGGCGCAAGAGGCTACACCTTC	CASSLVWGARGYTF	TRBV7-2	TRBJ1-2
TGTGCCAGCAGCTCCCTCAATGACCTGGACAGGGGAAAGTACTATGGCTACACCTTC	CASSSLNDLDRGKYYGYTF	TRBV7-8	TRBJ1-2
TGTGCCAGCAGTGGGCAACCCGTCGGGGGGGTATACGAGCAGTACTTC	CASSGQPVGGVYEQYF	TRBV27	TRBJ2-7
TGTGCCAGCAGTTCGGGACAGGGGGCGAACACTGAAGCTTTCTTT	CASSSGQGANTEAFF	TRBV27	TRBJ1-1
TGTGCCAGCAGCCCCATAAGCGGACGAACCGGGGAGCTGTTTTTT	CASSPISGRTGELFF	TRBV13	TRBJ2-2
TGTGCCAGCAGTCTAAGCGCTGTCGCCAAGCGCACTGAAGCTTTCTTT	CASSLSAVAKRTEAFF	TRBV6-5	TRBJ1-1
TGTGCCACCAGTGATTTGCATCTGACAGGGACTAGCGGGCCAATTCCAGATACGCAGTATTTT	CATSDLHLTGTSGPIPDTQYF	TRBV24-1	TRBJ2-3
TGTGCCACCAGCAGATTGGGACAGTCTGAAGCTTTCTTT	CATSRLGQSEAFF	TRBV15	TRBJ1-1
TGTGCCAGCAGCGTTATCGGACTAGCGGACTACAATGAGCAGTTCTTC	CASSVIGLADYNEQFF	TRBV9	TRBJ2-1
TGTGCCTGGGAGGGGGGGGCTTACGAAGCTTTCTTT	CAWEGGAYEAFF	TRBV30	TRBJ1-1
TGTGCCAGCACGGGACAGGGTGCCACTGAAGCTTTCTTT	CASTGQGATEAFF	TRBV9	TRBJ1-1
TGTGCCAGCAGCGTAGCCACAGGGGTGCGCAGGGTGAATGAGCAGTTCTTC	CASSVATGVRRVNEQFF	TRBV9	TRBJ2-1
TGCAGCGTTGGAAAAGCTAGCGGCTACAATGAGCAGTTCTTC	CSVGKASGYNEQFF	TRBV29-1	TRBJ2-1
TGTGCCAGCAGTGGGGCCGGGACAGGGCTCTCCTACGAGCAGTACTTC	CASSGAGTGLSYEQYF	TRBV2	TRBJ2-7
TGTGCCAGCAGCTTAGATGGGGGCGGGAGCTACGAGCAGTACTTC	CASSLDGGGSYEQYF	TRBV11-3	TRBJ2-7
TGTGCCAGCAGTTCGGCACAGGGCAAGTACTTC	CASSSAQGKYF	TRBV2	TRBJ2-7
TGCAGTGCTAGACCGCGAGGTGAAGCTTTCTTT	CSARPRGEAFF	TRBV20-1	TRBJ1-1
TGTGCCAGCAGTGACTCTCATGGGACACCTTACGAGCAGTACTTC	CASSDSHGTPYEQYF	TRBV6-4	TRBJ2-7
TGTGCCAGCACGAGAGATGGGTACGAGCAGTACTTC	CASTRDGYEQYF	TRBV7-4	TRBJ2-7
TGTGCCACCAGTGATTGGTCCCTTGGGCCGAACACTGAAGCTTTCTTT	CATSDWSLGPNTEAFF	TRBV24-1	TRBJ1-1
TGCGCCAGCAGTGACGAGGGGGCCGGCTACGAGCAGTACTTC	CASSDEGAGYEQYF	TRBV10-1	TRBJ2-7
TGCGCCAGCAGCTCAGCACCCGGGACAGGGGGCGAGGTCTGCAATCAGCCCCAGCATTTT	CASSSAPGTGGEVCNQPQHF	TRBV5-1	TRBJ1-5
TGCAGTGCGGACAGGGATTCACCCCTCCACTTT	CSADRDSPLHF	TRBV20-1	TRBJ1-6
TGCACCAGGACAGTCAATAACTATGGCTACACCTTC	CTRTVNNYGYTF	TRBV20-1	TRBJ1-2
TGCGCCAGCGGGAATAGTAGGCGGACAGGGGTTCATGTCTACGAGCAGTACTTC	CASGNSRRTGVHVYEQYF	TRBV5-1	TRBJ2-7
TGTGCCTGGAGAAGAGGTCGGGCCCGGGCAGGGGGAGCCGGGGAGCTGTTTTTT	CAWRRGRARAGGAGELFF	TRBV30	TRBJ2-2
TGTGCCAGCAGTTGTAAGGGGGCGCAGGGAGCCTACGAGCAGTACTTC	CASSCKGAQGAYEQYF	TRBV6-5	TRBJ2-7
TGTGCCAGCAGCTCAGGTGGGGGTGATACGCAGTATTTT	CASSSGGGDTQYF	TRBV7-9	TRBJ2-3
TGTGCCAGCAGCCCTTCCTTTAACAACCACAATGAGCAGTTCTTC	CASSPSFNNHNEQFF	TRBV5-6	TRBJ2-1
TGTGCCAGCAGCCCGGGACTAGAAGAGACCCAGTACTTC	CASSPGLEETQYF	TRBV5-6	TRBJ2-5
TGTGCCAGCAGCCGGGGGGGTGTCACCGGGGAGCTGTTTTTT	CASSRGGVTGELFF	TRBV7-3	TRBJ2-2
TGCGCCAGCAGCTTGACCCTGCGCAGGGAGGAGCGCTATGGCTACACCTTC	CASSLTLRREERYGYTF	TRBV5-1	TRBJ1-2
TGTGCCAGCACAGGTTCCAGGGGGTGGGACACTGAAGCTTTCTTT	CASTGSRGWDTEAFF	TRBV6-6	TRBJ1-1
TGTGCCAGCAGCTGTACTTCCGGGGGGAATGAGCAGTTCTTC	CASSCTSGGNEQFF	TRBV7-2	TRBJ2-1
TGTGCCAGCTACCTCGACAGGGCGGGTGGCTACACCTTC	CASYLDRAGGYTF	TRBV6-6	TRBJ1-2
TGTGCCAGCAGCTTAGCAGCCTACGAGCAGTACTTC	CASSLAAYEQYF	TRBV7-9	TRBJ2-7
TGCGCCAGCAGTGAGGCCCTGTGGGGGAAAGTAACGGGTAAAGTGTTAGGTGGGCCGAGCTCCTACAATGAGCAGTTCTTC	CASSEALWGKVTGKVLGGPSSYNEQFF	TRBV10-1	TRBJ2-1
TGTGCCAGCAGCAGTGAGGATGAGCAGTTCTTC	CASSSEDEQFF	TRBV5-4	TRBJ2-1
TGCGCCAGCAGCTCTACTGAGGGGACCTATGGCTACACCTTC	CASSSTEGTYGYTF	TRBV5-1	TRBJ1-2
TGTGCCAGCAGCCATCCCACGGGACTAGCGGGGCCGAAAAACATTCAGTACTTC	CASSHPTGLAGPKNIQYF	TRBV3-1	TRBJ2-4
TGTGCCAGCAGCCAAAGGCCATGGGGGACAGCGATCAAGGAAAACACCATATATTTT	CASSQRPWGTAIKENTIYF	TRBV13	TRBJ1-3
TGTGCCAGCAGCTTAGACGGGGGGGGTTTATTCTCCTACAATGAGCAGTTCTTC	CASSLDGGGLFSYNEQFF	TRBV7-2	TRBJ2-1
TGTGCCAGCAGCGTAGACGACCGAACGACCGAGGAACGGTATGGCTACACCTTC	CASSVDDRTTEERYGYTF	TRBV9	TRBJ1-2
TGCGCCAGCAGCTTGCCGCGAAGGCCCGGAAACACCATATATTTT	CASSLPRRPGNTIYF	TRBV5-1	TRBJ1-3
TGTGCCACCAGCAGAGCCGTGTCGCCTGGGGGGGGGGGCCAAAGGTACGCCTATTCCTACAATGAGCAGTTCTTC	CATSRAVSPGGGGQRYAYSYNEQFF	TRBV15	TRBJ2-1
TGTGCCACCAGTGATTTCCTAGACACCGGGGAGCTGTTTTTT	CATSDFLDTGELFF	TRBV24-1	TRBJ2-2
TGTGCCACCAGTGTGAGGAGACTAGCGGGAATCATGGGCCCAGAGTTAGCGAAGGGGGTCTACGAGCAGTACTTC	CATSVRRLAGIMGPELAKGVYEQYF	TRBV24-1	TRBJ2-7
TGTGCCAGCAGCTTATCTGGACAGCATCAGCCCCAGCATTTT	CASSLSGQHQPQHF	TRBV11-1	TRBJ1-5
TGTGCCAGCAGCTTAGCCAGCCCAGTGCCAAGGAATGAAGCTTTCTTT	CASSLASPVPRNEAFF	TRBV7-6	TRBJ1-1
TGTGCCAGCAGCCAAGACGGCGGGTCCAGCTCCTACGAGCAGTACTTC	CASSQDGGSSSYEQYF	TRBV3-1	TRBJ2-7
TGCGCCAGCAGCCAGAGGCCGGGACATAACCTCTACGAGCAGTACTTC	CASSQRPGHNLYEQYF	TRBV4-1	TRBJ2-7
TGTGCCAGCAGCTTAGCGGAGACTAGCGGGAGCTACGAGCAGTACTTC	CASSLAETSGSYEQYF	TRBV7-9	TRBJ2-7
TGTGCCATCAGAATCAGGGAGTTAAATGAGCAGTTCTTC	CAIRIRELNEQFF	TRBV10-3	TRBJ2-1
TGTGCCAGCAGCCCGGGGGGGGCCTACGAGCAGTACTTC	CASSPGGAYEQYF	TRBV5-4	TRBJ2-7
TGTGCCACCCCAGCGACTAGCGGGCATGAGCAGTTCTTC	CATPATSGHEQFF	TRBV24-1	TRBJ2-1
TGTGCCAGCAGTAGGACCCTAGGGGCCTACGAGCAGTACTTC	CASSRTLGAYEQYF	TRBV25-1	TRBJ2-7
TGTGCCAGCAGGACTTCCCCCGGGCGGCGAGGGTATAATTCACCCCTCCACTTT	CASRTSPGRRGYNSPLHF	TRBV6-5	TRBJ1-6
TGTGCCAGCAGCCTTGTAGGCTACGAGCAGTACTTC	CASSLVGYEQYF	TRBV14	TRBJ2-7
TGCGCCAGCAGCCCCCTTAAGGGACCCCACTATGGCTACACCTTC	CASSPLKGPHYGYTF	TRBV5-1	TRBJ1-2
TGTGCCAGCAGCGAGACGGGGGTCCCTTATAGCAATCAGCCCCAGCATTTT	CASSETGVPYSNQPQHF	TRBV13	TRBJ1-5
TGTGCCAGCAGTTACTCGAATCGAGGTTTCTTAGGCGGAGATACGCAGTATTTT	CASSYSNRGFLGGDTQYF	TRBV6-5	TRBJ2-3
TGTGCCAGTAGTATACGGGACAGGAACACTGAAGCTTTCTTT	CASSIRDRNTEAFF	TRBV19	TRBJ1-1
TGTGCCAGCAGTTACCACCGGACAAGTGGCTACGAGCAGTACTTC	CASSYHRTSGYEQYF	TRBV6-5	TRBJ2-7
TGTGCCTGGAGTGTGCAAAACCAGACAGGGGATTTGGACATCCACGACAGAAGAGACTACGAGCAGTACTTC	CAWSVQNQTGDLDIHDRRDYEQYF	TRBV30	TRBJ2-7
TGCAGTGCTACCCGGGCTTCAGAGACCCAGTACTTC	CSATRASETQYF	TRBV20-1	TRBJ2-5
TGTGCCAGCAGTTACAGGTCAGTTGGACAGGTATATAATTCACCCCTCCACTTT	CASSYRSVGQVYNSPLHF	TRBV6-3	TRBJ1-6
TGCTTTTTGGGACCGAGTATTAACACCGGGGAGCTGTTTTTT	CFLGPSINTGELFF	TRBV20-1	TRBJ2-2
TGCGCCAGCAGTGGAATACCTGGGGACTCTGGGGCCAACGTCCTGACTTTC	CASSGIPGDSGANVLTF	TRBV10-1	TRBJ2-6
TGTGCCAGCAGTTACTCCCGGGACAGTGGGGGCTACGAGCAGTACTTC	CASSYSRDSGGYEQYF	TRBV6-2	TRBJ2-7
TGTGCCTGGAGTGTAGGGGCAAACACCGGGGAGCTGTTTTTT	CAWSVGANTGELFF	TRBV30	TRBJ2-2
TGTGCTAGTGGACCGACGGGATTCAACACCGGGGAGCTGTTTTTT	CASGPTGFNTGELFF	TRBV12-5	TRBJ2-2
TGCGCCAGCAGTGAGTCCCCCCGGGGGGAGAGGAACAATGAGCAGTTCTTC	CASSESPRGERNNEQFF	TRBV10-1	TRBJ2-1
TGTGCCAGCAGCGTAGCCTCTGAAGCTTTCTTT	CASSVASEAFF	TRBV5-6	TRBJ1-1
TGTGCCAGCAGTTTTACAGGGGGGGTAGACGAGCAGTACTTC	CASSFTGGVDEQYF	TRBV27	TRBJ2-7
TGTGCCAGCAGTATGGGACAACTAGCTTTCTTT	CASSMGQLAFF	TRBV27	TRBJ1-1
TGTGCCAGCAGCCTATGTTCGGGGGACTCGGGTCGAGATACGCAGTATTTT	CASSLCSGDSGRDTQYF	TRBV14	TRBJ2-3
TGTGCCAGCATAGGCCACGGGGCAGATACGCAGTATTTT	CASIGHGADTQYF	TRBV6-1	TRBJ2-3
TGTGCCAGCAGCGCGATCTGTCACACAGATACGCAGTATTTT	CASSAICHTDTQYF	TRBV7-4	TRBJ2-3
TGCAGTGCTCCACCCCAGGGGGATGCCGGGGAGCTGTTTTTT	CSAPPQGDAGELFF	TRBV20-1	TRBJ2-2
TGTGCCGGAAGGACCGACGGACTCCGCAATGAGCAGTTCTTC	CAGRTDGLRNEQFF	TRBV10-3	TRBJ2-1
TGCAGTGCTAGCGACCGGGACAGCCCGCATCAGCCCCAGCATTTT	CSASDRDSPHQPQHF	TRBV20-1	TRBJ1-5
TGTGCCAGCAGTCCGGGACAGGGCGATAAAGGCAATGAGCAGTTCTTC	CASSPGQGDKGNEQFF	TRBV12-4	TRBJ2-1
TGCGCCAGCAGTCGGAACAGAACAAAATATAGCAATCAGCCCCAGCATTTT	CASSRNRTKYSNQPQHF	TRBV10-1	TRBJ1-5
TGCGCCAGCAGCTGTGAGAAGACAGGGGTCCGTCCAGTGGAAGGCGAGCAGTACTTC	CASSCEKTGVRPVEGEQYF	TRBV5-1	TRBJ2-7
TGTGCCAGCAGCCAAGCGGGGGACAGCCGAGACCAAGAGACCCAGTACTTC	CASSQAGDSRDQETQYF	TRBV14	TRBJ2-5
TGTGCCATCCTACCTAGGAGGGCCAGTAGGAATGAGCAGTTCTTC	CAILPRRASRNEQFF	TRBV10-3	TRBJ2-1
TGTGCCAGCAGCGCCCCCAGAATCCTAGCGGGGCACAATGAGCAGTTCTTC	CASSAPRILAGHNEQFF	TRBV7-3	TRBJ2-1
TGCAGTGCTAGACGTCCCATCAGGGAGTCGGCAAACATTCAGTACTTC	CSARRPIRESANIQYF	TRBV20-1	TRBJ2-4
TGTGCCAGCAGTTACACGGACAGGGCTAGGAATGGGAGAAGGGCGGCCCTCCACTTT	CASSYTDRARNGRRAALHF	TRBV6-5	TRBJ1-6
TGCAGTGCGGGGACAGTTTTTCAGCCCCAGCATTTT	CSAGTVFQPQHF	TRBV20-1	TRBJ1-5
TGTGCCAGCAGTTATTCCTCGGACAGGGGGCGGGACCAGAATGAAAAACTGTTTTTT	CASSYSSDRGRDQNEKLFF	TRBV6-9	TRBJ1-4
TGCGCCAGCAGTAGGAGAACCTTACCGGGACATGAAAATAACTATGGCTACACCTTC	CASSRRTLPGHENNYGYTF	TRBV10-1	TRBJ1-2
TGCGCCAGCAGCCAAGATGGCCACCTAAACAATGAGCAGTTCTTC	CASSQDGHLNNEQFF	TRBV4-1	TRBJ2-1
TGTGCCAGCAGCCCAGGGGGTACTAACTATGGCTACACCTTC	CASSPGGTNYGYTF	TRBV9	TRBJ1-2
TGTGCCATCAGGAACTCAGGCCTGGAAAAACTGTTTTTT	CAIRNSGLEKLFF	TRBV10-3	TRBJ1-4
TGCGCCAGCAGCCGGTCCGGGACAGAATCCGAGCAGTACTTC	CASSRSGTESEQYF	TRBV5-1	TRBJ2-7
TGTGCCAGCAGTATTAGCGCCCAACGCACCGGGGAGCTGTTTTTT	CASSISAQRTGELFF	TRBV6-2	TRBJ2-2
TGTGCCAGCAGTTACGGATATGAGACAGCCTACAATGAGCAGTTCTTC	CASSYGYETAYNEQFF	TRBV6-2	TRBJ2-1
TGTGCCAGCAGCTTATCTGACTTGGGGGGGGGAGGGATTCAAGAGACCCAGTACTTC	CASSLSDLGGGGIQETQYF	TRBV7-2	TRBJ2-5
TGTGCCAGACTAGCGCGGACTGACAATGAGCAGTTCTTC	CARLARTDNEQFF	TRBV6-4	TRBJ2-1
TGTGCCAGCTCACCAAGGGACAATCGACTAGGGATATTGGCAGATACGCAGTATTTT	CASSPRDNRLGILADTQYF	TRBV18	TRBJ2-3
TGTGCCAGTACGGGGGGATTGAATGAGCAGTTCTTC	CASTGGLNEQFF	TRBV19	TRBJ2-1
TGTGCCAGCAGTTACACCACCTGGGCCTCCTACGAGCAGTACTTC	CASSYTTWASYEQYF	TRBV6-5	TRBJ2-7
TGTGCTAGTGCTCGGGAGGACGAGCAGTACTTC	CASAREDEQYF	TRBV12-5	TRBJ2-7
TGTGCCACCAGGAGGGACCACTACGAGCAGTACTTC	CATRRDHYEQYF	TRBV24-1	TRBJ2-7
TGTGCCAGAATGTTCAGGGGGAAGGGAATAGGGTCCGAGCAGTACTTC	CARMFRGKGIGSEQYF	TRBV11-3	TRBJ2-7
TGCGCCAGCAGTGAGAAAGCTCTAGAGACCCAGTACTTC	CASSEKALETQYF	TRBV10-2	TRBJ2-5
TGTGCCAGCATCGGTGCGTCGCATTTT	CASIGASHF	TRBV12-3	TRBJ1-5
TGTGCCAGCAGCTTGCGTGTAGGGCGGCAGTACTTC	CASSLRVGRQYF	TRBV5-8	TRBJ2-7
TGTGCCACAGGGGCGAACACTGAAGCTTTCTTT	CATGANTEAFF	TRBV6-2	TRBJ1-1
TGTGCCAGCAGTCTGACTAGTAACAAGGTCTTC	CASSLTSNKVF	TRBV28	TRBJ2-1
TGTGCCTGGATACCAGCGGGAACTGAAGCTTTCTTT	CAWIPAGTEAFF	TRBV28	TRBJ1-1
TGCGCCAGCAGCGACAGGGGGCCCGAAAAACTGTTTTTT	CASSDRGPEKLFF	TRBV5-1	TRBJ1-4
TGTGCCAGCAGCTTGGCCAGGCACCGGGACAGGGGGCCAGATCAGCCCCAGCATTTT	CASSLARHRDRGPDQPQHF	TRBV5-4	TRBJ1-5
TGTGCCTGGACGTATATGTATCAGCCCCAGCATTTT	CAWTYMYQPQHF	TRBV30	TRBJ1-5
TGTGCCAGCAGCGGGGACAGGGGCGGGAACACTGAAGCTTTCTTT	CASSGDRGGNTEAFF	TRBV5-4	TRBJ1-1
TGCAGTGCTAGACATGGCGGGCGGTACCAAGAGACCCAGTACTTC	CSARHGGRYQETQYF	TRBV20-1	TRBJ2-5
TGTGCCAGCAGGGACAAGACGGACCCCTACGAGCAGTACTTC	CASRDKTDPYEQYF	TRBV6-1	TRBJ2-7
TGTGCCAGCTCCTTTCAGGTCAATGAGCAGTTCTTC	CASSFQVNEQFF	TRBV28	TRBJ2-1
TGTGCCAGTAGTAGCCCCTCAGGGATGAGGGGCGAAACTAATGAAAAACTGTTTTTT	CASSSPSGMRGETNEKLFF	TRBV19	TRBJ1-4
TGCGCCAGCAGCTTCCCAGGGGGCGTTCTCTATGGCTACACCTTC	CASSFPGGVLYGYTF	TRBV10-1	TRBJ1-2
TGCAGCGTCCTTCCCTGCCAGGGGACCTACGAGCAGTACTTC	CSVLPCQGTYEQYF	TRBV29-1	TRBJ2-7
TGCGCCAGCAGCCCTTTCCTAGTGGCCTGCAATCAGCCCCAGCATTTT	CASSPFLVACNQPQHF	TRBV4-1	TRBJ1-5
TGCGCCAGCAGCTTGGTACGGGGGCCTCAGCCCCAGCATTTT	CASSLVRGPQPQHF	TRBV5-1	TRBJ1-5
TGCGCCAGCAGCCCCCACATGACATGCTACGAGCAGTACTTC	CASSPHMTCYEQYF	TRBV4-1	TRBJ2-7
TGTGCCAGCAGTTCCACAGGGCCGACTGAAGCTTTCTTT	CASSSTGPTEAFF	TRBV6-5	TRBJ1-1
TGTGCTAGTGGTTTGGCAAGCGGGAGGTCACCCCTCCACTTT	CASGLASGRSPLHF	TRBV12-5	TRBJ1-6
TGTGCCAGCAGTGAAGCAACTAGCGGGAGCTACGAGCAGTACTTC	CASSEATSGSYEQYF	TRBV6-1	TRBJ2-7
TGTGCCAGTATACTAGCGGGAAACGAGCAGTACTTC	CASILAGNEQYF	TRBV19	TRBJ2-7
TGCAGTGCTAGAGATTGGGGCATACGGGGGCTGAGTAACTATGGCTACACCTTC	CSARDWGIRGLSNYGYTF	TRBV20-1	TRBJ1-2
TGTGCCAGCAGCTTAGGATATTTTCCCCAAGGGGGGGACCTTCAGAGCTATAGCAATCAGCCCCAGCATTTT	CASSLGYFPQGGDLQSYSNQPQHF	TRBV7-3	TRBJ1-5
TGTGCCAGCAGCATACTAGTGGACCAAGAGAGCTCCTACGAGCAGTACTTC	CASSILVDQESSYEQYF	TRBV13	TRBJ2-7
TGTGCCAGCAGCCAAACCGGGACAGGGCATATGAACACTGAAGCTTTCTTT	CASSQTGTGHMNTEAFF	TRBV14	TRBJ1-1
TGTGCCACCAGTGATCCCCGGGGAACGAATATCTCCTACGAGCAGTACTTC	CATSDPRGTNISYEQYF	TRBV24-1	TRBJ2-7
TGCAGTGCTTCCCCAGGGCAAAACTATGGCTACACCTTC	CSASPGQNYGYTF	TRBV20-1	TRBJ1-2
TGCAGTGCGGGTTTGGTCGTTGGACAGAGTAACACTGAAGCTTTCTTT	CSAGLVVGQSNTEAFF	TRBV20-1	TRBJ1-1
TGTGCCAGCAGCGTACTTAACACCGGGGAGCTGTTTTTT	CASSVLNTGELFF	TRBV5-6	TRBJ2-2
TGTGCCATATCGTGGGGTCGATACGAGCAGTACTTC	CAISWGRYEQYF	TRBV25-1	TRBJ2-7
TGCGCCAGCAGTGAGTCCTTAATGGAAGGGGCCCCTAGAATGAACACTGAAGCTTTCTTT	CASSESLMEGAPRMNTEAFF	TRBV10-2	TRBJ1-1
TGTGCCAGCAGAGGGGGACAGGCGATGAACACTGAAGCTTTCTTT	CASRGGQAMNTEAFF	TRBV2	TRBJ1-1
TGTGCCAGCAGCCAGAGAGGACAGGCAGATACGCAGTATTTT	CASSQRGQADTQYF	TRBV11-2	TRBJ2-3
TGTGCCAGCGGTGGGGGGCGGACGGAGCTGTTTTTT	CASGGGRTELFF	TRBV28	TRBJ2-2
TGTGCCAATATCAATTATAGCGGGACAGCTATTGAGCAGTTCTTC	CANINYSGTAIEQFF	TRBV11-3	TRBJ2-1
TGTGCTAGCGTGCGCCAAGATACAGAGACCCAGTACTTC	CASVRQDTETQYF	TRBV7-7	TRBJ2-5
TGTGCCAGCAGGCCGGCCCTCCTGAACACTGAAGCTTTCTTT	CASRPALLNTEAFF	TRBV6-3	TRBJ1-1
TGTGCCAGCAGTGACCGAGGCGCATTCTCCTACGAGCAGTACTTC	CASSDRGAFSYEQYF	TRBV6-4	TRBJ2-7
TGTGTCGCCGACCCCAGAGGAGCTCAAACCGGGGAGCTGTTTTTT	CVADPRGAQTGELFF	TRBV2	TRBJ2-2
TGCGCCAGCAGCTACCCGGGACAGGGGCCTATCGGAAACACCATATATTTT	CASSYPGQGPIGNTIYF	TRBV5-1	TRBJ1-3
TGTGCCAGCAGCAGGCTTTGGGACAGGGTAGTTGGCGCTAGCACAGATACGCAGTATTTT	CASSRLWDRVVGASTDTQYF	TRBV13	TRBJ2-3
TGTGCCACCGCCGGCCGCCAGATTCCCCCTGTATGTGGAAACACCATATATTTT	CATAGRQIPPVCGNTIYF	TRBV24-1	TRBJ1-3
TGTGCCAGCAGCGTTCAGGGGTATGGGAAAAACACTGAAGCTTTCTTT	CASSVQGYGKNTEAFF	TRBV7-3	TRBJ1-1
TGCAGTGCTAGCTTGGTGGGCCTCCGGGACAGGGGTGCTTCCTACGAGCAGTACTTC	CSASLVGLRDRGASYEQYF	TRBV20-1	TRBJ2-7
TGTGCCAGTAGTACCAGATGTCGAGGGGTGGGTGGAAATAGGCAACCTACGTCCCTATCCTACGAGCAGTACTTC	CASSTRCRGVGGNRQPTSLSYEQYF	TRBV19	TRBJ2-7
TGCGCCAGCAGTGAGGGTACCGGGACGGAGATCACCGGGGAGCTGTTTTTT	CASSEGTGTEITGELFF	TRBV10-1	TRBJ2-2
TGTGCCAGCAGCCGCTACAGGGGTGCGAACACCGGGGAGCTGTTTTTT	CASSRYRGANTGELFF	TRBV14	TRBJ2-2
TGTGCCAGCAGGGTAACTAGGTCCAGCACAGATACGCAGTATTTT	CASRVTRSSTDTQYF	TRBV6-5	TRBJ2-3
TGTGCCAGCAGAAAGGGACTAGCGGGAAATGAGCAGTTCTTC	CASRKGLAGNEQFF	TRBV6-5	TRBJ2-1
TGTGCCAGCAGTTTGGGCCAAGGCGGCGAGCAGTACTTC	CASSLGQGGEQYF	TRBV27	TRBJ2-7
TGTGCCAGCAGCTGTATAGCGGTAGACAATGAGCAGTTCTTC	CASSCIAVDNEQFF	TRBV5-6	TRBJ2-1
TGTGCCACCAGTGAGTTCACCAATCAGCCCCAGCATTTT	CATSEFTNQPQHF	TRBV24-1	TRBJ1-5
TGTGCCAGCAGTCTCCAGCACTCTGAAGCTTTCTTT	CASSLQHSEAFF	TRBV28	TRBJ1-1
TGTGCCAGCAGCTTATGGTTGTCAGGGTATGGCTACACCTTC	CASSLWLSGYGYTF	TRBV7-3	TRBJ1-2
TGCGCCAGCAGCCACGTGGGGCAACTGAACACTGAAGCTTTCTTT	CASSHVGQLNTEAFF	TRBV4-3	TRBJ1-1
TGTGCCAGCAAACAGGTTCCTCCCTACGAGCAGTACTTC	CASKQVPPYEQYF	TRBV14	TRBJ2-7
TGTGCCACTTCTCAGGGACGGTATTTT	CATSQGRYF	TRBV24-1	TRBJ2-3
TGTGCCAGCAGCCGGACTGAAGCTTTCTTT	CASSRTEAFF	TRBV7-9	TRBJ1-1
TGTGCCAGCATTAGCGGGTGGTTGGCTAGCACAGATACGCAGTATTTT	CASISGWLASTDTQYF	TRBV9	TRBJ2-3
TGTGCCAGTACCCCGCTAGCGGGTGAGACCCAGTACTTC	CASTPLAGETQYF	TRBV19	TRBJ2-5
TGTGCCAGCAGAACTGACAGGGGGGGAGGAAGCAATCAGCCCCAGCATTTT	CASRTDRGGGSNQPQHF	TRBV5-6	TRBJ1-5
TGCAGCGTTGAACTAGCGGGAGCCCCGTGGTCCTACGAGCAGTACTTC	CSVELAGAPWSYEQYF	TRBV29-1	TRBJ2-7
TGTGCCAGCAGTCCGAGGCTTACCAAACTGTTTTTT	CASSPRLTKLFF	TRBV6-4	TRBJ1-4
TGTGCCAGCAGCCCTCCCCCCTCCCAGAGGGGCTTC	CASSPPPSQRGF	TRBV6-4	TRBJ2-7
TGTGCCAGCTTTGTAGGTGGTCCCACAGATACGCAGTATTTT	CASFVGGPTDTQYF	TRBV2	TRBJ2-3
TGCGCCAGCAGCCGCCCTTTACGACTAGCGGGAGACAATGAGCAGTTCTTC	CASSRPLRLAGDNEQFF	TRBV4-3	TRBJ2-1
TGCGCCAGCAGCGGGACAGTTTTTGATACGCAGTATTTT	CASSGTVFDTQYF	TRBV5-1	TRBJ2-3
TGCAGTGCGCCAGGGGAGCAGTACTTC	CSAPGEQYF	TRBV20-1	TRBJ2-7
TGTGCCACCAGTGAGGGTAGCACAGATACGCAGTATTTT	CATSEGSTDTQYF	TRBV24-1	TRBJ2-3
TGTGCCAGCAGACCGGCACGGACAGGAGGTAGCTACGAGCAGTACTTC	CASRPARTGGSYEQYF	TRBV28	TRBJ2-7
TGTGCCAGCAGTGGGGCCTTCCAACATGAAAAACTGTTTTTT	CASSGAFQHEKLFF	TRBV6-5	TRBJ1-4
TGTGCCAGCAGCAAATCCGGGACAGGGGAAAAAGAGACCCAGTACTTC	CASSKSGTGEKETQYF	TRBV7-9	TRBJ2-5
TGTGCCAGCAGCTTAGCACCACAGGGGGCTACCCCCCCAGGAAACAATCAGCCCCAGCATTTT	CASSLAPQGATPPGNNQPQHF	TRBV11-2	TRBJ1-5
TGTGCCAGCAGTATTTCGGGACTAGCGGGCCGGAACAATGAGCAGTTCTTC	CASSISGLAGRNNEQFF	TRBV12-4	TRBJ2-1
TGTGCCAGCAGCAAGACTAGCCACTCCTACGAGCAGTACTTC	CASSKTSHSYEQYF	TRBV7-9	TRBJ2-7
TGCAGTGCTACCCCTAAGGAGGCCCAGACAGATACGCAGTATTTT	CSATPKEAQTDTQYF	TRBV20-1	TRBJ2-3
TGTGCCAGCAGTTTATATATGACAGGGTTAGCCTTTGATCAGCCCCAGCATTTT	CASSLYMTGLAFDQPQHF	TRBV27	TRBJ1-5
TGTGCCACTCGGCAACGCACAGATACGCAGTATTTT	CATRQRTDTQYF	TRBV24-1	TRBJ2-3
TGTGCTTTGACAGGGGGCCGCGTGAACACTGAAGCTTTCTTT	CALTGGRVNTEAFF	TRBV12-3	TRBJ1-1
TGTGCCAGCAGCTTAAGGATGAAGAGGGGGTACGCCTACGAGCAGTACTTC	CASSLRMKRGYAYEQYF	TRBV7-3	TRBJ2-7
TGTGCCAGCAGTTACCTAGCGCGACAGGGGGATAGCTCCTACGAGCAGTACTTC	CASSYLARQGDSSYEQYF	TRBV6-5	TRBJ2-7
TGCGCCAGCAGCCAAAGACTAGCGGGAGCACCTTCTTATAGCAATCAGCCCCAGCATTTT	CASSQRLAGAPSYSNQPQHF	TRBV4-1	TRBJ1-5
TGTGCCAGCAGCTCCGGGACGGAGGGAGGCACTGAAGCTTTCTTT	CASSSGTEGGTEAFF	TRBV11-2	TRBJ1-1
TGTGCCAGCAGCTTAGTTTTCCGAACGCTGACGGGAGGCGAAGGCGAGCAGTACTTC	CASSLVFRTLTGGEGEQYF	TRBV7-6	TRBJ2-7
TGTGCCAGCAGGGAGGACAGGGCTTTCTTT	CASREDRAFF	TRBV6-3	TRBJ1-1
TGTGCCAGCAGCGGACAGGAGGGCTACGAGCAGTACTTC	CASSGQEGYEQYF	TRBV5-4	TRBJ2-7
TGCAGTGCTAGAGATCGGGACCTATCCTACAATGAGCAGTTCTTC	CSARDRDLSYNEQFF	TRBV20-1	TRBJ2-1
TGCGCCAGCGGATCAGGCATGGGGTATTCAGCTAATGAAAAACTGTTTTTT	CASGSGMGYSANEKLFF	TRBV10-2	TRBJ1-4
TGTGCCAGCAGGGGACAGCGGGGCTACGAGCAGTACTTC	CASRGQRGYEQYF	TRBV6-5	TRBJ2-7
TGTGCCAGCAGGTTGAGGGAGGAGGATCAGCCCCAGCATTTT	CASRLREEDQPQHF	TRBV27	TRBJ1-5
TGCGCCAGCAGTGATAGGATCGACTGGGGGCGGCGCACAGATACGCAGTATTTT	CASSDRIDWGRRTDTQYF	TRBV10-1	TRBJ2-3
TGCGCCAGCAGCGGGACGGTTGGTGAAGCTTTCTTT	CASSGTVGEAFF	TRBV5-1	TRBJ1-1
TGTGCCAGCAGCCTGTCTGGGTGGAAGCAACTAGCGGATAGTGCCAAAAACATTCAGTACTTC	CASSLSGWKQLADSAKNIQYF	TRBV7-2	TRBJ2-4
TGTGCCAGCAGGGCAGCGGCCAATGAGCAGTTCTTC	CASRAAANEQFF	TRBV28	TRBJ2-1
TGTGCCAGCAGTTTACTCCGAACTGAAGCTTTCTTT	CASSLLRTEAFF	TRBV27	TRBJ1-1
TGTGCCAGCAGCTCCGGGGGGGGCCTAAATGAGCAGTTCTTC	CASSSGGGLNEQFF	TRBV9	TRBJ2-1
TGTGCCAGCAGCTCCCCGGGGGGCCGGGTTCGCACAGATACGCAGTATTTT	CASSSPGGRVRTDTQYF	TRBV5-4	TRBJ2-3
TGTGCCATAGGGGGAAATCAGCCCCAGCATTTT	CAIGGNQPQHF	TRBV6-5	TRBJ1-5
TGTGCTAGTGGTTTCGACACCTACAATGAGCAGTTCTTC	CASGFDTYNEQFF	TRBV12-5	TRBJ2-1
TGTGCCAGCAGAGGGCCGGGAGCAACTAATGAAAAACTGTTTTTT	CASRGPGATNEKLFF	TRBV12-4	TRBJ1-4
TGTGCCAGCAGGGGGAGGGGGCGGTCCGACTCCTATGGCTACACCTTC	CASRGRGRSDSYGYTF	TRBV6-1	TRBJ1-2
TGCGCCAGCAGGTCTAGGGCCCGCTACGAGCAGTACTTC	CASRSRARYEQYF	TRBV10-1	TRBJ2-7
TGTGCCCTGAGGGACAGGGGTTACATAGCTTTCTTT	CALRDRGYIAFF	TRBV6-1	TRBJ1-1
TGTGCCAGCAGTTTAAGACATACTGCAACTAATGAAAAACTGTTTTTT	CASSLRHTATNEKLFF	TRBV28	TRBJ1-4
TGTGCCACCAGTGAACCAGGGGGAGTTAAGGACCGGGACAGGGGACTGGGGGGGGAAGCTGAAGCTTTCTTT	CATSEPGGVKDRDRGLGGEAEAFF	TRBV24-1	TRBJ1-1
TGTGCCTGGAGTGTACGACTAGCGGGAGATGCAGATACGCAGTATTTT	CAWSVRLAGDADTQYF	TRBV30	TRBJ2-3
TGTGCCAGCAGTGGGGCGACAGTCAACCTTCCCTACGAGCAGTACTTC	CASSGATVNLPYEQYF	TRBV28	TRBJ2-7
TGTGCCAGCAGCTTGATTAGAGGGCGAGGACAGCCCCAGCATTTT	CASSLIRGRGQPQHF	TRBV11-3	TRBJ1-5
TGCAGTGCACCGTCTAGCGGGGATGAGCAGTTCTTC	CSAPSSGDEQFF	TRBV20-1	TRBJ2-1
TGTGCCAGCTCACCACCATGGGGGGGCCATGCTATGTACTCCTACGAGCAGTACTTC	CASSPPWGGHAMYSYEQYF	TRBV18	TRBJ2-7
TGTGCCACCAGTGACCTGTCCTTGGGACGGGACGGCTACGAGCAGTACTTC	CATSDLSLGRDGYEQYF	TRBV24-1	TRBJ2-7
TGTGCCAGCAGCCACGGGGGCAATAGCAATCAGCCCCAGCATTTT	CASSHGGNSNQPQHF	TRBV3-1	TRBJ1-5
TGTGCCAGCTACATCTTAGGGACTAGCGGGGAGGAGCTGTTTTTT	CASYILGTSGEELFF	TRBV18	TRBJ2-2
TGTGCTAGCCCTAAGAGGCAACTTTTGAACACTGAAGCTTTCTTT	CASPKRQLLNTEAFF	TRBV7-7	TRBJ1-1
TGTGCTAGTGGTTGTCCCCCAGGGCCACTGGCTTTCTTT	CASGCPPGPLAFF	TRBV12-5	TRBJ1-1
TGTGCCAGCAGTGAACGAGCACAGCTACTAGCAACTAATGAAAAACTGTTTTTT	CASSERAQLLATNEKLFF	TRBV6-1	TRBJ1-4
TGTGCCAGCAGCCAAGATCTAAGGGGGGACTATGGCTACACCTTC	CASSQDLRGDYGYTF	TRBV4-2	TRBJ1-2
TGCAGTGCTAGACCTAACATCGACAGCTCTGGAAACACCATATATTTT	CSARPNIDSSGNTIYF	TRBV20-1	TRBJ1-3
TGTGCCAGCAGTTATCCAATGGGGGGGGGCGGGCATTACGAGCAGTACTTC	CASSYPMGGGGHYEQYF	TRBV6-5	TRBJ2-7
TGCAGTGTCGGGACAGGGCCTAGCTATGGCTACACCTTC	CSVGTGPSYGYTF	TRBV20-1	TRBJ1-2
TGTGCCACCAGTGACTTTCAGTTCAAAACCCGGGACCCCATTGCCTTCTGCGACGAGCAGTACTTC	CATSDFQFKTRDPIAFCDEQYF	TRBV24-1	TRBJ2-7
TGTGCCAGCAGCGGATCGCAAGAGACCCAGTACTTC	CASSGSQETQYF	TRBV13	TRBJ2-5
TGTGCCAGCTCACCACATTGCAGCCGGGACAGGGAAGCTTTCTTT	CASSPHCSRDREAFF	TRBV18	TRBJ1-1
TGTGCCAGCAGCGACGGGGGAGGGGGAAATCAGCCCCAGCATTTT	CASSDGGGGNQPQHF	TRBV11-2	TRBJ1-5
TGCGCCAGCAGTGATCCGTCGGTAGGGGGGGGTACAAGGGGTAAGAGCTCTGGAAACACCATATATTTT	CASSDPSVGGGTRGKSSGNTIYF	TRBV10-2	TRBJ1-3
TGTGCCAGCAGAAGGCTAGCGGGTGATTGCACAGATACGCAGTATTTT	CASRRLAGDCTDTQYF	TRBV7-3	TRBJ2-3
TGTGCCCCCGGGAGAAATCAAGAGACCCAGTACTTC	CAPGRNQETQYF	TRBV9	TRBJ2-5
TGTGCCAGCAGCCAAGAAGGACAATATACCCGATATACCGTACGGGAAGAAGAGCAGTACTTC	CASSQEGQYTRYTVREEEQYF	TRBV4-2	TRBJ2-7
TGCGCCAGCAGCTTGGCCGGGACTAGCGGGAGGTTACCGGAGCTGTTTTTT	CASSLAGTSGRLPELFF	TRBV5-1	TRBJ2-2
TGTGCCAGCAGTTTAGGGCGCGGGAGTGGGGCCACAGATACGCAGTATTTT	CASSLGRGSGATDTQYF	TRBV27	TRBJ2-3
TGCGCCAGCAGCTTTTCATTGGACCCTTGCTACACCTTC	CASSFSLDPCYTF	TRBV5-1	TRBJ1-2
TGTGCCACCAGTGATTTAAACCGCACTAGCGGGAGTCCGGGGTCCTACGAGCAGTACTTC	CATSDLNRTSGSPGSYEQYF	TRBV24-1	TRBJ2-7
TGTGCCAGCAGCCTTATTTATAGGGGTCCGCAGCCCCAGCATTTT	CASSLIYRGPQPQHF	TRBV7-3	TRBJ1-5
TGTGCCAGCAGCCGAACGACCTCTACCCACAGGGACGGCTACACCTTC	CASSRTTSTHRDGYTF	TRBV11-2	TRBJ1-2
TGTGCCAGCCCGGGACTAGCGGGGGGGGTTGAGGAGACCCAGTACTTC	CASPGLAGGVEETQYF	TRBV6-3	TRBJ2-5
TGTGCCACCAAAGACGGGGACAGGGGAAAGGGGGCAACTAATGAAAAACTGTTTTTT	CATKDGDRGKGATNEKLFF	TRBV24-1	TRBJ1-4
TGTGCCAGCAGCGGGTCAAGGGTACAAAATCAGCCCCAGCATTTT	CASSGSRVQNQPQHF	TRBV4-2	TRBJ1-5
TGCGCCCAAGAGGGGTGGGTGTATGGCTACACCTTC	CAQEGWVYGYTF	TRBV5-1	TRBJ1-2
TGCAGTGCGATGAGGGGCCTGGGGACTAATGAAAAACTGTTTTTT	CSAMRGLGTNEKLFF	TRBV20-1	TRBJ1-4
TGTGCCAGCAGTACAAAGAGAGGAAGCCAAGAGACCCAGTACTTC	CASSTKRGSQETQYF	TRBV28	TRBJ2-5
TGTGCCGTAATCAAAGCCGGGACCCTAGATGAGCAGTTCTTC	CAVIKAGTLDEQFF	TRBV27	TRBJ2-1
TGTGCCAGCAGCACCGGCACCCCCCTGGACAAAAACATTCAGTACTTC	CASSTGTPLDKNIQYF	TRBV14	TRBJ2-4
TGTGCCAGCAGTGAACAATTTAGGAGTGAGGACAGGGGGCGAGCTAGCACAGATACGCAGTATTTT	CASSEQFRSEDRGRASTDTQYF	TRBV6-1	TRBJ2-3
TGTGCCAGCAGCTACGAGGCAGATACGCAGTATTTT	CASSYEADTQYF	TRBV7-9	TRBJ2-3
TGTGCCACCAAGTTCAGCTGGAACACTGAAGCTTTCTTT	CATKFSWNTEAFF	TRBV24-1	TRBJ1-1
TGTGCCACCAGTGATCCCGGGCCCCAGACTAGCGGCCCGAATTCCTCCTACGAGCAGTACTTC	CATSDPGPQTSGPNSSYEQYF	TRBV24-1	TRBJ2-7
TGCAGTGCTAGAGATACTGCGGCAGGGGAAGAGAATGAGCAGTTCTTC	CSARDTAAGEENEQFF	TRBV20-1	TRBJ2-1
TGTGCCAGCACCCCTCCGCTAGGTCAGCCCCAGCATTTT	CASTPPLGQPQHF	TRBV2	TRBJ1-5
TGTGCCAGCAGTTTGATACGGGATGAGCAGTTCTTC	CASSLIRDEQFF	TRBV28	TRBJ2-1
TGTGCCAACCAGGGCGACTGCAATCAGCCCCAGCATTTT	CANQGDCNQPQHF	TRBV27	TRBJ1-5
TGTGCCATCGGGACAAATACGCAGTATTTT	CAIGTNTQYF	TRBV5-5	TRBJ2-3
TGTGCCACCAGCCGAAATACGGGAGCTATTGGCTACACCTTC	CATSRNTGAIGYTF	TRBV15	TRBJ1-2
TGCAGTGCTAGTCTACTACGGGGCTCGCAGCCCCAGCATTTT	CSASLLRGSQPQHF	TRBV20-1	TRBJ1-5
TGTGCCAGGATGGAGGGGGCGAGTTATCAGCCCCAGCATTTT	CARMEGASYQPQHF	TRBV14	TRBJ1-5
TGTGCCAGCAGCTCCACCGGCGTTGATACGCAGTATTTT	CASSSTGVDTQYF	TRBV11-3	TRBJ2-3
TGTGCCAGTGTCCCCGGGACAGGGATCGTAGCAACGAACACCGGGGAGCTGTTTTTT	CASVPGTGIVATNTGELFF	TRBV19	TRBJ2-2
TGTGCCAGCAGTTTGTCGCCGGGGGGGGGGTACGAGCAGTACTTC	CASSLSPGGGYEQYF	TRBV25-1	TRBJ2-7
TGTGCCAGCTCCTTACCGGGACAGGTTTCCCACTATGGCTACACCTTC	CASSLPGQVSHYGYTF	TRBV6-1	TRBJ1-2
TGTGCCAGCAGCCGCCACCGCTCTGGAAACACCATATATTTT	CASSRHRSGNTIYF	TRBV7-3	TRBJ1-3
TGTGCCAGCGTTGACAGGGGGCGCGAACATTATAGCAATCAGCCCCAGCATTTT	CASVDRGREHYSNQPQHF	TRBV6-1	TRBJ1-5
TGTGCCAGCAGTGACGGGACGGACAGGGGGCGGAGAGCCGGTGACACCGGGGAGCTGTTTTTT	CASSDGTDRGRRAGDTGELFF	TRBV6-4	TRBJ2-2
TGTGCCAGCAGCTTAGATACCAGGCGACAGGGGACCTATAGCAATCAGCCCCAGCATTTT	CASSLDTRRQGTYSNQPQHF	TRBV11-3	TRBJ1-5
TGTGCCAGCAGATCCAGGGGGCAGGCAGCCAAAAACATTCAGTACTTC	CASRSRGQAAKNIQYF	TRBV28	TRBJ2-4
TGCAGCGCTAGCGGGGGGCCCCAGTCCTACAATGAGCAGTTCTTC	CSASGGPQSYNEQFF	TRBV29-1	TRBJ2-1
TGCGCCAGTTCACAGGGCTATGGCTACACCTTC	CASSQGYGYTF	TRBV10-1	TRBJ1-2
TGTGCCAGCAGCTTCCGGGGGTCCTACGAGCAGTACTTC	CASSFRGSYEQYF	TRBV7-3	TRBJ2-7
TGTGCCAGTACGACAGGGGCGCCGAACACCGGGGAGCTGTTTTTT	CASTTGAPNTGELFF	TRBV6-2	TRBJ2-2
TGTGCCAGCAGTTTATGTGACCAGGGGGCTGTAAACACCATATATTTT	CASSLCDQGAVNTIYF	TRBV28	TRBJ1-3
TGTGCCAGCAGCAATAATACTGTCAACACTGAAGCTTTCTTT	CASSNNTVNTEAFF	TRBV5-4	TRBJ1-1
TGCGCCAGCAGCCAAGACTACCGACAGGGGACGGGATGTCCTGGCTACGAGCAGTACTTC	CASSQDYRQGTGCPGYEQYF	TRBV4-1	TRBJ2-7
TGCAGTGCTAGAGATCAGTCGACCAGGGGGGCTTACGAGCAGTACTTC	CSARDQSTRGAYEQYF	TRBV20-1	TRBJ2-7
TGTGCCAGCAGTTATACAAAACCGGCGGGAGACACTGAAGCTTTCTTT	CASSYTKPAGDTEAFF	TRBV6-6	TRBJ1-1
TGTGCCAGCAGTTTTACGTTGGGACACCGTCCAGAGACCCAGTACTTC	CASSFTLGHRPETQYF	TRBV6-1	TRBJ2-5
TGCGCCAGCAGCCTCTTAGTGGGACGGGGCTTGGACGAGCAGTACTTC	CASSLLVGRGLDEQYF	TRBV4-1	TRBJ2-7
TGTGCCAGCAGCTTTTCAGCGGCGAACACTGAAGCTTTCTTT	CASSFSAANTEAFF	TRBV5-5	TRBJ1-1
TGTGCCAGCCCGGGACCGGGTAGCAATCAGCCCCAGCATTTT	CASPGPGSNQPQHF	TRBV6-3	TRBJ1-5
TGTGCCATCATCAGCGGGAATAGCTCCTACGAGCAGTACTTC	CAIISGNSSYEQYF	TRBV10-3	TRBJ2-7
TGTGCCTGGAGTGTAACGGGACAGTGGGTCTACGAGCAGTACTTC	CAWSVTGQWVYEQYF	TRBV30	TRBJ2-7
TGTGCCAGCAGTTTGGGGACCCGGGACATAAACACTGAAGCTTTCTTT	CASSLGTRDINTEAFF	TRBV28	TRBJ1-1
TGTGCCAGCAGTGAAGCCCGGGAAGGGACTAGCGGAGGGGGCATCAGGGTCCCCCACTACGAGCAGTACTTC	CASSEAREGTSGGGIRVPHYEQYF	TRBV6-1	TRBJ2-7
TGTGCCAGCAGCACCATGTACACGACAGGGGATTCGACCGGGGAGCTGTTTTTT	CASSTMYTTGDSTGELFF	TRBV13	TRBJ2-2
TGTGCCAGCAGCTACCGGTGGTTGGGGAGGAACCACCTAGCCAAAAACATTCAGTACTTC	CASSYRWLGRNHLAKNIQYF	TRBV5-6	TRBJ2-4
TGTGCTAGCAGCCCGCGTTGGGGGGACACTAATGAAAAACTGTTTTTT	CASSPRWGDTNEKLFF	TRBV7-7	TRBJ1-4
TGTGCCAGCAGCCGCCCCAAACCGGGGCAAGAGACCCAGTACTTC	CASSRPKPGQETQYF	TRBV3-1	TRBJ2-5
TGTGCCACCATCCCGGGACAGGGGCAAGGGAACTCCTACGAGCAGTACTTC	CATIPGQGQGNSYEQYF	TRBV24-1	TRBJ2-7
TGTGCCAGCAGCTTCAGACTCTCGGCTAGCGGAGAGTACAACACCGGGGAGCTGTTTTTT	CASSFRLSASGEYNTGELFF	TRBV5-6	TRBJ2-2
TGTGCCCCGGCGAAAGACTGTCAAGAGACCCAGTACTTC	CAPAKDCQETQYF	TRBV10-3	TRBJ2-5
TGTGCCAGCAGCTACTACAGGGTAGACGGGGAGCTGTTTTTT	CASSYYRVDGELFF	TRBV9	TRBJ2-2
TGTGCCAGCAGCGTGGTTCGGAGACAGCGTCCTAGCAATCAGCCCCAGCATTTT	CASSVVRRQRPSNQPQHF	TRBV11-3	TRBJ1-5
TGTGCCAGCCCGGATAGTAGTCATCAGCCCCAGCATTTT	CASPDSSHQPQHF	TRBV12-4	TRBJ1-5
TGCGCCAGCAGTGAGTGGGGGGGGGTACGGAATGAGCAGTTCTTC	CASSEWGGVRNEQFF	TRBV10-1	TRBJ2-1
TGTGCCATAAAGAAAGGGACGCCAGATACGCAGTATTTT	CAIKKGTPDTQYF	TRBV19	TRBJ2-3
TGTGCCAGTAGTGTACTGAGCGGGAGAGATCAGCCCCAGCATTTT	CASSVLSGRDQPQHF	TRBV19	TRBJ1-5
TGTGCCAGCAGCGGACGGGCATTGGCTTTCTTT	CASSGRALAFF	TRBV7-3	TRBJ1-1
TGTGCCAGCAGTCCGACTAGCGAGACGCTAGATACGCAGTATTTT	CASSPTSETLDTQYF	TRBV27	TRBJ2-3
TGTGCCAGCAGTTGTACTAGAGAGACCCAGTACTTC	CASSCTRETQYF	TRBV12-4	TRBJ2-5
TGTGCCAGCAGCGGCGGGGAAGGCACAGATACGCAGTATTTT	CASSGGEGTDTQYF	TRBV11-2	TRBJ2-3
TGCGCCAGCAGCGGGAGTCACTCCACCAGGAAAAACTCTGGAAACACCATATATTTT	CASSGSHSTRKNSGNTIYF	TRBV5-1	TRBJ1-3
TGTGCCTGGAGTCCCGCAGTAGCTAATGAAAAACTGTTTTTT	CAWSPAVANEKLFF	TRBV30	TRBJ1-4
TGTCAAGAACTCCCTTTAGCTTTCTTT	CQELPLAFF	TRBV10-3	TRBJ1-1
TGTGCCAGCAGTTTAGTTACAAGCCCAGCAAACTACGAGCAGTACTTC	CASSLVTSPANYEQYF	TRBV12-4	TRBJ2-7
TGTGCCACCAGTGATCTTATGCGGGAGTGTACGCAGTATTTT	CATSDLMRECTQYF	TRBV24-1	TRBJ2-3
TGTGCCAGCAGCTATTGGTCTCAGGATAATTCACCCCTCCACTTT	CASSYWSQDNSPLHF	TRBV13	TRBJ1-6
TGTGCCAGCAGCGTAACGGGGAACATAGATACGCAGTATTTT	CASSVTGNIDTQYF	TRBV7-9	TRBJ2-3
TGCGCCAGCAGCCAAGAGAAGGGGAACACTGAAGCTTTCTTT	CASSQEKGNTEAFF	TRBV4-1	TRBJ1-1
TGTGCCAGCAGCCCCCCAAGCCGCAACGTCCTGACTTTC	CASSPPSRNVLTF	TRBV9	TRBJ2-6
TGTGCCAGCATAAACACCCGGACAGCGAACACTGAAGCTTTCTTT	CASINTRTANTEAFF	TRBV7-3	TRBJ1-1
TGTGCCAGCAGCTTATTCTCCCCGGGTCTGTGGACAGCCGGGAGCCAAGAGACCCAGTACTTC	CASSLFSPGLWTAGSQETQYF	TRBV7-9	TRBJ2-5
TGTGCCAGCACACCAAACCCGCGGGAGCTGTCCTACAATGAGCAGTTCTTC	CASTPNPRELSYNEQFF	TRBV13	TRBJ2-1
TGCGCCAGCACAAGGACAGGGGTGGACTCCTACGAGCAGTACTTC	CASTRTGVDSYEQYF	TRBV10-1	TRBJ2-7
TGTGCCAGCAGCTTAATACAAAGGCAGGGGGGGGGGCCAGAGACCCAGTACTTC	CASSLIQRQGGGPETQYF	TRBV7-4	TRBJ2-5
TGTGCCAGCAGTGATGCAAAGTGGACTAGCGGACCCCGACAAGAGACCCAGTACTTC	CASSDAKWTSGPRQETQYF	TRBV6-4	TRBJ2-5
TGTGCCAGCAGCTTGGAGGCGAATCAGCCCCAGCATTTT	CASSLEANQPQHF	TRBV11-2	TRBJ1-5
TGTGCCCAGGGGTGGGGACATGGCTACACCTTC	CAQGWGHGYTF	TRBV19	TRBJ1-2
TGTGCCAGCAGCTACTTCCGGGCGCAGGGGTTGTTACTCACGCGGGAGCTGTTTTTT	CASSYFRAQGLLLTRELFF	TRBV7-8	TRBJ2-2
TGTGCCAGCGGTATTTACGAGCAGTACTTC	CASGIYEQYF	TRBV6-3	TRBJ2-7
TGTGCCAGCAGCGAGGGACAGGGGGGGACCACAGATACGCAGTATTTT	CASSEGQGGTTDTQYF	TRBV7-3	TRBJ2-3
TGTGCCAGCAGCTTAGCGCTACAAACCCACAGGGGGGGTAGCGGCTCTATATCTGAAGCTTTCTTT	CASSLALQTHRGGSGSISEAFF	TRBV7-7	TRBJ1-1
TGTGCCAGCAGCCAGCACCCCTACAATCAGCCCCAGCATTTT	CASSQHPYNQPQHF	TRBV7-9	TRBJ1-5
TGTGCCAGCAGTTCTAGACAGAGGTGTGAGCAGTTCTTC	CASSSRQRCEQFF	TRBV6-3	TRBJ2-1
TGTGCCAGCAGTTCCCGGGGTCAAGCTTTCTTT	CASSSRGQAFF	TRBV27	TRBJ1-1
TGTGCCATCAGTGCTGACCGGGGGGCCGGTTGTGAGACCCAGTACTTC	CAISADRGAGCETQYF	TRBV10-3	TRBJ2-5
TGTGCCAGCAGGAAACCCCTCGGCCGGCCAGGAAATGAGCAGTTCTTC	CASRKPLGRPGNEQFF	TRBV6-1	TRBJ2-1
TGCAGTGCTCAGCCCAACAATCAGCCCCAGCATTTT	CSAQPNNQPQHF	TRBV20-1	TRBJ1-5
TGTGCCAGCAGCTTATACTCGTGGACAGGGGATACGCAGTATTTT	CASSLYSWTGDTQYF	TRBV11-3	TRBJ2-3
TGTGCCAGCACGAACCCCGGCAGGGACGTAACTGGAAACACCATATATTTT	CASTNPGRDVTGNTIYF	TRBV6-1	TRBJ1-3
TGTGCAGTCTGCGGGAGGCCTAACTATGGCTACACCTTC	CAVCGRPNYGYTF	TRBV28	TRBJ1-2
TGTGCCAGCAGCAAATCGCATGGGCCGGGGCTCTACGAGCAGTACTTC	CASSKSHGPGLYEQYF	TRBV12-3	TRBJ2-7
TGTCCCCCCCGGGGGCACCAAAACTATGGCTACACCTTC	CPPRGHQNYGYTF	TRBV20-1	TRBJ1-2
TGTGCCTGGAGTGACCCGCCCGGGACGGAAAGTTTCTTC	CAWSDPPGTESFF	TRBV30	TRBJ2-1
TGTGCCAGCAGTATTGGGGGACTAGACGGCTACGAGCAGTACTTC	CASSIGGLDGYEQYF	TRBV6-1	TRBJ2-7
TGTGCCAGCAGTCACCTACCCGTGGCCTACGAGCAGTACTTC	CASSHLPVAYEQYF	TRBV27	TRBJ2-7
TGTGCTAGTGGTTTTATCAGATGTCCCCGGGGGGAGGAACACTACGAGCAGTACTTC	CASGFIRCPRGEEHYEQYF	TRBV12-5	TRBJ2-7
TGTGCCAGCAGCCAAGATGGGCTAGTATCAGGGGGGAGCACAGATACGCAGTATTTT	CASSQDGLVSGGSTDTQYF	TRBV4-2	TRBJ2-3
TGTGCCAGCAGCGACAGGGGAATGGGGAGAGAGACCCAGTACTTC	CASSDRGMGRETQYF	TRBV13	TRBJ2-5
TGTGCCAGCAGCTTTTCCTCCGACTACGAGCAGTACTTC	CASSFSSDYEQYF	TRBV7-8	TRBJ2-7
TGCAGTGCTAGAGATGGGGGACTAAAGGACCAAGATACGCAGTATTTT	CSARDGGLKDQDTQYF	TRBV20-1	TRBJ2-3
TGTGCCGGACAGACTAGCGGGATTAAGACCACAGATACGCAGTATTTT	CAGQTSGIKTTDTQYF	TRBV19	TRBJ2-3
TGTGCCACCAGCAGAGCAAGTCGAGGGGATGAGCAGTTCTTC	CATSRASRGDEQFF	TRBV15	TRBJ2-1
TGTGCCAGCAGTGAGGGCCCTTCACCCCTCCACTTT	CASSEGPSPLHF	TRBV6-4	TRBJ1-6
TGCAGCGTTGCGGGGGGGAGTGCCACTGAAGCTTTCTTT	CSVAGGSATEAFF	TRBV29-1	TRBJ1-1
TGTGCCAGCAGCAGGGGTGCTACAAATGTGATTAGGCGTAATGAAAAACTGTTTTTT	CASSRGATNVIRRNEKLFF	TRBV13	TRBJ1-4
TGTGCCATCATCCCGGGGCTTAATCAGCCCCAGCATTTT	CAIIPGLNQPQHF	TRBV10-3	TRBJ1-5
TGTGCCGAGGAGGGACTAGCGGGAGGGCTGGGCTACACCTTC	CAEEGLAGGLGYTF	TRBV30	TRBJ1-2
TGTGCCAGCAGCCCCTGGGGGAATTCTGAGACCCAGTACTTC	CASSPWGNSETQYF	TRBV5-6	TRBJ2-5
TGCAGCGTTGACGAGGGATGGACAGATACGCAGTATTTT	CSVDEGWTDTQYF	TRBV29-1	TRBJ2-3
TGTGCCAGCACGCGAGCCGACAGGGGTCCCATGAACACTGAAGCTTTCTTT	CASTRADRGPMNTEAFF	TRBV28	TRBJ1-1
TGTGCCCCCCCCCGGGGGGGGACGGGGGCACTCACTGAAGCTTTCTTT	CAPPRGGTGALTEAFF	TRBV27	TRBJ1-1
TGTGCTAGTGGTCCGGGTAGGGGGAACACTGAAGCTTTCTTT	CASGPGRGNTEAFF	TRBV12-5	TRBJ1-1
TGTGCCAGCAGCTCCGTTCCCCGTTGGCGGGGACACGAGCAGTACTTC	CASSSVPRWRGHEQYF	TRBV7-2	TRBJ2-7
TGTGCCAGCAGTTTCAAGTTAGGAGGGGGGGGTTCCTACGAGCAGTACTTC	CASSFKLGGGGSYEQYF	TRBV28	TRBJ2-7
TGCAGTGCTAGAATTTACAGGGACTACGAGCAGTACTTC	CSARIYRDYEQYF	TRBV20-1	TRBJ2-7
TGTGCCAGCAGTGGTGGGGCGGAAGAGACCCAGTACTTC	CASSGGAEETQYF	TRBV2	TRBJ2-5
TGTGCCAGCAGTTGGCCCCAGAACAATGAGCAGTTCTTC	CASSWPQNNEQFF	TRBV6-4	TRBJ2-1
TGTGCCAGCAGTCTAGGGAATGGAACAGGGGGATATCAGCCCCAGCATTTT	CASSLGNGTGGYQPQHF	TRBV6-6	TRBJ1-5
TGTGCCAGCAGCCAAGAGAGTAGGACTAGCGGGGTCTCTGGGGCCAACGTCCTGACTTTC	CASSQESRTSGVSGANVLTF	TRBV3-1	TRBJ2-6
TGTGCCAGCAGCCAGCTTGGGCTCCTAGCCAAAAACATTCAGTACTTC	CASSQLGLLAKNIQYF	TRBV13	TRBJ2-4
TGCGCCAGCAGCCACACCGCTCGACCTACCGGACTACTGCTAGATACGCAGTATTTT	CASSHTARPTGLLLDTQYF	TRBV5-1	TRBJ2-3
TGCGCCAGCAGCCCCGGGACAGGCTACACCTTC	CASSPGTGYTF	TRBV5-1	TRBJ1-2
TGCGCCAGCAGCTTGTTGGACAGAAGCTTACAGAATCGATATGGCTACACCTTC	CASSLLDRSLQNRYGYTF	TRBV5-1	TRBJ1-2
TGTGCCAGCAGCGTACTTAGGTGGCCTCGGAACACCGGGGAGCTGTTTTTT	CASSVLRWPRNTGELFF	TRBV13	TRBJ2-2
TGTGCCACTAAACCACAGGGATGGAGCTCCTATAATTCACCCCTCCACTTT	CATKPQGWSSYNSPLHF	TRBV19	TRBJ1-6
TGTGCCACCTACCGGGGTGAGCCCGAGCAGTACTTC	CATYRGEPEQYF	TRBV24-1	TRBJ2-7
TGCGCCAGCAGATCGGGACACGACACAGATACGCAGTATTTT	CASRSGHDTDTQYF	TRBV5-1	TRBJ2-3
TGTGCCACCGGGACAGGGCTAGAGTATGGCTACACCTTC	CATGTGLEYGYTF	TRBV11-2	TRBJ1-2
TGTGCCAGCTCACCACTTCGCCCCGGGAACTACGAGCAGTACTTC	CASSPLRPGNYEQYF	TRBV18	TRBJ2-7
TGTGCCAGCAGACCCTTCCGTCCTGGCGCCAACTATGGCTACACCTTC	CASRPFRPGANYGYTF	TRBV27	TRBJ1-2
TGCGCCAGCAGCTTGTTCGGTTCCGGGACTAGTATGACCTACGAGCAGTACTTC	CASSLFGSGTSMTYEQYF	TRBV5-1	TRBJ2-7
TGTGCCAGCAGCTTAGGCACTCCTAGGGGATTTACAGGGAACACTGAAGCTTTCTTT	CASSLGTPRGFTGNTEAFF	TRBV7-9	TRBJ1-1
TGCAGTGCTAAGGACAGCGGGGAGCTGTTTTTT	CSAKDSGELFF	TRBV20-1	TRBJ2-2
TGCGCCAGCAGCCGACAGGGACAACAAGATACGCAGTATTTT	CASSRQGQQDTQYF	TRBV4-1	TRBJ2-3
TGTGCCAGCATAGCCTACGAGCAGTACTTC	CASIAYEQYF	TRBV6-2	TRBJ2-7
TGTGCCAGCAGCTTAGCGTCCCGGGGGCGACGGGGGAGCTCCTACGAGCAGTACTTC	CASSLASRGRRGSSYEQYF	TRBV11-2	TRBJ2-7
TGTGCCAGCAAGGGGGACAGGGTGAGCAATCAGCCCCAGCATTTT	CASKGDRVSNQPQHF	TRBV4-2	TRBJ1-5
TGTGCCAGCAGCGTAGGACGAGGGACAGGAGAGACCCAGTACTTC	CASSVGRGTGETQYF	TRBV9	TRBJ2-5
TGTGCCAGCAGCCGACAGGGAGGGGAGACCCAGTACTTC	CASSRQGGETQYF	TRBV28	TRBJ2-5
TGTGCCAGCAAACCACGATGCCAAGAGACCCAGTACTTC	CASKPRCQETQYF	TRBV14	TRBJ2-5
TGTGCCAGCAGCGGTGGGACTGAAGCTTTCTTT	CASSGGTEAFF	TRBV9	TRBJ1-1
TGTGCCAGCAGCACAGGCGAAAATGGAGATACGCAGTATTTT	CASSTGENGDTQYF	TRBV9	TRBJ2-3
TGCGCCAGCAGCTTCCAGGGGGCGGGCTACACCTTC	CASSFQGAGYTF	TRBV5-1	TRBJ1-2
TGTGCCAGCAGTTATCAACAGGGCAGCGAAAAACTGTTTTTT	CASSYQQGSEKLFF	TRBV6-9	TRBJ1-4
TGTGCCAGCAGCTTAGGGACGGGACAGGGTACGGGCTACACCTTC	CASSLGTGQGTGYTF	TRBV11-2	TRBJ1-2
TGTGCCAGCAGCCAAGGTCGATGCCTTGGCTATGGCTACACCTTC	CASSQGRCLGYGYTF	TRBV14	TRBJ1-2
TGTGCCAGCAGCGCGACGGGGACTAGTCCGTCCACCTACGAGCAGTACTTC	CASSATGTSPSTYEQYF	TRBV7-3	TRBJ2-7
TGCGCCAGCAGTGAGTCGAGTGCGGGGCTGGGCTACGAGCAGTACTTC	CASSESSAGLGYEQYF	TRBV10-1	TRBJ2-7
TGTGCCAGCAGCACCCGAGGACTAGCAAACTGCACAGATACGCAGTATTTT	CASSTRGLANCTDTQYF	TRBV5-6	TRBJ2-3
TGTGCCAGCAGCACCCATCCGGGACGAGTTAACTATGGCTACACCTTC	CASSTHPGRVNYGYTF	TRBV13	TRBJ1-2
TGCGCCAGCAGTGAACTTGAGGGAGAGAACACTGAAGCTTTCTTT	CASSELEGENTEAFF	TRBV10-1	TRBJ1-1
TGTGCCAGCAGTTTCCTCGGGAGAGTCTACGAGCAGTACTTC	CASSFLGRVYEQYF	TRBV6-9	TRBJ2-7
TGTGCCAGCAGCATATGGGACAGTCCTGGAAACACCATATATTTT	CASSIWDSPGNTIYF	TRBV13	TRBJ1-3
TGTGCCAGCAGTGAAGTAGGACAGGTGGGGTATGAAAAACTGTTTTTT	CASSEVGQVGYEKLFF	TRBV25-1	TRBJ1-4
TGTGCCAGCAGCCCAGCATGGCAATGGGCGGGACGGAGTACGAATCAGCCCCAGCATTTT	CASSPAWQWAGRSTNQPQHF	TRBV9	TRBJ1-5
TGTCCCAGGTGGGGGAATGAAAAACTGTTTTTT	CPRWGNEKLFF	TRBV19	TRBJ1-4
TGTGCCAGCAGCGGAGCGGGAAGGGAAGAGACCCAGTACTTC	CASSGAGREETQYF	TRBV13	TRBJ2-5
TGTGCCTGGAGGGATGGGACCGGAGGCAATCAGCCCCAGCATTTT	CAWRDGTGGNQPQHF	TRBV30	TRBJ1-5
TGTGCCAGTTTAGCCCAGGTCCGTGGGGGATTCAATGAGCAGTTCTTC	CASLAQVRGGFNEQFF	TRBV6-4	TRBJ2-1
TGCGCCAGCAGCTCTCTCAGGAACACTGAAGCTTTCTTT	CASSSLRNTEAFF	TRBV5-1	TRBJ1-1
TGTGCCAGCAGGGTCAACGGCGAGCAGTACTTC	CASRVNGEQYF	TRBV28	TRBJ2-7
TGTGCCTGGCGGCCAAACGGCGAGGGGGGGACCGGGGAGCTGTTTTTT	CAWRPNGEGGTGELFF	TRBV30	TRBJ2-2
TGTGCCACCAGTGTCCCCAGGGGGAATGGCTACACCTTC	CATSVPRGNGYTF	TRBV24-1	TRBJ1-2
TGTGCCAGCAGCCAAGGGGGGGGCGGAGACCTTTACGAGCAGTACTTC	CASSQGGGGDLYEQYF	TRBV14	TRBJ2-7
TGCAGTGCTACAGGGGTTTATGGCTACACCTTC	CSATGVYGYTF	TRBV20-1	TRBJ1-2
TGTGCCAGCAGTTACCAGACAAAGGGGGGGCTAAACCGGTGGGACGAGCAGTACTTC	CASSYQTKGGLNRWDEQYF	TRBV6-5	TRBJ2-7
TGTGCCAGCAGTTTGGCCGGGGGGCCCTACGAGCAGTACTTC	CASSLAGGPYEQYF	TRBV27	TRBJ2-7
TGCAGTGCACCACAGTCTGACACTGAAGCTTTCTTT	CSAPQSDTEAFF	TRBV20-1	TRBJ1-1
TGTGCCAGCAAGAAAAAATCCCGCTACGAGCAGTACTTC	CASKKKSRYEQYF	TRBV27	TRBJ2-7
TGCGCCAGCAGCCAAGACCGCCCAAAAATCTATGGCTACACCTTC	CASSQDRPKIYGYTF	TRBV4-1	TRBJ1-2
TGTGCCTGGAGTTCTAATTCGACGACCAAAAACATTCAGTACTTC	CAWSSNSTTKNIQYF	TRBV30	TRBJ2-4
TGCAGTGCTAGAGGTCCCCAACCGGGGATCAGCATCAGGGATTATGGCTACACCTTC	CSARGPQPGISIRDYGYTF	TRBV20-1	TRBJ1-2
TGTGCCAGCAGGGATGCCCTTCCTAGCGGGAGCAATTCACCCCTCCACTTT	CASRDALPSGSNSPLHF	TRBV6-5	TRBJ1-6
TGCGCCAGCAGCCTCAGAGTATCGACGGACAGCACTGAAGCTTTCTTT	CASSLRVSTDSTEAFF	TRBV4-3	TRBJ1-1
TGTGCCAGCAGCACGACGGGCCCAATTAGGAACACTGAAGCTTTCTTT	CASSTTGPIRNTEAFF	TRBV7-3	TRBJ1-1
TGTGCCACCAGCAGAGATCGATGGTTCCTCAATCATAATGAAAAACTGTTTTTT	CATSRDRWFLNHNEKLFF	TRBV15	TRBJ1-4
TGCGCCAGCAGCCAAGATCCCCTCCTAGCGGAGGGTGGACAAGAGACCCAGTACTTC	CASSQDPLLAEGGQETQYF	TRBV4-1	TRBJ2-5
TGCAGTGCTAGAGGGAGTAAACTAGCGGGAGCTCCAAATGAAAAACTGTTTTTT	CSARGSKLAGAPNEKLFF	TRBV20-1	TRBJ1-4
TGCAGTGCTATACATCCGGGACAGGGAAGTCCGAGCGAAAAACTGTTTTTT	CSAIHPGQGSPSEKLFF	TRBV20-1	TRBJ1-4
TGTGCCAGCAGCTTGAGGAGCAGGACAGGCTACCCCGCAAATGAAAAACTGTTTTTT	CASSLRSRTGYPANEKLFF	TRBV5-5	TRBJ1-4
TGTGCCAGCAGTGAATTGGGGACAGGGGCGGTCTCTGGGGCCAACGTCCTGACTTTC	CASSELGTGAVSGANVLTF	TRBV25-1	TRBJ2-6
TGTGCCATCAGTGAGGGAAGCCTTAGCCCATCCAACAATGAGCAGTTCTTC	CAISEGSLSPSNNEQFF	TRBV10-3	TRBJ2-1
TGTGCCAGCAGTGGTATCCAAGTTGGTGGAAACACCATATATTTT	CASSGIQVGGNTIYF	TRBV7-2	TRBJ1-3
TGTGCCACCAGTGATTCCGCTGGCGAGCAGTACTTC	CATSDSAGEQYF	TRBV24-1	TRBJ2-7
TGCGCCAGCAGCCATCATGGAGGGTTCACTGAAGCTTTCTTT	CASSHHGGFTEAFF	TRBV4-1	TRBJ1-1
TGTGCCAGCATGGGGGGGGGAAATGAGCAGTTCTTC	CASMGGGNEQFF	TRBV7-3	TRBJ2-1
TGTGCCAGCAGGCTTTTCGACAGGGGCCCGAAACTAGCCAAAAACATTCAGTACTTC	CASRLFDRGPKLAKNIQYF	TRBV25-1	TRBJ2-4
TGTGCCAGCAGCGGTCACCCTCCTTATGGCTACACCTTC	CASSGHPPYGYTF	TRBV7-9	TRBJ1-2
TGCGCCAGCACCCACAGGGTTTACTTGGGCTACGAGCAGTACTTC	CASTHRVYLGYEQYF	TRBV10-1	TRBJ2-7
TGTGCCAGCAGCGCTCCTTACAGGTCGGGACAGGGGGCCTGGCAGGGGTCGCGCACAGATACGCAGTATTTT	CASSAPYRSGQGAWQGSRTDTQYF	TRBV9	TRBJ2-3
TGTGCCAGCAGCGGGGATGGGATTCCGGGACTGGGTGAAAAACTGTTTTTT	CASSGDGIPGLGEKLFF	TRBV7-4	TRBJ1-4
TGTGCCAGCAGCTACCCCTGGGGGGGCAAAAGCTCCTACGAGCAGTACTTC	CASSYPWGGKSSYEQYF	TRBV5-4	TRBJ2-7
TGTGCCAGCAGCCTAGACAGGCCGTCTAATGAAAAACTGTTTTTT	CASSLDRPSNEKLFF	TRBV9	TRBJ1-4
TGCAGTGCTAGAGATCGGGGGGGGGGGCAGTACTTC	CSARDRGGGQYF	TRBV20-1	TRBJ2-7
TGTGCCAGCAGCTGCGTCAGGGACCCCGGTGAAGCTTTCTTT	CASSCVRDPGEAFF	TRBV7-4	TRBJ1-1
TGCAGTGCTAACGTGGACAGTTTATTCACAGATACGCAGTATTTT	CSANVDSLFTDTQYF	TRBV20-1	TRBJ2-3
TGTGCCAGCAGCTTCGGGGGGTTGGGAAACACCATATATTTT	CASSFGGLGNTIYF	TRBV7-2	TRBJ1-3
TGCGCCAGCAGCTTGGGGCTAGCGGGTAGTCGCACAGATACGCAGTATTTT	CASSLGLAGSRTDTQYF	TRBV5-1	TRBJ2-3
TGTGCCAGCAGCCCCCTAACGAGGAGTTTCACTGAAGCTTTCTTT	CASSPLTRSFTEAFF	TRBV7-4	TRBJ1-1
TGTGCCAGCAGTTACTGCAGGGCCGGGACAGGGGGAGAAAAACTGTTTTTT	CASSYCRAGTGGEKLFF	TRBV6-2	TRBJ1-4
TGTGCCAGCAGCCAAGAGAAGACGGGGGGGGCATGCTATAGCAATCAGCCCCAGCATTTT	CASSQEKTGGACYSNQPQHF	TRBV14	TRBJ1-5
TGTGCCACCAGCAGAGAAGACAGGGAGGCGACTAACTATGGCTACACCTTC	CATSREDREATNYGYTF	TRBV15	TRBJ1-2
TGTGCCAGCAGCCAGAGGTTGCGCACAGATACGCAGTATTTT	CASSQRLRTDTQYF	TRBV13	TRBJ2-3
TGCAGTGCTAGAGAGTTGGACTATGGCTACACCTTC	CSARELDYGYTF	TRBV20-1	TRBJ1-2
TGCAGTGCTAGGTGGAGTCTAGCGTACAATGAGCAGTTCTTC	CSARWSLAYNEQFF	TRBV20-1	TRBJ2-1
TGTGCCAGCCCGGGACAGGGTGAGCAGTTCTTC	CASPGQGEQFF	TRBV7-2	TRBJ2-1
TGTGCCAGTACCGGGGGCATTGAAAAACTGTTTTTT	CASTGGIEKLFF	TRBV19	TRBJ1-4
TGTGCCAGCAGCTTGGGACTCTGCACTTTTTCCCACTACGAGCAGTACTTC	CASSLGLCTFSHYEQYF	TRBV5-4	TRBJ2-7
TGTGCCAGCAGCCTACAGGGGGGCCAAGAGACCCAGTACTTC	CASSLQGGQETQYF	TRBV14	TRBJ2-5
TGCAGTGGATCGGGGGTTGGCTACACCTTC	CSGSGVGYTF	TRBV20-1	TRBJ1-2
TGTGCCACCAGCGGGGGGGTGGATCTCGAGCAGTACTTC	CATSGGVDLEQYF	TRBV15	TRBJ2-7
TGTGCCATCCGCGGGAGGGGAAATGGCTACACCTTC	CAIRGRGNGYTF	TRBV10-3	TRBJ1-2
TGCGCCAGCAGCAGAAGGCAGGACCCAGATACGCAGTATTTT	CASSRRQDPDTQYF	TRBV5-1	TRBJ2-3
TGTGCCAGCAGCTCGAAGCGGGAGGATGAGCAGTTCTTC	CASSSKREDEQFF	TRBV5-4	TRBJ2-1
TGTGCCAGCAGAAGCAGGGGCTACGAGCAGTACTTC	CASRSRGYEQYF	TRBV6-5	TRBJ2-7
TGTGCCAGCAGTTACCCCGACAGGGGGGAGATGAACACTGAAGCTTTCTTT	CASSYPDRGEMNTEAFF	TRBV6-5	TRBJ1-1
TGCGCCAGCAGCTTGGAAGGACTCTGGGACCCCCGCTACACCTTC	CASSLEGLWDPRYTF	TRBV5-1	TRBJ1-2
TGTGCCAGGACAGGGCCTCCCTACGAGCAGTACTTC	CARTGPPYEQYF	TRBV9	TRBJ2-7
TGTGCCAGCTTCTCTAGGGGCGGTGGGGCCAACGTCCTGACTTTC	CASFSRGGGANVLTF	TRBV6-5	TRBJ2-6
TGTGCCAGCAGCGGAGTGGGGGGACAGTCTGGGGCCAACGTCCTGACTTTC	CASSGVGGQSGANVLTF	TRBV11-2	TRBJ2-6
TGTGCCAGCACGGGTCTCGAGGGAAGGGGCGTCTTC	CASTGLEGRGVF	TRBV5-6	TRBJ2-1
TGTGCCAGCAGCCTGGGGGGACTTGGCCCCTACGAGCAGTACTTC	CASSLGGLGPYEQYF	TRBV5-6	TRBJ2-7
TGTGCCAGCAGTTATCAAGTCCTTGCTGCTTTACTCTACCCGCTAGCCAAAAACATTCAGTACTTC	CASSYQVLAALLYPLAKNIQYF	TRBV6-5	TRBJ2-4
TGTGCCAGCAGTTTCCTGCCGGGACAGGGGAAAGCTCCCGGGAATGAGCAGTTCTTC	CASSFLPGQGKAPGNEQFF	TRBV12-4	TRBJ2-1
TGTGCCATGGGGGAGGGGACGGGGGCCAACGTCCTGACTTTC	CAMGEGTGANVLTF	TRBV27	TRBJ2-6
TGTGCCAGCAGCTTAGCTTACAGGGCGGATAGCAATCAGCCCCAGCATTTT	CASSLAYRADSNQPQHF	TRBV7-2	TRBJ1-5
TGTGCCAGCAGCCAAGGACACGTGGACGCGTCAATTTGCCCCCCTAATGAAAAACTGTTTTTT	CASSQGHVDASICPPNEKLFF	TRBV14	TRBJ1-4
TGCAGTGCTAATCCCTTTGACCCAGTTAAAATCTCTGGAAACACCATATATTTT	CSANPFDPVKISGNTIYF	TRBV20-1	TRBJ1-3
TGTGCCACCAGTGCCCTGGGAGGGGGGGGACACGAGCAGTACTTC	CATSALGGGGHEQYF	TRBV24-1	TRBJ2-7
TGTGCCAGCAGATCGACAGGGGTTAGCCAGTACTTC	CASRSTGVSQYF	TRBV6-1	TRBJ2-5
TGTGCCAGCAGCTTCTCTTCCTTGGGGGGGGGGCAGTTCTTC	CASSFSSLGGGQFF	TRBV7-4	TRBJ2-1
TGTGCTCCGGGGGGCGGTAACTATGGCTACACCTTC	CAPGGGNYGYTF	TRBV15	TRBJ1-2
TGTGCCAGTAGACCCGGACAGAATGCCTACGAGCAGTACTTC	CASRPGQNAYEQYF	TRBV27	TRBJ2-7
TGTGCCAGCAGCTTGGCGAAGGACAGGGGGCTGGAGCCCCTACGTTTGGGAAATACGCAGTATTTT	CASSLAKDRGLEPLRLGNTQYF	TRBV5-4	TRBJ2-3
TGCGCCAGCAGCTGGGGGACTAGGGAGGGGGATGACGACTGGGTCGGGCCTTGGGATGGCTACACCTTC	CASSWGTREGDDDWVGPWDGYTF	TRBV5-1	TRBJ1-2
TGCGCCAGCATTCGTCGGCAAGAGACCCAGTACTTC	CASIRRQETQYF	TRBV10-1	TRBJ2-5
TGTGCCAGCAGTGGAAACGGGAGCTCCGAGCAGTACTTC	CASSGNGSSEQYF	TRBV6-1	TRBJ2-7
TGTGCCACCAGCCGACAGGGCCCAACTAATGAAAAACTGTTTTTT	CATSRQGPTNEKLFF	TRBV15	TRBJ1-4
TGTGCCTGGTCAGGGGGGTCTCCCTCTGGAAACACCATATATTTT	CAWSGGSPSGNTIYF	TRBV30	TRBJ1-3
TGTGCCAGTAGTATCGGAGGCGGGAGAGAGATCAAAACGGAGACCCAGTACTTC	CASSIGGGREIKTETQYF	TRBV19	TRBJ2-5
TGCGCCAGCAGCTTGCCCCGGGACAGCCGAACTGAAGCTTTCTTT	CASSLPRDSRTEAFF	TRBV5-1	TRBJ1-1
TGTGCCAGCAGCTACCGGAGAGAGGCCGGGACAGACTTC	CASSYRREAGTDF	TRBV7-2	TRBJ1-2
TGTGCCAGCAGTGTCCCCGACGGGCCTGGGGCCAACGTCCTGACTTTC	CASSVPDGPGANVLTF	TRBV11-2	TRBJ2-6
TGTGCCAGCAGCCCAAGAGTTAAATCCGAGACCCAGTACTTC	CASSPRVKSETQYF	TRBV7-2	TRBJ2-5
TGTGCCAGTAGTATAAACAGGGGGTGGATGAACACTGAAGCTTTCTTT	CASSINRGWMNTEAFF	TRBV19	TRBJ1-1
TGTGCCAGCAGCTTTGCTGATGAGCAGTTCTTC	CASSFADEQFF	TRBV7-2	TRBJ2-1
TGTGCCAGCAGTGGGCCCCGACAGCCGAACACTGAAGCTTTCTTT	CASSGPRQPNTEAFF	TRBV2	TRBJ1-1
TGTGCCACCACTACGCGCAATGAAAAACTGTTTTTT	CATTTRNEKLFF	TRBV24-1	TRBJ1-4
TGTGCCAGCAGCAGACCGACGAACTCTGAAGCTTTCTTT	CASSRPTNSEAFF	TRBV13	TRBJ1-1
TGTGCCAGCAGCCAAGATGGGGAGGGGCAAGAGACCCAGTACTTC	CASSQDGEGQETQYF	TRBV4-2	TRBJ2-5
TGTGCCTGGACCTGGACAGCCTCCGACTATGGCTACACCTTC	CAWTWTASDYGYTF	TRBV30	TRBJ1-2
TGTGCCAGTCCCCCCTCTGGGACTAGCGGGGAGCAGTTCTTC	CASPPSGTSGEQFF	TRBV19	TRBJ2-1
TGTGCCAACCGACAGGGCGAGCAGTACTTC	CANRQGEQYF	TRBV11-2	TRBJ2-7
TGTGCCAGCATACGGGCCTGGGAGTGCTATGGCTACACCTTC	CASIRAWECYGYTF	TRBV6-5	TRBJ1-2
TGTGCCAGCAGGGAGATTCCCCCCTCGAATCCTCAGCGGGACAAGGTTGAGCAGTACTTC	CASREIPPSNPQRDKVEQYF	TRBV6-5	TRBJ2-7
TGTGCCACCAGTGATTGGAGTCGTCCGATAGCAGGGGCTGAAGCTTTCTTT	CATSDWSRPIAGAEAFF	TRBV24-1	TRBJ1-1
TGTGCCAGCAGCTTAGTCCACCGGGGGGGTGCCACAGATACGCAGTATTTT	CASSLVHRGGATDTQYF	TRBV11-3	TRBJ2-3
TGCGCCAGCAGCAACTCGACGGGGTACAATGAGCAGTTCTTC	CASSNSTGYNEQFF	TRBV10-2	TRBJ2-1
TGCGCCAGCAGCTATTTACTAGCGGGAGCAACAACCTCCTACGAGCAGTACTTC	CASSYLLAGATTSYEQYF	TRBV5-1	TRBJ2-7
TGTGCCAGCAGCGTGGGGGGACAGGGAGTAGATCAGAACACTGAAGCTTTCTTT	CASSVGGQGVDQNTEAFF	TRBV9	TRBJ1-1
TGTGCCAGCAGTTGGGGCACTGGGTGTAACTATGGCTACACCTTC	CASSWGTGCNYGYTF	TRBV6-5	TRBJ1-2
TGCGCCAGCACCAACGAAGCTTTCTTT	CASTNEAFF	TRBV10-1	TRBJ1-1
TGTGCCAGCAGCCCGCAGGGGGACACTGGGGCCAACGTCCTGACTTTC	CASSPQGDTGANVLTF	TRBV7-9	TRBJ2-6
TGTGCCAGCAATCCAGTTTCGATAACAGTAGCCAAAAACATTCAGTACTTC	CASNPVSITVAKNIQYF	TRBV6-5	TRBJ2-4
TGTGCCAGCAGGACGCCGTACGAGCAGTACTTC	CASRTPYEQYF	TRBV7-3	TRBJ2-7
TGCGCCAGCAGCTTGGGGGGGGATGGCTACACCTTC	CASSLGGDGYTF	TRBV5-1	TRBJ1-2
TGTGCCAGCTCACCCCCTCAGGCTGAGGTGAACACCGGGGAGCTGTTTTTT	CASSPPQAEVNTGELFF	TRBV18	TRBJ2-2
TGTGCCAGCAGCCAAGCCCGGGACAAGATTCTCTACGAGCAGTACTTC	CASSQARDKILYEQYF	TRBV3-1	TRBJ2-7
TGTGCCTGGACTAGACTTCGGGGGAGCAAAAGGGGCTCAGGCTACACCTTC	CAWTRLRGSKRGSGYTF	TRBV30	TRBJ1-2
TGCAGTGCTAGAGATAATTTCCACAGGGTCGAGAATTCACCCCTCCACTTT	CSARDNFHRVENSPLHF	TRBV20-1	TRBJ1-6
TGTGCCAGCAGCTGTAGCGGGGGGCTCACCGGGGAGCTGTTTTTT	CASSCSGGLTGELFF	TRBV7-9	TRBJ2-2
TGCCTGGGGGAATATGGCTACACCTTC	CLGEYGYTF	TRBV20-1	TRBJ1-2
TGTGCCAGCAGCTTACGGAGGTCCAGGGGGAACGAAGCTTTCTTT	CASSLRRSRGNEAFF	TRBV11-2	TRBJ1-1
TGTGCCAGAGGGGGTTCCTACTCCTACGAGCAGTACTTC	CARGGSYSYEQYF	TRBV2	TRBJ2-7
TGTGCCAGCAGCGTCCTGACAGGTGAAGCTTTCTTT	CASSVLTGEAFF	TRBV5-5	TRBJ1-1
TGTGCCAGCAGCTTACCTCCTCAGGGGGCCGAAGCTTTCTTT	CASSLPPQGAEAFF	TRBV7-2	TRBJ1-1
TGCAGCGTTGGTGGGCAGGGGGCGCGGGCGTATCAGCCCCAGCATTTT	CSVGGQGARAYQPQHF	TRBV29-1	TRBJ1-5
TGTGCCATCACCTGGGGAGACGGGGCTGAAGCTTTCTTT	CAITWGDGAEAFF	TRBV10-3	TRBJ1-1
TGTGCCAGTAGTCTCATAGGGGTGGGCACCGGGGAGCTGTTTTTT	CASSLIGVGTGELFF	TRBV19	TRBJ2-2
TGTGCCAGCGGAGTCACTAGCGGGAGAACTATGACCTCCTACGAGCAGTACTTC	CASGVTSGRTMTSYEQYF	TRBV6-2	TRBJ2-7
TGTGCCAGCAGCTTAAGTCCTGGGGGGCCCTCCTACGAGCAGTACTTC	CASSLSPGGPSYEQYF	TRBV7-3	TRBJ2-7
TGTGCCAGCAGTGACGGGAAGGATACGCAGTATTTT	CASSDGKDTQYF	TRBV6-5	TRBJ2-3
TGTGCCAGCAGCCAAGAGGTAGGAGCGGGATTCCCGCAGTATTTT	CASSQEVGAGFPQYF	TRBV3-1	TRBJ2-3
TGTGCCAGCAGCTTATGTCTGGCCTCTGGGGCCAACGTCCTGACTTTC	CASSLCLASGANVLTF	TRBV11-3	TRBJ2-6
TGTGCCAGTAGCGGGCAGGGGAGGGAGGTTAATCAGCCCCAGCATTTT	CASSGQGREVNQPQHF	TRBV19	TRBJ1-5
TGTGCCATGAGGGGGGCAGATACGCAGTATTTT	CAMRGADTQYF	TRBV7-9	TRBJ2-3
TGCAGTGCTCCTACTAGCGGGAGCTACAATGAGCAGTTCTTC	CSAPTSGSYNEQFF	TRBV20-1	TRBJ2-1
TGTGCCAGCAGCTTAGCGACCAGGGAGGCCAGGACCCAGTACTTC	CASSLATREARTQYF	TRBV11-2	TRBJ2-5
TGTGCCAGCTATTCGTCTTGGCCTCCTAGCTGCCAGCCCCAGCATTTT	CASYSSWPPSCQPQHF	TRBV12-4	TRBJ1-5
TGTGCCAGCAGCCTCGACCCACACTACACCTTC	CASSLDPHYTF	TRBV11-3	TRBJ1-2
TGCAGCGGCGAAAGGAACGGGGAGCTGTTTTTT	CSGERNGELFF	TRBV29-1	TRBJ2-2
TGTGCTAGTGGGACTAGAGGAGAGACCCAGTACTTC	CASGTRGETQYF	TRBV12-5	TRBJ2-5
TGTGCCAATCCGGGGGACAGCTTGCACGAGCAGTACTTC	CANPGDSLHEQYF	TRBV9	TRBJ2-7
TGTGCCAGAGGTAAGATCGACGACGAGCAGTACTTC	CARGKIDDEQYF	TRBV6-6	TRBJ2-7
TGTGCCAGCAGCCACAGGGTAGATAATTCACCCCTCCACTTT	CASSHRVDNSPLHF	TRBV13	TRBJ1-6
TGTGCCAGCAGCCCGGGGGTCACCGGGGAGCTGTTTTTT	CASSPGVTGELFF	TRBV3-1	TRBJ2-2
TGTGCCAGCAGGGGCATTGGCAGGGGGAACCCTAGCTCCTATAATTCACCCCTCCACTTT	CASRGIGRGNPSSYNSPLHF	TRBV7-3	TRBJ1-6
TGTGCCACCAGTGGGGAAGGTACGGGACAGGGGACCGCCTACGAGCAGTACTTC	CATSGEGTGQGTAYEQYF	TRBV24-1	TRBJ2-7
TGCGCCAGCAGCTTGAGGCGGAGGACACTAACCCGATACTATGGCTACACCTTC	CASSLRRRTLTRYYGYTF	TRBV5-1	TRBJ1-2
TGCGCCAGCAGCGCGCGTTCAGGACTAGCGGCCAAAAACATTCAGTACTTC	CASSARSGLAAKNIQYF	TRBV5-1	TRBJ2-4
TGTGCCACCAGTGTATGCGTAGCTAGCGGGGTTTTGGGCACAGATACGCAGTATTTT	CATSVCVASGVLGTDTQYF	TRBV24-1	TRBJ2-3
TGTGCCAGCAGGAAAGGCTTCTTTGAGCGGAGGGGTTATGGCTACACCTTC	CASRKGFFERRGYGYTF	TRBV6-5	TRBJ1-2
TGTGCCACTGGGATTGGGGTGTATGGCTACACCTTC	CATGIGVYGYTF	TRBV19	TRBJ1-2
TGTGCCAGCAGCTCCCTCCGGAGGGGACAGGGGTATGCTGAAGCTTTCTTT	CASSSLRRGQGYAEAFF	TRBV11-2	TRBJ1-1
TGTGCCAGCAGTGACATATTGCAGGGATGCACTGAAGCTTTCTTT	CASSDILQGCTEAFF	TRBV6-4	TRBJ1-1
TGTGCCAGCAGTGAAGGCCAGGACTCCTATAATTCACCCCTCCACTTT	CASSEGQDSYNSPLHF	TRBV2	TRBJ1-6
TGTGCCAGCAGCTTGAGACAAGGCCAAGAGACCCAGTACTTC	CASSLRQGQETQYF	TRBV7-3	TRBJ2-5
TGCGCCAGATGGACTAGCGGGCGGCGCACAGATACGCAGTATTTT	CARWTSGRRTDTQYF	TRBV10-1	TRBJ2-3
TGTGCCAGCAGCCAAGACCGGACGACCGGCTGTAATTCACCCCTCCACTTT	CASSQDRTTGCNSPLHF	TRBV14	TRBJ1-6
TGTGCACGGACCGAGCAGTACTTC	CARTEQYF	TRBV6-5	TRBJ2-7
TGTGCCAGCAAATACGATTCAGGGGGTGGCTACACCTTC	CASKYDSGGGYTF	TRBV2	TRBJ1-2
TGTGCCTGGAGTCAAAGGGTTGGTGCAGATACGCAGTATTTT	CAWSQRVGADTQYF	TRBV30	TRBJ2-3
TGTGCCAGCAGCCAAGACGGAGGGGGAACTACGGCTTTCTTT	CASSQDGGGTTAFF	TRBV4-2	TRBJ1-1
TGTGCCAGCAGCCCCGACAGGGTGATCCCAGACAATGAGCAGTTCTTC	CASSPDRVIPDNEQFF	TRBV7-9	TRBJ2-1
TGTGCCAGCAGGGACAGGGAGTGGGGGGATCAGCCCCAGCATTTT	CASRDREWGDQPQHF	TRBV6-4	TRBJ1-5
TGTGCCAGCAGTTACTCGCCAGGGAGCTATGGCTACACCTTC	CASSYSPGSYGYTF	TRBV6-3	TRBJ1-2
TGCAGTGCTAGAGATGGGACTAGCGACGAGCAGTACTTC	CSARDGTSDEQYF	TRBV20-1	TRBJ2-7
TGTGCCAGCAGTGAAGCGAATAGCGGGCTTAGTAACTCTAGCACAGATACGCAGTATTTT	CASSEANSGLSNSSTDTQYF	TRBV6-1	TRBJ2-3
TGTGCCAGCAGCGCGCCTAGAGGGGCGAACTACGAGCAGTACTTC	CASSAPRGANYEQYF	TRBV13	TRBJ2-7
TGCGCCAGCAGTGAGTCCTCTGGGGGGAGCACTGAAGCTTTCTTT	CASSESSGGSTEAFF	TRBV10-2	TRBJ1-1
TGTGCCAGCCTATCCGGGGCCAACGTCCTGACTTTC	CASLSGANVLTF	TRBV5-4	TRBJ2-6
TGTGCCAGCAGCGTAGCTTACCGCAGCGGACTAGTTGACGGGGAGCTGTTTTTT	CASSVAYRSGLVDGELFF	TRBV9	TRBJ2-2
TGCGCCAGCTCAAAGCAGACCCAAGATACGCAGTATTTT	CASSKQTQDTQYF	TRBV10-1	TRBJ2-3
TGTGCCAGTAGTATACGATTCCCCTCAGGGATTACTAACTCCTACGAGCAGTACTTC	CASSIRFPSGITNSYEQYF	TRBV19	TRBJ2-7
TGTGCCAGCAGCTTGGCGACCGGGACAGAAGGCAATCAGCCCCAGCATTTT	CASSLATGTEGNQPQHF	TRBV5-4	TRBJ1-5
TGTGCCAGCAGCTGCCGGGACGATTGGATGAACACTGAAGCTTTCTTT	CASSCRDDWMNTEAFF	TRBV7-9	TRBJ1-1
TGTGCCAGCAGGTCAGGGGTAGGAAACACCATATATTTT	CASRSGVGNTIYF	TRBV7-2	TRBJ1-3
TGTGCCAGCAGGAAACCGGGACAGTCACCCCTCCACTTT	CASRKPGQSPLHF	TRBV6-2	TRBJ1-6
TGCGCCAGCAGCCAAGATGACGGGACAAGCGCCAATGAGCAGTTCTTC	CASSQDDGTSANEQFF	TRBV4-3	TRBJ2-1
TGTGCCAGCAGCTTCTTACTCCGGCCTATCTCCTACGAGCAGTACTTC	CASSFLLRPISYEQYF	TRBV5-5	TRBJ2-7
TGTGCCAGCAGCTGGCCGCCCGGGACTAGCGGGGGGGCCTACGAGCAGTACTTC	CASSWPPGTSGGAYEQYF	TRBV11-3	TRBJ2-7
TGTGCCAGCAGCACATCGGCGGGAGCCAAAAACATTCAGTACTTC	CASSTSAGAKNIQYF	TRBV9	TRBJ2-4
TGTGCCAGCAGCTTAGGGTATGGCTACACCTTC	CASSLGYGYTF	TRBV5-8	TRBJ1-2
TGTGCCACCATTCACCTGGGGGACTATAATTCACCCCTCCACTTT	CATIHLGDYNSPLHF	TRBV24-1	TRBJ1-6
TGTGCCTGGCCCTTGGGAATTCCCATATATTTT	CAWPLGIPIYF	TRBV30	TRBJ1-3
TGTGCCAGCAGATGGGGGCAAGCAATTAGAGACACTGAAGCTTTCTTT	CASRWGQAIRDTEAFF	TRBV27	TRBJ1-1
TGTGCCAGCAGCCCAGGGGACCCTAAAGGGTACTACGAGCAGTACTTC	CASSPGDPKGYYEQYF	TRBV3-1	TRBJ2-7
TGTGCTAGTGGGGACGGGACATTCAACGGACAGCGACTAGGCAAATTCTACAATGAGCAGTTCTTC	CASGDGTFNGQRLGKFYNEQFF	TRBV12-5	TRBJ2-1
TGTGCCAGCAATGAAATTCGTTCAGAATACGAGCAGTACTTC	CASNEIRSEYEQYF	TRBV14	TRBJ2-7
TGCAGTGCTAGCACATTAAAGGGGCCCAACTCCGAGCAGTACTTC	CSASTLKGPNSEQYF	TRBV20-1	TRBJ2-7
TGTGCCAGCAGTGAAAAACCCACAGGTCCCAAAAAACTGTTTTTT	CASSEKPTGPKKLFF	TRBV6-1	TRBJ1-4
TGCGCCAGCAGTGGGCGGAGACTAATACAGCGCCCCTACGAGCAGTACTTC	CASSGRRLIQRPYEQYF	TRBV10-1	TRBJ2-7
TGCGCCAGCAGCTTGGAAACCACCACAGGTGGGACCAATGAGCAGTTCTTC	CASSLETTTGGTNEQFF	TRBV5-1	TRBJ2-1
TGTGCTAAGGGGGGACAGGGAGCAACTAATGAAAAACTGTTTTTT	CAKGGQGATNEKLFF	TRBV12-5	TRBJ1-4
TGTGCCAGCAGCCGGGACAGTGAAGCTTTCTTT	CASSRDSEAFF	TRBV7-9	TRBJ1-1
TGTGCCAGCAGAACGTACTACCAACGGCAGTACTTC	CASRTYYQRQYF	TRBV12-3	TRBJ2-7
TGCGCCAGCAGCCAAGTAGCTAGGGGAGATGAGCAGTTCTTC	CASSQVARGDEQFF	TRBV4-1	TRBJ2-1
TGTGCCAGCAGCTTACAGCCTACAGGGACTGAAGCTTTCTTT	CASSLQPTGTEAFF	TRBV7-8	TRBJ1-1
TGTGCCAGCAGCGCACGGGACAGGGGGTCGGAGCAGTACTTC	CASSARDRGSEQYF	TRBV7-3	TRBJ2-7
TGTGCCAGCAGCTTAGCCGTCCGCAGGACCTACTATGGCTACACCTTC	CASSLAVRRTYYGYTF	TRBV11-2	TRBJ1-2
TGCGCCAGCAGCCAAGAGGGTGGGAGTGGCTCCTACAATGAGCAGTTCTTC	CASSQEGGSGSYNEQFF	TRBV4-1	TRBJ2-1
TGCAGCGTCTCTAGCAGAAGCTATGGCTACACCTTC	CSVSSRSYGYTF	TRBV29-1	TRBJ1-2
TGTGCCAGCAGTTACGAAAAGGGACAGTATGGCTACACCTTC	CASSYEKGQYGYTF	TRBV6-3	TRBJ1-2
TGTGCCAGCAGTGTGACCAGCACTAGCGGGAGCTGCTGTTTAGCTTTCTTT	CASSVTSTSGSCCLAFF	TRBV6-4	TRBJ1-1
TGTGCCAGCAGCTTAGGTACTAGCCACAATGAGCAGTTCTTC	CASSLGTSHNEQFF	TRBV7-3	TRBJ2-1
TGTGCCAGCAGCTTAGCCGCCCGGGACAGGGGTCAGCCCCAGCATTTT	CASSLAARDRGQPQHF	TRBV7-4	TRBJ1-5
TGTGCCAGCAGCCCCCACAGGGTTGTAGGCTACACCTTC	CASSPHRVVGYTF	TRBV4-2	TRBJ1-2
TGTGCCACCATGCTGTCTCTATGTCGAACGTCGGCCTACGAGCAGTACTTC	CATMLSLCRTSAYEQYF	TRBV24-1	TRBJ2-7
TGTGCCAGCAGCTTATACAGAAGGCGATTCTCTGGGGCCAACGTCCTGACTTTC	CASSLYRRRFSGANVLTF	TRBV7-9	TRBJ2-6
TGTGCCAGCGGATTACGGGTAGATACGCAGTATTTT	CASGLRVDTQYF	TRBV2	TRBJ2-3
TGCGCCAGCAGCTTAAAGGGAGCGGGATCCGGGGAGCTGTTTTTT	CASSLKGAGSGELFF	TRBV5-1	TRBJ2-2
TGTGCCAGCAGTTACCACGTTTCGGACAGGTCTGGGGCCAACGTCCTGACTTTC	CASSYHVSDRSGANVLTF	TRBV6-3	TRBJ2-6
TGCAGTTTATTGAACCTGATAGTTAACTATGGCTACACCTTC	CSLLNLIVNYGYTF	TRBV20-1	TRBJ1-2
TGTGCCACCAGCAGACTTTCCCGGGACAAGTTTTACAATGAGCAGTTCTTC	CATSRLSRDKFYNEQFF	TRBV15	TRBJ2-1
TGTGCCAGCAGAAACGACAGCAGGGCTTTCTTT	CASRNDSRAFF	TRBV6-3	TRBJ1-1
TGTGCCAGCAGTGGCGACAACGTTCAATACGAGCAGTACTTC	CASSGDNVQYEQYF	TRBV6-1	TRBJ2-7
TGTGCCAGCAGCTACTACCTCGCAATTGGGGTCCCAGGGGAAACTAATGAAAAACTGTTTTTT	CASSYYLAIGVPGETNEKLFF	TRBV11-2	TRBJ1-4
TGTGCCACCAGCCCCCGGGACAGGGGCCGACAAGCTTTCTTT	CATSPRDRGRQAFF	TRBV15	TRBJ1-1
TGTGCCAGCAGCCGGTGGCGGAATTATGGCTACACCTTC	CASSRWRNYGYTF	TRBV9	TRBJ1-2
TGTGCCAGCAGCTTTGCGGGACATCCGGGCATCGACACTGAAGCTTTCTTT	CASSFAGHPGIDTEAFF	TRBV5-6	TRBJ1-1
TGCGCCAGCAGTGAGGGACAGGGGTTTAGCACAGATACGCAGTATTTT	CASSEGQGFSTDTQYF	TRBV10-1	TRBJ2-3
TGTGCCAGCAGCAACGCCGGGACATATGGCTACACCTTC	CASSNAGTYGYTF	TRBV3-1	TRBJ1-2
TGTGCCAGCAGCATGCCTTCTGTCGGGGATCAGCCCCAGCATTTT	CASSMPSVGDQPQHF	TRBV13	TRBJ1-5
TGCAGTGCTGGTGCGGGACAAGATTCCTACGAGCAGTACTTC	CSAGAGQDSYEQYF	TRBV20-1	TRBJ2-7
TGCGCCAGCAAACTTCACCTCGGGAGGGCCCTGAATAGCTCTGGAAACACCATATATTTT	CASKLHLGRALNSSGNTIYF	TRBV10-2	TRBJ1-3
TGTGCCAGCTCACCGCTCAGGACTAGGGCCGCGGGACAGGGAATCAGCAATCAGCCCCAGCATTTT	CASSPLRTRAAGQGISNQPQHF	TRBV18	TRBJ1-5
TGTGCCAGCAGCCAAGGACGTGGGGGGGGCGATAGCACAGATACGCAGTATTTT	CASSQGRGGGDSTDTQYF	TRBV3-1	TRBJ2-3
TGCAGTGCTAGAATACGGTTCCCAGATCCGGGGCCACGTAGAGTCTACGAGCAGTACTTC	CSARIRFPDPGPRRVYEQYF	TRBV20-1	TRBJ2-7
TGCAGTTTGAGGGGGGCGTTCTCGACGCCTAACTATGGCTACACCTTC	CSLRGAFSTPNYGYTF	TRBV20-1	TRBJ1-2
TGTGCCAGCAGCCAAGGCCGAGGGGGAGAGCAGTACTTC	CASSQGRGGEQYF	TRBV3-1	TRBJ2-7
TGTGCCAGCAGCCCTGGCCTAGAAGGCAATGAGCAGTTCTTC	CASSPGLEGNEQFF	TRBV7-3	TRBJ2-1
TGTGCCAGCAGCGCTCGTACGAAGGGCGGGGAGCTGTTTTTT	CASSARTKGGELFF	TRBV13	TRBJ2-2
TGTGCCAGCAGCGACTTGCCCTCCGGGACACCAAACCAGAATTCACCCCTCCACTTT	CASSDLPSGTPNQNSPLHF	TRBV11-3	TRBJ1-6
TGCAGTGCTCTCTCCGAGACCCAGTACTTC	CSALSETQYF	TRBV20-1	TRBJ2-5
TGTGCTAGTGGTTTGTGGGGACAGGGAGGGTACAATGAGCAGTTCTTC	CASGLWGQGGYNEQFF	TRBV12-5	TRBJ2-1
TGTGCCAGCAGCGAAGGGCTCCGGCGATTCTCTGGGGCCAACGTCCTGACTTTC	CASSEGLRRFSGANVLTF	TRBV11-2	TRBJ2-6
TGTGCCAGCAGCTTACACCCCAGGGAGGGTAGAAACGAGACCCAGTACTTC	CASSLHPREGRNETQYF	TRBV11-2	TRBJ2-5
TGCGCCAGCAGCCGACGTGACAGGGGGCGCTGGACTGAAGCTTTCTTT	CASSRRDRGRWTEAFF	TRBV4-1	TRBJ1-1
TGTTGGGGGCGGTTACCTGAAAAACTGTTTTTT	CWGRLPEKLFF	TRBV7-9	TRBJ1-4
TGTGCCAGCACGCAGGGGTTCGGAGGGGATGGCTACACCTTC	CASTQGFGGDGYTF	TRBV6-5	TRBJ1-2
TGTGCCAGCACTCGAGGACGCAGGGGGCGGAACACTGAAGCTTTCTTT	CASTRGRRGRNTEAFF	TRBV6-5	TRBJ1-1
TGTGCCAGCAGCAATGACAGGGGGCGGAACACCGGGGAGCTGTTTTTT	CASSNDRGRNTGELFF	TRBV27	TRBJ2-2
TGCGCCAGCAGCCCAATGGGGGACAGTACGAACACTGAAGCTTTCTTT	CASSPMGDSTNTEAFF	TRBV4-1	TRBJ1-1
TGTGCCAGCAGCCGTTCAGGGTTGCCGAGTGGGGAGCTGTTTTTT	CASSRSGLPSGELFF	TRBV14	TRBJ2-2
TGCGCCAGCAAGGGACAGCTCTACGAGCAGTACTTC	CASKGQLYEQYF	TRBV5-1	TRBJ2-7
TGTGCCAGCAGCTCCCCCGGGACAGGGCGTAGAGAGACCCAGTACTTC	CASSSPGTGRRETQYF	TRBV13	TRBJ2-5
TGTGCCAGCAGCTTAGTTCTAGCGAATGAGCAGTTCTTC	CASSLVLANEQFF	TRBV11-2	TRBJ2-1
TGTGCCAGCTCACCAAGTGTCCTTGTCGAGGTGATCGAGCAGTACTTC	CASSPSVLVEVIEQYF	TRBV18	TRBJ2-7
TGTGCCAGCAGCTTTAGAACAGATACGCAGTATTTT	CASSFRTDTQYF	TRBV27	TRBJ2-3
TGTGCCAGCAGTTTCCGGCGGGGTGACCGGGCGGATACTGAAGCTTTCTTT	CASSFRRGDRADTEAFF	TRBV28	TRBJ1-1
TGTGCCAGCAGTGAAGGTAGGCTCCGGCAGTTCTTC	CASSEGRLRQFF	TRBV6-1	TRBJ2-1
TGTGCCAGCAGCTTGGGGGGAAGGGACAGTGACTACGAGCAGTACTTC	CASSLGGRDSDYEQYF	TRBV5-6	TRBJ2-7
TGTGCTAGTGGCCCCACAGGTGACCTATACAATGAGCAGTTCTTC	CASGPTGDLYNEQFF	TRBV12-5	TRBJ2-1
TGCGCCAGCCCAGACAGGGCTAGCTCTGGGGCCAACGTCCTGACTTTC	CASPDRASSGANVLTF	TRBV10-2	TRBJ2-6
TGCGCCAGCAGTCACTTACATAGCACAGATACGCAGTATTTT	CASSHLHSTDTQYF	TRBV5-1	TRBJ2-3
TGTGCCTGGAGTGCTACCGGCGACTGGAATCAGCCCCAGCATTTT	CAWSATGDWNQPQHF	TRBV30	TRBJ1-5
TGCGCCAGCAGCTTTAGAAGGAACCCGGGACAGGGTCCCGGGGAGCTGTTTTTT	CASSFRRNPGQGPGELFF	TRBV4-3	TRBJ2-2
TGTGCCAGCAGTCCACTAGGGGACAGGGACCATTCACCCCTCCACTTT	CASSPLGDRDHSPLHF	TRBV6-5	TRBJ1-6
TGTGCCAGCAGCTTAGAGAGGACAGTCTACTCTGGAAACACCATATATTTT	CASSLERTVYSGNTIYF	TRBV7-6	TRBJ1-3
TGTGCCAGCAGCCCAGGGTACAATGAAAAACTGTTTTTT	CASSPGYNEKLFF	TRBV7-4	TRBJ1-4
TGCAGTGCTACGATGGGCGGACAGGGGCAGCCCCAGCATTTT	CSATMGGQGQPQHF	TRBV20-1	TRBJ1-5
TGCGAAACGGAGGAGAATGAAAAACTGTTTTTT	CETEENEKLFF	TRBV5-1	TRBJ1-4
TGTGCCAGCAGCAAGAATAGTGGAGGCAGGGAACAGACTGAAGCTTTCTTT	CASSKNSGGREQTEAFF	TRBV13	TRBJ1-1
TGTGCCATCATCCCCTTGCGACAGGGGGCGCATTGCACTGAAGCTTTCTTT	CAIIPLRQGAHCTEAFF	TRBV10-3	TRBJ1-1
TGTGCCAGTAGGTCTTACGTCAGGGGGTTAAGGACTAATGAAAAACTGTTTTTT	CASRSYVRGLRTNEKLFF	TRBV19	TRBJ1-4
TGTGCCAGCAGCCCGACTCTTAATGAGCAGTTCTTC	CASSPTLNEQFF	TRBV9	TRBJ2-1
TGTGCCAGCAGCCGGGGCCTCTACGAGCAGTACTTC	CASSRGLYEQYF	TRBV7-9	TRBJ2-7
TGTGCCAGCAGTTTGTGGGAAGGGGAGCAGTTCTTC	CASSLWEGEQFF	TRBV28	TRBJ2-1
TGTGCCAGCAGCGACCCGGGACTAGCGGGTTACGAGCAGTACTTC	CASSDPGLAGYEQYF	TRBV13	TRBJ2-7
TGTGCCAGCAGCCGCCCCGGGACATCTGGGAACACTGAAGCTTTCTTT	CASSRPGTSGNTEAFF	TRBV14	TRBJ1-1
TGTGCCAGCAGTGAAGCCCTAATGCGACGCATATATTTT	CASSEALMRRIYF	TRBV25-1	TRBJ1-3
TGTGCCAGCAGCATAGGGGCCATTGCCTCCTACAATGAGCAGTTCTTC	CASSIGAIASYNEQFF	TRBV12-3	TRBJ2-1
TGTGCCAGCAGCCAAGAGGATTTCTACCGAAAACTGTTTTTT	CASSQEDFYRKLFF	TRBV3-1	TRBJ1-4
TGTGCCAGCAGCTTTTGGGAGGGTCCAAACTACAATGAGCAGTTCTTC	CASSFWEGPNYNEQFF	TRBV11-2	TRBJ2-1
TGTGCCAGCAGTTCGGCCCGTACCGGGGAGGCGAGGATGAACACTGAAGCTTTCTTT	CASSSARTGEARMNTEAFF	TRBV12-4	TRBJ1-1
TGTGCCAGCAGACCCCGATACAATGAGCAGTTCTTC	CASRPRYNEQFF	TRBV12-4	TRBJ2-1
TGTGCCATAAAACCGGGACCAGTTGAGCAGTTCTTC	CAIKPGPVEQFF	TRBV6-3	TRBJ2-1
TGTGCCAGCAGAAGCAGACCAGGGGGCTTGGGGAATTCACCCCTCCACTTT	CASRSRPGGLGNSPLHF	TRBV7-9	TRBJ1-6
TGCGCCAGCAGCCAATTCTTATCCCCCAGGGGCTACGAGCAGTACTTC	CASSQFLSPRGYEQYF	TRBV4-1	TRBJ2-7
TGCGCCAGCAGCCCACCAAGGGGAGGTAATCAGCCCCAGCATTTT	CASSPPRGGNQPQHF	TRBV5-1	TRBJ1-5
TGCGCCAGCAGCTGTGGACTAGCGGGAGGGGTCTACGAGCAGTACTTC	CASSCGLAGGVYEQYF	TRBV5-1	TRBJ2-7
TGTGCCAGTACCCTGGACAGGCTTGTTGGGGCCAACGTCCTGACTTTC	CASTLDRLVGANVLTF	TRBV19	TRBJ2-6
TGTGCCAGCAGTGACTCGATGGTTTTGCGCCCGGGTGTCCCGGTTCACAGGGCGTGCAATCAGCCCCAGCATTTT	CASSDSMVLRPGVPVHRACNQPQHF	TRBV6-4	TRBJ1-5
TGTGCCAGCAGGAGGGACGCGACTGAGCAGTACTTC	CASRRDATEQYF	TRBV6-6	TRBJ2-7
TGTGCCACCAGTCCCCCTTCTGCGGGACAGGGGGCGAATGGCTACGAGCAGTACTTC	CATSPPSAGQGANGYEQYF	TRBV24-1	TRBJ2-7
TGTGCCAGCAGTACGGTGCGGGGGGGGGACAATGAGCAGTTCTTC	CASSTVRGGDNEQFF	TRBV27	TRBJ2-1
TGTGCCACCAGGGCCAAGGCTCCGGGACAGGGGATGAGCTCCTACAATGAGCAGTTCTTC	CATRAKAPGQGMSSYNEQFF	TRBV24-1	TRBJ2-1
TGTGCCATTCTTAGGGGACTGTGGAGCTACAATGAGCAGTTCTTC	CAILRGLWSYNEQFF	TRBV6-4	TRBJ2-1
TGTGCCAGCAGCAAGTGCCGACGCTCATACTTC	CASSKCRRSYF	TRBV13	TRBJ2-7
TGTGCCAGCAGTTACCCTTCAGAACGCACTGAAGCTTTCTTT	CASSYPSERTEAFF	TRBV6-9	TRBJ1-1
TGTGCCAGCAGCGGGGGTAGGCATGAAAAACTGTTTTTT	CASSGGRHEKLFF	TRBV11-2	TRBJ1-4
TGTGCCAGCGAGGGGACTAGCACAGATACGCAGTATTTT	CASEGTSTDTQYF	TRBV18	TRBJ2-3
TGTGCCAGGGGGACACAGGCAGCCAGAGGCTACACCTTC	CARGTQAARGYTF	TRBV6-1	TRBJ1-2
TGTGCCAGCAGCTTAATCTGCGGGAGGATACAAGAGACCCAGTACTTC	CASSLICGRIQETQYF	TRBV7-9	TRBJ2-5
TGCAGTGCTAGAAGTGGGCGGCTAGCGGGATGGGGCACAGATACGCAGTATTTT	CSARSGRLAGWGTDTQYF	TRBV20-1	TRBJ2-3
TGCGCCAGCAGTGAATCGGACCAGGGGACAGGGGGCTGGCGTAGCTCCTACGAGCAGTACTTC	CASSESDQGTGGWRSSYEQYF	TRBV10-1	TRBJ2-7
TGTGCCAGCAGTTGTTCCCCCGGGACTAGCGGGAGTTGGGGCTACACCTTC	CASSCSPGTSGSWGYTF	TRBV6-3	TRBJ1-2
TGTGCCAGCAGAGCTAGGTGGGATGAGCAGTTCTTC	CASRARWDEQFF	TRBV12-4	TRBJ2-1
TGTGCCAGCAGCTGGACTGGGAACACTGAAGCTTTCTTT	CASSWTGNTEAFF	TRBV9	TRBJ1-1
TGTGCCAGCAGCCAAGATTCAGTAGTACGTCCTGGGGCCAACGTCCTGACTTTC	CASSQDSVVRPGANVLTF	TRBV4-2	TRBJ2-6
TGTGCCTGGAGTGTGAAGCGGGGGTGTAACGAGCAGTACTTC	CAWSVKRGCNEQYF	TRBV30	TRBJ2-7
TGTGCCAGCAGCCCCAGGGGGGGCATTTACAATGAGCAGTTCTTC	CASSPRGGIYNEQFF	TRBV6-8	TRBJ2-1
TGTGCCAGCAGTTACTCGGGACATATCCCCGACACTGAAGCTTTCTTT	CASSYSGHIPDTEAFF	TRBV6-6	TRBJ1-1
TGCGCCAGCAAAGTAGGCGTACATAAGGGGAACCCTGAAGCTTTCTTT	CASKVGVHKGNPEAFF	TRBV4-3	TRBJ1-1
TGTGCCAGCAGTTACTCGAACAGGGGGCTCGAGCAGTTCTTC	CASSYSNRGLEQFF	TRBV6-8	TRBJ2-1
TGTGCCAGCAGTTACTCGAGCCGGGGGCAGGAGGATACGCAGTATTTT	CASSYSSRGQEDTQYF	TRBV6-6	TRBJ2-3
TGTGCCAGCAGCCGACTAGGAGGAAACTACGAGCAGTACTTC	CASSRLGGNYEQYF	TRBV6-2	TRBJ2-7
TGCGCCAGCAATATGCCCGGGACAGGGTGGTTTGAGCAGTTCTTC	CASNMPGTGWFEQFF	TRBV10-1	TRBJ2-1
TGCAGTGCTAGAGATACCGGGACGGGGTGGAATCAGCCCCAGCATTTT	CSARDTGTGWNQPQHF	TRBV20-1	TRBJ1-5
TGCAGTGCTAGAGATAGTAATCCACACCAATCATCTAGGTACTTTTTCTGGTACTACGAGCAGTACTTC	CSARDSNPHQSSRYFFWYYEQYF	TRBV20-1	TRBJ2-7
TGTGCCAGCAGCTTGGTCGGCCCCCCCGGGACAGGGACAAGGAACACTGAAGCTTTCTTT	CASSLVGPPGTGTRNTEAFF	TRBV5-4	TRBJ1-1
TGTGCCAGCAGCTTATTGTGCCCGGGGGGTTCTAATGAAAAACTGTTTTTT	CASSLLCPGGSNEKLFF	TRBV7-3	TRBJ1-4
TGTGCCAGCATCGGGGACAGTGTAGATACGCAGTATTTT	CASIGDSVDTQYF	TRBV6-5	TRBJ2-3
TGTGCCAGCAGCCCAGTTCATGAAGCTTTCTTT	CASSPVHEAFF	TRBV7-9	TRBJ1-1
TGTGCCAGCAGCTTCGGACTAGCGGGATGGATCAATGAGCAGTTCTTC	CASSFGLAGWINEQFF	TRBV9	TRBJ2-1
TGTGCGTTGACAGGGCAGCAAGAGACCCAGTACTTC	CALTGQQETQYF	TRBV27	TRBJ2-5
TGTGCCAGCAGCTGTACAGGGGTAGATCAGCCCCAGCATTTT	CASSCTGVDQPQHF	TRBV13	TRBJ1-5
TGCGCCAGCAGTGAGAAAAAGCGGGAGAATGAGCAGTTCTTC	CASSEKKRENEQFF	TRBV10-1	TRBJ2-1
TGTGCTAGTGGTTTGAGCAACTACGAGCAGTACTTC	CASGLSNYEQYF	TRBV12-5	TRBJ2-7
TGTGCCAGCGGACAGGAGAGCAATCAGCCCCAGCATTTT	CASGQESNQPQHF	TRBV5-6	TRBJ1-5
TGTGCCAGCAGCCTAACTCCAGTTGGCTCCAATCAGCCCCAGCATTTT	CASSLTPVGSNQPQHF	TRBV7-4	TRBJ1-5
TGTGCCAGTCCCCGTAGGGGGGGGGTGAACACCGGGGAGCTGTTTTTT	CASPRRGGVNTGELFF	TRBV7-3	TRBJ2-2
TGTGCCAGCAGTTTTGACAGGGGGCCAAAGTCGTGTGCAACTAATGAAAAACTGTTTTTT	CASSFDRGPKSCATNEKLFF	TRBV6-5	TRBJ1-4
TGTGCCAGCAGGGGGGACGGTATGCGAAACTATGGCTACACCTTC	CASRGDGMRNYGYTF	TRBV12-4	TRBJ1-2
TGCGCGCAGGGGGGGGGGAACACCGGGGAGCTGTTTTTT	CAQGGGNTGELFF	TRBV10-1	TRBJ2-2
TGTGCCATGGGACTGGAGGGGTCCGGGGAGCTGTTTTTT	CAMGLEGSGELFF	TRBV18	TRBJ2-2
TGTGCCAGCAGCTTAGATCCCAGAACAGGGAAAACTGAAGCTTTCTTT	CASSLDPRTGKTEAFF	TRBV7-2	TRBJ1-1
TGTGCCAGTAGTCTTTCGCCAGGGTCCTTTCGATCACCCCTCCACTTT	CASSLSPGSFRSPLHF	TRBV19	TRBJ1-6
TGTGCCAGCAGCTACCGGACAGGGCACAAAGCTTTCTTT	CASSYRTGHKAFF	TRBV7-2	TRBJ1-1
TGTGCCAGCAGTTTAGGAGTGAATTGTGGGACCCAGTACTTC	CASSLGVNCGTQYF	TRBV27	TRBJ2-5
TGTGCCAGCAGGTTCCGGGGATCTAGCCCTTGCAATCAGCCCCAGCATTTT	CASRFRGSSPCNQPQHF	TRBV12-3	TRBJ1-5
TGCGCCAGCAAGATGAGGGATGAGCAGTTCTTC	CASKMRDEQFF	TRBV10-1	TRBJ2-1
TGCAGTGCCCCCCAAGGGGGCCAGGGCTACACCTTC	CSAPQGGQGYTF	TRBV20-1	TRBJ1-2
TGTGCCAGCAGCCCGGGGAAAGTACCAACAGGAACTAGAAACACCATATATTTT	CASSPGKVPTGTRNTIYF	TRBV9	TRBJ1-3
TGTGCCAGCGTTCACCGTCTCCGGGACTACGACGAGCAGTACTTC	CASVHRLRDYDEQYF	TRBV6-5	TRBJ2-7
TGTGCCAGCAGCGCGGGGAGTAGGCATTACACTGAAGCTTTCTTT	CASSAGSRHYTEAFF	TRBV14	TRBJ1-1
TGTGCCAGCACCACAGGGGACACTGAAGCTTTCTTT	CASTTGDTEAFF	TRBV11-3	TRBJ1-1
TGTGCCAGCACGGGACAGAACGAGCAGTACTTC	CASTGQNEQYF	TRBV12-4	TRBJ2-7
TGTGCCACCAGTCGCAGGGGACAGGGGCCAGCTGAAGCTTTCTTT	CATSRRGQGPAEAFF	TRBV24-1	TRBJ1-1
TGTGCCAGCAGCTTAATGGTCTTCCGGGGGGGCAACCAAGAGACCCAGTACTTC	CASSLMVFRGGNQETQYF	TRBV11-2	TRBJ2-5
TGTGCCAGCAGTTTAGCGGGGGCCTACAATGAGCAGTTCTTC	CASSLAGAYNEQFF	TRBV27	TRBJ2-1
TGTGCCAGCAGTTACAACGCTCATTTATTGGGCCCAGGGACAGATACGCAGTATTTT	CASSYNAHLLGPGTDTQYF	TRBV6-5	TRBJ2-3
TGTGCCAGCAGCTTAGCAGCGGGACAGGGAGATTACAATGAGCAGTTCTTC	CASSLAAGQGDYNEQFF	TRBV11-3	TRBJ2-1
TGCAGCGTTGAAGATCGAGAACAGGGCCTTGGCTACACCTTC	CSVEDREQGLGYTF	TRBV29-1	TRBJ1-2
TGCAGTGCTAAAGACAGGGGGGTATATGGCTACACCTTC	CSAKDRGVYGYTF	TRBV20-1	TRBJ1-2
TGCAGTGCTAGAGATCGGGGGGCCTTCCGACGCACTGAAGCTTTCTTT	CSARDRGAFRRTEAFF	TRBV20-1	TRBJ1-1
TGTGCCAGCAGCCAAGAACGGGACACAGGAGGCTACACCTTC	CASSQERDTGGYTF	TRBV3-1	TRBJ1-2
TGTGCCAGTAGTATAGATCCGGGACTAGCGGGACCAGAGACCCAGTACTTC	CASSIDPGLAGPETQYF	TRBV19	TRBJ2-5
TGTGCCAGCAGCTTAGATTTCCGGGAACCGAAAGGATACAATGAGCAGTTCTTC	CASSLDFREPKGYNEQFF	TRBV7-9	TRBJ2-1
TGTGCCAGCCTGGACAGGGGAAGCTACGAGCAGTACTTC	CASLDRGSYEQYF	TRBV2	TRBJ2-7
TGTGCCAGCAGTTTAGTCAGAAAGAACAACAGGAGACAGGGTCCAGTTGAAGCTTTCTTT	CASSLVRKNNRRQGPVEAFF	TRBV12-3	TRBJ1-1
TGTGCCAGCAGCCAAGATGGATTAAGTAGACAAACAGGGAAGAGATCTGAGGGACGGTCCTACGAGCAGTACTTC	CASSQDGLSRQTGKRSEGRSYEQYF	TRBV14	TRBJ2-7
TGTGCCAGCAGCCCTACTAGGAGGCTAGCCAAAAACATTCAGTACTTC	CASSPTRRLAKNIQYF	TRBV7-3	TRBJ2-4
TGCAGTGCTAGAGATAACACTAGCGGTACCGGGGAGCTGTTTTTT	CSARDNTSGTGELFF	TRBV20-1	TRBJ2-2
TGTGCCAGCAGATACGACCGGAGGTTTCAAGACGAGCAGTACTTC	CASRYDRRFQDEQYF	TRBV5-6	TRBJ2-7
TGTGCCATCAGCGCTGCTGAAAAACTGTTTTTT	CAISAAEKLFF	TRBV19	TRBJ1-4
TGCAGTGCTCTGGGATGGTGGGAGGCTGAGCAGTACTTC	CSALGWWEAEQYF	TRBV20-1	TRBJ2-7
TGTGCCACCGGGGCGAATCAGCCCCAGCATTTT	CATGANQPQHF	TRBV6-4	TRBJ1-5
TGTGCCAGCAGCTGCAGGGACGCCACGAACACTGAAGCTTTCTTT	CASSCRDATNTEAFF	TRBV7-2	TRBJ1-1
TGTGCCTTCGGGACAGCGAGCAATCAGCCCCAGCATTTT	CAFGTASNQPQHF	TRBV30	TRBJ1-5
TGCGCCAGCCTTCGTGATCCCGGGACAGGGCATAGCTCCTATAATTCACCCCTCCACTTT	CASLRDPGTGHSSYNSPLHF	TRBV10-1	TRBJ1-6
TGTGCCAGCAGCCAAGATCAGACAGGGGGAGAAAAACTGTTTTTT	CASSQDQTGGEKLFF	TRBV14	TRBJ1-4
TGTGCCAGCAGCCCAGCTAAGGGCGAGACCCAGTACTTC	CASSPAKGETQYF	TRBV7-6	TRBJ2-5
TGTGCCAGCAGCGTACACAGGGGGCGAGGCTACACCTTC	CASSVHRGRGYTF	TRBV5-4	TRBJ1-2
TGCAGCGTCGGTGCGCCGTCCTACAATGAGCAGTTCTTC	CSVGAPSYNEQFF	TRBV29-1	TRBJ2-1
TGTGCCAGCAGGGGACAGGTTGTCTATGGCTACACCTTC	CASRGQVVYGYTF	TRBV6-4	TRBJ1-2
TGTGCCAGCAGCTTACCTAGCGGAGATACGCAGTATTTT	CASSLPSGDTQYF	TRBV7-2	TRBJ2-3
TGCAGTGCTAGCAGCCCTAGCGGGGGACGCGAGCAGTACTTC	CSASSPSGGREQYF	TRBV20-1	TRBJ2-7
TGTGCCAGCAGTGGGGCCGAGCCCCAGCATTTT	CASSGAEPQHF	TRBV12-4	TRBJ1-5
TGCAGCGTTGAGGGTCGGCTCGGCTACACCTTC	CSVEGRLGYTF	TRBV29-1	TRBJ1-2
TGTGCCAGCAGTGACTCGCCCCCCCGGACCGGCAATCAGCCCCAGCATTTT	CASSDSPPRTGNQPQHF	TRBV6-4	TRBJ1-5
TGTGCCAGCAGAAAAACTAGCGGGAGGGCGAAGTGTAGAGGGACTGGAAACACCATATATTTT	CASRKTSGRAKCRGTGNTIYF	TRBV28	TRBJ1-3
TGTGCCAGCAGGCGTCGACTAGCGGGAGATGAGGGCTACGAGCAGTACTTC	CASRRRLAGDEGYEQYF	TRBV7-9	TRBJ2-7
TGTGCCAGCAGCTTCAGGGTTGAAAAAGAGACCCAGTACTTC	CASSFRVEKETQYF	TRBV7-9	TRBJ2-5
TGCGCCAGCACCCCACAGGCGCGGGGAAGACGCACAGATACGCAGTATTTT	CASTPQARGRRTDTQYF	TRBV10-1	TRBJ2-3
TGTGCCAGCAGCCTAACGGGGACAGACTTTGACTATGGCTACACCTTC	CASSLTGTDFDYGYTF	TRBV7-9	TRBJ1-2
TGTGCCAGCAGTAGGGTCTTGACAGGGGACGAGCAGTACTTC	CASSRVLTGDEQYF	TRBV2	TRBJ2-7
TGTGCCAGCAGCTTCGGACAGTTGAATTCACCCCTCCACTTT	CASSFGQLNSPLHF	TRBV11-2	TRBJ1-6
TGTGCCATCAGTGCTCGCTGCCTTCCCCTTTACACTGAAGCTTTCTTT	CAISARCLPLYTEAFF	TRBV10-3	TRBJ1-1
TGTGCCAGCAGCGTGGAGGGGCCTACTCACACTGAAGCTTTCTTT	CASSVEGPTHTEAFF	TRBV7-3	TRBJ1-1
TGTGCCAGCGTGGAGATTGACAGGGGCGAGCAGTACTTC	CASVEIDRGEQYF	TRBV27	TRBJ2-7
TGTGCTAGCAGCTTATCTCTTTACAATGAGCAGTTCTTC	CASSLSLYNEQFF	TRBV7-7	TRBJ2-1
TGTGCCTGGAGTGTAGGACAGGGTTCCAACACTGAAGCTTTCTTT	CAWSVGQGSNTEAFF	TRBV30	TRBJ1-1
TGTGCCAGCAGCCACGCAGGGGTGGGTGGAAGAAGACCCGACAATGAGCAGTTCTTC	CASSHAGVGGRRPDNEQFF	TRBV3-1	TRBJ2-1
TGTGCCTCCCTGCAAGGGACGGCGAACACCGGGGAGCTGTTTTTT	CASLQGTANTGELFF	TRBV7-9	TRBJ2-2
TGTGCCTGGCCGTCGGGGGGGGACAATGAGCAGTTCTTC	CAWPSGGDNEQFF	TRBV30	TRBJ2-1
TGTGCCAGCAGCGTGGACCAGGCAACGGGCAATGACGAGCAGTACTTC	CASSVDQATGNDEQYF	TRBV9	TRBJ2-7
TGTGCCAGCAGCCAAAGGAAGCGGACAGCCTACGAGCAGTACTTC	CASSQRKRTAYEQYF	TRBV3-1	TRBJ2-7
TGCGCCAGCAGACCGCGGGGCCCAATCATATATTTT	CASRPRGPIIYF	TRBV10-1	TRBJ1-3
TGTGCCAGCTCACCCGGGTGGAGCGGGAGCCGGCGCAATCAGCCCCAGCATTTT	CASSPGWSGSRRNQPQHF	TRBV18	TRBJ1-5
TGTGCCAGCAGCCACGTAGCGGGCAAGGAGCAGTACTTC	CASSHVAGKEQYF	TRBV4-2	TRBJ2-7
