TGCGCCAGCAGCCAAAGCCTGAGACAGGGACACACTGAAGCTTTCTTT	CASSQSLRQGHTEAFF	TRBV4-1	TRBJ1-1
TGTGCCAGCAGCAGGGGAGACAGGTGGCTGCAACAGAACGAGCAGTACTTC	CASSRGDRWLQQNEQYF	TRBV5-4	TRBJ2-7
TGTGCCAGCATAAGACAGGGTCTCGAAAAACTGTTTTTT	CASIRQGLEKLFF	TRBV9	TRBJ1-4
TGTGCCAGCAGCTGGGGGTGGGACGAATCGCCCTACAATGAGCAGTTCTTC	CASSWGWDESPYNEQFF	TRBV7-3	TRBJ2-1
TGTGCCAGCATTACGGCAAGCGGGATGTATTCCTACGAGCAGTACTTC	CASITASGMYSYEQYF	TRBV2	TRBJ2-7
TGCAGTGCTGGGGGGGGGTGGCCCCAGCATTTT	CSAGGGWPQHF	TRBV20-1	TRBJ1-5
TGTGCCAGCAGCGTTTATTACCGATCCCGGGGGGGCTACACCTTC	CASSVYYRSRGGYTF	TRBV13	TRBJ1-2
TGCAGCGTTGATTTGAGCCTCCTCGATAATTTTGAAGCTTTCTTT	CSVDLSLLDNFEAFF	TRBV29-1	TRBJ1-1
TGTGCCAGCAGCTTAGCGTATGGTAGAGGGGTTACCGGGGAGCTGTTTTTT	CASSLAYGRGVTGELFF	TRBV11-2	TRBJ2-2
TGCGCCAGCAGCCAAGTCAGGGGACAGGGGCAAGAGACCCAGTACTTC	CASSQVRGQGQETQYF	TRBV4-1	TRBJ2-5
TGCGCCAGCGGGTTTCTTGGACGGTTTGGCTACACCTTC	CASGFLGRFGYTF	TRBV10-1	TRBJ1-2
TGTGCCAGCAGTTCAGAGGGGCTACCAAGGGGCTATGGCTACACCTTC	CASSSEGLPRGYGYTF	TRBV6-4	TRBJ1-2
TGTGCCAGCAGTTCAAAAATGGACGCGCCGAAGGAGCAGTACTTC	CASSSKMDAPKEQYF	TRBV27	TRBJ2-7
TGTGCCAGCAGTAACTGCTATGGCTACACCTTC	CASSNCYGYTF	TRBV28	TRBJ1-2
TGTGCCAACAGGAAAGATAGCAATCAGCCCCAGCATTTT	CANRKDSNQPQHF	TRBV9	TRBJ1-5
TGTGCCAGCATTACTGAGGGGGTCAGAGGGGCCAACGTCCTGACTTTC	CASITEGVRGANVLTF	TRBV27	TRBJ2-6
TGTGCCAGCAGTGGGACTAGCGGGAACCCTGAGACCCAGTACTTC	CASSGTSGNPETQYF	TRBV6-1	TRBJ2-5
TGTGCCAGCAGCTTGAGGGACAGGGAAAGGAACACTGAAGCTTTCTTT	CASSLRDRERNTEAFF	TRBV11-2	TRBJ1-1
TGTGCTAGTGACCAACCCGGGACAGGGGGCTCGGCGGGCGGAGGCCACGAGACCCAGTACTTC	CASDQPGTGGSAGGGHETQYF	TRBV12-5	TRBJ2-5
TGCGCCAGCAAGCGGCCTCAGGGTGGCTACACCTTC	CASKRPQGGYTF	TRBV10-1	TRBJ1-2
TGTGCCAGCAGCTTCCCCAGGCTAGACAAAAACATTCAGTACTTC	CASSFPRLDKNIQYF	TRBV4-2	TRBJ2-4
TGTGCCAGCAGTTACCCTGGGGCGCCGGCAACTAATGAAAAACTGTTTTTT	CASSYPGAPATNEKLFF	TRBV6-5	TRBJ1-4
TGTGCCAGCAGCCCGTGGGACAGGGGTTTCGAGCAGTACTTC	CASSPWDRGFEQYF	TRBV9	TRBJ2-7
TGCGCCAGGGGGTTCTTTCTCTTC	CARGFFLF	TRBV5-1	TRBJ2-1
TGTGCCAGCAGCCGCACATCAGAGTTGAACGGAAACACCATATATTTT	CASSRTSELNGNTIYF	TRBV27	TRBJ1-3
TGTGCCAGTAGTGATCCCGACAGACAGTCGGTTGAAAAACTGTTTTTT	CASSDPDRQSVEKLFF	TRBV19	TRBJ1-4
TGTGCCAGCAGCTTAAAAGGGGGGGCGGGGTTCGCGGCAAACGAGCAGTACTTC	CASSLKGGAGFAANEQYF	TRBV7-3	TRBJ2-7
TGTGCCAGCAGCTTGGGGGGGCCGCGAGAGACCCAGTACTTC	CASSLGGPRETQYF	TRBV7-3	TRBJ2-5
TGTGCCAGCAGTTACTCTGGGACTAGTAGAATTGGCTACGAGCAGTACTTC	CASSYSGTSRIGYEQYF	TRBV6-3	TRBJ2-7
TGTGCCTGGAGTGTAAGGGACAGGGGGCAGTCAAAAATCGATCAGCCCCAGCATTTT	CAWSVRDRGQSKIDQPQHF	TRBV30	TRBJ1-5
TGTGCCAGCAGCGGAATCCCAGGGGGAGCGCAAAATCAGCCCCAGCATTTT	CASSGIPGGAQNQPQHF	TRBV5-4	TRBJ1-5
TGTGCCAGCAGCTTAGATCGGTCCCGGGACACGTCACCCCTCCACTTT	CASSLDRSRDTSPLHF	TRBV11-2	TRBJ1-6
TGTGCCAGCAGCGTAGGCTGCGGACTTCAGCCCCAGCATTTT	CASSVGCGLQPQHF	TRBV9	TRBJ1-5
TGTGCCAGCAGCTTGGACGGGGACGAGCAGTACTTC	CASSLDGDEQYF	TRBV11-2	TRBJ2-7
TGTGCCAGCATAGGAACCTACGAGCAGTACTTC	CASIGTYEQYF	TRBV6-1	TRBJ2-7
TGTGCCAGCAGCCCGATATGTTGCAATCAGCCCCAGCATTTT	CASSPICCNQPQHF	TRBV7-3	TRBJ1-5
TGTGCCAGCTCACGCCCCGAAAAGGAGGCCTACGAGCAGTACTTC	CASSRPEKEAYEQYF	TRBV18	TRBJ2-7
TGTGCCAGCAGTTCTAAAGGTGAAACAGGTTTAGTCTCCTACGAGCAGTACTTC	CASSSKGETGLVSYEQYF	TRBV27	TRBJ2-7
TGTGCCAGCAGCTCAACTAGCGGGTACCACAATGAGCAGTTCTTC	CASSSTSGYHNEQFF	TRBV5-6	TRBJ2-1
TGTGCCAGCAGTTACGCATCCGATACCTGGTTGGGACAGGGTAGGAGGTGTGATCAGCCCCAGCATTTT	CASSYASDTWLGQGRRCDQPQHF	TRBV6-2	TRBJ1-5
TGTGCCACCATGAACCCCGGACAGCAGGAATTGGTGGGCTACACCTTC	CATMNPGQQELVGYTF	TRBV24-1	TRBJ1-2
TGTGCCAGCAGCTTTGAGGTAGACATCCCTTCTGGAAACACCATATATTTT	CASSFEVDIPSGNTIYF	TRBV7-9	TRBJ1-3
TGTGCCAGCAGCACCAGGGGGTATCAAGAGACCCAGTACTTC	CASSTRGYQETQYF	TRBV7-9	TRBJ2-5
TGCAGTGAGCCGGGACAGGGGGGGAGACGCTCCTACGAGCAGTACTTC	CSEPGQGGRRSYEQYF	TRBV20-1	TRBJ2-7
TGTGCCAGCAGTTACCTCCCGACAGGGCTAAGGGCCTACGAGCAGTACTTC	CASSYLPTGLRAYEQYF	TRBV6-5	TRBJ2-7
TGTGCCAACAGGGAGGGGGTTGAAGCTTTCTTT	CANREGVEAFF	TRBV27	TRBJ1-1
TGTGCCAGCACAAGAAGCGGGAGCCGGTCGTACAATGAGCAGTTCTTC	CASTRSGSRSYNEQFF	TRBV7-8	TRBJ2-1
TGTGCCTGGAGTGTGGACATCGTAGACGAGCAGTACTTC	CAWSVDIVDEQYF	TRBV30	TRBJ2-7
TGTGCCAGCAGTAGGCAGGCGAAACTTGCCGCGAACACCGGGGAGCTGTTTTTT	CASSRQAKLAANTGELFF	TRBV5-4	TRBJ2-2
TGTGCCAGCAACAGCGGCCCTACGTCAGATACGCAGTATTTT	CASNSGPTSDTQYF	TRBV28	TRBJ2-3
TGTGCCAGCAGCGGCCGACAGGGAGCCTACGAGCAGTACTTC	CASSGRQGAYEQYF	TRBV13	TRBJ2-7
TGTGCCCGTCGCCGCGGGAGACGTGGTCAGCCCCAGCATTTT	CARRRGRRGQPQHF	TRBV19	TRBJ1-5
TGCGCCAGCACGGGCATCATTGGAAACACCATATATTTT	CASTGIIGNTIYF	TRBV5-1	TRBJ1-3
TGCGCCAGCAGCCAAAGTGGTACCAGTTCTGGGGCCAACGTCCTGACTTTC	CASSQSGTSSGANVLTF	TRBV4-1	TRBJ2-6
TGTGCCACCCTAAACAGGGGTACTGGAAACACCATATATTTT	CATLNRGTGNTIYF	TRBV24-1	TRBJ1-3
TGTGCCAGCAGCCAAGAACATCCCCCAGGGGACTATGGCTACACCTTC	CASSQEHPPGDYGYTF	TRBV14	TRBJ1-2
TGTGCCAGCAGTTACTCGTGCTACAGAACATTTGAAAAACTGTTTTTT	CASSYSCYRTFEKLFF	TRBV6-5	TRBJ1-4
TGCAGTGCTAGTTATACTAGCGGGAGCCCTCAGCCCCAGCATTTT	CSASYTSGSPQPQHF	TRBV20-1	TRBJ1-5
TGCAGTGCTAGAGATCTGACTGTCTTGGGGCCGGCTGGGGCCAACGTCCTGACTTTC	CSARDLTVLGPAGANVLTF	TRBV20-1	TRBJ2-6
TGTGCCAGCAGTTGGACAGACGAGCAGTACTTC	CASSWTDEQYF	TRBV28	TRBJ2-7
TGTGCCAGCAGCGATGGGCTTACAGCGGGAGGCGCCTACGAGCAGTACTTC	CASSDGLTAGGAYEQYF	TRBV7-3	TRBJ2-7
TGTGCCAGCAGGTGCAGGGAAGCTTTCTTT	CASRCREAFF	TRBV5-6	TRBJ1-1
TGTGCCATCAGTGAGTCGGCCCTAGACTACAATGAGCAGTTCTTC	CAISESALDYNEQFF	TRBV10-3	TRBJ2-1
TGTGCCAGCAGCGCAACCACGCCTACTCAGTTTCATCCGGACACAGATACGCAGTATTTT	CASSATTPTQFHPDTDTQYF	TRBV7-9	TRBJ2-3
TGCGCCAGCAGCCTTATACCCGGCAATCAGCCCCAGCATTTT	CASSLIPGNQPQHF	TRBV4-1	TRBJ1-5
TGTGCCAGCAGCTTGGACCCGTTAGGGGGGGTATTCAATGAGCAGTTCTTC	CASSLDPLGGVFNEQFF	TRBV5-6	TRBJ2-1
TGCGCCAGCAATGGGGAGGCGGGCATTCAGTACTTC	CASNGEAGIQYF	TRBV10-1	TRBJ2-4
TGCAGTGCCTCCAACATCCTCCGGGCAAAGGGGGCCTCCTACGAGCAGTACTTC	CSASNILRAKGASYEQYF	TRBV20-1	TRBJ2-7
TGTGCCAGCAGCGATACCGGGGGGGGCTCTAGCACAGATACGCAGTATTTT	CASSDTGGGSSTDTQYF	TRBV5-8	TRBJ2-3
TGTGCCATCGCAGAGCCCTACGAGCAGTACTTC	CAIAEPYEQYF	TRBV10-3	TRBJ2-7
TGTGCCAGCAGGTACAGGACAGGTTGCATCGAAAAACTGTTTTTT	CASRYRTGCIEKLFF	TRBV6-2	TRBJ1-4
TGTGCTAGTGGTTTGGGGGAGGGCGGTACCCACGAGCAGTACTTC	CASGLGEGGTHEQYF	TRBV12-5	TRBJ2-7
TGTGCCAGCACGATGAGGGGCGGACTGGGCGAGTACTTC	CASTMRGGLGEYF	TRBV18	TRBJ2-7
TGTGCCAGCACCGCTAGCGGGTATTACAATGAGCAGTTCTTC	CASTASGYYNEQFF	TRBV7-2	TRBJ2-1
TGTGCCAGCAGCGTGGGCACTGAAGCTTTCTTT	CASSVGTEAFF	TRBV7-3	TRBJ1-1
TGCAGTGCTTTGGACAGGGAAGAAACCTACGAGCAGTACTTC	CSALDREETYEQYF	TRBV20-1	TRBJ2-7
TGTGCCAGCAGCGTAGACGATCAGGACAGGGGACCGGGTACCAATCAGCCCCAGCATTTT	CASSVDDQDRGPGTNQPQHF	TRBV9	TRBJ1-5
TGTGCCAGCCAGGGGCCATACAATGAGCAGTTCTTC	CASQGPYNEQFF	TRBV7-9	TRBJ2-1
TGCAGCGTTGAAGATGACACAGTGATTCAGCCCCAGCATTTT	CSVEDDTVIQPQHF	TRBV29-1	TRBJ1-5
TGCAGTGCTAGAGATCCGGGGCGGTACACCACTGAAGCTTTCTTT	CSARDPGRYTTEAFF	TRBV20-1	TRBJ1-1
TGTGCCACCAGCAGAGACGGTCTGGTACAGGGCGGAGGAGGAGATACGCAGTATTTT	CATSRDGLVQGGGGDTQYF	TRBV15	TRBJ2-3
TGTGCCAGCAGTGTATACAACGACGGGGGGGGTGAAGCTTTCTTT	CASSVYNDGGGEAFF	TRBV6-1	TRBJ1-1
TGCAGTGCTCCCCAATCCCAAAAGGGGGGGCGGGGACAAGAGACCCAGTACTTC	CSAPQSQKGGRGQETQYF	TRBV20-1	TRBJ2-5
TGTGCCAGCAGCTCGATGGACGAGCAGTACTTC	CASSSMDEQYF	TRBV7-7	TRBJ2-7
TGTGCTAGCAGCCCGGGACAGGGGGACAATCAGCCCCAGCATTTT	CASSPGQGDNQPQHF	TRBV7-7	TRBJ1-5
TGTGCCAGCAGGACAGATGATCAGCCCCAGCATTTT	CASRTDDQPQHF	TRBV7-4	TRBJ1-5
TGCGCCAGCAGCTTGGGGGGACTAGCGGGGGCTCCCGGCCAAGAGACCCAGTACTTC	CASSLGGLAGAPGQETQYF	TRBV5-1	TRBJ2-5
TGTGCCAGCAGTGAATTCGAGTGGGTGCGGGAGCTGTTAAGGGAAAGCTCCTACAATGAGCAGTTCTTC	CASSEFEWVRELLRESSYNEQFF	TRBV25-1	TRBJ2-1
TGCGCCAGCGGGACAATATACTACGAGCAGTACTTC	CASGTIYYEQYF	TRBV4-1	TRBJ2-7
TGTGCCAGCAGCTTAGCAGTGAGGGGACAGGATTCTGGCTACACCTTC	CASSLAVRGQDSGYTF	TRBV11-3	TRBJ1-2
TGTGCCAGCAGTAACACCAAGGGACTGCTCTTT	CASSNTKGLLF	TRBV12-3	TRBJ1-1
TGTGCCAGCAGCCAAGGGACAGGGGAAACCTACGAGCAGTACTTC	CASSQGTGETYEQYF	TRBV14	TRBJ2-7
TGTGCCAGTAGTATAGCTGGGGGGAATGAGCAGTTCTTC	CASSIAGGNEQFF	TRBV19	TRBJ2-1
TGTGCCAGCAGTTGGGACAGGGTCACAGATACGCAGTATTTT	CASSWDRVTDTQYF	TRBV27	TRBJ2-3
TGTGCCAGCAATGGGGGGCTAGCAGAGACCCAGTACTTC	CASNGGLAETQYF	TRBV6-4	TRBJ2-5
TGTGCTAGTGGTTTGTTCCCACCGGGACAGGGAGAGAATCGCAACTATGGCTACACCTTC	CASGLFPPGQGENRNYGYTF	TRBV12-5	TRBJ1-2
TGTGCCACCAGTGATGAGAGTGAAAAACTGTTTTTT	CATSDESEKLFF	TRBV24-1	TRBJ1-4
TGTGCCAGCAGTTTCCCAGGGGTCCCTATTATACTAGCGGGAGGGTCCTACAATGAGCAGTTCTTC	CASSFPGVPIILAGGSYNEQFF	TRBV27	TRBJ2-1
TGTGCCAGCAGTTTTCACAGAAGGATTGAGACCCAGTACTTC	CASSFHRRIETQYF	TRBV27	TRBJ2-5
TGTGCCACCAGTGACCTTGCCCCGGGACAGCACTTATTCAGGTGGAGAGATACGCAGTATTTT	CATSDLAPGQHLFRWRDTQYF	TRBV24-1	TRBJ2-3
TGTGCCAGCATTGACAGGGCATTGCACCTGAACACTGAAGCTTTCTTT	CASIDRALHLNTEAFF	TRBV13	TRBJ1-1
TGTGCCACCAAAAGTGTTCTTGGACTGGGATTCGACATGAACACTGAAGCTTTCTTT	CATKSVLGLGFDMNTEAFF	TRBV24-1	TRBJ1-1
TGCAGTGCTCCCGGCCCAGGGGGGAACACTGAAGCTTTCTTT	CSAPGPGGNTEAFF	TRBV20-1	TRBJ1-1
TGTGCCAGCAGCCATCCCTTGACCTACGAGCAGTACTTC	CASSHPLTYEQYF	TRBV3-1	TRBJ2-7
TGCGCCAGCAGCTTGCGGGACCTACTCTCCAATGAGCAGTTCTTC	CASSLRDLLSNEQFF	TRBV5-1	TRBJ2-1
TGCGCCAGCAGCTCCGGCCCGTTCCCAGGGGAGGAAGAGACCCAGTACTTC	CASSSGPFPGEEETQYF	TRBV5-1	TRBJ2-5
TGTGCCAGCAGCGGGACTCGGGGGGGGCGTCAGCCCCAGCATTTT	CASSGTRGGRQPQHF	TRBV9	TRBJ1-5
TGTGCCAGCAGTTACGCGACAGGGGGCTATCAGCCCCAGCATTTT	CASSYATGGYQPQHF	TRBV6-6	TRBJ1-5
TGTGCCAGCAGCGTTTATGTGAGTCAATACAATGAGCAGTTCTTC	CASSVYVSQYNEQFF	TRBV13	TRBJ2-1
TGCGCCAGCAGCTTGGGGCGGACGATCAGCTACAATGAGCAGTTCTTC	CASSLGRTISYNEQFF	TRBV5-1	TRBJ2-1
TGTGCCAGCAGTTCACAAAAACGAATTCCCGGGACTAGCGCGTTCAGGAGGTACGAGCAGTACTTC	CASSSQKRIPGTSAFRRYEQYF	TRBV6-5	TRBJ2-7
TGTGCCAGCAGGGACAGGGGGCTTCTTGCCAACTTCTTT	CASRDRGLLANFF	TRBV27	TRBJ1-1
TGCGCCAGCAGCTACAATATTATATTAGGGGGCTCCAATTCACCCCTCCACTTT	CASSYNIILGGSNSPLHF	TRBV5-1	TRBJ1-6
TGTGCCAGCAGTGGGACGTGGGAAGAGACCCAGTACTTC	CASSGTWEETQYF	TRBV14	TRBJ2-5
TGTGCCTACCAGGGGTACAATGAGCAGTTCTTC	CAYQGYNEQFF	TRBV7-3	TRBJ2-1
TGTGCCAGCTTGCGTGGGGGCGAATCGAATGAAAAACTGTTTTTT	CASLRGGESNEKLFF	TRBV3-1	TRBJ1-4
TGTGCCAGCAGCCTGTCCAAGGGGCGGAGGGGTAGCTGGAACACTGAAGCTTTCTTT	CASSLSKGRRGSWNTEAFF	TRBV9	TRBJ1-1
TGCGCCAGCAGCGCGTACGGACTAGCGCCCCAAGAGACCCAGTACTTC	CASSAYGLAPQETQYF	TRBV5-1	TRBJ2-5
TGTGCCAGCAGTGAAATAAGGGCTGTGACTAGGGAAGAGACCCAGTACTTC	CASSEIRAVTREETQYF	TRBV6-1	TRBJ2-5
TGTGCCAGCACAGGGACTGAGCCCGGCTATGGCTACACCTTC	CASTGTEPGYGYTF	TRBV12-3	TRBJ1-2
TGTGCCAGCAGCTGCCCACAGGGGTTAGTGCAGTTCTTC	CASSCPQGLVQFF	TRBV7-9	TRBJ2-1
TGTGCCAGCCGCGGGAGGAGGTACTTC	CASRGRRYF	TRBV6-2	TRBJ2-7
TGTGCCACCAGTGATCCTACTAGCGGGAGGGCGTCCCGACCCAATAGGTATCAGCCCCAGCATTTT	CATSDPTSGRASRPNRYQPQHF	TRBV24-1	TRBJ1-5
TGTGCCAGCAGCTTTTCGGGGGGCACCGAGGGCTCCTACAATGAGCAGTTCTTC	CASSFSGGTEGSYNEQFF	TRBV5-4	TRBJ2-1
TGTGCCAGCCGTACTAATACCTACGAGCAGTACTTC	CASRTNTYEQYF	TRBV4-2	TRBJ2-7
TGTGCCAGCAGCCTGAGGGGGGGGACAGATACGCAGTATTTT	CASSLRGGTDTQYF	TRBV7-9	TRBJ2-3
TGTGCCAGCAGCTTCACGAAAGGGCGGGGCTACGAGCAGTACTTC	CASSFTKGRGYEQYF	TRBV7-3	TRBJ2-7
TGTGCCAGCAGCCAAGAGCTGCAGGGGTGGTCCTTGCCCCAGCATTTT	CASSQELQGWSLPQHF	TRBV14	TRBJ1-5
TGTGCCAGCAGTGAAGGTCTAGCGGGCCCTAATGAGCAGTTCTTC	CASSEGLAGPNEQFF	TRBV6-1	TRBJ2-1
TGTGCCAGCAGTTTTGGAGCCGGACAGGAAAAACTGTTTTTT	CASSFGAGQEKLFF	TRBV27	TRBJ1-4
TGCAGTGCTAGAGATGGAACAGATAGCAATCAGCCCCAGCATTTT	CSARDGTDSNQPQHF	TRBV20-1	TRBJ1-5
TGCAGTGCGGGCCTCGTCCGTTTGATACGAAGGTACAATGAGCAGTTCTTC	CSAGLVRLIRRYNEQFF	TRBV20-1	TRBJ2-1
TGTGCCAAGACTTGGGACACTGAAGCTTTCTTT	CAKTWDTEAFF	TRBV28	TRBJ1-1
TGCGCCAGCAGCCAGGCGAAACGGGTCGGGAGGTCCATTCAGTACTTC	CASSQAKRVGRSIQYF	TRBV5-1	TRBJ2-4
TGTGCCAGCATCGAGCAGGGGAGAGTCTACGAGCAGTACTTC	CASIEQGRVYEQYF	TRBV12-3	TRBJ2-7
TGTGCCAGCAGTTTACCGGGACTAGCGTACGAGCAGTACTTC	CASSLPGLAYEQYF	TRBV27	TRBJ2-7
TGTGCCAGCTCTCGAGGGGGGGAGCAGTACTTC	CASSRGGEQYF	TRBV11-2	TRBJ2-7
TGTGCCAGCAGCTTAGATAAGCCAGGGATCGAGCCCCAGCATTTT	CASSLDKPGIEPQHF	TRBV11-2	TRBJ1-5
TGTGCCAGTAGTATGAGAGCCCCGGGACTAGAGTTCAATAGCACAGATACGCAGTATTTT	CASSMRAPGLEFNSTDTQYF	TRBV19	TRBJ2-3
TGTGCCAGCAGCGATATCCCGGGACAGGAGGCAAGCTCCTACGAGCAGTACTTC	CASSDIPGQEASSYEQYF	TRBV9	TRBJ2-7
TGCGCCAGCACTACGGCGCCCGGGACTAGGAACAGCAAAAACATTCAGTACTTC	CASTTAPGTRNSKNIQYF	TRBV5-1	TRBJ2-4
TGCGCCAGCAGCCGTCAGGGACTAGCGGGATCCTCGAGCCGAAACCGCTCCCAGTACAATGAGCAGTTCTTC	CASSRQGLAGSSSRNRSQYNEQFF	TRBV4-1	TRBJ2-1
TGTGCCAAGTTTGGGGCGGCCGGGGAGCTGTTTTTT	CAKFGAAGELFF	TRBV6-2	TRBJ2-2
TGTGCCAGCAGCCCACACAGGGGACACACCGGGGAGCTGTTTTTT	CASSPHRGHTGELFF	TRBV7-7	TRBJ2-2
TGCAGTGCAACCGGGACAGAGGCAACTAATGAAAAACTGTTTTTT	CSATGTEATNEKLFF	TRBV20-1	TRBJ1-4
TGTGCCAGCAGCTCGGACAGGGGAAGAGCTAACTATGGCTACACCTTC	CASSSDRGRANYGYTF	TRBV11-3	TRBJ1-2
TGTGCCAGCGTAGGGCTAGGGACTTATGAGCAGTTCTTC	CASVGLGTYEQFF	TRBV27	TRBJ2-1
TGTGCCAGCAGCTCTCCCCACAGTAAAAACTATGGCTACACCTTC	CASSSPHSKNYGYTF	TRBV13	TRBJ1-2
TGTGCCAGCAGCACCACTACGTCACCCCTCCACTTT	CASSTTTSPLHF	TRBV7-9	TRBJ1-6
TGTGCCAGCAGCCTCCTAAGTAGGGGACATACCTGGCATTTT	CASSLLSRGHTWHF	TRBV13	TRBJ1-5
TGTGCCAGCAGTTTATCACATCAGGGGTGGAGGCGCTCCTACGAGCAGTACTTC	CASSLSHQGWRRSYEQYF	TRBV27	TRBJ2-7
TGTGCCAGCAGCTTACAGGGCCAGGGGATCGGGATGTATAGCAATCAGCCCCAGCATTTT	CASSLQGQGIGMYSNQPQHF	TRBV7-9	TRBJ1-5
TGTGCCAGTGATTTTTCAGCCGAGACCCAGTACTTC	CASDFSAETQYF	TRBV19	TRBJ2-5
TGTGCCAGCAGCCAGATGTCCCGGACTAGCGGGGTGGCCACAGATACGCAGTATTTT	CASSQMSRTSGVATDTQYF	TRBV3-1	TRBJ2-3
TGTGCCAGCAGACCGGACATCTATGGCTACACCTTC	CASRPDIYGYTF	TRBV6-4	TRBJ1-2
TGCAGTGCTGCGAGCGTGGCGCGGAATGAGCAGTTCTTC	CSAASVARNEQFF	TRBV20-1	TRBJ2-1
TGTGCCAGCAGACCTGACAGGAGCAATCAGCCCCAGCATTTT	CASRPDRSNQPQHF	TRBV12-4	TRBJ1-5
TGCGCCAGGGATGGGGAAGGTCAGCCCCAGCATTTT	CARDGEGQPQHF	TRBV5-1	TRBJ1-5
TGTGCCAGCAGTTTGAGAGATGCTTACAATGAGCAGTTCTTC	CASSLRDAYNEQFF	TRBV6-5	TRBJ2-1
TGTGCCAGCAGCTTAGGACCAGAAGGGGACTATGGCTACACCTTC	CASSLGPEGDYGYTF	TRBV11-2	TRBJ1-2
TGCAGTGCTAGAGCCTCAGGCGGCACAGATACGCAGTATTTT	CSARASGGTDTQYF	TRBV20-1	TRBJ2-3
TGTGCCAGCAGCAAGGGAACGACTGAAGCTTTCTTT	CASSKGTTEAFF	TRBV7-3	TRBJ1-1
TGTGCCAGCAGCCACACAGGGGGGGGTGAAAAACTGTTTTTT	CASSHTGGGEKLFF	TRBV7-9	TRBJ1-4
TGTGCCAGCTCTTGGCGGGAGAAGACCTACGAGCAGTACTTC	CASSWREKTYEQYF	TRBV9	TRBJ2-7
TGCAGCGTTCCTAGCGGACGGGATACGCAGTATTTT	CSVPSGRDTQYF	TRBV29-1	TRBJ2-3
TGTGCCAGCAGCTTGGCAGAATCCCAGTACTTC	CASSLAESQYF	TRBV5-6	TRBJ2-5
TGTGCCAGCAGCCAAGATCCTAGGGCGGAAGCCTACGAGCAGTACTTC	CASSQDPRAEAYEQYF	TRBV14	TRBJ2-7
TGTGCCAGCAGCGCGTGGGACAGGGGCTCGCAGCCCCAGCATTTT	CASSAWDRGSQPQHF	TRBV9	TRBJ1-5
TGCAGCGTTGTAAGTCTAGCGGCCACCGGGGAGCTGTTTTTT	CSVVSLAATGELFF	TRBV29-1	TRBJ2-2
TGTGCCAGCAGCCAAGAACCCGCCAGGATCCCGCCCTTC	CASSQEPARIPPF	TRBV4-2	TRBJ1-2
TGCGCCAGCAGCCAAGATACCAGGGGCCGCAATCAGCCCCAGCATTTT	CASSQDTRGRNQPQHF	TRBV4-3	TRBJ1-5
TGTGCCAGCAGCTTAGACGTGGCAGGATTGGACGAGCAGTACTTC	CASSLDVAGLDEQYF	TRBV7-9	TRBJ2-7
TGTGCCAGCAGTACGAATCCGACAGGGGCTAGCACAGATACGCAGTATTTT	CASSTNPTGASTDTQYF	TRBV12-3	TRBJ2-3
TGCAGTGCTAGAGATCATGTCATATGGCCGGGACAGCCCCAGCATTTT	CSARDHVIWPGQPQHF	TRBV20-1	TRBJ1-5
TGTGCCAGCACCGGACAGGGCCGAGAGACCCAGTACTTC	CASTGQGRETQYF	TRBV27	TRBJ2-5
TGTGCCAGCAGCTTACGAGAAGAACGGGGAAGGGCCCGAGATACGCAGTATTTT	CASSLREERGRARDTQYF	TRBV7-9	TRBJ2-3
TGTGCCAGCAGCCTCTGGGGTCGTCCCATTTACAATGAGCAGTTCTTC	CASSLWGRPIYNEQFF	TRBV3-1	TRBJ2-1
TGTGCCAGCAGCCAAGATCTAAAGGGGACGAAGATTTCAGATACGCAGTATTTT	CASSQDLKGTKISDTQYF	TRBV4-2	TRBJ2-3
TGTGCCACTAAACAACAGGGAAAAACTGAAGCTTTCTTT	CATKQQGKTEAFF	TRBV27	TRBJ1-1
TGTGCCAGCAGCTTATGGGCCGGGACTAGCGGGAGCGGAGGAGGTGGTTCCAATCAGCCCCAGCATTTT	CASSLWAGTSGSGGGGSNQPQHF	TRBV11-3	TRBJ1-5
TGTGCCAGCAGTTACGGTAGGGAGGATTTCGGAAACACCATATATTTT	CASSYGREDFGNTIYF	TRBV6-6	TRBJ1-3
TGTGCCAGCAGTTTCCTACCTGGGGGGGGCTATGGCTACACCTTC	CASSFLPGGGYGYTF	TRBV28	TRBJ1-2
TGCTGGGAGGGGAATGTACAAGAGACCCAGTACTTC	CWEGNVQETQYF	TRBV20-1	TRBJ2-5
TGTGCCAGCAGCAATTCAATCCGGGGCCGAGCCTATGGCTACACCTTC	CASSNSIRGRAYGYTF	TRBV13	TRBJ1-2
TGTGCGAAGCGGGACCACAATGAGCAGTTCTTC	CAKRDHNEQFF	TRBV12-5	TRBJ2-1
TGTGCCAGCAGTGAATTGACAGGGGGAGGGGCAGCTGGGGCCAACGTCCTGACTTTC	CASSELTGGGAAGANVLTF	TRBV25-1	TRBJ2-6
TGCAGTGCTAGGACCTACGAGCAGTACTTC	CSARTYEQYF	TRBV20-1	TRBJ2-7
TGTGCCAGCAGTCAGTTGCCAGGGACCTATGGCTACACCTTC	CASSQLPGTYGYTF	TRBV6-4	TRBJ1-2
TGCGCCAGCAGCCAAGGTGTGGAGAGCTCCTACGAGCAGTACTTC	CASSQGVESSYEQYF	TRBV4-3	TRBJ2-7
TGTGCCAGCAGCCATCGGGTTACGGACAGAAACTGCTACGAGCAGTACTTC	CASSHRVTDRNCYEQYF	TRBV3-1	TRBJ2-7
TGTGCCAGCAGCGTGGCGGGACTAGCGGGTTGCCCCTACGAGCAGTACTTC	CASSVAGLAGCPYEQYF	TRBV9	TRBJ2-7
TGTGCCAGCAGCCCGGGGGTAGACCTTAGAATACCCCTCCACTTT	CASSPGVDLRIPLHF	TRBV12-4	TRBJ1-6
TGTGCCAGCAGCTTACCATCCTCCAGACAGGAACCAGAGACCCAGTACTTC	CASSLPSSRQEPETQYF	TRBV7-9	TRBJ2-5
TGTGCCAGCGACCCCCAGGGTTCACCCCTCCACTTT	CASDPQGSPLHF	TRBV6-4	TRBJ1-6
TGTGCCAGCAGTGAGGGCGCGGTTATTGGCTACACCTTC	CASSEGAVIGYTF	TRBV7-3	TRBJ1-2
TGTGCCAGCAGCTTGGTGGGAGGACGATACTTCCCGTACAATGAGCAGTTCTTC	CASSLVGGRYFPYNEQFF	TRBV5-6	TRBJ2-1
TGCGCCAGCAGCCAAGAACGTGGTTACCCTGGGGGGGGCTACACCTTC	CASSQERGYPGGGYTF	TRBV4-3	TRBJ1-2
TGCAGTGCAACCCTGGGTAAGTTGGGCGAAGAGACCCAGTACTTC	CSATLGKLGEETQYF	TRBV20-1	TRBJ2-5
TGTGCCAGCACCTCCGGGGGGACCGGGGAGCTGTTTTTT	CASTSGGTGELFF	TRBV6-3	TRBJ2-2
TGTGCCAGCAGCCGGTGGGAGCCCCCCCGCAATCAGCCCCAGCATTTT	CASSRWEPPRNQPQHF	TRBV5-6	TRBJ1-5
TGTGCCAGCAGCCAAGACGCTTCAGACCGGAACTATGGCTACACCTTC	CASSQDASDRNYGYTF	TRBV3-1	TRBJ1-2
TGCGCCAGCAAGCTGGAGGTTACAGATACGCAGTATTTT	CASKLEVTDTQYF	TRBV5-1	TRBJ2-3
TGTGCCAGCAGTCTCCGTGGACAGTGGGTATATTCCTACGAGCAGTACTTC	CASSLRGQWVYSYEQYF	TRBV7-3	TRBJ2-7
TGTGCCAGCACAGCGGAGACCCAGTACTTC	CASTAETQYF	TRBV6-4	TRBJ2-5
TGTGCCAGCAGTTTATCGTACACCGAGGAACCATATCTCTCTGGAAACACCATATATTTT	CASSLSYTEEPYLSGNTIYF	TRBV27	TRBJ1-3
TGTGCCAGCAGCTTATCCAATGAGGGACAGGGTGACCGTCAGCCCCAGCATTTT	CASSLSNEGQGDRQPQHF	TRBV7-9	TRBJ1-5
TGTGCCAGCAGTTACTTGTCTGGGTGGCTAGCCCATGAGCAGTTCTTC	CASSYLSGWLAHEQFF	TRBV6-5	TRBJ2-1
TGTGCCACCTTGGTCGCGGCCCCCGGCTATGGCTACACCTTC	CATLVAAPGYGYTF	TRBV24-1	TRBJ1-2
TGTGCCAGCAGTTTTCATACTAGCGGGGGGGACAATGAGCAGTTCTTC	CASSFHTSGGDNEQFF	TRBV7-3	TRBJ2-1
TGCAGTGCAAGAGGGCCATCAAAGGGACAGGGGGGCACCGGGGAGCTGTTTTTT	CSARGPSKGQGGTGELFF	TRBV20-1	TRBJ2-2
TGCGCCAGGTTGACAGGGGGGGAAAAACTGTTTTTT	CARLTGGEKLFF	TRBV10-1	TRBJ1-4
TGCAGTGCGCGACTAGCGGGCCATAACTACGAGCAGTACTTC	CSARLAGHNYEQYF	TRBV20-1	TRBJ2-7
TGTGCCAGCAGTGACGACCGGACAGGGAGCACCGGGGAGCTGTTTTTT	CASSDDRTGSTGELFF	TRBV6-4	TRBJ2-2
TGTGCCACCAGCAGAGATTGCTCAGAGGGACAAGATACGCAGTATTTT	CATSRDCSEGQDTQYF	TRBV15	TRBJ2-3
TGCGCCAGCGGCGGGGCCGCCGGGACAGGAGAGGAATGCAATCAGCCCCAGCATTTT	CASGGAAGTGEECNQPQHF	TRBV4-1	TRBJ1-5
TGCGCCAGCACCTCCAGGGGGAATGTGAATGAAAAACTGTTTTTT	CASTSRGNVNEKLFF	TRBV10-1	TRBJ1-4
TGTGCCAGTAGTATCGGGCCCGATCTCAGGGGGAACACCGGGGAGCTGTTTTTT	CASSIGPDLRGNTGELFF	TRBV19	TRBJ2-2
TGTGCTAGTGGTTTGGTACCCGGGGAGAGGGTGAAGAATGAGCAGTTCTTC	CASGLVPGERVKNEQFF	TRBV12-5	TRBJ2-1
TGTGCCAGCAGTGGGGGGGAGACCCAGTACTTC	CASSGGETQYF	TRBV6-6	TRBJ2-5
TGTGCCAGCAGTTTCCTCAGGACGAAAAACACTGAAGCTTTCTTT	CASSFLRTKNTEAFF	TRBV28	TRBJ1-1
TGTGCCAGTCCTCCGGGACTAGCGGGGGGGCGGTACAATGAGCAGTTCTTC	CASPPGLAGGRYNEQFF	TRBV28	TRBJ2-1
TGTGCCAGCAGCTCTCTGGCCCGGAGGTGTCGACTAGGCTCCTACGAGCAGTACTTC	CASSSLARRCRLGSYEQYF	TRBV9	TRBJ2-7
TGTGCCAGCAGTATAGAGAGGACAGGGGGAGATAGCAATCAGCCCCAGCATTTT	CASSIERTGGDSNQPQHF	TRBV7-3	TRBJ1-5
TGTGCCAGCAGCGTCTCCCCGGGAGGCCATGGCTACACCTTC	CASSVSPGGHGYTF	TRBV9	TRBJ1-2
TGTGCCAGCAGCGTGCGTCACTGGTTTACTAGCGGGAGTATGGAGGCCAAAAACATTCAGTACTTC	CASSVRHWFTSGSMEAKNIQYF	TRBV13	TRBJ2-4
TGTGCCAGCAGTCTAAGGTTGACGATGAACACTGAAGCTTTCTTT	CASSLRLTMNTEAFF	TRBV27	TRBJ1-1
TGTGCCAGCAGGGTTAGGGGGACTAGCGAGGGTACCGAGGCTCCGGTTATGGGCATGTATGAGCAGTTCTTC	CASRVRGTSEGTEAPVMGMYEQFF	TRBV2	TRBJ2-1
TGCAGTGCTAGAGAGAGGCTAGGACTAGCGGGGGGAGAGACCCAGTACTTC	CSARERLGLAGGETQYF	TRBV20-1	TRBJ2-5
TGTGCCAGCAGCTTAGACAGGGTGGCGGGCAATCAGCCCCAGCATTTT	CASSLDRVAGNQPQHF	TRBV11-2	TRBJ1-5
TGCAGTGGGATAGCCTGGGAGCAAGAGACCCAGTACTTC	CSGIAWEQETQYF	TRBV20-1	TRBJ2-5
TGTGCCAGCAGGGCGGAGCGGGAACCAGATACGCAGTATTTT	CASRAEREPDTQYF	TRBV6-4	TRBJ2-3
TGTGCCAGCAGCTTAGTTCAGGGTAACACCGGGGAGCTGTTTTTT	CASSLVQGNTGELFF	TRBV7-9	TRBJ2-2
TGTGCCAGCAGCGTTGAGGGACTAGCGGGCACAGATACGCAGTATTTT	CASSVEGLAGTDTQYF	TRBV28	TRBJ2-3
TGTGCCAGCAGCATCCGGGACAGGGTTGCTTTCTTT	CASSIRDRVAFF	TRBV11-3	TRBJ1-1
TGCAGTGCTAGAGAGGGGTCTTTGACAGGCACCGGGGAGCTGTTTTTT	CSAREGSLTGTGELFF	TRBV20-1	TRBJ2-2
TGCGCCAGCAGCTCTACGTTGGAGACCCAGTACTTC	CASSSTLETQYF	TRBV5-1	TRBJ2-5
TGTGCCAGCAGCTGGGCCACCCCCAGCTCCTACGAGCAGTACTTC	CASSWATPSSYEQYF	TRBV14	TRBJ2-7
TGTGCCAGCAGCAGGTATGAACGGGGCAGACAAGAGACCCAGTACTTC	CASSRYERGRQETQYF	TRBV9	TRBJ2-5
TGCGCCAGCAGCCAAGATCTAACAGTGACTTATGGCTACACCTTC	CASSQDLTVTYGYTF	TRBV4-1	TRBJ1-2
TGTGCCAGCAGTGATTATCGGGGTGGGGCCGACACTGAAGCTTTCTTT	CASSDYRGGADTEAFF	TRBV6-1	TRBJ1-1
TGTGCCATCAGTGCAACCTTAAGGAGAAGCACAGATACGCAGTATTTT	CAISATLRRSTDTQYF	TRBV10-3	TRBJ2-3
TGTGCCAGCAGCCAAGATGCAAGACTAGCACACGGAGAGGGCACAGATACGCAGTATTTT	CASSQDARLAHGEGTDTQYF	TRBV3-1	TRBJ2-3
TGCGCCAGCATTGACAGGACTCTCAAAGGCTACACCTTC	CASIDRTLKGYTF	TRBV4-1	TRBJ1-2
TGTGCCAGCTATCCACTGGACAGCTCCTACGAGCAGTACTTC	CASYPLDSSYEQYF	TRBV5-4	TRBJ2-7
TGTGCCACCAGCTGGGTACCCGTTGGTAGCATTACCATGGTAGAGACCCAGTACTTC	CATSWVPVGSITMVETQYF	TRBV24-1	TRBJ2-5
TGCAGTGCTAGCAGTCCGGGGCGTTCCTTTCGCCATTCACCCCTCCACTTT	CSASSPGRSFRHSPLHF	TRBV20-1	TRBJ1-6
TGTGCCAGCAGCTTAGGTACCCCCAAGAAGCTAGCCAAAAACATTCAGTACTTC	CASSLGTPKKLAKNIQYF	TRBV7-9	TRBJ2-4
TGTGCCAGCAGCTTATCTCAGACAGTCGTCGGTGTATGCTATGGCTACACCTTC	CASSLSQTVVGVCYGYTF	TRBV7-3	TRBJ1-2
TGCAGCGTTGAAGGGGACAGGGCGGTTGAAGCTTTCTTT	CSVEGDRAVEAFF	TRBV29-1	TRBJ1-1
TGCAGTCCGACAGGGACCGGGGAGCTGTTTTTT	CSPTGTGELFF	TRBV20-1	TRBJ2-2
TGTGCCAGCAGTTCGCGGACAAGGGGGCAAAAACTGTTTTTT	CASSSRTRGQKLFF	TRBV6-3	TRBJ1-4
TGCGCCAGCAGCTCACCCGACAGGGGCGGACTGGGCTACACCTTC	CASSSPDRGGLGYTF	TRBV5-1	TRBJ1-2
TGTGCCAGCAGTCCTCGCAATCAGCCCCAGCATTTT	CASSPRNQPQHF	TRBV6-1	TRBJ1-5
TGTGCCAGCAGCCATCCGACTAGGTTAACTGATACGCAGTATTTT	CASSHPTRLTDTQYF	TRBV14	TRBJ2-3
TGTGCCAGCAAGGGGCCTTGGACTAAAGAGACCCAGTACTTC	CASKGPWTKETQYF	TRBV12-4	TRBJ2-5
TGTGCCAGCAGTGACTCCGACAGGGGTGATCCACGCTACGAGCAGTACTTC	CASSDSDRGDPRYEQYF	TRBV6-4	TRBJ2-7
TGTGCCAGCAGCCCTCCAGGGTTTTTCTACGAGCAGTACTTC	CASSPPGFFYEQYF	TRBV27	TRBJ2-7
TGTGCCAGCAGAGCGGGGGGGGACCAAGAGACCCAGTACTTC	CASRAGGDQETQYF	TRBV9	TRBJ2-5
TGTGCCAGCAGCCCCGCGGTACATTCACCCCTCCACTTT	CASSPAVHSPLHF	TRBV7-3	TRBJ1-6
TGTGCCAGCAGTGAATCAACTAGCGGGTATGAGCAGTTCTTC	CASSESTSGYEQFF	TRBV25-1	TRBJ2-1
TGCAGTGCTCGTGGGACAGGGGCCAAAAACATTCAGTACTTC	CSARGTGAKNIQYF	TRBV20-1	TRBJ2-4
TGTGCCACCAGCATCCCTGGACTAGCGGGGTACAATGAGCAGTTCTTC	CATSIPGLAGYNEQFF	TRBV15	TRBJ2-1
TGTGCCAGCAGCTGGGGGCGAGGCTACACCTTC	CASSWGRGYTF	TRBV7-2	TRBJ1-2
TGCGCCAGCACTCGCCTAGCGGGCGAGCAGTACTTC	CASTRLAGEQYF	TRBV5-1	TRBJ2-7
TGTGCCAGCAGCTTAAATAAAATCCAGCGGGGACGTGTCTACGAGCAGTACTTC	CASSLNKIQRGRVYEQYF	TRBV5-4	TRBJ2-7
TGTGCCAGCAGTTACGGGGTCCGGGCGGAGCCCCAGCATTTT	CASSYGVRAEPQHF	TRBV6-2	TRBJ1-5
TGTGCCAGCAGCTTAGAGTCCCTAAATGGACAGGGGGGACTCGAGCAGTACTTC	CASSLESLNGQGGLEQYF	TRBV11-2	TRBJ2-7
TGCAGCGTAAGTCAGGGAGGAATTCCACCCGCCAGTTTCAGTCGCCCTAATTCACCCCTCCACTTT	CSVSQGGIPPASFSRPNSPLHF	TRBV29-1	TRBJ1-6
TGTGCCAGCGAGGACCCTACCCTGCTAGCCAAAAACATTCAGTACTTC	CASEDPTLLAKNIQYF	TRBV14	TRBJ2-4
TGTGCCAGTAGTAGTTACCTCAGGGGAATTTATGGCTACACCTTC	CASSSYLRGIYGYTF	TRBV19	TRBJ1-2
TGTGCCAGCAGTTTTCCCCAGGGGGCTTCGAACACCGGGGAGCTGTTTTTT	CASSFPQGASNTGELFF	TRBV28	TRBJ2-2
TGTGCCAGCAGCGCCTCGGGGGGGGCTCGGTACGAGCAGTACTTC	CASSASGGARYEQYF	TRBV7-3	TRBJ2-7
TGTGCCAGCAGCGTATATAACCGCTCCTACAATGAGCAGTTCTTC	CASSVYNRSYNEQFF	TRBV9	TRBJ2-1
TGTGGGGACAGGAGGTTTGGTAGCAATCAGCCCCAGCATTTT	CGDRRFGSNQPQHF	TRBV30	TRBJ1-5
TGTGCCAGCAGCCTATGGGGTACAAAGATCACTGAAGCTTTCTTT	CASSLWGTKITEAFF	TRBV5-6	TRBJ1-1
TGTGCCAGCAGCCTGTGTCAAGGACAGGGGGGGGGGCCGAATCAGCCCCAGCATTTT	CASSLCQGQGGGPNQPQHF	TRBV13	TRBJ1-5
TGTGCCAGCAGCTATCCAGGGGGACATAACATTCAGTACTTC	CASSYPGGHNIQYF	TRBV11-3	TRBJ2-4
TGTGCCAGCAGCCAGGGGGACGGAGAGACCCAGTACTTC	CASSQGDGETQYF	TRBV13	TRBJ2-5
TGTGCCAGCAGACCCGTACGACTAGCGGGGGACGAGCAGTACTTC	CASRPVRLAGDEQYF	TRBV6-3	TRBJ2-7
TGTGCCAGCCTTGGACAGCTTGCTGGCTACACCTTC	CASLGQLAGYTF	TRBV4-2	TRBJ1-2
TGCAGTGACAGGGTTCCCATGGCGGTGAATTCACCCCTCCACTTT	CSDRVPMAVNSPLHF	TRBV20-1	TRBJ1-6
TGTGCCAGCAGTTACAGATTTCCCTACGAGCAGTACTTC	CASSYRFPYEQYF	TRBV6-2	TRBJ2-7
TGTGCCAGCAGTGATCTGGTTCAAACTGAAGCTTTCTTT	CASSDLVQTEAFF	TRBV6-1	TRBJ1-1
TGTGCCAGCAGCCAAGATCCAGGACAGGGACACAACGGTATCCACTACGAGCAGTACTTC	CASSQDPGQGHNGIHYEQYF	TRBV14	TRBJ2-7
TGTGCCAGCAGCACACAGCCCCAGCATTTT	CASSTQPQHF	TRBV7-3	TRBJ1-5
TGTGCCAGCAGCGCCAATCTCAGGGGTTGTCCCTACGAGCAGTACTTC	CASSANLRGCPYEQYF	TRBV5-4	TRBJ2-7
TGTGCCAGCAGTCCTCCGGGACAGGTCTATGGCTACACCTTC	CASSPPGQVYGYTF	TRBV2	TRBJ1-2
TGTGCCAGCAGTCCGATTAAAGGGGTAGAATCCGGTGGCTACACCTTC	CASSPIKGVESGGYTF	TRBV6-5	TRBJ1-2
TGTGCCAGCAGCACCTACAAGGGGACAGATACGCAGTATTTT	CASSTYKGTDTQYF	TRBV3-1	TRBJ2-3
TGTGCCAGCAGCTCCCCGGACCAAACCAATGAGCAGTTCTTC	CASSSPDQTNEQFF	TRBV7-2	TRBJ2-1
TGTGCCAGCAGAAAAGTAGGGGGGGGCAAGAACACTGAAGCTTTCTTT	CASRKVGGGKNTEAFF	TRBV6-8	TRBJ1-1
TGTGCCTGGAAAGGGGCGGGGAACACTGAAGCTTTCTTT	CAWKGAGNTEAFF	TRBV30	TRBJ1-1
TGTGCCAGCAGTCCGGGCCGGGGCACCGGGGAGCTGTTTTTT	CASSPGRGTGELFF	TRBV6-1	TRBJ2-2
TGTGCCAGCAGTGATGGGACTAGCGGGAGGGATTTCTATGGCTACACCTTC	CASSDGTSGRDFYGYTF	TRBV6-1	TRBJ1-2
TGTGCCAGCAGTTACGGCTGCGGACAGAGTGGCTTCAGAATCTACGAGCAGTACTTC	CASSYGCGQSGFRIYEQYF	TRBV27	TRBJ2-7
TGCAGCAAGGCTAGCGGGGACACCGGGGAGCTGTTTTTT	CSKASGDTGELFF	TRBV29-1	TRBJ2-2
TGTGCCGGGGACAGGGGGAATCAGCCCCAGCATTTT	CAGDRGNQPQHF	TRBV24-1	TRBJ1-5
TGCAGTGCTAGAGATCGGAAAGGGTTTAGCACAGATACGCAGTATTTT	CSARDRKGFSTDTQYF	TRBV20-1	TRBJ2-3
TGTGCCAGCAGTTCGGGACGGAACACCGGGGAGCTGTTTTTT	CASSSGRNTGELFF	TRBV6-6	TRBJ2-2
TGTGCCAGCAGCAAAAGAAAGCGAGTATATAATTCACCCCTCCACTTT	CASSKRKRVYNSPLHF	TRBV13	TRBJ1-6
TGTGCCAGCAGCCCAGGGGGCATGAACACTGAAGCTTTCTTT	CASSPGGMNTEAFF	TRBV5-6	TRBJ1-1
TGTGCCAGCAGCTTACGGGAATCGTGGGGAGCGATGAGATGCTACGAGCAGTACTTC	CASSLRESWGAMRCYEQYF	TRBV7-6	TRBJ2-7
TGTGCCAGCAGCGTATTCCCCCTGGGCCAGGGAAAGGGACATTACGAAAAACTGTTTTTT	CASSVFPLGQGKGHYEKLFF	TRBV9	TRBJ1-4
TGTGCCAGCAGCTTAGCGGGGGTGGAGACCCAGTACTTC	CASSLAGVETQYF	TRBV9	TRBJ2-5
TGTGCCAGCAGCACAGGGGGGACAGATACGCAGTATTTT	CASSTGGTDTQYF	TRBV13	TRBJ2-3
TGTGCCATCAGTGAGCCCGTCGGCCGGCTCAATTCCTACGAGCAGTACTTC	CAISEPVGRLNSYEQYF	TRBV10-3	TRBJ2-7
TGTGCCAGCAGTTTATCGGAGTCGGGCTACACCTTC	CASSLSESGYTF	TRBV12-3	TRBJ1-2
TGTGCCACCAGCAGAGAGGTGCGGGAGCGGGGTGCCTACGAGCAGTACTTC	CATSREVRERGAYEQYF	TRBV15	TRBJ2-7
TGTGCCAGCAGCTTAGTAATGACAGGTCCCCTCCACTTT	CASSLVMTGPLHF	TRBV7-9	TRBJ1-6
TGTGCCACCAGTGATAGGGGTTTAGACGGAGCGGGACCGAACACTGAAGCTTTCTTT	CATSDRGLDGAGPNTEAFF	TRBV24-1	TRBJ1-1
TGTGCCAGCCCAGGGCAGTATGGCTACACCTTC	CASPGQYGYTF	TRBV7-3	TRBJ1-2
TGTGCCAGCAGCACAAGTTCATGGTACACCTTC	CASSTSSWYTF	TRBV6-6	TRBJ1-2
TGTGCCAGGGACAGGGCTTCCTACGAGCAGTACTTC	CARDRASYEQYF	TRBV19	TRBJ2-7
TGTGCCAGCAGCCCAGGGAAAGTACTTGAAGCTTTCTTT	CASSPGKVLEAFF	TRBV11-2	TRBJ1-1
TGCAGCTTCACAGGCTTGTCCTCCTACGAGCAGTACTTC	CSFTGLSSYEQYF	TRBV29-1	TRBJ2-7
TGTGCCAGCAGGGGACTAGCGGTCTACGAGCAGTACTTC	CASRGLAVYEQYF	TRBV28	TRBJ2-7
TGCGCCAGCAGTGAGCTGGAGGACGAGAGTGAAAAACTGTTTTTT	CASSELEDESEKLFF	TRBV10-1	TRBJ1-4
TGCGCCAGCAGCATTGAGGGTTCTAACTATGGCTACACCTTC	CASSIEGSNYGYTF	TRBV5-1	TRBJ1-2
TGTGCCAGCAGCTTAATGGGGTGGGCCTATAATTCACCCCTCCACTTT	CASSLMGWAYNSPLHF	TRBV7-3	TRBJ1-6
TGTGCCAGCAGCGAGGGTACAGGGAGGAATCAGCCCCAGCATTTT	CASSEGTGRNQPQHF	TRBV9	TRBJ1-5
TGCAGCGTTGTCGGACTGGGACAGAACTATGGCTACACCTTC	CSVVGLGQNYGYTF	TRBV29-1	TRBJ1-2
TGTGCCAGCAGTCTCCCCCCTCAGGACCCCGAGCAGTTCTTC	CASSLPPQDPEQFF	TRBV11-2	TRBJ2-1
TGTGCCAGCAGCTTCGCCTACGAGCAGTACTTC	CASSFAYEQYF	TRBV7-6	TRBJ2-7
TGTGCCAGCAGTTTCGCGAAGGACAGGGGGACAGGGCTCACTGAAGCTTTCTTT	CASSFAKDRGTGLTEAFF	TRBV27	TRBJ1-1
TGCAGCGTTTGGACTAGCGGTCCATCCTCCTACGAGCAGTACTTC	CSVWTSGPSSYEQYF	TRBV29-1	TRBJ2-7
TGTGCCAGCAGTTACAAGGAGGCGTCCACAGATACGCAGTATTTT	CASSYKEASTDTQYF	TRBV6-6	TRBJ2-3
TGCGCCAGCAGAAGACAGATAAAGGCCTCTGGAAACACCATATATTTT	CASRRQIKASGNTIYF	TRBV10-1	TRBJ1-3
TGTGCCAGCAGCTCAGGAGACAACACTGAAGCTTTCTTT	CASSSGDNTEAFF	TRBV11-3	TRBJ1-1
TGTGCCAGCAGCTTAGGTCTAGCGGGGTACCAGTACTTC	CASSLGLAGYQYF	TRBV11-2	TRBJ2-5
TGTGCCAGCATGGGGCCCGTAGAGACCCAGTACTTC	CASMGPVETQYF	TRBV28	TRBJ2-5
TGTGCCACTCGGACTTGGGGGGAAAAACTGTTTTTT	CATRTWGEKLFF	TRBV24-1	TRBJ1-4
TGTGCCAGCAGCTCCGTCCAGTATGGACTCACTGAAGCTTTCTTT	CASSSVQYGLTEAFF	TRBV13	TRBJ1-1
TGTGCCAGCAGCCCCAACGGGAATCAGCCCCAGCATTTT	CASSPNGNQPQHF	TRBV7-2	TRBJ1-5
TGTGCCAGCGGAAGCGGGGACAGGGGATACAATCAGCCCCAGCATTTT	CASGSGDRGYNQPQHF	TRBV6-6	TRBJ1-5
TGCGCCAGCAGTGACGAGAGGGGGCAAGCAGATACGCAGTATTTT	CASSDERGQADTQYF	TRBV10-1	TRBJ2-3
TGCAGCGTTGCCACCGGACTAGCTTTAAATGAGCAGTTCTTC	CSVATGLALNEQFF	TRBV29-1	TRBJ2-1
TGTGCCAGCAGCTGCCCGCTAAAGGACGGGGGCTATAATTCACCCCTCCACTTT	CASSCPLKDGGYNSPLHF	TRBV7-3	TRBJ1-6
TGTGCCAGCAGCTCTAGGGGCAGCAATCAGCCCCAGCATTTT	CASSSRGSNQPQHF	TRBV7-9	TRBJ1-5
TGTGCCAGCAGTGACTATACTCGGAGGCACCCCTCCTATAATTCACCCCTCCACTTT	CASSDYTRRHPSYNSPLHF	TRBV6-4	TRBJ1-6
TGTGCCAGCAGCCCGGGACAGGGCGGGGGGGGAGCCAAAAACATTCAGTACTTC	CASSPGQGGGGAKNIQYF	TRBV11-2	TRBJ2-4
TGTGCCAGCAGCTCCTCGACTAGCGGGGACACAGATACGCAGTATTTT	CASSSSTSGDTDTQYF	TRBV7-9	TRBJ2-3
TGTGCCAGCAGCCGGACAAGGCACTATGGCTACACCTTC	CASSRTRHYGYTF	TRBV7-3	TRBJ1-2
TGTGCCAGCAGTCGCGTCATTGGGGGCGAGCAGTACTTC	CASSRVIGGEQYF	TRBV28	TRBJ2-7
TGTGCCAGCAGCGCTGGACAGGGGTGCCACTATGGCTACACCTTC	CASSAGQGCHYGYTF	TRBV7-9	TRBJ1-2
TGTGCCAGCAGCTGGACAGGGGAATTCAAGTCACCCCTCCACTTT	CASSWTGEFKSPLHF	TRBV5-4	TRBJ1-6
TGTGCCACCAGTGAGGAGACAGGACAGGATACGCAGTATTTT	CATSEETGQDTQYF	TRBV24-1	TRBJ2-3
TGTGCCAGCAGCCGACAGGGAAACATTCAGTACTTC	CASSRQGNIQYF	TRBV5-4	TRBJ2-4
TGTGCCAGCAGTTACCTTCAGAGGTCCTACAATGAGCAGTTCTTC	CASSYLQRSYNEQFF	TRBV6-5	TRBJ2-1
TGTGCCACCAGTGATTGGGAGAAGGAAAATCAGCCCCAGCATTTT	CATSDWEKENQPQHF	TRBV24-1	TRBJ1-5
TGTGCCAGTAGATATTCCTCCCTGACGGGGGGGCGGAACACTGAAGCTTTCTTT	CASRYSSLTGGRNTEAFF	TRBV19	TRBJ1-1
TGTGCCAGCATCGAACCGGCGGGTAGCAATCAGCCCCAGCATTTT	CASIEPAGSNQPQHF	TRBV6-2	TRBJ1-5
TGTGCCAGCACAACAGGGGAGGAGGGCTACGAGCAGTACTTC	CASTTGEEGYEQYF	TRBV14	TRBJ2-7
TGTGCCAGCAGCTTAGTGAGAAGGGACAGGGGGCGGCCAGAGACCCAGTACTTC	CASSLVRRDRGRPETQYF	TRBV13	TRBJ2-5
TGTGCCAGCAGCGAGAGGGGCGCCGGGGAGCTGTTTTTT	CASSERGAGELFF	TRBV9	TRBJ2-2
TGCGCCAGCAGCTTTATGGGGGGTGCAACTAATGAAAAACTGTTTTTT	CASSFMGGATNEKLFF	TRBV5-1	TRBJ1-4
TGTGCCAAATCGGCCACCAGATTTAACCAAGAGACCCAGTACTTC	CAKSATRFNQETQYF	TRBV11-3	TRBJ2-5
TGTGCCAGCAGCAAAGGTCTAGCGGGCTTAGAGACCCAGTACTTC	CASSKGLAGLETQYF	TRBV14	TRBJ2-5
TGTGCCAGCCCGGGGGGGCCGGACACTGAAGCTTTCTTT	CASPGGPDTEAFF	TRBV6-5	TRBJ1-1
TGTGCCAGCAGGGGGGCCTCCTATAATTCACCCCTCCACTTT	CASRGASYNSPLHF	TRBV27	TRBJ1-6
TGTGCTAGTGGTTTGAGATCACAAGGTCCAGATACGCAGTATTTT	CASGLRSQGPDTQYF	TRBV12-5	TRBJ2-3
TGCGCCAGCAGCTCCCGGGGCCTTCGGATGAACACTGAAGCTTTCTTT	CASSSRGLRMNTEAFF	TRBV5-1	TRBJ1-1
TGTGCCATCCTGACACTGGGCGATGAGACCCAGTACTTC	CAILTLGDETQYF	TRBV10-3	TRBJ2-5
TGTGCCTCCCCGGGCCGGGGCTACACCTTC	CASPGRGYTF	TRBV7-8	TRBJ1-2
TGTGCCAGCAGCTCCCACGACAGGGGGCCTTTTAGCAATCAGCCCCAGCATTTT	CASSSHDRGPFSNQPQHF	TRBV5-6	TRBJ1-5
TGTGCCAGCGCGGGACTAGCGAAAGTCTCCTACGAGCAGTACTTC	CASAGLAKVSYEQYF	TRBV28	TRBJ2-7
TGCAGTGTCGGGGATAGACACAATGAGCAGTTCTTC	CSVGDRHNEQFF	TRBV20-1	TRBJ2-1
TGCAGTGCTCGCGGGCTGCGGAAGAACACTGAAGCTTTCTTT	CSARGLRKNTEAFF	TRBV20-1	TRBJ1-1
TGTGCCAGCAGCATGGAGGCTGCTGGGGCTCCAGAGACCCAGTACTTC	CASSMEAAGAPETQYF	TRBV7-9	TRBJ2-5
TGTGCCAGCAGCTCGGAGGGGAATGAGCAGTTCTTC	CASSSEGNEQFF	TRBV7-9	TRBJ2-1
TGTGCCAGCAGCGCGGTCGGGGCCGGGGAGCTGTTTTTT	CASSAVGAGELFF	TRBV5-6	TRBJ2-2
TGCAGTGCTAGCGCGGGGGCTTTCTTT	CSASAGAFF	TRBV20-1	TRBJ1-1
TGTGCCAGCAGTGAAGATATTAACGGGTTGGAGAGGGCAGACAATGAGCAGTTCTTC	CASSEDINGLERADNEQFF	TRBV6-1	TRBJ2-1
TGTGCTAGTGGTTTGCCCCAGGGATTTGGCTACACCTTC	CASGLPQGFGYTF	TRBV12-5	TRBJ1-2
TGCGCCAGTGGGCCCAAACTACAGCCTGGTATACTCTATGGCTACACCTTC	CASGPKLQPGILYGYTF	TRBV10-1	TRBJ1-2
TGCGCCAGCAGCTTCTGGTCCGGGACTAGCGGGGGGGCGAAGGTCTACGAGCAGTACTTC	CASSFWSGTSGGAKVYEQYF	TRBV5-1	TRBJ2-7
TGTGCCAGCAGTTACTCGCCCTCTTACGAGCAGTACTTC	CASSYSPSYEQYF	TRBV6-5	TRBJ2-7
TGTGCCAGTAGTGAGAAGATGGCGAGTGAAGCTTTCTTT	CASSEKMASEAFF	TRBV19	TRBJ1-1
TGTGCCAGCAGGCTAGGACCAGATCCGGGCGGTGGAAACACCATATATTTT	CASRLGPDPGGGNTIYF	TRBV12-4	TRBJ1-3
TGTGCCAGCAGTGAGGGGGTTTACTATGGCTACACCTTC	CASSEGVYYGYTF	TRBV28	TRBJ1-2
TGCGCCAGCAGTGAGGAAGGCAGGGGCTACGAGCAGTACTTC	CASSEEGRGYEQYF	TRBV10-1	TRBJ2-7
TGTGCCTGGCGAAGGGGTGTTGTGACCGGGAACACCGGGGAGCTGTTTTTT	CAWRRGVVTGNTGELFF	TRBV30	TRBJ2-2
TGTGCCAGCAGCTTGGTACCCTGGGGTTTTGCTGAAGCTTTCTTT	CASSLVPWGFAEAFF	TRBV5-4	TRBJ1-1
TGCGCCAGCAGCTGGACATATTTCGAGCAGTACTTC	CASSWTYFEQYF	TRBV5-1	TRBJ2-7
TGTGCCAGCAGCTTATCCCTAGGGACAGGGGGGACTTACGAGCAGTACTTC	CASSLSLGTGGTYEQYF	TRBV7-6	TRBJ2-7
TGCAGTGCTTTTACGAATTCACCCCTCCACTTT	CSAFTNSPLHF	TRBV20-1	TRBJ1-6
TGCGCCAGCAGGCTGGGGAGGGACAGCAATCAGCCCCAGCATTTT	CASRLGRDSNQPQHF	TRBV10-1	TRBJ1-5
TGCGCCAGCAGCCAGTTACAGGGGGGTTACTCTGGAAACACCATATATTTT	CASSQLQGGYSGNTIYF	TRBV4-3	TRBJ1-3
TGTGCCAGCAGCTTAGCGGGATGGGGATCATACGACGGTGGCTACACCTTC	CASSLAGWGSYDGGYTF	TRBV7-9	TRBJ1-2
TGCAGTGCTAGAGCCCTAATTATCACCGGGGAGCTGTTTTTT	CSARALIITGELFF	TRBV20-1	TRBJ2-2
TGTGCCAGCAGTTACAGTTCCAAGTATCACATTCAGTACTTC	CASSYSSKYHIQYF	TRBV6-2	TRBJ2-4
TGTGCCAGCAGCGTACAGACAGGGGCTCTCTTC	CASSVQTGALF	TRBV7-3	TRBJ1-2
TGTGCCAGCCTCCTATACGAGCAGTACTTC	CASLLYEQYF	TRBV6-4	TRBJ2-7
TGTGCCAGCAGTTATACGGGGAACGGGGACAGTAAAATTGATCAGCCCCAGCATTTT	CASSYTGNGDSKIDQPQHF	TRBV6-3	TRBJ1-5
TGTGCCAGCAGCCAAGACCGACTAGCGGGTGGCTCCTACAATGAGCAGTTCTTC	CASSQDRLAGGSYNEQFF	TRBV14	TRBJ2-1
TGTGCCACCAGGGTTATAGGGTCAAAAGAGACCCAGTACTTC	CATRVIGSKETQYF	TRBV24-1	TRBJ2-5
TGTGCCAGCAGTTTTTTCACAGGGCCCACGAGTGTGTACGAGCAGTACTTC	CASSFFTGPTSVYEQYF	TRBV12-4	TRBJ2-7
TGTGCGCACCCGCAGGGTACGCTCTACGAGCAGTACTTC	CAHPQGTLYEQYF	TRBV11-3	TRBJ2-7
TGTGGGGACACCAGACAGGGTGCCTATGGCTACACCTTC	CGDTRQGAYGYTF	TRBV27	TRBJ1-2
TGTGCCAGCAGTCGACAGCAGTATGAGCAGTTCTTC	CASSRQQYEQFF	TRBV12-3	TRBJ2-1
TGTGCCAGCAGAAAATCCCGCACGTACTGCAGCTATAATTCACCCCTCCACTTT	CASRKSRTYCSYNSPLHF	TRBV3-1	TRBJ1-6
TGTGCCAGCAGTGTGAGGAAGACACACAATGAGCAGTTCTTC	CASSVRKTHNEQFF	TRBV11-3	TRBJ2-1
TGTGCCTGGAGTCGGGAGTTGGTTTACACCGGGGAGCTGTTTTTT	CAWSRELVYTGELFF	TRBV30	TRBJ2-2
TGTGCCAGCAGTTTCCAGGGGCGCATGAACACTGAAGCTTTCTTT	CASSFQGRMNTEAFF	TRBV27	TRBJ1-1
TGTGCCAGCAGCCAAGGCTCGGGACAGTTTGGCTACACCTTC	CASSQGSGQFGYTF	TRBV3-1	TRBJ1-2
TGTGCCAGCAGCTTTAAAACAGGGGGAAACACCATATATTTT	CASSFKTGGNTIYF	TRBV7-9	TRBJ1-3
TGTGCCAGCACGGCACTAGCGGGAGGTAATGAGCAGTTCTTC	CASTALAGGNEQFF	TRBV9	TRBJ2-1
TGCAGTGCTAATGAACCCTACGAGCAGTACTTC	CSANEPYEQYF	TRBV20-1	TRBJ2-7
TGCGCCAGCAGCCCAGACGGCGAGAGCGGCTACGAGCAGTACTTC	CASSPDGESGYEQYF	TRBV4-1	TRBJ2-7
TGTGCCAGCAGCTACCTTGTTAGGGGCTGTAGCCCCTCGGACACCGGGGAGCTGTTTTTT	CASSYLVRGCSPSDTGELFF	TRBV7-3	TRBJ2-2
TGTGCCAGCAGCCCACCTCTAACTGAAGCTTTCTTT	CASSPPLTEAFF	TRBV9	TRBJ1-1
TGTGCCAGCGGGTTCCGACAGGGTACCTCTGGAAACACCATATATTTT	CASGFRQGTSGNTIYF	TRBV2	TRBJ1-3
TGTGCCAGCAGCACCGCGGTAGCTAACCTCACCGGGGAGCTGTTTTTT	CASSTAVANLTGELFF	TRBV5-6	TRBJ2-2
TGTGCCAGCAGGGGAGGACAGTATGGAGCCACTGAAGCTTTCTTT	CASRGGQYGATEAFF	TRBV6-3	TRBJ1-1
TGTGCCAGCAGCTGGCTGGGAGGCTACACCTTC	CASSWLGGYTF	TRBV7-3	TRBJ1-2
TGCGCCAGGCGGGGGAACGAGCAGTACTTC	CARRGNEQYF	TRBV4-1	TRBJ2-7
TGTGCCAGCAGTTTGCCTCCCAGAGAGCTAGACGAGCAGTACTTC	CASSLPPRELDEQYF	TRBV27	TRBJ2-7
TGCAGCGTTGGTGGGGGTCACAGGGGAAACACCGGGGAGCTGTTTTTT	CSVGGGHRGNTGELFF	TRBV29-1	TRBJ2-2
TGTGCCAGCAGCTCAGGGGTTAGGATACGCTACGAGCAGTACTTC	CASSSGVRIRYEQYF	TRBV5-6	TRBJ2-7
TGTGCCAGCACAGAAAAACTAGCGGGGGCAGATACGCAGTATTTT	CASTEKLAGADTQYF	TRBV7-3	TRBJ2-3
TGTGCCAGAGGACAGCCCCAGCATTTT	CARGQPQHF	TRBV6-6	TRBJ1-5
TGTGCCAGCAGCTCCTTATCTAATCCCGAACGCTACAATGAGCAGTTCTTC	CASSSLSNPERYNEQFF	TRBV5-6	TRBJ2-1
TGTGCCACCAGTGATTTGGGCCGCGGAGAGCAAGAGACCCAGTACTTC	CATSDLGRGEQETQYF	TRBV24-1	TRBJ2-5
TGTGCCATCAGTGCCCCTAGCGGGCCTCACTACAATGAGCAGTTCTTC	CAISAPSGPHYNEQFF	TRBV10-3	TRBJ2-1
TGTGCCAGCAGCTCGACAGAAATATATAGCAATCAGCCCCAGCATTTT	CASSSTEIYSNQPQHF	TRBV7-3	TRBJ1-5
TGTGCCAGCAGCGGCAGCACGAACACTGAAGCTTTCTTT	CASSGSTNTEAFF	TRBV9	TRBJ1-1
TGTGCCAGCAGCTTAGTTCAATCATCGACAGGCGAGCAGTACTTC	CASSLVQSSTGEQYF	TRBV7-9	TRBJ2-7
TGTGCCAGCACCCCGTACAGGGGGCTTTTCGGCAACTACGAGCAGTACTTC	CASTPYRGLFGNYEQYF	TRBV27	TRBJ2-7
TGTGCCAGCAGCAGGGGCCAGGTCCTTGTAGAGACCCAGTACTTC	CASSRGQVLVETQYF	TRBV7-4	TRBJ2-5
TGCAGCGCGGTAAACGGGGACCTATATCAGCCCCAGCATTTT	CSAVNGDLYQPQHF	TRBV29-1	TRBJ1-5
TGTGCCAGGGGGCGTATAGGAGGAGGATCCAATGAGCAGTTCTTC	CARGRIGGGSNEQFF	TRBV11-2	TRBJ2-1
TGCAGTGCTTCGGGTCCCCCAGATACGCAGTATTTT	CSASGPPDTQYF	TRBV20-1	TRBJ2-3
TGTGCCAGCAGCCAAGAAACCCCGGGATTAAAGAACACTGAAGCTTTCTTT	CASSQETPGLKNTEAFF	TRBV14	TRBJ1-1
TGTGCTAGTGGTGAAGAGGGGGGCTTGAACACCGGGGAGCTGTTTTTT	CASGEEGGLNTGELFF	TRBV12-5	TRBJ2-2
TGCGCCAGCAGCCCGGCATACAAGGCCAAAAACATTCAGTACTTC	CASSPAYKAKNIQYF	TRBV10-1	TRBJ2-4
TGTGCCAGCAGGGTACTCTCGCAGCCCCAGCATTTT	CASRVLSQPQHF	TRBV6-3	TRBJ1-5
TGTGCCAGCAGGGGGACAGGTGATGGCTACACCTTC	CASRGTGDGYTF	TRBV11-2	TRBJ1-2
TGCGCCAGCAGCGGGGAACAGGGGAGGGGCTACACCTTC	CASSGEQGRGYTF	TRBV5-1	TRBJ1-2
TGTGCCAGCTCCCTAAGGGGTCCTTCCGGGGAGCTGTTTTTT	CASSLRGPSGELFF	TRBV27	TRBJ2-2
TGTGCCAGCAGTGAATCCGGACCTGAGGGACAGTCGAATTCACCCCTCCACTTT	CASSESGPEGQSNSPLHF	TRBV25-1	TRBJ1-6
TGTGCCAGCAGTGACCAAGAGGGACTCTGGATTGAGGACTCTAACTATGGCTACACCTTC	CASSDQEGLWIEDSNYGYTF	TRBV6-4	TRBJ1-2
TGTGCCAGCAGTCCCCCCCGGGGGCTAGGCTACACCTTC	CASSPPRGLGYTF	TRBV6-4	TRBJ1-2
TGTGCCAGCAGCTTGGAACAGGGAAACCAGACTGAAGCTTTCTTT	CASSLEQGNQTEAFF	TRBV5-6	TRBJ1-1
TGTGCCAGCAGAAGGCTCAAATCGGATTTCTCCTACGAGCAGTACTTC	CASRRLKSDFSYEQYF	TRBV6-1	TRBJ2-7
TGTGCCAGCTCACCAGCAGGGCGTAGTCTCCTATATAGCAATCAGCCCCAGCATTTT	CASSPAGRSLLYSNQPQHF	TRBV18	TRBJ1-5
TGTGCCATCAGTCCAAGGGGGCGGTGTCTCTTC	CAISPRGRCLF	TRBV10-3	TRBJ2-1
TGTGCCAGCAGCCTCCCGACAGGCCAGACCGGATGGACTGAAGCTTTCTTT	CASSLPTGQTGWTEAFF	TRBV7-3	TRBJ1-1
TGTGCCAGCAGCATCCCATGGTTAGGGGAAGGTTACGAGCAGTACTTC	CASSIPWLGEGYEQYF	TRBV7-3	TRBJ2-7
TGTGCCAGCACTTCCGTATTGGGGAACTATGGCTACACCTTC	CASTSVLGNYGYTF	TRBV25-1	TRBJ1-2
TGTGCCCTAGCGGGTGCTAGCACAGATACGCAGTATTTT	CALAGASTDTQYF	TRBV30	TRBJ2-3
TGTGCCACCAGTTCGAGGGTGGGAAAAGAGTTTAACAATGAGCAGTTCTTC	CATSSRVGKEFNNEQFF	TRBV24-1	TRBJ2-1
TGCGCCAGCAGCCAAGGTTTCGGACCCGGGATACCATTCTCCTACGAGCAGTACTTC	CASSQGFGPGIPFSYEQYF	TRBV4-3	TRBJ2-7
TGTGCCAGCAGTTGGGACAGGGGTTGGGATTCACCCCTCCACTTT	CASSWDRGWDSPLHF	TRBV12-4	TRBJ1-6
TGTGCCAGCAGCCACGGGCGGGACAGTGCCTATGGCTACACCTTC	CASSHGRDSAYGYTF	TRBV14	TRBJ1-2
TGTGCCAGCAGTGGAACTACATCCCAATCCTACGAGCAGTACTTC	CASSGTTSQSYEQYF	TRBV12-3	TRBJ2-7
TGTGCCAGCAAGGACGAGCAGTACTTC	CASKDEQYF	TRBV28	TRBJ2-7
TGCGCCAGCAGCTTGAATACGCTAGCAGATACGCAGTATTTT	CASSLNTLADTQYF	TRBV5-1	TRBJ2-3
TGTGCCACCACCCTTAGCGGGTTTTTCGAGACCCAGTACTTC	CATTLSGFFETQYF	TRBV24-1	TRBJ2-5
TGTGCCAGCAGTTACGTAACCGGACTAGCCCGCACCGGGGAGCTGTTTTTT	CASSYVTGLARTGELFF	TRBV6-6	TRBJ2-2
TGTGCCAGCAGCCAAGCTCAGAGACAGGGTCAAGCTAGAAGCAATCAGCCCCAGCATTTT	CASSQAQRQGQARSNQPQHF	TRBV14	TRBJ1-5
TGTGCCAGCTCACCGGTGGGCAGAAGGAGCACAGATACGCAGTATTTT	CASSPVGRRSTDTQYF	TRBV18	TRBJ2-3
TGTGCCAGCAGTTTACACTACCCTGGGACAGGGGTAGGTCCAAAACAGCCCCAGCATTTT	CASSLHYPGTGVGPKQPQHF	TRBV27	TRBJ1-5
TGCAGTGCTAGCAGGGGTAGCTACACTGAAGCTTTCTTT	CSASRGSYTEAFF	TRBV20-1	TRBJ1-1
TGTGCCAGTACCTCCCCACCCAGACTAGCGGGGGGGAATTTCTCCTACGAGCAGTACTTC	CASTSPPRLAGGNFSYEQYF	TRBV6-5	TRBJ2-7
TGTGCCAGCAGCGCGACCCCAGGGCAGACCCAGTACTTC	CASSATPGQTQYF	TRBV13	TRBJ2-5
TGTGCCAGCAGCCAAGTGGGGGACAGGGGAGCTTTCTATGGCTACACCTTC	CASSQVGDRGAFYGYTF	TRBV14	TRBJ1-2
TGTGCCAGCACGCCTACAGGGGAACAGAACACTGAAGCTTTCTTT	CASTPTGEQNTEAFF	TRBV4-2	TRBJ1-1
TGTGCCAGCAGCTTACTACTGACAGGATTGTCACCCCTCCACTTT	CASSLLLTGLSPLHF	TRBV7-6	TRBJ1-6
TGTGCCAGCAGCTTAGACCTAGCGACTAGCGGGCAAGGTTACGAGCAGTACTTC	CASSLDLATSGQGYEQYF	TRBV11-3	TRBJ2-7
TGTGCCAGCACAAGAGTTCAGGGCTGCACGCAGTATTTT	CASTRVQGCTQYF	TRBV6-4	TRBJ2-3
TGTGCCAGCAGCCAAGATCCGGCCCGATATCGAACCAGCTCCTACGAGCAGTACTTC	CASSQDPARYRTSSYEQYF	TRBV14	TRBJ2-7
TGTGCCAGCAGTGTGGGACAGGGCCTAGATGGCTACACCTTC	CASSVGQGLDGYTF	TRBV6-1	TRBJ1-2
TGTGCCAGGGCCACGGGTCAGTACGAGCAGTACTTC	CARATGQYEQYF	TRBV11-3	TRBJ2-7
TGTGCCAGCAAGAAGTTCAATTGGCGAGAACAGGGGGGGCAGAAAGGATTTTATAGCAATCAGCCCCAGCATTTT	CASKKFNWREQGGQKGFYSNQPQHF	TRBV6-4	TRBJ1-5
TGTGCCAGCCTACCGGACAATTCTTCCTACAATGAGCAGTTCTTC	CASLPDNSSYNEQFF	TRBV9	TRBJ2-1
TGTGCCAGCAGGGTCAAAAGAGATGGCTACACCTTC	CASRVKRDGYTF	TRBV27	TRBJ1-2
TGTGCCAGCTCAGGGGGCCAAGGGCTAATAGCGGGGGAAACAGATACGCAGTATTTT	CASSGGQGLIAGETDTQYF	TRBV24-1	TRBJ2-3
TGCGCCAGCACCGACAGGAGATGCTACGAGCAGTACTTC	CASTDRRCYEQYF	TRBV10-2	TRBJ2-7
TGTGCCAGCAGCGCCAACGGGACTAGTTACGAGCAGTACTTC	CASSANGTSYEQYF	TRBV7-9	TRBJ2-7
TGTGCCAGCAGCTTGGCCCGCACCAGGGTGCTATGGCTGAACACCGGGGAGCTGTTTTTT	CASSLARTRVLWLNTGELFF	TRBV5-5	TRBJ2-2
TGTGCCAGCAGCTCTACGACAGGGGGCTACGAGCAGTACTTC	CASSSTTGGYEQYF	TRBV5-8	TRBJ2-7
TGTGCCACAAGACTAGCGGGAGGGAAGGCTGAAGCTTTCTTT	CATRLAGGKAEAFF	TRBV14	TRBJ1-1
TGCGCCAGCAGCCGGCCAGGGGGCGGGACTAACTATGGCTACACCTTC	CASSRPGGGTNYGYTF	TRBV10-2	TRBJ1-2
TGTGCCACCAGTGATTTGAGTTCCAGCTGGTTTTGGTCTCATAATTCACCCCTCCACTTT	CATSDLSSSWFWSHNSPLHF	TRBV24-1	TRBJ1-6
TGTGCCAGCAGCCCCGCCCGACCCAGGACTGAAGCTTTCTTT	CASSPARPRTEAFF	TRBV11-2	TRBJ1-1
TGCGCCAGCAGGACGACCAATCAGCCCCAGCATTTT	CASRTTNQPQHF	TRBV4-1	TRBJ1-5
TGTGCCAGCAGTGACCGACCTTTGACCTACGAGCAGTACTTC	CASSDRPLTYEQYF	TRBV2	TRBJ2-7
TGCGCCAGCAGCCAAGCCGGACAGGCCGGGTACGAGCAGTACTTC	CASSQAGQAGYEQYF	TRBV4-1	TRBJ2-7
TGTGCCAGCAGCACCTGGGGGAACACTGAAGCTTTCTTT	CASSTWGNTEAFF	TRBV9	TRBJ1-1
TGTGCCAGCAGAGACCCCAGGACTGGGGCCAACGTCCTGACTTTC	CASRDPRTGANVLTF	TRBV27	TRBJ2-6
TGTGCCAGCAGCTTAAGGACCGACCTCTACGAGCAGTACTTC	CASSLRTDLYEQYF	TRBV7-3	TRBJ2-7
TGTGCCAGCAGCAAGGACAGGGCCGCTCCACTACAGTACTTC	CASSKDRAAPLQYF	TRBV7-2	TRBJ2-4
TGTGCCAGCAGCTGGGGTCACAGGGTGAACACTGAAGCTTTCTTT	CASSWGHRVNTEAFF	TRBV11-3	TRBJ1-1
TGCAGCGTTGATCAACAGGGCGGTTACGAGCAGTACTTC	CSVDQQGGYEQYF	TRBV29-1	TRBJ2-7
TGCGCCAGCAGCTTGGCCTCCCCGCTAAGAACCGGGGAGCTGTTTTTT	CASSLASPLRTGELFF	TRBV5-1	TRBJ2-2
TGCAGTGCTAGAGATCTGGGCTTTGCTTGGGCCAAAAACATTCAGTACTTC	CSARDLGFAWAKNIQYF	TRBV20-1	TRBJ2-4
TGCGCCAGCAGCCAAGATTACCGGACAGGGTCGAACACTGAAGCTTTCTTT	CASSQDYRTGSNTEAFF	TRBV4-3	TRBJ1-1
TGTGCCAGTAGATACAGGGGGCCGGTAGCCAAAAACATTCAGTACTTC	CASRYRGPVAKNIQYF	TRBV19	TRBJ2-4
TGCAGTGCTTACGAGCTGGTCGGTCAAGAGACCCAGTACTTC	CSAYELVGQETQYF	TRBV20-1	TRBJ2-5
TGTGCCAGCATTCGGTGGTCTTCGGGGGAACAAGCCGAGACCCAGTACTTC	CASIRWSSGEQAETQYF	TRBV7-9	TRBJ2-5
TGTGCCAGCCGGCGCCAAGAGACCCAGTACTTC	CASRRQETQYF	TRBV28	TRBJ2-5
TGTGCCAGCAGTAAACTGACTTCGGCCCAGTACTTC	CASSKLTSAQYF	TRBV6-6	TRBJ2-5
TGTGCCAGCAGCGCCGGGACAGGGCATTACTTC	CASSAGTGHYF	TRBV18	TRBJ2-4
TGTGCCAGCACACGGGGGGGGCAGCATGAGCAGTTCTTC	CASTRGGQHEQFF	TRBV5-4	TRBJ2-1
TGCAGCGTATTGGGGGGATTTGAGCCCAATGAGCAGTTCTTC	CSVLGGFEPNEQFF	TRBV29-1	TRBJ2-1
TGTGCCCCGGGACATGAGCAGTTCTTC	CAPGHEQFF	TRBV27	TRBJ2-1
TGTGCCAGCAGCTTGAAGGGACAGGGTTTCGGGGAGCAGTACTTC	CASSLKGQGFGEQYF	TRBV5-4	TRBJ2-7
TGTGAACGTGTTTGGACACCGATCTCTGGAAACACCATATATTTT	CERVWTPISGNTIYF	TRBV12-3	TRBJ1-3
TGTGCCAGCAGCCCCCGGTCCGGGACTAGCGGGAGAAGGGGGACCTACAATGAGCAGTTCTTC	CASSPRSGTSGRRGTYNEQFF	TRBV9	TRBJ2-1
TGTGCCAGTAGTCATCGAACTAGCGGGAGGATCTACGAGCAGTACTTC	CASSHRTSGRIYEQYF	TRBV19	TRBJ2-7
TGCAGCGTTGGATCACGACCGGCTAACTATGGCTACACCTTC	CSVGSRPANYGYTF	TRBV29-1	TRBJ1-2
TGTGCCAGCAGCACGAGCAGCTCGAACACCGGGGAGCTGTTTTTT	CASSTSSSNTGELFF	TRBV14	TRBJ2-2
TGTGCCAGCAGTTGGTCCACAGGGGACAACTCCACTGAAGCTTTCTTT	CASSWSTGDNSTEAFF	TRBV28	TRBJ1-1
TGTGCCACCAGTGATCAGATTTTGCGGAATCAGCACGAGCAGTACTTC	CATSDQILRNQHEQYF	TRBV24-1	TRBJ2-7
TGTGCCAGCAGTAGCCCCAGGGGGGAAGGAGAGACCCAGTACTTC	CASSSPRGEGETQYF	TRBV27	TRBJ2-5
TGTGCCAGCAGCTGGCTGGGGGGGTACTACGAGCAGTACTTC	CASSWLGGYYEQYF	TRBV9	TRBJ2-7
TGTGCCAGCAGCTTAGAAAGGGGAGGGGGCCACACTGAAGCTTTCTTT	CASSLERGGGHTEAFF	TRBV7-7	TRBJ1-1
TGTGCCAGCAGTGACTCCGAGGAGGGGATAAATGAGCAGTTCTTC	CASSDSEEGINEQFF	TRBV6-4	TRBJ2-1
TGTGCCAGCAGATTGGCAGGAAATCAGCCCCAGCATTTT	CASRLAGNQPQHF	TRBV7-9	TRBJ1-5
TGTGCCAGCAGGGGGATGGGGACAGGTTTTTCGTACAATGAGCAGTTCTTC	CASRGMGTGFSYNEQFF	TRBV28	TRBJ2-1
TGTGCCAGCAGTGAAGTGGCGTACGAGCAGTACTTC	CASSEVAYEQYF	TRBV2	TRBJ2-7
TGCGCCAGCAGCTTGGAGGGTGACACTGTCTACGAGCAGTACTTC	CASSLEGDTVYEQYF	TRBV5-1	TRBJ2-7
TGCGGGGGCGGCACCCGGGACAACAAGCGTGGCTCCTACGAGCAGTACTTC	CGGGTRDNKRGSYEQYF	TRBV20-1	TRBJ2-7
TGTGCCAGCACAGTAGGCACTGAAGCTTTCTTT	CASTVGTEAFF	TRBV6-4	TRBJ1-1
TGTGCCAGCAGTGAATCTGCGGGCGCCGCCGAGCAGTACTTC	CASSESAGAAEQYF	TRBV6-4	TRBJ2-7
TGCGCCAGCAGTCGGGACAGGGGGTTAGATACGCAGTATTTT	CASSRDRGLDTQYF	TRBV5-1	TRBJ2-3
TGTGCCAAAAAGGGCCCTAGCCCCTACGAGCAGTACTTC	CAKKGPSPYEQYF	TRBV5-4	TRBJ2-7
TGTAAGGGAGGACTGGCCGGCTCCACCTCCTACGAGCAGTACTTC	CKGGLAGSTSYEQYF	TRBV7-9	TRBJ2-7
TGTGTTACTAATGAGCAGTTCTTC	CVTNEQFF	TRBV25-1	TRBJ2-1
TGCAGTGCTAACAGCGCTGAAAAACTGTTTTTT	CSANSAEKLFF	TRBV20-1	TRBJ1-4
TGTGCCAGAGGAAGCGACAGACCGATTGATGGCTACACCTTC	CARGSDRPIDGYTF	TRBV27	TRBJ1-2
TGTGCCAGCAGCCCGCCTGGGAACACCGGGGAGCTGTTTTTT	CASSPPGNTGELFF	TRBV2	TRBJ2-2
TGCGCCAGCAGCTCGGGACAGGGGAACTATGGCTACACCTTC	CASSSGQGNYGYTF	TRBV5-1	TRBJ1-2
TGTGCCAGCAGCGACCCCGTTGTAGCGGGGACCATGATCCCTGAGCAGTTCTTC	CASSDPVVAGTMIPEQFF	TRBV9	TRBJ2-1
TGTGCCAGCTCACCTTACGCGGGACTTAACAATGAGCAGTTCTTC	CASSPYAGLNNEQFF	TRBV18	TRBJ2-1
TGTGCCAGCAGCTTACACGGCTTTGGTGGTGAGACCCAGTACTTC	CASSLHGFGGETQYF	TRBV11-3	TRBJ2-5
TGTGCCAGCAGTACTACAGGGCAAGAGCAGTACTTC	CASSTTGQEQYF	TRBV27	TRBJ2-7
TGTGCCAGCAGCGGGACAGGGGGACAGGGGAGCGAGCAGTACTTC	CASSGTGGQGSEQYF	TRBV6-4	TRBJ2-7
TGTGCCAGCAGCCAGGGGGACAGCGGGGACTACAATGAGCAGTTCTTC	CASSQGDSGDYNEQFF	TRBV5-4	TRBJ2-1
TGTGCCACCAGTGATTTGACTAGCGGGAGGGCCCGCACCACCGGGGAGCTGTTTTTT	CATSDLTSGRARTTGELFF	TRBV24-1	TRBJ2-2
TGTGCCATCATAAGTGACTATGAGCAGTTCTTC	CAIISDYEQFF	TRBV10-3	TRBJ2-1
TGTGCCAGCAGCGGGACAGCCTACGAGCAGTACTTC	CASSGTAYEQYF	TRBV7-3	TRBJ2-7
TGTGCCAGCAGCAGGGGGCCCACTGAAGCTTTCTTT	CASSRGPTEAFF	TRBV7-4	TRBJ1-1
TGCGCCAGCAGCTTGGGGGGAGACAGGGGTGAAGCTTTCTTT	CASSLGGDRGEAFF	TRBV5-1	TRBJ1-1
TGTGCCAGCAGCAGTCCTAGTCCGAACAATGAGCAGTTCTTC	CASSSPSPNNEQFF	TRBV7-9	TRBJ2-1
TGTGCCAAAGGAGAGTGCAATGAGCAGTTCTTC	CAKGECNEQFF	TRBV19	TRBJ2-1
TGCAGCGTTGCTATAGGGACGACGGGCTATAGCAATCAGCCCCAGCATTTT	CSVAIGTTGYSNQPQHF	TRBV29-1	TRBJ1-5
TGTGCCAGCAGTGATGGAGGACAGGGTAAAGATACGCAGTATTTT	CASSDGGQGKDTQYF	TRBV25-1	TRBJ2-3
TGTGCCTGGAGTGCCGGGGAACCCAGGGGATTCGCAGGGGGGATGAACACTGAAGCTTTCTTT	CAWSAGEPRGFAGGMNTEAFF	TRBV30	TRBJ1-1
TGTGCCAGCAGCGCCCAGGTACGAGGTGAGGCAGCCAAAAACATTCAGTACTTC	CASSAQVRGEAAKNIQYF	TRBV11-3	TRBJ2-4
TGTGCCAGCAGCTTTTCTAGCGGGCCCGTGAGCTCCTACAATGAGCAGTTCTTC	CASSFSSGPVSSYNEQFF	TRBV6-5	TRBJ2-1
TGTGCCAGCAGTTTGACAGGGGGTCCGAACACTGAAGCTTTCTTT	CASSLTGGPNTEAFF	TRBV9	TRBJ1-1
TGTGCCAGCAGTTATCCGCTTGGGGACAGGGGGGAGGGCTACACCTTC	CASSYPLGDRGEGYTF	TRBV6-5	TRBJ1-2
TGCGCCAGCCCCGGGGGGGGCTCCGGGGAGCTGTTTTTT	CASPGGGSGELFF	TRBV10-1	TRBJ2-2
TGTGCCAGCAGACCATCAAGACTAGCTAGAACGGAGACCCAGTACTTC	CASRPSRLARTETQYF	TRBV28	TRBJ2-5
TGTGCCAGCTCTGCGGGGGGAGTAGTTTCCAATGAGCAGTTCTTC	CASSAGGVVSNEQFF	TRBV18	TRBJ2-1
TGTGCCAGCAGCCATTCTAGCGGGTCCTTCGTGACCGGGGAGCTGTTTTTT	CASSHSSGSFVTGELFF	TRBV4-2	TRBJ2-2
TGTGCCAGCAGCGTCTGGGACAGGGTCCACGAGCAGTACTTC	CASSVWDRVHEQYF	TRBV9	TRBJ2-7
TGTGCCAGCAGGCCGTCAGGTTCGAAGAGCTCTGGAAACACCATATATTTT	CASRPSGSKSSGNTIYF	TRBV5-4	TRBJ1-3
TGCAGTGCTCGCAGTCACCCGGGGGAGGCCTACAATGAGCAGTTCTTC	CSARSHPGEAYNEQFF	TRBV20-1	TRBJ2-1
TGTGCTAGCAGCTTACCCGTGGATCAGCCCCAGCATTTT	CASSLPVDQPQHF	TRBV7-7	TRBJ1-5
TGTGCCAGCAGCTCTACCCCTAGCGGGGCGACGGAGCAGTACTTC	CASSSTPSGATEQYF	TRBV7-9	TRBJ2-7
TGCAGTGCTGTCTCAGGGGAGGCTCAGCCCCAGCATTTT	CSAVSGEAQPQHF	TRBV20-1	TRBJ1-5
TGTGCCTGGACGGTCTACACGCACACCGGGGAGCTGTTTTTT	CAWTVYTHTGELFF	TRBV30	TRBJ2-2
TGTGCCAGCAGTCCGTGGGGGGGAAGGTGTGACAATGAGCAGTTCTTC	CASSPWGGRCDNEQFF	TRBV7-2	TRBJ2-1
TGCGCCAGCGGGGACACTCCCGCTGAGTTCTACGAGCAGTACTTC	CASGDTPAEFYEQYF	TRBV5-1	TRBJ2-7
TGTGCCAGCAGCACCTCCCGAGGGACTTCCACTGAAGCTTTCTTT	CASSTSRGTSTEAFF	TRBV13	TRBJ1-1
TGTGCCAGCAGCTCAGGCAGGAGCGAGCAGTACTTC	CASSSGRSEQYF	TRBV7-9	TRBJ2-7
TGCGCCAGCAGTTCGGGACAGGGGCCCCTCGCAACTAATGAAAAACTGTTTTTT	CASSSGQGPLATNEKLFF	TRBV10-1	TRBJ1-4
TGTGCCAGTGGGAGGGGGGGAGACAATGAGCAGTTCTTC	CASGRGGDNEQFF	TRBV19	TRBJ2-1
TGTGCCAGCAGTTACCATGCCACTAGCGGGAGGCGAGTTCGAGAAGGGGGATACACAGATACGCAGTATTTT	CASSYHATSGRRVREGGYTDTQYF	TRBV6-5	TRBJ2-3
TGTGCCAGCAGAGAAAGGTGGCCTAAGAGCGGACCAACCGGGGAGCTGTTTTTT	CASRERWPKSGPTGELFF	TRBV27	TRBJ2-2
TGTGCCAGCAGCGTAGCTGGACAGGGGACAGAGACCCAGTACTTC	CASSVAGQGTETQYF	TRBV9	TRBJ2-5
TGCGCCAGCACCGGGACCACCTCCTACGAGCAGTACTTC	CASTGTTSYEQYF	TRBV10-1	TRBJ2-7
TGTGCCAGCAGTTTACCAGGCGGGACTAACTATGGCTACACCTTC	CASSLPGGTNYGYTF	TRBV27	TRBJ1-2
TGTGCCAGCAGTTTATACCCAATTAAGACAGGGCAAGAGACCCTTTGGCAGTACTTC	CASSLYPIKTGQETLWQYF	TRBV27	TRBJ2-7
TGTGCCAGCAGCCAAGGATGTTGGGGAGTCCACGTAGAGAAATCTAGCACAGATACGCAGTATTTT	CASSQGCWGVHVEKSSTDTQYF	TRBV3-1	TRBJ2-3
TGTGCCAGCAGTTCAGCCCGCGGGAGATCCGGTGGCTACACCTTC	CASSSARGRSGGYTF	TRBV27	TRBJ1-2
TGTTCTTCGCCCCGGGCCTGGGAGGAGCAGTACTTC	CSSPRAWEEQYF	TRBV7-9	TRBJ2-7
TGTGCCAGCAGTGACCACACAGTAGCTGAGAACACTGAAGCTTTCTTT	CASSDHTVAENTEAFF	TRBV12-4	TRBJ1-1
TGCGCCAGCAGCTTAGACGTCGACAGGAACACCGGGGAGCTGTTTTTT	CASSLDVDRNTGELFF	TRBV5-1	TRBJ2-2
TGTGCCTGGAATGGCGAGACCCAGTACTTC	CAWNGETQYF	TRBV30	TRBJ2-5
TGTGCCAGCAGCCCACGGGCAGTCTACGAGCAGTACTTC	CASSPRAVYEQYF	TRBV7-3	TRBJ2-7
TGTGCCTCTCAGGGGGTCGATGAGAGCTCCTACAATGAGCAGTTCTTC	CASQGVDESSYNEQFF	TRBV6-5	TRBJ2-1
TGCAGCGTTGCGAATAGAGACGAGCAGTACTTC	CSVANRDEQYF	TRBV29-1	TRBJ2-7
TGTGCCATCAGTGACCAGGCTCAATGTAATTCACCCCTCCACTTT	CAISDQAQCNSPLHF	TRBV10-3	TRBJ1-6
TGTGCCATCAGTGAGTCGAAGGGACTGTACACAGATACGCAGTATTTT	CAISESKGLYTDTQYF	TRBV10-3	TRBJ2-3
TGTGCCAGCAGCTCCAAAGCATTCCGGGACAGGGGGCGGGGCTACACCTTC	CASSSKAFRDRGRGYTF	TRBV11-2	TRBJ1-2
TGCGCCAGCACGGGAGGGAACACTGAAGCTTTCTTT	CASTGGNTEAFF	TRBV10-1	TRBJ1-1
TGTGCCAGCAGAAGTGGACTAGCAGCGCAAGAGACCCAGTACTTC	CASRSGLAAQETQYF	TRBV6-1	TRBJ2-5
TGTGCCAGCAGTTGGGGTTCACCCCTCCACTTT	CASSWGSPLHF	TRBV28	TRBJ1-6
TGTGCCAGTAGGGCAAACAGGGGGTCGGTCTCCTACGAGCAGTACTTC	CASRANRGSVSYEQYF	TRBV19	TRBJ2-7
TGTGCCAGCAGCCGTGCGCGTGGGGGGCACGAGCAGTACTTC	CASSRARGGHEQYF	TRBV6-4	TRBJ2-7
TGCAGCGTTGAAGCTCAGGGGCGACACAATCAGCCCCAGCATTTT	CSVEAQGRHNQPQHF	TRBV29-1	TRBJ1-5
TGTGCCAGCAGTTCTGGCTCCGGGACTGGGGGTGAAGCTTTCTTT	CASSSGSGTGGEAFF	TRBV27	TRBJ1-1
TGTGCCAGCAGTACACCTAGCGGGAAGATCCATGAGCAGTTCTTC	CASSTPSGKIHEQFF	TRBV6-1	TRBJ2-1
TGTGCCAGCAGCCAAGGTAGGGGGCGGCTCCGGAACACTGAAGCTTTCTTT	CASSQGRGRLRNTEAFF	TRBV4-2	TRBJ1-1
TGTGCCAGCAGCGCCCGGGACAGGGGTGAGCAGTACTTC	CASSARDRGEQYF	TRBV7-9	TRBJ2-7
TGTGCCAGCAGTTTAGCGGACAGGGAGCCTTTATTAAAGAACTTCGAGACCCAGTACTTC	CASSLADREPLLKNFETQYF	TRBV28	TRBJ2-5
TGTGCCAGCAGTTTCAAAACTAACCGAGGCTACGAGCAGTACTTC	CASSFKTNRGYEQYF	TRBV12-4	TRBJ2-7
TGTACCCGCACTAGCGGGATGTCCTACGAGCAGTACTTC	CTRTSGMSYEQYF	TRBV7-9	TRBJ2-7
TGTGCCAGCAGTGCTTGCCGGGACGGAGGGGCCGGGGAGCTGTTTTTT	CASSACRDGGAGELFF	TRBV25-1	TRBJ2-2
TGCAGCGTTGAAGTGGGAGGGTCTAAAATCGATACGCAGTATTTT	CSVEVGGSKIDTQYF	TRBV29-1	TRBJ2-3
TGTGCCAGCAGCGTCAGAAACTTGAACCCGGGACAGGGAGATAGCAATCAGCCCCAGCATTTT	CASSVRNLNPGQGDSNQPQHF	TRBV13	TRBJ1-5
TGCGCCAGCAGCTTATTCGACCGGACAGGGCAAGAGACCCAGTACTTC	CASSLFDRTGQETQYF	TRBV5-1	TRBJ2-5
TGCGCCAGCAGCTTAATCGTCCAGGGGAACACTGAAGCTTTCTTT	CASSLIVQGNTEAFF	TRBV5-1	TRBJ1-1
TGTGCCAGCAGTTATTCTAGGCCGGCACAGGGGGGCTCCAATCAGCCCCAGCATTTT	CASSYSRPAQGGSNQPQHF	TRBV28	TRBJ1-5
TGTGCCAGCAGCGCATTCCCGGACAGGGGGGGCGTCACTGAAGCTTTCTTT	CASSAFPDRGGVTEAFF	TRBV9	TRBJ1-1
TGCGCCATCCCAGATACTGAAGCTTTCTTT	CAIPDTEAFF	TRBV10-2	TRBJ1-1
TGTGCCAGAAGACTGTCTTTGCCCCAGCATTTT	CARRLSLPQHF	TRBV6-2	TRBJ1-5
TGTGCCAGCAGTGACTCCTTCCCCCCTTACGGGCGCCAAGAGACCCAGTACTTC	CASSDSFPPYGRQETQYF	TRBV6-4	TRBJ2-5
TGTGCCAGCAGTGACGGGGCGGCGAACCAGAATCAGCCCCAGCATTTT	CASSDGAANQNQPQHF	TRBV6-4	TRBJ1-5
TGTGCCAGCAGTATCACGGGATATGGGGCTATCTACGAGCAGTACTTC	CASSITGYGAIYEQYF	TRBV6-4	TRBJ2-7
TGCAGTGCTAGCTCCAGGGGTACTGAAGCTTTCTTT	CSASSRGTEAFF	TRBV20-1	TRBJ1-1
TGTGCCAAAGTGGGACAGACAATCCAGCCCCAGCATTTT	CAKVGQTIQPQHF	TRBV7-9	TRBJ1-5
TGCGCCAGCCTCGTAGCGGGGGCTATGGCTGAGCAGTACTTC	CASLVAGAMAEQYF	TRBV10-1	TRBJ2-7
TGTGCCAGCAGTCTTCCCTTTGGGGGAGTGGGGAACACTGAAGCTTTCTTT	CASSLPFGGVGNTEAFF	TRBV6-2	TRBJ1-1
TGTGCCAGCAGGTTGAGTGATCCCGGGACAGGCACTGAAGCTTTCTTT	CASRLSDPGTGTEAFF	TRBV7-3	TRBJ1-1
TGTGCCAGCAGCCAAGTGAGACGGAGCACTGAAGCTTTCTTT	CASSQVRRSTEAFF	TRBV4-2	TRBJ1-1
TGCAGTGCTACGGCCTGGGCCAATGAGCAGTTCTTC	CSATAWANEQFF	TRBV20-1	TRBJ2-1
TGTGCCAGCAGCCAAGACTTACCGGGACAGTTATCCGGGCGGTACGAGCAGTACTTC	CASSQDLPGQLSGRYEQYF	TRBV3-1	TRBJ2-7
TGTGCCAGCGGTTTCACCTACGAGCAGTACTTC	CASGFTYEQYF	TRBV5-6	TRBJ2-7
TGTGCCAGCAGCCCCCCCCCCCTGCAGGTCGTAACCGCTGGAAACACCATATATTTT	CASSPPPLQVVTAGNTIYF	TRBV7-3	TRBJ1-3
TGCAGTGCTAGAGGCATAAGACGGTCCTACGAGCAGTACTTC	CSARGIRRSYEQYF	TRBV20-1	TRBJ2-7
TGCGCCAGCAGTAGGACTAGCGGACCCTACGAGCAGTACTTC	CASSRTSGPYEQYF	TRBV4-1	TRBJ2-7
TGCAGTGCTAGAGAGAAGCGGGAGGAGAGTAATAACTACGAGCAGTACTTC	CSAREKREESNNYEQYF	TRBV20-1	TRBJ2-7
TGTGCCAGCAGCCACAGTTTTTCTGGAAACACCATATATTTT	CASSHSFSGNTIYF	TRBV7-3	TRBJ1-3
TGTGCCAGCAGTTGCCCCCAGGGACATGGCTACACCTTC	CASSCPQGHGYTF	TRBV6-6	TRBJ1-2
TGTGCCAGTAGTGGGTGCGGGAGACTACACGAGCAGTACTTC	CASSGCGRLHEQYF	TRBV19	TRBJ2-7
TGTGCCTGGAGTGTCCGGGAGATTAAAGGCTACACCTTC	CAWSVREIKGYTF	TRBV30	TRBJ1-2
TGTGCCAGCAGCAGGGGGGGGAGGAGAACCTACGAGCAGTACTTC	CASSRGGRRTYEQYF	TRBV12-4	TRBJ2-7
TGTGCCAGCAGCTTAGCGACCGCGCAACAGCGGGATGCTCGCTCTGGAAACACCATATATTTT	CASSLATAQQRDARSGNTIYF	TRBV7-2	TRBJ1-3
TGTGCCAGCAAACGCCGCTTTAAGTCCGGGCCCTCGGATCGCACAGATACGCAGTATTTT	CASKRRFKSGPSDRTDTQYF	TRBV6-5	TRBJ2-3
TGTGCCAGCAGCTTAGGGAGTTCCGGGACTAGCGGGGTCGGCGAGCAGTACTTC	CASSLGSSGTSGVGEQYF	TRBV7-9	TRBJ2-7
TGTGCCAGCAGCTCTCAACAGGGTCCGAACACCGGGGAGCTGTTTTTT	CASSSQQGPNTGELFF	TRBV13	TRBJ2-2
TGCAAACTGGACTGGGGGACCTACGAGCAGTACTTC	CKLDWGTYEQYF	TRBV20-1	TRBJ2-7
TGTGCCAGCAGGGCGCAGGCCGCTGGGGCCAACGTCCTGACTTTC	CASRAQAAGANVLTF	TRBV6-1	TRBJ2-6
TGTGCCAGCAGAGTGGATGGAACTAGCGGGGGGGCCTCCACCGGGGAGCTGTTTTTT	CASRVDGTSGGASTGELFF	TRBV11-2	TRBJ2-2
TGTGCCAGCAGCTTCGATCCCCGGCAGCAAACAGATACGCAGTATTTT	CASSFDPRQQTDTQYF	TRBV7-2	TRBJ2-3
TGTGCCTGGACCCCCCAACAGGGGGCGAAGAAGGGCTATAGCAATCAGCCCCAGCATTTT	CAWTPQQGAKKGYSNQPQHF	TRBV30	TRBJ1-5
TGTGCCAGCAGTGAACGGAGTCGACTATCCAGAGCCTCTGGGGCCAACGTCCTGACTTTC	CASSERSRLSRASGANVLTF	TRBV2	TRBJ2-6
TGTGCCAGCAGAGCCCGGACAGTTAATCAGCCCCAGCATTTT	CASRARTVNQPQHF	TRBV6-4	TRBJ1-5
TGCAGTGCTGGGGCCAGGATAAATGAGCAGTTCTTC	CSAGARINEQFF	TRBV20-1	TRBJ2-1
TGTGCCAGCACCCGGATGACAGGGAACTCTGGGGCCAACGTCCTGACTTTC	CASTRMTGNSGANVLTF	TRBV25-1	TRBJ2-6
TGTGCCAGCAGTGAAGACAGGGGGCGGGGAAACACCATATATTTT	CASSEDRGRGNTIYF	TRBV6-1	TRBJ1-3
TGTGCCAGCAGCCTAGACAGGAGGAGCTCCTATAATTCACCCCTCCACTTT	CASSLDRRSSYNSPLHF	TRBV6-3	TRBJ1-6
TGTGCCAGCAGCCCTACCCCGGGCCGGGTCGGTTGGACAGGGCGCACAGATACGCAGTATTTT	CASSPTPGRVGWTGRTDTQYF	TRBV14	TRBJ2-3
TGCAGTGCTTCAGCAGAACGGGACGGGAGGAACACTGAAGCTTTCTTT	CSASAERDGRNTEAFF	TRBV20-1	TRBJ1-1
TGTGCCAGCAGCATTTGCCAGACCCACACTGAAGCTTTCTTT	CASSICQTHTEAFF	TRBV13	TRBJ1-1
TGCAGCGTCGCGACAGGACGAAATGAGCAGTTCTTC	CSVATGRNEQFF	TRBV29-1	TRBJ2-1
TGTGCCAGCAGCTTGGTGCCCGGGACCGACGATTTTGAGACCCAGTACTTC	CASSLVPGTDDFETQYF	TRBV5-5	TRBJ2-5
TGTGCCAGCACAGTAGAAAAATTCGAGACCGGGACGGGATGTAAAGGCGAGACCCAGTACTTC	CASTVEKFETGTGCKGETQYF	TRBV27	TRBJ2-5
TGCGCCAGCAGTTTCCTAAGACTAGCGGCTACTGAGCAGTTCTTC	CASSFLRLAATEQFF	TRBV10-1	TRBJ2-1
TGCGCCAGCAGCTTCCGCAGCAGGGAACGAGGGCCCCAGCATTTT	CASSFRSRERGPQHF	TRBV5-1	TRBJ1-5
TGTGCCAGCAGCTTAGCCAGACATCAGCGCACCTTC	CASSLARHQRTF	TRBV11-2	TRBJ1-2
TGCGGTGGGGGGGCAGTATTATACAATGAGCAGTTCTTC	CGGGAVLYNEQFF	TRBV10-1	TRBJ2-1
TGCGCCAGCAGTTGCCGAGACAGGCCTAACTATGGCTACACCTTC	CASSCRDRPNYGYTF	TRBV10-2	TRBJ1-2
TGTGCCAGCAGCTTCTCCGGGACAGGGGAGGAGCAGTACTTC	CASSFSGTGEEQYF	TRBV7-2	TRBJ2-7
TGTGCCAGCAGCTTACCTAAAGGCGAAGGAAACTACGAGCAGTACTTC	CASSLPKGEGNYEQYF	TRBV7-9	TRBJ2-7
TGTGCCAGCAGTGAATGGGACAGGGACACTGAAGCTTTCTTT	CASSEWDRDTEAFF	TRBV2	TRBJ1-1
TGTGCCGGGGGGGGAGTGCGGGGGGGCTACACCTTC	CAGGGVRGGYTF	TRBV27	TRBJ1-2
TGTGCCATGGGACGGCCTTGGTACTTC	CAMGRPWYF	TRBV6-6	TRBJ2-7
TGTGCCAGCATCCAGCAGCGGGACGAGCAGTTCTTC	CASIQQRDEQFF	TRBV27	TRBJ2-1
TGTGCCAGCAGTGAATACGAATGGACAGGGGAGAAAACCAATAGCAATCAGCCCCAGCATTTT	CASSEYEWTGEKTNSNQPQHF	TRBV25-1	TRBJ1-5
TGTGCCAGCTTGTCGAGCCGAGGCGATGGCTACACCTTC	CASLSSRGDGYTF	TRBV2	TRBJ1-2
TGTGCCAGCAGTGCGACAGGGGGAAGAAGGAGTGGCTACACCTTC	CASSATGGRRSGYTF	TRBV27	TRBJ1-2
TGCGCCAGCAGTGAGATCGGCAGCACAGATACGCAGTATTTT	CASSEIGSTDTQYF	TRBV10-1	TRBJ2-3
TGTGCCAGCAGGGGGGGTTTTTTTTCTGTGGTGGAACACACCGGGGAGCTGTTTTTT	CASRGGFFSVVEHTGELFF	TRBV9	TRBJ2-2
TGTGCCACCAGTCCCTTCCCTGGGACCAAAGCCTGGCAAGAGACCCAGTACTTC	CATSPFPGTKAWQETQYF	TRBV24-1	TRBJ2-5
TGTGCCAGCAGAAACGGACAGGGGTCCTCTGGAAACACCATATATTTT	CASRNGQGSSGNTIYF	TRBV7-4	TRBJ1-3
TGTGCCAGTATCTGGCGGGGGTACGAGCAGTACTTC	CASIWRGYEQYF	TRBV4-2	TRBJ2-7
TGTGCCAGCAGCGAAGGGGGGTACACCATATATTTT	CASSEGGYTIYF	TRBV6-6	TRBJ1-3
TGTGCCAGCAGCTCCGGGGAAGGCGGGTACTCCGGGGAGCTGTTTTTT	CASSSGEGGYSGELFF	TRBV9	TRBJ2-2
TGTGCCATCAAGGAGGAAGATAGCAATCAGCCCCAGCATTTT	CAIKEEDSNQPQHF	TRBV10-3	TRBJ1-5
TGCGCCAGCAGCCAAGAGATGGGGGATACTAACTATGGCTACACCTTC	CASSQEMGDTNYGYTF	TRBV4-1	TRBJ1-2
TGCAGTGCTAGAGTTGGGGACAGGGAGGCGGGGTACGAGCAGTACTTC	CSARVGDREAGYEQYF	TRBV20-1	TRBJ2-7
TGTGCCAGCAGCGGCCGACTAGCGGGTGGCTACGAGCAGTACTTC	CASSGRLAGGYEQYF	TRBV6-4	TRBJ2-7
TGTGCCAGCAGTGAGGGGGGTTGGCAAGAGACCCAGTACTTC	CASSEGGWQETQYF	TRBV25-1	TRBJ2-5
TGCAGTGCCCAGGTCGACGAGCAGTACTTC	CSAQVDEQYF	TRBV20-1	TRBJ2-7
TGTGCCAGCCTAACGAACGTTGAAGAGGAGACCCAGTACTTC	CASLTNVEEETQYF	TRBV18	TRBJ2-5
TGTGCCAGCAGCTTACGTCTTAGGCGCACCCGAAGGAAACTGTTTTTT	CASSLRLRRTRRKLFF	TRBV7-9	TRBJ1-4
TGTGCCAGCAGAGGAACGAGGGAGGGAACTGAAGCTTTCTTT	CASRGTREGTEAFF	TRBV12-3	TRBJ1-1
TGTGCCAGCAGCTTAAAGGGACAGGAGACCCAGTACTTC	CASSLKGQETQYF	TRBV7-3	TRBJ2-5
TGTGCCCCGCAAGAATCAGCGGGAGAGGGCGGCTACACCTTC	CAPQESAGEGGYTF	TRBV6-5	TRBJ1-2
TGCGCCAGCAGCTCCGGGCCGGTCTACTACCGGTACTTC	CASSSGPVYYRYF	TRBV5-1	TRBJ2-7
TGTGCCAGCAACCGGACCGGCGGGATAAACACTGAAGCTTTCTTT	CASNRTGGINTEAFF	TRBV6-6	TRBJ1-1
TGTGCCAGCAGTGTCGGCACCGGGACAGGGGAGGTGGAGCAGTTCTTC	CASSVGTGTGEVEQFF	TRBV6-3	TRBJ2-1
TGCGCCAGCAGTTTCTCACCGGGCCGTAATGAAAAACTGTTTTTT	CASSFSPGRNEKLFF	TRBV10-2	TRBJ1-4
TGCGCCAGCAGTACAGGTATGGAGGGGAACACCGGGGAGCTGTTTTTT	CASSTGMEGNTGELFF	TRBV10-1	TRBJ2-2
TGTGCCTGGAGACGCGGGGGGGGGCATCAAAACATTCAGTACTTC	CAWRRGGGHQNIQYF	TRBV30	TRBJ2-4
TGTGCCAGCAGAGAATCGTCGGGACAGGCGAAACTCTACGAGCAGTACTTC	CASRESSGQAKLYEQYF	TRBV2	TRBJ2-7
TGTGCCTGGAGGTATCAGTTAAACCCCGGGGAGCTGTTTTTT	CAWRYQLNPGELFF	TRBV30	TRBJ2-2
TGTGCCAGCAGCCCCGAATGGAACAGGGAAAACTACGAGCAGTACTTC	CASSPEWNRENYEQYF	TRBV14	TRBJ2-7
TGTGCCAGCAGCTGGGGCAGTGGCACTGAAGCTTTCTTT	CASSWGSGTEAFF	TRBV7-2	TRBJ1-1
TGTGCCAGCAGCGACAACCCCCACCAGGGGGCCACAGATACGCAGTATTTT	CASSDNPHQGATDTQYF	TRBV13	TRBJ2-3
TGCGCCAGCAGCCGTCCGGACAGGGGGTGGAGCAATCAGCCCCAGCATTTT	CASSRPDRGWSNQPQHF	TRBV4-3	TRBJ1-5
TGTGCTAGCAGCTCCTTGGTTCCCGGGACGGAGGAAGCTTTCTTT	CASSSLVPGTEEAFF	TRBV7-7	TRBJ1-1
TGTGCCAGCGGTGGGACAGGTCGAGCCAAAAACATTCAGTACTTC	CASGGTGRAKNIQYF	TRBV25-1	TRBJ2-4
TGTGCCAGCAGCTCGCGCCGAGGGGCCCTGGAAGCGCTTAGCTCCTACGAGCAGTACTTC	CASSSRRGALEALSSYEQYF	TRBV7-7	TRBJ2-7
TGTGCCAGCAGTTTACCGGGGGGGCCCCTAGGGGAGCTGTTTTTT	CASSLPGGPLGELFF	TRBV6-5	TRBJ2-2
TGCGCCAGCATTGAGGACTGTAGAGGATACGAGCAGTACTTC	CASIEDCRGYEQYF	TRBV10-2	TRBJ2-7
TGTGCCAGCAGTGATTCGGGACATCCGGCAGATACGCAGTATTTT	CASSDSGHPADTQYF	TRBV25-1	TRBJ2-3
TGTGCCAGCAGGTGGAGGGGGAAGATGACCTCAGATACGCAGTATTTT	CASRWRGKMTSDTQYF	TRBV2	TRBJ2-3
TGCGCCAGCAGACGAAGGAGGAGCATGAACACTGAAGCTTTCTTT	CASRRRRSMNTEAFF	TRBV10-2	TRBJ1-1
TGTGCCATCAGTGACCTGAGATACTATGGCTACACCTTC	CAISDLRYYGYTF	TRBV10-3	TRBJ1-2
TGTGCCAGCAGTTATTCCGGGACAGGGGGCGCCCCCGGTCAGCCCCAGCATTTT	CASSYSGTGGAPGQPQHF	TRBV6-5	TRBJ1-5
TGTGCCAGTAGTCAGAGGTATGAGCAGTTCTTC	CASSQRYEQFF	TRBV19	TRBJ2-1
TGTGCCACCACGGGGGGTTCGTGGGGGCAGTTCTTC	CATTGGSWGQFF	TRBV24-1	TRBJ2-1
TGTGCCAGCAGCCGGATTGGGGGGGGGCTACTGGACGAGACCCAGTACTTC	CASSRIGGGLLDETQYF	TRBV11-2	TRBJ2-5
TGTGCCAGCAGTGACGTTCCACCCGGACTTAGACCCGGGGAGCTGTTTTTT	CASSDVPPGLRPGELFF	TRBV6-4	TRBJ2-2
TGTGCCAGCTCACCAGTGGTAGCGGGCCCAGGCTACGAGCAGTACTTC	CASSPVVAGPGYEQYF	TRBV18	TRBJ2-7
TGTGCCATCAAGGGAAAGGGGGGGGATGGCTACACCTTC	CAIKGKGGDGYTF	TRBV10-3	TRBJ1-2
TGCGCCAGCAGCTTGTGTACGGGCCCCAATGGCTACACCTTC	CASSLCTGPNGYTF	TRBV5-1	TRBJ1-2
TGTGCCATCAGTGCCCCTTCAATCCCAGGGGGCGGCTGGGACGAGCAGTACTTC	CAISAPSIPGGGWDEQYF	TRBV10-3	TRBJ2-7
TGCGCCAGCAGCCAAGAAGTGGCAGCGACAGCGGGTGATCCGATGGATGGCTACACCTTC	CASSQEVAATAGDPMDGYTF	TRBV4-1	TRBJ1-2
TGCAGTGCTCCGAGATGGTATAGGCTTAATAGCACAGATACGCAGTATTTT	CSAPRWYRLNSTDTQYF	TRBV20-1	TRBJ2-3
TGTGCCAGCAGTAGGGACAGGGACACTGAAGCTTTCTTT	CASSRDRDTEAFF	TRBV6-2	TRBJ1-1
TGTGCCAGCAGTTACTCGCGGAGCCGGGAGACCCAGTACTTC	CASSYSRSRETQYF	TRBV6-2	TRBJ2-5
TGTGCCAGCAGCATCGTGGGACCTTGGGAGTCCTATAATTCACCCCTCCACTTT	CASSIVGPWESYNSPLHF	TRBV9	TRBJ1-6
TGTGCCAGCAGCAATGGCAACAGACTCCTTCCCACTGAAGCTTTCTTT	CASSNGNRLLPTEAFF	TRBV27	TRBJ1-1
TGTGCCAGCAGCTTCTCCTCTCACGTCAGGGACCGAGGGAACGAGCAGTACTTC	CASSFSSHVRDRGNEQYF	TRBV5-5	TRBJ2-7
TGTGCCAGCAGCACGGTGGCACACGGAGCGGGAGAGGTCTCTGGGGCCAACGTCCTGACTTTC	CASSTVAHGAGEVSGANVLTF	TRBV7-9	TRBJ2-6
TGTGCCAGCAGTTTTGATCCTCGACAGGCTGAGGGGATCCACACTGAAGCTTTCTTT	CASSFDPRQAEGIHTEAFF	TRBV27	TRBJ1-1
TGTGCCAGCAGCTTGAGAATGCAAGAGAGGGGGGGGTGCGAGCAGTACTTC	CASSLRMQERGGCEQYF	TRBV5-6	TRBJ2-7
TGTGCCAGGACAGGGAGCAATTCACCCCTCCACTTT	CARTGSNSPLHF	TRBV2	TRBJ1-6
TGTGCCAGCAGGAAATTCCCGGGGGACAGGGGGGGGGGTGGAAACACCATATATTTT	CASRKFPGDRGGGGNTIYF	TRBV7-4	TRBJ1-3
TGTGCCAGCAGCTCGCCTCTACTAGCTCCAGATACGCAGTATTTT	CASSSPLLAPDTQYF	TRBV13	TRBJ2-3
TGTGCCAGCAGCTTTGACGGTTACTATGGCTACACCTTC	CASSFDGYYGYTF	TRBV7-7	TRBJ1-2
TGTGCCAGCAGCGTAGGGGTTTTTGTCATAAGACAGGTTTCCCTTTTTTCACCCCTCCACTTT	CASSVGVFVIRQVSLFSPLHF	TRBV9	TRBJ1-6
TGTGCCAGCAGCGTAGTAAGACAGGGCACACGCACTGAAGCTTTCTTT	CASSVVRQGTRTEAFF	TRBV9	TRBJ1-1
TGTGCCAGCAGACGTAATACAGGGAGCCTGGCCGATACGCAGTATTTT	CASRRNTGSLADTQYF	TRBV27	TRBJ2-3
TGTGCCAGCAGTTCCCCGGTCCCGCCCCAGCATTTT	CASSSPVPPQHF	TRBV27	TRBJ1-5
TGTGCCTGGTTCGGGGGGACGAGGCCTAGCACAGATACGCAGTATTTT	CAWFGGTRPSTDTQYF	TRBV30	TRBJ2-3
TGCAGTGCTTCATTGGTGCTCGGGACATTGGCTTATAGCAATCAGCCCCAGCATTTT	CSASLVLGTLAYSNQPQHF	TRBV20-1	TRBJ1-5
TGCGCCAGCAGCTTCGGGGCCGGGACCCGAGCGAACACCGGGGAGCTGTTTTTT	CASSFGAGTRANTGELFF	TRBV5-1	TRBJ2-2
TGCGCCAGCAGCTGGACGGCGTCTGGGGCCAACGTCCTGACTTTC	CASSWTASGANVLTF	TRBV5-1	TRBJ2-6
TGCAGTGCTAGAGATTGTGTTAGCCGGGACGGGGTCGGAAACACCATATATTTT	CSARDCVSRDGVGNTIYF	TRBV20-1	TRBJ1-3
TGTGCCAGCAGCTTAGGGACTTGGTATGGCTACACCTTC	CASSLGTWYGYTF	TRBV11-3	TRBJ1-2
TGCGCCAGCGCCATATACAATGAGCAGTTCTTC	CASAIYNEQFF	TRBV10-1	TRBJ2-1
TGTGCCAGCAGCTTGGAACCATTCCTCCCCAACGGTTGCTGGCCCCAGCATTTT	CASSLEPFLPNGCWPQHF	TRBV5-4	TRBJ1-5
TGCAGCGTTGAACCATTAGAGAGGGATACCAGAAACACCGGGGAGCTGTTTTTT	CSVEPLERDTRNTGELFF	TRBV29-1	TRBJ2-2
TGTGCCAGCAGCGGGGCCTTACGGGACAGCGGTGCAACTAATGAAAAACTGTTTTTT	CASSGALRDSGATNEKLFF	TRBV7-3	TRBJ1-4
TGCGCCAGCAGCTTGGGACAGGGAGTCCCACTCGATACGCAGTACTTC	CASSLGQGVPLDTQYF	TRBV5-1	TRBJ2-7
TGTGCCAGTAGTATTAAAGGATGCGGGAGACGCTATGGCTACACCTTC	CASSIKGCGRRYGYTF	TRBV19	TRBJ1-2
TGTGCCAGCAGACACCCCACTAGTGGGGTTCAGCCCCAGCATTTT	CASRHPTSGVQPQHF	TRBV6-4	TRBJ1-5
TGCGCCAGCCCACGGCTGCGGACTAGCGAGCAGTACTTC	CASPRLRTSEQYF	TRBV10-2	TRBJ2-7
TGTGCCAGCAGCGAGGTACCGGTCGGGGGGGCTGATCCTAGCACAGATACGCAGTATTTT	CASSEVPVGGADPSTDTQYF	TRBV11-2	TRBJ2-3
TGTGCCAGCAGCGCTGGGAGGAATAACACTGAAGCTTTCTTT	CASSAGRNNTEAFF	TRBV13	TRBJ1-1
TGCAGTGTGAATGCACAGGGCCCTTCACCCCTCCACTTT	CSVNAQGPSPLHF	TRBV20-1	TRBJ1-6
TGTGCCAGCAGTTACATGGAAATTTTGAACGTAGCCAAAAACATTCAGTACTTC	CASSYMEILNVAKNIQYF	TRBV6-5	TRBJ2-4
TGCAGTGCTAGCTCCCCGGGACTAGCAGGAGTAGGACCCCGGCAGTTCTTC	CSASSPGLAGVGPRQFF	TRBV20-1	TRBJ2-1
TGTGCCAGCAGTGCAGGGCCGAGATCTGGGGCCAACGTCCTGACTTTC	CASSAGPRSGANVLTF	TRBV6-1	TRBJ2-6
TGTGCCAGCAGTCTACCCCTCCCGAAGGGGGGAACCGGAACCGGGGAGCTGTTTTTT	CASSLPLPKGGTGTGELFF	TRBV6-2	TRBJ2-2
TGTGCCTGGAAAGACCCATCCATGAACACTGAAGCTTTCTTT	CAWKDPSMNTEAFF	TRBV30	TRBJ1-1
TGCGCCAGCACGGTTGGGGATCAGCCCCAGCATTTT	CASTVGDQPQHF	TRBV5-1	TRBJ1-5
TGCAGTGCTCGCTCTGCGGTCCGGGGGGGCTACGAGCAGTACTTC	CSARSAVRGGYEQYF	TRBV20-1	TRBJ2-7
TGTGCCAGCAGTTACGTCGAAGCGCATTACGAGCAGTACTTC	CASSYVEAHYEQYF	TRBV6-5	TRBJ2-7
TGTGCCAGCAGCTTCGGCTGGGGTCCCTATAGCAATCAGCCCCAGCATTTT	CASSFGWGPYSNQPQHF	TRBV7-2	TRBJ1-5
TGTGCCAGCAGCCCTTCGAAGGACAGCCCCCGCAATCAGCCCCAGCATTTT	CASSPSKDSPRNQPQHF	TRBV13	TRBJ1-5
TGTGCCAGCAGCGTAGGTTGGGGGGGCCTGCAAGAGACCCAGTACTTC	CASSVGWGGLQETQYF	TRBV9	TRBJ2-5
TGTGCCAGCAGCGTAGATACCGGGACAGGGCGAGCCAAAAACATTCAGTACTTC	CASSVDTGTGRAKNIQYF	TRBV9	TRBJ2-4
TGTGCCAGCAGCATGGAAATGGTCGGCAATCAGCCCCAGCATTTT	CASSMEMVGNQPQHF	TRBV6-1	TRBJ1-5
TGTGCCAGCAGTTTCCAGCTAGCGGAAGAGACCCAGTACTTC	CASSFQLAEETQYF	TRBV27	TRBJ2-5
TGTGCCAGCAGAGACCCTCTACTGGAAGGAACAGATACGCAGTATTTT	CASRDPLLEGTDTQYF	TRBV11-3	TRBJ2-3
TGTGCCAGCAGCTTGTACCGGACTAGCGGGGGGGGGTCTGACACGCACAATGAGCAGTTCTTC	CASSLYRTSGGGSDTHNEQFF	TRBV7-2	TRBJ2-1
TGTGCCAGCAGTTCGAACACAGATACGCAGTATTTT	CASSSNTDTQYF	TRBV27	TRBJ2-3
TGTGCCAGCTGCACAGAAGCTTTCTTT	CASCTEAFF	TRBV5-6	TRBJ1-1
TGTGCCAGCCCGAGCGGCGCGGGCCCCTACGAGCAGTACTTC	CASPSGAGPYEQYF	TRBV2	TRBJ2-7
TGTGCCAGCAGTTATTTGAACGACCCTTCCGGGGAGCTGTTTTTT	CASSYLNDPSGELFF	TRBV6-5	TRBJ2-2
TGTGCCAGCAGCCTGGGAAGGGATCAGCCCCAGCATTTT	CASSLGRDQPQHF	TRBV7-9	TRBJ1-5
TGTGCCAGCAGAGGAGACATTGCTGATACCTACGAGCAGTACTTC	CASRGDIADTYEQYF	TRBV6-5	TRBJ2-7
TGCGCCAGCAGCCACCCGGGGCCCAATGAGCAGTTCTTC	CASSHPGPNEQFF	TRBV4-1	TRBJ2-1
TGTGCCAGCAGGCTAGCGGATACGCAGTATTTT	CASRLADTQYF	TRBV6-4	TRBJ2-3
TGTGCCAGTAGTATGGCAGGGAACGACTCCCAGCATTTT	CASSMAGNDSQHF	TRBV19	TRBJ1-5
TGTGCCAGCAAGTTGGGGGGTGTGAACACTGAAGCTTTCTTT	CASKLGGVNTEAFF	TRBV6-3	TRBJ1-1
TGTGCCAGCAGCCGGCGCGGTAACTATGGCTACACCTTC	CASSRRGNYGYTF	TRBV7-3	TRBJ1-2
TGTGCCAGCGTAGGAATGGTCAGGCCGAAAGAGACCCAGTACTTC	CASVGMVRPKETQYF	TRBV27	TRBJ2-5
TGTGCCAGCAGTCCCGGCAGGGGTGGGTTTCCCGCTTTCTTT	CASSPGRGGFPAFF	TRBV27	TRBJ1-1
TGTGCCACCAGCACCATTGCAGGGCCAGGAAATTACGAGCAGTACTTC	CATSTIAGPGNYEQYF	TRBV15	TRBJ2-7
TGTGCCTGGAAAACGAGGGATGATACGCAGTATTTT	CAWKTRDDTQYF	TRBV30	TRBJ2-3
TGTGCCAGTAGTATAGGGGGGTATCAGCCCCAGCATTTT	CASSIGGYQPQHF	TRBV19	TRBJ1-5
TGTGCCAGCAGTCATTCCGCGGGACTAGCGAAAGTGAATGAGCAGTTCTTC	CASSHSAGLAKVNEQFF	TRBV6-5	TRBJ2-1
TGCAGTGCTAGAGATTTTAAGGAGGGCTTTACGCAGTATTTT	CSARDFKEGFTQYF	TRBV20-1	TRBJ2-3
TGTGCCAGCAGTAGTCCCGGACAGGGAATGAACACTGAAGCTTTCTTT	CASSSPGQGMNTEAFF	TRBV25-1	TRBJ1-1
TGTGCCAGCAGCTATACCACAGGGGGCATTGAAGCTTTCTTT	CASSYTTGGIEAFF	TRBV5-6	TRBJ1-1
TGTGCCATACAGCCATTGGGATTGGACAGGTCCTACGAGCAGTACTTC	CAIQPLGLDRSYEQYF	TRBV7-8	TRBJ2-7
TGTGCCAGCAGTTACCCCCCAGATCCGGGCGTTCCGGCCTCGCAGTTCTTC	CASSYPPDPGVPASQFF	TRBV6-2	TRBJ2-1
TGTGCCACGACCCTTAAGGGACGGTCCACTGAAGCTTTCTTT	CATTLKGRSTEAFF	TRBV24-1	TRBJ1-1
TGCAGCGTTGACAGATACGTAGGTACGCAGTATTTT	CSVDRYVGTQYF	TRBV29-1	TRBJ2-3
TGCGCCAGCAGCGGACCGGAACGTTCCCTAGCCAAAAACATTCAGTACTTC	CASSGPERSLAKNIQYF	TRBV5-1	TRBJ2-4
TGTGCCACCATGGTGGGACCCGAGCGGCAAAGCTCCTACAATGAGCAGTTCTTC	CATMVGPERQSSYNEQFF	TRBV24-1	TRBJ2-1
TGTGCCTGGAAATCAACAGGGGGCCAGCCCCAGCATTTT	CAWKSTGGQPQHF	TRBV30	TRBJ1-5
TGTGCCAGCACAATGTCTCCCGGCTCAGGGGAGGACGAGCAGTACTTC	CASTMSPGSGEDEQYF	TRBV6-5	TRBJ2-7
TGTGCCAGCAGTGAATTCGGTAATACTCTCTTCCTGGATACCTACGAGCAGTACTTC	CASSEFGNTLFLDTYEQYF	TRBV25-1	TRBJ2-7
TGCGCCAGCAGCCTCCCAGACAGGGGGCGGGTGACTGAAGCTTTCTTT	CASSLPDRGRVTEAFF	TRBV4-3	TRBJ1-1
TGTGCCAGCTCACCACGAATAGCCATTCGAATCACTGAAGCTTTCTTT	CASSPRIAIRITEAFF	TRBV18	TRBJ1-1
TGTGCCAGCAGCTTAGATCGGAACCCAGGGAAAAGGGGAAACATTCAGTACTTC	CASSLDRNPGKRGNIQYF	TRBV11-2	TRBJ2-4
TGTGCCAGCAGCGTAGGGGACAGGGGCCCTAGCACAGATACGCAGTATTTT	CASSVGDRGPSTDTQYF	TRBV9	TRBJ2-3
TGTGCCAGCAGCGGGCTTGGGGTCCCTTCCTACGAGCAGTACTTC	CASSGLGVPSYEQYF	TRBV7-8	TRBJ2-7
TGTGCTAGTGGTTTGGAGGACAGACCGACTGAAGCTTTCTTT	CASGLEDRPTEAFF	TRBV12-5	TRBJ1-1
TGTGCCAGCAGCCATAGGACAGGGGGGTCCCCTTCACCCCTCCACTTT	CASSHRTGGSPSPLHF	TRBV14	TRBJ1-6
TGTGCCAGCAGCCAAGAGTGGATCCGATGGGGAAAGGGGGCCAACGTCCTGACTTTC	CASSQEWIRWGKGANVLTF	TRBV14	TRBJ2-6
TGTGCCAGCAGAAAGAACCCAAGGGAGGTGATGATTGGAAACACCATATATTTT	CASRKNPREVMIGNTIYF	TRBV6-1	TRBJ1-3
TGTGCCAGCAGCCCATACTTGGGACAGGGGGACTTTAATGATCAGCCCCAGCATTTT	CASSPYLGQGDFNDQPQHF	TRBV28	TRBJ1-5
TGTGCCACCAGCAGAGGGACCTTCGGGACTAGCGGAGACAATGAGCAGTTCTTC	CATSRGTFGTSGDNEQFF	TRBV15	TRBJ2-1
TGTGCCAGCAGCCAAGACCCCCTTTGTCTCCTGACAGGGTGGACCTACGAGCAGTACTTC	CASSQDPLCLLTGWTYEQYF	TRBV3-1	TRBJ2-7
TGTGCCAGCAGCATGGGTGGGACTAGCGGGGGGGTGAACACCGGGGAGCTGTTTTTT	CASSMGGTSGGVNTGELFF	TRBV7-2	TRBJ2-2
TGTGCCAGCAGCACTCAGAGGGTTCAGCCCCAGCATTTT	CASSTQRVQPQHF	TRBV13	TRBJ1-5
TGTGCCAGCGAGTCATCGGATTCTGGAAACACCATATATTTT	CASESSDSGNTIYF	TRBV6-4	TRBJ1-3
TGTGCCAGCGCTATGACCGGGGAAGAGACCCAGTACTTC	CASAMTGEETQYF	TRBV12-3	TRBJ2-5
TGCGCCAGCAGCCAGGGGGCTAACTATGGCTACACCTTC	CASSQGANYGYTF	TRBV5-1	TRBJ1-2
TGCAGCGTTGAAGAAGGGACACGGTCTGGAAACACCATATATTTT	CSVEEGTRSGNTIYF	TRBV29-1	TRBJ1-3
TGTGCCACGAGGGGGGCCGGGACAAGGGAGAGCTCCTACGAGCAGTACTTC	CATRGAGTRESSYEQYF	TRBV24-1	TRBJ2-7
TGTGCCAGCAGTGCAGGGCATGGGACAGGGAGAGATACGCAGTATTTT	CASSAGHGTGRDTQYF	TRBV7-2	TRBJ2-3
TGTGCCAGCAGCCCAATCCCAGCCCCCTACGAGCAGTACTTC	CASSPIPAPYEQYF	TRBV6-2	TRBJ2-7
TGTGCCAGCATATCAGTCGGCTACACCTTC	CASISVGYTF	TRBV6-6	TRBJ1-2
TGTGCCAGCAGCTTAGATCTGGTAGGGGGGGGTCGAGAGACCCAGTACTTC	CASSLDLVGGGRETQYF	TRBV11-3	TRBJ2-5
TGTGCCAGCAAAGAGTACCGTTCCTACGAGCAGTACTTC	CASKEYRSYEQYF	TRBV25-1	TRBJ2-7
TGCAGCGTTGACCCAGAGCCAAACACTGAAGCTTTCTTT	CSVDPEPNTEAFF	TRBV29-1	TRBJ1-1
TGTGCCAGCAGTTATAATTTGGGGAGGAGGTGGGAGGCCGGGGAGCTGTTTTTT	CASSYNLGRRWEAGELFF	TRBV6-3	TRBJ2-2
TGTGCCAACCCAGGGGGCCTAGCTGTGGGCTACGAGCAGTACTTC	CANPGGLAVGYEQYF	TRBV10-3	TRBJ2-7
TGTGCCAGCAAGACTAGCGGTTACCAAGAGACCCAGTACTTC	CASKTSGYQETQYF	TRBV6-4	TRBJ2-5
TGCGCCAGCAGGGTACAGCGCTACCACCAACCTGAAGCTTTCTTT	CASRVQRYHQPEAFF	TRBV10-1	TRBJ1-1
TGTGCCAGCAGCCGGACAGGGAGCTCCTACGAGCAGTACTTC	CASSRTGSSYEQYF	TRBV14	TRBJ2-7
TGTGCCAGCAGCCTCCTGGTAGAGTGGGACTGTGAAGCTTTCTTT	CASSLLVEWDCEAFF	TRBV7-3	TRBJ1-1
TGTGCCAGCAGCGGGAATCGTCCTAACACCGGGGAGCTGTTTTTT	CASSGNRPNTGELFF	TRBV9	TRBJ2-2
TGCAGTGCAAGACAGGGGCTCCAAAAACTGTTTTTT	CSARQGLQKLFF	TRBV20-1	TRBJ1-4
TGTGCCAGCAGTGAACGGGACAACCAGCAGTACTTC	CASSERDNQQYF	TRBV2	TRBJ2-7
TGCAGTGCTCCTCAGATCCGGGTTAATCAGCCCCAGCATTTT	CSAPQIRVNQPQHF	TRBV20-1	TRBJ1-5
TGTGCCAGCAGCCAAGATCAGGATCGGGGGGGAAACGTCACCGGGGAGCTGTTTTTT	CASSQDQDRGGNVTGELFF	TRBV14	TRBJ2-2
TGCGCCAGCAGCTTGATAGGACCCCCCGACAGGCAGTACTTC	CASSLIGPPDRQYF	TRBV5-1	TRBJ2-7
TGTGCCAGCAGCCAAGATTCGTCGGGACAAGAGCCCCAGCATTTT	CASSQDSSGQEPQHF	TRBV3-1	TRBJ1-5
TGTGCCAGCAGCTCCGCGGGACGTCGGGCATCCGAGCAGTACTTC	CASSSAGRRASEQYF	TRBV6-4	TRBJ2-7
TGTGCCAGCAGCTTAGGGCGACAGGGTGAACATCAGCCCCAGCATTTT	CASSLGRQGEHQPQHF	TRBV7-9	TRBJ1-5
TGTGCCAGCACCCCCTATGAAGGGCAGTATTTT	CASTPYEGQYF	TRBV11-3	TRBJ2-3
TGTTCTCGGACAGGGGTAGATGAAAAACTGTTTTTT	CSRTGVDEKLFF	TRBV7-9	TRBJ1-4
TGTGCCAGCAGCCAAAGCACTTTCTTT	CASSQSTFF	TRBV4-2	TRBJ1-1
TGTGCCAGCAGCTTAAGGGTTCAGACAGGGGACCAGCCCGGGGAGCTGTTTTTT	CASSLRVQTGDQPGELFF	TRBV7-3	TRBJ2-2
TGTGCCAGCAGCGGGGGCGCCCGGTACGAGCAGTACTTC	CASSGGARYEQYF	TRBV13	TRBJ2-7
TGCAGTGCAGGGCGGGAGCATGGTAGCAGCAATCAGCCCCAGCATTTT	CSAGREHGSSNQPQHF	TRBV20-1	TRBJ1-5
TGTGCCAGCAGTGAAGCACAGGGGGCGGTTGAAAAACTGTTTTTT	CASSEAQGAVEKLFF	TRBV2	TRBJ1-4
TGTGCTAGTGGATGGCCTCGAGGGGACAGATCTAGCAATCAGCCCCAGCATTTT	CASGWPRGDRSSNQPQHF	TRBV12-5	TRBJ1-5
TGTGCCAGCAGCGTAGGGACGAACTATGGCTACACCTTC	CASSVGTNYGYTF	TRBV9	TRBJ1-2
TGTGCCATTTGCGGGGGCGCCGGGCCCTACGAGCAGTACTTC	CAICGGAGPYEQYF	TRBV10-3	TRBJ2-7
TGTGCCAGCAGCTTAACTTTGGAGACTAGCGGGAATGAGCAGTTCTTC	CASSLTLETSGNEQFF	TRBV7-9	TRBJ2-1
TGTGCCAGCAGCGGAGAGGGGCAGTATTTT	CASSGEGQYF	TRBV5-4	TRBJ2-3
TGTGCCAGCAGCTTGACTGCCTGGCAGGGCACTGAAGCTTTCTTT	CASSLTAWQGTEAFF	TRBV5-5	TRBJ1-1
TGTGCCAGCAGTTTTGCGGGAGTCGCCCTGAAAAACATTCAGTACTTC	CASSFAGVALKNIQYF	TRBV28	TRBJ2-4
TGTGCCAGCAGCGCCCCCGGGGGGGTGTTCTCCTACGAGCAGTACTTC	CASSAPGGVFSYEQYF	TRBV9	TRBJ2-7
TGCAGTGCTAGAGAATCTAGCGGGCGATACGAGCAGTACTTC	CSARESSGRYEQYF	TRBV20-1	TRBJ2-7
TGTGCCAGCAGCCATGGAGTGCAAAGGCCAGGACAGCAGACTGAAGCTTTCTTT	CASSHGVQRPGQQTEAFF	TRBV14	TRBJ1-1
TGTGCCAGCAGTCGGGGGCAAGAGACCCAGTACTTC	CASSRGQETQYF	TRBV7-7	TRBJ2-5
TGTGCCACCAGTGATTTGTCGGCTAGGACAGGGTCTATCTACGAGCAGTACTTC	CATSDLSARTGSIYEQYF	TRBV24-1	TRBJ2-7
TGTGCCAGCAACCTCTGGGGGAAAGGTTTAATGAACACTGAAGCTTTCTTT	CASNLWGKGLMNTEAFF	TRBV7-3	TRBJ1-1
TGTGCCAGCCCCGGATCTGGTCCCGGGACTGGGACCTACAATGAGCAGTTCTTC	CASPGSGPGTGTYNEQFF	TRBV6-5	TRBJ2-1
TGCAGTGAGAGGGAGTGTTCCTACAATGAGCAGTTCTTC	CSERECSYNEQFF	TRBV20-1	TRBJ2-1
TGCGCCAGCAGCCTTGGGGCTGAAAAACTGTTTTTT	CASSLGAEKLFF	TRBV4-1	TRBJ1-4
TGTGCCAGCAGCTTAGCCGCTCAGGGGGCAATCAATCAGCCCCAGCATTTT	CASSLAAQGAINQPQHF	TRBV11-3	TRBJ1-5
TGTGCCAGCACCCAGGGCAACGGACGCTGGGGCACAGATACGCAGTATTTT	CASTQGNGRWGTDTQYF	TRBV5-6	TRBJ2-3
TGTGCCAGCAGCATATCCGCGCCCTGGGACGGGGACCGGAACACCGGGGAGCTGTTTTTT	CASSISAPWDGDRNTGELFF	TRBV7-2	TRBJ2-2
TGTGCCAGCAGCGCACAGGGATACTACGAGCAGTACTTC	CASSAQGYYEQYF	TRBV13	TRBJ2-7
TGTGCCAGACTCGCCGAGCAGTACTTC	CARLAEQYF	TRBV19	TRBJ2-7
TGTGCCAGCAGGACCAGGAGGAACACTGAAGCTTTCTTT	CASRTRRNTEAFF	TRBV7-8	TRBJ1-1
TGTGCCAGCAGCGACCAGACAGGGAGACGGCCCCCGAACACCGGGGAGCTGTTTTTT	CASSDQTGRRPPNTGELFF	TRBV12-4	TRBJ2-2
TGCAGTGCGCACCCTATAAAACAGCGGAAAAACTATGGCTACACCTTC	CSAHPIKQRKNYGYTF	TRBV20-1	TRBJ1-2
TGTGCCAGCAGAAAGGGCCAGGCCTACGAGCAGTACTTC	CASRKGQAYEQYF	TRBV6-5	TRBJ2-7
TGTGCCAGCAGTGCTTACCCGGGACTCCCCAATCGCTCCTACGAGCAGTACTTC	CASSAYPGLPNRSYEQYF	TRBV2	TRBJ2-7
TGTGCCAGCAGCACCCCAGGGCTTGAGCAGTACTTC	CASSTPGLEQYF	TRBV9	TRBJ2-7
TGCAGTGCTAGGTCAGACAGGGGGAGGACCCAGTACTTC	CSARSDRGRTQYF	TRBV20-1	TRBJ2-5
TGCAGTGAGGAGTCAGAGACCCAGTACTTC	CSEESETQYF	TRBV20-1	TRBJ2-5
TGTGCCAGCAGCAGACCGGGGACAGAGGCCACTGAAGCTTTCTTT	CASSRPGTEATEAFF	TRBV13	TRBJ1-1
TGTGCCAGCAGCTTCGGATCCGGCGCTAACTATGGCTACACCTTC	CASSFGSGANYGYTF	TRBV7-9	TRBJ1-2
TGTGCCAGCCAGACTAGAAACATTCAGTACTTC	CASQTRNIQYF	TRBV24-1	TRBJ2-4
TGTGCCAGCAGCGTACTGGGACAGGGGGAAGGCTACGAGCAGTACTTC	CASSVLGQGEGYEQYF	TRBV9	TRBJ2-7
TGCGCCAGCAGCCAAGATGACAGCCCTGGGGCCAACGTCCTGACTTTC	CASSQDDSPGANVLTF	TRBV4-1	TRBJ2-6
TGCAGTGCTAGTGTTTCCGGGGGTGGCGAGGTCGACTCCTACGAGCAGTACTTC	CSASVSGGGEVDSYEQYF	TRBV20-1	TRBJ2-7
TGTGCCAGCAGCGGCCATACCTACGAGCAGTACTTC	CASSGHTYEQYF	TRBV9	TRBJ2-7
TGTGCCAGTAGTATCAGAGTGATTCCCATCCCGGGCCACAATGGCTACACCTTC	CASSIRVIPIPGHNGYTF	TRBV19	TRBJ1-2
TGTGCCAGCAGCCTGGGGATCCCGACAGTGGTAGCAACTAATGAAAAACTGTTTTTT	CASSLGIPTVVATNEKLFF	TRBV7-9	TRBJ1-4
TGTGCCAGCAGTTACCCTGGAGACAGGGCACTGTTCTTT	CASSYPGDRALFF	TRBV12-3	TRBJ1-1
TGTGCCACCAGTGACGGGACAGGCACTGAAGCTTTCTTT	CATSDGTGTEAFF	TRBV24-1	TRBJ1-1
TGTGCCAGCAGTGACGGGGGATTCCGGACAGAATCGGATACGCAGTATTTT	CASSDGGFRTESDTQYF	TRBV6-4	TRBJ2-3
TGCAGCGCCCCCAGGGACGAACGGGGAAACACCATATATTTT	CSAPRDERGNTIYF	TRBV29-1	TRBJ1-3
TGCGCCAGCAGCTCCTTTCCACGGGGGGCCAGCTCCTACAATGAGCAGTTCTTC	CASSSFPRGASSYNEQFF	TRBV5-1	TRBJ2-1
TGTGCCAGCAGTTACTCGACGAACCCGGGACAGAGTCGAAACTATGGCTACACCTTC	CASSYSTNPGQSRNYGYTF	TRBV6-3	TRBJ1-2
TGTGCCAGCAGGCCGGGGAGAGCGGGAGTCTATGGCTACACCTTC	CASRPGRAGVYGYTF	TRBV12-3	TRBJ1-2
TGTGCCAGCAGTAGACTAGCGAACACCGGGGAGCTGTTTTTT	CASSRLANTGELFF	TRBV6-3	TRBJ2-2
TGTGCCAGCAGCTTAGGTAACCGGGGACAGGGGGCCTGTTCCGAGACCCAGTACTTC	CASSLGNRGQGACSETQYF	TRBV7-8	TRBJ2-5
TGCAGTGCTAGAGCATCCCTTACCCTTACTCCGTCAATGGGGCCCTGGTCACCCCTCCACTTT	CSARASLTLTPSMGPWSPLHF	TRBV20-1	TRBJ1-6
TGTGCCAGCAGCTTTATGGACAGGGGAGGCCTTCCTCAAGCCAAAAACATTCAGTACTTC	CASSFMDRGGLPQAKNIQYF	TRBV11-1	TRBJ2-4
TGTGCCAGCAGCTTGGTGGGGTGCTCCTACGAGCAGTACTTC	CASSLVGCSYEQYF	TRBV5-6	TRBJ2-7
TGTGCCAGCAGTAGGGCGGGTACTAATGAAAAACTGTTTTTT	CASSRAGTNEKLFF	TRBV6-5	TRBJ1-4
TGTGGGACACAGGGGGCGCGGCCATTCTACAATGAGCAGTTCTTC	CGTQGARPFYNEQFF	TRBV6-6	TRBJ2-1
TGTGCCAGCAGCGTCGTGAGGGGGGGTCAAGAGACCCAGTACTTC	CASSVVRGGQETQYF	TRBV7-6	TRBJ2-5
TGTGCCAGCAGCTCCTTTGACAGGGTGTTCCCCTACGAGCAGTACTTC	CASSSFDRVFPYEQYF	TRBV13	TRBJ2-7
TGCAGTGCTAGATTTGTGGGGGGGCATGTGGGGTACCAAGAGACCCAGTACTTC	CSARFVGGHVGYQETQYF	TRBV20-1	TRBJ2-5
TGTGCCAGCAGTGCTGAGGCCACTAACTATGGCTACACCTTC	CASSAEATNYGYTF	TRBV6-5	TRBJ1-2
TGTGCCAGCAGTTACTCGAGCAGGGGTTTTCGGGAACCCCCCAGGAATCAGCCCCAGCATTTT	CASSYSSRGFREPPRNQPQHF	TRBV6-5	TRBJ1-5
TGTGCCACCGAGGGGGCTGAGTACGAGCAGTACTTC	CATEGAEYEQYF	TRBV24-1	TRBJ2-7
TGTGCCCATAACAGGGCCAATCAGCCCCAGCATTTT	CAHNRANQPQHF	TRBV6-1	TRBJ1-5
TGTGCCAGCAAAGTCCCCAGGGGGCTACTTCCTTATAGCAATCAGCCCCAGCATTTT	CASKVPRGLLPYSNQPQHF	TRBV6-4	TRBJ1-5
TGTGCCAGCACCCCCGGGGGGATCGTCACCGGGGAGCTGTTTTTT	CASTPGGIVTGELFF	TRBV7-3	TRBJ2-2
TGCAGTGCTATGTCCACAGGGGATACGCCCTATGGCTACACCTTC	CSAMSTGDTPYGYTF	TRBV20-1	TRBJ1-2
TGCAGTGCGAAGGGGTGTAGGTACCAAGAGACCCAGTACTTC	CSAKGCRYQETQYF	TRBV20-1	TRBJ2-5
TGTGCCAGCAGGAGGGGGGGCCGCAATGAGCAGTTCTTC	CASRRGGRNEQFF	TRBV27	TRBJ2-1
TGTGCCAGCAGCCATCCCTTTGGGAGGTATACCCGTGGCTACACCTTC	CASSHPFGRYTRGYTF	TRBV3-1	TRBJ1-2
TGTGCCAGTAGTATCGGGACCAGGGACAGGAGCTCCTATAATTCACCCCTCCACTTT	CASSIGTRDRSSYNSPLHF	TRBV19	TRBJ1-6
TGTGCCAGCAAGCAAGAACAAGGGAGGGGGGGTAACTATGGCTACACCTTC	CASKQEQGRGGNYGYTF	TRBV28	TRBJ1-2
TGTGCCAGCAGCTTAATCCTGGGGACACACACTGAAGCTTTCTTT	CASSLILGTHTEAFF	TRBV5-6	TRBJ1-1
TGTGCCAGCAGCCAAGGACAAGAAATTTGGGTTAATGGCTACACCTTC	CASSQGQEIWVNGYTF	TRBV3-1	TRBJ1-2
TGTGCCAGCAGCCCGACTTGTGGACAGGTCACCTACACTGAAGCTTTCTTT	CASSPTCGQVTYTEAFF	TRBV7-2	TRBJ1-1
TGCGCCAGCAGCTGTTCGGGGGTCCAACGAGATGAGCAGTTCTTC	CASSCSGVQRDEQFF	TRBV5-1	TRBJ2-1
TGTGCCATCAGTGTAAAGCGGAACAGGGGGCAACTGGGGATCTACGAGCAGTACTTC	CAISVKRNRGQLGIYEQYF	TRBV10-3	TRBJ2-7
TGTGCCAGCACCTGCGGACCGGGGGGCCTTGGGAGCTCCTACAATGAGCAGTTCTTC	CASTCGPGGLGSSYNEQFF	TRBV5-4	TRBJ2-1
TGTGCCAGCAGTCAGGCCCCGGGGGGGGGAGTGACAGATACGCAGTATTTT	CASSQAPGGGVTDTQYF	TRBV6-5	TRBJ2-3
TGTGCCAGCAGTTCTCGGGACAGGAATAGCAATCAGCCCCAGCATTTT	CASSSRDRNSNQPQHF	TRBV2	TRBJ1-5
TGTGCCACCAGTGATTTATGGACCTGGGACAGGGGACCATTTTGCAATCAGCCCCAGCATTTT	CATSDLWTWDRGPFCNQPQHF	TRBV24-1	TRBJ1-5
TGTGCCAGCAGTCGGCGGGGGTATGGCTACACCTTC	CASSRRGYGYTF	TRBV6-4	TRBJ1-2
TGTGCCAAGCCACAGGTGTTACGCGGGGGGGAAAAACTGTTTTTT	CAKPQVLRGGEKLFF	TRBV28	TRBJ1-4
TGTGCCAGCAGCTTAGTCACGAGGGCTTTCTTT	CASSLVTRAFF	TRBV7-6	TRBJ1-1
TGTGCCTGGAGTGTATACGTGTTCCCCCTCAGGAGGTATGGCTACACCTTC	CAWSVYVFPLRRYGYTF	TRBV30	TRBJ1-2
TGTGCCAGCAGCCCGTCAGGGACCACTGGCTACACCTTC	CASSPSGTTGYTF	TRBV13	TRBJ1-2
TGTGCCAGCACTTTTTGGGGGGATCTCTATGGCTACACCTTC	CASTFWGDLYGYTF	TRBV9	TRBJ1-2
TGTGCCAGCAGTTGGTCACCGGGACAGAGAACCTACGAGCAGTACTTC	CASSWSPGQRTYEQYF	TRBV27	TRBJ2-7
TGTGCCAGCAGTGACTCGACAGTGGGACAAGGGGGGGATGAAAAACTGTTTTTT	CASSDSTVGQGGDEKLFF	TRBV6-4	TRBJ1-4
TGTGCCAGCAGCTCTACCCCAGAGTTCCAGCCCCAGCATTTT	CASSSTPEFQPQHF	TRBV7-4	TRBJ1-5
TGTGCTAGTGGTTTGGAATTGCCCGGGACAGGGGGCGCCCAAGCACCTGGAATCTACGAGCAGTACTTC	CASGLELPGTGGAQAPGIYEQYF	TRBV12-5	TRBJ2-7
TGTGCCAGCAGCTTACATGTCGGGACAATTGATGAGCAGTTCTTC	CASSLHVGTIDEQFF	TRBV7-3	TRBJ2-1
TGTGCCTGGGGATCCAGGAAGGAAAAACTGTTTTTT	CAWGSRKEKLFF	TRBV30	TRBJ1-4
TGTGCCAGGCAGGACAATTCACCCCTCCACTTT	CARQDNSPLHF	TRBV27	TRBJ1-6
TGTGCCAGCACCCTCGATAAGAACACTGAAGCTTTCTTT	CASTLDKNTEAFF	TRBV28	TRBJ1-1
TGTGCCAGCAGTGAACTATGGACTAGCGGGCGAGATACGCAGTATTTT	CASSELWTSGRDTQYF	TRBV2	TRBJ2-3
TGTGCCAGCAGCTTAGTAGGGGACGAGCAGTACTTC	CASSLVGDEQYF	TRBV11-2	TRBJ2-7
TGTGCCTGGAGGAGGGAGGAGGAGGGTAACTATGGCTACACCTTC	CAWRREEEGNYGYTF	TRBV30	TRBJ1-2
TGTGCCAGCAGCTTGAGGGGCCGCGACCTCGGCAATGAGCAGTTCTTC	CASSLRGRDLGNEQFF	TRBV5-4	TRBJ2-1
TGTGCCCGGAAGGGGAGGGAACGGGCGTCTGGAAACACCATATATTTT	CARKGRERASGNTIYF	TRBV5-4	TRBJ1-3
TGCACCGGGACAGAGGGCACAGATACGCAGTATTTT	CTGTEGTDTQYF	TRBV29-1	TRBJ2-3
TGTGCCAGCAGCCAAGGAGGGGTGGCAACTAATGAAAAACTGTTTTTT	CASSQGGVATNEKLFF	TRBV14	TRBJ1-4
TGTGCCAGGAAATCCCTCCCCGGTGGAGAAAGAGAACTAGCGGGAGGGGTCATCACCGGGGAGCTGTTTTTT	CARKSLPGGERELAGGVITGELFF	TRBV5-6	TRBJ2-2
TGTGCCAGCAGCGTAGCGACAGTGGCTCACGAGCAGTACTTC	CASSVATVAHEQYF	TRBV9	TRBJ2-7
TGTGCCAGCAGCCCACAGGGCCTTAACTATGGCTACACCTTC	CASSPQGLNYGYTF	TRBV13	TRBJ1-2
TGTGCCAGCAGTTCTAGCGGGGGGTCCTACAATGAGCAGTTCTTC	CASSSSGGSYNEQFF	TRBV6-3	TRBJ2-1
TGTGCCAGCAGCTTAAGAACAGGGGGCGTGAACACTGAAGCTTTCTTT	CASSLRTGGVNTEAFF	TRBV7-8	TRBJ1-1
TGCGCCAGCAGCTTGAGGCGGTGGAGAAATGAGCAGTTCTTC	CASSLRRWRNEQFF	TRBV5-1	TRBJ2-1
TGTGCCAGCAGGGTCGGGAGGACCTACGAGCAGTACTTC	CASRVGRTYEQYF	TRBV11-3	TRBJ2-7
TGTGCCAGCAGCACCCACAGGGGGGGGGAGCAGTTCTTC	CASSTHRGGEQFF	TRBV13	TRBJ2-1
TGTGCCAGTAGGGGGGGAACTAGCGGGAGTCCGTCGAACACTGAAGCTTTCTTT	CASRGGTSGSPSNTEAFF	TRBV19	TRBJ1-1
TGCAGTATCGAGAATCGTGAGCAGTTCTTC	CSIENREQFF	TRBV20-1	TRBJ2-1
TGTGCTATGGACAGGGACCCGAAAGGCATGAACACTGAAGCTTTCTTT	CAMDRDPKGMNTEAFF	TRBV9	TRBJ1-1
TGTGCCAGCAGGCCGGGGCACGAGCAGTACTTC	CASRPGHEQYF	TRBV28	TRBJ2-7
TGCAGTGCTGCTGACAGGCGGTACCCCACCGGGGAGCTGTTTTTT	CSAADRRYPTGELFF	TRBV20-1	TRBJ2-2
TGTGCCAGCCACTCCACAACCGGACAGGGACTAAGCCAGGCGAACACTGAAGCTTTCTTT	CASHSTTGQGLSQANTEAFF	TRBV27	TRBJ1-1
TGTGCCAGCCTAGCGGGTTCCTACGAGCAGTACTTC	CASLAGSYEQYF	TRBV7-2	TRBJ2-7
TGTGCCAGCAGTGACCCGGTACGCTCGAGTCCAGATACGCAGTATTTT	CASSDPVRSSPDTQYF	TRBV6-4	TRBJ2-3
TGTGCCAGCAGTTCCCTTACGAGACTAGCGGGAGGGCCCAGCTCCTACGAGCAGTACTTC	CASSSLTRLAGGPSSYEQYF	TRBV6-5	TRBJ2-7
TGCAGTGCGGTAAAGGTGGCGCGGGCCTACGAGCAGTACTTC	CSAVKVARAYEQYF	TRBV20-1	TRBJ2-7
TGTGCCAGCAGCGACGGACAGTCGCAGTTCTTC	CASSDGQSQFF	TRBV13	TRBJ2-1
TGTGCCACCAGCAGCCGTAGGGGGCGCGCCTATAGCAATCAGCCCCAGCATTTT	CATSSRRGRAYSNQPQHF	TRBV15	TRBJ1-5
TGTGCCAGCAGCCTCAGGAATGGATGTCCTGGAAACACCATATATTTT	CASSLRNGCPGNTIYF	TRBV9	TRBJ1-3
TGCGCCAAGCAGGCCACAGGGGGAATCGAGCCCCAGCATTTT	CAKQATGGIEPQHF	TRBV10-1	TRBJ1-5
TGCGCCAGCAGCCAAAACGAAGTCAAGGGAACCGACGATACGCAGTATTTT	CASSQNEVKGTDDTQYF	TRBV4-3	TRBJ2-3
TGTGCCTGCAGACGTTCAAGACAGGGCCTCCGCTACGAGCAGTACTTC	CACRRSRQGLRYEQYF	TRBV30	TRBJ2-7
TGTGCCTGGAGTGTAGTTAACAAAAATCAGCCCCAGCATTTT	CAWSVVNKNQPQHF	TRBV30	TRBJ1-5
TGTGCCAGCAGCTTAGTAAATCTCCGGGACAGGGTGGCCTACGAGCAGTACTTC	CASSLVNLRDRVAYEQYF	TRBV7-2	TRBJ2-7
TGTGCCAGCAGCACGCCACAGGTGATTGGGGGTAATGAAAAACTGTTTTTT	CASSTPQVIGGNEKLFF	TRBV14	TRBJ1-4
TGTGCCAGCACCCGAGCAGGGTCCCTATTACTAGGTCAGCCCCAGCATTTT	CASTRAGSLLLGQPQHF	TRBV27	TRBJ1-5
TGTGCCAGCAGGGCCCCCGGGGGGAACACTGAAGCTTTCTTT	CASRAPGGNTEAFF	TRBV27	TRBJ1-1
TGTGCCAGCAGCTTCCCCGAAGGACAGGGGCACTACAGGTGGAGGGAGAATTGGCATGGCTACACCTTC	CASSFPEGQGHYRWRENWHGYTF	TRBV7-3	TRBJ1-2
TGTGCCAGCAGTAGGGGGCTTCACTATGGCTACACCTTC	CASSRGLHYGYTF	TRBV6-4	TRBJ1-2
TGTGCCAGCAGGTGTGGGGGGGGGGGGGGGAAAACCGGGGAGCTGTTTTTT	CASRCGGGGGKTGELFF	TRBV6-4	TRBJ2-2
TGCAGTGCTAGAGTGGGGATGCGCACAGATACGCAGTATTTT	CSARVGMRTDTQYF	TRBV20-1	TRBJ2-3
TGTGCCAGAGAACTCGAGACCCAGTACTTC	CARELETQYF	TRBV7-9	TRBJ2-5
TGTGCCAGCATTAGCTTCACACAGGGGGGCTCCAATGAGCAGTTCTTC	CASISFTQGGSNEQFF	TRBV7-9	TRBJ2-1
TGTGCCAGCAGCCAAGCACTCAAATTAGACGGCCATGAGCAGTTCTTC	CASSQALKLDGHEQFF	TRBV4-2	TRBJ2-1
TGTGCCAGCAGTTTTCACGGGACCTACAATGAGCAGTTCTTC	CASSFHGTYNEQFF	TRBV6-1	TRBJ2-1
TGTGCCATCAGAAAGGGAGACCGGGGGGGTGAGCAGTTCTTC	CAIRKGDRGGEQFF	TRBV10-3	TRBJ2-1
TGTGCCATCCGAGTTAAACAGGGTCAGGGCACAGATACGCAGTATTTT	CAIRVKQGQGTDTQYF	TRBV10-3	TRBJ2-3
TGTGCCAGCAGTGAAGAGGGGGCTTTATTCTTT	CASSEEGALFF	TRBV6-1	TRBJ1-1
TGTGCCAGCAGTTACAAAACACTAGCGGGCTACGAGCAGTACTTC	CASSYKTLAGYEQYF	TRBV6-6	TRBJ2-7
TGTGCCAGCAGTGGTGGCACTTCAGGGGCCAAAAACATTCAGTACTTC	CASSGGTSGAKNIQYF	TRBV6-2	TRBJ2-4
TGTGCCACCAGCCGGGGGACAGGGCAAGAGACCCAGTACTTC	CATSRGTGQETQYF	TRBV15	TRBJ2-5
TGTGCCAGCAGCTTAGGGATCCCTACTAGCGGGGGATTATCCTACGAGCAGTACTTC	CASSLGIPTSGGLSYEQYF	TRBV11-2	TRBJ2-7
TGTGCCAGCAGTGCGGACAGGGGGTACTTC	CASSADRGYF	TRBV6-5	TRBJ2-7
TGCGCCAGCAGCTTTAAGCGTCCGGGGCTGTTTTTT	CASSFKRPGLFF	TRBV5-1	TRBJ2-2
TGTGCCAGCAGTCAAACTAGTTGCAACAATGAGCAGTTCTTC	CASSQTSCNNEQFF	TRBV12-4	TRBJ2-1
TGTGCCAGCAGCAGGGCTGCAAGGGGGGGCCCTCCTCTGGAAAGCTACGAGCAGTACTTC	CASSRAARGGPPLESYEQYF	TRBV13	TRBJ2-7
TGTGCCAGCATTCAGGCAACCTTCGATGAGCAGTTCTTC	CASIQATFDEQFF	TRBV5-6	TRBJ2-1
TGTGCCAGCAGCTCAATCCTGACGGGGTACGAGCAGTACTTC	CASSSILTGYEQYF	TRBV5-6	TRBJ2-7
TGTGCCAGCGTGGCAGGCTATGGCTACACCTTC	CASVAGYGYTF	TRBV7-6	TRBJ1-2
TGTGCCAGCAGCCAAGACTCCGGTAGCCAGCCCCAGCATTTT	CASSQDSGSQPQHF	TRBV14	TRBJ1-5
TGTGCCAGCTCACCACCGCCGGCGGAGGAGATGAACACTGAAGCTTTCTTT	CASSPPPAEEMNTEAFF	TRBV18	TRBJ1-1
TGTGCCAGCAGCACGTCGTACCGAGGTCCCTACAATGAGCAGTTCTTC	CASSTSYRGPYNEQFF	TRBV11-2	TRBJ2-1
TGTGCCACCAGTGAAGAGGACCTGGGCAGGGGGAACACTGAAGCTTTCTTT	CATSEEDLGRGNTEAFF	TRBV24-1	TRBJ1-1
TGTGCCAGCAGCTACAGACAGGGATCCAGGAACTATGGCTACACCTTC	CASSYRQGSRNYGYTF	TRBV5-4	TRBJ1-2
TGCGCCAGCAGCCAAGAGGTACTAGCGGGAGTTACGGAGCAGTACTTC	CASSQEVLAGVTEQYF	TRBV4-1	TRBJ2-7
TGTGCCAGCAGTGAAGGGACAGGGGTGGTTGGCTACACCTTC	CASSEGTGVVGYTF	TRBV6-1	TRBJ1-2
TGCAGCGACACTGAACGGGGACTATTAGGCACAGATACGCAGTATTTT	CSDTERGLLGTDTQYF	TRBV29-1	TRBJ2-3
TGCAGTGCTTTTTTGGGGAACTATAAGACCCAGTACTTC	CSAFLGNYKTQYF	TRBV20-1	TRBJ2-5
TGCGCCAGCAGCTCAGGACAGAACCAGGCCTTGTCGACCCAGTACTTC	CASSSGQNQALSTQYF	TRBV5-1	TRBJ2-5
TGTGCCAGCAGTTTATGGGCCCGGTATCAGCCCCAGCATTTT	CASSLWARYQPQHF	TRBV12-3	TRBJ1-5
TGTGCCAGCAGGGGAGCGATAGGCACAGATACGCAGTATTTT	CASRGAIGTDTQYF	TRBV12-4	TRBJ2-3
