TGTGCCAGCAGCTTAGGGCTGGGACAGGGTCGGACTGAAGCTTTCTTT	CASSLGLGQGRTEAFF	TRBV7-9	TRBJ1-1
TGTGCCAGCAGCTTGGCCGAGGAGGACAGCACCGGGGAGCTGTTTTTT	CASSLAEEDSTGELFF	TRBV5-5	TRBJ2-2
TGCGCCAGCAGCCCCCCCTCCGGTGGAATAGTTAGTAATGAGCAGTTCTTC	CASSPPSGGIVSNEQFF	TRBV4-3	TRBJ2-1
TGTGCCATCATGGAGACGGCAGCGGGACGGTCCGGGGAGCTGTTTTTT	CAIMETAAGRSGELFF	TRBV10-3	TRBJ2-2
TGTGCCACCAAGTCCTTTGAGACAGCCTTCGATTCACCCCTCCACTTT	CATKSFETAFDSPLHF	TRBV24-1	TRBJ1-6
TGTGCCAGCAGAGCCCTCCCCGGTCGACTAGCCTCCCAAGAGACCCAGTACTTC	CASRALPGRLASQETQYF	TRBV27	TRBJ2-5
TGTGGACATCACTACGAGCAGTACTTC	CGHHYEQYF	TRBV28	TRBJ2-7
TGTGCCAGCAGTGGTCGACGGGAGGGGGAAAGCAATCAGCCCCAGCATTTT	CASSGRREGESNQPQHF	TRBV25-1	TRBJ1-5
TGTGCCAGCTCACCTGGACCGGGACGTGAGGGTGATACGCAGTATTTT	CASSPGPGREGDTQYF	TRBV18	TRBJ2-3
TGTGCCAGCAGCCGGCGACAGGGACAGGGAGGGGCGAACGGCTACACCTTC	CASSRRQGQGGANGYTF	TRBV7-9	TRBJ1-2
TGTGCCACCAGTTCTGGGGTAAACAGGTTTGGGAACACCTTC	CATSSGVNRFGNTF	TRBV24-1	TRBJ1-2
TGTGCCAGCAGCCGGGGGGGCCGGGAGCAAGAGACCCAGTACTTC	CASSRGGREQETQYF	TRBV7-2	TRBJ2-5
TGCAGTGCTAGGTCTGTAGGACAGGGCAAGGGCGGGTACAATGAGCAGTTCTTC	CSARSVGQGKGGYNEQFF	TRBV20-1	TRBJ2-1
TGTGCCAGCAGCTTAGAGAGTGGGACTAGCGGGGGCCAAGAGACCCAGTACTTC	CASSLESGTSGGQETQYF	TRBV7-6	TRBJ2-5
TGTGCCAGCAGCTCCACTAGAGGACCCACTGAAGCTTTCTTT	CASSSTRGPTEAFF	TRBV13	TRBJ1-1
TGTGCCAGCAGCTCCGCAGTTAGCAATCAGCCCCAGCATTTT	CASSSAVSNQPQHF	TRBV5-8	TRBJ1-5
TGTGCCAGCAGCACCTGTAGCGGGGTGGGATGGAGGCCCGAGCAGTTCTTC	CASSTCSGVGWRPEQFF	TRBV9	TRBJ2-1
TGTGCCAGCAGCTTCCAGGACAGGGTGAATGGCTACACCTTC	CASSFQDRVNGYTF	TRBV7-3	TRBJ1-2
TGTGCCAGCAGGGGTGGAGGGATGTATAGCAATCAGCCCCAGCATTTT	CASRGGGMYSNQPQHF	TRBV9	TRBJ1-5
TGTGCCAGCAGCCCAGTACCGCATCAGCCCCAGCATTTT	CASSPVPHQPQHF	TRBV13	TRBJ1-5
TGTGCCAGCAGCCCGGGGGGCACTCGAAAAGTGGGTTGCTCCTACGAGCAGTACTTC	CASSPGGTRKVGCSYEQYF	TRBV2	TRBJ2-7
TGTGCCAGCTCACAGGGGACGAGGCGGGCCTACAATGAGCAGTTCTTC	CASSQGTRRAYNEQFF	TRBV18	TRBJ2-1
TGCGCCAGCAGCCATCACCGGTGCGGGGACTTC	CASSHHRCGDF	TRBV4-1	TRBJ2-7
TGTGCCAGCAGCTATGTGACAGGAGACTATGGCTACACCTTC	CASSYVTGDYGYTF	TRBV6-4	TRBJ1-2
TGTGCCAGCAGGGCGGGGAGGCGTTCGCATGGCTACACCTTC	CASRAGRRSHGYTF	TRBV6-4	TRBJ1-2
TGTGCCAGCAGCGGAAGACAGACCACCGGGGAGCTGTTTTTT	CASSGRQTTGELFF	TRBV9	TRBJ2-2
TGTGCCAGCAGCAATCTGGGCCAGAGGTACCAAGAGACCCAGTACTTC	CASSNLGQRYQETQYF	TRBV7-6	TRBJ2-5
TGTGCCAGCAGCTTGGTGACAGGTCGCTACGAGCAGTACTTC	CASSLVTGRYEQYF	TRBV9	TRBJ2-7
TGTGCCAGCAGTTCTAGCCACTCTGGAAACACCATATATTTT	CASSSSHSGNTIYF	TRBV6-1	TRBJ1-3
TGTGCCAGCAGTATCGGACAGGGACGCAGTAGCAATCAGCCCCAGCATTTT	CASSIGQGRSSNQPQHF	TRBV6-5	TRBJ1-5
TGTGCCTGGCAGAGGACAGGGGGCAGAAATGAAAAACTGTTTTTT	CAWQRTGGRNEKLFF	TRBV30	TRBJ1-4
TGTGCCAGCAGTAGACAGGTGAGCAGCACCGGGGAGCTGTTTTTT	CASSRQVSSTGELFF	TRBV25-1	TRBJ2-2
TGTGCCAGCAGTACGGGGGGGAGAAAGAAGAGTGGCTACACCTTC	CASSTGGRKKSGYTF	TRBV28	TRBJ1-2
TGCAGTGCTAGAGCGCCGCGGGGAGGGGGGAAATCAGAGACCCAGTACTTC	CSARAPRGGGKSETQYF	TRBV20-1	TRBJ2-5
TGTGCCAGCAGCCAAGAACTTCTCGCAGATACGCAGTATTTT	CASSQELLADTQYF	TRBV3-1	TRBJ2-3
TGTGCCAGTAGTACAGAGGTGACTAGCGGCGGTGGTAGTACGCAGTATTTT	CASSTEVTSGGGSTQYF	TRBV19	TRBJ2-3
TGTGCCAGCAGCGTACAGAAAGGACTAGCGGGGGGGGGCACAGATACGCAGTATTTT	CASSVQKGLAGGGTDTQYF	TRBV13	TRBJ2-3
TGTGCCAGCACTGTGTCGACTAGCGGGCTTCCAGAGACCCAGTACTTC	CASTVSTSGLPETQYF	TRBV12-3	TRBJ2-5
TGCGCCAGCAGTGAGCTTAAGAGAAGTCGGGGGGGCTGGGATGAGCAGTTCTTC	CASSELKRSRGGWDEQFF	TRBV10-1	TRBJ2-1
TGCGCCAGCGGAGGATCGGACAGGGGTGTCTACAATGAGCAGTTCTTC	CASGGSDRGVYNEQFF	TRBV5-1	TRBJ2-1
TGTGCCAGCAGTGAGACTAGCGGGGACTATGAGCAGTTCTTC	CASSETSGDYEQFF	TRBV27	TRBJ2-1
TGCGCCAGCAGCCAAGATCGACTGGACCACAATCAGCCCCAGCATTTT	CASSQDRLDHNQPQHF	TRBV4-1	TRBJ1-5
TGTGCCAGCAGGGACCCCAGGAGGGGAGACTTCACCGGGGAGCTGTTTTTT	CASRDPRRGDFTGELFF	TRBV6-1	TRBJ2-2
TGCAGTGAGCGTAGCACAGGGCGATTGGAGGGGTCTGGGGCCAACGTCCTGACTTTC	CSERSTGRLEGSGANVLTF	TRBV20-1	TRBJ2-6
TGTGCCAGCAGCCAAAACAGGGTCGGGGGGAACACTGAAGCTTTCTTT	CASSQNRVGGNTEAFF	TRBV14	TRBJ1-1
TGTGCCAACAAGCTAGCGGGTATTGGGGCCAACGTCCTGACTTTC	CANKLAGIGANVLTF	TRBV27	TRBJ2-6
TGTGCCAGCGATGTCGTCTGGACCTACGAGCAGTACTTC	CASDVVWTYEQYF	TRBV25-1	TRBJ2-7
TGTGCCAGCAATGCGGGACTAGCGGGAGGGAGCACCGGGGAGCTGTTTTTT	CASNAGLAGGSTGELFF	TRBV7-2	TRBJ2-2
TGTGCCAGCAGCCAAGGAACCAACAGGGGCGATCAGCCCCAGCATTTT	CASSQGTNRGDQPQHF	TRBV3-1	TRBJ1-5
TGTGCCAGCAGGGAGAACCCCCCATACCCCCCCAAAAACATTCAGTACTTC	CASRENPPYPPKNIQYF	TRBV27	TRBJ2-4
TGTGCCCGCACATACTATAGCAATCAGCCCCAGCATTTT	CARTYYSNQPQHF	TRBV6-6	TRBJ1-5
TGTGCCAGCAGTTTGGGGGGGGTTCAGACCCAGTACTTC	CASSLGGVQTQYF	TRBV12-4	TRBJ2-5
TGTGCTAGTGGCTATACTTCGAGGGGGGTCCCGGCAGATACGCAGTATTTT	CASGYTSRGVPADTQYF	TRBV12-5	TRBJ2-3
TGTGCCAGCAGTTTAGCCCGGGACAGGGGCCACACCGGGGAGCTGTTTTTT	CASSLARDRGHTGELFF	TRBV12-3	TRBJ2-2
TGTGCCACCAGCAGGATGACTAGCGGGGGGGCTTTCACGCAGTATTTT	CATSRMTSGGAFTQYF	TRBV15	TRBJ2-3
TGTGCCAGCAATAGGGCAATTACCTACGAGCAGTACTTC	CASNRAITYEQYF	TRBV9	TRBJ2-7
TGCAGTGCTTCTCTTCCCGGGACTAGCGGGACAGATACGCAGTATTTT	CSASLPGTSGTDTQYF	TRBV20-1	TRBJ2-3
TGTGCCAGCCCTACCTACGAGCAGTACTTC	CASPTYEQYF	TRBV9	TRBJ2-7
TGTGCCAGCAGTTACGCAAGCAGGGGAGGGGGCGAGCAGTACTTC	CASSYASRGGGEQYF	TRBV6-5	TRBJ2-7
TGTGCCAACACGACAGGGCCTGAAAAACTGTTTTTT	CANTTGPEKLFF	TRBV7-8	TRBJ1-4
TGTGCTTCTAAGGGCCGCAACTATGGCTACACCTTC	CASKGRNYGYTF	TRBV7-6	TRBJ1-2
TGTGCCAGCAGCTTCCCGGGGGTCCTAGACTCCTACGAGCAGTACTTC	CASSFPGVLDSYEQYF	TRBV5-5	TRBJ2-7
TGTGCCAGCAGTTTGACAAACGGGATTTACCGCACAGATACGCAGTATTTT	CASSLTNGIYRTDTQYF	TRBV27	TRBJ2-3
TGCAGTCCACCCATCCTGGGAAGGACTAGTCAAGAGACCCAGTACTTC	CSPPILGRTSQETQYF	TRBV20-1	TRBJ2-5
TGTGCCAGCAGTGCAAACAGGGGGGAATACAATGAGCAGTTCTTC	CASSANRGEYNEQFF	TRBV2	TRBJ2-1
TGTGCCAGCAGTTTGGGGATGAAGTTAAGGGTTCAGGGAAGCTATGGCTACACCTTC	CASSLGMKLRVQGSYGYTF	TRBV27	TRBJ1-2
TGTGCCAGCAGCCCTGCCGAGGGCCCTAGGGACGGGGAGCTGTTTTTT	CASSPAEGPRDGELFF	TRBV11-2	TRBJ2-2
TGTGCCAGCAGCCAAGATCCCTTATTCGGGACTAGCGGCCAAGCGAACACCGGGGAGCTGTTTTTT	CASSQDPLFGTSGQANTGELFF	TRBV4-2	TRBJ2-2
TGTGCCAGCAGCTTGGCAGTATCCTACGAGCAGTACTTC	CASSLAVSYEQYF	TRBV5-4	TRBJ2-7
TGTGCCAGCAGTTACTCTTCCAATAATGCAGGGGATACGAACACTGAAGCTTTCTTT	CASSYSSNNAGDTNTEAFF	TRBV6-2	TRBJ1-1
TGTGCTAGTGGTTTGGGGGGGCTTCCTCACGAGCAGTACTTC	CASGLGGLPHEQYF	TRBV12-5	TRBJ2-7
TGTGCCAGCAACGACAGACCCGGGACAGGGAGGGTACAGACGAACACCGGGGAGCTGTTTTTT	CASNDRPGTGRVQTNTGELFF	TRBV5-6	TRBJ2-2
TGTGCCAGCAGCCTGTCATCCTACAATGAGCAGTTCTTC	CASSLSSYNEQFF	TRBV7-3	TRBJ2-1
TGTGCCAGGCGTCGGGAGGGCAGGAGAAACACCGGGGAGCTGTTTTTT	CARRREGRRNTGELFF	TRBV19	TRBJ2-2
TGTGCCAGCAGTTCCCCCCTACAAGAGACCCAGTACTTC	CASSSPLQETQYF	TRBV12-3	TRBJ2-5
TGTGCCAGCAGCTTAGGGACAGGGGGCTACTCCCACTATAATTCACCCCTCCACTTT	CASSLGTGGYSHYNSPLHF	TRBV13	TRBJ1-6
TGTGCCAGCAGCTTACAGCGACAGGGGGCGCGTTCTAAGAATCAGCCCCAGCATTTT	CASSLQRQGARSKNQPQHF	TRBV7-4	TRBJ1-5
TGTGCCAGCAGCCGGCCCATGATCCGGGTGGCCTACGAGCAGTACTTC	CASSRPMIRVAYEQYF	TRBV5-4	TRBJ2-7
TGTGCCAGCAGCCCGGGGGGGGGGCTCAGCGGGGCCTACGAGCAGTACTTC	CASSPGGGLSGAYEQYF	TRBV7-3	TRBJ2-7
TGTGCCAGCAGCTTGGTCGGGACTAGCGGGGTAGGAGAGACCCAGTACTTC	CASSLVGTSGVGETQYF	TRBV7-9	TRBJ2-5
TGCAGTGCTAGAAGCTATAGGCAGAGCACCGGGGAGCTGTTTTTT	CSARSYRQSTGELFF	TRBV20-1	TRBJ2-2
TGTGCCAGCAGCTTAGACCATCTACCGGGCTATAATTCACCCCTCCACTTT	CASSLDHLPGYNSPLHF	TRBV11-2	TRBJ1-6
TGCAGTGCTAGCAGGGAAGGGACTGAAGCTTTCTTT	CSASREGTEAFF	TRBV20-1	TRBJ1-1
TGTGCCAGCAGTGGTATAGGGGCAGCCGGGGAGCTGTTTTTT	CASSGIGAAGELFF	TRBV6-1	TRBJ2-2
TGTGCCAGCAGCCAGAAGGACTTTCCCCAGGGGGCGGTACTCAATGAGCAGTTCTTC	CASSQKDFPQGAVLNEQFF	TRBV7-3	TRBJ2-1
TGTGCCAGACCCGGTTACAATGAGCAGTTCTTC	CARPGYNEQFF	TRBV25-1	TRBJ2-1
TGTGCCAGCAGTTACTCATGCGGGAGTGGGCCCACCTACGAGCAGTACTTC	CASSYSCGSGPTYEQYF	TRBV6-6	TRBJ2-7
TGTGCCAGCAACCAGTGGGTGCCGAACACTGAAGCTTTCTTT	CASNQWVPNTEAFF	TRBV7-2	TRBJ1-1
TGTGCCAGCAGCTTAGACCCGTCTCAGGAGCAGTACTTC	CASSLDPSQEQYF	TRBV7-2	TRBJ2-7
TGTGCCAGCAGCCTGTGGGGTCCCGAGACCCAGTACTTC	CASSLWGPETQYF	TRBV7-9	TRBJ2-5
TGTGCCAAACCGCTAAGCGCCTCCTATAATTCACCCCTCCACTTT	CAKPLSASYNSPLHF	TRBV27	TRBJ1-6
TGTGCCAGCAGCGTACCCGGGAGGAACACTGAAGCTTTCTTT	CASSVPGRNTEAFF	TRBV7-6	TRBJ1-1
TGCAGTGCAATTCTACTAGCGGGAGGTCTCAATGAGCAGTTCTTC	CSAILLAGGLNEQFF	TRBV20-1	TRBJ2-1
TGTGCCAGCGGCCTAAATACGGGACTCAAGTTTTTTTCCTACGAGCAGTACTTC	CASGLNTGLKFFSYEQYF	TRBV9	TRBJ2-7
TGTGCCAGCAGCCAACGGTGGGACAGTCATTCCGCAACTAATGAAAAACTGTTTTTT	CASSQRWDSHSATNEKLFF	TRBV3-1	TRBJ1-4
TGTGCCAGCAGCCAAAAAATGACTAGCGGGGCTGAGTCATACGAGCAGTACTTC	CASSQKMTSGAESYEQYF	TRBV4-2	TRBJ2-7
TGTGCCAGCAGCAGAGCCTACGAGCAGTACTTC	CASSRAYEQYF	TRBV13	TRBJ2-7
TGTGCCAGCTCACCAAAGGCGAGGCTACAGGCTAATGAAAAACTGTTTTTT	CASSPKARLQANEKLFF	TRBV18	TRBJ1-4
TGTGCCAGCAGCTTGGGGGGCTGGGGTAACTATGGCTACACCTTC	CASSLGGWGNYGYTF	TRBV5-6	TRBJ1-2
TGTGCCAGCAGCGGGCGAGGAACGGATTCACCCCTCCACTTT	CASSGRGTDSPLHF	TRBV9	TRBJ1-6
TGTGCCAGCAGCACACAGTCGCACAATGAGCAGTTCTTC	CASSTQSHNEQFF	TRBV14	TRBJ2-1
TGTGCCTTCCTCGTTCTCTCTGGGGCCAACGTCCTGACTTTC	CAFLVLSGANVLTF	TRBV19	TRBJ2-6
TGTGCCATCGGTCTAGGGGGCGCGGCAGGATACAATGAGCAGTTCTTC	CAIGLGGAAGYNEQFF	TRBV10-3	TRBJ2-1
TGTGCCAGGGGGGGCCCACATCCCGCAGATACGCAGTATTTT	CARGGPHPADTQYF	TRBV7-6	TRBJ2-3
TGCAGTGCTAGCCCCTCAAGCAGTCCGACCCCTAATAGCAATCAGCCCCAGCATTTT	CSASPSSSPTPNSNQPQHF	TRBV20-1	TRBJ1-5
TGTGCCAGCAGTTACAGTGCGGGCGGGCTTGGCAATCAGCCCCAGCATTTT	CASSYSAGGLGNQPQHF	TRBV6-5	TRBJ1-5
TGCGCCAGCGGGGGGCCTGAAGCTTTCTTT	CASGGPEAFF	TRBV10-1	TRBJ1-1
TGCGCCAGCAGTGAGGAGGGGACCGAGGGTGGCTACACCTTC	CASSEEGTEGGYTF	TRBV10-1	TRBJ1-2
TGCAGTGCTAGAACCGGGAGTTGGAAAGATACGCAGTATTTT	CSARTGSWKDTQYF	TRBV20-1	TRBJ2-3
TGTGCCAGCAGTTACTTCGGACAGGGGGCTCCAAACACCATATATTTT	CASSYFGQGAPNTIYF	TRBV6-5	TRBJ1-3
TGTGCCAGCAGCTTACCGGACAGGGGGCGGGGAAATGAAAAACTGTTTTTT	CASSLPDRGRGNEKLFF	TRBV7-3	TRBJ1-4
TGTGCCAGCAGCATAAGGGGTCCGCTTGGAAACACCATATATTTT	CASSIRGPLGNTIYF	TRBV7-9	TRBJ1-3
TGCAGTGCTAGAGGGGGGCTTAATGAAAAACTGTTTTTT	CSARGGLNEKLFF	TRBV20-1	TRBJ1-4
TGTGCCACCCGTGGGGGCGAGCAGTACTTC	CATRGGEQYF	TRBV24-1	TRBJ2-7
TGCGCCAGCAGCTTGCCGGCCTCCCTTGGTGGAGGAAACACCATATATTTT	CASSLPASLGGGNTIYF	TRBV5-1	TRBJ1-3
TGCAGTGCGAGGACAGGGTCAGGAACCAGTCAGCCCCAGCATTTT	CSARTGSGTSQPQHF	TRBV20-1	TRBJ1-5
TGCGCCAGCAGCCAAGATCTCCCCGGGACAGTGCCTAAGAACACCGGGGAGCTGTTTTTT	CASSQDLPGTVPKNTGELFF	TRBV4-1	TRBJ2-2
TGCGCCAGCAGCTCATCAACTAGCTGGGGGGATGAGCAGTTCTTC	CASSSSTSWGDEQFF	TRBV5-1	TRBJ2-1
TGTGCCAGCAGCGTAAGGTCCACAGGCAGGAAAAACATTCAGTACTTC	CASSVRSTGRKNIQYF	TRBV9	TRBJ2-4
TGTGCTAGTGGAAAAAGGGGGCGGACAGGAGGTATTCGCGTTTATGAGCAGTTCTTC	CASGKRGRTGGIRVYEQFF	TRBV12-5	TRBJ2-1
TGTGCCTCTAGACAGGGCTCTGGAAACACCATATATTTT	CASRQGSGNTIYF	TRBV2	TRBJ1-3
TGTGCCTGGGAATGGACAGGTGCTGGAAACACCATATATTTT	CAWEWTGAGNTIYF	TRBV30	TRBJ1-3
TGTGCCAGCAGCCAAGCACAGGGGTGTGCCTACGAGCAGTACTTC	CASSQAQGCAYEQYF	TRBV14	TRBJ2-7
TGTGCCGTCGATCGTACATATCTTGAAGCTTTCTTT	CAVDRTYLEAFF	TRBV28	TRBJ1-1
TGTGCCAGCAGTCCGCCGGGACAGGGCCCATATGGCTACACCTTC	CASSPPGQGPYGYTF	TRBV12-4	TRBJ1-2
TGTGCCAGCAGCGTGGCGGGACAGGTACACGGGGAAAAACTGTTTTTT	CASSVAGQVHGEKLFF	TRBV11-2	TRBJ1-4
TGTGCCAGCACTCCGGGACGTAGTCATGAGCAGTTCTTC	CASTPGRSHEQFF	TRBV6-4	TRBJ2-1
TGTGCCAGCAGTAAGGACTATGCTGAGCAGTACTTC	CASSKDYAEQYF	TRBV28	TRBJ2-7
TGTGCCAGTAGGGCCGGACAGTTTATTCAGGGTAGGAACACTGAAGCTTTCTTT	CASRAGQFIQGRNTEAFF	TRBV19	TRBJ1-1
TGTGCCAGCAGCTTAGGGACTAGTAGGGCAGATACGCAGTATTTT	CASSLGTSRADTQYF	TRBV7-9	TRBJ2-3
TGCGCCAGCAGCCACCAGCCTCGGGGGGGAAACACCATATATTTT	CASSHQPRGGNTIYF	TRBV4-3	TRBJ1-3
TGTGCCTGGGGCCCTGGACAGGGGGCTCTTGAAAAACTGTTTTTT	CAWGPGQGALEKLFF	TRBV30	TRBJ1-4
TGTGCAGACAGGGCAGTCCTTAGCTCTGGAAACACCATATATTTT	CADRAVLSSGNTIYF	TRBV24-1	TRBJ1-3
TGTGCCAGCAGACGCGTCACTGCCTGCCTGCGGAAGGACTATGGCTACACCTTC	CASRRVTACLRKDYGYTF	TRBV6-4	TRBJ1-2
TGTGCCGTAGCCGGGGGGCCCCAGCAGTACTTC	CAVAGGPQQYF	TRBV6-4	TRBJ2-7
TGTGCCAGCAGCGCGGGACTAGCGGGGGAGGAGACCCAGTACTTC	CASSAGLAGEETQYF	TRBV7-2	TRBJ2-5
TGTGCCAGCAGTTTCATTTGGGACTTTGGGATTAGGAGGCCAGGCTACGAGCAGTACTTC	CASSFIWDFGIRRPGYEQYF	TRBV27	TRBJ2-7
TGTGCCAGCAGTTACCGGGTCGTGACACGCTATGGCTACACCTTC	CASSYRVVTRYGYTF	TRBV6-2	TRBJ1-2
TGTGCCAGCAGCGTAGAAGACAGCTATGGCTACACCTTC	CASSVEDSYGYTF	TRBV9	TRBJ1-2
TGCGCCAGCAGCTTGCTTCAGGCTGGCCGGGAGCAGTACTTC	CASSLLQAGREQYF	TRBV5-1	TRBJ2-7
TGTGCCTGGAGCGGGGAGACAGGGGTCGTAGAGCAGTACTTC	CAWSGETGVVEQYF	TRBV30	TRBJ2-7
TGTGCCAGCAGCCCTATCGATCCGGAAGGTTTCAATCAGCCCCAGCATTTT	CASSPIDPEGFNQPQHF	TRBV5-6	TRBJ1-5
TGTGCCAGCAGCGTAGCCAGCCCTAGCGCCGACAATGAGCAGTTCTTC	CASSVASPSADNEQFF	TRBV9	TRBJ2-1
TGCGCCAGCAGCTTGGAGGAGGGAATAGATACGCAGTATTTT	CASSLEEGIDTQYF	TRBV5-1	TRBJ2-3
TGTGCCAGCAGCGACCCTCTTGGGGACAGGGATTGGCAGGAAAAACTGTTTTTT	CASSDPLGDRDWQEKLFF	TRBV7-2	TRBJ1-4
TGTGCCAGCAGCTTAGGAACAGGGGGCAAGGGAGGAAACTACGAGCAGTACTTC	CASSLGTGGKGGNYEQYF	TRBV7-9	TRBJ2-7
TGTGCCAGCAGCCGGAGGGGGCCGGAGAACACTGAAGCTTTCTTT	CASSRRGPENTEAFF	TRBV7-3	TRBJ1-1
TGCGCCAGCAGCTTCCGAGGACAGGGGGCAAGGGTCAATCAGCCCCAGCATTTT	CASSFRGQGARVNQPQHF	TRBV5-1	TRBJ1-5
TGTGCCAGCAGCCAAGATCCAGGGGGGCGGGTGAACACTGAAGCTTTCTTT	CASSQDPGGRVNTEAFF	TRBV3-1	TRBJ1-1
TGCAGTGCCACCGATACCTACGAGCAGTACTTC	CSATDTYEQYF	TRBV20-1	TRBJ2-7
TGTGCCAGCAGTGAGGACAGGGGCACAGATACGCAGTATTTT	CASSEDRGTDTQYF	TRBV6-4	TRBJ2-3
TGTGCCAGCAGAACCGAGGGACAAACGGGGGAGCAGTACTTC	CASRTEGQTGEQYF	TRBV7-9	TRBJ2-7
TGCAGCGTTCCTTTGGGGGGTGGCTACGAGCAGTACTTC	CSVPLGGGYEQYF	TRBV29-1	TRBJ2-7
TGTGCCACCAGTGAAAGGGACAGGGAAAATGCCGGGGAGCTGTTTTTT	CATSERDRENAGELFF	TRBV24-1	TRBJ2-2
TGTGCCAGCAGCACCCCGGGGGATCAGCCCCAGCATTTT	CASSTPGDQPQHF	TRBV13	TRBJ1-5
TGCAGTGCCCAGGGGCAGTCCAAAAACATTCAGTACTTC	CSAQGQSKNIQYF	TRBV20-1	TRBJ2-4
TGTGCCAGCAGCAGTACCCCCTGCTACGAGCAGTACTTC	CASSSTPCYEQYF	TRBV7-8	TRBJ2-7
TGTGCCAGCAGTTACGAGGGGACTAGCCGGCACGAGCAGTACTTC	CASSYEGTSRHEQYF	TRBV6-5	TRBJ2-7
TGTGCCGGGGGAGCCGCCGGGGAGCTGTTTTTT	CAGGAAGELFF	TRBV6-4	TRBJ2-2
TGCAGTGCTAGCGATCTCTGGCCGCCTGGCACTGAAGCTTTCTTT	CSASDLWPPGTEAFF	TRBV20-1	TRBJ1-1
TGCAGTGCTAGGTCAACCGAAAGACCGGAGTGGGGGTCCTACGAGCAGTACTTC	CSARSTERPEWGSYEQYF	TRBV20-1	TRBJ2-7
TGTGCCAGAAAGTACCACAGATACACCGGGGAGCTGTTTTTT	CARKYHRYTGELFF	TRBV6-2	TRBJ2-2
TGTGCCAGCAGGAAGGCCGGGACAGGGCTTAACACTGAAGCTTTCTTT	CASRKAGTGLNTEAFF	TRBV6-5	TRBJ1-1
TGCAGTGCTTCCCCGGACAGGGGTCTCTGTCAAGCTTTCTTT	CSASPDRGLCQAFF	TRBV20-1	TRBJ1-1
TGCAGTGCTCGGGATCACACAGATACGCAGTATTTT	CSARDHTDTQYF	TRBV20-1	TRBJ2-3
TGTGCCTGGAGTGTAGCGTGCACCCCCAGGTCTTATCAGCCCCAGCATTTT	CAWSVACTPRSYQPQHF	TRBV30	TRBJ1-5
TGTGCCAGCAGCTTAATCCGACAGGGACCGGGCTACACCTTC	CASSLIRQGPGYTF	TRBV7-9	TRBJ1-2
TGTGCCAGCAGCTTGCAGTCCCAGCATTTT	CASSLQSQHF	TRBV5-6	TRBJ1-5
TGTGCCAGCCCCAACTTTAACCGGGACAGGGCTGCTAATGAAAAACTGTTTTTT	CASPNFNRDRAANEKLFF	TRBV7-3	TRBJ1-4
TGTGCCAGCAGTTATAGACAGGGTCGAATGAACACTGAAGCTTTCTTT	CASSYRQGRMNTEAFF	TRBV28	TRBJ1-1
TGTGCCAGCAGCGGCTCCTTCCACAGGGCCGAGCAGTACTTC	CASSGSFHRAEQYF	TRBV9	TRBJ2-7
TGCAGTGCTCAAGCTGGGGACCACTACAGCTCCTACAATGAGCAGTTCTTC	CSAQAGDHYSSYNEQFF	TRBV20-1	TRBJ2-1
TGTGCCAGCCGGGACTACGGGCAAGCGAACACCGGGGAGCTGTTTTTT	CASRDYGQANTGELFF	TRBV27	TRBJ2-2
TGTGCCAGCAGCCGAGGGGGATTTAATGAAAAACTGTTTTTT	CASSRGGFNEKLFF	TRBV6-5	TRBJ1-4
TGCAGTGCTAGATGGGAAGAGGGGGGGGGGGGAAACACCATATATTTT	CSARWEEGGGGNTIYF	TRBV20-1	TRBJ1-3
TGCGCCAGCAGCAGAAGGGGGGGACGGAACATTCAGTACTTC	CASSRRGGRNIQYF	TRBV10-1	TRBJ2-4
TGTGCCAGCAGAGGCCAGGGCTTGGGCAGAAACTATGGCTACACCTTC	CASRGQGLGRNYGYTF	TRBV6-3	TRBJ1-2
TGTGCCAGCAGCCCGGGCACTGAAGCTTTCTTT	CASSPGTEAFF	TRBV7-3	TRBJ1-1
TGCAGTGCTAGAGATCCCCATCTAGCGGGCCCTGAGCAGTACTTC	CSARDPHLAGPEQYF	TRBV20-1	TRBJ2-7
TGTGCCAGCAGTGAACCTCTGGAAAAACTGTTTTTT	CASSEPLEKLFF	TRBV6-4	TRBJ1-4
TGTGCCAGCAGCCCCAGAGTAGGGGGCTACACCTTC	CASSPRVGGYTF	TRBV11-3	TRBJ1-2
TGTGCCTGGAGTGGAACTAGCGGGAGGCTTTCCTACGAGCAGTACTTC	CAWSGTSGRLSYEQYF	TRBV30	TRBJ2-7
TGTGCCAGCAGACCCAGGACTAGCGGGATCTACGAGCAGTACTTC	CASRPRTSGIYEQYF	TRBV7-2	TRBJ2-7
TGTGCCAGCGTTGGACAGGGCGTAAGTGGGGCAGATACGCAGTATTTT	CASVGQGVSGADTQYF	TRBV27	TRBJ2-3
TGTGCCACCGTCGCTGGAGGGGTTCAGCCCCAGCATTTT	CATVAGGVQPQHF	TRBV24-1	TRBJ1-5
TGCGCCAGCAGCTTGGAGACCGATACGGAGAGGGGAACTGAAGCTTTCTTT	CASSLETDTERGTEAFF	TRBV5-1	TRBJ1-1
TGTGCCAGCAGTGAAGCGCACCTCCACGGGGGGGGATACGAGCAGTACTTC	CASSEAHLHGGGYEQYF	TRBV6-1	TRBJ2-7
TGTGCCAGTAGTGAAGAGGCTATATCTCGAATATTGGGCTACACCTTC	CASSEEAISRILGYTF	TRBV19	TRBJ1-2
TGTGCCTGGAGGCGGGGTTGGCCAGAGACCCAGTACTTC	CAWRRGWPETQYF	TRBV30	TRBJ2-5
TGTGCCACCAGTGATTTAAAGAGGGCATTCAGCGGGAGGAGTCTCTCCTACGAGCAGTACTTC	CATSDLKRAFSGRSLSYEQYF	TRBV24-1	TRBJ2-7
TGTGCCAGCAGCGAGGCCCCCTGCAGGGGGGGAGTTAACTATGGCTACACCTTC	CASSEAPCRGGVNYGYTF	TRBV12-4	TRBJ1-2
TGTGCCAGCAGTGGGCAGGAGCCCAATCAGCCCCAGCATTTT	CASSGQEPNQPQHF	TRBV12-4	TRBJ1-5
TGTGCCAGCAGCCAAGCACCTGGACAGGGTAATTCACCCCTCCACTTT	CASSQAPGQGNSPLHF	TRBV3-1	TRBJ1-6
TGTGCCAGCAGCTTGGGGGGGGGCTACGAGCAGTACTTC	CASSLGGGYEQYF	TRBV5-4	TRBJ2-7
TGCGCCAGCAGTGAGTCCGGGACAGGGGCCGGTGCTAACTATGGCTACACCTTC	CASSESGTGAGANYGYTF	TRBV10-1	TRBJ1-2
TGTGCCAGCAGCAAACCTGTCCCTGGCTCCTACGAGCAGTACTTC	CASSKPVPGSYEQYF	TRBV7-7	TRBJ2-7
TGTGCCAGCAGCGGCAGACCCATCTATGGCTACACCTTC	CASSGRPIYGYTF	TRBV5-6	TRBJ1-2
TGTGCCAGCGAAAACAGGGCTGACGAGCAGTACTTC	CASENRADEQYF	TRBV27	TRBJ2-7
TGTGCCAGCAGTGAATATTACAGGACAGGGGAGCCGGAGACCCAGTACTTC	CASSEYYRTGEPETQYF	TRBV25-1	TRBJ2-5
TGTGCCAGCAGGGGGGGGCCTGGGGGCACCGGGGAGCTGTTTTTT	CASRGGPGGTGELFF	TRBV6-5	TRBJ2-2
TGTGCCAGTAGGCTCGGGACCTTTGGCGGCAATCAGCCCCAGCATTTT	CASRLGTFGGNQPQHF	TRBV19	TRBJ1-5
TGTGCCAGCAGTTTATCCTGCGTGAGTTGTGGCTACACCTTC	CASSLSCVSCGYTF	TRBV27	TRBJ1-2
TGTGCCAGCGTGTGGGGAAGAAGGAGCCGTCCCTACGAGCAGTACTTC	CASVWGRRSRPYEQYF	TRBV12-3	TRBJ2-7
TGTGCCAGCAGCGTCGCAGGGGATGGCTACACCTTC	CASSVAGDGYTF	TRBV27	TRBJ1-2
TGTGCCAGCAGCAGAAGGAGTCCGGGACAGGGATCGGGAGCTTTCTTT	CASSRRSPGQGSGAFF	TRBV5-4	TRBJ1-1
TGTGCCAGCAGTTACGGGGGCCAGGTTCCTCACTACGAGCAGTACTTC	CASSYGGQVPHYEQYF	TRBV6-3	TRBJ2-7
TGTGCCAGTAGTACTACCCGGACGTCCTACGAGCAGTACTTC	CASSTTRTSYEQYF	TRBV19	TRBJ2-7
TGTGCCATGCTCTCCACAGATACGCAGTATTTT	CAMLSTDTQYF	TRBV6-1	TRBJ2-3
TGCAGTGCTTCCTCCCGGGAGACCCAGTATTTT	CSASSRETQYF	TRBV20-1	TRBJ1-3
TGTGCTAGTTGCCAGGCAGGGCGGAGCACTGAAGCTTTCTTT	CASCQAGRSTEAFF	TRBV12-5	TRBJ1-1
TGTGCCAGCAGGAGTTCCGATCACCGTACAAAACTGTTTTTT	CASRSSDHRTKLFF	TRBV12-4	TRBJ1-4
TGTGCCAGCAGCAGTCCGACTTTGTATTACGAGCAGTACTTC	CASSSPTLYYEQYF	TRBV7-4	TRBJ2-7
TGTGCCAGCAGCTTGGACAATCAGCCCCAGCATTTT	CASSLDNQPQHF	TRBV11-3	TRBJ1-5
TGCAGCTCCCGGGTTCCCAATGAGCAGTTCTTC	CSSRVPNEQFF	TRBV20-1	TRBJ2-1
TGTGCCAGCTCACAACTTTGTTATAAGGGTTCGCAGTTCTTC	CASSQLCYKGSQFF	TRBV18	TRBJ2-1
TGTGCCAGCAGCTTCTCTGGGACAGTGGAGACTGAAGCTTTCTTT	CASSFSGTVETEAFF	TRBV5-4	TRBJ1-1
TGTGCCAGCAGCGTGGGGACAGGGTTGGACTTTGCTGAAGCTTTCTTT	CASSVGTGLDFAEAFF	TRBV13	TRBJ1-1
TGTGCTAGTGGTTTGGTACCTAGCGGGGCTTCCTACGAGCAGTACTTC	CASGLVPSGASYEQYF	TRBV12-5	TRBJ2-7
TGCAGTGCTAGCCCTCCACCCCCGGGACAGGGCGAACACACCGGGGAGCTGTTTTTT	CSASPPPPGQGEHTGELFF	TRBV20-1	TRBJ2-2
TGCAGTGCTGGACTAGCGGTTAAGAAGCACGAGCAGTACTTC	CSAGLAVKKHEQYF	TRBV20-1	TRBJ2-7
TGTGCTAGCAGCTTATTTAGCGGGACAGTGGAGACCCAGTACTTC	CASSLFSGTVETQYF	TRBV7-7	TRBJ2-5
TGTGCCAGCAGCTTTCCCCCACCCGGGACAACGGGGCTTTCACCCCTCCACTTT	CASSFPPPGTTGLSPLHF	TRBV7-8	TRBJ1-6
TGTGCCAGCATAGTGGGCCCGGCAGCTTTCTTT	CASIVGPAAFF	TRBV6-6	TRBJ1-1
TGTGCCAGCAGCGGAGAGACTAGCGGGCCCTACAATGAGCAGTTCTTC	CASSGETSGPYNEQFF	TRBV7-9	TRBJ2-1
TGTGCCAGCAGCTTGGGCGGGAGTCCCTACGAGCAGTACTTC	CASSLGGSPYEQYF	TRBV5-4	TRBJ2-7
TGTGCCAGCAGCAGTCTGGACAGGGAGGTAGCTTTCTTT	CASSSLDREVAFF	TRBV6-5	TRBJ1-1
TGTGCCAGCAGGTCACAGGCAGATACGCAGTATTTT	CASRSQADTQYF	TRBV28	TRBJ2-3
TGTGCCAGCAGCTTAGAACTAGCGGGAGGGCCCGGGAGCTCCTACGAGCAGTACTTC	CASSLELAGGPGSSYEQYF	TRBV7-2	TRBJ2-7
TGCGCCAGCAGCCTAAGTGTATGGGAGAGCAGTGCGTATCGTAACTATGGCTACACCTTC	CASSLSVWESSAYRNYGYTF	TRBV5-1	TRBJ1-2
TGTGCCTGGAGGAAAATGGGGGCCGGGGGGGCCTGGAGCACAGATACGCAGTATTTT	CAWRKMGAGGAWSTDTQYF	TRBV30	TRBJ2-3
TGTGCCACCAGCAGGGGGGGGGGAGAGACCCAGTACTTC	CATSRGGGETQYF	TRBV15	TRBJ2-5
TGTGCCAGCAGCGTATCCTGGGGGGGTTGTAATGAGCAGTTCTTC	CASSVSWGGCNEQFF	TRBV7-3	TRBJ2-1
TGTGCCAGCAGCATAACGGGGTTCCTCCTCCTCCACTTT	CASSITGFLLLHF	TRBV7-9	TRBJ1-6
TGTGCCAGCAGTGCTGGGACTAGCGGGAGCTCCTACGAGCAGTACTTC	CASSAGTSGSSYEQYF	TRBV6-4	TRBJ2-7
TGCAGTGCTAGAGTTGTTCGGGGGCCTAGCACAGATACGCAGTATTTT	CSARVVRGPSTDTQYF	TRBV20-1	TRBJ2-3
TGTGCCAGCAGCCGGCCGGACAGGGGGGGGGGGTATACATTAGCCAAAAACATTCAGTACTTC	CASSRPDRGGGYTLAKNIQYF	TRBV7-3	TRBJ2-4
TGTGCCAGCAGTGAGGTTATTTTGGCAGGGGAAAACTCCTATAATTCACCCCTCCACTTT	CASSEVILAGENSYNSPLHF	TRBV25-1	TRBJ1-6
TGTGCCAGCAGCGTCCGCCCAGGGACTAGCGGGGGGCCCACAGATACGCAGTATTTT	CASSVRPGTSGGPTDTQYF	TRBV7-4	TRBJ2-3
TGTGCCACCAAGAGCAGGTCCGAAAAACTGTTTTTT	CATKSRSEKLFF	TRBV24-1	TRBJ1-4
TGTGCCACACCTGGACAGGGGGTGGGGTATAGCAATCAGCCCCAGCATTTT	CATPGQGVGYSNQPQHF	TRBV27	TRBJ1-5
TGTGCCAGCAGCCAAATGGTCCAGTCCGAGGGACAGAGGGACACCATATATTTT	CASSQMVQSEGQRDTIYF	TRBV7-8	TRBJ1-3
TGTGCCAGCAGCTTAAACGGGGAAAAAAATGAAAAACTGTTTTTT	CASSLNGEKNEKLFF	TRBV7-2	TRBJ1-4
TGTGCCAGCAGTTTAGGGCCCTATGGCTACACCTTC	CASSLGPYGYTF	TRBV27	TRBJ1-2
TGTGCCAGCTGTTGCGAGCAGTACTTC	CASCCEQYF	TRBV6-5	TRBJ2-7
TGCGCCAGCAGCCACGGGGGGAGCACAGATACGCAGTATTTT	CASSHGGSTDTQYF	TRBV4-1	TRBJ2-3
TGCGCCAGCAGGCGGGAGATCCTGAGGAGAGACTACAATGAGCAGTTCTTC	CASRREILRRDYNEQFF	TRBV10-1	TRBJ2-1
TGCGCCAGCAGTGTAGTCAGCGGCAATCAGCCCCAGCATTTT	CASSVVSGNQPQHF	TRBV10-2	TRBJ1-5
TGTGCCAGCAGGGGGCTAAGGAACACTGAAGCTTTCTTT	CASRGLRNTEAFF	TRBV6-2	TRBJ1-1
TGTGCCAGCAGCTTCTCTCAGGGAAGCGAGACCCAGTACTTC	CASSFSQGSETQYF	TRBV7-9	TRBJ2-5
TGTGCCAGCAGTTCAGGGCGGGACGGGAGTTGCACCGGGGAGCTGTTTTTT	CASSSGRDGSCTGELFF	TRBV6-1	TRBJ2-2
TGTGCCAGCAGCTGGGTACTGCAAGAGACCCAGTACTTC	CASSWVLQETQYF	TRBV5-6	TRBJ2-5
TGCGCCAGCAGTGAGGGACAGAACACCGGGGAGCTGTTTTTT	CASSEGQNTGELFF	TRBV10-2	TRBJ2-2
TGTGCCAGCAGTAGGCTCGACAGTCACGAGCAGTACTTC	CASSRLDSHEQYF	TRBV27	TRBJ2-7
TGTGCCAGCAGTTCTCAGCAAGAGACCCAGTACTTC	CASSSQQETQYF	TRBV28	TRBJ2-5
TGTGCCAGCAGCTTGGGACGGGGGATCACTAACTATGGCTACACCTTC	CASSLGRGITNYGYTF	TRBV5-4	TRBJ1-2
TGTACAGGTAATGAAAAACTGTTTTTT	CTGNEKLFF	TRBV7-9	TRBJ1-4
TGTGCCAGCAAGGAAGGGGATAACTATGGCTACACCTTC	CASKEGDNYGYTF	TRBV25-1	TRBJ1-2
TGCAGTGCTAGAGCGGGCCCCCGGGACAGGGGGGACTATGGCTACACCTTC	CSARAGPRDRGDYGYTF	TRBV20-1	TRBJ1-2
TGTGCCAGCAGCTTAGGGGAGGGAGCCAATCAGCCCCAGCATTTT	CASSLGEGANQPQHF	TRBV7-6	TRBJ1-5
TGTGCCAGCAGCTTAATCGGGGGCAATCAGCCCCAGCATTTT	CASSLIGGNQPQHF	TRBV11-3	TRBJ1-5
TGTGGGTGTGACGGGACAGGGGGGTGGGACGAGCAGTACTTC	CGCDGTGGWDEQYF	TRBV7-9	TRBJ2-7
TGTGCCATCATCGAATGTTCGACAGGTACCAATCAGCCCCAGCATTTT	CAIIECSTGTNQPQHF	TRBV10-3	TRBJ1-5
TGTGCCAGCAGCATGCTACCAAGCGGAGAACGTGGGGCCCGCCGCTACGAGCAGTACTTC	CASSMLPSGERGARRYEQYF	TRBV7-3	TRBJ2-7
TGTGCCAGCAGTCCAACGCGGTCGACTAACACTGAAGCTTTCTTT	CASSPTRSTNTEAFF	TRBV27	TRBJ1-1
TGTGCCAGCAGCTCAGCGGGTCAAGAGACCCAGTACTTC	CASSSAGQETQYF	TRBV7-3	TRBJ2-5
TGCGCCAGCCCGTATTCTACCCGGGACAGGGCTTGTGAGCAGTTCTTC	CASPYSTRDRACEQFF	TRBV10-1	TRBJ2-1
TGTGCCACCAGTGAGACTGACGGAAATCAGCCCCAGCATTTT	CATSETDGNQPQHF	TRBV24-1	TRBJ1-5
TGTGCCAGCACTTCGGGGAAACTTAATTATGGCTACACCTTC	CASTSGKLNYGYTF	TRBV6-8	TRBJ1-2
TGTGCCAGCAGTGAAGCGCGACCCGCCCCCCAGGACAGCAATCAGCCCCAGCATTTT	CASSEARPAPQDSNQPQHF	TRBV6-1	TRBJ1-5
TGTGCCAGCAGCACGGACAGGATCCACAACTATGGCTACACCTTC	CASSTDRIHNYGYTF	TRBV9	TRBJ1-2
TGTGCCAGCGGCCGTACAGAGCATGAGGGGAGGGGCCCCTACGAGCAGTACTTC	CASGRTEHEGRGPYEQYF	TRBV11-3	TRBJ2-7
TGTGCCAGCAGCCGATCAGGTACGGGGGCTGAAGCTTTCTTT	CASSRSGTGAEAFF	TRBV7-9	TRBJ1-1
TGCGCCAGCAGCTTAAGGTTGCCGGGCCGGGAGGCCTACGAGCAGTACTTC	CASSLRLPGREAYEQYF	TRBV5-1	TRBJ2-7
TGTGCCAGCACGGGGATCGGCTACGAGCAGTACTTC	CASTGIGYEQYF	TRBV7-9	TRBJ2-7
TGTGCCAGCAGCGGGGGGGGGCAGGGTCCCAATGAGCAGTTCTTC	CASSGGGQGPNEQFF	TRBV7-7	TRBJ2-1
TGTGCCAGCAGCTTAGATCCCCGGACAGGGGCCTGGTACGAGCAGTACTTC	CASSLDPRTGAWYEQYF	TRBV7-9	TRBJ2-7
TGCGCCAGCAGCCCATTATTTGCCCAGGGTACGAACACCGGGGAGCTGTTTTTT	CASSPLFAQGTNTGELFF	TRBV5-1	TRBJ2-2
TGTGCCAGCAGTACCGTTAGGGGGGACAGGAACACTGAAGCTTTCTTT	CASSTVRGDRNTEAFF	TRBV6-5	TRBJ1-1
TGTGCCAGCAGTAACAGGCGGGGTGGTGACAATCAGCCCCAGCATTTT	CASSNRRGGDNQPQHF	TRBV27	TRBJ1-5
TGTGCCTGGAATAGGCCTGAAAAACTGTTTTTT	CAWNRPEKLFF	TRBV30	TRBJ1-4
TGTGCCATCACAGACCCCGGGGACCCTAACTATGGCTACACCTTC	CAITDPGDPNYGYTF	TRBV10-3	TRBJ1-2
TGCAGTCAGCTTGGGACTAGCGGGGGGGCCAATGAGCAGTTCTTC	CSQLGTSGGANEQFF	TRBV20-1	TRBJ2-1
TGTGCCAGCGTCCCGGGGACTAATGAAAAACTGTTTTTT	CASVPGTNEKLFF	TRBV6-2	TRBJ1-4
TGTGCCAGCAGCCATCGACGGACTCCCGACTACGAGCAGTACTTC	CASSHRRTPDYEQYF	TRBV13	TRBJ2-7
TGTGCCAGGAGGGACAGGGTCACTGAAGCTTTCTTT	CARRDRVTEAFF	TRBV19	TRBJ1-1
TGCGCCAGCAGTCAGTCCATAAAGGACGAGCAGTACTTC	CASSQSIKDEQYF	TRBV10-1	TRBJ2-7
TGTGCCAGCAGTTTAGAGGAGGGTGACTCCTACGAGCAGTACTTC	CASSLEEGDSYEQYF	TRBV28	TRBJ2-7
TGCGCCAGCAGCTTGTTACCCGTCCTACCCTCGGGGGCCTCTGGGGCCAACGTCCTGACTTTC	CASSLLPVLPSGASGANVLTF	TRBV5-1	TRBJ2-6
TGTGCCAGCAGCGTAGGACTTCCGGGACAGGTTAACAATGAGCAGTTCTTC	CASSVGLPGQVNNEQFF	TRBV9	TRBJ2-1
TGTGCCAGTAGTTGGCGACAGGGGACTGAAGCTTTCTTT	CASSWRQGTEAFF	TRBV19	TRBJ1-1
TGCGCCAGCAGCTTGGGGACTCCCCGGGTAGATACGCAGTATTTT	CASSLGTPRVDTQYF	TRBV5-1	TRBJ2-3
TGTGCCAGTAGCCGTCTCGGAGGGGGGACTGAAGCTTTCTTT	CASSRLGGGTEAFF	TRBV19	TRBJ1-1
TGTGCCAGCAGCAATGGGACCAACAATGAGCAGTTCTTC	CASSNGTNNEQFF	TRBV7-4	TRBJ2-1
TGTGCCAGCAGCAACTACCCGGGGACTAGGAGCTCCTACGAGCAGTACTTC	CASSNYPGTRSSYEQYF	TRBV7-4	TRBJ2-7
TGTGCCAGCAGTTCAAATTACAGGGGGGGGTTTAAGGGGATAAACAATGAGCAGTTCTTC	CASSSNYRGGFKGINNEQFF	TRBV12-3	TRBJ2-1
TGTGCCAGCAGCAGGGGGCCCGGGACTCCTATCTACGAGCAGTACTTC	CASSRGPGTPIYEQYF	TRBV13	TRBJ2-7
TGTGCCAGCAGCTCCGGAGGAGGTTGTGCAACTAATGAAAAACTGTTTTTT	CASSSGGGCATNEKLFF	TRBV7-6	TRBJ1-4
TGTGCCAGCAGTGGACAGTATGCCAAAAACATTCAGTACTTC	CASSGQYAKNIQYF	TRBV12-3	TRBJ2-4
TGCAGTGCCCCCGGCTTCAGTAAGCAGGGCCATACAGTAAAACTGTTTTTT	CSAPGFSKQGHTVKLFF	TRBV20-1	TRBJ1-4
TGTGCCAGCACCGGGGACAGACCTAACTATGGCTACACCTTC	CASTGDRPNYGYTF	TRBV28	TRBJ1-2
TGCGCCAGCAGCCCAGAGGACTTGGACAGAGTGGACGAGCAGTACTTC	CASSPEDLDRVDEQYF	TRBV4-1	TRBJ2-7
TGTGCCAGCAGCTTGATAAGGGGGCGCAATCAGCCCCAGCATTTT	CASSLIRGRNQPQHF	TRBV5-4	TRBJ1-5
TGCAGTGCTAGATATGGGGGGCGCTCCTACGAGCAGTACTTC	CSARYGGRSYEQYF	TRBV20-1	TRBJ2-7
TGTGCCTGGAGTCAAAACTGTTTCCCCGGGACGGCATACGAGCAGTACTTC	CAWSQNCFPGTAYEQYF	TRBV30	TRBJ2-7
TGCGCCAGCAGCCCGACAGGGGCAGTGAAGGATACATCCCTCCACTTT	CASSPTGAVKDTSLHF	TRBV5-1	TRBJ1-6
TGTGCCAGCAGCTTAGAGGACCGGGACAGGGGGCGCCGGGCCTCCTACGAGCAGTACTTC	CASSLEDRDRGRRASYEQYF	TRBV7-9	TRBJ2-7
TGCGCCAGCAGCCAAGAACCCGGGACAGAGCCTGAAAAACTGTTTTTT	CASSQEPGTEPEKLFF	TRBV4-1	TRBJ1-4
TGTGCCAGCAGTGAAGCCTCATCTGAAGCTTTCTTT	CASSEASSEAFF	TRBV6-1	TRBJ1-1
TGTGCCTGGGACACAGGGTCCTACGAGCAGTACTTC	CAWDTGSYEQYF	TRBV30	TRBJ2-7
TGTGCCAGCAGAGTCCGGGGGGTCTGCGGTGCAACTAATGAAAAACTGTTTTTT	CASRVRGVCGATNEKLFF	TRBV2	TRBJ1-4
TGCGCCAGCAGCGTTCCCAGACTAGCGGGGGGAACAGGGACAGATACGCAGTATTTT	CASSVPRLAGGTGTDTQYF	TRBV5-1	TRBJ2-3
TGCAGTGCTATTCTTCACTGGGGAGATGGGAACGAGCAGTACTTC	CSAILHWGDGNEQYF	TRBV20-1	TRBJ2-7
TGTGCCAGCCAGGTGCACCAGGAAGATTCACCCCTCCACTTT	CASQVHQEDSPLHF	TRBV7-3	TRBJ1-6
TGCAGCGTCGGACCGACCAGAGCCAACACTGAAGCTTTCTTT	CSVGPTRANTEAFF	TRBV29-1	TRBJ1-1
TGTGCCGAATTTACTAGCGGGAGGGCTTGGAACAATGAGCAGTTCTTC	CAEFTSGRAWNNEQFF	TRBV19	TRBJ2-1
TGTGCCAGCAGGGCCCTACGGGGGCTTTTGTACTTC	CASRALRGLLYF	TRBV6-2	TRBJ2-7
TGTGCCAGAAAGACATTTACTAATGAAAAACTGTTTTTT	CARKTFTNEKLFF	TRBV7-9	TRBJ1-4
TGTGCCAGCAGTTTTTATTCGGGGATTTACGAGCAGTACTTC	CASSFYSGIYEQYF	TRBV6-5	TRBJ2-7
TGTGCCAGCAGCACAGGGAAACCTGGCTACACCTTC	CASSTGKPGYTF	TRBV7-9	TRBJ1-2
TGTGCCATCAACTTTGCGCGGGACAGGGGCTTGTACTTC	CAINFARDRGLYF	TRBV10-3	TRBJ2-7
TGTGCCAGTAGTGATCCGGGGCATAGCTCCTATAATTCACCCCTCCACTTT	CASSDPGHSSYNSPLHF	TRBV19	TRBJ1-6
TGTGCCAGCAGCTTGGCCTTAGTCCCGACAGGGAGGTTTCAGCAGTACTTC	CASSLALVPTGRFQQYF	TRBV5-4	TRBJ2-7
TGTGCCAGCAGCTTAGACCTTCGGACATCTAACACTGAAGCTTTCTTT	CASSLDLRTSNTEAFF	TRBV11-3	TRBJ1-1
TGTGCCAGCAGAAGTCAAATTCCTGGGCTTGCGGACTACGAGCAGTACTTC	CASRSQIPGLADYEQYF	TRBV27	TRBJ2-7
TGTGCCAGCATCAAACGGGACTACGAGCAGTACTTC	CASIKRDYEQYF	TRBV6-2	TRBJ2-7
TGTGCCAGCAGTAGTACAGAATTTTACGATGGCTACACCTTC	CASSSTEFYDGYTF	TRBV28	TRBJ1-2
TGTGCCACCAGCTCGCTTTTACCAGATACGCAGTATTTT	CATSSLLPDTQYF	TRBV24-1	TRBJ2-3
TGCAGCGTTAAGGGGGGGCCATATCAGCCCCAGCATTTT	CSVKGGPYQPQHF	TRBV29-1	TRBJ1-5
TGTGCCAGCCGGACAGATCAGGGAACTAACTATGGCTACACCTTC	CASRTDQGTNYGYTF	TRBV6-4	TRBJ1-2
TGTGCCAGCAGCTTGTACAGGGATCTCACAGATACGCAGTATTTT	CASSLYRDLTDTQYF	TRBV5-5	TRBJ2-3
TGCGCCAGCATTCAGGGGGCGCTCTCCCCACATCAGCCCCAGCATTTT	CASIQGALSPHQPQHF	TRBV10-1	TRBJ1-5
TGTGCCAGCAGCAAACGAATAAGGTTTCACTACAATGAGCAGTTCTTC	CASSKRIRFHYNEQFF	TRBV9	TRBJ2-1
TGTGCCAGCAGAGGGGGGGCGAGCCCGTCCTACAATGAGCAGTTCTTC	CASRGGASPSYNEQFF	TRBV7-4	TRBJ2-1
TGCGCCAGCAGCCACCGGACTCTAGCCAAAAACATTCAGTACTTC	CASSHRTLAKNIQYF	TRBV4-3	TRBJ2-4
TGTGCCAGCAACGGATGGACAGAAGGGCACACTGAAGCTTTCTTT	CASNGWTEGHTEAFF	TRBV6-1	TRBJ1-1
TGCGCCAGCAGTGAAGTTCTATACAGGGGGCTGAAGAACACTGAAGCTTTCTTT	CASSEVLYRGLKNTEAFF	TRBV10-1	TRBJ1-1
TGTGCCAGCAGTGAGTGCGACAGGGGGAGACAGCCCCAGCATTTT	CASSECDRGRQPQHF	TRBV6-1	TRBJ1-5
TGTGCCAGCTCACCCGGGGTCCAAGAGACCCAGTACTTC	CASSPGVQETQYF	TRBV18	TRBJ2-5
TGTGCTAGCAGCGGTAATACAGAGCGGGAAGCGAACACTGAAGCTTTCTTT	CASSGNTEREANTEAFF	TRBV7-7	TRBJ1-1
TGTGCCAGCAGGATACGACACAGGGCCAATACCGGGGAGCTGTTTTTT	CASRIRHRANTGELFF	TRBV6-4	TRBJ2-2
TGTGCCTGGAGTGTGCCTAGCGACAATGAGCAGTTCTTC	CAWSVPSDNEQFF	TRBV30	TRBJ2-1
TGTGCCAGCCCCGACACACGGCCTTACACTGAAGCTTTCTTT	CASPDTRPYTEAFF	TRBV11-3	TRBJ1-1
TGTGCCACCACGCCGGGCCAATTCACAGATACGCAGTATTTT	CATTPGQFTDTQYF	TRBV24-1	TRBJ2-3
TGTGCCAGTAGTATAGATCCTCCGAGCTCAACAGCATTTCGGGGTCATAGCAATCAGCCCCAGCATTTT	CASSIDPPSSTAFRGHSNQPQHF	TRBV19	TRBJ1-5
TGTGCCTGGAGTGTACCCTTAGCCGAGGGCGAACAGTACTTC	CAWSVPLAEGEQYF	TRBV30	TRBJ2-7
TGTGCCAGCAGCTGCTGGGGGCAATACGAGCAGTACTTC	CASSCWGQYEQYF	TRBV13	TRBJ2-7
TGTGCCAGCAGTGACGTAGCTAGCGGCTTAGCCTACGAGCAGTACTTC	CASSDVASGLAYEQYF	TRBV6-4	TRBJ2-7
TGCAGTGCTCCATGGCGCGATTACGAGCAGTACTTC	CSAPWRDYEQYF	TRBV20-1	TRBJ2-7
TGCGCCAGCAGCTTGGTCAGGTCTAATGAGCAGTTCTTC	CASSLVRSNEQFF	TRBV5-1	TRBJ2-1
TGCAAGAAAAACCGACAGGGGGGACGCTACACCTTC	CKKNRQGGRYTF	TRBV20-1	TRBJ1-2
TGTGCCAGCAGCTTAGCGGGAGAGGCGAACACTGAAGCTTTCTTT	CASSLAGEANTEAFF	TRBV7-2	TRBJ1-1
TGCAGTGCTAGAGATTCGGCGTCGGGGGCTTTCTTT	CSARDSASGAFF	TRBV20-1	TRBJ1-1
TGTGCCACCAGCAGAGGGACCGGAGGGGGAACCCAAGAGACCCAGTACTTC	CATSRGTGGGTQETQYF	TRBV15	TRBJ2-5
TGTGCCAGCAGCCAAGATTACGGACAGGGACAGAGGGACTCTGGGGCCAACGTCCTGACTTTC	CASSQDYGQGQRDSGANVLTF	TRBV3-1	TRBJ2-6
TGCGCCAGCAGCCCCCATCTGACAGATCTAAATGAAAAACTGTTTTTT	CASSPHLTDLNEKLFF	TRBV4-1	TRBJ1-4
TGTGCCAGCAGGGCCGGACAGGGTGGGTACAATGAGCAGTTCTTC	CASRAGQGGYNEQFF	TRBV7-9	TRBJ2-1
TGTGCCAGCAGCCACAACAGCAACACCATATATTTT	CASSHNSNTIYF	TRBV7-3	TRBJ1-3
TGTGCCAGCAGCTTAGCCGGGACAGAGGCCTACGGGGTCAATCAGCCCCAGCATTTT	CASSLAGTEAYGVNQPQHF	TRBV7-3	TRBJ1-5
TGTGCCAGCAGTCGGGGCGATTCCTACAATGAGCAGTTCTTC	CASSRGDSYNEQFF	TRBV6-2	TRBJ2-1
TGCAGCGTTGAAGATCAGCTACATTCTGCGCAGTTCTTC	CSVEDQLHSAQFF	TRBV29-1	TRBJ2-1
TGTGCCAGCAGTGGACCAGAGGGGGAAGATAGCAATCAGCCCCAGCATTTT	CASSGPEGEDSNQPQHF	TRBV27	TRBJ1-5
TGTGCCAAGGGGGAGAACACCGGGGAGCTGTTTTTT	CAKGENTGELFF	TRBV27	TRBJ2-2
TGTGCCAGCAGCTTCGCCAGGGCTCAAAACATTCAGTACTTC	CASSFARAQNIQYF	TRBV7-3	TRBJ2-4
TGTGCCAGTCCAGGACCGGTAGCCAAAAACATTCAGTACTTC	CASPGPVAKNIQYF	TRBV6-4	TRBJ2-4
TGTGCCAGCAGTTACTACAGCAATCAGGGTAACTTCCGCTACGAGCAGTACTTC	CASSYYSNQGNFRYEQYF	TRBV6-5	TRBJ2-7
TGTGCTTTGGGGTACAGCAATCAGCCCCAGCATTTT	CALGYSNQPQHF	TRBV24-1	TRBJ1-5
TGTGCCAGCACTGAGTCTTTTGGGAGCTACGAGCAGTACTTC	CASTESFGSYEQYF	TRBV6-8	TRBJ2-7
TGTGCCAGCAGTGGTTCGGAGGGGTCTGTCTGGACTTTGGGGGCCACAGATACGCAGTATTTT	CASSGSEGSVWTLGATDTQYF	TRBV6-2	TRBJ2-3
TGTGCTAGCAGCTTATACTTGATTCCACAACCGGGACAGAATATCAGGGATAGCAATCAGCCCCAGCATTTT	CASSLYLIPQPGQNIRDSNQPQHF	TRBV7-7	TRBJ1-5
TGCGCCAGCAAAAGACCTTCTAGCAATCAGCCCCAGCATTTT	CASKRPSSNQPQHF	TRBV10-1	TRBJ1-5
TGCGCCAGCAGCCAACCCCCCTCTTATAAAGTAGTACAGTATAATTCACCCCTCCACTTT	CASSQPPSYKVVQYNSPLHF	TRBV4-1	TRBJ1-6
TGTGCCAGCAGCGGCGGGAGGGGAGCTGGCTACGAGCAGTACTTC	CASSGGRGAGYEQYF	TRBV7-9	TRBJ2-7
TGTGCCAGCAGGGGGCGCTATGGCTACACCTTC	CASRGRYGYTF	TRBV25-1	TRBJ1-2
TGCAGTGCTCTAAGGAACAGGGGAAAAACCAATCAGCCCCAGCATTTT	CSALRNRGKTNQPQHF	TRBV20-1	TRBJ1-5
TGTGCCAGCAGCACTGCGACCTACGAGCAGTACTTC	CASSTATYEQYF	TRBV7-3	TRBJ2-7
TGTGCCAGCAGCTGCGTAAAGAGGGGGGACAATCAGCCCCAGCATTTT	CASSCVKRGDNQPQHF	TRBV5-6	TRBJ1-5
TGTGCCATCAGCAGAGGACAGGGAGGGGCAACTAATGAAAAACTGTTTTTT	CAISRGQGGATNEKLFF	TRBV10-3	TRBJ1-4
TGTGCCAGCAGAGGAGGGTATCTTTCACCCCTCCACTTT	CASRGGYLSPLHF	TRBV2	TRBJ1-6
TGCGCCAGCAGCAAGAGAAATAGCAATCAGCCCCAGCATTTT	CASSKRNSNQPQHF	TRBV5-1	TRBJ1-5
TGTGCCAGCAGTTTAATAGGACTAAGGTACAATGAGCAGTTCTTC	CASSLIGLRYNEQFF	TRBV27	TRBJ2-1
TGTGCCAGCAGTGGTGGACAGGGAGAGAACACTGAAGCTTTCTTT	CASSGGQGENTEAFF	TRBV27	TRBJ1-1
TGTGCCACCAGCGGGGGGCCCGCCTACGAGCAGTACTTC	CATSGGPAYEQYF	TRBV15	TRBJ2-7
TGCAGTGCTAGAGATTCCCAGGCAGGGGGGGAGAACTATGGCTACACCTTC	CSARDSQAGGENYGYTF	TRBV20-1	TRBJ1-2
TGTGCCTGGAGAACGGGACAGGGTAGGAACTATGGCTACACCTTC	CAWRTGQGRNYGYTF	TRBV30	TRBJ1-2
TGTGCCAGCAGCCAAGTACGGGGTGGATACACTGAAGCTTTCTTT	CASSQVRGGYTEAFF	TRBV4-2	TRBJ1-1
TGTGCCAGCAGCTTAGATAGGGCGGCAACTGTAGAAGCTTTCTTT	CASSLDRAATVEAFF	TRBV11-3	TRBJ1-1
TGCGCCAGCAGCCAAGTCTTAACTAGGGTCCCCCTTGCCTACGAGCAGTACTTC	CASSQVLTRVPLAYEQYF	TRBV4-3	TRBJ2-7
TGTGCCAGCAGTATACTGGGAGGTAAGGGATATCAGCCCCAGCATTTT	CASSILGGKGYQPQHF	TRBV6-5	TRBJ1-5
TGTGCCAGCAGCCAAGGGAACAGGGCCTCAAGTAATGAAAAACTGTTTTTT	CASSQGNRASSNEKLFF	TRBV3-1	TRBJ1-4
TGTGCCAGCAGCCTCCTAGCCGGCTACGAGCAGTACTTC	CASSLLAGYEQYF	TRBV9	TRBJ2-7
TGTGCCAGCAGCGAGTCGACAGGGGTGGCTGAAGCTTTCTTT	CASSESTGVAEAFF	TRBV7-4	TRBJ1-1
TGTGCCAGCATCAGGTACAATGAGCAGTTCTTC	CASIRYNEQFF	TRBV27	TRBJ2-1
TGTGCCAGCACACCGACTAGCGGGGGAGAAAATGAGCAGTTCTTC	CASTPTSGGENEQFF	TRBV13	TRBJ2-1
TGTGCCAGCAGCGACGACAGGCATCCGAGAAAACTGTTTTTT	CASSDDRHPRKLFF	TRBV9	TRBJ1-4
TGTGCCACCAGAGTAGGGGAGACCTACGAGCAGTACTTC	CATRVGETYEQYF	TRBV24-1	TRBJ2-7
TGTGCCAGCAGCCAACGGGACAGGGCGGGGGAGCTGTTTTTT	CASSQRDRAGELFF	TRBV7-3	TRBJ2-2
TGTGCCAGCTGGGGTCAAGAGACCCAGTACTTC	CASWGQETQYF	TRBV27	TRBJ2-5
TGTGCCAGCAGTGGCCGCAGGCAGAACACTGAAGCTTTCTTT	CASSGRRQNTEAFF	TRBV25-1	TRBJ1-1
TGTGCCAGCAGCCGTCGACAGGGGTTCTCCTACGAGCAGTACTTC	CASSRRQGFSYEQYF	TRBV9	TRBJ2-7
TGCGCCAGCAGGCAGGGAAGTAAAGAGACCCAGTACTTC	CASRQGSKETQYF	TRBV10-1	TRBJ2-5
TGCGCCAGCAGCTTGCCTACAAACCGTTTCGAAGAGACCCAGTACTTC	CASSLPTNRFEETQYF	TRBV5-1	TRBJ2-5
TGCGCCAGCGGTTTCATGCACAGGGACCCTGAAAAACTGTTTTTT	CASGFMHRDPEKLFF	TRBV10-2	TRBJ1-4
TGCGCCAGCAGCTTGGCTAGCGGCTTAAGCGCAAGGGGGGATACGCAGTATTTT	CASSLASGLSARGDTQYF	TRBV5-1	TRBJ2-3
TGTGCCTGGACCGGGGGGGGGGACGAGCAGTACTTC	CAWTGGGDEQYF	TRBV30	TRBJ2-7
TGTGCCAGCAGCTTAACTCCGAGGCGGACAGGGAGATCTCAAGATACGCAGTATTTT	CASSLTPRRTGRSQDTQYF	TRBV5-5	TRBJ2-3
TGTGCCAGCAGCGGGCTGGCCGAGACCCAGTACTTC	CASSGLAETQYF	TRBV7-4	TRBJ2-5
TGCGCCAGCTCTTTCGACGGGAACTATGGCTACACCTTC	CASSFDGNYGYTF	TRBV10-2	TRBJ1-2
TGTGCCATCCAGAAGGGGGAGTTCAGCACTGAAGCTTTCTTT	CAIQKGEFSTEAFF	TRBV19	TRBJ1-1
TGCGCCAGCAGCAACGGAAGCTATAGCAATCAGCCCCAGCATTTT	CASSNGSYSNQPQHF	TRBV5-1	TRBJ1-5
TGTGCCAGCAGCTTGCCTCCCGGGCCGGGGGGGGAGCTGTTTTTT	CASSLPPGPGGELFF	TRBV7-7	TRBJ2-2
TGCAGTGCTCGGACAGGGGGAAACACCATATATTTT	CSARTGGNTIYF	TRBV20-1	TRBJ1-3
TGCGCCAGCAGCCATCGTTCTCCTAGACGGAGCTCCTACAATGAGCAGTTCTTC	CASSHRSPRRSSYNEQFF	TRBV4-1	TRBJ2-1
TGTGCCAGCAGTCAGGGTTTTACTAGCGGGTCGGGGTCCTACGAGCAGTACTTC	CASSQGFTSGSGSYEQYF	TRBV28	TRBJ2-7
TGTGCCAGCAGCGCAGGGAGCTACGAGCAGTACTTC	CASSAGSYEQYF	TRBV12-3	TRBJ2-7
TGTGCCAGCACGCAGGGACTCTCCTATAATTCACCCCTCCACTTT	CASTQGLSYNSPLHF	TRBV7-3	TRBJ1-6
TGTGCCAGCAGCCAAGTTAAACTAGCGGGAGACAGAAGCACAGATACGCAGTATTTT	CASSQVKLAGDRSTDTQYF	TRBV3-1	TRBJ2-3
TGTGCCAGCACCAACCCGACTCAGTGGGGAGACTATGGCTACACCTTC	CASTNPTQWGDYGYTF	TRBV5-4	TRBJ1-2
TGTGCCAGCACCGCCGGGACAGGTGGCTATGGCTACACCTTC	CASTAGTGGYGYTF	TRBV7-2	TRBJ1-2
TGCGCCAGCAGTACGCCCCGTGACGGGGCCAACGTCCTGACTTTC	CASSTPRDGANVLTF	TRBV5-1	TRBJ2-6
TGTGCCAGCAGCTGTCCGGGACTAGGGAGCTCCTACAATGAGCAGTTCTTC	CASSCPGLGSSYNEQFF	TRBV5-4	TRBJ2-1
TGTGCCAGCAGCGGCCCATGGGGCCCGGGAGTCTCCTACGAGCAGTACTTC	CASSGPWGPGVSYEQYF	TRBV9	TRBJ2-7
TGTGCCAGCCCCACTTCCGGGGGCTACACCTTC	CASPTSGGYTF	TRBV5-4	TRBJ1-2
TGTGCCAGCAGTTTCTTCAGGAACACCGGGGAGCTGTTTTTT	CASSFFRNTGELFF	TRBV28	TRBJ2-2
TGTGCCAGCTCGGGGGGCCGCAACACAGATACGCAGTATTTT	CASSGGRNTDTQYF	TRBV28	TRBJ2-3
TGTGCCAGAAAGGGGATGGACAGGGTACAACACACTGAAGCTTTCTTT	CARKGMDRVQHTEAFF	TRBV9	TRBJ1-1
TGTGCCAGCAGCGTTTGCCACAGGGTAGCTGGAAACACCATATATTTT	CASSVCHRVAGNTIYF	TRBV7-3	TRBJ1-3
TGCAGTGCTAGAGATGGACTAGCGGGAGCTCGCTTTGGTAATGAGCAGTTCTTC	CSARDGLAGARFGNEQFF	TRBV20-1	TRBJ2-1
TGTGCCAGCAGCCCTTTTTCGTGGGCCCCCGACAGGAAGACCCAGTACTTC	CASSPFSWAPDRKTQYF	TRBV9	TRBJ2-5
TGTGCCAGCAGTAAGCGGCCATCCTACAATGAGCAGTTCTTC	CASSKRPSYNEQFF	TRBV6-5	TRBJ2-1
TGTGCCAGCAGTCATCCTCGGGACGAGCAGTACTTC	CASSHPRDEQYF	TRBV27	TRBJ2-7
TGTGCCAGCAGCGTAGTGCATTTTGGGATCAATCAGCCCCAGCATTTT	CASSVVHFGINQPQHF	TRBV9	TRBJ1-5
TGTGCCAGCAGGCTCCGAAGCGGGAGTGCCTACGAGCAGTACTTC	CASRLRSGSAYEQYF	TRBV6-4	TRBJ2-7
TGTGCCAGCACCGCGGGAGGAACTGAAGCTTTCTTT	CASTAGGTEAFF	TRBV27	TRBJ1-1
TGTGCCAGCAGGACTAGCGGGAGGGCTATTTCCGTAACATTATACAATGAGCAGTTCTTC	CASRTSGRAISVTLYNEQFF	TRBV27	TRBJ2-1
TGCGCCAGCAGCCAAGATTTGGGACTAGGAAATGAGCAGTTCTTC	CASSQDLGLGNEQFF	TRBV4-1	TRBJ2-1
TGTGCCAGCAGCGGCGCGACCCAGCAGTACTTC	CASSGATQQYF	TRBV9	TRBJ2-7
TGTGCCTGGAGGTCTAGCGGGAGGAGTGATACGCAGTATTTT	CAWRSSGRSDTQYF	TRBV30	TRBJ2-3
TGTGCCAGCAGCTTAAGTTCGGCACGCTACGAGCAGTACTTC	CASSLSSARYEQYF	TRBV7-7	TRBJ2-7
TGTGCCAGCAGAGGTAGCTCCTCCAGGGGGCGCGGGAACTACTATGGCTACACCTTC	CASRGSSSRGRGNYYGYTF	TRBV2	TRBJ1-2
TGTGCCAGCAGCTACCCGGGACAGGGAGAGACCCAGTACTTC	CASSYPGQGETQYF	TRBV13	TRBJ2-5
TGTGCCAGCAGGTACTTCGACGGTGTGGGGGATCTTAACACCGGGGAGCTGTTTTTT	CASRYFDGVGDLNTGELFF	TRBV2	TRBJ2-2
TGTGCCAGCAGTTACTCGAAGGCGCCCCCGCACAGGCGTCAGCCCCAGCATTTT	CASSYSKAPPHRRQPQHF	TRBV6-5	TRBJ1-5
TGTGCCAGCAGCTTAGCTCCCGACGAGCTTAGGAGCTCCTACAATGAGCAGTTCTTC	CASSLAPDELRSSYNEQFF	TRBV7-6	TRBJ2-1
TGCAGTGCTACCACCGGGACAGGGGAGTACTATGGCTACACCTTC	CSATTGTGEYYGYTF	TRBV20-1	TRBJ1-2
TGCGCCAGCAGCCAAGATGCCCCTAGGGGGCGGATTGGCGAGCAGTACTTC	CASSQDAPRGRIGEQYF	TRBV4-1	TRBJ2-7
TGCAGTGCACGATTAGACTACGAGCAGTACTTC	CSARLDYEQYF	TRBV20-1	TRBJ2-7
TGCGCCAGCAGCCTGGGGGGGAGGGCCCGCAATGAGCAGTTCTTC	CASSLGGRARNEQFF	TRBV5-1	TRBJ2-1
TGCGCCAGCAGCTTGGCCTGGGGACAGGGGGCTACCTACGAGCAGTACTTC	CASSLAWGQGATYEQYF	TRBV5-1	TRBJ2-7
TGTGCCAGCAGTTTATCCAAGGGGGGTAGCTCCTACAATGAGCAGTTCTTC	CASSLSKGGSSYNEQFF	TRBV28	TRBJ2-1
TGTGCCAGCAGCTTGGCGCCCCCATGGCGGGGGGCCTGTACCGGGGAGCTGTTTTTT	CASSLAPPWRGACTGELFF	TRBV5-6	TRBJ2-2
TGCAGCGGGGCGAGACAGGGAGGGCGGCCGAACACCGGGGAGCTGTTTTTT	CSGARQGGRPNTGELFF	TRBV29-1	TRBJ2-2
TGTGCCAGCAGCCTTTCTAGCGGGAAGGCTGGGGCCAACGTCCTGACTTTC	CASSLSSGKAGANVLTF	TRBV13	TRBJ2-6
TGTGCCAGCCCTTGGGGCGGAGATAATTCACCCCTCCACTTT	CASPWGGDNSPLHF	TRBV7-3	TRBJ1-6
TGTGCCAGCAGGGTGGGCTCTTATCCCTACGAGCAGTACTTC	CASRVGSYPYEQYF	TRBV11-2	TRBJ2-7
TGTGCCAGCAGAACTAGCGGGAATCATTCCACAGATACGCAGTATTTT	CASRTSGNHSTDTQYF	TRBV9	TRBJ2-3
TGTGCCAGCAGCTGCCCCGGGACCTCGACCGGGGAGCTGTTTTTT	CASSCPGTSTGELFF	TRBV6-2	TRBJ2-2
TGTGCCTGGAGTGTACCCTCCCGGACGGAGGAGACCCAGTACTTC	CAWSVPSRTEETQYF	TRBV30	TRBJ2-5
TGTGCCAGCAGTCGGGACAGGGGGCAGCCCCAGCATTTT	CASSRDRGQPQHF	TRBV12-3	TRBJ1-5
TGTGCCAGCAAGGATTGTAACAGGGGGTCTGCAACTAATGAAAAACTGTTTTTT	CASKDCNRGSATNEKLFF	TRBV6-4	TRBJ1-4
TGTGCCAGCAGCGTGGGGGGACAGGGGAGCAATCAGCCCCAGCATTTT	CASSVGGQGSNQPQHF	TRBV9	TRBJ1-5
TGCGCCAGTCACTCTAGGTTGAGGACCGGGGAGCTGTTTTTT	CASHSRLRTGELFF	TRBV10-1	TRBJ2-2
TGTGCCAGCAGCTACCCAGGCAGGAGTCTCTTT	CASSYPGRSLF	TRBV5-4	TRBJ1-1
TGTGCCAGCAGTTTATCGTCAGACATTATTGCTGAAGCTTTCTTT	CASSLSSDIIAEAFF	TRBV27	TRBJ1-1
TGTGCCAGCCGCGTCCCTTGCATCAGCGGCTACACCTTC	CASRVPCISGYTF	TRBV11-2	TRBJ1-2
TGTGCCAGCAGCTGGACAGCTTTCTTT	CASSWTAFF	TRBV11-3	TRBJ1-1
TGTGCCAGCAGCCGGCCGGGACAGTTTATCACTGAAGCTTTCTTT	CASSRPGQFITEAFF	TRBV7-3	TRBJ1-1
TGCGCCAGCAGTGAGAAACTGGGGGGGCCTAGCTCCTACAATGAGCAGTTCTTC	CASSEKLGGPSSYNEQFF	TRBV10-2	TRBJ2-1
TGTGCCAGCAGCCAGGGTGGACAGGGGGCACTTAATTCACCCCTCCACTTT	CASSQGGQGALNSPLHF	TRBV14	TRBJ1-6
TGCGCCAGCAGCCAACCATTGGACAGGTGGGATAGCAATCAGCCCCAGCATTTT	CASSQPLDRWDSNQPQHF	TRBV4-1	TRBJ1-5
TGTGCCACTCGCATGAAACTCTACAATGAGCAGTTCTTC	CATRMKLYNEQFF	TRBV27	TRBJ2-1
TGTGCCAGCAGGGACCTGGACAGGGGCCGCCAAGAGACCCAGTACTTC	CASRDLDRGRQETQYF	TRBV6-5	TRBJ2-5
TGTGCCAGCAGTTATTCAACAGGGGTAAGTAACACCATATATTTT	CASSYSTGVSNTIYF	TRBV6-6	TRBJ1-3
TGCGCCAGCTCTCGAGATCAGCCCCCCAATCAGCCCCAGCATTTT	CASSRDQPPNQPQHF	TRBV10-1	TRBJ1-5
TGTGCCATCAGTGCGCGGCCTCAAGAAGAGACCCAGTACTTC	CAISARPQEETQYF	TRBV10-3	TRBJ2-5
TGTGCCAGCACCGAACTCCCAAGAGACGGGAGTAGGGGACTCTACGAGCAGTACTTC	CASTELPRDGSRGLYEQYF	TRBV7-2	TRBJ2-7
TGCAGTGCTAGATTTTGCATTTGGGACAGTGGTAACTATGGCTACACCTTC	CSARFCIWDSGNYGYTF	TRBV20-1	TRBJ1-2
TGTGCCTGGAGTGTAAGGGAACAGGGTTCAGAGACCCAGTACTTC	CAWSVREQGSETQYF	TRBV30	TRBJ2-5
TGTGCCAGCAGTCAGACAGGGCCGTTCCGACAAGAGACCCAGTACTTC	CASSQTGPFRQETQYF	TRBV27	TRBJ2-5
TGTGCCAGCAGCCCCACCGACAGGGGTTGTAATGAGCAGTTCTTC	CASSPTDRGCNEQFF	TRBV7-8	TRBJ2-1
TGTGCCAGCAGTCGCCCAACAGGGGTCTCTGGGGCCAACGTCCTGACTTTC	CASSRPTGVSGANVLTF	TRBV6-4	TRBJ2-6
TGTGCCAGCAGTACGACCACCTACGAGCAGTACTTC	CASSTTTYEQYF	TRBV27	TRBJ2-7
TGTGCCAGCAAGGGTCCGGGACTAGCGGTCAGGGGGAGCTACGAGCAGTACTTC	CASKGPGLAVRGSYEQYF	TRBV7-9	TRBJ2-7
TGCGCCAGCAGCCAAGACTTAGAGAAGTCTTACGAGCAGTACTTC	CASSQDLEKSYEQYF	TRBV4-1	TRBJ2-7
TGTGCCAGCAGTGAACTGGGAACTAGCGTTTTCTCCTACAATGAGCAGTTCTTC	CASSELGTSVFSYNEQFF	TRBV6-1	TRBJ2-1
TGTGCCAGCAGGGGCTGCCTGGGGGGGACCTACGAGCAGTACTTC	CASRGCLGGTYEQYF	TRBV6-1	TRBJ2-7
TGCAGTGCTAGTCCCTATCCGCGGGGGAATGAGCAGTTCTTC	CSASPYPRGNEQFF	TRBV20-1	TRBJ2-1
TGTGCCAGCTCACCACTAGAGGGAAGATTAGATACGCAGTATTTT	CASSPLEGRLDTQYF	TRBV18	TRBJ2-3
TGTGCCAGCAGCATGGACAGGGGCATCAATCAGCCCCAGCATTTT	CASSMDRGINQPQHF	TRBV5-4	TRBJ1-5
TGTGCCAGCAGGTTCCTTGCGTATTTT	CASRFLAYF	TRBV7-3	TRBJ2-3
TGTGCCAGCAGCAAGCAGGCCACGGCGGAGACCCAGTACTTC	CASSKQATAETQYF	TRBV7-3	TRBJ2-5
TGTGCCAGACGGACTAGCGGGCAGTACTTC	CARRTSGQYF	TRBV19	TRBJ2-5
TGTGCCACCAGCAGAGATGACCCCTTTCCACAGGGCCCGTTTCCTAATTACACCGGGGAGCTGTTTTTT	CATSRDDPFPQGPFPNYTGELFF	TRBV15	TRBJ2-2
TGTGCCAGCAGCTTAATAGACCGGTGGTATGGCTACACCTTC	CASSLIDRWYGYTF	TRBV7-9	TRBJ1-2
TGCGCCAGCAGCCAAGATGACAGCGGGAGGAGTATGACTAATGAAAAACTGTTTTTT	CASSQDDSGRSMTNEKLFF	TRBV4-1	TRBJ1-4
TGTGCCAGCTTAACCCTGGGGGATAGGCGCTCCTACGAGCAGTACTTC	CASLTLGDRRSYEQYF	TRBV11-2	TRBJ2-7
TGTGCCAGCAGGGACAGTGAGGGAATTCAATTGGCCGGGGAGCTGTTTTTT	CASRDSEGIQLAGELFF	TRBV6-5	TRBJ2-2
TGTGCCTGGATGTCGAGGGAGTTCTCCCAGTACTTC	CAWMSREFSQYF	TRBV30	TRBJ2-5
TGTGCCAGCAGGGGGACAGGGACGGACGAGCAGTACTTC	CASRGTGTDEQYF	TRBV12-4	TRBJ2-7
TGCGCCAGCAACTGGACAGCTCGGGTCCCCCAAGAGACCCAGTACTTC	CASNWTARVPQETQYF	TRBV10-2	TRBJ2-5
TGCAGTGAGGAAGGGGGAAGTTCCTACGAGCAGTACTTC	CSEEGGSSYEQYF	TRBV20-1	TRBJ2-7
TGTGCCAGCAGCCAAGAGTTTTTAACAAGAATCGTCTTAGGATGGGAAAAACTGTTTTTT	CASSQEFLTRIVLGWEKLFF	TRBV14	TRBJ1-4
TGTGCCAGCACGGGAGATAGCGGGAGCTCCTACAATGAGCAGTTCTTC	CASTGDSGSSYNEQFF	TRBV6-4	TRBJ2-1
TGTGCCTGGAGTGTCGCAGGGATCCCGTCTGACGAGCAGTACTTC	CAWSVAGIPSDEQYF	TRBV30	TRBJ2-7
TGTGCCACCAGTGATTTGCCCTGCGTGTCACCTAAAGAGACCCAGTACTTC	CATSDLPCVSPKETQYF	TRBV24-1	TRBJ2-5
TGTGCCAGCAGCACTAGCGGGAGAAGAGATACGCAGTATTTT	CASSTSGRRDTQYF	TRBV6-4	TRBJ2-3
TGTGCCCAGGGGGGGGTGAAAAACTATGGCTACACCTTC	CAQGGVKNYGYTF	TRBV24-1	TRBJ1-2
TGCGCCAGCTCGGGCGCCGACAGGGCCAACTATGGCTACACCTTC	CASSGADRANYGYTF	TRBV4-3	TRBJ1-2
TGCAGTGCTAGATTTGGGGGGAGCGAGCAGTACTTC	CSARFGGSEQYF	TRBV20-1	TRBJ2-7
TGTGCCAGCAGCCAAGAGCGGGGGATCTATGGCTACACCTTC	CASSQERGIYGYTF	TRBV3-1	TRBJ1-2
TGCGCCAGCAGCGGACAGGGGTTCGAGCAGTACTTC	CASSGQGFEQYF	TRBV5-1	TRBJ2-7
TGTGCCAGCTCTAGTGGGGTAGGGACGACCTACGAGCAGTACTTC	CASSSGVGTTYEQYF	TRBV7-3	TRBJ2-7
TGTGCCAGCAGCTTAAACCTTTCGGGCCGAAACACCATATATTTT	CASSLNLSGRNTIYF	TRBV7-3	TRBJ1-3
TGTGCTAGCAGCTTATCACCCAGGGGAACGGCCTACGAGCAGTACTTC	CASSLSPRGTAYEQYF	TRBV7-7	TRBJ2-7
TGTGCCAGCAGTCCTCAGGGAATTTATAATGAGCAGTTCTTC	CASSPQGIYNEQFF	TRBV6-4	TRBJ2-1
TGTGCCAGCTCACCCCAGGACAGGGGGGACCTATCCGAGCAGTACTTC	CASSPQDRGDLSEQYF	TRBV18	TRBJ2-7
TGCGCCAGCAGTGGAAGGGACAGGGCCTACGAGCAGTACTTC	CASSGRDRAYEQYF	TRBV10-1	TRBJ2-7
TGCAGTGCTAGAGGGGGGGGGGGGACAGATACGCAGTATTTT	CSARGGGGTDTQYF	TRBV20-1	TRBJ2-3
TGTGCCAGCAGTGCGGATAGTCTGGGACAGGGGACGGGGGCCAACGTCCTGACTTTC	CASSADSLGQGTGANVLTF	TRBV6-1	TRBJ2-6
TGCAGCGTCCTTGGTCCGGGCAGGGCAACCGCAACTAATGAAAAACTGTTTTTT	CSVLGPGRATATNEKLFF	TRBV29-1	TRBJ1-4
TGTGCCAGTACAGTCGGGACAGGGAAGGGGGCCAACGTCCTGACTTTC	CASTVGTGKGANVLTF	TRBV19	TRBJ2-6
TGTGCCAGCACCGGGGCACCTGAAGCTTTCTTT	CASTGAPEAFF	TRBV6-4	TRBJ1-1
TGTGCCAGCAGTACCCCGGGACGAATCACTGAAGCTTTCTTT	CASSTPGRITEAFF	TRBV2	TRBJ1-1
TGTGCCAAGGCCGGTATGTTTAACTATGGCTACACCTTC	CAKAGMFNYGYTF	TRBV6-2	TRBJ1-2
TGTGCCAGTAGTATAGGTCTCCCGGGACTAGTCACCTACGAGCAGTACTTC	CASSIGLPGLVTYEQYF	TRBV19	TRBJ2-7
TGTGCCAGCAGCTTGCAAGGGACTAGCGGGCGGTCGCTTGAGCAGTTCTTC	CASSLQGTSGRSLEQFF	TRBV5-6	TRBJ2-1
TGCGCCAGGGTGAAACGGCAAGGCTCCTACGAGCAGTACTTC	CARVKRQGSYEQYF	TRBV10-1	TRBJ2-7
TGTGCCAGCATAGGGAAGAAGTGGGCCTACGAGCAGTACTTC	CASIGKKWAYEQYF	TRBV6-5	TRBJ2-7
TGTGCCAGCAGTAGATTTGGGGGGGGTACCTACGAGCAGTACTTC	CASSRFGGGTYEQYF	TRBV6-1	TRBJ2-7
TGTGCCAGCAGTGAAGCAAGGACAGAGTACCGGAGTATATCCTACGAGCAGTACTTC	CASSEARTEYRSISYEQYF	TRBV2	TRBJ2-7
TGTGCCAGCAGCTTATTAGCCTCGAGAGGTTACGAGCAGTACTTC	CASSLLASRGYEQYF	TRBV11-3	TRBJ2-7
TGTGCCAGCAGCCAAGAGTTCACTCGCGGTCGGTCTGGAAACACCATATATTTT	CASSQEFTRGRSGNTIYF	TRBV3-1	TRBJ1-3
TGTGCCAGCAGAGGCGACAGGACCCAATATGGCTACACCTTC	CASRGDRTQYGYTF	TRBV6-1	TRBJ1-2
TGCGCCAGCAGCCTAAATAGAGGGGCCAACGTCCTGACTTTC	CASSLNRGANVLTF	TRBV4-1	TRBJ2-6
TGTGCCAGCAGTGACCCAGCCGGGACAGGGGGAGTGGGCTACACCTTC	CASSDPAGTGGVGYTF	TRBV6-4	TRBJ1-2
TGTGCCAGAGGCCGGCCCTTGGAGACCCAGTACTTC	CARGRPLETQYF	TRBV10-3	TRBJ2-5
TGTGCCAGCAGGGATCTTTACGAGCAGTACTTC	CASRDLYEQYF	TRBV7-9	TRBJ2-7
TGTGCCAGCAGCCAAACATTCAGGGAAAGCTACGAGCAGTACTTC	CASSQTFRESYEQYF	TRBV3-1	TRBJ2-7
TGTGCCGGTGAACGCGAGCAGTACTTC	CAGEREQYF	TRBV9	TRBJ2-7
TGTGCCAGCAGTCTTCCGGTGGGACTAGCGTGGGGGAGCACAGATACGCAGTATTTT	CASSLPVGLAWGSTDTQYF	TRBV14	TRBJ2-3
TGTGCCAGCAGTTTAACAGGCCTGTTTTTT	CASSLTGLFF	TRBV12-4	TRBJ1-4
TGTGCCAGCAGCTTGCCACAGGGGTCCCCTAACTATGGCTACACCTTC	CASSLPQGSPNYGYTF	TRBV5-6	TRBJ1-2
TGTGCCAGCAGCTTAGACGTGGGGGCGGCCTATAATTCACCCCTCCACTTT	CASSLDVGAAYNSPLHF	TRBV11-2	TRBJ1-6
TGCAGTGCTGTAGTTTGGGGAACCTACAATGAGCAGTTCTTC	CSAVVWGTYNEQFF	TRBV20-1	TRBJ2-1
TGTGCCAGCAGTGCTAGTCTCACCGGGGAGCTGTTTTTT	CASSASLTGELFF	TRBV6-5	TRBJ2-2
TGTGCCAGCTCACCATCCTATGGACAGGGCCCCCGTCGCAATCAGCCCCAGCATTTT	CASSPSYGQGPRRNQPQHF	TRBV18	TRBJ1-5
TGCGCCAGCAGCCACCTGGGGAATGAAAAACTGTTTTTT	CASSHLGNEKLFF	TRBV4-3	TRBJ1-4
TGTGCCAGCAGTGATTCGGGGGCTTCCTACGAGCAGTACTTC	CASSDSGASYEQYF	TRBV25-1	TRBJ2-7
TGTGCCAGCAGCTTAGTGGACTTCCGGGAGCCACCTGACGAGCAGTACTTC	CASSLVDFREPPDEQYF	TRBV11-3	TRBJ2-7
TGTGCCAGCAGCTTAGATCGCCGGGACAGGGGGCTGTGGCAAGAGACCCAGTACTTC	CASSLDRRDRGLWQETQYF	TRBV7-9	TRBJ2-5
TGTGCCACCAGTGATGGCCTCAATCAGCCCCAGCATTTT	CATSDGLNQPQHF	TRBV24-1	TRBJ1-5
TGTGCCAGCAGCCCTCAGAGTCAGAGCTCCTACAATGAGCAGTTCTTC	CASSPQSQSSYNEQFF	TRBV3-1	TRBJ2-1
TGTGCCAGCTCACCCTTACCTCGGGGACTAGCGGGTCGAGTCCCCCGTTCCGGGGAGCTGTTTTTT	CASSPLPRGLAGRVPRSGELFF	TRBV18	TRBJ2-2
TGTGCCAGCAGCGTAGCTGGATCACAGTGGCAAGATACGCAGTATTTT	CASSVAGSQWQDTQYF	TRBV9	TRBJ2-3
TGTGCCAGCAGCAGTCAGGGCTTCCCCACTGAAGCTTTCTTT	CASSSQGFPTEAFF	TRBV7-4	TRBJ1-1
TGTGCCAGCAGTTCGGGACTGGCACCGGGCTATGGCTACACCTTC	CASSSGLAPGYGYTF	TRBV6-5	TRBJ1-2
TGCAGTGCCCGGGGCCCCCCGGGGTTGCCTCTTTCAGACAACGAGCAGTACTTC	CSARGPPGLPLSDNEQYF	TRBV20-1	TRBJ2-7
TGTGCCAGCAGCCAAGCCCGGGACGGGGATCAGCCCCAGCATTTT	CASSQARDGDQPQHF	TRBV3-1	TRBJ1-5
TGCAGTGCTAGCACCGGGACTAGCGGGACGGGAGATACGCAGTATTTT	CSASTGTSGTGDTQYF	TRBV20-1	TRBJ2-3
TGTGCCAGCAGCCTCCGGTTTCACTACGAGCAGTACTTC	CASSLRFHYEQYF	TRBV9	TRBJ2-7
TGTGCCAGCAGTTTACCAGCAAGGAAAGAGACCCAGTACTTC	CASSLPARKETQYF	TRBV28	TRBJ2-5
TGTGCCAGACGAGGGGAGGAAGCGCAGTATTTT	CARRGEEAQYF	TRBV24-1	TRBJ2-3
TGTGCCACGTCTCAGGGGAGGGGGGTGGTAGAGACCCAGTACTTC	CATSQGRGVVETQYF	TRBV6-2	TRBJ2-5
TGTGCCAGTAGTCATCCGGACAGGGGTCCTAATCAGCCCCAGCATTTT	CASSHPDRGPNQPQHF	TRBV19	TRBJ1-5
TGTGCCAGCGGGACTAGCGGGTACAATGAGCAGTTCTTC	CASGTSGYNEQFF	TRBV7-3	TRBJ2-1
TGCAGTGCCCTCTTCGCTACAGGGGGGACGGACGAGCAGTACTTC	CSALFATGGTDEQYF	TRBV20-1	TRBJ2-7
TGTGCCAGCAGCTCTGGGGGGTATAGCAATCAGCCCCAGCATTTT	CASSSGGYSNQPQHF	TRBV11-2	TRBJ1-5
TGTGCCAGCAGGCATAGTTGCAATCAGCCCCAGCATTTT	CASRHSCNQPQHF	TRBV6-4	TRBJ1-5
TGTGCCAGCAGTGACCCATTGAAAAACTCCTACGAGCAGTACTTC	CASSDPLKNSYEQYF	TRBV6-1	TRBJ2-7
TGTGCCAGCAGCACCCTCTACGAGCAGTACTTC	CASSTLYEQYF	TRBV13	TRBJ2-7
TGCGCCAGCAGTCCGACAGTAGTCTCTGAAAAACTGTTTTTT	CASSPTVVSEKLFF	TRBV10-2	TRBJ1-4
TGTGCCAGCAGCATACGGACAGGGGAAATCGCAGTAGGATACGAGCAGTACTTC	CASSIRTGEIAVGYEQYF	TRBV7-2	TRBJ2-7
TGTGCCAGCAGCGTAGATGCTATGGCAAGGGGGCCATGTAACACTGAAGCTTTCTTT	CASSVDAMARGPCNTEAFF	TRBV9	TRBJ1-1
TGTGCCAGCAGCTTCCCGGGGCCGTCCTACAATGAGCAGTTCTTC	CASSFPGPSYNEQFF	TRBV11-3	TRBJ2-1
TGTGCCAGCTCACAGACGATGCCAAAAGTAGCGGGGGGTTTGCCGAGCACAGATACGCAGTATTTT	CASSQTMPKVAGGLPSTDTQYF	TRBV18	TRBJ2-3
TGCAGTGCTAGAGATAAGCGGTTTAATGAGCAGTTCTTC	CSARDKRFNEQFF	TRBV20-1	TRBJ2-1
TGCGCCAGCAAACTGGGCCCGCTACCTAACTATGGCTACACCTTC	CASKLGPLPNYGYTF	TRBV10-1	TRBJ1-2
TGTGCTATGTGGAGGGGGGGCGATTACTACACCGGGGAGCTGTTTTTT	CAMWRGGDYYTGELFF	TRBV24-1	TRBJ2-2
TGCAGTGCTAGAGAATCGGGGGGACTAGCGGGGGGCTACGAGCAGTACTTC	CSARESGGLAGGYEQYF	TRBV20-1	TRBJ2-7
TGTGCCAGCAGTTTCCAGAAACCCCGACAGAATAACTATGGCTACACCTTC	CASSFQKPRQNNYGYTF	TRBV27	TRBJ1-2
TGTGCCAGCAGCCGTTTTACGGGACTAGCGGGAGGGACATGGGACGAGCAGTACTTC	CASSRFTGLAGGTWDEQYF	TRBV7-4	TRBJ2-7
TGTGCCAGCATCCCCATTACTGATTTCCTATTTAGTATTCCATTGAGGAATCAGCCCCAGCATTTT	CASIPITDFLFSIPLRNQPQHF	TRBV27	TRBJ1-5
TGTGCCAGCAGCCAAGAGGCAGGGGTAACCTACAATGAGCAGTTCTTC	CASSQEAGVTYNEQFF	TRBV14	TRBJ2-1
TGTGCCAGCAGCTTAGGGTTGACCTACGAGCAGTACTTC	CASSLGLTYEQYF	TRBV7-2	TRBJ2-7
TGTGCCAGCAGCTCGCCCGTATCAATCTACGAGCAGTACTTC	CASSSPVSIYEQYF	TRBV11-2	TRBJ2-7
TGCAGTGCTCCTCCTGTCAGTGCCGAGCAGTACTTC	CSAPPVSAEQYF	TRBV20-1	TRBJ2-7
TGTGCCAGGAGGGTGGCCTACGAGCAGTACTTC	CARRVAYEQYF	TRBV25-1	TRBJ2-7
TGTGCCAGCAGCACTAGTTCGGAGACCCAGTACTTC	CASSTSSETQYF	TRBV7-9	TRBJ2-5
TGCAGTGCACCGAGTGGCTCCTACGAGCAGTACTTC	CSAPSGSYEQYF	TRBV20-1	TRBJ2-7
TGTGCCTGGACCCTCGGGCGCACAGATACGCAGTATTTT	CAWTLGRTDTQYF	TRBV30	TRBJ2-3
TGTGCCATCAGTGGTCTTACCGGGACGGGGACCAAAAACATTCAGTACTTC	CAISGLTGTGTKNIQYF	TRBV10-3	TRBJ2-4
TGTGCCAGCAGCCTCCCGCAACTTATCTCTGGGGCCAACGTCCTGACTTTC	CASSLPQLISGANVLTF	TRBV11-3	TRBJ2-6
TGTGCCAGCAGCCACCAGGGGACTAGCGAGTACAATGAGCAGTTCTTC	CASSHQGTSEYNEQFF	TRBV6-5	TRBJ2-1
TGCGCCAGCCCCACCGGACAGGAGAACACTGAAGCTTTCTTT	CASPTGQENTEAFF	TRBV10-1	TRBJ1-1
TGTGCCAGCAGCCCGAGGGCAAAGGGGACTGAAGCTTTCTTT	CASSPRAKGTEAFF	TRBV7-9	TRBJ1-1
TGTGCCAGCAGCTTATGGACTGGGTTTGACTCTGGAAACACCATATATTTT	CASSLWTGFDSGNTIYF	TRBV7-8	TRBJ1-3
TGCGCCAGCAGGAAGGGGGCCGTAGATGAAAAACTGTTTTTT	CASRKGAVDEKLFF	TRBV10-1	TRBJ1-4
TGTGCCAGGTTATCGGGGCTCGGCTACACCTTC	CARLSGLGYTF	TRBV19	TRBJ1-2
TGTGCCAGCGATCCGGGGCCGCGGAACACTGAAGCTTTCTTT	CASDPGPRNTEAFF	TRBV7-9	TRBJ1-1
TGTGCCAGCAGTGGAAGGTCCTCCCGGCAATACGAGCAGTACTTC	CASSGRSSRQYEQYF	TRBV6-1	TRBJ2-7
TGTGCCAGCAGCTTAATAGGTGTTGGGAGCGAGCAGTACTTC	CASSLIGVGSEQYF	TRBV7-6	TRBJ2-7
TGTGCCAGCACCTCCCGGGACTCCTACGAGCAGTACTTC	CASTSRDSYEQYF	TRBV12-3	TRBJ2-7
TGCGCCAGCAGCTTGAGAACAAGGCAGGTCGAGCAGTACTTC	CASSLRTRQVEQYF	TRBV5-1	TRBJ2-7
TGTGCCAGCAGTTCGGACAGGGGGAAGCACTATGGCTACACCTTC	CASSSDRGKHYGYTF	TRBV27	TRBJ1-2
TGTGCCATCAGTGAGTCGATACTCCACGGAAGGGGGTTGGAGCACGTCTTC	CAISESILHGRGLEHVF	TRBV10-3	TRBJ2-1
TGTGCCAGCAGCGGACAGGGGGCGGAGGGCTATGGCTACACCTTC	CASSGQGAEGYGYTF	TRBV13	TRBJ1-2
TGTGCCAGCAGATCAGGAGTGGGACAGTTAACAACTAATGAAAAACTGTTTTTT	CASRSGVGQLTTNEKLFF	TRBV3-1	TRBJ1-4
TGCAGCGATACCCCCACACTAGCGGGAGTAGGCCACCCCGACGAGCAGTACTTC	CSDTPTLAGVGHPDEQYF	TRBV29-1	TRBJ2-7
TGTGCCTGGGACAGGGGAAAAGGTCACACTGAAGCTTTCTTT	CAWDRGKGHTEAFF	TRBV30	TRBJ1-1
TGTGCCACCAGTGGGAAACGACAGGGGTTCCATGAAAAACTGTTTTTT	CATSGKRQGFHEKLFF	TRBV24-1	TRBJ1-4
TGTGCCAGAGAACACTGCACGGGCGGCGGCAATGAGCAGTTCTTC	CAREHCTGGGNEQFF	TRBV12-3	TRBJ2-1
TGTGCCAGCAGCGTAGATGGTGATAATGAAAAACTGTTTTTT	CASSVDGDNEKLFF	TRBV9	TRBJ1-4
TGTGCCAGCAGCTTAGAAGTCGTGCCCTACGAGCAGTACTTC	CASSLEVVPYEQYF	TRBV11-2	TRBJ2-7
TGTGCCAGACGGGGGCGGAACACTGAAGCTTTCTTT	CARRGRNTEAFF	TRBV19	TRBJ1-1
TGTGCCAGCAGCCGGAAAAGACAGGGGGGCTCCCAGCATTTT	CASSRKRQGGSQHF	TRBV3-1	TRBJ1-5
TGTGCCAGCAACAGGGGCGGGGGTAGTGAAGCTTTCTTT	CASNRGGGSEAFF	TRBV27	TRBJ1-1
TGTGCCAGCAGCGGAGGACTAGCGGGGGACGAGCAGTACTTC	CASSGGLAGDEQYF	TRBV7-2	TRBJ2-7
TGTGCCAGCAGCCAAGATAAAGGCCGGGACGAGGGGACTCTTGAGCAGTTCTTC	CASSQDKGRDEGTLEQFF	TRBV4-2	TRBJ2-1
TGTGCCAGCTCACCAACCCCGGGACAGGGCGGGGAGCTGTTTTTT	CASSPTPGQGGELFF	TRBV18	TRBJ2-2
TGTGCCAGCCGGGCAGGGGGAGCTTTCTTT	CASRAGGAFF	TRBV7-9	TRBJ1-1
TGTGCCAGCAGCGCCGACAGCAAGGTCTACGAGCAGTACTTC	CASSADSKVYEQYF	TRBV13	TRBJ2-7
TGTGCCACCAGTGATTCCGGGGGCAATGAAAAACTGTTTTTT	CATSDSGGNEKLFF	TRBV24-1	TRBJ1-4
TGTGCCAGCAGCTTAGCTCAATGTCCGGGACAGCGAGAGACCCAGTACTTC	CASSLAQCPGQRETQYF	TRBV7-6	TRBJ2-5
TGTGCCTGGAGACAGGGCAGAGCTTTCTTT	CAWRQGRAFF	TRBV30	TRBJ1-1
TGTGCCAGCAGCATAGGCGGATATGAGCAGTTCTTC	CASSIGGYEQFF	TRBV13	TRBJ2-1
TGTGCCAGCAGCTCCCCTCCCAAAAGTCTTGAGCAGTTCTTC	CASSSPPKSLEQFF	TRBV11-3	TRBJ2-1
TGTGCCAGCAGCTTACTCCGGGGGGGATTTGTCTACAATGAGCAGTTCTTC	CASSLLRGGFVYNEQFF	TRBV7-9	TRBJ2-1
TGTGCCTGGAGTGCACCCGGGACAGCCTACGAGCAGTACTTC	CAWSAPGTAYEQYF	TRBV30	TRBJ2-7
TGTGCCAGCACTGTCTTAGGCCGGAGGGGTACTCATAATGAAAAACTGTTTTTT	CASTVLGRRGTHNEKLFF	TRBV6-6	TRBJ1-4
TGTGCCAACCGGGAGGGCAGACGGGCCTACGAGCAGTACTTC	CANREGRRAYEQYF	TRBV6-4	TRBJ2-7
TGTGCCAGCAGCCAGACTCACCACGAGCAGTACTTC	CASSQTHHEQYF	TRBV9	TRBJ2-7
TGCGCCAGCAGCCGGGACAGAAACACTGAAGCTTTCTTT	CASSRDRNTEAFF	TRBV5-1	TRBJ1-1
TGTGCCTGGAGGATTTTGGGACAGGAAAGAGAGACCCAGTACTTC	CAWRILGQERETQYF	TRBV30	TRBJ2-5
TGTGCCAGCATGCACGACAGCCCGAACACTGAAGCTTTCTTT	CASMHDSPNTEAFF	TRBV12-4	TRBJ1-1
TGCGCCAGCAGCGCCGGGACAGGGGGATTTCAGCCCCAGCATTTT	CASSAGTGGFQPQHF	TRBV5-1	TRBJ1-5
TGTGCCAGCAATGGATGGGGCTATGGCTACACCTTC	CASNGWGYGYTF	TRBV9	TRBJ1-2
TGTGCCAGTAGGGGCTCTAGCGATCGTGAGCAGTTCTTC	CASRGSSDREQFF	TRBV19	TRBJ2-1
TGTGCCACCAGTGATTTGACTAGCGGGGGGGACACCGGGGAGCTGTTTTTT	CATSDLTSGGDTGELFF	TRBV24-1	TRBJ2-2
TGTGCCAGCAGCTTAGGGGGCTGGGTGGGAGAGACCCAGTACTTC	CASSLGGWVGETQYF	TRBV7-6	TRBJ2-5
TGCGCCAGCAGTGACGCAAAGAGCCTTTACGAGCAGTACTTC	CASSDAKSLYEQYF	TRBV10-1	TRBJ2-7
TGCAGCGTTGCAAACCAGGGGGCGCATTTTTGTAACTATGGCTACACCTTC	CSVANQGAHFCNYGYTF	TRBV29-1	TRBJ1-2
TGTGCCAGCAGTGCTACCATAGGGACTAGGGAAAACATTCAGTACTTC	CASSATIGTRENIQYF	TRBV28	TRBJ2-4
TGTGCCAGCAGGGAAAGGGGGCCAAGTAAGAGGAGTAATGAAAAACTGTTTTTT	CASRERGPSKRSNEKLFF	TRBV6-5	TRBJ1-4
TGTGCCAGCAGCGGGGTCCGGGACAGGGGGTCTTTGGGGAGAGAGACCCAGTACTTC	CASSGVRDRGSLGRETQYF	TRBV11-1	TRBJ2-5
TGTGCCAGCAGCTTGGACAGGGAGTACGAGCAGTACTTC	CASSLDREYEQYF	TRBV5-6	TRBJ2-7
TGTGCCAGCAGCGGGGGCTATGGCTACACCTTC	CASSGGYGYTF	TRBV13	TRBJ1-2
TGTGCCAGCAGCAGACAGGGGATGGAGCAGTACTTC	CASSRQGMEQYF	TRBV6-1	TRBJ2-7
TGTGCCAGCCCTACTCCGGGAACCTACGAGCAGTACTTC	CASPTPGTYEQYF	TRBV5-6	TRBJ2-7
TGTGCCAGCAGCTTAGATACTCACCTCAAGGTAGGAGAGCAGTACTTC	CASSLDTHLKVGEQYF	TRBV11-3	TRBJ2-7
TGCAGCGTCGGGCGGCATATTACGAACACTGAAGCTTTCTTT	CSVGRHITNTEAFF	TRBV29-1	TRBJ1-1
TGCAGTGCTAGAGATAAGGGGGATGAGCAGTTCTTC	CSARDKGDEQFF	TRBV20-1	TRBJ2-1
TGTGCCAGCCCTGGGTCTAAACAGGGGGAGCTGTTTTTT	CASPGSKQGELFF	TRBV28	TRBJ2-2
TGTGCCAGCAGCTCGACGGCTAGCGGGGGCACGCTACGCGATGAGCAGTTCTTC	CASSSTASGGTLRDEQFF	TRBV13	TRBJ2-1
TGTGCCAGCAGTGCCTTAGATTCGCAGTTCTGGACAGATACGCAGTATTTT	CASSALDSQFWTDTQYF	TRBV6-1	TRBJ2-3
TGTGCCAGCAGTGAACTCACGAGGGGGCAGAAAAACTATGGCTACACCTTC	CASSELTRGQKNYGYTF	TRBV25-1	TRBJ1-2
TGTGCCAGCAGCTCCCGACTAGCGGGAGCTAGGGGGGTAGCCAAAAACATTCAGTACTTC	CASSSRLAGARGVAKNIQYF	TRBV7-2	TRBJ2-4
TGTGCCACCAGTGATTTTCGGGGGTGTGAGCAGTTCTTC	CATSDFRGCEQFF	TRBV24-1	TRBJ2-1
TGCAGCGGGGGGGAATATAGCAATCAGCCCCAGCATTTT	CSGGEYSNQPQHF	TRBV29-1	TRBJ1-5
TGTGCCAGCAACTGGGGTGAGACCCAGTACTTC	CASNWGETQYF	TRBV28	TRBJ2-5
TGTGCCAGCAGTGGTTCCTTAACAGGGGGCACCCGATTTCAGCCCCAGCATTTT	CASSGSLTGGTRFQPQHF	TRBV25-1	TRBJ1-5
TGTGCCAGCGAGGGGGAGATTTCACCCCTCCACTTT	CASEGEISPLHF	TRBV6-2	TRBJ1-6
TGCGCCAGCGTAGGGGAGCAGTTCTTC	CASVGEQFF	TRBV10-1	TRBJ2-1
TGCAGTGCTAGAGGTGGGAATTTCGATAGCAATCAGCCCCAGCATTTT	CSARGGNFDSNQPQHF	TRBV20-1	TRBJ1-5
TGTGCCAGCAGCTTATCATCAAATCGAAGTAGGGCAGCCAATGAGCAGTTCTTC	CASSLSSNRSRAANEQFF	TRBV7-4	TRBJ2-1
TGTGCCACCAGTGACTCCCAGAACTATGGCTACACCTTC	CATSDSQNYGYTF	TRBV24-1	TRBJ1-2
TGTGCCTGGTGCGGGAGGGCGGAGACCCAGTACTTC	CAWCGRAETQYF	TRBV30	TRBJ2-5
TGCGCCAGCAGCCAGACAGGGGGGGTCGGTCTGACCGGGGAGCTGTTTTTT	CASSQTGGVGLTGELFF	TRBV4-1	TRBJ2-2
TGTGCCAGCCGGAGGACAAGGCCGGGCTCTGGAAACACCATATATTTT	CASRRTRPGSGNTIYF	TRBV6-8	TRBJ1-3
TGTGCCAGCACGGGGTTCGAGCAGTACTTC	CASTGFEQYF	TRBV6-1	TRBJ2-7
TGTGCCAGCGGACCACTAGTTTTGTCGGACTCCTACAATGAGCAGTTCTTC	CASGPLVLSDSYNEQFF	TRBV6-1	TRBJ2-1
TGCGCCAGCACTCAAGACGATAAACAAGAGACCCAGTACTTC	CASTQDDKQETQYF	TRBV5-1	TRBJ2-5
TGTGCCAGCAGGGAGAATTCACCCCTCCACTTT	CASRENSPLHF	TRBV6-1	TRBJ1-6
TGTGCCAGCAGCTTAAACCGGGACAGGGGAGACTACGAGCAGTACTTC	CASSLNRDRGDYEQYF	TRBV7-6	TRBJ2-7
TGCAGCGCTTCCCTAGGGACAACACCGGAGACCCAGTACTTC	CSASLGTTPETQYF	TRBV29-1	TRBJ2-5
TGCGCCAGCAGCCAAGGACTAAGGATTATTCGCAACGGTGCCAGTAACTATGGCTACACCTTC	CASSQGLRIIRNGASNYGYTF	TRBV5-1	TRBJ1-2
TGTGCCAGCAGCTTAGCGATGGAGACTAGCGGGAGGGATGAGCAGTTCTTC	CASSLAMETSGRDEQFF	TRBV7-9	TRBJ2-1
TGTGCCAGTAGTTCTCGACAGGGTGGGGCCACTGGAAACACCATATATTTT	CASSSRQGGATGNTIYF	TRBV19	TRBJ1-3
TGTGCCAGCAGTTTCCTGCGGACTAGCGGGAGGGCAAGAAAGGGGGAGCTGTTTTTT	CASSFLRTSGRARKGELFF	TRBV27	TRBJ2-2
TGTGCCAGCTCACCACGACAGGGAAAGAGGGCCAAAAACATTCAGTACTTC	CASSPRQGKRAKNIQYF	TRBV18	TRBJ2-4
TGTGCCAGCAGTTTAGCCCGGTACTGGACAGGTAAGTGGGAGCTGTTTTTT	CASSLARYWTGKWELFF	TRBV12-3	TRBJ2-2
TGTGCCAGTAGGGGTGGGGCGGTAGGCCATTACACAGATACGCAGTATTTT	CASRGGAVGHYTDTQYF	TRBV19	TRBJ2-3
TGCGCCAGCAGCCAAGATGGCACAACCTCAGAACGGGGGCATGAAAAACTGTTTTTT	CASSQDGTTSERGHEKLFF	TRBV4-3	TRBJ1-4
TGTGCCTGGAGGAAGGCCACGTGGGGAGGGGATGAGCAGTACTTC	CAWRKATWGGDEQYF	TRBV30	TRBJ2-7
TGCAGTGCTAGGGCCCGGGGGGGAGGGCAGTTCTTC	CSARARGGGQFF	TRBV20-1	TRBJ2-1
TGTGCCAGCAGAAGGCGGGAGCGGGAGCAGTACTTC	CASRRREREQYF	TRBV6-4	TRBJ2-7
TGCGCCAGCAGTACCGCAGGACAGGGGGCAAGTGAAGAGACCCAGTACTTC	CASSTAGQGASEETQYF	TRBV10-1	TRBJ2-5
TGTGCCAGCAGCCAAGAGCAGTCTAGGCGGTCTTACGAGCAGTACTTC	CASSQEQSRRSYEQYF	TRBV14	TRBJ2-7
TGTGCCAGCAGCCACAGTAGCGAGGTGGGAACCGGGGAGCTGTTTTTT	CASSHSSEVGTGELFF	TRBV13	TRBJ2-2
TGTGCCAGCAGCTTGGGGGGGGGAACCCAGTACTTC	CASSLGGGTQYF	TRBV13	TRBJ2-5
TGTGCCACCAGCAGAGATAACGGGACTAAGGGAGGGGATTATGAGCAGTTCTTC	CATSRDNGTKGGDYEQFF	TRBV15	TRBJ2-1
TGTGCCAGCAGCCAACTAAGCACAGATACGCAGTATTTT	CASSQLSTDTQYF	TRBV14	TRBJ2-3
TGTGCCAGCAGCGTAGAAAAGGGCCAGCTTAAAGATACGCAGTATTTT	CASSVEKGQLKDTQYF	TRBV9	TRBJ2-3
TGTGCTAGTGATATGATCACCCTGGACCCGTACAATGAGCAGTTCTTC	CASDMITLDPYNEQFF	TRBV12-5	TRBJ2-1
TGTGCCAGCGAGGGGGGGCCTAACTATGGCTACACCTTC	CASEGGPNYGYTF	TRBV7-3	TRBJ1-2
TGCAGTGCAGACAACTTGGGGGGGCAGTATAGCAATCAGCCCCAGCATTTT	CSADNLGGQYSNQPQHF	TRBV20-1	TRBJ1-5
TGTGCCAGCAGCTACTACGAGCAGTACTTC	CASSYYEQYF	TRBV7-9	TRBJ2-7
TGTGCCTCACCGGATGGGACAATGGGATGGGGTCGCGAGCAGTACTTC	CASPDGTMGWGREQYF	TRBV6-6	TRBJ2-7
TGTGCCAGCAGAAGAGGGGTTATGGGTGGCTATGGCTACACCTTC	CASRRGVMGGYGYTF	TRBV6-5	TRBJ1-2
TGTGCCAGCAGGATGTACGAGCAGTACTTC	CASRMYEQYF	TRBV6-4	TRBJ2-7
TGTGCCAGCAACTTCCACGGACAGGGGAGACCTAATGAAAAACTGTTTTTT	CASNFHGQGRPNEKLFF	TRBV6-6	TRBJ1-4
TGCAGTGCTAGGGACGGAAGCAATCAGCCCCAGCATTTT	CSARDGSNQPQHF	TRBV20-1	TRBJ1-5
TGCGCCAGCAGCTTGTCCACCAGGTTCCGGGGGGGTTGGAATGAAAAACTGTTTTTT	CASSLSTRFRGGWNEKLFF	TRBV5-1	TRBJ1-4
TGTGCCAGCAGCAGACGACAGGGTTTGTTCATCTACAATGAGCAGTTCTTC	CASSRRQGLFIYNEQFF	TRBV13	TRBJ2-1
TGCAGTGCTAGAGATCTTAGAATTCGACAGGGCGTAAGCTCCTACGAGCAGTACTTC	CSARDLRIRQGVSSYEQYF	TRBV20-1	TRBJ2-7
TGTGCCATGACAGGGATTGATGGCTACACCTTC	CAMTGIDGYTF	TRBV7-9	TRBJ1-2
TGTGCCAGTAGTAACAGAGCAACTTACGAGCAGTACTTC	CASSNRATYEQYF	TRBV19	TRBJ2-7
TGTGCCATCAGTGACCGACGACGACAGGCAAGTTCTGGAAACACCATATATTTT	CAISDRRRQASSGNTIYF	TRBV10-3	TRBJ1-3
TGTGCCACCAGTGATTCCCCTTCTATCCGGGATGAGCAGTTCTTC	CATSDSPSIRDEQFF	TRBV24-1	TRBJ2-1
TGTGCCAGCAGCCCGACAGGGGGAGCTAACTATGGCTACACCTTC	CASSPTGGANYGYTF	TRBV7-4	TRBJ1-2
TGCGCCAGCAGCTACTCCCGTCCGACAGGCGAGACCCAGTACTTC	CASSYSRPTGETQYF	TRBV5-1	TRBJ2-5
TGTGCCAGCATTCAAAACCAGACGGTCTCTGGGGCCAACGTCCTGACTTTC	CASIQNQTVSGANVLTF	TRBV6-5	TRBJ2-6
TGTGCCAGCAGGGATCGGACAGGGAATCGCTGTTACGAGCAGTACTTC	CASRDRTGNRCYEQYF	TRBV7-9	TRBJ2-7
TGTGCCAGCAGCACGCCGGGGACGCATAATCAGCCCCAGCATTTT	CASSTPGTHNQPQHF	TRBV13	TRBJ1-5
TGTGCCAGCAATAACTTTCCGGGTTGGAACACTGAAGCTTTCTTT	CASNNFPGWNTEAFF	TRBV6-3	TRBJ1-1
TGTGCCAGCAGCTTAGAGTTAGCGGGACCAGGCACAGATACGCAGTATTTT	CASSLELAGPGTDTQYF	TRBV11-2	TRBJ2-3
TGCAGTGCGGGGGACAGAGCTCCTAACTATGGCTACACCTTC	CSAGDRAPNYGYTF	TRBV20-1	TRBJ1-2
TGTGCCACCAGTGAAGTAGCTGTATTTGGGGCCAACGTCCTGACTTTC	CATSEVAVFGANVLTF	TRBV24-1	TRBJ2-6
TGTGCCAGCAGTGACTCGATAACAGGGGAAAAACTGTTTTTT	CASSDSITGEKLFF	TRBV6-4	TRBJ1-4
TGCAGTGCCCCATCCCTCAGGTTTTCGGGGGTTCTCAATGGCTACACCTTC	CSAPSLRFSGVLNGYTF	TRBV20-1	TRBJ1-2
TGTGCCAGCAGTTTACAGACAGGCTCGGGCATTGAGCAGTACTTC	CASSLQTGSGIEQYF	TRBV28	TRBJ2-7
TGTGCCAGCAGCTTAGATCTCGGTAGGATTACGGGGGGAACTAATGAAAAACTGTTTTTT	CASSLDLGRITGGTNEKLFF	TRBV11-3	TRBJ1-4
TGTGCCAGCAGTGCGCCCCCCGGCTACGAGCAGTACTTC	CASSAPPGYEQYF	TRBV2	TRBJ2-7
TGTGCCAGCAGCCAACAAAAAAGGGGGATAAAGGACTATGGCTACACCTTC	CASSQQKRGIKDYGYTF	TRBV14	TRBJ1-2
TGTGCCAGCAGCTATCGGGGCTTACAGAGAGATACGCAGTATTTT	CASSYRGLQRDTQYF	TRBV7-9	TRBJ2-3
TGTGCCAGCAGCAGGGGGGGGGACTATGGCTACACCTTC	CASSRGGDYGYTF	TRBV7-9	TRBJ1-2
TGTGCCAGTAGTAAACCTGTGAGCCGTAACTATGGCTACACCTTC	CASSKPVSRNYGYTF	TRBV19	TRBJ1-2
TGTGCCACCACCCCAGGGGGCGAGCGCAGCTCCTATAATTCACCCCTCCACTTT	CATTPGGERSSYNSPLHF	TRBV24-1	TRBJ1-6
TGCGCCAGCAGCCAACTCTATTTACGGCACGGTAGCACAGATACGCAGTATTTT	CASSQLYLRHGSTDTQYF	TRBV4-1	TRBJ2-3
TGCAGTGCCTCTATTACCACATTCTTTAGCTACGAGCAGTACTTC	CSASITTFFSYEQYF	TRBV20-1	TRBJ2-7
TGTGCCAGCAGCGGAGCCGGGACAGGGCCAGAACACTACGAGCAGTACTTC	CASSGAGTGPEHYEQYF	TRBV5-5	TRBJ2-7
TGCGCCAGCAGTGCAAGGACAGGGAGTCCCACCGGGGAGCTGTTTTTT	CASSARTGSPTGELFF	TRBV10-1	TRBJ2-2
TGTGCCAGCAGTAACCGGTCGGGGATAGCAACTAATGAAAAACTGTTTTTT	CASSNRSGIATNEKLFF	TRBV6-8	TRBJ1-4
TGTGCCAGCAGCGCCTTTCTACGTGAGACCCAGTACTTC	CASSAFLRETQYF	TRBV9	TRBJ2-5
TGTGCCAGCAGCGCCAGTCCACCAGGTGTAGAGACCCAGTACTTC	CASSASPPGVETQYF	TRBV7-9	TRBJ2-5
TGTGCCAGCAGCCGCGTTTATGAAGCTTTCTTT	CASSRVYEAFF	TRBV3-1	TRBJ1-1
TGTGCCAGCAGCTTAGCGAATCTAGCGGGACGTTGGGTCCAAGAGACCCAGTACTTC	CASSLANLAGRWVQETQYF	TRBV7-9	TRBJ2-5
TGTGCCACCAGCAGGGGAGGGTGGGAAACCACAGATACGCAGTATTTT	CATSRGGWETTDTQYF	TRBV15	TRBJ2-3
TGTGCCAGCAGCTCGGTGGACCCCAGTCCAAGGGTCCTGCCCCATAACTACGAGCAGTACTTC	CASSSVDPSPRVLPHNYEQYF	TRBV11-2	TRBJ2-7
TGCGCCAGCGGACTAGCGGGGCTTCCCTACGAGCAGTACTTC	CASGLAGLPYEQYF	TRBV5-1	TRBJ2-7
TGTGCCTGGTGTGGGGACCTTTACGAGCAGTACTTC	CAWCGDLYEQYF	TRBV30	TRBJ2-7
TGTGCCAGCAGTGAACAGTCCACCCGGGCTATCAATGAAAAACTGTTTTTT	CASSEQSTRAINEKLFF	TRBV2	TRBJ1-4
TGTGCCAGCAGTGTGGTCTTAGGGGCAAGCCCTAAAGAGACCCAGTACTTC	CASSVVLGASPKETQYF	TRBV6-5	TRBJ2-5
TGTGCCAGCAGCCACTGGGGGTGTGCAACTAATGAAAAACTGTTTTTT	CASSHWGCATNEKLFF	TRBV11-1	TRBJ1-4
TGTGCTAGTGGTGTTGTGTGGGACATTATTGAGTCTGGGGCCAACGTCCTGACTTTC	CASGVVWDIIESGANVLTF	TRBV12-5	TRBJ2-6
TGTGCCAGCAGCGGGCGACAGGGGAGTCCGCAGTCAGATACGCAGTATTTT	CASSGRQGSPQSDTQYF	TRBV7-3	TRBJ2-3
TGTGCCAGCAGCGTAGAGATGGGCGCGGGAGTCCCGGGCACAGATACGCAGTATTTT	CASSVEMGAGVPGTDTQYF	TRBV9	TRBJ2-3
TGTGCCAGCAGCGAAGGAAATAGCAATCAGCCCCAGCATTTT	CASSEGNSNQPQHF	TRBV6-4	TRBJ1-5
TGTGCCAGCAGCTTAGCGCTCCGGGGGGGGGACACAGATACGCAGTATTTT	CASSLALRGGDTDTQYF	TRBV7-4	TRBJ2-3
TGTGCCAGTAGTATTGTAGTTACAGACGAGCAGTACTTC	CASSIVVTDEQYF	TRBV19	TRBJ2-7
TGTGCCTTGCTTACGGGTCGGGGGGTAGGAGGTGAAAAACTGTTTTTT	CALLTGRGVGGEKLFF	TRBV6-5	TRBJ1-4
TGTGCCAGCAGCCAGGCGGATCAGCCCCAGCATTTT	CASSQADQPQHF	TRBV6-2	TRBJ1-5
TGTGCCAGCAGCTTACCCGTACTTGGGACGGAGAATGAGCAGTTCTTC	CASSLPVLGTENEQFF	TRBV7-2	TRBJ2-1
TGCAGTGCTAGAATCGCCGGCTGCCTCAATTCACCCCTCCACTTT	CSARIAGCLNSPLHF	TRBV20-1	TRBJ1-6
TGTGCCAGCAGAGTCTACCGGGGGGACGAGCAGTACTTC	CASRVYRGDEQYF	TRBV14	TRBJ2-7
TGTGCCAGCAGGACCTCCGGGACATACAATGAGCAGTTCTTC	CASRTSGTYNEQFF	TRBV6-2	TRBJ2-1
TGTGCCAGCAGCCAAGTTGTAACCACCCGGGACAGAAACGGGGCCAAAAACATTCAGTACTTC	CASSQVVTTRDRNGAKNIQYF	TRBV4-2	TRBJ2-4
TGTGCCAGCAGCCAAGCAGGGACAGTTGCACAGCCCCAGCATTTT	CASSQAGTVAQPQHF	TRBV3-1	TRBJ1-5
TGTGCCAGCAGAAAGGGTGGATCCTATAATTCACCCCTCCACTTT	CASRKGGSYNSPLHF	TRBV27	TRBJ1-6
TGTGCCAGCAGTGAACGATGGGGACAGAACAAGTCTCAGCCCCAGCATTTT	CASSERWGQNKSQPQHF	TRBV2	TRBJ1-5
TGTGCCAGCAGCGTGGCCGGGGGGGGGGATGGGGACTGGCGGGATACGCAGTATTTT	CASSVAGGGDGDWRDTQYF	TRBV7-2	TRBJ2-3
TGTGCCAGCATATCGAGAGAGGTGGTCCCTGGGGCCAACGTCCTGACTTTC	CASISREVVPGANVLTF	TRBV5-6	TRBJ2-6
TGTGCCACCAGTGATAGTCCCCCCCAACAGCAGGGTAGAATATACGAGCAGTACTTC	CATSDSPPQQQGRIYEQYF	TRBV24-1	TRBJ2-7
TGTGCCAGCAGCTTAAACCCAAGACAGGGGGTATCCGAGACCCAGTACTTC	CASSLNPRQGVSETQYF	TRBV11-3	TRBJ2-5
TGTGCCAGTAGCCTAGCAGGGACCACAGATACGCAGTATTTT	CASSLAGTTDTQYF	TRBV19	TRBJ2-3
TGTGCCAGCAGTGAAGACAGGGGATACTATGGCTACACCTTC	CASSEDRGYYGYTF	TRBV25-1	TRBJ1-2
TGTGCCAGCAGCGATGGGGGGTCCCAAGTGGACGAGCAGTACTTC	CASSDGGSQVDEQYF	TRBV6-5	TRBJ2-7
TGTGCCAGCATGACCCCCGGGACAGGGGGGGAGCCCCAGCATTTT	CASMTPGTGGEPQHF	TRBV28	TRBJ1-5
TGTGCCAGCAGTTGGGTCCGGGACACTATTAGCACAGATACGCAGTATTTT	CASSWVRDTISTDTQYF	TRBV28	TRBJ2-3
TGTGCCAGTACTTCGGGGGGCCAAATTGAGACCCAGTACTTC	CASTSGGQIETQYF	TRBV19	TRBJ2-5
TGTGCCAGCTCACCCTCGGGAGGGCAGGCACACTACAATGAGCAGTTCTTC	CASSPSGGQAHYNEQFF	TRBV18	TRBJ2-1
TGTGCCAGCAGTAGGACCGGGGAGCTGTTTTTT	CASSRTGELFF	TRBV6-6	TRBJ2-2
TGCAGTGCTAGGAACAAGACTCCCTACGAGCAGTACTTC	CSARNKTPYEQYF	TRBV20-1	TRBJ2-7
TGTGCTAGTGGACAGGATAGGAACACTGAAGCTTTCTTT	CASGQDRNTEAFF	TRBV12-5	TRBJ1-1
TGTGCCAGCAGCCCGGGACATTTTTTTTCGATAGATACGCAGTATTTT	CASSPGHFFSIDTQYF	TRBV7-3	TRBJ2-3
TGTGCCAGCAGTGAGGCGGGACTTGGAAATCCCCTCAATCAGCCCCAGCATTTT	CASSEAGLGNPLNQPQHF	TRBV2	TRBJ1-5
TGTGCCAGCAGCGAAGGGGGGATGGGTGATACGCAGTATTTT	CASSEGGMGDTQYF	TRBV5-6	TRBJ2-3
TGTGCCAGCAGCTGGGACGGTCAGCCCCAGCATTTT	CASSWDGQPQHF	TRBV14	TRBJ1-5
TGTGCCAGCAGCTATGGGAGGGGTTTTACCGGGGAGCTGTTTTTT	CASSYGRGFTGELFF	TRBV7-8	TRBJ2-2
TGTGCCAGCGGGCAGCGGGTACAGCCCCAGCATTTT	CASGQRVQPQHF	TRBV14	TRBJ1-5
TGTGCCAGCAGAAGGGCTAATGAAAAACTGTTTTTT	CASRRANEKLFF	TRBV12-4	TRBJ1-4
TGTGCCATCAGCGACAGGGTCCCCGAGCAGTACTTC	CAISDRVPEQYF	TRBV10-3	TRBJ2-7
TGCGCCAGCAGGGACTTCTTCGGCAGATCTGAAGCTTTCTTT	CASRDFFGRSEAFF	TRBV5-1	TRBJ1-1
TGTGCCACCCAAGAAAGGCCTGAAGCTTTCTTT	CATQERPEAFF	TRBV15	TRBJ1-1
TGTGCCAGCAACAGACAGGAGGGTCAGCCCCAGCATTTT	CASNRQEGQPQHF	TRBV6-8	TRBJ1-5
TGTGCCAGCAGATTAACGGGGGGGGGGAATGAGCAGTTCTTC	CASRLTGGGNEQFF	TRBV6-4	TRBJ2-1
TGTGCCAGCAGTGAGGCCCGGGCTTGGACAGAGGACGAGCAGTACTTC	CASSEARAWTEDEQYF	TRBV6-4	TRBJ2-7
TGTGCCAGCAGCCAAGGGCCGGATAGCGGGACCGGGGAGCTGTTTTTT	CASSQGPDSGTGELFF	TRBV3-1	TRBJ2-2
TGTGCCAGCAGTCTCAGGTCATATAATTCACCCCTCCACTTT	CASSLRSYNSPLHF	TRBV27	TRBJ1-6
TGTGCCAGCAGTTATCCAGGGGATTTTCAGCCCCAGCATTTT	CASSYPGDFQPQHF	TRBV6-2	TRBJ1-5
TGTGCCAGCAGCACAGTGGGAGTGCAGCAGTTCTTC	CASSTVGVQQFF	TRBV13	TRBJ2-1
TGTGCCAGCAGCTTGGGGGGGGCCTGCAAAGATACGCAGTATTTT	CASSLGGACKDTQYF	TRBV5-6	TRBJ2-3
TGCGCCAGCAGCCGTACGACGGGAGCGGGGGGGCCCCAGCATTTT	CASSRTTGAGGPQHF	TRBV4-3	TRBJ1-5
TGCAGTGACAACGGACAGGTCCAGCAGTACTTC	CSDNGQVQQYF	TRBV20-1	TRBJ2-7
TGTGCCAGCAGCTTGGTCGAGCAGGGACTAGCGAGAAGCTCCTACAATGAGCAGTTCTTC	CASSLVEQGLARSSYNEQFF	TRBV5-6	TRBJ2-1
TGTGCCAGCAGTTCGAGGGGGGGGCCCCAGCATTTT	CASSSRGGPQHF	TRBV6-2	TRBJ1-5
TGCAGTGCAGCCCGGCAGGATAGGAGGGGCTACGAGCAGTACTTC	CSAARQDRRGYEQYF	TRBV20-1	TRBJ2-7
TGTGCCATTAAGGGCGTGCAGCCCCAGCATTTT	CAIKGVQPQHF	TRBV24-1	TRBJ1-5
TGCGCCAGCAGACTAGCGGGTGAGCAGTTCTTC	CASRLAGEQFF	TRBV5-1	TRBJ2-1
TGTGCCAGCAGTTTACTACTAGCGGGTGAGACCCAGTACTTC	CASSLLLAGETQYF	TRBV6-5	TRBJ2-5
TGTGCCAGCAGTCTACTAGCGTTTAATTGCAAGAGCTCCTACGAGCAGTACTTC	CASSLLAFNCKSSYEQYF	TRBV27	TRBJ2-7
TGTGCCAGCAGCAATCCTGGGGGCACAAATGAGCAGTTCTTC	CASSNPGGTNEQFF	TRBV7-9	TRBJ2-1
TGTGCCAGCAGCTCCCTGTTTGGGGAGGCCGGGACAGGGGACACCTACGAGCAGTACTTC	CASSSLFGEAGTGDTYEQYF	TRBV11-2	TRBJ2-7
TGCGCCAGCAGCTTTCGCTACGAGCAGTACTTC	CASSFRYEQYF	TRBV5-1	TRBJ2-7
TGTGCCAGCAGTTATCCTCGGGGAGGGTTTTGGAACACTGAAGCTTTCTTT	CASSYPRGGFWNTEAFF	TRBV6-5	TRBJ1-1
TGTGCCAGCAGCCAAGGGAGTCATCCCGGTGAGCAGTTCTTC	CASSQGSHPGEQFF	TRBV7-9	TRBJ2-1
TGTGCCTGGAAATGTCTTAGGGCCCAAGAGACCCAGTACTTC	CAWKCLRAQETQYF	TRBV30	TRBJ2-5
TGTGCCAGCAGCGTAGCGCCTATCGTGGGACTCCTGATTAAACACAATCAGCCCCAGCATTTT	CASSVAPIVGLLIKHNQPQHF	TRBV9	TRBJ1-5
TGTGCCAGCAGTTTATCCCCAGCAAACACCATATATTTT	CASSLSPANTIYF	TRBV27	TRBJ1-3
TGCAGTGCTAGAGAAGTGGGGCACGATGGCTCCTATAATTCACCCCTCCACTTT	CSAREVGHDGSYNSPLHF	TRBV20-1	TRBJ1-6
TGTGCCAGCAAAATGAGGCACTCGTATGGCTACACCTTC	CASKMRHSYGYTF	TRBV6-2	TRBJ1-2
TGTGCCAGCAGCTCATACGAGCAGTACTTC	CASSSYEQYF	TRBV13	TRBJ2-7
TGCGCCAGCATAAGAAAGACACTCGGGGAGCTGTTTTTT	CASIRKTLGELFF	TRBV10-1	TRBJ2-2
TGTGCCACCAGTGGGTCGCTAGCGGGGGCCTACACCGGGGAGCTGTTTTTT	CATSGSLAGAYTGELFF	TRBV24-1	TRBJ2-2
TGTGCCAGTATTGGACGGGGGGCTGAAAAACTGTTTTTT	CASIGRGAEKLFF	TRBV9	TRBJ1-4
TGTGCCAGCTCACAGGGGGACAGACTCACAGATACGCAGTATTTT	CASSQGDRLTDTQYF	TRBV18	TRBJ2-3
TGTGCCTGGAGTGTACCAGGACCAGGGAGCAACGTCCTGACTTTC	CAWSVPGPGSNVLTF	TRBV30	TRBJ2-6
TGTGCCAGCAGCTTAGTTCCGTGGGGGGGCAACCGGTCCGGGGAGCTGTTTTTT	CASSLVPWGGNRSGELFF	TRBV7-2	TRBJ2-2
TGTGCCAGCAGTCAATGGGTACACATGGCTGGAAACACCATATATTTT	CASSQWVHMAGNTIYF	TRBV6-4	TRBJ1-3
TGTGCCAGCAGAGGTCCCCCCCAAGAGACCCAGTACTTC	CASRGPPQETQYF	TRBV6-4	TRBJ2-5
TGTGCCAGCAGCGCGGGTCGAGACAGGGGGCGGGATGAGCAGTTCTTC	CASSAGRDRGRDEQFF	TRBV9	TRBJ2-1
TGTGCCAGCAGTATGGTGGCCGGGACAGGGGGGGCCAAAAACATTCAGTACTTC	CASSMVAGTGGAKNIQYF	TRBV27	TRBJ2-4
TGTGCCAGCAGCCAAGACGAGTGGGTCGGATATAATTCACCCCTCCACTTT	CASSQDEWVGYNSPLHF	TRBV14	TRBJ1-6
TGTGCCAGCAGTTTATCCCTAACCCGAGTGGACTACAATGAGCAGTTCTTC	CASSLSLTRVDYNEQFF	TRBV27	TRBJ2-1
TGCGCCAGCAGCTCTTTCCATGTATATCTTAACTATGGCTACACCTTC	CASSSFHVYLNYGYTF	TRBV5-1	TRBJ1-2
TGTGCCAGCAGCGTGAGGAGCTCCTACGAGCAGTACTTC	CASSVRSSYEQYF	TRBV9	TRBJ2-7
TGCAGTGCTAAACCGGCCCGACAGGGCTCTGGGGCCAACGTCCTGACTTTC	CSAKPARQGSGANVLTF	TRBV20-1	TRBJ2-6
TGTGCCAGCAGTGACTCGGTGAGCTTGAGGGAGGGTAATGAGCAGTTCTTC	CASSDSVSLREGNEQFF	TRBV6-4	TRBJ2-1
TGTGCCAGCAGTCCGGACAGGTGTTACCAACGATACGAGCAGTACTTC	CASSPDRCYQRYEQYF	TRBV12-4	TRBJ2-7
TGTGCCAGACAGGGCTACGAGCAGTACTTC	CARQGYEQYF	TRBV28	TRBJ2-7
TGTGCCAGCAGCTATGAAGCTTTCTTT	CASSYEAFF	TRBV11-2	TRBJ1-1
TGTGCCTGGAGTGTACGGTCCCGACCGCGAACAGGGGGGCCTCTGCGAAAGGGGGGCGGGAATCAGCCCCAGCATTTT	CAWSVRSRPRTGGPLRKGGGNQPQHF	TRBV30	TRBJ1-5
TGTGCCAGCAGCAGCGGCAAGAGGGGTTCTGAAGCTTTCTTT	CASSSGKRGSEAFF	TRBV7-3	TRBJ1-1
TGCAGTGCTCTTACTAGCGGGGGGGCCAATCCTGATACGCAGTATTTT	CSALTSGGANPDTQYF	TRBV20-1	TRBJ2-3
TGTGCCAGCAGTTACCGGGACAGGGGGGCCTACGAGCAGTACTTC	CASSYRDRGAYEQYF	TRBV6-5	TRBJ2-7
TGTGCCAGCAGCTTGACGGGACTAGCGGGGGGGCCTGGGAATGAGCAGTTCTTC	CASSLTGLAGGPGNEQFF	TRBV5-5	TRBJ2-1
TGTGCCAGCAGTTACCATGGACTAGCGGGCGAAGGCAACACCGGGGAGCTGTTTTTT	CASSYHGLAGEGNTGELFF	TRBV6-5	TRBJ2-2
TGTGCCAGCAGACCGGGACTGGGTGCTCCCAGGACAGATACGCAGTATTTT	CASRPGLGAPRTDTQYF	TRBV6-5	TRBJ2-3
TGTGCCAGCCCATTGGACAGGGGTAGACGTACGAACACCGGGGAGCTGTTTTTT	CASPLDRGRRTNTGELFF	TRBV12-3	TRBJ2-2
TGTGCCAGCAGCTTTAATGAACCCTCACCCCTCCACTTT	CASSFNEPSPLHF	TRBV5-6	TRBJ1-6
TGCGCCAGCAGTGAGAAAAACGGGACAGGGGAGACCCAGTACTTC	CASSEKNGTGETQYF	TRBV10-2	TRBJ2-5
TGTGCCAGCAGAGCCACGGGCATTGGGGCAGATACGCAGTATTTT	CASRATGIGADTQYF	TRBV6-5	TRBJ2-3
TGTGCCATCAGTGAGTCACCCACCGGGACAGGGGAGGATACGCAGTATTTT	CAISESPTGTGEDTQYF	TRBV10-3	TRBJ2-3
TGTGCCAGCAGCCTACTAGACCCCTGCAGGGGAAACACCATATATTTT	CASSLLDPCRGNTIYF	TRBV5-4	TRBJ1-3
TGCAGTGCTTACTGCGACTATGGCTACACCTTC	CSAYCDYGYTF	TRBV20-1	TRBJ1-2
TGTGCCAGCTCACCACTCGGGGGACGGAATCACTATGGCTACACCTTC	CASSPLGGRNHYGYTF	TRBV18	TRBJ1-2
TGTGCCAGCAGCTGGGACAGGGACACAGATACGCAGTATTTT	CASSWDRDTDTQYF	TRBV13	TRBJ2-3
TGTGCCAGCAGCGGGCGGGAGGTAGGGAGCTCCTACGAGCAGTACTTC	CASSGREVGSSYEQYF	TRBV13	TRBJ2-7
TGTGCCAGCAGCTCCCCAGGGCTCGAGCAGTACTTC	CASSSPGLEQYF	TRBV7-4	TRBJ2-7
TGTGCCAGCAGTGACTCGAGTACACGCGTCGCTGAAGCTTTCTTT	CASSDSSTRVAEAFF	TRBV6-4	TRBJ1-1
TGTGCCAGCAGTTATGGACAGCCAGGTCAAGAGACCCAGTACTTC	CASSYGQPGQETQYF	TRBV6-2	TRBJ2-5
TGTGCCAGCAGCATGCGGGGGGAAGAGACCCAGTACTTC	CASSMRGEETQYF	TRBV6-2	TRBJ2-5
TGCGCCAGCAGTGCCGCAACAGTTACACCCTACGAGCAGTACTTC	CASSAATVTPYEQYF	TRBV10-1	TRBJ2-7
TGCGCCAGCAGTGAGGTAGGGAACACTGAAGCTTTCTTT	CASSEVGNTEAFF	TRBV10-1	TRBJ1-1
TGTGCCAGCGATTTCACCGACAGGGGGCCCAGGGGAGCCCCTAGCACAGATACGCAGTATTTT	CASDFTDRGPRGAPSTDTQYF	TRBV2	TRBJ2-3
TGTGCCAGCAGCTCCCCCAGGGGGTACTTC	CASSSPRGYF	TRBV9	TRBJ2-7
TGTGCCAGCAGCACCAGTTCGGTCTACGAGCAGTACTTC	CASSTSSVYEQYF	TRBV9	TRBJ2-7
TGCAGTGCTAGTCCCTGGAGGACAGCCTGGGAGAACACTGAAGCTTTCTTT	CSASPWRTAWENTEAFF	TRBV20-1	TRBJ1-1
TGTGCCAGCAGTGACTCTAGACGACCACAGGGGGAAGCCAATCAGCCCCAGCATTTT	CASSDSRRPQGEANQPQHF	TRBV6-4	TRBJ1-5
TGTGCCAGCAGCTGGTTATATAGGCCCCAGCATTTT	CASSWLYRPQHF	TRBV5-6	TRBJ1-5
TGTGCCACCAGTGATCTCAGTCAGGGGCCCGTTGAGCAGTTCTTC	CATSDLSQGPVEQFF	TRBV24-1	TRBJ2-1
TGTGCCAGCAGCGGGAGGGACGAACCCTACGAGCAGTACTTC	CASSGRDEPYEQYF	TRBV7-8	TRBJ2-7
TGTGCCAGCAGCTTGGGGCACTGGGCTAGCCCACTAGAGCAGTACTTC	CASSLGHWASPLEQYF	TRBV5-4	TRBJ2-7
TGTGCCAGCCCCCAGGGTAACTATGGCTACACCTTC	CASPQGNYGYTF	TRBV27	TRBJ1-2
TGCAGTGCTAGCTCCAGCCCTGCTTCAGGCGCCCAGCATTTT	CSASSSPASGAQHF	TRBV20-1	TRBJ1-5
TGCAGTGCTGGGCACAGGGAAGGCTATGGCTACACCTTC	CSAGHREGYGYTF	TRBV20-1	TRBJ1-2
TGTGCCAGCAGCCAGGGGGCCCCCGAGTTCTACGAGCAGTACTTC	CASSQGAPEFYEQYF	TRBV7-3	TRBJ2-7
TGCGCCAGCAAAGCGGGATACGGAGGGAAAGAGACCCAGTACTTC	CASKAGYGGKETQYF	TRBV5-1	TRBJ2-5
TGTGCCAGCAGCTTAGCCAGGGACAGGGAGATATTAGCCAAAAACATTCAGTACTTC	CASSLARDREILAKNIQYF	TRBV7-2	TRBJ2-4
TGCGCCAGCAGCTTGGGACAGGGCTGGCCCTATAGCAATCAGCCCCAGCATTTT	CASSLGQGWPYSNQPQHF	TRBV5-1	TRBJ1-5
TGTGCCAGCAGTGACTCGATATCCCCCATTATTGCGGGAGGTAATGAGCAGTTCTTC	CASSDSISPIIAGGNEQFF	TRBV6-4	TRBJ2-1
TGTGCCAGCAGCTTGGTGACGCGGGGGGGGTACCTCTACGAGCAGTACTTC	CASSLVTRGGYLYEQYF	TRBV5-4	TRBJ2-7
TGCAGTGCCCTAGTCAGGGGACAGCCCCAGCATTTT	CSALVRGQPQHF	TRBV20-1	TRBJ1-5
TGTGCCAGCAGCCAAGAGGGGGGGAACTCCACAGATACGCAGTATTTT	CASSQEGGNSTDTQYF	TRBV3-1	TRBJ2-3
TGTGCCAGCAGTTACTGCAGGGGAAATTCCCTATTAAATTCACCCCTCCACTTT	CASSYCRGNSLLNSPLHF	TRBV6-6	TRBJ1-6
TGTGCCACCACCCCCGCGCGGGAGTATAGCAATCAGCCCCAGCATTTT	CATTPAREYSNQPQHF	TRBV24-1	TRBJ1-5
TGCGCCAGCACCACCAGGGAGGGCGCAGATACGCAGTATTTT	CASTTREGADTQYF	TRBV10-1	TRBJ2-3
TGTGCCAGTAGTTTTCCCGTCCAGGGGGCAACCTACGAGCAGTACTTC	CASSFPVQGATYEQYF	TRBV19	TRBJ2-7
TGTGCCAGCAAGGGAGGCGACAGGGGGGCTAACTATGGCTACACCTTC	CASKGGDRGANYGYTF	TRBV6-4	TRBJ1-2
TGTGCCAGCAGCCAAGCTCCAGGGAAGAACACTGAAGCTTTCTTT	CASSQAPGKNTEAFF	TRBV4-2	TRBJ1-1
TGTGCCAGCTTCCGGGATGCTACGGGGAACACTGAAGCTTTCTTT	CASFRDATGNTEAFF	TRBV7-9	TRBJ1-1
TGTGCCAGCAGTTACTCGAGCGTGGACAAACATGGCTACACCTTC	CASSYSSVDKHGYTF	TRBV6-5	TRBJ1-2
TGTGCTAGTGATAGTCACTGCCCGGCTGACTTGGGCTCTCCAGATACGCAGTATTTT	CASDSHCPADLGSPDTQYF	TRBV12-5	TRBJ2-3
TGTGCCTGGAGTGTATTTTACGGTGGGGGTTGTGCAACTAATGAAAAACTGTTTTTT	CAWSVFYGGGCATNEKLFF	TRBV30	TRBJ1-4
TGCGCCAGCAGTGAGGTCCGCCTAGACGGGACTAGTAATGAGCAGTTCTTC	CASSEVRLDGTSNEQFF	TRBV10-1	TRBJ2-1
TGTGCCAGCAGCCACAGGGTTTACGAGCAGTACTTC	CASSHRVYEQYF	TRBV4-2	TRBJ2-7
TGCAGCGTAGTCGGCCGGGGGTTCACTAATGAAAAACTGTTTTTT	CSVVGRGFTNEKLFF	TRBV29-1	TRBJ1-4
TGTGCCAGCAGCTGGGAGGGTAAGGGGATCACTGAAGCTTTCTTT	CASSWEGKGITEAFF	TRBV7-9	TRBJ1-1
TGTGCCAGCAGCCCGTCTCGTCCTACGGACCTGGGGAACACCGGGGAGCTGTTTTTT	CASSPSRPTDLGNTGELFF	TRBV7-7	TRBJ2-2
TGTGCCAGCAGCGGCGGTGGGGCTCACACTGAAGCTTTCTTT	CASSGGGAHTEAFF	TRBV7-9	TRBJ1-1
TGTGCCAGCAGTGAAAGACTAGAATTACGGAGCACAGATACGCAGTATTTT	CASSERLELRSTDTQYF	TRBV6-4	TRBJ2-3
TGTGCCAGCAGCGCAAGGGGGGGCCCTAAGTTTTATAGCACCGGGGAGCTGTTTTTT	CASSARGGPKFYSTGELFF	TRBV5-6	TRBJ2-2
TGCGCCAGCAGCTTGGAATGGGGCCTGCGAAGCTCCTACGAGCAGTACTTC	CASSLEWGLRSSYEQYF	TRBV5-1	TRBJ2-7
TGTGCCAGCACAGGGGGAGGGACCTCGCCCTACGAGCAGTACTTC	CASTGGGTSPYEQYF	TRBV6-6	TRBJ2-7
TGTGCCAGCAGCCCTGAGGAGAAGCCCAATCAGCCCCAGCATTTT	CASSPEEKPNQPQHF	TRBV9	TRBJ1-5
TGTGCCAGCAGCGAGGTTCAGGTTCGCGAAGCTTTCTTT	CASSEVQVREAFF	TRBV7-9	TRBJ1-1
TGTGCCAGCAGTCCGGGCAAGGAGCAGTACTTC	CASSPGKEQYF	TRBV14	TRBJ2-7
TGTGCCAGCTCACCTCTCCCTCCGGGACGACCCTACGAGCAGTACTTC	CASSPLPPGRPYEQYF	TRBV18	TRBJ2-7
TGTGCCTGGAGGTCCGCGGGAGGCACAGATACGCAGTATTTT	CAWRSAGGTDTQYF	TRBV30	TRBJ2-3
TGTGCCAGCAGTGCCGGGACAGGGAATCAGCCCCAGCATTTT	CASSAGTGNQPQHF	TRBV27	TRBJ1-5
TGTGCCAGCAGTTATGTTTGGGGGCCGAGCAACACTGAAGCTTTCTTT	CASSYVWGPSNTEAFF	TRBV6-5	TRBJ1-1
TGTGCCACGAAGGGGGTCCCGGTTCCGGCTGAAAAACTGTTTTTT	CATKGVPVPAEKLFF	TRBV24-1	TRBJ1-4
TGTGCCACCAGTGATCTTCGACCAGGTTGGTATGAAAAACTGTTTTTT	CATSDLRPGWYEKLFF	TRBV24-1	TRBJ1-4
TGTGCCAGCAGCCAAATTCAGGGGGCGGGTATCTATAATTCACCCCTCCACTTT	CASSQIQGAGIYNSPLHF	TRBV3-1	TRBJ1-6
TGTGCCATCATGACAGCGAGGCAGGGGAATCAGCCCCAGCATTTT	CAIMTARQGNQPQHF	TRBV10-3	TRBJ1-5
TGTGCCAGCAGCGGGGGGGATACTAACAATGAGCAGTTCTTC	CASSGGDTNNEQFF	TRBV5-5	TRBJ2-1
TGTGCCACCAGTGTCCAAGGGGACGGACGGGGATCAACTAATGAAAAACTGTTTTTT	CATSVQGDGRGSTNEKLFF	TRBV24-1	TRBJ1-4
TGTGCCAGCAGAGTGGGCCGAGGGGATAGATCTAATGAAAAACTGTTTTTT	CASRVGRGDRSNEKLFF	TRBV12-3	TRBJ1-4
TGCAGCGGGACTGGGCGGGCTGGGGCCAACGTCCTGACTTTC	CSGTGRAGANVLTF	TRBV29-1	TRBJ2-6
TGTGCCAGCAGTTACTCGCCGGCAGGGGAAAATCAGCCCCAGCATTTT	CASSYSPAGENQPQHF	TRBV6-5	TRBJ1-5
TGTGCCATCCCCCTGAGGCAGCCCCAGCATTTT	CAIPLRQPQHF	TRBV10-3	TRBJ1-5
TGTGCCACCAGAAAGTGGGGGCTACGCCACGATACGCAGTATTTT	CATRKWGLRHDTQYF	TRBV24-1	TRBJ2-3
TGTGCCACCATAACTTTGCCACGGGGCCATTATCAGCCCCAGCATTTT	CATITLPRGHYQPQHF	TRBV24-1	TRBJ1-5
TGCGCCAGCAGCCCGGCTCCCATCTTCGCCGGCGAGCAGTACTTC	CASSPAPIFAGEQYF	TRBV5-1	TRBJ2-7
TGCAGTGCCACCGGACAGTGCCATCAGCCCCAGCATTTT	CSATGQCHQPQHF	TRBV20-1	TRBJ1-5
TGTGCCAGCAGTAAAGGGGCTGAGCAGTTCTTC	CASSKGAEQFF	TRBV27	TRBJ2-1
TGTGCCAGCACCTGTAGCGGGGGGACCGGGGAGCTGTTTTTT	CASTCSGGTGELFF	TRBV6-1	TRBJ2-2
TGTGCCAGCAGGGACAGTTGCAATCAGCCCCAGCATTTT	CASRDSCNQPQHF	TRBV6-4	TRBJ1-5
TGTGCCAGCAGCTACAGGGGGACATTTGAGCCCCAGTACTTC	CASSYRGTFEPQYF	TRBV7-8	TRBJ2-5
TGCGCCAGCTGGCTAGCGGGAAAGACCCAGTACTTC	CASWLAGKTQYF	TRBV10-1	TRBJ2-5
TGTGCCAGCAGCGCCTCCGTCTGGCTACTAGCGGGTAATTACGAGCAGTACTTC	CASSASVWLLAGNYEQYF	TRBV7-3	TRBJ2-7
TGTGCCAGCAGAGACCCGGGACTAGGAGGCTACGAGCAGTACTTC	CASRDPGLGGYEQYF	TRBV27	TRBJ2-7
TGTGCCAGCAGCCCCTCCGCGGGGGCTCCCTACAATGAGCAGTTCTTC	CASSPSAGAPYNEQFF	TRBV3-1	TRBJ2-1
TGTGCCAGCAGCTTTTTTAGCAGGGCACTTTCACCCCTCCACTTT	CASSFFSRALSPLHF	TRBV11-3	TRBJ1-6
TGTGCCAGCAGCCATAGTTCCGGGACAGAGCGGTTGCAGTACTTC	CASSHSSGTERLQYF	TRBV14	TRBJ2-7
TGTGCCAGCAGTTGCAGCGTGGATTCGACTAGCGGGAGATTAGGTCCTAGCACAGATACGCAGTATTTT	CASSCSVDSTSGRLGPSTDTQYF	TRBV6-5	TRBJ2-3
TGTGCCAGCAGTTACGAATTGACAGTGCCCTTGGTGGGTACCACAGATACGCAGTATTTT	CASSYELTVPLVGTTDTQYF	TRBV6-3	TRBJ2-3
TGTGCCAGCAGCGATACTGCACCCGGGGATTCCTACGAGCAGTACTTC	CASSDTAPGDSYEQYF	TRBV13	TRBJ2-7
TGTGCCAGCAGGCCAGTAAAACGAAATGGCTACACCTTC	CASRPVKRNGYTF	TRBV5-4	TRBJ1-2
TGCGCCAGCAGCGTCCCCCCCCCCAACCACTCCATGACAGTCGGGTATGGCTACACCTTC	CASSVPPPNHSMTVGYGYTF	TRBV5-1	TRBJ1-2
TGTGCCAGCAGTTTGTGGTGGGGACTTAAGACCAATCAGCCCCAGCATTTT	CASSLWWGLKTNQPQHF	TRBV28	TRBJ1-5
TGCAGTGCTAGAGATCGGCACTACTATGGCTACACCTTC	CSARDRHYYGYTF	TRBV20-1	TRBJ1-2
TGTGCCAGCAGCCGGGACTCTAGGGAAAAACTGTTTTTT	CASSRDSREKLFF	TRBV7-3	TRBJ1-4
TGTGCCAGCTCACCACTAGATCCTTGTGGCTACACCTTC	CASSPLDPCGYTF	TRBV18	TRBJ1-2
TGTGCCAGCAGCTTACTGGGACTAGCGGGCGGTCCCTACAATGAGCAGTTCTTC	CASSLLGLAGGPYNEQFF	TRBV11-2	TRBJ2-1
TGCAGTGCTAGAGATTGTTTGGGTCTTACTGGAAACACCATATATTTT	CSARDCLGLTGNTIYF	TRBV20-1	TRBJ1-3
TGCAGTGCTGGGACTAGCGGGGGGGCCAATGAGCAGTTCTTC	CSAGTSGGANEQFF	TRBV20-1	TRBJ2-1
TGTGCCAGTAGTGTCCCAAAGGTCCGGACTAGCGGGGGGGGGGTCTTGAACACCGGGGAGCTGTTTTTT	CASSVPKVRTSGGGVLNTGELFF	TRBV19	TRBJ2-2
TGTGCCAGCAGTGACTCCGTAGCTGGGTACGAGCAGTACTTC	CASSDSVAGYEQYF	TRBV6-4	TRBJ2-7
TGTGCCAGCAGCCCTGCGGGAGGAGATACGCAGTATTTT	CASSPAGGDTQYF	TRBV7-3	TRBJ2-3
TGTGCCAGCAGAGCGGGGCCTCGGGGCTATGGCTACACCTTC	CASRAGPRGYGYTF	TRBV27	TRBJ1-2
TGTGCCATCAACCGGGACTTATCATTAACAGATACGCAGTATTTT	CAINRDLSLTDTQYF	TRBV10-3	TRBJ2-3
TGTGCCTGGACTCAGAGTAAAAACATTCAGTACTTC	CAWTQSKNIQYF	TRBV30	TRBJ2-4
TGCAGTGCGGCTCCTAGCTCCTACGAGCAGTACTTC	CSAAPSSYEQYF	TRBV20-1	TRBJ2-7
TGTGCCAGCAGCCTTGAGGGCGTCCAAGAGACCCAGTACTTC	CASSLEGVQETQYF	TRBV25-1	TRBJ2-5
TGTGCCATACGACAGGGGAGCGGGCATGAGACCCAGTACTTC	CAIRQGSGHETQYF	TRBV19	TRBJ2-5
TGTGCCTGGAGTCTGACTAGCGGGAGATACAATGAGCAGTTCTTC	CAWSLTSGRYNEQFF	TRBV30	TRBJ2-1
TGTGCCAGCAGCAAACTCAGAGGGAGGGGGTCCAGTTACAATGAGCAGTTCTTC	CASSKLRGRGSSYNEQFF	TRBV13	TRBJ2-1
TGTGCCAGCAGCCAAGCGCCTGGGGGGTATAGCAATCAGCCCCAGCATTTT	CASSQAPGGYSNQPQHF	TRBV3-1	TRBJ1-5
TGTGCCAGCAGTTACGTTAGGGAACCTAGCACAGATACGCAGTATTTT	CASSYVREPSTDTQYF	TRBV6-5	TRBJ2-3
TGCGCCAGCAGCTTGCTCCAGGGAGACATTCATCAGCCCCAGCATTTT	CASSLLQGDIHQPQHF	TRBV5-1	TRBJ1-5
TGTGCCACGGGGACCCTAGGACAGGCCTTCGGATGGTTCGCCAAAAACATTCAGTACTTC	CATGTLGQAFGWFAKNIQYF	TRBV6-5	TRBJ2-4
TGTGCCACCAGTGAGACAGGGGCGACCTCCTACGAGCAGTACTTC	CATSETGATSYEQYF	TRBV24-1	TRBJ2-7
TGTGCCACCTACAGGACCCGACTAGCGGGCCAGTACGAGCAGTACTTC	CATYRTRLAGQYEQYF	TRBV24-1	TRBJ2-7
TGTGCCAGCAGTTTAAATTCAAGTAATCAGCCCCAGCATTTT	CASSLNSSNQPQHF	TRBV28	TRBJ1-5
TGTGCCAGCAAAGGCAGGGGCACTGAAGCTTTCTTT	CASKGRGTEAFF	TRBV11-2	TRBJ1-1
TGTGCCAGCAGGATCAGGGGGAATACTAATCAGCCCCAGCATTTT	CASRIRGNTNQPQHF	TRBV12-4	TRBJ1-5
TGTGCCAGTACATACAGGGACGAGCAGTACTTC	CASTYRDEQYF	TRBV19	TRBJ2-7
TGCGCCGCCCAACCTCAGGGAGCGATGGAAGGCTACACCTTC	CAAQPQGAMEGYTF	TRBV5-1	TRBJ1-2
TGTGCCAGCAGCTTAAGGGGTGCCAGGCAGCCCCAGCATTTT	CASSLRGARQPQHF	TRBV5-8	TRBJ1-5
TGTGCCAGCAGCTTGAGGGGGCTCAGTGAAGCTTTCTTT	CASSLRGLSEAFF	TRBV7-3	TRBJ1-1
TGTGCCATGCATTGGGGGGAGGGGAACACTGAAGCTTTCTTT	CAMHWGEGNTEAFF	TRBV9	TRBJ1-1
TGTGCCACCAGTGATTTTCCAAAGGCGGAGAACCCAACTAATGAAAAACTGTTTTTT	CATSDFPKAENPTNEKLFF	TRBV24-1	TRBJ1-4
TGTGCCAGCGACCGACTAGCGAACCTCGAGCAGTACTTC	CASDRLANLEQYF	TRBV6-4	TRBJ2-7
TGTGCCAGCAGTGGGGGACTGGTACCCCAGCATTTT	CASSGGLVPQHF	TRBV6-1	TRBJ1-5
TGTGCCAGTAGTAACTTTAGCGGGGCGGGGATTAACACCGGGGAGCTGTTTTTT	CASSNFSGAGINTGELFF	TRBV19	TRBJ2-2
TGTGCCACCAGTGATCAGGGACTAGCGGGGAGCTACAATGAGCAGTTCTTC	CATSDQGLAGSYNEQFF	TRBV24-1	TRBJ2-1
TGTGCCAGCTCACCACCTCGGGAATCGACAGCCCAGTATGGCTACACCTTC	CASSPPRESTAQYGYTF	TRBV18	TRBJ1-2
TGCAGTGCTAGAGATGCGATGGCTAGCACAGATACGCAGTATTTT	CSARDAMASTDTQYF	TRBV20-1	TRBJ2-3
TGTGCCACGAATAGACCGACTTGCGAGAAAATCAGCTACGAGCAGTACTTC	CATNRPTCEKISYEQYF	TRBV6-5	TRBJ2-7
TGTGCCAGCAGCCTCCAGCCTTGGTATGAAAAACTGTTTTTT	CASSLQPWYEKLFF	TRBV7-3	TRBJ1-4
TGTGCCAGCAGCGACCTGCGACAGGGCCCCACTGAAGCTTTCTTT	CASSDLRQGPTEAFF	TRBV11-2	TRBJ1-1
TGTGCCAGCAGCTTGCGGAGATTCTCCTACGAGCAGTACTTC	CASSLRRFSYEQYF	TRBV5-6	TRBJ2-7
TGTGCCAGCAGTGAAGCGAGTCGAGTCGGGTCAGATGAGCAGTACTTC	CASSEASRVGSDEQYF	TRBV6-1	TRBJ2-7
TGTGCCAGCAGCTTCAGGGGGGAGGGAGGAAACACCATATATTTT	CASSFRGEGGNTIYF	TRBV5-6	TRBJ1-3
TGCGCCAGCAGCAAGGTCTGGGCAGCACGTACAAGGAACACTGAAGCTTTCTTT	CASSKVWAARTRNTEAFF	TRBV5-1	TRBJ1-1
TGTGCCTCAGGGGTGGGGCACATTCAGTACTTC	CASGVGHIQYF	TRBV24-1	TRBJ2-4
TGTGCCAGCAGTGCCCTAGGGACAAACACCATATATTTT	CASSALGTNTIYF	TRBV6-2	TRBJ1-3
TGTGCCGGCACAGCTTTTTACGAGCAGTACTTC	CAGTAFYEQYF	TRBV3-1	TRBJ2-7
TGTGCCAGCTGCCCGGGACAGGGTACTGGCTACACCTTC	CASCPGQGTGYTF	TRBV6-4	TRBJ1-2
TGTGCCAGCAGCTTGTCCTCAGGGAGTTGCTCCTACAATGAGCAGTTCTTC	CASSLSSGSCSYNEQFF	TRBV5-5	TRBJ2-1
TGTGCCAAATCCCTCTTCAGGGTGGGGGGGAACACTGAAGCTTTCTTT	CAKSLFRVGGNTEAFF	TRBV7-2	TRBJ1-1
TGTGCCAGCAGCCAAAAGTGCAGGGGGCGTGGGTCTCATAGCAATCAGCCCCAGCATTTT	CASSQKCRGRGSHSNQPQHF	TRBV3-1	TRBJ1-5
TGCGCCAGCAGCCAGTTCCCTCCGGGGGGAACGGCGTCCACCGGGGAGCTGTTTTTT	CASSQFPPGGTASTGELFF	TRBV4-1	TRBJ2-2
TGTGCCAGCAGTTTATCCCCCTATCGGTATCAGCCCCAGCATTTT	CASSLSPYRYQPQHF	TRBV27	TRBJ1-5
TGTGCCCGGGGGCGGGGGTCAACCGGGGAGCTGTTTTTT	CARGRGSTGELFF	TRBV10-3	TRBJ2-2
TGTGCCAGCAGCCAAGGGGCAACCGGGACAGACACTGAAGCTTTCTTT	CASSQGATGTDTEAFF	TRBV14	TRBJ1-1
TGTGCCAGTAGTATGAGACGGGGGCAAGCAGATACGCAGTATTTT	CASSMRRGQADTQYF	TRBV19	TRBJ2-3
TGCGCCAGCAAAAAGGGTACTGAAGCTTTCTTT	CASKKGTEAFF	TRBV10-2	TRBJ1-1
TGCGCCAGCAGTGAGTCTCGGGACGACAGGGGGAATGGCTATGGCTACACCTTC	CASSESRDDRGNGYGYTF	TRBV10-1	TRBJ1-2
TGTGCCAGCACTTGGACGAGCAATCAGCCCCAGCATTTT	CASTWTSNQPQHF	TRBV2	TRBJ1-5
TGTGCCAGCAGGTGTCTTAGCGGGTTACCCGAGCAGTTCTTC	CASRCLSGLPEQFF	TRBV6-4	TRBJ2-1
TGTGCCAGCAGCGATTACTTTGGCCAGACCCAGTACTTC	CASSDYFGQTQYF	TRBV13	TRBJ2-5
TGCAGTTCGGTTCGGGGGTCCGAGCAGTACTTC	CSSVRGSEQYF	TRBV20-1	TRBJ2-7
TGTGCCAGCAGCTTGAGTAGAAGGGGGGATCTCACAGATACGCAGTATTTT	CASSLSRRGDLTDTQYF	TRBV5-6	TRBJ2-3
TGTGCCACCCCTTTGACTGCCTGGGGCCCCGAGCAGTACTTC	CATPLTAWGPEQYF	TRBV24-1	TRBJ2-7
TGTGCCAGCAGCCCCAGGGCAAGCTCCTATAATTCACCCCTCCACTTT	CASSPRASSYNSPLHF	TRBV6-1	TRBJ1-6
TGTGCCAGCAGGGCAACCGGGACAGGGACCTACAATGAGCAGTTCTTC	CASRATGTGTYNEQFF	TRBV6-6	TRBJ2-1
TGTGCCAGCAGCAGTTCGGGGTCCAATGAGCAGTTCTTC	CASSSSGSNEQFF	TRBV7-2	TRBJ2-1
TGTGCCAGCAGCTTAGTCACTCGGGCTTCCCCATCAGATACGCAGTATTTT	CASSLVTRASPSDTQYF	TRBV11-2	TRBJ2-3
TGTGCCAGCACCCCAGGCACAGGTAACTATGGCTACACCTTC	CASTPGTGNYGYTF	TRBV28	TRBJ1-2
TGTGCCAGCAGCAAGGGGACAGTGAGTCAGCCCCAGCATTTT	CASSKGTVSQPQHF	TRBV13	TRBJ1-5
