TGTGCCAGCAGTATCCAGGGGTACAATGAGCAGTTCTTC	CASSIQGYNEQFF	TRBV6-1	TRBJ2-1
TGTGCTAGTGGCCCAAGGCCCGGCTACACCTTC	CASGPRPGYTF	TRBV12-5	TRBJ1-2
TGTGCCAGCAGTTTAGCGGCCACCGGGACAGAGGGAGGTACCGGGGAGCTGTTTTTT	CASSLAATGTEGGTGELFF	TRBV12-3	TRBJ2-2
TGCGCCAGCCCCCCCCTGGGGGTCTCATGTGATACGCAGTATTTT	CASPPLGVSCDTQYF	TRBV10-2	TRBJ2-3
TGTGCCAGCAGTTTCTCTCCACCCACAGGGCGTAATGAAAAACTGTTTTTT	CASSFSPPTGRNEKLFF	TRBV27	TRBJ1-4
TGTGCCAGCAGTTTAGGGAGGCTCGAGCAGTACTTC	CASSLGRLEQYF	TRBV27	TRBJ2-7
TGTGCCAGCAGCAGGGCAGTCTCCAGGACCACTGAAGCTTTCTTT	CASSRAVSRTTEAFF	TRBV7-9	TRBJ1-1
TGTGCCATAAGGGAATCCAATCCGGGGCGCACCTACGAGCAGTACTTC	CAIRESNPGRTYEQYF	TRBV7-6	TRBJ2-7
TGTGCCAGCAGCCTCGGACTAGCGGGGGAGGAGCAGTTCTTC	CASSLGLAGEEQFF	TRBV9	TRBJ2-1
TGTGCCAAGTTTGTCACCGCCGGCGAGACCCAGTACTTC	CAKFVTAGETQYF	TRBV6-5	TRBJ2-5
TGCGCCAGCAGCCAAGATGGCCCCGGGACATTGGGAACCTACGAGCAGTACTTC	CASSQDGPGTLGTYEQYF	TRBV4-1	TRBJ2-7
TGCAGTGCACTTGTTATGCCAAGGGACAGGGGGATGTCCTACGAGCAGTACTTC	CSALVMPRDRGMSYEQYF	TRBV20-1	TRBJ2-7
TGTGCCAGCAGTACTAACAGGAGCGCCTACGAGCAGTACTTC	CASSTNRSAYEQYF	TRBV6-3	TRBJ2-7
TGTGCCACCAGTGATTTGAGGGGGGTTGGCTACACCTTC	CATSDLRGVGYTF	TRBV24-1	TRBJ1-2
TGTGCCAGCAGAGGTGGTTCGGACCGGCCGGAGACCCAGTACTTC	CASRGGSDRPETQYF	TRBV7-9	TRBJ2-5
TGCGCCAGCAGCTTGGGAGCGGAAAACTACGAGCAGTACTTC	CASSLGAENYEQYF	TRBV5-1	TRBJ2-7
TGTGCCAGCAGTGACCCGTCTACAGTGGAGGCCAACGTCCTGACTTTC	CASSDPSTVEANVLTF	TRBV6-4	TRBJ2-6
TGTGCCAGCAGCGTAGAGAGGAGGACAGGGTACAATGAGCAGTTCTTC	CASSVERRTGYNEQFF	TRBV13	TRBJ2-1
TGCAGTGCTAAAGTCTCCGGGACTAGTGAGATCGAGGAGACCCAGTACTTC	CSAKVSGTSEIEETQYF	TRBV20-1	TRBJ2-5
TGCAGTGGCGCTAGGGGCCACAATGAGCAGTTCTTC	CSGARGHNEQFF	TRBV20-1	TRBJ2-1
TGTGCCAGCAGTTTCGCGTCCCGGGACAGGGGGGTTATTTGCAATCAGCCCCAGCATTTT	CASSFASRDRGVICNQPQHF	TRBV6-5	TRBJ1-5
TGTGCCAGCAGCGTAGATACAAGGGGCTACGAGCAGTACTTC	CASSVDTRGYEQYF	TRBV13	TRBJ2-7
TGTGCCAGCAGCTTAACGCCTCCCGGGACAGGGCAATGGAGTAGCAATCAGCCCCAGCATTTT	CASSLTPPGTGQWSSNQPQHF	TRBV7-3	TRBJ1-5
TGTGCCAGCAGATTGGGCGACAATGAGCAGTTCTTC	CASRLGDNEQFF	TRBV5-6	TRBJ2-1
TGTGCCACCTCCCGAAAACTAGCCTACGAGCAGTACTTC	CATSRKLAYEQYF	TRBV24-1	TRBJ2-7
TGCAGTGCTAGGGTGGGTTGGGGAGCGGGAAATGGCTACACCTTC	CSARVGWGAGNGYTF	TRBV20-1	TRBJ1-2
TGTGCCAGCAGCGGTCCGGGACAGGGCTACGAGCAGTACTTC	CASSGPGQGYEQYF	TRBV13	TRBJ2-7
TGTGCCAGCAGCCGACTAGCGGACACAGATACGCAGTATTTT	CASSRLADTDTQYF	TRBV7-2	TRBJ2-3
TGTGCCAGCAGCGGTAGGTACACTGAAGCTTTCTTT	CASSGRYTEAFF	TRBV5-5	TRBJ1-1
TGTGCCAGCAGCGTAGCTTCAGAACCTCCGGGACAGGGAGGCGCCAAAAACATTCAGTACTTC	CASSVASEPPGQGGAKNIQYF	TRBV9	TRBJ2-4
TGTGCCAGCAGCCAAGACGGGACATACACTGAAGCTTTCTTT	CASSQDGTYTEAFF	TRBV3-1	TRBJ1-1
TGTGCCAGCCTGACTAGCGGGTGCTACGAGCAGTACTTC	CASLTSGCYEQYF	TRBV7-9	TRBJ2-7
TGTGCCAGCAGTTCCTGCGGACACTCTTATAGCAATCAGCCCCAGCATTTT	CASSSCGHSYSNQPQHF	TRBV12-4	TRBJ1-5
TGTGCCAGCAGCTCGCCAGGACGTGGCAATCAGCCCCAGCATTTT	CASSSPGRGNQPQHF	TRBV13	TRBJ1-5
TGTGCCAGCAGCCAACTCGGGGGGGGGGAGACCCAGTACTTC	CASSQLGGGETQYF	TRBV9	TRBJ2-5
TGCGCCAGCAGCCTCTATGAAAGGCACACCGGGGAGCTGTTTTTT	CASSLYERHTGELFF	TRBV4-3	TRBJ2-2
TGTGCCAGCAGTTACTGGCAACCCTGTAAGGACAGACCTAATCAGCCCCAGCATTTT	CASSYWQPCKDRPNQPQHF	TRBV6-8	TRBJ1-5
TGCAGCGTTGACCGGCTTAGGGTCTCCTACAATGAGCAGTTCTTC	CSVDRLRVSYNEQFF	TRBV29-1	TRBJ2-1
TGTGCCAGCAGCCCGGAAAGGGACAGTCCCACCGGGGAGCTGTTTTTT	CASSPERDSPTGELFF	TRBV13	TRBJ2-2
TGCAGTGCTAGCCCCCCGGGGGACCCCCCACACTACAATGAGCAGTTCTTC	CSASPPGDPPHYNEQFF	TRBV20-1	TRBJ2-1
TGTGCCAGCGAAGGTACGGGGGGGCTCACTCGTCCCTACGAGCAGTACTTC	CASEGTGGLTRPYEQYF	TRBV9	TRBJ2-7
TGCAGTGCTTTAGAAAGGACCTGGGATGATGAGCAGTTCTTC	CSALERTWDDEQFF	TRBV20-1	TRBJ2-1
TGTGCCAGCAGCTTCTGGACAGGGGGAGAGACCCAGTACTTC	CASSFWTGGETQYF	TRBV5-8	TRBJ2-5
TGTGCCACCAGTCTCCCTACGGGAGGGGGGGATGAGCAGTTCTTC	CATSLPTGGGDEQFF	TRBV24-1	TRBJ2-1
TGTGCCAGCAGCCCCCGGACAGGGCCCTACAATGAGCAGTTCTTC	CASSPRTGPYNEQFF	TRBV9	TRBJ2-1
TGTGCCAGCAGTCGAAAAGACAGGGATTCTCGCAATCAGCCCCAGCATTTT	CASSRKDRDSRNQPQHF	TRBV6-1	TRBJ1-5
TGTGCCAGCAGTGGGGTAGCGGGTGGAACGAACAATGAGCAGTTCTTC	CASSGVAGGTNNEQFF	TRBV6-1	TRBJ2-1
TGCGCCAGCAGTGAGTCGGAGCGGACTGGGGACGAGCAGTACTTC	CASSESERTGDEQYF	TRBV10-1	TRBJ2-7
TGTGCCAGCAGCCAGTCGACCGCTAGCTCTATATACAATGAGCAGTTCTTC	CASSQSTASSIYNEQFF	TRBV14	TRBJ2-1
TGCAGTGCTAGATGGGGGGGGGGGGTCGGGGTGGGAGAGACCCAGTACTTC	CSARWGGGVGVGETQYF	TRBV20-1	TRBJ2-5
TGTGCCTGGAGGTGGGGGGCTGAGACCCAGTACTTC	CAWRWGAETQYF	TRBV30	TRBJ2-5
TGTGCCATAACCGGGAGGGGCGGGGGGGGGAGCAATCAGCCCCAGCATTTT	CAITGRGGGGSNQPQHF	TRBV6-5	TRBJ1-5
TGTGCCAGCAGCGTTTGTCGGACAGCCGGGGAGCTGTTTTTT	CASSVCRTAGELFF	TRBV9	TRBJ2-2
TGCAGTGCTGATGAACCCCAGGGGAGGCGATGCAATGAGCAGTTCTTC	CSADEPQGRRCNEQFF	TRBV20-1	TRBJ2-1
TGTGCCAGCAGGTCCGGGGGCACTGAAGCTTTCTTT	CASRSGGTEAFF	TRBV6-3	TRBJ1-1
TGTGCCAGCAGTCACAGGGGGCCTGAATTTGCTAACTATGGCTACACCTTC	CASSHRGPEFANYGYTF	TRBV7-9	TRBJ1-2
TGTGCCAGCAGCGTTACATTAGCGGGGGAGAATCAGCCCCAGCATTTT	CASSVTLAGENQPQHF	TRBV9	TRBJ1-5
TGTGCCAGCAGTTACCTAAACACTGAAGCTTTCTTT	CASSYLNTEAFF	TRBV27	TRBJ1-1
TGTGCCAGCAGTTTATGGGCGATAGTGAAGAAAAACATTCAGTACTTC	CASSLWAIVKKNIQYF	TRBV28	TRBJ2-4
TGTGCCAGCAGCGCCGGAGGGTCAGGCGCGAACACCGGGGAGCTGTTTTTT	CASSAGGSGANTGELFF	TRBV13	TRBJ2-2
TGTGCCAGCAGCTGTCGTAACCCCGTAGCTGCGGAATCCTACGAGCAGTACTTC	CASSCRNPVAAESYEQYF	TRBV5-6	TRBJ2-7
TGCGCCAGCAGCTTGCGGAGACGGGGAGGGGCACTGGGAAATCAGCCCCAGCATTTT	CASSLRRRGGALGNQPQHF	TRBV5-1	TRBJ1-5
TGTGCCAGCAGTGAATGTACAGGGCCGGGACGGATATATAGCAATCAGCCCCAGCATTTT	CASSECTGPGRIYSNQPQHF	TRBV6-4	TRBJ1-5
TGTGCCAGCAGCTTGGACGACACAGGGGGCCAAAGCAATCAGCCCCAGCATTTT	CASSLDDTGGQSNQPQHF	TRBV11-2	TRBJ1-5
TGTGCCAGCAGTTTAGCTCGGCAGACTCCCATCCATCAGCCCCAGCATTTT	CASSLARQTPIHQPQHF	TRBV12-3	TRBJ1-5
TGTGCCAGTACGTGTCGGGACAGGGGGTATTTT	CASTCRDRGYF	TRBV3-1	TRBJ1-3
TGTGCCACCAGTGAAACCGGGACAGGCACAGATACGCAGTATTTT	CATSETGTGTDTQYF	TRBV24-1	TRBJ2-3
TGCAGTGCTACCGTGGGTGGGGCGAGAAACACCATATATTTT	CSATVGGARNTIYF	TRBV20-1	TRBJ1-3
TGTGCCAGCAGTAATATTCCTAGAAGAACAGAGACCCAGTACTTC	CASSNIPRRTETQYF	TRBV27	TRBJ2-5
TGTGCCAGCGAGACCCGGCTTTGCTCTGGAAACACCATATATTTT	CASETRLCSGNTIYF	TRBV5-5	TRBJ1-3
TGTGCCAGCAGCCAAGAAGGGGGGCCTGGCCAGACCATGTACACTGAAGCTTTCTTT	CASSQEGGPGQTMYTEAFF	TRBV4-2	TRBJ1-1
TGTGCCACCAGTGATTTGCAGCCTTCCTCAGGGTATCACACTGAAGCTTTCTTT	CATSDLQPSSGYHTEAFF	TRBV24-1	TRBJ1-1
TGTGCCAGCAGCCCCCCGGCGGAAACAGGGGGATTGAACACTGAAGCTTTCTTT	CASSPPAETGGLNTEAFF	TRBV27	TRBJ1-1
TGTGCCAGCAGTCGTTCGGGGGTTCCCTACAATGAGCAGTTCTTC	CASSRSGVPYNEQFF	TRBV12-3	TRBJ2-1
TGTGCCAGCAGCCATTCCATTAAAAGCGGGAGCGCCGAGACCCAGTACTTC	CASSHSIKSGSAETQYF	TRBV5-4	TRBJ2-5
TGTGCCACGCACGGTACGCCTGGAAACACCATATATTTT	CATHGTPGNTIYF	TRBV19	TRBJ1-3
TGTGCCAGCAGTTTTGGGGGATGGACAGATACGCAGTATTTT	CASSFGGWTDTQYF	TRBV27	TRBJ2-3
TGTGCCAGCAGACAGCGGGGGTCGGAGAACACCGGGGAGCTGTTTTTT	CASRQRGSENTGELFF	TRBV2	TRBJ2-2
TGTGCCAGCAGTGAATCTCTAGGCAGAGGTGGCTCCTACGAGCAGTACTTC	CASSESLGRGGSYEQYF	TRBV25-1	TRBJ2-7
TGCGCCAGCAGCTTCCGAGGAACTCCCATGAACACTGAAGCTTTCTTT	CASSFRGTPMNTEAFF	TRBV5-1	TRBJ1-1
TGTGCCAGCAGCCCCGCGGGCAGGGTGGCCAATCAGCCCCAGCATTTT	CASSPAGRVANQPQHF	TRBV5-5	TRBJ1-5
TGTGCCAGCAGCTTCCTCACAGGGGACGCAGATACGCAGTATTTT	CASSFLTGDADTQYF	TRBV7-9	TRBJ2-3
TGTGCCAGCAGTCAATGGGGAGCCAGCAATCAGCCCCAGCATTTT	CASSQWGASNQPQHF	TRBV2	TRBJ1-5
TGTGCCAGCTCCGGGAACCCCCGGGCCGAGGGGTCGAACACCGGGGAGCTGTTTTTT	CASSGNPRAEGSNTGELFF	TRBV18	TRBJ2-2
TGTGCCAGCAGTGACCCTACCCCCCCAGACCCTCCGGTTCATGAAAAACTGTTTTTT	CASSDPTPPDPPVHEKLFF	TRBV6-4	TRBJ1-4
TGTGCCAGCAGCATGTGGACTAGCGGGGCGGCGAACACCGGGGAGCTGTTTTTT	CASSMWTSGAANTGELFF	TRBV9	TRBJ2-2
TGTGCCAGCAGCTTGACAGGGACTTTTTGCACAGATACGCAGTATTTT	CASSLTGTFCTDTQYF	TRBV5-6	TRBJ2-3
TGTGCCAGCAGCCAAGGGGATTCGGGTGAGGGAAACACCATATATTTT	CASSQGDSGEGNTIYF	TRBV4-2	TRBJ1-3
TGTGCCAGCAGTGCCCGGGGGCGGGGTAACACTGAAGCTTTCTTT	CASSARGRGNTEAFF	TRBV27	TRBJ1-1
TGTGCCAGCAGCGGGGGCTGTGATGGCTACACCTTC	CASSGGCDGYTF	TRBV7-3	TRBJ1-2
TGTGCCAGCAGCAACGTTCGATCAGGGGGCAGCTCCTACAATGAGCAGTTCTTC	CASSNVRSGGSSYNEQFF	TRBV7-2	TRBJ2-1
TGTGCCAGCAGTTACTCTCTACACGGGGCGTTCCCATCAGATACGCAGTATTTT	CASSYSLHGAFPSDTQYF	TRBV6-5	TRBJ2-3
TGCGCCAGCAGCGCTCCCCCAGGGTATGGCTACACCTTC	CASSAPPGYGYTF	TRBV5-1	TRBJ1-2
TGTGCCATCCGGACAGAGATTAACTATGGCTACACCTTC	CAIRTEINYGYTF	TRBV10-3	TRBJ1-2
TGTGCCATCTCCCGGGGCGAAGGCTACACCTTC	CAISRGEGYTF	TRBV10-3	TRBJ1-2
TGTGCCAGCATGGGCTTGAACACTGAAGCTTTCTTT	CASMGLNTEAFF	TRBV14	TRBJ1-1
TGTGCCAGCTGGAGTTGCTACACCTTC	CASWSCYTF	TRBV5-4	TRBJ1-2
TGTGCCAGCAGCCGGGGTCTGAGGACGAAGGGGGACAATGAGCAGTTCTTC	CASSRGLRTKGDNEQFF	TRBV4-2	TRBJ2-1
TGTGCCAGCAGTGAAGCGGACAGCGCTTACACCGGGGAGCTGTTTTTT	CASSEADSAYTGELFF	TRBV6-1	TRBJ2-2
TGTGCCAGAGGGACAGGGGCGACTAACGAGCAGTACTTC	CARGTGATNEQYF	TRBV9	TRBJ2-7
TGTGCCATACCTCCGTATGGGGGGATTAGCTCTGGGGCCAACGTCCTGACTTTC	CAIPPYGGISSGANVLTF	TRBV6-3	TRBJ2-6
TGTGCCAGCAGAGCGGGGGGGGGGAGCAATGAGCAGTTCTTC	CASRAGGGSNEQFF	TRBV6-1	TRBJ2-1
TGTGCCAGCATAGGGGGGAGTTGTTTTGGCTACACCTTC	CASIGGSCFGYTF	TRBV14	TRBJ1-2
TGCGCCAGCAGTGAACCTCTACCGGGACTCTACGAGCAGTACTTC	CASSEPLPGLYEQYF	TRBV10-2	TRBJ2-7
TGCAGTGCTAGAGCGACAGGGAGTGATAATGAAAAACTGTTTTTT	CSARATGSDNEKLFF	TRBV20-1	TRBJ1-4
TGTGCCATCAGTGATAGCAAGGGCAGCACAGATACGCAGTATTTT	CAISDSKGSTDTQYF	TRBV10-3	TRBJ2-3
TGTGCCAGCAGCTTGCCCACCGGGACAGGTGAGCAGTACTTC	CASSLPTGTGEQYF	TRBV5-6	TRBJ2-7
TGTGCCAGCAGACATATCTCCGGGGCAGGGGGCGTACCGGAGCAGTACTTC	CASRHISGAGGVPEQYF	TRBV6-4	TRBJ2-7
TGTGCCACCGGGGGGAACTCCTACGAGCAGTACTTC	CATGGNSYEQYF	TRBV24-1	TRBJ2-7
TGCAGTGCTCCACTCCGGGACAAATCAAATGGGAATGAAAAACTGTTTTTT	CSAPLRDKSNGNEKLFF	TRBV20-1	TRBJ1-4
TGTGCCAGCAGCACCAGGGCTCTCGCCCAGCATTTT	CASSTRALAQHF	TRBV5-4	TRBJ1-5
TGCAGTGCTAGACCGGGACAGGGGGCGGCCCTGTACACTGAAGCTTTCTTT	CSARPGQGAALYTEAFF	TRBV20-1	TRBJ1-1
TGTGCCAGCAGCCCGGGGACATTTCAGCCCCAGCATTTT	CASSPGTFQPQHF	TRBV7-6	TRBJ1-5
TGTGCCAGCAGTTACCCAGAAGCCAGGAGATGGGAGGGTGCAAGCGAGCAGTACTTC	CASSYPEARRWEGASEQYF	TRBV6-3	TRBJ2-7
TGTGCCAGTAGTTACAAAAACAAGGGTATCTATGGCTACACCTTC	CASSYKNKGIYGYTF	TRBV19	TRBJ1-2
TGTGCCAGCAGTTACCAGGTCGGACTAGGAGCTGGCGAGCAGTACTTC	CASSYQVGLGAGEQYF	TRBV6-6	TRBJ2-7
TGTGCCAGCAGCTTAGGGGGTCGGGACACGGATCCCATGAACACTGAAGCTTTCTTT	CASSLGGRDTDPMNTEAFF	TRBV11-3	TRBJ1-1
TGTGCCAGCAGCTTAGCGAAGGGGATTCTCAATCAGCCCCAGCATTTT	CASSLAKGILNQPQHF	TRBV7-6	TRBJ1-5
TGTGCCAGCACGCTGGAGGGGTACGAGCAGTACTTC	CASTLEGYEQYF	TRBV9	TRBJ2-7
TGTGCCACCAGTGGACAGGGGCCTTCACCCCTCCACTTT	CATSGQGPSPLHF	TRBV24-1	TRBJ1-6
TGTGCCAGCAGCTTAAGACAGGGATTTGAGGAAAAACTGTTTTTT	CASSLRQGFEEKLFF	TRBV5-6	TRBJ1-4
TGTGCCAGCAGCCGGACAGGGGGTCAGCCCCAGCATTTT	CASSRTGGQPQHF	TRBV5-4	TRBJ1-5
TGCGCCAGCAGCTTGACTCCTTTATACGAGCAGTACTTC	CASSLTPLYEQYF	TRBV5-1	TRBJ2-7
TGTGCCAGCAGTTACCAGGTCCCTAACTATGGCTACACCTTC	CASSYQVPNYGYTF	TRBV6-6	TRBJ1-2
TGCAGCGTCACAGACTACGAGCAGTACTTC	CSVTDYEQYF	TRBV29-1	TRBJ2-7
TGCGCCAGCAGGAGCCAGGGGGGCAATCAGCCCCAGCATTTT	CASRSQGGNQPQHF	TRBV4-3	TRBJ1-5
TGTGCCAGCAGCCCTCGTACAGGGTCGGCCTCCTACAATGAGCAGTTCTTC	CASSPRTGSASYNEQFF	TRBV3-1	TRBJ2-1
TGTGCCAGCAGTCCTGAACCTGGGGGCATTTGTCAGCCCCAGCATTTT	CASSPEPGGICQPQHF	TRBV27	TRBJ1-5
TGTGCCAGCAGGAGGAACAGGGCGTTTGAGACCCAGTACTTC	CASRRNRAFETQYF	TRBV28	TRBJ2-5
TGTGCCAGCACCACAGGGGGCGCTCTAGATGGCTACACCTTC	CASTTGGALDGYTF	TRBV12-4	TRBJ1-2
TGTGACCTTCAGGGAACCTATAATTCACCCCTCCACTTT	CDLQGTYNSPLHF	TRBV27	TRBJ1-6
TGTGCCAGCACCCCCCGGACCGGACTAGCACACAATGAGCAGTTCTTC	CASTPRTGLAHNEQFF	TRBV6-3	TRBJ2-1
TGTGCCAGCAGTGGGGAGGGGTCATACGAGCAGTACTTC	CASSGEGSYEQYF	TRBV6-6	TRBJ2-7
TGTGCCAGTAGTCGCACAGGGAGGATGAACACTGAAGCTTTCTTT	CASSRTGRMNTEAFF	TRBV19	TRBJ1-1
TGTGCCAGCAGTGACTCGTTTGGGGCTCTGAACACTGAAGCTTTCTTT	CASSDSFGALNTEAFF	TRBV6-4	TRBJ1-1
TGTGCCAGCAGCCGCGGACAGGCCGAGACCCAGTACTTC	CASSRGQAETQYF	TRBV13	TRBJ2-5
TGTGCCAGCAGCACAGGGCTAGCCTACGAGCAGTACTTC	CASSTGLAYEQYF	TRBV7-7	TRBJ2-7
TGCAGTGCAGGCAGGGGGCGTAGGCCCCAGCATTTT	CSAGRGRRPQHF	TRBV20-1	TRBJ1-5
TGTGCCAGCAGCGTAGGGCCGGGACAGGGGGCAAGGTACGAGCAGTACTTC	CASSVGPGQGARYEQYF	TRBV9	TRBJ2-7
TGTGCCAGCAGTGTTAGGACGACCCAGTACTTC	CASSVRTTQYF	TRBV6-4	TRBJ2-5
TGTGCCAGCAGCAGTCAAACCCCCCCTCCCGGACTAGGAACAGGGGAAGAGACCCAGTACTTC	CASSSQTPPPGLGTGEETQYF	TRBV7-9	TRBJ2-5
TGTGCCAGCAGCTTATGCCGGGACAGGGATAGGACGGAGACCCAGTACTTC	CASSLCRDRDRTETQYF	TRBV7-4	TRBJ2-5
TGTGCCAGCAGTAGGACTGGGGCTAGCACAGATACGCAGTATTTT	CASSRTGASTDTQYF	TRBV6-5	TRBJ2-3
TGTGCCAGCAGTGAGGATCTAGCGGGATTCAATGAGCAGTTCTTC	CASSEDLAGFNEQFF	TRBV2	TRBJ2-1
TGTGCCACTCAGGGAAGATCGGAGACCCAGTACTTC	CATQGRSETQYF	TRBV6-5	TRBJ2-5
TGTGCCAGCAGATTTCCGGGGGGGCCCTGGGACTACAATGAGCAGTTCTTC	CASRFPGGPWDYNEQFF	TRBV12-3	TRBJ2-1
TGTGCCAGCAGCGTAAGGGGGGGAGGGATGAACACTGAAGCTTTCTTT	CASSVRGGGMNTEAFF	TRBV9	TRBJ1-1
TGTGCCAGAACGCAGGGGGCGACCTACGAGCAGTACTTC	CARTQGATYEQYF	TRBV3-1	TRBJ2-7
TGTGCCATCAGTGAGACCGGGACAGGAAACACTGAAGCTTTCTTT	CAISETGTGNTEAFF	TRBV10-3	TRBJ1-1
TGTGCCAGCAGTTACTCGAGTGGGGGATGTAACTACGAGCAGTACTTC	CASSYSSGGCNYEQYF	TRBV6-5	TRBJ2-7
TGTGCCAGCAGTTTACGGGCAGCCTGTACTAATGAAAAACTGTTTTTT	CASSLRAACTNEKLFF	TRBV27	TRBJ1-4
TGTGCCAGCAGCTTTGAGGGGGTCCGCAATCAGCCCCAGCATTTT	CASSFEGVRNQPQHF	TRBV7-9	TRBJ1-5
TGCAGCGTTGGCTTAGCCGCCCCGGCCAAACCCGGGACAGCCGGGAATAGGAACTATGGCTACACCTTC	CSVGLAAPAKPGTAGNRNYGYTF	TRBV29-1	TRBJ1-2
TGTGCCAGCAGACCTCAGGCCTACGAGCAGTACTTC	CASRPQAYEQYF	TRBV7-2	TRBJ2-7
TGTGCCAGCAGTCCAAAGCAGCTCTACGAGCAGTACTTC	CASSPKQLYEQYF	TRBV6-5	TRBJ2-7
TGCGCCAACCTTTGGACTAGCGGGACAAGTGGAGATGAGCAGTTCTTC	CANLWTSGTSGDEQFF	TRBV10-1	TRBJ2-1
TGTGCCAGCAGCGTAGGACAGCCCGTTGATACCCACAATGAGCAGTTCTTC	CASSVGQPVDTHNEQFF	TRBV9	TRBJ2-1
TGTGCCAGCAGCGTAGCCTGGGGGGCCGGTTCCCCCGAGCAGTACTTC	CASSVAWGAGSPEQYF	TRBV9	TRBJ2-7
TGTGCCAGCAACCATTGGGACAGCACCAATGAGCAGTTCTTC	CASNHWDSTNEQFF	TRBV28	TRBJ2-1
TGTGCCAGCAGCGTCAGGGGACTAGCGGGAGGGTACGAGCAGTACTTC	CASSVRGLAGGYEQYF	TRBV5-4	TRBJ2-7
TGCAGTGCTATTTCGGAGGCTAAACAGTGCACAGATACGCAGTATTTT	CSAISEAKQCTDTQYF	TRBV20-1	TRBJ2-3
TGCATAAAAGAGGTCATCGCGCAGTATTTT	CIKEVIAQYF	TRBV20-1	TRBJ2-3
TGCAGCGTCTCACAGAAGCCCGGACCCTACGAGCAGTACTTC	CSVSQKPGPYEQYF	TRBV29-1	TRBJ2-7
TGTGCCAGCTTAGGTCGAGTCCGACTAGCGGGCTACAATGAGCAGTTCTTC	CASLGRVRLAGYNEQFF	TRBV9	TRBJ2-1
TGTGCCAGCAGCCCGCAAGGGGCTCAGGGGAGGATAATACGTGGGGGATTGAACACTGAAGCTTTCTTT	CASSPQGAQGRIIRGGLNTEAFF	TRBV7-2	TRBJ1-1
TGTGCCAGCAGCGGAAGGAGGTCTAAAGGAGACTATGGCTACACCTTC	CASSGRRSKGDYGYTF	TRBV7-9	TRBJ1-2
TGTGCCATCACTCGGAGTTCCTACGAGCAGTACTTC	CAITRSSYEQYF	TRBV10-3	TRBJ2-7
TGCAGTGCTCCAGGACAGGGGGCGGAGCAGTTCTTC	CSAPGQGAEQFF	TRBV20-1	TRBJ2-1
TGTGCCAGTAGTATGAGGGGCTCTGGAAACACCATATATTTT	CASSMRGSGNTIYF	TRBV19	TRBJ1-3
TGTGCCAGCAGGCGGGACAGGGGAATCGAGCAGTACTTC	CASRRDRGIEQYF	TRBV6-4	TRBJ2-7
TGTGCCAGCAATGGGGCTGGATTCGGGAATGAGCAGTTCTTC	CASNGAGFGNEQFF	TRBV6-4	TRBJ2-1
TGTGCCAGCAGCTTGACGACGGGCACCGGGGAGCTGTTTTTT	CASSLTTGTGELFF	TRBV7-9	TRBJ2-2
TGTGCCAGCAGTGACTCTCCCGGGACAGCTGAGCAGTTCTTC	CASSDSPGTAEQFF	TRBV6-4	TRBJ2-1
TGTGCCACCAGTAAGGACTCTGAAGCTTTCTTT	CATSKDSEAFF	TRBV24-1	TRBJ1-1
TGTGCCACCAGCAGACCCGTACGGCGCACAGATACGCAGTATTTT	CATSRPVRRTDTQYF	TRBV15	TRBJ2-3
TGCGCCAGCAGCTTGAAAGGACCGCTTGATCCATTCTCCCAGCGGAACACTGAAGCTTTCTTT	CASSLKGPLDPFSQRNTEAFF	TRBV5-1	TRBJ1-1
TGTGCCAGCAGCTTTCGCGACTGGGATTGGCAGAATGAGCAGTTCTTC	CASSFRDWDWQNEQFF	TRBV5-8	TRBJ2-1
TGTGCCACCCACTCTGGTGACAGCAGTGAAGCTTTCTTT	CATHSGDSSEAFF	TRBV24-1	TRBJ1-1
TGCAGTGCTAGAGCTGCGGACACCGGGGAGCTGTTTTTT	CSARAADTGELFF	TRBV20-1	TRBJ2-2
TGTGCCACCCTTGAGGACAGAGAGAGTAATGAAAAACTGTTTTTT	CATLEDRESNEKLFF	TRBV6-3	TRBJ1-4
TGTGCCAGCATCTCGAACTGGGCCCAGCCCCAGCATTTT	CASISNWAQPQHF	TRBV28	TRBJ1-5
TGTGCCAGCAGTTTTACAGCCGGCCCTATCCAAGAGACCCAGTACTTC	CASSFTAGPIQETQYF	TRBV6-5	TRBJ2-5
TGCAGCGTTACCACTAGGGGCACAGATACGCAGTATTTT	CSVTTRGTDTQYF	TRBV29-1	TRBJ2-3
TGTGCCAGCAAGGAGGGGGGACCTGAGCAGTTCTTC	CASKEGGPEQFF	TRBV6-3	TRBJ2-1
TGCGCCAGCAGTCTCGGGGCAGGGGCCTCTTCTGGAAACACCATATATTTT	CASSLGAGASSGNTIYF	TRBV5-1	TRBJ1-3
TGTGCCAGCGCCTTCGCTTTGGAGATCCTAGCTTTCAAGACCCAGTACTTC	CASAFALEILAFKTQYF	TRBV6-3	TRBJ2-5
TGTGCCAGCAGTTTCCCCTTGCCCCCTAGGGAAGAGACCCAGTACTTC	CASSFPLPPREETQYF	TRBV28	TRBJ2-5
TGTGCCAGCAGTTACTCATCACCAGAACCCGGGGGGCGGAAAGAACAAGAGACCCAGTACTTC	CASSYSSPEPGGRKEQETQYF	TRBV6-6	TRBJ2-5
TGTGCCGACCGGGGCTCGGAAATAAGGTACACCATATATTTT	CADRGSEIRYTIYF	TRBV24-1	TRBJ1-3
TGTGCCAGCAGTTACAATGGGGTTGGTGCTAGCTACGAGCAGTACTTC	CASSYNGVGASYEQYF	TRBV6-5	TRBJ2-7
TGTGCCAGCAGTTTGGTCTCGGACGCCTCTGGAAACACCATATATTTT	CASSLVSDASGNTIYF	TRBV27	TRBJ1-3
TGTGCCAGCAGTGCCGGCTACAGGTGGTACGAGCAGTACTTC	CASSAGYRWYEQYF	TRBV6-4	TRBJ2-7
TGTGCCATCAGTGAGCCCGAGTCACAGGGGGCTGAAGCTTTCTTT	CAISEPESQGAEAFF	TRBV10-3	TRBJ1-1
TGTGCCAGCAGCCAAGCAGGTTCGGGGGGGGAGAGCTACGAGCAGTACTTC	CASSQAGSGGESYEQYF	TRBV14	TRBJ2-7
TGTGCCAGCAGTGAAGTACCCCCGAACACTGAAGCTTTCTTT	CASSEVPPNTEAFF	TRBV2	TRBJ1-1
TGCAGTGCTAGTCCAGGACAGCCGAACGAGCAGTACTTC	CSASPGQPNEQYF	TRBV20-1	TRBJ2-7
TGTGCCAGCAGTGGGACAGGGGCTGAAGCTTTCTTT	CASSGTGAEAFF	TRBV25-1	TRBJ1-1
TGTGCCAGCAGACGGGAAGGGGTCATCCACAATGAGCAGTTCTTC	CASRREGVIHNEQFF	TRBV7-3	TRBJ2-1
TGTGCCAGCAGCTTGAGGGGGGGGGATGTGAAGAGCACAGATACGCAGTATTTT	CASSLRGGDVKSTDTQYF	TRBV5-4	TRBJ2-3
TGTGCCAGCAGTGGTGAGCTAGCGGGTTTGAGCTCCTACGAGCAGTACTTC	CASSGELAGLSSYEQYF	TRBV27	TRBJ2-7
TGTGCCAAAAAACATACCACAGATACGCAGTATTTT	CAKKHTTDTQYF	TRBV12-4	TRBJ2-3
TGTGCCAGCAGCCAAGGACCGGGACAGCACTACGAGCAGTACTTC	CASSQGPGQHYEQYF	TRBV4-2	TRBJ2-7
TGTGCCAGCAGTTTATCCCTTGGACCGCGGTGTCAGCCCCAGCATTTT	CASSLSLGPRCQPQHF	TRBV28	TRBJ1-5
TGTGCCAGCAGGCGGGTTCCGGGACAGGGGCAAGCCTACGAGCAGTACTTC	CASRRVPGQGQAYEQYF	TRBV12-4	TRBJ2-7
TGTGCCAGCAGGGACCCCCGACACCCCGGGGAGCTGTTTTTT	CASRDPRHPGELFF	TRBV6-8	TRBJ2-2
TGTGCCACCAGTTTCCCGGGACACACCTTCTCCTACGAGCAGTACTTC	CATSFPGHTFSYEQYF	TRBV24-1	TRBJ2-7
TGTGCCAGCAGTGACTCTGGTCGAATGACAGGAGGAACCCTAGGTCACAATGAAAAACTGTTTTTT	CASSDSGRMTGGTLGHNEKLFF	TRBV6-4	TRBJ1-4
TGTGCCAGCAGCCAAGTGACCTTTCGGGGAAATGAAAAACTGTTTTTT	CASSQVTFRGNEKLFF	TRBV3-1	TRBJ1-4
TGTGCCAGCAGTCGAGGTGTGGGGGGGCCCGAGGCAGCTTTCTTT	CASSRGVGGPEAAFF	TRBV28	TRBJ1-1
TGTGCCAGCAGCTTAGAGCCCCGGGGCAGAAACATTCAGTACTTC	CASSLEPRGRNIQYF	TRBV11-3	TRBJ2-4
TGTGCCAGCAGTTACTCGAAATGTAAAGGGGGGAACTTCACTGAAGCTTTCTTT	CASSYSKCKGGNFTEAFF	TRBV6-5	TRBJ1-1
TGTGCCAGCAGATCGCTAGCGTTAAAGGACAATGAGCAGTTCTTC	CASRSLALKDNEQFF	TRBV7-3	TRBJ2-1
TGTGCCAGCAGCTTGACAGAAGAGTACTTC	CASSLTEEYF	TRBV7-9	TRBJ2-7
TGCAGCGGGGGGGGCTCTGGAAACACCATATATTTT	CSGGGSGNTIYF	TRBV29-1	TRBJ1-3
TGTGCCAGCTCACCACCACGACCGACTGAAGCTTTCTTT	CASSPPRPTEAFF	TRBV18	TRBJ1-1
TGTGCCAGCAGCTTAGGACAGGGCCCGGCGAGGTATGGCTACACCTTC	CASSLGQGPARYGYTF	TRBV7-9	TRBJ1-2
TGTGCCACCAGCTCCTCTCCGCTGGTCTACGAGCAGTACTTC	CATSSSPLVYEQYF	TRBV15	TRBJ2-7
TGCAGCGTTGAAGAGACTAGGGGAAGAGGGGTTACAGATACGCAGTATTTT	CSVEETRGRGVTDTQYF	TRBV29-1	TRBJ2-3
TGTGCCTGGAGGAAGGGACCCTACAATGAGCAGTTCTTC	CAWRKGPYNEQFF	TRBV30	TRBJ2-1
TGCGCCAGCAGCTTTATCCGGGACAGGGGAACTGGCGAGCAGTACTTC	CASSFIRDRGTGEQYF	TRBV5-1	TRBJ2-7
TGTGCCAGCAGCTCAGGGCAATCACCCCTCCACTTT	CASSSGQSPLHF	TRBV27	TRBJ1-6
TGCAGCGTTGCGTGGTTGACGGACACCGGGGAGCTGTTTTTT	CSVAWLTDTGELFF	TRBV29-1	TRBJ2-2
TGTGCCAGCAGCCCTACGGTAAAAGAGACCCAGTACTTC	CASSPTVKETQYF	TRBV7-9	TRBJ2-5
TGCAGCGAAGGGGGGGGACTCGGGAGCTCCTATAATTCACCCCTCCACTTT	CSEGGGLGSSYNSPLHF	TRBV29-1	TRBJ1-6
TGTGCCAGCAGGCTAGGCTCTAACTATGGCTACACCTTC	CASRLGSNYGYTF	TRBV6-4	TRBJ1-2
TGCAGTGCTTGGGGCGGGTCCTACGAGCAGTACTTC	CSAWGGSYEQYF	TRBV20-1	TRBJ2-7
TGTGCCAGCAGCTACCAGCAAGATTTCTTC	CASSYQQDFF	TRBV13	TRBJ2-1
TGTGCCAGCAGTTATGGGACAGACACCGGGGAGCTGTTTTTT	CASSYGTDTGELFF	TRBV6-5	TRBJ2-2
TGTGCCAGCAGTTTAGGCCGGGACAGGGTAGGGGACCATCAGCCCCAGCATTTT	CASSLGRDRVGDHQPQHF	TRBV27	TRBJ1-5
TGTGCCAGCAGCTTATCCCGCTGTGGGGGGAAGGTGACGGGGAATTCACCCCTCCACTTT	CASSLSRCGGKVTGNSPLHF	TRBV7-2	TRBJ1-6
TGTGCCAGCAGCCAAGCAATAACCACGGGGGGCCGGGACACCGGGGAGCTGTTTTTT	CASSQAITTGGRDTGELFF	TRBV3-1	TRBJ2-2
TGTGCCAGCAGCACCCTCGGGGGTGAAAAACTGTTTTTT	CASSTLGGEKLFF	TRBV7-3	TRBJ1-4
TGTGCCAGCAGTGATCAGCGGGAGATGGGCTACACCTTC	CASSDQREMGYTF	TRBV25-1	TRBJ1-2
TGCGCCAGCAGTGGGCCCCTCAACAGGGTAGGCACAGATACGCAGTATTTT	CASSGPLNRVGTDTQYF	TRBV10-2	TRBJ2-3
TGTGCCAGTATAAAAAATCAGGGACTAGGTCTGGTCTCTGGAAACACCATATATTTT	CASIKNQGLGLVSGNTIYF	TRBV19	TRBJ1-3
TGCAGTGCTACTACCCCCGGGACAGGGACGCAGTATTTT	CSATTPGTGTQYF	TRBV20-1	TRBJ2-3
TGCGCCAGCAGCCTCCCCTGGACGGGGGGGGAGGCCTACGAGCAGTACTTC	CASSLPWTGGEAYEQYF	TRBV4-1	TRBJ2-7
TGTGCCAGCAGAACCTGGGGGGGCGATACGCAGTATTTT	CASRTWGGDTQYF	TRBV13	TRBJ2-3
TGTGCCACCATCCCAAGGGGGTACCAAGTGGCACCCTACGAGCAGTACTTC	CATIPRGYQVAPYEQYF	TRBV24-1	TRBJ2-7
TGTGCCATCCTGAGGAATGAGCAGTTCTTC	CAILRNEQFF	TRBV10-3	TRBJ2-1
TGTGCCAGCAGCTTAGCCGAAATGGGGCGGTGCACAGATACGCAGTATTTT	CASSLAEMGRCTDTQYF	TRBV7-9	TRBJ2-3
TGTGCCAGCAGTTACTCAGATCGGGGAGTCTTC	CASSYSDRGVF	TRBV6-5	TRBJ2-1
TGCGCCAGCAGGCCTCGTGAGAGAAAAACTGAAGCTTTCTTT	CASRPRERKTEAFF	TRBV10-1	TRBJ1-1
TGTGCCAGCAGCGAACTCGGGTTAGCCAAAAACATTCAGTACTTC	CASSELGLAKNIQYF	TRBV13	TRBJ2-4
TGTGCCAGCTCACCGGCTGGTAGAGGGAGAGAGACCCAGTACTTC	CASSPAGRGRETQYF	TRBV18	TRBJ2-5
TGTGCCAGCAGCGGGCGCGGGACTAGCTGCTCTGGGGCCAACGTCCTGACTTTC	CASSGRGTSCSGANVLTF	TRBV11-3	TRBJ2-6
TGTGCCAGTAGTATAGCCGACAGGAAGATTACTGGGGCCAACGTCCTGACTTTC	CASSIADRKITGANVLTF	TRBV19	TRBJ2-6
TGCAGTGCTCTCTCGGGCAATGCAGATACGCAGTATTTT	CSALSGNADTQYF	TRBV20-1	TRBJ2-3
TGTGCCAGCAGCTTCAGGGGGGGGCGAGACTACGAGCAGTACTTC	CASSFRGGRDYEQYF	TRBV28	TRBJ2-7
TGCAGCAAACTACAAGAGACCCAGTACTTC	CSKLQETQYF	TRBV29-1	TRBJ2-5
TGTGCCAGCAGTTACTCGGAGGGCCCTAGCGGGAACACTGAAGCTTTCTTT	CASSYSEGPSGNTEAFF	TRBV6-3	TRBJ1-1
TGTGCCAGCGAGAGCCCGGACAGGACGAACAATCAGCCCCAGCATTTT	CASESPDRTNNQPQHF	TRBV7-9	TRBJ1-5
TGTGCCACCGAGCGGGAAGCTAGACCAACTAATGAAAAACTGTTTTTT	CATEREARPTNEKLFF	TRBV6-3	TRBJ1-4
TGTGCCAGCTTTACAGGGGAGACGGTCCACTATGGCTACACCTTC	CASFTGETVHYGYTF	TRBV18	TRBJ1-2
TGCGCCATTGGGGCGGACATGAACACTGAAGCTTTCTTT	CAIGADMNTEAFF	TRBV5-1	TRBJ1-1
TGTGCCATCAACCAGACAGGGGGGGAGACCCAGTACTTC	CAINQTGGETQYF	TRBV27	TRBJ2-5
TGCAGTGCTCATTCAGAACCGACAGGACAGGTCAATGGCTACACCTTC	CSAHSEPTGQVNGYTF	TRBV20-1	TRBJ1-2
TGTGCCACCATCCCAGAATGTCAGGCAAGCTACGAGCAGTACTTC	CATIPECQASYEQYF	TRBV24-1	TRBJ2-7
TGTGCCAGCAGCCGAACCCAGGGGGACAAGGGTTGCACAGATACGCAGTATTTT	CASSRTQGDKGCTDTQYF	TRBV3-1	TRBJ2-3
TGTGCCAGCAGCCCTACCCCCGGGACAGGGAGGAATGAGCAGTTCTTC	CASSPTPGTGRNEQFF	TRBV14	TRBJ2-1
TGTGCCACCGGACGGTCGGGACAGGGCGAAGCGAACACCGGGGAGCTGTTTTTT	CATGRSGQGEANTGELFF	TRBV24-1	TRBJ2-2
TGTGCCACCCCGCTAGATAGGAACACTGAAGCTTTCTTT	CATPLDRNTEAFF	TRBV24-1	TRBJ1-1
TGTGCCAGCAGTGTCCTAGCGGGCCCAGATACGCAGTATTTT	CASSVLAGPDTQYF	TRBV6-4	TRBJ2-3
TGTGCCAGCAGCCAAGACAGGGATAATGAAAAACTGTTTTTT	CASSQDRDNEKLFF	TRBV14	TRBJ1-4
TGTGCCAGCGCGGAACAGGGGGCCCAGCCCCAGCATTTT	CASAEQGAQPQHF	TRBV11-2	TRBJ1-5
TGTGCCAGCAGCTGGGACAGGGTAAATGAAAAACTGTTTTTT	CASSWDRVNEKLFF	TRBV7-9	TRBJ1-4
TGTGCCAGCAGCCCTTTTGGACAGGGGAATTCACCCCTCCACTTT	CASSPFGQGNSPLHF	TRBV7-3	TRBJ1-6
TGTGCCAGCAGCAGGAGACAGGGGGGAGACGGGGAGCTGTTTTTT	CASSRRQGGDGELFF	TRBV5-5	TRBJ2-2
TGTGCCAGCACGAAAGTACCGCAGAATGAGCAGTTCTTC	CASTKVPQNEQFF	TRBV7-3	TRBJ2-1
TGCATATCAGGGGGTGAGGGCCGGAAGCCCCAGCATTTT	CISGGEGRKPQHF	TRBV20-1	TRBJ1-5
TGTGCCAGCAGGGCAGGAAAGACTGAAGCTTTCTTT	CASRAGKTEAFF	TRBV12-3	TRBJ1-1
TGTGCCAGCGTTGGGACAGCGGAGGTGTCCGGGGAGCTGTTTTTT	CASVGTAEVSGELFF	TRBV25-1	TRBJ2-2
TGTGCCTGGAGTTCGGGGGACCAGTACTTC	CAWSSGDQYF	TRBV30	TRBJ2-7
TGTGCCAGCAGTCCCCCGAGGACTTGGTACAATGAGCAGTTCTTC	CASSPPRTWYNEQFF	TRBV6-2	TRBJ2-1
TGTGCCAGCAGCTTGCAAACTAGCGGGGGGGCCATACCCCCCTGCACAGATACGCAGTATTTT	CASSLQTSGGAIPPCTDTQYF	TRBV5-6	TRBJ2-3
TGCGCCAGCAGTGTTCAGGGGGCGGGAAACACCATATATTTT	CASSVQGAGNTIYF	TRBV4-1	TRBJ1-3
TGTGCCTGGAGATGCCTAGCGGGCAACAGCACAGATACGCAGTATTTT	CAWRCLAGNSTDTQYF	TRBV30	TRBJ2-3
TGTGCCAGCAGCAGGGGCGTCGCTGCGGGAGTGATGCCGATAGATACGCAGTATTTT	CASSRGVAAGVMPIDTQYF	TRBV11-3	TRBJ2-3
TGCAGTGCTATAGGAATTAACACTGAAGCTTTCTTT	CSAIGINTEAFF	TRBV20-1	TRBJ1-1
TGTGCCAGCAGCCCTCGGGGGGCGGGACGCATTCAGTACTTC	CASSPRGAGRIQYF	TRBV7-2	TRBJ2-4
TGTGCCAGCAGCTTAGATCATGGTGGACAGGGCGGGGTGGTTGGGGATGAGCAGTTCTTC	CASSLDHGGQGGVVGDEQFF	TRBV11-2	TRBJ2-1
TGTGCCAGCAGCCAAAAAAACTGCGGGGTTCAGCCCCAGCATTTT	CASSQKNCGVQPQHF	TRBV3-1	TRBJ1-5
TGTGCCAGTAGTATGCAGGCCTCGTGGTCGAGGAACACTGAAGCTTTCTTT	CASSMQASWSRNTEAFF	TRBV19	TRBJ1-1
TGTGCCAGCAGCCACTTCAGGGATGGCTACACCTTC	CASSHFRDGYTF	TRBV14	TRBJ1-2
TGCAGTGCTTCCTTGACCGGGACTAGCGGGATCTGGGGTCTTAGCAATCAGCCCCAGCATTTT	CSASLTGTSGIWGLSNQPQHF	TRBV20-1	TRBJ1-5
TGTGCCAGCAGCATAACTAGCGGGGAGCCAGATACGCAGTATTTT	CASSITSGEPDTQYF	TRBV9	TRBJ2-3
TGTGCCAGCAGGATGGGCGTTGAAACAGATACGCAGTATTTT	CASRMGVETDTQYF	TRBV6-8	TRBJ2-3
TGTGCCAGCAGTTGGGGGACAGGGGAAAAACTGTTTTTT	CASSWGTGEKLFF	TRBV13	TRBJ1-4
TGTGCCAGTAGTATGACGGACCAATTGATCACTGAAGCTTTCTTT	CASSMTDQLITEAFF	TRBV19	TRBJ1-1
TGTGCCAGGATTCGACGGGGATTAAGCAATCAGCCCCAGCATTTT	CARIRRGLSNQPQHF	TRBV5-4	TRBJ1-5
TGTGCCAGCAGCTTCTGGGACCACGGGGCCTACGAGCAGTACTTC	CASSFWDHGAYEQYF	TRBV7-9	TRBJ2-7
TGCAGTGCTAGAAAGCGGGAGCGCCTAGAGACCCAGTACTTC	CSARKRERLETQYF	TRBV20-1	TRBJ2-5
TGTGCCAGCAGCCAAGAGGGTAGGAGGGGGGTGGCTACCTACAATGAGCAGTTCTTC	CASSQEGRRGVATYNEQFF	TRBV3-1	TRBJ2-1
TGTGCCAGCGGGGGCGGGGCTTACTACAATGAGCAGTTCTTC	CASGGGAYYNEQFF	TRBV6-4	TRBJ2-1
TGTGCCACCAGCAGCCCCAAAGATCCCATAGGCTTAAACCCTTCCTACGAGCAGTACTTC	CATSSPKDPIGLNPSYEQYF	TRBV15	TRBJ2-7
TGTGCCAGCAGCGAGCGCCCAGGCACCCTGTTAGTGGGCGAGCAGTACTTC	CASSERPGTLLVGEQYF	TRBV7-4	TRBJ2-7
TGCAGTGCGTCGACAGGGTCACCGTCGGCTGGAAACACCATATATTTT	CSASTGSPSAGNTIYF	TRBV20-1	TRBJ1-3
TGTATAAGGGCCAAAAACATTCAGTACTTC	CIRAKNIQYF	TRBV7-9	TRBJ2-4
TGTGCCAGCAGTTACCTCCGCCGGGACACTAGGAACACTGAAGCTTTCTTT	CASSYLRRDTRNTEAFF	TRBV6-5	TRBJ1-1
TGTGCCACCAGTGATTCTTCGTCCCAGAACTATGGCTACACCTTC	CATSDSSSQNYGYTF	TRBV24-1	TRBJ1-2
TGCGCCAGCAGCCAAGTTCCCCCCAATTGGGACAGGGCCACCCACTCCTACGAGCAGTACTTC	CASSQVPPNWDRATHSYEQYF	TRBV4-1	TRBJ2-7
TGTGCCAGCAGCCCACTAACGGTGGTGGGACTAGCGACCACAGATACGCAGTATTTT	CASSPLTVVGLATTDTQYF	TRBV7-3	TRBJ2-3
TGTGCCAGCAACAGGGGGCGCTGCCAGCCCCAGCATTTT	CASNRGRCQPQHF	TRBV7-2	TRBJ1-5
TGTGCCTGGTCCCCGAACAACCCCGGGACAGCCCCTATTGGCTACACCTTC	CAWSPNNPGTAPIGYTF	TRBV30	TRBJ1-2
TGTGCCAGCAGCCGTATAGGGGTTGAGGGTCAAGAGACCCAGTACTTC	CASSRIGVEGQETQYF	TRBV5-4	TRBJ2-5
TGTGCCCAGAGGGGGACAGGGGGGTACAATGAGCAGTTCTTC	CAQRGTGGYNEQFF	TRBV12-3	TRBJ2-1
TGTGCCAGCAGCAACGGGATAGAGACCCAGTACTTC	CASSNGIETQYF	TRBV11-2	TRBJ2-5
TGTGCCAGCAGGAGGGGGAATAACTACGAGCAGTACTTC	CASRRGNNYEQYF	TRBV12-4	TRBJ2-7
TGTGCCAGCAGTGATATAAGGGACAGGGCCTACGAGCAGTACTTC	CASSDIRDRAYEQYF	TRBV6-6	TRBJ2-7
TGTGCCAGCAGCTTACCTGGACAGGTGGGGAACACTGAAGCTTTCTTT	CASSLPGQVGNTEAFF	TRBV11-3	TRBJ1-1
TGTGCCAGCAGCTGGGGCTTAGGAGGCCAGCCCCAGCATTTT	CASSWGLGGQPQHF	TRBV6-2	TRBJ1-5
TGTGCAGGGGGACAGGGTACCTATGGCTACACCTTC	CAGGQGTYGYTF	TRBV28	TRBJ1-2
TGTGCCAGCAGTTACTTCCCCCGACAGGTTGAAAAACTGTTTTTT	CASSYFPRQVEKLFF	TRBV6-5	TRBJ1-4
TGTGCCACGTCAGAGACCGGGGTAGGAGTGAATTCACCCCTCCACTTT	CATSETGVGVNSPLHF	TRBV6-4	TRBJ1-6
TGTGCCAGCAGGACGGGACTAGCGGGGTGGAAGTACGAGCAGTACTTC	CASRTGLAGWKYEQYF	TRBV27	TRBJ2-7
TGCAGTGCTACCAGGGGGGGGTATGGCTACACCTTC	CSATRGGYGYTF	TRBV20-1	TRBJ1-2
TGTGCCACCAGTGATTTCCTGGACTACGAGCAGTACTTC	CATSDFLDYEQYF	TRBV24-1	TRBJ2-7
TGTGCCAGCATAGGGGGGACTCGCAACACCGGGGAGCTGTTTTTT	CASIGGTRNTGELFF	TRBV6-4	TRBJ2-2
TGTGCCAGCAGCCAATCAGGAAACACTGAAGCTTTCTTT	CASSQSGNTEAFF	TRBV14	TRBJ1-1
TGTGCCAGCAGTGGAATCGGACAGGGGGCCCCTGAAGCTTTCTTT	CASSGIGQGAPEAFF	TRBV25-1	TRBJ1-1
TGTGCCCTTACTGAGATAGGTGAGCAGTTCTTC	CALTEIGEQFF	TRBV2	TRBJ2-1
TGTGCCAGCAGCTTCGACGGGGATCACGAGCAGTACTTC	CASSFDGDHEQYF	TRBV11-2	TRBJ2-7
TGTGGTAGGCCAGGGGGGCGGGCTGAAGCTTTCTTT	CGRPGGRAEAFF	TRBV28	TRBJ1-1
TGTGCCAGCAGCAGTCGGCGACTGGCCGGCTTTTATCAGCCCCAGCATTTT	CASSSRRLAGFYQPQHF	TRBV13	TRBJ1-5
TGTGCCAGCAGCTTATCGTGCACCGATTACCAGCCCCAGCATTTT	CASSLSCTDYQPQHF	TRBV7-3	TRBJ1-5
TGTGCCAGTAGTATGTTTGGGACAGGGCAGCCCCAGCATTTT	CASSMFGTGQPQHF	TRBV19	TRBJ1-5
TGTGCCAGCAGAGGGGGAAGGAGCAATCAGCCCCAGCATTTT	CASRGGRSNQPQHF	TRBV9	TRBJ1-5
TGTGCCAGCATCAAAAATGAAAAACTGTTTTTT	CASIKNEKLFF	TRBV9	TRBJ1-4
TGTGCCAGCAGTGAACGACCTCGGGCAATCGGGGAGCTGTTTTTT	CASSERPRAIGELFF	TRBV6-1	TRBJ2-2
TGTGCCAGCATGACAGGGCTGTCCATGAACACTGAAGCTTTCTTT	CASMTGLSMNTEAFF	TRBV12-3	TRBJ1-1
TGCAGCGGGACAGTATTAAAGTGGGGAGGGAAGCCCCAGCATTTT	CSGTVLKWGGKPQHF	TRBV29-1	TRBJ1-5
TGTGCCAGCAGCACGGCTTTTCCCTACGAGCAGTACTTC	CASSTAFPYEQYF	TRBV13	TRBJ2-7
TGTGCCAGCCGAAAGACATGGCCGGAGCGTATGACCCAGTACTTC	CASRKTWPERMTQYF	TRBV2	TRBJ2-5
TGTGCCAGCAGCTTAGAACACCTGGGACAGGAAAAACTGTTTTTT	CASSLEHLGQEKLFF	TRBV7-7	TRBJ1-4
TGTGCCATTGCGAAGGCTTCCCCGTATTACAATGAGCAGTTCTTC	CAIAKASPYYNEQFF	TRBV12-4	TRBJ2-1
TGTGCCATCTCGCCGGGGACAACTGAAGCTTTCTTT	CAISPGTTEAFF	TRBV28	TRBJ1-1
TGTGCCAGCAGCTTACTATACTCTGGAAACACCATATATTTT	CASSLLYSGNTIYF	TRBV7-9	TRBJ1-3
TGCAGTGCTAGACGACTAGCGGGGCTACACAACAATGAGCAGTTCTTC	CSARRLAGLHNNEQFF	TRBV20-1	TRBJ2-1
TGTGCCAGCAGCCCGACAGGGGGTAATGGCTACACCTTC	CASSPTGGNGYTF	TRBV13	TRBJ1-2
TGTGCCAGCAGTTTTCCCAGGGCTTCTGGAAACACCATATATTTT	CASSFPRASGNTIYF	TRBV28	TRBJ1-3
TGTGCCAGCAGCTACTCTGGACAGGGAAATCAGCCCCAGCATTTT	CASSYSGQGNQPQHF	TRBV5-4	TRBJ1-5
TGCAGCGTTGAAGTGAGACTCCCCGAAGTCTTC	CSVEVRLPEVF	TRBV29-1	TRBJ2-1
TGTGCCAGCAGCCAATTGGTAAATGAGCAGTTCTTC	CASSQLVNEQFF	TRBV9	TRBJ2-1
TGCGCCAGCAGCCACCCAAAAACAGGTAGGTACGAGCAGTACTTC	CASSHPKTGRYEQYF	TRBV4-1	TRBJ2-7
TGTGCCATCCGCGGGACAGGGAAGAAGCCGGTAACTAATGAAAAACTGTTTTTT	CAIRGTGKKPVTNEKLFF	TRBV6-2	TRBJ1-4
TGTGCCAGCAGTTACCCCGGGACAAGCAATCAGCCCCAGCATTTT	CASSYPGTSNQPQHF	TRBV6-5	TRBJ1-5
TGTGCCAGCAGCTTAGGGACAGGAGTAACTGACAGGGGGAACACTGAAGCTTTCTTT	CASSLGTGVTDRGNTEAFF	TRBV7-6	TRBJ1-1
TGTGCCAGCAGTTTAGGCCGGGGGAAGCGTGGTACCTACAATGAGCAGTTCTTC	CASSLGRGKRGTYNEQFF	TRBV27	TRBJ2-1
TGCGCCAGCAGGCATCGGAAGGGCCTAGCGGGAGCCTACGAGCAGTACTTC	CASRHRKGLAGAYEQYF	TRBV5-1	TRBJ2-7
TGCAGTGCTAGCGGTCCAAGGGGATCTGAAAAACTGTTTTTT	CSASGPRGSEKLFF	TRBV20-1	TRBJ1-4
TGCAGTGCTCGGCAACAGCCCCAGCATTTT	CSARQQPQHF	TRBV20-1	TRBJ1-5
TGTGCCAGTAGTGGACAGCGGCAGCCCCAGCATTTT	CASSGQRQPQHF	TRBV19	TRBJ1-5
TGTGCCAGCGCGTCTGGATGCCACGGGAGGACTAATGAAAAACTGTTTTTT	CASASGCHGRTNEKLFF	TRBV27	TRBJ1-4
TGTGCCAGCAGCAAAGGACAGGGGAGCCCTGGAAACACCATATATTTT	CASSKGQGSPGNTIYF	TRBV11-3	TRBJ1-3
TGCAGTGCGGCTAGGGACTCAGATGAGCAGTTCTTC	CSAARDSDEQFF	TRBV20-1	TRBJ2-1
TGCGCCAGCAGCTCGGGGGAGAGGGTAAAACTGTTTTTT	CASSSGERVKLFF	TRBV5-1	TRBJ1-4
TGTGCCAGCAGCGGCAACAAGGCGACAGGGATTTGTCATGAGCAGTTCTTC	CASSGNKATGICHEQFF	TRBV13	TRBJ2-1
TGTGCTAGCAGCGCGACAGACCATAATTCACCCCTCCACTTT	CASSATDHNSPLHF	TRBV7-7	TRBJ1-6
TGTGCTAGCAGCGCTAAGAGGTATAACAGGGAGACGGCCTACAATGAGCAGTTCTTC	CASSAKRYNRETAYNEQFF	TRBV7-7	TRBJ2-1
TGTGCCAGCACTGCTAGCGGGAGAGTGAACAATGAGCAGTTCTTC	CASTASGRVNNEQFF	TRBV14	TRBJ2-1
TGTGCCAGCAGCAGCCGTCCAGACAGGGAGTACTTC	CASSSRPDREYF	TRBV7-3	TRBJ2-5
TGTGCCAGCAGCTTAGCGGGACAGGAGGAGACCCAGTACTTC	CASSLAGQEETQYF	TRBV7-4	TRBJ2-5
TGTGCCAGCAGCTTGGGAGAGGGGAGCTCCTACAATGAGCAGTTCTTC	CASSLGEGSSYNEQFF	TRBV11-3	TRBJ2-1
TGTGCCAGCAGTTTAATCCCGGGTTTGTCTGGGGCCAACGTCCTGACTTTC	CASSLIPGLSGANVLTF	TRBV12-4	TRBJ2-6
TGTGCCAGCAGCCAAATCCAGGGGCCCCCAATCCAAGAGACCCAGTACTTC	CASSQIQGPPIQETQYF	TRBV9	TRBJ2-5
TGTGCCAGCAGCCTTGCGACAGGGGATGAGCAGTTCTTC	CASSLATGDEQFF	TRBV7-4	TRBJ2-1
TGTGCCAGCAGCGGAACGACAGGGGGGCCCTACGAGCAGTACTTC	CASSGTTGGPYEQYF	TRBV9	TRBJ2-7
TGTGCCAGCAGGACGGGACAGGTGAACACCGGGGAGCTGTTTTTT	CASRTGQVNTGELFF	TRBV28	TRBJ2-2
TGTGCCTTATACTTTCTGACAGGGGTGGCTTTCTTT	CALYFLTGVAFF	TRBV27	TRBJ1-1
TGTGCCAGCTCCAAGCGGGGCTTGGAGCAGTACTTC	CASSKRGLEQYF	TRBV18	TRBJ2-7
TGTGCCAGCAGAAAGACTAGCGCCGGAAGGTCCCAAGAGACCCAGTACTTC	CASRKTSAGRSQETQYF	TRBV6-5	TRBJ2-5
TGTGCCAGTAGTATTCAACTATCGACAGGGGGCGGCGTCGAGCAGTACTTC	CASSIQLSTGGGVEQYF	TRBV19	TRBJ2-7
TGTGCCAGCAGCTTACGCACACTTTCATACAACCCAATTGAACTAGCGGGAGCAAACGAGCAGTACTTC	CASSLRTLSYNPIELAGANEQYF	TRBV7-2	TRBJ2-7
TGTGCCAGCAGTGACGGGAGGGGGGTTCGCACCGGGGAGCTGTTTTTT	CASSDGRGVRTGELFF	TRBV6-4	TRBJ2-2
TGTGCCATCAGGCGCCAGGGGGGTTCGGGCTGCGACTATGGCTACACCTTC	CAIRRQGGSGCDYGYTF	TRBV10-3	TRBJ1-2
TGTGCCGGAACCGGGACCAGCTATGGCTACACCTTC	CAGTGTSYGYTF	TRBV19	TRBJ1-2
TGTGCCAGCAGCTCTAGACAGGGGCAAGAGACCCAGTACTTC	CASSSRQGQETQYF	TRBV7-9	TRBJ2-5
TGTGCCACCAGTGAAGGCCACGACAGGGTTCGTCCTTCCTACGAGCAGTACTTC	CATSEGHDRVRPSYEQYF	TRBV24-1	TRBJ2-7
TGTGCCAGCAGCATAGGGGGGGGGGCCGCGAGAGAGACCCAGTACTTC	CASSIGGGAARETQYF	TRBV7-4	TRBJ2-5
TGTGCCAGCAGTTACTCCATAGGACTAGCGGGATTAGCACCCACAGATACGCAGTATTTT	CASSYSIGLAGLAPTDTQYF	TRBV6-5	TRBJ2-3
TGTGCTAGTGGCCCTAATAGCGACAGGGATCGTGAAAAACTGTTTTTT	CASGPNSDRDREKLFF	TRBV12-5	TRBJ1-4
TGCGCCAGCAGCTTGAGCTTTTATGGAACTAATGAAAAACTGTTTTTT	CASSLSFYGTNEKLFF	TRBV5-1	TRBJ1-4
TGTGCCAGCAGCGTAAGGACCAGGTTCGAGCAGTACTTC	CASSVRTRFEQYF	TRBV9	TRBJ2-7
TGTGCCAGCAGCCAAGATACGGGACAGCTCGCCACAGATACGCAGTATTTT	CASSQDTGQLATDTQYF	TRBV14	TRBJ2-3
TGTGCCAGTAGTATTCCCTTTTGGGGGACAGTCCTTGGGGCCTACAATGAGCAGTTCTTC	CASSIPFWGTVLGAYNEQFF	TRBV19	TRBJ2-1
TGTGCCAGCAGTTATCCAGGGGGGGTCACAGATACGCAGTATTTT	CASSYPGGVTDTQYF	TRBV6-3	TRBJ2-3
TGTGCCAGCTCACCGGAAACCGAGCAGTACTTC	CASSPETEQYF	TRBV18	TRBJ2-7
TGCAGTGCTAGCGAAGGGGGGTGGGAGGGCGGGGAGCTGTTTTTT	CSASEGGWEGGELFF	TRBV20-1	TRBJ2-2
TGCAGTGCTAGAGAGCCGCAGTACTTC	CSAREPQYF	TRBV20-1	TRBJ2-7
TGTGCCAGCAACAGTGCCCTAGCCAAAAACATTCAGTACTTC	CASNSALAKNIQYF	TRBV28	TRBJ2-4
TGCAGTGCTAGCCCGGGCCCAATAACAGATACGCAGTATTTT	CSASPGPITDTQYF	TRBV20-1	TRBJ2-3
TGTGCCAGCAGCCTAAGACTGGCCACTGAAGCTTTCTTT	CASSLRLATEAFF	TRBV14	TRBJ1-1
TGTGCCAAGCCGGGGGGGGAGGGGTGCTATGATACGCAGTATTTT	CAKPGGEGCYDTQYF	TRBV10-3	TRBJ2-3
TGCAGTGCTAGAGATTCTGAGCGGTACTATAGGGGCTCTGGAAACACCATATATTTT	CSARDSERYYRGSGNTIYF	TRBV20-1	TRBJ1-3
TGCGCCAGCAGCTTGGTTTCCCGCTGGAGCCTCAGGAGCACAGATACGCAGTATTTT	CASSLVSRWSLRSTDTQYF	TRBV5-1	TRBJ2-3
TGTGCCAGCAGCCCAGGAGCGAGGCCCTACGAGCAGTACTTC	CASSPGARPYEQYF	TRBV12-3	TRBJ2-7
TGCGCCGGGCCCACAGGACACGAGCAGTACTTC	CAGPTGHEQYF	TRBV4-3	TRBJ2-7
TGTGCTAGCAGCTTAAATGGGGCAGTGCGGGGGCAGCCCCAGCATTTT	CASSLNGAVRGQPQHF	TRBV7-7	TRBJ1-5
TGTGCCAGCAGGTCCGAGGCAAATGAGCAGTTCTTC	CASRSEANEQFF	TRBV6-2	TRBJ2-1
TGTGCCAGCAGCTTAGCAAACTGGGGGGGACCCAATGAGCAGTTCTTC	CASSLANWGGPNEQFF	TRBV7-6	TRBJ2-1
TGTGCCAGCAGCTGGGAGAACACCGGGGAGCTGTTTTTT	CASSWENTGELFF	TRBV13	TRBJ2-2
TGTGCCAGGTGTTGGTGGGGACATAATTCACCCCTCCACTTT	CARCWWGHNSPLHF	TRBV9	TRBJ1-6
TGTGCCAGCAGAGAGGGGGGGTGTACTAGCACAGATACGCAGTATTTT	CASREGGCTSTDTQYF	TRBV27	TRBJ2-3
TGTGCCAGCAGTGAGGGGGGTTCGGACGAGCAGTACTTC	CASSEGGSDEQYF	TRBV12-3	TRBJ2-7
TGCGCCAGCAGTGAGGCTGTATTGGGGGGGCCAAGAGTGCAAGAGACCCAGTACTTC	CASSEAVLGGPRVQETQYF	TRBV10-2	TRBJ2-5
TGTGCCAGCAGCTGCGGGAGGGTTTGGGCGGGTGGCTACACCTTC	CASSCGRVWAGGYTF	TRBV6-5	TRBJ1-2
TGTGCCACCACCCAGACAGTTGACTATGGCTACACCTTC	CATTQTVDYGYTF	TRBV24-1	TRBJ1-2
TGTGCCACCAGGGACAGGGGCGAGTCGTCCTACGAGCAGTACTTC	CATRDRGESSYEQYF	TRBV24-1	TRBJ2-7
TGCGCCAGCAGCCAAGCCACCACAGGGGGCCAACTCTACGAGCAGTACTTC	CASSQATTGGQLYEQYF	TRBV4-3	TRBJ2-7
TGTGCCTGGAGCCGCCCAAGCGGACTCGGTGAGCAGTTCTTC	CAWSRPSGLGEQFF	TRBV30	TRBJ2-1
TGCGCCAGCAGCTTGCGGACCTCTGGAAACACCATATATTTT	CASSLRTSGNTIYF	TRBV5-1	TRBJ1-3
TGTGCCAGCAGCCAAGCAAGTGGGACTAGCGGGGGTCACTCCTACAATGAGCAGTTCTTC	CASSQASGTSGGHSYNEQFF	TRBV14	TRBJ2-1
TGTGCCAGCAGCTGGAGGCCCCCTACCCCTGGAAAGCCGGGACAGGGGGGGAGTGGCTACACCTTC	CASSWRPPTPGKPGQGGSGYTF	TRBV5-6	TRBJ1-2
TGTGCCACCAGGGCGGAGGGGACAGGGGATGGCTACACCTTC	CATRAEGTGDGYTF	TRBV24-1	TRBJ1-2
TGTGCCAGCAGCTTAGCTAATTACCCCGATTCTGGAAACACCATATATTTT	CASSLANYPDSGNTIYF	TRBV7-9	TRBJ1-3
TGTGCCAGCAGCTTACGACAGGGAAATGAAAAACTGTTTTTT	CASSLRQGNEKLFF	TRBV5-4	TRBJ1-4
TGCGCCAGCAGTCTACGGAACACCATATATTTT	CASSLRNTIYF	TRBV10-1	TRBJ1-3
TGTGCCTGGAGCCATTCCGTCGGCCGCTCTGGAAACACCATATATTTT	CAWSHSVGRSGNTIYF	TRBV30	TRBJ1-3
TGCAGCGTCACTAGCGGGGGCATTCAGTACTTC	CSVTSGGIQYF	TRBV29-1	TRBJ2-4
TGCGCCAGCAGCCAAGTCTTGCCCCAGGGAGGCCCGAATTACGAGCAGTACTTC	CASSQVLPQGGPNYEQYF	TRBV4-3	TRBJ2-7
TGTGCCAGCAGCTTGCGACAGGCTAATAAGGTTCCCTCAGATACGCAGTATTTT	CASSLRQANKVPSDTQYF	TRBV7-9	TRBJ2-3
TGTGCCAGCCATCCTAATCGCGGGAGTAAGGTTACCGGGGAGCTGTTTTTT	CASHPNRGSKVTGELFF	TRBV9	TRBJ2-2
TGCAGTGCCCTCAGGCGCGGGAGCTTGCAGCCCCAGCATTTT	CSALRRGSLQPQHF	TRBV20-1	TRBJ1-5
TGTGCCAGCAGTGACGTGAGAACGGACACTGAAGCTTTCTTT	CASSDVRTDTEAFF	TRBV6-4	TRBJ1-1
TGCAGTGCTAGAGTCGGACAGAATCAGCCCCAGCATTTT	CSARVGQNQPQHF	TRBV20-1	TRBJ1-5
TGTGCCAGCAGTTACACTGAAGCCTACGAGCAGTACTTC	CASSYTEAYEQYF	TRBV6-5	TRBJ2-7
TGTGCCAGCAGTGATTACCGACAGGGAAGTGGCTACACCTTC	CASSDYRQGSGYTF	TRBV6-4	TRBJ1-2
TGTGCCAGCTCACGTCGCTTTTGGGGCTCACCCCTCCACTTT	CASSRRFWGSPLHF	TRBV18	TRBJ1-6
TGTGCCCGGGCTCGGGACCGGGTAACAGATACGCAGTATTTT	CARARDRVTDTQYF	TRBV2	TRBJ2-3
TGTGCCACTGCGGACAGGGCGAACTTC	CATADRANF	TRBV6-4	TRBJ2-5
TGCGCCAGCAGCTTGAAGTGTGATGGCGAGCAGTACTTC	CASSLKCDGEQYF	TRBV5-1	TRBJ2-7
TGTGCCAGCAGTTTGCCTTATCTAACACTTAGCAATCAGCCCCAGCATTTT	CASSLPYLTLSNQPQHF	TRBV12-3	TRBJ1-5
TGTGCCACCAGGGACAGGGGGAAAATTCTGGGGTGTGCTTTCTTT	CATRDRGKILGCAFF	TRBV24-1	TRBJ1-1
TGTGCCAGCAGTGACGTAAGGGACAGGAGCTATGGCTACACCTTC	CASSDVRDRSYGYTF	TRBV6-4	TRBJ1-2
TGTGCCACCAGCAGACTCTCAGGGGGGGCTTGGTGCTATAGCAATCAGCCCCAGCATTTT	CATSRLSGGAWCYSNQPQHF	TRBV15	TRBJ1-5
TGTGCCAGCAGTGGACCGGGACAGGGTAGTGGGAATCAGCCCCAGCATTTT	CASSGPGQGSGNQPQHF	TRBV6-1	TRBJ1-5
TGTGCCAGCAGCTTAGGCTGGGGCGGGGCCAACGTCCTGACTTTC	CASSLGWGGANVLTF	TRBV11-2	TRBJ2-6
TGTGCCAGTAGTCGACCTCTCTATGGCTACACCTTC	CASSRPLYGYTF	TRBV19	TRBJ1-2
TGTGCCAGCAGCCCACGGGGAGGCTACGAGCAGTACTTC	CASSPRGGYEQYF	TRBV7-3	TRBJ2-7
TGCAGCGTTGAAAGCCCCCCCGACAGGGGGCGGAACGAGCAGTACTTC	CSVESPPDRGRNEQYF	TRBV29-1	TRBJ2-7
TGTGCCACCAGCTACTCTGAAGCTTTCTTT	CATSYSEAFF	TRBV15	TRBJ1-1
TGTGCCAGCAGCTCCCGGGGCTTATCGTGTCGGAGCAATCAGCCCCAGCATTTT	CASSSRGLSCRSNQPQHF	TRBV9	TRBJ1-5
TGTGCCAGCAGCAAGCCGGACAGATTCCACAATGAAAAACTGTTTTTT	CASSKPDRFHNEKLFF	TRBV13	TRBJ1-4
TGTGCCAGCAGGGGGACAGAGGATCAGCCCCAGCATTTT	CASRGTEDQPQHF	TRBV12-4	TRBJ1-5
TGTGCCAGCAGGACAGGGGGCGAAAAACTGTTTTTT	CASRTGGEKLFF	TRBV7-3	TRBJ1-4
TGTGCCAGCAGCTTAGTCCGACAGGGGGCGGCCTCAGATACGCAGTATTTT	CASSLVRQGAASDTQYF	TRBV7-9	TRBJ2-3
TGTGCCAGCAGTTGCAATAGGGCTCTAGGGTACGAGCAGTACTTC	CASSCNRALGYEQYF	TRBV28	TRBJ2-7
TGTGCCAGCAGCGGGCTTGATAGCAATCAGCCCCAGCATTTT	CASSGLDSNQPQHF	TRBV6-1	TRBJ1-5
TGTGCCAGCAGCCTCCCCGATAGCAATCAGCCCCAGCATTTT	CASSLPDSNQPQHF	TRBV7-3	TRBJ1-5
TGTGCCAGCGTCCGGACGGGATCCGAGCAGTACTTC	CASVRTGSEQYF	TRBV6-1	TRBJ2-7
TGTGCCAGCATTATCGTCCGGGACAGGGTGTTCTATGGCTACACCTTC	CASIIVRDRVFYGYTF	TRBV12-3	TRBJ1-2
TGCAGTGCTAGAGCAATGGGGGGCGGCTCTGGGGCCAACGTCCTGACTTTC	CSARAMGGGSGANVLTF	TRBV20-1	TRBJ2-6
TGTGCCAGCAGCCAAGATAACCTCCTAGCGGGTCGACGAAGTAGCACAGATACGCAGTATTTT	CASSQDNLLAGRRSSTDTQYF	TRBV4-2	TRBJ2-3
TGTGCCACCAGAGGAGTAAAACTGTTTTTT	CATRGVKLFF	TRBV24-1	TRBJ1-4
TGTGCCAGATGGGCCGGGGATACGCAGTATTTT	CARWAGDTQYF	TRBV19	TRBJ2-3
TGTGCCTGGCATCCAGACCCTAATGAGCAGTTCTTC	CAWHPDPNEQFF	TRBV30	TRBJ2-1
TGTGCCAGCAGCTGGGGACAGGGGGGAAGCTCCTATAATTCACCCCTCCACTTT	CASSWGQGGSSYNSPLHF	TRBV11-1	TRBJ1-6
TGTGCCAGCAGTTTACCAACTTATAGTGTTGAGCAGTACTTC	CASSLPTYSVEQYF	TRBV27	TRBJ2-7
TGTGCCAGCAGCTTAGGGGGAAACCAGGGGACTTCAGATACGCAGTATTTT	CASSLGGNQGTSDTQYF	TRBV7-2	TRBJ2-3
TGTGCCAGCACGGGACACCCCCAAGAGACCCAGTACTTC	CASTGHPQETQYF	TRBV12-3	TRBJ2-5
TGCGCCAGCAGTAGTAGCGGGACTAATGAGCAGTTCTTC	CASSSSGTNEQFF	TRBV10-2	TRBJ2-1
TGTGCCCGACAGTCTTGGTGGAATGAAAAACTGTTTTTT	CARQSWWNEKLFF	TRBV27	TRBJ1-4
TGTGCCAGCAGCTTATGTCCCGACAGAGGCTATGGCTACACCTTC	CASSLCPDRGYGYTF	TRBV7-9	TRBJ1-2
TGTGCCATCACCCTCGCTTATGTTGCCCGGCTACTGACGGAAGATACGCAGTATTTT	CAITLAYVARLLTEDTQYF	TRBV10-3	TRBJ2-3
TGTGCCAGCAGTTATTCAGGGAGCATCGAGCAGTACTTC	CASSYSGSIEQYF	TRBV27	TRBJ2-7
TGTGCCAGCAGCCAACCGACAATGTCCACTGAAGCTTTCTTT	CASSQPTMSTEAFF	TRBV3-1	TRBJ1-1
TGTGCCAGCAGCGTATCGGGGAGGAATGAGCAGTTCTTC	CASSVSGRNEQFF	TRBV7-3	TRBJ2-1
TGTGCCAGCAGCCAAGGAGCTTACCCGACTAGCGGGGCCGTAACTGACCACGATACGCAGTATTTT	CASSQGAYPTSGAVTDHDTQYF	TRBV14	TRBJ2-3
TGTGCCAGCGGGGGGGTGGTAGGCTACGAGCAGTACTTC	CASGGVVGYEQYF	TRBV6-1	TRBJ2-7
TGTGCCAGCAGCGGCTCGGGGAGGGAGACCCAGTACTTC	CASSGSGRETQYF	TRBV7-3	TRBJ2-5
TGTGCCAGCAGCTTATCCCCGGGACCTGCTCCACCAGATACGCAGTATTTT	CASSLSPGPAPPDTQYF	TRBV11-1	TRBJ2-3
TGTGCCAGCAGCTTTAGGGGTTGGGTGAACACTGAAGCTTTCTTT	CASSFRGWVNTEAFF	TRBV5-6	TRBJ1-1
TGTGCCAGTAGCGGAGTTAACCCCGGGGAGACCCAGTACTTC	CASSGVNPGETQYF	TRBV19	TRBJ2-5
TGTGCTAGCAGCTTAGCGCCCCCCGACAGGGGTGAGACCCAGTACTTC	CASSLAPPDRGETQYF	TRBV7-7	TRBJ2-5
TGTGCTAGCAGCAGGGATCGAGGGGGATGCACAGATACGCAGTATTTT	CASSRDRGGCTDTQYF	TRBV7-7	TRBJ2-3
TGTGCCACCAGTGATTCGGGGGGGGGGGCAGAGCAGTTCTTC	CATSDSGGGAEQFF	TRBV24-1	TRBJ2-1
TGTGCCAGCAGTTTGCCGGCTATTTTCTTGAGACAGGGCTCGCTTAACTATGGCTACACCTTC	CASSLPAIFLRQGSLNYGYTF	TRBV12-3	TRBJ1-2
TGTGCCAGCAGTGACCTGGGACAGGTCACTGAAGCTTTCTTT	CASSDLGQVTEAFF	TRBV25-1	TRBJ1-1
TGCAGTGCTAGAGGCCGGCAGGGGGCGGGGAACACTGAAGCTTTCTTT	CSARGRQGAGNTEAFF	TRBV20-1	TRBJ1-1
TGTGCCAGCGACAGGTGGCTCAAGACCTACGAGCAGTACTTC	CASDRWLKTYEQYF	TRBV28	TRBJ2-7
TGTGCCAGCAGCCCCCGGGGGGTAGGGGGGCACACTGAAGCTTTCTTT	CASSPRGVGGHTEAFF	TRBV6-1	TRBJ1-1
TGTGCCAGCAGTTACTCCGATAGCAATCAGCCCCAGCATTTT	CASSYSDSNQPQHF	TRBV6-5	TRBJ1-5
TGTGCCAGCAGCCACCGCCCCAGGGGGAGGCGGGCGTACTTC	CASSHRPRGRRAYF	TRBV3-1	TRBJ2-5
TGTGCCAGCTCACAACTTTTACCGACTAGCGGGGGGCTTTTCGTACAGGGCACAGATACGCAGTATTTT	CASSQLLPTSGGLFVQGTDTQYF	TRBV18	TRBJ2-3
TGTGCCAGCAGCCGCACCCCTGAAACCGGGACAGGTGAGCAGTTCTTC	CASSRTPETGTGEQFF	TRBV14	TRBJ2-1
TGTGCCATGGTTAGCGGGTACACAGATACGCAGTATTTT	CAMVSGYTDTQYF	TRBV6-1	TRBJ2-3
TGTGCCAGCAGCTTAGCGAACACGGGGGGGGGAGTAGCCAAAAACATTCAGTACTTC	CASSLANTGGGVAKNIQYF	TRBV7-6	TRBJ2-4
TGTGCCAGCAGCCCACCCGACAAAATTGACTATGGCTACACCTTC	CASSPPDKIDYGYTF	TRBV4-2	TRBJ1-2
TGTGCCAGCAGCTTTGGACGCACAGCGCACGCAGAGACTGGGAACACCGGGGAGCTGTTTTTT	CASSFGRTAHAETGNTGELFF	TRBV5-6	TRBJ2-2
TGTAAGCACAGGGGTTTAGTCTTT	CKHRGLVF	TRBV20-1	TRBJ1-1
TGTGCCACCAGTGAAAGGGAAGAGACCCAGTACTTC	CATSEREETQYF	TRBV24-1	TRBJ2-5
TGTGCCACCAGTTCTAGCGCCGGCCGAGGGACCTACGAGCAGTACTTC	CATSSSAGRGTYEQYF	TRBV24-1	TRBJ2-7
TGTGCCAGCAGAGGGACAGGGTATCAGCCCCAGCATTTT	CASRGTGYQPQHF	TRBV9	TRBJ1-5
TGCACCCCCAGCCGGGACAGGGGACCCGAGCAGTACTTC	CTPSRDRGPEQYF	TRBV20-1	TRBJ2-7
TGTGCCAGCAGCCAAGGGCAACTGTATAGCAATCAGCCCCAGCATTTT	CASSQGQLYSNQPQHF	TRBV3-1	TRBJ1-5
TGTGCCAGCAGTGACTCGACGGATCAGGGCCGGGACAATCAGACTCCCAATTCACCCCTCCACTTT	CASSDSTDQGRDNQTPNSPLHF	TRBV6-4	TRBJ1-6
TGTACGTCGGGAAAGCTTGGGTCCTCTGGGGCCAACGTCCTGACTTTC	CTSGKLGSSGANVLTF	TRBV7-9	TRBJ2-6
TGTGCCAGCAGTGGCCGGGACAGCTTGTTGGAGAAAAACATTCAGTACTTC	CASSGRDSLLEKNIQYF	TRBV6-4	TRBJ2-4
TGTGCCAGCAGCTCCCGGGGAACTAATGGCTACACCTTC	CASSSRGTNGYTF	TRBV7-9	TRBJ1-2
TGTGCCAGCAGTGAGGTCTTAGACACGGTCAATCAGCCCCAGCATTTT	CASSEVLDTVNQPQHF	TRBV6-4	TRBJ1-5
TGTGCCAGCAGAAAATTGGGACTAGCGGGGCAGAACAATGAGCAGTTCTTC	CASRKLGLAGQNNEQFF	TRBV6-5	TRBJ2-1
TGTGCCAGCAGTCCGACTTCCGGGGCCGGGGAGCTGTTTTTT	CASSPTSGAGELFF	TRBV7-9	TRBJ2-2
TGTGCCAGCAACTCCTGCCCCAGCGCCCGGACCGGGGAGCTGTTTTTT	CASNSCPSARTGELFF	TRBV6-4	TRBJ2-2
TGTGCCAGCAGTGAAAAGACGGGACACACTGAAGCTTTCTTT	CASSEKTGHTEAFF	TRBV6-1	TRBJ1-1
TGCGCCAGCAGCCTTCGACTAGCGGAGAGCTCCTACAATGAGCAGTTCTTC	CASSLRLAESSYNEQFF	TRBV4-1	TRBJ2-1
TGCGCCAGCAGCTTGCCCCCCTGGAGCGAGAGGAATCAGCCCCAGCATTTT	CASSLPPWSERNQPQHF	TRBV5-1	TRBJ1-5
TGTGCCAGCAGTTACAGTCCGCCGGGACTACAATTCCCCTCCTACAATGAGCAGTTCTTC	CASSYSPPGLQFPSYNEQFF	TRBV6-2	TRBJ2-1
TGTGCCATCAGAGGCGGGACAGGGTACGAGCAGTACTTC	CAIRGGTGYEQYF	TRBV10-3	TRBJ2-7
TGTGCCTGGAGTGTAGGCGGGGAGCTGTTTTTT	CAWSVGGELFF	TRBV30	TRBJ2-2
TGTGCCAGCAGCCAAGCCCCTGGACAGGACGGGAACTCCTACAATGAGCAGTTCTTC	CASSQAPGQDGNSYNEQFF	TRBV3-1	TRBJ2-1
TGTGCCACCAGGGAGGATACGCAGTATTTT	CATREDTQYF	TRBV15	TRBJ2-3
TGTGCCAGCAGCGAGGAGCTATTCTCCTACGAGCAGTACTTC	CASSEELFSYEQYF	TRBV13	TRBJ2-7
TGCGCCAGCAGACTAGCGGGGGGTTCCTACGAGCAGTACTTC	CASRLAGGSYEQYF	TRBV10-2	TRBJ2-7
TGCAGCGAAGTGGACAGGTTAATATATAGGGGGGATAGCAATCAGCCCCAGCATTTT	CSEVDRLIYRGDSNQPQHF	TRBV29-1	TRBJ1-5
TGTGCCAGCAGCAGCTACAATGAGCAGTTCTTC	CASSSYNEQFF	TRBV27	TRBJ2-1
TGTGCCTGGAGTGGACATAGGGACAGGGTTCAGCCCCAGCATTTT	CAWSGHRDRVQPQHF	TRBV30	TRBJ1-5
TGCGCCAGCAGTGGGCAAAAGCGGGCCTACAATGAGCAGTTCTTC	CASSGQKRAYNEQFF	TRBV10-1	TRBJ2-1
TGTGGAACAGAGGGGGGCCAATCCCACGAGCAGTACTTC	CGTEGGQSHEQYF	TRBV7-3	TRBJ2-7
TGCAGCGGGGCCCTGGACAGCGGGTTCAAAAACATTCAGTACTTC	CSGALDSGFKNIQYF	TRBV29-1	TRBJ2-4
TGCAGTGCTGAAGCAGGGGCCTTCTGTCTGGGGACTGAGCAGTTCTTC	CSAEAGAFCLGTEQFF	TRBV20-1	TRBJ2-1
TGTGCCAGCAGTTTATCTTCAGGGGGGGGAAGGAGCACAGATACGCAGTATTTT	CASSLSSGGGRSTDTQYF	TRBV27	TRBJ2-3
TGTGCTGTAGGGGAGGGTAACAATGAGCAGTTCTTC	CAVGEGNNEQFF	TRBV12-5	TRBJ2-1
TGTGCTAGTGGTTTGGTGGTATTGAATCCCGGTGGTAACTATGGCTACACCTTC	CASGLVVLNPGGNYGYTF	TRBV12-5	TRBJ1-2
TGTGCCAGCAGCTCGGGGAGAAGCACAGATACGCAGTATTTT	CASSSGRSTDTQYF	TRBV7-9	TRBJ2-3
TGTGCCAGCAGGCCCGCCACCAGGGAGGGAAACACCATATATTTT	CASRPATREGNTIYF	TRBV28	TRBJ1-3
TGTGCCAGCAGTGGGAACTTCAGGGTCTCCGGTGGGGGGAACACTGAAGCTTTCTTT	CASSGNFRVSGGGNTEAFF	TRBV6-4	TRBJ1-1
TGTGCCAGCAGTCCTACACCTTTGGACAATGAGCAGTTCTTC	CASSPTPLDNEQFF	TRBV27	TRBJ2-1
TGTGCCACCAAGGGCCGGGACGCGGCTCAGCCCCAGCATTTT	CATKGRDAAQPQHF	TRBV24-1	TRBJ1-5
TGCGCCAGCTGGGTAGTTCCCTCCTACGAGCAGTACTTC	CASWVVPSYEQYF	TRBV10-1	TRBJ2-7
TGCAGTGCTCTGGCCGGGGGGGGCGGATCCTACAATGAGCAGTTCTTC	CSALAGGGGSYNEQFF	TRBV20-1	TRBJ2-1
TGTGCCAGCAGTCCAAGGGTAACCTACGAGCAGTACTTC	CASSPRVTYEQYF	TRBV12-4	TRBJ2-7
TGTGCCAGCAGCTTTGTATTAGTATCCTACGAGCAGTACTTC	CASSFVLVSYEQYF	TRBV7-9	TRBJ2-7
TGTGCCAGCAGCTCAGATCATCCGGGGGCTTTCTTT	CASSSDHPGAFF	TRBV5-4	TRBJ1-1
TGTGCTAGCAGCAAAGGGCCGAGAGTAGAGACCCAGTACTTC	CASSKGPRVETQYF	TRBV7-7	TRBJ2-5
TGTGCCACCAGTGAAAAGGGGCTCCCCTACGAGCAGTACTTC	CATSEKGLPYEQYF	TRBV24-1	TRBJ2-7
TGCGCCAGCAGTGGAAAACGCCGCAACTACGAGCAGTACTTC	CASSGKRRNYEQYF	TRBV10-1	TRBJ2-7
TGCAGTGCTAGAGATACTCAGGGATACCCACGACTCTTC	CSARDTQGYPRLF	TRBV20-1	TRBJ2-1
TGTGCCAGCAGCGCAATCTCTAGAATCTACGAGCAGTACTTC	CASSAISRIYEQYF	TRBV6-4	TRBJ2-7
TGTGCCAGCAGCCTCCCGACAGGTTCCTTC	CASSLPTGSF	TRBV11-2	TRBJ1-2
TGCGCCAGCAGCTTCCCTCACGGGTTTATAAGCTACGAGCAGTACTTC	CASSFPHGFISYEQYF	TRBV5-1	TRBJ2-7
TGTGCCAGCAGTTTAGTAACCAAACAGGACAGGGAGTTCCCGAACACCGGGGAGCTGTTTTTT	CASSLVTKQDREFPNTGELFF	TRBV12-4	TRBJ2-2
TGTGCCAGCAGTTTACACCCGAGGTACAGATTCATGAACACTGAAGCTTTCTTT	CASSLHPRYRFMNTEAFF	TRBV28	TRBJ1-1
TGTGCCAGTAGTCTAACCCTGGAGGGTTCGGAGACCCAGTACTTC	CASSLTLEGSETQYF	TRBV19	TRBJ2-5
TGTGCCAGCAGTTGGAGCTGGCCGGGACAGGGGGCCCCAACTAATGAAAAACTGTTTTTT	CASSWSWPGQGAPTNEKLFF	TRBV27	TRBJ1-4
TGTGCCAGCAGTGATATGGGCACTGAAGCTTTCTTT	CASSDMGTEAFF	TRBV6-5	TRBJ1-1
TGTGCCAGCAGCTCTAGCGGGGACGAGCAGTACTTC	CASSSSGDEQYF	TRBV7-3	TRBJ2-7
TGTGCCAGCAGTTTCTTACTAGCGGGAGATGAGCCTTTAGAAGGGGGAAGCACAGATACGCAGTATTTT	CASSFLLAGDEPLEGGSTDTQYF	TRBV28	TRBJ2-3
TGTGCCAGCAGCTCGGGGGAGCCGCACGCTGGGGCCAACGTCCTGACTTTC	CASSSGEPHAGANVLTF	TRBV9	TRBJ2-6
TGCGCCAGCAGTTCTCACTCAGGGGGGAGGGGTGAGCAGTACTTC	CASSSHSGGRGEQYF	TRBV10-1	TRBJ2-7
TGTGCCAGCAGTGAAGGGAACGTATGGGGGGGGGAGAATAGCAATCAGCCCCAGCATTTT	CASSEGNVWGGENSNQPQHF	TRBV6-1	TRBJ1-5
TGTGCCAGCAGTTACATTCCGGGACTAGCGGGAGTGTGCTGTGCCAGAGAGACCCAGTACTTC	CASSYIPGLAGVCCARETQYF	TRBV6-3	TRBJ2-5
TGTGCCAGCAGTGAATGGGCGGGACAGCAGCCCCAGCATTTT	CASSEWAGQQPQHF	TRBV25-1	TRBJ1-5
TGTGCCAGCAGCTTAAAACAAAGACAGGTGGCTCTCACTGAAGCTTTCTTT	CASSLKQRQVALTEAFF	TRBV7-3	TRBJ1-1
TGCGCCAGCAGTGTCAGGGCCTACAATGAGCAGTTCTTC	CASSVRAYNEQFF	TRBV10-1	TRBJ2-1
TGTGCCAGCAGCCGGAATGACGGAACCTCTGGGGCCAACGTCCTGACTTTC	CASSRNDGTSGANVLTF	TRBV3-1	TRBJ2-6
TGTGCCTGGATCGTGGACAAGGGTAATGAAAAACTGTTTTTT	CAWIVDKGNEKLFF	TRBV30	TRBJ1-4
TGTGCCAGCAGCTTGGCTCTAAGCTTCGCCTACGAGCAGTACTTC	CASSLALSFAYEQYF	TRBV5-5	TRBJ2-7
TGTGCCAGCAGTCCGGGACAGGGGCCCCCCTCAGGAGAAGCTTTCTTT	CASSPGQGPPSGEAFF	TRBV11-2	TRBJ1-1
TGCGCCAGCAGTGTATGGGTGGTTCACAATCAGCCCCAGCATTTT	CASSVWVVHNQPQHF	TRBV10-1	TRBJ1-5
TGTGCCAGCAGCAGCCTCTCCGTTTCTGGCTACACCTTC	CASSSLSVSGYTF	TRBV7-8	TRBJ1-2
TGCGCCAGCAGCCTTGGACAGGAAACAGCTAACTATGGCTACACCTTC	CASSLGQETANYGYTF	TRBV5-1	TRBJ1-2
TGTGCCACCGCCATATCCCAGGGTCTCAATCAGCCCCAGCATTTT	CATAISQGLNQPQHF	TRBV24-1	TRBJ1-5
TGTGCCAGCAGCAAGTCGAAGATGTGGGGTACAATTCAGGCCGCTTTCTTT	CASSKSKMWGTIQAAFF	TRBV7-3	TRBJ1-1
TGTGCCAGCAGTCTGGGGTGGGGGGGGACAACTAATGAAAAACTGTTTTTT	CASSLGWGGTTNEKLFF	TRBV12-3	TRBJ1-4
TGTGCCAGCAGTTACTCAATTCAGGGTGTGACAAATCAGCCCCAGCATTTT	CASSYSIQGVTNQPQHF	TRBV6-2	TRBJ1-5
TGCGCCAGCAGCTTGGGCATAATTGGACAGGGGGACTACGAGCAGTACTTC	CASSLGIIGQGDYEQYF	TRBV5-1	TRBJ2-7
TGTGCCAGCAGCAGTAGGGGGGGTTGGGGGCAAGAGACCCAGTACTTC	CASSSRGGWGQETQYF	TRBV11-2	TRBJ2-5
TGTGCCACCAACATTGCGGGACTAGCGGCGGTCCCGAACACCGGGGAGCTGTTTTTT	CATNIAGLAAVPNTGELFF	TRBV24-1	TRBJ2-2
TGTGCCAGCAGTTTATGTTTAAAAGGTCAAAACAGTCAGAATGGCTACACCTTC	CASSLCLKGQNSQNGYTF	TRBV27	TRBJ1-2
TGTGCCAGCAGTTTAGAGCGTGGAGAGGCGTACTTC	CASSLERGEAYF	TRBV28	TRBJ2-7
TGTGCCAGCAGCCCCCACAGGGTAGCCAAAAACATTCAGTACTTC	CASSPHRVAKNIQYF	TRBV3-1	TRBJ2-4
TGTGCCAGCAGCCCGCCGGAGGGAGACCAGTGTCAGCCCCAGCATTTT	CASSPPEGDQCQPQHF	TRBV7-3	TRBJ1-5
TGTGCCAGCAGTGGATGCGCTAGGCCGGAGACCCAGTACTTC	CASSGCARPETQYF	TRBV6-4	TRBJ2-5
TGCGCCAGCAGCTTGGTTAGGGTGCTCAATGGCTACACCTTC	CASSLVRVLNGYTF	TRBV5-1	TRBJ1-2
TGCAGCGTTGCCTCCGCCCGGGCAACTAATGAAAAACTGTTTTTT	CSVASARATNEKLFF	TRBV29-1	TRBJ1-4
TGCGCCAGCAGTGAGTCAGATAGGGGGCCGTGTTCCACCAAAAACATTCAGTACTTC	CASSESDRGPCSTKNIQYF	TRBV10-1	TRBJ2-4
TGTGCCTGGAGTGTCTATACGCAGTATTTT	CAWSVYTQYF	TRBV30	TRBJ2-3
TGTGCCAGTAGTACCCCTAGGTATACGCAGTATTTT	CASSTPRYTQYF	TRBV19	TRBJ2-3
TGTGCCAGCAGTTACTCGCGAGCCGGGACAGTTATCTGTTCTAAGGGAAACACCATATATTTT	CASSYSRAGTVICSKGNTIYF	TRBV6-8	TRBJ1-3
TGTGCCACCAGTGAATGCCCCGGGGGGTGCACCGGGGAGCTGTTTTTT	CATSECPGGCTGELFF	TRBV24-1	TRBJ2-2
TGCGCCAGCAGCTGTCATCGGACTAGCGGGGCAGATACGCAGTATTTT	CASSCHRTSGADTQYF	TRBV5-1	TRBJ2-3
TGCGCCAGGCAACCATTAGACACTGAAGCTTTCTTT	CARQPLDTEAFF	TRBV10-1	TRBJ1-1
TGTGCCAGCAGTAGCCATGAGCCCCAGCCCCAGCATTTT	CASSSHEPQPQHF	TRBV12-3	TRBJ1-5
TGTGCCAGCAGTAAAGAACAGGGCACCGGGGAGCTGTTTTTT	CASSKEQGTGELFF	TRBV28	TRBJ2-2
TGCGCCAGCAGTGATGTACAGGGTAATGGCTACACCTTC	CASSDVQGNGYTF	TRBV10-1	TRBJ1-2
TGTGCCAGCAGCCGCCCTCCGGGGGGGCCCTACGAGCAGTACTTC	CASSRPPGGPYEQYF	TRBV3-1	TRBJ2-7
TGTGCCAGCAACTTCGGACAGGGTGGGGGCAATCAGCCCCAGCATTTT	CASNFGQGGGNQPQHF	TRBV28	TRBJ1-5
TGTGCCAGCAGTGAGTTTGTAGTACACCATAATCAGCCCCAGCATTTT	CASSEFVVHHNQPQHF	TRBV25-1	TRBJ1-5
TGTGCCAGCAGTGACCACAGGACCGGGACAAAGCAAGAGACCCAGTACTTC	CASSDHRTGTKQETQYF	TRBV6-4	TRBJ2-5
TGTGCCAGCGGACAGACCCCAAACATTCAGTACTTC	CASGQTPNIQYF	TRBV6-4	TRBJ2-4
TGCAGTGCTGACTACACTGAAGCTTTCTTT	CSADYTEAFF	TRBV20-1	TRBJ1-1
TGTGCCAGCAGTTATTTACGAGGGAAGGGAAATGAGCAGTTCTTC	CASSYLRGKGNEQFF	TRBV6-5	TRBJ2-1
TGTGCCACCAGTCGTCTTGTCGACAGGATGGTTTATCAGCCCCAGCATTTT	CATSRLVDRMVYQPQHF	TRBV24-1	TRBJ1-5
TGTGCCACCAGTGTGGCGGGGGGCCAAGGGGAGCTGTTTTTT	CATSVAGGQGELFF	TRBV24-1	TRBJ2-2
TGTGCCAGCAGTTTTTACAGGGACGGACACGGCTACACCTTC	CASSFYRDGHGYTF	TRBV28	TRBJ1-2
TGTGCCAGCGGAAAACGAGGGAGCAATCAGCCCCAGCATTTT	CASGKRGSNQPQHF	TRBV27	TRBJ1-5
TGTGCTAGTGGTTTGGTACCGGGACTAAGGGGAGGCTACGAGCAGTACTTC	CASGLVPGLRGGYEQYF	TRBV12-5	TRBJ2-7
TGTGCCAGCAGCTTGGGTCGGACAGACAATCAGCCCCAGCATTTT	CASSLGRTDNQPQHF	TRBV5-6	TRBJ1-5
TGTGCCTGGACTGGGACAGGGGGCATCTATGGCTACACCTTC	CAWTGTGGIYGYTF	TRBV30	TRBJ1-2
TGTGCCAGCAGAACGGACAGGGGAACTGAAAAACTGTTTTTT	CASRTDRGTEKLFF	TRBV12-3	TRBJ1-4
TGTGCCAGCAGCCAAGCGAAGCCGAAGGAGACCCAGTACTTC	CASSQAKPKETQYF	TRBV3-1	TRBJ2-5
TGTGCCAGCAGCGCACCGGGACTAGCGGGAGGGAATGAGCAGTTCTTC	CASSAPGLAGGNEQFF	TRBV9	TRBJ2-1
TGTGCCAGCAGCGCCGACAGGACAGGATGTAGCAATCAGCCCCAGCATTTT	CASSADRTGCSNQPQHF	TRBV6-5	TRBJ1-5
TGTGCCTGGAGTCCCAGGCAGCCCCAGCATTTT	CAWSPRQPQHF	TRBV30	TRBJ1-5
TGTGCCAGCAGCTTTGGACAGGGGTGGTTGGGGGGAAACACCGGGGAGCTGTTTTTT	CASSFGQGWLGGNTGELFF	TRBV7-9	TRBJ2-2
TGTGCCAGAAATCGGTTAGGGTTTAGAGCTGAAGCTTTCTTT	CARNRLGFRAEAFF	TRBV3-1	TRBJ1-1
TGTGCCAGCAGTGAAGGGACAGGGGAGCAGTACTTC	CASSEGTGEQYF	TRBV6-1	TRBJ2-5
TGTGCCAGTAGTGATAATAGGGGGCGGGCAACTAATGAAAAACTGTTTTTT	CASSDNRGRATNEKLFF	TRBV19	TRBJ1-4
TGTGCCAGCAGTTATGCGACAGGGCACAGCTACACCTTC	CASSYATGHSYTF	TRBV6-5	TRBJ1-2
TGTGCCACCAGTGAGTCCGCAGAGACAGACTATGGCTACACCTTC	CATSESAETDYGYTF	TRBV24-1	TRBJ1-2
TGCAGCGTGACTGGGGACGAGGCTAGGACTGAAGCTTTCTTT	CSVTGDEARTEAFF	TRBV29-1	TRBJ1-1
TGTGCCAGCACGTTGACAGGGGGCACTACCTACGAGCAGTACTTC	CASTLTGGTTYEQYF	TRBV27	TRBJ2-7
TGCGCCAGCCAGGGTAACGGGGGTAGGAATGCGGAGACCCAGTACTTC	CASQGNGGRNAETQYF	TRBV10-1	TRBJ2-5
TGTGCCAGCAGCTTCTCACGACAGTACACCTTC	CASSFSRQYTF	TRBV7-9	TRBJ1-2
TGTGCCAGCAGCTTAGAGGCCGGGACGCAGTTCTTC	CASSLEAGTQFF	TRBV7-8	TRBJ2-1
TGTGCCAGCAAGGAGGGAGGGGAATGGAACAATGAGCAGTTCTTC	CASKEGGEWNNEQFF	TRBV6-8	TRBJ2-1
TGTGCCACCAGCAGAGATAAGGGGAGGGGGTGGACCCAGCCCCAGCATTTT	CATSRDKGRGWTQPQHF	TRBV15	TRBJ1-5
TGTGCCAGCAGCCAAGCGTGGGGGGACAGGGGACCCACTGAAGCTTTCTTT	CASSQAWGDRGPTEAFF	TRBV3-1	TRBJ1-1
TGTGCCAGCAGTTACTCCAGGGGACTGCACAATGAGCAGTTCTTC	CASSYSRGLHNEQFF	TRBV6-2	TRBJ2-1
TGTGCCAGCAGCTTAGTTACCCCGTTAGGGACTAGGCACTACGAGCAGTACTTC	CASSLVTPLGTRHYEQYF	TRBV11-2	TRBJ2-7
TGCGCCAGCAGTGTCGACAGAGACTATGGCTACACCTTC	CASSVDRDYGYTF	TRBV10-1	TRBJ1-2
TGCAGTGCTAGACCTTCAGGGAGGGAGACAGATACGCAGTATTTT	CSARPSGRETDTQYF	TRBV20-1	TRBJ2-3
TGTGCCATCGACAGTACCTACGAGCAGTACTTC	CAIDSTYEQYF	TRBV10-3	TRBJ2-7
TGTGCCAGCAGCAAGGGACGCGGGAGTAATTATAGCAATCAGCCCCAGCATTTT	CASSKGRGSNYSNQPQHF	TRBV13	TRBJ1-5
TGCAGTCATCCACGTCACAATCAGCCCCAGCATTTT	CSHPRHNQPQHF	TRBV20-1	TRBJ1-5
TGTGCCAGCAGCTGGTCGGGTAACGAAGAGACCCAGTACTTC	CASSWSGNEETQYF	TRBV13	TRBJ2-5
TGTGCCACCCGACGTACTGAAGCTTTCTTT	CATRRTEAFF	TRBV19	TRBJ1-1
TGTGCCAGCAGCTTAAGGATTGGACAGGGGGCTGAAGCTTTCTTT	CASSLRIGQGAEAFF	TRBV7-3	TRBJ1-1
TGTGCCAGCAGCTTGGTGAGTCAGGGGGTAAATCAGCCCCAGCATTTT	CASSLVSQGVNQPQHF	TRBV5-5	TRBJ1-5
TGTGCCAGCATCGACGCTACTCCCGGGACTAGTAGGAATGAGCAGTTCTTC	CASIDATPGTSRNEQFF	TRBV6-2	TRBJ2-1
TGCGCCAGCAGCCACTCTCCCCCCTACGAGCAGTACTTC	CASSHSPPYEQYF	TRBV5-1	TRBJ2-7
TGTGCCATCAGTGCCCAATGGGGACAGGACAAATCTTCGAACACTGAAGCTTTCTTT	CAISAQWGQDKSSNTEAFF	TRBV10-3	TRBJ1-1
TGTGCCAGCAGCAACCCGGGACAGGGGAGGAACACCGGGGAGCTGTTTTTT	CASSNPGQGRNTGELFF	TRBV7-4	TRBJ2-2
TGCGCCAGCGGAAGGACTGTATCACCCCTCCACTTT	CASGRTVSPLHF	TRBV5-1	TRBJ1-6
TGTGCCAGCAGCCGACACCCTGAAGCTTTCTTT	CASSRHPEAFF	TRBV12-4	TRBJ1-1
TGTGCTAGTGGTCGCGGGAGAGGGAGCTCCTATAATTCACCCCTCCACTTT	CASGRGRGSSYNSPLHF	TRBV12-5	TRBJ1-6
TGTGCCAGCAGCTGCTGTGGAGCCGGGACAGGGATCTGCCAAGAGACCCAGTACTTC	CASSCCGAGTGICQETQYF	TRBV11-2	TRBJ2-5
TGTGCCAGCACGGTGGGACAGGGGGCGGCTAATGAAAAACTGTTTTTT	CASTVGQGAANEKLFF	TRBV5-6	TRBJ1-4
TGCGCCAGCAGCCACGGCAGGGAGAGCTCCTACGAGCAGTACTTC	CASSHGRESSYEQYF	TRBV4-1	TRBJ2-7
TGTGCCACCAGTGATTTGCAGGACGTCCGGGCAACTAATGAAAAACTGTTTTTT	CATSDLQDVRATNEKLFF	TRBV24-1	TRBJ1-4
TGTGCCAGCAGTTACGGGGGACTACAGTCAGGGTGCCGTCTCGGTAATCAGCCCCAGCATTTT	CASSYGGLQSGCRLGNQPQHF	TRBV6-6	TRBJ1-5
TGTGCCTGGAGTGGACAGGGGGCGCGGGAGGGCTACACCTTC	CAWSGQGAREGYTF	TRBV30	TRBJ1-2
TGTGCCAGCAGCCCGCGGGAGTGGGGACTGGGGGAGCTGTTTTTT	CASSPREWGLGELFF	TRBV5-6	TRBJ2-2
TGCGCCAGCAGTGATGGGACAGGGACCTACGAGCAGTACTTC	CASSDGTGTYEQYF	TRBV10-1	TRBJ2-7
TGTGCCAGCAGTGAACGAGGGGAAAGCACAGATACGCAGTATTTT	CASSERGESTDTQYF	TRBV6-1	TRBJ2-3
TGTGCCAGCAGCTTAACGGCTGCCCGGCAGGGGCTCTTTAACACCGGGGAGCTGTTTTTT	CASSLTAARQGLFNTGELFF	TRBV7-3	TRBJ2-2
TGCGCCAGCAGTGAAACGGGGGAAGATACGCAGTATTTT	CASSETGEDTQYF	TRBV10-1	TRBJ2-3
TGCAGTGCTAGAGTGGCATTCCATTCTGGAAACACCATATATTTT	CSARVAFHSGNTIYF	TRBV20-1	TRBJ1-3
TGCGCCAGCAGCCAAGAGACCTACGACGGACAGGGAAGTCAGCCCCAGCATTTT	CASSQETYDGQGSQPQHF	TRBV4-1	TRBJ1-5
TGTGCTAGCAGCCCAACACCCAAGGGACAACGGTCCTCTGGAAACACCATATATTTT	CASSPTPKGQRSSGNTIYF	TRBV7-7	TRBJ1-3
TGTGCCAGCAGCCTCGGGGTAGCCAATGAGCAGTTCTTC	CASSLGVANEQFF	TRBV3-1	TRBJ2-1
TGTGCCAGCAGCCCAAGTGGAGGAAACACCATATATTTT	CASSPSGGNTIYF	TRBV11-3	TRBJ1-3
TGCGCCAGCAGCCAAGATATGGGGCGCGGGAGTCGGGCCGGGGAGCTGTTTTTT	CASSQDMGRGSRAGELFF	TRBV4-1	TRBJ2-2
TGTGCCAGCAGTTTATCCATCAACAGGGGCCAAGCTAACTATGGCTACACCTTC	CASSLSINRGQANYGYTF	TRBV27	TRBJ1-2
TGTGCCAGCAACAGGGGGGTACGTGAGCGAGGGTCACCCCTCCACTTT	CASNRGVRERGSPLHF	TRBV28	TRBJ1-6
TGTAAAAAGCCCTACAGCCCCCCTAACTATGGCTACACCTTC	CKKPYSPPNYGYTF	TRBV7-9	TRBJ1-2
TGTGCCAGCAGCCAAGATGCCCGGCCCTACAATGAGCAGTTCTTC	CASSQDARPYNEQFF	TRBV3-1	TRBJ2-1
TGTGCCAGCAGTCGGGCCTTC	CASSRAF	TRBV6-2	TRBJ1-2
TGTGCCAGCAGCTTTGTTATCCCTAGGGGCTCCTACAATGAGCAGTTCTTC	CASSFVIPRGSYNEQFF	TRBV5-4	TRBJ2-1
TGTGCCAGCAGTTTACTAGAATTAGAGACCCAGTACTTC	CASSLLELETQYF	TRBV12-3	TRBJ2-5
TGCACATACGTTGGGTCTGGCTACACCTTC	CTYVGSGYTF	TRBV20-1	TRBJ1-2
TGTGCCAGCAGACGGAGGCCGAACACCGGGGAGCTGTTTTTT	CASRRRPNTGELFF	TRBV7-9	TRBJ2-2
TGCGCCCGCTCCGGAGGACAGCAGTACTTC	CARSGGQQYF	TRBV10-1	TRBJ2-7
TGTGCCAGCAGTGAGGTTTGGGACACTAGACACCACACAGATACGCAGTATTTT	CASSEVWDTRHHTDTQYF	TRBV25-1	TRBJ2-3
TGTGCCAGCAGCAAATACAGGGGTGCCGCCAACACTGAAGCTTTCTTT	CASSKYRGAANTEAFF	TRBV9	TRBJ1-1
TGCGCCAGCAGCTCCCTCGGGGGATACGAGCAGTACTTC	CASSSLGGYEQYF	TRBV5-1	TRBJ2-7
TGTGCCAGTAGTGGAGGGGACAGGGTTAGCTCCTACAATGAGCAGTTCTTC	CASSGGDRVSSYNEQFF	TRBV19	TRBJ2-1
TGTGCCAGCAGCGTTAGAAGGGGGAAGCATAAGTCCTATAATTCACCCCTCCACTTT	CASSVRRGKHKSYNSPLHF	TRBV9	TRBJ1-6
TGTGCCACAGTAGCGGGGGGCCACTACAATGAGCAGTTCTTC	CATVAGGHYNEQFF	TRBV24-1	TRBJ2-1
TGTGCCAGCAGTTTATGGCACGCAAGAGACAGGGGGAGGGCGTCTGAAGCTTTCTTT	CASSLWHARDRGRASEAFF	TRBV27	TRBJ1-1
TGTGCCAGCAGCTTACCCGTTAATGCCGGGACAGGGGCTGAGGTTGGGGGTAGCAATCAGCCCCAGCATTTT	CASSLPVNAGTGAEVGGSNQPQHF	TRBV7-9	TRBJ1-5
TGTGCCAGCAGTGCGAAGCAGTGGGGGCGGGTCGTGAACACTGAAGCTTTCTTT	CASSAKQWGRVVNTEAFF	TRBV2	TRBJ1-1
TGTGCCAGCAGCCAACTAGACGCGTTTCAGCCCCAGCATTTT	CASSQLDAFQPQHF	TRBV14	TRBJ1-5
TGCAATATCCGGGCCCCCTACAATGAGCAGTTCTTC	CNIRAPYNEQFF	TRBV20-1	TRBJ2-1
TGTGCCAGCAGCCATCCCCCCCCGCCCTATGGCTACACCTTC	CASSHPPPPYGYTF	TRBV14	TRBJ1-2
TGTGCCAGCAGCTCCGGACGGGGGCAACCTCTCAATCAGCCCCAGCATTTT	CASSSGRGQPLNQPQHF	TRBV7-9	TRBJ1-5
TGTGCCAGCAGCAGACGGGGGGAGAACACTGAAGCTTTCTTT	CASSRRGENTEAFF	TRBV7-4	TRBJ1-1
TGTGCCATCAGTGAGGTCCCGGGACAGGGGCCTTCCGGAGACGAGCAGTACTTC	CAISEVPGQGPSGDEQYF	TRBV10-3	TRBJ2-7
TGTGCCAGCAGCTCTTGGGCAGAGAAAAATCAGCCCCAGCATTTT	CASSSWAEKNQPQHF	TRBV7-9	TRBJ1-5
TGTGCCAGCAGTTGGGGCGACACGGCCAACTATGGCTACACCTTC	CASSWGDTANYGYTF	TRBV28	TRBJ1-2
TGTGCCAGCAGCAAAGGGCGGGGGGGGATGGGGGGAGACAACCCCTACGAGCAGTACTTC	CASSKGRGGMGGDNPYEQYF	TRBV7-3	TRBJ2-7
TGTGCCAGCAGCGGGGGGGAAGCAGATACGCAGTATTTT	CASSGGEADTQYF	TRBV25-1	TRBJ2-3
TGTGCCAGCAGTTATTTCGGGCGGACTAGCACAGATACGCAGTATTTT	CASSYFGRTSTDTQYF	TRBV6-2	TRBJ2-3
TGTGCCAGCGGTTCCTCCCCGCAGATGGAGGAGACCCAGTACTTC	CASGSSPQMEETQYF	TRBV6-3	TRBJ2-5
TGTGCCAGCAGGCCCAGCCCGGACGGTGGGTACGAGCAGTACTTC	CASRPSPDGGYEQYF	TRBV12-3	TRBJ2-7
TGTGCCAGCAGCTACCGAGTGGCTGACTGCTACGAGCAGTACTTC	CASSYRVADCYEQYF	TRBV7-8	TRBJ2-7
TGTGCCAGCAGCTTGGGGCGTACGCGGGGCCCTTCACCCCTCCACTTT	CASSLGRTRGPSPLHF	TRBV5-5	TRBJ1-6
TGTGCCAGCAGCTGGGGAGGGAGGACTAATGAAAAACTGTTTTTT	CASSWGGRTNEKLFF	TRBV5-6	TRBJ1-4
TGTGCCAGCAGCGAATGCCCGTTGGGGGCCACCAAAAACATTCAGTACTTC	CASSECPLGATKNIQYF	TRBV14	TRBJ2-4
TGTGCCAGCAGCTTGTCCCTGGGTGTCGTTTCCTACGAGCAGTACTTC	CASSLSLGVVSYEQYF	TRBV5-4	TRBJ2-7
TGTGCCAGCAGTCCTAGGGGGGAAATTCCAACTAATGAAAAACTGTTTTTT	CASSPRGEIPTNEKLFF	TRBV14	TRBJ1-4
TGCAGCGTTCCGGGGGGGGCCCCACCGAACATTCAGTACTTC	CSVPGGAPPNIQYF	TRBV29-1	TRBJ2-4
TGTGCCAGCAGTGACTATGATTGGCAGACCCAGTACTTC	CASSDYDWQTQYF	TRBV6-4	TRBJ2-5
TGCAGTGCTAGGGTACCAAAGGGGGGAGACGAAAACACTGAAGCTTTCTTT	CSARVPKGGDENTEAFF	TRBV20-1	TRBJ1-1
TGTGCCAGCAGTGAAGCGGACCTCTCTGGAAACACCATATATTTT	CASSEADLSGNTIYF	TRBV2	TRBJ1-3
TGTGCCAGCAGCGGGGACACTGAAGCTTTCTTT	CASSGDTEAFF	TRBV7-3	TRBJ1-1
TGTGCCAGCAGTCGACAAGAGACCCAGTACTTC	CASSRQETQYF	TRBV28	TRBJ2-5
TGTGCCAGCAGCCCAGGGGGGGGAAGCAATCAGCCCCAGCATTTT	CASSPGGGSNQPQHF	TRBV13	TRBJ1-5
TGTGCCATTCGGGACGGCGACTACAATGAGCAGTTCTTC	CAIRDGDYNEQFF	TRBV11-3	TRBJ2-1
TGTGCCAGCAGCCAAGATAAGGTAACACTCTGCCTCGAGCAGTACTTC	CASSQDKVTLCLEQYF	TRBV14	TRBJ2-7
TGCAGTGCTAGAGATCTTCTTGGACAGGGCAAGAGCTACGAGCAGTACTTC	CSARDLLGQGKSYEQYF	TRBV20-1	TRBJ2-7
TGTGCCAGTAGGGTGCTCAGACGTAACTATGGCTACACCTTC	CASRVLRRNYGYTF	TRBV19	TRBJ1-2
TGCGCCAGCAGCCCAAATAGGTTTACCTCCTACGAGCAGTACTTC	CASSPNRFTSYEQYF	TRBV4-3	TRBJ2-7
TGTGCCAGCAGCGGACTAGGTCAGTACGAGCAGTACTTC	CASSGLGQYEQYF	TRBV27	TRBJ2-7
TGTGCCAGCAGTGAATGCCAGTCTACCGGGACGGGCTACGAGCAGTACTTC	CASSECQSTGTGYEQYF	TRBV25-1	TRBJ2-7
TGCAGTGCTCCCGGGGGTCTGGATACGCAGTATTTT	CSAPGGLDTQYF	TRBV20-1	TRBJ2-3
TGCAGTGCTACAGTTAATACCGGTGGCTACACCTTC	CSATVNTGGYTF	TRBV20-1	TRBJ1-2
TGCGCCAGCAGCCGCCAGAAGGGGGGGCGGGACGAGCAGTACTTC	CASSRQKGGRDEQYF	TRBV5-1	TRBJ2-7
TGCAGCCCTGGCCGGGACAGTGGCTACACCTTC	CSPGRDSGYTF	TRBV29-1	TRBJ1-2
TGTGCCACCAGTGATTTGCAGCTTCGACTAGGTACAGCTAGCACAGATACGCAGTATTTT	CATSDLQLRLGTASTDTQYF	TRBV24-1	TRBJ2-3
TGTGCCAGCAACGCCCGGGACCCCCCCCTGGAAGCTTTCTTT	CASNARDPPLEAFF	TRBV6-2	TRBJ1-1
TGCGCCAGCAGCTCGTTTGTAGGGGGGCCCGAGGACACCGGGGAGCTGTTTTTT	CASSSFVGGPEDTGELFF	TRBV5-1	TRBJ2-2
TGTGCCAGCAGCCCCTGGACAGGGCCTCGTGAAAAACTGTTTTTT	CASSPWTGPREKLFF	TRBV12-4	TRBJ1-4
TGCGCCAGCAGCCTGGCGGGTCCAAGGTCCGTTGAGGAGACCCAGTACTTC	CASSLAGPRSVEETQYF	TRBV4-1	TRBJ2-5
TGTGCCAGCAGACTAGCGGGAGTGAGTTCTCTAGCCAAAAACATTCAGTACTTC	CASRLAGVSSLAKNIQYF	TRBV27	TRBJ2-4
TGCGCCAGCGCACTAAGCCTCTCTAGCGGGCACACCGGGGAGCTGTTTTTT	CASALSLSSGHTGELFF	TRBV10-1	TRBJ2-2
TGTGCCAGCAGTAGTTACCCCTCGTACGAGCAGTACTTC	CASSSYPSYEQYF	TRBV2	TRBJ2-7
TGTGCCAGGCGGACAGGGGGCGGGGGGAACACTGAAGCTTTCTTT	CARRTGGGGNTEAFF	TRBV19	TRBJ1-1
TGTGCCATACGGGGGGGTATCAGCAATCAGCCCCAGCATTTT	CAIRGGISNQPQHF	TRBV19	TRBJ1-5
TGTGCCAGCAGCTTACCACGGAACAGGGCCCCTGGCTACACCTTC	CASSLPRNRAPGYTF	TRBV11-2	TRBJ1-2
TGTGCCAGCAGCTTAGACCCCAGGGATAACATTCAGTACTTC	CASSLDPRDNIQYF	TRBV13	TRBJ2-4
TGTGCCAGCAGCTTGTACCCGGCTAATAGGAGCTCCTATAATTCACCCCTCCACTTT	CASSLYPANRSSYNSPLHF	TRBV7-4	TRBJ1-6
TGTGCCAGCTCACCACCGGGTGGACTAGCGGGAGACGAGCAGTACTTC	CASSPPGGLAGDEQYF	TRBV18	TRBJ2-7
TGTGCCAGCAGTTACTGGACACAGGGGAGGTGGGGGTCCTACGAGCAGTACTTC	CASSYWTQGRWGSYEQYF	TRBV6-5	TRBJ2-7
TGTGCCAAGTCCCCCAGGGGGCCCAGAGGAAACACCATATATTTT	CAKSPRGPRGNTIYF	TRBV10-3	TRBJ1-3
TGTGCCAGTGGACAGGGAGGTAGATACAATGAGCAGTTCTTC	CASGQGGRYNEQFF	TRBV19	TRBJ2-1
TGCAGCGTTTCCCGGTTTAGCGGGGAGCTGTTTTTT	CSVSRFSGELFF	TRBV29-1	TRBJ2-2
TGTGCCAGTAACCAGGGCCGGCGGAATGGCTACACCTTC	CASNQGRRNGYTF	TRBV19	TRBJ1-2
TGTGCCAGCAGCCCGCGACTAGCGGACAACTACGAGCAGTACTTC	CASSPRLADNYEQYF	TRBV11-2	TRBJ2-7
TGTGCCAGCAGTTTGACGCGGGAGTTGCAGTACTTC	CASSLTRELQYF	TRBV6-3	TRBJ2-7
TGTGCCAGCAGCGGGAGGACAGGGATACAATCCTACGAGCAGTACTTC	CASSGRTGIQSYEQYF	TRBV7-9	TRBJ2-7
TGTGCCAGCAGCTTATTAGCCGACTGTGCTAATGAAAAACTGTTTTTT	CASSLLADCANEKLFF	TRBV7-9	TRBJ1-4
TGTGCCAGCAGTTCGGTATACTACCGGGACGAGCAGTACTTC	CASSSVYYRDEQYF	TRBV6-6	TRBJ2-7
TGTGCCAGCAGGCCCTGGGACAGGGCATTGCTCCCTTTCTTT	CASRPWDRALLPFF	TRBV6-6	TRBJ1-1
TGTGCCTGGAGTGTACCCTGGCAAGGGCCCTCTAATGAAAAACTGTTTTTT	CAWSVPWQGPSNEKLFF	TRBV30	TRBJ1-4
TGTGCCAGCGTGTCACTAGCGGGAGAATGGGGAGAGACCCAGTACTTC	CASVSLAGEWGETQYF	TRBV6-4	TRBJ2-5
TGTGCCAGCAGCAAGTTTGGTCGACTAGCGGGGACAGATACGCAGTATTTT	CASSKFGRLAGTDTQYF	TRBV7-2	TRBJ2-3
TGCGCCAGCAGTGAGTCCCCATACCCCCCCACGGCCCACGGCTACGAGCAGTACTTC	CASSESPYPPTAHGYEQYF	TRBV10-2	TRBJ2-7
TGTGCCAGCAGTTTATCAAAGGAGGACAGGGGAGATACGCAGTATTTT	CASSLSKEDRGDTQYF	TRBV28	TRBJ2-3
TGTGCCAGCTCACCAGAGGAACGGACATTCGGCTACACCTTC	CASSPEERTFGYTF	TRBV18	TRBJ1-2
TGTGCCAGCAGTGGGGGGGAAAACAATGTCTTC	CASSGGENNVF	TRBV6-5	TRBJ2-1
TGTGCTAGCGGGTGGTACGAGCAGTACTTC	CASGWYEQYF	TRBV27	TRBJ2-7
TGTGCCACCAGCCGGTTGAGGCAACGGACTAGCGGGTACGAGCAGTACTTC	CATSRLRQRTSGYEQYF	TRBV15	TRBJ2-7
TGTGCCAGGTCCGACCGCGGAGACAATGAGCAGTTCTTC	CARSDRGDNEQFF	TRBV28	TRBJ2-1
TGTGCCACGTTCTCTAAAAGAACTGATTCACCCCTCCACTTT	CATFSKRTDSPLHF	TRBV24-1	TRBJ1-6
TGTGCCACCAGTGATTGGGGGAGGAACACTGAAGCTTTCTTT	CATSDWGRNTEAFF	TRBV24-1	TRBJ1-1
TGTGCCAGCAGTGCCAGACAGGGGCTTTACAATGAGCAGTTCTTC	CASSARQGLYNEQFF	TRBV6-1	TRBJ2-1
TGTGCCAGCAGCCGGGCGCGTCAGCCCCAGCATTTT	CASSRARQPQHF	TRBV9	TRBJ1-5
TGTGCCAGCAGCCAAGAATCTTGGGGGGACTGGACAGGGTCTAATTCACCCCTCCACTTT	CASSQESWGDWTGSNSPLHF	TRBV14	TRBJ1-6
TGTGCCAGCAGCTTCCAGGGGCTACGGCGATCCTACGAGCAGTACTTC	CASSFQGLRRSYEQYF	TRBV7-3	TRBJ2-7
TGCAGCGTTGCCCCGGGACAGGGGAACTATGGCTACACCTTC	CSVAPGQGNYGYTF	TRBV29-1	TRBJ1-2
TGTGCCAGCAGCTTGCCTTTGGTCTACAGAGAGACCCAGTACTTC	CASSLPLVYRETQYF	TRBV5-8	TRBJ2-5
TGCGCCAGCAGCTTGGAGGGGTATGACAGGGCGGATCTATGGAACACTGAAGCTTTCTTT	CASSLEGYDRADLWNTEAFF	TRBV5-1	TRBJ1-1
TGTGCCAGCAGCGTATACGGGGGCAATGACTACGAGCAGTACTTC	CASSVYGGNDYEQYF	TRBV9	TRBJ2-7
TGTGCCAGCAGGGGACATGGCTACACCTTC	CASRGHGYTF	TRBV18	TRBJ1-2
TGCAGTGCTACGGGACTAAACGAGCAGTACTTC	CSATGLNEQYF	TRBV20-1	TRBJ2-7
TGCGCCAGCAGCTTGGGGTGGACAGGGGGCCAAGAGACCCAGTACTTC	CASSLGWTGGQETQYF	TRBV5-1	TRBJ2-5
TGTGCCAGCAGACTAGCGGGAGGATATGAGCAGTTCTTC	CASRLAGGYEQFF	TRBV6-5	TRBJ2-1
TGTGCCAGCTTACCCCCCACTAGCGGGAGTAGGGAGACCCAGTACTTC	CASLPPTSGSRETQYF	TRBV9	TRBJ2-5
TGTGCCACCAGTGACCTTCAGGACAGGTACCAAGAGACCCAGTACTTC	CATSDLQDRYQETQYF	TRBV24-1	TRBJ2-5
TGCGCCAGCCCGGGACTAGCGGGGTTCCACAATGAGCAGTTCTTC	CASPGLAGFHNEQFF	TRBV4-1	TRBJ2-1
TGCGCCAGCACGGACGAAAGGAAGGCCTACGAGCAGTACTTC	CASTDERKAYEQYF	TRBV10-2	TRBJ2-7
TGTGCCAGCAGCGGGAGGACAGGGGGCGCAGGTGAGCAGTACTTC	CASSGRTGGAGEQYF	TRBV7-9	TRBJ2-7
TGCGCCAGCAGCCGCAGGGGCCCCAACTACGAGCAGTACTTC	CASSRRGPNYEQYF	TRBV4-3	TRBJ2-7
TGCGCCGAGGGGGTATCCTACGAGCAGTACTTC	CAEGVSYEQYF	TRBV4-1	TRBJ2-7
TGTGCCAGCAGCTTGGAGAATCAGGGCTGCATGAACACTGAAGCTTTCTTT	CASSLENQGCMNTEAFF	TRBV5-6	TRBJ1-1
TGTGCTAGTGGTTTGGGGCCCTCACGCTACCCTCAGGGTCTCCGGGGGCGCAATCAGCCCCAGCATTTT	CASGLGPSRYPQGLRGRNQPQHF	TRBV12-5	TRBJ1-5
TGTGCCAGCACATCCTCGAGGACGGAAGGGGGACACACTGAAGCTTTCTTT	CASTSSRTEGGHTEAFF	TRBV7-9	TRBJ1-1
TGTGCCAGCAGTTTCCACAGTAGAAATCAGCCCCAGCATTTT	CASSFHSRNQPQHF	TRBV27	TRBJ1-5
TGTGCCATCAGTGAGTCGGAAAAGGGAGGTGGAGGACCATACGAGCAGTACTTC	CAISESEKGGGGPYEQYF	TRBV10-3	TRBJ2-7
TGCAGCGTTGAACCGGGACACTACGAGCAGTACTTC	CSVEPGHYEQYF	TRBV29-1	TRBJ2-7
TGTGCCAGCAGCGCCCCCTCAGGAGGACCCTCACCCCTCCACTTT	CASSAPSGGPSPLHF	TRBV7-2	TRBJ1-6
TGTGCCAGAGGGACAGGGGGCTTCCTCACCGGGGAGCTGTTTTTT	CARGTGGFLTGELFF	TRBV6-4	TRBJ2-2
TGTGCCAGCAGTGTATACGAACAGGCGAACACCGGGGAGCTGTTTTTT	CASSVYEQANTGELFF	TRBV25-1	TRBJ2-2
TGCGCCAGCCACCCAGGACAACGGGTGCAGCCCCAGCATTTT	CASHPGQRVQPQHF	TRBV5-1	TRBJ1-5
TGCAGCGTTGACTCGACAGGGTTTCCGAAGTCCTACGAGCAGTACTTC	CSVDSTGFPKSYEQYF	TRBV29-1	TRBJ2-7
TGTGCCAGCAGCAAAGAGGGGCCCGAGCAGTACTTC	CASSKEGPEQYF	TRBV9	TRBJ2-7
TGTGCCAGCAGCCGTAGCGGGTACTACAATGAGCAGTTCTTC	CASSRSGYYNEQFF	TRBV7-6	TRBJ2-1
TGTGCCAGCAGTTTCGACGCCGGGACCTCTGGAAACACCATATATTTT	CASSFDAGTSGNTIYF	TRBV6-5	TRBJ1-3
TGCAGCGTTGTAGAGGCAGGGCCGAACTATGGCTACACCTTC	CSVVEAGPNYGYTF	TRBV29-1	TRBJ1-2
TGTGCCAGCAGTGGGGGCGGGGCCTCTGGAAACACCATATATTTT	CASSGGGASGNTIYF	TRBV6-4	TRBJ1-3
TGTGCCAGCAGTCGCCCCTTCGGGGAGACCGAGCAGTTCTTC	CASSRPFGETEQFF	TRBV6-1	TRBJ2-1
TGTGCCAGCTCACCCACCGGGACAGTGAGGAACACTGAAGCTTTCTTT	CASSPTGTVRNTEAFF	TRBV18	TRBJ1-1
TGTGCCAGCAGCTTAGCCGATAGCGGGGGTCAATCCTACGAGCAGTACTTC	CASSLADSGGQSYEQYF	TRBV11-3	TRBJ2-7
TGCAGTGCTAGAGATACTGCACGCCTAAATGAGCAGTTCTTC	CSARDTARLNEQFF	TRBV20-1	TRBJ2-1
TGTGCCAGCAGCCGCCGAACGGTAGCAACGGGACGTGGGGGGAGCTCCTATAATTCACCCCTCCACTTT	CASSRRTVATGRGGSSYNSPLHF	TRBV6-1	TRBJ1-6
TGTGCCAGCAGCAGAGGACTAGCGGGAGAAGGGTATACCGGGGAGCTGTTTTTT	CASSRGLAGEGYTGELFF	TRBV7-2	TRBJ2-2
TGTGCCTGGAGAGGCCCCAGACCCAGCAATTACGAGCAGTACTTC	CAWRGPRPSNYEQYF	TRBV30	TRBJ2-7
TGTGCCAGCAGTTTCCCCACAGATGCCGTACAAGAGACCCAGTACTTC	CASSFPTDAVQETQYF	TRBV12-4	TRBJ2-5
TGCAGTGCTAGAGGATTGATCCGGGGTACAGATACGCAGTATTTT	CSARGLIRGTDTQYF	TRBV20-1	TRBJ2-3
TGTGCCAGTAGTATGGGACAGGGCCGAGCTACAGATACGCAGTATTTT	CASSMGQGRATDTQYF	TRBV19	TRBJ2-3
TGTGCCAGCAGCTTAGTATTAAGGGGCTCTGAGCAGTACTTC	CASSLVLRGSEQYF	TRBV11-3	TRBJ2-7
TGTGCCAGCAGTCCACGGGTTGGACAGGGAACCCAGCATTTT	CASSPRVGQGTQHF	TRBV6-2	TRBJ1-5
TGCGCCAGCAGCCAAGATCACCTTAAGGCCTACGAGCAGTACTTC	CASSQDHLKAYEQYF	TRBV4-1	TRBJ2-7
TGTGCCAGCAGCTTATCCCCCCAACACGGACTAGCGGGCCACAATGAGCAGTTCTTC	CASSLSPQHGLAGHNEQFF	TRBV7-9	TRBJ2-1
TGCGCCAGCAGCCCAAAAAGTATGTTAGAGACCCAGTACTTC	CASSPKSMLETQYF	TRBV4-3	TRBJ2-5
TGTGCCAGCAGCCCCCGAAATGCGTACAATGAGCAGTTCTTC	CASSPRNAYNEQFF	TRBV7-3	TRBJ2-1
TGTGCCAGCAGCTTTAAGACAGGGGTTGAGAGTTGCGAGCAGTACTTC	CASSFKTGVESCEQYF	TRBV11-3	TRBJ2-7
TGTGCCAGCAGCTCTAATCCGGGGGGAGTGCAGTACTTC	CASSSNPGGVQYF	TRBV9	TRBJ2-7
TGTGCCAGCAGCTTTTCCGTAGGAGCGGATAGGAATGAGCAGTTCTTC	CASSFSVGADRNEQFF	TRBV7-4	TRBJ2-1
TGCGCCAGCAGAACGGTAAATAATTCACCCCTCCACTTT	CASRTVNNSPLHF	TRBV10-1	TRBJ1-6
TGTGCCAGCAGTTACACCGGGACACACTCCTACGAGCAGTACTTC	CASSYTGTHSYEQYF	TRBV6-3	TRBJ2-7
TGCGCCAGCAGCATGGACAGCGACTTTACGGAGGGAGAGACCCAGTACTTC	CASSMDSDFTEGETQYF	TRBV5-1	TRBJ2-5
TGCGCCAGCAGCACCCGGGCTGGAAACACCATATATTTT	CASSTRAGNTIYF	TRBV5-1	TRBJ1-3
TGCAGTGCTACCGGGACTAGCCAAAGCTCCTACAATGAGCAGTTCTTC	CSATGTSQSSYNEQFF	TRBV20-1	TRBJ2-1
TGCAGTGCTCGAAAAGATACGCAGTATTTT	CSARKDTQYF	TRBV20-1	TRBJ2-3
TGCGCCAGCAGCTTGTCCGCTACCAATGAGCAGTTCTTC	CASSLSATNEQFF	TRBV5-1	TRBJ2-1
TGCAGTGCTAGAGATGTAATCGCTAGCGGGAATAAGCAGTTCTTC	CSARDVIASGNKQFF	TRBV20-1	TRBJ2-1
TGTGCCAGCAGATACAGGGGTCCGGATCATTCACCCCTCCACTTT	CASRYRGPDHSPLHF	TRBV7-9	TRBJ1-6
TGTGCCAGCAGCAAGACTAGCGGGTGTTTAGCTCACAATGAGCAGTTCTTC	CASSKTSGCLAHNEQFF	TRBV11-2	TRBJ2-1
TGTGCCAGCAACCCCGGAGGGGCGCATGGGTATGGCTACACCTTC	CASNPGGAHGYGYTF	TRBV7-3	TRBJ1-2
TGTGCCAGCAGCGACTTGACAGGGTATGGCTACACCTTC	CASSDLTGYGYTF	TRBV3-1	TRBJ1-2
TGTGCCAGCATAGCAGGGAGGGATGGCTACACCTTC	CASIAGRDGYTF	TRBV14	TRBJ1-2
TGTGCCAGCAGTTGGGGACTAGGTCCCAGGGAAGAGACCCAGTACTTC	CASSWGLGPREETQYF	TRBV27	TRBJ2-5
TGTGCCAGCAGCAGACAGGGCGGATCAGAGACCCAGTACTTC	CASSRQGGSETQYF	TRBV7-7	TRBJ2-5
TGTGCCACCAGTGATTTCCTGCGGGAGAGCTATGGCTACACCTTC	CATSDFLRESYGYTF	TRBV24-1	TRBJ1-2
TGTGCCAGCAGCTTGGGACTAGCGGGAGCCTACGAGCAGTACTTC	CASSLGLAGAYEQYF	TRBV5-6	TRBJ2-7
TGCGCCAGCAGCCTCGGGCCCTACACTGAAGCTTTCTTT	CASSLGPYTEAFF	TRBV4-3	TRBJ1-1
TGTGCCACCAGTGATTTGTGTCTCAGGGGGAGGAACACTGAAGCTTTCTTT	CATSDLCLRGRNTEAFF	TRBV24-1	TRBJ1-1
TGTGATGTTCAGCCGAATTCACCCCTCCACTTT	CDVQPNSPLHF	TRBV27	TRBJ1-6
TGTGCCAGCAGTGACTCGGACCCGAAAGGACAGGGGACCGACACTGAAGCTTTCTTT	CASSDSDPKGQGTDTEAFF	TRBV6-4	TRBJ1-1
TGTGCCAGCAGCGTAGCTCGACAGTGCGATTCCTACGAGCAGTACTTC	CASSVARQCDSYEQYF	TRBV9	TRBJ2-7
TGTGCCAGCAGCTTTATAGACTTTAGGGGGGGCTCCTATAATTCACCCCTCCACTTT	CASSFIDFRGGSYNSPLHF	TRBV11-3	TRBJ1-6
TGTGCCAGCAGCGGGAAATTTCAGCCCCAGCATTTT	CASSGKFQPQHF	TRBV5-6	TRBJ1-5
TGTGCCAGCAGTTTAGTTATAGCGGGAGGGGGTGAAGCTTTCTTT	CASSLVIAGGGEAFF	TRBV27	TRBJ1-1
TGTGCCAGCAGCGGGGGGAGGAACACTGAAGCTTTCTTT	CASSGGRNTEAFF	TRBV7-6	TRBJ1-1
TGCAGTGCTAGAGAATTCGGGAGGAGGGACTATTTT	CSAREFGRRDYF	TRBV20-1	TRBJ1-3
TGTGCCAGCAGCCAGCGGACGGCGCTGAACACTGAAGCTTTCTTT	CASSQRTALNTEAFF	TRBV7-2	TRBJ1-1
TGTGCCAGAGCCAGGGGCTTACTTAATAATTCACCCCTCCACTTT	CARARGLLNNSPLHF	TRBV7-2	TRBJ1-6
TGTGCCAGTAGCCTGGGGCGTCGGTATAGTGCAACTAATGAAAAACTGTTTTTT	CASSLGRRYSATNEKLFF	TRBV19	TRBJ1-4
TGTGCCAGCAGCTTAGAAGGGCGATGGACTAATCAGCCCCAGCATTTT	CASSLEGRWTNQPQHF	TRBV13	TRBJ1-5
TGTGCCAGCAGTCCACCGGGCTTCAAAAACATTCAGTACTTC	CASSPPGFKNIQYF	TRBV28	TRBJ2-4
TGCAGGACAGATCAGCCCCAGCATTTT	CRTDQPQHF	TRBV20-1	TRBJ1-5
TGTGCCACCCAAACGGGGGGACAGGGGAGCTCCTACGAGCAGTACTTC	CATQTGGQGSSYEQYF	TRBV24-1	TRBJ2-7
TGTGCCAGTAGTACTGCCCTTTACAATGAGCAGTTCTTC	CASSTALYNEQFF	TRBV6-5	TRBJ2-1
TGTGCCAGCATCCCTTCAACGAGGGGGGCGGGTGGCTACACCTTC	CASIPSTRGAGGYTF	TRBV6-3	TRBJ1-2
TGTGCCAGCAGCTTGGGAGGGGGGAGACTCTCCTACGAGCAGTACTTC	CASSLGGGRLSYEQYF	TRBV7-3	TRBJ2-7
TGCGCCAGCAGTGCAAAACTTGGGGTAGTCAATCAGCCCCAGCATTTT	CASSAKLGVVNQPQHF	TRBV10-1	TRBJ1-5
TGTGCCAGCAGCTGGAAGGGGACATACGAGCAGTACTTC	CASSWKGTYEQYF	TRBV13	TRBJ2-7
TGTGCCAGCAGTGCAAACCAGGAGGGGGGGACCTACGAGCAGTACTTC	CASSANQEGGTYEQYF	TRBV6-1	TRBJ2-7
TGTGCCAGCAGCTCTCAGGACGTTCGGATGAACACTGAAGCTTTCTTT	CASSSQDVRMNTEAFF	TRBV7-9	TRBJ1-1
TGTGCCAGCAGACATCTCCCCGAGAACCGGTACGAGCAGTACTTC	CASRHLPENRYEQYF	TRBV27	TRBJ2-7
TGTGCCAGCAGTGAGGCACTAGCGGGGGGGCCGCCAAGTTGGGGTACGCAGTATTTT	CASSEALAGGPPSWGTQYF	TRBV6-1	TRBJ2-3
TGCGCCAGCAGCTTGGTCCCTAGCGGGAACTACGAGCAGTACTTC	CASSLVPSGNYEQYF	TRBV5-1	TRBJ2-7
TGTGCCAGCAGCTTGGGGGCGATTTTGGGCAATCAGCCCCAGCATTTT	CASSLGAILGNQPQHF	TRBV5-8	TRBJ1-5
TGTGCCAGTAGTATAGAGCGGCCGGGACAGGGCGGGAATGAAAAACTGTTTTTT	CASSIERPGQGGNEKLFF	TRBV19	TRBJ1-4
TGCAGCGTTCCCTGGCCTAAGGGGGGGAAGGAATACGAGCAGTACTTC	CSVPWPKGGKEYEQYF	TRBV29-1	TRBJ2-7
TGTGCCAGTCCCGGGACTAGCGGGGTTGACAATGAGCAGTTCTTC	CASPGTSGVDNEQFF	TRBV5-4	TRBJ2-1
TGTGCCATCAGTGAGTCGCTACAGGGACATGAGACCCAGTACTTC	CAISESLQGHETQYF	TRBV10-3	TRBJ2-5
TGTGCCAGCAGATTAAGTATCCGCCGGAGGAACGAGCAGTACTTC	CASRLSIRRRNEQYF	TRBV7-2	TRBJ2-7
TGTGCCAGCAGCTTAACAGACAGGAGGAATGAGCAGTTCTTC	CASSLTDRRNEQFF	TRBV11-3	TRBJ2-1
TGTGCCAGCAGCAGGCGGACAGATACTCCCACTGAAGCTTTCTTT	CASSRRTDTPTEAFF	TRBV13	TRBJ1-1
TGCGCCAGCAGCCAAGGGTTCGGGACAGGGGGTGAAGCTTTCTTT	CASSQGFGTGGEAFF	TRBV4-1	TRBJ1-1
TGTGCCAGCAGCTCAAATGGGCCGGGACAGGGCGGGAGGTTTGGCTACACCTTC	CASSSNGPGQGGRFGYTF	TRBV13	TRBJ1-2
TGTGCCAGCAGTTGTTACCCCCCGGGACAAAGAGAAAAACTGTTTTTT	CASSCYPPGQREKLFF	TRBV27	TRBJ1-4
TGTGCCAGCAGTTACGCCCGAGTTAGGGAGCAGTACTTC	CASSYARVREQYF	TRBV6-5	TRBJ2-7
TGTGCCAGCAGCGGCAGCTCCTACAATGAGCAGTTCTTC	CASSGSSYNEQFF	TRBV7-3	TRBJ2-1
TGTGCCAGCGGAGATGGCTACACCTTC	CASGDGYTF	TRBV7-9	TRBJ1-2
TGTGCCACCAGTGATTTGGAGCCCTCCCCTAGTGGGGGCGCGGACGCTTTCTTT	CATSDLEPSPSGGADAFF	TRBV24-1	TRBJ1-1
TGCAGTGCTCAACCGGTTTGCTACGAGCAGTACTTC	CSAQPVCYEQYF	TRBV20-1	TRBJ2-7
TGTGCCAGCAGCCAAGTTCCATATGGGGCCTACGAGCAGTACTTC	CASSQVPYGAYEQYF	TRBV3-1	TRBJ2-7
TGCAGTGCTAGTTCAGGAGCCCCAAATTCACCCCTCCACTTT	CSASSGAPNSPLHF	TRBV20-1	TRBJ1-6
TGTGCCACCCGGGGCACAGATACGCAGTATTTT	CATRGTDTQYF	TRBV19	TRBJ2-3
TGTGCCACCCGGCACAGCAGCTACTCTGGAAACACCATATATTTT	CATRHSSYSGNTIYF	TRBV28	TRBJ1-3
TGTGCCTGGAGAACGTCCGGGGACAGCCCGGGTGGCTACACCTTC	CAWRTSGDSPGGYTF	TRBV30	TRBJ1-2
TGTGCCAGTAGTATAGCGGAGGACTATGGCTACACCTTC	CASSIAEDYGYTF	TRBV19	TRBJ1-2
TGTGCCAGCAGCTTATCTGACAGGAGTGGCTACACCTTC	CASSLSDRSGYTF	TRBV11-2	TRBJ1-2
TGTGCCAGCAGCTTGTCGGGGACAGGGGGAAACACCATATATTTT	CASSLSGTGGNTIYF	TRBV5-4	TRBJ1-3
TGCGCCAGCAGCTTGGCCCTCCTCCCAGTAAGCAATCAGCCCCAGCATTTT	CASSLALLPVSNQPQHF	TRBV5-1	TRBJ1-5
TGTGCCCGAAGGGGACAGGCGTGGATCTACGAGCAGTACTTC	CARRGQAWIYEQYF	TRBV2	TRBJ2-7
TGTGCCAGCAGGGGGACAGTAACCTACGAGCAGTACTTC	CASRGTVTYEQYF	TRBV27	TRBJ2-7
TGTGCCAGCACGGGCAATCTAGGGGCCAACGTCCTGACTTTC	CASTGNLGANVLTF	TRBV18	TRBJ2-6
TGTGCCAGCAGCTTGGGGAGGTCTAGCGGGCCGAAGGAGACCCAGTACTTC	CASSLGRSSGPKETQYF	TRBV5-6	TRBJ2-5
TGTGCCAGCAGCTTAACAGGGGGCTCTGTTTGCACGACCCAGTACTTC	CASSLTGGSVCTTQYF	TRBV7-9	TRBJ2-5
TGTGCCAGCGCCGGGGGGATCGGGGAGCTGTTTTTT	CASAGGIGELFF	TRBV5-4	TRBJ2-2
TGTGTTTCCTGGAGGGGTGATCGGGAGACCCAGTACTTC	CVSWRGDRETQYF	TRBV5-4	TRBJ2-5
TGTGCCAGCAGCGTAAAGGAGACTTTTACAGCCAAAAACATTCAGTACTTC	CASSVKETFTAKNIQYF	TRBV13	TRBJ2-4
TGTGCCAGCAGCTTGAGCGGGTCTTTCTTC	CASSLSGSFF	TRBV14	TRBJ2-1
TGTGCCACCTCCCAGACCTCTGGAAACACCATATATTTT	CATSQTSGNTIYF	TRBV24-1	TRBJ1-3
TGCGCCAGGTGGGCGGGGTTAGAGAGCTCCTACGAGCAGTACTTC	CARWAGLESSYEQYF	TRBV5-1	TRBJ2-7
TGTGCCAGCAGTTGTGCAGGGAAGTTACTTGGTTCGGTAAACACCATATATTTT	CASSCAGKLLGSVNTIYF	TRBV27	TRBJ1-3
TGTGCCAGCAGTCACGGGGGGGCGGGGGTCACAGATACGCAGTATTTT	CASSHGGAGVTDTQYF	TRBV6-5	TRBJ2-3
TGTGCAACAGGGGAGCAACAGCCCCAGCATTTT	CATGEQQPQHF	TRBV6-5	TRBJ1-5
TGTGCCAGCAATTCGCAGAGAAGTGGGGACAGGGGTGTTTCGGCTCGCCCGAGGTTTACTGAAGCTTTCTTT	CASNSQRSGDRGVSARPRFTEAFF	TRBV12-3	TRBJ1-1
TGCAGTGCTAGAGCCCCTCCACCGAAACGCACAGATACGCAGTATTTT	CSARAPPPKRTDTQYF	TRBV20-1	TRBJ2-3
TGTGCCAGCAGCCGGAGGACAGGTATCTACGAGCAGTACTTC	CASSRRTGIYEQYF	TRBV27	TRBJ2-7
TGTGCCAGCACGCTGACAGGGGGCTATACGCAGTATTTT	CASTLTGGYTQYF	TRBV11-2	TRBJ2-3
TGCGCCAGCAGCTTGGTACCGGGGCGCTATGGCTACACCTTC	CASSLVPGRYGYTF	TRBV5-1	TRBJ1-2
TGTGCCAGCAGCAGGGGACAGACAGATTTTAGCTCCTATAATTCACCCCTCCACTTT	CASSRGQTDFSSYNSPLHF	TRBV9	TRBJ1-6
TGTGCCAGCAGTCTCTCTTTCGCCGAGTGCAACGAGCAGTACTTC	CASSLSFAECNEQYF	TRBV12-4	TRBJ2-7
TGTGCCAGCAGCCCTACATTAGACGAGCAGTACTTC	CASSPTLDEQYF	TRBV25-1	TRBJ2-7
TGTGCCAGCAGCCAAGATAAACAGGGGAAGGGCTACACCTTC	CASSQDKQGKGYTF	TRBV14	TRBJ1-2
TGTGCCAGCAGCCAAGGGGGCCGGGAATACGAGCAGTACTTC	CASSQGGREYEQYF	TRBV14	TRBJ2-7
TGCGCCAGCAGCGGGCTAGCTTTTGCGAACACTGAAGCTTTCTTT	CASSGLAFANTEAFF	TRBV5-1	TRBJ1-1
TGTGCCAGTAGTATAGATCTACCCGGAACCGGGGGGCCGGGAACAAGGACCGGGGAGCTGTTTTTT	CASSIDLPGTGGPGTRTGELFF	TRBV19	TRBJ2-2
TGCAGTGCTAGAGTGGCAGGGGCAACCGGGGAGCTGTTTTTT	CSARVAGATGELFF	TRBV20-1	TRBJ2-2
TGTGCCAGCAGCTTAGCTCAGGACATCATCTGGTACACAGATACGCAGTATTTT	CASSLAQDIIWYTDTQYF	TRBV7-2	TRBJ2-3
TGCAGTGCTAGTCCCCCTCGGGGGGGGCAAACTAGCACAGATACGCAGTATTTT	CSASPPRGGQTSTDTQYF	TRBV20-1	TRBJ2-3
TGCGCCGTGGGGAGTCAGCCCGGGACCGGGGAGCTGTTTTTT	CAVGSQPGTGELFF	TRBV5-1	TRBJ2-2
TGTGCCAGCAGCGCCGGGACAGCTAATTCACCCCTCCACTTT	CASSAGTANSPLHF	TRBV5-4	TRBJ1-6
TGCGCCAGCAGCGGAGGGGCTGAGGGCTACACCTTC	CASSGGAEGYTF	TRBV5-1	TRBJ1-2
TGTGCCAGCAGCTTCAGGAGGGAAAATTCACCCCTCCACTTT	CASSFRRENSPLHF	TRBV7-3	TRBJ1-6
TGTGCCAGCAGTTTAAGGTGGGCCAGTTGCACCGGGGAGCTGTTTTTT	CASSLRWASCTGELFF	TRBV12-3	TRBJ2-2
TGTGCCAGCTCTTCGGACAGGGCGCCGGATTCACCCCTCCACTTT	CASSSDRAPDSPLHF	TRBV25-1	TRBJ1-6
TGTGCCATCAGGCTCAACGGGACAGGGAATTCACCCCTCCACTTT	CAIRLNGTGNSPLHF	TRBV10-3	TRBJ1-6
TGCGCCAGCAGCTTGGATGGGGGACTAGAGCACATTCAGTACTTC	CASSLDGGLEHIQYF	TRBV5-1	TRBJ2-4
TGTGCCAACCGGGGCCCCTTCGAGACTAGTCCCGTGTACAATGAGCAGTTCTTC	CANRGPFETSPVYNEQFF	TRBV27	TRBJ2-1
TGTGCCAGCAGCCAAGATTCCGCTGACTTACGCTACGAGCAGTACTTC	CASSQDSADLRYEQYF	TRBV14	TRBJ2-7
TGTGCCAGTAGTCGGGACAGTGTATATGGCTACACCTTC	CASSRDSVYGYTF	TRBV19	TRBJ1-2
TGTGCCAGCTCACCAAGGACCGGGGAGCTGTTTTTT	CASSPRTGELFF	TRBV18	TRBJ2-2
TGCAGTGCTCATGGGACAGGAGGAAACACCATATATTTT	CSAHGTGGNTIYF	TRBV20-1	TRBJ1-3
TGCAGTGCTAAAGGACCGTGGCTCGGGGGGGGGTATCGCACAGATACGCAGTATTTT	CSAKGPWLGGGYRTDTQYF	TRBV20-1	TRBJ2-3
TGTGCCAGCCGGGGGAAGCGGGATGACCGTTTGGGAAACACCATATATTTT	CASRGKRDDRLGNTIYF	TRBV18	TRBJ1-3
TGTGCCACCCGAAGACCCCCGGGACACCAGCAGTTCTTC	CATRRPPGHQQFF	TRBV6-5	TRBJ2-1
TGTGCCATCAGTGCCGCGGGGTATCCTAGCACAGATACGCAGTATTTT	CAISAAGYPSTDTQYF	TRBV10-3	TRBJ2-3
TGTGCCAGCAGCTTGGCGCCCGAGGCTTGGGATACGCAGTATTTT	CASSLAPEAWDTQYF	TRBV5-5	TRBJ2-3
TGTGCCAGCAGCCAAGATGAGGGACCGTGTGGAAACACCATATATTTT	CASSQDEGPCGNTIYF	TRBV14	TRBJ1-3
TGTGCATATAGGGGAGGGAATGAGCAGTTCTTC	CAYRGGNEQFF	TRBV6-4	TRBJ2-1
TGTGCCAGCAGCTTGGAAGTAGAGGGCACCGGGGAGCTGTTTTTT	CASSLEVEGTGELFF	TRBV5-6	TRBJ2-2
TGCAGTGCTAGAGGCGTGACCCCGGACGTAGCTGACTATGGCTACACCTTC	CSARGVTPDVADYGYTF	TRBV20-1	TRBJ1-2
TGTGCCAGCAGCCTTGGGCGCGACACTGAAGCTTTCTTT	CASSLGRDTEAFF	TRBV7-3	TRBJ1-1
TGTGCCAGCAGTGCGGAGAGTCCGGAGCAGTACTTC	CASSAESPEQYF	TRBV2	TRBJ2-7
TGTGCCAGCAGCTGCTCTGAGACCCAGTACTTC	CASSCSETQYF	TRBV7-9	TRBJ2-5
TGTGCCAGCAGCGTGGGTTTGCTAGCGGGCCATTACACCGGGGAGCTGTTTTTT	CASSVGLLAGHYTGELFF	TRBV9	TRBJ2-2
TGTGCCAGCAGACCCAGCCGGGGGAAGGAGTACGAGCAGTACTTC	CASRPSRGKEYEQYF	TRBV27	TRBJ2-7
TGTGCCAGCAATCGGTGGGACGGGCGAAGAGATACGCAGTATTTT	CASNRWDGRRDTQYF	TRBV6-1	TRBJ2-3
TGTGCCAGACAGGGGGCCGGCCTCTCCCTCCACTTT	CARQGAGLSLHF	TRBV28	TRBJ1-6
TGTGCCAGCAGTGTAGACAGTTCCTACATTCTTCAAGAGACCCAGTACTTC	CASSVDSSYILQETQYF	TRBV27	TRBJ2-5
TGCAGCGTTGTCCTCCCTGGAGAGGCCGAGCAGTACTTC	CSVVLPGEAEQYF	TRBV29-1	TRBJ2-7
TGTGCCAGCAGCCCCGGGGCGGCGAACACCGGGGAGCTGTTTTTT	CASSPGAANTGELFF	TRBV13	TRBJ2-2
TGTGCCAGCAGCGGGGCTGAGCACACTGAAGCTTTCTTT	CASSGAEHTEAFF	TRBV28	TRBJ1-1
TGTGCCAGCAGTCCCGGAAGGCAGTCTGCCGGTAAAGATACGCAGTATTTT	CASSPGRQSAGKDTQYF	TRBV27	TRBJ2-3
TGCAGTGCTGCCCCTCCAACCACCGGGGAGCTGTTTTTT	CSAAPPTTGELFF	TRBV20-1	TRBJ2-2
TGTGCTAGTGGTTTAGACCTCGCTGGCTACGAGCAGTACTTC	CASGLDLAGYEQYF	TRBV12-5	TRBJ2-7
TGCGCCAGCTTGTCCCCATCGGGGCCGGAAGGCAATCAGCCCCAGCATTTT	CASLSPSGPEGNQPQHF	TRBV10-1	TRBJ1-5
TGTGCCAGCAGGACCGGGACAGGTTACACTGAAGCTTTCTTT	CASRTGTGYTEAFF	TRBV6-5	TRBJ1-1
TGCAGTGCTAGAGATATCCGGGACAGGGGAAAGAGCAATCAGCCCCAGCATTTT	CSARDIRDRGKSNQPQHF	TRBV20-1	TRBJ1-5
TGTGCCAGCAAACTAGCGGGAGTGAGCTACGAGCAGTACTTC	CASKLAGVSYEQYF	TRBV7-2	TRBJ2-7
TGTGCCAGCGGCCTAGGAGGGTGTGAGTATCAGCCCCAGCATTTT	CASGLGGCEYQPQHF	TRBV6-2	TRBJ1-5
TGCGCCAGCAGTGACTATCTAGGGGGCCTCGAGGGCGGCAATCAGCCCCAGCATTTT	CASSDYLGGLEGGNQPQHF	TRBV10-1	TRBJ1-5
TGTGCCAGCAGTTACGTACCGGGAATTAACTATGGCTACACCTTC	CASSYVPGINYGYTF	TRBV6-6	TRBJ1-2
TGTGCCAGCAGTGATCGGGAGTATTCACCCCTCCACTTT	CASSDREYSPLHF	TRBV2	TRBJ1-6
TGTGCCAGCTCACTGGGGAAGGATCAGCCCCAGCATTTT	CASSLGKDQPQHF	TRBV18	TRBJ1-5
TGTGCCAGCAGCTTAACTCCGGGACAGGTTGCTTCTAACTATGGCTACACCTTC	CASSLTPGQVASNYGYTF	TRBV11-2	TRBJ1-2
TGTGCCAGCAGCTCTCGCAGGACGGGTGATACGCAGTATTTT	CASSSRRTGDTQYF	TRBV27	TRBJ2-3
TGTGCCAGCAGCTTATCGGGACTACGACTAGAAAAACTGTTTTTT	CASSLSGLRLEKLFF	TRBV7-6	TRBJ1-4
TGTGCCAGCTCACCCCAACAAAGCAATCAGCCCCAGCATTTT	CASSPQQSNQPQHF	TRBV18	TRBJ1-5
TGCAGCGTCGCGGTCAGCGGGAGAGATGCCTACGAGCAGTACTTC	CSVAVSGRDAYEQYF	TRBV29-1	TRBJ2-7
TGTGCCAGCAGCAGGTCACAGGGCTTAAAACTGTTTTTT	CASSRSQGLKLFF	TRBV2	TRBJ1-4
TGTGCCAGCAGTTACGGCCGTCCCCCTCCCAGGGGAAACACCATATATTTT	CASSYGRPPPRGNTIYF	TRBV6-5	TRBJ1-3
TGTGCCAGCAGCCAAGATCCCCGGGAAAATGGCTACACCTTC	CASSQDPRENGYTF	TRBV14	TRBJ1-2
TGTGCCAGCAAGGGGACAGGAGATCAGCCCCAGCATTTT	CASKGTGDQPQHF	TRBV6-4	TRBJ1-5
TGTGCCAGCAGCCCGCCCCGGGTCTTC	CASSPPRVF	TRBV5-6	TRBJ2-1
TGTGCCAGCGGCCCTCCCTGGGGGGGCAGGGTGAGAAGGCCGCCCTACAATGAGCAGTTCTTC	CASGPPWGGRVRRPPYNEQFF	TRBV6-5	TRBJ2-1
TGTGCTAGTGGTTCTTCAGGTACAGGGGGCGGGTCGGGCTACACCTTC	CASGSSGTGGGSGYTF	TRBV12-5	TRBJ1-2
TGCAGTGCACGACTAGCGGGGAAGAACTACGAGCAGTACTTC	CSARLAGKNYEQYF	TRBV20-1	TRBJ2-7
TGTGCCAGCAGTTTTACCGGGACAGAAGACCAAACCTCTGGGGCCAACGTCCTGACTTTC	CASSFTGTEDQTSGANVLTF	TRBV28	TRBJ2-6
TGTGCCACCAGTGTAAGACCGGCGGCGAAGGGCTACACTGAAGCTTTCTTT	CATSVRPAAKGYTEAFF	TRBV24-1	TRBJ1-1
TGTGCCACGGGGAACCGGATGTACCATAGCAATCAGCCCCAGCATTTT	CATGNRMYHSNQPQHF	TRBV19	TRBJ1-5
TGTGCCAGCAGAGCGAGGGGCACAGATACGCAGTATTTT	CASRARGTDTQYF	TRBV28	TRBJ2-3
TGTGCCAGCAGCTTAAAGAAGGGCCAAAAGCCCCAGCATTTT	CASSLKKGQKPQHF	TRBV7-2	TRBJ1-5
TGCGCCAGCAGCTTGCCCAGTGGGACTAGCGGGGAGGGCTACGAGCAGTACTTC	CASSLPSGTSGEGYEQYF	TRBV5-1	TRBJ2-7
TGTGCCAGCAGCGTAGCTTCGACAGGGGGTGTTGGGCAGTACTTC	CASSVASTGGVGQYF	TRBV9	TRBJ2-7
TGCAGTGAGTTGACTAGCGGGAATGAGAGCTCCTACGAGCAGTACTTC	CSELTSGNESSYEQYF	TRBV20-1	TRBJ2-7
TGTGCCAGCAGCGTCACGAGGGGGGGGGGCGCTGAAGCTTTCTTT	CASSVTRGGGAEAFF	TRBV9	TRBJ1-1
TGCGCCAGCAGCCCCCGACAGATACTGAACACTGAAGCTTTCTTT	CASSPRQILNTEAFF	TRBV4-1	TRBJ1-1
TGCGCCAGCAGCTTGGCTAATTGCCCCGGGTGCCAAGAGACCCAGTACTTC	CASSLANCPGCQETQYF	TRBV5-1	TRBJ2-5
TGTGCCAGCAGTTACTCGAGGTCGGGACAGGGGGGGTCCTACGAGCAGTACTTC	CASSYSRSGQGGSYEQYF	TRBV6-5	TRBJ2-7
TGTGCCAGCAGGTCGGGGGTCGTCACAGATACGCAGTATTTT	CASRSGVVTDTQYF	TRBV28	TRBJ2-3
TGTGCCAGCCCCCAGGAGACTAGCGGGAGCGGATTCGTAAAGCTGGGTAGTGAAGCTTTCTTT	CASPQETSGSGFVKLGSEAFF	TRBV12-4	TRBJ1-1
TGTGCCAGCAGCTTAGTTCCAGACGCGGGGAACGAGCAGTACTTC	CASSLVPDAGNEQYF	TRBV11-3	TRBJ2-7
TGTGCCAGCACCGTGGGACAGGGTACCAATAATCAGCCCCAGCATTTT	CASTVGQGTNNQPQHF	TRBV6-4	TRBJ1-5
TGCGCCACAGTACACGGCGGCCGGTACACTGAAGCTTTCTTT	CATVHGGRYTEAFF	TRBV10-1	TRBJ1-1
TGTGCCAGCAGCTTCTTCGCAGGGACTAGCGGGGGGGCGCACTCCTACGAGCAGTACTTC	CASSFFAGTSGGAHSYEQYF	TRBV7-6	TRBJ2-7
TGTGCCAGCAGTGCACAGGTGAACTACGAGCAGTACTTC	CASSAQVNYEQYF	TRBV12-3	TRBJ2-7
TGTGCACGCGGACAGGGGGCTAAACGGAACAATGAGCAGTTCTTC	CARGQGAKRNNEQFF	TRBV2	TRBJ2-1
TGTGCCAGCAGCCGTCAAACCAACACCATATATTTT	CASSRQTNTIYF	TRBV9	TRBJ1-3
TGTGCCAGCAGTTTGAAATTCAGGGCCCAAGAGACCCAGTACTTC	CASSLKFRAQETQYF	TRBV12-3	TRBJ2-5
TGTGCCAGCAGCCACTGCCTAGCGGAATATGAGCAGTTCTTC	CASSHCLAEYEQFF	TRBV4-2	TRBJ2-1
TGTGCCAGCAGCGTATACGGACCACGTAATGAAAAACTGTTTTTT	CASSVYGPRNEKLFF	TRBV9	TRBJ1-4
TGTGCCAGCAGTTTAAATGTAGCCGGGACGGGGGGCACAGATACGCAGTATTTT	CASSLNVAGTGGTDTQYF	TRBV27	TRBJ2-3
TGTGCCAGCAGCCAATTTGGGCCCGAGGGCTATGGCTACACCTTC	CASSQFGPEGYGYTF	TRBV14	TRBJ1-2
TGTGCCAGCAGCGACAGCATCGAGGGGTACCAAGAGACCCAGTACTTC	CASSDSIEGYQETQYF	TRBV7-3	TRBJ2-5
TGTGCCTGGAAAGGGGGCTTTGGGGTTACCAATCAGCCCCAGCATTTT	CAWKGGFGVTNQPQHF	TRBV30	TRBJ1-5
TGCGCCCCTGTACAGGGATGGAAGGGCTACACCTTC	CAPVQGWKGYTF	TRBV10-2	TRBJ1-2
TGTGCCAGCAGCTTGCAACGGGTTAGATACTCCCTTGAGCAGTACTTC	CASSLQRVRYSLEQYF	TRBV5-8	TRBJ2-7
TGTGCCAGTAAGGGACTCGAGCAGTACTTC	CASKGLEQYF	TRBV27	TRBJ2-7
TGTGCCAGCAGCTGGGGGGCGGCCTTAACCAATGAGCAGTTCTTC	CASSWGAALTNEQFF	TRBV7-2	TRBJ2-1
TGCGCCAGCAGCTCGGGGAGCTCCTACGAGCAGTACTTC	CASSSGSSYEQYF	TRBV5-1	TRBJ2-7
TGTGCCACCCGGGCGACTAGCGGGGGGGCCTTTAATGAGCAGTTCTTC	CATRATSGGAFNEQFF	TRBV24-1	TRBJ2-1
TGTGCCAGTAGTGTTTGGCGTGGGTGGCCTAGCACAGATACGCAGTATTTT	CASSVWRGWPSTDTQYF	TRBV19	TRBJ2-3
TGTGCCAGAAGCCTTGGGGGGACCGAAAACACTGAAGCTTTCTTT	CARSLGGTENTEAFF	TRBV12-3	TRBJ1-1
TGTGCCAGCAGTGACTTCCCCGAAGAGGGAGTAGACACTGAAGCTTTCTTT	CASSDFPEEGVDTEAFF	TRBV6-4	TRBJ1-1
TGCAGTGCTAGAGATGACCCGGGACACCAGCCCCAGCATTTT	CSARDDPGHQPQHF	TRBV20-1	TRBJ1-5
TGTGCCAGCAGCGTAGAAGGGGGCAACTCTGGAAACACCATATATTTT	CASSVEGGNSGNTIYF	TRBV9	TRBJ1-3
TGTGCCAGCAGCTTAACGAGCACTGAAGCTTTCTTT	CASSLTSTEAFF	TRBV7-6	TRBJ1-1
TGTGCCAGCAGCAGGCAGGATAGCAATCAGCCCCAGCATTTT	CASSRQDSNQPQHF	TRBV5-6	TRBJ1-5
TGCGCCAGCAGCTTGCAGGGGGTGGTGGGCGACACCGGGGAGCTGTTTTTT	CASSLQGVVGDTGELFF	TRBV5-1	TRBJ2-2
TGCGCCAGCAAAATAGTTAGAAACTCCTACGAGCAGTACTTC	CASKIVRNSYEQYF	TRBV5-1	TRBJ2-7
TGTGCCAGCCGGGGGCGGGAGGCTTTCTTT	CASRGREAFF	TRBV25-1	TRBJ1-1
