TGTGCCACCTCAGGGCTCTTC	CATSGLF	TRBV24-1	TRBJ2-7
TGTGCCAGCAGTCTACGGACCGTGGGCATCCCCTACGAGCAGTACTTC	CASSLRTVGIPYEQYF	TRBV28	TRBJ2-7
TGCAGCGTTGTTAGGGACGATACAGCAGTGGTAACCGGGGAGCTGTTTTTT	CSVVRDDTAVVTGELFF	TRBV29-1	TRBJ2-2
TGCAGTGCTGTCCAGGGACAGCCGGAGACCCAGTACTTC	CSAVQGQPETQYF	TRBV20-1	TRBJ2-5
TGTGCCAGCAGTTGGTCTTCACACTTAAAGCCCCAGCATTTT	CASSWSSHLKPQHF	TRBV6-5	TRBJ1-5
TGTGCCAGCAGTCGTCGGCCTGGCAATGAGCAGTTCTTC	CASSRRPGNEQFF	TRBV6-1	TRBJ2-1
TGTGCCAGCAGTCAGTCAGATACGCAGTATTTT	CASSQSDTQYF	TRBV2	TRBJ2-3
TGTGCCAGCCAGGGTTGTGATACGCAGTATTTT	CASQGCDTQYF	TRBV9	TRBJ2-3
TGTGCCAGCAGCGGGCCTGGGGGGCTTTGCACTGAAGCTTTCTTT	CASSGPGGLCTEAFF	TRBV13	TRBJ1-1
TGTGCCAGCAGCTTCCCGGCCCAACCAGGGGTAATCAACACTGAAGCTTTCTTT	CASSFPAQPGVINTEAFF	TRBV2	TRBJ1-1
TGTGCCAGCAGGCCTGGGGCGGGATACCCCTATGGCTACACCTTC	CASRPGAGYPYGYTF	TRBV12-3	TRBJ1-2
TGTGCCAGCAGTGACTCTTCCTCTTTGTACAATGAGCAGTTCTTC	CASSDSSSLYNEQFF	TRBV6-4	TRBJ2-1
TGTGCCAGCAGCTTCTGTCACAGGAGAACTGAAGCTTTCTTT	CASSFCHRRTEAFF	TRBV5-4	TRBJ1-1
TGTGCCAGCAGTTTAAAAGCAGGGTGCAAAAACATTCAGTACTTC	CASSLKAGCKNIQYF	TRBV27	TRBJ2-4
TGTGCCAGCAGCTGGGACAGACATAGCAATCAGCCCCAGCATTTT	CASSWDRHSNQPQHF	TRBV7-2	TRBJ1-5
TGCGCCAGCAGCCAAGAATGGGGTCATCCAACCGGGACTAGCGGGGAACGTAGCACAGATACGCAGTATTTT	CASSQEWGHPTGTSGERSTDTQYF	TRBV4-3	TRBJ2-3
TGTGCTAGTGGTTTGGTACGTGGACAGGGGGCCAACGTCCTGACTTTC	CASGLVRGQGANVLTF	TRBV12-5	TRBJ2-6
TGTGCCAGCAGCGTAGCTATAGTTCGGCTCAGGGGCCTGGGCTCCTACAATGAGCAGTTCTTC	CASSVAIVRLRGLGSYNEQFF	TRBV9	TRBJ2-1
TGCTCACATGGGGGCTACACCTTC	CSHGGYTF	TRBV20-1	TRBJ1-2
TGTGCCTGGAGTGTACGGTGCCCGGGACAATGGGTTAGCTCCTATAATTCACCCCTCCACTTT	CAWSVRCPGQWVSSYNSPLHF	TRBV30	TRBJ1-6
TGTGCCAGCACCACCTCAACCGGGGAGCAGTTCTTC	CASTTSTGEQFF	TRBV6-6	TRBJ2-1
TGTGCCACCTCCCGCCCTGCTATACAGGGTCACGAGCAGTACTTC	CATSRPAIQGHEQYF	TRBV24-1	TRBJ2-7
TGTGCCAGCTCACCATACCCGACTAGCGGGGCTGATACGCAGTATTTT	CASSPYPTSGADTQYF	TRBV18	TRBJ2-3
TGCAGTGCTAGATCAGGAAGTAACTATGGCTACACCTTC	CSARSGSNYGYTF	TRBV20-1	TRBJ1-2
TGTGCCAGCAGCCGGGGGTCTGGAAACACCATATATTTT	CASSRGSGNTIYF	TRBV9	TRBJ1-3
TGTGCCAGCAGCTGTAATATACCCTACGAGCAGTACTTC	CASSCNIPYEQYF	TRBV7-4	TRBJ2-7
TGTGCTAGTGGAGCCGACAGGGGAGGTCAGCCCCAGCATTTT	CASGADRGGQPQHF	TRBV12-5	TRBJ1-5
TGTGCCAGCAGGGGGAATATTCGGGAGGAAAATGGCTACACCTTC	CASRGNIREENGYTF	TRBV7-9	TRBJ1-2
TGTGCCACCAGTGTTTCAGACAACGGAGAGCAGTTCTTC	CATSVSDNGEQFF	TRBV24-1	TRBJ2-1
TGCAGTGCTGGTGGAGCTAGTTCAGATTTTTTCGGCTCTGGAAACACCATATATTTT	CSAGGASSDFFGSGNTIYF	TRBV20-1	TRBJ1-3
TGTGCCAGCGGCCAGGGTACTTTACAAGAGACCCAGTACTTC	CASGQGTLQETQYF	TRBV25-1	TRBJ2-5
TGTGCCAGTAGTATAGATTGCCGACTAGCGGGACAGACGAACACCGGGGAGCTGTTTTTT	CASSIDCRLAGQTNTGELFF	TRBV19	TRBJ2-2
TGTGCCAGCAGTTGGGGACAGGACCGCTATAATTCACCCCTCCACTTT	CASSWGQDRYNSPLHF	TRBV12-3	TRBJ1-6
TGTGCCAGCAGTTACTCAGGGGAAAAGAGAGAGACCCAGTACTTC	CASSYSGEKRETQYF	TRBV6-5	TRBJ2-5
TGTGCCAGCAGGGGTTCAGCGGGCCATGGCTACACCTTC	CASRGSAGHGYTF	TRBV28	TRBJ1-2
TGCGCCAGCAGCCCGTCGATGGGCACAGATACGCAGTATTTT	CASSPSMGTDTQYF	TRBV5-1	TRBJ2-3
TGTGCCAGCTCACCACGGTGGGGGGGGCAGTACTTC	CASSPRWGGQYF	TRBV18	TRBJ2-7
TGCAGTGCAACGCTGCGGGTAACCGGGGAGCTGTTTTTT	CSATLRVTGELFF	TRBV20-1	TRBJ2-2
TGTGCCAGCTCACCAGGGAACGCCGGACAACCTAATGAAAAACTGTTTTTT	CASSPGNAGQPNEKLFF	TRBV18	TRBJ1-4
TGTGCCAGCAGAAGACTAACCTCGGAAAGCTACGAGCAGTACTTC	CASRRLTSESYEQYF	TRBV7-9	TRBJ2-7
TGTGCCAGCAGCAGATTTGGGCAGCCCCAGCATTTT	CASSRFGQPQHF	TRBV5-8	TRBJ1-5
TGCGCCAGTCTCGGAGGGGGTAGCAATGAGCAGTTCTTC	CASLGGGSNEQFF	TRBV4-1	TRBJ2-1
TGTGCCAGCAGATGGAGGAGAGACTCTGGGGCCAACGTCCTGACTTTC	CASRWRRDSGANVLTF	TRBV5-6	TRBJ2-6
TGCAGTGCGCGTTTGGGGCGGGAGACCCAGTACTTC	CSARLGRETQYF	TRBV20-1	TRBJ2-5
TGTGCCAGCAGTTTATCGGGTTTGCGGGGCACAGATACGCAGTATTTT	CASSLSGLRGTDTQYF	TRBV27	TRBJ2-3
TGTGCCAGCAGCTGCCCCAACTGGGAGACCCAGTACTTC	CASSCPNWETQYF	TRBV7-8	TRBJ2-5
TGCGCCAGCAGCACTCTAGGACGACAGTGGAGTACTCAGCCCCAGCATTTT	CASSTLGRQWSTQPQHF	TRBV5-1	TRBJ1-5
TGTGCCAGCAGCTTTCGCCGACGAAACACCATATATTTT	CASSFRRRNTIYF	TRBV5-4	TRBJ1-3
TGCAGTGCTGGCAGGGAGCCCCTGCCCTACGAGCAGTACTTC	CSAGREPLPYEQYF	TRBV20-1	TRBJ2-7
TGTGCCAGCAGCTTAGCCCCAGGGCCGAATCAGCCCCAGCATTTT	CASSLAPGPNQPQHF	TRBV7-8	TRBJ1-5
TGTGCCATGTATCCGGGGGGCCAACACACCGGGGAGCTGTTTTTT	CAMYPGGQHTGELFF	TRBV12-4	TRBJ2-2
TGTGCCACCAGTGATTTGCAGAGTGGCTTTTGGAGGGGAGGGAGTTACAATGAGCAGTTCTTC	CATSDLQSGFWRGGSYNEQFF	TRBV24-1	TRBJ2-1
TGCGCCAGCAGGAACAGCCGGACTTGCACAGATACGCAGTATTTT	CASRNSRTCTDTQYF	TRBV5-1	TRBJ2-3
TGCGCCAGCAGTGAGAAGTATAGCCGAAACACCATATATTTT	CASSEKYSRNTIYF	TRBV10-1	TRBJ1-3
TGTGCCAGCCGGACAGGGGGATCCGAGCAGTACTTC	CASRTGGSEQYF	TRBV7-9	TRBJ2-7
TGCAGTGCTAGCCCCCAAACCACTAGCGGGAGGGGTCGCCGCAAAAACATTCAGTACTTC	CSASPQTTSGRGRRKNIQYF	TRBV20-1	TRBJ2-4
TGTGCCAGCAGCAAACCCAGAGCCCTCCTCAGCTCCTACGAGCAGTACTTC	CASSKPRALLSSYEQYF	TRBV7-4	TRBJ2-7
TGCAGTGCGGGGGACAGGGGCTTAGGAAACACCATATATTTT	CSAGDRGLGNTIYF	TRBV20-1	TRBJ1-3
TGTGCCATCCGTAGAGGTTACAATGAGCAGTTCTTC	CAIRRGYNEQFF	TRBV5-5	TRBJ2-1
TGCGCCAGCAGTGAACCCGGGACAGATCTCAGTCAGCCCCAGCATTTT	CASSEPGTDLSQPQHF	TRBV10-1	TRBJ1-5
TGTGCTAGTGGTTTCAGGACCAACCTAGCGGCCGCAACAGGTTTCTACGAGCAGTACTTC	CASGFRTNLAAATGFYEQYF	TRBV12-5	TRBJ2-7
TGTGCCAGCGCTCATCTAGCGGGGGGCATTCAGTACTTC	CASAHLAGGIQYF	TRBV25-1	TRBJ2-4
TGTGCCAGCCTCAACAGGGTCACAGATACGCAGTATTTT	CASLNRVTDTQYF	TRBV27	TRBJ2-3
TGTGCCAGCAGCGGACAGCTTGATACGCAGTATTTT	CASSGQLDTQYF	TRBV12-3	TRBJ2-3
TGCGCCAGCAGCCGTTCGGGTTCCTACGAGCAGTACTTC	CASSRSGSYEQYF	TRBV4-1	TRBJ2-7
TGTGCCAGCTCACCAACCCTCCCGGGCCGGAGTCGATTCACTGAAGCTTTCTTT	CASSPTLPGRSRFTEAFF	TRBV18	TRBJ1-1
TGTGCCAGCAGTTACCCTAACCGGTCGGAGCCCCAGCATTTT	CASSYPNRSEPQHF	TRBV6-3	TRBJ1-5
TGTGCCAGCAGCCAAGATGGACAGCACCGTGGAGACGAGCAGTACTTC	CASSQDGQHRGDEQYF	TRBV4-2	TRBJ2-7
TGTGCCAGCAGCCAACCGGACACGTACTACAATGAGCAGTTCTTC	CASSQPDTYYNEQFF	TRBV14	TRBJ2-1
TGTGCCAGCAGCTTAGCGGGGGGGGCCCCCGGGGAGCTGTTTTTT	CASSLAGGAPGELFF	TRBV7-4	TRBJ2-2
TGTGCCATCAGTGAGTCCGGAGTCGGGGCTCTCTACGAGCAGTACTTC	CAISESGVGALYEQYF	TRBV10-3	TRBJ2-7
TGTGCCAGATATCAAGAGTTGGACAGTAGAAACACCATATATTTT	CARYQELDSRNTIYF	TRBV6-1	TRBJ1-3
TGTGCTAGTGGTTTGCGAGGGGGGCGGGAAGGGTCTGATACGCAGTATTTT	CASGLRGGREGSDTQYF	TRBV12-5	TRBJ2-3
TGTGCCAGCAGCATGGTGGTTAACAGCGGAAACACCGGGGAGCTGTTTTTT	CASSMVVNSGNTGELFF	TRBV13	TRBJ2-2
TGTGCCAGCACCCACGGGGTCACTGAAGCTTTCTTT	CASTHGVTEAFF	TRBV12-4	TRBJ1-1
TGTGCCCCCCGAAGGAGGGGCACAGATACGCAGTATTTT	CAPRRRGTDTQYF	TRBV19	TRBJ2-3
TGTGCCAGCCCAAAGCAGGGCTACGAGCAGTACTTC	CASPKQGYEQYF	TRBV6-8	TRBJ2-7
TGTGCCAGCGATAGGGACAGCGGTTCGACTAGCGGGAGTCCACACACCGGGGAGCTGTTTTTT	CASDRDSGSTSGSPHTGELFF	TRBV11-3	TRBJ2-2
TGTGCCAGCAGTGCAAAGTCGGGGAGATCCCTATACGAGCAGTACTTC	CASSAKSGRSLYEQYF	TRBV27	TRBJ2-7
TGTGCCAGCAGTTACCATCTGCGAACAGATACGCAGTATTTT	CASSYHLRTDTQYF	TRBV6-5	TRBJ2-3
TGCGCCAGCAGCTTGGGCAGGGGGCAATCACCCCTCCACTTT	CASSLGRGQSPLHF	TRBV5-1	TRBJ1-6
TGTGCCAGCAGCTTAGAAGAGGGGACAGGGGGGGATCAGCCCCAGCATTTT	CASSLEEGTGGDQPQHF	TRBV7-3	TRBJ1-5
TGCAGTGCTCGGACAGGGTCGGATTCACCCCTCCACTTT	CSARTGSDSPLHF	TRBV20-1	TRBJ1-6
TGTGCCTGGAGTGACCAGAAGAACCGACAGGAGATGACCGGGGAGCTGTTTTTT	CAWSDQKNRQEMTGELFF	TRBV30	TRBJ2-2
TGTGCCAGCAGCGTAGAAAGGGGAAGGCGCGCCTACGAGCAGTACTTC	CASSVERGRRAYEQYF	TRBV9	TRBJ2-7
TGTGCCAGCAGTTATATCTATTCCGACTCCCCAGATACGCAGTATTTT	CASSYIYSDSPDTQYF	TRBV6-5	TRBJ2-3
TGTGCCAGCAGTCAGGGGGTTGGCATAACAACGGATAACTATGGCTACACCTTC	CASSQGVGITTDNYGYTF	TRBV6-5	TRBJ1-2
TGCGCCAGCACCAGTACCGGGACGGGACATGAAAAACTGTTTTTT	CASTSTGTGHEKLFF	TRBV10-1	TRBJ1-4
TGTGCCAGCAGCTTACCGGGGACAGGGGATGCTAACAATGAGCAGTTCTTC	CASSLPGTGDANNEQFF	TRBV11-3	TRBJ2-1
TGTGCCAGAGGGAGATCATATGGCTACACCTTC	CARGRSYGYTF	TRBV2	TRBJ1-2
TGCGCCAGCAGCTCTTTGGGGACTAGCGGGGGTACCGGGGAGCTGTTTTTT	CASSSLGTSGGTGELFF	TRBV5-1	TRBJ2-2
TGTGCCAGCAGTTTAAGAGTGCCCCTGCAGGGACATTGGCCGACTCAGCCCCAGCATTTT	CASSLRVPLQGHWPTQPQHF	TRBV27	TRBJ1-5
TGCGCCAGCAGCCCTGGGGGTCACGAGCAGTACTTC	CASSPGGHEQYF	TRBV5-1	TRBJ2-7
TGTGCCAGCAGCGGCCGACAGGGCACCGGGGAGCTGTTTTTT	CASSGRQGTGELFF	TRBV5-4	TRBJ2-2
TGCAGTGCTAGATCGGGACAGGGGATAGGGAACTATGGCTACACCTTC	CSARSGQGIGNYGYTF	TRBV20-1	TRBJ1-2
TGTGCCAGAATCACGGGGGGGAGCCTAGGCTACGAGCAGTACTTC	CARITGGSLGYEQYF	TRBV6-5	TRBJ2-7
TGTGCCAGCAGTTACTTCGTTTGGCAGGGGGGGTTAGATACGCAGTATTTT	CASSYFVWQGGLDTQYF	TRBV6-5	TRBJ2-3
TGTGCCAGCAGCCAAGATGGAACCCTCTTCTCCCGGGACACAGTCTACGAGCAGTACTTC	CASSQDGTLFSRDTVYEQYF	TRBV3-1	TRBJ2-7
TGTGCCAGCAGCTTAGTACTAGCGGGAGGGCAAACAGATACGCAGTATTTT	CASSLVLAGGQTDTQYF	TRBV7-8	TRBJ2-3
TGTGCCAAATATGACGGGACCGGCAATCAGCCCCAGCATTTT	CAKYDGTGNQPQHF	TRBV27	TRBJ1-5
TGCGCCAGCAATTCATTGTCGGGACGCCAACTCACCTATTCACCCCTCCACTTT	CASNSLSGRQLTYSPLHF	TRBV10-1	TRBJ1-6
TGCGCCAGCAGCTTGGAAGACACTGCGTACGGAAATGGTGACACTGAAGCTTTCTTT	CASSLEDTAYGNGDTEAFF	TRBV5-1	TRBJ1-1
TGTGCCAGCAGCTTAGTGAACAGGGCCTGCCACTCGGGTGGGGCCAACGTCCTGACTTTC	CASSLVNRACHSGGANVLTF	TRBV7-3	TRBJ2-6
TGTGCCAGCAGCTGTATGTCATGTCTTGAAGAGACCCAGTACTTC	CASSCMSCLEETQYF	TRBV7-3	TRBJ2-5
TGCGCCAGCGTAAGACAAATTACAGGGGAGAGTTATCAGCCCCAGCATTTT	CASVRQITGESYQPQHF	TRBV5-1	TRBJ1-5
TGTGCCAGCGCGACAGGGCGCGATGAGCAGTTCTTC	CASATGRDEQFF	TRBV6-6	TRBJ2-1
TGTGCCAGCAGCTTAGTATATATGGGGACGCAGTATTTT	CASSLVYMGTQYF	TRBV11-2	TRBJ2-3
TGTGCCAGGCCAAAGAGAACGCCGGGCGGGTACACTGAAGCTTTCTTT	CARPKRTPGGYTEAFF	TRBV7-4	TRBJ1-1
TGTGCTAGCAGCTTAATTAGGACAGGAATAGGGGGAGATGAGCAGTTCTTC	CASSLIRTGIGGDEQFF	TRBV7-7	TRBJ2-1
TGTGCCAGCAAGGGACTGGGACATGGCTACACCTTC	CASKGLGHGYTF	TRBV27	TRBJ1-2
TGTGCCAGCGAGCCAACCGGGACAGAGGAAAACTATGGCTACACCTTC	CASEPTGTEENYGYTF	TRBV28	TRBJ1-2
TGTGCCAGCAGCGGACAGGGGTCTGGAAACACCATATATTTT	CASSGQGSGNTIYF	TRBV7-6	TRBJ1-3
TGCAGTGCTAGTCGGTCCGCAAGGTCAGGCCCTAATGAAAAACTGTTTTTT	CSASRSARSGPNEKLFF	TRBV20-1	TRBJ1-4
TGCGCCAGCACCGGCAGGGCAAGCACAGATACGCAGTATTTT	CASTGRASTDTQYF	TRBV10-2	TRBJ2-3
TGTGCCAGCAGCCGGACAGGGTGGTGGGGTGAGGATGGCTACACCTTC	CASSRTGWWGEDGYTF	TRBV7-9	TRBJ1-2
TGTGCCAACAGGGGGACCACTGAAGCTTTCTTT	CANRGTTEAFF	TRBV6-5	TRBJ1-1
TGTGCCAGCAGCACATCCAGGAAGTCTGAAGCTTTCTTT	CASSTSRKSEAFF	TRBV11-3	TRBJ1-1
TGTGCCAGCTCACCCGAGACTAGCGTGTACGAGCAGTACTTC	CASSPETSVYEQYF	TRBV18	TRBJ2-7
TGTGCCAGTAGTACTCCGTCCGGGGTTAAGGGGGATCAGCCCCAGCATTTT	CASSTPSGVKGDQPQHF	TRBV19	TRBJ1-5
TGCAGTGCCGGAATGGGGACAGGCGCGAACACTGAAGCTTTCTTT	CSAGMGTGANTEAFF	TRBV20-1	TRBJ1-1
TGTGCCAGCAGCTTAGGAGTAAGCGAAGGAAACACCATATATTTT	CASSLGVSEGNTIYF	TRBV11-3	TRBJ1-3
TGTGCCAGCAGCTTTAAATACGAAGCTTTCTTT	CASSFKYEAFF	TRBV9	TRBJ1-1
TGTGCCAGCAGCTACCAGCGGGACCAGCGAAGCGGGGAGCTGTTTTTT	CASSYQRDQRSGELFF	TRBV7-8	TRBJ2-2
TGCGCCAGCAGTGAGTTCACGAGGGTTATTGAGGCCTACGAGCAGTACTTC	CASSEFTRVIEAYEQYF	TRBV10-1	TRBJ2-7
TGTGCCAGCAGCGTAGGGGCCTGCGCGATATTCTATAATTCACCCCTCCACTTT	CASSVGACAIFYNSPLHF	TRBV9	TRBJ1-6
TGTGCCAGCAGACGCCGGGACAGGGGAGGGGCCCATAACATTCAGTACTTC	CASRRRDRGGAHNIQYF	TRBV6-5	TRBJ2-4
TGTGCCAGCAGTGCTTCCCGTGCGGAGGGGGAGATGAACACTGAAGCTTTCTTT	CASSASRAEGEMNTEAFF	TRBV6-4	TRBJ1-1
TGTGCCAGCAGCCTGGGGACTAGCGGGGAGGGAACCTACAATGAGCAGTTCTTC	CASSLGTSGEGTYNEQFF	TRBV7-9	TRBJ2-1
TGTGCCTGGCTTAGGGGTTTCAATCAGCCCCAGCATTTT	CAWLRGFNQPQHF	TRBV30	TRBJ1-5
TGCATTCCTTGCCAGGCGACAGGGAGAGGTAACTATGGCTACACCTTC	CIPCQATGRGNYGYTF	TRBV20-1	TRBJ1-2
TGTGCCAGCAGCCCGCCAGGGGGCGGGACTGAAGCTTTCTTT	CASSPPGGGTEAFF	TRBV11-3	TRBJ1-1
TGTGCCAGCAGCAACCGGCAGGGAATTTTCGAGGTTAATTCACCCCTCCACTTT	CASSNRQGIFEVNSPLHF	TRBV5-4	TRBJ1-6
TGCAGTGCTAGAGATCGGTACAATGAGCAGTTCTTC	CSARDRYNEQFF	TRBV20-1	TRBJ2-1
TGTGCCAGCAGCCACATCCGGGACAGGGGGCGAAATTCACCCCTCCACTTT	CASSHIRDRGRNSPLHF	TRBV9	TRBJ1-6
TGCAGCGCCCGGCAGGACAACACCGGGGAGCTGTTTTTT	CSARQDNTGELFF	TRBV29-1	TRBJ2-2
TGTGCCGGGCGCGGGAGGTATAGAGACAATGAGCAGTTCTTC	CAGRGRYRDNEQFF	TRBV12-5	TRBJ2-1
TGTGCCAGCAGCTTGCGTAGTGAATTGCGTACCTACCTTCGGGACTCCTACGAGCAGTACTTC	CASSLRSELRTYLRDSYEQYF	TRBV5-4	TRBJ2-7
TGTGCCAGCAGCACACGTTTTGGGGACAGGATTGGCAATCAGCCCCAGCATTTT	CASSTRFGDRIGNQPQHF	TRBV5-6	TRBJ1-5
TGTGCCAGCTCACCAGCCCCGCTAACAGATACGCAGTATTTT	CASSPAPLTDTQYF	TRBV18	TRBJ2-3
TGCGCCAGCAGTTCCCCTCAAGAGACCCAGTACTTC	CASSSPQETQYF	TRBV10-2	TRBJ2-5
TGTGCCAGCAGCACGGACAGCCAAGAGACCCAGTACTTC	CASSTDSQETQYF	TRBV7-9	TRBJ2-5
TGTGCCAGCAGCTTAACGGGGGGGGTGATGGTACTAGGACCCTATGGCTACACCTTC	CASSLTGGVMVLGPYGYTF	TRBV7-3	TRBJ1-2
TGCGCCAAACATGGGGGGCCCGTAGAACCCGGGGAGCTGTTTTTT	CAKHGGPVEPGELFF	TRBV10-1	TRBJ2-2
TGCGCCACGGATTCACAGGGGCGTTATAGCAATCAGCCCCAGCATTTT	CATDSQGRYSNQPQHF	TRBV10-1	TRBJ1-5
TGTGCCAGCAGTTACGAGACAGGGGGGGAGCAGTACTTC	CASSYETGGEQYF	TRBV6-5	TRBJ2-7
TGTGCCAGCAAGAGCCGGGACAGGGGGTCGCCGAATCAGCCCCAGCATTTT	CASKSRDRGSPNQPQHF	TRBV27	TRBJ1-5
TGTGCCAGCAGCCAGAGGACAGGTCTGACGAACACCGGGGAGCTGTTTTTT	CASSQRTGLTNTGELFF	TRBV14	TRBJ2-2
TGTGCCAGCAGGAGGGGACAGGGGGGAGGAACCACGGGGGTTGGACCCGAAAACTATGGCTACACCTTC	CASRRGQGGGTTGVGPENYGYTF	TRBV11-2	TRBJ1-2
TGTGCCAGCATTGAGGGACACACTGAAGCTTTCTTT	CASIEGHTEAFF	TRBV7-2	TRBJ1-1
TGTGCCAGCACCGCAGATCAGGATTTACTGGCAGATACGCAGTATTTT	CASTADQDLLADTQYF	TRBV9	TRBJ2-3
TGTGCCAGCAGCACCATTCCAGGGGGTTATCAGCCCCAGCATTTT	CASSTIPGGYQPQHF	TRBV9	TRBJ1-5
TGTGCCAGCAGTTACCCATCGCGCACTTTCTCCTATAATTCACCCCTCCACTTT	CASSYPSRTFSYNSPLHF	TRBV6-6	TRBJ1-6
TGTGCCTGGCACACACTATCCTCTGGAAACACCATATATTTT	CAWHTLSSGNTIYF	TRBV30	TRBJ1-3
TGCGCCAGCAGCTTGTCCAGGGAGGTTATTGTGCACAATCAGCCCCAGCATTTT	CASSLSREVIVHNQPQHF	TRBV5-1	TRBJ1-5
TGTGCCAGCAGCTTAGGGACAGGGTGGAATGAAAAACTGTTTTTT	CASSLGTGWNEKLFF	TRBV11-2	TRBJ1-4
TGTGCCAGCAGACGGGACAGGTATCTAGAAACAGATACGCAGTATTTT	CASRRDRYLETDTQYF	TRBV5-8	TRBJ2-3
TGTGCCAGCAGCTTAGATAGTAGGGGGGCAAATGAGCAGTTCTTC	CASSLDSRGANEQFF	TRBV11-3	TRBJ2-1
TGTGCCAGCACCCCCGTGGGGGGGGATGGCTACACCTTC	CASTPVGGDGYTF	TRBV9	TRBJ1-2
TGTGCCTTAAGGGGAAGGTACTGCACAGATACGCAGTATTTT	CALRGRYCTDTQYF	TRBV30	TRBJ2-3
TGTGCCAGCAGTGCCTCGGGAAGACAGACTGAGCAGTTCTTC	CASSASGRQTEQFF	TRBV6-4	TRBJ2-1
TGTGCCAGCAGCCAAGCGTTCGGTGGGGACGGGGGGTCCGCCTACGAGCAGTACTTC	CASSQAFGGDGGSAYEQYF	TRBV3-1	TRBJ2-7
TGTGCCAGCAGCTTAGGTGGACAGGGGGCGGGAGGCTACACCTTC	CASSLGGQGAGGYTF	TRBV7-9	TRBJ1-2
TGTGCCAGCTCATCCACTAGCGGGTCCTACGAGCAGTACTTC	CASSSTSGSYEQYF	TRBV18	TRBJ2-7
TGTGCCACCAGGTCCCAACACGCGGCGGACAATGAGCAGTTCTTC	CATRSQHAADNEQFF	TRBV15	TRBJ2-1
TGTGCCAGCTCGGCACGGGGGGGCCGGGGCTACGAGCAGTACTTC	CASSARGGRGYEQYF	TRBV13	TRBJ2-7
TGTGCCAGCAGCGTGTCTCTAATCTCCCGCTACGAGCAGTACTTC	CASSVSLISRYEQYF	TRBV9	TRBJ2-7
TGTGCCAGCAGCCAAGACACTCCCTCTTTCGGGACTAGCGGAGTTGGTAGCACAGATACGCAGTATTTT	CASSQDTPSFGTSGVGSTDTQYF	TRBV14	TRBJ2-3
TGTGCCACCAGTAGCAGGGCACTAGCGGTCCCCAATGAGCAGTTCTTC	CATSSRALAVPNEQFF	TRBV24-1	TRBJ2-1
TGTGCCAGTAGTTTTCCGAAGGGCTACGTTGAAATCTATGGCTACACCTTC	CASSFPKGYVEIYGYTF	TRBV19	TRBJ1-2
TGTGCCAGTAGCCGGGACAGAAACACTGAAGCTTTCTTT	CASSRDRNTEAFF	TRBV19	TRBJ1-1
TGTGCCAGCAGCCTAGGCGATACGCAGTATTTT	CASSLGDTQYF	TRBV13	TRBJ2-3
TGTGCCAGCAACCCAGGGAGGGGTACAGAGACCCAGTACTTC	CASNPGRGTETQYF	TRBV27	TRBJ2-5
TGTGCCAGCATCGACAGCGGGAGCAGTAGCACAGATACGCAGTATTTT	CASIDSGSSSTDTQYF	TRBV6-1	TRBJ2-3
TGTGCCAGCAGTGGGAACCTCCGCAGAATGACCCAGTACTTC	CASSGNLRRMTQYF	TRBV7-2	TRBJ2-5
TGTGCCAGCAGTAATGGGACAGTTTTCTACGAGCAGTACTTC	CASSNGTVFYEQYF	TRBV6-6	TRBJ2-7
TGTGCCAGCAGTGAAGGACTAGCGGGCAACCACAGGGATGCCTACGAGCAGTACTTC	CASSEGLAGNHRDAYEQYF	TRBV2	TRBJ2-7
TGTGCCAGCAGCGTAGAAGACACAGGGGTACACCCCTACGAGCAGTACTTC	CASSVEDTGVHPYEQYF	TRBV9	TRBJ2-7
TGTGCCAGCAGTTCCTGGGGGGGGGCTGAAGCTTTCTTT	CASSSWGGAEAFF	TRBV7-2	TRBJ1-1
TGCGCCAGCAGCAGCTCTACGCAGTATTTT	CASSSSTQYF	TRBV5-1	TRBJ2-3
TGCAGCCCCGAGCGGAGGTCAGATACGCAGTATTTT	CSPERRSDTQYF	TRBV29-1	TRBJ2-3
TGTGCCAGCAAAGTCAGGGTTGAGGAGGAGACCCAGTACTTC	CASKVRVEEETQYF	TRBV6-2	TRBJ2-5
TGCAGTGCTCAAGAGGGATACGAGTACTTC	CSAQEGYEYF	TRBV20-1	TRBJ2-4
TGTGCCAGTATAATCACCTGTCCTCAAAAGAAGACTGAAGCTTTCTTT	CASIITCPQKKTEAFF	TRBV19	TRBJ1-1
TGTGCCAGCAGCCCCGTGGGGGACAATGAGCAGTTCTTC	CASSPVGDNEQFF	TRBV12-3	TRBJ2-1
TGTGCCAGCAGCTTCCCAATATTCGGAGACACAGATACGCAGTATTTT	CASSFPIFGDTDTQYF	TRBV5-6	TRBJ2-3
TGCGCCAGCAGCCAAGGACACAGGTTGGTCAGCTCCTACAATGAGCAGTTCTTC	CASSQGHRLVSSYNEQFF	TRBV4-3	TRBJ2-1
TGTGCCAGCAGTGAGTTATCCGAAAAATCGCATGAGCAGTTCTTC	CASSELSEKSHEQFF	TRBV6-1	TRBJ2-1
TGTGCCACCAGCAGAAAACTGTCGCAAATGCAAGAGACCCAGTACTTC	CATSRKLSQMQETQYF	TRBV15	TRBJ2-5
TGTGCCAGCAGTTTACGGCACGCTAGCGGGGAGCTGGGAAAAGAGACCCAGTACTTC	CASSLRHASGELGKETQYF	TRBV12-4	TRBJ2-5
TGTGCCAGCAGCTTAGATCAGGGTCCGTACACCGGGGAGCTGTTTTTT	CASSLDQGPYTGELFF	TRBV7-3	TRBJ2-2
TGTGCCAGCCGGGAACCCACAGATACGCAGTATTTT	CASREPTDTQYF	TRBV9	TRBJ2-3
TGTGCCAGCAGCACGAGAGGGGGGGAGCAGTTCTTC	CASSTRGGEQFF	TRBV9	TRBJ2-1
TGCGCCAGCGGACTGGGACAGGACGAGCAGTACTTC	CASGLGQDEQYF	TRBV10-2	TRBJ2-7
TGTGCCAGCAGCCTCGGGAGGGCCTGGTTCTTCTCCTATAATTCACCCCTCCACTTT	CASSLGRAWFFSYNSPLHF	TRBV7-9	TRBJ1-6
TGTGCCAGCAGTTTAATCTACAGGGACGAGCAGTACTTC	CASSLIYRDEQYF	TRBV12-4	TRBJ2-7
TGTGCTAGTGATCCCCCCCAGACAGGGGGGCAATCTAGCCTCTACGAGCAGTACTTC	CASDPPQTGGQSSLYEQYF	TRBV12-5	TRBJ2-7
TGTGCCAGCAGGGCCACGGTGCGGGGGCGCTCTGGCTATGGCTACACCTTC	CASRATVRGRSGYGYTF	TRBV7-3	TRBJ1-2
TGTGCCAGCAGTTCAGGGAACAAATGCCGTTCACCCCTCCACTTT	CASSSGNKCRSPLHF	TRBV27	TRBJ1-6
TGTGCCATCGGGGCGGCTGTCGGTATCAACTATGGCTACACCTTC	CAIGAAVGINYGYTF	TRBV25-1	TRBJ1-2
TGTGCCAGCAGTACAGGGGAGGCCTATGGCTACACCTTC	CASSTGEAYGYTF	TRBV27	TRBJ1-2
TGTGCCAGCAGTCCCCCCCTTCTAATTCGGAACACTGAAGCTTTCTTT	CASSPPLLIRNTEAFF	TRBV6-5	TRBJ1-1
TGTGCCAGCAGCCGTCAGCAGCCATCAGGTCGGAACGAGCAGTACTTC	CASSRQQPSGRNEQYF	TRBV7-8	TRBJ2-7
TGTGCCAGCAGTGACCCCGACAGGGGAGGGGGGGGCTACACCTTC	CASSDPDRGGGGYTF	TRBV6-4	TRBJ1-2
TGTGCCAGCGGGGACACTGAAGCTTTCTTT	CASGDTEAFF	TRBV11-3	TRBJ1-1
TGTGCCAGCAGTTTACCTGGAGGGGGGTCACCCCTCCACTTT	CASSLPGGGSPLHF	TRBV28	TRBJ1-6
TGCGCCAGCAGCCAAGAATGCTGCAGGGGGGGCGAGCAGTACTTC	CASSQECCRGGEQYF	TRBV4-1	TRBJ2-7
TGTGCCAGCAGCGCGGACAGGGGGCGTAGGTCCAATCAGCCCCAGCATTTT	CASSADRGRRSNQPQHF	TRBV7-3	TRBJ1-5
TGCAGTGCAGTCGGGGGGGGTACAGAGACCCAGTACTTC	CSAVGGGTETQYF	TRBV20-1	TRBJ2-5
TGTGCCAGCAGTCCGACTAGCGGGTACAATGAGCAGTTCTTC	CASSPTSGYNEQFF	TRBV28	TRBJ2-1
TGTGCCAGCCGGTCCCGTCGCGGGGCCAGAGCCTACGAGCAGTACTTC	CASRSRRGARAYEQYF	TRBV5-5	TRBJ2-7
TGTGCCAGCAGCCGGGGAGGGGGTGCTCCTAATGAAAAACTGTTTTTT	CASSRGGGAPNEKLFF	TRBV6-4	TRBJ1-4
TGTGCCAGCAGCTGGAGGGCCTATGGCTACACCTTC	CASSWRAYGYTF	TRBV7-3	TRBJ1-2
TGCGCCAGCAGCTTGGGGAAACTACTAGCGTCCTTAGCCAAAAACATTCAGTACTTC	CASSLGKLLASLAKNIQYF	TRBV5-1	TRBJ2-4
TGTGCCAGCAGCTGCCCTCGGACTAGCGGGGGAGCCCTATACGAGCAGTACTTC	CASSCPRTSGGALYEQYF	TRBV5-4	TRBJ2-7
TGTGCCAGCATGTTGCGGGAGGGCTACAATGAGCAGTTCTTC	CASMLREGYNEQFF	TRBV7-9	TRBJ2-1
TGTGCCAGCAGCTTCCAGGAAAGGAGCAATCAGCCCCAGCATTTT	CASSFQERSNQPQHF	TRBV11-2	TRBJ1-5
TGTGCCAGCAGTGATGTGGGGTTCCGAGACACTGAAGCTTTCTTT	CASSDVGFRDTEAFF	TRBV6-1	TRBJ1-1
TGTGCCAGCAGCTTAGTACCAGGACAGGGGGCACTTTGGAACACTGAAGCTTTCTTT	CASSLVPGQGALWNTEAFF	TRBV7-4	TRBJ1-1
TGTGCCAGCGACGAAGGACGACAGTCTACCGCTGGGGCCAACGTCCTGACTTTC	CASDEGRQSTAGANVLTF	TRBV5-6	TRBJ2-6
TGTGCCAGCACCCGGGACAGGGGGGATGGAGCTTTCTTT	CASTRDRGDGAFF	TRBV6-4	TRBJ1-1
TGTGCCAGCAGTTTTGTCCATGCGCATAAGTATGGAAACACCATATATTTT	CASSFVHAHKYGNTIYF	TRBV12-3	TRBJ1-3
TGTGCCAGCCCCCTAGCGGGGAGTCCCAATGACAATGAGCAGTTCTTC	CASPLAGSPNDNEQFF	TRBV25-1	TRBJ2-1
TGTGCCAGCAGCATGGGGATTAATGAAAAACTGTTTTTT	CASSMGINEKLFF	TRBV7-3	TRBJ1-4
TGTGCCACGTTTCCAGGAGGGGGACAGAAACTGTTTTTT	CATFPGGGQKLFF	TRBV28	TRBJ1-4
TGTGCCATGCCCGGCGGAGGTGGGGCAGACAATTCACCCCTCCACTTT	CAMPGGGGADNSPLHF	TRBV10-3	TRBJ1-6
TGTGCCAGCAGCTTGGCCCCCCCTTACTATGAAAAACTGTTTTTT	CASSLAPPYYEKLFF	TRBV5-4	TRBJ1-4
TGTGCCAGCAGTGAAGCGGACAGGCAGCCCCAGCATTTT	CASSEADRQPQHF	TRBV2	TRBJ1-5
TGTGCCACCAGCAGGACGGACTCAGTCCGGTTGGGGCAAGAGACCCAGTACTTC	CATSRTDSVRLGQETQYF	TRBV15	TRBJ2-5
TGCGCCAGCAGTGACTCACCTAGCGGCAGAGTATCTTTCACCTATGGCTACACCTTC	CASSDSPSGRVSFTYGYTF	TRBV10-1	TRBJ1-2
TGTGCCAGCAGGCATCCATTTGGGACAGGGGGCGGGTACGAGCAGTACTTC	CASRHPFGTGGGYEQYF	TRBV7-3	TRBJ2-7
TGCAGTGAGAGCGGCGGACAAGAGACCCAGTACTTC	CSESGGQETQYF	TRBV20-1	TRBJ2-5
TGCGCCAGCAGCCAAGCCCGGGACACGGGCAAGGGCTACGAGCAGTACTTC	CASSQARDTGKGYEQYF	TRBV4-1	TRBJ2-7
TGCAGTGTAACAACTATCCCAGCCAAAAACATTCAGTACTTC	CSVTTIPAKNIQYF	TRBV20-1	TRBJ2-4
TGTGCCAGCAGTTGCGGGATAACTCCTTCCGGGGGCCCCAATGAGCAGTTCTTC	CASSCGITPSGGPNEQFF	TRBV25-1	TRBJ2-1
TGTGCCAGCAGTAACCTCGCGGCGGGGAGCTCCTACAATGAGCAGTTCTTC	CASSNLAAGSSYNEQFF	TRBV6-1	TRBJ2-1
TGTGCCAGCAGTTACTGCCCCGAATACGAGCAGTACTTC	CASSYCPEYEQYF	TRBV6-3	TRBJ2-7
TGCGCCAGCAGCCAAGAGACTAAGTGCGACGGGGTTGAGACCCAGTACTTC	CASSQETKCDGVETQYF	TRBV4-1	TRBJ2-5
TGTGCCAGCAGTTTAAGTCAACAATTTCGCGACAATGAGCAGTTCTTC	CASSLSQQFRDNEQFF	TRBV27	TRBJ2-1
TGTGCCAGCAGCTTAACAAGGGGACAGGGGCTGTTTTTT	CASSLTRGQGLFF	TRBV7-3	TRBJ1-4
TGTGCCACCGTGGGAAGACCGTTAAATCGGAGAATTGGTGCGAACACTGAAGCTTTCTTT	CATVGRPLNRRIGANTEAFF	TRBV24-1	TRBJ1-1
TGTGCCAGCAGCACCCGTGGGACAGACGAAGCTTTCTTT	CASSTRGTDEAFF	TRBV5-6	TRBJ1-1
TGTGCCAGCAGCTTACCCGGACAGGACATTCAGTACTTC	CASSLPGQDIQYF	TRBV7-6	TRBJ2-4
TGTGCCAGCAGCGGCAGGAAGGCTCATGAGCAGTTCTTC	CASSGRKAHEQFF	TRBV7-9	TRBJ2-1
TGCGCCAGCACGGGCGAAAATCAGCCCCAGCATTTT	CASTGENQPQHF	TRBV5-1	TRBJ1-5
TGCGCCAGCAGCCTACAGGGGAGCACCTTC	CASSLQGSTF	TRBV5-1	TRBJ1-2
TGTGCCAGCAGCTCAACAGTGTACCGGATAAACACTGAAGCTTTCTTT	CASSSTVYRINTEAFF	TRBV11-2	TRBJ1-1
TGCAGTGCTAGAGAGGAGGGGACGAGACACAATGAGCAGTTCTTC	CSAREEGTRHNEQFF	TRBV20-1	TRBJ2-1
TGTGCCAGCAGTTTATGGGACAGGGACAATGAGCAGTTCTTC	CASSLWDRDNEQFF	TRBV27	TRBJ2-1
TGCGCCAGCAGTGAGTGGACAGGGGGCTGTACCGGGGAGCTGTTTTTT	CASSEWTGGCTGELFF	TRBV10-2	TRBJ2-2
TGTGCCAGCAGCTTAGGAGACAGGGTTCTATATAGCAATCAGCCCCAGCATTTT	CASSLGDRVLYSNQPQHF	TRBV5-4	TRBJ1-5
TGTGCCAGCAGTTCATGCCGGGACAGGGCATGTCGGAACACCGGGGAGCTGTTTTTT	CASSSCRDRACRNTGELFF	TRBV12-3	TRBJ2-2
TGTGCCAGCAGCCGAGACAGGGGGGGTGGCTACACCTTC	CASSRDRGGGYTF	TRBV11-2	TRBJ1-2
TGTGCCAGCAGGGGCGCAAGCTACGAGCAGTACTTC	CASRGASYEQYF	TRBV6-5	TRBJ2-7
TGCAGCGTTGACCCTACGTGTAATGAGCAGTTCTTC	CSVDPTCNEQFF	TRBV29-1	TRBJ2-1
TGTGCCTTCTCCCTAGGGAGCCCGGATACGCAGTATTTT	CAFSLGSPDTQYF	TRBV30	TRBJ2-3
TGTGCCAGCAGTCTAACCGGGACAGGGAACACCGGGGAGCTGTTTTTT	CASSLTGTGNTGELFF	TRBV28	TRBJ2-2
TGTGCCAGCCGTGCAGAGGTGAACACTGAAGCTTTCTTT	CASRAEVNTEAFF	TRBV7-9	TRBJ1-1
TGTGCCTGGTCCCTAGGGGACAATGAGCAGTTCTTC	CAWSLGDNEQFF	TRBV30	TRBJ2-1
TGTGCCAGTAGTATGGTAGGGAATCGTAACTACGAGCAGTACTTC	CASSMVGNRNYEQYF	TRBV19	TRBJ2-7
TGTGCCAGCAGCTGGTCCGGCTCTCCGCACAATGAGCAGTTCTTC	CASSWSGSPHNEQFF	TRBV11-2	TRBJ2-1
TGTGCCAGCAGAAAGTTGGGCGTAAACGAGCAGTACTTC	CASRKLGVNEQYF	TRBV13	TRBJ2-7
TGCAGTGCTAGAGATTCCCCCGCTAGAGGGTACGAGCAGTACTTC	CSARDSPARGYEQYF	TRBV20-1	TRBJ2-7
TGTGCCAGCAGACAGACTTCGGGACACAATCAGCCCCAGCATTTT	CASRQTSGHNQPQHF	TRBV7-9	TRBJ1-5
TGTGCCAGCAGTTTAATAACCGGGTGCCAGGGGAACTCTGGAAACACCATATATTTT	CASSLITGCQGNSGNTIYF	TRBV12-3	TRBJ1-3
TGCAGTGCTTACCCCAGGACTAAAACCGGGGAGCTGTTTTTT	CSAYPRTKTGELFF	TRBV20-1	TRBJ2-2
TGTGCCAGCAGCCGAAGGGGGGGCCATGGGGTTTTAGGGGACAATGAGCAGTTCTTC	CASSRRGGHGVLGDNEQFF	TRBV7-9	TRBJ2-1
TGCAGCGTTGAAGAGGGCGGTGAAGCTTTCTTT	CSVEEGGEAFF	TRBV29-1	TRBJ1-1
TGTGCCACCAGCAGAGACCCGGGCGCCGGGACTAGCGGGAGCTCTGGAAACACCATATATTTT	CATSRDPGAGTSGSSGNTIYF	TRBV15	TRBJ1-3
TGTTGCTCCACAAATTCACCCCTCCACTTT	CCSTNSPLHF	TRBV20-1	TRBJ1-6
TGTGCCAGCAGCCAAGAGGGGGATCCGAACACTGAAGCTTTCTTT	CASSQEGDPNTEAFF	TRBV3-1	TRBJ1-1
TGCAGTACAGGGGGGGGCGGGAACTATGGCTACACCTTC	CSTGGGGNYGYTF	TRBV29-1	TRBJ1-2
TGTGCCAGCAGTGAATGTTCCACGGCTGGGGGCGGCCACACTGAAGCTTTCTTT	CASSECSTAGGGHTEAFF	TRBV25-1	TRBJ1-1
TGTGCCTGGAGTGGCCTGCGGGACAGTCCGAATGAAAAACTGTTTTTT	CAWSGLRDSPNEKLFF	TRBV30	TRBJ1-4
TGTGCCAGCAGTAGCCCCGGCCGACTAGCGGGTCTGGCGAACACCGGGGAGCTGTTTTTT	CASSSPGRLAGLANTGELFF	TRBV12-3	TRBJ2-2
TGTGCCTGGAGTGTACAACTGATTATAGACTCCTACGAGCAGTACTTC	CAWSVQLIIDSYEQYF	TRBV30	TRBJ2-7
TGCGCCAGCAGCATAGCGGGGGCCGAGCAGTTCTTC	CASSIAGAEQFF	TRBV5-1	TRBJ2-1
TGTGCCAGCAGTATCCTGGCAGGCTACACCTTC	CASSILAGYTF	TRBV27	TRBJ1-2
TGTGCCAGTAGCTATAGGTTGCTACGGGACACCGGGGAGCTGTTTTTT	CASSYRLLRDTGELFF	TRBV19	TRBJ2-2
TGCGCCAGCAGCCAAGATAAGAGTAGATCCTGGACAGGGCACGTTGTGACGGGGCCACCGCCTCCTACTGAAGCTTTCTTT	CASSQDKSRSWTGHVVTGPPPPTEAFF	TRBV4-1	TRBJ1-1
TGTGCCTGGAGAGAAGACTGGGGGGGGGGCACAGATACGCAGTATTTT	CAWREDWGGGTDTQYF	TRBV30	TRBJ2-3
TGTGCCAGCCTAGGATTTTCCCCTGGCTACACCTTC	CASLGFSPGYTF	TRBV6-5	TRBJ1-2
TGTGCCACCAGCCGGCCCGGAGAACTAGCTGGGGCCAACGTCCTGACTTTC	CATSRPGELAGANVLTF	TRBV15	TRBJ2-6
TGTGCCAGCAACAGGTATAGCAATCAGCCCCAGCATTTT	CASNRYSNQPQHF	TRBV6-4	TRBJ1-5
TGTGCCAGCGCTTCGGTCCTTCCTGCTCGGAATTCACCCCTCCACTTT	CASASVLPARNSPLHF	TRBV7-3	TRBJ1-6
TGTGCCAGCAGTTTAGAAATGGGGAGAATGATCCAGGAGTGCATGTACGAGCAGTACTTC	CASSLEMGRMIQECMYEQYF	TRBV12-4	TRBJ2-7
TGTGCCAGTAGTATACTGAACAGGAAGGGTAACACTGAAGCTTTCTTT	CASSILNRKGNTEAFF	TRBV19	TRBJ1-1
TGTGCCACCAGCGGACTATACTCCAATGAGCAGTTCTTC	CATSGLYSNEQFF	TRBV15	TRBJ2-1
TGTGCCAGCTCACCAGTCCGCGGGAGTTACGAGCAGTACTTC	CASSPVRGSYEQYF	TRBV18	TRBJ2-7
TGTGCCAGCAGCCAAGACAAAAAGCAGGGGGCTATCAATGTAGCCAAAAACATTCAGTACTTC	CASSQDKKQGAINVAKNIQYF	TRBV14	TRBJ2-4
TGTGCCAGCAGCGCTCTAGGGGGAACGCGCAATCAGCCCCAGCATTTT	CASSALGGTRNQPQHF	TRBV7-8	TRBJ1-5
TGTGCCAGCAGTTCCTCGAGGGATAACTATGGCTACACCTTC	CASSSSRDNYGYTF	TRBV6-2	TRBJ1-2
TGTGCCAGCAGTACCCACTGCAGGGATGGCTACACCTTC	CASSTHCRDGYTF	TRBV6-2	TRBJ1-2
TGTGCCAGCAGTGAAGCTGTAGGATTAAATGGCTACACCTTC	CASSEAVGLNGYTF	TRBV6-1	TRBJ1-2
TGTGCCAGCAGTCCGCGGGACAGCTACGAGCAGTACTTC	CASSPRDSYEQYF	TRBV6-5	TRBJ2-7
TGTGCCAGCGGACGCCTCCTCTTTTATAGGGGGGGACTTTTGGCGAACACCGGGGAGCTGTTTTTT	CASGRLLFYRGGLLANTGELFF	TRBV7-3	TRBJ2-2
TGCAGTGCTAGGGGAGTTATCGGGGGGGGGAGCTCCTACGAGCAGTACTTC	CSARGVIGGGSSYEQYF	TRBV20-1	TRBJ2-7
TGTGCCAGCAGCCAAGCCACCTGGCGGAAATCTTCCCAGCCCCAGCATTTT	CASSQATWRKSSQPQHF	TRBV3-1	TRBJ1-5
TGTGCCAGCAGCGTGCCGAAACGCTATGGCTACACCTTC	CASSVPKRYGYTF	TRBV7-9	TRBJ1-2
TGTGCCAGCCCCCGTAGCGGAAGATACGAGCAGTACTTC	CASPRSGRYEQYF	TRBV25-1	TRBJ2-7
TGTGCCACGTCCGGGACAGGGCCTGTATTACACTATGGCTACACCTTC	CATSGTGPVLHYGYTF	TRBV5-4	TRBJ1-2
TGTGCCACCAGAAACTCAGCTCTGGGGGGCCCTCACGTCACAGATACGCAGTATTTT	CATRNSALGGPHVTDTQYF	TRBV24-1	TRBJ2-3
TGTGCCAGCACTGACAGGGGTCAGCATGGCTACACCTTC	CASTDRGQHGYTF	TRBV11-3	TRBJ1-2
TGTGCCAGCAGCAGAAGGCGGGTCTACAATGAGCAGTTCTTC	CASSRRRVYNEQFF	TRBV7-6	TRBJ2-1
TGTGCGGGAACTAGCGGTCATCAAGAGACCCAGTACTTC	CAGTSGHQETQYF	TRBV3-1	TRBJ2-5
TGTGCCAGCAGTGCAGGGGGACCCTATGATCAGCCCCAGCATTTT	CASSAGGPYDQPQHF	TRBV2	TRBJ1-5
TGCAGTGCTAGAGATCAGGGGCAGGCTAACTATGGCTACACCTTC	CSARDQGQANYGYTF	TRBV20-1	TRBJ1-2
TGTGCCAGCATCGTGGGACAGACTGAAGCTTTCTTT	CASIVGQTEAFF	TRBV27	TRBJ1-1
TGCGCCAGCACCCAGCCAGGGGGGACGCAGTTCTTC	CASTQPGGTQFF	TRBV10-1	TRBJ2-1
TGTGCCAGTAGTCAAGGACTAGCGGCTTGTGAGACCCAGTACTTC	CASSQGLAACETQYF	TRBV19	TRBJ2-5
TGTGCCAAGCCTCAGGGGCCAAATTCACCCCTCCACTTT	CAKPQGPNSPLHF	TRBV28	TRBJ1-6
TGCGCCAGCATATTCAAGACAGGGCCCGGAAACACCATATATTTT	CASIFKTGPGNTIYF	TRBV5-1	TRBJ1-3
TGTGCCAGCAGGCCCTATCCCGCGGCTCAGGGCCATGAGCAGTTCTTC	CASRPYPAAQGHEQFF	TRBV28	TRBJ2-1
TGTGCCAGCAGCCAAGCCGTAAAACTAGCGGGTTATGAGCAGTTCTTC	CASSQAVKLAGYEQFF	TRBV14	TRBJ2-1
TGTGCCAGCAGCTGCGGTTCGACAGGGGAAGCTTTCTTT	CASSCGSTGEAFF	TRBV7-9	TRBJ1-1
TGTGCCAGCAGCGACGCTCCTCTAGCGGGCGGGAAATCCTACGAGCAGTACTTC	CASSDAPLAGGKSYEQYF	TRBV2	TRBJ2-7
TGCAGTGCTAGAATCGCACTAACCCTCGGGCAGGTGTACGAGCAGTACTTC	CSARIALTLGQVYEQYF	TRBV20-1	TRBJ2-7
TGTGCCAGCAGTGAGGGCGACAGGGTACATAGCAATCAGCCCCAGCATTTT	CASSEGDRVHSNQPQHF	TRBV2	TRBJ1-5
TGTGCCAGCAGTCCTCCAGCTGAGCACGGACGAGGGAGGGCTGAGCAGTTCTTC	CASSPPAEHGRGRAEQFF	TRBV7-4	TRBJ2-1
TGTGCCAGCAGCGGTAGAGATGGGGGCGCTGAAGCTTTCTTT	CASSGRDGGAEAFF	TRBV6-3	TRBJ1-1
TGTGCCAGCAGTTACTCGATCAAGCGGGATAACAGTAATCAGCCCCAGCATTTT	CASSYSIKRDNSNQPQHF	TRBV6-5	TRBJ1-5
TGCAGTGCTAGAGAAGCCGGGACAGGGGTAAGAGGAGGAGAGCCCCAGCATTTT	CSAREAGTGVRGGEPQHF	TRBV20-1	TRBJ1-5
TGTGCCAGCAGTCCAGGGACTAGCTTGAACAATGAGCAGTTCTTC	CASSPGTSLNNEQFF	TRBV6-1	TRBJ2-1
TGTGCCACCAGTGCTTCGGGGGGGGCCTACGAGCAGTACTTC	CATSASGGAYEQYF	TRBV24-1	TRBJ2-7
TGTGCCAGCAGCTTAGACAGGAATTTTAATGAAAAACTGTTTTTT	CASSLDRNFNEKLFF	TRBV7-2	TRBJ1-4
TGTGCCAGCAGCAGAAGGCCTCCAGAGGGGTACACCATATATTTT	CASSRRPPEGYTIYF	TRBV7-4	TRBJ1-3
TGTGCCAGCAGCGTAGGTAGGACAGGGAACTACAATGAGCAGTTCTTC	CASSVGRTGNYNEQFF	TRBV5-5	TRBJ2-1
TGTGCCCAACGGGGGGAAACCTCAGATACGCAGTATTTT	CAQRGETSDTQYF	TRBV27	TRBJ2-3
TGTGCCAGTAGGTGGGGGGGAGATACGCAGTATTTT	CASRWGGDTQYF	TRBV19	TRBJ2-3
TGTGCCACCAGCAGGCTCAGGTTCAAGAGGGTAGTCTACGAGCAGTACTTC	CATSRLRFKRVVYEQYF	TRBV15	TRBJ2-7
TGCGCCAGCAGCCAGCGAAGGGACAGGGGTGGATTGACCGGCTACACCTTC	CASSQRRDRGGLTGYTF	TRBV4-1	TRBJ1-2
TGTGCCACCAGGGGACCGGGACAGGGGAGTATCTCCTACGAGCAGTACTTC	CATRGPGQGSISYEQYF	TRBV24-1	TRBJ2-7
TGTGCCGAAACTAGCGGGTTGTATGGAACAGATACGCAGTATTTT	CAETSGLYGTDTQYF	TRBV24-1	TRBJ2-3
TGTGCCAGCAGCCGCGAGACAGGGCCTCTCTATGGCTACACCTTC	CASSRETGPLYGYTF	TRBV9	TRBJ1-2
TGTGCCAGCAGCAACACCGGGACAGGGGAGTTTCAGCCCCAGCATTTT	CASSNTGTGEFQPQHF	TRBV7-3	TRBJ1-5
TGTGCCAGCAGCCAAGTAGAGGTCCGGGACAGCAGATCGGGCTCTGGGGCCAACGTCCTGACTTTC	CASSQVEVRDSRSGSGANVLTF	TRBV14	TRBJ2-6
TGTGCCAGCAGTTTAAACGGGGACGTTTTTGGGGGCTCCAATGAGCAGTTCTTC	CASSLNGDVFGGSNEQFF	TRBV27	TRBJ2-1
TGTGCCTTAGGGAGCCCGAGGGAGCAGTACTTC	CALGSPREQYF	TRBV6-2	TRBJ2-7
TGTCTCCCTCGGACCTTCAATGAGCAGTTCTTC	CLPRTFNEQFF	TRBV10-3	TRBJ2-1
TGTGCCAGCAGCATACTTCCGGGGGTGGATGCCTATGGCTACACCTTC	CASSILPGVDAYGYTF	TRBV28	TRBJ1-2
TGTGCCAGCAGTTTGAAGAATGGGGGCGCGCGTTCACACTACGAGCAGTACTTC	CASSLKNGGARSHYEQYF	TRBV12-3	TRBJ2-7
TGTGCCAGCAGGGGGGCTTTGGACTATGGCTACACCTTC	CASRGALDYGYTF	TRBV7-9	TRBJ1-2
TGTGCCAGCAGCGGGGCAAGCGATATAACCGACGAGCAGTACTTC	CASSGASDITDEQYF	TRBV7-3	TRBJ2-7
TGTGCCTGGAGTGTACCGGATAGGCCACTACAGTCCGGGACTAGGGATGAGCAGTTCTTC	CAWSVPDRPLQSGTRDEQFF	TRBV30	TRBJ2-1
TGCGCCAGCCCCGGGCCACCCTCGGAGGGGGGGGATACTAATGAAAAACTGTTTTTT	CASPGPPSEGGDTNEKLFF	TRBV4-1	TRBJ1-4
TGTGCCAGCAGTTACGTCAACAATGAAAAACTGTTTTTT	CASSYVNNEKLFF	TRBV5-5	TRBJ1-4
TGTGCCAGCTTAGGACTAGGACCCTACACCGGGGAGCTGTTTTTT	CASLGLGPYTGELFF	TRBV6-4	TRBJ2-2
TGTGCCAGCAGTGACTCAGAAGCCCGCGTGAGGAACACTGAAGCTTTCTTT	CASSDSEARVRNTEAFF	TRBV6-4	TRBJ1-1
TGTGCCAGCAGTGGCGGAGCCCGGAGGGAGCTCGAGCAGTACTTC	CASSGGARRELEQYF	TRBV2	TRBJ2-7
TGTGCCACCAGTTCCTTCTGGGGGGGAAGCTCCTATAATTCACCCCTCCACTTT	CATSSFWGGSSYNSPLHF	TRBV24-1	TRBJ1-6
TGTGCCAGCAGTTGTCCGGGACATGGCTATTTCTACGAGCAGTACTTC	CASSCPGHGYFYEQYF	TRBV6-5	TRBJ2-7
TGCAGCTCCTCAAGGGGAATTAATTCACCCCTCCACTTT	CSSSRGINSPLHF	TRBV29-1	TRBJ1-6
TGCGCCAGCAGCCTTTCTTCAGGTTCATACGAGCAGTACTTC	CASSLSSGSYEQYF	TRBV4-3	TRBJ2-7
TGTGCCAGCAAGAGGGAGAGAAAAGAGACCCAGTACTTC	CASKRERKETQYF	TRBV3-1	TRBJ2-5
TGTGCCAGCTTGAGAAGGGGCTACAATGAGCAGTTCTTC	CASLRRGYNEQFF	TRBV27	TRBJ2-1
TGTGCCACCAGTGATAGGACAGGGGCAACCTACGAGCAGTACTTC	CATSDRTGATYEQYF	TRBV24-1	TRBJ2-7
TGCGCCAGCAGCCTTCTGGACAGGGTTAATCAGCCCCAGCATTTT	CASSLLDRVNQPQHF	TRBV4-1	TRBJ1-5
TGTGCCAGCAGCCAAGATCTGCACCCCGGGACAGGGGGCGGCTACACCTTC	CASSQDLHPGTGGGYTF	TRBV4-2	TRBJ1-2
TGTGCTAGTGGTGCCCGTGTGGGGGCGCCGGAAAATAACTATGGCTACACCTTC	CASGARVGAPENNYGYTF	TRBV12-5	TRBJ1-2
TGTGCCAGCTTGCCAGGGAGGGGTTGCAATCAGCCCCAGCATTTT	CASLPGRGCNQPQHF	TRBV28	TRBJ1-5
TGCGCCAGCAGCTTGGGGTTGGCAAGGGTTTTCCGGACTGAAGCTTTCTTT	CASSLGLARVFRTEAFF	TRBV5-1	TRBJ1-1
TGTGCCAGCAGCCCACCCACAGGCGAACAGCCCCAGCATTTT	CASSPPTGEQPQHF	TRBV13	TRBJ1-5
TGTGCCAGCAGTGATTGGACAGTTACTGAAGCTTTCTTT	CASSDWTVTEAFF	TRBV6-4	TRBJ1-1
TGTGCCAGCAGTGATCATAAGGCCTTAGCTGGGGCCAACGTCCTGACTTTC	CASSDHKALAGANVLTF	TRBV6-1	TRBJ2-6
TGTGCCAGCAGCCGAGAAGAGCAGGGGGGTTCCTACGAGCAGTACTTC	CASSREEQGGSYEQYF	TRBV11-2	TRBJ2-7
TGTGCCAGCAGCACTTCGGCTTTAGGAGTGTACGAGCAGTACTTC	CASSTSALGVYEQYF	TRBV7-9	TRBJ2-7
TGCGCCAGCAGCCACCGCGGGGCCACAAAGGGTCTACGCGGCGGAAGCTCCTACAATGAGCAGTTCTTC	CASSHRGATKGLRGGSSYNEQFF	TRBV4-1	TRBJ2-1
TGTGCCAGCATCCCTACGCGGGTGGAGACCCAGTACTTC	CASIPTRVETQYF	TRBV27	TRBJ2-5
TGTGCCAGCAGGGGTATCCATCAGCCCCAGCATTTT	CASRGIHQPQHF	TRBV27	TRBJ1-5
TGCAGTGCTAGGAGGGGCTCTGGGGCCAACGTCCTGACTTTC	CSARRGSGANVLTF	TRBV20-1	TRBJ2-6
TGTGCCAGCAGTCGCCGGGGTCCAGGGGATCTCGACCTCTATGGCTACACCTTC	CASSRRGPGDLDLYGYTF	TRBV6-1	TRBJ1-2
TGCGCCAGCAGCCAAGACCCGGGAGGGCCCTTCAACTATGGCTACACCTTC	CASSQDPGGPFNYGYTF	TRBV4-1	TRBJ1-2
TGTGCCAGCAGTTACGTCCACCTAGATACGCAGTATTTT	CASSYVHLDTQYF	TRBV6-2	TRBJ2-3
TGTGCCAGCAGGCGGGAGGAGGGCAATGAGCAGTTCTTC	CASRREEGNEQFF	TRBV6-4	TRBJ2-1
TGTGCCATAATGACAGGGCTTGGAAACACCATATATTTT	CAIMTGLGNTIYF	TRBV25-1	TRBJ1-3
TGTGCCAGCAGTGGACTAGCGGGCTACGAGCAGTACTTC	CASSGLAGYEQYF	TRBV28	TRBJ2-7
TGTGTGGAGAAGACAATCCACCGCGAGCAGTACTTC	CVEKTIHREQYF	TRBV30	TRBJ2-7
TGTGCCAGCAGCCCTGGGGGGGGTCCTGAGCAGTTCTTC	CASSPGGGPEQFF	TRBV11-2	TRBJ2-1
TGCGCCAGCAGCTTGGTGGGGGGGCAACCCACAGATACGCAGTATTTT	CASSLVGGQPTDTQYF	TRBV5-1	TRBJ2-3
TGTGCCAGCAGCCAAGCAGGGACAGACTCTGAAAAGGGCAACACCGGGGAGCTGTTTTTT	CASSQAGTDSEKGNTGELFF	TRBV3-1	TRBJ2-2
TGCGCCAGCAGACCAGAGCGGGAAAAACTGTTTTTT	CASRPEREKLFF	TRBV10-1	TRBJ1-4
TGTGCCAGCAGAAAGTACGGGGAGCTGTTTTTT	CASRKYGELFF	TRBV7-4	TRBJ2-2
TGTGCCACGCCAGGGCCCACGCAGTATTTT	CATPGPTQYF	TRBV19	TRBJ2-3
TGTGCCGAATCCGTCGGGACAGAAACGGTGAACACTGAAGCTTTCTTT	CAESVGTETVNTEAFF	TRBV2	TRBJ1-1
TGCGCCAGCAAAGGGGGACTAGCGAATGAGCAGTTCTTC	CASKGGLANEQFF	TRBV10-1	TRBJ2-1
TGTGCCAGCTCACCCCCCAGCGGCCAAGAGGGAGAGACCCAGTACTTC	CASSPPSGQEGETQYF	TRBV18	TRBJ2-5
TGCGCCAGCATATCGACAGGTGGGGCCAAAAACATTCAGTACTTC	CASISTGGAKNIQYF	TRBV10-1	TRBJ2-4
TGTGCCACCGTGGACAGCTATGGCTACACCTTC	CATVDSYGYTF	TRBV24-1	TRBJ1-2
TGTGCCAGCAGTGGGACAGGGCTTAAGGGAGCCTACGAGCAGTACTTC	CASSGTGLKGAYEQYF	TRBV25-1	TRBJ2-7
TGCAGTGCTAGAGATCTAGGGAGGAATGAGCAGTTCTTC	CSARDLGRNEQFF	TRBV20-1	TRBJ2-1
TGTGCCAGCAGCCCGGGGGAGCCAGGCTACACCTTC	CASSPGEPGYTF	TRBV14	TRBJ1-2
TGTGCCAGCAGCCCAGGGGGGACCACTGAAGCTTTCTTT	CASSPGGTTEAFF	TRBV12-4	TRBJ1-1
TGTGCCACAAGCCCTGAGACCCAGTACTTC	CATSPETQYF	TRBV11-3	TRBJ2-5
TGTGCCAGCAGCTTAGACACCCAGGAGAGACAGGACGAGCAGTACTTC	CASSLDTQERQDEQYF	TRBV11-2	TRBJ2-7
TGCGCCAGCAGCTGCCCTGAGATCGTTGGGGGATATCCCTACGAGCAGTACTTC	CASSCPEIVGGYPYEQYF	TRBV5-1	TRBJ2-7
TGTGCCAGCAGTTACCATGCTCCGGGACCTTTGGACCTTCCTTACAATGAGCAGTTCTTC	CASSYHAPGPLDLPYNEQFF	TRBV6-2	TRBJ2-1
TGTGCCAGCAGCCAGATCCCCGGGAAATCAGATACGCAGTATTTT	CASSQIPGKSDTQYF	TRBV4-2	TRBJ2-3
TGTGCCACCATCCGGGGGGGCGGGGAGCTGTTTTTT	CATIRGGGELFF	TRBV24-1	TRBJ2-2
TGTGCCATCAGTGAGTTGGAGGGCACGAAAGAGACCCAGTACTTC	CAISELEGTKETQYF	TRBV10-3	TRBJ2-5
TGTGCCAGCAGGATGTTTTTGAGGGGTCAATATAGCAATCAGCCCCAGCATTTT	CASRMFLRGQYSNQPQHF	TRBV6-3	TRBJ1-5
TGTGCCAGCAGCTTAGTTCCTCTGTTGAGGGTCCGCGAAGATACGCAGTATTTT	CASSLVPLLRVREDTQYF	TRBV7-9	TRBJ2-3
TGCAGTGCTACCGGGACAGGGCGGAGCTCCTACAATGAGCAGTTCTTC	CSATGTGRSSYNEQFF	TRBV20-1	TRBJ2-1
TGTGCCAGCAGTTTAGGGGGTAGGACGGGACCTCCCACTGAAGCTTTCTTT	CASSLGGRTGPPTEAFF	TRBV12-3	TRBJ1-1
TGTGCCAGCAGCATGACTAGCGGGAGGTCTCGGAACACTGAAGCTTTCTTT	CASSMTSGRSRNTEAFF	TRBV5-4	TRBJ1-1
TGTGCCACCAGTGCCGGGGGCAGCAATCAGCCCCAGCATTTT	CATSAGGSNQPQHF	TRBV24-1	TRBJ1-5
TGTGCCAGCAGCTTAGGGGCGACAGGGGGCTGCCATGGCTACACCTTC	CASSLGATGGCHGYTF	TRBV11-2	TRBJ1-2
TGCGCCAGCAGCTTGCACTCTCCCGGGGGACAGTGGTCAAATGGCGTGAACACTGAAGCTTTCTTT	CASSLHSPGGQWSNGVNTEAFF	TRBV5-1	TRBJ1-1
TGTGCCAGCAGCTGGGCTTGTTTTCTCCTAGCGGGCGTCCCCCAAGAGACCCAGTACTTC	CASSWACFLLAGVPQETQYF	TRBV9	TRBJ2-5
TGTGCCAGCAGCTCCATCACGGCTATGAAAGAGACCCAGTACTTC	CASSSITAMKETQYF	TRBV7-9	TRBJ2-5
TGTGCCACCAGTGCCATCCGGGACAGGGGAGAGGACTATGGCTACACCTTC	CATSAIRDRGEDYGYTF	TRBV24-1	TRBJ1-2
TGTGCCAGCAGCAGAGCCCAGATGGGGCTGAACACTGAAGCTTTCTTT	CASSRAQMGLNTEAFF	TRBV13	TRBJ1-1
TGTGCCAGCAGCTTAGCGCTCCACCGGGACAGGGGTACTGAAGCTTTCTTT	CASSLALHRDRGTEAFF	TRBV7-9	TRBJ1-1
TGTGCCATCAGAACACAGGGTAGGAACACTGAAGCTTTCTTT	CAIRTQGRNTEAFF	TRBV10-3	TRBJ1-1
TGTGCCAGCAGCTGCTTTCCGGGACCGAAAACCTACGAGCAGTACTTC	CASSCFPGPKTYEQYF	TRBV9	TRBJ2-7
TGTGCCAGCAGGATTGATCGGGGGGGCACAGATACGCAGTATTTT	CASRIDRGGTDTQYF	TRBV6-5	TRBJ2-3
TGCGCCAGCAGTGAGTCGTCAGTGCGACCCCGTCCTGGGGGTTTATACGAGCAGTACTTC	CASSESSVRPRPGGLYEQYF	TRBV10-2	TRBJ2-7
TGTGCCAGCTCTTCCGGTCCCCCCGACAGGAGATATAGCAATCAGCCCCAGCATTTT	CASSSGPPDRRYSNQPQHF	TRBV27	TRBJ1-5
TGTGCCAGCAGTGACTCGACTGGCGGGCTTAGAGACACTGAAGCTTTCTTT	CASSDSTGGLRDTEAFF	TRBV6-4	TRBJ1-1
TGTGCCAGCAGAGACAGCCGGGACAGGGTCGAAGCTTTCTTT	CASRDSRDRVEAFF	TRBV27	TRBJ1-1
TGTGCCAGCAGCTTTCGGACCGGGGTCAATCAGCCCCAGCATTTT	CASSFRTGVNQPQHF	TRBV11-3	TRBJ1-5
TGCGCCAGCAGTGAGGGCCGTCCAGGGTTATACTATGGCTACACCTTC	CASSEGRPGLYYGYTF	TRBV10-1	TRBJ1-2
TGCAGTGCGGCGGTCGACGGGGGGGTTCCCCGTGATACGCAGTATTTT	CSAAVDGGVPRDTQYF	TRBV20-1	TRBJ2-3
TGTGCCAGCAGCGTGTTCTGGGGGGGCAACGAGCAGTACTTC	CASSVFWGGNEQYF	TRBV7-2	TRBJ2-7
TGTGCCAGCAGGACTAGCGGAAGCACAGATACGCAGTATTTT	CASRTSGSTDTQYF	TRBV3-1	TRBJ2-3
TGTGCCACCACGCCGGGCCGCATTGCCTATGGCTACACCTTC	CATTPGRIAYGYTF	TRBV24-1	TRBJ1-2
TGTGCCAGCTCCCGGACAGATGGCTACACCTTC	CASSRTDGYTF	TRBV18	TRBJ1-2
TGTGCCAGCAGCAGACAGGGTAATCGTAACCGTTGGAACACTGAAGCTTTCTTT	CASSRQGNRNRWNTEAFF	TRBV13	TRBJ1-1
TGTGCCATTAACGGTGGGGTCTGGGGGCGTCATGACACTGAAGCTTTCTTT	CAINGGVWGRHDTEAFF	TRBV25-1	TRBJ1-1
TGTGCCAGCAGCGCCACGGAGTTAGGTTACGTATCCTACGAGCAGTACTTC	CASSATELGYVSYEQYF	TRBV11-2	TRBJ2-7
TGTGCCAGCAGCCCGAGCCGCCGGGCTGAAGCTTTCTTT	CASSPSRRAEAFF	TRBV7-2	TRBJ1-1
TGTGCCAGCAGTTTGGAACAGTATAATTCACCCCTCCACTTT	CASSLEQYNSPLHF	TRBV12-3	TRBJ1-6
TGTGCCAGTAGTCTAACTAGCGGGAGACTGCACACCGGGGAGCTGTTTTTT	CASSLTSGRLHTGELFF	TRBV19	TRBJ2-2
TGTGCCAGCAAAACCGGGATTCCCACCGGGGAGCTGTTTTTT	CASKTGIPTGELFF	TRBV27	TRBJ2-2
TGTGCCAGCAGCTCCGCGGGACAGAACACTGAAGCTTTCTTT	CASSSAGQNTEAFF	TRBV7-3	TRBJ1-1
TGTGCTAGTGGCCGACAGGGGAAGGAAGGCGACGAGCAGTACTTC	CASGRQGKEGDEQYF	TRBV12-5	TRBJ2-7
TGTGCCAGCATCAGTCGGGCAGACGAGCAGTACTTC	CASISRADEQYF	TRBV7-3	TRBJ2-7
TGCGCCAGCAGATATCTAGGGATCTCCTATAATTCACCCCTCCACTTT	CASRYLGISYNSPLHF	TRBV10-1	TRBJ1-6
TGCAGCGAGCCCCGAGCTCCTACTGAAGCTTTCTTT	CSEPRAPTEAFF	TRBV29-1	TRBJ1-1
TGTGCCATGCTGAATTCCAGGGGGTGGGTAGCTCCCTACGAGCAGTACTTC	CAMLNSRGWVAPYEQYF	TRBV19	TRBJ2-7
TGTGCCAGCAGTGCGGCGACAGCCTACAATGAGCAGTTCTTC	CASSAATAYNEQFF	TRBV6-3	TRBJ2-1
TGTAAAGGGCGGAGGCACAATGAGCAGTTCTTC	CKGRRHNEQFF	TRBV19	TRBJ2-1
TGCAGTGCTAGCCAGCAGGGGGGTCGAAGCAATCAGCCCCAGCATTTT	CSASQQGGRSNQPQHF	TRBV20-1	TRBJ1-5
TGTGCCAGCAGCGGGCGGAGGGTGCCCCCCAGCTCCTACAATGAGCAGTTCTTC	CASSGRRVPPSSYNEQFF	TRBV7-4	TRBJ2-1
TGCAGTGCGACACTGTTGATAAGGACAGGGACCCCCACCACCGGGGAGCTGTTTTTT	CSATLLIRTGTPTTGELFF	TRBV20-1	TRBJ2-2
TGCGCCAGCAGGTACAGGTCCTTATCGCCCCGCACAGATACGCAGTATTTT	CASRYRSLSPRTDTQYF	TRBV10-2	TRBJ2-3
TGTGCCAGCATGGGACAGGGAGAGAGGGGGGTGCGGGGAAACACCATATATTTT	CASMGQGERGVRGNTIYF	TRBV6-5	TRBJ1-3
TGCGCCAGCAGCTCCCTAGGCCAAGAGACCCAGTACTTC	CASSSLGQETQYF	TRBV5-1	TRBJ2-5
TGCGCCAGCAGCTTCACAGGGAAGGCTCTGTTTTTT	CASSFTGKALFF	TRBV5-1	TRBJ1-4
TGTGCCAGCAGCTTAGTTCAAGGGAGGGACTATACGCAGTATTTT	CASSLVQGRDYTQYF	TRBV7-9	TRBJ2-3
TGCGCCATAAGCCTTCGGGGAGGGGGAAACACCATATATTTT	CAISLRGGGNTIYF	TRBV5-1	TRBJ1-3
TGTGCCAGCAGCGGACTAGCGGGGGGTTCCGGTCCCCACAATGAGCAGTTCTTC	CASSGLAGGSGPHNEQFF	TRBV7-9	TRBJ2-1
TGTGCCAGCAGTTTAACCTCCCCGGACAGGGATAATCAGCCCCAGCATTTT	CASSLTSPDRDNQPQHF	TRBV28	TRBJ1-5
TGTGCCAGCAGCTTAGCGGGGAGTGAGCAGTTCTTC	CASSLAGSEQFF	TRBV7-4	TRBJ2-1
TGTGCTTTATGGGGGAACGATCAGCCCCAGCATTTT	CALWGNDQPQHF	TRBV12-3	TRBJ1-5
TGTGCCAGCAGCCCAAGCGCCAGATTCTACGAGCAGTACTTC	CASSPSARFYEQYF	TRBV6-5	TRBJ2-7
TGTGCCAGCAGCCCCCGGGGTAATGAAAAACTGTTTTTT	CASSPRGNEKLFF	TRBV7-2	TRBJ1-4
TGTGCCAGCAGCTTGGGATCCCTTCGCGAATCTATTCAGTACTTC	CASSLGSLRESIQYF	TRBV5-5	TRBJ2-4
TGCAGTGGTTCTACCGGGGGGACCGGCTCCTACGAGCAGTACTTC	CSGSTGGTGSYEQYF	TRBV20-1	TRBJ2-7
TGTGCCAGCAGTTACTTAGAACAGGGGGACTCCTACGAGCAGTACTTC	CASSYLEQGDSYEQYF	TRBV6-5	TRBJ2-7
TGTGCCACCAGTGATTCCCCCGACCGTGCGTCGGGGAGATTGCCACGTAGTAGTAGCAATCAGCCCCAGCATTTT	CATSDSPDRASGRLPRSSSNQPQHF	TRBV24-1	TRBJ1-5
TGCGCCAGCAGCCAGAGCTGGTCAGGGGGGTGTAATGGCTACACCTTC	CASSQSWSGGCNGYTF	TRBV4-1	TRBJ1-2
TGTGCCAGCAGCTTAGAGGACAGAGGGTCGAGCTCCTATAATTCACCCCTCCACTTT	CASSLEDRGSSSYNSPLHF	TRBV11-3	TRBJ1-6
TGCAGTGCTCGGGGGAGCTCCTACGAGCAGTACTTC	CSARGSSYEQYF	TRBV20-1	TRBJ2-7
TGTGCCACCAGCAGACGACAGTACGAGCAGTACTTC	CATSRRQYEQYF	TRBV15	TRBJ2-7
TGTGCCAGCAGTGACTCGACCGTCCTGTCTCCGGGACTAGCGGGAGGGCACAATGAGCAGTTCTTC	CASSDSTVLSPGLAGGHNEQFF	TRBV6-4	TRBJ2-1
TGTGCCAGCACTCAAATTGACAGGGTCAAGAACACCGGGGAGCTGTTTTTT	CASTQIDRVKNTGELFF	TRBV6-2	TRBJ2-2
TGTGCCAGCAGCTTGGCCCGAAAAAATAGAGAGCAGTACTTC	CASSLARKNREQYF	TRBV5-6	TRBJ2-7
TGCAGTGCTAGAGATCAGTCACCCCAGGGACCGAAGAGTATCTCCTCTGGAAACACCATATATTTT	CSARDQSPQGPKSISSGNTIYF	TRBV20-1	TRBJ1-3
TGTGCCAGCAGCTTAGCGGGAATAGGACAGGGTCCCCAGACCCAGTACTTC	CASSLAGIGQGPQTQYF	TRBV7-9	TRBJ2-5
TGTGCCAGGGACGCCGGGAATAATCAAGAGACCCAGTACTTC	CARDAGNNQETQYF	TRBV25-1	TRBJ2-5
TGCAGTGCTCGGGCCGAGGGGAACTCCACAGATACGCAGTATTTT	CSARAEGNSTDTQYF	TRBV20-1	TRBJ2-3
TGTGCCAGCAGCGAATTCGCACTTAGCTACGAGCAGTACTTC	CASSEFALSYEQYF	TRBV9	TRBJ2-7
TGTGCCAGCAGCCCCGGAGCCGATACGCAGTATTTT	CASSPGADTQYF	TRBV14	TRBJ2-3
TGCAGTGCCAGGGGACACAATCTGAACACTGAAGCTTTCTTT	CSARGHNLNTEAFF	TRBV20-1	TRBJ1-1
TGTGCCAGCATCGATGCTGGACAGTGGCCTCGCTACACCTTC	CASIDAGQWPRYTF	TRBV6-2	TRBJ1-2
TGTGCCAGCAGTTTTTTCGGGTCCTACGAGCAGTACTTC	CASSFFGSYEQYF	TRBV27	TRBJ2-7
TGCGCCAGCAGCGTCGTGGGGACTAACTATGGCTACACCTTC	CASSVVGTNYGYTF	TRBV5-1	TRBJ1-2
TGCAGTGCTAGAGGGTGCCAGGATAAGGGGTTTTACGTTAATTCACCCCTCCACTTT	CSARGCQDKGFYVNSPLHF	TRBV20-1	TRBJ1-6
TGTGCCAGCAGTTTATCACAAAACGGATACGAGCAGTACTTC	CASSLSQNGYEQYF	TRBV27	TRBJ2-7
TGTGCCTCGCCGAGAACACAGGGGGGGGAGCTGTTTTTT	CASPRTQGGELFF	TRBV9	TRBJ2-2
TGCGCCAGCAGTGATCCACAGGTGAGAATTCACGAGCAGTACTTC	CASSDPQVRIHEQYF	TRBV10-1	TRBJ2-7
TGCGCCAGCAGCCATCAGAGGGAGGGCTTT	CASSHQREGF	TRBV4-1	TRBJ1-1
TGTGCCAGCAGCGGACTAGCGGGGCGTGCCGAGCAGTACTTC	CASSGLAGRAEQYF	TRBV7-9	TRBJ2-7
TGTGCCAGCAGTTACTCGACCGGTGGATTGGGAGACGGGGGTCGGGGATACGAGCAGTACTTC	CASSYSTGGLGDGGRGYEQYF	TRBV6-6	TRBJ2-7
TGCGCCAGCAGCCGTAGAGCCTACAATGAGCAGTTCTTC	CASSRRAYNEQFF	TRBV10-1	TRBJ2-1
TGCGCCAGCGATCAGGGGAGTGATCAGCCCCAGCATTTT	CASDQGSDQPQHF	TRBV5-1	TRBJ1-5
TGCAGCGTTTGGGGACTAGCGGGGGGAAACACCGGGGAGCTGTTTTTT	CSVWGLAGGNTGELFF	TRBV29-1	TRBJ2-2
TGTGCCAGCAGTGGTCGCAGGGCGGCCCTCACTGAAGCTTTCTTT	CASSGRRAALTEAFF	TRBV6-5	TRBJ1-1
TGTGCCAGCAGCTTGGCCAGTACTGGCTACGAGCAGTACTTC	CASSLASTGYEQYF	TRBV5-4	TRBJ2-7
TGTGCCACCAGTGATTTTGGGGGAGCCACTGGAAACACCATATATTTT	CATSDFGGATGNTIYF	TRBV24-1	TRBJ1-3
TGTGCCAGCAGTGGAACCCGGCTAACTTACGAGCAGTACTTC	CASSGTRLTYEQYF	TRBV6-2	TRBJ2-7
TGCGCCAGCAGCTTGATAGGACAGGCGGGGAACACTGAAGCTTTCTTT	CASSLIGQAGNTEAFF	TRBV5-1	TRBJ1-1
TGCAGTGCTAGAGATAAAAAATTCGGGACGTGGTGGGACAGCGACAAAAACATTCAGTACTTC	CSARDKKFGTWWDSDKNIQYF	TRBV20-1	TRBJ2-4
TGTGCCAGCAGCGGAGACAGCTGCTTCGGGGAGCTGTTTTTT	CASSGDSCFGELFF	TRBV13	TRBJ2-2
TGTGCCAGCAGCGACGGGGAGCAGTACTTC	CASSDGEQYF	TRBV13	TRBJ2-7
TGCAGTGCTAGACCTAAAAGGGGGGGTGGACAGTACAATGAGCAGTTCTTC	CSARPKRGGGQYNEQFF	TRBV20-1	TRBJ2-1
TGCGCCAGCAGCTTGCCGGACCTGGTCTACGAGCAGTACTTC	CASSLPDLVYEQYF	TRBV5-1	TRBJ2-7
TGTGCCTGGAGTTCACCCGGACTAGATGATGAGCAGTTCTTC	CAWSSPGLDDEQFF	TRBV30	TRBJ2-1
TGTGCCAGCAGTTACCCAAGGGGCGGCTACGAGCAGTACTTC	CASSYPRGGYEQYF	TRBV6-3	TRBJ2-7
TGTGCCAGTAGTATAGAAAAAAGAAGAGTGGGGCTGTATAGCAATCAGCCCCAGCATTTT	CASSIEKRRVGLYSNQPQHF	TRBV19	TRBJ1-5
TGTGCCAGCAGCCCTCAAGGACGGAACACTGAAGCTTTCTTT	CASSPQGRNTEAFF	TRBV7-9	TRBJ1-1
TGTGCCAGCAGTTACTCGGCAGGGGGCGGAAACCTGTACGAGCAGTACTTC	CASSYSAGGGNLYEQYF	TRBV6-2	TRBJ2-7
TGTGCCAGCAGCAGACCCGGGGACACTTGCGAGCAGTACTTC	CASSRPGDTCEQYF	TRBV11-3	TRBJ2-7
TGTGCTAGCAGCTTAGAACTAGCACCGGAATTCTCCTACAATGAGCAGTTCTTC	CASSLELAPEFSYNEQFF	TRBV7-7	TRBJ2-1
TGCAGTGCTAGAAGGGAGGATCAGCCCCAGCATTTT	CSARREDQPQHF	TRBV20-1	TRBJ1-5
TGTGCCAGCAGTTACTCGAACCGCGGGAGGGGGGAATATGGCTACACCTTC	CASSYSNRGRGEYGYTF	TRBV6-5	TRBJ1-2
TGTGCCAGCATGACGGGGAGGGGGGGAGAGGTTCCAAGCACAGATACGCAGTATTTT	CASMTGRGGEVPSTDTQYF	TRBV3-1	TRBJ2-3
TGCGCCAGCAGTGAGGACCCACTAGCGGGAGGTGCCTACGAGCAGTACTTC	CASSEDPLAGGAYEQYF	TRBV10-2	TRBJ2-7
TGTGCCAGCTCACAAATAAGGGTCCTTGAGCAGTTCTTC	CASSQIRVLEQFF	TRBV18	TRBJ2-1
TGTGCCACAGGGGACAGGGCCCTGCCCCAGCATTTT	CATGDRALPQHF	TRBV27	TRBJ1-5
TGTGCCAGCAGCTTGGGGGGGGGCCGCTCCAATGAGCAGTTCTTC	CASSLGGGRSNEQFF	TRBV5-5	TRBJ2-1
TGTGCTAGTGGTTGGGGGGCGTTTCAAGAGACCCAGTACTTC	CASGWGAFQETQYF	TRBV12-5	TRBJ2-5
TGTGCCAGCATCTGGGAGACCCAGTACTTC	CASIWETQYF	TRBV6-1	TRBJ2-5
TGTGCCAGCAGTGGGGGACAGGGGGTTTTCCCCTACGAGCAGTACTTC	CASSGGQGVFPYEQYF	TRBV6-5	TRBJ2-7
TGTGCCAGCAGCCATAGTCAGGGGGTTAGCTCCTACGAGCAGTACTTC	CASSHSQGVSSYEQYF	TRBV7-4	TRBJ2-7
TGTGCCAGCAGCTTAGAACCGGGACAGGGGGACGGCTACACCTTC	CASSLEPGQGDGYTF	TRBV7-9	TRBJ1-2
TGTGCCAGCAGTGTGGAGGTCGGGTATGACACCTTC	CASSVEVGYDTF	TRBV27	TRBJ1-2
TGCGCCAGCAGTGTCAGGGGACGGCCAACGGTCAGCTCCTACGAGCAGTACTTC	CASSVRGRPTVSSYEQYF	TRBV10-2	TRBJ2-7
TGTGCCAGCAGAGTAAAGGGCGGGGAAGAGACCCAGTACTTC	CASRVKGGEETQYF	TRBV2	TRBJ2-5
TGTGCCAGCAGCACAGGGATTTACTACGAGCAGTACTTC	CASSTGIYYEQYF	TRBV7-3	TRBJ2-7
TGTGCCACCAGCTTCTGGACAGGGCTGAGTGGCTACACCTTC	CATSFWTGLSGYTF	TRBV15	TRBJ1-2
TGTGCCAGCAGCTTCTGGGGTGGACAGGGTGGGGCACAGCCCCAGCATTTT	CASSFWGGQGGAQPQHF	TRBV5-4	TRBJ1-5
TGCGCCAGCAGCTGGGGCGATCGGTCAAATGAAAAACTGTTTTTT	CASSWGDRSNEKLFF	TRBV5-1	TRBJ1-4
TGTGCCAGCAGCTTAGGGACAGGGGTTACCTACGAGCAGTACTTC	CASSLGTGVTYEQYF	TRBV9	TRBJ2-7
TGTGCCAGCAGTTACTCCGCCACAGGGGGTTACGAGCAGTACTTC	CASSYSATGGYEQYF	TRBV6-2	TRBJ2-7
TGTGCCAGCAGTTACTCGCTAAGGACAGGGGGGGCCAACGTCCTGACTTTC	CASSYSLRTGGANVLTF	TRBV6-5	TRBJ2-6
TGTGCCAGCAGTTTGCGGACAGATATGACTGAAGCTTTCTTT	CASSLRTDMTEAFF	TRBV12-3	TRBJ1-1
TGCGCCAGCAAGCTAGGGGGGGGCAATGAGCAGTTCTTC	CASKLGGGNEQFF	TRBV10-1	TRBJ2-1
TGTGCCAGGGGGTTGCGACACCGGAATCAGCCCCAGCATTTT	CARGLRHRNQPQHF	TRBV10-3	TRBJ1-5
TGTGCCAGCAGTCGACCCGGGACAGGGGGCGTTGATCAGCCCCAGCATTTT	CASSRPGTGGVDQPQHF	TRBV6-1	TRBJ1-5
TGCCTGGTCAGGGGGGGACCCTACGAGCAGTACTTC	CLVRGGPYEQYF	TRBV5-1	TRBJ2-7
TGTGCCAGTAGTTCTAACCCGGGACAGGGGACCAATCAGCCCCAGCATTTT	CASSSNPGQGTNQPQHF	TRBV19	TRBJ1-5
TGTGCCAGCAGCGGTAGGGGGCGGGGCTACGAGCAGTACTTC	CASSGRGRGYEQYF	TRBV9	TRBJ2-7
TGTGCCAGCGGGGGCGAAATCGCCTACGAGCAGTACTTC	CASGGEIAYEQYF	TRBV27	TRBJ2-7
TGTGCCAGCAGCTTGGGGACTAGCGGGCTAACGCAGTACTTC	CASSLGTSGLTQYF	TRBV5-5	TRBJ2-7
TGCAGTGCTAGAGATCGACGAGCCGGGGTCTTC	CSARDRRAGVF	TRBV20-1	TRBJ2-1
TGTGCCAGCAGCTTAGGACAGGGGGATGGGGGGACTGAAGCTTTCTTT	CASSLGQGDGGTEAFF	TRBV7-2	TRBJ1-1
TGTGCCAGCAGTTTGGCTATGGACAGGGCCGGGGTTGATGAGCAGTTCTTC	CASSLAMDRAGVDEQFF	TRBV28	TRBJ2-1
TGTGCCAGCAGCCAAGAAACGAAGGGAGGGGCTGATGAGCAGTTCTTC	CASSQETKGGADEQFF	TRBV14	TRBJ2-1
TGTGCCTGGATTCAAAGCTTAGAGTGGGGGTCGGTCCAAGAGACCCAGTACTTC	CAWIQSLEWGSVQETQYF	TRBV30	TRBJ2-5
TGTGCCAGCAGATCGTCCGGCCGGGACCCGGACCGGGATCAGCCCCAGCATTTT	CASRSSGRDPDRDQPQHF	TRBV6-5	TRBJ1-5
TGTGCCTGGGTTAACCGTTGTGGACAGGGTGTTGAAGGGGAAACTGAAGCTTTCTTT	CAWVNRCGQGVEGETEAFF	TRBV30	TRBJ1-1
TGTGCCATCAACGGAAACAGAGGAGTAGAAGAGACCCAGTACTTC	CAINGNRGVEETQYF	TRBV10-3	TRBJ2-5
TGTGCCAGTAGGCGGGAGGGGTCACCCTATGGCTACACCTTC	CASRREGSPYGYTF	TRBV19	TRBJ1-2
TGTGCCAGCAGCTGGGACAGGGGGCTATACAGTCCACCCCTCCACTTT	CASSWDRGLYSPPLHF	TRBV7-9	TRBJ1-6
TGTGCCAGCAGCCAAGATCGGGGCCGCTTTCTCGCAACTAATGAAAAACTGTTTTTT	CASSQDRGRFLATNEKLFF	TRBV14	TRBJ1-4
TGTGCCAGCAGTGGAGTATCCTACGAGCAGTACTTC	CASSGVSYEQYF	TRBV6-1	TRBJ2-7
TGCAGCGTTGAAGATTTACCAGTCCTAGCGGGCACCGGGGAGCTGTTTTTT	CSVEDLPVLAGTGELFF	TRBV29-1	TRBJ2-2
TGTGCCAGCAGCCCAAGACGGGACAGGGTTGGGGCCAACGTCCTGACTTTC	CASSPRRDRVGANVLTF	TRBV28	TRBJ2-6
TGCGCCAGCAGCTTGGAGGGCCGAGGACCGGGACAGCGGACTAACTATGGCTACACCTTC	CASSLEGRGPGQRTNYGYTF	TRBV5-1	TRBJ1-2
TGTGCCAGCGCGACAGGGGAGACCCAGTACTTC	CASATGETQYF	TRBV28	TRBJ2-5
TGTGCCAGCGATGAGGCTAGATTGACTGTTAGCAATCAGCCCCAGCATTTT	CASDEARLTVSNQPQHF	TRBV28	TRBJ1-5
TGCGCCAGCAGCCCGGGGGGGCCTCGGGCTCCCTACGAGCAGTACTTC	CASSPGGPRAPYEQYF	TRBV10-1	TRBJ2-7
TGTGCCAGCGCAGGGCCTGCCTACACAGATACGCAGTATTTT	CASAGPAYTDTQYF	TRBV27	TRBJ2-3
TGCAGTGCTAGAGTGCTAATGCAGAACGGGGAGCTGTTTTTT	CSARVLMQNGELFF	TRBV20-1	TRBJ2-2
TGTGCCAGCAGCCGGGCGGCAAAGGGGGCTTTCTTT	CASSRAAKGAFF	TRBV14	TRBJ1-1
TGTGCCTGGAAAGGGGGCGTAGGGTCAGAGACCCAGTACTTC	CAWKGGVGSETQYF	TRBV30	TRBJ2-5
TGTGCCAGCATCAGTGGGGGGACTGAAGCTTTCTTT	CASISGGTEAFF	TRBV6-4	TRBJ1-1
TGCGCCAAAGGGGGCTATAATTCACCCCTCCACTTT	CAKGGYNSPLHF	TRBV10-1	TRBJ1-6
TGTGCCAGCAGCCAAGATGACGGGACAGGGACGTTCTCAACTGGAAACACCATATATTTT	CASSQDDGTGTFSTGNTIYF	TRBV14	TRBJ1-3
TGCGCCAGCAGCCTGACAGGTAACTATGGCTACACCTTC	CASSLTGNYGYTF	TRBV5-1	TRBJ1-2
TGTGCCAGCAGCGCCTGTGTAACAAATGAGCAGTTCTTC	CASSACVTNEQFF	TRBV5-6	TRBJ2-1
TGTGCCAGCTGCCCCCCTCACGGACTAGCGGTGGGCTACAATGAGCAGTTCTTC	CASCPPHGLAVGYNEQFF	TRBV5-4	TRBJ2-1
TGCGCCAGCAGCCGGGGGGTTAACAGGGTTAGGCATGCCACTGAAGCTTTCTTT	CASSRGVNRVRHATEAFF	TRBV4-3	TRBJ1-1
TGCCCGACATCCTGGGGGGCCGATCAGGCCAAAAACATTCAGTACTTC	CPTSWGADQAKNIQYF	TRBV20-1	TRBJ2-4
TGTGCCAGCAGGCCCGGGACTTTTGGGGCCAACGTCCTGACTTTC	CASRPGTFGANVLTF	TRBV28	TRBJ2-6
TGTGCCAGCAGCTTCACCGGGACAATTTTCTTTCCCCAAGAGACCCAGTACTTC	CASSFTGTIFFPQETQYF	TRBV13	TRBJ2-5
TGCGCCAGCAGCTTCCAGGACAGGGAGCTCTCCTACGAGCAGTACTTC	CASSFQDRELSYEQYF	TRBV5-1	TRBJ2-7
TGTGCCAGCAGCTCACTAGCGGCGGTAGAGACCCAGTACTTC	CASSSLAAVETQYF	TRBV7-9	TRBJ2-5
TGCGCCAGCAGGACACACACTGAAGCTTTCTTT	CASRTHTEAFF	TRBV10-1	TRBJ1-1
TGTGCCAGCAGTGAAGGGGTAGAGAGCACAGATACGCAGTATTTT	CASSEGVESTDTQYF	TRBV6-1	TRBJ2-3
TGTGCCAGCTCACCAGGGAATGAGCAGTTCTTC	CASSPGNEQFF	TRBV18	TRBJ2-1
TGTGCCTGGAGTGTACGTCCGGGCTATCCTAATGAAAAACTGTTTTTT	CAWSVRPGYPNEKLFF	TRBV30	TRBJ1-4
TGCGCCAGCAGCTTCTGGGGGCCAACCCATTATAGCAATCAGCCCCAGCATTTT	CASSFWGPTHYSNQPQHF	TRBV5-1	TRBJ1-5
TGTGCCAGCAAGGGACAGCCGGAAACCCAGCCCCAGCATTTT	CASKGQPETQPQHF	TRBV6-2	TRBJ1-5
TGTGCCAGCAGCGGCGAGACGTCCTACGAGCAGTACTTC	CASSGETSYEQYF	TRBV7-3	TRBJ2-7
TGTGCCACCCTCCCCGTCCCCCGAGGGAACTACTATGGCTACACCTTC	CATLPVPRGNYYGYTF	TRBV24-1	TRBJ1-2
TGTGCCAGCAGCCCGACGGATGAGCAGTTCTTC	CASSPTDEQFF	TRBV12-4	TRBJ2-1
TGTGCCAGCAGCTGGGAGGGGGAGCCAGATACGCAGTATTTT	CASSWEGEPDTQYF	TRBV11-2	TRBJ2-3
TGTGCCAGCAGCAGACAGGGAAAAGGTACTCGTCCACAGGGCTACGAGCAGTACTTC	CASSRQGKGTRPQGYEQYF	TRBV11-1	TRBJ2-7
TGTGCCATTTTAGTGGGGTCGCACACCGGGGAGCTGTTTTTT	CAILVGSHTGELFF	TRBV12-3	TRBJ2-2
TGTGCCAGCAGCTGCAAGGAAAAGAGCGGGAAAGATACGCAGTATTTT	CASSCKEKSGKDTQYF	TRBV13	TRBJ2-3
TGTGCCAGCAGCTGGCTTAGGGACAGTCGAATACCCACTGAAGCTTTCTTT	CASSWLRDSRIPTEAFF	TRBV13	TRBJ1-1
TGTGCCAGCAGAAGAGATCAGCCCCAGCATTTT	CASRRDQPQHF	TRBV3-1	TRBJ1-5
TGTGCCAGCAGCTTTGCCGGGACTAGGGAGGAGACCCAGTACTTC	CASSFAGTREETQYF	TRBV5-6	TRBJ2-5
TGTGCCTGGAGCAGGTTACCTCCGAAACGGCTTACCCAGTACTTC	CAWSRLPPKRLTQYF	TRBV30	TRBJ2-5
TGTGCCAGCAGCGGGCCAGGGACTATTGGTCCCGGGGAGCTGTTTTTT	CASSGPGTIGPGELFF	TRBV13	TRBJ2-2
TGCAGTGCACACCCCGGGGGGGAGCGTGCTGAAGCTTTCTTT	CSAHPGGERAEAFF	TRBV20-1	TRBJ1-1
TGCAGCGTTGCGGGGCAGGGCTACAATGAGCAGTTCTTC	CSVAGQGYNEQFF	TRBV29-1	TRBJ2-1
TGCAGCGTTGGCCCCAAGGGCGAGCAGTACTTC	CSVGPKGEQYF	TRBV29-1	TRBJ2-7
TGTGCCAGCAGCTTGAGACATAGGTACGAGCAGTACTTC	CASSLRHRYEQYF	TRBV5-6	TRBJ2-7
TGTGCCAGCAGTTACCGGAATGGGGTGGAAAAACTGTTTTTT	CASSYRNGVEKLFF	TRBV6-3	TRBJ1-4
TGTGCCAGCAGTGACCTACGATCAAGTAGCCGGAACACTGAAGCTTTCTTT	CASSDLRSSSRNTEAFF	TRBV6-4	TRBJ1-1
TGTGCCACCAGTGATTTTCCGTCGAGAACCGGGGAGCTGTTTTTT	CATSDFPSRTGELFF	TRBV24-1	TRBJ2-2
TGTGCCAGCAAGCATCTAGCGGGGGACGAGCAGTACTTC	CASKHLAGDEQYF	TRBV11-2	TRBJ2-7
TGTGCCAGCAGAGCCACCTCGGGGTGGAAGGAGCAGTTCTTC	CASRATSGWKEQFF	TRBV6-1	TRBJ2-1
TGTGCCAGCAGCTTTATCTCGGGCAATCACGAGCAGTACTTC	CASSFISGNHEQYF	TRBV7-2	TRBJ2-7
TGTGCCAGCAGCTTACCGACAGGGGGCATGGGAAACACCATATATTTT	CASSLPTGGMGNTIYF	TRBV11-3	TRBJ1-3
TGTGCCAGCAGTATGACTACAAGAAATCAGCCCCAGCATTTT	CASSMTTRNQPQHF	TRBV12-3	TRBJ1-5
TGTGCCAGCAGCTCCCCGACAGGAAACAATCAGCCCCAGCATTTT	CASSSPTGNNQPQHF	TRBV7-2	TRBJ1-5
TGCGCCAGCAGCCCAGTGGCCCGGAGGATCGTACGGGGGACTAGCGGCGGCCATGAGCAGTTCTTC	CASSPVARRIVRGTSGGHEQFF	TRBV4-1	TRBJ2-1
TGTGCCAGCAGTTTGGGCAATGAAAAACTGTTTTTT	CASSLGNEKLFF	TRBV28	TRBJ1-4
TGTGCCAGCAGCCAAGTATACAGGATTGTCGATGCCTACAATGAGCAGTTCTTC	CASSQVYRIVDAYNEQFF	TRBV3-1	TRBJ2-1
TGCGCCAGCAGTCAAAGGACAGGGGGAGCCAAAAACATTCAGTACTTC	CASSQRTGGAKNIQYF	TRBV5-1	TRBJ2-4
TGTGCCAGCAGCGTCGGGACTAGCAACTACGAGCAGTACTTC	CASSVGTSNYEQYF	TRBV7-3	TRBJ2-7
TGTGCCACCAGCCGCGTAAGGGGACAGTTGGAGACAGAGACCCAGTACTTC	CATSRVRGQLETETQYF	TRBV15	TRBJ2-5
TGCAGCGTTTTGACAGGATGGGGTCATTCACCCCTCCACTTT	CSVLTGWGHSPLHF	TRBV29-1	TRBJ1-6
TGTGCCAGCAGTGAATTTGGGAGGGGGGGAGGGACCCAGTACTTC	CASSEFGRGGGTQYF	TRBV6-1	TRBJ2-5
TGTGCCAGCAGTTTCGTATACGAGCAGTACTTC	CASSFVYEQYF	TRBV27	TRBJ2-7
TGTGCCAGCAGTAGTAGCGGGAGGAGTTTGAGCTCCTATAATTCACCCCTCCACTTT	CASSSSGRSLSSYNSPLHF	TRBV11-3	TRBJ1-6
TGTGCCAGCAGCGCCCTGACTAGCGGGGGGGCCCGTCAAGAGACCCAGTACTTC	CASSALTSGGARQETQYF	TRBV7-3	TRBJ2-5
TGCGCCAGCAGTGCTGGGACTAGCGGCTTACACACCGGGGAGCTGTTTTTT	CASSAGTSGLHTGELFF	TRBV10-1	TRBJ2-2
TGCGCCAGCAGCTTGACACCGGTAGGACAAGAGACCCAGTACTTC	CASSLTPVGQETQYF	TRBV5-1	TRBJ2-5
TGCGCCAGCAGCGTGCGGGACGGCTACGAGCAGTACTTC	CASSVRDGYEQYF	TRBV4-1	TRBJ2-7
TGTGCCAGCAAAAGGGGGGGCCAAAGAACTGGAAACACCATATATTTT	CASKRGGQRTGNTIYF	TRBV28	TRBJ1-3
TGTGCCAGCAGTTGGGCCGGACGTTCGGACATTCAGTACTTC	CASSWAGRSDIQYF	TRBV12-4	TRBJ2-4
TGTGCCAGCAGCTTAGTCCTTGGTAACGGGAGGTGCGCCTACGAGCAGTACTTC	CASSLVLGNGRCAYEQYF	TRBV11-3	TRBJ2-7
TGTGCCAGCCCCCACAGGGGTCTGGATCAGCCCCAGCATTTT	CASPHRGLDQPQHF	TRBV7-3	TRBJ1-5
TGTGCCAGCAGTGAGTGCGCAAACACCTGGAGCTACAATGAGCAGTTCTTC	CASSECANTWSYNEQFF	TRBV2	TRBJ2-1
TGTGCCTGGGTCGCCAGGACAGGGCTCCCCTACGAGCAGTACTTC	CAWVARTGLPYEQYF	TRBV6-1	TRBJ2-7
TGTGCCAGCGGGTCGAAAGAGGGCGGGAGCTACAATGAGCAGTTCTTC	CASGSKEGGSYNEQFF	TRBV5-6	TRBJ2-1
TGTGCCAGCAGTCCTATAGTTTTGGGGACAGGGGAGACCCAGTACTTC	CASSPIVLGTGETQYF	TRBV28	TRBJ2-5
TGTGCCTGGAGTGGTCGGTCGACCAGTACCTACGAGCAGTACTTC	CAWSGRSTSTYEQYF	TRBV30	TRBJ2-7
TGTGCCAGCAGCCCCGGGACCCCCGGGGAGCTGTTTTTT	CASSPGTPGELFF	TRBV7-2	TRBJ2-2
TGTGCCACGGTTACAGGGTTCCGCAATGAGCAGTTCTTC	CATVTGFRNEQFF	TRBV2	TRBJ2-1
TGCGCCAGCAGCCAAGACTTGAGAAACACCATATATTTT	CASSQDLRNTIYF	TRBV4-3	TRBJ1-3
TGTGCCAGCAGGGACCCCTACAATGAGCAGTTCTTC	CASRDPYNEQFF	TRBV13	TRBJ2-1
TGTGCCAGCAGTTGGCCGGTCAGGGGACCGAACACCGGGGAGCTGTTTTTT	CASSWPVRGPNTGELFF	TRBV6-9	TRBJ2-2
TGCAGTGCTAGAGGGACGGGACAGGGCTCATGCGAAAAACTGTTTTTT	CSARGTGQGSCEKLFF	TRBV20-1	TRBJ1-4
TGCAGCGTTGCCGTCCGCGACAATGAGCAGTTCTTC	CSVAVRDNEQFF	TRBV29-1	TRBJ2-1
TGCGCCAGCATTTTGAGCCTAGGACCCGGGAACAGTGGATCGACGCAGTATTTT	CASILSLGPGNSGSTQYF	TRBV10-1	TRBJ2-3
TGTGCCAGCCATAGCGGGACGCAGTATTTT	CASHSGTQYF	TRBV14	TRBJ2-3
TGTGCCAGCAGTTACCCCGTCCACCCCGGAGGGATCTACACCGGGGAGCTGTTTTTT	CASSYPVHPGGIYTGELFF	TRBV6-5	TRBJ2-2
TGTGCCAGCATTAGGCCTAGCCAGGTTTGGGGCTACAATGAGCAGTTCTTC	CASIRPSQVWGYNEQFF	TRBV6-5	TRBJ2-1
TGTGCCAGCAGCTTATCATGCACTGGAGATACGCAGTATTTT	CASSLSCTGDTQYF	TRBV11-2	TRBJ2-3
TGTGCCAGCAGTGACCCCGATCATCGCAATCAGCCCCAGCATTTT	CASSDPDHRNQPQHF	TRBV6-4	TRBJ1-5
TGTGCCAGCAGAGGGATAAGGGGAGGCTACACCTTC	CASRGIRGGYTF	TRBV6-2	TRBJ1-2
TGCGCCAGCAGCAGGGGGGGAGGGGGGGAGCAGTTCTTC	CASSRGGGGEQFF	TRBV5-1	TRBJ2-1
TGTGCCAGCAGCATAAAGGCAGGGACGAAGGCCTACGAGCAGTACTTC	CASSIKAGTKAYEQYF	TRBV6-8	TRBJ2-7
TGTGCCAGCAGCTTAGGCGCGACTTACAGATGTAGGGGCTACACCTTC	CASSLGATYRCRGYTF	TRBV7-2	TRBJ1-2
TGTGCCAGCAGCTTTCCGTACAGGGCCCCTGGGGCCAAAAACATTCAGTACTTC	CASSFPYRAPGAKNIQYF	TRBV5-6	TRBJ2-4
TGTGCCAGCAGCTTGCGGTCTAAAAAGGGGACCTACGAGCAGTACTTC	CASSLRSKKGTYEQYF	TRBV5-4	TRBJ2-7
TGTGCTAGTGGTTCCCACAGACAGGGATGGAACTATGGCTACACCTTC	CASGSHRQGWNYGYTF	TRBV12-5	TRBJ1-2
TGCGCCAGCAGCTTGGTCGGCCCGGGGCCTAACTATGGCTACACCTTC	CASSLVGPGPNYGYTF	TRBV5-1	TRBJ1-2
TGTGCCAGCAGAAAGGTCGGTCGAGAGGCACGCTACAATGAGCAGTTCTTC	CASRKVGREARYNEQFF	TRBV2	TRBJ2-1
TGTGCCAGCGACCGGGACAGGGGAATGGACTATGGCTACACCTTC	CASDRDRGMDYGYTF	TRBV6-1	TRBJ1-2
TGTGCCACTCCCGGGACAGCCGTACGGAACAATGAGCAGTTCTTC	CATPGTAVRNNEQFF	TRBV24-1	TRBJ2-1
TGTGCCTGGAGTGGAGGCCAAGAGACCCAGTACTTC	CAWSGGQETQYF	TRBV30	TRBJ2-5
TGTGCCAGCAGCTTAAGTGGGGACAGCTATGGCTACACCTTC	CASSLSGDSYGYTF	TRBV5-4	TRBJ1-2
TGTGCGACAGATTGTATTTCCTCCTATAATTCACCCCTCCACTTT	CATDCISSYNSPLHF	TRBV27	TRBJ1-6
TGTGCCAGCAGAAGGGGGCCCGCGACTTATCAGCCCCAGCATTTT	CASRRGPATYQPQHF	TRBV28	TRBJ1-5
TGTGCCAGCAGTCAGTTGGGGCAGGGCCTCGGGGAGCTGTTTTTT	CASSQLGQGLGELFF	TRBV6-2	TRBJ2-2
TGTGCCTGGAGTGAATCAGGGCCTCACAATCAGCCCCAGCATTTT	CAWSESGPHNQPQHF	TRBV30	TRBJ1-5
TGTGCCAGCAGCTTAGTCACTAGCGAGCAGTACTTC	CASSLVTSEQYF	TRBV7-3	TRBJ2-7
TGCGCCAGCAGCTTGGAGGACAGGGAGCCACCCCTCCACTTT	CASSLEDREPPLHF	TRBV5-1	TRBJ1-6
TGTGCCAGCAAAGGACCGGGGACTAGTGCCATCTCGGGCACAGATACGCAGTATTTT	CASKGPGTSAISGTDTQYF	TRBV6-3	TRBJ2-3
TGTGCCAGCAGCTTAAGACAGATGTACACTGAAGCTTTCTTT	CASSLRQMYTEAFF	TRBV11-3	TRBJ1-1
TGCGCCAGCAGCTTTTTAGAAAACTCCTACGAGCAGTACTTC	CASSFLENSYEQYF	TRBV5-1	TRBJ2-7
TGTGCCAGCAGCCAACTGGGGCGGAGACGCCAAGAGACCCAGTACTTC	CASSQLGRRRQETQYF	TRBV3-1	TRBJ2-5
TGTGCCTACCGGGACAGGAGACGCAATCAGCCCCAGCATTTT	CAYRDRRRNQPQHF	TRBV19	TRBJ1-5
TGTGCCAGCAGAGGAGCCCTCAGGTGGGCAAGGGCCCAGCATTTT	CASRGALRWARAQHF	TRBV6-5	TRBJ1-5
TGTGCCAGCAGTCTCCATACAGGGCTCTCTGGAAACACCATATATTTT	CASSLHTGLSGNTIYF	TRBV6-3	TRBJ1-3
TGTGCCAGCACCTCTGAGGGTAATTCACCCCTCCACTTT	CASTSEGNSPLHF	TRBV6-4	TRBJ1-6
TGTGCCAGCACCCTGATTGTCCGGGCCGGTTACACTGAAGCTTTCTTT	CASTLIVRAGYTEAFF	TRBV5-6	TRBJ1-1
TGCAGTGCTGAGCTGGCGAGGGGGTGGAGCTACACCTTC	CSAELARGWSYTF	TRBV20-1	TRBJ1-2
TGCAGCGAGGCCAGGACTCAAAACATTCAGTACTTC	CSEARTQNIQYF	TRBV29-1	TRBJ2-4
TGTGCCAGCAGCTTGCATGGGGAGAGCACAGATACGCAGTATTTT	CASSLHGESTDTQYF	TRBV5-6	TRBJ2-3
TGTCTCCGGGGCGGGAGCCGCTATAGCAATCAGCCCCAGCATTTT	CLRGGSRYSNQPQHF	TRBV10-3	TRBJ1-5
TGCAGTGCTAGCACGGAGGGGGAACCGGGGCAATCCGGGGAGCTGTTTTTT	CSASTEGEPGQSGELFF	TRBV20-1	TRBJ2-2
TGTGCCAGCAGCAATACGGTCTCGGCCTACGAGCAGTACTTC	CASSNTVSAYEQYF	TRBV9	TRBJ2-7
TGTGCCAGCAGAATTTGCCGGGGGCGCAAGAGCGCCCGGAATGAGCAGTTCTTC	CASRICRGRKSARNEQFF	TRBV6-6	TRBJ2-1
TGTGCCAGCAGCAGAACGACCCATCAGCCCCAGCATTTT	CASSRTTHQPQHF	TRBV6-4	TRBJ1-5
TGTGCCAGTAGTATAGCGTACTACGAGGGGACAGATACGCAGTATTTT	CASSIAYYEGTDTQYF	TRBV19	TRBJ2-3
TGTGCCACCAGTGAGACTGGAGGACAATACACTGAAGCTTTCTTT	CATSETGGQYTEAFF	TRBV24-1	TRBJ1-1
TGCGCCAGCAGCCAAGAATACCGACAGGTCAATCAGCCCCAGCATTTT	CASSQEYRQVNQPQHF	TRBV4-1	TRBJ1-5
TGTGCCAGCAGCCACAAGCAGGGGACGGGAATACCCAATCAGCCCCAGCATTTT	CASSHKQGTGIPNQPQHF	TRBV3-1	TRBJ1-5
TGTGCCAGCAGTCCCCGGGGGGGCCTTGTTAATGAGCAGTTCTTC	CASSPRGGLVNEQFF	TRBV11-3	TRBJ2-1
TGTGCCAGCAGTGTAGTTCCCAGCTCCTACAATGAGCAGTTCTTC	CASSVVPSSYNEQFF	TRBV25-1	TRBJ2-1
TGTGCCAGCAGCTTAGCCCATCTGGGGGAAGCTTTCTTT	CASSLAHLGEAFF	TRBV7-4	TRBJ1-1
TGTGCCAGCAGTTTATGGGGGCGGGACTATGGCTACACCTTC	CASSLWGRDYGYTF	TRBV27	TRBJ1-2
TGTGCCAGCAGCTTGTCAGCTGGGTCATTGGGTATGACCTACAATGAGCAGTTCTTC	CASSLSAGSLGMTYNEQFF	TRBV5-6	TRBJ2-1
TGTGCCAGCAGTGAGTCGGCCAAAAACATTCAGTACTTC	CASSESAKNIQYF	TRBV27	TRBJ2-4
TGTGCCAGCAGCTTAGGGAGGGAGATGTACTACGAGCAGTACTTC	CASSLGREMYYEQYF	TRBV6-8	TRBJ2-7
TGTGCCAGCAGTGAAAACCCACAGGGGGCACCTGGGGCCAACGTCCTGACTTTC	CASSENPQGAPGANVLTF	TRBV6-1	TRBJ2-6
TGTGCCATCATAATAGTCGAAGGGATGAACACTGAAGCTTTCTTT	CAIIIVEGMNTEAFF	TRBV10-3	TRBJ1-1
TGCGCCAGCAGGGAAGGACAGGGGCGCCCCCGGCCCCAGCATTTT	CASREGQGRPRPQHF	TRBV5-1	TRBJ1-5
TGTGCCAGCAGTTTCGAGCGGGAGAGGACTGAAGCTTTCTTT	CASSFERERTEAFF	TRBV6-1	TRBJ1-1
TGTGCCAGTAGTATAGGGGGACAGTCTAGTGTGGGCACAGATACGCAGTATTTT	CASSIGGQSSVGTDTQYF	TRBV19	TRBJ2-3
TGTGCCAGCAGCGTGAGGAAATGTCCCTCGGGGGGCCCTAACGAGCAGTACTTC	CASSVRKCPSGGPNEQYF	TRBV7-3	TRBJ2-7
TGTGCCAGCAGCTGCAGGGGTGAGACAGACTCCTACGAGCAGTACTTC	CASSCRGETDSYEQYF	TRBV11-2	TRBJ2-7
TGTGCCAGTAGTACGGTTGACGGTAACCAGAAAGGCACCGGGGAGCTGTTTTTT	CASSTVDGNQKGTGELFF	TRBV19	TRBJ2-2
TGTGCCAGCAGCTTCCCTCCGGTTGGCTACACCTTC	CASSFPPVGYTF	TRBV7-8	TRBJ1-2
TGTGCCAGCAGCCAAGGTCGGACCGTGCTGAACACTGAAGCTTTCTTT	CASSQGRTVLNTEAFF	TRBV3-1	TRBJ1-1
TGTGCCAGCAGCGCGGGACTAGAAGGTTCGACGCGGGTGGGCTCTGGGGCCAACGTCCTGACTTTC	CASSAGLEGSTRVGSGANVLTF	TRBV13	TRBJ2-6
TGTGCTAGTGTAACGGGGGGGGGGAAGTTCACAGATACGCAGTATTTT	CASVTGGGKFTDTQYF	TRBV12-5	TRBJ2-3
TGCGCCAGCAGCTGTCGGAGGGTCGAGCAGTACTTC	CASSCRRVEQYF	TRBV5-1	TRBJ2-7
TGTGCCAGCAGCCAAGCCCTCCGGAGCGGGAGCCTGTACAATGAGCAGTTCTTC	CASSQALRSGSLYNEQFF	TRBV3-1	TRBJ2-1
TGCGCCAGCAGCTCATTAGATATCCCAGAGCTGACCGGGGAGCTGTTTTTT	CASSSLDIPELTGELFF	TRBV5-1	TRBJ2-2
TGTGCCAGCAGCTTGATCCTCCCAGGGGGCCTAGAGACCCAGTACTTC	CASSLILPGGLETQYF	TRBV5-6	TRBJ2-5
TGTGCCACCAGTGAACCAGGGGGGGGGAACACCGGGGAGCTGTTTTTT	CATSEPGGGNTGELFF	TRBV24-1	TRBJ2-2
TGCGCCAGCAGCTCTCAACGGGAGGGAAATGAGCAGTTCTTC	CASSSQREGNEQFF	TRBV5-1	TRBJ2-1
TGTGCCATCAGGGAGCGGGACAGGGAGGCTGGAAACACCATATATTTT	CAIRERDREAGNTIYF	TRBV10-3	TRBJ1-3
TGCAGTGCTAGAGACCGATCCCAACTAGTGGTTGCAGAGACCCAGTACTTC	CSARDRSQLVVAETQYF	TRBV20-1	TRBJ2-5
TGTGCCAGCAGCCAAGTCCTCCCCCAGTGGCAGTACGAGCAGTACTTC	CASSQVLPQWQYEQYF	TRBV4-2	TRBJ2-7
TGTGCCAGCAGCCCTGGGACAGGGGCCCCCTACGAGCAGTACTTC	CASSPGTGAPYEQYF	TRBV6-1	TRBJ2-7
TGTGCCAGCAGCTCTACAGGGGGGGAAGTATATGCCTACGAGCAGTACTTC	CASSSTGGEVYAYEQYF	TRBV11-3	TRBJ2-7
TGTGCCAGCAGCTTGGTCGGAGGTACGGTCTACGAGCAGTACTTC	CASSLVGGTVYEQYF	TRBV5-5	TRBJ2-7
TGTGCCAGCAGTACCCACGGGGGTCTTTATGAGCAGTTCTTC	CASSTHGGLYEQFF	TRBV28	TRBJ2-1
TGTGCCAGCAGTGGTCTTACGCCTAGCGGGGGGGGCAATGAGCAGTTCTTC	CASSGLTPSGGGNEQFF	TRBV6-6	TRBJ2-1
TGTGCCAGCAGCGCGGGAGGGGATATTAATCAGCCCCAGCATTTT	CASSAGGDINQPQHF	TRBV9	TRBJ1-5
TGTGCCAGCAGTGACTCGAACCCTTCCTACGAGCAGTACTTC	CASSDSNPSYEQYF	TRBV6-4	TRBJ2-7
TGTGCTAGTGGGTGTCACAGGGGATGTGGGGGACAGCCCCAGCATTTT	CASGCHRGCGGQPQHF	TRBV12-5	TRBJ1-5
TGCGCCAGCAGTGGCCCTCGGACAGGGTTTCGCAATGAGCAGTTCTTC	CASSGPRTGFRNEQFF	TRBV10-1	TRBJ2-1
TGTGCCAGCAGTTTGACTGGTCCCCATTTAATGCAGCCCTACGAGCAGTACTTC	CASSLTGPHLMQPYEQYF	TRBV27	TRBJ2-7
TGTGCCAGCAGCTCTAGGGACCTGTTGGGCTCCACTGAAGCTTTCTTT	CASSSRDLLGSTEAFF	TRBV13	TRBJ1-1
TGTGCCAGCAGCTTAGCCGGACAGGGGGACCGGGGAAGGCAGCCCCAGCATTTT	CASSLAGQGDRGRQPQHF	TRBV7-9	TRBJ1-5
TGTGCCAGCAGCCAAGGACGGAGGCCGAAGCAAGAGACCCAGTACTTC	CASSQGRRPKQETQYF	TRBV4-2	TRBJ2-5
TGTGCCTGGAGTGGGGGCCCAGCCAAAAACATTCAGTACTTC	CAWSGGPAKNIQYF	TRBV30	TRBJ2-4
TGTGACCTCTGGGCAAAATTCTACGAGCAGTACTTC	CDLWAKFYEQYF	TRBV6-5	TRBJ2-7
TGTGCCAGCAGCGTTCCCACTGGGGTAATACAGCCCCAGCATTTT	CASSVPTGVIQPQHF	TRBV11-2	TRBJ1-5
TGTGCCAGCAGCGCGGGAGCTCTAAATGAAAAACTGTTTTTT	CASSAGALNEKLFF	TRBV6-4	TRBJ1-4
TGTGCCGGACAGGGGAACTATGGCTACACCTTC	CAGQGNYGYTF	TRBV12-4	TRBJ1-2
TGTGCCAGCAGCTTAGGCGAGCGGGTGCGGAACACCGGGGAGCTGTTTTTT	CASSLGERVRNTGELFF	TRBV11-3	TRBJ2-2
TGTGCCAGCAGCTTGCAGGAGGTGAGGAACACTGAAGCTTTCTTT	CASSLQEVRNTEAFF	TRBV5-6	TRBJ1-1
TGTGCCAGCAGCCGTATCCCAGGGGCGTGTTGCAATCAGCCCCAGCATTTT	CASSRIPGACCNQPQHF	TRBV9	TRBJ1-5
TGTGCCATCAGTATACAGGCTCGTAACTATGGCTACACCTTC	CAISIQARNYGYTF	TRBV10-3	TRBJ1-2
TGCAGCGTCCGACGGGGGAGCCCGCCGTATGGCTACACCTTC	CSVRRGSPPYGYTF	TRBV29-1	TRBJ1-2
TGTGCCAGCAACGCCTTCATGACAGGGCCGGGGCATCAGCCCCAGCATTTT	CASNAFMTGPGHQPQHF	TRBV6-6	TRBJ1-5
TGTGCCAGCAGTCCCGGGGGCCCAGAGACCCAGTACTTC	CASSPGGPETQYF	TRBV27	TRBJ2-5
TGTGCCAGCAGCCTTCAATATTACAGGACAAACACCGGGGAGCTGTTTTTT	CASSLQYYRTNTGELFF	TRBV13	TRBJ2-2
TGTGCCAGCAGCGGTCCTCTCATAAGAGTGGGGGGGCATGGGTTCGTCCGTTTATTTTACGAGCAGTACTTC	CASSGPLIRVGGHGFVRLFYEQYF	TRBV6-1	TRBJ2-7
TGCAGCGTTGGGTCGGGACACGAGACCCAGTACTTC	CSVGSGHETQYF	TRBV29-1	TRBJ2-5
TGTGCCACCACACGTTCTGGAAACACCATATATTTT	CATTRSGNTIYF	TRBV10-3	TRBJ1-3
TGTGCCTGGAGTGAAATTCCCCAGGGGGGTTACGAGCAGTACTTC	CAWSEIPQGGYEQYF	TRBV30	TRBJ2-7
TGTGCCAGCAGCTTACCCTCCGGGGAAGGATCGTACGAGCAGTACTTC	CASSLPSGEGSYEQYF	TRBV7-9	TRBJ2-7
TGTGCCAGCAGTGATCTTATGGGGGAGGGCAGCAATCAGCCCCAGCATTTT	CASSDLMGEGSNQPQHF	TRBV25-1	TRBJ1-5
TGCAGTGCTTTTCCCCGGGGGTACACGGCGAACACCGGGGAGCTGTTTTTT	CSAFPRGYTANTGELFF	TRBV20-1	TRBJ2-2
TGCAGCGGCCGCCGAGATACGCAGTATTTT	CSGRRDTQYF	TRBV29-1	TRBJ2-3
TGTGCCAGCAGCTTCATCCGTACAGGGGGCCCCTTCGGGGAGCTGTTTTTT	CASSFIRTGGPFGELFF	TRBV11-2	TRBJ2-2
TGTGCCAGCAGTAGCGGGGACAGGGGAAACAATGAGCAGTTCTTC	CASSSGDRGNNEQFF	TRBV12-4	TRBJ2-1
TGCGCCAGCAGCTTGTCGTGTAATGGACAGGGGAACATTCAGTACTTC	CASSLSCNGQGNIQYF	TRBV5-1	TRBJ2-4
TGCGCCAGCAGCTCCGAGAGCCACACTGAAGCTTTCTTT	CASSSESHTEAFF	TRBV5-1	TRBJ1-1
TGCAGTGCGGGACACCCGAATCAGCCCCAGCATTTT	CSAGHPNQPQHF	TRBV20-1	TRBJ1-5
TGTGCCAGCTCACCCTGGAGACAGGCGCTATCTTCGACTGAAGCTTTCTTT	CASSPWRQALSSTEAFF	TRBV18	TRBJ1-1
TGTGCCACCAGTGACATAACAGGTATCCTTGGCTACACCTTC	CATSDITGILGYTF	TRBV24-1	TRBJ1-2
TGTGCCATCGCCATGACAGGGGGCGCCTCCTACGAGCAGTACTTC	CAIAMTGGASYEQYF	TRBV10-3	TRBJ2-7
TGTGCCAACAAGACTCAGCCCCAGCATTTT	CANKTQPQHF	TRBV19	TRBJ1-5
TGTGCCAGCAGGGGAACTAGTGGGCTCTTGATGAACGACAATGAGCAGTTCTTC	CASRGTSGLLMNDNEQFF	TRBV6-6	TRBJ2-1
TGTGCCATTAGACAGGGACAAGGGCACGGCGGCTATGGCTACACCTTC	CAIRQGQGHGGYGYTF	TRBV6-3	TRBJ1-2
TGTGCCAGCATGACCGGAAGCTCCTACGAGCAGTACTTC	CASMTGSSYEQYF	TRBV6-1	TRBJ2-7
TGCAGCGTTGAAGATGGTAGGGCCTCCTACGAGCAGTACTTC	CSVEDGRASYEQYF	TRBV29-1	TRBJ2-7
TGTGCCAGCAGCCCGACAGGGAGACTGAACACTGAAGCTTTCTTT	CASSPTGRLNTEAFF	TRBV13	TRBJ1-1
TGCAGTGCTAGAGAGGCTCGACAGTTCCGGGAGCAGTACTTC	CSAREARQFREQYF	TRBV20-1	TRBJ2-7
TGCGCCAGCAGTGGAGGCGGGAGCGGGCCCCCCGATGCAACTAATGAAAAACTGTTTTTT	CASSGGGSGPPDATNEKLFF	TRBV10-2	TRBJ1-4
TGTGCCAGCAGTGGCCGGTCACTAGCGGGTGGGGCCTACGAGCAGTACTTC	CASSGRSLAGGAYEQYF	TRBV6-4	TRBJ2-7
TGTGCCAGCAGTGAAAGGGGACTAGCGGGGTTCTGTGAGCAGTTCTTC	CASSERGLAGFCEQFF	TRBV2	TRBJ2-1
TGTGCCAGCAACGAGAAGGGGCGTAATGAAAAACTGTTTTTT	CASNEKGRNEKLFF	TRBV7-8	TRBJ1-4
TGTGCCAGCAGCCTGACTAGCGGGGAGACCCAGTACTTC	CASSLTSGETQYF	TRBV11-3	TRBJ2-5
TGTGCCAGCAGTTACTCTCCCCCTACCACTGGAAACACCATATATTTT	CASSYSPPTTGNTIYF	TRBV6-2	TRBJ1-3
TGCAGTGCTAGAGATCTCCCACTAGGATATGAGCAGTTCTTC	CSARDLPLGYEQFF	TRBV20-1	TRBJ2-1
TGTGCCAGCAGCGGGAAGGGGCCTAATGAAAAACTGTTTTTT	CASSGKGPNEKLFF	TRBV14	TRBJ1-4
TGTGCCACCAGTGAGTCGCCTGAGAGGGCCACTACGCAGTATTTT	CATSESPERATTQYF	TRBV24-1	TRBJ2-3
TGTGCCAGCAGCTTGAAACGGACTAGCGTTAGGTACAATGAGCAGTTCTTC	CASSLKRTSVRYNEQFF	TRBV5-6	TRBJ2-1
TGCAGCACTCCCCACAACGAGCAGTACTTC	CSTPHNEQYF	TRBV29-1	TRBJ2-7
TGTGCCAGCAGCGTAGCTGGGGGCTCCGGGCCATATGAGCAGTTCTTC	CASSVAGGSGPYEQFF	TRBV9	TRBJ2-1
TGTGCCAGCAGCTTAGGGTTGCGCATATCTTTCAGAGAGACCCAGTACTTC	CASSLGLRISFRETQYF	TRBV7-8	TRBJ2-5
TGTGCCAGCAGCTTCCTTCGACAGGGGATTGGATACACTGAAGCTTTCTTT	CASSFLRQGIGYTEAFF	TRBV7-3	TRBJ1-1
TGTGCCAGCAGCTTAGGCAGGGACAGGGGGCGAAACCATAGCAATCAGCCCCAGCATTTT	CASSLGRDRGRNHSNQPQHF	TRBV7-9	TRBJ1-5
TGCGCCAGCAGTGCGTTTAGGGGGGAAACTGAAGCTTTCTTT	CASSAFRGETEAFF	TRBV10-1	TRBJ1-1
TGTGCCAGCAGTTCCCCCAAGGTGGAAACCACCAATCAGCCCCAGCATTTT	CASSSPKVETTNQPQHF	TRBV12-4	TRBJ1-5
TGTGCCAGCAGTTGGTCGTTCGGGGGGTCGTATCAGCCCCAGCATTTT	CASSWSFGGSYQPQHF	TRBV6-5	TRBJ1-5
TGCAGTGCTCTCCGGGTATTTAAGACTAGGCCCCCAGGCTTGAATGAGCAGTTCTTC	CSALRVFKTRPPGLNEQFF	TRBV20-1	TRBJ2-1
TGTGCCAGCAGCCAAGATGCGAGGGGTCAAGCCTACGAGCAGTACTTC	CASSQDARGQAYEQYF	TRBV14	TRBJ2-7
TGTGCCAGCAGCCAAGACAAAACCTACGAGCAGTACTTC	CASSQDKTYEQYF	TRBV14	TRBJ2-7
TGTGCCAGCAGTTTGAGGGGGGGAGGGAATGAGCAGTTCTTC	CASSLRGGGNEQFF	TRBV27	TRBJ2-1
TGCAGCGTCGCGGATCAGCCCCAGCATTTT	CSVADQPQHF	TRBV29-1	TRBJ1-5
TGTGCCAGCAGTAACGGACAGGGGGAGGTCTCCTATAATTCACCCCTCCACTTT	CASSNGQGEVSYNSPLHF	TRBV6-5	TRBJ1-6
TGTGCCTGGAGTCATCAGAGGATAGCGGAGACAGGCACAGATACGCAGTATTTT	CAWSHQRIAETGTDTQYF	TRBV30	TRBJ2-3
TGCGCCAGCAGTGTAGGGTTTTTATCCTACTACGAGCAGTACTTC	CASSVGFLSYYEQYF	TRBV10-1	TRBJ2-7
TGCGCCAGCAGCAAGGCAGGGGGCAGACCTGGTTTGGTAGACGAGCAGTACTTC	CASSKAGGRPGLVDEQYF	TRBV5-1	TRBJ2-7
TGTGCCAGCAGCTTAGGCCCCACAGGGCCTGCAGGGGAGAACACTGAAGCTTTCTTT	CASSLGPTGPAGENTEAFF	TRBV7-3	TRBJ1-1
TGTGCCAGCAGCCAAGTCCTCGGGACAGGTGGACAGCCCCAGCATTTT	CASSQVLGTGGQPQHF	TRBV3-1	TRBJ1-5
TGTGCCAGCAGCGTCCGGGGTGGCTCTGGGGCCAACGTCCTGACTTTC	CASSVRGGSGANVLTF	TRBV13	TRBJ2-6
TGTGCCAGCAGTTCAAGATCGACTGGAATGCCGGAGACCCAGTACTTC	CASSSRSTGMPETQYF	TRBV28	TRBJ2-5
TGCAGTGCTCCCGAGGGAATCTATGGCTACACCTTC	CSAPEGIYGYTF	TRBV20-1	TRBJ1-2
TGTGAAGATGTCGGGGCAGGGGGCAAATATGGCTACACCTTC	CEDVGAGGKYGYTF	TRBV11-3	TRBJ1-2
TGTGCCAGCAGCTTGCCCCATAACCGGGTCACTAGCGGGGGGACGAATGAGCAGTTCTTC	CASSLPHNRVTSGGTNEQFF	TRBV5-5	TRBJ2-1
TGTGCCAGCAGCCTTGCTCGACTAGTTTATGTCGTGCCCGAGCAGTACTTC	CASSLARLVYVVPEQYF	TRBV3-1	TRBJ2-7
TGCGCCAGCAGCCCCCTCAGCGGAAACACCATATATTTT	CASSPLSGNTIYF	TRBV4-3	TRBJ1-3
TGCAGCGTTGAAGAGAGGGGGGCCCCCCAGTCCAATGAGCAGTTCTTC	CSVEERGAPQSNEQFF	TRBV29-1	TRBJ2-1
TGTGCCAGCAGCCAAGTCCCACGTTGTGAAAAACTGTTTTTT	CASSQVPRCEKLFF	TRBV4-2	TRBJ1-4
TGTGCCAGCAGCTTAGATGGGTCCAGGGACAACATTCAGTACTTC	CASSLDGSRDNIQYF	TRBV11-3	TRBJ2-4
TGTGCCAGCAGCTCCGAAACTTCTAGCGGGTGTTACTACAATGAGCAGTTCTTC	CASSSETSSGCYYNEQFF	TRBV13	TRBJ2-1
TGTGCCAGCAAGTGTTGGCGGCCAGGGGGTCAGCCCCAGCATTTT	CASKCWRPGGQPQHF	TRBV13	TRBJ1-5
TGTGCCAGCAGGCGTAGGACAGGGCATTCACCCCTCCACTTT	CASRRRTGHSPLHF	TRBV6-1	TRBJ1-6
TGTGCCACCGGGACAGGAAACTATGGCTACACCTTC	CATGTGNYGYTF	TRBV7-8	TRBJ1-2
TGTGCCAGCAGCGATAAAGGCGAAAGCAATCAGCCCCAGCATTTT	CASSDKGESNQPQHF	TRBV9	TRBJ1-5
TGTGCCAGCGGGGGCGAACGCTCCTACAATGAGCAGTTCTTC	CASGGERSYNEQFF	TRBV27	TRBJ2-1
TGTGCCACCTCCTCTAGCGCACAGTACTTC	CATSSSAQYF	TRBV24-1	TRBJ2-4
TGTGCCAGAGGTACAGCGGGAGATACGCAGTATTTT	CARGTAGDTQYF	TRBV27	TRBJ2-3
TGCGCCAGCAGCTGTGAGGGGAACAATCAGCCCCAGCATTTT	CASSCEGNNQPQHF	TRBV5-1	TRBJ1-5
TGCGCCAGCTCCCCTGGAGGAGTTAAGACAGGCGATTCACCCCTCCACTTT	CASSPGGVKTGDSPLHF	TRBV5-1	TRBJ1-6
TGTGCCACCAGTGATCCCTTGCTAGCGCGGTTCTACGAGCAGTACTTC	CATSDPLLARFYEQYF	TRBV24-1	TRBJ2-7
TGTGCCAGCAGCGTATTCCCGGGACAGGGCCACACGCCCCAGCATTTT	CASSVFPGQGHTPQHF	TRBV9	TRBJ1-5
TGTGCTAGTGGTTTCACGAGGAGCGAGCAGTACTTC	CASGFTRSEQYF	TRBV12-5	TRBJ2-7
TGCGCCAGCAGCCAAGCACCGGGGGTGCTAGCTTTCTTT	CASSQAPGVLAFF	TRBV4-3	TRBJ1-1
TGTGCTAGCAGCTTAGGGCGACAGGACACAGATACGCAGTATTTT	CASSLGRQDTDTQYF	TRBV7-7	TRBJ2-3
TGTGCCAGCAGCCATAGGGAATCGAGCGAGCAGTACTTC	CASSHRESSEQYF	TRBV13	TRBJ2-7
TGTGCCAGCTCACCAAACGGACAGAGCAATCAGCCCCAGCATTTT	CASSPNGQSNQPQHF	TRBV18	TRBJ1-5
TGTGCCAGCAGTGTCCGGGACAGGGAAAAACTGTTTTTT	CASSVRDREKLFF	TRBV25-1	TRBJ1-4
TGTGCCAGCAGCGCTCAGTCGTGCACAGATACGCAGTATTTT	CASSAQSCTDTQYF	TRBV6-5	TRBJ2-3
TGTGCCAGCAGCTTGGAAGTGGGGGCCTACGAGCAGTACTTC	CASSLEVGAYEQYF	TRBV5-4	TRBJ2-7
TGTCCGCTTCCCTTCCCGGGACAGGGGATTGCTGAAGCTTTCTTT	CPLPFPGQGIAEAFF	TRBV6-6	TRBJ1-1
TGTGCCAGCAGCGTTAACTCGTCCTACGAGCAGTACTTC	CASSVNSSYEQYF	TRBV11-2	TRBJ2-7
TGTGCCAGCAGTGTTCAGGGGATGGGCTATGGCTACACCTTC	CASSVQGMGYGYTF	TRBV6-1	TRBJ1-2
TGTGCCAGCACGACAGGGAATGAGCAGTTCTTC	CASTTGNEQFF	TRBV27	TRBJ2-1
TGTGCCAGCAGCTTGGGCGACAGGGTTGCAACTAATGAAAAACTGTTTTTT	CASSLGDRVATNEKLFF	TRBV7-3	TRBJ1-4
TGTGCCAGCATCCCTAGCGCCAAAAACATTCAGTACTTC	CASIPSAKNIQYF	TRBV6-4	TRBJ2-4
TGTGCCAGCAGCCAACCCCGGACAGTGTTGGACGAGCAGTACTTC	CASSQPRTVLDEQYF	TRBV14	TRBJ2-7
TGTGCCAGCAGACTCAGCGGGAACACTGAAGCTTTCTTT	CASRLSGNTEAFF	TRBV28	TRBJ1-1
TGTGCCAGCGCCCAGTCCTCCCCGAGGACAGGGGGCCAGCCCTACGAGCAGTACTTC	CASAQSSPRTGGQPYEQYF	TRBV2	TRBJ2-7
TGTGCCAGCAGCCCCCACTCGGGCATAGCTTTCTTT	CASSPHSGIAFF	TRBV13	TRBJ1-1
TGTGCCAGCAGTGGGGCTCGCGGGACTAGCGGGGCATCCTCCTACGAGCAGTACTTC	CASSGARGTSGASSYEQYF	TRBV12-3	TRBJ2-7
TGCAGTGCGCCCCCGGGACGTTTAAGTCACACAGATACGCAGTATTTT	CSAPPGRLSHTDTQYF	TRBV20-1	TRBJ2-3
TGCAGTGCTCCTCCCCTACAGGGGGGCACTGTGCCCTCAGAGACCCAGTACTTC	CSAPPLQGGTVPSETQYF	TRBV20-1	TRBJ2-5
TGTGCCAGCATTTGGAGATGGAAGGCGTACTTC	CASIWRWKAYF	TRBV5-6	TRBJ2-7
TGTGCCAGCAGCTTAGATAGCGGGAGCACAGATACGCAGTATTTT	CASSLDSGSTDTQYF	TRBV11-2	TRBJ2-3
TGTGCCAGCAGTTTACACCAAACGGGGACAGTTTCCGGGTCCAGCACTGAAGCTTTCTTT	CASSLHQTGTVSGSSTEAFF	TRBV27	TRBJ1-1
TGTGCCAGCAGAATAATAAGGACAGGGAGCACAGATACGCAGTATTTT	CASRIIRTGSTDTQYF	TRBV6-5	TRBJ2-3
TGTGCCAATCTATCCGGACTCTCCTATAATTCACCCCTCCACTTT	CANLSGLSYNSPLHF	TRBV6-1	TRBJ1-6
TGTGCCAGCAGTATACGGGCTAATTCACCCCTCCACTTT	CASSIRANSPLHF	TRBV28	TRBJ1-6
TGCAGTGCCCTTCGGGACCTCGGCTACACCTTC	CSALRDLGYTF	TRBV20-1	TRBJ1-2
TGTGCCAGCAGCTCCTTCTACCTGGACGGCACTGAAGCTTTCTTT	CASSSFYLDGTEAFF	TRBV11-2	TRBJ1-1
TGTGCCAGCAGCTGCCCTAGTCCCTATGGCTACACCTTC	CASSCPSPYGYTF	TRBV7-2	TRBJ1-2
TGCAGCGTCCCCAAATTGACTAGCGGGGGGAGCTCCTACAATGAGCAGTTCTTC	CSVPKLTSGGSSYNEQFF	TRBV29-1	TRBJ2-1
TGTGCCAGCAGCACTTTGTCGAGGGGCGAGCAGTACTTC	CASSTLSRGEQYF	TRBV7-8	TRBJ2-7
TGCGCCAGCAGTGAGCTCCCGGGGGGGAGGGTCCATACAGATACGCAGTATTTT	CASSELPGGRVHTDTQYF	TRBV10-1	TRBJ2-3
TGTGCCACCAGCAGGTACCACAGAACCGGGGAGCTGTTTTTT	CATSRYHRTGELFF	TRBV15	TRBJ2-2
TGCAGTGCTTCGATAACCACAGATACGCAGTATTTT	CSASITTDTQYF	TRBV20-1	TRBJ2-3
TGTGCCAGCAGAAGGATCTGCCCCCCAGGCCCCGGGACTAGGGACAATGAGCAGTTCTTC	CASRRICPPGPGTRDNEQFF	TRBV12-4	TRBJ2-1
TGTCCGGACAGGGGGAATTCACCCCTCCACTTT	CPDRGNSPLHF	TRBV30	TRBJ1-6
TGCGCCAGCAGCCAAGAAGGGCGCGGGACAGGGTCTGAAGCTTTCTTT	CASSQEGRGTGSEAFF	TRBV4-1	TRBJ1-1
TGCAGCGTTGATCCGGACACCTCCTACAATGAGCAGTTCTTC	CSVDPDTSYNEQFF	TRBV29-1	TRBJ2-1
TGTGCCAGCAGCTTAGATCGACCGGGACTGACGAACACTGAAGCTTTCTTT	CASSLDRPGLTNTEAFF	TRBV11-3	TRBJ1-1
TGCGCCAGCAGCCAAGAGTCCACGGCTTTCTTT	CASSQESTAFF	TRBV4-1	TRBJ1-1
TGTGCCAGTAGTCCCGTTTCCGGGACGCCCGGAAACACCATATATTTT	CASSPVSGTPGNTIYF	TRBV19	TRBJ1-3
TGTGCCAGTAGCGTTATACTAGCGGGAGCCGGGGGCACCGGGGAGCTGTTTTTT	CASSVILAGAGGTGELFF	TRBV19	TRBJ2-2
TGTGCCACCCCTAGCGGTGGGGCGACCACAGATACGCAGTATTTT	CATPSGGATTDTQYF	TRBV6-5	TRBJ2-3
TGTGCCAGCATTGGGAACATCTACGAGCAGTACTTC	CASIGNIYEQYF	TRBV12-3	TRBJ2-7
TGCAGCGTTGCCCAGGGGACTAGCGGGACTACCACCGGGGAGCTGTTTTTT	CSVAQGTSGTTTGELFF	TRBV29-1	TRBJ2-2
TGCGCCAGCAGCTTGGTCCCACGGGACAGGGCTAAATCAGAGACCCAGTACTTC	CASSLVPRDRAKSETQYF	TRBV5-1	TRBJ2-5
TGCAGTGCTCTAAATAAGGAACAAGAGACCCAGTACTTC	CSALNKEQETQYF	TRBV20-1	TRBJ2-5
TGTGCCAGCAACCAGGGGGGAGGGAGTCCACAGCCCCAGCATTTT	CASNQGGGSPQPQHF	TRBV25-1	TRBJ1-5
TGTGCCAGCAGGGGGGGAAGTCTGACGGGGGGGCCCTCTTTGACCCCCTACGAGCAGTACTTC	CASRGGSLTGGPSLTPYEQYF	TRBV5-6	TRBJ2-7
TGTGCCAGCACCGGGGGCTTTAACACTCCCTACGAGCAGTACTTC	CASTGGFNTPYEQYF	TRBV6-5	TRBJ2-7
TGTGCCAGCAGCCAAGGACTAGCGGGCACAGATACGCAGTATTTT	CASSQGLAGTDTQYF	TRBV14	TRBJ2-3
TGTGCCACCAGTGACAACGACAGGGGACTTTCTGGAAACACCATATATTTT	CATSDNDRGLSGNTIYF	TRBV24-1	TRBJ1-3
TGCGCCAGCAGCCAAGATCCGCAGAGTCCAAGGTACGAGCAGTACTTC	CASSQDPQSPRYEQYF	TRBV4-3	TRBJ2-7
TGTGCCAGCAGTAAATCAGAGTGTCGGAGCACAGATACGCAGTATTTT	CASSKSECRSTDTQYF	TRBV6-8	TRBJ2-3
TGTGCCAGCAGTGGCTTGACAGCTGAGTCGGAAGCTTTCTTT	CASSGLTAESEAFF	TRBV28	TRBJ1-1
TGTGCCAGCAGTGAATTAGGGCTCCCGGGACAGTGTCAGCCCCAGCATTTT	CASSELGLPGQCQPQHF	TRBV2	TRBJ1-5
TGTGCCAGCAGCAGAGTCCGGGAACCTTACGAGCAGTACTTC	CASSRVREPYEQYF	TRBV28	TRBJ2-7
TGTGCCAGCAGCTTCGGACTAGCGGACTACGAGCAGTACTTC	CASSFGLADYEQYF	TRBV7-2	TRBJ2-7
TGTGCCAGCAGCTTGGCCCATCAGGGGCTGAGTTTGCGGAGCCGGACCAAAAACATTCAGTACTTC	CASSLAHQGLSLRSRTKNIQYF	TRBV5-6	TRBJ2-4
TGCAGCGGATCCAGTGGCTACACCTTC	CSGSSGYTF	TRBV29-1	TRBJ1-2
TGTGCCAGCAGTGACAGGGGGCATGAAAAACTGTTTTTT	CASSDRGHEKLFF	TRBV27	TRBJ1-4
TGTGCCAGCAGCGTTGGACTCCGGGACAGGGCCTACGAGCAGTACTTC	CASSVGLRDRAYEQYF	TRBV7-4	TRBJ2-7
TGTGCCAGCAGTTACGCCGACTGGTACGAGCAGTACTTC	CASSYADWYEQYF	TRBV6-5	TRBJ2-7
TGCAGCGTTGATTCAAAACCCACTAGCGGGACGCCCTACAATGAGCAGTTCTTC	CSVDSKPTSGTPYNEQFF	TRBV29-1	TRBJ2-1
TGCGCCCCCCGGCGGGGCTATGGCTACACCTTC	CAPRRGYGYTF	TRBV10-1	TRBJ1-2
TGTGCCAGCAGGGAAGCAGGGGGGGTCGGGTACGAGCAGTACTTC	CASREAGGVGYEQYF	TRBV28	TRBJ2-7
TGCGCCAGCAGCCTCCCCCCGGGACTAGTGAGCACAGATACGCAGTATTTT	CASSLPPGLVSTDTQYF	TRBV5-1	TRBJ2-3
TGCAGTGCTATGAGGGACCTAGGGAAATTCACAGATACGCAGTATTTT	CSAMRDLGKFTDTQYF	TRBV20-1	TRBJ2-3
TGCAGTGCTAGAGATCTAGATCCAATACGACAGGGGCCAGAGACCCAGTACTTC	CSARDLDPIRQGPETQYF	TRBV20-1	TRBJ2-5
TGCGCCAGCAGCCAAGATTTTCAGAACCGACCTGAGACCCAGTACTTC	CASSQDFQNRPETQYF	TRBV4-1	TRBJ2-5
TGCAGTGCTAGTTCCATGGCCTACGAGCAGTACTTC	CSASSMAYEQYF	TRBV20-1	TRBJ2-7
TGTGCCAGCAGCCCCTCCAGGAGGGACCGGGACCCCTATAATTCACCCCTCCACTTT	CASSPSRRDRDPYNSPLHF	TRBV14	TRBJ1-6
TGTGCCAGCAGCGTATTTGGACAGGGCTCACGCACAGATACGCAGTATTTT	CASSVFGQGSRTDTQYF	TRBV9	TRBJ2-3
TGTGCCAGCAGTGACCAGGGGACAGGGGTGAAGGAATTACCTAACTATGGCTACACCTTC	CASSDQGTGVKELPNYGYTF	TRBV6-4	TRBJ1-2
TGTGCTAGTGCTTCTCGGGACGTAAAACTGTTTTTT	CASASRDVKLFF	TRBV12-5	TRBJ1-4
TGTGCCAGCGGCGAGGGGCACAATGAGCAGTTCTTC	CASGEGHNEQFF	TRBV27	TRBJ2-1
TGTGCCAGCAGCGCCCCCGGCTTCTACGAGCAGTACTTC	CASSAPGFYEQYF	TRBV13	TRBJ2-7
TGCGCCAGCAGCCAAGTGAGCCGGGACAAAGCTGAAGCTTTCTTT	CASSQVSRDKAEAFF	TRBV4-3	TRBJ1-1
TGCGCCAGCAGCTTGGGACGATGTTTCTACAATGAGCAGTTCTTC	CASSLGRCFYNEQFF	TRBV5-1	TRBJ2-1
TGCAGTGCTAGAGCCTCCCCGGACAGGAAGGGGGGATATAATTCACCCCTCCACTTT	CSARASPDRKGGYNSPLHF	TRBV20-1	TRBJ1-6
TGTGCCAGCAGTCTACAGGGGGTGGATTCACCCCTCCACTTT	CASSLQGVDSPLHF	TRBV27	TRBJ1-6
TGCGCCAGCAGTGAGTCCCAGAAAGGCGAAAGACTGAACACTGAAGCTTTCTTT	CASSESQKGERLNTEAFF	TRBV10-1	TRBJ1-1
TGTGCCAGCAGCTTTGAGGGACAGGGATTGATCCTCTCCTACGAGCAGTACTTC	CASSFEGQGLILSYEQYF	TRBV7-9	TRBJ2-7
TGCGCCAGCAGCTTGGAGACAGGGGGCAGATGCTACGAGCAGTACTTC	CASSLETGGRCYEQYF	TRBV5-1	TRBJ2-7
TGTGCCAGCAGCCCCCGAAGGACAGGGCCTCTCTACGAGCAGTACTTC	CASSPRRTGPLYEQYF	TRBV13	TRBJ2-7
TGTGCCAGCAGCAGTTCCAGACAGGGGGCTGACACTGAAGCTTTCTTT	CASSSSRQGADTEAFF	TRBV13	TRBJ1-1
TGCAGTGCTAGAGTAATGGCACGAGGTCCTGAGCAGTACTTC	CSARVMARGPEQYF	TRBV20-1	TRBJ2-7
TGCAGCGGGAAAGGGAAGGACAGGAACGGGGCCAACGTCCTGACTTTC	CSGKGKDRNGANVLTF	TRBV29-1	TRBJ2-6
TGTGGCACCAGGTATGACAGGGGGGGCGGGGAGCTGTTTTTT	CGTRYDRGGGELFF	TRBV7-9	TRBJ2-2
TGTGCCAGTAGTATGTTAGGACAGGGAGCTAACTATGGCTACACCTTC	CASSMLGQGANYGYTF	TRBV19	TRBJ1-2
TGTGCCAGCAGCTCCGCTAGCGGGAAGTACACAGATACGCAGTATTTT	CASSSASGKYTDTQYF	TRBV13	TRBJ2-3
TGTGCCAGCAGGCCGGGCCAACGGCTACCTAGCACAGATACGCAGTATTTT	CASRPGQRLPSTDTQYF	TRBV27	TRBJ2-3
TGTGCCAGCAGCGTAGCCAAAACCGAAGAATACAATGAGCAGTTCTTC	CASSVAKTEEYNEQFF	TRBV9	TRBJ2-1
TGTGCCAGCAGGGCGGACAGGGGGGATGGCTACACCTTC	CASRADRGDGYTF	TRBV6-4	TRBJ1-2
TGTGCCAGTACGGCCCAGGGAGAGAACGAGCAGTACTTC	CASTAQGENEQYF	TRBV19	TRBJ2-7
TGTGCCATCAGATTAAGTAGGCGGGGCAATGAGCAGTTCTTC	CAIRLSRRGNEQFF	TRBV10-3	TRBJ2-1
TGTGCCAGCAGCGTAGGTAAACAGGGGAAGAATGGCTACACCTTC	CASSVGKQGKNGYTF	TRBV9	TRBJ1-2
TGTGCCAGCAGGCGGATCAGGAACACAGATACGCAGTATTTT	CASRRIRNTDTQYF	TRBV6-4	TRBJ2-3
TGTGCCAGTGGCGGGAGCGGCCAGCCCCAGCATTTT	CASGGSGQPQHF	TRBV27	TRBJ1-5
TGTGCCAGCAGCGGCCCCAGAAGGTTCCAAGAGACCCAGTACTTC	CASSGPRRFQETQYF	TRBV7-3	TRBJ2-5
TGTGCCAGCAGTAGGGGGGGCAGGGATCCGAACACTGAAGCTTTCTTT	CASSRGGRDPNTEAFF	TRBV6-2	TRBJ1-1
TGTGCGGGTCCGGGACTAGCGGGGGGGCATAGCGAGACCCAGTACTTC	CAGPGLAGGHSETQYF	TRBV24-1	TRBJ2-5
TGTGCCAGCAGCTCCGATATTCGGGGACAGGAGACTGAAGCTTTCTTT	CASSSDIRGQETEAFF	TRBV5-4	TRBJ1-1
TGCGCCAGCCCACGTAGCGTCTCCTACGAGCAGTACTTC	CASPRSVSYEQYF	TRBV10-1	TRBJ2-7
TGTGCCAAAAAACGTGCCGGGACAGGGGGCTTAGCCAAAAACATTCAGTACTTC	CAKKRAGTGGLAKNIQYF	TRBV7-4	TRBJ2-4
TGTGCCAGCAGCCACCCCGGGGGGGGCCGATTGGCCTACAATGAGCAGTTCTTC	CASSHPGGGRLAYNEQFF	TRBV14	TRBJ2-1
TGTGCCAGCAGCGTCACCCGGCCACTAGCGGGAGTCACTTACACTGAAGCTTTCTTT	CASSVTRPLAGVTYTEAFF	TRBV9	TRBJ1-1
TGTGCCATCCGGGTCCCTAGCGGGCCAGAAGAGACCCAGTACTTC	CAIRVPSGPEETQYF	TRBV3-1	TRBJ2-5
TGTGCCAGCAGCCGTAAACCCTTAGGGGGCATCGCTATCAAGCCCCAGCATTTT	CASSRKPLGGIAIKPQHF	TRBV7-8	TRBJ1-5
TGTGCCAGCAGCCCCCTAGCGGGAAAATGCTTCTACGAGCAGTACTTC	CASSPLAGKCFYEQYF	TRBV13	TRBJ2-7
TGCGCCAGCAATGCGGTCCGGGACAGGGGGCCTAGCTACGAGCAGTACTTC	CASNAVRDRGPSYEQYF	TRBV4-1	TRBJ2-7
TGTGCCAGCAAAGGGGAATGCTACGAGCAGTACTTC	CASKGECYEQYF	TRBV6-1	TRBJ2-7
TGCAGTGCTAGAGATTTGGATCGACGATATGGCTACACCTTC	CSARDLDRRYGYTF	TRBV20-1	TRBJ1-2
TGTGCCAGCAGCACTCAGTTGGGGATGGCCGGGGAGCTGTTTTTT	CASSTQLGMAGELFF	TRBV5-6	TRBJ2-2
TGTGCCAGCAGCCCTACAGGGAGAAACACCATATATTTT	CASSPTGRNTIYF	TRBV27	TRBJ1-3
TGTGCCATCAGTGACGGAGGGGCTGCTTTCTTT	CAISDGGAAFF	TRBV10-3	TRBJ1-1
TGCAGTGCTACTACAGGGGGGTCCTACAATGAGCAGTTCTTC	CSATTGGSYNEQFF	TRBV20-1	TRBJ2-1
TGCGCCAGCAGCCTCTCTGGACTAGCGGGGGGGCCGGGTAGCTCCTACAATGAGCAGTTCTTC	CASSLSGLAGGPGSSYNEQFF	TRBV5-1	TRBJ2-1
TGTGCCAGCAGCCGAGGACAGGGCTCCTACGAGCAGTACTTC	CASSRGQGSYEQYF	TRBV6-5	TRBJ2-7
TGTGCCAGCAGCTCTTGGTCCGGCACCGGGGAGCTGTTTTTT	CASSSWSGTGELFF	TRBV11-3	TRBJ2-2
TGCGCCAGCAGCTTGGGGGATCCGGCCGACAGGAGCAACGGCTACACCTTC	CASSLGDPADRSNGYTF	TRBV5-1	TRBJ1-2
TGTGCCAGCAGTGAAGCGAGCACAGGGTGTACGAACTATGGCTACACCTTC	CASSEASTGCTNYGYTF	TRBV6-1	TRBJ1-2
TGTGGTTTCAGGGAGGCGAACCCCTACGAGCAGTACTTC	CGFREANPYEQYF	TRBV2	TRBJ2-7
TGCAGTGCTAGAGAGCCGATTACTGCGGACTCAGGTAGCTCCTACGAGCAGTACTTC	CSAREPITADSGSSYEQYF	TRBV20-1	TRBJ2-7
TGTGCCAGCAGCGCTGAGGGACAGGGACATGGCTACACCTTC	CASSAEGQGHGYTF	TRBV9	TRBJ1-2
TGTGCCAGCAGCCGTCGGACCGGGGACAGTTTGAAGTATGGCTACACCTTC	CASSRRTGDSLKYGYTF	TRBV27	TRBJ1-2
TGTGCCAGCAGTGACCCCAAGGGGTCACCCCTCCACTTT	CASSDPKGSPLHF	TRBV6-4	TRBJ1-6
TGTGCTAGTGGTTTGCAAAGAGGGGGTGTGTACTTC	CASGLQRGGVYF	TRBV12-5	TRBJ2-7
TGCAGTGCTCTAGGCGACAACACCGGGGAGCTGTTTTTT	CSALGDNTGELFF	TRBV20-1	TRBJ2-2
TGTGCCAGCAGCTCGGGACAGGGAGTCCTCAATCAGCCCCAGCATTTT	CASSSGQGVLNQPQHF	TRBV6-1	TRBJ1-5
TGTGCCAGCATTTCTAAGACAGGGGAAAACAACGAGCAGTACTTC	CASISKTGENNEQYF	TRBV6-4	TRBJ2-7
TGTGCCAGCAGCTTTGGGGACAGCTACGAGCAGTACTTC	CASSFGDSYEQYF	TRBV11-3	TRBJ2-7
TGTGCCAATCCGGAGCCTTACACCGGGGAGCTGTTTTTT	CANPEPYTGELFF	TRBV7-9	TRBJ2-2
TGTGCCAGCAGTAACAGCGGGAGACGGTCTGGAAACACCATATATTTT	CASSNSGRRSGNTIYF	TRBV12-3	TRBJ1-3
TGTGCCAGCGTTATAGGGGAAGAAACTGAAGCTTTCTTT	CASVIGEETEAFF	TRBV5-4	TRBJ1-1
TGTGCCAGCAGCAGTGAACATAATTCACCCCTCCACTTT	CASSSEHNSPLHF	TRBV13	TRBJ1-6
TGTGCCAGCAGTGGCCCCCACCCGGGCGACACTGAAGCTTTCTTT	CASSGPHPGDTEAFF	TRBV6-5	TRBJ1-1
TGTGCCATCAGTGGGTCAACCTGCGAGGTAGACAATGAGCAGTTCTTC	CAISGSTCEVDNEQFF	TRBV10-3	TRBJ2-1
TGTGCCGGGCCCTATCAGCCCCAGCATTTT	CAGPYQPQHF	TRBV9	TRBJ1-5
TGTGCCATCAGTGACCAGATCAGTCCTGAGCAGTTCTTC	CAISDQISPEQFF	TRBV10-3	TRBJ2-1
TGTGCCAGTAGTATAAAGGGACAGGGCACCGGGGAGCTGTTTTTT	CASSIKGQGTGELFF	TRBV19	TRBJ2-2
TGTGCCAGCAGCTTGGGGCCAGGGAATGGCTACACCTTC	CASSLGPGNGYTF	TRBV5-5	TRBJ1-2
TGTGCCAGCAGCACCACCCATTTGCCGGGGCCTCTGAACACTGAAGCTTTCTTT	CASSTTHLPGPLNTEAFF	TRBV5-8	TRBJ1-1
TGTGCCAGCAGCGTCTGGCCAGAAAACATTCAGTACTTC	CASSVWPENIQYF	TRBV7-9	TRBJ2-4
TGTGCCAGCAGTTATAACATACAAACAGGGGACAAGAAAATTGAAGCTTTCTTT	CASSYNIQTGDKKIEAFF	TRBV6-3	TRBJ1-1
TGTGCCAGCTCAGCCGGGCGCGTCAATCAGCCCCAGCATTTT	CASSAGRVNQPQHF	TRBV25-1	TRBJ1-5
TGTGCCAGCAAAGGGGGCGGGAACACTGAAGCTTTCTTT	CASKGGGNTEAFF	TRBV6-5	TRBJ1-1
TGTGCCAGCACCAGCCGGCGTACAGACAGGGGTATGAACACCGGGGAGCTGTTTTTT	CASTSRRTDRGMNTGELFF	TRBV6-4	TRBJ2-2
TGTGCCAGAATGGCCTCCCGGACAGGGAAGAGCTATGGCTACACCTTC	CARMASRTGKSYGYTF	TRBV25-1	TRBJ1-2
TGCAGTGCAGGGGGAGGGACAGGGTGGGACGAGATTGAAGCTTTCTTT	CSAGGGTGWDEIEAFF	TRBV20-1	TRBJ1-1
TGTGCCATCATCCGGTCTAGCGGGGGGGCCGTAACCTACGAGCAGTACTTC	CAIIRSSGGAVTYEQYF	TRBV10-3	TRBJ2-7
TGTGCCAGCAGTCTCCGGGGGGACTGCGAGCAGTACTTC	CASSLRGDCEQYF	TRBV6-5	TRBJ2-7
TGTGCCAGCAGTTTACGAGGGGGAAATAATCTTCCGAGCACCGGGGAGCTGTTTTTT	CASSLRGGNNLPSTGELFF	TRBV27	TRBJ2-2
TGTGCCAGCAGCCTACCGGGACTAGCGGGGCGCACCACAGATACGCAGTATTTT	CASSLPGLAGRTTDTQYF	TRBV7-3	TRBJ2-3
TGCGCCAGCAGCTTGTACCGGGACTGGGGGGGCGCCCGGGAGACCCAGTACTTC	CASSLYRDWGGARETQYF	TRBV5-1	TRBJ2-5
TGTGCCAGCAGTGGCTGGGACAGGGTAGAGACCCAGTACTTC	CASSGWDRVETQYF	TRBV6-4	TRBJ2-5
TGTGCCAGCAGCATAAGGGGGAACTATGGCTACACCTTC	CASSIRGNYGYTF	TRBV9	TRBJ1-2
TGTGCCAGCAGCTTGCGTACAGGGGGCCTCGTCGATCAGCCCCAGCATTTT	CASSLRTGGLVDQPQHF	TRBV5-4	TRBJ1-5
TGCAGTGCTAGAGGGCCGGGTTGCTATGGCTACACCTTC	CSARGPGCYGYTF	TRBV20-1	TRBJ1-2
TGTGCCACCAGCAGAGATAGGGAAGGGGGCGTGCAGCCCCAGCATTTT	CATSRDREGGVQPQHF	TRBV15	TRBJ1-5
TGTGCCAGCAGCCAAGAACAGGGGGCGGGGCAGCCCCAGCATTTT	CASSQEQGAGQPQHF	TRBV3-1	TRBJ1-5
TGTGCCAGCAGCCAAGTCAGTCCCTCAGGGCGGAGGTATAGCAATCAGCCCCAGCATTTT	CASSQVSPSGRRYSNQPQHF	TRBV14	TRBJ1-5
TGTGCCAGCACCGGGACAGGGAGCCCCTACGAGCAGTACTTC	CASTGTGSPYEQYF	TRBV7-2	TRBJ2-7
TGTGCCAGCAGCGTAGGGCAGGAGGGGGGGGAGTACTTC	CASSVGQEGGEYF	TRBV9	TRBJ2-7
TGCGCCAGCAGCCAAGGTAATGGTCGACGGTCGGGGGCAGATACGCAGTATTTT	CASSQGNGRRSGADTQYF	TRBV4-1	TRBJ2-3
TGCGCCAGCAGCTCTATGGCGGGAGAGAGGGGTTCTCGAACAGATACGCAGTATTTT	CASSSMAGERGSRTDTQYF	TRBV5-1	TRBJ2-3
TGTGCCTGCAAGGGCCACGAGCAGTACTTC	CACKGHEQYF	TRBV30	TRBJ2-7
TGCGCCAGCAGCGAAGGACAGGGTACAAACACCATATATTTT	CASSEGQGTNTIYF	TRBV5-1	TRBJ1-3
TGCAGTGCTCCAACTAGCGGGAGGGCGAATGGCTACACCTTC	CSAPTSGRANGYTF	TRBV20-1	TRBJ1-2
TGCAGTGCTAGTCCCCTGATGGGACAGTTAGGCACCTTC	CSASPLMGQLGTF	TRBV20-1	TRBJ1-2
TGCGCCAGCAGTGCGCGGCGGACATCGAACACCGGGGAGCTGTTTTTT	CASSARRTSNTGELFF	TRBV10-2	TRBJ2-2
TGCGCCAGCAGCTTGGTAGGTATGAAGGGCTCCTACGAGCAGTACTTC	CASSLVGMKGSYEQYF	TRBV5-1	TRBJ2-7
TGCAGTGCTAGCGGGATTCTTAGAAGGACCTACGAGCAGTACTTC	CSASGILRRTYEQYF	TRBV20-1	TRBJ2-7
TGTGCCAGCAGCCCCCCCACCCCTAGCGGGTTGCAGTTCTTC	CASSPPTPSGLQFF	TRBV5-6	TRBJ2-1
TGTGCCAGTAGTTGTAGCGCAAACGAGCAGTACTTC	CASSCSANEQYF	TRBV19	TRBJ2-7
TGTGCCAGCAGCTACAGACTAGTTCATAAGCATAGGGTCTCCTACAATGAGCAGTTCTTC	CASSYRLVHKHRVSYNEQFF	TRBV11-2	TRBJ2-1
TGTGCCACCAGTGATTTGACTACGGTAGAAGCCAAAAACATTCAGTACTTC	CATSDLTTVEAKNIQYF	TRBV24-1	TRBJ2-4
TGTGCCACGGAAACTCGGTGTGAGCAGTTCTTC	CATETRCEQFF	TRBV24-1	TRBJ2-1
TGTGCCAGCAGGGCGAACAGGGGGGGAAACACCATATATTTT	CASRANRGGNTIYF	TRBV6-5	TRBJ1-3
TGTGTAAAAAATCCAGGGGGGTGGAGCAATCAGCCCCAGCATTTT	CVKNPGGWSNQPQHF	TRBV24-1	TRBJ1-5
TGTTGGGGACTAGGAGCCAATGAGCAGTTCTTC	CWGLGANEQFF	TRBV10-3	TRBJ2-1
TGCGCCAGCAGCAGGGACAGGGATAGCAATCAGCCCCAGCATTTT	CASSRDRDSNQPQHF	TRBV10-1	TRBJ1-5
TGCGCCAGCAGCCATAGGGGGGGTGATGAGCAGTTCTTC	CASSHRGGDEQFF	TRBV5-1	TRBJ2-1
TGTGCCAGCAGTTTGAGGGGGGGGTCCCAGAAAGCCTACAATGAGCAGTTCTTC	CASSLRGGSQKAYNEQFF	TRBV28	TRBJ2-1
TGTGCCAGCTCACCACAACTCGGGCCCATAAAACTGTTTTTT	CASSPQLGPIKLFF	TRBV18	TRBJ1-4
TGTGCCAGGGCCCTAAGCTACGAGCAGTACTTC	CARALSYEQYF	TRBV25-1	TRBJ2-7
TGCGCCAGCAGCTTGATCTCAGAGAATGAGCAGTTCTTC	CASSLISENEQFF	TRBV5-1	TRBJ2-1
TGCAGGTTGGGAGAAGATACGCAGTATTTT	CRLGEDTQYF	TRBV20-1	TRBJ2-3
TGTGCCAGCAGCTTGGTTACTAGCGGGAGGGGCCACACAGATACGCAGTATTTT	CASSLVTSGRGHTDTQYF	TRBV5-8	TRBJ2-3
TGTGCCAGCAGCTTGTTCCGGGAAAGGACAGGGGGACGCGAGCAGTACTTC	CASSLFRERTGGREQYF	TRBV5-5	TRBJ2-7
TGTGCCAGCAGCTTTTTTTTAACGGGGTTTAGCTCCTACAATGAGCAGTTCTTC	CASSFFLTGFSSYNEQFF	TRBV7-6	TRBJ2-1
TGTGCCAGCAGCACCAGCGGGAGGGGGAGGAGGAACACTGAAGCTTTCTTT	CASSTSGRGRRNTEAFF	TRBV7-8	TRBJ1-1
TGTGCCAGCAGGGACAGGCATGACAATGAGCAGTTCTTC	CASRDRHDNEQFF	TRBV7-3	TRBJ2-1
TGTGCCAGCAGCCAATCAGGAGGGGGGGGGACCCGCTACGAGCAGTACTTC	CASSQSGGGGTRYEQYF	TRBV3-1	TRBJ2-7
TGCGCCAGCAGCTCAGCCGGGACAGTCCTCGAGGGGGGGGGTTCCGGCTACACCTTC	CASSSAGTVLEGGGSGYTF	TRBV5-1	TRBJ1-2
TGCGCCAGCAGCTTGGCTGCGACCGGGGAGCTGTTTTTT	CASSLAATGELFF	TRBV5-1	TRBJ2-2
