TGCGCCAAGTCCCAGCACGGCGGGCAGGACTATGGCTACACCTTC	CAKSQHGGQDYGYTF	TRBV10-2	TRBJ1-2
TGTGCCAGCAGCCACCCGTCACAGGAGGACCATGGCTACACCTTC	CASSHPSQEDHGYTF	TRBV14	TRBJ1-2
TGTGCCAGCAGCTTATGGGGGGGTCTGAACACTGAAGCTTTCTTT	CASSLWGGLNTEAFF	TRBV7-9	TRBJ1-1
TGTGCCAGCAGCCAATCCGAGAGCTACGAGCAGTACTTC	CASSQSESYEQYF	TRBV5-4	TRBJ2-7
TGTGTTATCCGAGGGTGGGAAGAGACCCAGTACTTC	CVIRGWEETQYF	TRBV2	TRBJ2-5
TGTGCCAGCAGCGAAGCAGGGACAGGCTCCTACGAGCAGTACTTC	CASSEAGTGSYEQYF	TRBV7-3	TRBJ2-7
TGCAGTGCACGGGGGGGGGCGTCTAGGCTCTACGAGCAGTACTTC	CSARGGASRLYEQYF	TRBV20-1	TRBJ2-7
TGTGCCAGCAGCCAACCCGGGACAGAAAGGGATACGCAGTATTTT	CASSQPGTERDTQYF	TRBV14	TRBJ2-3
TGTGCCAGCAGCCAAGATCTTATAAAGGCGTACGCCACCGGGAACAATCAGCCCCAGCATTTT	CASSQDLIKAYATGNNQPQHF	TRBV4-2	TRBJ1-5
TGTGCCTGGAGTGTCGTGGGAGGGGGTGGTCGGAACACTGAAGCTTTCTTT	CAWSVVGGGGRNTEAFF	TRBV30	TRBJ1-1
TGTGCCAGCTCACCAACGGGCGGTACGACGGACGGGGAGGAGACCCAGTACTTC	CASSPTGGTTDGEETQYF	TRBV18	TRBJ2-5
TGTGCCAGCAGCTTAGCGCGAAGGAATGAAAAACTGTTTTTT	CASSLARRNEKLFF	TRBV7-7	TRBJ1-4
TGTGCCAGCAGCACCTCACCTTGGCAGTACTTC	CASSTSPWQYF	TRBV7-9	TRBJ2-7
TGTGCCAGCAGCCCACGAGGGACAGGAAGCAACGTCCTGACTTTC	CASSPRGTGSNVLTF	TRBV13	TRBJ2-6
TGCAGTGCTAGCGAGGCCCCGTGGGATGGCTACACCTTC	CSASEAPWDGYTF	TRBV20-1	TRBJ1-2
TGTGCCAGCAGCCAAGGTCCAAATCAGGGCGCGAGGGGATATTCCTACGAGCAGTACTTC	CASSQGPNQGARGYSYEQYF	TRBV3-1	TRBJ2-7
TGCAGCGTGGAGAGCCCCAGGGATATACCCCCTAACTATGGCTACACCTTC	CSVESPRDIPPNYGYTF	TRBV29-1	TRBJ1-2
TGTGCCAGCGGACCGACGTGCGAGCAGTACTTC	CASGPTCEQYF	TRBV27	TRBJ2-7
TGTGCCAGACAGGGGCGGGGTGGCTACACCTTC	CARQGRGGYTF	TRBV2	TRBJ1-2
TGTGCCAGCAGTTTGGTGGAGTTGAGACGAAGGGAAAAACTGTTTTTT	CASSLVELRRREKLFF	TRBV28	TRBJ1-4
TGTGCCAGCAGCTTAATAGACAGGGGCGATGAGCAGTTCTTC	CASSLIDRGDEQFF	TRBV11-3	TRBJ2-1
TGTGCCAGCAGCTTAAAGTCGGGATGTTACACCGGGGAGCTGTTTTTT	CASSLKSGCYTGELFF	TRBV7-3	TRBJ2-2
TGTGCCAGCAGCGCTAGTCCCGGGACTAGCGTCAGCTACGAGCAGTACTTC	CASSASPGTSVSYEQYF	TRBV13	TRBJ2-7
TGTGCCAGCAGTCGAGGGTATAATGAAAAACTGTTTTTT	CASSRGYNEKLFF	TRBV6-1	TRBJ1-4
TGTGCCAGCAGCTATCGGAATAGCGGGCCAAACCCCGAGCAGTACTTC	CASSYRNSGPNPEQYF	TRBV7-9	TRBJ2-7
TGTGCCAGCAGGAATAAAAGGGTACCGGTAATTGGGGCCAACGTCCTGACTTTC	CASRNKRVPVIGANVLTF	TRBV9	TRBJ2-6
TGTGCCAGCAGCCGGACCTCCTACAATGAGCAGTTCTTC	CASSRTSYNEQFF	TRBV7-3	TRBJ2-1
TGTGCCAGCAGCCCGCAAGGGGGGCCTTTCCATGGCTACACCTTC	CASSPQGGPFHGYTF	TRBV7-3	TRBJ1-2
TGTGCCAGCAGTGAAAGAGGGGAGTGGCGATTCTACGAGCAGTACTTC	CASSERGEWRFYEQYF	TRBV6-1	TRBJ2-7
TGTGCTAGTGGTTTGGTGAAAACCAAGCCTCCGGGACTAGCGGGAGGTTTTGGTTTCTGGTACGAGCAGTACTTC	CASGLVKTKPPGLAGGFGFWYEQYF	TRBV12-5	TRBJ2-7
TGTGCCAGCAGTTATGTACGAGGTCCCACAGATACGCAGTATTTT	CASSYVRGPTDTQYF	TRBV6-3	TRBJ2-3
TGTGCCAGCAGCTTAGATGAAGGGACATGGAACTATGGCTACACCTTC	CASSLDEGTWNYGYTF	TRBV11-3	TRBJ1-2
TGCGCCAGCAGCTGGACAGGCTACGAGCAGTACTTC	CASSWTGYEQYF	TRBV5-1	TRBJ2-7
TGTGCCAGCAGCGGACAGCGCTTGAAGCGCACTGAAGCTTTCTTT	CASSGQRLKRTEAFF	TRBV7-9	TRBJ1-1
TGTGCCAGCAGCAGAACAATAAGAAGCTCCTATAATTCACCCCTCCACTTT	CASSRTIRSSYNSPLHF	TRBV9	TRBJ1-6
TGTGCCAGCAGCACTGACAGGGACAGGGACTCCTACGAGCAGTACTTC	CASSTDRDRDSYEQYF	TRBV5-4	TRBJ2-7
TGTGCCAGCAGTTACTCGAACAACAGGTCTGGCTACACCTTC	CASSYSNNRSGYTF	TRBV6-5	TRBJ1-2
TGTGCCAGCTCACCACCGACTGGGGCCGGTTATTCACCCCTCCACTTT	CASSPPTGAGYSPLHF	TRBV18	TRBJ1-6
TGTGCCAGTAAGGGCCAGGACACCGGGGAGCTGTTTTTT	CASKGQDTGELFF	TRBV19	TRBJ2-2
TGTGCTAGTGACTACAAAAACATTCAGTACTTC	CASDYKNIQYF	TRBV12-5	TRBJ2-4
TGTGCCAGCAGTTACGGGACCCTCAGCACAGATACGCAGTATTTT	CASSYGTLSTDTQYF	TRBV6-3	TRBJ2-3
TGTGCCACCAGCAGAGATCCCAGGGAATCTCGCTCCTACGAGCAGTACTTC	CATSRDPRESRSYEQYF	TRBV15	TRBJ2-7
TGCAGTGCTAGAGATGTTGGTCAGCCGTGTGTTGATCTGGATAGCAATCAGCCCCAGCATTTT	CSARDVGQPCVDLDSNQPQHF	TRBV20-1	TRBJ1-5
TGCGCCAGCATAAAGGGCGGGCCATGGCCTGCTTTCTTT	CASIKGGPWPAFF	TRBV10-1	TRBJ1-1
TGTGCCAGCAGGCAGTGGGGGGGAGGAAAGGCTGGAAACACCATATATTTT	CASRQWGGGKAGNTIYF	TRBV6-4	TRBJ1-3
TGTGCCATAAAGGCGTGGAGCTCTGGAAACACCATATATTTT	CAIKAWSSGNTIYF	TRBV6-1	TRBJ1-3
TGTGCCAGACAGGACCAAGAGACCCAGTACTTC	CARQDQETQYF	TRBV7-2	TRBJ2-5
TGTGCCAGCAGCATAGCGGAGAACGCGTATGGCTACACCTTC	CASSIAENAYGYTF	TRBV7-2	TRBJ1-2
TGTGCCAGCAGCTTACCAGGGGCATCCTCCGGCAATCAGCCCCAGCATTTT	CASSLPGASSGNQPQHF	TRBV11-1	TRBJ1-5
TGCAGCGTTTCCTCGGGGGAATGCCACAGGGGAAACAGCAATCAGCCCCAGCATTTT	CSVSSGECHRGNSNQPQHF	TRBV29-1	TRBJ1-5
TGTGCCAGCAGCTTTCAGGTCGGGACAGAAAACTATGGCTACACCTTC	CASSFQVGTENYGYTF	TRBV11-2	TRBJ1-2
TGTGCCAGCAGTTACGTCGGCTTTGAGCAGTACTTC	CASSYVGFEQYF	TRBV6-2	TRBJ2-7
TGTGCCAGCAGCCCGGGACAGGGCGCTGAAAAACTGTTTTTT	CASSPGQGAEKLFF	TRBV7-3	TRBJ1-4
TGTGCCTGGAGTGAGGGGGGCCTGAATGCCGGGGAGCTGTTTTTT	CAWSEGGLNAGELFF	TRBV30	TRBJ2-2
TGCGCCAGCAGTGAGCGATATGACACATCTCCCTACGAGCAGTACTTC	CASSERYDTSPYEQYF	TRBV10-1	TRBJ2-7
TGTGCCAGCAGCCAAGATCTAGTAGACTTGGGGACCGGGCCCGGGGAGACCCAGTACTTC	CASSQDLVDLGTGPGETQYF	TRBV3-1	TRBJ2-5
TGTGCCAGTGTGGGCTGTGGGTGTACCTACAATGAGCAGTTCTTC	CASVGCGCTYNEQFF	TRBV19	TRBJ2-1
TGCAGTGCTAGCCGGACCTCGCCAGGAAAAGCTAACTATGGCTACACCTTC	CSASRTSPGKANYGYTF	TRBV20-1	TRBJ1-2
TGTGCCAGCAGCCAAGGGGAATCCAGGGTGCAAGAGACCCAGTACTTC	CASSQGESRVQETQYF	TRBV3-1	TRBJ2-5
TGTGCCTGCTCTCCGGTCACTGAACTCTTATTCCGCAATCAGCCCCAGCATTTT	CACSPVTELLFRNQPQHF	TRBV30	TRBJ1-5
TGTGCCAGCAGTCCCCCCAGGACCTATGTCACTGAAGCTTTCTTT	CASSPPRTYVTEAFF	TRBV12-4	TRBJ1-1
TGTGCCAGCAGGGGGGACTCTGGGGCCAACGTCCTGACTTTC	CASRGDSGANVLTF	TRBV28	TRBJ2-6
TGTGCCAGCAGTCGGATTAAGGGGGAGAGCACGCAGTATTTT	CASSRIKGESTQYF	TRBV28	TRBJ2-3
TGCAGTGCTCCAAACCGGCGAAGGTATAGCAATCAGCCCCAGCATTTT	CSAPNRRRYSNQPQHF	TRBV20-1	TRBJ1-5
TGTGCCAGCAGCTCCCTGACTTCCCAGAAGCTAAAAACCCCCTACGAGCAGTACTTC	CASSSLTSQKLKTPYEQYF	TRBV5-6	TRBJ2-7
TGCGCCAGCAGTGAGTTTCGTTTGGGTATGGTGGGACTAGACTCCTACGAGCAGTACTTC	CASSEFRLGMVGLDSYEQYF	TRBV10-1	TRBJ2-7
TGTGCCAGCAGCCAAGGTGTCCCGGGACAGGCTACCGGGGAGCTGTTTTTT	CASSQGVPGQATGELFF	TRBV14	TRBJ2-2
TGTGCCAGCAGTTTACTCGAGCTTTATCCAGGGCAACACACTGAAGCTTTCTTT	CASSLLELYPGQHTEAFF	TRBV6-5	TRBJ1-1
TGTGCCAGCAGCTCTCTCATATCGTTGCACGCGGGGGAAACGAACACCGGGGAGCTGTTTTTT	CASSSLISLHAGETNTGELFF	TRBV7-9	TRBJ2-2
TGTGCCAGCAGCTTTCTACAGGGTAATGGCTACGAGCAGTACTTC	CASSFLQGNGYEQYF	TRBV11-2	TRBJ2-7
TGTGCCAGCAGTGAAAAACTAGCGGGAGGGAGCTCCTACGAGCAGTACTTC	CASSEKLAGGSSYEQYF	TRBV6-1	TRBJ2-7
TGTGCCTGGAGTGTGCGGGACAGTAGAATGAACACTGAAGCTTTCTTT	CAWSVRDSRMNTEAFF	TRBV30	TRBJ1-1
TGTGCCAGCAGCTGGACTAGCGGCTCTAAGGGTCTCACAGATACGCAGTATTTT	CASSWTSGSKGLTDTQYF	TRBV2	TRBJ2-3
TGTGCCAGCAATTTACCTTATGGCTACACCTTC	CASNLPYGYTF	TRBV25-1	TRBJ1-2
TGTGCCAGCACTTCTCCGACAGGGGGCGAGAATAGCAATCAGCCCCAGCATTTT	CASTSPTGGENSNQPQHF	TRBV6-4	TRBJ1-5
TGCGCCAGCAGGCCTGTTCTACAGGGGTTAACGGATTCACCCCTCCACTTT	CASRPVLQGLTDSPLHF	TRBV10-2	TRBJ1-6
TGTGCCAGCAGCCAAGATCAACCTGACAGGTGGCATAGCAATCAGCCCCAGCATTTT	CASSQDQPDRWHSNQPQHF	TRBV14	TRBJ1-5
TGTGCCAGCAGCTACCATCTGGGACAGGGGGGCGTCACCGGGGAGCTGTTTTTT	CASSYHLGQGGVTGELFF	TRBV5-4	TRBJ2-2
TGTGCCAGCAGCATAACAACTAGCGGGGCTCTATACAATGAGCAGTTCTTC	CASSITTSGALYNEQFF	TRBV7-2	TRBJ2-1
TGTGCCAGCAGCTTACTAACTGGACATTATAGCAATCAGCCCCAGCATTTT	CASSLLTGHYSNQPQHF	TRBV7-9	TRBJ1-5
TGTGCCAGCAGTGTAAAAGCCCCGGGGCCAGAGACCCAGTACTTC	CASSVKAPGPETQYF	TRBV6-4	TRBJ2-5
TGTGCCAGCAGCCGCCTTTTGAGGGTCGACGAGCAGTACTTC	CASSRLLRVDEQYF	TRBV7-9	TRBJ2-7
TGTGCCAGCACCCGTCAGGGAGCTTTCTTT	CASTRQGAFF	TRBV5-4	TRBJ1-1
TGTGCCAGCAGTTTCACCCCTCCTAGGAGTCACGAGCAGTACTTC	CASSFTPPRSHEQYF	TRBV12-4	TRBJ2-7
TGTGCCAGCAGCTTAAACAGCGGGAGAGAGCAGTACTTC	CASSLNSGREQYF	TRBV7-3	TRBJ2-7
TGTGCCAGCAGGGGCTCGGGGGGTTGTCAGCCCCAGCATTTT	CASRGSGGCQPQHF	TRBV14	TRBJ1-5
TGTAGCGGGACATTAGTGGATAATCAGCCCCAGCATTTT	CSGTLVDNQPQHF	TRBV20-1	TRBJ1-5
TGCGCCAGCAGCCAAAGGGGGTCGCACTCCTACAATGAGCAGTTCTTC	CASSQRGSHSYNEQFF	TRBV4-1	TRBJ2-1
TGTGCCAGCAGTTACGCCCAACCAGTTTACTATGGCTACACCTTC	CASSYAQPVYYGYTF	TRBV6-5	TRBJ1-2
TGTGCCAGCAGCACGGGAATGGCGGACACTGAAGCTTTCTTT	CASSTGMADTEAFF	TRBV27	TRBJ1-1
TGCGCCAGCAGCTACCGAGGCCACGAGCAGTACTTC	CASSYRGHEQYF	TRBV5-1	TRBJ2-7
TGTGCCAGCAGCCGGGCAGAGCAGTACTTC	CASSRAEQYF	TRBV7-3	TRBJ2-7
TGTGCCAGCAGTGGTTCCGGGACTAGGTACAATGAGCAGTTCTTC	CASSGSGTRYNEQFF	TRBV6-1	TRBJ2-1
TGCGCCAGCAGCCAATCCTTACGCAGCTCCTACGAGCAGTACTTC	CASSQSLRSSYEQYF	TRBV4-1	TRBJ2-7
TGTGCCAGCAGCCCGTTGGGGGAGGTCTACGAGCAGTACTTC	CASSPLGEVYEQYF	TRBV6-5	TRBJ2-7
TGTGCCAGCAGCCAAGGGAAACCCCGGGACATGTACCTTGGCACTGAAGCTTTCTTT	CASSQGKPRDMYLGTEAFF	TRBV3-1	TRBJ1-1
TGCAGTGCTAGGACGGGGGCCAGAAGGACGAACACCGGGGAGCTGTTTTTT	CSARTGARRTNTGELFF	TRBV20-1	TRBJ2-2
TGTGCCAGCATACGCGGGACTAGGGGCGGGTTAGCCTACGAGCAGTACTTC	CASIRGTRGGLAYEQYF	TRBV27	TRBJ2-7
TGTGCCAGCAGCGTGCGGACTAGCGGGGTCGGGGGTAGCTCCTACGAGCAGTACTTC	CASSVRTSGVGGSSYEQYF	TRBV9	TRBJ2-7
TGTGCCAGCGACGGGGCAGCGAGTAAAGCTAACTATGGCTACACCTTC	CASDGAASKANYGYTF	TRBV6-4	TRBJ1-2
TGTGCCAACGCCGGGACAGGGCAAGAGACCCAGTACTTC	CANAGTGQETQYF	TRBV6-4	TRBJ2-5
TGTGCCACCATGTTATGGACTAGCGCCTACGAGCAGTACTTC	CATMLWTSAYEQYF	TRBV24-1	TRBJ2-7
TGCGCCAGCAGCTGTCAAAACACTAGCGGGTCCTACAATGAGCAGTTCTTC	CASSCQNTSGSYNEQFF	TRBV5-1	TRBJ2-1
TGTGCCTGGAGTTGGGACAGGGTGTACTTC	CAWSWDRVYF	TRBV30	TRBJ2-5
TGTGCCAGCAGTGACATTTCGACAGGGGCCTTCCAACTCTACTGCAATCAGCCCCAGCATTTT	CASSDISTGAFQLYCNQPQHF	TRBV25-1	TRBJ1-5
TGTGCCAGCAGTTTATGTCTCACTGGGAATGAGCAGTTCTTC	CASSLCLTGNEQFF	TRBV28	TRBJ2-1
TGTGCCAGCAGCGAAATAACAGATACGCAGTATTTT	CASSEITDTQYF	TRBV5-6	TRBJ2-3
TGTGCCAGCAGCACTTATGGGAGGCATTTCTATGGCTACACCTTC	CASSTYGRHFYGYTF	TRBV9	TRBJ1-2
TGTGCCAGCAGCCCCCCCCAGCGGACCCAAGAGACCCAGTACTTC	CASSPPQRTQETQYF	TRBV6-4	TRBJ2-5
TGCGCCAGCCCGAGTGGGGACAGGCTTATCAGCTATGGCTACACCTTC	CASPSGDRLISYGYTF	TRBV4-3	TRBJ1-2
TGTGCCAGCAGCTTAGTTGGCGAACGACTAGCCAAAAACATTCAGTACTTC	CASSLVGERLAKNIQYF	TRBV13	TRBJ2-4
TGTGCTTTGTCGGGGACAGGGCTTTTCACCATATATTTT	CALSGTGLFTIYF	TRBV28	TRBJ1-3
TGCGCCAGCAACCCGGGACAGGGGGGGGGCTATGGCTACACCTTC	CASNPGQGGGYGYTF	TRBV5-1	TRBJ1-2
TGCGCCAGCAGCCAAGATCCGGGACAGGGAAGGAGCTACGAGCAGTACTTC	CASSQDPGQGRSYEQYF	TRBV4-1	TRBJ2-7
TGTGCCAGCAGTTTTGGACAGGGGGTCACCTACGAGCAGTACTTC	CASSFGQGVTYEQYF	TRBV27	TRBJ2-7
TGTGCCAGCAGTAACCGACATAAGATTCACTATGGCTACACCTTC	CASSNRHKIHYGYTF	TRBV6-5	TRBJ1-2
TGTGCCAGCAGCTTCTTCTGCGGACCAGAGAACACTGAAGCTTTCTTT	CASSFFCGPENTEAFF	TRBV5-4	TRBJ1-1
TGCGCCAGCAGCGCCGTAGGACTAGCGGGGGCCCCTTACAATGAGCAGTTCTTC	CASSAVGLAGAPYNEQFF	TRBV5-1	TRBJ2-1
TGTGCCAGCAGCTTGGCTCCAGGGATTGTGCCAGCTTTCTTT	CASSLAPGIVPAFF	TRBV5-6	TRBJ1-1
TGTGCCAGCACATCGCGGGAGGTATATCAGCCCCAGCATTTT	CASTSREVYQPQHF	TRBV6-6	TRBJ1-5
TGCAGCGTTGAAGTAAACCCCCTGTACAGGGGAAAGAACACTGAAGCTTTCTTT	CSVEVNPLYRGKNTEAFF	TRBV29-1	TRBJ1-1
TGTGCCAGCAGCGGAGGGTTCCCCAACTATGGCTACACCTTC	CASSGGFPNYGYTF	TRBV11-3	TRBJ1-2
TGTGCCACCGGGGAAGCTTTCTTT	CATGEAFF	TRBV6-5	TRBJ1-1
TGTGCCAGCAGTCCGTTCTGTTTATTGGACGGGAGGTACGAGCAGTACTTC	CASSPFCLLDGRYEQYF	TRBV6-8	TRBJ2-7
TGTGCTACAGGGGGCAGGGAGCGGAGCTCCTACGAGCAGTACTTC	CATGGRERSSYEQYF	TRBV12-5	TRBJ2-7
TGTGCCAGCAGCGAGGGTTACAATGAGCAGTTCTTC	CASSEGYNEQFF	TRBV27	TRBJ2-1
TGTGCCAGCAGCCTTTTGGGACTGTCTAGCCGCACTGAAGCTTTCTTT	CASSLLGLSSRTEAFF	TRBV5-8	TRBJ1-1
TGTGCCAGCAGTGAACTCTTCCGGGGGGGCGAGACCCAGTACTTC	CASSELFRGGETQYF	TRBV2	TRBJ2-5
TGTGCCAGCAGCATGGAGACAGGGTGTGCAGATACGCAGTATTTT	CASSMETGCADTQYF	TRBV7-3	TRBJ2-3
TGTGCCAGCAGCTTAGCGCCGACAGGAAATTACGAGCAGTACTTC	CASSLAPTGNYEQYF	TRBV7-2	TRBJ2-7
TGTGCCAGCAGCTTACTAGCGGCCTACGAGCAGTACTTC	CASSLLAAYEQYF	TRBV7-3	TRBJ2-7
TGTGCCAGCAGTGGTTCCCACCTGCTAGCGGGGGAAACCTCCTACGAGCAGTACTTC	CASSGSHLLAGETSYEQYF	TRBV6-4	TRBJ2-7
TGTGCCAGCAGAGAAGTGAGACAGGGGGCGCTTGCCCTCGTCACTGAAGCTTTCTTT	CASREVRQGALALVTEAFF	TRBV25-1	TRBJ1-1
TGCGCCAGCAGCCAAGATTTGCGGGACAGGGCCTATGGCTACACCTTC	CASSQDLRDRAYGYTF	TRBV4-1	TRBJ1-2
TGTGCCACCAGTGATTTCCCAACGCAGTATTTT	CATSDFPTQYF	TRBV24-1	TRBJ2-3
TGTGCCAGCAGGATCGGGGGGGCGGATCCACCTCAGCCCCAGCATTTT	CASRIGGADPPQPQHF	TRBV6-5	TRBJ1-5
TGTGCCAGCAGCTTAATACGACAGGGGGGCCAAGCCTACAATGAGCAGTTCTTC	CASSLIRQGGQAYNEQFF	TRBV7-3	TRBJ2-1
TGTGCCGCAGGACAGGGAGCCAAAAACATTCAGTACTTC	CAAGQGAKNIQYF	TRBV25-1	TRBJ2-4
TGCCTGAAAACACGTTACGAGCAGTACTTC	CLKTRYEQYF	TRBV20-1	TRBJ2-7
TGTGCCAGCAGTGGTGGGAGCAATGACTACGAGCAGTACTTC	CASSGGSNDYEQYF	TRBV6-4	TRBJ2-7
TGTGCCACCAGTGATTTGGCGGTATCCCTGGGACAGGGGGAGGTGACCTACGAGCAGTACTTC	CATSDLAVSLGQGEVTYEQYF	TRBV24-1	TRBJ2-7
TGCGCCAGCAGTGTAGACAATCCCTACGGTCTAGCGGTATCCTACAATGAGCAGTTCTTC	CASSVDNPYGLAVSYNEQFF	TRBV10-1	TRBJ2-1
TGTGCCAGCAGTGCCAAGGGGGGGGGGCCACAGGGCACAGATACGCAGTATTTT	CASSAKGGGPQGTDTQYF	TRBV25-1	TRBJ2-3
TGTGCCAGCAGTCAGGGGAAGGTGTCGGGCCCTGGAAACACCATATATTTT	CASSQGKVSGPGNTIYF	TRBV6-1	TRBJ1-3
TGTGCCAGCAGCCGAATCCGGACAGGGGGCTCGGAAAAACTGTTTTTT	CASSRIRTGGSEKLFF	TRBV7-4	TRBJ1-4
TGTGCCAGCAGCTTAGGATACGAGCAGTACTTC	CASSLGYEQYF	TRBV11-2	TRBJ2-7
TGTGCCCGGGGGTTTTACACTGAAGCTTTCTTT	CARGFYTEAFF	TRBV6-5	TRBJ1-1
TGCGCCAGCAGCCAAGATCAGGAGGGTAGGGGGACAGGGTTCAGAGGGGGAAACACCATATATTTT	CASSQDQEGRGTGFRGGNTIYF	TRBV4-1	TRBJ1-3
TGCAGTGCTAGAGTAGGGCGCCAGGACGGGACGGAGGACACTGAAGCTTTCTTT	CSARVGRQDGTEDTEAFF	TRBV20-1	TRBJ1-1
TGTGCCAGCAGCTACTCTGGGGCCAACGTCCTGACTTTC	CASSYSGANVLTF	TRBV7-3	TRBJ2-6
TGTGCCAGCAGACTTCGGGGGGACACCGGGGAGCTGTTTTTT	CASRLRGDTGELFF	TRBV13	TRBJ2-2
TGTGCCAGCAGTTACCCACGAACAGGGATTTCGGGTTCGAACACTGAAGCTTTCTTT	CASSYPRTGISGSNTEAFF	TRBV6-5	TRBJ1-1
TGCAGTGCTAGTCGAGCCGGGACTAGCGGGGGAGGACTCTACAATGAGCAGTTCTTC	CSASRAGTSGGGLYNEQFF	TRBV20-1	TRBJ2-1
TGCAGCGTTGAGGAGGGAGGCTACACCTTC	CSVEEGGYTF	TRBV29-1	TRBJ1-2
TGTGCCAGCAGCCAAGCGGCTAGCGGTCTAGTCCGGAGCTCCTACAATGAGCAGTTCTTC	CASSQAASGLVRSSYNEQFF	TRBV14	TRBJ2-1
TGTGCCAGCAGCACCCTATGCGGCAGGAGCTCCTACAATGAGCAGTTCTTC	CASSTLCGRSSYNEQFF	TRBV7-3	TRBJ2-1
TGTGCCAGCAGGAATCAGGGGGCCGTACAGGCTGAGACCCAGTACTTC	CASRNQGAVQAETQYF	TRBV6-4	TRBJ2-5
TGCAGTGCTAATGGCAGATCCTATAATTCACCCCTCCACTTT	CSANGRSYNSPLHF	TRBV20-1	TRBJ1-6
TGTGCCAGCAGCCACCAGGACAGCGGGAACGAGCAGTACTTC	CASSHQDSGNEQYF	TRBV14	TRBJ2-7
TGCGCCAGCAGCTTTATCTATAGCGGTCGGGGCGAGCAGTTCTTC	CASSFIYSGRGEQFF	TRBV5-1	TRBJ2-1
TGTGCCAGCAGCGTTCGGACAGGAATGAACACTGAAGCTTTCTTT	CASSVRTGMNTEAFF	TRBV13	TRBJ1-1
TGCAGTGCTAGGGGCTACCGGGACAGTACGGGCTACGAGCAGTACTTC	CSARGYRDSTGYEQYF	TRBV20-1	TRBJ2-7
TGTGCCAGCAGTGGGGCTGCTGACAGGGACTTGCTGGCTAAGGAGACCCAGTACTTC	CASSGAADRDLLAKETQYF	TRBV2	TRBJ2-5
TGTGCCAGCAGCTCTTGGGGAGGGGGTAAATGGGAAGCTTTCTTT	CASSSWGGGKWEAFF	TRBV5-6	TRBJ1-1
TGTGCCAGCAGTTTAAGTGGGGCGACAGGGAACGATCAGCCCCAGCATTTT	CASSLSGATGNDQPQHF	TRBV27	TRBJ1-5
TGTGCCACTCGCCGGGACAGGGGTGAAGCTTTCTTT	CATRRDRGEAFF	TRBV13	TRBJ1-1
TGTGCCAGCGGACAGGTACAGGTCCTGACTTTC	CASGQVQVLTF	TRBV7-9	TRBJ2-6
TGTGCCAGCAGCTTTCAGGACAGAAGTGGCTACACCTTC	CASSFQDRSGYTF	TRBV7-9	TRBJ1-2
TGTGCCAGCAGTTACCCCCCCTCAAATGAGCAGTTCTTC	CASSYPPSNEQFF	TRBV6-5	TRBJ2-1
TGTGCCAGTAGTAGGCCCTCATGCTCCACCAATCAGCCCCAGCATTTT	CASSRPSCSTNQPQHF	TRBV19	TRBJ1-5
TGTGCCAGCAGTTTATGGCGGCAGGGCGCCAAAAACATTCAGTACTTC	CASSLWRQGAKNIQYF	TRBV27	TRBJ2-4
TGTGCCAGCCGGCAACGGGGTGGTTCTGGAAACACCATATATTTT	CASRQRGGSGNTIYF	TRBV4-2	TRBJ1-3
TGTGCCAGCAGCGCCCACAGGGGCGTTGACACTGAAGCTTTCTTT	CASSAHRGVDTEAFF	TRBV13	TRBJ1-1
TGCGCCAGCACCAGGGGCGCAGGAGCCAAAAACATTCAGTACTTC	CASTRGAGAKNIQYF	TRBV10-1	TRBJ2-4
TGCAGTGCTAGCTCCCAGGGTTATAGCAATCAGCCCCAGCATTTT	CSASSQGYSNQPQHF	TRBV20-1	TRBJ1-5
TGCGCCAGCAGTGAGTCCCGGCGGCGGGAAAACACTGAAGCTTTCTTT	CASSESRRRENTEAFF	TRBV10-1	TRBJ1-1
TGTGCCAGCAGTCTGGGACTAGCGTCAGTCTACGAGCAGTACTTC	CASSLGLASVYEQYF	TRBV12-3	TRBJ2-7
TGTGCCAGCAGTGATGGGACAAGGGCTCCAAGGTTCCGGTACTCCTCCTACGAGCAGTACTTC	CASSDGTRAPRFRYSSYEQYF	TRBV6-1	TRBJ2-7
TGTGCCAGCAGCGGGGCCCACAATGAGCAGTTCTTC	CASSGAHNEQFF	TRBV6-4	TRBJ2-1
TGTGCCACCCTAGGGGGGGATCAGCCCCAGCATTTT	CATLGGDQPQHF	TRBV24-1	TRBJ1-5
TGTGCCAGCAGTCCTAAAGGCAGGGCGTTATGTCATGAGCAGTTCTTC	CASSPKGRALCHEQFF	TRBV6-5	TRBJ2-1
TGCAGTGCTAGAGATGAGCGGGAGTGCGAGCAGTACTTC	CSARDERECEQYF	TRBV20-1	TRBJ2-7
TGCGCCAGCAGCCAGGGGGAGGGGGGAAACACCATATATTTT	CASSQGEGGNTIYF	TRBV4-3	TRBJ1-3
TGTGCCAGCAGGCCGTACCCGACAGGTGTGTGTCGCAATGAGCAGTTCTTC	CASRPYPTGVCRNEQFF	TRBV6-5	TRBJ2-1
TGTGCCAGCCACAGGGAGACCCAGTACTTC	CASHRETQYF	TRBV7-3	TRBJ2-5
TGCACGTACGGACAGGGAGATCAGCCCCAGCATTTT	CTYGQGDQPQHF	TRBV20-1	TRBJ1-5
TGTGCCAGATTCGACAGGGACTATGGCTACACCTTC	CARFDRDYGYTF	TRBV2	TRBJ1-2
TGTGGCAGGGGGCCGGGCAATCAGCCCCAGCATTTT	CGRGPGNQPQHF	TRBV30	TRBJ1-5
TGCGCCAGCAGCCCGTGGGCTTATCGGGGCTACACCTTC	CASSPWAYRGYTF	TRBV4-3	TRBJ1-2
TGTGCCAGAGGATCTAGGAATCCCCATGGCTACACCTTC	CARGSRNPHGYTF	TRBV6-5	TRBJ1-2
TGCGCCAGCAGCTACGGGACCCCCAATTCACCCCTCCACTTT	CASSYGTPNSPLHF	TRBV5-1	TRBJ1-6
TGCGCCAGCAGCTTGCCCACTAGCGGGAGGGCGGTGGTGAACACTGAAGCTTTCTTT	CASSLPTSGRAVVNTEAFF	TRBV5-1	TRBJ1-1
TGTGCCCCTAGCGGGAGGGGTGCAGCGACCCAGTACTTC	CAPSGRGAATQYF	TRBV2	TRBJ2-5
TGTGCCAGCAGTTATTCGGCAGAAGGCTACACCTTC	CASSYSAEGYTF	TRBV6-5	TRBJ1-2
TGTGCTAGTGGTTTGGAGGGCACCAATGAGCAGTTCTTC	CASGLEGTNEQFF	TRBV12-5	TRBJ2-1
TGTGCCAGCAGCTTCCCGGACAGGGGGCTTGGGCAGCCCCAGCATTTT	CASSFPDRGLGQPQHF	TRBV7-9	TRBJ1-5
TGTGCCATCAAGGGACAGAAACAAGAGACCCAGTACTTC	CAIKGQKQETQYF	TRBV10-3	TRBJ2-5
TGCAGCGTTGAGGAGAGCGGGAGCGAGTTAGCCAAAAACATTCAGTACTTC	CSVEESGSELAKNIQYF	TRBV29-1	TRBJ2-4
TGTGCCAGCAGCCTGTACTACGAGCAGTACTTC	CASSLYYEQYF	TRBV28	TRBJ2-7
TGTGCCAGCAGCCAAGGTTACGGTGCCAAAAACATTCAGTACTTC	CASSQGYGAKNIQYF	TRBV3-1	TRBJ2-4
TGTGCCTGGAGTGTCCCAGGGAAGTTCTACGAGCAGTACTTC	CAWSVPGKFYEQYF	TRBV30	TRBJ2-7
TGTGCCAGCGGAGGGGATTACAATGAGCAGTTCTTC	CASGGDYNEQFF	TRBV5-4	TRBJ2-1
TGTGCCAGCAGCTTACCCCCCGGGACAGGGCTTAACTATGGCTACACCTTC	CASSLPPGTGLNYGYTF	TRBV7-6	TRBJ1-2
TGCGCCAGCAGCCAAGCATTCCGGGACAGGGCCGACCAAGAGACCCAGTACTTC	CASSQAFRDRADQETQYF	TRBV4-1	TRBJ2-5
TGTGCCAGCAGGTTGGGGGTACAGAACACTGAAGCTTTCTTT	CASRLGVQNTEAFF	TRBV2	TRBJ1-1
TGTGCCAGCAGCCCGACTGTCGCGGGGAAATCCAACGAGCAGTACTTC	CASSPTVAGKSNEQYF	TRBV13	TRBJ2-7
TGTGCCAGCAGCCCCGGACGGGCCTACGAGCAGTACTTC	CASSPGRAYEQYF	TRBV5-4	TRBJ2-7
TGTGCCAGCAGCTTCCGGCAGGCGTTTCAGCCCCAGCATTTT	CASSFRQAFQPQHF	TRBV11-2	TRBJ1-5
TGTGCCAGCAGCCAGACAGGGGGAGATACGCAGTATTTT	CASSQTGGDTQYF	TRBV14	TRBJ2-3
TGTGCCAGCAGCCCCCACTGTTGGCGGGTCTCCGCCAAAAACATTCAGTACTTC	CASSPHCWRVSAKNIQYF	TRBV11-3	TRBJ2-4
TGTGCCACCAGTGAGCCTGACCAGAGGGGCGGTGACTACGAGCAGTACTTC	CATSEPDQRGGDYEQYF	TRBV24-1	TRBJ2-7
TGTGCCAGCAGCCAAGATCGGGGGGGAGTGGCTTTCTTT	CASSQDRGGVAFF	TRBV3-1	TRBJ1-1
TGTGCCACCAGTGATTTAGACTCGAAAAGCCGCTACACCTTC	CATSDLDSKSRYTF	TRBV24-1	TRBJ1-2
TGTGCCAGCAGCGAGACTAGCGGGCTTAATGAGCAGTTCTTC	CASSETSGLNEQFF	TRBV7-2	TRBJ2-1
TGTGCCACCAGTGAGTCCACCTACGAGCAGTACTTC	CATSESTYEQYF	TRBV24-1	TRBJ2-7
TGCGCCGGGGGGGCCGAGCAGTACTTC	CAGGAEQYF	TRBV10-1	TRBJ2-7
TGTGCTAGTGCCCCGACTAGCGGGAGCGAGCAGTACTTC	CASAPTSGSEQYF	TRBV12-5	TRBJ2-7
TGTGCCAGCCGACCCGGGACAGGGACTGGCCAAGAGACCCAGTACTTC	CASRPGTGTGQETQYF	TRBV25-1	TRBJ2-5
TGTGCCAGCTTAACACGAGAACACAATGAGCAGTTCTTC	CASLTREHNEQFF	TRBV5-6	TRBJ2-1
TGCAGTGCTGGAAAGGGGGCGATAAGGACTACGCAGTATTTT	CSAGKGAIRTTQYF	TRBV20-1	TRBJ2-3
TGTGCCAGCATTCCGGGGTACGACTATGGCTACACCTTC	CASIPGYDYGYTF	TRBV6-1	TRBJ1-2
TGTGCCAGCCCGGGGGCAAACTATGGCTACACCTTC	CASPGANYGYTF	TRBV27	TRBJ1-2
TGTGCCAGCAGTCGATCCTCGAGCAATCAGCCCCAGCATTTT	CASSRSSSNQPQHF	TRBV14	TRBJ1-5
TGTGCCAGCAGCTATCCCGGGACAGGAGAGACCCAGTACTTC	CASSYPGTGETQYF	TRBV11-2	TRBJ2-5
TGTGCCAGCAGTTACTCGGGGGACAGCGGTAACCGAGACGAGCAGTACTTC	CASSYSGDSGNRDEQYF	TRBV6-8	TRBJ2-7
TGTGCCAGCAGCGTATGGGACAGGGGGAAGGATGGCTACACCTTC	CASSVWDRGKDGYTF	TRBV9	TRBJ1-2
TGTGCCAGCAGCCGGCGGGACAGGGGGCGGGAGGGGGTCACTGAAGCTTTCTTT	CASSRRDRGREGVTEAFF	TRBV13	TRBJ1-1
TGTGCCAGCAGCAAGGGAACGGAAAAACTGTTTTTT	CASSKGTEKLFF	TRBV7-4	TRBJ1-4
TGTGCCAGCCCCCTTGGGGGATTACCTGGGGAGCTGTTTTTT	CASPLGGLPGELFF	TRBV12-3	TRBJ2-2
TGTGCCAGCAGTTACTCATGGGGACGCCACTACGAGCAGTACTTC	CASSYSWGRHYEQYF	TRBV6-5	TRBJ2-7
TGTGCCAGCAGGTGTGTCTTCTTAGCGGACAATGAGCAGTTCTTC	CASRCVFLADNEQFF	TRBV5-6	TRBJ2-1
TGCGCCAGCAGTGAGTCACTTACGGGACACGTTAGAGCTGGGGCCAACGTCCTGACTTTC	CASSESLTGHVRAGANVLTF	TRBV10-1	TRBJ2-6
TGTGCCACCAGCAGAGATCGGGACAGGGCGAGGGTAAAATGGAATTTTCCTAACTATGGCTACACCTTC	CATSRDRDRARVKWNFPNYGYTF	TRBV15	TRBJ1-2
TGCGCCAGCAGCCGGCTCGATGAAAAACTGTTTTTT	CASSRLDEKLFF	TRBV5-1	TRBJ1-4
TGTGCCAGCAGCTTTGGGGGGGCTTTCTCAGACTACAATGAGCAGTTCTTC	CASSFGGAFSDYNEQFF	TRBV13	TRBJ2-1
TGCGCGGGGCAGAGACCTTATCAGCCCCAGCATTTT	CAGQRPYQPQHF	TRBV5-1	TRBJ1-5
TGTGCCAGCATTGAGTCGCCCCGGGGGGTTAATGAGCAGTTCTTC	CASIESPRGVNEQFF	TRBV5-6	TRBJ2-1
TGTGCCAGCAGCAAAGGGGGGGATTGCACAGATACGCAGTATTTT	CASSKGGDCTDTQYF	TRBV13	TRBJ2-3
TGCGGAAGACAGGGCACGACAAGGCAGCCCCAGCATTTT	CGRQGTTRQPQHF	TRBV20-1	TRBJ1-5
TGTGCCAGCAGCGCCAGGGGGCTTCCCTTTTACTATGGCTACACCTTC	CASSARGLPFYYGYTF	TRBV9	TRBJ1-2
TGTGCCAGCAACGACGGGAGGACGGGCCCAGATACGCAGTATTTT	CASNDGRTGPDTQYF	TRBV27	TRBJ2-3
TGTGCCAGCAGCCTGCTGGAGAAGGACAGGGTTCGGGAGCAGTACTTC	CASSLLEKDRVREQYF	TRBV5-8	TRBJ2-7
TGTGCCAGCAGCGAAAGACAGGTACGGGCCAAAAACATTCAGTACTTC	CASSERQVRAKNIQYF	TRBV13	TRBJ2-4
TGCGCCAGGAGTCCGGGATCCTGGTCCTACGAGCAGTACTTC	CARSPGSWSYEQYF	TRBV10-1	TRBJ2-7
TGCAGTGCAGGGAGGGATTCACCCCTCCACTTT	CSAGRDSPLHF	TRBV20-1	TRBJ1-6
TGTGCCAGCACTCCGGGGGCGAATAAGGGCGAGTATAGCAATCAGCCCCAGCATTTT	CASTPGANKGEYSNQPQHF	TRBV6-5	TRBJ1-5
TGCGCCAGCAGCTCCGCGACGTTCGCCTGGGACTACGAGCAGTACTTC	CASSSATFAWDYEQYF	TRBV5-1	TRBJ2-7
TGTGCCAGCAGTTGGATTGGACAGCTAGCCAAAAACATTCAGTACTTC	CASSWIGQLAKNIQYF	TRBV6-5	TRBJ2-4
TGTGCCAGCAGCTTGGCCGACCAGCGGACCAGGAACACTGAAGCTTTCTTT	CASSLADQRTRNTEAFF	TRBV5-4	TRBJ1-1
TGCAGTGCGGGGCCGGAGACCCAGTACTTC	CSAGPETQYF	TRBV20-1	TRBJ2-5
TGTGCCAGCTCACCCTTGGGGAATCAGCCCCAGCATTTT	CASSPLGNQPQHF	TRBV18	TRBJ1-5
TGTGCCAGCAGCGCAGGAGAGACCCAGTACTTC	CASSAGETQYF	TRBV9	TRBJ2-5
TGTGCCAGCAGCCAAGGATCCGGGACGAACACTGAAGCTTTCTTT	CASSQGSGTNTEAFF	TRBV3-1	TRBJ1-1
TGTGCCAGCATTAAAGGACAGAGGGAGAAGTACAATGAGCAGTTCTTC	CASIKGQREKYNEQFF	TRBV7-6	TRBJ2-1
TGTGCCAGCAGCTCCAGGGGACAAAAGCCCCAGCATTTT	CASSSRGQKPQHF	TRBV6-6	TRBJ1-5
TGTGCCAGCAGCTTACCAAGGGAGGATGCCAAAAACATTCAGTACTTC	CASSLPREDAKNIQYF	TRBV7-9	TRBJ2-4
TGTGCCAGCAGTTATCCGGGGACAGGGTTGTGCTATGGCTACACCTTC	CASSYPGTGLCYGYTF	TRBV6-2	TRBJ1-2
TGTGCCAGCAGTGAGGTCGGCAAGCGGGGAACCTACGAGCAGTACTTC	CASSEVGKRGTYEQYF	TRBV2	TRBJ2-7
TGTGCCAGCACCACCCCGGAGTACTATGGCTACACCTTC	CASTTPEYYGYTF	TRBV25-1	TRBJ1-2
TGCGCCAGCAGCTCTGAGACAGGGTCAGTCGAGCAGTACTTC	CASSSETGSVEQYF	TRBV5-1	TRBJ2-7
TGTGCCAGCAGCATGTCAGGGGGGACAGGGGACTCCTACGAGCAGTACTTC	CASSMSGGTGDSYEQYF	TRBV5-6	TRBJ2-7
TGTGCCAGCAGTGATGAACCCCCCCCTGGGGGCTCTGGAAACACCATATATTTT	CASSDEPPPGGSGNTIYF	TRBV2	TRBJ1-3
TGTGCCAGCAGCGTTCCTGTCGGGCGGAGTGATACGCAGTATTTT	CASSVPVGRSDTQYF	TRBV13	TRBJ2-3
TGTGCCAGCAGTAGCGGGAACACCGGGGAGCTGTTTTTT	CASSSGNTGELFF	TRBV11-2	TRBJ2-2
TGCGCCAGCAGCCCGTGGGACAGGCATGGAGACGAGCAGTACTTC	CASSPWDRHGDEQYF	TRBV4-1	TRBJ2-7
TGTGCCAGCAGCTTAGCGAAGTGGACAGGGGAACAGCCCCAGCATTTT	CASSLAKWTGEQPQHF	TRBV7-6	TRBJ1-5
TGTGCCAGCAGAAATTCCGGGACGGGGGGCCAAGAGACCCAGTACTTC	CASRNSGTGGQETQYF	TRBV6-1	TRBJ2-5
TGTGCCAGCCATAACCCGACTAGGTTCTCCTACGAGCAGTACTTC	CASHNPTRFSYEQYF	TRBV3-1	TRBJ2-7
TGTGCCAGCAGCCGCGGGAGATCCGGAACTGAAGCTTTCTTT	CASSRGRSGTEAFF	TRBV6-1	TRBJ1-1
TGTGCCAGCAGTTCCCCGGACAGAGAAAAACTGTTTTTT	CASSSPDREKLFF	TRBV6-2	TRBJ1-4
TGTGCCAGCAGCCCCCCCGGGAATGGATGGGATCTCAATCAGCCCCAGCATTTT	CASSPPGNGWDLNQPQHF	TRBV11-3	TRBJ1-5
TGTGCCGAGGAGGGGACAGGGGGCCGGCCGAACACTGAAGCTTTCTTT	CAEEGTGGRPNTEAFF	TRBV6-4	TRBJ1-1
TGTGCCTGGGGGACAGGGGGGGCCAGCACAGATACGCAGTATTTT	CAWGTGGASTDTQYF	TRBV10-3	TRBJ2-3
TGTGCCAGCAGCACTAAGGGGCAGAATCAGCCCCAGCATTTT	CASSTKGQNQPQHF	TRBV7-3	TRBJ1-5
TGTGCCAGCAGCGCAGGGGGGATGTGGGAAGCTTTCTTT	CASSAGGMWEAFF	TRBV5-6	TRBJ1-1
TGCGCCAAACCTACCGGGACAGGGCCCGACTCTGGAAACACCATATATTTT	CAKPTGTGPDSGNTIYF	TRBV10-1	TRBJ1-3
TGTGCCACCAGTGTCCCCGGGACTAGCGGGAGGCCGGGGGGCATACTTAGCTCCTACAATGAGCAGTTCTTC	CATSVPGTSGRPGGILSSYNEQFF	TRBV24-1	TRBJ2-1
TGCAGTGCGCGGGAGCGGGGAGACTACGAGCAGTACTTC	CSARERGDYEQYF	TRBV20-1	TRBJ2-7
TGTGCCACCAGTGATTTGCAGGGACCCCAGAGCCGGGACAGGGGGCACGGCTATGGCTACACCTTC	CATSDLQGPQSRDRGHGYGYTF	TRBV24-1	TRBJ1-2
TGTGCCAGCAGTTATCCACAGGGGCCAGGCAACACCATATATTTT	CASSYPQGPGNTIYF	TRBV6-9	TRBJ1-3
TGCGCCAGCAGCCAAGATAGGGGTGACCTCTCCTACGAGCAGTACTTC	CASSQDRGDLSYEQYF	TRBV4-1	TRBJ2-7
TGTGCCACCTACCAGGGGGCGGAGGAAAAACTGTTTTTT	CATYQGAEEKLFF	TRBV24-1	TRBJ1-4
TGTGCCAGCAGCTTGACGGGCCGGGGGGGCCCTTCCCTGGATACGCAGTATTTT	CASSLTGRGGPSLDTQYF	TRBV5-4	TRBJ2-3
TGTGCCAGCAGTGCGGAGTCATACGGGGAGCTGTTTTTT	CASSAESYGELFF	TRBV6-1	TRBJ2-2
TGTGCCAGCAGCTTAGACCAGGGCCGGTACGAGCAGTACTTC	CASSLDQGRYEQYF	TRBV11-3	TRBJ2-7
TGTGCCAGCAGCACCCACCGAAACACCATATATTTT	CASSTHRNTIYF	TRBV13	TRBJ1-3
TGTGCCAGCAGCTTACGGGGCGGAATAGCTAACTATGGCTACACCTTC	CASSLRGGIANYGYTF	TRBV7-9	TRBJ1-2
TGCGCCATCGAAGGGAGCCAGGTAGCGGGGAACACCGGGGAGCTGTTTTTT	CAIEGSQVAGNTGELFF	TRBV10-2	TRBJ2-2
TGTGCCAGTAGTCCACAAGCGGGATTGGAGTACTTGAACACTGAAGCTTTCTTT	CASSPQAGLEYLNTEAFF	TRBV19	TRBJ1-1
TGTGCCAGCAGCTATAAAGAGGGAAAACTGTTTTTT	CASSYKEGKLFF	TRBV11-3	TRBJ1-4
TGCAGTGCTAGACCGTCCAGGGCCAATGAAAAACTGTTTTTT	CSARPSRANEKLFF	TRBV20-1	TRBJ1-4
TGTGCCAGCAGCTTAGAGGCGACCCATCAGCCCCAGCATTTT	CASSLEATHQPQHF	TRBV7-9	TRBJ1-5
TGTGCCAGCAGCCAGCAGGGGTTCTCCTACGAGCAGTACTTC	CASSQQGFSYEQYF	TRBV7-8	TRBJ2-7
TGTGCCAGCAGTGCTCGGGGTAACTATGGCTACACCTTC	CASSARGNYGYTF	TRBV6-4	TRBJ1-2
TGTGCCAGCAGCTCAGATGGGAGGGATACGCAGTATTTT	CASSSDGRDTQYF	TRBV3-1	TRBJ2-3
TGTGCCAGCAGTGGGGACAGACACACTGAAGCTTTCTTT	CASSGDRHTEAFF	TRBV12-3	TRBJ1-1
TGTGCCAGCAGCGCTACGGCATGCGGGAGCACCTACGAGCAGTACTTC	CASSATACGSTYEQYF	TRBV9	TRBJ2-7
TGTGCCACCAGTGAGACGGAGCGGTATTTT	CATSETERYF	TRBV24-1	TRBJ2-3
TGCAGCGTTGAAGGACGGAGGCGTAGGTCACCCCTCCACTTT	CSVEGRRRRSPLHF	TRBV29-1	TRBJ1-6
TGTGCGAATCTGCCGTACAATGAGCAGTTCTTC	CANLPYNEQFF	TRBV24-1	TRBJ2-1
TGCGCCAGCAGCCAAGATCGCGAGGGGGTGAATCAGCCCCAGCATTTT	CASSQDREGVNQPQHF	TRBV4-3	TRBJ1-5
TGTGCCAGCAGCTTGAACCTAAGAGGCAGCTCCTACGAGCAGTACTTC	CASSLNLRGSSYEQYF	TRBV7-3	TRBJ2-7
TGTGCCAGCCGCGGGAGGAGGGGATCCTACGAGCAGTACTTC	CASRGRRGSYEQYF	TRBV6-2	TRBJ2-7
TGTGCCAGCAGCTTAGTCCGAAGAGGGGCAAGGACAGATACGCAGTATTTT	CASSLVRRGARTDTQYF	TRBV11-3	TRBJ2-3
TGTGCCAGCAGTCATCGGGGGGGCCCCACCGGGGAGCTGTTTTTT	CASSHRGGPTGELFF	TRBV6-2	TRBJ2-2
TGTGCCAGCAGCGGGGGGGGGAACACTGAAGCTTTCTTT	CASSGGGNTEAFF	TRBV25-1	TRBJ1-1
TGCGCCAGCAGCTTGTTACAACAGGGGAAACACCCTCACTATGGCTACACCTTC	CASSLLQQGKHPHYGYTF	TRBV5-1	TRBJ1-2
TGTGCCAGCAGCTCTCTTCTCCGAGGGACAGGGGATGCTTCCCTCGGATATAGCAATCAGCCCCAGCATTTT	CASSSLLRGTGDASLGYSNQPQHF	TRBV7-4	TRBJ1-5
TGTGCCAGCGGTTACGGGGCTAATGAAAAACTGTTTTTT	CASGYGANEKLFF	TRBV10-3	TRBJ1-4
TGTGCCAGCAGCTTCACCACTAGCGATGAGCAGTTCTTC	CASSFTTSDEQFF	TRBV7-9	TRBJ2-1
TGTGCCAGCAGCGGGCTTGGGGGGTCCACGTATGAGCAGTTCTTC	CASSGLGGSTYEQFF	TRBV9	TRBJ2-1
TGCAGTGCTAGGGGTCCGAATTTCTACGAGCAGTACTTC	CSARGPNFYEQYF	TRBV20-1	TRBJ2-7
TGTGCCAGCAGCGCAGCAGGGGGCAACACCTACGAGCAGTACTTC	CASSAAGGNTYEQYF	TRBV9	TRBJ2-7
TGTGCCAGCAGCATAGGCCCGGGGGAAGATAGCAATCAGCCCCAGCATTTT	CASSIGPGEDSNQPQHF	TRBV7-3	TRBJ1-5
TGTGCCAGCAGCGGGCCCGATACGCAGTATTTT	CASSGPDTQYF	TRBV7-3	TRBJ2-3
TGTGCCACCAGTTCGGTAGTCGAAGAGACCCAGTACTTC	CATSSVVEETQYF	TRBV24-1	TRBJ2-5
TGTGCCAGCAGTTACAATTGTCAGGGCAGGACCGGGGAGCTGTTTTTT	CASSYNCQGRTGELFF	TRBV6-5	TRBJ2-2
TGTGCCAGCAGCGTAGACGGCTACCTACATTTTGGGGGTAACACTGAAGCTTTCTTT	CASSVDGYLHFGGNTEAFF	TRBV9	TRBJ1-1
TGCGCCAGCCGCGTAGACCGAGGTCCGAACACTGAAGCTTTCTTT	CASRVDRGPNTEAFF	TRBV4-1	TRBJ1-1
TGCGCCCAGACAGGGTGGGCACGCTGCTACAATGAGCAGTTCTTC	CAQTGWARCYNEQFF	TRBV10-1	TRBJ2-1
TGCGCCAGCAGCTTGGTCGGGGGGACGTGGTGGGGTAACTATGGCTACACCTTC	CASSLVGGTWWGNYGYTF	TRBV5-1	TRBJ1-2
TGCGCCAGCAGTAGAACCCACAACCGGACAGGTGGCAATCAGCCCCAGCATTTT	CASSRTHNRTGGNQPQHF	TRBV10-1	TRBJ1-5
TGTGCCAGCAGCATCAGTCTCAAAGCAACTAGCGGGAGTTACACCGGGGAGCTGTTTTTT	CASSISLKATSGSYTGELFF	TRBV9	TRBJ2-2
TGTGCCACCAGTGATGTAATCGGGGCCTCACTCTACGAGCAGTACTTC	CATSDVIGASLYEQYF	TRBV24-1	TRBJ2-7
TGTGCCAGACGAGGTCGCTGCGACGTGGATTACGAGCAGTACTTC	CARRGRCDVDYEQYF	TRBV3-1	TRBJ2-7
TGTGCCAGCAGCCGGGGGAAGGGCTATGGCTACACCTTC	CASSRGKGYGYTF	TRBV27	TRBJ1-2
TGTGCCAGCAGTGATCCCATAATGGTCCAGGGGGCAAGGGCTCTAGCCAAAAACATTCAGTACTTC	CASSDPIMVQGARALAKNIQYF	TRBV6-1	TRBJ2-4
TGTGCCAGCAGAGGGGGGAAAGAGACCCAGTACTTC	CASRGGKETQYF	TRBV7-3	TRBJ2-5
TGTGCCAGCAGCCAGGGTATCCCCCAGCCCCAGCATTTT	CASSQGIPQPQHF	TRBV7-9	TRBJ1-5
TGTGCCAGCAGCTTGCCTCACATCGGGGACAGGGTAACGGACGAGCAGTACTTC	CASSLPHIGDRVTDEQYF	TRBV5-6	TRBJ2-7
TGCGCCAGCACGGGGCAAGAGACCCAGTACTTC	CASTGQETQYF	TRBV10-2	TRBJ2-5
TGTGCCAGCAGCCAAGGCGCAGCATCTGGAAACACCATATATTTT	CASSQGAASGNTIYF	TRBV3-1	TRBJ1-3
TGTGCCAGCAGCTTAGTGGGCGTACGGGACAGGGATCCATCCTATGGCTACACCTTC	CASSLVGVRDRDPSYGYTF	TRBV7-8	TRBJ1-2
TGCAGTGCTAGAGGGGGGGGGGCCCCCGATACGCAGTATTTT	CSARGGGAPDTQYF	TRBV20-1	TRBJ2-3
TGTGCCAGCAGTGGGGGGGGGGGTAATGAGCAGTTCTTC	CASSGGGGNEQFF	TRBV6-4	TRBJ2-1
TGTGCCAGCAGTGAAGTAGGCCTTACAGTCACTGAAGCTTTCTTT	CASSEVGLTVTEAFF	TRBV25-1	TRBJ1-1
TGTGCCAGCAGCTTAGGGGACAGGGATACGGAAGCTTTCTTT	CASSLGDRDTEAFF	TRBV7-6	TRBJ1-1
TGTGCCAGCCCGTCGCCAATCAGGGAGCAGTACTTC	CASPSPIREQYF	TRBV6-3	TRBJ2-7
TGTGCCAGCACCAGGGGGCTCGAGCAGTACTTC	CASTRGLEQYF	TRBV6-3	TRBJ2-7
TGTGCCAGCAGCAGACACAAGAGCCCTGAAGCTTTCTTT	CASSRHKSPEAFF	TRBV7-6	TRBJ1-1
TGCAGTGCCGACAGGGGGAACACCGGGGAGCTGTTTTTT	CSADRGNTGELFF	TRBV20-1	TRBJ2-2
TGTGCCAGCAGTGACTCCCGAACGGGGGTGTCACCCGAAAAACTGTTTTTT	CASSDSRTGVSPEKLFF	TRBV6-4	TRBJ1-4
TGTGCCAGCAGTCATCACGGAACTAGCGGGAGTATCCCGAACACCGGGGAGCTGTTTTTT	CASSHHGTSGSIPNTGELFF	TRBV27	TRBJ2-2
TGTGCCAGCAGGGGGGGGCGCAACCTGAGCGTGGGCACCGGGGAGCTGTTTTTT	CASRGGRNLSVGTGELFF	TRBV28	TRBJ2-2
TGTGCCAGGGTAAGGGGCTGCCAAGAGACCCAGTACTTC	CARVRGCQETQYF	TRBV19	TRBJ2-5
TGTGCCAGCAGTGCGGACGGCCCTTACGAGCAGTACTTC	CASSADGPYEQYF	TRBV6-5	TRBJ2-7
TGTGCCAGCAGCGGCCCCCAGAACAGCTCCTACAATGAGCAGTTCTTC	CASSGPQNSSYNEQFF	TRBV7-3	TRBJ2-1
TGTGCCTGGTGGTACTCAAAATATGGACAGGATCAGCCCCAGCATTTT	CAWWYSKYGQDQPQHF	TRBV30	TRBJ1-5
TGTGCCAGCATGCCCGGGAATTGTGAGCAGTTCTTC	CASMPGNCEQFF	TRBV12-4	TRBJ2-1
TGTGCCAGCAGCCAAGGGGGCCTCCATCAGCCCCAGCATTTT	CASSQGGLHQPQHF	TRBV14	TRBJ1-5
TGCAGTGCTAGAGATACCCTTGGGGGCTTCGTGCAGCCCCAGCATTTT	CSARDTLGGFVQPQHF	TRBV20-1	TRBJ1-5
TGTGCCAGCAGGCATTCCAAGGACAGGTTTCAGCCCCAGCATTTT	CASRHSKDRFQPQHF	TRBV6-4	TRBJ1-5
TGTGCCACCAGATTACGGAGGCCTCTGTATAGCAATCAGCCCCAGCATTTT	CATRLRRPLYSNQPQHF	TRBV24-1	TRBJ1-5
TGTGCCAGCAGACTAGGTAGCACAGATACGCAGTATTTT	CASRLGSTDTQYF	TRBV28	TRBJ2-3
TGCGCCAGCAGAGCGGGATATAGCAATCAGCCCCAGCATTTT	CASRAGYSNQPQHF	TRBV10-1	TRBJ1-5
TGTGCTAGTGGTTTGCGCAATGGACAGGTGAACACTGAAGCTTTCTTT	CASGLRNGQVNTEAFF	TRBV12-5	TRBJ1-1
TGTGCCAGCAGTAAGACGGACTGGGGGGAAAATGGGGAGCTGTTTTTT	CASSKTDWGENGELFF	TRBV6-5	TRBJ2-2
TGTGCCAGCAGCCCAGGACAGCCCCAGCATTTT	CASSPGQPQHF	TRBV13	TRBJ1-5
TGTGCCAGCAGCTTAGCACCTCCTCCCGGGACAGGGAGCGGAGACACTGAAGCTTTCTTT	CASSLAPPPGTGSGDTEAFF	TRBV11-3	TRBJ1-1
TGTGCCAGCACCGACAGGAACCGGCCCACTGAAGCTTTCTTT	CASTDRNRPTEAFF	TRBV6-5	TRBJ1-1
TGTGCCAGTAGTATAGACCCTCGTGATCCGGGGGACAATGAGCAGTTCTTC	CASSIDPRDPGDNEQFF	TRBV19	TRBJ2-1
TGTGCCAGCAGCGTAGATCCCGTCAAGTGGGGGGCCTACAATGAGCAGTTCTTC	CASSVDPVKWGAYNEQFF	TRBV9	TRBJ2-1
TGCGCCAGCAGCCCCCCGGCGAGTCCAGGCGCCTACACAGATACGCAGTATTTT	CASSPPASPGAYTDTQYF	TRBV4-1	TRBJ2-3
TGTGGGAGGGGTCATAGCAATCAGCCCCAGCATTTT	CGRGHSNQPQHF	TRBV12-3	TRBJ1-5
TGTGCCAGCATCGGACAGCGGCCCGAGCAGTACTTC	CASIGQRPEQYF	TRBV6-5	TRBJ2-7
TGTGCCAGCAGCAGGGACAAGGGCAATGAGCAGTTCTTC	CASSRDKGNEQFF	TRBV7-2	TRBJ2-1
TGCAGTGCTTCCGAGGGTGGGAACTACTATGGCTACACCTTC	CSASEGGNYYGYTF	TRBV20-1	TRBJ1-2
TGTGGTCCGTCCAACAGGGATTGGGGATACGAGCAGTACTTC	CGPSNRDWGYEQYF	TRBV24-1	TRBJ2-7
TGTGCCAGCAGCTTGGTGGAAGGGACGACAGCCATTGAAAAACTGTTTTTT	CASSLVEGTTAIEKLFF	TRBV5-4	TRBJ1-4
TGTGCCTGGAGTGAACCGGGTGGGACAGGGAATGAAAAACTGTTTTTT	CAWSEPGGTGNEKLFF	TRBV30	TRBJ1-4
TGCGCCCCCCGCGGGGACTTCCACACCGGGGAGCTGTTTTTT	CAPRGDFHTGELFF	TRBV10-2	TRBJ2-2
TGTGCCAGCAGTTTCAGGGGCTCTGGGGCCAACGTCCTGACTTTC	CASSFRGSGANVLTF	TRBV2	TRBJ2-6
TGTGCCAGGATCCAGGACTCCTACGAGCAGTACTTC	CARIQDSYEQYF	TRBV13	TRBJ2-7
TGTGCCAGCAGGGCGGCCAATGAAAAACTGTTTTTT	CASRAANEKLFF	TRBV12-4	TRBJ1-4
TGTGCCAGCAGCCCCTTTAAGGGGGGACCGAGCAATCAGCCCCAGCATTTT	CASSPFKGGPSNQPQHF	TRBV5-4	TRBJ1-5
TGCGCCAGCAGCCATGGGTGCACTACGGACAGCGACGAGCAGTACTTC	CASSHGCTTDSDEQYF	TRBV5-1	TRBJ2-7
TGCGCCAGCAGCTCAGTCCGACAGGGGACCCCCGTCGGTGGGAACACTGAAGCTTTCTTT	CASSSVRQGTPVGGNTEAFF	TRBV5-1	TRBJ1-1
TGCAGTGCTAGGGGAGGGTCGTCCTACAATGAGCAGTTCTTC	CSARGGSSYNEQFF	TRBV20-1	TRBJ2-1
TGTGCCATCATTGACAGGGGGCGCGGGCATGAGCAGTTCTTC	CAIIDRGRGHEQFF	TRBV10-3	TRBJ2-1
TGTGCCAGCAGTGACTGCCGGGTTCTTATCTATGGCTACACCTTC	CASSDCRVLIYGYTF	TRBV6-4	TRBJ1-2
TGTGCCTGGCTAGCGGGCCCCCACGAGCAGTACTTC	CAWLAGPHEQYF	TRBV30	TRBJ2-7
TGTGCCAGCAGGGTTAGGACAGGGGACTATAATTCACCCCTCCACTTT	CASRVRTGDYNSPLHF	TRBV28	TRBJ1-6
TGTGCCATCAGTGAGTCTTACCGGGACAAAGAATCCTACGAGCAGTACTTC	CAISESYRDKESYEQYF	TRBV10-3	TRBJ2-7
TGTGCCAGCAGCGTCCCCGGGACAGGGAACACTGAAGCTTTCTTT	CASSVPGTGNTEAFF	TRBV14	TRBJ1-1
TGCGCCAGCAGGTGGGGGTACGGGGAAGGTCCAGGATACGAGCAGTACTTC	CASRWGYGEGPGYEQYF	TRBV10-1	TRBJ2-7
TGTGCCAGCAATCAGATATTAACTAGCGGGAGGGCCCGATGCCTGGTCTCTGGGGCCAACGTCCTGACTTTC	CASNQILTSGRARCLVSGANVLTF	TRBV7-3	TRBJ2-6
TGTGCCAGCAGCTTTGGGGGCGACTGTAAAAACATTCAGTACTTC	CASSFGGDCKNIQYF	TRBV7-7	TRBJ2-4
TGTGCCAGCAGCGTAGACGGGGGTTCTGGGACTAGCGTCCGCGGTGGGTCCGGAGAGACCCAGTACTTC	CASSVDGGSGTSVRGGSGETQYF	TRBV9	TRBJ2-5
TGTGCCAGCAGCTTATTCCCGGGACAGGGGCCCCCCTCTAATGAAAAACTGTTTTTT	CASSLFPGQGPPSNEKLFF	TRBV7-9	TRBJ1-4
TGTGCCAGCAGGTGGACTAGCGGGAGTGGCGATAACATTCAGTACTTC	CASRWTSGSGDNIQYF	TRBV28	TRBJ2-4
TGTGCCAGCAGCGCCGGGACAGGGCGAGATGGCTACACCTTC	CASSAGTGRDGYTF	TRBV13	TRBJ1-2
TGTGCCAGCCCTCGGGCCCAGCCCCAGCATTTT	CASPRAQPQHF	TRBV11-3	TRBJ1-5
TGTGCCAGTAGTCTAACGAAGGGAACAGATACGCAGTATTTT	CASSLTKGTDTQYF	TRBV19	TRBJ2-3
TGCAGTGCTAGGAGGACAGGGGGCTTTCAGCCCCAGCATTTT	CSARRTGGFQPQHF	TRBV20-1	TRBJ1-5
TGTGCCAGCAGTTACTGGCTGGTGAACACTGAAGCTTTCTTT	CASSYWLVNTEAFF	TRBV6-5	TRBJ1-1
TGTGCCACCAACCTGACAGGATTCTACGAGCAGTACTTC	CATNLTGFYEQYF	TRBV24-1	TRBJ2-7
TGTGCCAGTGCCCTAGGACTAGCGGGAAGAGGGACTTCGGTGTACGAGCAGTACTTC	CASALGLAGRGTSVYEQYF	TRBV19	TRBJ2-7
TGTGCCAGCAGTTACTCGAATCCCTCGGAGTCCCGTGGCGACACCGGGGAGCTGTTTTTT	CASSYSNPSESRGDTGELFF	TRBV6-5	TRBJ2-2
TGTGCCAGCAGCCGTAAGCGACAGAGGGAAAAACTGTTTTTT	CASSRKRQREKLFF	TRBV3-1	TRBJ1-4
TGTGCCAGCAGCCGACAGTTGGGGCACCGGCAGCCCCAGCATTTT	CASSRQLGHRQPQHF	TRBV7-3	TRBJ1-5
TGTGCCAGCAGCTTCCGTGACAGGTTGGGACCTGGCTACACCTTC	CASSFRDRLGPGYTF	TRBV5-5	TRBJ1-2
TGTGCCAGCAGCCGCGCTGGGGTCCGTTCAGAGACCCAGTACTTC	CASSRAGVRSETQYF	TRBV13	TRBJ2-5
TGTGCCAGCAGTTTACCGACAGGGGGCTACGAGCAGTACTTC	CASSLPTGGYEQYF	TRBV27	TRBJ2-7
TGTGCCAGCAGCCAAGGCAGGCGGTCAGACTTCTATGGCTACACCTTC	CASSQGRRSDFYGYTF	TRBV3-1	TRBJ1-2
TGTGCCAGCAGCAATAAGGACTATTCTGGGACGACAGATACGCAGTATTTT	CASSNKDYSGTTDTQYF	TRBV13	TRBJ2-3
TGTGCCAGCAGCCCGGGACAGGGGCACACAGATACGCAGTATTTT	CASSPGQGHTDTQYF	TRBV13	TRBJ2-3
TGTGCCAGCAGTGACACTCCCGGGACAGGGGGCTATGGCTACACCTTC	CASSDTPGTGGYGYTF	TRBV6-4	TRBJ1-2
TGCGCCAGCAGCCAAGCAGATACCGATGGTAGGGCGGGGGTATACGAGCAGTACTTC	CASSQADTDGRAGVYEQYF	TRBV4-1	TRBJ2-7
TGCAGTGCTAGCGCCTCCTCGGGGACTAGGGTCTACGGCTACGAGCAGTACTTC	CSASASSGTRVYGYEQYF	TRBV20-1	TRBJ2-7
TGCAGTGCTAGATGCTCTGACGCAGGATATGGCTACACCTTC	CSARCSDAGYGYTF	TRBV20-1	TRBJ1-2
TGTGCCATGGACGAGGAGGGGGAGCAGTACTTC	CAMDEEGEQYF	TRBV24-1	TRBJ2-7
TGTGCCAGCAGTGAGGTTGGGGCAGCCACTGAAGCTTTCTTT	CASSEVGAATEAFF	TRBV2	TRBJ1-1
TGTGCCAGCAGCCGAAGCAGGGTCTTAACCTATAGCAATCAGCCCCAGCATTTT	CASSRSRVLTYSNQPQHF	TRBV11-2	TRBJ1-5
TGTGCCAGCAGCCTACAACGAAAATATTTTAACACTGAAGCTTTCTTT	CASSLQRKYFNTEAFF	TRBV3-1	TRBJ1-1
TGCGCCAGCAGCCGTACTACCTACGAGCAGTACTTC	CASSRTTYEQYF	TRBV4-1	TRBJ2-7
TGTGCCAGCAGCTTGGATACAGGGGGTAGATTCTTT	CASSLDTGGRFF	TRBV5-4	TRBJ1-1
TGTGCCAGCAGCTCCTGGGTTACGACCTCAGGGGCCGGCTACACCTTC	CASSSWVTTSGAGYTF	TRBV7-9	TRBJ1-2
TGTGCCAGCAGCTGGCCACGAGGCTCCTACGAGCAGTACTTC	CASSWPRGSYEQYF	TRBV5-6	TRBJ2-7
TGTGCCAGCAGTGCCCACAGGGGGCACCGTGGTGGCCAAGGCTACGAGCAGTACTTC	CASSAHRGHRGGQGYEQYF	TRBV6-1	TRBJ2-7
TGTGCCAGCAGCATTGTAAGAGGACAGCTCCCCAATCAGCCCCAGCATTTT	CASSIVRGQLPNQPQHF	TRBV7-9	TRBJ1-5
TGTGCCAGCAGCCAACGCCCCTCTGGAAACACCATATATTTT	CASSQRPSGNTIYF	TRBV7-4	TRBJ1-3
TGTGCCAGCAGCGGGACAGGGAAGGGGAACACTGAAGCTTTCTTT	CASSGTGKGNTEAFF	TRBV25-1	TRBJ1-1
TGTGCCAGCATCCCTTCTAACTACGAGCAGTACTTC	CASIPSNYEQYF	TRBV27	TRBJ2-7
TGTGCCAGCAGCGTAGCGGGCCCACCTTCACCCCTCCACTTT	CASSVAGPPSPLHF	TRBV9	TRBJ1-6
TGCAGTGCTAGTCTTAAGGGACAGGACTGCTATAATTCACCCCTCCACTTT	CSASLKGQDCYNSPLHF	TRBV20-1	TRBJ1-6
TGTGCCAGCAGCCGGACCTACGAGCAGTACTTC	CASSRTYEQYF	TRBV27	TRBJ2-7
TGTGCCAGCAGCCCTAAAGTCGCCAGGGGGGGGGACAGCTCCTATAATTCACCCCTCCACTTT	CASSPKVARGGDSSYNSPLHF	TRBV7-6	TRBJ1-6
TGTGCCAGCAGTGACGAAAGCCGAGATCAGCCCCAGCATTTT	CASSDESRDQPQHF	TRBV6-1	TRBJ1-5
TGCGCCAGCACCCGGGGACAGGGGGAGCTGTTTTTT	CASTRGQGELFF	TRBV10-1	TRBJ2-2
TGTGCCAGCAGCTCTGGTACGGGACAGCGAGAAACCGGGGAGCTGTTTTTT	CASSSGTGQRETGELFF	TRBV7-3	TRBJ2-2
TGTGCCAGCAGCAGGTCCACGACTAGCGGGTGGTCGAGCTCCTACAATGAGCAGTTCTTC	CASSRSTTSGWSSSYNEQFF	TRBV7-7	TRBJ2-1
TGTGCCAGCGAGATCCCTGCCGGGACAGATGGCTACACCTTC	CASEIPAGTDGYTF	TRBV9	TRBJ1-2
TGTGCCAGCAAAACAGGGGGATACGAGCAGTACTTC	CASKTGGYEQYF	TRBV11-3	TRBJ2-7
TGCGCCAGCGAGGGGGGGCCCTCCTACAATGAGCAGTTCTTC	CASEGGPSYNEQFF	TRBV10-1	TRBJ2-1
TGTGCCAGCAGTGACAACAAGACCTTTAATGAAAAACTGTTTTTT	CASSDNKTFNEKLFF	TRBV6-4	TRBJ1-4
TGTGCCAGCAGCTTCCAGGCCGGGGGGATAGACTACGAGCAGTACTTC	CASSFQAGGIDYEQYF	TRBV7-9	TRBJ2-7
TGTGCCAGCAGCGGGGACTCGGGCAGGGACCCAAATGAAAAACTGTTTTTT	CASSGDSGRDPNEKLFF	TRBV7-3	TRBJ1-4
TGCAGTGCTAGTAGTGCTGAAGCTTTCTTT	CSASSAEAFF	TRBV20-1	TRBJ1-1
TGTGCCAGCCTCAGGAACACTGAAGCTTTCTTT	CASLRNTEAFF	TRBV3-1	TRBJ1-1
TGTGCCAGCAGCTTAGCTGCAGACAGGGGACCTCCCTATGGCTACACCTTC	CASSLAADRGPPYGYTF	TRBV7-9	TRBJ1-2
TGCGCCAGCAGCTTGTTGCTTATCGAGCAGTACTTC	CASSLLLIEQYF	TRBV5-1	TRBJ2-7
TGTGCCAGCAGCCAAGTATGGACAGGCCATGGCTACACCTTC	CASSQVWTGHGYTF	TRBV3-1	TRBJ1-2
TGCGCCAGCAGCTTGAGAAATAAAGACAGGGAGGGGGGAGGTGGCGGCTACACCTTC	CASSLRNKDREGGGGGYTF	TRBV5-1	TRBJ1-2
TGTGCCAGCAGCGTAATAACCTACGAGCAGTACTTC	CASSVITYEQYF	TRBV11-3	TRBJ2-7
TGCAGCGGAAAGAACCGGGAAACTAATGAAAAACTGTTTTTT	CSGKNRETNEKLFF	TRBV29-1	TRBJ1-4
TGTGCCAGCAGCGAATCCCGGCCTGTGGATGAGCAGTTCTTC	CASSESRPVDEQFF	TRBV7-3	TRBJ2-1
TGTGCCACCAGTGACCTTCCGGTCGTTTGGACGTCAGATACGCAGTATTTT	CATSDLPVVWTSDTQYF	TRBV24-1	TRBJ2-3
TGTGCCAGCAGCCAAGATCTGGGCAGAGAGACCCAGTACTTC	CASSQDLGRETQYF	TRBV14	TRBJ2-5
TGTGCCATCAGTGCAACGAGGGAGAAAACGACGAATGAGACCCAGTACTTC	CAISATREKTTNETQYF	TRBV10-3	TRBJ2-5
TGTGCCAGCAGCCAAGCCGTGAAACATTGGGAGACCCAGTACTTC	CASSQAVKHWETQYF	TRBV3-1	TRBJ2-5
TGTGCCAGCCTTCCTAGCGGGGGCCTTACGGGGCTAGCCAAAAACATTCAGTACTTC	CASLPSGGLTGLAKNIQYF	TRBV27	TRBJ2-4
TGCGCCAGCAGTGGATCACCCCCGGGACCTTTAGACAATGAGCAGTTCTTC	CASSGSPPGPLDNEQFF	TRBV10-1	TRBJ2-1
TGTGCCAGCAGCTTAACGCGGGACGCCTACAATGAGCAGTTCTTC	CASSLTRDAYNEQFF	TRBV7-3	TRBJ2-1
TGTGCCAGCAGAGGACAGGGGACCCATTTTTCGTTAGCCAAAAACATTCAGTACTTC	CASRGQGTHFSLAKNIQYF	TRBV6-1	TRBJ2-4
TGTGCCAGCAGGAAAAGGACAGTGAACTCCTACGAGCAGTACTTC	CASRKRTVNSYEQYF	TRBV7-9	TRBJ2-7
TGTGCCAGCAGTCACTTTGGATATGGCTACACCTTC	CASSHFGYGYTF	TRBV27	TRBJ1-2
TGTGCCAGCAGCTTAGGGCTACAGGGGTTTGCAGATACGCAGTATTTT	CASSLGLQGFADTQYF	TRBV11-2	TRBJ2-3
TGCGCCAGCAGCGTATGGTCGGTACCCCCACTAGCGGGAGCTGTCTATAGCAATCAGCCCCAGCATTTT	CASSVWSVPPLAGAVYSNQPQHF	TRBV5-1	TRBJ1-5
TGTGCCAGCAGCTTAGCCGAACCCGGGGAAATATCACCCCTCCACTTT	CASSLAEPGEISPLHF	TRBV11-2	TRBJ1-6
TGTGCCAGCAGCCCCGGCCGACCGGGACAGGGCTACGAGCAGTACTTC	CASSPGRPGQGYEQYF	TRBV11-3	TRBJ2-7
TGTGCCGGGTCCATCTCGTCTCCTTGGCCAGATACGCAGTATTTT	CAGSISSPWPDTQYF	TRBV30	TRBJ2-3
TGTGCCAGGAACCGGGACAGGGGGTTACCCTGCTATGGCTACACCTTC	CARNRDRGLPCYGYTF	TRBV7-9	TRBJ1-2
TGTGCCAGCAGGAAACAGGGGGCCGGGATCCGTCAGCCCCAGCATTTT	CASRKQGAGIRQPQHF	TRBV12-3	TRBJ1-5
TGTGCCAGCTTCGGCGTAGAGACCCAGTACTTC	CASFGVETQYF	TRBV27	TRBJ2-5
TGTGCCAGCAGTTACCCTGGAGGACTTTGCCGTAATGAAAAACTGTTTTTT	CASSYPGGLCRNEKLFF	TRBV6-5	TRBJ1-4
TGTGCCAGCAGTCTGCGGGAGAAGCATGAAGGTAGTCTCGAAAAAGAGACCCAGTACTTC	CASSLREKHEGSLEKETQYF	TRBV27	TRBJ2-5
TGTGCCAGCAGCTACGAAGAAGACAGGGACCTCTACGAGCAGTACTTC	CASSYEEDRDLYEQYF	TRBV7-4	TRBJ2-7
TGCAGTGCTACCTCGGGGGGTTCCTACTACGAGCAGTACTTC	CSATSGGSYYEQYF	TRBV20-1	TRBJ2-7
TGTGCCAGCAGCTCCCCGGGACAGGACGAGCAGTACTTC	CASSSPGQDEQYF	TRBV13	TRBJ2-7
TGTGCCAGCAGGGAGGTGGGCCCGGATCGAGCCTACGAGCAGTACTTC	CASREVGPDRAYEQYF	TRBV7-3	TRBJ2-7
TGTGCCAGCAGTTACTCGAGTTGTGGAGGGCTGGCCGGGGAGCTGTTTTTT	CASSYSSCGGLAGELFF	TRBV6-5	TRBJ2-2
TGTGCCAGCAGCTATAAACCAGGACAGGGGGATAACTATGGCTACACCTTC	CASSYKPGQGDNYGYTF	TRBV7-8	TRBJ1-2
TGTGCCAGCCACGGTGACAGGGGGCCCCCTAACGCGAACACCGGGGAGCTGTTTTTT	CASHGDRGPPNANTGELFF	TRBV7-3	TRBJ2-2
TGTGCCTCCGGCAGGGATTCACCCCTCCACTTT	CASGRDSPLHF	TRBV6-5	TRBJ1-6
TGTGCCACCAGTGTCCCCGGGACGGGATCCACCGACGAGCAGTACTTC	CATSVPGTGSTDEQYF	TRBV24-1	TRBJ2-7
TGTGCCAGCACCCCGGATATAGGGGACCTGAGGGCAAATGAGCAGTTCTTC	CASTPDIGDLRANEQFF	TRBV7-9	TRBJ2-1
TGTGCCAAAAGGACTAGCGGGGGGGCCTTTGAGAGAAACGAGCAGTACTTC	CAKRTSGGAFERNEQYF	TRBV6-5	TRBJ2-7
TGTGCCAGCAGAAAATCCTTGGGGGCTCCAGATACGCAGTATTTT	CASRKSLGAPDTQYF	TRBV28	TRBJ2-3
TGTGCCAGCAGTTTAAGTAGCTCCTACAATGAGCAGTTCTTC	CASSLSSSYNEQFF	TRBV12-3	TRBJ2-1
TGCGCCAGCCCGGGGGGCAGCCAAGCTTTCTTT	CASPGGSQAFF	TRBV10-1	TRBJ1-1
TGTGCCAGCAGCCAAGAGCTCTACGGAGAACCCTACGAGCAGTACTTC	CASSQELYGEPYEQYF	TRBV3-1	TRBJ2-7
TGTGCCAGCAGCCGTATTGGGAATACTAATAATGAGCAGTTCTTC	CASSRIGNTNNEQFF	TRBV7-2	TRBJ2-1
TGTGCTAGTGGTTTGTTGGTGACAGGGGCAAATGAGCAGTTCTTC	CASGLLVTGANEQFF	TRBV12-5	TRBJ2-1
TGTGCCAGCAGCTTTCAACCCAGGGGCCATAGTAATGAGCAGTTCTTC	CASSFQPRGHSNEQFF	TRBV11-3	TRBJ2-1
TGTGCCAGCAGCTCAGCGGGAGGGGCAGAGTACAATGAGCAGTTCTTC	CASSSAGGAEYNEQFF	TRBV5-4	TRBJ2-1
TGCAGTGCTTACGGGTTGTTGGACGGGATAGGGGGGAATGAAAAACTGTTTTTT	CSAYGLLDGIGGNEKLFF	TRBV20-1	TRBJ1-4
TGCAGTGCTAGATACCGGGACAGGGGTCCGCCCGGGGAGCTGTTTTTT	CSARYRDRGPPGELFF	TRBV20-1	TRBJ2-2
TGTGCCATCAGTGAGTCGCTGGAGTGGGACACCATATATTTT	CAISESLEWDTIYF	TRBV10-3	TRBJ1-3
TGTGCCAGCAGTTACGCAATGCCCGTACGCTACCTGGAGTGCTATGGCTACACCTTC	CASSYAMPVRYLECYGYTF	TRBV6-3	TRBJ1-2
TGTGCCAGCCCCATGCTAGCGAGCACAGATACGCAGTATTTT	CASPMLASTDTQYF	TRBV6-1	TRBJ2-3
TGTGCCAACCCCCCATCGGGACAGGGTAGCTACGAGCAGTACTTC	CANPPSGQGSYEQYF	TRBV6-1	TRBJ2-7
TGTGCTCAGCCCTATGGCTACACCTTC	CAQPYGYTF	TRBV28	TRBJ1-2
TGTGCCAGCAGCGGAGAAAGGTATGAAAAACTGTTTTTT	CASSGERYEKLFF	TRBV7-3	TRBJ1-4
TGTGCCAGCAGGAAGGGGGCGCCCGGAGAGACCCAGTACTTC	CASRKGAPGETQYF	TRBV5-4	TRBJ2-5
TGCGCCAGCAGCTTGGGTAGCCTGTCGGGGGGGACTAGCGGGGATGATACGCAGTATTTT	CASSLGSLSGGTSGDDTQYF	TRBV5-1	TRBJ2-3
TGTGCCAGCAACCTGTCAGGGGCCAACAGGGGTAGCAGGACTGAAGCTTTCTTT	CASNLSGANRGSRTEAFF	TRBV27	TRBJ1-1
TGTGCCAGCAGCGGACAAGGTATGAACACTGAAGCTTTCTTT	CASSGQGMNTEAFF	TRBV7-4	TRBJ1-1
TGTGCCAGCAGCTTACGTCGGGGGCCCACAGATACGCAGTATTTT	CASSLRRGPTDTQYF	TRBV11-1	TRBJ2-3
TGTGCCAGCAGTTTTGGCACCCACACTGAAGCTTTCTTT	CASSFGTHTEAFF	TRBV27	TRBJ1-1
TGCGCCAGCAGCTTGGGGACCGGGATCTGCTACGAGCAGTACTTC	CASSLGTGICYEQYF	TRBV5-1	TRBJ2-7
TGTGCCAGCGAAGTTACTAGCGTGGGCACAGATACGCAGTATTTT	CASEVTSVGTDTQYF	TRBV6-6	TRBJ2-3
TGTGCCAGCAGCTTAGATCCCAAGGTTCACCTTGGATACGAGCAGTACTTC	CASSLDPKVHLGYEQYF	TRBV11-3	TRBJ2-7
TGTGCCTCCAGGGGGGGCGCGTATGAGCAGTTCTTC	CASRGGAYEQFF	TRBV30	TRBJ2-1
TGCGCCAGCAGCTGCAGGGGGACTAGCAATCAGCCCCAGCATTTT	CASSCRGTSNQPQHF	TRBV5-1	TRBJ1-5
TGTGCCAGCAGCTACAACAGGGTTTTCTCCTCCCTCGAAAAACTGTTTTTT	CASSYNRVFSSLEKLFF	TRBV5-6	TRBJ1-4
TGCGCCAGCAGCCGCCGGGGGCAGGAAGCTTTCTTT	CASSRRGQEAFF	TRBV4-3	TRBJ1-1
TGTGCCAGCCCGGGACAGGAGCGGTTGAACACTGAAGCTTTCTTT	CASPGQERLNTEAFF	TRBV28	TRBJ1-1
TGTGCCAGCAGCGCCCCCCCTTCACAGACAGATGAAGAGACCCAGTACTTC	CASSAPPSQTDEETQYF	TRBV11-2	TRBJ2-5
TGTGCCAGCAGTACCCAGGCGCCGGGACGTAGAGTGCAGTACTTC	CASSTQAPGRRVQYF	TRBV27	TRBJ2-7
TGTGCCAGCAGTTTTATAGGGACTCCGGCCTACAATGAGCAGTTCTTC	CASSFIGTPAYNEQFF	TRBV12-3	TRBJ2-1
TGTGCCAGTACCGGGGGGTGCACTGAAGCTTTCTTT	CASTGGCTEAFF	TRBV19	TRBJ1-1
TGTGCCAGCAGCCCCGAAGGGAGGTCTTCACCCCTCCACTTT	CASSPEGRSSPLHF	TRBV11-2	TRBJ1-6
TGCGCCAGCAGCGTCGGGACTATGGATTCACCCCTCCACTTT	CASSVGTMDSPLHF	TRBV5-1	TRBJ1-6
TGCGCCAGCAGTGATGGGGGGGCGGGAAACACCATATATTTT	CASSDGGAGNTIYF	TRBV10-1	TRBJ1-3
TGTGCCAGCAGCTTAGATTTTAATCCGCCGCCACAGGGTGAAGCTTTCTTT	CASSLDFNPPPQGEAFF	TRBV11-3	TRBJ1-1
TGCAGTGCTAGACCGAGACAGGGGGCCCTCGAGACCCAGTACTTC	CSARPRQGALETQYF	TRBV20-1	TRBJ2-5
TGTGCCAGCACCTTAGCAGAAAAACTGTTTTTT	CASTLAEKLFF	TRBV6-4	TRBJ1-4
TGTGCCAGCAGCCGGCGAATCCAGGGGGCCCGCTATGGCTACACCTTC	CASSRRIQGARYGYTF	TRBV9	TRBJ1-2
TGTGCCAGCAGCGTCCCCCGGAAGCCTGCCTCCCCGAACGGCACAGATACGCAGTATTTT	CASSVPRKPASPNGTDTQYF	TRBV9	TRBJ2-3
TGCAGTGCGCGGGGAGTACCGGGACAGGAACTCGAGCAGTACTTC	CSARGVPGQELEQYF	TRBV20-1	TRBJ2-7
TGTGCCAGCAGCACCCTAGATCCCGGGGAGCTGTTTTTT	CASSTLDPGELFF	TRBV7-3	TRBJ2-2
TGCGCCAGCAGCCAAGAGGAGCGGGGACGACAGGTCGGCCTAGCCAAAAACATTCAGTACTTC	CASSQEERGRQVGLAKNIQYF	TRBV4-1	TRBJ2-4
TGTGCCAGCAGTTTCTTCGTTAAATCCCGAAGGGCAGATACGCAGTATTTT	CASSFFVKSRRADTQYF	TRBV28	TRBJ2-3
TGTGCCAGCAGCCACGCGGGAGGATACTCTGGAAACACCATATATTTT	CASSHAGGYSGNTIYF	TRBV14	TRBJ1-3
TGTGCCAGCACCCAGGGGGCAAATAATTCACCCCTCCACTTT	CASTQGANNSPLHF	TRBV13	TRBJ1-6
TGCGCCAGCAGCTGGGTTTCTAATTCACCCCTCCACTTT	CASSWVSNSPLHF	TRBV5-1	TRBJ1-6
TGCGCCAGCAGCCAAGAGGGCTATGGCTACACCTTC	CASSQEGYGYTF	TRBV4-3	TRBJ1-2
TGTGCCAGCAGTGGCCCAGGGGACGGGGAGCTGTTTTTT	CASSGPGDGELFF	TRBV2	TRBJ2-2
TGTGCCAGCAGTTTATTATTATGCGATTCCTACAATGAGCAGTTCTTC	CASSLLLCDSYNEQFF	TRBV27	TRBJ2-1
TGCGCCAGCAGTGACGTTCCAGGGAAAACGGAAGGGGAGCTGTTTTTT	CASSDVPGKTEGELFF	TRBV10-1	TRBJ2-2
TGTGCCAGCAGCCCAAACCGGGACAGGGGGGCCTACGAGCAGTACTTC	CASSPNRDRGAYEQYF	TRBV7-2	TRBJ2-7
TGTGCCAGCAAACCTGACCGGGGGGCCGTTGAAGCTTTCTTT	CASKPDRGAVEAFF	TRBV27	TRBJ1-1
TGTGCCAGCAGACCGTCGCTGACAGTTCGTGAAAAACTGTTTTTT	CASRPSLTVREKLFF	TRBV27	TRBJ1-4
TGTGCCAGCAGCAATACGGGGTCCAAGGGCGAGCAGTACTTC	CASSNTGSKGEQYF	TRBV7-9	TRBJ2-7
TGCAGTGCCGGGACAGGGTATCTGAAGCGGGAAGATACGCAGTATTTT	CSAGTGYLKREDTQYF	TRBV20-1	TRBJ2-3
TGTGCCAGTAGAATAAGGGGGGGCGAATTGATACGAACCTCCTACGAGCAGTACTTC	CASRIRGGELIRTSYEQYF	TRBV19	TRBJ2-7
TGTGCTAGTGGTTTGGTACGGGACAGGGGCACAGATACGCAGTATTTT	CASGLVRDRGTDTQYF	TRBV12-5	TRBJ2-3
TGTGCCACCAGTGTAGGACAGGGTCTCTATGGCTACACCTTC	CATSVGQGLYGYTF	TRBV24-1	TRBJ1-2
TGTGCCAGCAGTTACGTAAGAATCGGACAGGGGTCCAATGAGCAGTTCTTC	CASSYVRIGQGSNEQFF	TRBV6-2	TRBJ2-1
TGTGCCTGGAGTGTACCTTCCCTCGAAGAGAGGGGTTGCCAGCCCCAGCATTTT	CAWSVPSLEERGCQPQHF	TRBV30	TRBJ1-5
TGTGCCTGGAGTAAGACCTTTTACGAGCAGTACTTC	CAWSKTFYEQYF	TRBV30	TRBJ2-7
TGTGCCAGCAGTATGTTAAAACTAGCGGGGCGGTATTTT	CASSMLKLAGRYF	TRBV25-1	TRBJ2-3
TGTGCCAGCAGCGGGGACCCGGGACATGGGGCCAACGTCCTGACTTTC	CASSGDPGHGANVLTF	TRBV13	TRBJ2-6
TGTGCCAGCAGCGGACAGGGGGCCTTTCGGAGAGGGGTATATTTT	CASSGQGAFRRGVYF	TRBV13	TRBJ1-3
TGTGCCAGCAGCTTAGAAGGGGGAAACTCTGAAGCTTTCTTT	CASSLEGGNSEAFF	TRBV11-3	TRBJ1-1
TGTGCCACCAGTGATTTGGGGAAACTCCGACTCTCTCTAGGATATAATTCACCCCTCCACTTT	CATSDLGKLRLSLGYNSPLHF	TRBV24-1	TRBJ1-6
TGTGCCAGCAGTAACCCTGGGACACAGGGGGCGAGACCCTACGAGCAGTACTTC	CASSNPGTQGARPYEQYF	TRBV12-4	TRBJ2-7
TGTGCCAGCAGCTTCGCGATTCCTGAGGGCGGGGGTAATGAAAAACTGTTTTTT	CASSFAIPEGGGNEKLFF	TRBV5-4	TRBJ1-4
TGCAGTGCTCTTGGGGGGGGAAGCACAGATACGCAGTATTTT	CSALGGGSTDTQYF	TRBV20-1	TRBJ2-3
TGTGCCACCTTGGAAGCGGAGGAAGCACACTATGGCTACACCTTC	CATLEAEEAHYGYTF	TRBV24-1	TRBJ1-2
TGTGCCAGCAGCGGGGGGGGAAAAAACACCGGGGAGCTGTTTTTT	CASSGGGKNTGELFF	TRBV5-4	TRBJ2-2
TGTGCCAGCAGTGACTGCGATCAGTGGGGGGAAGAAGGCACCGGGGAGCTGTTTTTT	CASSDCDQWGEEGTGELFF	TRBV6-4	TRBJ2-2
TGTGCCAGCATACAAAAGGGACAGAACTATGGCTACACCTTC	CASIQKGQNYGYTF	TRBV28	TRBJ1-2
TGTGCCAGCAGCCAGTTGGGGGGCGCCGGCTATGGCTACACCTTC	CASSQLGGAGYGYTF	TRBV3-1	TRBJ1-2
TGTGCCTGGCCACTGCCAGCCGGGCGAGGCACTAATGAAAAACTGTTTTTT	CAWPLPAGRGTNEKLFF	TRBV30	TRBJ1-4
TGTGCCAGCAGTCTGACAGTCGTTTACAATCAGCCCCAGCATTTT	CASSLTVVYNQPQHF	TRBV7-9	TRBJ1-5
TGTGCCAGCAGTGTAAAGCGGGGGGGGCCCCAGCATTTT	CASSVKRGGPQHF	TRBV27	TRBJ1-5
TGTGCCAGCAGTTTCCGGGGACAGGGGGCCTTTGCAGATACGCAGTATTTT	CASSFRGQGAFADTQYF	TRBV28	TRBJ2-3
TGTGCCAGAACAGGGGGCGATAAGGGGCCCCACTATGGCTACACCTTC	CARTGGDKGPHYGYTF	TRBV6-1	TRBJ1-2
TGTGCCAGCAGCGCGACAGGCGGGAACTATGGCTACACCTTC	CASSATGGNYGYTF	TRBV11-3	TRBJ1-2
TGTGCCAGCAGTTGTCGGGCCGGGGGGTTAGAAGAGACCCAGTACTTC	CASSCRAGGLEETQYF	TRBV28	TRBJ2-5
TGTGCCAGCAGTATGTTCGGGGTGGGTCAGCCCCAGCATTTT	CASSMFGVGQPQHF	TRBV6-1	TRBJ1-5
TGTGCCAGCAGCTACGTGGATATCCCCCTCCACTTT	CASSYVDIPLHF	TRBV9	TRBJ1-6
TGCAGTGCTAGCTCGGGGACAGAGGCTGGAAACACCATATATTTT	CSASSGTEAGNTIYF	TRBV20-1	TRBJ1-3
TGTGCCAGCAGCTTAGATATTATGGCGGCAAAGTATGATAAGGACTCCTACGAGCAGTACTTC	CASSLDIMAAKYDKDSYEQYF	TRBV11-2	TRBJ2-7
TGTGCCAGCAGCGCCTTAGCGGGAGGAGGCTACGAGCAGTACTTC	CASSALAGGGYEQYF	TRBV13	TRBJ2-7
TGTGCCAGCAGCTTAGACCTCCCCAGGAGGGGGAGGCAAGAGACCCAGTACTTC	CASSLDLPRRGRQETQYF	TRBV7-9	TRBJ2-5
TGTGCCAGCAGCCCCTGTCGACTAGCATACAATGAGCAGTTCTTC	CASSPCRLAYNEQFF	TRBV14	TRBJ2-1
TGTGCTAGTGGTTTTCCCGGGGCGAGTTACGAGCAGTACTTC	CASGFPGASYEQYF	TRBV12-5	TRBJ2-7
TGTGCCAGCAACGTCAGGGCCCAAACTAATGAGCAGTTCTTC	CASNVRAQTNEQFF	TRBV27	TRBJ2-1
TGTGCCAGCAGTTTATCGGATTCACAGGGGAAAGGACGGAACACTGAAGCTTTCTTT	CASSLSDSQGKGRNTEAFF	TRBV27	TRBJ1-1
TGTGCCAGCAGCCAAGCTTCGGTACGCCGCACAGATACGCAGTATTTT	CASSQASVRRTDTQYF	TRBV14	TRBJ2-3
TGTGCCAGCAGCTTGGCATTGGGGCGTCGAGAGACCCAGTACTTC	CASSLALGRRETQYF	TRBV5-6	TRBJ2-5
TGTGCCAGCAGTGCTTGCGGGAGCTGTGAAGCTTTCTTT	CASSACGSCEAFF	TRBV28	TRBJ1-1
TGCAGTGCTAGAGGGGGACAGGGTGGCTACACCTTC	CSARGGQGGYTF	TRBV20-1	TRBJ1-2
TGCAGCGCCAGAGGGACTAAGCGCCCCGATGGCTACACCTTC	CSARGTKRPDGYTF	TRBV29-1	TRBJ1-2
TGTGCCAGCAGCATGGGCGAGCAGTACTTC	CASSMGEQYF	TRBV7-9	TRBJ2-7
TGTGCCAGCTCACCACCCCAAATTCAGGGTAGGTCCTATGGCTACACCTTC	CASSPPQIQGRSYGYTF	TRBV18	TRBJ1-2
TGTGCCAGCAGCTTAGGCAGGGCAGGCTATGGCTACACCTTC	CASSLGRAGYGYTF	TRBV11-3	TRBJ1-2
TGTGCTAGCAGCTTACGGGGACAGCCACCAAGCAATCAGCCCCAGCATTTT	CASSLRGQPPSNQPQHF	TRBV7-7	TRBJ1-5
TGCAGTGCTAGCACGGGGGGGTGGCCCGGGGAGCTGTTTTTT	CSASTGGWPGELFF	TRBV20-1	TRBJ2-2
TGTGCCAGCAGCGACCCGGGACAGGGCAATCAGCCCCAGCATTTT	CASSDPGQGNQPQHF	TRBV13	TRBJ1-5
TGTGCCTGGAGATTTCCCGGGGGCGAAGAGACCCAGTACTTC	CAWRFPGGEETQYF	TRBV30	TRBJ2-5
TGTGCCCGAACCGACAGCACCTACGAGCAGTACTTC	CARTDSTYEQYF	TRBV10-3	TRBJ2-7
TGCAGTGCTGAGTGGGACAGGGATGCACCATACTATGGCTACACCTTC	CSAEWDRDAPYYGYTF	TRBV20-1	TRBJ1-2
TGTGCCAGCAGTTTATTCCCGAGAAGATTTGAGGGCACAGATACGCAGTATTTT	CASSLFPRRFEGTDTQYF	TRBV12-4	TRBJ2-3
TGCAGTGCGGGCAGTAGATTGATTCAGCCCCAGCATTTT	CSAGSRLIQPQHF	TRBV20-1	TRBJ1-5
TGTGCCAGCAGCACTCGGGACTCTACAGATACGCAGTATTTT	CASSTRDSTDTQYF	TRBV7-3	TRBJ2-3
TGCATGTTATCCCCTCAGGGGCCCAATGAGCAGTTCTTC	CMLSPQGPNEQFF	TRBV29-1	TRBJ2-1
TGCAGTGCTGGCTTGGCGGATTTTGGAAATTCACCCCTCCACTTT	CSAGLADFGNSPLHF	TRBV20-1	TRBJ1-6
TGTGCCAGCATTTACCAGGAACACACTGAAGCTTTCTTT	CASIYQEHTEAFF	TRBV13	TRBJ1-1
TGTGCCAGCAGCATAGACATGGACAGCTCCTACGAGCAGTACTTC	CASSIDMDSSYEQYF	TRBV5-4	TRBJ2-7
TGTGCCAGCAGTTCCCCACAGGGGAGAGGTCCTAACTATGGCTACACCTTC	CASSSPQGRGPNYGYTF	TRBV6-2	TRBJ1-2
TGTGCCACCAGTACCCGGGGGGGAGCTAGCTTCGTCTTC	CATSTRGGASFVF	TRBV24-1	TRBJ2-1
TGTGCCAGCAGGTTCAGCGGGGACCGCTCCTACGAGCAGTACTTC	CASRFSGDRSYEQYF	TRBV2	TRBJ2-7
TGCAGTGCTAGAGATGAAACCGAACCTCGGAACACTGAAGCTTTCTTT	CSARDETEPRNTEAFF	TRBV20-1	TRBJ1-1
TGTGCCAGCAGCTATCGTACAGAATCGCTTTCCTACGAGCAGTACTTC	CASSYRTESLSYEQYF	TRBV7-2	TRBJ2-7
TGTGCCAGCAGCATTGGACGCCCTAAGCTGTTTTTT	CASSIGRPKLFF	TRBV7-3	TRBJ2-2
TGTGCCAGCAGCCCGCTCACGGGACACCGGGGTGGCTACACCTTC	CASSPLTGHRGGYTF	TRBV4-2	TRBJ1-2
TGTGCCAGCATAGTCAGCAGGGGAAATCATGAGCAGTTCTTC	CASIVSRGNHEQFF	TRBV12-3	TRBJ2-1
TGTGCCAGCAGCCAAGATCCCATGGGGGGGGACGAGCAGTACTTC	CASSQDPMGGDEQYF	TRBV3-1	TRBJ2-7
TGTGCCATGTGTAGGGAACTCGCGAACACCGGGGAGCTGTTTTTT	CAMCRELANTGELFF	TRBV19	TRBJ2-2
TGTGCCAGCAGTTTTCACCCGGCAGGGGTCCTCACTGAAGCTTTCTTT	CASSFHPAGVLTEAFF	TRBV6-1	TRBJ1-1
TGTGCCAGCGGAGAAGTGAACACTGAAGCTTTCTTT	CASGEVNTEAFF	TRBV27	TRBJ1-1
TGTGCCAGCAGCGTGGGGGCCAGTGCAACTAATGAAAAACTGTTTTTT	CASSVGASATNEKLFF	TRBV7-2	TRBJ1-4
TGTGCCATTGGGAGCAGGGGATACAATGAGCAGTTCTTC	CAIGSRGYNEQFF	TRBV6-4	TRBJ2-1
TGCAGCGAGCGAATGGGCGCAGGGTCACCCCTCCACTTT	CSERMGAGSPLHF	TRBV29-1	TRBJ1-6
TGTGCCAGCAGTGACAGACCAGGGCATAGCAATCAGCCCCAGCATTTT	CASSDRPGHSNQPQHF	TRBV6-4	TRBJ1-5
TGTGCCAGCAGTGAAGGGTCCGGGGTCACTGAAGCTTTCTTT	CASSEGSGVTEAFF	TRBV6-4	TRBJ1-1
TGCAGTGCTGGGTGGACAGGGTATGGCCAAGAGACCCAGTACTTC	CSAGWTGYGQETQYF	TRBV20-1	TRBJ2-5
TGTGCCAGCAGCCGCTGTTATATCTACGAGCAGTACTTC	CASSRCYIYEQYF	TRBV6-1	TRBJ2-7
TGTGCCAGCAGCCCGGTTGTCGGGGCTTTCTTT	CASSPVVGAFF	TRBV12-3	TRBJ1-1
TGTGCCAGCCGTTTCGGGGGGCGGCCAGAAGAGACCCAGTACTTC	CASRFGGRPEETQYF	TRBV11-3	TRBJ2-5
TGCGCCAGCAGCCAAGATATAGGACCGGGACGACACTATAATTCACCCCTCCACTTT	CASSQDIGPGRHYNSPLHF	TRBV4-1	TRBJ1-6
TGTGCCAGCAGTGACAACCCTCCGTATGGCTACACCTTC	CASSDNPPYGYTF	TRBV6-1	TRBJ1-2
TGTGCCACCAGCAGCCGACTCGGGGCGCACTACTATGGCTACACCTTC	CATSSRLGAHYYGYTF	TRBV15	TRBJ1-2
TGTGCCAGCAGCTTACTCCACGGAAGAGGTAGTTACGAGCAGTACTTC	CASSLLHGRGSYEQYF	TRBV7-9	TRBJ2-7
TGCAGTGCTAGCCGGGCTTCCCGGTGGACAGGAACTTATTATGGCTACACCTTC	CSASRASRWTGTYYGYTF	TRBV20-1	TRBJ1-2
TGCAGTGCTAGATACAGGACTAGCGGGAGGTTATTGGCGTGCAGAGGTGCCTACAATGAGCAGTTCTTC	CSARYRTSGRLLACRGAYNEQFF	TRBV20-1	TRBJ2-1
TGTGCCAGCAGCGTCCGACTAGCCCAACTGGTGTACAATGAGCAGTTCTTC	CASSVRLAQLVYNEQFF	TRBV5-8	TRBJ2-1
TGTGCCAGTAGTTTCCGGGAGGCGGGACCCGGCTACACCTTC	CASSFREAGPGYTF	TRBV19	TRBJ1-2
TGTGCCAGCAGCAGTCCAGCTGAAGCTTTCTTT	CASSSPAEAFF	TRBV13	TRBJ1-1
TGTGCCAGCAGCTTAGGCTATTCGACCACACCCTCGAACCAAGAGACCCAGTACTTC	CASSLGYSTTPSNQETQYF	TRBV7-4	TRBJ2-5
TGTGCCTTTTCTGTTCACAGCGGGAGAAATTATGAGCAGTTCTTC	CAFSVHSGRNYEQFF	TRBV25-1	TRBJ2-1
TGTGCCAGCAGCCAGCGCGAAAGGGACAGGGGAGGTTTTGGGTCACCCCTCCACTTT	CASSQRERDRGGFGSPLHF	TRBV7-3	TRBJ1-6
TGTGCCAGCAGTTCTCCCCGGGACCCACAAGAGACCCAGTACTTC	CASSSPRDPQETQYF	TRBV6-4	TRBJ2-5
TGTGCCAGCAGTTTATGCAACAGGGGGGGGAACACTGAAGCTTTCTTT	CASSLCNRGGNTEAFF	TRBV28	TRBJ1-1
TGTGCCAGCAGTTTATGTGCACAGGGGCCGATGAACACTGAAGCTTTCTTT	CASSLCAQGPMNTEAFF	TRBV27	TRBJ1-1
TGTGCCAGCAGAGGGCCCTACGAGCAGTACTTC	CASRGPYEQYF	TRBV7-7	TRBJ2-7
TGTGCCAGCAGCCTGCGGGGGGGCCGGTATGAGCAGTTCTTC	CASSLRGGRYEQFF	TRBV5-4	TRBJ2-1
TGTGCCAGCAGTTACGTTGGTTTGGAGACCCAGTACTTC	CASSYVGLETQYF	TRBV27	TRBJ2-5
TGTGCCAGCAGCTTACTTCTTCCCGAGCGGACTAGCGGATTAAGCTCCTACAATGAGCAGTTCTTC	CASSLLLPERTSGLSSYNEQFF	TRBV11-1	TRBJ2-1
TGTGCCAGCAGCTTAGTTTGGACAGGGGAGCGCTCTGGAAACACCATATATTTT	CASSLVWTGERSGNTIYF	TRBV7-3	TRBJ1-3
TGTGCCAGCAGTTTGGGGCGGATGGGCTCCTACGAGCAGTACTTC	CASSLGRMGSYEQYF	TRBV27	TRBJ2-7
TGTGCCAGCAGTTTCCTAAAGGCCGGGACAGGGCAAGCTAACTATGGCTACACCTTC	CASSFLKAGTGQANYGYTF	TRBV27	TRBJ1-2
TGTGCCAGCAGCCATGTTCCTTCAACGGCCCTACAGCCCCAGCATTTT	CASSHVPSTALQPQHF	TRBV7-3	TRBJ1-5
TGTGCCAGCAGTGTCGGACTAGTAGACTACGAGCAGTACTTC	CASSVGLVDYEQYF	TRBV6-1	TRBJ2-7
TGTGCCACCCTAACGTCCCGGGACAGGGGAGGGACGTATGGCTACACCTTC	CATLTSRDRGGTYGYTF	TRBV6-6	TRBJ1-2
TGTGCCAGCAGTTTAAGTGGGATAGGGGCGAGGATCTCTGGAAACACCATATATTTT	CASSLSGIGARISGNTIYF	TRBV12-3	TRBJ1-3
TGTGCCAGCAGCAAACAGGGCACTGAAGCTTTCTTT	CASSKQGTEAFF	TRBV13	TRBJ1-1
TGTGCCTGGTGGTCCGGGACAGGGAGCAATCAGCCCCAGCATTTT	CAWWSGTGSNQPQHF	TRBV30	TRBJ1-5
TGTGCCAGCACCCCCCACAGGGCCCTCCACTTT	CASTPHRALHF	TRBV14	TRBJ1-6
TGTGCCACCCAGGGAGCTTTCTTT	CATQGAFF	TRBV7-9	TRBJ1-1
TGTGCCAGCAGCCCGAGGACTAGTAGTAAGTACGAGCAGTACTTC	CASSPRTSSKYEQYF	TRBV7-4	TRBJ2-7
TGTGCCAGCAGTTATCCCCTAGCGGGTGAACTGTACAATGAGCAGTTCTTC	CASSYPLAGELYNEQFF	TRBV6-5	TRBJ2-1
TGTACGGGGAGCGGTCAGCCCCAGCATTTT	CTGSGQPQHF	TRBV30	TRBJ1-5
TGTGCCAGCTCCCTAGCGTTCCCCTCCTACAATGAGCAGTTCTTC	CASSLAFPSYNEQFF	TRBV25-1	TRBJ2-1
TGTGCCACCAGTGATTCACGGGAGGGGTTTGGTGCCGGGGAGCTGTTTTTT	CATSDSREGFGAGELFF	TRBV24-1	TRBJ2-2
TGTGCCAGCCGAGTGACTGAAGCTTTCTTT	CASRVTEAFF	TRBV27	TRBJ1-1
TGCAGTGCCATATTAGTAAGAGGACAGCCGGGTCAGCCCCAGCATTTT	CSAILVRGQPGQPQHF	TRBV20-1	TRBJ1-5
TGTGCCAGCAGAAAAAGGGGTGGGCATGGATACGAGCAGTACTTC	CASRKRGGHGYEQYF	TRBV6-1	TRBJ2-7
TGTGCCAGCAGCTTAGCGACGGTCAGGGGGCACACTGAAGCTTTCTTT	CASSLATVRGHTEAFF	TRBV7-8	TRBJ1-1
TGTGCCAGCAGCTACGTGGACAGATCCCGAGAAGCTTTCTTT	CASSYVDRSREAFF	TRBV11-3	TRBJ1-1
TGTGCCAGCAGTTACCAATCGGACGCTCTTGGACACAGTAGCAATCAGCCCCAGCATTTT	CASSYQSDALGHSSNQPQHF	TRBV6-5	TRBJ1-5
TGTGCCAGCAGCTTGCAGGGGGACGAGACCCAGTACTTC	CASSLQGDETQYF	TRBV5-5	TRBJ2-5
TGCAGTGCTAGGGGGGGGGAGATCTACGAGCAGTACTTC	CSARGGEIYEQYF	TRBV20-1	TRBJ2-7
TGTGCCAGCAGCTTACGATTCACCGGGACGGGGTCGGTCTCCTACGAGCAGTACTTC	CASSLRFTGTGSVSYEQYF	TRBV7-9	TRBJ2-7
TGTGCCAGCAGTGAACAGGTAACGACTGATACGCAGTATTTT	CASSEQVTTDTQYF	TRBV27	TRBJ2-3
TGCAGTGCTGTATGGTCCTCCAAGCCCGCCACTGAAGCTTTCTTT	CSAVWSSKPATEAFF	TRBV20-1	TRBJ1-1
TGTGCCAGCAGCTTACAGACAGGTTTCCTCTCAACTAATGAAAAACTGTTTTTT	CASSLQTGFLSTNEKLFF	TRBV7-3	TRBJ1-4
TGCGCCAGCAGCATCTTGAAGACAGAAGATAAGGGCTACGAGCAGTACTTC	CASSILKTEDKGYEQYF	TRBV5-1	TRBJ2-7
TGTGCTAGCAGCTGGGGGGCGAGTACCACCGGGGAGCTGTTTTTT	CASSWGASTTGELFF	TRBV7-7	TRBJ2-2
TGTGCCAGCAGTTACGGGGGGGACGAGCAGTACTTC	CASSYGGDEQYF	TRBV28	TRBJ2-7
TGTGCCACCAGTGAGGAAAAGTGGGGACAGGGGGGCGCGTCCTACGAGCAGTACTTC	CATSEEKWGQGGASYEQYF	TRBV24-1	TRBJ2-7
TGCAGTGGCATTTTTAGGGGATACGAGCAGTACTTC	CSGIFRGYEQYF	TRBV20-1	TRBJ2-7
TGTGCCATCAGTGAGTTTAGGGCAAACTATGGCTACACCTTC	CAISEFRANYGYTF	TRBV10-3	TRBJ1-2
TGTGCCAGCAGCCGGGGGGTATCCTACAATGAGCAGTTCTTC	CASSRGVSYNEQFF	TRBV4-2	TRBJ2-1
TGCAGCGGGAAGACTAGCGGGGGGGCCACCGTAGATGAGCAGTTCTTC	CSGKTSGGATVDEQFF	TRBV29-1	TRBJ2-1
TGTGCCAGCAGCGTATGTCGGCGGGGACACGACGAGCAGTACTTC	CASSVCRRGHDEQYF	TRBV9	TRBJ2-7
TGTGCCAGCAGCTTGGGAGGGAGGCAGTACTACGAGCAGTACTTC	CASSLGGRQYYEQYF	TRBV5-6	TRBJ2-7
TGTGCCAGCAGCTTAAAGGGGGCTAGTTCCTACGAGCAGTACTTC	CASSLKGASSYEQYF	TRBV7-6	TRBJ2-7
TGCGCCAGCAGAGGCCGAATTGTAGTCTATGGCTACACCTTC	CASRGRIVVYGYTF	TRBV4-1	TRBJ1-2
TGTGCCATCAGTGACTATGGATCTGAAGCTTTCTTT	CAISDYGSEAFF	TRBV10-3	TRBJ1-1
TGCGCCAGCAGCTTGGCAGTAGGGGTGTTCTCTGGGGCCAACGTCCTGACTTTC	CASSLAVGVFSGANVLTF	TRBV5-1	TRBJ2-6
TGCGCCAGCAGCTCGCCGACAGGCAATCAGCCCCAGCATTTT	CASSSPTGNQPQHF	TRBV5-1	TRBJ1-5
TGTGCCAGTAGCCCTTTCGCCGGGGGGGGGCTCCAAGAGACCCAGTACTTC	CASSPFAGGGLQETQYF	TRBV19	TRBJ2-5
TGTGCCACCCACCTAAGCACAGATACGCAGTATTTT	CATHLSTDTQYF	TRBV15	TRBJ2-3
TGTGCCAGCAGTGAGGATAACCTGTGGAGGGTCCCCTCCTACAATGAGCAGTTCTTC	CASSEDNLWRVPSYNEQFF	TRBV6-4	TRBJ2-1
TGCAGTGCTAGAAAGTGGGGGACCCAGTACTTC	CSARKWGTQYF	TRBV20-1	TRBJ2-5
TGTGCCAGCAACGGACAGGGGGCTGTGCGCAATGAGCAGTTCTTC	CASNGQGAVRNEQFF	TRBV13	TRBJ2-1
TGTGCCAGCAGCCAAAAAGTTGGACTGGACGACACAGATACGCAGTATTTT	CASSQKVGLDDTDTQYF	TRBV14	TRBJ2-3
TGTGCCAGCAGCATACCAAAAACAACTAATGAAAAACTGTTTTTT	CASSIPKTTNEKLFF	TRBV7-8	TRBJ1-4
TGTGCCAGGGGGAACACTGAAGCTTTCTTT	CARGNTEAFF	TRBV28	TRBJ1-1
TGTGCCAGCAGTCCGGGAACGGGACTAGGGTCTGAGACCCAGTACTTC	CASSPGTGLGSETQYF	TRBV12-4	TRBJ2-5
TGTGCCAGCAGCACGCGCACCACAGGGTTCGACACTGAAGCTTTCTTT	CASSTRTTGFDTEAFF	TRBV7-4	TRBJ1-1
TGCAGTGCTGGTCACGGCTATGGCTACACCTTC	CSAGHGYGYTF	TRBV20-1	TRBJ1-2
TGCGCCAGCAGTTCCATCTCCACCGGCTACGAGCAGTACTTC	CASSSISTGYEQYF	TRBV10-1	TRBJ2-7
TGTGCCAGCAGTAGCCATCACCCTGTAAGGGCGGGAGAACTGTTTTTT	CASSSHHPVRAGELFF	TRBV25-1	TRBJ1-4
TGTGCCAGCAGCCGCAGCAGGGCCGGGGGGGAACTGTTTTTT	CASSRSRAGGELFF	TRBV5-5	TRBJ1-4
TGTGCCAGCAGCAGTGGGGTCCCAGGTTCTTCACCCCTCCACTTT	CASSSGVPGSSPLHF	TRBV7-3	TRBJ1-6
TGTGCCAGCAGTGTAACCATGGGACTAGCGGAGCCTTGTAAAAACATTCAGTACTTC	CASSVTMGLAEPCKNIQYF	TRBV6-1	TRBJ2-4
TGTGCCAGCAGTTTATCCCGGGTCAGGATTGGCCAAGATACGCAGTATTTT	CASSLSRVRIGQDTQYF	TRBV27	TRBJ2-3
TGCAGCGTTGAAGATCCCAGGGTCAAAACCTACGAGCAGTACTTC	CSVEDPRVKTYEQYF	TRBV29-1	TRBJ2-7
TGTGCCAGCCATGGGGGTCAGCCCCAGCATTTT	CASHGGQPQHF	TRBV5-4	TRBJ1-5
TGCAGCGTCGGGGGGCGCCAGCATAGCAATCAGCCCCAGCATTTT	CSVGGRQHSNQPQHF	TRBV29-1	TRBJ1-5
TGTGCCAGCAGTTTAGCAAGGATGGGCAAGGGGAACACTGAAGCTTTCTTT	CASSLARMGKGNTEAFF	TRBV27	TRBJ1-1
TGTGCCAGCAGTGACCCCGGACTAGCGGGCGAGGCGAACACCGGGGAGCTGTTTTTT	CASSDPGLAGEANTGELFF	TRBV6-4	TRBJ2-2
TGTGCCAGCATAGGTCCCTTAAGGGAGACCCAGTACTTC	CASIGPLRETQYF	TRBV6-3	TRBJ2-5
TGTGCCAGCAGCCGGGGAGGGGGCCGCAATCAGCCCCAGCATTTT	CASSRGGGRNQPQHF	TRBV3-1	TRBJ1-5
TGCGCCAGCAGGTCCCCGGACCAAGGGAATGAGCAGTTCTTC	CASRSPDQGNEQFF	TRBV10-1	TRBJ2-1
TGTGCCTGGAGTGGGGCCGGGACAGGGCAAGCTAACTATGGCTACACCTTC	CAWSGAGTGQANYGYTF	TRBV30	TRBJ1-2
TGTGCCAGCACATCCTGCCAGGGGGCGCGACCCTACGAGCAGTACTTC	CASTSCQGARPYEQYF	TRBV6-5	TRBJ2-7
TGTGCCAGCAGTGGCTGGAAGGACGGACGCTACGAGCAGTACTTC	CASSGWKDGRYEQYF	TRBV6-3	TRBJ2-7
TGTGCCAGCAGCGTAGGACCTAGCGGGAATGAGCAGTTCTTC	CASSVGPSGNEQFF	TRBV9	TRBJ2-1
TGCAGTGCTAGAGATTCGGGGGTCGACGGGGCCAACGTCCTGACTTTC	CSARDSGVDGANVLTF	TRBV20-1	TRBJ2-6
TGTGCCAGCAGTTTATGCCTTGGGCGCATCGGGACTAGCGGAGGAACCACCTTGGGCTCCTACAATGAGCAGTTCTTC	CASSLCLGRIGTSGGTTLGSYNEQFF	TRBV27	TRBJ2-1
TGTGCCAGCAGCTTAGAAGACGGGGGGGACAGGGAGGACACTGAAGCTTTCTTT	CASSLEDGGDREDTEAFF	TRBV7-4	TRBJ1-1
TGTGCCACAACCGTATGGACAATCAAGAACACCGGGGAGCTGTTTTTT	CATTVWTIKNTGELFF	TRBV24-1	TRBJ2-2
TGTGCCAGCAGCAGTAAATGGACGGTACCAGAGACCCAGTACTTC	CASSSKWTVPETQYF	TRBV13	TRBJ2-5
TGTGCCAGCAGCACTGGATGGCCCTATAATTCACCCCTCCACTTT	CASSTGWPYNSPLHF	TRBV13	TRBJ1-6
TGCGCCAGCAGCTACCACCTGACTAGCGGGGGGGCAGGAGAGACCCAGTACTTC	CASSYHLTSGGAGETQYF	TRBV5-1	TRBJ2-5
TGTGCCAGCAGCCCGCCGCCTAGCGGGAAGGATTCGCAGTTCTTC	CASSPPPSGKDSQFF	TRBV11-2	TRBJ2-1
TGTGCCACCGAGGACAGGGTAGGCAGGGCAACTAATGAAAAACTGTTTTTT	CATEDRVGRATNEKLFF	TRBV24-1	TRBJ1-4
TGTGCCAGCAGCTTAGATGGAGTCCTCGGGACCTTCACTGAAGCTTTCTTT	CASSLDGVLGTFTEAFF	TRBV11-2	TRBJ1-1
TGTGCCAGCAGCCAATCCCGGGACCAGGCAAACACTGAAGCTTTCTTT	CASSQSRDQANTEAFF	TRBV7-4	TRBJ1-1
TGTGCCAGCAGTTGTCCGGACGGAGCGGGATGGGGCTCTGGAAACACCATATATTTT	CASSCPDGAGWGSGNTIYF	TRBV6-3	TRBJ1-3
TGCGCCAGCAGCTCCTACAGGGGGGGAACCGGGGAGCTGTTTTTT	CASSSYRGGTGELFF	TRBV5-1	TRBJ2-2
TGCGCCAGCAGCTTGGCCAGTGATGACTGGTACTTC	CASSLASDDWYF	TRBV5-1	TRBJ2-7
TGTGCCAGCAGCGGACAGGGGAGGGTGCCCCAGCATTTT	CASSGQGRVPQHF	TRBV7-9	TRBJ1-5
TGTGCCAGCAGGACTAGCGGGGACTATGAGCAGTTCTTC	CASRTSGDYEQFF	TRBV9	TRBJ2-1
TGTGCCAGCAGCGCGGGGACAGGGCCCAACACCGGGGAGCTGTTTTTT	CASSAGTGPNTGELFF	TRBV9	TRBJ2-2
TGCGCCAGCAGCTCCTTAGGGAAAGGCACAGATACGCAGTATTTT	CASSSLGKGTDTQYF	TRBV5-1	TRBJ2-3
TGTGCCAGCAGCGACTTGGAGTCAGGGGGGGGGAGCACAGATACGCAGTATTTT	CASSDLESGGGSTDTQYF	TRBV9	TRBJ2-3
TGCGCCAGCCATCCGCCTGTGAACACTGAAGCTTTCTTT	CASHPPVNTEAFF	TRBV5-1	TRBJ1-1
TGTGCCAGCAAAAGCGCCGGGACTAGCGGGAGAAGTAGGGGTAACTATGGCTACACCTTC	CASKSAGTSGRSRGNYGYTF	TRBV9	TRBJ1-2
TGTGCCAGCAGCCCCCTAAGAGGGTGCCAAGAGACCCAGTACTTC	CASSPLRGCQETQYF	TRBV11-3	TRBJ2-5
TGTGCCAGCAGGAGAACGCGGAGGCCGAATGAGCAGTTCTTC	CASRRTRRPNEQFF	TRBV6-4	TRBJ2-1
TGTGCCAGCAGCCAAGTGGCCGGGACTAGCGGCGCTAGCTCCTACGAGCAGTACTTC	CASSQVAGTSGASSYEQYF	TRBV4-2	TRBJ2-7
TGTGCCAGCAGCCAACCGAGGGGGACGGGTGTCACAGATACGCAGTATTTT	CASSQPRGTGVTDTQYF	TRBV14	TRBJ2-3
TGTGCCAGCAGCAGGGGCGAACGAGTCGAGCAGTACTTC	CASSRGERVEQYF	TRBV13	TRBJ2-7
TGTGCCAGCAGCCTTGGGGGCTCCTACGAGCAGTACTTC	CASSLGGSYEQYF	TRBV13	TRBJ2-7
TGCAGTGCTAGAGCGAAAAGAGTATCGGTGGACGAGCAGTACTTC	CSARAKRVSVDEQYF	TRBV20-1	TRBJ2-7
TGTGCCAGCAGGAACAGGGAGGCTGAAGCTTTCTTT	CASRNREAEAFF	TRBV6-1	TRBJ1-1
TGTGCCAGCAGCCACTTAGGGGGACAGCAAGCTAACTATGGCTACACCTTC	CASSHLGGQQANYGYTF	TRBV11-2	TRBJ1-2
TGTGCCAGCAGCATAGCGGGTCATGAGCAGTTCTTC	CASSIAGHEQFF	TRBV7-7	TRBJ2-1
TGCAGTGCTAGCCGGGACCTGCACGAGCAGTACTTC	CSASRDLHEQYF	TRBV20-1	TRBJ2-7
TGTGCCAGCAGCCCGCGCGGGAGGACCACCGGGGAGCTGTTTTTT	CASSPRGRTTGELFF	TRBV5-6	TRBJ2-2
TGTGCCAGGTATGGGCGATGCTACGAGCAGTACTTC	CARYGRCYEQYF	TRBV7-9	TRBJ2-7
TGTGCCACCAGCCGGGGTGAGAACACTGAAGCTTTCTTT	CATSRGENTEAFF	TRBV24-1	TRBJ1-1
TGTGCTAGTGGTTTGGTAAATGGGAGGGGGGGCTGTGAAAAACTGTTTTTT	CASGLVNGRGGCEKLFF	TRBV12-5	TRBJ1-4
TGTGCCAGCAGTCTTACCGGGGGGGCCGGAATTTACCAAGAGACCCAGTACTTC	CASSLTGGAGIYQETQYF	TRBV6-3	TRBJ2-5
TGTGCCAGCAGCCGGACAGAGCCGGGAAACACCATATATTTT	CASSRTEPGNTIYF	TRBV28	TRBJ1-3
TGTGCCAGCAGTCGCCCAGCTGTCTCTTACTATGGCTACACCTTC	CASSRPAVSYYGYTF	TRBV7-3	TRBJ1-2
TGTGCCAGCACAAGGGATGTGAAATGCTATGGCTACACCTTC	CASTRDVKCYGYTF	TRBV6-4	TRBJ1-2
TGTGCCAGCAGGGGCCTAGGTCCTTCCGATCGCACAGATACGCAGTATTTT	CASRGLGPSDRTDTQYF	TRBV7-3	TRBJ2-3
TGTGCCAGCAGCCGGGACAGGGGGACAGAGACTTATGAGACCCAGTACTTC	CASSRDRGTETYETQYF	TRBV9	TRBJ2-5
TGTGCCACCAGCAGAGATGGAGTGCTCCCTGACGGGTTTTCCTATGGCTACACCTTC	CATSRDGVLPDGFSYGYTF	TRBV15	TRBJ1-2
TGTGCCAGTAAGGGGTCGGGACTTGAAAAACTGTTTTTT	CASKGSGLEKLFF	TRBV19	TRBJ1-4
TGCGCCAGCAGCTCCGGGTCTCTCACCAATGAGCAGTTCTTC	CASSSGSLTNEQFF	TRBV5-1	TRBJ2-1
TGTGCCAGCAGCTCTTACGTTCGTGGGACTAGCGGAGAGACCCAGTACTTC	CASSSYVRGTSGETQYF	TRBV5-4	TRBJ2-5
TGTGCCACCAGTGATTTCCCCAGGGAAACTTATCAGCCCCAGCATTTT	CATSDFPRETYQPQHF	TRBV24-1	TRBJ1-5
TGTGCCAGCAGCGCCCAACAGACACCCAGGCCAATCGATACGCAGTATTTT	CASSAQQTPRPIDTQYF	TRBV9	TRBJ2-3
TGCAGTGCTAGAGATCAACAGGGGAGCGATACGCAGTATTTT	CSARDQQGSDTQYF	TRBV20-1	TRBJ2-3
TGTGCCAGCAGTTCGAACAGGGGGACCAAACCTGAAGCTTTCTTT	CASSSNRGTKPEAFF	TRBV6-4	TRBJ1-1
TGTGCCAGCAGTTGCATGGCCGGGACAAACGCCTTTGAAGCTTTCTTT	CASSCMAGTNAFEAFF	TRBV6-6	TRBJ1-1
TGCAGTGCAGCAGAGCGCACTGAAGCTTTCTTT	CSAAERTEAFF	TRBV20-1	TRBJ1-1
TGCGCCAGCAGCGACGAGCAGTACTTC	CASSDEQYF	TRBV5-1	TRBJ2-7
TGTGCCAGCAGTTTGATCACTAGCGGGAGTTTCGCAAGCTCTGGAAACACCATATATTTT	CASSLITSGSFASSGNTIYF	TRBV27	TRBJ1-3
TGTGCCAGCAGTTTAGCACTACTCTCGGGGGGGGAGCTGTTTTTT	CASSLALLSGGELFF	TRBV12-4	TRBJ2-2
TGCAGTGCCCACATTCTTAGCGGGGGCCAGTACTTC	CSAHILSGGQYF	TRBV20-1	TRBJ2-5
TGTGCCAGCAGCCAAGCCGGGACAGGGTTTCCGGGATATGGCTACACCTTC	CASSQAGTGFPGYGYTF	TRBV4-2	TRBJ1-2
TGTGCCAGCAGCTGTCTAACAGGGGGGGGACAGGGGTGCAAAGATTATAGCAATCAGCCCCAGCATTTT	CASSCLTGGGQGCKDYSNQPQHF	TRBV5-4	TRBJ1-5
TGTGCCACATCAAGGAACGGGTCAGGACAAGAGACCCAGTACTTC	CATSRNGSGQETQYF	TRBV19	TRBJ2-5
TGTGCCAGCAGTCAATCTCACAGGGAAGCCTACAATGAGCAGTTCTTC	CASSQSHREAYNEQFF	TRBV6-6	TRBJ2-1
TGTGCCAGCAGTTACGGGGGTCCTCGGGACAGGGGAACAGATACGCAGTATTTT	CASSYGGPRDRGTDTQYF	TRBV6-6	TRBJ2-3
TGTGCCAGCAGCTTGAACAGGGGGGGGTTCACTGAAGCTTTCTTT	CASSLNRGGFTEAFF	TRBV7-4	TRBJ1-1
TGTGCCAGCACCCGACCGGGGCCAACTAACTATGGCTACACCTTC	CASTRPGPTNYGYTF	TRBV6-1	TRBJ1-2
TGTGCCAGCCCCCGTAGAGAAGCCTACGAGCAGTACTTC	CASPRREAYEQYF	TRBV18	TRBJ2-7
TGTGCCAGCAGCCCGAGACGCTATGGCTACACCTTC	CASSPRRYGYTF	TRBV11-2	TRBJ1-2
TGTGCCAGCAGCTTCCGGGGGGGGATGAGAGGAGTCAGAGCTGGGGCCAACGTCCTGACTTTC	CASSFRGGMRGVRAGANVLTF	TRBV5-5	TRBJ2-6
TGTGCCAGCAGCTCAAGCGGGATACTCTCCTACGAGCAGTACTTC	CASSSSGILSYEQYF	TRBV9	TRBJ2-7
TGTGCCAGCAGTGACGATCCGAGCGGGACACCTTCAGATACGCAGTATTTT	CASSDDPSGTPSDTQYF	TRBV6-4	TRBJ2-3
TGCGCCAGCCTACTTTGGGGACAGGGAGTGAACACTGAAGCTTTCTTT	CASLLWGQGVNTEAFF	TRBV10-1	TRBJ1-1
TGTGCCAGCAGTGAGCGACTAGCCAATGAGCAGTTCTTC	CASSERLANEQFF	TRBV6-1	TRBJ2-1
TGTGCCAGCAGTGCGGGGGGCAAAGCCCGAAGGGGTAATTCACCCCTCCACTTT	CASSAGGKARRGNSPLHF	TRBV6-5	TRBJ1-6
TGTGCCAGCAGCGGGTGCCCAGGGATAGAGACCCAGTACTTC	CASSGCPGIETQYF	TRBV13	TRBJ2-5
TGTGCCTGGAGTGTACAGGGACTCCGGGAAGAGACCCAGTACTTC	CAWSVQGLREETQYF	TRBV30	TRBJ2-5
TGCGCCAGCAGCGCGGGACAGGGAGGGTCCTACGAGCAGTACTTC	CASSAGQGGSYEQYF	TRBV5-1	TRBJ2-7
TGTGCCAGCAGTGAATCTGAAGCGAACGAGCAGTACTTC	CASSESEANEQYF	TRBV6-4	TRBJ2-7
TGTGCCAGCAGCTTAGGGACCCGGACAGGGAATGGCTCCTATAATTCACCCCTCCACTTT	CASSLGTRTGNGSYNSPLHF	TRBV7-2	TRBJ1-6
TGTGCCTGGAACATGACAGGGGGCGAAACTAATGAAAAACTGTTTTTT	CAWNMTGGETNEKLFF	TRBV30	TRBJ1-4
TGTGCCAGCAGCGACCCCGGGGGGAACACCGGGGAGCTGTTTTTT	CASSDPGGNTGELFF	TRBV2	TRBJ2-2
TGTGCCAGCAGCTGCAAGCTAGAGACCTACAATGAGCAGTTCTTC	CASSCKLETYNEQFF	TRBV5-4	TRBJ2-1
TGTGCCAGCGACATTGGCACTGAGAACACTGAAGCTTTCTTT	CASDIGTENTEAFF	TRBV4-2	TRBJ1-1
TGCAGTGCTAGAGAGTTTTGCGGACGACAAGAGACCCAGTACTTC	CSAREFCGRQETQYF	TRBV20-1	TRBJ2-5
TGCGCCAGCAGCTTCCCGCCTAACAGGGGCACCAATCAGCCCCAGCATTTT	CASSFPPNRGTNQPQHF	TRBV5-1	TRBJ1-5
TGTGCCACCGCCCTGGGGGACGGCTACACCTTC	CATALGDGYTF	TRBV10-3	TRBJ1-2
TGCGCCAGCAGCCGCGGGGCGGTAAAGGACGAGCAGTACTTC	CASSRGAVKDEQYF	TRBV5-1	TRBJ2-7
TGCGCCAGCAGCTTGGTGAACAGGGAGCACAGGAGGAACACTGAAGCTTTCTTT	CASSLVNREHRRNTEAFF	TRBV5-1	TRBJ1-1
TGTGCCAGCTCGGTCGACAGGGGAGAGACCCAGTACTTC	CASSVDRGETQYF	TRBV18	TRBJ2-5
TGTGCCAGCAGTTTCCGCTACCCAGGACAGAGCGTACAGCCCCAGCATTTT	CASSFRYPGQSVQPQHF	TRBV12-4	TRBJ1-5
TGTGGGAGCTCTGAAGGACAAGCTAACTATGGCTACACCTTC	CGSSEGQANYGYTF	TRBV9	TRBJ1-2
TGTGCCAGCATAACACTACTTAGCTATAGCAATCAGCCCCAGCATTTT	CASITLLSYSNQPQHF	TRBV6-2	TRBJ1-5
TGTGCCAGCACTTCAACCCGACAGGTTTCGGACAGCACTAACTATGGCTACACCTTC	CASTSTRQVSDSTNYGYTF	TRBV7-4	TRBJ1-2
TGTGCCAGCAGCGAGGGACACATGTGTTACGAGCAGTACTTC	CASSEGHMCYEQYF	TRBV7-3	TRBJ2-7
TGTGCCAGCAGTTACGGAGGGACAGGCCGGAATCAGCCCCAGCATTTT	CASSYGGTGRNQPQHF	TRBV6-3	TRBJ1-5
TGTGCCAGCAGTGACTTAGCCTCTGTCTGGGGGGCATCCTCAGATACGCAGTATTTT	CASSDLASVWGASSDTQYF	TRBV6-4	TRBJ2-3
TGTGCCAGCAGCAAAATCCACAGGGGGGACTCCAATCAGCCCCAGCATTTT	CASSKIHRGDSNQPQHF	TRBV7-3	TRBJ1-5
TGTGCCACGGGGGCCGGCCGCCAAGAGACCCAGTACTTC	CATGAGRQETQYF	TRBV6-5	TRBJ2-5
TGTGCCAGCAGCTTTAAAGCTAGCGGGGCCGGGGAGCAGTACTTC	CASSFKASGAGEQYF	TRBV7-2	TRBJ2-7
TGTGCCAGCAGTTTACCCACCGGGACTAGGGGCAATGAGCAGTTCTTC	CASSLPTGTRGNEQFF	TRBV28	TRBJ2-1
TGTGCCAGCAGCGTACGGCCGACGGCTTTCTTT	CASSVRPTAFF	TRBV7-3	TRBJ1-1
TGTGCCAGCAGTTGGCCACGACAGCGTGGCTACACCTTC	CASSWPRQRGYTF	TRBV28	TRBJ1-2
TGTGCCACCAGTGATGGGGCCCTTGAGCAGTTCTTC	CATSDGALEQFF	TRBV24-1	TRBJ2-1
TGCGCCAGCAGTGCGACCTATTTCCGGGACAGGTACACCTTC	CASSATYFRDRYTF	TRBV10-1	TRBJ1-2
TGTGCCACCAGTGATAGAAAATGGGGGCGCAGTAATGAAAAACTGTTTTTT	CATSDRKWGRSNEKLFF	TRBV24-1	TRBJ1-4
TGTGCCAGCAGCCAAGGAAGACAGGGCGAGCAGTACTTC	CASSQGRQGEQYF	TRBV14	TRBJ2-7
TGTGCCAAGGGGGGCCAGGGGCCGTGCACAGATACGCAGTATTTT	CAKGGQGPCTDTQYF	TRBV7-3	TRBJ2-3
TGTGCCAGCAGCCCGGTATGGGGGGCTCAGCCCCAGCATTTT	CASSPVWGAQPQHF	TRBV9	TRBJ1-5
TGCAGTGCGGAAGCTAAACGGGGACAGGGTGAAAAACTGTTTTTT	CSAEAKRGQGEKLFF	TRBV20-1	TRBJ1-4
TGCAGTGCACATGCAGGATATGGCTACACCTTC	CSAHAGYGYTF	TRBV20-1	TRBJ1-2
TGTGCCAGCAGTTACCTAAAGATCGACCTGCATGGCTACACCTTC	CASSYLKIDLHGYTF	TRBV6-8	TRBJ1-2
TGCAGTGCTATCGCCCCCCCCGGGCCCCTGGAGAACCCCCTTACCGACACTGAAGCTTTCTTT	CSAIAPPGPLENPLTDTEAFF	TRBV20-1	TRBJ1-1
TGTGCCAGCAGCAAACAGGGAGGCTCGCCCCAGCATTTT	CASSKQGGSPQHF	TRBV13	TRBJ1-5
TGTGCCAGCAGCGTTTGGAATCAGCCCCAGCATTTT	CASSVWNQPQHF	TRBV11-2	TRBJ1-5
TGTGCCATCAAATCCGGGTTAAGGACAGATTGCTCCTACGAGCAGTACTTC	CAIKSGLRTDCSYEQYF	TRBV10-3	TRBJ2-7
TGTGCCAGCAGCTCAGCAGGGGGCTTCGGCGAGAACGGCTACACCTTC	CASSSAGGFGENGYTF	TRBV7-8	TRBJ1-2
TGTGCCAGCAGCTTCGGCAGGGGAACTGCCAGCTCCTATAATTCACCCCTCCACTTT	CASSFGRGTASSYNSPLHF	TRBV5-4	TRBJ1-6
TGCAGTGCACGTTCCCGGGAGGGTGGAGGCGGGGAGCTGTTTTTT	CSARSREGGGGELFF	TRBV20-1	TRBJ2-2
TGTGCCACCAGTGATTGTGAACCCAAAGGGACTGAAGCTTTCTTT	CATSDCEPKGTEAFF	TRBV24-1	TRBJ1-1
TGTGCCAGCAGTTTGGAGGAGGGGATAGAAGCTTTCTTT	CASSLEEGIEAFF	TRBV27	TRBJ1-1
TGTGCCAGCAGCTGGGGCAGCTCTGGAAACACCATATATTTT	CASSWGSSGNTIYF	TRBV13	TRBJ1-3
TGTGCCATCAAGAAACCTGGGGGAGATGGCTTTGCCGGCAATCAGCCCCAGCATTTT	CAIKKPGGDGFAGNQPQHF	TRBV10-3	TRBJ1-5
TGCGCCAGCAGCCTCCCTAGAGGGCGTAAGAAGTACTTC	CASSLPRGRKKYF	TRBV4-3	TRBJ2-7
TGTGCCAGCAGCAAAGACATGGGACATGGGGGCCAAGAGACCCAGTACTTC	CASSKDMGHGGQETQYF	TRBV7-4	TRBJ2-5
TGTGCCAGCTATAGGAAAGGCTACGAGCAGTACTTC	CASYRKGYEQYF	TRBV27	TRBJ2-7
TGCGCCAGCAGCCGGACAGGGAACACCATATATTTT	CASSRTGNTIYF	TRBV4-3	TRBJ1-3
TGTGCCAGCAGTTTACTGAGGGCAAACCAAGAGACCCAGTACTTC	CASSLLRANQETQYF	TRBV9	TRBJ2-5
TGTGCCAGGTCGCGGGAGTCCGTCACCATATATTTT	CARSRESVTIYF	TRBV19	TRBJ1-3
TGTGCCAGCATTATGGGGGGGGGGATGAACTACAATGAGCAGTTCTTC	CASIMGGGMNYNEQFF	TRBV27	TRBJ2-1
TGCAGTGCCCTCACTAGCGACCCAGATACGCAGTATTTT	CSALTSDPDTQYF	TRBV20-1	TRBJ2-3
TGCAGTGCGATGGGGCAGGGGGCCAGGTGCTATGGCTACACCTTC	CSAMGQGARCYGYTF	TRBV20-1	TRBJ1-2
TGTGCCAGCAGTACGGACAGGGCGAACACCGGGGAGCTGTTTTTT	CASSTDRANTGELFF	TRBV6-5	TRBJ2-2
TGTGCCAGCAGCTCCCCCCCGGGGGCCTACGAGCAGTACTTC	CASSSPPGAYEQYF	TRBV7-4	TRBJ2-7
TGTGCCAGCAGTCGGGACAAGTATTTGCTCTCTGGAAACACCATATATTTT	CASSRDKYLLSGNTIYF	TRBV6-5	TRBJ1-3
TGTGCCAGCAGCATGGACAGGATCTCAAGCCGGGTAACCTATGGCTACACCTTC	CASSMDRISSRVTYGYTF	TRBV9	TRBJ1-2
TGTGCCAGCGGGGGCGGTGAAGCTTTCTTT	CASGGGEAFF	TRBV27	TRBJ1-1
TGTGCCAGCAGTGGTGAGGGGGGTTTCGGGGGGGCGGCGGAGCAGTACTTC	CASSGEGGFGGAAEQYF	TRBV27	TRBJ2-7
TGTGCCAGCAGCTTCTATACGGAAGGGACTGAAGCTTTCTTT	CASSFYTEGTEAFF	TRBV5-6	TRBJ1-1
TGTGCCAGTAGTGCCTGGGAGGGCAACTCCTACGAGCAGTACTTC	CASSAWEGNSYEQYF	TRBV19	TRBJ2-7
TGTGCCAGCAGTTGGGTCTTCAATGGCTACACCTTC	CASSWVFNGYTF	TRBV12-3	TRBJ1-2
TGTGCCAGCAGTTACGGAACAGGGGTAGGCACCGGGGAGCTGTTTTTT	CASSYGTGVGTGELFF	TRBV6-5	TRBJ2-2
TGTGCCAGCATGGAGGGTCACTCCTACAATGAGCAGTTCTTC	CASMEGHSYNEQFF	TRBV27	TRBJ2-1
TGTGCCAGCAGCGCGCCCGGAGGGGGGGGAAGCGAGCAGTACTTC	CASSAPGGGGSEQYF	TRBV11-3	TRBJ2-7
TGCAGCAATGGGACGGGGAGTAAGCAAGAGACCCAGTACTTC	CSNGTGSKQETQYF	TRBV29-1	TRBJ2-5
TGCAGTGCTAGAGACTTTCAGGGGGAGAACTATGGCTACACCTTC	CSARDFQGENYGYTF	TRBV20-1	TRBJ1-2
TGTGCCAGCAGCTTAGGATGGGGGGCCTACGAGCAGTACTTC	CASSLGWGAYEQYF	TRBV7-9	TRBJ2-7
TGTGCCAGCAGTTTATCGTTGTTGGGGGCCGACGAGCAGTACTTC	CASSLSLLGADEQYF	TRBV28	TRBJ2-7
TGTGCCAGCAGCACGGAGGGCTACGAGCAGTACTTC	CASSTEGYEQYF	TRBV12-4	TRBJ2-7
TGCGCCAGCAGCTTGTCAAGGTTCACCGGGGAGCTGTTTTTT	CASSLSRFTGELFF	TRBV5-1	TRBJ2-2
TGTGCTAGTGGTTTGGTTCCGAAACCGCGTGCCACCCGGGACAGGTGGAAAGAGACCCAGTACTTC	CASGLVPKPRATRDRWKETQYF	TRBV12-5	TRBJ2-5
TGTGCCAGCAGGCCCCCGGGGGGAGGCTACGAGCAGTACTTC	CASRPPGGGYEQYF	TRBV6-5	TRBJ2-7
TGTGCCACCAGCACAGGGGGCGCGTCTAGCTCTGGGGCCAACGTCCTGACTTTC	CATSTGGASSSGANVLTF	TRBV15	TRBJ2-6
TGCAGTGCTAGGCCAGGAAAAGGGACAGGCCTTACAGATACGCAGTATTTT	CSARPGKGTGLTDTQYF	TRBV20-1	TRBJ2-3
TGTGCCAGCAGCCTAGTCACCCGGGACAGGAAGGTCACTGAAGCTTTCTTT	CASSLVTRDRKVTEAFF	TRBV7-3	TRBJ1-1
TGCGCCAGCAGCTGGGGTTATCAGCCCCAGCATTTT	CASSWGYQPQHF	TRBV5-1	TRBJ1-5
TGTGCCTGGAGCAATGGGGTTTACGAGCAGTACTTC	CAWSNGVYEQYF	TRBV30	TRBJ2-7
TGTGCCACCAGTCGCTGGGGCGGAAACACCATATATTTT	CATSRWGGNTIYF	TRBV24-1	TRBJ1-3
TGCGCCAGCAGCCAAGAGGGGTACTATGGCTACACCTTC	CASSQEGYYGYTF	TRBV4-1	TRBJ1-2
TGCAGTGAACTCCAGGGGGGGTATCAGCCCCAGCATTTT	CSELQGGYQPQHF	TRBV20-1	TRBJ1-5
TGTGCCAGCAGCTTAGCCGACAGCCCTGAAGCTTTCTTT	CASSLADSPEAFF	TRBV11-3	TRBJ1-1
TGCAGTGGAAGGCCGGGACAGGGTGGACAAGAGACCCAGTACTTC	CSGRPGQGGQETQYF	TRBV20-1	TRBJ2-5
TGTGCCAGCAGTTTTAGGGGGAAGCGTTCTGAAGCTTTCTTT	CASSFRGKRSEAFF	TRBV28	TRBJ1-1
TGTGCCAGCAGCTTAATACTTACTATAACCTACGAGCAGTACTTC	CASSLILTITYEQYF	TRBV5-6	TRBJ2-7
TGTCTACGGGACCGCGGGACAGGGGACGACACTGAAGCTTTCTTT	CLRDRGTGDDTEAFF	TRBV7-9	TRBJ1-1
TGTGCCATAAGGGGTCTCCCGAACACTGAAGCTTTCTTT	CAIRGLPNTEAFF	TRBV10-3	TRBJ1-1
TGTGCCAGCAGTTTACCCCGAGGGTCCTACGAGCAGTACTTC	CASSLPRGSYEQYF	TRBV27	TRBJ2-7
TGTGCCAGCAGCTTAGCAGGGGGAACTTACTCCTACGAGCAGTACTTC	CASSLAGGTYSYEQYF	TRBV13	TRBJ2-7
TGTGCCAGCAGCGATGCGCCAGGGCCCACCGGGGAGCTGTTTTTT	CASSDAPGPTGELFF	TRBV9	TRBJ2-2
TGTGCCAGCAGCCCGGGACAGGGTACCGGGAAAAATCAGCCCCAGCATTTT	CASSPGQGTGKNQPQHF	TRBV5-6	TRBJ1-5
TGTGCCAGCTCACCACTCCCAGGAAACACTGAAGCTTTCTTT	CASSPLPGNTEAFF	TRBV18	TRBJ1-1
TGTGCCACCAGTGATAGACTGGGGTCCTACGAGCAGTACTTC	CATSDRLGSYEQYF	TRBV24-1	TRBJ2-7
TGTGCTATAAGCTTCGCCACCTACGAGCAGTACTTC	CAISFATYEQYF	TRBV12-5	TRBJ2-7
TGCAGTGCAGTTCTTTCCGGGACAGGGCGGTCTGTAACCACCTTC	CSAVLSGTGRSVTTF	TRBV20-1	TRBJ1-2
TGCGCCAGGCGGGAGACGGAAGCTTTCTTT	CARRETEAFF	TRBV10-1	TRBJ1-1
TGCGCCAGCAGCCTCCGAACGGCAACTAATGAAAAACTGTTTTTT	CASSLRTATNEKLFF	TRBV5-1	TRBJ1-4
TGCGCCAGCAGCCGGGGCATGGCCTCATTCAATGAGCAGTTCTTC	CASSRGMASFNEQFF	TRBV4-1	TRBJ2-1
TGCAGTGCAATAGGAATGGACCTGGAGGGGCGGGTCAACTCCTACGAGCAGTACTTC	CSAIGMDLEGRVNSYEQYF	TRBV20-1	TRBJ2-7
TGTGCCACCAGTGATTTGGTGCCCCCGACGGGGAACAATGAAGCTTTCTTT	CATSDLVPPTGNNEAFF	TRBV24-1	TRBJ1-1
TGCGCCAGCAGCTTGGCTCCCCGCCGAGAGAGGGGCAATCAGCCCCAGCATTTT	CASSLAPRRERGNQPQHF	TRBV5-1	TRBJ1-5
TGTGCCAGCAAATTTGGGTGTTCTAACTATGGCTACACCTTC	CASKFGCSNYGYTF	TRBV6-4	TRBJ1-2
TGTGCCAGCAAAAGGAAGACAGGGAGCTGCAATCAGCCCCAGCATTTT	CASKRKTGSCNQPQHF	TRBV6-5	TRBJ1-5
TGTGCCAGCAGTTACTCTCACCCTAGCGGGGATTACAATGAGCAGTTCTTC	CASSYSHPSGDYNEQFF	TRBV6-3	TRBJ2-1
TGTGCCAGCAGCCAAGGGGGGGGTATCCAAATCTCCTACGAGCAGTACTTC	CASSQGGGIQISYEQYF	TRBV4-2	TRBJ2-7
TGCGCCAGCAGCAGGGGGCTGCCCTACGAGCAGTACTTC	CASSRGLPYEQYF	TRBV5-1	TRBJ2-7
TGTGCCACCCGAGCCGGGACAGGGGGTTGGGGGGGCAATCAGCCCCAGCATTTT	CATRAGTGGWGGNQPQHF	TRBV28	TRBJ1-5
TGTGCCAGCTCAGCCCGGACAGCCCTGACCGGGGAGCTGTTTTTT	CASSARTALTGELFF	TRBV18	TRBJ2-2
TGTGCCAGCAAAGGCGACAGGGGGTTAACAACTCCGTATAGCAATCAGCCCCAGCATTTT	CASKGDRGLTTPYSNQPQHF	TRBV28	TRBJ1-5
TGTGCCAGCAGCTTAAACTTCGGGGAGACAGTAGACGAGCAGTACTTC	CASSLNFGETVDEQYF	TRBV11-2	TRBJ2-7
TGTGCCAGTAGTATACTAATTACTGCCTACGAGCAGTACTTC	CASSILITAYEQYF	TRBV19	TRBJ2-7
TGTGCCACCAGTGATTCGATGTCAAGACGAAAGCGTGAAAAACTGTTTTTT	CATSDSMSRRKREKLFF	TRBV24-1	TRBJ1-4
TGTGCCAGCAGCTCCGGACAGGGCTGGGGGGGCTACGAGCAGTACTTC	CASSSGQGWGGYEQYF	TRBV28	TRBJ2-7
TGTGCCTGGAGTGCCCCAGGGACAGGGAGGCATGGCTACACCTTC	CAWSAPGTGRHGYTF	TRBV30	TRBJ1-2
TGTGCCAGTAGCCTGCCTAGTCGGGGTATTGAAGCTTTCTTT	CASSLPSRGIEAFF	TRBV19	TRBJ1-1
TGCGCCAGCGGGGAGGGAGGGAAAAATTCACCCCTCCACTTT	CASGEGGKNSPLHF	TRBV5-1	TRBJ1-6
TGCAGCGTTATTCGGCAGAAGCAGTTCTTC	CSVIRQKQFF	TRBV29-1	TRBJ2-1
TGTGCCAGCAGCCGGACGAGAGATACGCAGTATTTT	CASSRTRDTQYF	TRBV7-8	TRBJ2-3
TGTGCCAGCGGACTAGCGGGATCAGTTAATGAGCAGTTCTTC	CASGLAGSVNEQFF	TRBV6-3	TRBJ2-1
TGTGCCAGCCGGAAAAGCTATGGCTACACCTTC	CASRKSYGYTF	TRBV27	TRBJ1-2
TGTGCCAGTCCTGCTCCGGGGGCTTGGAGGACAGATACGCAGTATTTT	CASPAPGAWRTDTQYF	TRBV19	TRBJ2-3
TGTGCCAGCAGCGGAACCCACCCAGGGGCTTTCTTT	CASSGTHPGAFF	TRBV7-2	TRBJ1-1
TGTGCCAGCAGCACCAGAGCCGCAACTAATGAAAAACTGTTTTTT	CASSTRAATNEKLFF	TRBV7-4	TRBJ1-4
TGTGCCAGCAGCTTAGCGCCAGCTCCGCCGAGGAACTATGGCTACACCTTC	CASSLAPAPPRNYGYTF	TRBV7-6	TRBJ1-2
TGTGCCAGCTCACGCTTCACCCGGGGGCTGAATTCACCCCTCCACTTT	CASSRFTRGLNSPLHF	TRBV18	TRBJ1-6
TGCGCCAGCAGCCAAGGCACAAAGTCAGGGGGCTCAGATTGCAATCAGCCCCAGCATTTT	CASSQGTKSGGSDCNQPQHF	TRBV4-1	TRBJ1-5
TGCGCCAGCAGTGCGGTAACAGGGGTGAGGAACACCGGGGAGCTGTTTTTT	CASSAVTGVRNTGELFF	TRBV10-1	TRBJ2-2
TGTGCCTGGAGTTATAGGACATTTGGGTATTTT	CAWSYRTFGYF	TRBV30	TRBJ1-3
TGTGCCAGCAGTTTACGGGGGGCGGATGAGACCCAGTACTTC	CASSLRGADETQYF	TRBV27	TRBJ2-5
TGCGCCAGCAGTGCGGTAGCGGGGCCCTCCTACGAGCAGTACTTC	CASSAVAGPSYEQYF	TRBV10-1	TRBJ2-7
TGTGCCAGCAGCCCGGCAACCGCATGGACTAGCGGGAACTCCTACGAGCAGTACTTC	CASSPATAWTSGNSYEQYF	TRBV3-1	TRBJ2-7
TGCAGTGCTAGAGATGGGGCGGGAAACATTCAGTACTTC	CSARDGAGNIQYF	TRBV20-1	TRBJ2-4
TGTGCCAGCAGCCAAGAGGAGGGGCGTATTCGTAGCTCCTACAATGAGCAGTTCTTC	CASSQEEGRIRSSYNEQFF	TRBV14	TRBJ2-1
TGTGCCACCAGTGATTTGGGTCAGGAACGTGGAGGGGTAAATGAGCAGTTCTTC	CATSDLGQERGGVNEQFF	TRBV24-1	TRBJ2-1
TGTGCCAGCAGCTTAAATCTGACGTTCCATTCACCCCTCCACTTT	CASSLNLTFHSPLHF	TRBV7-4	TRBJ1-6
TGTGCCAGCAGCGTAGCTGAGTCGCGAACAGGGGGTAATCAGCCCCAGCATTTT	CASSVAESRTGGNQPQHF	TRBV9	TRBJ1-5
TGTGCCAGCAGCGTAGCCGAAGAGGAGCAGTTCTTC	CASSVAEEEQFF	TRBV9	TRBJ2-1
TGTGCCAGCACGGACAGGGGAGGTCAGCCCCAGCATTTT	CASTDRGGQPQHF	TRBV7-9	TRBJ1-5
TGTGCCAGCAGCCAACCGGGGGGTACGTTTGAAAGCACAGATACGCAGTATTTT	CASSQPGGTFESTDTQYF	TRBV3-1	TRBJ2-3
TGCAGTGCTAGACACAGGGTTCCGAACACTGAAGCTTTCTTT	CSARHRVPNTEAFF	TRBV20-1	TRBJ1-1
TGTGCCAGCAAGGAAATTAAACTAGCGGGCCCCGGGGAGCTGTTTTTT	CASKEIKLAGPGELFF	TRBV6-5	TRBJ2-2
TGTGCCAGCAGATTGGGGGCGCCGGGCTACGAGCAGTACTTC	CASRLGAPGYEQYF	TRBV6-4	TRBJ2-7
TGTGCCAGCAGCAACTGCACTCGCGGGGAGCTGTTTTTT	CASSNCTRGELFF	TRBV6-5	TRBJ2-2
TGTGCCAGCAGCCTAGCGGGGTACCAAGAAGAGACCCAGTACTTC	CASSLAGYQEETQYF	TRBV13	TRBJ2-5
TGTGCGACTGACAGCTCCTACAATGAGCAGTTCTTC	CATDSSYNEQFF	TRBV6-2	TRBJ2-1
TGTGCCTGGAGTCTAGCGGGGCTGGACGAGCAGTACTTC	CAWSLAGLDEQYF	TRBV30	TRBJ2-7
TGTGCCACCAGTTTAGGGACAGGGGAGGCCTACGAGCAGTACTTC	CATSLGTGEAYEQYF	TRBV24-1	TRBJ2-7
TGTGCCAGCACACGCTGGGGGGCGCAGCCCCAGCATTTT	CASTRWGAQPQHF	TRBV27	TRBJ1-5
TGTGCCAGCAGCTTAGAGATCCACCTCCCAACAGATACGCAGTATTTT	CASSLEIHLPTDTQYF	TRBV11-3	TRBJ2-3
TGTGCCATCACATCGCGGCTGGAGGAGACCCAGTACTTC	CAITSRLEETQYF	TRBV10-3	TRBJ2-5
TGTGCCAGCAGTGGCGACAGGGGGCCTGGAAACACCATATATTTT	CASSGDRGPGNTIYF	TRBV28	TRBJ1-3
TGTGCCAGCCATTCCTGGTCGACTAGCGGGGGGAACACCGGGGAGCTGTTTTTT	CASHSWSTSGGNTGELFF	TRBV13	TRBJ2-2
TGTCGAATCACCAATGGTGTAGGGGCGAACTATGGCTACACCTTC	CRITNGVGANYGYTF	TRBV7-9	TRBJ1-2
TGCAGCGCGCGGGGGGAACGAGCTTTCTTT	CSARGERAFF	TRBV29-1	TRBJ1-1
TGTGCCAGCAGCAAACCGGTGAATGAAAAACTGTTTTTT	CASSKPVNEKLFF	TRBV7-2	TRBJ1-4
TGTGCCAGCAGTTCTGTGGGACAAAAGGGGGAGCCCCAGCATTTT	CASSSVGQKGEPQHF	TRBV28	TRBJ1-5
TGTGCCAGCAGCCTAGGGGTCAAAGATACGCAGTATTTT	CASSLGVKDTQYF	TRBV3-1	TRBJ2-3
TGTGCCACACAGGGGCCGTTTCTCACTGAAGCTTTCTTT	CATQGPFLTEAFF	TRBV10-3	TRBJ1-1
TGCAGTGCTAGAGATCTGGTCAGGGGGCCTGGAAACACCATATATTTT	CSARDLVRGPGNTIYF	TRBV20-1	TRBJ1-3
TGCAGTGCTAGAGATCAATTAGTTGCCCGATACGAGCAGTACTTC	CSARDQLVARYEQYF	TRBV20-1	TRBJ2-7
TGTGCCAGCAGCGTCGGCAGCAGCCTAGACGAGCAGTACTTC	CASSVGSSLDEQYF	TRBV9	TRBJ2-7
TGTGCCAGCAGCCCACAGGGGACAAATGGCTACACCTTC	CASSPQGTNGYTF	TRBV11-2	TRBJ1-2
TGTGCCAGCAGCTTGTGTAGCGGGAGGATTGGATGCCCCGGCTCCTACGAGCAGTACTTC	CASSLCSGRIGCPGSYEQYF	TRBV5-6	TRBJ2-7
TGTGCCAGCAGCTTTCGGCCTAAGTGTCATGGCTACACCTTC	CASSFRPKCHGYTF	TRBV11-2	TRBJ1-2
TGTGCCAGCAGCTTATCAGAAGCAGGGGGCCAAGAGACCCAGTACTTC	CASSLSEAGGQETQYF	TRBV11-2	TRBJ2-5
TGTGCCAGCAGTCCAGGGCCTAGGAGGACTAGCACAGATACGCAGTATTTT	CASSPGPRRTSTDTQYF	TRBV27	TRBJ2-3
TGTGCCAGCAGTTACGACTATGGCTACACCTTC	CASSYDYGYTF	TRBV6-5	TRBJ1-2
TGCAGTGCTCCTCTCGCGGGTAAGGGCTACGAGCAGTACTTC	CSAPLAGKGYEQYF	TRBV20-1	TRBJ2-7
TGTGCCAGTAGTATAGCGCGGACGACCTGTAATGAGACCCAGTACTTC	CASSIARTTCNETQYF	TRBV19	TRBJ2-5
TGTGCCTGGAGCTCGGTCTACGAGCAGTACTTC	CAWSSVYEQYF	TRBV30	TRBJ2-7
TGCAGCGGACAGGGATACGAGCAGTACTTC	CSGQGYEQYF	TRBV29-1	TRBJ2-7
TGTGCCAGCCCCACGGGTAACTACGAGCAGTACTTC	CASPTGNYEQYF	TRBV12-4	TRBJ2-7
TGCGCCAGCAGCAGCGGGAGAAACTTCAGGGGAAACACCATATATTTT	CASSSGRNFRGNTIYF	TRBV5-1	TRBJ1-3
TGTGCCAGCACCTTATTCCTGGGCCGGGACCCTTTCTCTGGAAACACCATATATTTT	CASTLFLGRDPFSGNTIYF	TRBV28	TRBJ1-3
TGTGCCAGCTCACCTTTCGCCACAGGGTTTTATGTCCTTGCTGGCTACACCTTC	CASSPFATGFYVLAGYTF	TRBV18	TRBJ1-2
TGTGCCAGCAGTTACCCGACAGGCTCCGCTAATGAAAAACTGTTTTTT	CASSYPTGSANEKLFF	TRBV6-3	TRBJ1-4
TGTGCCAGCAGCGTAGCACCCGGGACAGTTACCTCTGGAAACACCATATATTTT	CASSVAPGTVTSGNTIYF	TRBV9	TRBJ1-3
TGTGCCAGCAGTTTAGACCGGCGGGATATAGGAAATGAAAAACTGTTTTTT	CASSLDRRDIGNEKLFF	TRBV6-9	TRBJ1-4
TGCGCCACTAGCGGGGAGGAGGAGACCCAGTACTTC	CATSGEEETQYF	TRBV10-1	TRBJ2-5
TGCGCCTCCGACGGACAAGACAGGGGGCGCTCCTACGAGCAGTACTTC	CASDGQDRGRSYEQYF	TRBV10-1	TRBJ2-7
TGCGCCAGCATAACTAGGACAGGGTGTCGAACTGAAGCTTTCTTT	CASITRTGCRTEAFF	TRBV10-2	TRBJ1-1
TGTGCCAGCAGCTTGGAGGGGGGGGGGGGGACCGTCGACTACAATGAGCAGTTCTTC	CASSLEGGGGTVDYNEQFF	TRBV5-4	TRBJ2-1
TGTGCCAGCAGTTCCCGATGCGGAAGGGGCCGGAACACCGGGGAGCTGTTTTTT	CASSSRCGRGRNTGELFF	TRBV27	TRBJ2-2
TGTGCCAGCAGCGGGGACGGAGGGCATGAGCAGTTCTTC	CASSGDGGHEQFF	TRBV7-3	TRBJ2-1
TGTGCCAGCCCCTGGGCGGGACTAGCGGGTAATGAGCAGTTCTTC	CASPWAGLAGNEQFF	TRBV7-9	TRBJ2-1
TGTGCTAGTGGTGGGGGCCCAGGGGTGGTCTCTGGAAACACCATATATTTT	CASGGGPGVVSGNTIYF	TRBV12-5	TRBJ1-3
TGTGCCAGTAGCCGCCCCTCGCTGGGGACTAGCGGGGGTCCATGGCAGTTCTTC	CASSRPSLGTSGGPWQFF	TRBV19	TRBJ2-1
TGCGCCAGCAGCTTAGTGGGACTAGCTAGCACAGATACGCAGTATTTT	CASSLVGLASTDTQYF	TRBV5-1	TRBJ2-3
TGTGCCAGCAGTGTTCCACGCAAATATGGCTACACCTTC	CASSVPRKYGYTF	TRBV6-4	TRBJ1-2
TGCAGTGCGGGACTAGCGGAGCAAGAGACCCAGTACTTC	CSAGLAEQETQYF	TRBV20-1	TRBJ2-5
TGTGCCAGCAGCGGGAATAGACGAGAGAGGAACGAGCAGTACTTC	CASSGNRRERNEQYF	TRBV9	TRBJ2-7
TGCAGTGCTAGTTCGCCCACTGGGGGCGAGAACACTGAAGCTTTCTTT	CSASSPTGGENTEAFF	TRBV20-1	TRBJ1-1
TGTGCCAGCAGATGGGGGGCCTTGTACAATGAGCAGTTCTTC	CASRWGALYNEQFF	TRBV27	TRBJ2-1
TGTGCCAGCAGGGGGGGTCATCACAATGAGCAGTTCTTC	CASRGGHHNEQFF	TRBV6-5	TRBJ2-1
TGTGCCAGCAGCGTACGTCCGGGGGCCACCCCCTACGAGCAGTACTTC	CASSVRPGATPYEQYF	TRBV9	TRBJ2-7
TGTGCCAGCAGTAAATACGGTTCTAAGGAAGGAGGACAGCAGACCGGGGAGCTGTTTTTT	CASSKYGSKEGGQQTGELFF	TRBV27	TRBJ2-2
TGTGCCAGCAGCTGGACAGAAGCCCTCCACTTT	CASSWTEALHF	TRBV6-5	TRBJ1-6
TGTGCCACCAGTCTCCGGGGTAACAATGAAAAACTGTTTTTT	CATSLRGNNEKLFF	TRBV24-1	TRBJ1-4
TGCAGTGCTAGAAGGGGACAGGAGCCTACCGGGAAATATCAGCCCCAGCATTTT	CSARRGQEPTGKYQPQHF	TRBV20-1	TRBJ1-5
TGCAGTGCTAGTACAGGGACAGGGGGCGGTCTAGAGACCCAGTACTTC	CSASTGTGGGLETQYF	TRBV20-1	TRBJ2-5
TGTGCCAGCAGTGTCCTACTAGCGGGCTACGAGCAGTACTTC	CASSVLLAGYEQYF	TRBV2	TRBJ2-7
TGCGCCATGGGCCTCCGGCGCACAGATACGCAGTATTTT	CAMGLRRTDTQYF	TRBV5-1	TRBJ2-3
TGTGCCAGCAGCGTAGCGACAGACCTCGAGCAGTACTTC	CASSVATDLEQYF	TRBV9	TRBJ2-7
TGTGCCAATGGGGCCGGCTCTAACTATGGCTACACCTTC	CANGAGSNYGYTF	TRBV19	TRBJ1-2
TGTGCCAGCAGCTCCCCTCGAGGGGGAAAAGTATTGAGGGACCTTGACGAGCAGTACTTC	CASSSPRGGKVLRDLDEQYF	TRBV7-3	TRBJ2-7
TGTGCCAGCAGCAACGGGACAGGCTCTGCAGATACGCAGTATTTT	CASSNGTGSADTQYF	TRBV7-3	TRBJ2-3
TGTGCCAGCAGTTTGAGGGGGGGATATAATGAGCAGTTCTTC	CASSLRGGYNEQFF	TRBV6-5	TRBJ2-1
TGCGCCAGCAGGGGTCTCCGGGGGGGAGAGACCCAGTACTTC	CASRGLRGGETQYF	TRBV10-1	TRBJ2-5
TGTGCCAGCATTGACAGGGTCTACGAGCAGTACTTC	CASIDRVYEQYF	TRBV12-4	TRBJ2-7
TGTGCCCCCGGGATATGCTCCACCGGGGAGCTGTTTTTT	CAPGICSTGELFF	TRBV2	TRBJ2-2
TGCAGTGCTAGAGGCTTGGGGCACCGTAATGAAAAACTGTTTTTT	CSARGLGHRNEKLFF	TRBV20-1	TRBJ1-4
TGTGCCAGCAGCTTAGGTGTGCGGGCAAATGAGCAGTACTTC	CASSLGVRANEQYF	TRBV7-2	TRBJ2-7
TGTGCCAGCAGTTACTATACAGTGTACAACAGGGGGCCAAGCTCCTACAATGAGCAGTTCTTC	CASSYYTVYNRGPSSYNEQFF	TRBV27	TRBJ2-1
TGTGCCAGCAGCCCAGTGGCAGGGCCGCAGCCCCAGCATTTT	CASSPVAGPQPQHF	TRBV7-3	TRBJ1-5
TGTGCCAGCAGCTGGACAGGGCCGTATCAGCCCCAGCATTTT	CASSWTGPYQPQHF	TRBV13	TRBJ1-5
TGTGCCTGGACCCCAGGGGCAACTAGCTCCTACGAGCAGTACTTC	CAWTPGATSSYEQYF	TRBV30	TRBJ2-7
TGTGCCTGGAGTGCTCTCCGGGGGCCGAGCTCCTACAATGAGCAGTTCTTC	CAWSALRGPSSYNEQFF	TRBV30	TRBJ2-1
TGTGCCCGGGTGTCAGGGATATACGAGCAGTACTTC	CARVSGIYEQYF	TRBV28	TRBJ2-7
TGTGCCACCAGTGTTTTGTGTGACTATTGCGATTACCGGACCCAGCATTTT	CATSVLCDYCDYRTQHF	TRBV24-1	TRBJ1-5
TGTGCCAGCAGTCCGCCACGGGGGGCCCCCCCCCCCTCCTACGAGCAGTACTTC	CASSPPRGAPPPSYEQYF	TRBV6-5	TRBJ2-7
TGTGCCAGCAGTTTCATGGGAGGGTACGAGCAGTACTTC	CASSFMGGYEQYF	TRBV6-4	TRBJ2-7
