TGCGCCAGCAGTGAGCTCAAACAGGTACGAACTAATGAAAAACTGTTTTTT	CASSELKQVRTNEKLFF	TRBV10-1	TRBJ1-4
TGTGCCAGCAGTGGCAGAGGGGGGGTGAACGAGCAGTACTTC	CASSGRGGVNEQYF	TRBV28	TRBJ2-7
TGTGCCATCAGAGAGGGGGACCGACAGGAAGCTTTCTTT	CAIREGDRQEAFF	TRBV10-3	TRBJ1-1
TGTGCCATCAGTGCCCTCGGACGGTCGGTATACGAGCAGTACTTC	CAISALGRSVYEQYF	TRBV10-3	TRBJ2-7
TGTGCCAGCTCTTCCCTACCGGGACAGCCTATTAAAGCCCAGCATTTT	CASSSLPGQPIKAQHF	TRBV14	TRBJ1-5
TGTGCCAGCAGCCGCGACAATGAGCAGTTCTTC	CASSRDNEQFF	TRBV28	TRBJ2-1
TGTGCCAGCAGTTACAACCGGGACTATCACTTC	CASSYNRDYHF	TRBV6-3	TRBJ2-7
TGTGCCAGCAGCCAAATAGCTAGCGGGCACGAGCAGTACTTC	CASSQIASGHEQYF	TRBV13	TRBJ2-7
TGTGCCAGCTCTCAAAGAGGGCGCGTAAGCTCCTACGAGCAGTACTTC	CASSQRGRVSSYEQYF	TRBV11-3	TRBJ2-7
TGTGCCCCCGACAGGGGCAATCAGCCCCAGCATTTT	CAPDRGNQPQHF	TRBV6-5	TRBJ1-5
TGTGCCAGCAGCTTGCAGGACGGGTACGAGCAGTACTTC	CASSLQDGYEQYF	TRBV5-6	TRBJ2-7
TGTGCCAGCAGCGCCAAGCTATTGACCCACGAGCAGTACTTC	CASSAKLLTHEQYF	TRBV7-2	TRBJ2-7
TGTGCCAGCACACCCCCTTTCGCGGCGGTGGGTGCCGCCTACGAGCAGTACTTC	CASTPPFAAVGAAYEQYF	TRBV6-4	TRBJ2-7
TGCGCCAGCAGTGAGGAGCGGACAGGGCCCAATCAGCCCCAGCATTTT	CASSEERTGPNQPQHF	TRBV10-2	TRBJ1-5
TGTGCCAGCAGCTTAGGACCGGGACTAGCGGGGGGTTCAAATGAGCAGTTCTTC	CASSLGPGLAGGSNEQFF	TRBV11-3	TRBJ2-1
TGCGCCAGCTCCGGGTCCCAGGAAACCTACAATGAGCAGTTCTTC	CASSGSQETYNEQFF	TRBV5-1	TRBJ2-1
TGTGCCAGCAGCTTATGTTCACCACAGGGGGGGAATCAGCCCCAGCATTTT	CASSLCSPQGGNQPQHF	TRBV11-3	TRBJ1-5
TGCAGTGCTAGAGTGGGGGGACGAGGCACAGATACGCAGTATTTT	CSARVGGRGTDTQYF	TRBV20-1	TRBJ2-3
TGTGCCTCCCGTAACAGGGGGTTCCCCTACGAGCAGTACTTC	CASRNRGFPYEQYF	TRBV30	TRBJ2-7
TGTGCCAGCAGCCTTCGAGAGGGACAGCCTCAGCCCCAGCATTTT	CASSLREGQPQPQHF	TRBV13	TRBJ1-5
TGTGCCAGCAGTTACTTGGGCCCTGGAAATGACTCCTACGAGCAGTACTTC	CASSYLGPGNDSYEQYF	TRBV6-5	TRBJ2-7
TGTGCCAGCAGTGAATTTGACGCGAGAGAGACCCAGTACTTC	CASSEFDARETQYF	TRBV2	TRBJ2-5
TGTGCCAGCAGCCAGGGGAGGATAGACAATGAGCAGTTCTTC	CASSQGRIDNEQFF	TRBV7-9	TRBJ2-1
TGTGCCAGCAGCATGGGCCGTCGACAGGCGAGTATGAACACTGAAGCTTTCTTT	CASSMGRRQASMNTEAFF	TRBV7-9	TRBJ1-1
TGCGCCAGCAGCCAGGGGGGGCAGGAACTTTTACTAGCCAAAAACATTCAGTACTTC	CASSQGGQELLLAKNIQYF	TRBV4-3	TRBJ2-4
TGCGCCACGACACTAGCGGGAGATCTCGGCTCCTACAATGAGCAGTTCTTC	CATTLAGDLGSYNEQFF	TRBV10-1	TRBJ2-1
TGTGCCAGCAGCCAAGCTGCTAGCCCCGACTACGAGCAGTACTTC	CASSQAASPDYEQYF	TRBV3-1	TRBJ2-7
TGTGCCAGTCGGGGGCTCCCCCAGCATTTT	CASRGLPQHF	TRBV19	TRBJ1-5
TGTGCCAGCAGTGAAAGAGGGAATTCACCCCTCCACTTT	CASSERGNSPLHF	TRBV25-1	TRBJ1-6
TGTGCCAGCAGCGAATGTGACAGCATCTCGGGGGAAGCTTTCTTT	CASSECDSISGEAFF	TRBV11-2	TRBJ1-1
TGTGCCAGCAGCCAAGATCCTCGTTATGAGACAATAAAACTGTTTTTT	CASSQDPRYETIKLFF	TRBV14	TRBJ1-4
TGTGCCAGCAGTCGAGGGAGGAATGTGGGGCCCCAGCATTTT	CASSRGRNVGPQHF	TRBV28	TRBJ1-5
TGTGCCAGCAGTTACCTGACAGGGACCCGCTATGGCTACACCTTC	CASSYLTGTRYGYTF	TRBV6-6	TRBJ1-2
TGTGCCACCAGTGATCTAAGGACTTTAGCTTTCTTT	CATSDLRTLAFF	TRBV24-1	TRBJ1-1
TGCAGCGATGACAGTGACACTGAAGCTTTCTTT	CSDDSDTEAFF	TRBV29-1	TRBJ1-1
TGTGCCAGCAGCCAAGATGGAGACTGTGGGATGGATACGCAGTATTTT	CASSQDGDCGMDTQYF	TRBV3-1	TRBJ2-3
TGTGCCATCACACCATATCTTCAAAGTAGGACAGGGCTAAACCAGAACTACGAGCAGTACTTC	CAITPYLQSRTGLNQNYEQYF	TRBV10-3	TRBJ2-7
TGTGCCAGCAGCCCTCTCCCCGAGGCGCATACTTCCTACAATGAGCAGTTCTTC	CASSPLPEAHTSYNEQFF	TRBV5-5	TRBJ2-1
TGTGCCAGCAGCCCATTACTAGCGGGAGTAACCCTCCGCAATCAGCCCCAGCATTTT	CASSPLLAGVTLRNQPQHF	TRBV7-8	TRBJ1-5
TGCGCCAATGTCCCACAGGGGGAACTAGTTAGTAGCAATCAGCCCCAGCATTTT	CANVPQGELVSSNQPQHF	TRBV10-1	TRBJ1-5
TGTGCCAGCAGGGCGGACAGGATAAAAGAGACCCAGTACTTC	CASRADRIKETQYF	TRBV6-5	TRBJ2-5
TGTGCCAGTATCCGACTGGTGTATCAGCCCCAGCATTTT	CASIRLVYQPQHF	TRBV3-1	TRBJ1-5
TGCAGTGCGCCGGACAGGGATGCTTTCTTT	CSAPDRDAFF	TRBV20-1	TRBJ1-1
TGTGCCAGCAAGAAGAGGACAGGGGGAGGGAAACGCAATCAGCCCCAGCATTTT	CASKKRTGGGKRNQPQHF	TRBV13	TRBJ1-5
TGTGCCAGGTTTACAGGGGTAAGAGGCACTGAAGCTTTCTTT	CARFTGVRGTEAFF	TRBV6-6	TRBJ1-1
TGTGCCAGCAGCACAGCCCCTCGCCGGGACGGCGATCCGTGGATCGGGGAGCTGTTTTTT	CASSTAPRRDGDPWIGELFF	TRBV13	TRBJ2-2
TGCGCCAGCAGTGGGACAGGGAGCTACGAGCAGTACTTC	CASSGTGSYEQYF	TRBV10-2	TRBJ2-7
TGTGCCTGGAGTGTACGGCCCAGGGGGAGTTCCTGGTATAGCAATCAGCCCCAGCATTTT	CAWSVRPRGSSWYSNQPQHF	TRBV30	TRBJ1-5
TGTGCCACCACAGGGACGGTCGGAGGGTATAGCAATCAGCCCCAGCATTTT	CATTGTVGGYSNQPQHF	TRBV24-1	TRBJ1-5
TGTGCCAGCAGTTTCCGCCTACCGACCTACGAGCAGTACTTC	CASSFRLPTYEQYF	TRBV27	TRBJ2-7
TGTGCCAGCAGCGAGCGCAGGGAACAAGAGACCCAGTACTTC	CASSERREQETQYF	TRBV9	TRBJ2-5
TGTGCCAGCAGTAATAGCGACCGTTTCGTTGGGGCCAACGTCCTGACTTTC	CASSNSDRFVGANVLTF	TRBV6-4	TRBJ2-6
TGTGCCAGCAGTTTATGGGTTTCAGGGGGCAACACTGAAGCTTTCTTT	CASSLWVSGGNTEAFF	TRBV12-4	TRBJ1-1
TGCGCCAGCAGCTTCCGGGGGCGCGGGGAGCTGTTTTTT	CASSFRGRGELFF	TRBV5-1	TRBJ2-2
TGTGCCAGCTCCGACCGACCGCAAGAGACCCAGTACTTC	CASSDRPQETQYF	TRBV6-1	TRBJ2-5
TGCAGTGTAGAGGGACCCGAGCAGTACTTC	CSVEGPEQYF	TRBV20-1	TRBJ2-7
TGTGCCAGGAAGAGGCTACTAGCGGGAGGGCTGAGGAATGAAGCTTTCTTT	CARKRLLAGGLRNEAFF	TRBV19	TRBJ1-1
TGTGCCACCAGCGCGGGAGGGAAAAACGAGCAGTACTTC	CATSAGGKNEQYF	TRBV15	TRBJ2-7
TGTGCCAGCAGGGACTTGCCTCGTTTACGACAGGGGGCGGGACCCCAGCATTTT	CASRDLPRLRQGAGPQHF	TRBV28	TRBJ1-5
TGTGCCAGCTCACCACAACCGGGGGGGTCGGAGGTCTACGAGCAGTACTTC	CASSPQPGGSEVYEQYF	TRBV18	TRBJ2-7
TGCGCCAGCAGCTTGGTCTACAGGACAGGGGGCGGTACCTACGAGCAGTACTTC	CASSLVYRTGGGTYEQYF	TRBV5-1	TRBJ2-7
TGTGCCATCGCAGTAAACACCGGGGAGCTGTTTTTT	CAIAVNTGELFF	TRBV10-3	TRBJ2-2
TGTGCCAGCAGCTTGGTACAGAATAGCAATCAGCCCCAGCATTTT	CASSLVQNSNQPQHF	TRBV5-5	TRBJ1-5
TGTGCCTGGAGTGTACCCGCTAGCGGGGGATACGAGCAGTACTTC	CAWSVPASGGYEQYF	TRBV30	TRBJ2-7
TGTGCCACCAGTGATGGGGGACAGGCACAGCCCCAGCATTTT	CATSDGGQAQPQHF	TRBV24-1	TRBJ1-5
TGTGCCAGCCAGCGTTCCGGTGAGCAGTTCTTC	CASQRSGEQFF	TRBV27	TRBJ2-1
TGTGCTACGGTCGCTCAGTCCTACGAGCAGTACTTC	CATVAQSYEQYF	TRBV30	TRBJ2-7
TGTGCCAGCAGTTTGGGCCCCCGGAGGGGCGAGAACACTGAAGCTTTCTTT	CASSLGPRRGENTEAFF	TRBV28	TRBJ1-1
TGTGCCAGCAAGGAGGACAGGGGCAAGCAACCCGTGAACACTGAAGCTTTCTTT	CASKEDRGKQPVNTEAFF	TRBV27	TRBJ1-1
TGTGCCAGCAGCTTAAAACTAGCGGGAGAGCGGGATCAGCCCCAGCATTTT	CASSLKLAGERDQPQHF	TRBV7-2	TRBJ1-5
TGTGCCAGCAGCCAAGGAGATCTGTTACGTGAGAAGGGCTCCTACGAGCAGTACTTC	CASSQGDLLREKGSYEQYF	TRBV3-1	TRBJ2-7
TGTGCCAGCATGCGGGGGGTACCATACGAGCAGTACTTC	CASMRGVPYEQYF	TRBV7-9	TRBJ2-7
TGTGCCAGCAGATTCAGGGGGCAGATCATGCAGTACTTC	CASRFRGQIMQYF	TRBV7-3	TRBJ2-7
TGTGCCCGGGACAGGGAAAAACTGTTTTTT	CARDREKLFF	TRBV7-3	TRBJ1-4
TGTGCCACCAATGATGACAGGGAGGGGCTGGATACCGGGGCCAACGTCCTGACTTTC	CATNDDREGLDTGANVLTF	TRBV24-1	TRBJ2-6
TGTGCCAGCGTTCGGACAGGGGGCTCTGGAAACACCATATATTTT	CASVRTGGSGNTIYF	TRBV10-3	TRBJ1-3
TGTGCCAACAGGAGACAGGGAAAGGAGAACACTGAAGCTTTCTTT	CANRRQGKENTEAFF	TRBV6-4	TRBJ1-1
TGTGCCAGCCGCCGGGACCCGAACACTGAAGCTTTCTTT	CASRRDPNTEAFF	TRBV6-1	TRBJ1-1
TGCAGTGCGAGGGGGACTGGGGCCAACGTCCTGACTTTC	CSARGTGANVLTF	TRBV20-1	TRBJ2-6
TGTGCCAGCAGCATCCTTGGGGACTCCTACGAGCAGTACTTC	CASSILGDSYEQYF	TRBV7-3	TRBJ2-7
TGCGCCAGCAGCTTGGAGCTTCGGACAGGGGGCGAGCAGTACTTC	CASSLELRTGGEQYF	TRBV5-1	TRBJ2-7
TGTGCCAGCAGATATAAACCGAAACCGGGGGCCCCTGAAAAACTGTTTTTT	CASRYKPKPGAPEKLFF	TRBV6-2	TRBJ1-4
TGCGCCGACGGAGGGACAGCCTACGAGCAGTACTTC	CADGGTAYEQYF	TRBV5-1	TRBJ2-7
TGCAGTCAGAGGACCGCAGAGAAGCAGTATTTT	CSQRTAEKQYF	TRBV20-1	TRBJ2-3
TGTGCCAGCAGCGCACAGGGGTACGAGCAGTACTTC	CASSAQGYEQYF	TRBV7-9	TRBJ2-7
TGTGCCAGCAGTTGGGGGGGGCGGTTCACCTCTGGGGCCAACGTCCTGACTTTC	CASSWGGRFTSGANVLTF	TRBV27	TRBJ2-6
TGTGCCAGCAGTCCAGGGAGGCGGGAGAACACCGGGGAGCTGTTTTTT	CASSPGRRENTGELFF	TRBV27	TRBJ2-2
TGTGCCAGCAGCCCAGCCGGGACTAGCGTAAAAGATACGCAGTATTTT	CASSPAGTSVKDTQYF	TRBV7-9	TRBJ2-3
TGTGCCAGCAGCCGGAGGGATCCGGGTTACGAGCAGTACTTC	CASSRRDPGYEQYF	TRBV13	TRBJ2-7
TGTGCCAGCAGCTCCGAGAAGACTAGCGGGTACGAGCAGTACTTC	CASSSEKTSGYEQYF	TRBV11-2	TRBJ2-7
TGTGCCAGCAGCACAGGGGGCCCTTCGAACACTGAAGCTTTCTTT	CASSTGGPSNTEAFF	TRBV9	TRBJ1-1
TGTGCCAGCAGCAATCATACTAGCGGGAGGGCTGAGTACTTC	CASSNHTSGRAEYF	TRBV13	TRBJ2-5
TGTGCCAGTAGTAAAGATTCTGACAGGGCGGGTGGGGGCTATGGCTACACCTTC	CASSKDSDRAGGGYGYTF	TRBV19	TRBJ1-2
TGTGCCTGGTGGGGCGGGACAGGGCTTGCGGGTAATGTGGATCAGCCCCAGCATTTT	CAWWGGTGLAGNVDQPQHF	TRBV30	TRBJ1-5
TGTGCCAGCAGTTGTTCGGGGCAGCCCCAGCATTTT	CASSCSGQPQHF	TRBV27	TRBJ1-5
TGCAGCCAAACCGGAGCGGCCGGGACAGGGTGCTGCTCCTACGAGCAGTACTTC	CSQTGAAGTGCCSYEQYF	TRBV29-1	TRBJ2-7
TGTGCCAGCAGAGCCAAGACTTACAATGAGCAGTTCTTC	CASRAKTYNEQFF	TRBV6-6	TRBJ2-1
TGTGCCAGCTCACGTGGGGGGGCCGAACTCGTTAAGATTAATGAGCAGTTCTTC	CASSRGGAELVKINEQFF	TRBV18	TRBJ2-1
TGTGCCAGCAGTTTGGGACGAGGGAAGACCCAGTACTTC	CASSLGRGKTQYF	TRBV27	TRBJ2-5
TGCAGTGAGGAAGGGCAGCTACATGGAAACACCATATATTTT	CSEEGQLHGNTIYF	TRBV20-1	TRBJ1-3
TGTGCCAAGTACTCGTCCCCCCTCAGGGGGAACACCGGGGAGCTGTTTTTT	CAKYSSPLRGNTGELFF	TRBV6-3	TRBJ2-2
TGTGCCAGCAGTTTTACACTGACAGGGAGCAACAGGGGCTACGAGCAGTACTTC	CASSFTLTGSNRGYEQYF	TRBV6-2	TRBJ2-7
TGTGCCAGCAGTTTCCAAAGCAGCCATACGGGGTCCAAAAACATTCAGTACTTC	CASSFQSSHTGSKNIQYF	TRBV27	TRBJ2-4
TGTGCTAGTGGTTTGCGGGAATTTGTACCACCCCCGGGACAGGGCCCGACGCAAGAGACCCAGTACTTC	CASGLREFVPPPGQGPTQETQYF	TRBV12-5	TRBJ2-5
TGCAGTGCACAGGGTTTATACGAGCAGTACTTC	CSAQGLYEQYF	TRBV20-1	TRBJ2-7
TGCGCCAGCCTACAGGGAGGGATGACATTCTTC	CASLQGGMTFF	TRBV4-3	TRBJ2-1
TGTGCCAGCAGCAAACCGTATCGGGGCGCCCAGCATTTT	CASSKPYRGAQHF	TRBV5-6	TRBJ1-5
TGTGCCAGCAGTTACTCGCCGGGTCTTAGCGGGGAAGTCAATGAGCAGTTCTTC	CASSYSPGLSGEVNEQFF	TRBV6-2	TRBJ2-1
TGTGCCAGCAGTTTAAGGAGGGTACGAAAAGGCTACACCTTC	CASSLRRVRKGYTF	TRBV27	TRBJ1-2
TGTGCCAGCAGCCGGGACTGGAGGGAGCCCTACGAGCAGTACTTC	CASSRDWREPYEQYF	TRBV13	TRBJ2-7
TGTGCCAGCAGTTATCCAGACTACGAGCAGTACTTC	CASSYPDYEQYF	TRBV6-2	TRBJ2-7
TGCGCCAGCATTCCCTACCGGCAGACCGGGGAGCTGTTTTTT	CASIPYRQTGELFF	TRBV5-1	TRBJ2-2
TGTGCCAGCAGCAAACTAGATGTCACAGATACGCAGTATTTT	CASSKLDVTDTQYF	TRBV5-4	TRBJ2-3
TGTGCCAGCAGGAGGGTCAGCTCTGGGGCCAACGTCCTGACTTTC	CASRRVSSGANVLTF	TRBV7-9	TRBJ2-6
TGTGCCAGCAGTCCACAGGCTATCAAGCAAATTGCGGTCACTGAAGCTTTCTTT	CASSPQAIKQIAVTEAFF	TRBV6-1	TRBJ1-1
TGTGCCACCAGCAGAGTCCCGAAGGACCCCGGGACGGAAAAACTGTTTTTT	CATSRVPKDPGTEKLFF	TRBV15	TRBJ1-4
TGTGCCAGCGGGGGGGTAGTGTACAATGAGCAGTTCTTC	CASGGVVYNEQFF	TRBV2	TRBJ2-1
TGCGCCAGCAGCCAAGATGGGCCCGGACAGGGGAACTATGGCTACACCTTC	CASSQDGPGQGNYGYTF	TRBV4-3	TRBJ1-2
TGTGCCACCAGCTTGGCCGGTCCTAGGGCGTTATCCTACGAGCAGTACTTC	CATSLAGPRALSYEQYF	TRBV15	TRBJ2-7
TGTGCCAGCAGCTTAACTACGCGGGAGCCAATCACAGATACGCAGTATTTT	CASSLTTREPITDTQYF	TRBV7-3	TRBJ2-3
TGCAGTGCGCCCATACGCCCGGGACTAGGGGGCGAGCAGTACTTC	CSAPIRPGLGGEQYF	TRBV20-1	TRBJ2-7
TGTGCCACCAGCAGAGATACCGGGGTACACAACACTGAAGCTTTCTTT	CATSRDTGVHNTEAFF	TRBV15	TRBJ1-1
TGCGCCAGCAACCGCCCCAACGACAGACCTTCCTACGAGCAGTACTTC	CASNRPNDRPSYEQYF	TRBV10-2	TRBJ2-7
TGCGCCAGCAGCACCGGGGTGAACACTGAAGCTTTCTTT	CASSTGVNTEAFF	TRBV5-1	TRBJ1-1
TGCAGTGCTAGAATCGGATCTGGCAGGGTTCACTATGGCTACACCTTC	CSARIGSGRVHYGYTF	TRBV20-1	TRBJ1-2
TGCAGTGCTAGAGTTGCGATAGCCTACAATGAGCAGTTCTTC	CSARVAIAYNEQFF	TRBV20-1	TRBJ2-1
TGTGCCAGCAATGTACCCCAGGACAGGGGTAGGGACACCATATATTTT	CASNVPQDRGRDTIYF	TRBV7-2	TRBJ1-3
TGTGCCAGCACCCCTCGGACACGGTTCTACGAGCAGTACTTC	CASTPRTRFYEQYF	TRBV6-4	TRBJ2-7
TGTGCCAGCAGTCGCCCTCTGGACGGGTATAACTATGGCTACACCTTC	CASSRPLDGYNYGYTF	TRBV6-5	TRBJ1-2
TGTGCCAAGGGGGGGTGGGGGAAGAACACTGAAGCTTTCTTT	CAKGGWGKNTEAFF	TRBV6-4	TRBJ1-1
TGTGCCAGCCCTCCTAGCGGGACCAGGGGTCAAGAGACCCAGTACTTC	CASPPSGTRGQETQYF	TRBV25-1	TRBJ2-5
TGTGCCAGCAGTGACAGGGATGGCTACACCTTC	CASSDRDGYTF	TRBV6-1	TRBJ1-2
TGTGCCAGCACGAGGGGGGCGACCTCTGGGGCCAACGTCCTGACTTTC	CASTRGATSGANVLTF	TRBV12-3	TRBJ2-6
TGTGCCATCAGTGAGTCGTCCCCCTATATCAAGGGCCTCGGGAATAGCAATCAGCCCCAGCATTTT	CAISESSPYIKGLGNSNQPQHF	TRBV10-3	TRBJ1-5
TGCAGTGCTACAGAGCCTACGATCGGGTGCGAGCAGTACTTC	CSATEPTIGCEQYF	TRBV20-1	TRBJ2-7
TGTGCCAGCAGCTTACGAGCAGCAGATACGCAGTATTTT	CASSLRAADTQYF	TRBV5-5	TRBJ2-3
TGTGCCAGCAGTCTCACTGGACAGGGGGTCTTC	CASSLTGQGVF	TRBV6-2	TRBJ2-1
TGCGCCAGCAGCCAACCTAGCGGGAAAGCCTACGAGCAGTACTTC	CASSQPSGKAYEQYF	TRBV4-1	TRBJ2-7
TGTGCCAGCAGCACGTACGAGCAGTACTTC	CASSTYEQYF	TRBV11-2	TRBJ2-7
TGCGCCAGCAGCCAAGAACTAACTGGACAGGGAAGGGCCAACGTCCTGACTTTC	CASSQELTGQGRANVLTF	TRBV4-3	TRBJ2-6
TGTGCCAGCAGTTTGGGGGGGGGGGACAAAAACATTCAGTACTTC	CASSLGGGDKNIQYF	TRBV12-3	TRBJ2-4
TGTGCCAGACAGGAGTTGAACACTGAAGCTTTCTTT	CARQELNTEAFF	TRBV7-2	TRBJ1-1
TGTGCCACCCCTAGCGGAGAGACCCAGTACTTC	CATPSGETQYF	TRBV27	TRBJ2-5
TGTGCCAGCAGGGGAGGGACAGGGGATTTTGATACGCAGTATTTT	CASRGGTGDFDTQYF	TRBV6-1	TRBJ2-3
TGTGCCAGCAGCTGGCTAGCCCATGAGCAGTTCTTC	CASSWLAHEQFF	TRBV11-3	TRBJ2-1
TGTGCCAGCAGTTGCCCTCCGGACGGCTCCTACGAGCAGTACTTC	CASSCPPDGSYEQYF	TRBV2	TRBJ2-7
TGTGCCAGCAGCTTAAGGCCGGGACTAGCGGCCGAAGGTGGTTTCACCGGGGAGCTGTTTTTT	CASSLRPGLAAEGGFTGELFF	TRBV7-4	TRBJ2-2
TGTGCCAGCACAAGTCCCCCCACAGGGGACACAGATACGCAGTATTTT	CASTSPPTGDTDTQYF	TRBV13	TRBJ2-3
TGTGCCAGCAGCTTACGAGACCGACACACTCGGTACGAGCAGTACTTC	CASSLRDRHTRYEQYF	TRBV7-9	TRBJ2-7
TGTGCCAGCAGCGAAATGGGGGGGGCCATACGGGAAGAGACCCAGTACTTC	CASSEMGGAIREETQYF	TRBV13	TRBJ2-5
TGTGCCAGCAGCTTCCCTCCGGGACGGGGGGGCTACACCTTC	CASSFPPGRGGYTF	TRBV7-3	TRBJ1-2
TGTGCCAGCAGCTTCTATGGTAGCGGGAGAGCTAGCACAGATACGCAGTATTTT	CASSFYGSGRASTDTQYF	TRBV5-8	TRBJ2-3
TGTGCCAGCTCAGGGACAGGGAGCCTGCATAGCAATCAGCCCCAGCATTTT	CASSGTGSLHSNQPQHF	TRBV18	TRBJ1-5
TGCGCCAGCAATTCAGGGGGTCTCGAGACCCAGTACTTC	CASNSGGLETQYF	TRBV4-1	TRBJ2-5
TGTGCCAGCAGTTTCATCAGGGCGAGATTCCATCAGCCCCAGCATTTT	CASSFIRARFHQPQHF	TRBV28	TRBJ1-5
TGTGCCAGCAGAAAGGGGGGGGAAGCTTTCTTT	CASRKGGEAFF	TRBV2	TRBJ1-1
TGCGCCAGCAGTCAGGGTTACGAGCAGTACTTC	CASSQGYEQYF	TRBV5-1	TRBJ2-7
TGTGCCACGGACAGGGGCTATGGCTACACCTTC	CATDRGYGYTF	TRBV24-1	TRBJ1-2
TGCAGTGCTAGAGATAATGCAAATAACTATGGCTACACCTTC	CSARDNANNYGYTF	TRBV20-1	TRBJ1-2
TGTGCCACCGACAGGGGGCGCGTCGGACACGAGCAGTACTTC	CATDRGRVGHEQYF	TRBV24-1	TRBJ2-7
TGCAGTGCAAATTACAGGGGCAAAGAAGCTTTCTTT	CSANYRGKEAFF	TRBV20-1	TRBJ1-1
TGTGCCAGCAGTGTCTCCAGGGACCCACCAAACTACGAGCAGTACTTC	CASSVSRDPPNYEQYF	TRBV28	TRBJ2-7
TGTGCTAGTGGTTTGGTAACCCCGGGACAGGGGAGATTTAACTATGGCTACACCTTC	CASGLVTPGQGRFNYGYTF	TRBV12-5	TRBJ1-2
TGTGCCAGCAGTTACACTTTTCGGGACCGAAGCTCCTACGAGCAGTACTTC	CASSYTFRDRSSYEQYF	TRBV6-5	TRBJ2-7
TGTGCCATGCACCTCAGGGACGGACCGGAGGTAGCCAAAAACATTCAGTACTTC	CAMHLRDGPEVAKNIQYF	TRBV2	TRBJ2-4
TGCGCCAGCAGCCGGGGCAACAATGAGCAGTTCTTC	CASSRGNNEQFF	TRBV5-1	TRBJ2-1
TGTGCCAGCAGCAAGTCAGGGCGGGTAGGAACCAAAAACTATGGCTACACCTTC	CASSKSGRVGTKNYGYTF	TRBV13	TRBJ1-2
TGTGCCAGCAGCTGTCAGGGACTAGCGGACAGGAGTGGCTCCTACAATGAGCAGTTCTTC	CASSCQGLADRSGSYNEQFF	TRBV5-5	TRBJ2-1
TGCGCCAGCAGCTTGGGGGCACAGGGCCCACCCCTCCACTTT	CASSLGAQGPPLHF	TRBV5-1	TRBJ1-6
TGTGCCAGCAGCTTAGAATGGACAGTGCTCAATCAGCCCCAGCATTTT	CASSLEWTVLNQPQHF	TRBV7-6	TRBJ1-5
TGTGCCAGCAGTTTGTGGACTTGTTCCTACAATGAGCAGTTCTTC	CASSLWTCSYNEQFF	TRBV27	TRBJ2-1
TGTGCTAGCAGACGGGCGGGGGATCAGCCCCAGCATTTT	CASRRAGDQPQHF	TRBV7-7	TRBJ1-5
TGCGCCAGCAGTGGGAAGGTTGACAGGGAGGGGGATGAAGCTTTCTTT	CASSGKVDREGDEAFF	TRBV5-1	TRBJ1-1
TGTGCCAGCGGAGTAGACAGACCCAATGAGCAGTTCTTC	CASGVDRPNEQFF	TRBV6-1	TRBJ2-1
TGTGCCAGCAGTCCAAGGCCTACGGGGATAATCCCGAATCAGCCCCAGCATTTT	CASSPRPTGIIPNQPQHF	TRBV27	TRBJ1-5
TGTGCCAGCAGTTGGCATGGCGAGCAGTACTTC	CASSWHGEQYF	TRBV27	TRBJ2-7
TGTGCCAGCAGTTACATGGGGCGTTTCGAGCAGTACTTC	CASSYMGRFEQYF	TRBV6-8	TRBJ2-7
TGTGCCAGCAGTGAACCTTTTAGGGCCCTCCCGAACACCGGGGAGCTGTTTTTT	CASSEPFRALPNTGELFF	TRBV6-1	TRBJ2-2
TGCGCCAGCAGCTTGTCAGTGGGGAACTACGAGCAGTACTTC	CASSLSVGNYEQYF	TRBV5-1	TRBJ2-7
TGCAGCACCCAAACAGGGACCGCCCGGGTCCAAGAGACCCAGTACTTC	CSTQTGTARVQETQYF	TRBV10-1	TRBJ2-5
TGCAGTGCCCGCGGGCCAAAACAGGGCTCTGGAAACACCATATATTTT	CSARGPKQGSGNTIYF	TRBV20-1	TRBJ1-3
TGTGCCAGCAGCAACCTGATACGGGACAGAGCCCGGGGGAACAGCTCCTACGAGCAGTACTTC	CASSNLIRDRARGNSSYEQYF	TRBV11-2	TRBJ2-7
TGTGCCAGCAGACAAGGAGGGGGGATCCCGGCCAACACTGAAGCTTTCTTT	CASRQGGGIPANTEAFF	TRBV6-5	TRBJ1-1
TGTGCCAGCAGCCTAACAGGCCTGGCCTATAATTCACCCCTCCACTTT	CASSLTGLAYNSPLHF	TRBV12-4	TRBJ1-6
TGTGCCAGCAGCTCAACTTTTCGGGGGCGGAGCAATCAGCCCCAGCATTTT	CASSSTFRGRSNQPQHF	TRBV11-3	TRBJ1-5
TGTGCCAGCAGCGGGTTGGGTAGACAGGGGGCCCCCAACTCTGGAAACACCATATATTTT	CASSGLGRQGAPNSGNTIYF	TRBV7-9	TRBJ1-3
TGCAGTGAGGGTGAGGCTGGGGCCAACGTCCTGACTTTC	CSEGEAGANVLTF	TRBV20-1	TRBJ2-6
TGTGCTAGTGGCCCAGAGGGGATCACAGATACGCAGTATTTT	CASGPEGITDTQYF	TRBV12-5	TRBJ2-3
TGTGCCAGCTCACGAACTAGTGGGGCCAACGTCCTGACTTTC	CASSRTSGANVLTF	TRBV18	TRBJ2-6
TGCGCCAGCAGCCAACCCCTCGGGGGTAACACGAACACTGAAGCTTTCTTT	CASSQPLGGNTNTEAFF	TRBV4-1	TRBJ1-1
TGTGCCAGCAGCAACCCCCAGGGGACTAGCGGGGCTCCCTACGAGCAGTACTTC	CASSNPQGTSGAPYEQYF	TRBV13	TRBJ2-7
TGTGCCAGCAGTTACAGAATGGGGGAGGCACGTAGCACAGATACGCAGTATTTT	CASSYRMGEARSTDTQYF	TRBV6-2	TRBJ2-3
TGCAGTGCTGAACACAGGGGTCTGAACACTGAAGCTTTCTTT	CSAEHRGLNTEAFF	TRBV20-1	TRBJ1-1
TGTGCCAGCAGGGGAGGGGACAGGGGGCGATACGAGCAGTACTTC	CASRGGDRGRYEQYF	TRBV11-1	TRBJ2-7
TGCGCCAGCAGCCAAGTGAGCTGTCCCCGGGACAGGGCCAGAGAGCAGTACTTC	CASSQVSCPRDRAREQYF	TRBV4-1	TRBJ2-7
TGCAGTCGAAGGCTAGCAGACGAGCAGTACTTC	CSRRLADEQYF	TRBV20-1	TRBJ2-7
TGTGCCAGCAGCCAACATCCCCCCCGGGAGGACACTGAAGCTTTCTTT	CASSQHPPREDTEAFF	TRBV3-1	TRBJ1-1
TGTGCCAGCAGCCTCGGACTAGCGGGTGAGGGACACCAAGAGACCCAGTACTTC	CASSLGLAGEGHQETQYF	TRBV12-3	TRBJ2-5
TGTGCCAGCAGTGACAAGGGACTAGCGGGATCGGAGAACACCGGGGAGCTGTTTTTT	CASSDKGLAGSENTGELFF	TRBV6-4	TRBJ2-2
TGTGCCAGCAGCTTTCATGCAGGGGGGGTCACCGGGGAGCTGTTTTTT	CASSFHAGGVTGELFF	TRBV11-3	TRBJ2-2
TGTGCCAGCAGGCGGGATTCTGGACTAGCGGGTTCCTACGAGCAGTACTTC	CASRRDSGLAGSYEQYF	TRBV6-4	TRBJ2-7
TGTGCCAGCTCACCTAGTAGGGCTTTATCCTACGAGCAGTACTTC	CASSPSRALSYEQYF	TRBV18	TRBJ2-7
TGCGCCAGCACTCTACAGGAAAAAGGCTACACCTTC	CASTLQEKGYTF	TRBV10-2	TRBJ1-2
TGCGCCAGCAGCAGGGACAGAATGTACATATATTTT	CASSRDRMYIYF	TRBV5-1	TRBJ1-3
TGTGCCAGTAGTACAGATACGCAGTATTTT	CASSTDTQYF	TRBV14	TRBJ2-3
TGCAGTGCTAGAGAGTCCAGCCCAGGTTGGGACAATGAGCAGTTCTTC	CSARESSPGWDNEQFF	TRBV20-1	TRBJ2-1
TGTGCCAGCAGACAGGGCGCTTCCCCGGAGACCCAGTACTTC	CASRQGASPETQYF	TRBV27	TRBJ2-5
TGTGCCAGCAGCTTAGACCAGGGTCGTAATAATGAGCAGTTCTTC	CASSLDQGRNNEQFF	TRBV7-9	TRBJ2-1
TGCCGCCGCTCCACAAACGTCCCCAGCTCCTACGAGCAGTACTTC	CRRSTNVPSSYEQYF	TRBV10-2	TRBJ2-7
TGCAGTGCAGGGAGAGTAGCGGGAGGTAAGGCTGAGCAGTACTTC	CSAGRVAGGKAEQYF	TRBV20-1	TRBJ2-7
TGTGCCAGCAGTTATACAGGGGCGGAGCAGTTCTTC	CASSYTGAEQFF	TRBV6-2	TRBJ2-1
TGTGCTAGTGGCAGAAGCGGGAAAGGATTAATGGAAGCTGAAGCTTTCTTT	CASGRSGKGLMEAEAFF	TRBV12-5	TRBJ1-1
TGTGCCAGCAGCCCAATCGTCAGGGGAGGCTACACCTTC	CASSPIVRGGYTF	TRBV5-4	TRBJ1-2
TGTGCCAGCAGTTTCAGGGGGAGCAATCAGCCCCAGCATTTT	CASSFRGSNQPQHF	TRBV6-1	TRBJ1-5
TGCGCCAGCAGAGGACAGGGGGGAAGGGGTCTCTACGAGCAGTACTTC	CASRGQGGRGLYEQYF	TRBV10-1	TRBJ2-7
TGTGCCAGCTGGACTAGCGGGGCGAACATTCAGTACTTC	CASWTSGANIQYF	TRBV6-2	TRBJ2-4
TGCGCCAGCTCCGACAGGTATAACTATGGCTACACCTTC	CASSDRYNYGYTF	TRBV4-1	TRBJ1-2
TGTGCCAGCAGTTACGCCCTGGGACAGCACACTGAAGCTTTCTTT	CASSYALGQHTEAFF	TRBV6-5	TRBJ1-1
TGTGCCAGCAGCTTAACTAATGAGACCCAGTACTTC	CASSLTNETQYF	TRBV5-6	TRBJ2-5
TGTGCCAGCAGCGATGGGACTAGCGGCATTACGGGGGGTAAGACCCAGTACTTC	CASSDGTSGITGGKTQYF	TRBV5-5	TRBJ2-5
TGCAGTGCTACGCCACCCGGTGGGAGGGCTATCGACACTGAAGCTTTCTTT	CSATPPGGRAIDTEAFF	TRBV20-1	TRBJ1-1
TGTGCCAGCAGTTCCAAGAACAGGATGCAGAACGAGCAGTACTTC	CASSSKNRMQNEQYF	TRBV27	TRBJ2-7
TGTGCCAGCAGTTACTCGTGCGGGCAAGCCGGGACAGGGGGCTCCTACGAGCAGTACTTC	CASSYSCGQAGTGGSYEQYF	TRBV6-5	TRBJ2-7
TGTGCCAGTAGTATGTTACCGGGACAGGGCGGGCGGGTGGGAGCCACCGGGGAGCTGTTTTTT	CASSMLPGQGGRVGATGELFF	TRBV19	TRBJ2-2
TGTGCCAGCAGCTTGCCTCACCAAGGACTAGTGTACCAAGAGACCCAGTACTTC	CASSLPHQGLVYQETQYF	TRBV5-5	TRBJ2-5
TGTGCCACCTGCAGGACTCGCTTCCTGCCCCAGCATTTT	CATCRTRFLPQHF	TRBV15	TRBJ1-5
TGCAGTGCTAGACCTTGGGGGGAAGAAAGCTCCTACAATGAGCAGTTCTTC	CSARPWGEESSYNEQFF	TRBV20-1	TRBJ2-1
TGTGCCAGCAGCCAAGTACCTCCACGTCACAGGGACCTGGGCCAAGAGACCCAGTACTTC	CASSQVPPRHRDLGQETQYF	TRBV14	TRBJ2-5
TGTGCCAGCAGTTGGATACCCGAAGGGAGACGTGAAGCTTTCTTT	CASSWIPEGRREAFF	TRBV28	TRBJ1-1
TGTGCCAGCAGCTTGTCCTTACGATCGGGACGGGGACGCTACGAGCAGTACTTC	CASSLSLRSGRGRYEQYF	TRBV7-2	TRBJ2-7
TGTGCCAGCCCCCCGGGACATTCCGGCGAGCAGTACTTC	CASPPGHSGEQYF	TRBV6-1	TRBJ2-7
TGCGCCAGCAGAGATTACAGGACTAGCGGGGTCTACGAGCAGTACTTC	CASRDYRTSGVYEQYF	TRBV10-1	TRBJ2-7
TGTGCCAGCAGCGGGACAGGGGGTACCCTTTTATATGGCTACACCTTC	CASSGTGGTLLYGYTF	TRBV13	TRBJ1-2
TGCGCCAGCGTTAAGCCTCCGACAGGGGGCGCTGGGGCCAACGTCCTGACTTTC	CASVKPPTGGAGANVLTF	TRBV10-1	TRBJ2-6
TGTGCCAGCAGTAACAGGACAGGGGGGTACAATGAGCAGTTCTTC	CASSNRTGGYNEQFF	TRBV6-5	TRBJ2-1
TGTGCCATCAGCGGGACTAGGACGACCTACGAGCAGTACTTC	CAISGTRTTYEQYF	TRBV10-3	TRBJ2-7
TGTGCCAGCAGGGGGGCAGAGACCCAGTACTTC	CASRGAETQYF	TRBV2	TRBJ2-5
TGTGCCAGCAGTGACTCGACCCGGGGGGGGGCTCCACCCACCGGGGAGCTGTTTTTT	CASSDSTRGGAPPTGELFF	TRBV6-4	TRBJ2-2
TGTGCCAGCAGCCCCGGTAGCTCCTACAATGAGCAGTTCTTC	CASSPGSSYNEQFF	TRBV13	TRBJ2-1
TGTGCCACCAGCCCACATACCTTCGGGGAGCTGTTTTTT	CATSPHTFGELFF	TRBV24-1	TRBJ2-2
TGTGCCAGCAGGGACCCGGGACAGGGGGGCCGAAATGAAAAACTGTTTTTT	CASRDPGQGGRNEKLFF	TRBV27	TRBJ1-4
TGTGCCACCAGTGAGAGGAGTATCTATGGCTACACCTTC	CATSERSIYGYTF	TRBV24-1	TRBJ1-2
TGTGCCAGCAGCACCTCCAGGACTAGCACAGATACGCAGTATTTT	CASSTSRTSTDTQYF	TRBV11-3	TRBJ2-3
TGTTACCTAGAGTCTGGGGGTGTCTACGAGCAGTACTTC	CYLESGGVYEQYF	TRBV30	TRBJ2-7
TGTGCCAGCAGCCGGGGGGGCCCGATCTCCTACGAGCAGTACTTC	CASSRGGPISYEQYF	TRBV9	TRBJ2-7
TGCGCCAGCAGTGAGCCCCCGGGACTTTACACCGGGGAGCTGTTTTTT	CASSEPPGLYTGELFF	TRBV10-1	TRBJ2-2
TGTGCCAGCAGTGAGAAACTGGATGAGACCCAGTACTTC	CASSEKLDETQYF	TRBV2	TRBJ2-5
TGTGCCAGCAGCTCTACAGGGGGAGAAAAACTGTTTTTT	CASSSTGGEKLFF	TRBV7-2	TRBJ1-4
TGTGCCAGCAAGACTAGCGGGCGAGATGGCTACGAGCAGTACTTC	CASKTSGRDGYEQYF	TRBV6-4	TRBJ2-7
TGCAGTGCTGAACAAGTATCCTTGGCGGGACGGCATTTTCATACGGCAAAGGGCCAAGAGACCCAGTACTTC	CSAEQVSLAGRHFHTAKGQETQYF	TRBV20-1	TRBJ2-5
TGTGCCAGCATCGGCAAGTACAATGAGCAGTTCTTC	CASIGKYNEQFF	TRBV6-1	TRBJ2-1
TGTGCTAGTGGTCTAACTGACAGGGGTATCGCAGCAACTAATGAAAAACTGTTTTTT	CASGLTDRGIAATNEKLFF	TRBV12-5	TRBJ1-4
TGTGCCAGCAACGACTGGAAGGAGGGCGAGCAGTACTTC	CASNDWKEGEQYF	TRBV9	TRBJ2-7
TGTGCCAGCTCACCGAGGGCTCATCAGCCCCAGCATTTT	CASSPRAHQPQHF	TRBV18	TRBJ1-5
TGTGCCAGCAGCACGAGGGGACGGGGCAATGAGCAGTTCTTC	CASSTRGRGNEQFF	TRBV3-1	TRBJ2-1
TGCGCCCAGCTCCCGGGACAGGGGTCTAATTCACCCCTCCACTTT	CAQLPGQGSNSPLHF	TRBV5-1	TRBJ1-6
TGTGCCAGCAGCTTATGTAAGTTATACCTGCGGAACTCTGGGGCCAACGTCCTGACTTTC	CASSLCKLYLRNSGANVLTF	TRBV7-2	TRBJ2-6
TGCGCCAGCAGGATCCACGGAAGCTGGGAGAATGGCTACACCTTC	CASRIHGSWENGYTF	TRBV10-1	TRBJ1-2
TGTGCCAGTAGTAGTGGCGGACTAGCGGGCGATCACACCGGGGAGCTGTTTTTT	CASSSGGLAGDHTGELFF	TRBV19	TRBJ2-2
TGTGCCAGCAGCGTTTCCCGGGGGTGGAATAGTTTTCAGCCCCAGCATTTT	CASSVSRGWNSFQPQHF	TRBV11-1	TRBJ1-5
TGTGCCAGCAGCGTAGGATTCGGTAGGGGGTCTAATGAAAAACTGTTTTTT	CASSVGFGRGSNEKLFF	TRBV9	TRBJ1-4
TGTGCCAGCAGCAGGGAACATGGCTACACCTTC	CASSREHGYTF	TRBV3-1	TRBJ1-2
TGTGCCAGCAGCTTAGCCACCTTGCGTCCGGGACGCCTCTATGGCTACACCTTC	CASSLATLRPGRLYGYTF	TRBV11-3	TRBJ1-2
TGTGCCACCACAACGACTAGCGGGAGGGCTAATCTGAAAATAGGGCATAGCAATCAGCCCCAGCATTTT	CATTTTSGRANLKIGHSNQPQHF	TRBV24-1	TRBJ1-5
TGTGCCAGCAGTTTAGCGCCGGGGGCCAGTACGACTGAAGCTTTCTTT	CASSLAPGASTTEAFF	TRBV12-3	TRBJ1-1
TGTGCCATCAGTGAGTCCGTAGGTTTGGGGATGGAGAACACCGGGGAGCTGTTTTTT	CAISESVGLGMENTGELFF	TRBV10-3	TRBJ2-2
TGCAGTGCTAGAGATATGACAGTGACTAACTATGGCTACACCTTC	CSARDMTVTNYGYTF	TRBV20-1	TRBJ1-2
TGTGCCAGCAGGTTTGTCAGGGTTAACTATGGCTACACCTTC	CASRFVRVNYGYTF	TRBV7-3	TRBJ1-2
TGTGCCAGCTCACCCGGGACAGGAGCTTTCTTT	CASSPGTGAFF	TRBV18	TRBJ1-1
TGTGCCACCAGTGCTCGGCCTGAGAATCCCAATCAGCCCCAGCATTTT	CATSARPENPNQPQHF	TRBV24-1	TRBJ1-5
TGTGCCAGCAGCTTCACTAGCGGGAGATTCACAGATACGCAGTATTTT	CASSFTSGRFTDTQYF	TRBV7-8	TRBJ2-3
TGTGCCAGCAGAGGCGCTAGGGACAAGGATGGCTACACCTTC	CASRGARDKDGYTF	TRBV9	TRBJ1-2
TGCGCCAGCAGCCTGGTAGGGGGGCGACTGGGAGGCTACGAGCAGTACTTC	CASSLVGGRLGGYEQYF	TRBV5-1	TRBJ2-7
TGTGCCAGCAGACAGGCGGTCGGACTAGCGGGAAGTACGCAGTATTTT	CASRQAVGLAGSTQYF	TRBV6-5	TRBJ2-3
TGTGCCAGCAGTGACTCGACGGCCCCCAGAGCTAGCGGGAGGTACGAGCAGTACTTC	CASSDSTAPRASGRYEQYF	TRBV6-4	TRBJ2-7
TGTGCCAGCAGTTCACCCACAAGCACAGATACGCAGTATTTT	CASSSPTSTDTQYF	TRBV6-5	TRBJ2-3
TGTGCCAGCACAGTGGGGGGGGGAAACACCGGGGAGCTGTTTTTT	CASTVGGGNTGELFF	TRBV6-3	TRBJ2-2
TGTGCCAGCAGTTTACTCGGCGGAAACTATGGCTACACCTTC	CASSLLGGNYGYTF	TRBV12-4	TRBJ1-2
TGTGCCAGCAGCGGGACAAGGAACACTGAAGCTTTCTTT	CASSGTRNTEAFF	TRBV11-3	TRBJ1-1
TGTGCCAGCAAAACGAGACTAGCGGGGGGTAATGAGCAGTTCTTC	CASKTRLAGGNEQFF	TRBV6-4	TRBJ2-1
TGTGCCAGCAGTTACCTGGCAAGTGGCACAGATACGCAGTATTTT	CASSYLASGTDTQYF	TRBV6-3	TRBJ2-3
TGTGCCAGCAGTTCCGGGGACTTGCCCTACGAGCAGTACTTC	CASSSGDLPYEQYF	TRBV27	TRBJ2-7
TGCGCCAGCAGGACAGCAAACTTTCGCTCTGGGGCCAACGTCCTGACTTTC	CASRTANFRSGANVLTF	TRBV10-1	TRBJ2-6
TGTGCCAGCAGCTTGGGGTTGGACTTATTTGGCTACACCTTC	CASSLGLDLFGYTF	TRBV5-8	TRBJ1-2
TGTGCCAGCAGCTGCCGGACATCACCCCTCCACTTT	CASSCRTSPLHF	TRBV6-6	TRBJ1-6
TGTGCCAGCAGGAGCAGACAGCCCCAGCATTTT	CASRSRQPQHF	TRBV12-4	TRBJ1-5
TGTGCCAGCAGTTACGGGTGCCCGACTAGCGGGAGGTCGCGGGACTATGGCTACACCTTC	CASSYGCPTSGRSRDYGYTF	TRBV6-3	TRBJ1-2
TGTGCCAGCAGCCACAAAGGGATGAGCAACACCGGGGAGCTGTTTTTT	CASSHKGMSNTGELFF	TRBV3-1	TRBJ2-2
TGCGCCAGCAGCCGGGGGCTAGCGGGAAGGTGTCATGCAGACAATGAGCAGTTCTTC	CASSRGLAGRCHADNEQFF	TRBV5-1	TRBJ2-1
TGTGCCAGCAGCTTTACCGCCGGGGGTGAACGCACAGATACGCAGTATTTT	CASSFTAGGERTDTQYF	TRBV7-8	TRBJ2-3
TGTGCCCAAGCGGGAGGCAATGGGAGATACTTGGAGACCCAGTACTTC	CAQAGGNGRYLETQYF	TRBV19	TRBJ2-5
TGCAGTGCTAGAGATTCGGGGGATCAAGAGACCCAGTACTTC	CSARDSGDQETQYF	TRBV20-1	TRBJ2-5
TGTGCCAGCAGCTGGCTTTCGGGGAAGGAGACCCAGTACTTC	CASSWLSGKETQYF	TRBV13	TRBJ2-5
TGTGCCAGCAGCCTAGGGGGGGAGGGATTGGGCACCGGGGAGCTGTTTTTT	CASSLGGEGLGTGELFF	TRBV14	TRBJ2-2
TGTGCCAGCAGCCGGATACGGACAGGGGTCAAAAAACACAGAAGAAGTGAGCAGTTCTTC	CASSRIRTGVKKHRRSEQFF	TRBV3-1	TRBJ2-1
TGTGCCAGCAGCGGGCAGCGCTACGAGCAGTACTTC	CASSGQRYEQYF	TRBV13	TRBJ2-7
TGTGCCAGCAGCTCCGGGACAGGGAGACCTTTGGACGAGCAGTACTTC	CASSSGTGRPLDEQYF	TRBV5-6	TRBJ2-7
TGTGCCACTCTTTTGGGGGAGAATCAGCCCCAGCATTTT	CATLLGENQPQHF	TRBV27	TRBJ1-5
TGTGCCATACCAACCGCAACAGGTTCTGAAGCTTTCTTT	CAIPTATGSEAFF	TRBV10-3	TRBJ1-1
TGTGCCAGCAAAGAAACTAGCGGTCCCCCTCAGCAGTTCACAGATACGCAGTATTTT	CASKETSGPPQQFTDTQYF	TRBV11-3	TRBJ2-3
TGTGCCAGCAGTACCGGTAGCAGTGTCGACGGGCGGGGCATTCAGTACTTC	CASSTGSSVDGRGIQYF	TRBV28	TRBJ2-4
TGTGCCAGCAGTGACCCGGCCGGACTAGCGTACGAGCAGTACTTC	CASSDPAGLAYEQYF	TRBV6-4	TRBJ2-7
TGTGCTAGTGGTTTCTCAGGTTCAGGGGGTCTAGAAAAACTGTTTTTT	CASGFSGSGGLEKLFF	TRBV12-5	TRBJ1-4
TGTGCCAGCAGTTTACCCCTGAGACAAGTTCCATTTAACTATGGCTACACCTTC	CASSLPLRQVPFNYGYTF	TRBV6-4	TRBJ1-2
TGTGCCAGTTCTCCGGGACAGGATGCAACTAATGAAAAACTGTTTTTT	CASSPGQDATNEKLFF	TRBV19	TRBJ1-4
TGCGCCAGCAGCTTGGGATCCGGGACAGGGTCCAACACTGAAGCTTTCTTT	CASSLGSGTGSNTEAFF	TRBV5-1	TRBJ1-1
TGTGCCAGCAGGCCTGCCCTGGACAGGTCCTTGGAGGCCGAGACCCAGTACTTC	CASRPALDRSLEAETQYF	TRBV6-1	TRBJ2-5
TGTGCCAGCAGCTTAGCCCCGACAGGGTCCCGGGCCTACGAGCAGTACTTC	CASSLAPTGSRAYEQYF	TRBV11-3	TRBJ2-7
TGTGCCAGCAGCGGGGGGGTAGCAAACGAGCAGTACTTC	CASSGGVANEQYF	TRBV6-4	TRBJ2-7
TGTGCCAGCAGCCGTCTTAATATCGGCCGAACGCAGTATTTT	CASSRLNIGRTQYF	TRBV13	TRBJ2-3
TGTGCCAGCAGTTATGTACCAGATACGCAGTATTTT	CASSYVPDTQYF	TRBV12-3	TRBJ2-3
TGCGCCAGCAGCCAAGAGAACCCCACTCAGCAAATTGCCTATAATTCACCCCTCCACTTT	CASSQENPTQQIAYNSPLHF	TRBV4-1	TRBJ1-6
TGCGCCAGCAGCCAAGATCGTGTCTTCGGGGGGAATGAGCAGTTCTTC	CASSQDRVFGGNEQFF	TRBV4-1	TRBJ2-1
TGTGCCAGCAGTGAAGCGCATGGGAGGGTGAAATACAATGAGCAGTTCTTC	CASSEAHGRVKYNEQFF	TRBV6-4	TRBJ2-1
TGTGCCTGGAGTGAAGGGACAGGGGGGGCTAACTATGGCTACACCTTC	CAWSEGTGGANYGYTF	TRBV30	TRBJ1-2
TGTGCCAGCAGCCAAGGCGAATCGGGGACAGGGGGCGGGTTCGACGGCTACACCTTC	CASSQGESGTGGGFDGYTF	TRBV4-2	TRBJ1-2
TGTGCCAGCAGTGCTGAACGCCAGGGGCAAGAGACCCAGTACTTC	CASSAERQGQETQYF	TRBV25-1	TRBJ2-5
TGTGCCAGCAGCCAAGATGCAAAGGACAGGCCCAGCAATCAGCCCCAGCATTTT	CASSQDAKDRPSNQPQHF	TRBV14	TRBJ1-5
TGTGCCAGCAGAGGTCAGGGGACAGGCGAAAAACTGTTTTTT	CASRGQGTGEKLFF	TRBV5-6	TRBJ1-4
TGTGCCAGCAGTAAAAGTTATGGCTACACCTTC	CASSKSYGYTF	TRBV6-5	TRBJ1-2
TGTGATACAGGGTTCTATGGCTACACCTTC	CDTGFYGYTF	TRBV11-3	TRBJ1-2
TGTGCCACCAGTGCCCCCGGGACAGGGAACAATGAGCAGTTCTTC	CATSAPGTGNNEQFF	TRBV24-1	TRBJ2-1
TGTGCCAGCAGTGATAGAAGTTCGACAGGCGTGAATCAGCCCCAGCATTTT	CASSDRSSTGVNQPQHF	TRBV6-5	TRBJ1-5
TGTGCCACCAGCACCCGCCAACGGACAGGGGGTAGCTACACCTTC	CATSTRQRTGGSYTF	TRBV15	TRBJ1-2
TGTGCCAGCAGTGCCACAATCGGAGTGCGAAACACCATATATTTT	CASSATIGVRNTIYF	TRBV25-1	TRBJ1-3
TGTGCCAGCAGTGACTCGACCAGAGGGGCCCGACAAGAGACCCAGTACTTC	CASSDSTRGARQETQYF	TRBV6-4	TRBJ2-5
TGCCACCGGGACAGGGGAGGCTACACCTTC	CHRDRGGYTF	TRBV20-1	TRBJ1-2
TGCGCCAGCAGTGAGCGACAGGCGACCGGCTATGGCTACACCTTC	CASSERQATGYGYTF	TRBV10-2	TRBJ1-2
TGTGCCAGCACGGGGGGACCCCGTCCCGGGGAGCTGTTTTTT	CASTGGPRPGELFF	TRBV6-4	TRBJ2-2
TGCAGTGCTAGGGGAGGGGGGGGCCGCGGGGAGCTGTTTTTT	CSARGGGGRGELFF	TRBV20-1	TRBJ2-2
TGTGCCAGCAGCAACGGGAGGTCACAAGAGACCCAGTACTTC	CASSNGRSQETQYF	TRBV13	TRBJ2-5
TGTGCCAGCATCGGCGCGACTGAAGCTTTCTTT	CASIGATEAFF	TRBV27	TRBJ1-1
TGTGCCAAGTATGAGATCTATGGCTACACCTTC	CAKYEIYGYTF	TRBV10-3	TRBJ1-2
TGTGCCAGCAGTGATCTTCCCCCGACAACTAACTATGGCTACACCTTC	CASSDLPPTTNYGYTF	TRBV6-1	TRBJ1-2
TGTGCCAGCAGCCATAGCCGGCTCTACGAGCAGTACTTC	CASSHSRLYEQYF	TRBV14	TRBJ2-7
TGCAGTGCTACCCGACAGGGAAGTAGCAATCAGCCCCAGCATTTT	CSATRQGSSNQPQHF	TRBV20-1	TRBJ1-5
TGTGCCAGCAGCGTAGTCCGCGGACGGTCGGGCTACGAGCAGTACTTC	CASSVVRGRSGYEQYF	TRBV9	TRBJ2-7
TGTGCCATCATCCGCAGGCAAGAGACCCAGTACTTC	CAIIRRQETQYF	TRBV10-3	TRBJ2-5
TGCGCCAGCAGCCCAAGAAAGGAAGCGGTACCCGGGACAGGACAAGAGACCCAGTACTTC	CASSPRKEAVPGTGQETQYF	TRBV4-1	TRBJ2-5
TGTGCCAGCAGCTTGCGTGAGGGGGGCCGGGAGCAGTACTTC	CASSLREGGREQYF	TRBV5-6	TRBJ2-7
TGTGCCAGCAGCTTGTGGGAAGGGGGCGACACGCGGAGCAATCAGCCCCAGCATTTT	CASSLWEGGDTRSNQPQHF	TRBV5-4	TRBJ1-5
TGCAGTGCGGCAGGCCGAAAGTGGGCCTACAATGAGCAGTTCTTC	CSAAGRKWAYNEQFF	TRBV20-1	TRBJ2-1
TGCAGCGTTGAAGCCGATGGGGGTGTCTCCTACAATGAGCAGTTCTTC	CSVEADGGVSYNEQFF	TRBV29-1	TRBJ2-1
TGCGCCAGACCGAAGGACAACTACGAGCAGTACTTC	CARPKDNYEQYF	TRBV5-1	TRBJ2-7
TGTGCCAGCAGAACCACAGGGGGGAATCAGCCCCAGCATTTT	CASRTTGGNQPQHF	TRBV28	TRBJ1-5
TGCGCCAGCAGCTCCCATCGTGCATCACCCCTCCACTTT	CASSSHRASPLHF	TRBV5-1	TRBJ1-6
TGCAGCGTTGAGGCGACAGGGTTTCCGTACAATGAGCAGTTCTTC	CSVEATGFPYNEQFF	TRBV29-1	TRBJ2-1
TGTGCCAGCAGCTTAAACAAAGTTGCGGGACGGGGTGCTAGCACAGATACGCAGTATTTT	CASSLNKVAGRGASTDTQYF	TRBV11-1	TRBJ2-3
TGTGCCTGGAGTTACGGAGGGGCTTACGAGCAGTACTTC	CAWSYGGAYEQYF	TRBV30	TRBJ2-7
TGTGCCAGCAGCCCCAATCCTAGCGGCTACTACAATGAGCAGTTCTTC	CASSPNPSGYYNEQFF	TRBV2	TRBJ2-1
TGCGCCAGCAGCAACTCCGGGACAGGGGGCGCAAGCACTAGCAATCAGCCCCAGCATTTT	CASSNSGTGGASTSNQPQHF	TRBV5-1	TRBJ1-5
TGTGCCAGCAGCAAGCCGCACAGCTCCTATAATTCACCCCTCCACTTT	CASSKPHSSYNSPLHF	TRBV7-3	TRBJ1-6
TGCAGTGCTGCCCGGGACAGGGGGCAGAACTATGGCTACACCTTC	CSAARDRGQNYGYTF	TRBV20-1	TRBJ1-2
TGTGCCAGCAGCGACGGGGGTTTGTTTGAGCAGTACTTC	CASSDGGLFEQYF	TRBV7-6	TRBJ2-7
TGTGCCAGCAGCAGGTCGGACAGGCCCTGTGAAAAACTGTTTTTT	CASSRSDRPCEKLFF	TRBV7-3	TRBJ1-4
TGTGCCAGCAGTTACAAAAATCCCGGGACAGGTACCTACGAGCAGTACTTC	CASSYKNPGTGTYEQYF	TRBV6-2	TRBJ2-7
TGCGCCAGCAGCAAGACAGGGTTCTCCTACGAGCAGTACTTC	CASSKTGFSYEQYF	TRBV5-1	TRBJ2-7
TGTGCCAGCAGCCAAGCAACCGGGGCAGACTACGAGCAGTACTTC	CASSQATGADYEQYF	TRBV3-1	TRBJ2-7
TGTGCCAGCAGCCGAAGACAGGGGGGAGCCTACGAGCAGTACTTC	CASSRRQGGAYEQYF	TRBV11-2	TRBJ2-7
TGCGCCAGCAGTGCAAACACCGGAAGGTCCTACAATGAGCAGTTCTTC	CASSANTGRSYNEQFF	TRBV10-1	TRBJ2-1
TGTGCCAGCAAGCGACAGGGGGTATACACTGAAGCTTTCTTT	CASKRQGVYTEAFF	TRBV27	TRBJ1-1
TGCAGTGCTCGGGGAGACCATCAGCCCCAGCATTTT	CSARGDHQPQHF	TRBV20-1	TRBJ1-5
TGTGCCAGCAGCACGCCGGGGGATGGCACAGATACGCAGTATTTT	CASSTPGDGTDTQYF	TRBV7-4	TRBJ2-3
TGCGCCAGCAGCTTGGGCTACCCAGGGATCTACAAGGGGGAGGGCTATGGCTACACCTTC	CASSLGYPGIYKGEGYGYTF	TRBV5-1	TRBJ1-2
TGCGCCAGCAGCGTATTGGGACAGGGCGACAATGAGCAGTTCTTC	CASSVLGQGDNEQFF	TRBV5-1	TRBJ2-1
TGTGCCAGCAGCGTAGTTAGCGGGGACTACAATGAGCAGTTCTTC	CASSVVSGDYNEQFF	TRBV9	TRBJ2-1
TGTGCCAGCAGCCTAGGACTAGCGGTAGAAGAGACCCAGTACTTC	CASSLGLAVEETQYF	TRBV7-9	TRBJ2-5
TGTGCCAGCAGTCCGATGGGACAAATAGCCAAAAACATTCAGTACTTC	CASSPMGQIAKNIQYF	TRBV27	TRBJ2-4
TGTGCCAGCAGCAATTCCAGATCCGGGGAGCTGTTTTTT	CASSNSRSGELFF	TRBV7-4	TRBJ2-2
TGTGCCAGCAGTGACAGGGACTACGAGCAGTACTTC	CASSDRDYEQYF	TRBV7-3	TRBJ2-7
TGTGCCAGCGGGCATTGGGGGGAGGGCTACACCTTC	CASGHWGEGYTF	TRBV7-3	TRBJ1-2
TGTGCCAGCAGCCAAGCCGGCGTCGGGGGCCAAGAGACCCAGTACTTC	CASSQAGVGGQETQYF	TRBV3-1	TRBJ2-5
TGTGCCATACCAGGGGGCGAGCAGTACTTC	CAIPGGEQYF	TRBV19	TRBJ2-7
TGTGCCAGCAGGGGTTTCACCCGACAGACCTATAATTCACCCCTCCACTTT	CASRGFTRQTYNSPLHF	TRBV6-6	TRBJ1-6
TGTGCCTGGACCGGGACTAGCGGGGGGGGCACCAATGAGCAGTTCTTC	CAWTGTSGGGTNEQFF	TRBV30	TRBJ2-1
TGTGCTAGTGGTTTTGACAGAAAGTTCTACGAGCAGTACTTC	CASGFDRKFYEQYF	TRBV12-5	TRBJ2-7
TGTGCCATCAGTGAGTCGTTTTCCGGGACTAGGGCCTCCTACAATGAGCAGTTCTTC	CAISESFSGTRASYNEQFF	TRBV10-3	TRBJ2-1
TGTGCCAGCAGCCTTCCCTGCCTGTGGGCCGATACGCAGTATTTT	CASSLPCLWADTQYF	TRBV3-1	TRBJ2-3
TGTGCCAGCAGCCGGGGGCTAGGCTACGAGCAGTACTTC	CASSRGLGYEQYF	TRBV11-1	TRBJ2-7
TGTGCCAGCAGTTTATTACCTAGCGTTAGCGTGAACTGTGGCGAGACCCAGTACTTC	CASSLLPSVSVNCGETQYF	TRBV27	TRBJ2-5
TGTGCCAGCATACAGTTCAATACGCAGTATTTT	CASIQFNTQYF	TRBV6-2	TRBJ2-3
TGCGCCAGCAGCCTGGTTGGGGGACAAGGGAACTGGCGGCCGAACACTGAAGCTTTCTTT	CASSLVGGQGNWRPNTEAFF	TRBV4-1	TRBJ1-1
TGTGATCCACCGGGCCAGCCTAGTGTCATGAACACTGAAGCTTTCTTT	CDPPGQPSVMNTEAFF	TRBV25-1	TRBJ1-1
TGTGCCAGTAGTATTAGCAGAGACAGGGATGAAGCTTTCTTT	CASSISRDRDEAFF	TRBV19	TRBJ1-1
TGTGCCAGCAGCCAATATCGGCAAGAGACCCAGTACTTC	CASSQYRQETQYF	TRBV14	TRBJ2-5
TGTGCCAGCAGCCAAGAAACGACCCCCGGGACAAGTGGCGGAAGCTCCTACAATGAGCAGTTCTTC	CASSQETTPGTSGGSSYNEQFF	TRBV4-2	TRBJ2-1
TGTGCCACCAGTGATTGTCCCCAGGGCACCTTC	CATSDCPQGTF	TRBV24-1	TRBJ1-2
TGCGCCAGCAGCTTGCAGGCTTACGAAGCTTTCTTT	CASSLQAYEAFF	TRBV5-1	TRBJ1-1
TGCAGCGTTGGGGGGGGCCTCTGGGTGTACAATGAGCAGTTCTTC	CSVGGGLWVYNEQFF	TRBV29-1	TRBJ2-1
TGTGCCAGCAGTCCCGATGAGGGATATGGTGGCTACACCTTC	CASSPDEGYGGYTF	TRBV12-3	TRBJ1-2
TGCGCCAGCAGCTTGGGGACTAGCGGGGGGGCCCCAAGGAGCTCCTACGAGCAGTACTTC	CASSLGTSGGAPRSSYEQYF	TRBV5-1	TRBJ2-7
TGTGCCTGGAGTGTCCGGGGACCCCGGGGGCTGAACACTGAAGCTTTCTTT	CAWSVRGPRGLNTEAFF	TRBV30	TRBJ1-1
TGTGCCAGCAGCTTACGGGGGATGGAGCAGTTCTTC	CASSLRGMEQFF	TRBV11-3	TRBJ2-1
TGTGCCAGCAAACAGGGGGCGGAAATAGATACGCAGTATTTT	CASKQGAEIDTQYF	TRBV6-4	TRBJ2-3
TGTGCCAGCAGCTTAACCCCAAGCTATGGCTACACCTTC	CASSLTPSYGYTF	TRBV7-2	TRBJ1-2
TGTGCCAGCAACGCGCCGGGACAGGGGCAAAAACTGTTTTTT	CASNAPGQGQKLFF	TRBV7-9	TRBJ1-4
TGTGCCAGCAGCCCGGTTCGGGGCAATGAGCAGTTCTTC	CASSPVRGNEQFF	TRBV7-3	TRBJ2-1
TGTGCCAGCAGCTTAGTCTGGGGGGGCGCCCTCCACTTT	CASSLVWGGALHF	TRBV7-2	TRBJ1-6
TGCAGCGTTAGGGGACAGGGGGCGACAACACGTGGAAACACCATATATTTT	CSVRGQGATTRGNTIYF	TRBV29-1	TRBJ1-3
TGCAGTGCTAGAAACACCGGAACAGGGGGTTGTGAAAAACTGTTTTTT	CSARNTGTGGCEKLFF	TRBV20-1	TRBJ1-4
TGTGCCAGCAGTGCAGAGACCCAGTACTTC	CASSAETQYF	TRBV27	TRBJ2-5
TGTGCCACCAGTACCCGGGACGAAGCCTATGGCTACACCTTC	CATSTRDEAYGYTF	TRBV24-1	TRBJ1-2
TGTGCCAGCAGCTCAAAGACAGGACCTTCCCCCTGGCAGCCCCAGCATTTT	CASSSKTGPSPWQPQHF	TRBV13	TRBJ1-5
TGTGCCAGCAGCTGTCCTAACCACAGTATGGCTGAAGAGACCCAGTACTTC	CASSCPNHSMAEETQYF	TRBV7-2	TRBJ2-5
TGTGCCAGCAGCCCATTAGGGGAGGGGTTGAGTAATGAAAAACTGTTTTTT	CASSPLGEGLSNEKLFF	TRBV5-6	TRBJ1-4
TGCGCCAGCAGCTTTCCGAGGGGGGTCAGAGGACGCTACGAGCAGTACTTC	CASSFPRGVRGRYEQYF	TRBV5-1	TRBJ2-7
TGTGCCAGCGTTCCCGGCGGAGGCTACGAGCAGTACTTC	CASVPGGGYEQYF	TRBV6-1	TRBJ2-7
TGTGTCGGGACAGCTGACCAAGAGACCCAGTACTTC	CVGTADQETQYF	TRBV25-1	TRBJ2-5
TGCAGCTCCACAACAGGGAAGAACACCGGGGAGCTGTTTTTT	CSSTTGKNTGELFF	TRBV29-1	TRBJ2-2
TGTGCCAGCAGTTTATTCCGGCAGGCTGGGGCCAACGTCCTGACTTTC	CASSLFRQAGANVLTF	TRBV12-4	TRBJ2-6
TGTGCCAGCCCCCAGGGGAAATGGGGGGAGCTGTTTTTT	CASPQGKWGELFF	TRBV10-3	TRBJ2-2
TGTGCCAGCAGCCATATCCGGACTCGAGCAGATACGCAGTATTTT	CASSHIRTRADTQYF	TRBV3-1	TRBJ2-3
TGTGCCAGTAGTATTCAAGGAATGACAGGGAGGAATAGCAATCAGCCCCAGCATTTT	CASSIQGMTGRNSNQPQHF	TRBV19	TRBJ1-5
TGCGCCAGCAGCTTGGCCAGGAGACCCCTCCACTTT	CASSLARRPLHF	TRBV5-1	TRBJ1-6
TGTGCCACCAGTGAGTTCTGTTCTCCTGGGGCCAACGTCCTGACTTTC	CATSEFCSPGANVLTF	TRBV24-1	TRBJ2-6
TGTGCCAGCAGCTTAGTCGTGGACAGTAAGAACACTGAAGCTTTCTTT	CASSLVVDSKNTEAFF	TRBV7-9	TRBJ1-1
TGTGCCAGCAGCTACCGGACTTCAGAAAAACTGTTTTTT	CASSYRTSEKLFF	TRBV7-3	TRBJ1-4
TGTGCCAGCAGTTACGGGACTAGCTATCGGCCCCTTTCAGAGACCCAGTACTTC	CASSYGTSYRPLSETQYF	TRBV6-6	TRBJ2-5
TGTGCCACCAGTGATTTGTTCCGGGTAGCGGGGGATCGGGTAAGCACAGATACGCAGTATTTT	CATSDLFRVAGDRVSTDTQYF	TRBV24-1	TRBJ2-3
TGTGCCAGCAGCTTAGATCAAACCCTAGCGTACTCCTACGAGCAGTACTTC	CASSLDQTLAYSYEQYF	TRBV11-2	TRBJ2-7
TGCAGTGCTAGGGAATCAGAAAGTGGCTACACCTTC	CSARESESGYTF	TRBV20-1	TRBJ1-2
TGTGCCAGCAGCGGACTAGCGTACAATGAGCAGTTCTTC	CASSGLAYNEQFF	TRBV7-9	TRBJ2-1
TGTGCCAGCAGCACCCTAGCGGGTGCTGGGGAGCTGTTTTTT	CASSTLAGAGELFF	TRBV7-8	TRBJ2-2
TGTGCCAGCAGTAGACGGGACAGGGGGTCCTCCTACGAGCAGTACTTC	CASSRRDRGSSYEQYF	TRBV27	TRBJ2-7
TGTGCCAGCAGTGAAGCCAATAAACCTCGCCGGGTCACAGATACGCAGTATTTT	CASSEANKPRRVTDTQYF	TRBV6-1	TRBJ2-3
TGTGCTAGTGGGGACCGACAGGGGGTTCAGCCCCAGCATTTT	CASGDRQGVQPQHF	TRBV12-5	TRBJ1-5
TGTGCCAGCAGCTTAGTGCAGGGGACGGGGACTGAAGCTTTCTTT	CASSLVQGTGTEAFF	TRBV7-4	TRBJ1-1
TGCGCCAGCAGCTTGACGGGGGGGGAGGGGGGAGACTATGGCTACACCTTC	CASSLTGGEGGDYGYTF	TRBV5-1	TRBJ1-2
TGTGCCAGCAGCCGGGTAACAGGGCCCTCTGGAAACACCATATATTTT	CASSRVTGPSGNTIYF	TRBV3-1	TRBJ1-3
TGCAGCGAACTTAGGGTTTTCCTGAACACTGAAGCTTTCTTT	CSELRVFLNTEAFF	TRBV29-1	TRBJ1-1
TGTGCCGGGACAGGGAATTCACCCCTCCACTTT	CAGTGNSPLHF	TRBV5-6	TRBJ1-6
TGTGCCACCAGTGCTATAGCGGGTACGCAGTATTTT	CATSAIAGTQYF	TRBV24-1	TRBJ2-3
TGTGCCACCAGCAGTCCACGGTCAGGGGTCCCTTCACCCCTCCACTTT	CATSSPRSGVPSPLHF	TRBV15	TRBJ1-6
TGTGCCAGCACGGCTTTCACAGATACGCAGTATTTT	CASTAFTDTQYF	TRBV6-5	TRBJ2-3
TGTGCCAGCAGCACACGGGACAATCGGGTTTCCCAAGAGACCCAGTACTTC	CASSTRDNRVSQETQYF	TRBV13	TRBJ2-5
TGTGCCAGCGGTTCACTTATCACGTACTTC	CASGSLITYF	TRBV11-1	TRBJ2-5
TGTGCCACCAGGGCCAGTCCTAAGGACGGAAGGGCCTATGGCTACACCTTC	CATRASPKDGRAYGYTF	TRBV24-1	TRBJ1-2
TGTGCCAGCAGTTCTATAAGGAATGGGGCTATAGAGCAGTACTTC	CASSSIRNGAIEQYF	TRBV28	TRBJ2-7
TGCGCCAGCAGCCGCTTAGGACAGGGAGGGCCGTTCACTGAAGCTTTCTTT	CASSRLGQGGPFTEAFF	TRBV4-1	TRBJ1-1
TGTGCCAGCAGCTTAACGTGGACTAGTGGACTAGACTACGAGCAGTACTTC	CASSLTWTSGLDYEQYF	TRBV7-3	TRBJ2-7
TGTGCCAGCAGCAGATGCGGGAGGGCGGGCCATAATTCACCCCTCCACTTT	CASSRCGRAGHNSPLHF	TRBV7-3	TRBJ1-6
TGTGCCAGGTTACGCCCTCCAATGACGGAGCAGTTCTTC	CARLRPPMTEQFF	TRBV11-3	TRBJ2-1
TGTGCCAGCAGTTTGCAGGGGGCGTACACTGAAGCTTTCTTT	CASSLQGAYTEAFF	TRBV28	TRBJ1-1
TGCAGTGCCCCGACAAGTCGCCGGGACACCCACGTGGATTCACCCCTCCACTTT	CSAPTSRRDTHVDSPLHF	TRBV20-1	TRBJ1-6
TGTGCCAGCAGCCCGGTCGGGACTAGCGGGGGGGACGAGCAGTACTTC	CASSPVGTSGGDEQYF	TRBV11-3	TRBJ2-7
TGCGCCAGCAGCTTGGCCCCAAGGGACGTGCACGAGCAGTACTTC	CASSLAPRDVHEQYF	TRBV5-1	TRBJ2-7
TGTGCCAGCAGCCCCGGGGATGAGCAGTTCTTC	CASSPGDEQFF	TRBV5-4	TRBJ2-1
TGTGCCAGGGGCGGACACGACAATCAGCCCCAGCATTTT	CARGGHDNQPQHF	TRBV19	TRBJ1-5
TGTGCCAGCAGCTTGATGGAGAAAGGGTTCGAGCAGTACTTC	CASSLMEKGFEQYF	TRBV7-3	TRBJ2-7
TGTGCTAGTGGTCAAACGGGACAAGACGGCTACACCTTC	CASGQTGQDGYTF	TRBV12-5	TRBJ1-2
TGTGCCAGCAGTTACGGTCTCTCTGGACAGGGACGAGCAGAGTACCAAGAGACCCAGTACTTC	CASSYGLSGQGRAEYQETQYF	TRBV6-6	TRBJ2-5
TGCAGTGCTCGTAACAGGAACGAGCAGTACTTC	CSARNRNEQYF	TRBV20-1	TRBJ2-7
TGTGCCAGCAGTGACATCACGGGGACTAGCGGGACGAACACCGGGGAGCTGTTTTTT	CASSDITGTSGTNTGELFF	TRBV6-1	TRBJ2-2
TGTGCCAGCAGCCAAGGATTGCCCACCGGCTTAGATGGCTACACCTTC	CASSQGLPTGLDGYTF	TRBV3-1	TRBJ1-2
TGTGCCAGCAACCATAATAGACTTATAAAGGAGACCCAGTACTTC	CASNHNRLIKETQYF	TRBV25-1	TRBJ2-5
TGTGCCAGCAGCTTAAAACACCCCGACTACACCGGGGAGCTGTTTTTT	CASSLKHPDYTGELFF	TRBV11-1	TRBJ2-2
TGTGCCAGCAGGGGCCGGGACAGGGGAGATTGTGAAAAACTGTTTTTT	CASRGRDRGDCEKLFF	TRBV27	TRBJ1-4
TGTGCCAGCAGTTACTGGGTTGGGTCTACAGGGGTTGGGGCCAACGTCCTGACTTTC	CASSYWVGSTGVGANVLTF	TRBV6-5	TRBJ2-6
TGTGCCAGCACTCCGGGGGGCGCAGTAAGAAACGAGCAGTACTTC	CASTPGGAVRNEQYF	TRBV11-2	TRBJ2-7
TGTGCCAGAGGGCAGCCCTCCCTGGGAGGGTTCACAGATACGCAGTATTTT	CARGQPSLGGFTDTQYF	TRBV19	TRBJ2-3
TGCGCTCGGACGGACAATGGCTACACCTTC	CARTDNGYTF	TRBV5-1	TRBJ1-2
TGTGCCAGCAGCAAGAAGCCTAGCGGGAGTACGCAGTATTTT	CASSKKPSGSTQYF	TRBV7-3	TRBJ2-3
TGTGCCAGCAGCCGCGGGGGGGAGCTGTTTTTT	CASSRGGELFF	TRBV11-2	TRBJ2-2
TGCGCCAGGGAGAACGGGACAGGCGGAAACACCATATATTTT	CARENGTGGNTIYF	TRBV5-1	TRBJ1-3
TGTGCCAGCAGCGGTGGACTAGGAAATACCGGACTAAGTTCCACAGATACGCAGTATTTT	CASSGGLGNTGLSSTDTQYF	TRBV5-6	TRBJ2-3
TGTGCCAGCAGCTTCCCCGGGACCCAGCCCCAGCATTTT	CASSFPGTQPQHF	TRBV7-9	TRBJ1-5
TGCGCCAGCACAGATGTTAAGAGGTGGAATGCAACTAATGAAAAACTGTTTTTT	CASTDVKRWNATNEKLFF	TRBV10-1	TRBJ1-4
TGCAGCGTGGGGGGATCGCTAGACCGCCCGGATACGCAGTATTTT	CSVGGSLDRPDTQYF	TRBV29-1	TRBJ2-3
TGTGCCAGCAGTTGGGCAGGGTTCCATGAAAAACTGTTTTTT	CASSWAGFHEKLFF	TRBV27	TRBJ1-4
TGCGCCAGCAGTGTCCTAGAAGGTACACCGGGACTAGCGGGAGCCGTATGCTCCTGGCCCTGTAAAGAGACCCAGTACTTC	CASSVLEGTPGLAGAVCSWPCKETQYF	TRBV10-1	TRBJ2-5
TGTGCCAGCAGTGAATTGGGACTTTTAGTCACTGAAGCTTTCTTT	CASSELGLLVTEAFF	TRBV6-1	TRBJ1-1
TGTGCCAGCAGCTACTACAGGGCGCCTTCACCCCTCCACTTT	CASSYYRAPSPLHF	TRBV7-6	TRBJ1-6
TGCAGTGCTAGAGACGACGAGCCCGTGGGACCCCTCCACTTT	CSARDDEPVGPLHF	TRBV20-1	TRBJ1-6
TGTGCCAGCATCCCGACTAGGGGAAATGAGCAGTTCTTC	CASIPTRGNEQFF	TRBV7-9	TRBJ2-1
TGTGCCAGCAGCCTGGGGGGGGCCACAGATACGCAGTATTTT	CASSLGGATDTQYF	TRBV13	TRBJ2-3
TGCAGTGCTGGATATATCAGCACCGGGGAGCTGTTTTTT	CSAGYISTGELFF	TRBV20-1	TRBJ2-2
TGTGCCAGCGGCTTGTACAATGAGCAGTTCTTC	CASGLYNEQFF	TRBV4-2	TRBJ2-1
TGTGCCACCAGCAGAGATCTAATTACCTACCACTCCTATAATTCACCCCTCCACTTT	CATSRDLITYHSYNSPLHF	TRBV15	TRBJ1-6
TGTGGGATAGAGTCTCACTACGAGCAGTACTTC	CGIESHYEQYF	TRBV5-4	TRBJ2-7
TGTGCCAGCAGTGCCCGGGATTCACGCAGACGAGCTAACTATGGCTACACCTTC	CASSARDSRRRANYGYTF	TRBV6-2	TRBJ1-2
TGTGCCACAGGACAGGGAGGCGGCTATGGCTACACCTTC	CATGQGGGYGYTF	TRBV15	TRBJ1-2
TGCGCCAGCAGCTTGGAGGGGGGTGGGCTCGTTCGACTATACGAGCAGTACTTC	CASSLEGGGLVRLYEQYF	TRBV5-1	TRBJ2-7
TGTGCCAGCAGGCTTCCGGGACAGGACGAGCAGTACTTC	CASRLPGQDEQYF	TRBV6-1	TRBJ2-7
TGTGCCAGCAGCTGCAGGGGTAAGGAAAAACTGTTTTTT	CASSCRGKEKLFF	TRBV7-6	TRBJ1-4
TGTGCCAGCAGTCCAGGAGTTTCTGAAAAACTGTTTTTT	CASSPGVSEKLFF	TRBV11-3	TRBJ1-4
TGCGCCAGCAGCCAAAGCCAGTTCGGCTACACCTTC	CASSQSQFGYTF	TRBV5-1	TRBJ1-2
TGTGCCAGCAGCTTAGGACTAGCGGGCGGCCGGAGCTACGAGCAGTACTTC	CASSLGLAGGRSYEQYF	TRBV7-6	TRBJ2-7
TGTGCCAGCAGCTACAGGGTATTCACTGAAGCTTTCTTT	CASSYRVFTEAFF	TRBV5-5	TRBJ1-1
TGTGCCAGCAGTTACATGGGCGTAGAAAACATTCAGTACTTC	CASSYMGVENIQYF	TRBV6-5	TRBJ2-4
TGCAGTGCAGTGGGGAACACTGAAGCTTTCTTT	CSAVGNTEAFF	TRBV20-1	TRBJ1-1
TGTGCCAGCAGCCAAGCCCGAGGGGGGAGCTACGAGCAGTACTTC	CASSQARGGSYEQYF	TRBV4-2	TRBJ2-7
TGCAGTGCACCAACAATATTTGTAATTAACTATGGCTACACCTTC	CSAPTIFVINYGYTF	TRBV20-1	TRBJ1-2
TGTGCCAGCAGCTTAGGGCCCGGGACTAGCGGGGAGCTTGAGCAGTTCTTC	CASSLGPGTSGELEQFF	TRBV5-4	TRBJ2-1
TGTGCCAGCATGTCACCCCGGGACATCAACTATGGCTACACCTTC	CASMSPRDINYGYTF	TRBV6-5	TRBJ1-2
TGTGCCATCAGTGAGGGTCTGATCCCAAATGGCACAACCGGGGAGCTGTTTTTT	CAISEGLIPNGTTGELFF	TRBV10-3	TRBJ2-2
TGTGCCAGCTCACCCGGCGGGGACTCCTACAATGAGCAGTTCTTC	CASSPGGDSYNEQFF	TRBV18	TRBJ2-1
TGTGCCAACCCTGCTAGGAAAAACAATCAGCCCCAGCATTTT	CANPARKNNQPQHF	TRBV27	TRBJ1-5
TGCACCAGGGAGATACGTAACGAGCAGTACTTC	CTREIRNEQYF	TRBV29-1	TRBJ2-7
TGTGCCAGCAGCAGGGCCCGGGATTTATCCTACAATGAGCAGTTCTTC	CASSRARDLSYNEQFF	TRBV13	TRBJ2-1
TGTGCCAGCAGTGAGTGGTCCCGACATTTCTATGGCTACACCTTC	CASSEWSRHFYGYTF	TRBV6-4	TRBJ1-2
TGTGCCAGTAGTATAAGGGCCAGGTATGCTAACTATGGCTACACCTTC	CASSIRARYANYGYTF	TRBV19	TRBJ1-2
TGCAGTGCTAGGGGGACACTCTACGAGCAGTACTTC	CSARGTLYEQYF	TRBV20-1	TRBJ2-7
TGCGCCAGCAGCTGGGACAGGGGTAGCCAAGAGACCCAGTACTTC	CASSWDRGSQETQYF	TRBV5-1	TRBJ2-5
TGCGCCAGCAGCTTATTCCTCTCCTACGAGCAGTACTTC	CASSLFLSYEQYF	TRBV5-1	TRBJ2-7
TGTGCCAGCAGCGTGGCCGGACTAGCGGGAGCCTACGAGCAGTACTTC	CASSVAGLAGAYEQYF	TRBV9	TRBJ2-7
TGTGCCAGCAGTTTATCCGGACGTCGCGAGCAGTACTTC	CASSLSGRREQYF	TRBV28	TRBJ2-7
TGTGCCAGCAGCCCCAGGGGTGGGGTTCAGCCCCAGCATTTT	CASSPRGGVQPQHF	TRBV7-9	TRBJ1-5
TGTGCCAGCAGCAACCGGGAGGAGCACACCATATATTTT	CASSNREEHTIYF	TRBV7-4	TRBJ1-3
TGTGCCAGCAGCTTGTATGGACAGGGAAGGCATAACTATGGCTACACCTTC	CASSLYGQGRHNYGYTF	TRBV5-4	TRBJ1-2
TGTGCCAGCAGCGGAATTGAGTGGAATTCACCCCTCCACTTT	CASSGIEWNSPLHF	TRBV11-2	TRBJ1-6
TGCACCGGGACTAGCGGGAAGTCCCCGGGCATCTCTGGAAACACCATATATTTT	CTGTSGKSPGISGNTIYF	TRBV20-1	TRBJ1-3
TGTGCCAGCAGCTTATGGGACAGGGGGCTCCGGGCTGGAAACACCATATATTTT	CASSLWDRGLRAGNTIYF	TRBV7-6	TRBJ1-3
TGCGCCAGCAGCTTGCTGAGACCTGGGAATGAGCAGTTCTTC	CASSLLRPGNEQFF	TRBV5-1	TRBJ2-1
TGTGCCAGCATCTGGACAGGGGACCGATATAGCAATCAGCCCCAGCATTTT	CASIWTGDRYSNQPQHF	TRBV6-1	TRBJ1-5
TGTGCCTGGAGTGTAGGACTAGCGGGCAGCACAGATACGCAGTATTTT	CAWSVGLAGSTDTQYF	TRBV30	TRBJ2-3
TGTGCCACCAGTCCCGCACTCTCGGGACAGGGAAGGGTGGTGAATAGTAGCAATCAGCCCCAGCATTTT	CATSPALSGQGRVVNSSNQPQHF	TRBV24-1	TRBJ1-5
TGTGCCAGCAGCTCTCGGGGGCCCACCATATATTTT	CASSSRGPTIYF	TRBV9	TRBJ1-3
TGTGCCAGCCAATGGACCAACACTGAAGCTTTCTTT	CASQWTNTEAFF	TRBV11-2	TRBJ1-1
TGCAGTGCTAGAAACCCGGGACTAGCGGGGGACGATACGCAGTATTTT	CSARNPGLAGDDTQYF	TRBV20-1	TRBJ2-3
TGTGCCAGCAGCTTCGGTTTAGTTGGGGGGGCACATGTTCCGGGTACGGAGACCCAGTACTTC	CASSFGLVGGAHVPGTETQYF	TRBV7-2	TRBJ2-5
TGTGCCAGCAGCTTCAGTGTAGCGGTCTTC	CASSFSVAVF	TRBV3-1	TRBJ2-1
TGCAGTGCCAAAGTGGGGCCGTACTTC	CSAKVGPYF	TRBV20-1	TRBJ2-5
TGTGCCAGCAGCAAATGGGCGTCTGAGACCCAGTACTTC	CASSKWASETQYF	TRBV7-7	TRBJ2-5
TGTGCCAGCAGCCGCCGGGGTCGTAGACAGCCCCAGCATTTT	CASSRRGRRQPQHF	TRBV14	TRBJ1-5
TGTGCCAGCAGCCCTCTCCAGGGGGCTCTAAGACAAGAGACCCAGTACTTC	CASSPLQGALRQETQYF	TRBV11-3	TRBJ2-5
TGTGCCAGCAGCCGGACATATGAGCAGTTCTTC	CASSRTYEQFF	TRBV27	TRBJ2-1
TGTGCCACCAGTGATTGTCAAAGAGAGGGGTACAATGAGCAGTTCTTC	CATSDCQREGYNEQFF	TRBV24-1	TRBJ2-1
TGTGCCACCAGCAGAAGCGGGAGGGGAGAGAACACTGAAGCTTTCTTT	CATSRSGRGENTEAFF	TRBV15	TRBJ1-1
TGTGCCAGCTCACCAGGGTCCTACGAGCAGTACTTC	CASSPGSYEQYF	TRBV18	TRBJ2-7
TGTGCCAGCCACTTATTAACCTATGGCTACACCTTC	CASHLLTYGYTF	TRBV11-2	TRBJ1-2
TGTGCCAGCAGCGTTTATAGTTTCCCGAGAGCTGGGGCCAACGTCCTGACTTTC	CASSVYSFPRAGANVLTF	TRBV7-9	TRBJ2-6
TGTGCCCCAGCTGGGGAGGCAGATACGCAGTATTTT	CAPAGEADTQYF	TRBV12-3	TRBJ2-3
TGTGCCAGCTCACCACCGCGGCCGCAGCCCCAGCATTTT	CASSPPRPQPQHF	TRBV18	TRBJ1-5
TGTGCCAGCAGGACTATATCAGGGGCAGATACGCAGTATTTT	CASRTISGADTQYF	TRBV6-5	TRBJ2-3
TGTGCCAGCAGTGGAGTACCGCCACGGTTTTCACCCCTCCACTTT	CASSGVPPRFSPLHF	TRBV6-1	TRBJ1-6
TGTGCCAGCAGCCGGTCAGCAAGTGGGGAGCTGTTTTTT	CASSRSASGELFF	TRBV6-6	TRBJ2-2
TGTGCCAGCAGCTTAGCCTCGGGGGGACGGGGGTCACGACACACTGAAGCTTTCTTT	CASSLASGGRGSRHTEAFF	TRBV7-2	TRBJ1-1
TGTGCCAGCAGCTTGGGGGCGCTTGTCAGTGGCCCTTTCTTT	CASSLGALVSGPFF	TRBV5-4	TRBJ1-1
TGTGCCAGCAGTGAGAATCGGACCGAAAAACTGTTTTTT	CASSENRTEKLFF	TRBV6-4	TRBJ1-4
TGCGCCAGCAGCTGGGAGGGGGTGAACACTGAAGCTTTCTTT	CASSWEGVNTEAFF	TRBV5-1	TRBJ1-1
TGTGCCAGTAGTGAGGCAAGAAATAGCAATCAGCCCCAGCATTTT	CASSEARNSNQPQHF	TRBV19	TRBJ1-5
TGCAGTGCTAGATTCCCGGACCGTGGGGGTGGGAGCTCCTACAATGAGCAGTTCTTC	CSARFPDRGGGSSYNEQFF	TRBV20-1	TRBJ2-1
TGTGCCATCAGGGAAAGCCAGGAGGGTGAAACACCCCTCCACTTT	CAIRESQEGETPLHF	TRBV10-3	TRBJ1-6
TGTGCCAGCAGCTTAGATGGGACAGGGGAGGTAAACTATGGCTACACCTTC	CASSLDGTGEVNYGYTF	TRBV11-3	TRBJ1-2
TGCGCCAGCGGGCCTAGCTTCTACACCGGGGAGCTGTTTTTT	CASGPSFYTGELFF	TRBV10-1	TRBJ2-2
TGTGCCAGCAGCATGCCCGGACAGGGTCCCGGGGAGCTGTTTTTT	CASSMPGQGPGELFF	TRBV5-6	TRBJ2-2
TGTGCCAGCAGCTTTCCGGACGCGGGCCCAGCTAACTATGGCTACACCTTC	CASSFPDAGPANYGYTF	TRBV11-2	TRBJ1-2
TGCGCCAGCAGCTCCCTAAACCTGTTGGGGGGGCCCAATGAGCAGTTCTTC	CASSSLNLLGGPNEQFF	TRBV5-1	TRBJ2-1
TGTGCCAGCAGCCGCATGGGTGGCGAGCAGTACTTC	CASSRMGGEQYF	TRBV7-3	TRBJ2-7
TGTGCCACCAGCAGACCAGGCCGGGACAGGGTGGCGCATTTCATGAACACTGAAGCTTTCTTT	CATSRPGRDRVAHFMNTEAFF	TRBV15	TRBJ1-1
TGCAGTGCTACGGAGACCCAGTACTTC	CSATETQYF	TRBV20-1	TRBJ2-5
TGTGCCAGCAGCAAGGGGACGGCCTACGAGCAGTACTTC	CASSKGTAYEQYF	TRBV13	TRBJ2-7
TGTGCCAGCAGTGAGAAGCTAGGGTGTTTTAATTCACCCCTCCACTTT	CASSEKLGCFNSPLHF	TRBV25-1	TRBJ1-6
TGTGCCAGCAGCCCCGAGGGGATCGCTGGAAACACCATATATTTT	CASSPEGIAGNTIYF	TRBV7-4	TRBJ1-3
TGCGCCAGCAATGCCCCTGGGACCCAGTACTTC	CASNAPGTQYF	TRBV10-2	TRBJ2-5
TGTGTCCTGACTAGCGGCCCCCAAGAGACCCAGTACTTC	CVLTSGPQETQYF	TRBV24-1	TRBJ2-5
TGTGCCAGCCATGGTTCACTAGCGGGACAAGAGACCCAGTACTTC	CASHGSLAGQETQYF	TRBV6-2	TRBJ2-5
TGTGCCAGCAGCGGTCCCAGTCTTAGTCAAAACATTCAGTACTTC	CASSGPSLSQNIQYF	TRBV9	TRBJ2-4
TGTGCCAGCAGCCAGGGACTAACTGAAGCTTTCTTT	CASSQGLTEAFF	TRBV13	TRBJ1-1
TGTGCCAGACACCCTGTTCCACTTGGAGTGTACGAGCAGTACTTC	CARHPVPLGVYEQYF	TRBV27	TRBJ2-7
TGCGCCAGCCCCCCACAGCACAATGAGCAGTTCTTC	CASPPQHNEQFF	TRBV10-1	TRBJ2-1
TGTGCCGGGACAGCGTTTTTGGGGGTGACCGGGGAGCTGTTTTTT	CAGTAFLGVTGELFF	TRBV10-3	TRBJ2-2
TGTGCCAGCAGCCAAACGGGACTAGCGAGCGGGCACGAGCAGTACTTC	CASSQTGLASGHEQYF	TRBV9	TRBJ2-7
TGCGCCAGCAGCTGCCATGTAGCGGGTGGTAATGAGCAGTTCTTC	CASSCHVAGGNEQFF	TRBV5-1	TRBJ2-1
TGCGCCAGCAGCCAAGCAGGGACTAGCAAGGGCGGGGGGGGCGGTGGCTACGAGCAGTACTTC	CASSQAGTSKGGGGGGYEQYF	TRBV4-1	TRBJ2-7
TGTGCCAGCAGCGTAGACGGGACAGCTGGCTACACCTTC	CASSVDGTAGYTF	TRBV9	TRBJ1-2
TGTGCCAGCAGCGGGCTAGCCTACAATGAGCAGTTCTTC	CASSGLAYNEQFF	TRBV7-3	TRBJ2-1
TGTGCCAGCAGCTTATTCCCCCCCAACAGAGGTAGCAATCAGCCCCAGCATTTT	CASSLFPPNRGSNQPQHF	TRBV7-9	TRBJ1-5
TGTGCCAGCAGTGAAGTAACAGGGAGCTCCTACGAGCAGTACTTC	CASSEVTGSSYEQYF	TRBV25-1	TRBJ2-7
TGTGCCTGGAGTCAACAGGCTGTTCGGTCGCTGGGCAATCAGCCCCAGCATTTT	CAWSQQAVRSLGNQPQHF	TRBV30	TRBJ1-5
TGTGCCAGCAGCTCGCGGGAGTCCCTAGCTTTCTTT	CASSSRESLAFF	TRBV13	TRBJ1-1
TGCGCCAGCAGCCAAGACCTGGGGCAGCCACAGCCCCAGCATTTT	CASSQDLGQPQPQHF	TRBV4-1	TRBJ1-5
TGTGCCAGCAGCTTAGATCCTCCGGAGGGGCTTTCAGATACGCAGTATTTT	CASSLDPPEGLSDTQYF	TRBV11-2	TRBJ2-3
TGTGCCAGCAGCCCCAGGCTGCCACGACCAGGGACAGGTTCAGACTTAAAGCTTCCACCGAACACCGGGGAGCTGTTTTTT	CASSPRLPRPGTGSDLKLPPNTGELFF	TRBV13	TRBJ2-2
TGTGCCACCAGTGAGTGCCCCCCAGACACGATGAACACTGAAGCTTTCTTT	CATSECPPDTMNTEAFF	TRBV24-1	TRBJ1-1
TGTGCCACCAGTGAAGGACCTCTTAAGGGGGGGCCGTGGTTGGGGCCGGAAGGCCTACACATTCAGTACTTC	CATSEGPLKGGPWLGPEGLHIQYF	TRBV24-1	TRBJ2-4
TGTGCCAGCGTCACCCCGGACCCCGCAGGGACTAATGAAAAACTGTTTTTT	CASVTPDPAGTNEKLFF	TRBV28	TRBJ1-4
TGCAGTGCGGTGGGGGGAGGGGAAGCTAACTATGGCTACACCTTC	CSAVGGGEANYGYTF	TRBV20-1	TRBJ1-2
TGTGCCAGCAGCTTGCCAAGACCTTCGGTGACAGCGACCGGGAACTACGAGCAGTACTTC	CASSLPRPSVTATGNYEQYF	TRBV5-5	TRBJ2-7
TGTGCCAGCAGCCGGTACCCGGGACAGGACACAGATACGCAGTATTTT	CASSRYPGQDTDTQYF	TRBV7-9	TRBJ2-3
TGTGCCAGCAGCTCGGACAGGGAGGAGGGCTATGGCTACACCTTC	CASSSDREEGYGYTF	TRBV3-1	TRBJ1-2
TGTGCCAGCAGCAGACAGGGGTTCAATCAGCCCCAGCATTTT	CASSRQGFNQPQHF	TRBV13	TRBJ1-5
TGTGCAGAGTGCCAGGGAGGGTATAGCAATCAGCCCCAGCATTTT	CAECQGGYSNQPQHF	TRBV7-6	TRBJ1-5
TGCGCCGTCCCTAGCGGGGCCGCAGATACGCAGTATTTT	CAVPSGAADTQYF	TRBV10-1	TRBJ2-3
TGCAGTGCTAGGGCTTCGAGGGACACTGAAGCTTTCTTT	CSARASRDTEAFF	TRBV20-1	TRBJ1-1
TGTGCCACCCAACCAGCGGGATTTCTCACAGATACGCAGTATTTT	CATQPAGFLTDTQYF	TRBV19	TRBJ2-3
TGTGCCAGCAGCTTAGGGCAGGGGCAGGGAATGCAGGAAAACTATGGCTACACCTTC	CASSLGQGQGMQENYGYTF	TRBV7-2	TRBJ1-2
TGTGCCAGCAGGGGGGCCGGGACGAACTATGGCTACACCTTC	CASRGAGTNYGYTF	TRBV6-3	TRBJ1-2
TGTGCCAGCATTCGGAAATCAGGGAAGGAGGAAGGCTACGAGCAGTACTTC	CASIRKSGKEEGYEQYF	TRBV9	TRBJ2-7
TGTGCCACCAGTGATTTAGGTCATGACGAGCAGTACTTC	CATSDLGHDEQYF	TRBV24-1	TRBJ2-7
TGCGCCAGCAGCTTGATCAGGGGGGAGGGACAAGAGACCCAGTACTTC	CASSLIRGEGQETQYF	TRBV5-1	TRBJ2-5
TGTGCCAGCAGCTTAAGGGTGGGGGGGGCGCTAAGCTCCTACAATGAGCAGTTCTTC	CASSLRVGGALSSYNEQFF	TRBV7-3	TRBJ2-1
TGCGCCAGCTCCGCATTATTTAACTATGGCTACACCTTC	CASSALFNYGYTF	TRBV10-1	TRBJ1-2
TGTGCCAGCAGCTTAGAAAGCCACCTGGGGGACGTCTACGAGCAGTACTTC	CASSLESHLGDVYEQYF	TRBV7-6	TRBJ2-7
TGTGCCAGCAGCTTTGGTCTACTACGAGAGCAGTACTTC	CASSFGLLREQYF	TRBV7-2	TRBJ2-7
TGTGCCAGCAGCTTATTAAGGAACGCTACGACAGAGGAAAAACTGTTTTTT	CASSLLRNATTEEKLFF	TRBV7-3	TRBJ1-4
TGTGCCAGTACGCTGACTGAGCGATGCACAGATACGCAGTATTTT	CASTLTERCTDTQYF	TRBV19	TRBJ2-3
TGTGCCAGTAGTATAGATGGGTCCGGGACAGTTTGTGATAATTCACCCCTCCACTTT	CASSIDGSGTVCDNSPLHF	TRBV19	TRBJ1-6
TGTGCCAGCACTCGGGACAAGAGCCAAGAGACCCAGTACTTC	CASTRDKSQETQYF	TRBV7-3	TRBJ2-5
TGTGCCAGCGGCTCAACCTACGAGCAGTACTTC	CASGSTYEQYF	TRBV13	TRBJ2-7
TGTGCCAGCAGCCAAGAGAGCTATGGCTACACCTTC	CASSQESYGYTF	TRBV12-3	TRBJ1-2
TGTGCCAAGAGGGCGAAGCCTTCCTACGAGCAGTACTTC	CAKRAKPSYEQYF	TRBV19	TRBJ2-7
TGTGCCAGCAGTTGCCTAAGGCGAGGGACTCAGCCCCAGCATTTT	CASSCLRRGTQPQHF	TRBV27	TRBJ1-5
TGTGCCAGCAGCCCCCGTGAACCCATCCCGGGACAGGGTGGCACAGATACGCAGTATTTT	CASSPREPIPGQGGTDTQYF	TRBV7-2	TRBJ2-3
TGCAGTGCTAGCGCTAGGAGTAGCTCCTACGAGCAGTACTTC	CSASARSSSYEQYF	TRBV20-1	TRBJ2-7
TGTGCCAGCAGTTACTCGAGTCCTAGGGGAGACGAGCAGTACTTC	CASSYSSPRGDEQYF	TRBV6-5	TRBJ2-7
TGTGCTAGTGGTTTGGTGAGGAGCCCAGGGGGGCACACCGGGGAGCTGTTTTTT	CASGLVRSPGGHTGELFF	TRBV12-5	TRBJ2-2
TGCAGCGTTGGGAAAGGTCCGACAGGCTCCTATAATTCACCCCTCCACTTT	CSVGKGPTGSYNSPLHF	TRBV29-1	TRBJ1-6
TGCGCCAGTTACCTGTGGGTACCCTACGAGCAGTACTTC	CASYLWVPYEQYF	TRBV10-1	TRBJ2-7
TGTGCCAGCAGCTTGCTCCCGGGGGTGTGTAACACCGGGGAGCTGTTTTTT	CASSLLPGVCNTGELFF	TRBV13	TRBJ2-2
TGTGCCAGCAGAGTGGACAATGAGCAGTTCTTC	CASRVDNEQFF	TRBV27	TRBJ2-1
TGTGCCAGCAGTGAATTCGACAGGGATTATACAAACACCGGGGAGCTGTTTTTT	CASSEFDRDYTNTGELFF	TRBV6-1	TRBJ2-2
TGCGCCAGCAGCTTGGGGGAGGACAGGGGCACTGAAGCTTTCTTT	CASSLGEDRGTEAFF	TRBV5-1	TRBJ1-1
TGCAGTGCTATAGCCACTAGCGGGAGGGCGGGAATAGGCAATCAGCCCCAGCATTTT	CSAIATSGRAGIGNQPQHF	TRBV20-1	TRBJ1-5
TGTGCCAGCAGCACACCGACAGGACCCGGGGAGCTGTTTTTT	CASSTPTGPGELFF	TRBV7-9	TRBJ2-2
TGTGCCAGCAGTTACCCGTTCCTTGGCGGGAGAGGCTACACCTTC	CASSYPFLGGRGYTF	TRBV6-5	TRBJ1-2
TGCAGTGCTAGAGCACCGGGGAGGGCGGCCAAAAACATTCAGTACTTC	CSARAPGRAAKNIQYF	TRBV20-1	TRBJ2-4
TGTGCCAGCAGCCATGCTCGAAAAGAATTAAAGGGGGGGCCTTCTGGCACAGATACGCAGTATTTT	CASSHARKELKGGPSGTDTQYF	TRBV13	TRBJ2-3
TGTGCCACCAGCAGAGAGCGGGAGGGATACAATGAGCAGTTCTTC	CATSREREGYNEQFF	TRBV15	TRBJ2-1
TGTGCCAGCAGCCTATTGGTAGCTATCGGGGAGCTGTTTTTT	CASSLLVAIGELFF	TRBV13	TRBJ2-2
TGTGCCAGCAAGCAGAGTTGTTCCACAGATACGCAGTATTTT	CASKQSCSTDTQYF	TRBV5-4	TRBJ2-3
TGTGCCAGCAGCTTACCCACGAGGCGGGGAGGGACAGGAACCTACGAGCAGTACTTC	CASSLPTRRGGTGTYEQYF	TRBV7-2	TRBJ2-7
TGTGCCACCAGTGAGGGAGGGGTGGCCTACGAGCAGTACTTC	CATSEGGVAYEQYF	TRBV24-1	TRBJ2-7
TGTGCCAGCAGTGAAGAGCTGGGGAGGGGGTACAATGAGCAGTTCTTC	CASSEELGRGYNEQFF	TRBV6-1	TRBJ2-1
TGTGCCAGCTCACCACAGGGGATTAGCTCCTATAATTCACCCCTCCACTTT	CASSPQGISSYNSPLHF	TRBV18	TRBJ1-6
TGTGCCAGCAGCTTAGAGGCCGACAGGGGATATCAGGGCTTTAACATTCAGTACTTC	CASSLEADRGYQGFNIQYF	TRBV7-9	TRBJ2-4
TGTGCCAGCAGCTTACTCATGAACACTGAAGCTTTCTTT	CASSLLMNTEAFF	TRBV7-8	TRBJ1-1
TGTGCCAGCAGTACTAGCGGGCACGAGCAGTACTTC	CASSTSGHEQYF	TRBV6-2	TRBJ2-7
TGTGCCAGCAGTTCATCCCGCAACAATGAGCAGTTCTTC	CASSSSRNNEQFF	TRBV6-9	TRBJ2-1
TGTGCCAGCAGCCCCGCCCAGGGTCCCCCAGCTTTCTTT	CASSPAQGPPAFF	TRBV9	TRBJ1-1
TGTGCCACCAGAATGATACGGGTAAGACGGGAGGGCGGGGAGCAGTACTTC	CATRMIRVRREGGEQYF	TRBV24-1	TRBJ2-7
TGTGCCAGCAGCGGGAAGGGGACCTTCGCTTTCTTT	CASSGKGTFAFF	TRBV7-3	TRBJ1-1
TGTGCCAGCAGTACCCCCCCGGGACAGGGGGTCCTGTTTTTT	CASSTPPGQGVLFF	TRBV27	TRBJ1-4
TGCAGTGCTAGGAGGAGACAGCGCGTGAGCTCTGGGGCCAACGTCCTGACTTTC	CSARRRQRVSSGANVLTF	TRBV20-1	TRBJ2-6
TGTGCCAGCAGCTTAGTAGGTTTTGGGGGGGTCCGCTACAATGAGCAGTTCTTC	CASSLVGFGGVRYNEQFF	TRBV7-8	TRBJ2-1
TGCAGTGCTCGGACTAGCGGGAGCTACGAGCAGTACTTC	CSARTSGSYEQYF	TRBV20-1	TRBJ2-7
TGTGCCAGCAGCGAGGGGTTTACGGAGGGAGGCGGGGAGCTGTTTTTT	CASSEGFTEGGGELFF	TRBV3-1	TRBJ2-2
TGTGCCAGCCCCGGAGGGGAGTTGCCCCAGCATTTT	CASPGGELPQHF	TRBV28	TRBJ1-5
TGCAGTGCTAGAGATCAGGGCAGGTTGCGTAACTATGGCTACACCTTC	CSARDQGRLRNYGYTF	TRBV20-1	TRBJ1-2
TGTGCCAGCGAGTACAGGGATGCTGAAGCTTTCTTT	CASEYRDAEAFF	TRBV27	TRBJ1-1
TGTGCCAGCGACCCCTGGCCGGACAGGGCGGTATACACCATATATTTT	CASDPWPDRAVYTIYF	TRBV12-4	TRBJ1-3
TGCAGTGCTAGGTGGACAGTCGGATCCAATCAGCCCCAGCATTTT	CSARWTVGSNQPQHF	TRBV20-1	TRBJ1-5
TGTGCCAGCAGTGGCTTCCTCCCGCTAGCGGGGGAAAACACCGGGGAGCTGTTTTTT	CASSGFLPLAGENTGELFF	TRBV6-4	TRBJ2-2
TGTGCCAGCAGCGGCTACCACAATGAGCAGTTCTTC	CASSGYHNEQFF	TRBV5-5	TRBJ2-1
TGTGCCAGCTCACCACGGAGGGACAGGGGAAATCCTGAAGCTTTCTTT	CASSPRRDRGNPEAFF	TRBV18	TRBJ1-1
TGCGCCAGCAGCGGAAAGGGACTAGCGGGCCCCTACGAGCAGTACTTC	CASSGKGLAGPYEQYF	TRBV4-3	TRBJ2-7
TGTGCCAGCAGTGACTCAACGAGTTACCCCAGGGGTTCCTGTAGTCAGCCCCAGCATTTT	CASSDSTSYPRGSCSQPQHF	TRBV6-4	TRBJ1-5
TGTGCCAGCAGTCCCAGGGCGGTGGACCAGGCGAACACTGAAGCTTTCTTT	CASSPRAVDQANTEAFF	TRBV12-4	TRBJ1-1
TGCGCCAGCAGCTTGGAAACGCAGGGTATTTTGGGGGACGGGGGCCCCGCTACAGATACGCAGTATTTT	CASSLETQGILGDGGPATDTQYF	TRBV5-1	TRBJ2-3
TGTGCCGCCCGGGAGGCTCACACTGAAGCTTTCTTT	CAAREAHTEAFF	TRBV19	TRBJ1-1
TGTGCCAGCAGTGAAGCCACGTGGAGGTATCACCTCGAGCAGTACTTC	CASSEATWRYHLEQYF	TRBV6-1	TRBJ2-7
TGTGCCAGCAGTTTATCGGGGGGCCCAGGGGCGGACCAAGAGACCCAGTACTTC	CASSLSGGPGADQETQYF	TRBV12-4	TRBJ2-5
TGTGCCACCAGCAGAGATCCGACTGTGAACGAGCAGTACTTC	CATSRDPTVNEQYF	TRBV15	TRBJ2-7
TGTGCCAGCAGTATAGGGGGGGGTCGCAATCAGCCCCAGCATTTT	CASSIGGGRNQPQHF	TRBV2	TRBJ1-5
TGTGCCACCCCGGACAGGGGCTATAATTCACCCCTCCACTTT	CATPDRGYNSPLHF	TRBV24-1	TRBJ1-6
TGTGCCAGCAGTTTTAAGGATACCACAGATACGCAGTATTTT	CASSFKDTTDTQYF	TRBV27	TRBJ2-3
TGTGCCAGCAGCTTGCGGCGGTCGGCGTCCTACGAGCAGTACTTC	CASSLRRSASYEQYF	TRBV7-4	TRBJ2-7
TGTGCCAGCAGCGGGCGGGAGGAGTACACCGGGGAGCTGTTTTTT	CASSGREEYTGELFF	TRBV12-4	TRBJ2-2
TGTGCCAGCTGGTATAAGGGGAAGAATGAGCAGTTCTTC	CASWYKGKNEQFF	TRBV6-5	TRBJ2-1
TGTGCCAGCAGTTTCAGCCAGGGGACAGGGCATTCACCCCTCCACTTT	CASSFSQGTGHSPLHF	TRBV12-4	TRBJ1-6
TGTGCCAGCAGAAATCGTAGGAATGAGCAGTTCTTC	CASRNRRNEQFF	TRBV6-4	TRBJ2-1
TGTGCCAGCAGCGGGACAGGCGGTAATTCACCCCTCCACTTT	CASSGTGGNSPLHF	TRBV5-6	TRBJ1-6
TGTGCCAGTAGTGCCCAGGGGCGTGCCTACGAGCAGTACTTC	CASSAQGRAYEQYF	TRBV19	TRBJ2-7
TGTGCCAGCAGCAGGGTCCGAGGGGGTAGCTCCTACAATGAGCAGTTCTTC	CASSRVRGGSSYNEQFF	TRBV3-1	TRBJ2-1
TGTGCCAGCAGTAACCCAACCGGGACTAGCGGGTCAATTAAGACCCAGTACTTC	CASSNPTGTSGSIKTQYF	TRBV5-5	TRBJ2-5
TGTGCCAGCAGTGCAGAGGGGGACGAGCAGTACTTC	CASSAEGDEQYF	TRBV2	TRBJ2-7
TGCGCCAGCAAAACCTACAGGCCATCCCCCTCCTACAATGAGCAGTTCTTC	CASKTYRPSPSYNEQFF	TRBV10-1	TRBJ2-1
TGTGCCAGCAGCACGACTAGCGGGAATGAGCAGTTCTTC	CASSTTSGNEQFF	TRBV4-2	TRBJ2-1
TGCAGTGCTAGGCAGGGGAGGGCAAAGGGGTCCAAGAACACTGAAGCTTTCTTT	CSARQGRAKGSKNTEAFF	TRBV20-1	TRBJ1-1
TGCGCCAGCAGCTTGCACTTGACAGGGGGCGGGAGACAAGAGACCCAGTACTTC	CASSLHLTGGGRQETQYF	TRBV5-1	TRBJ2-5
TGTGCCAGCAGTTGTCCCGAGGTTGGGTGTAATGAGCAGTTCTTC	CASSCPEVGCNEQFF	TRBV27	TRBJ2-1
TGTGCCAGCTCACCATTGCTAGGGAGCACAGATACGCAGTATTTT	CASSPLLGSTDTQYF	TRBV18	TRBJ2-3
TGTGCCAGCAGTTTATATGCCCATGGGTTAGTCGACACTGAAGCTTTCTTT	CASSLYAHGLVDTEAFF	TRBV27	TRBJ1-1
TGTGCCAGCAGCTTTGACAGGGGGCAGCATCCGGGGGAGCTGTTTTTT	CASSFDRGQHPGELFF	TRBV5-4	TRBJ2-2
TGTGCCAGCAGCTTGCGTAGGGGTGGCCTGAACACTGAAGCTTTCTTT	CASSLRRGGLNTEAFF	TRBV5-6	TRBJ1-1
TGTGCCAGCATCCCGGGACGGATGACCTACGAGCAGTACTTC	CASIPGRMTYEQYF	TRBV6-1	TRBJ2-7
TGCGCCAGCAGCCAAGATGGAGGGGTTAGATCTGGAAACACCATATATTTT	CASSQDGGVRSGNTIYF	TRBV4-3	TRBJ1-3
TGTGCCAGAGGGGCAGGCTATGGCTACACCTTC	CARGAGYGYTF	TRBV27	TRBJ1-2
TGCGCCAGCGTGGGACTAGCGATCATCCCAGATACGCAGTATTTT	CASVGLAIIPDTQYF	TRBV10-1	TRBJ2-3
TGCGCCAGCAGCCCCCCCCGCGGGCAAAACATTCAGTACTTC	CASSPPRGQNIQYF	TRBV5-1	TRBJ2-4
TGTGCCAGCAGTGACCGTCCGGACACTGAAGCTTTCTTT	CASSDRPDTEAFF	TRBV6-4	TRBJ1-1
TGCGCCAGCAGACCCCAGAGCCGGGACAGGAACACTGAAGCTTTCTTT	CASRPQSRDRNTEAFF	TRBV10-1	TRBJ1-1
TGTGCCAGCAGCTTGGGACAGGAGATCGGCTACACCTTC	CASSLGQEIGYTF	TRBV7-3	TRBJ1-2
TGTGCCAGCAGCTTCCCCAGGCCCAACACAGATACGCAGTATTTT	CASSFPRPNTDTQYF	TRBV7-2	TRBJ2-3
TGTGCCAGTAACAGGGGGAGCTCCTATAATTCACCCCTCCACTTT	CASNRGSSYNSPLHF	TRBV19	TRBJ1-6
TGTGCCAGCTCCCTTAGATCCGGGGCGGGAGACAAGTCCTACGAGCAGTACTTC	CASSLRSGAGDKSYEQYF	TRBV18	TRBJ2-7
TGTGCCAAAAAGACAGGTGGATGCTACGAGCAGTACTTC	CAKKTGGCYEQYF	TRBV10-3	TRBJ2-7
TGTGCCAGCATTGCACAGGGGGGGTCGGAGCCCCAGCATTTT	CASIAQGGSEPQHF	TRBV6-1	TRBJ1-5
TGTGCCAGCAGAAAACAGGGGTACAATTCACCCCTCCACTTT	CASRKQGYNSPLHF	TRBV6-5	TRBJ1-6
TGCGCCAGCAGCTTGACTGGCCTTAGGACCCCGTACAATGAGCAGTTCTTC	CASSLTGLRTPYNEQFF	TRBV5-1	TRBJ2-1
TGTGCCAGCAGTTTATGTGTTAGGGTCAGGGATCACAATGAGCAGTTCTTC	CASSLCVRVRDHNEQFF	TRBV28	TRBJ2-1
TGTGCCAGAACCAGGGTAGGTCATGGCTACACCTTC	CARTRVGHGYTF	TRBV27	TRBJ1-2
TGTGCCAGCAGCTTGAGTGCACTACCTGGACAGGGGTATTGGAGCTATGGCTACACCTTC	CASSLSALPGQGYWSYGYTF	TRBV5-6	TRBJ1-2
TGTGCCACCCCAGGGCGAACTAGCACAGATACGCAGTATTTT	CATPGRTSTDTQYF	TRBV24-1	TRBJ2-3
TGTGCCAGCAGTTACCTAATTTCGGGACTGCCCTACGAGCAGTACTTC	CASSYLISGLPYEQYF	TRBV6-5	TRBJ2-7
TGCGCCAGCAGCTTGGGTCAGACCATGAACACTGAAGCTTTCTTT	CASSLGQTMNTEAFF	TRBV5-1	TRBJ1-1
TGTGCCAGCAGTTATATAGGGGAAAACAATGAGCAGTTCTTC	CASSYIGENNEQFF	TRBV28	TRBJ2-1
TGTGCCAGCAGCCCCCCTGGGGGGGCAGTCTCCTACAATGAGCAGTTCTTC	CASSPPGGAVSYNEQFF	TRBV7-4	TRBJ2-1
TGTGCCAGCAGTGAGGGATACGAGCAGTACTTC	CASSEGYEQYF	TRBV7-3	TRBJ2-7
TGTGCCAGCAGACAGGGACCAAACTATGGCTACACCTTC	CASRQGPNYGYTF	TRBV7-8	TRBJ1-2
TGCGCCAGCAGCTTGGGTGTTTTTCGCGCTGACAGGGAGGTCTATTCACCCCTCCACTTT	CASSLGVFRADREVYSPLHF	TRBV5-1	TRBJ1-6
TGCGCCAGCAGTGAGTCTCGCCATGATCCTAGGCAAGAGACCCAGTACTTC	CASSESRHDPRQETQYF	TRBV10-2	TRBJ2-5
TGTGCCAGCAGCCAAGCGAAGACCGACAGGGGTGTTGCCCCTAGCACAGATACGCAGTATTTT	CASSQAKTDRGVAPSTDTQYF	TRBV3-1	TRBJ2-3
TGTGCCAGCAGCCCCTCTGGGATTCACGTCCAGTTGTTGAACACTGAAGCTTTCTTT	CASSPSGIHVQLLNTEAFF	TRBV28	TRBJ1-1
TGTGCCACACCGGGACTTTCTTTTGACTATGGCTACACCTTC	CATPGLSFDYGYTF	TRBV5-8	TRBJ1-2
TGCAGTGCTACCCCCGGGGGGGGGCATCCAGATACGCAGTATTTT	CSATPGGGHPDTQYF	TRBV20-1	TRBJ2-3
TGTGCCACCAGCGGATCGATAGGCAGCCAGGAAGAGACCCAGTACTTC	CATSGSIGSQEETQYF	TRBV24-1	TRBJ2-5
TGTGCCTGGAGCGGGCGGAGCTCCTACAATGAGCAGTTCTTC	CAWSGRSSYNEQFF	TRBV30	TRBJ2-1
TGTGCCAGCAGCCAATGTCTAGCGGGCCACAATGAGCAGTTCTTC	CASSQCLAGHNEQFF	TRBV4-2	TRBJ2-1
TGTGCCAGTAGTGGGCCGGGACTAGAAATGTACGAGCAGTACTTC	CASSGPGLEMYEQYF	TRBV19	TRBJ2-7
TGCAGTGCCCCCACAGGGGCGTGTTATTCCCCCTACGAGCAGTACTTC	CSAPTGACYSPYEQYF	TRBV20-1	TRBJ2-7
TGCAGTGCATGCCGTCTAGCGGTTAGGGGGGAAGAGACCCAGTACTTC	CSACRLAVRGEETQYF	TRBV20-1	TRBJ2-5
TGTGCCAGCAGGGTCCTAGAGACAGATACGCAGTATTTT	CASRVLETDTQYF	TRBV2	TRBJ2-3
TGTGCCAGCAGCTGGTGCCCAGGGGGGGCTTTCTTT	CASSWCPGGAFF	TRBV5-6	TRBJ1-1
TGTGCCAGCATGGGAGGGGTGTTCTTC	CASMGGVFF	TRBV4-2	TRBJ2-1
TGTGCCACCAGTGGAACAACAGGGCCTGGGGCCAACGTCCTGACTTTC	CATSGTTGPGANVLTF	TRBV24-1	TRBJ2-6
TGTGCCAGCAGAATGGCTAGCGGGAGGCCTGAGCAGTACTTC	CASRMASGRPEQYF	TRBV6-2	TRBJ2-7
TGTGCCAGCAGCTATTATGGACTCTACGAGCAGTACTTC	CASSYYGLYEQYF	TRBV11-2	TRBJ2-7
TGTGCCAGCAGTTACGAATCCGTCGACAGCTTTGCCACCGGGGAGCTGTTTTTT	CASSYESVDSFATGELFF	TRBV6-5	TRBJ2-2
TGTGCCGGAGGGAACGAGCAGTACTTC	CAGGNEQYF	TRBV19	TRBJ2-7
TGTGCCAGCAAGGGACTAGCGGTATCCTACAATGAGCAGTTCTTC	CASKGLAVSYNEQFF	TRBV27	TRBJ2-1
TGTGCCAGCCGACTTGACACCATATATTTT	CASRLDTIYF	TRBV6-1	TRBJ1-3
TGTGCCAGCAGAGGGAGGGGTTGGTATTACAATCGACTAGCCAAAAACATTCAGTACTTC	CASRGRGWYYNRLAKNIQYF	TRBV6-5	TRBJ2-4
TGTGCCAGCAGCCAAGATGTCTCACCGGGAAAACCGAACACTGAAGCTTTCTTT	CASSQDVSPGKPNTEAFF	TRBV14	TRBJ1-1
TGCAGTGCTAGCTCAGGACTCCAGCCCCAGCATTTT	CSASSGLQPQHF	TRBV20-1	TRBJ1-5
TGTGCCAGCAGTTTAGCCGGGGGGGGTTCAAGCTCCTACAATGAGCAGTTCTTC	CASSLAGGGSSSYNEQFF	TRBV12-4	TRBJ2-1
TGTGCCCCACAACTAGCGGGAGTAGAGCAGTACTTC	CAPQLAGVEQYF	TRBV6-5	TRBJ2-7
TGTGCCAGTAGTATAGGCCGCAGGGAGGGAGTTGCCTACGAGCAGTACTTC	CASSIGRREGVAYEQYF	TRBV19	TRBJ2-7
TGTGCCATCACAAGACAGGGCAAAACGACTTCGGAAAAACTGTTTTTT	CAITRQGKTTSEKLFF	TRBV10-3	TRBJ1-4
TGTTCAGAGCCGGGACAGTGGAGAGTGAACACTGAAGCTTTCTTT	CSEPGQWRVNTEAFF	TRBV19	TRBJ1-1
TGTGCCAGCAGCCAAGCGGGGAGGGGCACGGATGGGGCCAACGTCCTGACTTTC	CASSQAGRGTDGANVLTF	TRBV3-1	TRBJ2-6
TGTGCCAGCAGCCCTACAGGTTACACTGAAGCTTTCTTT	CASSPTGYTEAFF	TRBV3-1	TRBJ1-1
TGTGCCAGCAGCTTTCCTAGGGGCATCATGAACACTGAAGCTTTCTTT	CASSFPRGIMNTEAFF	TRBV7-9	TRBJ1-1
TGCAGTGCTGAGGAACGGAACACTGAAGCTTTCTTT	CSAEERNTEAFF	TRBV20-1	TRBJ1-1
TGTGCCAGCAGCTTGGGCCCGGCCAGCAGGGGGCTACGGTACCATCAGCCCCAGCATTTT	CASSLGPASRGLRYHQPQHF	TRBV5-6	TRBJ1-5
TGTGCCAGTAGTCCCCAAGACAGGGCTGAAGAGACCCAGTACTTC	CASSPQDRAEETQYF	TRBV19	TRBJ2-5
TGTGCCAGCACCCCGGGACCAAGCCGGCCTGGAAACACCATATATTTT	CASTPGPSRPGNTIYF	TRBV6-3	TRBJ1-3
TGTGCCGACCGGCACACTGAAGCTTTCTTT	CADRHTEAFF	TRBV7-9	TRBJ1-1
TGTGCCAGCAGCGTAGGACTGAAGAGGGGGGTCTACGAGCAGTACTTC	CASSVGLKRGVYEQYF	TRBV9	TRBJ2-7
TGCGCCAGCAGTGAGGATGGGTCCATACACGAGCAGTACTTC	CASSEDGSIHEQYF	TRBV10-1	TRBJ2-7
TGCAGTGCTCATGGGGGGGAAAGGGGCTGTCACACCGGGGAGCTGTTTTTT	CSAHGGERGCHTGELFF	TRBV20-1	TRBJ2-2
TGTGCCAGCAGCCAAGATGTGTCGGGCGCAGCCCCAGTTCAAGCCGTCGACAGACCAGTCACTGAAGCTTTCTTT	CASSQDVSGAAPVQAVDRPVTEAFF	TRBV3-1	TRBJ1-1
TGTGCCAGTAGTATTTTGATGCTAGCGGGTAAGACAGAGACCCAGTACTTC	CASSILMLAGKTETQYF	TRBV19	TRBJ2-5
TGTGCCAGCAGCCTCCGCGGTGGGACCGGGGAGCTGTTTTTT	CASSLRGGTGELFF	TRBV7-2	TRBJ2-2
TGTGCCAGCAGCCGGAAGGTGACACGATCTAACTATGGCTACACCTTC	CASSRKVTRSNYGYTF	TRBV11-2	TRBJ1-2
TGTGCCAGCAGTTCAGGCGGGAGTGAAAAACTGTTTTTT	CASSSGGSEKLFF	TRBV12-3	TRBJ1-4
TGTGCCAGACCAGGACAGGGCGTGAACACTGAAGCTTTCTTT	CARPGQGVNTEAFF	TRBV6-6	TRBJ1-1
TGTGCCAGCAGCGTTTTTACTAGCGGGGATTTCACAGATACGCAGTATTTT	CASSVFTSGDFTDTQYF	TRBV5-6	TRBJ2-3
TGTGCCACCAGTACCGGACAGCGAAGGGTTTACACCGGGGAGCTGTTTTTT	CATSTGQRRVYTGELFF	TRBV24-1	TRBJ2-2
TGTGCCAGCAGTCGAGAGCCCTCCGCCAAAAACATTCAGTACTTC	CASSREPSAKNIQYF	TRBV6-2	TRBJ2-4
TGCAGTGCCGGAGGGCGGGAGACCCAGTACTTC	CSAGGRETQYF	TRBV20-1	TRBJ2-5
TGTGCCAGCAGTAGGACAACCGTCCAGGCGTTGGACAATGAGCAGTTCTTC	CASSRTTVQALDNEQFF	TRBV12-3	TRBJ2-1
TGTGCCAGCAGTAGAACCCCGGGTCCTGGCTACACCTTC	CASSRTPGPGYTF	TRBV9	TRBJ1-2
TGTGCCAGCAGCCTTTGCGGGAGGCAGTACTTC	CASSLCGRQYF	TRBV7-3	TRBJ2-7
TGTGCCAGCAGCTACCTTGTTAAAGGAGGTGACATATTAGACGGAGCTAACTATGGCTACACCTTC	CASSYLVKGGDILDGANYGYTF	TRBV7-3	TRBJ1-2
TGTGCCAGCACCTTTAGAAATAAGCAGTACTTC	CASTFRNKQYF	TRBV2	TRBJ2-7
TGTGCCAGCAGCTCGCGCCCCCACCAAGAGACCCAGTACTTC	CASSSRPHQETQYF	TRBV9	TRBJ2-5
TGTGCCAGCTCACCACCCCCGGGGACAGGGGGCACAGATACGCAGTATTTT	CASSPPPGTGGTDTQYF	TRBV18	TRBJ2-3
TGTGCCACCAGTGATTGCCGAACAGAAGACACCGGGGAGCTGTTTTTT	CATSDCRTEDTGELFF	TRBV24-1	TRBJ2-2
TGTGCCAGCAGTCTGGTGGGGGGGGCCGGCTACACCTTC	CASSLVGGAGYTF	TRBV6-1	TRBJ1-2
TGCGCCAGCAGCTCCCCAGGGACTAGCGGGGGGAGTCAAAATGAGCAGTTCTTC	CASSSPGTSGGSQNEQFF	TRBV5-1	TRBJ2-1
TGTGCCAGCGGGGCGGAGGCTGAAGCTTTCTTT	CASGAEAEAFF	TRBV6-5	TRBJ1-1
TGTGCCAGCAGCGTAGAAAGGACTAGCGGATCCTACAATGAGCAGTTCTTC	CASSVERTSGSYNEQFF	TRBV9	TRBJ2-1
TGCAGTGCTAGAGGGATCCCCACAATGCTCTACGAGCAGTACTTC	CSARGIPTMLYEQYF	TRBV20-1	TRBJ2-7
TGTGCCAGCAGTGAAGCGCTTCACAAATGGGAGGCGGGCTACGAGCAGTACTTC	CASSEALHKWEAGYEQYF	TRBV2	TRBJ2-7
TGCGCCAGCAGCCAAGATTGCCTAGGGGAGGGGGAGATGCCTGGAAACACCATATATTTT	CASSQDCLGEGEMPGNTIYF	TRBV4-1	TRBJ1-3
TGCGCCAGCAGCTGTAAACTAGCGGGAGGGCAGTCCTACGAGCAGTACTTC	CASSCKLAGGQSYEQYF	TRBV5-1	TRBJ2-7
TGTGCCAGCAGCCGGAGACTAGCGTTCTTGTACAATGAGCAGTTCTTC	CASSRRLAFLYNEQFF	TRBV5-5	TRBJ2-1
TGTGCCAGCTCTGAGACCCGGAAACCGAGACAGGTTCCCTACGAGCAGTACTTC	CASSETRKPRQVPYEQYF	TRBV18	TRBJ2-7
TGCAGTGCTAGAGATAAAAAGGTAGTGCACAATGAGCAGTTCTTC	CSARDKKVVHNEQFF	TRBV20-1	TRBJ2-1
TGTGCCAGCAGCCAAGGGGGGGACGGGTACACAGATACGCAGTATTTT	CASSQGGDGYTDTQYF	TRBV14	TRBJ2-3
TGTGCCAGCAGACCCGGGACTAGGGCTGGGTACGACGCCACAGATACGCAGTATTTT	CASRPGTRAGYDATDTQYF	TRBV6-5	TRBJ2-3
TGTGCTAGTGGTCACACAGGTTTTAATCAGCCCCAGCATTTT	CASGHTGFNQPQHF	TRBV12-5	TRBJ1-5
TGTGCCAGCAGCGAGAATCCGAGCTCCTACGAGCAGTACTTC	CASSENPSSYEQYF	TRBV7-9	TRBJ2-7
TGTGCCAGCAGGTGTAGACAGGGAGAAGCTTTCTTT	CASRCRQGEAFF	TRBV6-5	TRBJ1-1
TGTGCCAGATCGAGGGCACCCGGGACAGGGTCGCCAGGATATGGCTACACCTTC	CARSRAPGTGSPGYGYTF	TRBV9	TRBJ1-2
TGTGCCAGCAGCTTGGGACAGCCGATAGATACGCAGTATTTT	CASSLGQPIDTQYF	TRBV7-4	TRBJ2-3
TGTGCCACCATGAGGGGGGGTAACTATGGCTACACCTTC	CATMRGGNYGYTF	TRBV24-1	TRBJ1-2
TGTGCCAGCAGTTACGGACTAGCGGGGAAAAATGAGCAGTTCTTC	CASSYGLAGKNEQFF	TRBV6-2	TRBJ2-1
TGTGCCAGCAGCTCCCTTTCTAATTCACCCCTCCACTTT	CASSSLSNSPLHF	TRBV9	TRBJ1-6
TGTGCCAGCAGCTCTTCGAACACCTACGAGCAGTACTTC	CASSSSNTYEQYF	TRBV9	TRBJ2-7
TGTGCCAGCAGTAGCCCGGGAGACAGGAGGCCCGAGACCCAGTACTTC	CASSSPGDRRPETQYF	TRBV7-9	TRBJ2-5
TGCGCCAGCAGCTTATACACTAGCGGGAGGGCGGGCGACTACAATGAGCAGTTCTTC	CASSLYTSGRAGDYNEQFF	TRBV5-1	TRBJ2-1
TGCAGTGGATCCCCGGATCCGGGACAGGGGGGTCCCCCCAGGAACACTGAAGCTTTCTTT	CSGSPDPGQGGPPRNTEAFF	TRBV20-1	TRBJ1-1
TGTGCCAGCAGTTACGCAGTGCGGGAGGTCTCCTACGAGCAGTACTTC	CASSYAVREVSYEQYF	TRBV6-5	TRBJ2-7
TGTGCCAGCAGCTTCCCCTCTTTGGGCTATGGCTACACCTTC	CASSFPSLGYGYTF	TRBV13	TRBJ1-2
TGTGCCAGCAGTCCTTGGGACAGGAACAATGAGCAGTTCTTC	CASSPWDRNNEQFF	TRBV6-1	TRBJ2-1
TGTGCCCCTTCCCCCCAGCGCTCTGGAAACACCATATATTTT	CAPSPQRSGNTIYF	TRBV30	TRBJ1-3
TGTGCCACCAGTGATTCCGCGATCCCCAGGGGGGGAGAGGGGAACATTCAGTACTTC	CATSDSAIPRGGEGNIQYF	TRBV24-1	TRBJ2-4
TGTGCCACCAGCAGAGATGAGCCCTGGGACAGGGAAGACAACTATGGCTACACCTTC	CATSRDEPWDREDNYGYTF	TRBV15	TRBJ1-2
TGCGCCAGCATCTACAGGGATGTCGCTGGCTACACCTTC	CASIYRDVAGYTF	TRBV5-1	TRBJ1-2
TGTGCCAGCAGCGTAGCTAGCACTCGGGGGAACATTCAGTACTTC	CASSVASTRGNIQYF	TRBV9	TRBJ2-4
TGTGCCAGCAGGGGTCCTCCTCCCATAGCCAAAAACATTCAGTACTTC	CASRGPPPIAKNIQYF	TRBV7-9	TRBJ2-4
TGTGCCAGCAACTTGGGACAGGGGGCGCCTTGGCAAGAGACCCAGTACTTC	CASNLGQGAPWQETQYF	TRBV27	TRBJ2-5
TGTGCCAGCGTTCACTCGGAGTACGAGCAGTACTTC	CASVHSEYEQYF	TRBV12-4	TRBJ2-7
TGTGCCAGCAGCTTGACATTGGAAGCGGTAGCGGACGACGAGCAGTACTTC	CASSLTLEAVADDEQYF	TRBV7-9	TRBJ2-7
TGCAGTGCTAGGTATCGGAAAGAGACCCAGTACTTC	CSARYRKETQYF	TRBV20-1	TRBJ2-5
TGTGCCAGCAGCAGACATACACAGGGTGAAAAACTGTTTTTT	CASSRHTQGEKLFF	TRBV13	TRBJ1-4
TGCAGTGCTCGGGGGCGTTTCGAGCAGTACTTC	CSARGRFEQYF	TRBV20-1	TRBJ2-7
TGTGCCAGCAGTCTTTCAGGGCGTAGGAGGGATAGCTCCTATAATTCACCCCTCCACTTT	CASSLSGRRRDSSYNSPLHF	TRBV12-3	TRBJ1-6
TGTGCCAGCAGCGCTACTGTCCCACTAGCGGGGGGAGATACGCAGTATTTT	CASSATVPLAGGDTQYF	TRBV7-3	TRBJ2-3
TGTGCCAGCAGCCACCGGGGACAGCCCCAGCATTTT	CASSHRGQPQHF	TRBV14	TRBJ1-5
TGTGCCAGCAGCCAAGATGGGACACCGGGGGCCTTAAATCAGCCCCAGCATTTT	CASSQDGTPGALNQPQHF	TRBV14	TRBJ1-5
TGTGCCAGCAGTTACTACGGAGGACTAAGTGGAAACACCATATATTTT	CASSYYGGLSGNTIYF	TRBV6-5	TRBJ1-3
TGTGCCAGCAGCCAAGATGCTTGGACAGGCTCACCCCTCCACTTT	CASSQDAWTGSPLHF	TRBV14	TRBJ1-6
TGCAGTGCTAGTCTCCGAGCGTTCTGGGAAGCGGAGGCCTACGAGCAGTACTTC	CSASLRAFWEAEAYEQYF	TRBV20-1	TRBJ2-7
TGTGCCAGCAGCTGGGCCTCAGGCTGTACGCAGTATTTT	CASSWASGCTQYF	TRBV5-5	TRBJ2-3
TGTGCCAGCAGTCGCAGGGCTAATTATCCCCGGAACACTGAAGCTTTCTTT	CASSRRANYPRNTEAFF	TRBV11-3	TRBJ1-1
TGCAGTGCTATCGCGGGACTTCTGGTCACAGATACGCAGTATTTT	CSAIAGLLVTDTQYF	TRBV20-1	TRBJ2-3
TGTGCCAGCAGCAGGTTCCTAGCAGGTGAAAGCGAGCAGTACTTC	CASSRFLAGESEQYF	TRBV13	TRBJ2-7
TGTGCCACTCCCGGACTACTTCTTACTGAAGCTTTCTTT	CATPGLLLTEAFF	TRBV24-1	TRBJ1-1
TGCGCCAGCAGCCTTCCGATCCAGCGGGATAAGAAGACCCAGTACTTC	CASSLPIQRDKKTQYF	TRBV4-3	TRBJ2-5
TGTGCCAGCAGCTTGGTGAGGGTCCCCGGGACAGCCCTGTTGGAATACGAGCAGTACTTC	CASSLVRVPGTALLEYEQYF	TRBV5-4	TRBJ2-7
TGTGCCAAAAAAGAGGACAGAACGCTGCGGTGCAATTCACCCCTCCACTTT	CAKKEDRTLRCNSPLHF	TRBV12-3	TRBJ1-6
TGTGCCAGCATCTTTTCAAAAGGACCAGGGACAGGGGGGACACTAATCGAGCAGTACTTC	CASIFSKGPGTGGTLIEQYF	TRBV6-5	TRBJ2-7
TGCGCCAGCACGGTTAGCGGGGCCTACGAGCAGTACTTC	CASTVSGAYEQYF	TRBV10-2	TRBJ2-7
TGTGCCAGCAGCGTCACGGAAGAGACCCAGTACTTC	CASSVTEETQYF	TRBV5-4	TRBJ2-5
TGTGCCCCCCTTGTCAGAGGGGCCACTGAAGCTTTCTTT	CAPLVRGATEAFF	TRBV6-2	TRBJ1-1
TGTGCCCTAACATGGGGGGGGGGCAATGAGCAGTTCTTC	CALTWGGGNEQFF	TRBV9	TRBJ2-1
TGTGCCAGCAGCTCCCCTGGGGGGGGGTACGAGCAGTACTTC	CASSSPGGGYEQYF	TRBV7-4	TRBJ2-7
TGTGCCAGCAGCCACCTGCGGAATGATGAGCAGTTCTTC	CASSHLRNDEQFF	TRBV14	TRBJ2-1
TGTGCCAGCAGCGTAGTTAAAACTGGGGAAATTTTTGCGAATGAAAAACTGTTTTTT	CASSVVKTGEIFANEKLFF	TRBV9	TRBJ1-4
TGCGCCAGCACGAACCTCGGGACTAGAGGGTGCTCCTACAATGAGCAGTTCTTC	CASTNLGTRGCSYNEQFF	TRBV10-1	TRBJ2-1
TGTGCCAGCAGTGGGGGGCGGTTGGGGCAAGAGACCCAGTACTTC	CASSGGRLGQETQYF	TRBV25-1	TRBJ2-5
TGTGCCAGCAGCTTGAAAGTGCGACAGCGCTCTGGAAACACCATATATTTT	CASSLKVRQRSGNTIYF	TRBV5-6	TRBJ1-3
TGTGCCAGCAGCGAACAGGGATCCCTGAACACTGAAGCTTTCTTT	CASSEQGSLNTEAFF	TRBV5-6	TRBJ1-1
TGCGCCAGCAGCGGAAAATTGTTAGCGGGTCTTCTCAACAATGAGCAGTTCTTC	CASSGKLLAGLLNNEQFF	TRBV5-1	TRBJ2-1
TGTGCCAGCAGTTTAGGACCTAGCGGGCGTTACAATGAGCAGTTCTTC	CASSLGPSGRYNEQFF	TRBV27	TRBJ2-1
TGTGCCAGTAGTAAAAGGAAAATTCCGACCCGGAGAGAGACCCAGTACTTC	CASSKRKIPTRRETQYF	TRBV19	TRBJ2-5
TGTGCCAGTAGCCGCAGCCTAGCGGGGCCGAACACCGGGGAGCTGTTTTTT	CASSRSLAGPNTGELFF	TRBV19	TRBJ2-2
TGCAGTGCTATTAGCGGGAAATGTTTGGGGAGCTCCTACGAGCAGTACTTC	CSAISGKCLGSSYEQYF	TRBV20-1	TRBJ2-7
TGTGCCAGCAGCTACCCGGGGAACCAAGAGACCCAGTACTTC	CASSYPGNQETQYF	TRBV7-6	TRBJ2-5
TGTGCCAGCAGCTTAGGCCCCTCTGGGGACGAGCAGTACTTC	CASSLGPSGDEQYF	TRBV7-2	TRBJ2-7
TGTGCCAGTGCGGGATTTTCACCCCTCCACTTT	CASAGFSPLHF	TRBV2	TRBJ1-6
TGTGCCAGCAGCGAAGTTCAGCATCCGGGACAGCCCTATGGCTACACCTTC	CASSEVQHPGQPYGYTF	TRBV4-2	TRBJ1-2
TGTGCCAGCAGTTTCGTGACTCAAACAGATACGCAGTATTTT	CASSFVTQTDTQYF	TRBV28	TRBJ2-3
TGTGCCAGCAGGAGGGGGGTGAACACTGAAGCTTTCTTT	CASRRGVNTEAFF	TRBV7-9	TRBJ1-1
TGTGCCAGTAGTTTGGGACAGGGCTCCTACAATGAGCAGTTCTTC	CASSLGQGSYNEQFF	TRBV19	TRBJ2-1
TGTGCCAGCAGCCTTCGACAGAGCGCCACCGGGGAGCTGTTTTTT	CASSLRQSATGELFF	TRBV7-2	TRBJ2-2
TGTGCCAGCAGCTTAGCGGGGCTAGAGACAGGTCAAAATGAGCAGTTCTTC	CASSLAGLETGQNEQFF	TRBV7-6	TRBJ2-1
TGTGCCAGCAGTACAACTTACAATGAGCAGTTCTTC	CASSTTYNEQFF	TRBV6-3	TRBJ2-1
TGTGCCAGCAGCTCGGAGGACCGCGAAAAACTGTTTTTT	CASSSEDREKLFF	TRBV11-2	TRBJ1-4
TGTGCCAGCTCACCACACGCGGACGAATCTGGGGCCAACGTCCTGACTTTC	CASSPHADESGANVLTF	TRBV18	TRBJ2-6
TGCAGTGCTAACGGAGGGGTCTCCTATGGCTACACCTTC	CSANGGVSYGYTF	TRBV20-1	TRBJ1-2
TGCAGTGCTGGATTTACAGGGAGGTCCTACGAGCAGTACTTC	CSAGFTGRSYEQYF	TRBV20-1	TRBJ2-7
TGTGCCAGCAGTTACTCGAAGGGACAGGGGTTTGGCTACACCTTC	CASSYSKGQGFGYTF	TRBV6-5	TRBJ1-2
TGTGCCAGCAGCGAAGGGCTGGGGAGCTATGGCTACACCTTC	CASSEGLGSYGYTF	TRBV9	TRBJ1-2
TGTGGCAGGAGTGTAGCCAAAAACATTCAGTACTTC	CGRSVAKNIQYF	TRBV6-5	TRBJ2-4
TGTGCCAGCAGTTCCAAACAGGTAGATACAAATCAGCCCCAGCATTTT	CASSSKQVDTNQPQHF	TRBV27	TRBJ1-5
TGTGCCAGCAGCCCCTGGGGAATCGTACAGAGTGAAAAACTGTTTTTT	CASSPWGIVQSEKLFF	TRBV11-2	TRBJ1-4
TGTGCCAGCAGCAGTCCTCCAGGAAAGTATGGCTACACCTTC	CASSSPPGKYGYTF	TRBV7-3	TRBJ1-2
TGTGCCAGCAGGACCGGGTTAGGACTACAAGAGACCCAGTACTTC	CASRTGLGLQETQYF	TRBV6-2	TRBJ2-5
TGTGCCACCAGTGATCGGTGGGAAGAAGCTTTCTTT	CATSDRWEEAFF	TRBV24-1	TRBJ1-1
TGTGCCAGCAGTTTATGTCCCGAGACAGATTTCACCTACGAGCAGTACTTC	CASSLCPETDFTYEQYF	TRBV28	TRBJ2-7
TGTGCCAGCAGCGCATTAGGAGGTGGGACTAGCGGGCCCCGGTACAATGAGCAGTTCTTC	CASSALGGGTSGPRYNEQFF	TRBV9	TRBJ2-1
TGTGCCAGCAGCCCCCGCGTAGACAGGGATGAGCAGTTCTTC	CASSPRVDRDEQFF	TRBV7-3	TRBJ2-1
TGCGCCAGCACAGGACTAGACATTACAGATACGCAGTATTTT	CASTGLDITDTQYF	TRBV10-1	TRBJ2-3
TGTGCCAGCAGCCAACCATGGGGGGGTCACTACAATGAGCAGTTCTTC	CASSQPWGGHYNEQFF	TRBV13	TRBJ2-1
TGTGCCTGGAGTGTGCACTCCGGGACAGGATCTCGAGATCAGCCCCAGCATTTT	CAWSVHSGTGSRDQPQHF	TRBV30	TRBJ1-5
TGTGCCAGCAGCACGGGACAGGGTCTCTACGAGCAGTACTTC	CASSTGQGLYEQYF	TRBV5-4	TRBJ2-7
TGTGCCAGCAGCTTAGTTAACTTTCATATCAGGCGCACTATTGGAGCTAACTATGGCTACACCTTC	CASSLVNFHIRRTIGANYGYTF	TRBV7-3	TRBJ1-2
TGTGCCAGCAGCTTGGGGTTCCATGACACCGGGGAGCTGTTTTTT	CASSLGFHDTGELFF	TRBV11-2	TRBJ2-2
TGTGCTAGCAGCAGCGGGGACGGCACAGATACGCAGTATTTT	CASSSGDGTDTQYF	TRBV7-7	TRBJ2-3
TGTGCCAGCAGCCGCGGGCCCCGTGGCTACACCTTC	CASSRGPRGYTF	TRBV13	TRBJ1-2
TGCAGCGTTGCCAAAGACATTAGTGGAAACACCATATATTTT	CSVAKDISGNTIYF	TRBV29-1	TRBJ1-3
TGTGCCAGCAGTTACGGTACGTTTACGGAGTTCGCAGATACGCAGTATTTT	CASSYGTFTEFADTQYF	TRBV12-4	TRBJ2-3
TGCAGCGTTTTACAGGGGAACTATGGCTACACCTTC	CSVLQGNYGYTF	TRBV29-1	TRBJ1-2
TGTGCTAGTGGTTTGGTACCCCCCCTAGATGCCCGGGACAGGGGGGGAGCCAAAAACATTCAGTACTTC	CASGLVPPLDARDRGGAKNIQYF	TRBV12-5	TRBJ2-4
TGCGCCAGCAGCTCTAACCCCGGGACGCGACGCTACGAGCAGTACTTC	CASSSNPGTRRYEQYF	TRBV5-1	TRBJ2-7
TGTGCCAGCAGCCCCAGAAAAAGAGGTGAGCAGTTCTTC	CASSPRKRGEQFF	TRBV7-8	TRBJ2-1
TGTGCCAGCAGTTACGCCTCGAGGGGACTGGTTAATGAGCAGTTCTTC	CASSYASRGLVNEQFF	TRBV6-5	TRBJ2-1
TGTGCCAGCAGTTCCCGGCGGGAGATCTACGAGCAGTACTTC	CASSSRREIYEQYF	TRBV27	TRBJ2-7
TGCAGCGTTGCGAAAAGACAGGACTCCTACGAGCAGTACTTC	CSVAKRQDSYEQYF	TRBV29-1	TRBJ2-7
TGTGCCAGCAGTTTAAAGTTGCGGGACCGTGAATGCTACGAGCAGTACTTC	CASSLKLRDRECYEQYF	TRBV27	TRBJ2-7
TGCAGTGCTAGAGATTTTGGCCATGACGTCACTGAAGCTTTCTTT	CSARDFGHDVTEAFF	TRBV20-1	TRBJ1-1
TGCGCCAGCAGCTTAGAACCTACAGGGGGCGATTCACCCCTCCACTTT	CASSLEPTGGDSPLHF	TRBV5-1	TRBJ1-6
TGTGCCAGCAGTTTTCGGACGGGCTCTGGAAACACCATATATTTT	CASSFRTGSGNTIYF	TRBV12-3	TRBJ1-3
TGCAGTGCTAGGCGGAGCATCCATGGCTACACCTTC	CSARRSIHGYTF	TRBV20-1	TRBJ1-2
TGCGCCAGCAGTGACCTTACCGGGACTAGCGGGCGGGACCGGGTGTCCTACAATGAGCAGTTCTTC	CASSDLTGTSGRDRVSYNEQFF	TRBV10-1	TRBJ2-1
TGTGCCAGCAGCGGGGGGGGGTGGAGGTCTCAGTGCTCAGATACGCAGTATTTT	CASSGGGWRSQCSDTQYF	TRBV13	TRBJ2-3
TGTGCCACCAGCAGCCCCGGGACTAGCGGTTCAGATACGCAGTATTTT	CATSSPGTSGSDTQYF	TRBV15	TRBJ2-3
TGTGCCTGGAGTAAGGGGCGGGAGCACGGAAGGGGCTACGAGCAGTACTTC	CAWSKGREHGRGYEQYF	TRBV30	TRBJ2-7
TGTGCCAGCAGCATAACGGGGACACCCTACGAGCAGTACTTC	CASSITGTPYEQYF	TRBV7-6	TRBJ2-7
TGTGCCAGCAGTTTGCAAGGGAATGATGGCTACACCTTC	CASSLQGNDGYTF	TRBV27	TRBJ1-2
TGCGCCAGCAGTGATCCGGACATTGACGTTCCCTACGAGCAGTACTTC	CASSDPDIDVPYEQYF	TRBV10-2	TRBJ2-7
TGTGCCAGCAGCTTAGTGGGGTCCTCCTACGAGCAGTACTTC	CASSLVGSSYEQYF	TRBV11-2	TRBJ2-7
TGTGCCAGCAGCCAAGCCACCCCAGTACCAGAGACCCAGTACTTC	CASSQATPVPETQYF	TRBV14	TRBJ2-5
TGTGCCAGCAGCTTAGTGACCAATGAGCAGTTCTTC	CASSLVTNEQFF	TRBV7-2	TRBJ2-1
TGTGCCATCAGTGAGAAACAGGCATGGGCCGAGCAGTACTTC	CAISEKQAWAEQYF	TRBV10-3	TRBJ2-7
TGTGCCAGTAACCCCGGGGACAGCACCCTCCGCTCTGGAAACACCATATATTTT	CASNPGDSTLRSGNTIYF	TRBV19	TRBJ1-3
TGCGCCAAGCAACATATATACAATGAGCAGTTCTTC	CAKQHIYNEQFF	TRBV10-1	TRBJ2-1
TGTGCCAGCAGCCAAGAATCCGGGACAGGGGGCAGGGTGATGTACGAGCAGTACTTC	CASSQESGTGGRVMYEQYF	TRBV14	TRBJ2-7
TGTGCCTGGCTCCCAGGGGGGGAGCAGTACTTC	CAWLPGGEQYF	TRBV30	TRBJ2-7
TGTGCCAGCAGCCAACGCACAGGGGGCCCCTCATACCCCTACGAGCAGTACTTC	CASSQRTGGPSYPYEQYF	TRBV4-2	TRBJ2-7
TGTGCCAGCAGCAATCCCTTCCGGGGCTTCTTACGCGAGCAGTACTTC	CASSNPFRGFLREQYF	TRBV13	TRBJ2-7
TGCGCCAGCAGTCCAGACAGGGGGTACGAGCAGTACTTC	CASSPDRGYEQYF	TRBV10-1	TRBJ2-7
TGTGCCAGCAGCCCTGCCCCGGGGGACCCGTACCAAGAGACCCAGTACTTC	CASSPAPGDPYQETQYF	TRBV3-1	TRBJ2-5
TGTGCCAGCAGTTTTAGGACTAGCGGGGATACCTACGAGCAGTACTTC	CASSFRTSGDTYEQYF	TRBV27	TRBJ2-7
TGTGCCAGCAGTTCCTGTCCTAGGACGACTAATGAAAAACTGTTTTTT	CASSSCPRTTNEKLFF	TRBV12-4	TRBJ1-4
TGTGCCAGCAGCCAGATTACCGATCGTAAGCGGACAGGGCCTAGCAATCAGCCCCAGCATTTT	CASSQITDRKRTGPSNQPQHF	TRBV7-3	TRBJ1-5
TGTGCCAGCAGCTTAGGAATGGGACAGTATTGCTACGAGCAGTACTTC	CASSLGMGQYCYEQYF	TRBV11-2	TRBJ2-7
TGTGCCAGCAGCAATTCAAGGGGGCAATTTGGCTCCTACGAGCAGTACTTC	CASSNSRGQFGSYEQYF	TRBV5-5	TRBJ2-7
TGCGCCAGCCCGCGACGCATAGCTCAGCCCCAGCATTTT	CASPRRIAQPQHF	TRBV10-1	TRBJ1-5
TGTGCCACCAGTGATTTCTGGTCGGGGCGGCCATATAATCAGCCCCAGCATTTT	CATSDFWSGRPYNQPQHF	TRBV24-1	TRBJ1-5
TGTGCCAGCAGCTTCGGATGGAATAAGAGCTCCTATAATTCACCCCTCCACTTT	CASSFGWNKSSYNSPLHF	TRBV7-2	TRBJ1-6
TGTGCCAGCAGCGGGACAGGGTCCACTGAAGCTTTCTTT	CASSGTGSTEAFF	TRBV6-3	TRBJ1-1
TGTGCCAGCAGTTACGAACTAGGACTGAACTCCAATCAGCCCCAGCATTTT	CASSYELGLNSNQPQHF	TRBV6-6	TRBJ1-5
TGTGCCAGCAGCCCGCAAAAAGAGCGGAGAACCTACGAGCAGTACTTC	CASSPQKERRTYEQYF	TRBV13	TRBJ2-7
TGTGCCAGCAGTGAGGGGGGGACAGGCTACGAGCAGTACTTC	CASSEGGTGYEQYF	TRBV25-1	TRBJ2-7
TGCGCCAGCAGCTTCAAAACTGGGGGAAACACTGAAGCTTTCTTT	CASSFKTGGNTEAFF	TRBV5-1	TRBJ1-1
TGTGCCACCAGCCTAGCGGGCAATGAGCAGTTCTTC	CATSLAGNEQFF	TRBV15	TRBJ2-1
TGTGCCAGCAGTTTCTCAGGGGCTGCTGAAGCTTTCTTT	CASSFSGAAEAFF	TRBV27	TRBJ1-1
TGTGCCAGCAGTGACTCTGGGACAGGGTTCCTTGGCTACACCTTC	CASSDSGTGFLGYTF	TRBV6-4	TRBJ1-2
TGCAGTGCTGGTGGGACAGGGGGAGCCGAGACCCAGTACTTC	CSAGGTGGAETQYF	TRBV20-1	TRBJ2-5
TGTGCCTGGAGTGTACCCGACAGGACATTTGAAAAACTGTTTTTT	CAWSVPDRTFEKLFF	TRBV30	TRBJ1-4
TGTGCCAGCGATCAGGTCCCCTACGAGCAGTACTTC	CASDQVPYEQYF	TRBV27	TRBJ2-7
TGTGCCAGCAGCAAGGGCCACACTGAAGCTTTCTTT	CASSKGHTEAFF	TRBV5-6	TRBJ1-1
TGTGCCAGCGGACCCAGGACAAATACGCAGTATTTT	CASGPRTNTQYF	TRBV7-3	TRBJ2-3
TGCGCCAGCAGCTCCCCACTTCCCCGGGACACATTTAGGTATAGCAATCAGCCCCAGCATTTT	CASSSPLPRDTFRYSNQPQHF	TRBV5-1	TRBJ1-5
TGTGCCAGCAGCTTAGGGGGGACAGCCGGCTACGAGCAGTACTTC	CASSLGGTAGYEQYF	TRBV7-4	TRBJ2-7
TGTGCCACCGGGGGCACCTCCTACAATGAGCAGTTCTTC	CATGGTSYNEQFF	TRBV24-1	TRBJ2-1
TGTGCCATCAGTGACAGGGCCCGGACAGACTCTGGGGCCAACGTCCTGACTTTC	CAISDRARTDSGANVLTF	TRBV10-3	TRBJ2-6
TGTGCCAGCAGTTCCAAATTAGGGGGGGCCTTAAGTAGCACAGATACGCAGTATTTT	CASSSKLGGALSSTDTQYF	TRBV6-5	TRBJ2-3
TGCGCCAGCAGCGCGGTCTCCTACGAGCAGTACTTC	CASSAVSYEQYF	TRBV5-1	TRBJ2-7
TGCGCCAGCAGGGAAGGGGGGGGAGGGTACGAGCAGTACTTC	CASREGGGGYEQYF	TRBV10-1	TRBJ2-7
TGTGCCAGCAGTGTACTAGCGGGAGGGAGACACGAGCAGTACTTC	CASSVLAGGRHEQYF	TRBV27	TRBJ2-7
TGCAGTGCTTGGCTCCTAGGGGGGGCGCCCCAGCATTTT	CSAWLLGGAPQHF	TRBV20-1	TRBJ1-5
TGTGCCAGCAGCGGATACACCGTAAGCGGATGCTCCGGGGAGCTGTTTTTT	CASSGYTVSGCSGELFF	TRBV13	TRBJ2-2
TGCGCCAGCAGCCAGGAGAGGGCAGATGAGCAGTTCTTC	CASSQERADEQFF	TRBV4-1	TRBJ2-1
TGCGCCAGCAGCTTGGGGTCACAGGGTCACACTGAAGCTTTCTTT	CASSLGSQGHTEAFF	TRBV4-3	TRBJ1-1
TGTGCCAGCAGTTATCTTGCCCGCCTTAGATACATGAACACTGAAGCTTTCTTT	CASSYLARLRYMNTEAFF	TRBV6-5	TRBJ1-1
TGTGCCAGCAGTACAGGGACTAGCGGGGGGTTGATTCACGAGCAGTACTTC	CASSTGTSGGLIHEQYF	TRBV6-5	TRBJ2-7
TGTGCCAGCAGTGTCGGTGGACTAGTGCCCAACAGGGTTAGCTCCTACGAGCAGTACTTC	CASSVGGLVPNRVSSYEQYF	TRBV7-3	TRBJ2-7
TGTGCCAGCTGTGGCAAGGTATGTAGGCACAATGAGCAGTTCTTC	CASCGKVCRHNEQFF	TRBV5-6	TRBJ2-1
TGTGCCAGCAGCTTATTCAAGAGCGGGACCGAAGATGGCTACACCTTC	CASSLFKSGTEDGYTF	TRBV7-2	TRBJ1-2
TGTGCCAGCAGCCAAGATCCTCCGGGACAGGGAGGGGATTCGAAAAGGAGCTCCTACAATGAGCAGTTCTTC	CASSQDPPGQGGDSKRSSYNEQFF	TRBV14	TRBJ2-1
TGTGCCAGCACCCGCTGCACACATCAAGAGACCCAGTACTTC	CASTRCTHQETQYF	TRBV6-4	TRBJ2-5
TGTGCCAGCAGTCGCCGGGAATTGGAGACCCAGTACTTC	CASSRRELETQYF	TRBV6-2	TRBJ2-5
TGTGCCAGCAGCTTGGAAGGGACAGGGGGCCCTGTGGCGAGTAACTATGGCTACACCTTC	CASSLEGTGGPVASNYGYTF	TRBV11-3	TRBJ1-2
TGTGCCAGCACCGATTGTGTGACAGATACGCAGTATTTT	CASTDCVTDTQYF	TRBV7-3	TRBJ2-3
TGTGCCAGCAGCGTAGCCCCAGGGGCGGGCACCGGGGAGCTGTTTTTT	CASSVAPGAGTGELFF	TRBV9	TRBJ2-2
TGTGCCAGCATGGACAGGAATAACACCGGGGAGCTGTTTTTT	CASMDRNNTGELFF	TRBV6-4	TRBJ2-2
TGTGCCAGCAGCGGACAGGTAGAAAACCAGACTAATGAAAAACTGTTTTTT	CASSGQVENQTNEKLFF	TRBV11-3	TRBJ1-4
TGCGCCAGCAGCCCTCTCCCTCAGCCCCAGCATTTT	CASSPLPQPQHF	TRBV4-3	TRBJ1-5
TGCGCCAGCTCTGGTATTGCGGCCCGGGTAAATGCCCAAATGAACACTGAAGCTTTCTTT	CASSGIAARVNAQMNTEAFF	TRBV10-1	TRBJ1-1
TGCAGTGCTAGAGATGGGAAACTAGCGGGCGGGGAGTTAAAGCAAGAGACCCAGTACTTC	CSARDGKLAGGELKQETQYF	TRBV20-1	TRBJ2-5
TGTGCCAGCAGCGGACTCCCGGGGGACCCCTCGACTCTTTTCCAAGAGACCCAGTACTTC	CASSGLPGDPSTLFQETQYF	TRBV7-9	TRBJ2-5
TGTGCCAGCAGTCACACAGGGCGACCCAGGTATAGCAATCAGCCCCAGCATTTT	CASSHTGRPRYSNQPQHF	TRBV6-4	TRBJ1-5
TGTGCCAGCACGTCTTGGGGCTCTGCCTACGAGCAGTACTTC	CASTSWGSAYEQYF	TRBV6-4	TRBJ2-7
TGTGCCAGCAGACACGGGGGGGAGGCCTACGAGCAGTACTTC	CASRHGGEAYEQYF	TRBV12-4	TRBJ2-7
TGTGCCAGCAGCTTACCAAGGGACACCGGGGAGCTGTTTTTT	CASSLPRDTGELFF	TRBV7-9	TRBJ2-2
TGTGCCAGCAGCCTAGGGGGCGTCACCACTGAAGCTTTCTTT	CASSLGGVTTEAFF	TRBV4-2	TRBJ1-1
TGTGCCAGCAGCTTGGGACAGGGCGGCAAAGGCAATCAGCCCCAGCATTTT	CASSLGQGGKGNQPQHF	TRBV5-6	TRBJ1-5
TGTGCCAGCAGCTTAACTCAGGGCAATCAGCCCCAGCATTTT	CASSLTQGNQPQHF	TRBV7-3	TRBJ1-5
TGCAGTGCTAGACCCCCTGGGGCAGGTCCTTGTAACGCTGAAGCTTTCTTT	CSARPPGAGPCNAEAFF	TRBV20-1	TRBJ1-1
TGTGCCAGCAGTCGGGAACCGGGACAGGGAGGGATTACGGAGACCCAGTACTTC	CASSREPGQGGITETQYF	TRBV6-2	TRBJ2-5
TGTGCCAGCAGTGGGACGTTCAACAATGAGCAGTTCTTC	CASSGTFNNEQFF	TRBV27	TRBJ2-1
TGTGCCAGCAGGGGACAGGGGGCATCCCAGCCCCAGCATTTT	CASRGQGASQPQHF	TRBV2	TRBJ1-5
TGTGCCAGCAGCGGGGAGGCGGGGGGGAATGTCTACAATGAGCAGTTCTTC	CASSGEAGGNVYNEQFF	TRBV5-4	TRBJ2-1
TGTGCCAGCAGCTTGATACCTCCGAAGAGCTCCTACAATGAGCAGTTCTTC	CASSLIPPKSSYNEQFF	TRBV11-3	TRBJ2-1
TGTGCCAGCAGCCGGCGGGACGTTGTTCCGTCGGGTTTCTGCTGCATTACTAATGAAAAACTGTTTTTT	CASSRRDVVPSGFCCITNEKLFF	TRBV4-2	TRBJ1-4
TGTGCCTGGATACCTAATATGCGGGAGGGAGCCAGTAGGGAAATTAGCAATCAGCCCCAGCATTTT	CAWIPNMREGASREISNQPQHF	TRBV30	TRBJ1-5
TGTGCCAGCATTACGGAAAACCAGGGGAAAAACACTGAAGCTTTCTTT	CASITENQGKNTEAFF	TRBV7-2	TRBJ1-1
TGTGCCAGCAGCTTAGGGCTTAAAACACGGAGGGAGGTGACCCAGTACTTC	CASSLGLKTRREVTQYF	TRBV7-9	TRBJ2-5
TGTGCCAGTAGTAACCACAGGGCGACTGAGACCCAGTACTTC	CASSNHRATETQYF	TRBV19	TRBJ2-5
TGTGCCAGCAGCTATCCGGGACAGGCTACTGAAGCTTTCTTT	CASSYPGQATEAFF	TRBV7-4	TRBJ1-1
TGTGCCAGCAGTGCCAAAGACCGACAGGCGGGCTACGAGCAGTACTTC	CASSAKDRQAGYEQYF	TRBV27	TRBJ2-7
TGTGCCAGACCCGGGGGGGGATGGCACAATGAGCAGTTCTTC	CARPGGGWHNEQFF	TRBV19	TRBJ2-1
TGTGCCAGCAGCCTCACGGACGGACGCTACGAGCAGTACTTC	CASSLTDGRYEQYF	TRBV7-3	TRBJ2-7
TGTGCCAGCGGTACGGGGCGGATAAACTCCTACGAGCAGTACTTC	CASGTGRINSYEQYF	TRBV7-3	TRBJ2-7
TGTGCCAGCAGTTTAGAATATCAGGGGACCTATGGCTACACCTTC	CASSLEYQGTYGYTF	TRBV12-4	TRBJ1-2
TGTGCCAGCAGGCCCGGGCGCCATCAGCCCCAGCATTTT	CASRPGRHQPQHF	TRBV27	TRBJ1-5
TGTGCCAGCAGCGGGCGGGTTTACGAGCAGTACTTC	CASSGRVYEQYF	TRBV6-1	TRBJ2-7
TGTGCCAGCAGTGCCTGCGGGAGCGATAGCACAGATACGCAGTATTTT	CASSACGSDSTDTQYF	TRBV2	TRBJ2-3
TGCGCCAGCAGCGGTGAGGGACTGAAAGAGACCCAGTACTTC	CASSGEGLKETQYF	TRBV4-1	TRBJ2-5
TGTGCCAGCAGCTTAGGGTCGATTACTCAAGTCCAAGAGACCCAGTACTTC	CASSLGSITQVQETQYF	TRBV11-2	TRBJ2-5
TGCAGTGCTAGTCCCTGTCACTGGGACAGGGTTGGCAATCAGCCCCAGCATTTT	CSASPCHWDRVGNQPQHF	TRBV20-1	TRBJ1-5
TGTGCCAGCATGCACTTGGACAGGGGGCCTCACGAGCAGTACTTC	CASMHLDRGPHEQYF	TRBV7-3	TRBJ2-7
TGCAGCGGGGGGGGGGCTCTCGAGCAGTACTTC	CSGGGALEQYF	TRBV29-1	TRBJ2-7
TGTGCCAGTAGGGGGCCGCCGAGAGATACGCAGTATTTT	CASRGPPRDTQYF	TRBV19	TRBJ2-3
TGTGCCAGCAGCCAAGTTCCAGGGCGGGAAGAAAGCTCCTATAATTCACCCCTCCACTTT	CASSQVPGREESSYNSPLHF	TRBV4-2	TRBJ1-6
TGTGCCAGCATGAGACAGGTTGGGGACACCGGGGAGCTGTTTTTT	CASMRQVGDTGELFF	TRBV5-6	TRBJ2-2
TGTGCCATGGCCGGGACAGGGGGGACCGAAAAACTGTTTTTT	CAMAGTGGTEKLFF	TRBV19	TRBJ1-4
TGCAGCGTTGCGCCCTTAACTTCGTGGGAGGGGGCAACTAATGAAAAACTGTTTTTT	CSVAPLTSWEGATNEKLFF	TRBV29-1	TRBJ1-4
TGTGCTAGTGGTTTCCGGACAGGGTGCATTGGCTACACCTTC	CASGFRTGCIGYTF	TRBV12-5	TRBJ1-2
TGTGCCACGGGGGTAACCTCACCCCTCCACTTT	CATGVTSPLHF	TRBV13	TRBJ1-6
TGCGCCAGCAGACCACTAGCGGGAGAGAAAAACATTCAGTACTTC	CASRPLAGEKNIQYF	TRBV10-2	TRBJ2-4
TGTGCCAGCAGCCTGCAGTGCCATGGGCCCTATAACCAGTACGAGCAGTACTTC	CASSLQCHGPYNQYEQYF	TRBV13	TRBJ2-7
TGTGCCAGCAGTGTGAGAACCGGACGGAGAAATGGCTACACCTTC	CASSVRTGRRNGYTF	TRBV7-2	TRBJ1-2
TGCAGTGCTAGACAGCAGGGGACATCCTACGAGCAGTACTTC	CSARQQGTSYEQYF	TRBV20-1	TRBJ2-7
TGTGCCAGCAGTGTTGTGGGACGCGGCATGGTGAACACTGAAGCTTTCTTT	CASSVVGRGMVNTEAFF	TRBV2	TRBJ1-1
TGTGCCAGCCACACTTATTTTTCATACAATGAGCAGTTCTTC	CASHTYFSYNEQFF	TRBV18	TRBJ2-1
TGTGCCTTGGACGACAGGGGAAACACAGATACGCAGTATTTT	CALDDRGNTDTQYF	TRBV12-4	TRBJ2-3
TGTGCCAGCGGTGGAGGCAATCAGCCCCAGCATTTT	CASGGGNQPQHF	TRBV7-2	TRBJ1-5
TGTGCCAGCAGCTTAGCACAGGAGTGCTATGGCTACACCTTC	CASSLAQECYGYTF	TRBV7-9	TRBJ1-2
TGTGCCACCAGCAGATTTGAGGACAGTTCCCGCAATCAGCCCCAGCATTTT	CATSRFEDSSRNQPQHF	TRBV15	TRBJ1-5
TGCGCCAGCAGTTCAAACGACTCGGCGGGACACAGTGAGCAGTTCTTC	CASSSNDSAGHSEQFF	TRBV10-1	TRBJ2-1
TGCAGTGCTAGGGCTACTTATTATGGTGAAGCTTTCTTT	CSARATYYGEAFF	TRBV20-1	TRBJ1-1
TGCGCCAGCAGCTTGGTGCCCCCCCGGCCGGTGTGCTACGAGCAGTACTTC	CASSLVPPRPVCYEQYF	TRBV5-1	TRBJ2-7
TGCGCCAGCAGCTGTCCACCGACAGCCTACGAGCAGTACTTC	CASSCPPTAYEQYF	TRBV5-1	TRBJ2-7
