TGTGCCAGCGACAGGGTGCCAACCAATCAGCCCCAGCATTTT	CASDRVPTNQPQHF	TRBV6-4	TRBJ1-5
TGCAGTGCTAGAATAAAGGGACACTACAATGAGCAGTTCTTC	CSARIKGHYNEQFF	TRBV20-1	TRBJ2-1
TGCAGTGCTAAACACATCGACGAGCAGTACTTC	CSAKHIDEQYF	TRBV20-1	TRBJ2-7
TGTGCCAGCAGGACGGGCACTGAAGCTTTCTTT	CASRTGTEAFF	TRBV6-2	TRBJ1-1
TGTGCCAGCAGCCTAGTAGGCACTGAAGCTTTCTTT	CASSLVGTEAFF	TRBV5-6	TRBJ1-1
TGTGCCAGCAGTTTTCCCAGGGCAGCCTCCTACGAGCAGTACTTC	CASSFPRAASYEQYF	TRBV27	TRBJ2-7
TGTGCCAGCAGCCAAGGCCCGATCGGGGATACGAACGAGCAGTACTTC	CASSQGPIGDTNEQYF	TRBV3-1	TRBJ2-7
TGTGCCAGCAGCTCCGTCTGGGGCTTGCTTTGCTATCAGCCCCAGCATTTT	CASSSVWGLLCYQPQHF	TRBV11-2	TRBJ1-5
TGTGCCAGTCTATCTAAAAACAATGAGCAGTTCTTC	CASLSKNNEQFF	TRBV2	TRBJ2-1
TGTGCCAGCAGCTCTAGCGGGGTCGGAGACGAGCAGTACTTC	CASSSSGVGDEQYF	TRBV7-7	TRBJ2-7
TGTGCCAGCAGCCCGGGGAAGGCCCCTAATGAAAAACTGTTTTTT	CASSPGKAPNEKLFF	TRBV11-2	TRBJ1-4
TGCAGTGCTACCCAGGGGAACCGCACCGGGGAGCTGTTTTTT	CSATQGNRTGELFF	TRBV20-1	TRBJ2-2
TGCGCCAGCAGCTTGGACAGCTCCGCCAAAAACATTCAGTACTTC	CASSLDSSAKNIQYF	TRBV5-1	TRBJ2-4
TGTGCCATAGGGGCCTACGAGCAGTACTTC	CAIGAYEQYF	TRBV10-3	TRBJ2-7
TGTGCCACGCCGCTAGGTTACCCCTCGAACACCGGGGAGCTGTTTTTT	CATPLGYPSNTGELFF	TRBV24-1	TRBJ2-2
TGCGCCAGCAGCTTGAAGCTAAGATTCCCCTACGAGCAGTACTTC	CASSLKLRFPYEQYF	TRBV5-1	TRBJ2-7
TGCAGTGCTGGAAACGGGGAGAACACCGGGGAGCTGTTTTTT	CSAGNGENTGELFF	TRBV20-1	TRBJ2-2
TGTGCCAGCAGTTTCGGGGGGACAGGGTGGAACACTGAAGCTTTCTTT	CASSFGGTGWNTEAFF	TRBV27	TRBJ1-1
TGTGCCTGGCCCCCCAGGTCGACTAGAGAGACCCAGTACTTC	CAWPPRSTRETQYF	TRBV30	TRBJ2-5
TGTGCCAGCAGATCAGCAACAGGGGCATGGAATCAGCCCCAGCATTTT	CASRSATGAWNQPQHF	TRBV28	TRBJ1-5
TGTGCCAGCAGCGGCGACAATGAGCAGTTCTTC	CASSGDNEQFF	TRBV7-8	TRBJ2-1
TGTGCCAGCCCCCAAGACAGGGGCGCCCAGCCCCAGCATTTT	CASPQDRGAQPQHF	TRBV27	TRBJ1-5
TGCAGTGCTGAGCCGGGGACACGAAATAAACTGTTTTTT	CSAEPGTRNKLFF	TRBV20-1	TRBJ1-4
TGTGCCAGCCCGGGACCAAAAAACACCATATATTTT	CASPGPKNTIYF	TRBV6-5	TRBJ1-3
TGTGCCAGGCCTCATCCAGAGGATAGCAATCAGCCCCAGCATTTT	CARPHPEDSNQPQHF	TRBV6-5	TRBJ1-5
TGCGCCAGCAGCGCTGCACGACAGGGGAATTCCTATAATTCACCCCTCCACTTT	CASSAARQGNSYNSPLHF	TRBV5-1	TRBJ1-6
TGTGCCAGCAGCGCCACACGCGTAGGGGATCACAATGAGCAGTTCTTC	CASSATRVGDHNEQFF	TRBV7-8	TRBJ2-1
TGTGCCAGCAGCTTAGGCGAGTTTCGAGCATACACAGATACGCAGTATTTT	CASSLGEFRAYTDTQYF	TRBV7-3	TRBJ2-3
TGTGCCAGCAGCCAAGGAAAAAGGGGGACGACGAACACTGAAGCTTTCTTT	CASSQGKRGTTNTEAFF	TRBV3-1	TRBJ1-1
TGTGCCAGCAGCGCATACCCCCAGACCTCTGGAAACACCATATATTTT	CASSAYPQTSGNTIYF	TRBV9	TRBJ1-3
TGTGCCAGCAGTTACTCGACGTCCGGCAGGGACGAGCAGTACTTC	CASSYSTSGRDEQYF	TRBV6-5	TRBJ2-7
TGTGCCAGCAGCTGCGGGTTTGCCTTTGGGGAGACCCAGTACTTC	CASSCGFAFGETQYF	TRBV11-1	TRBJ2-5
TGTGCCAGCAGCTCGGGGGCGGGAAATGAGCAGTTCTTC	CASSSGAGNEQFF	TRBV7-9	TRBJ2-1
TGTGCCAGCAGACTCACAGGGTCGATCTCTCGAGATACGCAGTATTTT	CASRLTGSISRDTQYF	TRBV7-9	TRBJ2-3
TGTGCCAGCAGCCAAGATGTCAGGAGCGTCGGGCAAGATGTCAATCAGCCCCAGCATTTT	CASSQDVRSVGQDVNQPQHF	TRBV14	TRBJ1-5
TGTGCCAGTACCCTCAATGGGAGCTCGAGTAGAGGGGCCCAAGAGACCCAGTACTTC	CASTLNGSSSRGAQETQYF	TRBV19	TRBJ2-5
TGCGCCAGCAGCCCTCGGGCCGGGACAGGTCCCGATCAGCCCCAGCATTTT	CASSPRAGTGPDQPQHF	TRBV5-1	TRBJ1-5
TGTGCCAGCAGTGACCCCATGGAATGGTACAATGAGCAGTTCTTC	CASSDPMEWYNEQFF	TRBV6-4	TRBJ2-1
TGTGCCAGCAGCTTCTCTGGAGCAACTAATGAAAAACTGTTTTTT	CASSFSGATNEKLFF	TRBV7-3	TRBJ1-4
TGCGAGGTCACAGGGGCCCCGCAAGAGACCCAGTACTTC	CEVTGAPQETQYF	TRBV20-1	TRBJ2-5
TGCAGCGAGACTAGCTCTTGGGCCAATGAGCAGTTCTTC	CSETSSWANEQFF	TRBV29-1	TRBJ2-1
TGTGCCAGCAGCGCAACAGGCCCTTCCTACGAGCAGTACTTC	CASSATGPSYEQYF	TRBV11-3	TRBJ2-7
TGTGCCAGCAGCTTAGTGGACGAGACCCAGTACTTC	CASSLVDETQYF	TRBV7-9	TRBJ2-5
TGTGCCACCAGCACAGGGGGTCCCTACGAGCAGTACTTC	CATSTGGPYEQYF	TRBV24-1	TRBJ2-7
TGCGCCAGCAGCCAAGTACCCACTGGGGCCAATTCACCCCTCCACTTT	CASSQVPTGANSPLHF	TRBV4-1	TRBJ1-6
TGCAGAGGGGGAAACGCTGAAGCTTTCTTT	CRGGNAEAFF	TRBV20-1	TRBJ1-1
TGTGCCAGCAGTTGGGGCAGTCGAGAAGCGGAGACCCAGTACTTC	CASSWGSREAETQYF	TRBV6-4	TRBJ2-5
TGTGCCAGCTCACAGAATGAGCAGTTCTTC	CASSQNEQFF	TRBV18	TRBJ2-1
TGTGCCAGCCCGCAGACGGGATCCTCCTATAATTCACCCCTCCACTTT	CASPQTGSSYNSPLHF	TRBV5-6	TRBJ1-6
TGTGCCAGCAGTTACTCGCCAGTAGGTAACACTGAAGCTTTCTTT	CASSYSPVGNTEAFF	TRBV6-5	TRBJ1-1
TGTGCCAGCAGCTCAGGATGTTATCCCAAAAACATTCAGTACTTC	CASSSGCYPKNIQYF	TRBV13	TRBJ2-4
TGTGCCAGCGCTTTGGGGGTTCACGAGCAGTACTTC	CASALGVHEQYF	TRBV7-9	TRBJ2-7
TGCGCCCACAGGGGGCGTAATAGCCCTGAAGCTTTCTTT	CAHRGRNSPEAFF	TRBV10-1	TRBJ1-1
TGTGCCAGTAGTATAAGCGGGTCCGGGACTAGCGGGCGTCCGTACGAGCAGTACTTC	CASSISGSGTSGRPYEQYF	TRBV19	TRBJ2-7
TGCAGCTCTCCAGGGGCCTACAATGAGCAGTTCTTC	CSSPGAYNEQFF	TRBV29-1	TRBJ2-1
TGTGCCAGCAAGCTAACCGGGGGGGGTGCCTACGAGCAGTACTTC	CASKLTGGGAYEQYF	TRBV13	TRBJ2-7
TGTGCCAGCAGCCAGGGGTCCTGCTATGGCTACACCTTC	CASSQGSCYGYTF	TRBV13	TRBJ1-2
TGTGCCAGCAGCCAAGGGAAACCCTCTACAGGGGTTAACACTGAAGCTTTCTTT	CASSQGKPSTGVNTEAFF	TRBV4-2	TRBJ1-1
TGTGCCAGCAGTCCCGGACGACCTTTTCGTAGTAGCAGCAATCAGCCCCAGCATTTT	CASSPGRPFRSSSNQPQHF	TRBV6-3	TRBJ1-5
TGTGCCAGCAGTTACAGACAGGGCCCGAACTACGAGCAGTACTTC	CASSYRQGPNYEQYF	TRBV6-6	TRBJ2-7
TGTGTCGGGACAGGTCAGCCCCAGCATTTT	CVGTGQPQHF	TRBV28	TRBJ1-5
TGTGCCAGCAGCCCCTCCCGTAGGACAGGGCGATGGAACACTGAAGCTTTCTTT	CASSPSRRTGRWNTEAFF	TRBV14	TRBJ1-1
TGTGCCAAAGAGGGTGGCAGAGGGGAAGAAAAACTGTTTTTT	CAKEGGRGEEKLFF	TRBV24-1	TRBJ1-4
TGTGCCAGCAGCCAAAAGGGGCGGGGGCGCTTACGCCAAGAGACCCAGTACTTC	CASSQKGRGRLRQETQYF	TRBV7-2	TRBJ2-5
TGCAGCCTTAAACGGACGTGCAGCAATGAGCAGTTCTTC	CSLKRTCSNEQFF	TRBV29-1	TRBJ2-1
TGTGCCAGCAGTTTATTTTGGGACGACCCTAGCGGGGACCACGAGCAGTACTTC	CASSLFWDDPSGDHEQYF	TRBV27	TRBJ2-7
TGTGCCAGCAGTCCCCGGGGGGCGGATTCCTACGAGCAGTACTTC	CASSPRGADSYEQYF	TRBV27	TRBJ2-7
TGCGCCACCTACAACCAAGGTCGGGGGGGAACAGATACGCAGTATTTT	CATYNQGRGGTDTQYF	TRBV10-2	TRBJ2-3
TGTGCCAGCAGCATTATGGACAGGGCACGGGGCTACACCTTC	CASSIMDRARGYTF	TRBV7-8	TRBJ1-2
TGCGCCACGTCTCAGGGATCTAATCGCAAAAACATTCAGTACTTC	CATSQGSNRKNIQYF	TRBV10-1	TRBJ2-4
TGTGCCAGCAGCCAAGCACTAGCGGGACTTAATGAAAAACTGTTTTTT	CASSQALAGLNEKLFF	TRBV14	TRBJ1-4
TGTGCCAGCAGTTACAACCTTGATCTGCCCGGGGAGCTGTTTTTT	CASSYNLDLPGELFF	TRBV6-2	TRBJ2-2
TGCAGCGTTAAGGGCCGGGGGGGCTACGAGCAGTACTTC	CSVKGRGGYEQYF	TRBV29-1	TRBJ2-7
TGTGCCAGCGTTCGGCCGGGACAGGGCCGCAATGAGCAGTTCTTC	CASVRPGQGRNEQFF	TRBV28	TRBJ2-1
TGTGCCAGCAGCTTTAGACGGCCGGCAACTAATGAAAAACTGTTTTTT	CASSFRRPATNEKLFF	TRBV9	TRBJ1-4
TGCAGTATCGGACCCGAGTACGAGCAGTACTTC	CSIGPEYEQYF	TRBV20-1	TRBJ2-7
TGTGCCAGCACCATGGCCTACGAGCAGTACTTC	CASTMAYEQYF	TRBV6-2	TRBJ2-7
TGTGCCAGCAGTTACTCGAGTGTCGGTAGCCCCGCCCAGGGGGCGCGTACTGACATTCAGTACTTC	CASSYSSVGSPAQGARTDIQYF	TRBV6-5	TRBJ2-4
TGTGCCAAACCGAGGGCTAAGGGATTGACAAGTCAGCCCCAGCATTTT	CAKPRAKGLTSQPQHF	TRBV10-3	TRBJ1-5
TGTGCCAGCAGCCCCCATCATCTGGGACAGGGGATCTGGGCCTACGAGCAGTACTTC	CASSPHHLGQGIWAYEQYF	TRBV13	TRBJ2-7
TGTGTGACTCGGAACACTGAAGCTTTCTTT	CVTRNTEAFF	TRBV27	TRBJ1-1
TGTGCCAGCAGTTACTACGGACTAGCGCCATTCAATGAGCAGTTCTTC	CASSYYGLAPFNEQFF	TRBV6-8	TRBJ2-1
TGTGCTAGTGGTTTGCTTCCTGGTACCGAAAAAACTAATGAAAAACTGTTTTTT	CASGLLPGTEKTNEKLFF	TRBV12-5	TRBJ1-4
TGCGCCATGAGGGGTTCAGCGGACGCCTCCTACGAGCAGTACTTC	CAMRGSADASYEQYF	TRBV5-1	TRBJ2-7
TGCGCCAGCAGCTTGTATTCCCGCGGTGGCTCCTACGAGCAGTACTTC	CASSLYSRGGSYEQYF	TRBV5-1	TRBJ2-7
TGTGCTAGTGGTTTGGGGGGAGGGGACAATGAGCAGTTCTTC	CASGLGGGDNEQFF	TRBV12-5	TRBJ2-1
TGTGCCAGCAGCTGCGGGACAGCCTTTGGCTACACCTTC	CASSCGTAFGYTF	TRBV7-6	TRBJ1-2
TGTGCCATCAGTGACCTACCGGGACAGGGAGTGTATCAGCCCCAGCATTTT	CAISDLPGQGVYQPQHF	TRBV10-3	TRBJ1-5
TGTGCCAGCAGCCCCCCCGGGACAGGGGGCGCAAGCACCTTC	CASSPPGTGGASTF	TRBV9	TRBJ1-2
TGTGCCAGCAGCGGGAACAGGGAAGGCTACACCTTC	CASSGNREGYTF	TRBV7-2	TRBJ1-2
TGCAGTGCTAGATCGTTAGCGGGTAAGAGGGTTTCCTACGAGCAGTACTTC	CSARSLAGKRVSYEQYF	TRBV20-1	TRBJ2-7
TGCGCCAACTGGGACGCCGCCGTCGAGCAGTACTTC	CANWDAAVEQYF	TRBV10-1	TRBJ2-7
TGTGCTAGTGCCTGCGGGAGTCAGAATGAAAAACTGTTTTTT	CASACGSQNEKLFF	TRBV12-5	TRBJ1-4
TGTGCCAGCAGCGGTGCAACACAGGAACAGGGGGCCCACAATCAGCCCCAGCATTTT	CASSGATQEQGAHNQPQHF	TRBV13	TRBJ1-5
TGTGCCAGCAGCCACCCTTCAGGACTAGGAGGAGGGGAGCTGTTTTTT	CASSHPSGLGGGELFF	TRBV11-3	TRBJ2-2
TGTGCCTGTGGCACAGGGAACTACGAGCAGTACTTC	CACGTGNYEQYF	TRBV30	TRBJ2-7
TGTGCCAGCAGCGACCCGCCGGGACAGTCCTTTCGCCAGCCCCAGCATTTT	CASSDPPGQSFRQPQHF	TRBV13	TRBJ1-5
TGTGCCATCAGTGGTCCGCTAGCCTACGAGCAGTACTTC	CAISGPLAYEQYF	TRBV10-3	TRBJ2-7
TGCGCCAGCAGCCTTCGCTACTACGAGCAGTACTTC	CASSLRYYEQYF	TRBV4-3	TRBJ2-7
TGCGCCAGCAGCCATAACAGAGCCTACGAGCAGTACTTC	CASSHNRAYEQYF	TRBV4-1	TRBJ2-7
TGTGCCAGCAGTTCCCCCCTCCCGGGTCAGGACTATGGCTACACCTTC	CASSSPLPGQDYGYTF	TRBV6-9	TRBJ1-2
TGTGCCAGCAGCGCAGCGGGAGCGGGCGAAGCTTTCTTT	CASSAAGAGEAFF	TRBV7-3	TRBJ1-1
TGCAGTGCTCCAGGCGGGCGACGAGAATTAGGTAACACAGATACGCAGTATTTT	CSAPGGRRELGNTDTQYF	TRBV20-1	TRBJ2-3
TGTGCCAGCACCTTCGGATACACCGGGGAGCTGTTTTTT	CASTFGYTGELFF	TRBV27	TRBJ2-2
TGTGCCAGCAGTGGGAGTAGTGCAATACAGGGAGCCTACGAGCAGTACTTC	CASSGSSAIQGAYEQYF	TRBV6-1	TRBJ2-7
TGTGCCAGCAGGACTAGGAACTCCTACAATGAGCAGTTCTTC	CASRTRNSYNEQFF	TRBV28	TRBJ2-1
TGTGCCAGCAGCTTGGTGTGGGGGCCCTACGAGCAGTACTTC	CASSLVWGPYEQYF	TRBV5-6	TRBJ2-7
TGTGCCACCGGGAATGGACTAGCGGGAACGGGGGAGACCCAGTACTTC	CATGNGLAGTGETQYF	TRBV24-1	TRBJ2-5
TGTGCTAGTGGTGACTGTATTTTGGAAAAACTGTTTTTT	CASGDCILEKLFF	TRBV12-5	TRBJ1-4
TGTGCCAGCAGCAATCCTGCAAGGGGAAGCTCCTATAATTCACCCCTCCACTTT	CASSNPARGSSYNSPLHF	TRBV7-3	TRBJ1-6
TGTGCCAGCAGCTTAGATCCCCGCGGGAGCACAGATACGCAGTATTTT	CASSLDPRGSTDTQYF	TRBV11-2	TRBJ2-3
TGTGCCAGCAGTTACAGTCGGACAGGGGGGGCTTTCTTT	CASSYSRTGGAFF	TRBV6-6	TRBJ1-1
TGTGCCAGCAGTTTAGATACCTCAGATACGCAGTATTTT	CASSLDTSDTQYF	TRBV27	TRBJ2-3
TGTGCCAGCCATGGGGGGACAGAGACCCAGTACTTC	CASHGGTETQYF	TRBV13	TRBJ2-5
TGTGCCAGCCTGACAGGGAGCAATCAGCCCCAGCATTTT	CASLTGSNQPQHF	TRBV6-5	TRBJ1-5
TGTGCCAGCAGTGATCCGGGTGGGAGCTCCTACGAGCAGTACTTC	CASSDPGGSSYEQYF	TRBV25-1	TRBJ2-7
TGCAGTGCTAGACTAGAAAGGTCTTACAATGAGCAGTTCTTC	CSARLERSYNEQFF	TRBV20-1	TRBJ2-1
TGTGCCAGCAGAAAGCAGGAAGCCGGCTACACCTTC	CASRKQEAGYTF	TRBV6-5	TRBJ1-2
TGTGCCAGCAGCCCCTGGGACAGGGACCTGTCCACCGGGGAGCTGTTTTTT	CASSPWDRDLSTGELFF	TRBV13	TRBJ2-2
TGCGCCAGCAGCCAATTAAGAGGACAGGGGTCCCCGCCCCAGCATTTT	CASSQLRGQGSPPQHF	TRBV5-1	TRBJ1-5
TGCAGCGCCGGGGAATGTAACTATGGCTACACCTTC	CSAGECNYGYTF	TRBV29-1	TRBJ1-2
TGTGCCAGCAGTTACGATTGGGAGGGAGATACGCAGTATTTT	CASSYDWEGDTQYF	TRBV6-5	TRBJ2-3
TGTGCCAGCAGCTTGGTGGGACAGTTCGTCCGCAATCAGCCCCAGCATTTT	CASSLVGQFVRNQPQHF	TRBV7-9	TRBJ1-5
TGCAGTGCTCAACAGGGGCCTGGTGGACAGCCCCAGCATTTT	CSAQQGPGGQPQHF	TRBV20-1	TRBJ1-5
TGTGCCAGTAGTATAGTTGCGGGGGGCACAGATACGCAGTATTTT	CASSIVAGGTDTQYF	TRBV19	TRBJ2-3
TGTGCTAGTGGCCCCCCGAGGGCGGGACAGGGACATGGAATAACCTACGAGCAGTACTTC	CASGPPRAGQGHGITYEQYF	TRBV12-5	TRBJ2-7
TGTGCCAGCAGTTACTTAACCTTCCACGGGACTAGCTATGGCACAGATACGCAGTATTTT	CASSYLTFHGTSYGTDTQYF	TRBV6-5	TRBJ2-3
TGTGCCAGCAGCTTGTATCCAGGGGGTTTCGATGGCTACACCTTC	CASSLYPGGFDGYTF	TRBV5-6	TRBJ1-2
TGTGCCAGTAGTCCCAGGGACAGGGGAAGGGATAATGAAAAACTGTTTTTT	CASSPRDRGRDNEKLFF	TRBV19	TRBJ1-4
TGTGCCAGCTCAGGGGCCGACTCCTACGAGCAGTACTTC	CASSGADSYEQYF	TRBV2	TRBJ2-7
TGTGCCATCAAGAGGCGCAATCAGCCCCAGCATTTT	CAIKRRNQPQHF	TRBV27	TRBJ1-5
TGTGCCAGCCCGAGCAGTTTCGGAAGGACTGAAGCTTTCTTT	CASPSSFGRTEAFF	TRBV7-3	TRBJ1-1
TGTGCCAGCAGCAAGGGCGCCAAAAACATTCAGTACTTC	CASSKGAKNIQYF	TRBV14	TRBJ2-4
TGTGCCAGCAGTTGGCATGTGGGAGACAGTCTGGACTATGGCTACACCTTC	CASSWHVGDSLDYGYTF	TRBV6-5	TRBJ1-2
TGTGCCAGCGGGGGGACAGGGGGGTCCTACGAGCAGTACTTC	CASGGTGGSYEQYF	TRBV7-7	TRBJ2-7
TGCGCCAGCAGCAAGGGATATTATCGCGGTAGCAATCAGCCCCAGCATTTT	CASSKGYYRGSNQPQHF	TRBV5-1	TRBJ1-5
TGTGCCAGCAGTTTGATTATCCAGTGGAACTATGGCTACACCTTC	CASSLIIQWNYGYTF	TRBV27	TRBJ1-2
TGTGCCAGTGTCAGGGGGTCCCAGCATTTT	CASVRGSQHF	TRBV19	TRBJ1-5
TGTGCCAGCAGCTACACAGAGTACACAGATACGCAGTATTTT	CASSYTEYTDTQYF	TRBV13	TRBJ2-3
TGTGCCAGCAGCTTAAAACAGGGAAGGACAGATACGCAGTATTTT	CASSLKQGRTDTQYF	TRBV7-2	TRBJ2-3
TGTGCCAGCAGCTGGAACCGACAGAGTGGCTACACCTTC	CASSWNRQSGYTF	TRBV11-2	TRBJ1-2
TGCAGCGAAGGTAGGACTAGCGGGCCCTCCTACGAGCAGTACTTC	CSEGRTSGPSYEQYF	TRBV29-1	TRBJ2-7
TGTGCCAGCAGCCGGGGTAGTTTATTATATCAGCCCCAGCATTTT	CASSRGSLLYQPQHF	TRBV13	TRBJ1-5
TGTGCCAGCAGTCGGGAGTTGAAAAATCCAACCCCTAGCGGGGGAATGGGGCCCTTAGAGACCCAGTACTTC	CASSRELKNPTPSGGMGPLETQYF	TRBV27	TRBJ2-5
TGTGCCAGCAGCCCCGGGAAACCGAACTTC	CASSPGKPNF	TRBV7-9	TRBJ2-5
TGTGCCAGCAGCAGGACAGGGCTGACTAATGAAAAACTGTTTTTT	CASSRTGLTNEKLFF	TRBV13	TRBJ1-4
TGCGCCAGCAGTGAGCCAGGGACAGGGGCTTCGACAGATACGCAGTATTTT	CASSEPGTGASTDTQYF	TRBV10-1	TRBJ2-3
TGTGCCAGCAGCTCACCTCCGGGACAGTCTACCTACGAGCAGTACTTC	CASSSPPGQSTYEQYF	TRBV5-4	TRBJ2-7
TGCGCCAGCATTCCGGAACCAGGCTGTGTGAACACTGAAGCTTTCTTT	CASIPEPGCVNTEAFF	TRBV10-1	TRBJ1-1
TGTGCCAGCAGCCCGGGAGGACTAGGAGATACGCAGTATTTT	CASSPGGLGDTQYF	TRBV7-9	TRBJ2-3
TGTGCCAGCAGAGAACGGACTGATACGCAGTATTTT	CASRERTDTQYF	TRBV6-5	TRBJ2-3
TGTGCCAGCTCCAAGGGACTAGCGGGCACTGATAGCAATGAGCAGTTCTTC	CASSKGLAGTDSNEQFF	TRBV18	TRBJ2-1
TGTGCTAGTGGTTTGTCAAGGGCCAGAGTGAAGAACACTGAAGCTTTCTTT	CASGLSRARVKNTEAFF	TRBV12-5	TRBJ1-1
TGTGCCAGCAGCCTTCGGCGGACAGACTATGGCTACACCTTC	CASSLRRTDYGYTF	TRBV14	TRBJ1-2
TGTGCCAAGTCGGGGGACAGGGGCCAAGAGACCCAGTACTTC	CAKSGDRGQETQYF	TRBV2	TRBJ2-5
TGTGCCAGCAGCTCCCGACGGGCCTACGAGCAGTACTTC	CASSSRRAYEQYF	TRBV7-9	TRBJ2-7
TGTGCCAGCAGGCCACGGAGACCCTTCCCAAATGAAAAACTGTTTTTT	CASRPRRPFPNEKLFF	TRBV12-3	TRBJ1-4
TGCGCCAGCAGCTGCGGGACTCCGGGAGGCGCCGGGGAGCTGTTTTTT	CASSCGTPGGAGELFF	TRBV5-1	TRBJ2-2
TGTGCCAGTAGTATGACCCGACAGGTACCCGCTTTCTTT	CASSMTRQVPAFF	TRBV19	TRBJ1-1
TGTGCCAGCAGCGGCGGGAGTCGGGACTTTGGCTCTGGAAACACCATATATTTT	CASSGGSRDFGSGNTIYF	TRBV7-9	TRBJ1-3
TGCGCCAGCAGCTTGGGGGCAGACAGGGAGGGCTCTGGAAACACCATATATTTT	CASSLGADREGSGNTIYF	TRBV5-1	TRBJ1-3
TGTGCCATCAGGCGGGTCAGGTCCTGGAGCAATCAGCCCCAGCATTTT	CAIRRVRSWSNQPQHF	TRBV10-3	TRBJ1-5
TGTGCCAGCAGCCCGGGACCCGGTGGCAAACCTCAGCCCCAGCATTTT	CASSPGPGGKPQPQHF	TRBV6-5	TRBJ1-5
TGTGCCAGCAGTGCCGGGGGCCCCGTCTTC	CASSAGGPVF	TRBV6-1	TRBJ2-1
TGTGCTAGGGGACCAGGGGCCTATAGCAATCAGCCCCAGCATTTT	CARGPGAYSNQPQHF	TRBV12-5	TRBJ1-5
TGCGCCAGCAGCCAAGACAGGAGACGATCATACGAGCAGTACTTC	CASSQDRRRSYEQYF	TRBV4-3	TRBJ2-7
TGTGCCAGCAGCGGGTCACTAGAGTCCGATCCCAATGAGCAGTTCTTC	CASSGSLESDPNEQFF	TRBV7-4	TRBJ2-1
TGCCAGGCGGGAGTTTATGACGAGCAGTACTTC	CQAGVYDEQYF	TRBV20-1	TRBJ2-7
TGTGCCACCAGTGATTGGCACGGGACGGACAATGAGCAGTTCTTC	CATSDWHGTDNEQFF	TRBV24-1	TRBJ2-1
TGTATTGGTCGGGGTCATGGAAACACCATATATTTT	CIGRGHGNTIYF	TRBV11-2	TRBJ1-3
TGCAGTGCAAAAAGGGGAAGGGCAGATACGCAGTATTTT	CSAKRGRADTQYF	TRBV20-1	TRBJ2-3
TGCAGTGCGGGGGGGGAAAAACGGAACCTGGAGGAGCAGTTCTTC	CSAGGEKRNLEEQFF	TRBV20-1	TRBJ2-1
TGCGCCAGCAGTGAGGGGGGCCCAGATACGCAGTATTTT	CASSEGGPDTQYF	TRBV10-1	TRBJ2-3
TGTGCCAGCAGCTCAGTGGAAAACACTGAAGCTTTCTTT	CASSSVENTEAFF	TRBV7-9	TRBJ1-1
TGCAGTGCTTCGTCCGCCGGGACAGGGTTCTCACCCCTCCACTTT	CSASSAGTGFSPLHF	TRBV20-1	TRBJ1-6
TGTGCCAGCAGCTCCCCGGAAGGGAGGGGCCCGGGGAAACACACTGAAGCTTTCTTT	CASSSPEGRGPGKHTEAFF	TRBV11-2	TRBJ1-1
TGTGCCAGCAGCGGACAGAGACAGCCCCAGCATTTT	CASSGQRQPQHF	TRBV13	TRBJ1-5
TGTGCCTGGAGCAGTCCCGGGACCGGGACAGGATACTACGAGCAGTACTTC	CAWSSPGTGTGYYEQYF	TRBV30	TRBJ2-7
TGCGCCAGCAGCTTAGGCCCCTCCCTGGTGCTAGGTCATGGACAGGGGTCCTACGAGCAGTACTTC	CASSLGPSLVLGHGQGSYEQYF	TRBV5-1	TRBJ2-7
TGTGCCACCAGCGCCAGGACAGGGCGAGGCACAGATACGCAGTATTTT	CATSARTGRGTDTQYF	TRBV15	TRBJ2-3
TGTGCCACCAGTGGTGAGGGCTTCACAGATACGCAGTATTTT	CATSGEGFTDTQYF	TRBV24-1	TRBJ2-3
TGTGCCTGGAGTGACTTCAGGTGGCCCGGTAAGCCCCAGCATTTT	CAWSDFRWPGKPQHF	TRBV30	TRBJ1-5
TGTGCCAGCAGGAGCTTGGAGTTCGATTCACCCCTCCACTTT	CASRSLEFDSPLHF	TRBV6-4	TRBJ1-6
TGCAGCGTCTCTCTAACCAATTCACCCCTCCACTTT	CSVSLTNSPLHF	TRBV29-1	TRBJ1-6
TGTGCCAGCACCGGGACCCGGGGGCAAGAGACCCAGTACTTC	CASTGTRGQETQYF	TRBV6-6	TRBJ2-5
TGTGCCAGCAGCAGGGGGGGAGTGGAGCAGTACTTC	CASSRGGVEQYF	TRBV6-1	TRBJ2-7
TGCGCCAGAGGGACAGAACTAGGGAGCTCCTACAATGAGCAGTTCTTC	CARGTELGSSYNEQFF	TRBV5-1	TRBJ2-1
TGTGCCAGCAGTGAACCAGGGGGACAGGGTGTCTACGAGCAGTACTTC	CASSEPGGQGVYEQYF	TRBV6-4	TRBJ2-7
TGTGCCAGCAGGGATAGATCCTCGAGATCTGGGGCCAACGTCCTGACTTTC	CASRDRSSRSGANVLTF	TRBV27	TRBJ2-6
TGTGCCAGCAGAAGATGGGACAGGGGGCGGAGCGGCTATGGCTACACCTTC	CASRRWDRGRSGYGYTF	TRBV7-9	TRBJ1-2
TGTGCCAGCAGTTTCAAGGAGCGTACCGGGGAGCTGTTTTTT	CASSFKERTGELFF	TRBV27	TRBJ2-2
TGTGCCAGCAGTTTTGAGACGATAGATGGCTACACCTTC	CASSFETIDGYTF	TRBV6-5	TRBJ1-2
TGCGCCAGCAGCCCTACAGGGGGTTGCTACGAGCAGTACTTC	CASSPTGGCYEQYF	TRBV4-1	TRBJ2-7
TGTGCCCACAGGAATGAAAAACTGTTTTTT	CAHRNEKLFF	TRBV24-1	TRBJ1-4
TGCGCCAGCAGCCTCGATAACAGGGAGGATAACGAGCAGTACTTC	CASSLDNREDNEQYF	TRBV4-3	TRBJ2-7
TGTGCCACCAGTGAGCGGGCCAAACCGGGCGGGGGCAATCAGCCCCAGCATTTT	CATSERAKPGGGNQPQHF	TRBV24-1	TRBJ1-5
TGTGCCTGGAGTGTACAGAGGGCCGGACTTCGCACTGAAGCTTTCTTT	CAWSVQRAGLRTEAFF	TRBV30	TRBJ1-1
TGTGCCAGCAGTGAACTGAATTCCCGGCTTACAGATACGCAGTATTTT	CASSELNSRLTDTQYF	TRBV6-1	TRBJ2-3
TGCGCCAGCAGCCGGGCGATAATCCTCTTC	CASSRAIILF	TRBV4-1	TRBJ2-7
TGTGCCAGTAGTATAAGTAACCGGAACGTAGTCGAACTGTTTTTT	CASSISNRNVVELFF	TRBV19	TRBJ1-4
TGTGCCAGAAAAATGGACACCTCCCAAGAGACCCAGTACTTC	CARKMDTSQETQYF	TRBV19	TRBJ2-5
TGTGCCTGGAGTGTCGGTCTGCCGGCTGGCCCAACCTATGGCTACACCTTC	CAWSVGLPAGPTYGYTF	TRBV30	TRBJ1-2
TGCGCCAGCAGAGGCGTCGGTATCGCCAGCTTGAGCTCCTATAATTCACCCCTCCACTTT	CASRGVGIASLSSYNSPLHF	TRBV10-1	TRBJ1-6
TGTGCCAGCAGCCTCAGGGCCTACGAGCAGTACTTC	CASSLRAYEQYF	TRBV6-2	TRBJ2-7
TGTGCCAGCAGTTTAACCGGGAAGGGGCTGCCATGGAGTGAGAATGAAAAACTGTTTTTT	CASSLTGKGLPWSENEKLFF	TRBV27	TRBJ1-4
TGTGCGCGGGGCTGCTACTACGAGCAGTACTTC	CARGCYYEQYF	TRBV24-1	TRBJ2-7
TGTGCCACCAGCAGAGGTCCGGGACTTTCCATCGCCTTAGGGTCCTTCTACGAGCAGTACTTC	CATSRGPGLSIALGSFYEQYF	TRBV15	TRBJ2-7
TGTGCCAGCAGTTATTCGATCAGGGCCCCAGACTACGAGCAGTACTTC	CASSYSIRAPDYEQYF	TRBV6-9	TRBJ2-7
TGTGCCAGCAGGTCGATTAATAGACCCCGATTCTCCTACAATGAGCAGTTCTTC	CASRSINRPRFSYNEQFF	TRBV27	TRBJ2-1
TGTGCCAGCTTGAGTGACAGGGGTCTTTTTTCACCCCTCCACTTT	CASLSDRGLFSPLHF	TRBV6-4	TRBJ1-6
TGTGCCAGCAGCGTGGGGGAACTCAGGCAGCTCACTCCTGGCCCCCCTTACGAGCAGTACTTC	CASSVGELRQLTPGPPYEQYF	TRBV13	TRBJ2-7
TGTGCTAGTGGGTGGGACAGGGCCCACGAGCAGTACTTC	CASGWDRAHEQYF	TRBV12-5	TRBJ2-7
TGTGCCAGTCGGGGCGTCGACACCGGGGAGCTGTTTTTT	CASRGVDTGELFF	TRBV25-1	TRBJ2-2
TGTGAGGCGAGGGGGCACAGGGCGGGGATTGATCAGCCCCAGCATTTT	CEARGHRAGIDQPQHF	TRBV28	TRBJ1-5
TGTGCCAGCAGCTTAGCCCCCCGGCAGCGGAGCAATCAGCCCCAGCATTTT	CASSLAPRQRSNQPQHF	TRBV7-2	TRBJ1-5
TGCGCCAGCAGTGAGTCGGGGCAAAAGAACACTGAAGCTTTCTTT	CASSESGQKNTEAFF	TRBV10-1	TRBJ1-1
TGTGCCAGCAGTTCACTAGAGACCCAGTACTTC	CASSSLETQYF	TRBV27	TRBJ2-5
TGTGCCAGCAGCCACTACGTGTTTCCCTACGAGCAGTACTTC	CASSHYVFPYEQYF	TRBV4-2	TRBJ2-7
TGTGCCAGCAGCTTACTAGGGGGGCCCCCCGAGCAGTACTTC	CASSLLGGPPEQYF	TRBV7-3	TRBJ2-7
TGTGCCAGCACGACAGGGGCCTATCCTCTGCCCCAGCATTTT	CASTTGAYPLPQHF	TRBV6-3	TRBJ1-5
TGCGCCAGCAGCCAAGAGGCCAGGAAAAATCAGCCCCAGCATTTT	CASSQEARKNQPQHF	TRBV4-1	TRBJ1-5
TGTGCCAGCAGCTCCGGGACGCTTAGCAATCAGCCCCAGCATTTT	CASSSGTLSNQPQHF	TRBV6-4	TRBJ1-5
TGTGCCTGGGGGGTGCAGAATGGCTACACCTTC	CAWGVQNGYTF	TRBV30	TRBJ1-2
TGTGCCCAGGGGGGATATGGCTACACCTTC	CAQGGYGYTF	TRBV5-4	TRBJ1-2
TGTGCCACCAGTGATGTCCCCGGGGGGGGCGTGGACTACGAGCAGTACTTC	CATSDVPGGGVDYEQYF	TRBV24-1	TRBJ2-7
TGTGCCAGCAGCGTAGCCGGGACTAGCAACAATGAGCAGTTCTTC	CASSVAGTSNNEQFF	TRBV9	TRBJ2-1
TGTGCCAGTAGTATAGGCCCGTTTCCTACGTACGCCAGTACGGGGCACAATGAAAAACTGTTTTTT	CASSIGPFPTYASTGHNEKLFF	TRBV19	TRBJ1-4
TGTGCCAGCAGCCCCAAAAGCGGGAGGAGTCAGCGCACTGAAGCTTTCTTT	CASSPKSGRSQRTEAFF	TRBV7-3	TRBJ1-1
TGTGCCAGCCCGGGCTGGACTAGCGGGTACGAGCAGTACTTC	CASPGWTSGYEQYF	TRBV11-1	TRBJ2-7
TGTGCCAGCAGCCACCCCTCACCATTGCACCATTATCAGCCCCAGCATTTT	CASSHPSPLHHYQPQHF	TRBV14	TRBJ1-5
TGTGCCAGCAGCTTAACCGGGACAGGGGGCCCTGAAGCTTTCTTT	CASSLTGTGGPEAFF	TRBV7-9	TRBJ1-1
TGTGCCAGCAGCGTAGCTGAGGAGGGGCCCGGGGAAAATGAGCAGTTCTTC	CASSVAEEGPGENEQFF	TRBV9	TRBJ2-1
TGTGCCAGCAGCCCCTACATTGGGACACTTAATGAAAAACTGTTTTTT	CASSPYIGTLNEKLFF	TRBV11-2	TRBJ1-4
TGTGCCACCAGCAGAGGGGGGCCGGGACTAGCCGGGGACAATGAGCAGTTCTTC	CATSRGGPGLAGDNEQFF	TRBV15	TRBJ2-1
TGTGCCAGCAGTTTAGACCGGAACACTGAAGCTTTCTTT	CASSLDRNTEAFF	TRBV6-2	TRBJ1-1
TGTGCCAGCAGCTTCCGTCCTGGGCAACAGCCCCAGCATTTT	CASSFRPGQQPQHF	TRBV7-3	TRBJ1-5
TGTGCCAGCAGTGACTCGATCGCTACAGGGGAGGACACTGAAGCTTTCTTT	CASSDSIATGEDTEAFF	TRBV6-4	TRBJ1-1
TGTGCCAGCAGCCCCCCGGGACGAGAGCAGTTCTTC	CASSPPGREQFF	TRBV7-9	TRBJ2-1
TGTGCCAGCAGCACAAAAGTACAGCCCCAGCATTTT	CASSTKVQPQHF	TRBV9	TRBJ1-5
TGTGCCAGCAGCGCCCCCGGTGGGACAGAGGGAAAGGGGGGCAATCAGCCCCAGCATTTT	CASSAPGGTEGKGGNQPQHF	TRBV25-1	TRBJ1-5
TGTGCCAGCAGCAAAACGATCGGACCCTACACAGGGGGGGCCTCTGGAAACACCATATATTTT	CASSKTIGPYTGGASGNTIYF	TRBV7-2	TRBJ1-3
TGTGCCAGCAGCCGGCCAGATGGCTACACCTTC	CASSRPDGYTF	TRBV6-1	TRBJ1-2
TGTGCCAGCAGTTTATGGGTCCTAAGCGGGAGAGACTATGGCTACACCTTC	CASSLWVLSGRDYGYTF	TRBV28	TRBJ1-2
TGTGCCACCAGCAGAGATGCCCCCCGCGAGAGCCGCTACACCTTC	CATSRDAPRESRYTF	TRBV15	TRBJ1-2
TGTGCCTCACCTAACGGGAGTCATGGATGGAGGAACACCGGGGAGCTGTTTTTT	CASPNGSHGWRNTGELFF	TRBV30	TRBJ2-2
TGTGCCGAGGGGGATATTAGGGGGGCTGAAGCTTTCTTT	CAEGDIRGAEAFF	TRBV2	TRBJ1-1
TGTGCCAGCAGCCGCGTCCTTAACAGGGAGGGGGACTACGAGCAGTACTTC	CASSRVLNREGDYEQYF	TRBV5-6	TRBJ2-7
TGTGCCAGCAGCCAAGATATCATCCCAAAATTACGGGAGGGCTCTGGAAACACCATATATTTT	CASSQDIIPKLREGSGNTIYF	TRBV14	TRBJ1-3
TGTGCCAGCAGCTTAGCCCCCCTAAAACGGCACGGGCACACTGAAGCTTTCTTT	CASSLAPLKRHGHTEAFF	TRBV11-2	TRBJ1-1
TGTGCCAGCATGAGACGCAATTCACCCCTCCACTTT	CASMRRNSPLHF	TRBV6-4	TRBJ1-6
TGTGCCAGCAGTGCCGCCACTAGCGGGAGGAGGAATCAGCCCCAGCATTTT	CASSAATSGRRNQPQHF	TRBV2	TRBJ1-5
TGTGCCAGCAGCGATAGGGGGCCGAATGAAAAACTGTTTTTT	CASSDRGPNEKLFF	TRBV5-4	TRBJ1-4
TGTGCCAGCAGTTACGGGGGGAACACTGAAGCTTTCTTT	CASSYGGNTEAFF	TRBV6-5	TRBJ1-1
TGTGCCAGCAGGCCGGGGTGGACCATGAGGGGCTATGGCTACACCTTC	CASRPGWTMRGYGYTF	TRBV6-2	TRBJ1-2
TGCGCCAGCAGCCAAGATGACCCCCCAGGGGAACACGGCAATTCACCCCTCCACTTT	CASSQDDPPGEHGNSPLHF	TRBV4-1	TRBJ1-6
TGTGCCAGCAGCTTGGGGGAGGGGAACACTGAAGCTTTCTTT	CASSLGEGNTEAFF	TRBV7-7	TRBJ1-1
TGCGCCAGCAGCCCCCAGTGCAGGGGTTCGCAGTTCTTC	CASSPQCRGSQFF	TRBV5-1	TRBJ2-1
TGTGCCACCAGTGGACATGGCCCTACCCGCTCCTACGAGCAGTACTTC	CATSGHGPTRSYEQYF	TRBV24-1	TRBJ2-7
TGTGCCAGCAGCAGGGAGAACCGACAAGATACGCAGTATTTT	CASSRENRQDTQYF	TRBV9	TRBJ2-3
TGCGCCAGCAGCCCCCGGGAGTATGGCTACACCTTC	CASSPREYGYTF	TRBV4-1	TRBJ1-2
TGTGCCAGCACGGGAGTTGACCAGCCCCAGCATTTT	CASTGVDQPQHF	TRBV28	TRBJ1-5
TGTGCCAGCAGCCAAGATGGGCTATATCAGCCCCAGCATTTT	CASSQDGLYQPQHF	TRBV3-1	TRBJ1-5
TGCAGTGCTAGAATAAAGGGAGGCACAGATACGCAGTATTTT	CSARIKGGTDTQYF	TRBV20-1	TRBJ2-3
TGTGCCAGCAGCGGGACGGGCGGGAGGACCTACAATGAGCAGTTCTTC	CASSGTGGRTYNEQFF	TRBV3-1	TRBJ2-1
TGTGCCAGCAGCCAAGATTCGACAGCGCCCGGGGAGCTGTTTTTT	CASSQDSTAPGELFF	TRBV14	TRBJ2-2
TGTGCCTGGAGTGTACTTTTCATTCCCGGGGTACTTGGCTACACCTTC	CAWSVLFIPGVLGYTF	TRBV30	TRBJ1-2
TGTGCCAGCAGTTGGGCTACACAGGGCACCTACGAGCAGTACTTC	CASSWATQGTYEQYF	TRBV12-4	TRBJ2-7
TGCAGTGCTATGGAAAGAGATTATGGACGCTTGATCAATGAAAAACTGTTTTTT	CSAMERDYGRLINEKLFF	TRBV20-1	TRBJ1-4
TGCGCCAGCAGCTGGACAGGGCCCGATACGCAGTATTTT	CASSWTGPDTQYF	TRBV5-1	TRBJ2-3
TGTGCCAGCAGTGAGGCTGTAGCGGGAGGGGCCTACGAGCAGTACTTC	CASSEAVAGGAYEQYF	TRBV6-8	TRBJ2-7
TGTGCCAGCTCACACCCCCGAGGCACTGGCGGTACCGGGACGGACACCGGGGAGCTGTTTTTT	CASSHPRGTGGTGTDTGELFF	TRBV18	TRBJ2-2
TGTGCCAGCAGCCGGAGCATTGGTGTCGGAGATAGCAATCAGCCCCAGCATTTT	CASSRSIGVGDSNQPQHF	TRBV4-2	TRBJ1-5
TGCAGTGCTAGAGACGCTGTTCATAACTATGGCTACACCTTC	CSARDAVHNYGYTF	TRBV20-1	TRBJ1-2
TGTGCCAGCAGCTTAGCGCCGGGTAGACCCTCTCTTGATGCCTACAATGAGCAGTTCTTC	CASSLAPGRPSLDAYNEQFF	TRBV11-2	TRBJ2-1
TGTGCCACCCAGCGAGACAGCAATCAGCCCCAGCATTTT	CATQRDSNQPQHF	TRBV15	TRBJ1-5
TGTGCCACCAGTGATTTCTCGGTGAACAGGGGGGATAGCACAGATACGCAGTATTTT	CATSDFSVNRGDSTDTQYF	TRBV24-1	TRBJ2-3
TGTGCCAGCAGTGCCCCTAGCGGGGGGAAAGATACGCAGTATTTT	CASSAPSGGKDTQYF	TRBV2	TRBJ2-3
TGTGCCAGCAGCGGGGGGCGATTTTCCTACGAGCAGTACTTC	CASSGGRFSYEQYF	TRBV13	TRBJ2-7
TGTGCCAGTAGTTACTCAGTTTCAGTAATGCAGCCCCAGCATTTT	CASSYSVSVMQPQHF	TRBV19	TRBJ1-5
TGTGCCAGCAGCCAACTCGCTTGGGAAAGGGGCTACACCTTC	CASSQLAWERGYTF	TRBV11-2	TRBJ1-2
TGTGCCAGCAGGTTTCGGGCCCTGAATAATGAGCAGTTCTTC	CASRFRALNNEQFF	TRBV6-8	TRBJ2-1
TGTGCCAGCCGTCCGCCCCACATTCAGTACTTC	CASRPPHIQYF	TRBV6-6	TRBJ2-4
TGTGCCAGCAGCGGAGTAGAAAAACTGTTTTTT	CASSGVEKLFF	TRBV13	TRBJ1-4
TGTGCCAGCAGTGCTCCACTAGCGGGAGGGTACGAGCAGTACTTC	CASSAPLAGGYEQYF	TRBV6-1	TRBJ2-7
TGCGCCAGCAGCCAAGATTATTTCCTGGAGCGGTACGAGCAGTACTTC	CASSQDYFLERYEQYF	TRBV4-3	TRBJ2-7
TGTGCCAGCAGCTTGTCGCAGGGGGGGGGGAATGTGATCGCTGAGTGGGCCTACAATGAGCAGTTCTTC	CASSLSQGGGNVIAEWAYNEQFF	TRBV7-2	TRBJ2-1
TGCAGTGCATTTGACGGGACTAGCGGGGGGGCCCGGTCCTACAATGAGCAGTTCTTC	CSAFDGTSGGARSYNEQFF	TRBV20-1	TRBJ2-1
TGTGCCAGCTCACCACCGGGTTGCGGGGGGACTAATGAAAAACTGTTTTTT	CASSPPGCGGTNEKLFF	TRBV18	TRBJ1-4
TGTGCCAGCAGGCGGGGAAAAGGAGTTGGAAACACCATATATTTT	CASRRGKGVGNTIYF	TRBV6-1	TRBJ1-3
TGTGCCACCAGTGTCGGGGGGGCGTGGGAGAACACCGGGGAGCTGTTTTTT	CATSVGGAWENTGELFF	TRBV24-1	TRBJ2-2
TGCGCCAGCAGCCAAGATTATTTCGGGGCTTTAAGGTGTAGCTCCTATAATTCACCCCTCCACTTT	CASSQDYFGALRCSSYNSPLHF	TRBV4-1	TRBJ1-6
TGTGCCAGCAGGGACCGGTTATTGGAAAGCAATCAGCCCCAGCATTTT	CASRDRLLESNQPQHF	TRBV28	TRBJ1-5
TGTGCCAGCAGTTACGCACGGAAGAGCTCCTACAATGAGCAGTTCTTC	CASSYARKSSYNEQFF	TRBV6-5	TRBJ2-1
TGTGCCAGCAGCTTAGACCCGGGACCCACCGGGACACGTCCCTACGAGCAGTACTTC	CASSLDPGPTGTRPYEQYF	TRBV11-2	TRBJ2-7
TGCGCCAGCAGGGGGAACACCGGGGAGCTGTTTTTT	CASRGNTGELFF	TRBV10-1	TRBJ2-2
TGTGCCAGCGTGAGGTCACCGGGACAGGGGCACTATGGCTACACCTTC	CASVRSPGQGHYGYTF	TRBV6-3	TRBJ1-2
TGCGCCAGGGACAGGGAGGCACTGGTTGGCTACACCTTC	CARDREALVGYTF	TRBV5-1	TRBJ1-2
TGTGCCAGCAGCTGTCGGACGGGTCAAGGGGGATTCACAGATACGCAGTATTTT	CASSCRTGQGGFTDTQYF	TRBV5-4	TRBJ2-3
TGCAGCGAAAACTCTAGATCCTACGAGCAGTACTTC	CSENSRSYEQYF	TRBV29-1	TRBJ2-7
TGTGCCAGCAGTGATCCAACGGGGGTTTCTGGGGCCAACGTCCTGACTTTC	CASSDPTGVSGANVLTF	TRBV6-4	TRBJ2-6
TGTGCCAGCAGCGAACTGAACGGCGGGCGTTACTATGGCTACACCTTC	CASSELNGGRYYGYTF	TRBV5-6	TRBJ1-2
TGCAGCGTTGCTAGCGGGTCATCCTACAATGAGCAGTTCTTC	CSVASGSSYNEQFF	TRBV29-1	TRBJ2-1
TGTGCCAGCAGTTACTCGAAGGTTAACAATGAGCAGTTCTTC	CASSYSKVNNEQFF	TRBV6-5	TRBJ2-1
TGTGCCAGCAGTGACATTTCCTACGAGCAGTACTTC	CASSDISYEQYF	TRBV11-2	TRBJ2-7
TGTGCCAGCAATGACAGCCACGAGCAGTACTTC	CASNDSHEQYF	TRBV12-4	TRBJ2-7
TGTGCCAGCAGTCGGGTTACTAGGGGGTTAATAGCTAACTATGGCTACACCTTC	CASSRVTRGLIANYGYTF	TRBV6-2	TRBJ1-2
TGTGCCATAAGGGACTCGATGAACACTGAAGCTTTCTTT	CAIRDSMNTEAFF	TRBV24-1	TRBJ1-1
TGTGCCAGCAGGCCGGGGTACTCTGGAAACACCATATATTTT	CASRPGYSGNTIYF	TRBV7-3	TRBJ1-3
TGTGCCTGGAGAGGCCGGTCTAGGCTGTTTTTT	CAWRGRSRLFF	TRBV30	TRBJ1-4
TGCAGTGCTAGCTCAGGTGCCAGGAGGGGGGCCACAGATACGCAGTATTTT	CSASSGARRGATDTQYF	TRBV20-1	TRBJ2-3
TGTGCCAGCAGCCAAGACGTCGGACAGGAGTACTTC	CASSQDVGQEYF	TRBV3-1	TRBJ2-7
TGTGCCAGCAGTAAGTTAGGGACAATTGGAAAGACCTACAATGAGCAGTTCTTC	CASSKLGTIGKTYNEQFF	TRBV9	TRBJ2-1
TGTGCCAGCAGCTTCCCCGGATACCGGACTAGCGGGTACCCGAGCAATGAGCAGTTCTTC	CASSFPGYRTSGYPSNEQFF	TRBV5-8	TRBJ2-1
TGTGCCAGCAGCGGTTGTAACACCGGGGAGCTGTTTTTT	CASSGCNTGELFF	TRBV11-3	TRBJ2-2
TGTGCCAGCACTCCGGGGGTTAGACCGCGGGAGCTGTTTTTT	CASTPGVRPRELFF	TRBV7-9	TRBJ2-2
TGTGCCAGCAGCCCCCCTGTGGCAGAGGACGTATCCTACGAGCAGTACTTC	CASSPPVAEDVSYEQYF	TRBV5-6	TRBJ2-7
TGTGCCAGCAGCCGGAGGAAAGGAAGCTCCTACAATGAGCAGTTCTTC	CASSRRKGSSYNEQFF	TRBV7-8	TRBJ2-1
TGCAGTGCTAGAGCCAGGGGACAGGGATTTATGCCTCAGCCCCAGCATTTT	CSARARGQGFMPQPQHF	TRBV20-1	TRBJ1-5
TGTGCCAGCAGCTTAAAGGGGGAGGTCGGGACTAGCGGAGGACCCTACAATGAGCAGTTCTTC	CASSLKGEVGTSGGPYNEQFF	TRBV7-3	TRBJ2-1
TGTGCCAGCAGCCCCAGCTATGGCTACACCTTC	CASSPSYGYTF	TRBV13	TRBJ1-2
TGTGCCAGCAGTATACGGGACGATAACTATGGCTACACCTTC	CASSIRDDNYGYTF	TRBV27	TRBJ1-2
TGTGCCAGCAGCGACAATGAGCAGTTCTTC	CASSDNEQFF	TRBV9	TRBJ2-1
TGTGCCAGCAGCCTTTGGTCCGCGGGAGCGGGGCACACAGATACGCAGTATTTT	CASSLWSAGAGHTDTQYF	TRBV7-9	TRBJ2-3
TGTGCCACCAGTGATGCGAGGGTCCAAGAGACCCAGTACTTC	CATSDARVQETQYF	TRBV24-1	TRBJ2-5
TGTGCCAGCAGCGAAGGGTTCCCACAGGTTCAATACTACGAGCAGTACTTC	CASSEGFPQVQYYEQYF	TRBV9	TRBJ2-7
TGTGCCAGCAGTCGCGTAGACAGGGTGCTTAACTATGGCTACACCTTC	CASSRVDRVLNYGYTF	TRBV27	TRBJ1-2
TGCGCCAGCAGTCGCCTATACAATGAGCAGTTCTTC	CASSRLYNEQFF	TRBV10-1	TRBJ2-1
TGTGCCAGTAGTAAGAGTGGTTGGGGGGGCACAGATACGCAGTATTTT	CASSKSGWGGTDTQYF	TRBV19	TRBJ2-3
TGTGCCAGCAGCCTTAGGAGGACTGGTCTGTTCGAGCAGTACTTC	CASSLRRTGLFEQYF	TRBV7-3	TRBJ2-7
TGTGCCAGCAGCAAAATTCGGACTAGAAGGGAGACCCAGTACTTC	CASSKIRTRRETQYF	TRBV7-3	TRBJ2-5
TGTGCCACCGCGACAGGACGGAGCAATGAGCAGTTCTTC	CATATGRSNEQFF	TRBV15	TRBJ2-1
TGTGCCAGCAGTTGGGACAGGGTTGGCCGTACTGAAGCTTTCTTT	CASSWDRVGRTEAFF	TRBV12-4	TRBJ1-1
TGTGCCATCGGGGAAGTCCAAGAGACCCAGTACTTC	CAIGEVQETQYF	TRBV10-3	TRBJ2-5
TGCAGTGCTAGTAACCCGGGACAGGGTAGCAATCAGCCCCAGCATTTT	CSASNPGQGSNQPQHF	TRBV20-1	TRBJ1-5
TGTGCCAGCAGCTCCACCGGGACAGGGGTTGGTCAGCCCCAGCATTTT	CASSSTGTGVGQPQHF	TRBV7-3	TRBJ1-5
TGTGCCAGCAGTGGGGCTGGGGAGCAGTTCTTC	CASSGAGEQFF	TRBV12-3	TRBJ2-1
TGCGCCAATTACAGGGGGGAACGTCAGCCCCAGCATTTT	CANYRGERQPQHF	TRBV5-1	TRBJ1-5
TGTGCCTGCGGCGAGACAAACTATGGCTACACCTTC	CACGETNYGYTF	TRBV30	TRBJ1-2
TGTGCCAGCAGCTTTCCTGACAGAGTGAGGAGCTACGAGCAGTACTTC	CASSFPDRVRSYEQYF	TRBV7-3	TRBJ2-7
TGTGCCAGCATAAGCGAGGGGGGGACCGGGGAGCTGTTTTTT	CASISEGGTGELFF	TRBV25-1	TRBJ2-2
TGTGCCAGCAGTTTCGGCCCTGTGGTGGGGGGTATAACTGAAGCTTTCTTT	CASSFGPVVGGITEAFF	TRBV28	TRBJ1-1
TGTGCCATCAGTGAAGGACTAGCGGAAGACTACGAGCAGTACTTC	CAISEGLAEDYEQYF	TRBV10-3	TRBJ2-7
TGTGCCAGCAGCCAAGTAGGTTCCCTCGACAGCCCCCACACAGATACGCAGTATTTT	CASSQVGSLDSPHTDTQYF	TRBV14	TRBJ2-3
TGTGCCAGCAGCGTTCGGCACGCTGGGGATACGCAGTATTTT	CASSVRHAGDTQYF	TRBV7-9	TRBJ2-3
TGTGCCAGCAGCGGGGGGGGGGTGACCCCAGATACGCAGTATTTT	CASSGGGVTPDTQYF	TRBV13	TRBJ2-3
TGTGCCAACCCGGACCGGGAGGACTTGCAGTTCTTC	CANPDREDLQFF	TRBV10-3	TRBJ2-1
TGTGCCAGCAGCGGGGGCCCCCCCTCAAAAGAGGAAGAGACCCAGTACTTC	CASSGGPPSKEEETQYF	TRBV5-6	TRBJ2-5
TGTGCCATCAAACCTGGGAAGGCTCATGAGCAGTTCTTC	CAIKPGKAHEQFF	TRBV10-3	TRBJ2-1
TGTGCCAGCAGTTTGCCCACAGACCCTTTCATCTACGAGCAGTACTTC	CASSLPTDPFIYEQYF	TRBV12-4	TRBJ2-7
TGTGCCAGCAGCAGTTGGTGGTCGGACAGGTCTGTTGACTACGAGCAGTACTTC	CASSSWWSDRSVDYEQYF	TRBV7-3	TRBJ2-7
TGTGCCAGCAGGGGCTGGGTAGAGCCCCAGCATTTT	CASRGWVEPQHF	TRBV27	TRBJ1-5
TGTGCCAGCAGACAGCCTTGTGGGTGCACAGATACGCAGTATTTT	CASRQPCGCTDTQYF	TRBV28	TRBJ2-3
TGTGCCAGCAGTAGGGGGGGAATTCCCGAGACCCAGTACTTC	CASSRGGIPETQYF	TRBV28	TRBJ2-5
TGTGCCAGCCCCGTGACAGGGGGCCAAACTGGGGCCAACGTCCTGACTTTC	CASPVTGGQTGANVLTF	TRBV28	TRBJ2-6
TGTGCCAGCAGCTCGACAGGGGACTTC	CASSSTGDF	TRBV7-2	TRBJ2-7
TGTGCCAGCAGCCAAAAAGCAGTTCCCTATGGCTACACCTTC	CASSQKAVPYGYTF	TRBV3-1	TRBJ1-2
TGTGCCAGTAGTTTAAAGGACAAAAGCTCCTACGAGCAGTACTTC	CASSLKDKSSYEQYF	TRBV19	TRBJ2-7
TGTGCCAGCAGCCCCCGGGGGGATGGCTACACCTTC	CASSPRGDGYTF	TRBV11-2	TRBJ1-2
TGTGCCAGCAGCCCCTCCGCCAGCGAAGAGACCCAGTACTTC	CASSPSASEETQYF	TRBV27	TRBJ2-5
TGTGCCAGTAGTATGGATGGACAGTCCTACGAGCAGTACTTC	CASSMDGQSYEQYF	TRBV19	TRBJ2-7
TGCGCCAGCAGCTTGCCCCCGGGGGGCACCGGGGAGCTGTTTTTT	CASSLPPGGTGELFF	TRBV5-1	TRBJ2-2
TGTGCCAGCAGTCGGGTGACACATGCCCACACCGGGGAGCTGTTTTTT	CASSRVTHAHTGELFF	TRBV28	TRBJ2-2
TGTGCCAGCAGCTTACCCAGCAGGGACCCTTTGTACTTC	CASSLPSRDPLYF	TRBV5-4	TRBJ2-7
TGTGCCAGCAGCTTACCAACCGGAAACACCATATATTTT	CASSLPTGNTIYF	TRBV7-7	TRBJ1-3
TGTGCCACCTCAGATGGACAGGAGATTCTCTTCACAGATACGCAGTATTTT	CATSDGQEILFTDTQYF	TRBV24-1	TRBJ2-3
TGCAGTGCTGAGGTTCAGGGATCCAAAAACATTCAGTACTTC	CSAEVQGSKNIQYF	TRBV20-1	TRBJ2-4
TGTGCCACCAGCAGGAATAGACAGGGAAATCAGCCCCAGCATTTT	CATSRNRQGNQPQHF	TRBV15	TRBJ1-5
TGTGCCAGCAGCCTCAGCGGGGGGGCCTCTGGGGCCAACGTCCTGACTTTC	CASSLSGGASGANVLTF	TRBV6-5	TRBJ2-6
TGTGCTAGTGGTTCCCGTCCTTGCAATGAGCAGTTCTTC	CASGSRPCNEQFF	TRBV12-5	TRBJ2-1
TGTGCCAGCAGTGACTATAGGGGGGGACATAATTCACCCCTCCACTTT	CASSDYRGGHNSPLHF	TRBV6-4	TRBJ1-6
TGCGCCAGCAGTGAGCTTCATCCCCGCCGGGACAGGGGTGGTTACGGGGGCTACGAGCAGTACTTC	CASSELHPRRDRGGYGGYEQYF	TRBV10-1	TRBJ2-7
TGTGCCTGGAATACGGGGCGTAGGATTGGCTACACCTTC	CAWNTGRRIGYTF	TRBV30	TRBJ1-2
TGCAGTGCCAGGGAGCGGGAGGAAGAGGATACGCAGTATTTT	CSAREREEEDTQYF	TRBV20-1	TRBJ2-3
TGTGCCAGCAGCCAAGTTACCGGGGGGGCCAGCACAGATACGCAGTATTTT	CASSQVTGGASTDTQYF	TRBV4-2	TRBJ2-3
TGTGCCCTTGGCAGGGAAGCCAGGTCCTACAATGAGCAGTTCTTC	CALGREARSYNEQFF	TRBV10-3	TRBJ2-1
TGTGCTAGCAGCAGAACTAGGGGGGCCGAGCAGTACTTC	CASSRTRGAEQYF	TRBV7-7	TRBJ2-7
TGTGCCAGCAGCGCTTCTGAGAGGGTCGATAGCAATCAGCCCCAGCATTTT	CASSASERVDSNQPQHF	TRBV11-3	TRBJ1-5
TGCGCCAGCAGCTTGGAGAGGGCTCCCGGGGAGCTGTTTTTT	CASSLERAPGELFF	TRBV5-1	TRBJ2-2
TGTGCCAACTCACAAGGGATGAACACTGAAGCTTTCTTT	CANSQGMNTEAFF	TRBV6-2	TRBJ1-1
TGTGCCAGCAGCTCAGTTCTCTCCTACGAGCAGTACTTC	CASSSVLSYEQYF	TRBV11-3	TRBJ2-7
TGTGCCACCAGGCCTTCATCACTAGCGGGCTTCCAAGAGACCCAGTACTTC	CATRPSSLAGFQETQYF	TRBV24-1	TRBJ2-5
TGTGCCAGCGGGAGGGTAGACAAGACTGAAGCTTTCTTT	CASGRVDKTEAFF	TRBV9	TRBJ1-1
TGTGCCAGCAGCTCATTTTTGGGACGTTACAGCAATCAGCCCCAGCATTTT	CASSSFLGRYSNQPQHF	TRBV6-1	TRBJ1-5
TGTGCCAGCAGCTTATTGGAGACCCCTCACTATGGCTACACCTTC	CASSLLETPHYGYTF	TRBV11-2	TRBJ1-2
TGCAGAGGACAGGGCCCAATAGTTGAGAACACTGAAGCTTTCTTT	CRGQGPIVENTEAFF	TRBV20-1	TRBJ1-1
TGTGCCAGCAGTTACTCGCCTCCGAGACAGCCAATTAAGCCCTATGGCTACACCTTC	CASSYSPPRQPIKPYGYTF	TRBV6-2	TRBJ1-2
TGTGCCAGCAGCTTAAAGACGTCCCCCGCGAACACCGGGGAGCTGTTTTTT	CASSLKTSPANTGELFF	TRBV7-2	TRBJ2-2
TGTGCCAGCAGCTCGACAGGGATTGATGAGCAGTTCTTC	CASSSTGIDEQFF	TRBV7-3	TRBJ2-1
TGTGCCACCAGTGATCCTGGACAGCGGAGCAATCAGCCCCAGCATTTT	CATSDPGQRSNQPQHF	TRBV24-1	TRBJ1-5
TGTGCCAGCAGCTTAGAACTCAAGACAGGCCGCAAGCATGGCTACACCTTC	CASSLELKTGRKHGYTF	TRBV7-8	TRBJ1-2
TGCGCCAGCGGGACAGGGTCCAGTCAGCCCCAGCATTTT	CASGTGSSQPQHF	TRBV5-1	TRBJ1-5
TGTGCCAGCAGCTCAGGACGCACTGAAGCTTTCTTT	CASSSGRTEAFF	TRBV7-3	TRBJ1-1
TGCGCCAGCAGCCAAGTTCTCCCAGGGGGCAAGCAGTACTTC	CASSQVLPGGKQYF	TRBV4-1	TRBJ2-7
TGTGCCAGTAGTCAGGGGCCTCCACCGGGGGTTCTAACCCACGAGCAGTACTTC	CASSQGPPPGVLTHEQYF	TRBV19	TRBJ2-7
TGTGCCAGCAGCGTAGGGACAGGGGGCCACTATGGCTACACCTTC	CASSVGTGGHYGYTF	TRBV13	TRBJ1-2
TGCAGTGCGGCAGGGTCCTACGAGCAGTACTTC	CSAAGSYEQYF	TRBV20-1	TRBJ2-7
TGTGCCAGCAGCCCGGCTGAGGATTACGAGCAGTACTTC	CASSPAEDYEQYF	TRBV7-8	TRBJ2-7
TGTGCCACCAGTGTTCAAGCACCCCTGAGCTCCTACGAGCAGTACTTC	CATSVQAPLSSYEQYF	TRBV24-1	TRBJ2-7
TGCAGTGCTACCGGGACAGGGTTCCAAGAGACCCAGTACTTC	CSATGTGFQETQYF	TRBV20-1	TRBJ2-5
TGTGCCAGCAGTTTAAAGGAACCGGGACATGGAGCCGGCTACACCTTC	CASSLKEPGHGAGYTF	TRBV27	TRBJ1-2
TGTGCCAGCAGTGCAGAAGTGCACCCTAGTCTGGGGGGCTACACCTTC	CASSAEVHPSLGGYTF	TRBV6-1	TRBJ1-2
TGTGCTAGTGGTTTAGAAGGCAAGCTAGCGGTCAGGGCAGATACGCAGTATTTT	CASGLEGKLAVRADTQYF	TRBV12-5	TRBJ2-3
TGTGCCAGCAGGGAGGGGATAGGCTACGAGCAGTACTTC	CASREGIGYEQYF	TRBV6-5	TRBJ2-7
TGTGCCAGCAGCTCCAACAGGGGTGGACAGACCGGGGAGCTGTTTTTT	CASSSNRGGQTGELFF	TRBV5-4	TRBJ2-2
TGTGCCACCGACAGGGGGCACACGGACACAGATACGCAGTATTTT	CATDRGHTDTDTQYF	TRBV7-9	TRBJ2-3
TGTGCCAGCAGTCCAACACCAGAGGTGTCAATATCTGAGCAGTTCTTC	CASSPTPEVSISEQFF	TRBV27	TRBJ2-1
TGTGCCAGCGAACTAGCGGGGGGGCCCTCCGGGGAGCTGTTTTTT	CASELAGGPSGELFF	TRBV2	TRBJ2-2
TGTGCCAGCAGCATCCACAGGGGGGTTCTGTTTTTT	CASSIHRGVLFF	TRBV5-6	TRBJ1-4
TGCAGCGCCAGGCAACAGCCCCAGCATTTT	CSARQQPQHF	TRBV29-1	TRBJ1-5
TGTGCCAGCAGCCCGGCAGCGGGGAGGCAGTTCTTC	CASSPAAGRQFF	TRBV13	TRBJ2-1
TGTGCCAGCAGCTTTATCCCGACAGGACGAGACGGGAGCTCCTATAATTCACCCCTCCACTTT	CASSFIPTGRDGSSYNSPLHF	TRBV7-2	TRBJ1-6
TGTGCCAGCAGCTTAACCTCCGGGACAGAGTGCAATCAGCCCCAGCATTTT	CASSLTSGTECNQPQHF	TRBV7-3	TRBJ1-5
TGTGCCAGCAGTTTAGGTAATGAAAAACTGTTTTTT	CASSLGNEKLFF	TRBV27	TRBJ1-4
TGTGCCAGCAGTACTGTCTCGGAACTTGACAGGGTGAACACTGAAGCTTTCTTT	CASSTVSELDRVNTEAFF	TRBV27	TRBJ1-1
TGTGCCAGCAGACCAGGGGGCCCCGACTCTGGGGCCAACGTCCTGACTTTC	CASRPGGPDSGANVLTF	TRBV7-2	TRBJ2-6
TGTGCCACCAGCAGGCGCAAGGGAGAGGGGACTAGCGGGGGGGACGAGCAGTACTTC	CATSRRKGEGTSGGDEQYF	TRBV15	TRBJ2-7
TGTGCCAGCAGCCCGAGTCCGGACAGGAATTGCTCTGGAAACACCATATATTTT	CASSPSPDRNCSGNTIYF	TRBV3-1	TRBJ1-3
TGCAGTGCTGAGGGTATTACAACCGGGCCTGAGCAGTTCTTC	CSAEGITTGPEQFF	TRBV20-1	TRBJ2-1
TGTGCCAGCAGTTACAGACTAGCGGGGTGGCAAGAGACCCAGTACTTC	CASSYRLAGWQETQYF	TRBV27	TRBJ2-5
TGTGCCAGCAGCTTCTGGGACAGGGGGCTAAGACATGATACGCAGTATTTT	CASSFWDRGLRHDTQYF	TRBV5-4	TRBJ2-3
TGTGCCAGCAGCGTAGTTCGACAAGAGACAGGGATTACTTGCGAGCAGTACTTC	CASSVVRQETGITCEQYF	TRBV9	TRBJ2-7
TGTGCCACTGGGGCCACGCAGTATTTT	CATGATQYF	TRBV24-1	TRBJ2-3
TGCGCCAGCAGTGACCCGCAACCCCGCCATAGGGGGCGAGGAAACACCATATATTTT	CASSDPQPRHRGRGNTIYF	TRBV10-1	TRBJ1-3
TGTGCCACCAGTGATCCTAGAAACAGCGGGAGCGCAGTGAACACTGAAGCTTTCTTT	CATSDPRNSGSAVNTEAFF	TRBV24-1	TRBJ1-1
TGTGCCATCACGCAGGTGACCTACGAGCAGTACTTC	CAITQVTYEQYF	TRBV10-3	TRBJ2-7
TGTGCCAGCAGGGGGACAGCTAACTATGGCTACACCTTC	CASRGTANYGYTF	TRBV6-1	TRBJ1-2
TGTGCCAGCAGCTATCACAGGGTACCAGATTACGAGCAGTACTTC	CASSYHRVPDYEQYF	TRBV5-4	TRBJ2-7
TGTGCTAGTGGTTTGGTAGGGCCCAAGACTAGTAGGGACAATGAGCAGTTCTTC	CASGLVGPKTSRDNEQFF	TRBV12-5	TRBJ2-1
TGTGCCAGCAGGGGGGCCTCCCCAAATCAGCCCCAGCATTTT	CASRGASPNQPQHF	TRBV6-2	TRBJ1-5
TGTGCCAGCAGCTCTCGCCGAAGGTTTGGACGGTATAATGAGCAGTTCTTC	CASSSRRRFGRYNEQFF	TRBV11-2	TRBJ2-1
TGCAGTGCTGTCGGGCAGATCTTGAACACTGAAGCTTTCTTT	CSAVGQILNTEAFF	TRBV20-1	TRBJ1-1
TGTGCCAGCAGCCGCGGGGGGGACAATGAGCAGTTCTTC	CASSRGGDNEQFF	TRBV7-9	TRBJ2-1
TGTGCCAGCTCCAGGGGCTATGGCTACACCTTC	CASSRGYGYTF	TRBV6-5	TRBJ1-2
TGTGCCAGCAGCCAAGAACTAGGACCCGAGACCCAGTACTTC	CASSQELGPETQYF	TRBV3-1	TRBJ2-5
TGTGCCATCCAGGGGGCGCCCAGCTCCTACAATGAGCAGTTCTTC	CAIQGAPSSYNEQFF	TRBV6-5	TRBJ2-1
TGTGCCAGCACCTGGGGAAGAAGGGGCGGGCACGAGCAGTACTTC	CASTWGRRGGHEQYF	TRBV12-3	TRBJ2-7
TGTGCCTGGAGTGTCAGGGGGCACGCGGACTACGAGCAGTACTTC	CAWSVRGHADYEQYF	TRBV30	TRBJ2-7
TGTGCCAGCAGTTTATCGGGGGCTTTTGGCCAAGAGACCCAGTACTTC	CASSLSGAFGQETQYF	TRBV27	TRBJ2-5
TGTGCCAGCAGTGTTAGACCCAATGAGCAGTTCTTC	CASSVRPNEQFF	TRBV6-1	TRBJ2-1
TGTGCCAGCAGCCTCGCAAGACTCACTGAAGCTTTCTTT	CASSLARLTEAFF	TRBV14	TRBJ1-1
TGTGCCAGCCTCCGGGACAGGGGGAAGGGGGAGGAGACCCAGTACTTC	CASLRDRGKGEETQYF	TRBV7-9	TRBJ2-5
TGTGCCAGCAGCGCCGGGGAAGAGACCCAGTACTTC	CASSAGEETQYF	TRBV9	TRBJ2-5
TGTGCCAGCAGTTGGGAGGGGGGGAACCTGGAGCAGTACTTC	CASSWEGGNLEQYF	TRBV5-4	TRBJ2-7
TGTGCCAGCTCCCAGAAATGGGGGGCGGGCACTGAAGCTTTCTTT	CASSQKWGAGTEAFF	TRBV7-2	TRBJ1-1
TGTGCCAGCAGCTTTCAAAAACGGAACCACAGGACAGGGAGCTCCTACGAGCAGTACTTC	CASSFQKRNHRTGSSYEQYF	TRBV7-3	TRBJ2-7
TGTGCCAGCAGTAAGCGGGGGTCTCAAGAGACCCAGTACTTC	CASSKRGSQETQYF	TRBV6-1	TRBJ2-5
TGCGCCAGCAGTTCCACGGGACGATTTCTAGAGAACTATGGCTACACCTTC	CASSSTGRFLENYGYTF	TRBV5-1	TRBJ1-2
TGCAGCGACGATCTCGATGGGGGACAGGGTGAGACCCAGTACTTC	CSDDLDGGQGETQYF	TRBV29-1	TRBJ2-5
TGTGCCAGCGCGGACAGGGAACTCTACGAGCAGTACTTC	CASADRELYEQYF	TRBV2	TRBJ2-7
TGTGCCTGGAATTACCCAGGGAACACCATATATTTT	CAWNYPGNTIYF	TRBV30	TRBJ1-3
TGTGCCAGCAGCGTAACTGAGGGGGATGAGACCCAGTACTTC	CASSVTEGDETQYF	TRBV13	TRBJ2-5
TGTGCCAGCAGGTTTACACATCTGGCCGATAGCACAGATACGCAGTATTTT	CASRFTHLADSTDTQYF	TRBV12-3	TRBJ2-3
TGTGCCAGCAGTGAGCCCCAACCCAGACAGGGACGGAACACTGAAGCTTTCTTT	CASSEPQPRQGRNTEAFF	TRBV6-4	TRBJ1-1
TGTGCCAGCAGCTTGACAGGGAAAGAGACCCAGTACTTC	CASSLTGKETQYF	TRBV5-6	TRBJ2-5
TGTGCCAGCAGTCCCGGGACTAGCGGTTTATCCTACGAGCAGTACTTC	CASSPGTSGLSYEQYF	TRBV7-9	TRBJ2-7
TGTGCCACCGATCAGTACTTC	CATDQYF	TRBV24-1	TRBJ2-5
TGCGCCAGCAGCTTGGCCAAGAAGTCGGGGGCAAACACCGAGACCCAGTACTTC	CASSLAKKSGANTETQYF	TRBV5-1	TRBJ2-5
TGTGCCAGCAGTAAGTCCCCGGGACGGCAGGGCTACACCTTC	CASSKSPGRQGYTF	TRBV2	TRBJ1-2
TGTGCCAGCGCAGGGATTGTTGTACTCTACGAGCAGTACTTC	CASAGIVVLYEQYF	TRBV6-1	TRBJ2-7
TGTGCCAGCAGCGCGTTAAGCCTTCGGCCCCAGCATTTT	CASSALSLRPQHF	TRBV9	TRBJ1-5
TGTGCCAGCAGCCAAGATTCCGAGGTTTCCGAGATCACCGGGGAGCTGTTTTTT	CASSQDSEVSEITGELFF	TRBV3-1	TRBJ2-2
TGTGCCAGCAGTTGTACGTGCACGGACTACGAGCAGTACTTC	CASSCTCTDYEQYF	TRBV3-1	TRBJ2-7
TGTGCCAGCAGTAAAGGGAAGGAGGAGACCCAGTACTTC	CASSKGKEETQYF	TRBV27	TRBJ2-5
TGTGCCAGCAGTGTACGGGAACCTCCCCTCCACTTT	CASSVREPPLHF	TRBV6-2	TRBJ1-6
TGTGCCAGCAGCCAACTAGCGGGAGCGCCCTCGAACACCGGGGAGCTGTTTTTT	CASSQLAGAPSNTGELFF	TRBV14	TRBJ2-2
TGTGCCAGCAAGTCCTGGAGGGAAGGTAGAAATCAGCCCCAGCATTTT	CASKSWREGRNQPQHF	TRBV6-1	TRBJ1-5
TGCAGTGCTATTTCTAGCGGGGAGGGTGAACGATTTTACACCGGGGAGCTGTTTTTT	CSAISSGEGERFYTGELFF	TRBV20-1	TRBJ2-2
TGCAGCGTTGTGGGGGGGGACGAGCAGTACTTC	CSVVGGDEQYF	TRBV29-1	TRBJ2-7
TGTGCCAGCAGCCAGATAGGGCTAAACCGGGACAGAACCATATATTTT	CASSQIGLNRDRTIYF	TRBV4-2	TRBJ1-3
TGTGCCAGCAGCTTACTAGCGGGAGTGGAGCAGTTCTTC	CASSLLAGVEQFF	TRBV7-8	TRBJ2-1
TGTGCCAGCAGCTTAGATCGGGACAGGGGAAGGTTCCGAGATACGCAGTATTTT	CASSLDRDRGRFRDTQYF	TRBV11-3	TRBJ2-3
TGTGCCAGCAGCTTCGGGACCAATGAGCAGTTCTTC	CASSFGTNEQFF	TRBV7-3	TRBJ2-1
TGTGCCAGCAGCCCACTAGCGGGAGGAAACATTCAGTACTTC	CASSPLAGGNIQYF	TRBV6-4	TRBJ2-4
TGTGCCAGCAGCGCGCTCTCGGGCTACACCTTC	CASSALSGYTF	TRBV9	TRBJ1-2
TGTGCCAGCAGTCGTATATACACCTACGAGCAGTACTTC	CASSRIYTYEQYF	TRBV11-1	TRBJ2-7
TGTGCCCCGACAGGCTCCACTGAAGCTTTCTTT	CAPTGSTEAFF	TRBV10-3	TRBJ1-1
TGTGCCAGCAAGTGGGACGACCCACCCAACTACGAGCAGTACTTC	CASKWDDPPNYEQYF	TRBV12-3	TRBJ2-7
TGCGCCAGGGGCCCGGGGGCCAACGTCCTGACTTTC	CARGPGANVLTF	TRBV10-1	TRBJ2-6
TGTGCCAGCAGCCATCCAGGGAGGCGGCCAGATACGCAGTATTTT	CASSHPGRRPDTQYF	TRBV14	TRBJ2-3
TGTGCCAGCAGCGGGGTGCAAGAGACCCAGTACTTC	CASSGVQETQYF	TRBV11-3	TRBJ2-5
TGTGCCAGTCAAGGGAGGGTCTCCAAAAACATTCAGTACTTC	CASQGRVSKNIQYF	TRBV19	TRBJ2-4
TGTGCCAGCAGTTACCCCTTTCTATCTCAGGGAGGTGAAAAACTGTTTTTT	CASSYPFLSQGGEKLFF	TRBV6-3	TRBJ1-4
TGTGCCAGCAGCTTCGACAGAAACACCATATATTTT	CASSFDRNTIYF	TRBV11-1	TRBJ1-3
TGCACCTCTCAGGGGGATTTCCAAGAGACCCAGTACTTC	CTSQGDFQETQYF	TRBV20-1	TRBJ2-5
TGTGCCAGCAGCTCTTCACTAGCGGGGGGGCCGGAAGATACGCAGTATTTT	CASSSSLAGGPEDTQYF	TRBV7-9	TRBJ2-3
TGTGCCAGCAGCTTGCGGCAAGAGACCCAGTACTTC	CASSLRQETQYF	TRBV5-5	TRBJ2-5
TGTGCCAGCAGGACCAGGGGCTTGAGCACAGATACGCAGTATTTT	CASRTRGLSTDTQYF	TRBV11-3	TRBJ2-3
TGCAGTGCTAGGATCTACGGGGGGAGGGTTCCCTCTGGGGCCAACGTCCTGACTTTC	CSARIYGGRVPSGANVLTF	TRBV20-1	TRBJ2-6
TGTGCCAGCAGCAACCCTGGGTCTGAAACTAGCGGGAGCTATTCAGATACGCAGTATTTT	CASSNPGSETSGSYSDTQYF	TRBV11-3	TRBJ2-3
TGTGCCAGCACATTCTCCCCTGGGGCGAATCAGCCCCAGCATTTT	CASTFSPGANQPQHF	TRBV27	TRBJ1-5
TGCAGTGCTATTCTCAGGGCGGGGGATACGCAGTATTTT	CSAILRAGDTQYF	TRBV20-1	TRBJ2-3
TGCGCCAGCAACGGGGGCAATCAGCCCCAGCATTTT	CASNGGNQPQHF	TRBV10-2	TRBJ1-5
TGTGCCAGCAGCCAAGATCCCCTTGGACTAGCGGTATCTGAGCAGTTCTTC	CASSQDPLGLAVSEQFF	TRBV14	TRBJ2-1
TGTGCCACCAAACTAGCGGGGCAGCGCACAGATACGCAGTATTTT	CATKLAGQRTDTQYF	TRBV24-1	TRBJ2-3
TGTGCCAGCAGTGGGACAGGTGAACTGTTTTTT	CASSGTGELFF	TRBV12-4	TRBJ1-4
TGCGCCAGCAGTGAGTCGGCCTTCGCCGCCGGACTAGCGGGCTACGAGCAGTACTTC	CASSESAFAAGLAGYEQYF	TRBV10-1	TRBJ2-7
TGTGCCCAGTCTAGCGGGGACACCGGGGAGCTGTTTTTT	CAQSSGDTGELFF	TRBV6-5	TRBJ2-2
TGTGCCAGCAGAACTAGCGGGGACTCCTACGAGCAGTACTTC	CASRTSGDSYEQYF	TRBV7-9	TRBJ2-7
TGCGCCAGCCCTCCGGGGACGCCTTTTTACTACGAGCAGTACTTC	CASPPGTPFYYEQYF	TRBV10-2	TRBJ2-7
TGTGCCACCAGTGATAAAAGGGGGGGGCGCAGTCACGAGCAGTACTTC	CATSDKRGGRSHEQYF	TRBV24-1	TRBJ2-7
TGCGCCAGCAGCGAGGGGGGGACCCAAGAGACCCAGTACTTC	CASSEGGTQETQYF	TRBV5-1	TRBJ2-5
TGTGCCAGCAGCCTTGGAGGGGGTTTTAACTATGGCTACACCTTC	CASSLGGGFNYGYTF	TRBV9	TRBJ1-2
TGTGCCAGCAGCCATCCTCCGGTTACCGGGGAGCTGTTTTTT	CASSHPPVTGELFF	TRBV7-7	TRBJ2-2
TGCAGTAATTCCGACAGGGGGGGTAGATATCAGCCCCAGCATTTT	CSNSDRGGRYQPQHF	TRBV20-1	TRBJ1-5
TGTGCCAGTAGTATAGTCGGGAATTCACCCCTCCACTTT	CASSIVGNSPLHF	TRBV19	TRBJ1-6
TGTGCCAGGCAGGGCCAGACGCAGTATTTT	CARQGQTQYF	TRBV14	TRBJ2-3
TGTGCCAGCGGCGACCCCTACGAGCAGTACTTC	CASGDPYEQYF	TRBV6-2	TRBJ2-7
TGTGCCAGCAGCTTGAGGATACACCACAATGAGCAGTTCTTC	CASSLRIHHNEQFF	TRBV5-6	TRBJ2-1
TGTGCCAGCAGCTCCTACAGGGGGCAGACCTACAATGAGCAGTTCTTC	CASSSYRGQTYNEQFF	TRBV14	TRBJ2-1
TGCGCCAGCAGGGTTCTAAGGAGCTCTAGGGGCTATGGCTACACCTTC	CASRVLRSSRGYGYTF	TRBV10-2	TRBJ1-2
TGTGCCAGCAGCCAAGTTATCTGGGACCCACACAGCTCCTATAATTCACCCCTCCACTTT	CASSQVIWDPHSSYNSPLHF	TRBV14	TRBJ1-6
TGTGTGGGGGGCTATGGCTACACCTTC	CVGGYGYTF	TRBV7-9	TRBJ1-2
TGTGCCAGCAGTTTCAGGCCAACTGTCAATCAGCCCCAGCATTTT	CASSFRPTVNQPQHF	TRBV28	TRBJ1-5
TGTGCCACCAGTGATGACGGAACTAGCGGGGGCTCCTACAATGAGCAGTTCTTC	CATSDDGTSGGSYNEQFF	TRBV24-1	TRBJ2-1
TGCAGCGTTCCGACAGGGGCCAAAAACATTCAGTACTTC	CSVPTGAKNIQYF	TRBV29-1	TRBJ2-4
TGCAGCGTTGAGATCCCGGGGAGGGATACTAACTATGGCTACACCTTC	CSVEIPGRDTNYGYTF	TRBV29-1	TRBJ1-2
TGTGCCAGCAGCAACCCCTCGGACGTGAACCCCCACAATGAGCAGTTCTTC	CASSNPSDVNPHNEQFF	TRBV14	TRBJ2-1
TGTGCCAGCACTAGACTTATGTATGGCTACACCTTC	CASTRLMYGYTF	TRBV27	TRBJ1-2
TGTGCCAGCAGCCAAGATATAAACGACCCCTTCATTCAGTACTTC	CASSQDINDPFIQYF	TRBV14	TRBJ2-4
TGTGCCAGCCTCGGGACAGCAGTTGAAAAACTGTTTTTT	CASLGTAVEKLFF	TRBV6-3	TRBJ1-4
TGTGCCACCAGAGGGGCAACCGGGGGCGGGGAGCTGTTTTTT	CATRGATGGGELFF	TRBV24-1	TRBJ2-2
TGCAGTGCTTGGCGGGACAGGGAAACAAGTTATGGCTACACCTTC	CSAWRDRETSYGYTF	TRBV20-1	TRBJ1-2
TGTGCCAGCAGTGAGACAGGGGATCCTAACTATGGCTACACCTTC	CASSETGDPNYGYTF	TRBV6-5	TRBJ1-2
TGTGCCAGCAGCCCGCTTCTAGCGGGTGCCTACGAGCAGTACTTC	CASSPLLAGAYEQYF	TRBV13	TRBJ2-7
TGCAGTGCTAGACCGAGACTGAGAACGGGTGATGAAGCTTTCTTT	CSARPRLRTGDEAFF	TRBV20-1	TRBJ1-1
TGTGCCACCAGTGAAGAAGGACAGGGATTACGTGAGCAGTTCTTC	CATSEEGQGLREQFF	TRBV24-1	TRBJ2-1
TGTGCCAGCAGCCTATCCGGCAGGAACACCGGGGAGCTGTTTTTT	CASSLSGRNTGELFF	TRBV7-8	TRBJ2-2
TGCAGTGCTGGGTGGGATAGCAATCAGCCCCAGCATTTT	CSAGWDSNQPQHF	TRBV20-1	TRBJ1-5
TGCGCCAGCAGTGGGAGAATTAGGGGTCCCTCCTACGAGCAGTACTTC	CASSGRIRGPSYEQYF	TRBV10-1	TRBJ2-7
TGTGCCAGCTCACCACCCAGACGGTGCTCTGGAAACACCATATATTTT	CASSPPRRCSGNTIYF	TRBV18	TRBJ1-3
TGTGCCAGCAGAATAAGGACTAGCGGGAGACTAAGCAGGGTTCCAAATTTCACAGATACGCAGTATTTT	CASRIRTSGRLSRVPNFTDTQYF	TRBV5-5	TRBJ2-3
TGTGCCAGCAAGGACGCGGTAACCCAGCCCCAGCATTTT	CASKDAVTQPQHF	TRBV6-4	TRBJ1-5
TGCGCCAGCAGACAGTGCCCGGACAGGGGAGGGTTCCATAGCAATCAGCCCCAGCATTTT	CASRQCPDRGGFHSNQPQHF	TRBV10-2	TRBJ1-5
TGTGCCAGCGAAACGAGGCGGACTAGCGGGGTAATTTACTACGAGCAGTACTTC	CASETRRTSGVIYYEQYF	TRBV6-2	TRBJ2-7
TGCAGTGCTAGAAGGAGCGGAGTAGGGGTTCCCTACGAGCAGTACTTC	CSARRSGVGVPYEQYF	TRBV20-1	TRBJ2-7
TGTGCCAGCAGCTTAGCGAAAGCGGGTAAATGCGGGGAGCTGTTTTTT	CASSLAKAGKCGELFF	TRBV7-9	TRBJ2-2
TGCGCCAGCAGCTTGCCTGGGACTAGCGGGGATACGCAGTATTTT	CASSLPGTSGDTQYF	TRBV5-1	TRBJ2-3
TGTGCCACCAGCGGCGCTGAAGCTTTCTTT	CATSGAEAFF	TRBV24-1	TRBJ1-1
TGTGCCAGCAGTCGGCTGCCTGGAAACACCATATATTTT	CASSRLPGNTIYF	TRBV6-3	TRBJ1-3
TGTGCCAGTAGGTTCCCGGGACATGAATCTGAAGCTTTCTTT	CASRFPGHESEAFF	TRBV19	TRBJ1-1
TGTGCCAGCAGCGCCCTCTGTGGGGGGGTGGCAGATACGCAGTATTTT	CASSALCGGVADTQYF	TRBV7-3	TRBJ2-3
TGTGCCAGCAGTTCCAACGGAGGGCTTCGCGGTGGCTACACCTTC	CASSSNGGLRGGYTF	TRBV12-3	TRBJ1-2
TGCAGCGTTAATGGCTACACCTTC	CSVNGYTF	TRBV29-1	TRBJ1-2
TGTGCCAGCAGTGGGCCAACTGAAGCTTTCTTT	CASSGPTEAFF	TRBV7-2	TRBJ1-1
TGTGCCACCAGTGTATTTCACAGGGAAGGAGGGGCCAACGTCCTGACTTTC	CATSVFHREGGANVLTF	TRBV24-1	TRBJ2-6
TGTGCCAGCCATACGCCCAGTTTAAACTACGAGACCCAGTACTTC	CASHTPSLNYETQYF	TRBV9	TRBJ2-5
TGTGCCAGCAGTGATGGAACATATTGGGTTGTTTTCAACACTGAAGCTTTCTTT	CASSDGTYWVVFNTEAFF	TRBV6-4	TRBJ1-1
TGTGCCAGCAGTTATTCAGTCTCTGGCCCTGACAGGGGTACTGGGTTCTCTGGGGCCAACGTCCTGACTTTC	CASSYSVSGPDRGTGFSGANVLTF	TRBV6-9	TRBJ2-6
TGTGCCAGCAGCTTACCGAAAGACCAGTGCACAGATACGCAGTATTTT	CASSLPKDQCTDTQYF	TRBV7-3	TRBJ2-3
TGTGCCAGCAACATTGACGGTGGACCGAAAGAAGTAAATAGGCTCTCTGGGGCCAACGTCCTGACTTTC	CASNIDGGPKEVNRLSGANVLTF	TRBV27	TRBJ2-6
TGTGCCAGCAGTCGGGGTTGTGCGCCGGGACCTAGCACAGATACGCAGTATTTT	CASSRGCAPGPSTDTQYF	TRBV12-3	TRBJ2-3
TGCGCCAGAGACAGGGGAGCCGGCTCCTACGAGCAGTACTTC	CARDRGAGSYEQYF	TRBV5-1	TRBJ2-7
TGTGCCAGCAGCCAAGTTGTACGCAGGGGGCTCGGCAATCAGCCCCAGCATTTT	CASSQVVRRGLGNQPQHF	TRBV4-2	TRBJ1-5
TGTGCCAGCAGTTCCCGTCCCCAGGGTTCTGAAGCTTTCTTT	CASSSRPQGSEAFF	TRBV6-1	TRBJ1-1
TGTGCCAGCAGTCACTCCGGGACTAGAGCTAGGGAGGAGCAGTACTTC	CASSHSGTRAREEQYF	TRBV12-3	TRBJ2-7
TGTGCCTTAAAATTTACAGGGGAGGTCACTGAAGCTTTCTTT	CALKFTGEVTEAFF	TRBV19	TRBJ1-1
TGTGCCAGCAGTTTTAACTCCTACACCGGGGAGCTGTTTTTT	CASSFNSYTGELFF	TRBV12-4	TRBJ2-2
TGTGCCAGCAGCGACAGCGACCGGGGCTTTTCCATGAACACTGAAGCTTTCTTT	CASSDSDRGFSMNTEAFF	TRBV6-5	TRBJ1-1
TGTGCCAGCAGCGGGCTGGGGCATGATCAGCCCCAGCATTTT	CASSGLGHDQPQHF	TRBV13	TRBJ1-5
TGTGCCAGCAGCTCCACACCCAGGGGTTCACCCCTCCACTTT	CASSSTPRGSPLHF	TRBV5-4	TRBJ1-6
TGCGCCAGCAGCAAAAGGGGGCGGATATCCTACGAGCAGTACTTC	CASSKRGRISYEQYF	TRBV5-1	TRBJ2-7
TGCGCCAGCAGCCAAGATGGAATAGGGGGCCTCTACAATGAGCAGTTCTTC	CASSQDGIGGLYNEQFF	TRBV4-1	TRBJ2-1
TGCGCCAGCAGCTTCTTTGGGGGGAGGGATAGCAATCAGCCCCAGCATTTT	CASSFFGGRDSNQPQHF	TRBV5-1	TRBJ1-5
TGTGCCAGCAGTTTGGCTGGGGCCAAAAACATTCAGTACTTC	CASSLAGAKNIQYF	TRBV12-4	TRBJ2-4
TGCGCCAGCAGCTTGGCGGGCGGTTGTTACGAGCAGTACTTC	CASSLAGGCYEQYF	TRBV5-1	TRBJ2-7
TGTGCCACCAGCAGAGATCTCTTAAAGCGCTGGGGACTGAAGGGTCCCACAGATACGCAGTATTTT	CATSRDLLKRWGLKGPTDTQYF	TRBV15	TRBJ2-3
TGTGCCAGCAGTTCTCATCGCCGGGACGAAAAAAGCTACTATGGCTACACCTTC	CASSSHRRDEKSYYGYTF	TRBV6-5	TRBJ1-2
TGCAGCGAGGGGGTCCCAGAGGGAGGCCAAGAGACCCAGTACTTC	CSEGVPEGGQETQYF	TRBV29-1	TRBJ2-5
TGTGCCAGGCAATACGGCCATGAAAAACTGTTTTTT	CARQYGHEKLFF	TRBV6-5	TRBJ1-4
TGTGCCAGCAGCGACTGGACCGGGACTAGCGGGGCGACGGCATTGGATGAGCAGTTCTTC	CASSDWTGTSGATALDEQFF	TRBV9	TRBJ2-1
TGTGCCAGCAGCAGCCGCGGGCACACCGGGGAGCTGTTTTTT	CASSSRGHTGELFF	TRBV13	TRBJ2-2
TGCAGTGCTAGACCCCATAGCGGGACTTGGTCAGAGACCCAGTACTTC	CSARPHSGTWSETQYF	TRBV20-1	TRBJ2-5
TGTGCCAGCAGTCCAAGAGGGGGACACTACGAGCAGTACTTC	CASSPRGGHYEQYF	TRBV6-3	TRBJ2-7
TGTGCCAGCAGCCAAGATTGTTGCGGGCCTCCGCAAGAGACCCAGTACTTC	CASSQDCCGPPQETQYF	TRBV3-1	TRBJ2-5
TGTGCCACACAGGGCGGCTATGGCTACACCTTC	CATQGGYGYTF	TRBV24-1	TRBJ1-2
TGTGCCAGCAGGAGCAACACGGGAACCGGGGAGCTGTTTTTT	CASRSNTGTGELFF	TRBV14	TRBJ2-2
TGTGCCAGCAGACTAGCGGGCGCTAGCACAGATACGCAGTATTTT	CASRLAGASTDTQYF	TRBV6-6	TRBJ2-3
TGTGCCAGCAGTGACAAGATTAGGCCCCCGGCGAACACCGGGGAGCTGTTTTTT	CASSDKIRPPANTGELFF	TRBV6-4	TRBJ2-2
TGCAGTGCTAGAGATCTGAAGGGGAGCTACACCGAAAAACTGTTTTTT	CSARDLKGSYTEKLFF	TRBV20-1	TRBJ1-4
TGTGCCAGCAGCGTAAGAGTCGCGTTTCTCTACGAGCAGTACTTC	CASSVRVAFLYEQYF	TRBV9	TRBJ2-7
TGTGCCACAGTGGGGCTAAAAGGCACCGGGGAGCTGTTTTTT	CATVGLKGTGELFF	TRBV24-1	TRBJ2-2
TGTGCCAGCAGCCAAGGCTGGGCGGAAGAAGATGAGCAGTTCTTC	CASSQGWAEEDEQFF	TRBV3-1	TRBJ2-1
TGTGCCACCAGTGAGTTAGGAAGGGACAATGAGCGACCGAACACCGGGGAGCTGTTTTTT	CATSELGRDNERPNTGELFF	TRBV24-1	TRBJ2-2
TGTGCCAGCAGTGAAGTGGGCGGTGCGCCGGGATTCTTT	CASSEVGGAPGFF	TRBV6-4	TRBJ1-1
TGCGCCAGCAGTGAGCCGGGGGGATTGGATTCACCCCTCCACTTT	CASSEPGGLDSPLHF	TRBV10-1	TRBJ1-6
TGTGCCTGGCTTCCGACAGATGGCTACACCTTC	CAWLPTDGYTF	TRBV30	TRBJ1-2
TGTGCCACCAGCCCTTCGGGACAGGCTTCTAATGAAAAACTGTTTTTT	CATSPSGQASNEKLFF	TRBV15	TRBJ1-4
TGTGCCAGCAGCTTAGTGCAGGGTAGGTACGAGCAGTACTTC	CASSLVQGRYEQYF	TRBV11-2	TRBJ2-7
TGTGCCAGCAGTGAAGCGGGGCAAGATACGCAGTATTTT	CASSEAGQDTQYF	TRBV6-4	TRBJ2-3
TGTGCCAGCAGACCCGGGCCAGAGGGCACTGAAGCTTTCTTT	CASRPGPEGTEAFF	TRBV6-5	TRBJ1-1
TGTGCCAGCAGTATAACAGGGGGCAGCAATCAGCCCCAGCATTTT	CASSITGGSNQPQHF	TRBV28	TRBJ1-5
TGTGCCAGCAGGGGCACCCGGACAGGTAGAGAAAAACTGTTTTTT	CASRGTRTGREKLFF	TRBV6-3	TRBJ1-4
TGTGCCAGCAGCGTAGGGGGGGGAGGGGATACGCAGTATTTT	CASSVGGGGDTQYF	TRBV9	TRBJ2-3
TGCAGCGGGGGGACAGGGCAATGGTACGAGCAGTACTTC	CSGGTGQWYEQYF	TRBV29-1	TRBJ2-7
TGTGCCAGCAGCCCTATGAGAGTCCTTCGAAAGACAGGGGGCTTAGATCAGCCCCAGCATTTT	CASSPMRVLRKTGGLDQPQHF	TRBV11-3	TRBJ1-5
TGTGCCAGCAGCATTACAGGGGTATTCAATCAGCCCCAGCATTTT	CASSITGVFNQPQHF	TRBV14	TRBJ1-5
TGTGCCTGGCTAGCGGGGTCTCAAGAGACCCAGTACTTC	CAWLAGSQETQYF	TRBV30	TRBJ2-5
TGTGCCAGCAGCACCAGGGGAATATCCGGTGCAACCGCCCCCTCTGGAAACACCATATATTTT	CASSTRGISGATAPSGNTIYF	TRBV7-2	TRBJ1-3
TGCAGTGCTCCGTCGCAGGGGGGGTACGAGCAGTACTTC	CSAPSQGGYEQYF	TRBV20-1	TRBJ2-7
TGTGCCAGCAGTTTATTACTGGGGGAGCTGTTTTTT	CASSLLLGELFF	TRBV27	TRBJ2-2
TGCGCCAGCGCTGGCTATACATTAGAGCAGTACTTC	CASAGYTLEQYF	TRBV10-1	TRBJ2-7
TGTGCCAGCAGCCTTTGGCAAGACACTGAAGCTTTCTTT	CASSLWQDTEAFF	TRBV14	TRBJ1-1
TGTGCCAGCACTCAGGACAGGGGGTCCTACGAGCAGTACTTC	CASTQDRGSYEQYF	TRBV5-4	TRBJ2-7
TGTGCCAGCAGCCGGGGGGGGTGGGACTCCTACGAGCAGTACTTC	CASSRGGWDSYEQYF	TRBV14	TRBJ2-7
TGTGCCAGCAGCCCTCCGGGTGGCGGGAGACATGGCTACACCTTC	CASSPPGGGRHGYTF	TRBV7-2	TRBJ1-2
TGTGCCAGCAGTTTACGCCCTTACAGGACAGGCTCCTACGAGCAGTACTTC	CASSLRPYRTGSYEQYF	TRBV28	TRBJ2-7
TGTGCCAGCAGCTGCAGGATGAACTATGGCTACACCTTC	CASSCRMNYGYTF	TRBV7-9	TRBJ1-2
TGTGCCAGCAGTTACCGGAAATGTCAGCCGGGACAGGGCGTGTACGAGCAGTACTTC	CASSYRKCQPGQGVYEQYF	TRBV6-5	TRBJ2-7
TGTGCCACCCTTAGGTGGACAGATACGCAGTATTTT	CATLRWTDTQYF	TRBV6-1	TRBJ2-3
TGTGCCAGCAGCTTACTACAGTCAGGGAGGAGGGAAGAGACCCAGTACTTC	CASSLLQSGRREETQYF	TRBV11-2	TRBJ2-5
TGTGCCAGCAGTCCCCAGCCCAGACAGAGCCAAGAGACCCAGTACTTC	CASSPQPRQSQETQYF	TRBV6-3	TRBJ2-5
TGTGCCAGCAGCGTAAGCCGACGCGATCCTCGGAACACTGAAGCTTTCTTT	CASSVSRRDPRNTEAFF	TRBV5-6	TRBJ1-1
TGTGCCAGCAGACCGCAGCAGGGGTCGACTGAAGCTTTCTTT	CASRPQQGSTEAFF	TRBV28	TRBJ1-1
TGTGCCAGCAGCCAATCAACTGGAAACACCATATATTTT	CASSQSTGNTIYF	TRBV14	TRBJ1-3
TGCGCCAGCAGTCCTTTGTCCAGAGACAGGGAAGTTTATAGCAATCAGCCCCAGCATTTT	CASSPLSRDREVYSNQPQHF	TRBV10-1	TRBJ1-5
TGTGCCATCAGTGAGTTGAGGCCCGGCAATGAGCAGTTCTTC	CAISELRPGNEQFF	TRBV10-3	TRBJ2-1
TGTGCCACCCGGATCCATAGGAGGGCCTCTGGAAACACCATATATTTT	CATRIHRRASGNTIYF	TRBV24-1	TRBJ1-3
TGTGCCAGCAGCGTAGCCGGGACAGTCACTGAAGCTTTCTTT	CASSVAGTVTEAFF	TRBV9	TRBJ1-1
TGTGCCAGCAGGGGGGGGGGGAGACTTGTCAATGAGCAGTTCTTC	CASRGGGRLVNEQFF	TRBV12-3	TRBJ2-1
TGTGCCAGCAGCTCCACTGGGGCAGCTTTCTTT	CASSSTGAAFF	TRBV11-1	TRBJ1-1
TGTGCCAGCAGTGGGAGTGGACCGAACAGGCCCATCTACGAGCAGTACTTC	CASSGSGPNRPIYEQYF	TRBV25-1	TRBJ2-7
TGCGCCAGCAGCTCGATAGCCGGGACCACAGATACGCAGTATTTT	CASSSIAGTTDTQYF	TRBV5-1	TRBJ2-3
TGTGCCCCGTCACAGAAGGGGGACTATGGCTACACCTTC	CAPSQKGDYGYTF	TRBV6-5	TRBJ1-2
TGTGCCAGCAGTGGAGCCAGTAATGAAAAACTGTTTTTT	CASSGASNEKLFF	TRBV25-1	TRBJ1-4
TGTGCCAGCATCACACGAACACTAGCGGGAGTGAATGGCTACACCTTC	CASITRTLAGVNGYTF	TRBV6-1	TRBJ1-2
TGCGCCAGCAGCAACACGCTTAGACTTCCCAGGATACCCTTCGATACGCAGTATTTT	CASSNTLRLPRIPFDTQYF	TRBV5-1	TRBJ2-3
TGTGCCAGCAGCTTAAACGACAGGGGCCCAAACACCGGGGAGCTGTTTTTT	CASSLNDRGPNTGELFF	TRBV7-3	TRBJ2-2
TGCGCCAGCAGGCAACCTAGCGGGCACAATGAGCAGTTCTTC	CASRQPSGHNEQFF	TRBV4-3	TRBJ2-1
TGCAGTGCAACTGGGGGCCCCTGGTGCTACGAGCAGTACTTC	CSATGGPWCYEQYF	TRBV20-1	TRBJ2-7
TGTGCCAGTAGTCCGGGCGGGACTTCACCCCTCCACTTT	CASSPGGTSPLHF	TRBV19	TRBJ1-6
TGTGCCAGCAGTTTATGGGGCCGCTCCCACAGGGGGGGGTATCTGGACGAGCAGTACTTC	CASSLWGRSHRGGYLDEQYF	TRBV27	TRBJ2-7
TGTGCCAGCAGCATCGGACTAGAGACCCAGTACTTC	CASSIGLETQYF	TRBV9	TRBJ2-5
TGTGCCAGCAGCAGACCCTTGGGTTTCTTTAGCTCCTACGAGCAGTACTTC	CASSRPLGFFSSYEQYF	TRBV7-6	TRBJ2-7
TGTGCCAGCAGTTACACCGGGGCAGAATCCTACGAGCAGTACTTC	CASSYTGAESYEQYF	TRBV6-5	TRBJ2-7
TGTGCCAGCAGCCCCGCTAGCGCGGGAGAGACCCAGTACTTC	CASSPASAGETQYF	TRBV3-1	TRBJ2-5
TGTGCCAAAAAGGGTACTAGAAAAAGCCAGCAGTACTTC	CAKKGTRKSQQYF	TRBV27	TRBJ2-7
TGTGCCAGCAGTCAGGGGGGGGGGTGGGCCTACGAGCAGTACTTC	CASSQGGGWAYEQYF	TRBV27	TRBJ2-7
TGTGCCAGTACCGGGGGAGAGACCCAGTACTTC	CASTGGETQYF	TRBV19	TRBJ2-5
TGTGCCAGCAGCCAAGAAAGGTCGCTTACCTTCATGAACACTGAAGCTTTCTTT	CASSQERSLTFMNTEAFF	TRBV4-2	TRBJ1-1
TGTGCCAGCAGAGGGACAGGGGAGACCCAGTACTTC	CASRGTGETQYF	TRBV5-6	TRBJ2-5
TGCAGTGCTAGACTAGCGGGAGGAAGTCTAGACATTCAGTACTTC	CSARLAGGSLDIQYF	TRBV20-1	TRBJ2-4
TGTGCCAGCATCCAGGAGGGCGACAATGAGCAGTTCTTC	CASIQEGDNEQFF	TRBV2	TRBJ2-1
TGTGCCAGCAGCCAAGATGGACAGGGGGACACTGAAGCTTTCTTT	CASSQDGQGDTEAFF	TRBV4-2	TRBJ1-1
TGCAGTCCACAGGAGCACCCCCCCTATCAGCCCCAGCATTTT	CSPQEHPPYQPQHF	TRBV20-1	TRBJ1-5
TGCGCCAGCAGCTTGGGACGCTTC	CASSLGRF	TRBV5-1	TRBJ2-7
TGTGCCAGCCACAAAGTCGGGGGCGGCCGAGGAAACACCATATATTTT	CASHKVGGGRGNTIYF	TRBV9	TRBJ1-3
TGTGCCAGCAGCCTCCCAAGACAGGGGCCTCTTTATGGCTACACCTTC	CASSLPRQGPLYGYTF	TRBV4-2	TRBJ1-2
TGTGCCAGTAGTATGGTAAGCCGTAACAGGCAGCCCCAGCATTTT	CASSMVSRNRQPQHF	TRBV19	TRBJ1-5
TGTGCCAGCAGCCTTTTACAGGCTTTACGCTACGAGCAGTACTTC	CASSLLQALRYEQYF	TRBV7-3	TRBJ2-7
TGTGCCAGCAGCAGACCCGGGACAGGAGGGGATGGCTACACCTTC	CASSRPGTGGDGYTF	TRBV7-9	TRBJ1-2
TGTGCCACCAAGGTAGGACGGGACCTTGTGACCCAGTACTTC	CATKVGRDLVTQYF	TRBV24-1	TRBJ2-5
TGTGCCAGCAGCGTTCCCCCACAGGGCGAATCGGGATCGGAGCAGTACTTC	CASSVPPQGESGSEQYF	TRBV9	TRBJ2-7
TGTGCCAGCAGCAATCCCGAAATTCAGAACGAAATCCGAGAGACCCAGTACTTC	CASSNPEIQNEIRETQYF	TRBV7-6	TRBJ2-5
TGTGCCAGCAGCTTATCCGGACAGGGGGCAGACGAGCAGTACTTC	CASSLSGQGADEQYF	TRBV11-2	TRBJ2-7
TGTGCCAGCAGTTACCCACAGGGGCTTAGCAATCAGCCCCAGCATTTT	CASSYPQGLSNQPQHF	TRBV6-3	TRBJ1-5
TGTGCCAGCAGCTTACGAGAAGGGAAGACCCAGTACTTC	CASSLREGKTQYF	TRBV5-4	TRBJ2-5
TGTGCCAGCAGCTTACGTTTGGGTCCGGACACGACCGGGGAGCTGTTTTTT	CASSLRLGPDTTGELFF	TRBV7-3	TRBJ2-2
TGTGCCACCAGTCCCTTCCGGGACAGGGGGGACCAGCCCCAGCATTTT	CATSPFRDRGDQPQHF	TRBV24-1	TRBJ1-5
TGTGCCAGCAGATTCGAGAGGCGGGGGCATCCAGACAATCAGCCCCAGCATTTT	CASRFERRGHPDNQPQHF	TRBV9	TRBJ1-5
TGTGCCAGCAGTGAGCGGGAGCCGGATGGAAACTATGGCTACACCTTC	CASSEREPDGNYGYTF	TRBV25-1	TRBJ1-2
TGTGCCAGCGGGTATCAGGGGGCCATCCATAATTCACCCCTCCACTTT	CASGYQGAIHNSPLHF	TRBV5-4	TRBJ1-6
TGCGCCAGCAGCGGCGACCAGAAAGTAGAGCCCCAGCATTTT	CASSGDQKVEPQHF	TRBV5-1	TRBJ1-5
TGCAGTGCTAGCCGCCTAGAGGCGGGGCAGTTCTTC	CSASRLEAGQFF	TRBV20-1	TRBJ2-1
TGTGCCAGCAGTTACACCGGACGTGGGAAGGAGCAGTACTTC	CASSYTGRGKEQYF	TRBV6-2	TRBJ2-7
TGTGCCAGCAGCGTGTACTCCACGTTGGGGGAGCAGCCCCAGCATTTT	CASSVYSTLGEQPQHF	TRBV7-9	TRBJ1-5
TGTGCCAGCAGTTTACCTGGACTAGCGGGCAGGGAGACCGGGGAGCTGTTTTTT	CASSLPGLAGRETGELFF	TRBV12-3	TRBJ2-2
TGTGCCAGCAGCTCAACGGATTATGGCTACACCTTC	CASSSTDYGYTF	TRBV7-8	TRBJ1-2
TGTGCCAGCAATTCCGGGCAGGGGACTAACTATGGCTACACCTTC	CASNSGQGTNYGYTF	TRBV7-3	TRBJ1-2
TGTGCCAGCAGCTTATGGACGACCACGGACAGGTTACCTGGAAACACCATATATTTT	CASSLWTTTDRLPGNTIYF	TRBV7-3	TRBJ1-3
TGTGCCAGCAGCTATCCGGGACAGGGGACCTATGAAAAACTGTTTTTT	CASSYPGQGTYEKLFF	TRBV11-3	TRBJ1-4
TGTGCCAGCAGGCCATTGACTAGCCTATGTAGCTACGAGCAGTACTTC	CASRPLTSLCSYEQYF	TRBV6-3	TRBJ2-7
TGTGCCAGCAGCATTGACATCTACGAGCAGTACTTC	CASSIDIYEQYF	TRBV13	TRBJ2-7
TGTGCCAGCAGCCCCGCATCGACGGCCTATAATTCACCCCTCCACTTT	CASSPASTAYNSPLHF	TRBV9	TRBJ1-6
TGTGCCAGCAGTTTATCGACAGGACCCAGCTCTTGCATATACAATGAGCAGTTCTTC	CASSLSTGPSSCIYNEQFF	TRBV27	TRBJ2-1
TGCAGTGCCGTGGACAGGGCCAGCACAGATACGCAGTATTTT	CSAVDRASTDTQYF	TRBV20-1	TRBJ2-3
TGTGCCAGCAGCGTGGTAGTCTGGGACAGGGGGTCCTACGAGCAGTACTTC	CASSVVVWDRGSYEQYF	TRBV13	TRBJ2-7
TGTGCCACCAGCAGAGATGTAGCGGGAGGAACCTACGAGCAGTACTTC	CATSRDVAGGTYEQYF	TRBV15	TRBJ2-7
TGTGCCAGCAGCCGCCAGTGTAAGGAGGGTGAGCAGTTCTTC	CASSRQCKEGEQFF	TRBV5-4	TRBJ2-1
TGTGCCAGCAGCAGGGACAGGGGTGGCTACACCTTC	CASSRDRGGYTF	TRBV11-2	TRBJ1-2
TGCGCCAGCAGCCTAACAGGGGCCCGCTATGGCTACACCTTC	CASSLTGARYGYTF	TRBV4-1	TRBJ1-2
TGTGCCAGCAGCTTGATCGGGGGTGATACGCAGTATTTT	CASSLIGGDTQYF	TRBV5-8	TRBJ2-3
TGTGCCAGCATCAGAAGGAGGGAAGAGACCCAGTACTTC	CASIRRREETQYF	TRBV9	TRBJ2-5
TGTGCCATCAGAAGCAATCAGCCCCAGCATTTT	CAIRSNQPQHF	TRBV10-3	TRBJ1-5
TGTGCCAGCAGCGGACGTTCAGGGTACGAGCAGTACTTC	CASSGRSGYEQYF	TRBV11-2	TRBJ2-7
TGCGCCAGCAGCCCTCTGCGGGGAATAGAGACCCAGTACTTC	CASSPLRGIETQYF	TRBV4-3	TRBJ2-5
TGTGCCAGCAGCTTACTTTGGGACTACGAGCAGTACTTC	CASSLLWDYEQYF	TRBV11-1	TRBJ2-7
TGTGCCAGCAGCTACTCGGGGGGCTATGGCTACACCTTC	CASSYSGGYGYTF	TRBV12-3	TRBJ1-2
TGCATCCAGGGTAAGGGCAATCAGCCCCAGCATTTT	CIQGKGNQPQHF	TRBV29-1	TRBJ1-5
TGTGCCAGCAGCCAAGAGGGACTAGCGGGGGGGCTATTGCAACATAGCTACGAGCAGTACTTC	CASSQEGLAGGLLQHSYEQYF	TRBV14	TRBJ2-7
TGCGCCAGCAGCCCAACATCACGAGCATGGAGGTATCAGCCCCAGCATTTT	CASSPTSRAWRYQPQHF	TRBV5-1	TRBJ1-5
TGTCTGGGAGGCTCGGGTATTCTGCCGTACAATGAGCAGTTCTTC	CLGGSGILPYNEQFF	TRBV27	TRBJ2-1
TGTGCCAGCAGCTCGGGCGGGGCCGGAGGCTACACCTTC	CASSSGGAGGYTF	TRBV7-9	TRBJ1-2
TGCGCCAGCAGCTTGAGTCTAGCGGGTACGGAGCTGTTTTTT	CASSLSLAGTELFF	TRBV5-1	TRBJ2-2
TGTGCCAGCAGTGGGTCCTCAGGGTACACCGGGGAGCTGTTTTTT	CASSGSSGYTGELFF	TRBV6-4	TRBJ2-2
TGTGCCAGCAGTTTAGTGACGGGGAGCCAAAACGAGCAGTACTTC	CASSLVTGSQNEQYF	TRBV12-3	TRBJ2-7
TGTGCCACCAGTGATTCCAACAGGGGGCGAACGTGGACGGCGGTTACCTACGAGCAGTACTTC	CATSDSNRGRTWTAVTYEQYF	TRBV24-1	TRBJ2-7
TGTGCCAGCAGTGACTCCCCGCGGGAGGGCGATGAGCAGTTCTTC	CASSDSPREGDEQFF	TRBV6-4	TRBJ2-1
TGCGCCAGCAGTCCGAAGGACAGAGGGGACACCATATATTTT	CASSPKDRGDTIYF	TRBV10-1	TRBJ1-3
TGTGCCAGCAGTTTGTATTTTGAGTACGAGCAGTACTTC	CASSLYFEYEQYF	TRBV6-5	TRBJ2-7
TGTGCCAGCAGCCCCAGAGGAGTTTCCTACGAGCAGTACTTC	CASSPRGVSYEQYF	TRBV7-9	TRBJ2-7
TGTGCCAGCAGGTACCCAGGCGGCTCCTCTAACTATGGCTACACCTTC	CASRYPGGSSNYGYTF	TRBV28	TRBJ1-2
TGTGCCAGCAGTTTGATAAATGAGACCCAGTACTTC	CASSLINETQYF	TRBV2	TRBJ2-5
TGTGCCAGCAGCGTTCCCAACGTTCCAGGGGGACAGTCTGGAAACACCATATATTTT	CASSVPNVPGGQSGNTIYF	TRBV7-4	TRBJ1-3
TGTGCCAGCAGCTTACCCCGGCGTAGTAATGAAAAACTGTTTTTT	CASSLPRRSNEKLFF	TRBV7-9	TRBJ1-4
TGCGCCAGCAGTGAGTCGGGCCCAGGATCTCGTAATAACTATGGCTACACCTTC	CASSESGPGSRNNYGYTF	TRBV10-1	TRBJ1-2
TGTGCCAGTAGTCTGACAGGGCCGGACTATGGCTACACCTTC	CASSLTGPDYGYTF	TRBV19	TRBJ1-2
TGTGCCAGCAGCCAAGATCTTTGCAGAATTGTCACTGAAGCTTTCTTT	CASSQDLCRIVTEAFF	TRBV3-1	TRBJ1-1
TGTGCTAGTGGTTTGCCGGTTAGGTTGGGTAATCAGCCCCAGCATTTT	CASGLPVRLGNQPQHF	TRBV12-5	TRBJ1-5
TGTGCCAGCAGGTCACAGGGGGCAAGAGGAAACCACACCGGGGAGCTGTTTTTT	CASRSQGARGNHTGELFF	TRBV9	TRBJ2-2
TGTGCCAGCAGTTTATCCCCTCCGGGACTTCTAACTAATGAAAAACTGTTTTTT	CASSLSPPGLLTNEKLFF	TRBV28	TRBJ1-4
TGTGCCAGCAGACCCAAAAAGGGGAACTACAATGAGCAGTTCTTC	CASRPKKGNYNEQFF	TRBV6-4	TRBJ2-1
TGTGCCAGCAGCAGGAGCGACAGGGAGGACTACGAGCAGTACTTC	CASSRSDREDYEQYF	TRBV13	TRBJ2-7
TGTGCCAGCAGCGACGGAAAATGTACTCATAGCGGGGACAATGAGCAGTTCTTC	CASSDGKCTHSGDNEQFF	TRBV5-4	TRBJ2-1
TGCAGTGCTAGACCCCCTACTGAAGCTTTCTTT	CSARPPTEAFF	TRBV20-1	TRBJ1-1
TGCACCCCCCCCTACAGAAGCCCCACCCCCGGGCAGCCCCAGCATTTT	CTPPYRSPTPGQPQHF	TRBV20-1	TRBJ1-5
TGTGCCTACACGGGGGACAGGGGGTACAATGAGCAGTTCTTC	CAYTGDRGYNEQFF	TRBV15	TRBJ2-1
TGTGCCATCAGTGCGTTAGTTCAGGGGGGAAACACCATATATTTT	CAISALVQGGNTIYF	TRBV10-3	TRBJ1-3
TGTGCCAGCAGATCCTATACAGGGCTAGGGACGCATTTT	CASRSYTGLGTHF	TRBV27	TRBJ1-5
TGTGCCAGCAGTGGGCCCCCATTCGGGGGCTGCACCGGGGAGCTGTTTTTT	CASSGPPFGGCTGELFF	TRBV12-4	TRBJ2-2
TGTGCCTGGAAGGGACAGGGAATGTTGAATGAGCAGTTCTTC	CAWKGQGMLNEQFF	TRBV30	TRBJ2-1
TGTGCCAGCAGTTTAATCAGAGACTACGAGCAGTACTTC	CASSLIRDYEQYF	TRBV12-4	TRBJ2-7
TGTGCCAGCAGCCAAGACCGGGCGGGGGGGCAAGAGACCCAGTACTTC	CASSQDRAGGQETQYF	TRBV14	TRBJ2-5
TGTGCCAGCAGTTACTTGCTTGGTCGTGGGGCCAACGTCCTGACTTTC	CASSYLLGRGANVLTF	TRBV6-2	TRBJ2-6
TGTGCCTGGAGTGAATTGGGGCACACCTATAATTCACCCCTCCACTTT	CAWSELGHTYNSPLHF	TRBV30	TRBJ1-6
TGTGCCAGCAGCTTCTGGCGCGCCCGGGGAAGCGAGCAGTACTTC	CASSFWRARGSEQYF	TRBV13	TRBJ2-7
TGTGCCAGCCTGCGGCGGAGCTCCTACAATGAGCAGTTCTTC	CASLRRSSYNEQFF	TRBV19	TRBJ2-1
TGCACTGCGCGACAGAGGGAATCTAACTATGGCTACACCTTC	CTARQRESNYGYTF	TRBV20-1	TRBJ1-2
TGTGCCAGCAGCCCCGCTGAACAGGTCCAGCCCCAGCATTTT	CASSPAEQVQPQHF	TRBV11-2	TRBJ1-5
TGCAGTCAGGTCTTCGGGGGGGCGTACACCGGGGAGCTGTTTTTT	CSQVFGGAYTGELFF	TRBV20-1	TRBJ2-2
TGTGCCAGCTCACTTGGACAGGGAAGTTCATCTAACTATGGCTACACCTTC	CASSLGQGSSSNYGYTF	TRBV18	TRBJ1-2
TGTGCCACCAGTGATTTGGGACAGGGGGCTACGGGCACTGAAGCTTTCTTT	CATSDLGQGATGTEAFF	TRBV24-1	TRBJ1-1
TGTGCCAGCAGCCAAACCAGTACGGACTACGAGCAGTACTTC	CASSQTSTDYEQYF	TRBV7-8	TRBJ2-7
TGTGCTAGTGGTTTGGTACCCGATGTGGACAGGGAGCAGCTCTACGAGCAGTACTTC	CASGLVPDVDREQLYEQYF	TRBV12-5	TRBJ2-7
TGTGCCAGCAGATCGTTGGACGAGAATGAAAAACTGTTTTTT	CASRSLDENEKLFF	TRBV11-3	TRBJ1-4
TGTGCCAGCAGTGAGCCACCGGGCCGACGGGACAATGAGCAGTTCTTC	CASSEPPGRRDNEQFF	TRBV6-4	TRBJ2-1
TGTGCCAGCAGCGCCGGGACAGGGCGCTACGAGCAGTACTTC	CASSAGTGRYEQYF	TRBV5-6	TRBJ2-7
TGTGCCAGCAGCTCCCGGGATCCCGGGACAGGGGGTTCTGAAGCTTTCTTT	CASSSRDPGTGGSEAFF	TRBV11-3	TRBJ1-1
TGTGCCAGCAGCACCCAAGTAGAGAGGGCCTACGAGCAGTACTTC	CASSTQVERAYEQYF	TRBV9	TRBJ2-7
TGCGCCAGCCCCCGGGCAGGGGGCGAGCTAATATCGGGAGGGGCCAACGTCCTGACTTTC	CASPRAGGELISGGANVLTF	TRBV5-1	TRBJ2-6
TGTGCCAGCAGCCAAGATGAGAGGGCCCGGGACAGGGATGGCTACACCTTC	CASSQDERARDRDGYTF	TRBV14	TRBJ1-2
TGTGCCAGCAGCTACCACATCAGCCGGTTATATGGAAACACCATATATTTT	CASSYHISRLYGNTIYF	TRBV7-3	TRBJ1-3
TGTGCCAGCCTGTGCCAGGGCGAGCAAGAGACCCAGTACTTC	CASLCQGEQETQYF	TRBV7-2	TRBJ2-5
TGTGCCAGCAGTGACCCGACTAGCGGGGGGAAAAACACCGGGGAGCTGTTTTTT	CASSDPTSGGKNTGELFF	TRBV6-4	TRBJ2-2
TGTGCTAGTAGCCTGGGGGGCGGGGAATCCTACAATGAGCAGTTCTTC	CASSLGGGESYNEQFF	TRBV12-5	TRBJ2-1
TGTGCCAGCACGCTGCTCACTGAAGCTTTCTTT	CASTLLTEAFF	TRBV6-5	TRBJ1-1
TGTGCTAGTGGTTCCCTTGCGCAAACCGGCTACACCTTC	CASGSLAQTGYTF	TRBV12-5	TRBJ1-2
TGCAGTGCTAGGTCCGGGACTACTGAAGCTTTCTTT	CSARSGTTEAFF	TRBV20-1	TRBJ1-1
TGTGCCAGCTTGCGACAGGTTCGGGGTACCAACGTCCTGACTTTC	CASLRQVRGTNVLTF	TRBV27	TRBJ2-6
TGTGCCACCAGCAGAGCCCGTCCTAATCAGGGCGGGGCAGTGGAAACCTATGGCTACACCTTC	CATSRARPNQGGAVETYGYTF	TRBV15	TRBJ1-2
TGCGCCAAGGGCGCGGGAGTCGACGAGCAGTACTTC	CAKGAGVDEQYF	TRBV10-2	TRBJ2-7
TGTGCCAGCAGCTTAGATTCCGGGTTAAGCGGGGGGTGGCCCAATCAGCCCCAGCATTTT	CASSLDSGLSGGWPNQPQHF	TRBV11-2	TRBJ1-5
TGTGCCACCATTTCTCAGGGGGGGGGCTATGGCTACACCTTC	CATISQGGGYGYTF	TRBV24-1	TRBJ1-2
TGTGCCAGCAGCTTAGTGGGGTTGAGGGGACTGGCAACTAATGAAAAACTGTTTTTT	CASSLVGLRGLATNEKLFF	TRBV7-8	TRBJ1-4
TGTGCTAGTGGTTTGGTAGCCCGGGACAGGGGTGACTCTGGGGCCAACGTCCTGACTTTC	CASGLVARDRGDSGANVLTF	TRBV12-5	TRBJ2-6
TGTGCCAGCAGCTTAGAGTACCCGGAGGGTCACGAGCAGTACTTC	CASSLEYPEGHEQYF	TRBV7-6	TRBJ2-7
TGTGCTAGTGGTTTCCACCAGGGTTTTGGCACAGATACGCAGTATTTT	CASGFHQGFGTDTQYF	TRBV12-5	TRBJ2-3
TGCAGTGGCGACAGGGCAGGTAATGAAAAACTGTTTTTT	CSGDRAGNEKLFF	TRBV20-1	TRBJ1-4
TGTGCCAGCCTGGGCCACGGGCCGGGCTCTGGAAACACCATATATTTT	CASLGHGPGSGNTIYF	TRBV2	TRBJ1-3
TGTGCCAGCAGCTTACGTAAGGGAGGGAGAGAGATCAGGAATAATTCACCCCTCCACTTT	CASSLRKGGREIRNNSPLHF	TRBV7-6	TRBJ1-6
TGTGCCAGCTCCCGGACTAGCGGACGGGCCCAATTAGGAAACATTCAGTACTTC	CASSRTSGRAQLGNIQYF	TRBV28	TRBJ2-4
TGTGCCAGCAGCGGAAGGGGGCCAAGCTCTGGGGCCAACGTCCTGACTTTC	CASSGRGPSSGANVLTF	TRBV7-9	TRBJ2-6
TGTGCCAGCAGGGCGACAGAGGGAGGGTACAGAGGGGCCAACGTCCTGACTTTC	CASRATEGGYRGANVLTF	TRBV5-4	TRBJ2-6
TGTGCCAGCAGAGATAGCAATCAGCCCCAGCATTTT	CASRDSNQPQHF	TRBV6-1	TRBJ1-5
TGTGCCAGCAGCCAAGAACAGGATTCCAATGAAGCTTTCTTT	CASSQEQDSNEAFF	TRBV14	TRBJ1-1
TGTGCCAGCTACGAGGACAGGGGCTCGGAGCACTATGGCTACACCTTC	CASYEDRGSEHYGYTF	TRBV6-1	TRBJ1-2
TGTGCCAGCAGGGACAGGGTCGGCAATCAGCCCCAGCATTTT	CASRDRVGNQPQHF	TRBV28	TRBJ1-5
TGTGCCAGCAGCTTAGATCGTGGGGGGGAACAGTATTTT	CASSLDRGGEQYF	TRBV11-2	TRBJ2-3
TGTGCCAGCGTGCCTAGGGTTTTTTGCAATCAGCCCCAGCATTTT	CASVPRVFCNQPQHF	TRBV12-3	TRBJ1-5
TGTGCCAGCAGCCCCGGACCCGGGGAGCTGTTTTTT	CASSPGPGELFF	TRBV13	TRBJ2-2
TGTGCCAGCAGCCATCAGGAGCAAGTATCCTACGAGCAGTACTTC	CASSHQEQVSYEQYF	TRBV13	TRBJ2-7
TGTGCCAGGGGGGCCCAGCACTACGAGCAGTACTTC	CARGAQHYEQYF	TRBV2	TRBJ2-7
TGTGCCAGCAGCCTTACCGGGGAGAACAATGAGCAGTTCTTC	CASSLTGENNEQFF	TRBV14	TRBJ2-1
TGTGCCAGCCTGGGGCAGATGACGGAGCCCCAGCATTTT	CASLGQMTEPQHF	TRBV9	TRBJ1-5
TGTGCCAGCAGCGGCCCAGGGAACCAGCCCCAGCATTTT	CASSGPGNQPQHF	TRBV7-4	TRBJ1-5
TGTGCCAGGGAGGATCCTTACTATGGCTACACCTTC	CAREDPYYGYTF	TRBV2	TRBJ1-2
TGTGCCAGCAGCGACAGGGGCTATGGCTACACCTTC	CASSDRGYGYTF	TRBV7-9	TRBJ1-2
TGTGCCAGCAGTTCACAGGGCGCTAATGAAAAACTGTTTTTT	CASSSQGANEKLFF	TRBV27	TRBJ1-4
TGCGCCAGCAGTGAGATGCAGGGGGAAATGAACACTGAAGCTTTCTTT	CASSEMQGEMNTEAFF	TRBV10-2	TRBJ1-1
TGTGCCAGCAGCTTAGATGGGGTCGGCAGGGGCTACACCTTC	CASSLDGVGRGYTF	TRBV11-3	TRBJ1-2
TGTGCCAGTAGTACCACCTTGATGGCGGGGGGATTTAAGACCCAGTACTTC	CASSTTLMAGGFKTQYF	TRBV19	TRBJ2-5
TGTGCCAGCAGGGGAAAAAGACAGAGTATAGAGACCCAGTACTTC	CASRGKRQSIETQYF	TRBV28	TRBJ2-5
TGTGCCAGCCCGGGGGGTTGCGAGCCCTACAATGAGCAGTTCTTC	CASPGGCEPYNEQFF	TRBV27	TRBJ2-1
TGTGCCAGCAGTTCGACATCGCATCTTGAAAAACTGTTTTTT	CASSSTSHLEKLFF	TRBV28	TRBJ1-4
TGTGCCAGCAGCTTAGAAGGACGGACTGTTGGCACCGGGGAGCTGTTTTTT	CASSLEGRTVGTGELFF	TRBV11-2	TRBJ2-2
TGTGCCAGCAGTGCGGAAGACAATGAGCAGTTCTTC	CASSAEDNEQFF	TRBV18	TRBJ2-1
TGCAGTGCTAGAGCTGGGGGGGTCACTAGCCTGCCCCCAGAGACCCAGTACTTC	CSARAGGVTSLPPETQYF	TRBV20-1	TRBJ2-5
TGTGCCAGCAGGCGCACAGAGACCCAGTACTTC	CASRRTETQYF	TRBV11-3	TRBJ2-5
TGCGCCGTGACGGCGTCGAGGAGCACAGATACGCAGTATTTT	CAVTASRSTDTQYF	TRBV5-1	TRBJ2-3
TGTGCCAGCAGCTTTACCCGGGACAGTCAGTTCAACACCTTC	CASSFTRDSQFNTF	TRBV7-8	TRBJ1-2
TGCAGTGCTAGATACATTTACGTAATCAATCAGCCCCAGCATTTT	CSARYIYVINQPQHF	TRBV20-1	TRBJ1-5
TGTGCCAGCAGCCTAGCGGGGGAGTGCTCCTACAATGAGCAGTTCTTC	CASSLAGECSYNEQFF	TRBV7-3	TRBJ2-1
TGTGCCGGAGACCCCATGAACACTGAAGCTTTCTTT	CAGDPMNTEAFF	TRBV6-5	TRBJ1-1
TGTGCCAGCAGCGAAAGGGGGAAGAGCTCCTACGAGCAGTACTTC	CASSERGKSSYEQYF	TRBV11-3	TRBJ2-7
TGTGCCAGCAGCCGAGAAGCGAGACTAGCGGGGGGGCCCAATGAGCAGTTCTTC	CASSREARLAGGPNEQFF	TRBV13	TRBJ2-1
TGTGCCAGCAGGGGGGGGGGCACAGATACGCAGTATTTT	CASRGGGTDTQYF	TRBV2	TRBJ2-3
TGTGCCAGCAGCTTGAGGCCGGGACAGGGATACTATGGCTACACCTTC	CASSLRPGQGYYGYTF	TRBV7-3	TRBJ1-2
TGTGCCAGCAGTGGACTAGCGATTCCTAGCACAGATACGCAGTATTTT	CASSGLAIPSTDTQYF	TRBV6-1	TRBJ2-3
TGTGCCAGCAGCTTACCCTGGACTAGCGGGTTCTGGGATGAGCAGTTCTTC	CASSLPWTSGFWDEQFF	TRBV7-9	TRBJ2-1
TGTGCCAGCAGCGTTTTTGGACCGGGGCGGATTTACAATGAGCAGTTCTTC	CASSVFGPGRIYNEQFF	TRBV13	TRBJ2-1
TGCGCCAGCAGTGGTAAGCACAGGGAGTATTTT	CASSGKHREYF	TRBV10-2	TRBJ2-3
TGTGCCAGCCCGGCGGTCAGTAGCTCCTACGAGCAGTACTTC	CASPAVSSSYEQYF	TRBV7-3	TRBJ2-7
TGTGCCAGCAGTTACGTAGGACTAGCGGAGCATCTATGCACAGATACGCAGTATTTT	CASSYVGLAEHLCTDTQYF	TRBV6-3	TRBJ2-3
TGTGCCAGCAGCGTACGGACTGGCTACACCTTC	CASSVRTGYTF	TRBV9	TRBJ1-2
TGTGCCAGCAGCTTAGGGGGAATAGCTTTCTTT	CASSLGGIAFF	TRBV11-3	TRBJ1-1
TGTGCCAGCAGCTTAGCCGCGACCCTGACATCCGGCTACACCTTC	CASSLAATLTSGYTF	TRBV7-8	TRBJ1-2
TGTGCCAGCAGCTTAGGGAGAAGCGGACGGGAAAAACTGTTTTTT	CASSLGRSGREKLFF	TRBV7-6	TRBJ1-4
TGCGCCAGCAGTGAGGGACTAGCATATGAGCAGTTCTTC	CASSEGLAYEQFF	TRBV10-2	TRBJ2-1
TGTGCCAGCAGCTTGGCCCCCCGGGACGCATCCGGGGAGCTGTTTTTT	CASSLAPRDASGELFF	TRBV5-4	TRBJ2-2
TGTGCCAGCACTTCCTCCGACAGGGGAAACACCATATATTTT	CASTSSDRGNTIYF	TRBV13	TRBJ1-3
TGCGCCAGCAGCCAAGTTTCCGGGACGAAGGAAGCTTTCTTT	CASSQVSGTKEAFF	TRBV4-3	TRBJ1-1
TGTGCCAGCAGCAGAGAAAGGCATCAGCCCCAGCATTTT	CASSRERHQPQHF	TRBV7-9	TRBJ1-5
TGTGCCAGCAGTTTCATTGGGACAAGAGGTTGGGGGACCTATGGCTACACCTTC	CASSFIGTRGWGTYGYTF	TRBV27	TRBJ1-2
TGTGCCAGCAGCGAAAAGGGGTTTCGCTATGGCTACACCTTC	CASSEKGFRYGYTF	TRBV9	TRBJ1-2
TGTGCCAGCATCGCACCGCAGGGCGAGCAGTACTTC	CASIAPQGEQYF	TRBV2	TRBJ2-7
TGTGCCAGCAGCGCGGCGCAAGAGACCCAGTACTTC	CASSAAQETQYF	TRBV13	TRBJ2-5
TGTGCCAGCACTAAGGACATTACCTACGAGCAGTACTTC	CASTKDITYEQYF	TRBV27	TRBJ2-7
TGTGACACAGGGGGCGGAAACACCATATATTTT	CDTGGGNTIYF	TRBV9	TRBJ1-3
TGTGCCACCAGTGATTTGAATGACAGTGGGACGGGACACGATGAGACCCAGTACTTC	CATSDLNDSGTGHDETQYF	TRBV24-1	TRBJ2-5
TGTGCCAGCACGCTTAGGGAGGAAAAACTGTTTTTT	CASTLREEKLFF	TRBV6-8	TRBJ1-4
TGTGCCAGCAGCTGCCTATTTAGCTCCTACAATGAGCAGTTCTTC	CASSCLFSSYNEQFF	TRBV13	TRBJ2-1
TGTGCCAGCAGAGACAGGGAGATCACAGATACGCAGTATTTT	CASRDREITDTQYF	TRBV28	TRBJ2-3
TGTGCCAGCAGGCAGGGCTACGAGCAGTACTTC	CASRQGYEQYF	TRBV9	TRBJ2-7
TGTGCCAGCAGCCAAGAGACGGGAGGTACCTACGAGCAGTACTTC	CASSQETGGTYEQYF	TRBV14	TRBJ2-7
TGTGCCAGCAGCTTAGACGTGGGTTGGGGGGATGGCTACACCTTC	CASSLDVGWGDGYTF	TRBV13	TRBJ1-2
TGTGCCACTCCAGCGGGACTCTACGAGCAGTACTTC	CATPAGLYEQYF	TRBV19	TRBJ2-7
TGTGCCAGCAGTTTATCAGGTGGGGGCGGAAACACCATATATTTT	CASSLSGGGGNTIYF	TRBV27	TRBJ1-3
TGTGCCAGCAGCCGAACGTTACAGGGTCCCGGCACAGATACGCAGTATTTT	CASSRTLQGPGTDTQYF	TRBV13	TRBJ2-3
TGTGCCACCCCGGAGACTAGTGAGGTAGCCAAAAACATTCAGTACTTC	CATPETSEVAKNIQYF	TRBV11-2	TRBJ2-4
TGTGCCAGCAGCTTTCTTCAACGATCAGGTCACGAGCAGTACTTC	CASSFLQRSGHEQYF	TRBV11-2	TRBJ2-7
TGTGCCAGCAGCGCGCGGCGGGAGTACTCTGGAAACACCATATATTTT	CASSARREYSGNTIYF	TRBV7-4	TRBJ1-3
TGTGCCAGCAGCCAACAACAGCCCGGGACAGATACGCAGTATTTT	CASSQQQPGTDTQYF	TRBV3-1	TRBJ2-3
TGTGCCAGCAGTTTTAAAGTAACCACGAACAGTATGTCCTACGAGCAGTACTTC	CASSFKVTTNSMSYEQYF	TRBV12-3	TRBJ2-7
TGTGCCTGGAGTTCGGGGTGTAGCAATCAGCCCCAGCATTTT	CAWSSGCSNQPQHF	TRBV30	TRBJ1-5
TGTGCCAGCAGCTTACCTAGCGGGAGTGAGCAGTTCTTC	CASSLPSGSEQFF	TRBV11-3	TRBJ2-1
TGTGCCGTCCAGCGGGAGGAGTGCTACGAGCAGTACTTC	CAVQREECYEQYF	TRBV6-5	TRBJ2-7
TGTGCCAGTAGTATTCACACGTCGACAGGTAGCACAGATACGCAGTATTTT	CASSIHTSTGSTDTQYF	TRBV19	TRBJ2-3
TGTGCCAGCAGTGGCGGGGGGCGTTCCGAACAGCCCCAGCATTTT	CASSGGGRSEQPQHF	TRBV12-3	TRBJ1-5
TGTGCCAACTCTAGCGGGCAAGAGACCCAGTACTTC	CANSSGQETQYF	TRBV12-3	TRBJ2-5
TGTGCCAGCATAGTGGCGGGGGGGGACGAGCAGTACTTC	CASIVAGGDEQYF	TRBV27	TRBJ2-7
TGTGCCAGCAGTTCCAACAGGGGAGGGGACCAAGAGACCCAGTACTTC	CASSSNRGGDQETQYF	TRBV27	TRBJ2-5
TGTGCCAGCAGCCACCCGGGGGGTTCCTGCCTGGGTGAAAAACTGTTTTTT	CASSHPGGSCLGEKLFF	TRBV14	TRBJ1-4
TGTGCCAGCAGGGCGAGGGCCGATACGCAGTATTTT	CASRARADTQYF	TRBV28	TRBJ2-3
TGTGCTAGCAGCTTAGCGGAGGGGGGGGAAGCCAAAAACATTCAGTACTTC	CASSLAEGGEAKNIQYF	TRBV7-7	TRBJ2-4
TGTGCCAGTAGTATGCGCGGGCCCAATGGGGCCAACGTCCTGACTTTC	CASSMRGPNGANVLTF	TRBV19	TRBJ2-6
TGTGCCAGCAGTGGGTTGAGGGCCCGAGACAGCTGGGATCCCGGCTACACCTTC	CASSGLRARDSWDPGYTF	TRBV2	TRBJ1-2
TGTGCCAGCAGCTTAGAAGCAGGGGGACTGAACACTGAAGCTTTCTTT	CASSLEAGGLNTEAFF	TRBV11-3	TRBJ1-1
TGCGCCAGCAATAGGGCCCACGAGTCGTCAGATACGCAGTATTTT	CASNRAHESSDTQYF	TRBV4-1	TRBJ2-3
TGTGCCAGCAGCCAGGGGGACGGAACTTCCTACAATGAGCAGTTCTTC	CASSQGDGTSYNEQFF	TRBV7-8	TRBJ2-1
TGCGCCAGCAGCCTCGGGAAGGACCAGGGGACAACAGCCTACGAGCAGTACTTC	CASSLGKDQGTTAYEQYF	TRBV5-1	TRBJ2-7
TGTGCCAGCAGCGTCTCGGGGCGCGCCAAAAACATTCAGTACTTC	CASSVSGRAKNIQYF	TRBV9	TRBJ2-4
TGCGCCAGCAGCTTCAACAGGAGGATTGGCTACACCTTC	CASSFNRRIGYTF	TRBV5-1	TRBJ1-2
TGTGCCAGCACTGAGATCCGGGGGGCCTACGAGCAGTACTTC	CASTEIRGAYEQYF	TRBV2	TRBJ2-7
TGTGCCAGCAACTGTTACTGGGACTCCTCTGGAAACACCATATATTTT	CASNCYWDSSGNTIYF	TRBV27	TRBJ1-3
TGTGCCAGCAGTTATGTTTTAGAGCCCGACTACGAGCAGTACTTC	CASSYVLEPDYEQYF	TRBV6-2	TRBJ2-7
TGTGCCAGCAGCGCTTTGACAGGGGGCTTTCTGGATAGCAATCAGCCCCAGCATTTT	CASSALTGGFLDSNQPQHF	TRBV7-3	TRBJ1-5
TGTGCCAGCAGTGGGGCCTCCTATGGCTACACCTTC	CASSGASYGYTF	TRBV2	TRBJ1-2
TGTGCCAGCAGTCTAAAGGACGGTGAAGGCACCGGGGAGCTGTTTTTT	CASSLKDGEGTGELFF	TRBV27	TRBJ2-2
TGTGCCAGCAGCGTCAGGCCCAGAAGGGGTTACGAGCAGTACTTC	CASSVRPRRGYEQYF	TRBV7-4	TRBJ2-7
TGTGCCAGCATCCCCGAAAAACTAGCGGGGAGACCGCAGTTCTTC	CASIPEKLAGRPQFF	TRBV28	TRBJ2-1
TGTGCCAGCAGCCGGGAGCGGCAGAACACTGAAGCTTTCTTT	CASSRERQNTEAFF	TRBV7-2	TRBJ1-1
TGTGCCAGCAGCAAGATGCTAGCGGGAGATACGCAGTATTTT	CASSKMLAGDTQYF	TRBV6-5	TRBJ2-3
TGTGCCAGCAGCTTCCTGGGGAATCCCTACGAGCAGTACTTC	CASSFLGNPYEQYF	TRBV11-2	TRBJ2-7
TGCAGTGCTAGAGCGACTTTTCCCCAGTTCGGTACTTCCTACGAGCAGTACTTC	CSARATFPQFGTSYEQYF	TRBV20-1	TRBJ2-7
TGTGCCAGCAGCTTAGCCACGGGAGAGGACACAGATACGCAGTATTTT	CASSLATGEDTDTQYF	TRBV7-9	TRBJ2-3
TGTGCCAGCAGTCTTCTCTTGCACGATGGGTCCCCCTCCTATAATTCACCCCTCCACTTT	CASSLLLHDGSPSYNSPLHF	TRBV14	TRBJ1-6
TGTGCCAGCAGTTACAACAGGGGCCGGACGACGGAAATTAGCTTCCAAGAGACCCAGTACTTC	CASSYNRGRTTEISFQETQYF	TRBV6-3	TRBJ2-5
TGTGCCAGCAGTGCTACAGGGTTAGGGTACGAGCAGTACTTC	CASSATGLGYEQYF	TRBV7-3	TRBJ2-7
TGTGCCAGCAGTTACTCGAACCAGGACAGGGATAGGCAGCCCCAGCATTTT	CASSYSNQDRDRQPQHF	TRBV6-5	TRBJ1-5
TGTGCCAGCAGCCAAGCAGAGAATTGTTTCTCCTATAATTCACCCCTCCACTTT	CASSQAENCFSYNSPLHF	TRBV14	TRBJ1-6
TGTGCCAGCAGGACCGGGACGAGAGGGCTCCACCCAAAGGACGAACACACTGAAGCTTTCTTT	CASRTGTRGLHPKDEHTEAFF	TRBV28	TRBJ1-1
TGTGCCACCAGTGATAAGACAGGGACTGAAGCTTTCTTT	CATSDKTGTEAFF	TRBV24-1	TRBJ1-1
TGCAGTGCTAGAGATCTTTCCTGGACAGGATACGACAGCGAGCAGTACTTC	CSARDLSWTGYDSEQYF	TRBV20-1	TRBJ2-7
TGCGCCAGCAGTGAGGAGGGACTCACAGATACGCAGTATTTT	CASSEEGLTDTQYF	TRBV10-1	TRBJ2-3
TGTGCCAGCAGCGCCGCGGGACAGCTGGTACCCGACACTGAAGCTTTCTTT	CASSAAGQLVPDTEAFF	TRBV13	TRBJ1-1
TGCGCCAGCAGCGATGACAGGGTAGAAAAAGTATCCACTGAAGCTTTCTTT	CASSDDRVEKVSTEAFF	TRBV5-1	TRBJ1-1
TGTGCCAGCAGCCGACAGGGGCAGCCGGGCTACGAGCAGTACTTC	CASSRQGQPGYEQYF	TRBV14	TRBJ2-7
TGTGCCAGCAAAATGAAGGCTGGCACAGATACGCAGTATTTT	CASKMKAGTDTQYF	TRBV6-1	TRBJ2-3
TGTGCCAGCAGCGTAGCCCGGTACTCCTACAATGAGCAGTTCTTC	CASSVARYSYNEQFF	TRBV9	TRBJ2-1
TGTGCCACCGCACTACAGATAAGAACTGAAGCTTTCTTT	CATALQIRTEAFF	TRBV24-1	TRBJ1-1
TGTGCCAGCAGGGACAGTCATACGCAGTATTTT	CASRDSHTQYF	TRBV27	TRBJ2-3
TGTGCTAGCAGCTGTAGGTCTGGAAACACCATATATTTT	CASSCRSGNTIYF	TRBV7-7	TRBJ1-3
TGTGCCAGCACTAGCTCTGTGGAGGACCCGAACTATGGCTACACCTTC	CASTSSVEDPNYGYTF	TRBV6-6	TRBJ1-2
TGTGCCAGCAGTTATGGGGCAACCGGGACAGGGGGCGGGGATGGAACTCGTCAGCCCCAGCATTTT	CASSYGATGTGGGDGTRQPQHF	TRBV6-5	TRBJ1-5
TGCGCCAGCAGGCGAATTTGGGGGACAGGGGGTGGAGGCTACACCTTC	CASRRIWGTGGGGYTF	TRBV10-1	TRBJ1-2
TGTGCCAGCAGGTGTGCCGGGACTACCGAGACCCAGTACTTC	CASRCAGTTETQYF	TRBV7-3	TRBJ2-5
TGTGCCACCAGGGGACAGGGGTGGGTCGAGACCCAGTACTTC	CATRGQGWVETQYF	TRBV10-3	TRBJ2-5
TGCGCCAGCGCCAGGGAAACCTACGAGCAGTACTTC	CASARETYEQYF	TRBV10-1	TRBJ2-7
TGTGCCAGCAGCCACCGACTAGCGGGGGGGCTGATCGGAAGCTCCTACAATGAGCAGTTCTTC	CASSHRLAGGLIGSSYNEQFF	TRBV14	TRBJ2-1
TGTGCCAGCAGCCGCGGGGGCCCCAATGAGCAGTTCTTC	CASSRGGPNEQFF	TRBV14	TRBJ2-1
TGTGCCAGTAGTATGAAGGGGGACGATTGCAATCAGCCCCAGCATTTT	CASSMKGDDCNQPQHF	TRBV19	TRBJ1-5
TGTGCCAGCAGCTCCTTATGTGAAAAACTGTTTTTT	CASSSLCEKLFF	TRBV13	TRBJ1-4
TGTGCCAGCAGCCATCCAGGGATCAATCAGCCCCAGCATTTT	CASSHPGINQPQHF	TRBV7-9	TRBJ1-5
TGTGCCAGCAGTTCTGGGGCAGGGGGGAGTACCTACGAGCAGTACTTC	CASSSGAGGSTYEQYF	TRBV6-5	TRBJ2-7
TGTGCCAGCAGCTTAAGCGCTAATGGGGACAGCCCGCGGGGGCAGCCCCAGCATTTT	CASSLSANGDSPRGQPQHF	TRBV7-3	TRBJ1-5
TGCGCCAGCAGCTATTCAGCCGAGCAGTACTTC	CASSYSAEQYF	TRBV5-1	TRBJ2-7
TGTGCCAGCAGCTTGGTAGTTTCCCGAGATACGCAGTATTTT	CASSLVVSRDTQYF	TRBV5-5	TRBJ2-3
TGTGCCAGCAGCCAACTTGAGCGCCTAAGGTACGAGCAGTACTTC	CASSQLERLRYEQYF	TRBV14	TRBJ2-7
TGTGCCTGGAGTGTAGGGACTCCGATAATCTACGAGCAGTACTTC	CAWSVGTPIIYEQYF	TRBV30	TRBJ2-7
TGCGCCAGCATTCGGACAGGGAAAGGTGATGGAGCTTTCTTT	CASIRTGKGDGAFF	TRBV10-1	TRBJ1-1
TGTGCCAGCAGCCATAAAGGGGCCGGAGTGAGTTCTGGAAACACCATATATTTT	CASSHKGAGVSSGNTIYF	TRBV4-2	TRBJ1-3
TGTGCCAGCAGCGGGGTGCGTCCCCAGGACAGGGGAGCTAACTATGGCTACACCTTC	CASSGVRPQDRGANYGYTF	TRBV7-2	TRBJ1-2
TGTGCCACCAGTGATGGAAGTAGGGCAGTCTACAATGAGCAGTTCTTC	CATSDGSRAVYNEQFF	TRBV24-1	TRBJ2-1
TGTGCCAGCAGCCACAAGGATGCTGGCTACGAGCAGTACTTC	CASSHKDAGYEQYF	TRBV13	TRBJ2-7
TGTGCCAGCAGTTTTAGACAGTCTGAAGCTTTCTTT	CASSFRQSEAFF	TRBV28	TRBJ1-1
TGTGCCAGCATTCTCTCGGGGGCTGGAAAGAACACTGAAGCTTTCTTT	CASILSGAGKNTEAFF	TRBV28	TRBJ1-1
TGTGCCATCAGTGAGTGTCCGACAGATACGCAGTATTTT	CAISECPTDTQYF	TRBV10-3	TRBJ2-3
TGTGCCAGCAGTATACCGGCTTTTGGCGGCTACACCTTC	CASSIPAFGGYTF	TRBV5-5	TRBJ1-2
TGTGCCAGCAGCCAACTTGACGGGACAGGGGCGACGGTTGAGACCCAGTACTTC	CASSQLDGTGATVETQYF	TRBV3-1	TRBJ2-5
TGTGCCAGCAGCCAAGATAGGTTCCCGGGACAATGCTATGGCTACACCTTC	CASSQDRFPGQCYGYTF	TRBV3-1	TRBJ1-2
TGCAGTGCCGGCTCCTCCTACGAGCAGTACTTC	CSAGSSYEQYF	TRBV20-1	TRBJ2-7
TGTGCCAGCAGTGAAGCCCGAGGACCCTACAACTATGGCTACACCTTC	CASSEARGPYNYGYTF	TRBV6-1	TRBJ1-2
TGCGCCAGCAGTCTCCTCTTAGGGGGGGGGGAGACCCAGTACTTC	CASSLLLGGGETQYF	TRBV10-1	TRBJ2-5
TGTGCCAGTAGAGGACTAGCGGGTCTGGACAATGAGCAGTTCTTC	CASRGLAGLDNEQFF	TRBV19	TRBJ2-1
TGTGCCAGCAGCAAGGGGGGCGTGCGGAAACCCGCGAACACCGGGGAGCTGTTTTTT	CASSKGGVRKPANTGELFF	TRBV14	TRBJ2-2
TGCAGTGCAATACCTAGCGGGGAACAAGAGACCCAGTACTTC	CSAIPSGEQETQYF	TRBV20-1	TRBJ2-5
TGTGCCAGCAGCAACCGGGACAAAAACACTGAAGCTTTCTTT	CASSNRDKNTEAFF	TRBV13	TRBJ1-1
TGTGCCAGCAGCCCTCCTGGACAGGGGGATCGAACTGAAGCTTTCTTT	CASSPPGQGDRTEAFF	TRBV9	TRBJ1-1
TGTGCCAGCAGTTACGGGGGCATAACTGGGAGGGGACACGAGCAGTACTTC	CASSYGGITGRGHEQYF	TRBV6-5	TRBJ2-7
TGTGCCAGCAATGAAACGATACACAATGAGCAGTTCTTC	CASNETIHNEQFF	TRBV28	TRBJ2-1
TGTGCCAGCCACGTTGGGACAGACTCCTACAATGAGCAGTTCTTC	CASHVGTDSYNEQFF	TRBV7-2	TRBJ2-1
TGCAGTGCTCCCCCCGGGGCCAAAAACATTCAGTACTTC	CSAPPGAKNIQYF	TRBV20-1	TRBJ2-4
TGCAGCGCCTCACTAGGGGACAGCTACGAGCAGTACTTC	CSASLGDSYEQYF	TRBV29-1	TRBJ2-7
TGTGCCAGTAGTATAGCCCTCATCAGGGACGAGCAGTACTTC	CASSIALIRDEQYF	TRBV19	TRBJ2-7
TGTGCCAGCAGCGTAGGGCCGGGCGGATATAGTTTTTGGTCTGGGGACAATGAGCAGTTCTTC	CASSVGPGGYSFWSGDNEQFF	TRBV9	TRBJ2-1
TGTGCCACCAGTGATTTCCTGTTAGGGAAACAGGGGGACACTGAAGCTTTCTTT	CATSDFLLGKQGDTEAFF	TRBV24-1	TRBJ1-1
TGTGCCAGCAGCGTAGGGTTAAATAGAAGGGGCACTGAAGCTTTCTTT	CASSVGLNRRGTEAFF	TRBV6-4	TRBJ1-1
TGCGCCAGCAGCTTGGGGGCGAGCAACGAGCAGTACTTC	CASSLGASNEQYF	TRBV5-1	TRBJ2-7
TGTGCCGCACGGGACAGTATAACCGGGGAGCTGTTTTTT	CAARDSITGELFF	TRBV7-9	TRBJ2-2
TGTGCCAGCAGCTTAAGCGGGAGCTCCTACAATGAGCAGTTCTTC	CASSLSGSSYNEQFF	TRBV7-3	TRBJ2-1
TGTGCCATCGGGGCGGGCGGGGAGCTGTTTTTT	CAIGAGGELFF	TRBV10-3	TRBJ2-2
TGTGCCAGCAGCCGGGACAGGGCTCAAGAGACCCAGTACTTC	CASSRDRAQETQYF	TRBV7-3	TRBJ2-5
TGCGCCAGCAGCCAAAGATCGTGCTACGAGCAGTACTTC	CASSQRSCYEQYF	TRBV4-3	TRBJ2-7
TGTGCCAGCAGTTTTACAGTGACAGGGGGCCGGAGGGGCAATCAGCCCCAGCATTTT	CASSFTVTGGRRGNQPQHF	TRBV12-3	TRBJ1-5
TGTGCCAGCAGCTTAATTGGGGGGCGCCGGAACACTGAAGCTTTCTTT	CASSLIGGRRNTEAFF	TRBV7-2	TRBJ1-1
TGTGCCAGCAGCGCATGGCGCCAGGGGGGGCCGAGACATGAGCAGTTCTTC	CASSAWRQGGPRHEQFF	TRBV9	TRBJ2-1
TGTGCCAGCAGCTTTAGACCGGGGCAAGCTAGGAACACTGAAGCTTTCTTT	CASSFRPGQARNTEAFF	TRBV7-9	TRBJ1-1
TGCAGTGCTAAAACCGTTTATGAAGGGCCAAAGTCTAGCACAGATACGCAGTATTTT	CSAKTVYEGPKSSTDTQYF	TRBV20-1	TRBJ2-3
TGTGCCAGCAGAGGGGACAGCTACGAGCAGTACTTC	CASRGDSYEQYF	TRBV28	TRBJ2-7
TGTGCCAGCAGTACGCGCGGGAGGAACACTGAAGCTTTCTTT	CASSTRGRNTEAFF	TRBV6-5	TRBJ1-1
TGCAGTGCTGCCCCTTCAGGGGGCTACACCTTC	CSAAPSGGYTF	TRBV20-1	TRBJ1-2
TGTGCCAGCAGTCCCGGGGAGGGGCAAGGAAACACCATATATTTT	CASSPGEGQGNTIYF	TRBV6-5	TRBJ1-3
TGCGCCAGCAGCTTGGCTGGGCGTGGAAACACCATATATTTT	CASSLAGRGNTIYF	TRBV10-1	TRBJ1-3
TGCAGTGCTAGAGCACAGGGTAAGCCCCAGCATTTT	CSARAQGKPQHF	TRBV20-1	TRBJ1-5
TGTGCCAGCAGCCGTACAGTCACAGATACGCAGTATTTT	CASSRTVTDTQYF	TRBV14	TRBJ2-3
TGTGCCAGCAGGTTCGGGGATAATGAAAAACTGTTTTTT	CASRFGDNEKLFF	TRBV5-4	TRBJ1-4
TGTGCCAGCAGCTTACCCTGGACTAGCGGGGGCACAGATACGCAGTATTTT	CASSLPWTSGGTDTQYF	TRBV11-2	TRBJ2-3
TGTGCCAGCAGCCAAGGTCACCCGGACCTATATAGGATTGAGAGCTCCTACGAGCAGTACTTC	CASSQGHPDLYRIESSYEQYF	TRBV14	TRBJ2-7
TGTGCCTGGCATAGGATCTCCGCCTACAATGAGCAGTTCTTC	CAWHRISAYNEQFF	TRBV30	TRBJ2-1
TGTGCCAGCAGCCAAGATAACCTGATCGGGACTAGGGAACCAGGGTACAATGAGCAGTTCTTC	CASSQDNLIGTREPGYNEQFF	TRBV3-1	TRBJ2-1
TGTGCCAGCAGCCAATTGTCCGGACAGGGGCTAGCTAACTATGGCTACACCTTC	CASSQLSGQGLANYGYTF	TRBV3-1	TRBJ1-2
TGCAGTGCTAGGACATGGGGAGGGAAAAAGAACTCTGGGGCCAACGTCCTGACTTTC	CSARTWGGKKNSGANVLTF	TRBV20-1	TRBJ2-6
TGTGCCAGCAGGCGGTTCAGCACCGGGGAGCTGTTTTTT	CASRRFSTGELFF	TRBV7-9	TRBJ2-2
TGCGCCAGCAGTGCTAACGAGACTAGCAAATACAATGAGCAGTTCTTC	CASSANETSKYNEQFF	TRBV10-1	TRBJ2-1
TGTGCCCCCCCCGGGACAGGGACGGCTCAGCCCCAGCATTTT	CAPPGTGTAQPQHF	TRBV27	TRBJ1-5
TGTGCCAGCAGCGTAGACAGGGGGCGTGGCTACACCTTC	CASSVDRGRGYTF	TRBV9	TRBJ1-2
TGCAGTGCTAGATCCAGGGGGAAGAGGACTGGGGCCAACGTCCTGACTTTC	CSARSRGKRTGANVLTF	TRBV20-1	TRBJ2-6
TGCGCCAGCAGCTTCGGGATAGTCTACGAGCAGTACTTC	CASSFGIVYEQYF	TRBV5-1	TRBJ2-7
TGCAGTGCAGAGTCGGCGTACGAGCAGTACTTC	CSAESAYEQYF	TRBV20-1	TRBJ2-7
TGTGCCAGTAGTATTCTAGCGGCATTTACAAGCTCCTACGAGCAGTACTTC	CASSILAAFTSSYEQYF	TRBV19	TRBJ2-7
TGCGCCAGCAGCCAACGGACAGGGTTCAATGAGCAGTTCTTC	CASSQRTGFNEQFF	TRBV4-3	TRBJ2-1
TGTGCCAGCAGTCCCTCATCCGAGCAGTACTTC	CASSPSSEQYF	TRBV6-5	TRBJ2-7
TGTGCCACCACGAGGCTTTTAGAGACCCAGTACTTC	CATTRLLETQYF	TRBV24-1	TRBJ2-5
TGTGCCAGCAGCCAAACAATCCCAAAGGGTAGCGCCTACGAGCAGTACTTC	CASSQTIPKGSAYEQYF	TRBV3-1	TRBJ2-7
TGTGCCAGCAGCTTACTCGCAACAGGGGGCAACTATGGCTACACCTTC	CASSLLATGGNYGYTF	TRBV7-3	TRBJ1-2
TGTGCCACCAGTGACAGGTGTTCCACAGATACGCAGTATTTT	CATSDRCSTDTQYF	TRBV24-1	TRBJ2-3
TGTGCCAGCATTTTTGGCACTAGCGGGAGGGCACGCTACGAGCAGTACTTC	CASIFGTSGRARYEQYF	TRBV28	TRBJ2-7
TGTGCCAGCAGCGGACAGGGTTGGGTATCCTCCTACGAGCAGTACTTC	CASSGQGWVSSYEQYF	TRBV9	TRBJ2-7
TGTGCCAGCAGCTTGAGCGGGGGCGCCTCCTACGAGCAGTACTTC	CASSLSGGASYEQYF	TRBV5-5	TRBJ2-7
TGTGCCAGCAGTTACCGTCAGGGGGGGGCTGGGGCCAACGTCCTGACTTTC	CASSYRQGGAGANVLTF	TRBV6-2	TRBJ2-6
TGTGCCAGTAGTATCAGGGAGGGGGTGCAATACGAGCAGTACTTC	CASSIREGVQYEQYF	TRBV19	TRBJ2-7
TGTGCCAGCAGCCCATTGCGACAGTACAATGAGCAGTTCTTC	CASSPLRQYNEQFF	TRBV16	TRBJ2-1
TGCAGTGCCGAGGGACCCGGATTTGCCAACTGCAATGAGCAGTTCTTC	CSAEGPGFANCNEQFF	TRBV20-1	TRBJ2-1
TGTGCCAGCAGCGTAGCCAGGGGGCGTCCAGATACGCAGTATTTT	CASSVARGRPDTQYF	TRBV9	TRBJ2-3
TGCGCCAGCGCACAGGACAGGGATAGCAATCAGCCCCAGCATTTT	CASAQDRDSNQPQHF	TRBV4-3	TRBJ1-5
TGTGCCAGCAGCTTAGCCAAGGGGGGACTAGCGGGGGGCGGATCCTACAATGAGCAGTTCTTC	CASSLAKGGLAGGGSYNEQFF	TRBV7-9	TRBJ2-1
TGCAGCGGGACATTTTTCGAGCAGTACTTC	CSGTFFEQYF	TRBV29-1	TRBJ2-7
TGTGCCAGCAGTTTATACCCCACTAGCGGGACCCCCTACGAGCAGTACTTC	CASSLYPTSGTPYEQYF	TRBV27	TRBJ2-7
TGTGCCAGCAGTTTGACTGGGAGGGGACGCACAGATACGCAGTATTTT	CASSLTGRGRTDTQYF	TRBV28	TRBJ2-3
TGTGCCAGCAGTGACTCGAGCGGGGGCTTTGTTCAACAAGAGACCCAGTACTTC	CASSDSSGGFVQQETQYF	TRBV6-4	TRBJ2-5
TGTGCCAGCAGCACTCTTGCCCCGGGGGCCCTGGGCACCATATATTTT	CASSTLAPGALGTIYF	TRBV7-3	TRBJ1-3
TGCAGTGCTGGTGCCCGGGACAGGGTGAACACTGAAGCTTTCTTT	CSAGARDRVNTEAFF	TRBV20-1	TRBJ1-1
TGTGCCAGCCTCGGGGTGGGCTACACCTTC	CASLGVGYTF	TRBV12-4	TRBJ1-2
TGTGCCAGCAGCTCCTCGGGACAGAGCACTGAAGCTTTCTTT	CASSSSGQSTEAFF	TRBV7-3	TRBJ1-1
TGTGCCAGCAGTGAATGGGGGACTAGCGGGGGGACGACCCGCTACAATGAGCAGTTCTTC	CASSEWGTSGGTTRYNEQFF	TRBV6-1	TRBJ2-1
TGTGCCAGCAGCCAAGATCAAGCGGGGACCGAGCGGGACGAGCAGTACTTC	CASSQDQAGTERDEQYF	TRBV3-1	TRBJ2-7
TGTGCCAGCAGGGGACAGGAGGAAAAACTGTTTTTT	CASRGQEEKLFF	TRBV6-4	TRBJ1-4
TGTGCTTTCAGGTTCGAGGACTGTTATAGCAATCAGCCCCAGCATTTT	CAFRFEDCYSNQPQHF	TRBV25-1	TRBJ1-5
TGCGCCAGCAGCTACAGGGGGGAGGCCGACTACGAGCAGTACTTC	CASSYRGEADYEQYF	TRBV5-1	TRBJ2-7
TGTGCCACCAGTGATGGCAGGGGAAGTGAGACCCAGTACTTC	CATSDGRGSETQYF	TRBV24-1	TRBJ2-5
TGTGCCAGCAGGAGCAGGGACAGGGAGGATAATTCACCCCTCCACTTT	CASRSRDREDNSPLHF	TRBV6-2	TRBJ1-6
TGTGCCTGGATACTTAGGGGTAGTGGCTACACCTTC	CAWILRGSGYTF	TRBV30	TRBJ1-2
TGTGCCAGCACCGACAGGGCGTATACGGGATACGAGCAGTACTTC	CASTDRAYTGYEQYF	TRBV9	TRBJ2-7
TGTGCCAGACCCCTCAGGGTCACCCAGCCCCAGCATTTT	CARPLRVTQPQHF	TRBV12-4	TRBJ1-5
TGCAGCGGCCGGATACGACTAGCGGGGGGGCCCCTCAATGAGCAGTTCTTC	CSGRIRLAGGPLNEQFF	TRBV29-1	TRBJ2-1
TGTGCCAGCAGGCTCCGGACAGTTCTTGGGAACTACGAGCAGTACTTC	CASRLRTVLGNYEQYF	TRBV12-3	TRBJ2-7
TGCAGTGCTAGAGATCCTTTAGTGCCGGGCGTAGCCTACAATGAGCAGTTCTTC	CSARDPLVPGVAYNEQFF	TRBV20-1	TRBJ2-1
TGTGCCAGCAGGGGCAACACTGAAGCTTTCTTT	CASRGNTEAFF	TRBV6-1	TRBJ1-1
TGTGCCAGCAGAACCACGGCGGTTACCAGGGACAGTGGTGGGGCCAACGTCCTGACTTTC	CASRTTAVTRDSGGANVLTF	TRBV12-4	TRBJ2-6
TGTGCCAGCAGCTTAGTCCCCAGGTACGAGCAGTACTTC	CASSLVPRYEQYF	TRBV7-8	TRBJ2-7
TGTGCCAGCCCCCAGGGGGAGAACTACGAGCAGTACTTC	CASPQGENYEQYF	TRBV5-6	TRBJ2-7
